,y_proba,y_test,Neg,Pos,TN,FP,FN,TP,FP/P,Prec
0,0.0212,0,4,0,4,676440,0,126256,5.357685971359777,0.15728993292603924
1,0.0229,0,1,0,5,676439,0,126256,5.357678050944114,0.1572901288783411
2,0.0232,0,2,0,7,676437,0,126256,5.357662210112787,0.15729052078440947
3,0.0235,0,6,0,13,676431,0,126256,5.357614687618806,0.15729169651433247
4,0.0236,0,1,0,14,676430,0,126256,5.357606767203142,0.1572918924710285
5,0.0239,0,2,0,16,676428,0,126256,5.357590926371816,0.15729228438588536
6,0.024,0,1,0,17,676427,0,126256,5.357583005956153,0.15729248034404616
7,0.0241,0,7,0,24,676420,0,126256,5.357527563046509,0.1572938520648431
8,0.0244,1,0,1,24,676420,1,126255,5.357527563046509,0.15729280219266825
9,0.0245,0,8,0,32,676412,1,126255,5.357464199721202,0.15729436989436466
10,0.0247,0,3,0,35,676409,1,126255,5.357440438474211,0.15729495779055744
11,0.0248,1,0,1,35,676409,2,126254,5.357440438474211,0.15729390790406433
12,0.0249,0,1,0,36,676408,2,126254,5.357432518058547,0.15729410386937465
13,0.025,0,1,0,37,676407,2,126254,5.3574245976428845,0.15729429983517326
14,0.0251,0,4,0,41,676403,2,126254,5.35739291598023,0.15729508370325057
15,0.0252,0,4,0,45,676399,2,126254,5.357361234317577,0.15729586757914069
16,0.0253,0,3,0,48,676396,2,126254,5.3573374730705865,0.15729645549118546
17,0.0254,1,0,1,48,676396,3,126253,5.3573374730705865,0.15729540558824592
18,0.0255,0,1,0,49,676395,3,126253,5.357329552654924,0.15729560155884023
19,0.0257,0,2,0,51,676393,3,126253,5.357313711823596,0.1572959935014938
20,0.0258,0,1,0,52,676392,3,126253,5.357305791407933,0.15729618947355306
21,0.0259,0,4,0,56,676388,3,126253,5.35727410974528,0.15729697336667328
22,0.026,0,4,0,60,676384,3,126253,5.357242428082626,0.15729775726760664
23,0.0261,0,2,0,62,676382,3,126253,5.357226587251299,0.15729814922100332
24,0.0262,1,14,1,76,676368,4,126252,5.357115701432011,0.15729984301412872
25,0.0263,1,13,1,89,676355,5,126251,5.357012736028387,0.15730134088207665
26,0.0264,0,2,0,91,676353,5,126251,5.35699689519706,0.1573017328595422
27,0.0265,0,5,0,96,676348,5,126251,5.356957293118743,0.15730271281175282
28,0.0266,0,4,0,100,676344,5,126251,5.356925611456089,0.15730349678231237
29,0.0267,0,11,0,111,676333,5,126251,5.356838486883792,0.15730565274164449
30,0.0268,2,17,2,128,676316,7,126249,5.356703839817514,0.15730688480060806
31,0.0269,0,6,0,134,676310,7,126249,5.356656317323533,0.15730806084038682
32,0.027,0,1,0,135,676309,7,126249,5.35664839690787,0.1573082568487262
33,0.0271,0,5,0,140,676304,7,126249,5.356608794829553,0.15730923689775006
34,0.0272,2,36,2,176,676268,9,126247,5.356323659865669,0.15731419350417125
35,0.0273,2,11,2,187,676257,11,126245,5.356236535293372,0.15731424968411295
36,0.0275,1,6,1,193,676251,12,126244,5.356189012799391,0.15731437579050336
37,0.0276,0,7,0,200,676244,12,126244,5.356133569889748,0.15731574802364645
38,0.0277,1,15,1,215,676229,13,126243,5.356014763654796,0.15731763849704414
39,0.0278,1,7,1,222,676222,14,126242,5.355959320745153,0.1573179606811022
40,0.0279,0,12,0,234,676210,14,126242,5.355864275757192,0.15732031323991966
41,0.028,0,3,0,237,676207,14,126242,5.355840514510201,0.15732090139061797
42,0.0281,0,12,0,249,676195,14,126242,5.35574546952224,0.15732325403738862
43,0.0282,1,12,1,261,676183,15,126241,5.3556504245342795,0.15732455659352163
44,0.0283,2,32,2,293,676151,17,126239,5.35539697123305,0.1573287304178766
45,0.0284,0,5,0,298,676146,17,126239,5.355357369154733,0.15732971079967845
46,0.0285,2,33,2,331,676113,19,126237,5.355095995437841,0.15733408113666106
47,0.0286,1,10,1,341,676103,20,126236,5.355016791281207,0.15733499181767308
48,0.0287,0,17,0,358,676086,20,126236,5.354882144214929,0.15733832551020663
49,0.0288,0,21,0,379,676065,20,126236,5.354715815485997,0.15734244379603166
50,0.0289,1,29,1,408,676036,21,126235,5.354486123431758,0.1573470809738854
51,0.029,0,26,0,434,676010,21,126235,5.3542801926245085,0.15735218044363006
52,0.0291,1,25,1,459,675985,22,126234,5.354082182232924,0.1573560337015204
53,0.0292,3,23,3,482,675962,25,126231,5.353900012672665,0.15735739404357804
54,0.0293,2,45,2,527,675917,27,126229,5.353543593967811,0.1573641207460986
55,0.0294,0,22,0,549,675895,27,126229,5.353369344823216,0.15736843680029522
56,0.0295,2,32,2,581,675863,29,126227,5.353115891521987,0.15737261404580533
57,0.0296,5,30,5,611,675833,34,126222,5.352878279052085,0.15737324747056
58,0.0297,0,42,0,653,675791,34,126222,5.3525456215942215,0.1573814888287347
59,0.0298,0,36,0,689,675755,34,126222,5.352260486630338,0.1573885535370715
60,0.0299,1,25,1,714,675730,35,126221,5.352062476238753,0.1573924092619125
61,0.03,1,33,1,747,675697,36,126220,5.35180110252186,0.1573978354368345
62,0.0301,5,51,5,798,675646,41,126215,5.3513971613230265,0.15740259221984856
63,0.0302,2,108,2,906,675538,43,126213,5.350541756431378,0.1574216932688578
64,0.0303,1,19,1,925,675519,44,126212,5.350391268533772,0.15742437301289336
65,0.0304,2,46,2,971,675473,46,126210,5.350026929413255,0.15743130389443208
66,0.0305,1,53,1,1024,675420,47,126209,5.349607147383095,0.15744066145311608
67,0.0306,1,85,1,1109,675335,48,126208,5.348933912051704,0.1574563061495141
68,0.0307,1,35,1,1144,675300,49,126207,5.348656697503485,0.15746213071127263
69,0.0308,1,21,1,1165,675279,50,126206,5.348490368774553,0.1574652052128237
70,0.0309,2,54,2,1219,675225,52,126204,5.348062666328729,0.15747371258090237
71,0.031,1,27,1,1246,675198,53,126203,5.3478488151058166,0.15747796671079772
72,0.0311,3,43,3,1289,675155,56,126200,5.34750823723229,0.15748326272376162
73,0.0312,0,34,0,1323,675121,56,126200,5.347238943099734,0.15748994472876662
74,0.0313,1,38,1,1361,675083,57,126199,5.346937967304524,0.15749636207976717
75,0.0314,7,113,7,1474,674970,64,126192,5.346042960334558,0.1575112149602702
76,0.0315,4,55,4,1529,674915,68,126188,5.34560733747307,0.15751782230250042
77,0.0316,3,57,3,1586,674858,71,126185,5.345155873780256,0.15752587563963483
78,0.0317,4,71,4,1657,674787,75,126181,5.344593524268154,0.15753563188541864
79,0.0318,0,75,0,1732,674712,75,126181,5.343999493093397,0.157550384383432
80,0.0319,4,137,4,1869,674575,79,126177,5.34291439614751,0.1575731312566188
81,0.032,4,56,4,1925,674519,83,126173,5.342470852870359,0.1575799433490031
82,0.0321,4,100,4,2025,674419,87,126169,5.341678811304018,0.15759541736823435
83,0.0322,4,75,4,2100,674344,91,126165,5.341084780129261,0.15760597319955177
84,0.0323,3,65,3,2165,674279,94,126162,5.34056995311114,0.1576156143925661
85,0.0324,4,83,4,2248,674196,98,126158,5.339912558611076,0.15762774972074856
86,0.0325,1,123,1,2371,674073,99,126157,5.338938347484476,0.1576509253589593
87,0.0326,3,120,3,2491,673953,102,126154,5.337987897604866,0.15767141144871874
88,0.0327,2,141,2,2632,673812,104,126152,5.336871118996325,0.15769709636933663
89,0.0328,2,104,2,2736,673708,106,126150,5.33604739576733,0.1577154945002738
90,0.0329,2,149,2,2885,673559,108,126148,5.334867253833481,0.15774277329071773
91,0.033,1,86,1,2971,673473,109,126147,5.334186098086428,0.15775868537555338
92,0.0331,2,93,2,3064,673380,111,126145,5.33344949942973,0.157774928864013
93,0.0332,5,116,5,3180,673264,116,126140,5.332530731212774,0.1577925554538131
94,0.0333,1,120,1,3300,673144,117,126139,5.3315802813331645,0.15781519186570964
95,0.0334,6,115,6,3415,673029,123,126133,5.330669433531872,0.15783157857856103
96,0.0335,8,160,8,3575,672869,131,126125,5.329402167025726,0.15785475235108148
97,0.0336,2,125,2,3700,672744,133,126123,5.328412115067799,0.15787734378813995
98,0.0337,1,98,1,3798,672646,134,126122,5.3276359143327845,0.15789565931534563
99,0.0338,1,82,1,3880,672564,135,126121,5.326986440248384,0.15791081590364162
100,0.0339,10,198,10,4078,672366,145,126111,5.3254181979470285,0.1579394271845025
101,0.034,2,96,2,4174,672270,147,126109,5.324657838043341,0.1579563089710526
102,0.0341,3,91,3,4265,672179,150,126106,5.32393708021797,0.15797115065421496
103,0.0342,1,121,1,4386,672058,151,126105,5.322978709922697,0.15799404382312887
104,0.0343,7,163,7,4549,671895,158,126098,5.321687682169561,0.15801892999061395
105,0.0344,3,75,3,4624,671820,161,126095,5.321093650994804,0.15803061729632856
106,0.0345,6,78,6,4702,671742,167,126089,5.320475858573058,0.15803973523214815
107,0.0346,5,87,5,4789,671655,172,126084,5.319786782410341,0.15805169359903426
108,0.0347,6,153,6,4942,671502,178,126078,5.318574958813839,0.1580756789287595
109,0.0348,7,99,7,5041,671403,185,126071,5.317790837663161,0.15808791258398394
110,0.0349,6,186,6,5227,671217,191,126065,5.316317640349766,0.15811845745921768
111,0.035,10,170,10,5397,671047,201,126055,5.314971169686985,0.15814161801124574
112,0.0351,2,63,2,5460,670984,203,126053,5.3144721835001905,0.15815200549033484
113,0.0352,0,114,0,5574,670870,203,126053,5.313569256114561,0.15817462916743524
114,0.0353,5,182,5,5756,670688,208,126048,5.312127740463819,0.15820547835167484
115,0.0354,7,153,7,5909,670535,215,126041,5.310915916867317,0.15822846784236533
116,0.0355,5,125,5,6034,670410,220,126036,5.30992586490939,0.1582480168146993
117,0.0356,4,102,4,6136,670308,224,126032,5.309117982511722,0.15826405806565036
118,0.0357,1,76,1,6212,670232,225,126031,5.308516030921303,0.15827810660548086
119,0.0358,4,99,4,6311,670133,229,126027,5.307731909770625,0.1582935590836013
120,0.0359,4,90,4,6401,670043,233,126023,5.307019072360918,0.15830722578278686
121,0.036,5,161,5,6562,669882,238,126018,5.3057438854391075,0.15833396155295892
122,0.0361,0,41,0,6603,669841,238,126018,5.305419148396908,0.1583421183903179
123,0.0362,5,135,5,6738,669706,243,126013,5.304349892282347,0.15836369371599773
124,0.0363,2,73,2,6811,669633,245,126011,5.303771701938918,0.15837610790755666
125,0.0364,0,107,0,6918,669526,245,126011,5.302924217462932,0.1583974095485188
126,0.0365,4,124,4,7042,669402,249,126007,5.301942085920669,0.15841787055464548
127,0.0366,2,122,2,7164,669280,251,126005,5.300975795209733,0.15844005608052458
128,0.0367,10,190,10,7354,669090,261,125995,5.299470916233684,0.1584673336813045
129,0.0368,10,145,10,7499,668945,271,125985,5.298322455962489,0.15848565282477703
130,0.0369,2,146,2,7645,668799,273,125983,5.297166075275631,0.15851264875148155
131,0.037,1,87,1,7732,668712,274,125982,5.2964769991129135,0.15852894321587932
132,0.0371,5,131,5,7863,668581,279,125977,5.295439424661006,0.15854978491186295
133,0.0372,6,125,6,7988,668456,285,125971,5.294449372703079,0.1585683769559695
134,0.0373,5,122,5,8110,668334,290,125966,5.293483081992143,0.15858743547777918
135,0.0374,4,189,4,8299,668145,294,125962,5.291986123431758,0.158620941510401
136,0.0375,6,109,6,8408,668036,300,125956,5.291122798124445,0.15863635905651444
137,0.0376,2,103,2,8511,667933,302,125954,5.290306995311114,0.1586548211521287
138,0.0377,6,111,6,8622,667822,308,125948,5.289427829172475,0.15867064766872016
139,0.0378,2,88,2,8710,667734,310,125946,5.288730832594094,0.1586861203507711
140,0.0379,6,111,6,8821,667623,316,125940,5.287851666455456,0.15870195561032963
141,0.038,4,105,4,8926,667518,320,125936,5.287020022810797,0.15871871589279277
142,0.0381,1,98,1,9024,667420,321,125935,5.286243822075782,0.15873726137731534
143,0.0382,9,127,9,9151,667293,330,125926,5.285237929286529,0.15875313122857623
144,0.0383,3,142,3,9293,667151,333,125923,5.284113230262324,0.15877837377092174
145,0.0384,1,153,1,9446,666998,334,125922,5.282901406665822,0.15880795036069212
146,0.0385,4,125,4,9571,666873,338,125918,5.281911354707895,0.15882874553318593
147,0.0386,8,103,8,9674,666770,346,125910,5.2810955518945635,0.15884089418176314
148,0.0387,1,194,1,9868,666576,347,125909,5.279558991255861,0.15887871694732392
149,0.0388,3,196,3,10064,666380,350,125906,5.278006589785832,0.1589148363091106
150,0.0389,4,100,4,10164,666280,354,125902,5.277214548219491,0.15893064977492546
151,0.039,5,227,5,10391,666053,359,125897,5.275416613863896,0.15897089462718605
152,0.0391,9,201,9,10592,665852,368,125888,5.2738246103155495,0.15900169247480234
153,0.0392,4,109,4,10701,665743,372,125884,5.272961285008237,0.15901933612673647
154,0.0393,2,111,2,10812,665632,374,125882,5.272082118869598,0.1590395116195039
155,0.0394,6,163,6,10975,665469,380,125876,5.270791091116462,0.15906589414225147
156,0.0395,3,123,3,11098,665346,383,125873,5.269816879989862,0.15908743344131018
157,0.0396,11,164,11,11262,665182,394,125862,5.268517931821062,0.15910872214440663
158,0.0397,10,154,10,11416,665028,404,125852,5.267298187808896,0.15912907141412097
159,0.0398,3,136,3,11552,664892,407,125849,5.266221011278672,0.15915324992633492
160,0.0399,5,85,5,11637,664807,412,125844,5.265547775947281,0.15916504247765448
161,0.04,8,128,8,11765,664679,420,125836,5.264533962742365,0.15918230520609983
162,0.0401,7,151,7,11916,664528,427,125829,5.263337979977189,0.15920527052964673
163,0.0402,4,135,4,12051,664393,431,125825,5.262268723862628,0.1592282129741413
164,0.0403,2,101,2,12152,664292,433,125823,5.261468761880623,0.1592464388095404
165,0.0404,4,111,4,12263,664181,437,125819,5.260589595741984,0.15926455696202532
166,0.0405,6,156,6,12419,664025,443,125813,5.259354010898492,0.15928962648036685
167,0.0406,6,180,6,12599,663845,449,125807,5.257928336079077,0.15931954835801088
168,0.0407,8,237,8,12836,663608,457,125799,5.2560511975668485,0.15935886051175122
169,0.0408,3,67,3,12903,663541,460,125796,5.2555205297173995,0.1593691921194623
170,0.0409,2,128,2,13031,663413,462,125794,5.254506716512482,0.1593929095915267
171,0.041,9,142,9,13173,663271,471,125785,5.253382017488278,0.15941200624543758
172,0.0411,10,157,10,13330,663114,481,125775,5.252138512229122,0.15943307613618646
173,0.0412,1,76,1,13406,663038,482,125774,5.251536560638702,0.15944737149029173
174,0.0413,4,113,4,13519,662925,486,125770,5.2506415536687365,0.15946595325189078
175,0.0414,3,131,3,13650,662794,489,125767,5.249603979216829,0.1594892468686633
176,0.0415,4,169,4,13819,662625,493,125763,5.248265428969712,0.15951917076363414
177,0.0416,6,100,6,13919,662525,499,125757,5.247473387403371,0.15953300976046644
178,0.0417,4,145,4,14064,662380,503,125753,5.246324927132176,0.15955809489007566
179,0.0418,6,157,6,14221,662223,509,125747,5.24508142187302,0.159583486680965
180,0.0419,4,98,4,14319,662125,513,125743,5.2443052211380055,0.15959906989495704
181,0.042,2,76,2,14395,662049,515,125741,5.243703269547586,0.15961233323601468
182,0.0421,5,157,5,14552,661892,520,125736,5.24245976428843,0.15963881426257065
183,0.0422,8,121,8,14673,661771,528,125728,5.241501393993157,0.15965480591086464
184,0.0423,7,158,7,14831,661613,535,125721,5.240249968318337,0.15967937368384955
185,0.0424,7,132,7,14963,661481,542,125714,5.239204473450767,0.15969867694789727
186,0.0425,1,95,1,15058,661386,543,125713,5.2384520339627425,0.15971688440717113
187,0.0426,5,124,5,15182,661262,548,125708,5.237469902420479,0.15973671169167822
188,0.0427,8,136,8,15318,661126,556,125700,5.236392725890255,0.15975577827880624
189,0.0428,5,156,5,15474,660970,561,125695,5.235157141046762,0.15978211818245378
190,0.0429,6,93,6,15567,660877,567,125689,5.2344205423900645,0.15979460083451358
191,0.043,5,142,5,15709,660735,572,125684,5.23329584336586,0.1598181122277056
192,0.0431,4,103,4,15812,660632,576,125680,5.232480040552528,0.15983477296543866
193,0.0432,15,164,15,15976,660468,591,125665,5.2311810923837285,0.15985208609739066
194,0.0433,2,152,2,16128,660316,593,125663,5.22997718920289,0.15988086195687162
195,0.0434,6,115,6,16243,660201,599,125657,5.229066341401596,0.15989784413978098
196,0.0435,6,61,6,16304,660140,605,125651,5.228583196046128,0.15990384211577888
197,0.0436,13,211,13,16515,659929,618,125638,5.226911988341148,0.15993288923796442
198,0.0437,6,135,6,16650,659794,624,125632,5.225842732226587,0.1599539612897969
199,0.0438,6,105,6,16755,659689,630,125626,5.225011088581929,0.1599689296651662
200,0.0439,14,187,14,16942,659502,644,125612,5.22352997085287,0.15999205210962994
201,0.044,2,96,2,17038,659406,646,125610,5.222769610949182,0.16000947751383413
202,0.0441,3,82,3,17120,659324,649,125607,5.222120136864783,0.16002298291187378
203,0.0442,9,171,9,17291,659153,658,125598,5.220765745786339,0.160048219116637
204,0.0443,11,162,11,17453,658991,669,125587,5.2194826384488655,0.16006948958548417
205,0.0444,6,121,6,17574,658870,675,125581,5.218524268153593,0.160087755640569
206,0.0445,4,112,4,17686,658758,679,125577,5.21763718159929,0.16010633211574135
207,0.0446,3,123,3,17809,658635,682,125574,5.21666297047269,0.16012823112206057
208,0.0447,4,124,4,17933,658511,686,125570,5.215680838930427,0.16014927029222747
209,0.0448,11,193,11,18126,658318,697,125559,5.214152198707388,0.1601769155109794
210,0.0449,10,126,10,18252,658192,707,125549,5.213154226333798,0.1601919511675413
211,0.045,4,88,4,18340,658104,711,125545,5.212457229755418,0.16020565329630995
212,0.0451,6,189,6,18529,657915,717,125539,5.210960271195033,0.1602378697409165
213,0.0452,5,126,5,18655,657789,722,125534,5.209962298821442,0.16025828425821786
214,0.0453,7,172,7,18827,657617,729,125527,5.208599987327335,0.16028597550386647
215,0.0454,2,114,2,18941,657503,731,125525,5.207697059941705,0.16030716653810592
216,0.0455,7,156,7,19097,657347,738,125518,5.206461475098213,0.16033160251128867
217,0.0456,17,252,17,19349,657095,755,125501,5.204465530351033,0.16036499036539925
218,0.0457,14,201,14,19550,656894,769,125487,5.202873526802686,0.16039116491837097
219,0.0458,9,171,9,19721,656723,778,125478,5.201519135724243,0.16041656811995894
220,0.0459,2,61,2,19782,656662,780,125476,5.201035990368775,0.16042693233163458
221,0.046,12,215,12,19997,656447,792,125464,5.19933310100114,0.16045815956035916
222,0.0461,8,135,8,20132,656312,800,125456,5.198263844886579,0.160477277146161
223,0.0462,14,224,14,20356,656088,814,125442,5.196489671777975,0.16050823384898852
224,0.0463,15,230,15,20586,655858,829,125427,5.194667976175389,0.16053936783632095
225,0.0464,5,151,5,20737,655707,834,125422,5.193471993410214,0.1605650283115849
226,0.0465,5,112,5,20849,655595,839,125417,5.192584906855912,0.16058267990760705
227,0.0466,6,136,6,20985,655459,845,125411,5.191507730325688,0.16060419788184974
228,0.0467,12,243,12,21228,655216,857,125399,5.189583069319478,0.16064128923989418
229,0.0468,9,138,9,21366,655078,866,125390,5.188490051957927,0.16066001424786153
230,0.0469,13,234,13,21600,654844,879,125377,5.1866366746926875,0.16069421356256752
231,0.047,19,324,19,21924,654520,898,125358,5.184070460017741,0.16074052608228467
232,0.0471,12,292,12,22216,654228,910,125346,5.181757698644025,0.1607878148835133
233,0.0472,16,374,16,22590,653854,926,125330,5.178795463185908,0.1608477586808764
234,0.0473,12,120,12,22710,653734,938,125318,5.177845013306298,0.16085960885794529
235,0.0474,20,228,20,22938,653506,958,125298,5.17603915853504,0.16088515210502258
236,0.0475,8,159,8,23097,653347,966,125290,5.174779812444557,0.16090938396197457
237,0.0476,7,132,7,23229,653215,973,125283,5.1737343175769865,0.16092912248971739
238,0.0477,9,124,9,23353,653091,982,125274,5.172752186034723,0.1609450579098495
239,0.0478,12,186,12,23539,652905,994,125262,5.171278988721328,0.16097058857546
240,0.0479,6,119,6,23658,652786,1000,125256,5.170336459257382,0.16098873839715594
241,0.048,5,161,5,23819,652625,1005,125251,5.169061272335572,0.1610166658953355
242,0.0481,5,148,5,23967,652477,1010,125246,5.1678890508173865,0.16104191338047094
243,0.0482,19,216,19,24183,652261,1029,125227,5.166178241034089,0.16106615150330295
244,0.0483,6,140,6,24323,652121,1035,125221,5.165069382841211,0.1610886842599525
245,0.0484,8,190,8,24513,651931,1043,125213,5.163564503865163,0.16111943217730562
246,0.0485,3,151,3,24664,651780,1046,125210,5.162368521099987,0.16114750511589596
247,0.0486,10,257,10,24921,651523,1056,125200,5.16033297427449,0.161190025272845
248,0.0487,8,159,8,25080,651364,1064,125192,5.159073628184007,0.16121438762948198
249,0.0488,10,202,10,25282,651162,1074,125182,5.157473704219997,0.16124553033191472
250,0.0489,16,290,16,25572,650872,1090,125166,5.155176783677607,0.1612884936046946
251,0.049,10,236,10,25808,650636,1100,125156,5.153307565581041,0.16132674737558522
252,0.0491,3,138,3,25946,650498,1103,125153,5.152214548219491,0.1613522060823747
253,0.0492,8,136,8,26082,650362,1111,125145,5.151137371689266,0.16137185093106832
254,0.0493,5,123,5,26205,650239,1116,125140,5.150163160562666,0.16139204182728703
255,0.0494,19,188,19,26393,650051,1135,125121,5.148674122417945,0.16141062886688373
256,0.0495,3,125,3,26518,649926,1138,125118,5.147684070460017,0.1614334153931906
257,0.0496,7,186,7,26704,649740,1145,125111,5.1462108731466225,0.16146459125689971
258,0.0497,2,84,2,26788,649656,1147,125109,5.1455455582308955,0.16147993262473137
259,0.0498,10,176,10,26964,649480,1157,125099,5.144151565074135,0.16150579863383852
260,0.0499,16,213,16,27177,649267,1173,125083,5.142464516537828,0.16153289856008266
261,0.05,13,254,13,27431,649013,1186,125070,5.14045273095932,0.16157182110962262
262,0.0501,11,135,11,27566,648878,1197,125059,5.1393834748447595,0.16158808791930093
263,0.0502,11,222,11,27788,648656,1208,125048,5.137625142567482,0.16162253264814452
264,0.0503,18,316,18,28104,648340,1226,125030,5.135122291217843,0.16166905879462612
265,0.0504,10,133,10,28237,648207,1236,125020,5.134068875934609,0.16168602493187642
266,0.0505,4,135,4,28372,648072,1240,125016,5.1329996198200485,0.1617099217682851
267,0.0506,10,141,10,28513,647931,1250,125006,5.131882841211507,0.16172857555014186
268,0.0507,10,309,10,28822,647622,1260,124996,5.129435432771512,0.16178240734748608
269,0.0508,13,241,13,29063,647381,1273,124983,5.127526612596629,0.1618187797463372
270,0.0509,27,396,27,29459,646985,1300,124956,5.124390127993917,0.16187247470985477
271,0.051,6,195,6,29654,646790,1306,124950,5.122845646939552,0.16190685982325653
272,0.0511,4,185,4,29839,646605,1310,124946,5.12138037004182,0.161941336347176
273,0.0512,5,121,5,29960,646484,1315,124941,5.120421999746546,0.1619613053764138
274,0.0513,6,172,6,30132,646312,1321,124935,5.119059688252439,0.16199090563723426
275,0.0514,9,107,9,30239,646205,1330,124926,5.118212203776454,0.16200360250074242
276,0.0515,9,148,9,30387,646057,1339,124917,5.117039982258269,0.16202491912827152
277,0.0516,4,205,4,30592,645852,1343,124913,5.115416297047269,0.1620636640221079
278,0.0517,5,147,5,30739,645705,1348,124908,5.114251995944747,0.162089142020703
279,0.0518,8,195,8,30934,645510,1356,124900,5.112707514890381,0.16212146778987813
280,0.0519,10,205,10,31139,645305,1366,124890,5.111083829679382,0.1621537402865508
281,0.052,17,290,17,31429,645015,1383,124873,5.108786909136992,0.1621963194646494
282,0.0521,34,507,34,31936,644508,1417,124839,5.10477125839564,0.16226618157996328
283,0.0522,32,403,32,32339,644105,1449,124807,5.101579330883284,0.16231636390120066
284,0.0523,15,255,15,32594,643850,1464,124792,5.099559624889114,0.16235386564876755
285,0.0524,15,247,15,32841,643603,1479,124777,5.097603282220251,0.16238970301153074
286,0.0525,33,564,33,33405,643039,1512,124744,5.093136167786086,0.16247299041526056
287,0.0526,4,82,4,33487,642957,1516,124740,5.0924866937016855,0.16248598079711135
288,0.0527,16,268,16,33755,642689,1532,124724,5.09036402230389,0.16252526345005883
289,0.0528,12,177,12,33932,642512,1544,124712,5.088962108731466,0.16254965955183884
290,0.0529,4,97,4,34029,642415,1548,124708,5.088193828412115,0.16256584667647822
291,0.053,7,170,7,34199,642245,1555,124701,5.086847357749335,0.16259423740393716
292,0.0531,3,126,3,34325,642119,1558,124698,5.085849385375744,0.16261767801183333
293,0.0532,13,373,13,34698,641746,1571,124685,5.082895070333291,0.16268261591715366
294,0.0533,13,224,13,34922,641522,1584,124672,5.081120897224686,0.16271597010678757
295,0.0534,19,288,19,35210,641234,1603,124653,5.078839817513623,0.1627563857331434
296,0.0535,18,280,18,35490,640954,1621,124635,5.076622101127867,0.16279622617357356
297,0.0536,20,432,20,35922,640522,1641,124615,5.073200481561273,0.16286625793812087
298,0.0537,14,211,14,36133,640311,1655,124601,5.071529273856292,0.16289586253059177
299,0.0538,22,378,22,36511,639933,1677,124579,5.068535356735522,0.16295231467916788
300,0.0539,12,128,12,36639,639805,1689,124567,5.067521543530605,0.16296646135651227
301,0.054,9,131,9,36770,639674,1698,124558,5.066483969078697,0.16298453872646002
302,0.0541,20,329,20,37099,639345,1718,124538,5.063878152325434,0.16303282047119783
303,0.0542,21,237,21,37336,639108,1739,124517,5.062001013813205,0.16306040268456376
304,0.0543,12,323,12,37659,638785,1751,124505,5.059442719553922,0.16311624677383432
305,0.0544,15,233,15,37892,638552,1766,124490,5.057597262704347,0.1631496038225943
306,0.0545,14,300,14,38192,638252,1780,124476,5.055221138005322,0.16319841411355032
307,0.0546,15,347,15,38539,637905,1795,124461,5.052472753770118,0.16325623125900157
308,0.0547,8,196,8,38735,637709,1803,124453,5.050920352300088,0.1632894319055529
309,0.0548,20,311,20,39046,637398,1823,124433,5.048457103028767,0.16333412528500416
310,0.0549,35,562,35,39608,636836,1858,124398,5.044005829425928,0.16341624257455659
311,0.055,8,179,8,39787,636657,1866,124390,5.042588075022177,0.1634458844197533
312,0.0551,19,360,19,40147,636297,1885,124371,5.0397367253833485,0.16350234267775166
313,0.0552,12,189,12,40336,636108,1897,124359,5.038239766822963,0.16352977841247548
314,0.0553,9,329,9,40665,635779,1906,124350,5.0356339500697,0.16359065369167602
315,0.0554,17,270,17,40935,635509,1923,124333,5.033495437840578,0.1636300704620171
316,0.0555,14,318,14,41253,635191,1937,124319,5.030976745659612,0.1636831641453042
317,0.0556,15,225,15,41478,634966,1952,124304,5.029194652135344,0.16371514744425567
318,0.0557,7,155,7,41633,634811,1959,124297,5.027966987707515,0.1637408642775468
319,0.0558,10,231,10,41864,634580,1969,124287,5.026137371689266,0.1637796873496937
320,0.0559,9,273,9,42137,634307,1978,124278,5.023975098213154,0.16382870739600705
321,0.056,15,229,15,42366,634078,1993,124263,5.022161323026232,0.16386164008012227
322,0.0561,16,295,16,42661,633783,2009,124247,5.019824800405526,0.16390776090656042
323,0.0562,43,437,43,43098,633346,2052,124204,5.016363578760614,0.1639548544650518
324,0.0563,13,283,13,43381,633063,2065,124191,5.014122101127867,0.1640017748338074
325,0.0564,22,451,22,43832,632612,2087,124169,5.010549993663667,0.1640752080192288
326,0.0565,15,191,15,44023,632421,2102,124154,5.009037194271955,0.16410005617420612
327,0.0566,19,333,19,44356,632088,2121,124135,5.006399695856039,0.1641513151543923
328,0.0567,10,319,10,44675,631769,2131,124125,5.00387308325941,0.16420953202433144
329,0.0568,44,721,44,45396,631048,2175,124081,4.9981624635660875,0.16431761990335425
330,0.0569,36,351,36,45747,630697,2211,124045,4.995382397668229,0.16435417665904375
331,0.057,6,145,6,45892,630552,2217,124039,4.994233937397035,0.16437911398360172
332,0.0571,7,227,7,46119,630325,2224,124032,4.99243600304144,0.16442082462282448
333,0.0572,13,372,13,46491,629953,2237,124019,4.989489608414649,0.16448754065137697
334,0.0573,19,367,19,46858,629586,2256,124000,4.986582815866177,0.16454658127937621
335,0.0574,19,261,19,47119,629325,2275,123981,4.984515587378025,0.16458252025073475
336,0.0575,11,193,11,47312,629132,2286,123970,4.982986947154987,0.1646124960496719
337,0.0576,11,206,11,47518,628926,2297,123959,4.981355341528324,0.16464533096023962
338,0.0577,19,311,19,47829,628615,2316,123940,4.978892092257001,0.1646922816272565
339,0.0578,13,301,13,48130,628314,2329,123927,4.976508047142314,0.1647437456878846
340,0.0579,22,382,22,48512,627932,2351,123905,4.97348244835889,0.16480300916289037
341,0.058,9,218,9,48730,627714,2360,123896,4.971755797744265,0.16484080839797235
342,0.0581,16,218,16,48948,627496,2376,123880,4.970029147129641,0.1648708502800196
343,0.0582,41,717,41,49665,626779,2417,123839,4.964350209098973,0.16498272090464125
344,0.0583,15,206,15,49871,626573,2432,123824,4.96271860347231,0.16501132067425642
345,0.0584,13,228,13,50099,626345,2445,123811,4.960912748701052,0.16504700355659357
346,0.0585,26,408,26,50507,625937,2471,123785,4.957681219110379,0.165107866649238
347,0.0586,26,432,26,50939,625505,2497,123759,4.954259599543784,0.16517409084114545
348,0.0587,5,179,5,51118,625326,2502,123754,4.952841845140033,0.16520798846585144
349,0.0588,8,334,8,51452,624992,2510,123746,4.950196426308453,0.16527276564031745
350,0.0589,22,263,22,51715,624729,2532,123724,4.948113356988975,0.16530630513873282
351,0.059,28,378,28,52093,624351,2560,123696,4.945119439868204,0.16535859377819842
352,0.0591,11,191,11,52284,624160,2571,123685,4.943606640476492,0.16538854976632858
353,0.0592,11,218,11,52502,623942,2582,123674,4.941879989861868,0.16542449599794548
354,0.0593,27,362,27,52864,623580,2609,123647,4.939012799391712,0.1654744809810138
355,0.0594,18,270,18,53134,623310,2627,123629,4.93687428716259,0.16551418522797712
356,0.0595,11,214,11,53348,623096,2638,123618,4.935179318210619,0.16554932678374853
357,0.0596,16,285,16,53633,622811,2654,123602,4.932921999746546,0.16559465068266496
358,0.0597,19,259,19,53892,622552,2673,123583,4.9308706120897225,0.16563088449141242
359,0.0598,20,284,20,54176,622268,2693,123563,4.928621214041313,0.16567157975466293
360,0.0599,9,254,9,54430,622014,2702,123554,4.926609428462806,0.16571794926820893
361,0.06,26,513,26,54943,621501,2728,123528,4.922546255227474,0.16580294189890596
362,0.0601,15,266,15,55209,621235,2743,123513,4.920439424661006,0.16584535977270165
363,0.0602,27,384,27,55593,620851,2770,123486,4.9173979850462555,0.1659006605878789
364,0.0603,23,221,23,55814,620630,2793,123463,4.915647573184641,0.16592415195412402
365,0.0604,18,336,18,56150,620294,2811,123445,4.912986313521734,0.16597892540259418
366,0.0605,14,265,14,56415,620029,2825,123431,4.910887403370929,0.16602238183627901
367,0.0606,12,348,12,56763,619681,2837,123419,4.908131098720061,0.16608666397523886
368,0.0607,24,380,24,57143,619301,2861,123395,4.9051213407679635,0.16614469446449154
369,0.0608,34,270,34,57413,619031,2895,123361,4.902982828538842,0.16616693067813232
370,0.0609,21,304,21,57717,618727,2916,123340,4.900575022177164,0.16621140678671872
371,0.061,18,243,18,57960,618484,2934,123322,4.898650361170954,0.16624562217075622
372,0.0611,28,361,28,58321,618123,2962,123294,4.895791091116462,0.16629508090588696
373,0.0612,6,165,6,58486,617958,2968,123288,4.894484222531998,0.16632534947912028
374,0.0613,14,202,14,58688,617756,2982,123274,4.892884298567989,0.16635493839655616
375,0.0614,20,322,20,59010,617434,3002,123254,4.890333924724369,0.16640474801805888
376,0.0615,15,268,15,59278,617166,3017,123239,4.888211253326575,0.16644809259797003
377,0.0616,30,301,30,59579,616865,3047,123209,4.885827208211887,0.16648200044860378
378,0.0617,9,123,9,59702,616742,3056,123200,4.884852997085287,0.1664995364501542
379,0.0618,15,159,15,59861,616583,3071,123185,4.883593650994804,0.1665184219917596
380,0.0619,15,176,15,60037,616407,3086,123170,4.8821996578380435,0.16654114446501175
381,0.062,18,257,18,60294,616150,3104,123152,4.8801641110125455,0.166578745898158
382,0.0621,16,352,16,60646,615798,3120,123136,4.877376124699024,0.16664005175022398
383,0.0622,43,464,43,61110,615334,3163,123093,4.8737010518312,0.16669623402177872
384,0.0623,30,390,30,61500,614944,3193,123063,4.870612089722469,0.16675045087648221
385,0.0624,12,223,12,61723,614721,3205,123051,4.868845837029527,0.16678730014150714
386,0.0625,20,279,20,62002,614442,3225,123031,4.866636041059435,0.16682780250938
387,0.0626,33,401,33,62403,614041,3258,122998,4.863459954378405,0.16688126408507556
388,0.0627,11,161,11,62564,613880,3269,122987,4.862184767456596,0.16690528955700282
389,0.0628,28,545,28,63109,613335,3297,122959,4.8578681409200355,0.16699715059473524
390,0.0629,44,485,44,63594,612850,3341,122915,4.85402673932328,0.16705741643051789
391,0.063,24,245,24,63839,612605,3365,122891,4.852086237485743,0.167085884899442
392,0.0631,11,304,11,64143,612301,3376,122880,4.849678431124065,0.16714251320423135
393,0.0632,10,155,10,64298,612146,3386,122870,4.848450766696236,0.16716642903011636
394,0.0633,17,268,17,64566,611878,3403,122853,4.846328095298441,0.1672081346778617
395,0.0634,13,120,13,64686,611758,3416,122840,4.845377645418831,0.1672207111916994
396,0.0635,9,256,9,64942,611502,3425,122831,4.843350019008998,0.1672688003943715
397,0.0636,20,337,20,65279,611165,3445,122811,4.840680838930427,0.16732290974091796
398,0.0637,36,474,36,65753,610691,3481,122775,4.836926561905969,0.1673901721415853
399,0.0638,23,314,23,66067,610377,3504,122752,4.834439551387657,0.1674357445961079
400,0.0639,8,191,8,66258,610186,3512,122744,4.832926751995945,0.16747029047794468
401,0.064,23,287,23,66545,609899,3535,122721,4.8306535927005445,0.16750975949332533
402,0.0641,15,235,15,66780,609664,3550,122706,4.8287922950196425,0.16754645875718557
403,0.0642,23,399,23,67179,609265,3573,122683,4.825632049169941,0.1676116336133168
404,0.0643,13,205,13,67384,609060,3586,122670,4.82400836395894,0.1676438030421057
405,0.0644,10,236,10,67620,608824,3596,122660,4.822139145862375,0.16768651125656883
406,0.0645,18,329,18,67949,608495,3614,122642,4.819533329109111,0.16774147663160255
407,0.0646,37,497,37,68446,607998,3651,122605,4.815596882524395,0.1678134362985096
408,0.0647,31,525,31,68971,607473,3682,122574,4.811438664301103,0.16789877911970053
409,0.0648,28,342,28,69313,607131,3710,122546,4.808729882144215,0.1679455430279425
410,0.0649,29,374,29,69687,606757,3739,122517,4.805767646686098,0.1679985848940179
411,0.065,18,269,18,69956,606488,3757,122499,4.80363705487264,0.1680400336357164
412,0.0651,7,151,7,70107,606337,3764,122492,4.802441072107464,0.16806685793238194
413,0.0652,25,451,25,70558,605886,3789,122467,4.7988689646432645,0.16814237052637937
414,0.0653,22,275,22,70833,605611,3811,122445,4.796690850335826,0.1681807443383476
415,0.0654,26,271,26,71104,605340,3837,122419,4.79454441769104,0.16821365314616515
416,0.0655,32,336,32,71440,605004,3869,122387,4.791883158028133,0.1682547625692372
417,0.0656,11,179,11,71619,604825,3880,122376,4.790465403624382,0.16828359696975115
418,0.0657,32,539,32,72158,604286,3912,122344,4.786196299581802,0.16837179857699242
419,0.0658,13,157,13,72315,604129,3925,122331,4.784952794322646,0.16839330451779863
420,0.0659,28,411,28,72726,603718,3953,122303,4.781697503484983,0.16845655979647972
421,0.066,14,141,14,72867,603577,3967,122289,4.780580724876441,0.16847324437292835
422,0.0661,15,304,15,73171,603273,3982,122274,4.7781729185147634,0.1685266426571952
423,0.0662,17,151,17,73322,603122,3999,122257,4.776976935749588,0.16854223791976333
424,0.0663,27,340,27,73662,602782,4026,122230,4.774283994424027,0.16859031298792296
425,0.0664,37,389,37,74051,602393,4063,122193,4.77120295273096,0.16863836728835502
426,0.0665,14,204,14,74255,602189,4077,122179,4.769587187935623,0.16866979214984648
427,0.0666,21,314,21,74569,601875,4098,122158,4.767100177417311,0.1687188291141426
428,0.0667,24,281,24,74850,601594,4122,122134,4.764874540615891,0.16875677049941415
429,0.0668,20,248,20,75098,601346,4142,122114,4.762910277531365,0.16879164017361015
430,0.0669,27,302,27,75400,601044,4169,122087,4.760518312001014,0.1688310969934908
431,0.067,18,286,18,75686,600758,4187,122069,4.758253073121278,0.1688772002152659
432,0.0671,7,177,7,75863,600581,4194,122062,4.756851159548853,0.16891051321330172
433,0.0672,13,200,13,76063,600381,4207,122049,4.75526707641617,0.16894231967111
434,0.0673,9,152,9,76215,600229,4216,122040,4.754063173235331,0.16896751764231885
435,0.0674,13,174,13,76389,600055,4229,122027,4.752685020909897,0.16899327223223956
436,0.0675,7,195,7,76584,599860,4236,122020,4.751140539855531,0.16903086385548843
437,0.0676,45,512,45,77096,599348,4281,121975,4.747085287035864,0.16909900280456883
438,0.0677,12,135,12,77231,599213,4293,121963,4.746016030921303,0.16911683139760614
439,0.0678,19,248,19,77479,598965,4312,121944,4.744051767836776,0.16915311086420062
440,0.0679,27,327,27,77806,598638,4339,121917,4.74146179191484,0.16919874263588483
441,0.068,22,254,22,78060,598384,4361,121895,4.739450006336333,0.16923303331070322
442,0.0681,13,191,13,78251,598193,4374,121882,4.73793720694462,0.16926292400097212
443,0.0682,13,298,13,78549,597895,4387,121869,4.735576923076923,0.16931799867734423
444,0.0683,11,145,11,78694,597750,4398,121858,4.734428462805728,0.16933941812764727
445,0.0684,7,125,7,78819,597625,4405,121851,4.733438410847802,0.16936075699536884
446,0.0685,12,117,12,78936,597508,4417,121839,4.732511722215182,0.16937444654665967
447,0.0686,13,184,13,79120,597324,4430,121826,4.731054365733113,0.16940276715566988
448,0.0687,20,205,20,79325,597119,4450,121806,4.729430680522114,0.1694279653649546
449,0.0688,18,170,18,79495,596949,4468,121788,4.728084209859333,0.16944723869788253
450,0.0689,9,127,9,79622,596822,4477,121779,4.72707831707008,0.16946678337491877
451,0.069,12,239,12,79861,596583,4489,121767,4.725185337726524,0.16950929212779287
452,0.0691,11,204,11,80065,596379,4500,121756,4.723569572931187,0.16954472348513858
453,0.0692,23,384,23,80449,595995,4523,121733,4.720528133316437,0.16960882116902226
454,0.0693,11,195,11,80644,595800,4534,121722,4.718983652262071,0.16964218518735313
455,0.0694,21,288,21,80932,595512,4555,121701,4.716702572551007,0.16968599286404457
456,0.0695,9,115,9,81047,595397,4564,121692,4.715791724749715,0.16970278445213913
457,0.0696,18,106,18,81153,595291,4582,121674,4.714952160689393,0.16970702893446682
458,0.0697,21,193,21,81346,595098,4603,121653,4.713423520466354,0.1697283994023029
459,0.0698,13,217,13,81563,594881,4616,121640,4.711704790267393,0.16976473822818872
460,0.0699,15,195,15,81758,594686,4631,121625,4.710160309213028,0.16979356731922307
461,0.07,14,227,14,81985,594459,4645,121611,4.708362374857432,0.1698311617579287
462,0.0701,6,142,6,82127,594317,4651,121605,4.707237675833228,0.1698578895466266
463,0.0702,33,511,33,82638,593806,4684,121572,4.703190343429223,0.16994092633544783
464,0.0703,32,350,32,82988,593456,4716,121540,4.7004181979470285,0.16998696496204174
465,0.0704,25,324,25,83312,593132,4741,121515,4.697851983272082,0.17003499629887203
466,0.0705,15,208,15,83520,592924,4756,121500,4.696204536814092,0.17006707501427723
467,0.0706,13,244,13,83764,592680,4769,121487,4.694271955392219,0.17011007229401526
468,0.0707,13,195,13,83959,592485,4782,121474,4.692727474337853,0.1701414226867369
469,0.0708,38,381,38,84340,592104,4820,121436,4.689709795970092,0.17018807635171118
470,0.0709,12,222,12,84562,591882,4832,121424,4.687951463692815,0.17022708346768428
471,0.071,14,199,14,84761,591683,4846,121410,4.686375300975795,0.17025829730483963
472,0.0711,23,272,23,85033,591411,4869,121387,4.684220947915347,0.1702964935367383
473,0.0712,17,231,17,85264,591180,4886,121370,4.682391331897098,0.1703319065328749
474,0.0713,29,323,29,85587,590857,4915,121341,4.679833037637815,0.17037537314061538
475,0.0714,16,228,16,85815,590629,4931,121325,4.678027182866557,0.17041129061709043
476,0.0715,16,233,16,86048,590396,4947,121309,4.676181726016981,0.17044843017823397
477,0.0716,12,182,12,86230,590214,4959,121297,4.67474021036624,0.17047803899026157
478,0.0717,46,620,46,86850,589594,5005,121251,4.669829552654924,0.17057305038369827
479,0.0718,26,295,26,87145,589299,5031,121225,4.667493030034216,0.17061351903665464
480,0.0719,16,234,16,87379,589065,5047,121209,4.665639652768977,0.1706510445264785
481,0.072,30,299,30,87678,588766,5077,121179,4.663271448485617,0.17068787018712717
482,0.0721,21,260,21,87938,588506,5098,121158,4.661212140413129,0.17072586463453127
483,0.0722,18,206,18,88144,588300,5116,121140,4.659580534786466,0.17075439783491203
484,0.0723,17,205,17,88349,588095,5133,121123,4.6579568495754655,0.17078387745375892
485,0.0724,13,136,13,88485,587959,5146,121110,4.656879673045242,0.1708014311724247
486,0.0725,24,292,24,88777,587667,5170,121086,4.654566911671525,0.17084372129641778
487,0.0726,29,272,29,89049,587395,5199,121057,4.652412558611076,0.17087537334921774
488,0.0727,19,210,19,89259,587185,5218,121038,4.650749271321759,0.1709037972503011
489,0.0728,18,231,18,89490,586954,5236,121020,4.64891965530351,0.17093848079166749
490,0.0729,20,265,20,89755,586689,5256,121000,4.646820745152706,0.17097906001082397
491,0.073,14,199,14,89954,586490,5270,120986,4.645244582435686,0.17101074806777897
492,0.0731,20,238,20,90192,586252,5290,120966,4.643359523507794,0.17104485462756888
493,0.0732,31,304,31,90496,585948,5321,120935,4.640951717146116,0.17108206025608197
494,0.0733,39,427,39,90923,585521,5360,120896,4.637569699657838,0.17113970926520738
495,0.0734,13,289,13,91212,585232,5373,120883,4.635280699531111,0.17119449381474688
496,0.0735,38,417,38,91629,584815,5411,120845,4.631977886199468,0.17125102740696652
497,0.0736,20,213,20,91842,584602,5431,120825,4.630290837663161,0.17127923938267178
498,0.0737,14,224,14,92066,584378,5445,120811,4.628516664554556,0.17131719297947076
499,0.0738,19,350,19,92416,584028,5464,120792,4.625744519072361,0.17137992678981867
500,0.0739,28,257,28,92673,583771,5492,120764,4.623708972246863,0.17140951123790868
501,0.074,16,172,16,92845,583599,5508,120748,4.622346660752756,0.1714325467418758
502,0.0741,17,299,17,93144,583300,5525,120731,4.619978456469395,0.17148534652593422
503,0.0742,15,286,15,93430,583014,5540,120716,4.617713217589659,0.1715373793926648
504,0.0743,37,365,37,93795,582649,5577,120679,4.614822265872513,0.1715828176896128
505,0.0744,26,220,26,94015,582429,5603,120653,4.613079774426562,0.17160587243024283
506,0.0745,12,280,12,94295,582149,5615,120641,4.610862058040806,0.17166009761095063
507,0.0746,29,310,29,94605,581839,5644,120612,4.608406729185147,0.17170165605857204
508,0.0747,29,186,29,94791,581653,5673,120583,4.606933531871753,0.17171292841722727
509,0.0748,23,203,23,94994,581450,5696,120560,4.60532568749208,0.17173544536402616
510,0.0749,22,392,22,95386,581058,5718,120538,4.602220884552021,0.1718054264847576
511,0.075,18,270,18,95656,580788,5736,120520,4.600082372322899,0.1718503139847257
512,0.0751,12,243,12,95899,580545,5748,120508,4.59815771131669,0.17189570546021485
513,0.0752,29,250,29,96149,580295,5777,120479,4.596177607400836,0.1719227596914269
514,0.0753,12,201,12,96350,580094,5789,120467,4.59458560385249,0.17195790230972036
515,0.0754,32,391,32,96741,579703,5821,120435,4.591488721328095,0.1720160882568865
516,0.0755,20,522,20,97263,579181,5841,120415,4.587354264351793,0.1721207668425777
517,0.0756,24,230,24,97493,578951,5865,120391,4.585532568749208,0.17214896288225218
518,0.0757,27,237,27,97730,578714,5892,120364,4.583655430236979,0.17217535096226744
519,0.0758,40,544,40,98274,578170,5932,120324,4.579346724116082,0.1722620380418443
520,0.0759,15,295,15,98569,577875,5947,120309,4.577010201495375,0.17231703963425116
521,0.076,9,95,9,98664,577780,5956,120300,4.576257762007351,0.1723298189319276
522,0.0761,26,232,26,98896,577548,5982,120274,4.574420225573438,0.17235627423612326
523,0.0762,37,311,37,99207,577237,6019,120237,4.571956976302117,0.17238922167708043
524,0.0763,18,231,18,99438,577006,6037,120219,4.570127360283868,0.17242497041844454
525,0.0764,30,320,30,99758,576686,6067,120189,4.567592827271575,0.1724685201793722
526,0.0765,14,161,14,99919,576525,6081,120175,4.566317640349766,0.17249174680637291
527,0.0766,20,303,20,100222,576222,6101,120155,4.563917754403751,0.17254303344309188
528,0.0767,28,323,28,100545,575899,6129,120127,4.561359460144469,0.17258981704706433
529,0.0768,26,326,26,100871,575573,6155,120101,4.558777404638195,0.17263977092718716
530,0.0769,18,234,18,101105,575339,6173,120083,4.556924027372957,0.17267644681934136
531,0.077,13,231,13,101336,575108,6186,120070,4.555094411354708,0.17271835414814624
532,0.0771,21,301,21,101637,574807,6207,120049,4.55271036624002,0.17276817067133335
533,0.0772,35,366,35,102003,574441,6242,120014,4.54981149410721,0.17281753317349577
534,0.0773,27,292,27,102295,574149,6269,119987,4.5474987327334935,0.17285805663443474
535,0.0774,27,366,27,102661,573783,6296,119960,4.544599860600684,0.1729170600640295
536,0.0775,15,248,15,102909,573535,6311,119945,4.542635597516158,0.17296100824825517
537,0.0776,35,418,35,103327,573117,6346,119910,4.539324863768851,0.1730235618525685
538,0.0777,16,160,16,103487,572957,6362,119894,4.538057597262704,0.17304442080620508
539,0.0778,20,291,20,103778,572666,6382,119874,4.5357527563046505,0.17309325093135414
540,0.0779,20,267,20,104045,572399,6402,119854,4.533638005322519,0.1731361221980981
541,0.078,30,381,30,104426,572018,6432,119824,4.530620326954758,0.17319561402748027
542,0.0781,26,351,26,104777,571667,6458,119798,4.5278402610569,0.17325244227835104
543,0.0782,19,271,19,105048,571396,6477,119779,4.525693828412115,0.17329764531413897
544,0.0783,21,314,21,105362,571082,6498,119758,4.523206817893803,0.17335128249667073
545,0.0784,39,481,39,105843,570601,6537,119719,4.519397097959701,0.17342536794530072
546,0.0785,20,214,20,106057,570387,6557,119699,4.517702129007731,0.1734551925412195
547,0.0786,11,194,11,106251,570193,6568,119688,4.516165568369028,0.1734907904406702
548,0.0787,23,246,23,106497,569947,6591,119665,4.514217146115828,0.17352511267205328
549,0.0788,37,331,37,106828,569616,6628,119628,4.511595488531238,0.17356407890384248
550,0.0789,17,208,17,107036,569408,6645,119611,4.509948042073248,0.17359608370741592
551,0.079,28,352,28,107388,569056,6673,119583,4.5071600557597264,0.17365121638478215
552,0.0791,35,345,35,107733,568711,6708,119548,4.504427512355848,0.17369623935175565
553,0.0792,23,199,23,107932,568512,6731,119525,4.502851349638829,0.17371885523598296
554,0.0793,29,272,29,108204,568240,6760,119496,4.50069699657838,0.1737527190666186
555,0.0794,9,132,9,108336,568108,6769,119487,4.49965150171081,0.17377526014587075
556,0.0795,17,348,17,108684,567760,6786,119470,4.496895197059942,0.17384281827044804
557,0.0796,27,267,27,108951,567493,6813,119443,4.49478044607781,0.17387791584659998
558,0.0797,24,267,24,109218,567226,6837,119419,4.4926656950956785,0.1739166527099156
559,0.0798,27,274,27,109492,566952,6864,119392,4.490495501203903,0.17395358595689625
560,0.0799,28,296,28,109788,566656,6892,119364,4.488151058167532,0.17399492726159588
561,0.08,35,340,35,110128,566316,6927,119329,4.485458116841972,0.1740390435283565
562,0.0801,28,417,28,110545,565899,6955,119301,4.4821553035103285,0.17411120840630473
563,0.0802,32,425,32,110970,565474,6987,119269,4.4787891268533775,0.17418067800620088
564,0.0803,35,314,35,111284,565160,7022,119234,4.476302116335066,0.1742183595998796
565,0.0804,35,448,35,111732,564712,7057,119199,4.472753770117856,0.17429022197332694
566,0.0805,40,333,40,112065,564379,7097,119159,4.470116271701939,0.1743268113842976
567,0.0806,27,388,27,112453,563991,7124,119132,4.4670431504245345,0.17439319127009337
568,0.0807,14,231,14,112684,563760,7138,119118,4.465213534406286,0.17443525783522093
569,0.0808,34,490,34,113174,563270,7172,119084,4.461332530731212,0.17451938436647255
570,0.0809,46,496,46,113670,562774,7218,119038,4.457404004562159,0.17459064962188992
571,0.081,33,258,33,113928,562516,7251,119005,4.455360537320999,0.17461677629889616
572,0.0811,20,371,20,114299,562145,7271,118985,4.452422063109872,0.17468765140281592
573,0.0812,26,365,26,114664,561780,7297,118959,4.449531111392726,0.1747497939739019
574,0.0813,15,196,15,114860,561584,7312,118944,4.447978709922697,0.17478193402769615
575,0.0814,15,234,15,115094,561350,7327,118929,4.4461253326574575,0.17482385903430797
576,0.0815,32,281,32,115375,561069,7359,118897,4.443899695856039,0.17485727227537848
577,0.0816,36,337,36,115712,560732,7395,118861,4.441230515777468,0.174900271191728
578,0.0817,36,361,36,116073,560371,7431,118825,4.438371245722975,0.17494949911365792
579,0.0818,18,269,18,116342,560102,7449,118807,4.436240653909517,0.17499694362572893
580,0.0819,26,259,26,116601,559843,7475,118781,4.434189266252693,0.17503212382703826
581,0.082,35,351,35,116952,559492,7510,118746,4.431409200354834,0.1750801341122143
582,0.0821,22,327,22,117279,559165,7532,118724,4.428819224432898,0.17513781754830068
583,0.0822,28,242,28,117521,558923,7560,118696,4.426902483842352,0.17516628075659035
584,0.0823,21,220,21,117741,558703,7581,118675,4.425159992396401,0.17519760015825728
585,0.0824,28,386,28,118127,558317,7609,118647,4.422102711950323,0.17526338180464546
586,0.0825,27,300,27,118427,558017,7636,118620,4.419726587251299,0.17530817853590624
587,0.0826,23,250,23,118677,557767,7659,118597,4.417746483335446,0.17534493261025128
588,0.0827,29,286,29,118963,557481,7688,118568,4.415481244455709,0.17538373697764512
589,0.0828,13,181,13,119144,557300,7701,118555,4.414047649220631,0.17541484490016349
590,0.0829,22,375,22,119519,556925,7723,118533,4.411077493346851,0.17548537436820646
591,0.083,31,326,31,119845,556599,7754,118502,4.408495437840578,0.17553225369241046
592,0.0831,28,378,28,120223,556221,7782,118474,4.405501520719807,0.17559638058678365
593,0.0832,40,394,40,120617,555827,7822,118434,4.402380876948422,0.1756500820898732
594,0.0833,25,265,25,120882,555562,7847,118409,4.400281966797618,0.17568856820248943
595,0.0834,19,268,19,121150,555294,7866,118390,4.3981592953998225,0.1757352111672535
596,0.0835,47,394,47,121544,554900,7913,118343,4.395038651628438,0.1757805131282464
597,0.0836,28,254,28,121798,554646,7941,118315,4.39302686604993,0.17581256566130876
598,0.0837,44,403,44,122201,554243,7985,118271,4.389834938537574,0.17586399688333626
599,0.0838,29,419,29,122620,553824,8014,118242,4.386516284374604,0.17593807751024454
600,0.0839,19,261,19,122881,553563,8033,118223,4.384449055886453,0.17598312557868132
601,0.084,45,389,45,123270,553174,8078,118178,4.381368014193385,0.1760298621289577
602,0.0841,22,368,22,123638,552806,8100,118156,4.378453301229248,0.17609939161979368
603,0.0842,38,362,38,124000,552444,8138,118118,4.375586110759093,0.1761477685881395
604,0.0843,20,228,20,124228,552216,8158,118098,4.3737802559878345,0.17618310224760336
605,0.0844,19,177,19,124405,552039,8177,118079,4.37237834241541,0.1762062800879845
606,0.0845,30,283,30,124688,551756,8207,118049,4.370136864782664,0.1762438321601063
607,0.0846,25,193,25,124881,551563,8232,118024,4.368608224559625,0.1762638760907843
608,0.0847,28,226,28,125107,551337,8260,117996,4.3668182106196936,0.17628893241480698
609,0.0848,14,291,14,125398,551046,8274,117982,4.36451336966164,0.17634837405908274
610,0.0849,26,282,26,125680,550764,8300,117956,4.362279812444557,0.17639071659289388
611,0.085,30,340,30,126020,550424,8330,117926,4.359586871118997,0.17644348021246353
612,0.0851,40,464,40,126484,549960,8370,117886,4.355911798251173,0.17651674188360789
613,0.0852,19,234,19,126718,549726,8389,117867,4.354058420985933,0.17655517658213912
614,0.0853,22,179,22,126897,549547,8411,117845,4.352640666582182,0.1765753859800537
615,0.0854,25,290,25,127187,549257,8436,117820,4.350343746039792,0.1766212895962535
616,0.0855,58,542,58,127729,548715,8494,117762,4.346050880750222,0.17669326923509737
617,0.0856,27,314,27,128043,548401,8521,117735,4.34356387023191,0.17674318757731153
618,0.0857,24,264,24,128307,548137,8545,117711,4.341472880496768,0.17678359024882556
619,0.0858,27,339,27,128646,547798,8572,117684,4.338787859586871,0.17684024511557037
620,0.0859,20,312,20,128958,547486,8592,117664,4.336316689899886,0.17689844396000903
621,0.086,36,263,36,129221,547223,8628,117628,4.334233620580408,0.1769238521112249
622,0.0861,21,262,21,129483,546961,8649,117607,4.3321584716765935,0.1769675939858675
623,0.0862,35,290,35,129773,546671,8684,117572,4.329861551134203,0.177001488912943
624,0.0863,26,276,26,130049,546395,8710,117546,4.327675516411102,0.17704283964990866
625,0.0864,19,181,19,130230,546214,8729,117527,4.326241921176023,0.1770675609914108
626,0.0865,10,293,10,130523,545921,8739,117517,4.323921239386643,0.17713335684721104
627,0.0866,31,365,31,130888,545556,8770,117486,4.321030287669497,0.17719239505189716
628,0.0867,43,411,43,131299,545145,8813,117443,4.317774996831834,0.17724890882418637
629,0.0868,49,349,49,131648,544796,8862,117394,4.315010771765302,0.17728144490252043
630,0.0869,34,358,34,132006,544438,8896,117360,4.3121752629578,0.17733507807518306
631,0.087,24,224,24,132230,544214,8920,117336,4.310401089849195,0.17736527851258407
632,0.0871,56,549,56,132779,543665,8976,117280,4.306052781649981,0.1774429037211871
633,0.0872,24,204,24,132983,543461,9000,117256,4.304437016854645,0.17746781148358526
634,0.0873,37,315,37,133298,543146,9037,117219,4.301942085920669,0.17750637904795075
635,0.0874,28,287,28,133585,542859,9065,117191,4.2996689266252694,0.17754867055526097
636,0.0875,36,357,36,133942,542502,9101,117155,4.29684133823343,0.17759987387384657
637,0.0876,34,332,34,134274,542170,9135,117121,4.294211760233177,0.17764689643875012
638,0.0877,38,332,38,134606,541838,9173,117083,4.291582182232924,0.17768897940724304
639,0.0878,30,272,30,134878,541566,9203,117053,4.289427829172475,0.17772490620525674
640,0.0879,30,320,30,135198,541246,9233,117023,4.286893296160183,0.1777738280247133
641,0.088,28,262,28,135460,540984,9261,116995,4.2848181472563684,0.1778096261430836
642,0.0881,49,389,49,135849,540595,9310,116946,4.2817371055633,0.1778535482958477
643,0.0882,25,316,25,136165,540279,9335,116921,4.279234254213661,0.177907790626902
644,0.0883,35,292,35,136457,539987,9370,116886,4.276921492839945,0.177943072709641
645,0.0884,26,253,26,136710,539734,9396,116860,4.274917627677101,0.17797908601053314
646,0.0885,54,462,54,137172,539272,9450,116806,4.271258395640603,0.17803675782452696
647,0.0886,26,264,26,137436,539008,9476,116780,4.269167405905462,0.1780758415829506
648,0.0887,32,253,32,137689,538755,9508,116748,4.267163540742618,0.17810444803456277
649,0.0888,33,372,33,138061,538383,9541,116715,4.264217146115828,0.17816418306879275
650,0.0889,52,393,52,138454,537990,9593,116663,4.2611044227601065,0.17820585867627584
651,0.089,47,454,47,138908,537536,9640,116616,4.257508554048917,0.17827049370788442
652,0.0891,28,294,28,139202,537242,9668,116588,4.255179951843873,0.17831546426441125
653,0.0892,27,445,27,139647,536797,9695,116561,4.251655366873654,0.1784029582556577
654,0.0893,30,268,30,139915,536529,9725,116531,4.2495326954758585,0.17843842832205312
655,0.0894,46,494,46,140409,536035,9771,116485,4.245620010138132,0.1785156010543738
656,0.0895,41,263,41,140672,535772,9812,116444,4.243536940818654,0.17853594514700652
657,0.0896,38,266,38,140938,535506,9850,116406,4.241430110252186,0.1785609100614807
658,0.0897,43,385,43,141323,535121,9893,116363,4.238380750221772,0.1786122145747248
659,0.0898,20,217,20,141540,534904,9913,116343,4.236662020022811,0.17864650432170898
660,0.0899,40,367,40,141907,534537,9953,116303,4.2337552274743375,0.17869676110872104
661,0.09,23,207,23,142114,534330,9976,116280,4.232115701432011,0.17872458154654863
662,0.0901,28,371,28,142485,533959,10004,116252,4.229177227220885,0.1787911923975448
663,0.0902,27,264,27,142749,533695,10031,116225,4.227086237485743,0.17882970211718366
664,0.0903,44,381,44,143130,533314,10075,116181,4.224068559117982,0.17887897520381218
665,0.0904,45,378,45,143508,532936,10120,116136,4.221074641997212,0.17892622081987822
666,0.0905,41,434,41,143942,532502,10161,116095,4.21763718159929,0.17899404406742553
667,0.0906,41,354,41,144296,532148,10202,116054,4.214833354454441,0.17903986720189077
668,0.0907,35,229,35,144525,531919,10237,116019,4.21301957926752,0.17905879883569106
669,0.0908,32,373,32,144898,531546,10269,115987,4.210065264225067,0.17912137296477554
670,0.0909,32,209,32,145107,531337,10301,115955,4.208409897351413,0.17913862677122536
671,0.091,19,200,19,145307,531137,10320,115936,4.20682581421873,0.17916989273235015
672,0.0911,35,334,35,145641,530803,10355,115901,4.20418039538715,0.17921800390905268
673,0.0912,25,311,25,145952,530492,10380,115876,4.201717146115828,0.1792724887370662
674,0.0913,34,372,34,146324,530120,10414,115842,4.198770751489038,0.1793325303965249
675,0.0914,30,301,30,146625,529819,10444,115812,4.1963867063743505,0.17937800384430116
676,0.0915,26,217,26,146842,529602,10470,115786,4.194667976175389,0.17940525699269277
677,0.0916,41,396,41,147238,529206,10511,115745,4.191531491572678,0.17946324604504837
678,0.0917,22,311,22,147549,528895,10533,115723,4.189068242301356,0.17952182532910965
679,0.0918,29,296,29,147845,528599,10562,115694,4.1867237992649855,0.1795673707459184
680,0.0919,20,247,20,148092,528352,10582,115674,4.184767456596123,0.17961076105623064
681,0.092,47,359,47,148451,527993,10629,115627,4.181924027372957,0.1796510363257823
682,0.0921,39,296,39,148747,527697,10668,115588,4.179579584336586,0.17968396589381067
683,0.0922,37,394,37,149141,527303,10705,115551,4.176458940565201,0.1797468787625184
684,0.0923,31,292,31,149433,527011,10736,115520,4.174146179191484,0.1797889907257393
685,0.0924,23,335,23,149768,526676,10759,115497,4.17149283994424,0.1798534039892677
686,0.0925,50,520,50,150288,526156,10809,115447,4.167374223799265,0.17993525591370366
687,0.0926,23,256,23,150544,525900,10832,115424,4.165346597389431,0.17997767119272007
688,0.0927,44,289,44,150833,525611,10876,115380,4.163057597262704,0.18000252733657726
689,0.0928,33,268,33,151101,525343,10909,115347,4.160934925864909,0.18003558663316113
690,0.0929,67,508,67,151609,524835,10976,115280,4.156911354707895,0.1800926396038212
691,0.093,45,324,45,151933,524511,11021,115235,4.154345140032949,0.18012617507573317
692,0.0931,37,348,37,152281,524163,11058,115198,4.151588835382081,0.18017677024404052
693,0.0932,50,387,50,152668,523776,11108,115148,4.148523634520339,0.18022174781351147
694,0.0933,56,391,56,153059,523385,11164,115092,4.145426751995945,0.1802602129755653
695,0.0934,42,280,42,153339,523105,11206,115050,4.143209035610189,0.18028535387170827
696,0.0935,32,311,32,153650,522794,11238,115018,4.140745786338867,0.1803321354882003
697,0.0936,27,250,27,153900,522544,11265,114991,4.1387656824230135,0.1803681366513211
698,0.0937,49,459,49,154359,522085,11314,114942,4.1351302116335065,0.18043505220343878
699,0.0938,38,276,38,154635,521809,11352,114904,4.132944176910404,0.1804643536412795
700,0.0939,34,265,34,154900,521544,11386,114870,4.130845266759599,0.18049571505340864
701,0.094,29,327,29,155227,521217,11415,114841,4.1282552908376635,0.18055114470692923
702,0.0941,38,370,38,155597,520847,11453,114803,4.1253247370422,0.18060725241878392
703,0.0942,35,365,35,155962,520482,11488,114768,4.122433785325054,0.1806658795749705
704,0.0943,43,284,43,156246,520198,11531,114725,4.120184387276645,0.18069120192527283
705,0.0944,32,259,32,156505,519939,11563,114693,4.11813299961982,0.1807236319630904
706,0.0945,22,272,22,156777,519667,11585,114671,4.1159786465593715,0.18077271107832102
707,0.0946,51,508,51,157285,519159,11636,114620,4.111955075402357,0.18085168489331455
708,0.0947,36,242,36,157527,518917,11672,114584,4.110038334811811,0.18087422119302102
709,0.0948,45,407,45,157934,518510,11717,114539,4.106814725636801,0.18093228170331208
710,0.0949,27,304,27,158238,518206,11744,114512,4.104406919275124,0.1809842615509595
711,0.095,41,276,41,158514,517930,11785,114471,4.102220884552021,0.18101015020532857
712,0.0951,29,272,29,158786,517658,11814,114442,4.1000665314915725,0.18105046669830724
713,0.0952,53,440,53,159226,517218,11867,114389,4.09658154859967,0.18110787245866497
714,0.0953,39,389,39,159615,516829,11906,114350,4.093500506906603,0.18116889186744173
715,0.0954,41,344,41,159959,516485,11947,114309,4.090775883918388,0.18121446938303154
716,0.0955,22,320,22,160279,516165,11969,114287,4.088241350906095,0.1812778768248812
717,0.0956,29,334,29,160613,515831,11998,114258,4.085595932074515,0.1813362874133654
718,0.0957,25,318,25,160931,515513,12023,114233,4.08307723989355,0.18139535622298514
719,0.0958,41,420,41,161351,515093,12064,114192,4.079750665314916,0.18146308906139508
720,0.0959,35,332,35,161683,514761,12099,114157,4.077121087314662,0.18151332924164995
721,0.096,33,297,33,161980,514464,12132,114124,4.074768723862628,0.181556122611313
722,0.0961,39,396,39,162376,514068,12171,114085,4.071632239259916,0.18161976461148796
723,0.0962,31,360,31,162736,513708,12202,114054,4.068780889621087,0.18168350425798313
724,0.0963,49,432,49,163168,513276,12251,114005,4.0653592700544925,0.1817447045263606
725,0.0964,33,307,33,163475,512969,12284,113972,4.062927702445824,0.18179063101631573
726,0.0965,63,537,63,164012,512432,12347,113909,4.058674439234571,0.18186419218923877
727,0.0966,19,209,19,164221,512223,12366,113890,4.057019072360918,0.18190007235115707
728,0.0967,31,203,31,164424,512020,12397,113859,4.055411227981245,0.1819185497516293
729,0.0968,39,376,39,164800,511644,12436,113820,4.052433151691801,0.18197690034918076
730,0.0969,39,369,39,165169,511275,12475,113781,4.049510518312001,0.18203328981723238
731,0.097,38,337,38,165506,510938,12513,113743,4.04684133823343,0.18208173451729762
732,0.0971,40,336,40,165842,510602,12553,113703,4.044180078570523,0.18212732558605169
733,0.0972,46,422,46,166264,510180,12599,113657,4.040837663160563,0.18219021956055828
734,0.0973,32,271,32,166535,509909,12631,113625,4.038691230515777,0.1822274326660615
735,0.0974,48,385,48,166920,509524,12679,113577,4.035641870485363,0.182277030529561
736,0.0975,54,440,54,167360,509084,12733,113523,4.032156887593461,0.18233492395684597
737,0.0976,58,446,58,167806,508638,12791,113465,4.028624382207578,0.18238941139971998
738,0.0977,33,267,33,168073,508371,12824,113432,4.026509631225447,0.18242433696846108
739,0.0978,57,496,57,168569,507875,12881,113375,4.0225811050563935,0.18249496981891347
740,0.0979,40,297,40,168866,507578,12921,113335,4.02022874160436,0.18252959754426143
741,0.098,23,306,23,169172,507272,12944,113312,4.017805094411354,0.18258930297912934
742,0.0981,31,264,31,169436,507008,12975,113281,4.0157141046762135,0.1826261629659723
743,0.0982,32,341,32,169777,506667,13007,113249,4.013013242934989,0.18268442821285463
744,0.0983,41,335,41,170112,506332,13048,113208,4.010359903687745,0.1827291216063531
745,0.0984,34,302,34,170414,506030,13082,113174,4.007967938157394,0.18277336709711178
746,0.0985,34,361,34,170775,505669,13116,113140,4.005108668102902,0.182835091280185
747,0.0986,39,432,39,171207,505237,13155,113101,4.001687048536307,0.1829112880010609
748,0.0987,42,321,42,171528,504916,13197,113059,3.9991445951083513,0.18295076661677254
749,0.0988,55,455,55,171983,504461,13252,113004,3.995540805981498,0.1830128023450722
750,0.0989,35,276,35,172259,504185,13287,112969,3.9933547712583954,0.18304831533134355
751,0.099,28,297,28,172556,503888,13315,112941,3.9910024078063615,0.1830993678961268
752,0.0991,25,227,25,172783,503661,13340,112916,3.9892044734507666,0.18313365565047027
753,0.0992,39,315,39,173098,503346,13379,112877,3.9867095425167913,0.183175571181212
754,0.0993,38,342,38,173440,503004,13417,112839,3.9840007603599035,0.1832268938674305
755,0.0994,39,265,39,173705,502739,13456,112800,3.981901850209099,0.18325402614619057
756,0.0995,63,486,63,174191,502253,13519,112737,3.9780525281966796,0.183315175856518
757,0.0996,47,380,47,174571,501873,13566,112690,3.9750427702445825,0.18336606661969562
758,0.0997,42,295,42,174866,501578,13608,112648,3.9727062476238753,0.18339829313640257
759,0.0998,53,505,53,175371,501073,13661,112595,3.968706437713851,0.18347868880241433
760,0.0999,69,539,69,175910,500534,13730,112526,3.9644373336712713,0.18354810295892734
761,0.1,43,437,43,176347,500097,13773,112483,3.9609761120263594,0.1836217310392112
762,0.1001,37,360,37,176707,499737,13810,112446,3.95812476238753,0.18368037008541563
763,0.1002,43,348,43,177055,499389,13853,112403,3.955368457736662,0.1837274760049167
764,0.1003,34,253,34,177308,499136,13887,112369,3.953364592573818,0.18375810500322973
765,0.1004,42,346,42,177654,498790,13929,112327,3.950624128754277,0.18380604695991112
766,0.1005,29,325,29,177979,498465,13958,112298,3.9480499936636675,0.18386509988326077
767,0.1006,33,358,33,178337,498107,13991,112265,3.9452144848561654,0.18392881718034249
768,0.1007,45,306,45,178643,497801,14036,112220,3.9427908376631606,0.18396088003527747
769,0.1008,36,351,36,178994,497450,14072,112184,3.9400107717653023,0.1840186078860431
770,0.1009,45,347,45,179341,497103,14117,112139,3.9372623875300974,0.1840631473207691
771,0.101,35,380,35,179721,496723,14152,112104,3.9342526295780003,0.18413112427668288
772,0.1011,40,345,40,180066,496378,14192,112064,3.9315200861741224,0.1841818940835774
773,0.1012,66,592,66,180658,495786,14258,111998,3.926831200101381,0.18427270214418282
774,0.1013,56,458,56,181116,495328,14314,111942,3.9232036497275375,0.184336456600853
775,0.1014,36,311,36,181427,495017,14350,111906,3.920740400456216,0.18438253287484574
776,0.1015,64,448,64,181875,494569,14414,111842,3.9171920542390066,0.184432670251694
777,0.1016,30,313,30,182188,494256,14444,111812,3.914712964136358,0.1844875492518991
778,0.1017,46,397,46,182585,493859,14490,111766,3.9115685591179825,0.18454654282765737
779,0.1018,30,253,30,182838,493606,14520,111736,3.9095646939551387,0.18458326037182288
780,0.1019,42,323,42,183161,493283,14562,111694,3.907006399695856,0.18462520062746188
781,0.102,37,367,37,183528,492916,14599,111657,3.904099607147383,0.1846873743948208
782,0.1021,54,482,54,184010,492434,14653,111603,3.9002819667976176,0.18476186061449879
783,0.1022,39,362,39,184372,492072,14692,111564,3.897414776327462,0.18481999085541617
784,0.1023,38,414,38,184786,491658,14730,111526,3.8941357242428083,0.18489548794397728
785,0.1024,45,370,45,185156,491288,14775,111481,3.891205170447345,0.18494813104190827
786,0.1025,95,645,95,185801,490643,14870,111386,3.886096502344443,0.18501766526197244
787,0.1026,38,345,38,186146,490298,14908,111348,3.8833639589405653,0.1850722850313972
788,0.1027,37,352,37,186498,489946,14945,111311,3.8805759726270437,0.18513048496732679
789,0.1028,33,315,33,186813,489631,14978,111278,3.878081041693068,0.18518278141948283
790,0.1029,47,351,47,187164,489280,15025,111231,3.8753009757952097,0.18522724812701183
791,0.103,37,311,37,187475,488969,15062,111194,3.872837726523888,0.18527300083477322
792,0.1031,54,423,54,187898,488546,15116,111140,3.869487390698264,0.18533032286896808
793,0.1032,67,406,67,188304,488140,15183,111073,3.866271701938918,0.18536480350059162
794,0.1033,60,400,60,188704,487740,15243,111013,3.8631035356735524,0.18540700422377843
795,0.1034,29,241,29,188945,487499,15272,110984,3.8611947154986694,0.1854421930113303
796,0.1035,32,434,32,189379,487065,15304,110952,3.8577572551007475,0.18553318718364192
797,0.1036,46,316,46,189695,486749,15350,110906,3.855254403751109,0.18556859726765443
798,0.1037,34,327,34,190022,486422,15384,110872,3.8526644278291724,0.18562383014060077
799,0.1038,39,383,39,190405,486039,15423,110833,3.849630908630085,0.18568972912115161
800,0.1039,54,432,54,190837,485607,15477,110779,3.84620928906349,0.18575050386830005
801,0.104,43,301,43,191138,485306,15520,110736,3.8438252439488023,0.18578556544673028
802,0.1041,41,347,41,191485,484959,15561,110695,3.841076859713598,0.18583775144630943
803,0.1042,31,259,31,191744,484700,15592,110664,3.8390254720567736,0.18587620346544298
804,0.1043,48,374,48,192118,484326,15640,110616,3.836063236598657,0.18592736770979357
805,0.1044,49,354,49,192472,483972,15689,110567,3.833259409453808,0.1859709791956457
806,0.1045,42,333,42,192805,483639,15731,110525,3.830621911037891,0.18601766515642146
807,0.1046,44,395,44,193200,483244,15775,110481,3.8274933468508427,0.18608109815150112
808,0.1047,37,298,37,193498,482946,15812,110444,3.8251330629831455,0.18612379716543925
809,0.1048,58,476,58,193974,482470,15870,110386,3.82136294512736,0.1861936119394929
810,0.1049,55,407,55,194381,482063,15925,110331,3.8181393359523508,0.18624597818343872
811,0.105,43,319,43,194700,481744,15968,110288,3.8156127233557218,0.18628722771742068
812,0.1051,45,392,45,195092,481352,16013,110243,3.8125079204156633,0.18634876900582323
813,0.1052,59,465,59,195557,480887,16072,110184,3.808824927132176,0.18641415329122898
814,0.1053,45,342,45,195899,480545,16117,110139,3.8061161449752885,0.18646010387957013
815,0.1054,30,246,30,196145,480299,16147,110109,3.8041677227220885,0.18649645668757875
816,0.1055,23,297,23,196442,480002,16170,110086,3.8018153592700545,0.18655861498623935
817,0.1056,21,278,21,196720,479724,16191,110065,3.7996134837156252,0.18661758696754263
818,0.1057,59,299,59,197019,479425,16250,110006,3.7972452794322646,0.18663083550067777
819,0.1058,63,456,63,197475,478969,16313,109943,3.7936335698897476,0.18668833374086452
820,0.1059,54,394,54,197869,478575,16367,109889,3.7905129261183625,0.18673869599499715
821,0.106,44,340,44,198209,478235,16411,109845,3.787819984792802,0.1867858114542239
822,0.1061,44,343,44,198552,477892,16455,109801,3.785103282220251,0.18683394221132463
823,0.1062,30,289,30,198841,477603,16485,109771,3.782814282093524,0.18688433604483684
824,0.1063,29,288,29,199129,477315,16514,109742,3.780533202382461,0.18693585120354583
825,0.1064,41,311,41,199440,477004,16555,109701,3.7780699531111392,0.1869781235885155
826,0.1065,42,445,42,199885,476559,16597,109659,3.7745453681409202,0.1870618097704267
827,0.1066,40,332,40,200217,476227,16637,109619,3.7719157901406666,0.18711231279209894
828,0.1067,40,287,40,200504,475940,16677,109579,3.769642630845267,0.18714849560816985
829,0.1068,47,399,47,200903,475541,16724,109532,3.7664823849955646,0.18721082668316602
830,0.1069,51,387,51,201290,475154,16775,109481,3.7634171841338233,0.18726384838403448
831,0.107,60,553,60,201843,474601,16835,109421,3.7590371942719556,0.18735766803305354
832,0.1071,62,585,62,202428,474016,16897,109359,3.754403751108858,0.18745918148703664
833,0.1072,49,422,49,202850,473594,16946,109310,3.7510613356988975,0.1875265909995471
834,0.1073,88,649,88,203499,472945,17034,109222,3.745920985933342,0.18761283274386903
835,0.1074,46,381,46,203880,472564,17080,109176,3.742903307565581,0.18767146835356002
836,0.1075,52,346,52,204226,472218,17132,109124,3.74016284374604,0.18771050431587602
837,0.1076,40,290,40,204516,471928,17172,109084,3.7378659232036497,0.187748273701748
838,0.1077,50,421,50,204937,471507,17222,109034,3.7345314282093525,0.1878144696067978
839,0.1078,39,400,39,205337,471107,17261,108995,3.731363261943987,0.18788937117955118
840,0.1079,51,401,51,205738,470706,17312,108944,3.7281871752629576,0.18794789959458294
841,0.108,65,484,65,206222,470222,17377,108879,3.7243536940818656,0.18801383523772192
842,0.1081,56,383,56,206605,469839,17433,108823,3.721320174882778,0.1880596963339566
843,0.1082,49,367,49,206972,469472,17482,108774,3.718413382334305,0.1881102506545657
844,0.1083,55,442,55,207414,469030,17537,108719,3.714912558611076,0.18817687265577265
845,0.1084,46,497,46,207911,468533,17583,108673,3.7109761120263594,0.18827420366385658
846,0.1085,46,383,46,208294,468150,17629,108627,3.707942592827272,0.18833448629192912
847,0.1086,60,437,60,208731,467713,17689,108567,3.7044813711823594,0.18839279516901505
848,0.1087,27,378,27,209109,467335,17716,108540,3.701487454061589,0.18847840243108313
849,0.1088,63,431,63,209540,466904,17779,108477,3.698073754910658,0.1885307300727692
850,0.1089,61,412,61,209952,466492,17840,108416,3.694810543657331,0.18857973797546737
851,0.109,70,526,70,210478,465966,17910,108346,3.6906444050183755,0.18865355416567997
852,0.1091,62,355,62,210833,465611,17972,108284,3.6878326574578635,0.18868259873321774
853,0.1092,70,619,70,211452,464992,18042,108214,3.68292992016221,0.18878727717434918
854,0.1093,52,357,52,211809,464635,18094,108162,3.6801023317703714,0.18883129625329742
855,0.1094,106,683,106,212492,463952,18200,108056,3.6746926878722594,0.1889064488608551
856,0.1095,60,407,60,212899,463545,18260,107996,3.67146907869725,0.1889558229418362
857,0.1096,51,312,51,213211,463233,18311,107945,3.668997909010265,0.18898662063314764
858,0.1097,42,339,42,213550,462894,18353,107903,3.6663128881003675,0.18903918555984
859,0.1098,62,484,62,214034,462410,18415,107841,3.662479406919275,0.18911146144417107
860,0.1099,48,347,48,214381,462063,18463,107793,3.6597310226840705,0.1891583136792453
861,0.11,54,521,54,214902,461542,18517,107739,3.6556044861234316,0.189254515783945
862,0.1101,48,304,48,215206,461238,18565,107691,3.653196679761754,0.189287239708294
863,0.1102,56,379,56,215585,460859,18621,107635,3.65019484222532,0.1893335725618916
864,0.1103,65,427,65,216012,460432,18686,107570,3.6468128247370424,0.18938313597487333
865,0.1104,58,386,58,216398,460046,18744,107512,3.6437555442909644,0.18942909799527097
866,0.1105,51,324,51,216722,459722,18795,107461,3.6411893296160183,0.18946442329900579
867,0.1106,48,312,48,217034,459410,18843,107413,3.638718159929033,0.18950007321509538
868,0.1107,37,305,37,217339,459105,18880,107376,3.636302433151692,0.18954916404963273
869,0.1108,40,336,40,217675,458769,18920,107336,3.6336411734887846,0.1896044020102278
870,0.1109,53,397,53,218072,458372,18973,107283,3.6304967684704095,0.18966154281319886
871,0.111,59,424,59,218496,457948,19032,107224,3.6271385122291218,0.18971923591402262
872,0.1111,60,498,60,218994,457450,19092,107164,3.6231941452287417,0.1898004654507327
873,0.1112,39,382,39,219376,457068,19131,107125,3.6201685464453175,0.1898729690017423
874,0.1113,53,358,53,219734,456710,19184,107072,3.6173330376378154,0.18991737941260983
875,0.1114,44,391,44,220125,456319,19228,107028,3.6142361551134203,0.18998592341842593
876,0.1115,37,380,37,220505,455939,19265,106991,3.611226397161323,0.190060931199261
877,0.1116,47,337,47,220842,455602,19312,106944,3.6085572170827525,0.1901071201288428
878,0.1117,47,351,47,221193,455251,19359,106897,3.605777151184894,0.19015810782925494
879,0.1118,50,469,50,221662,454782,19409,106847,3.602062476238753,0.1902448057347466
880,0.1119,45,286,45,221948,454496,19454,106802,3.5997972373590166,0.19027682265035686
881,0.112,50,323,50,222271,454173,19504,106752,3.597238943099734,0.1903142131300976
882,0.1121,54,473,54,222744,453700,19558,106698,3.593492586490939,0.19039682511358
883,0.1122,42,281,42,223025,453419,19600,106656,3.5912669496895195,0.1904316386198277
884,0.1123,49,446,49,223471,452973,19649,106607,3.587734444303637,0.1905125272525823
885,0.1124,52,492,52,223963,452481,19701,106555,3.583837599797237,0.19060489843230133
886,0.1125,56,463,56,224426,452018,19757,106499,3.580170447345077,0.19068175185356936
887,0.1126,53,355,53,224781,451663,19810,106446,3.5773586997845648,0.1907261843116667
888,0.1127,42,332,42,225113,451331,19852,106404,3.574729121784311,0.1907787748661999
889,0.1128,64,458,64,225571,450873,19916,106340,3.5711015714104675,0.19084264006762225
890,0.1129,36,379,36,225950,450494,19952,106304,3.5680997338740337,0.19092022600655892
891,0.113,72,510,72,226460,449984,20024,106232,3.5640603218856928,0.1909905504336445
892,0.1131,34,247,34,226707,449737,20058,106198,3.5621039792168294,0.19102592929029472
893,0.1132,48,394,48,227101,449343,20106,106150,3.5589833354454443,0.19109151690480347
894,0.1133,34,303,34,227404,449040,20140,106116,3.55658344949943,0.19114627239910945
895,0.1134,68,588,68,227992,448452,20208,106048,3.551926245089342,0.1912497745716862
896,0.1135,73,546,73,228538,447906,20281,105975,3.547601698137118,0.19133171204645041
897,0.1136,50,400,50,228938,447506,20331,105925,3.5444335318717526,0.19139694017863113
898,0.1137,96,588,96,229526,446918,20427,105829,3.539776327461665,0.19146010742708688
899,0.1138,41,301,41,229827,446617,20468,105788,3.5373922823469774,0.19150442157475042
900,0.1139,46,370,46,230197,446247,20514,105742,3.5344617285515145,0.19156541162957957
901,0.114,65,514,65,230711,445733,20579,105677,3.5303906349005194,0.19164868246858055
902,0.1141,34,317,34,231028,445416,20613,105643,3.5278798631352175,0.1917090547473138
903,0.1142,39,313,39,231341,445103,20652,105604,3.525400773032569,0.19176077297001853
904,0.1143,52,341,52,231682,444762,20704,105552,3.5226999112913444,0.19180322506787034
905,0.1144,53,297,53,231979,444465,20757,105499,3.5203475478393105,0.19182891971110835
906,0.1145,53,438,53,232417,444027,20810,105446,3.5168784057787352,0.19190387880751192
907,0.1146,35,406,35,232823,443621,20845,105411,3.5136627170193893,0.19199427355782542
908,0.1147,31,274,31,233097,443347,20876,105380,3.5114925231276137,0.19204449571462676
909,0.1148,71,463,71,233560,442884,20947,105309,3.507825370675453,0.1921020516496927
910,0.1149,50,491,50,234051,442393,20997,105259,3.5039364465847167,0.19220052149905414
911,0.115,54,441,54,234492,441952,21051,105205,3.500443543277151,0.19227570880021638
912,0.1151,58,450,58,234942,441502,21109,105147,3.496879356228615,0.19234828930447143
913,0.1152,72,516,72,235458,440986,21181,105075,3.492792421746293,0.19242355707512532
914,0.1153,79,612,79,236070,440374,21260,104996,3.487945127360284,0.19252250765535325
915,0.1154,80,513,80,236583,439861,21340,104916,3.4838819541249526,0.19258522294443414
916,0.1155,73,418,73,237001,439443,21413,104843,3.4805712203776453,0.19262483326780405
917,0.1156,77,506,77,237507,438937,21490,104766,3.4765634900519577,0.1926897589308869
918,0.1157,32,406,32,237913,438531,21522,104734,3.473347801292612,0.19278620930853266
919,0.1158,47,342,47,238255,438189,21569,104687,3.4706390191357244,0.19283777510886463
920,0.1159,91,651,91,238906,437538,21660,104596,3.4654828285388417,0.1929338503026927
921,0.116,62,390,62,239296,437148,21722,104534,3.4623938664301104,0.19298038332453357
922,0.1161,90,546,90,239842,436602,21812,104444,3.458069319477886,0.19304088746613043
923,0.1162,48,399,48,240241,436203,21860,104396,3.4549090736281842,0.1931117149680262
924,0.1163,54,399,54,240640,435804,21914,104342,3.451748827778482,0.19317369748179197
925,0.1164,67,578,67,241218,435226,21981,104275,3.4471708275250283,0.19328045731147858
926,0.1165,42,328,42,241546,434898,22023,104233,3.444572931187429,0.19333520053567685
927,0.1166,80,611,80,242157,434287,22103,104153,3.4397335572170826,0.19343473738949557
928,0.1167,58,438,58,242595,433849,22161,104095,3.4362644151565074,0.19350527192421516
929,0.1168,73,490,73,243085,433359,22234,104022,3.4323834114814344,0.19357215830109364
930,0.1169,55,401,55,243486,432958,22289,103967,3.4292073248004056,0.19363412022163246
931,0.117,63,542,63,244028,432416,22352,103904,3.424914459510835,0.19373508353221958
932,0.1171,56,345,56,244373,432071,22408,103848,3.422181916106957,0.193775551902433
933,0.1172,95,744,95,245117,431327,22503,103753,3.416289126853377,0.19390184645286687
934,0.1173,44,305,44,245422,431022,22547,103709,3.413873400076036,0.19394611496247646
935,0.1174,48,416,48,245838,430606,22595,103661,3.410578507160056,0.19402471049119635
936,0.1175,62,330,62,246168,430276,22657,103599,3.4079647699911293,0.19405104191055958
937,0.1176,79,547,79,246715,429729,22736,103520,3.4036323026232416,0.1941306969164499
938,0.1177,97,571,97,247286,429158,22833,103423,3.399109745279432,0.19419205717064633
939,0.1178,28,280,28,247566,428878,22861,103395,3.396892028893676,0.19425182190342175
940,0.1179,63,583,63,248149,428295,22924,103332,3.392274426561906,0.19436936047266223
941,0.118,68,532,68,248681,427763,22992,103264,3.38806076542897,0.19446092194935474
942,0.1181,46,287,46,248968,427476,23038,103218,3.38578760613357,0.1944962633834187
943,0.1182,48,423,48,249391,427053,23086,103170,3.3824372703079457,0.19457850753362266
944,0.1183,42,323,42,249714,426730,23128,103128,3.379878976048663,0.19463327910496775
945,0.1184,38,319,38,250033,426411,23166,103090,3.377352363452034,0.19469273901276862
946,0.1185,50,471,50,250504,425940,23216,103040,3.373621847674566,0.19478997315588492
947,0.1186,59,431,59,250935,425509,23275,102981,3.3702081485236346,0.1948589377282446
948,0.1187,54,380,54,251315,425129,23329,102927,3.367198390571537,0.19491682700319662
949,0.1188,55,337,55,251652,424792,23384,102872,3.3645292104929667,0.19495739713150792
950,0.1189,72,480,72,252132,424312,23456,102800,3.360727410974528,0.19502496623108562
951,0.119,75,515,75,252647,423797,23531,102725,3.3566483969078695,0.19510105940492514
952,0.1191,45,311,45,252958,423486,23576,102680,3.354185147636548,0.19514753898959644
953,0.1192,53,454,53,253412,423032,23629,102627,3.350589278925358,0.19523493367373146
954,0.1193,54,390,54,253802,422642,23683,102573,3.3475003168166264,0.1952971640185448
955,0.1194,61,549,61,254351,422093,23744,102512,3.3431520086174125,0.1954079736182461
956,0.1195,68,399,68,254750,421694,23812,102444,3.3399917627677103,0.19545234270363912
957,0.1196,57,473,57,255223,421221,23869,102387,3.3362454061589153,0.1955413209882202
958,0.1197,37,311,37,255534,420910,23906,102350,3.3337821568875934,0.1956006574169629
959,0.1198,106,631,106,256165,420279,24012,102244,3.328784374603979,0.1956736832637032
960,0.1199,67,462,67,256627,419817,24079,102177,3.325125142567482,0.19574362923711766
961,0.12,67,458,67,257085,419359,24146,102110,3.3214975921936385,0.19581221510770536
962,0.1201,50,306,50,257391,419053,24196,102060,3.3190739450006337,0.19585003636447373
963,0.1202,65,331,65,257722,418722,24261,101995,3.316452287416044,0.19587415045024456
964,0.1203,45,308,45,258030,418414,24306,101950,3.314012799391712,0.1959205479241454
965,0.1204,66,454,66,258484,417960,24372,101884,3.310416930680522,0.19598956610059942
966,0.1205,52,333,52,258817,417627,24424,101832,3.3077794322646055,0.19603472073830658
967,0.1206,59,439,59,259256,417188,24483,101773,3.3043023697883664,0.1961091488570432
968,0.1207,73,522,73,259778,416666,24556,101700,3.3001679128120642,0.19619342317976102
969,0.1208,27,319,27,260097,416347,24583,101673,3.2976413002154352,0.19627234469711594
970,0.1209,49,349,49,260446,415998,24632,101624,3.2948770751489036,0.1963285949978942
971,0.121,57,412,57,260858,415586,24689,101567,3.291613863895577,0.19639642426902676
972,0.1211,44,372,44,261230,415214,24733,101523,3.288667469268787,0.19646938384516688
973,0.1212,60,406,60,261636,414808,24793,101463,3.285451780509441,0.19653050432815325
974,0.1213,64,427,64,262063,414381,24857,101399,3.2820697630211635,0.19659350886036683
975,0.1214,68,446,68,262509,413935,24925,101331,3.2785372576352807,0.19665764867078364
976,0.1215,44,371,44,262880,413564,24969,101287,3.275598783424154,0.1967307046116255
977,0.1216,78,430,78,263310,413134,25047,101209,3.272193004688886,0.19677335941190996
978,0.1217,69,472,69,263782,412662,25116,101140,3.2684545684957547,0.19684625595073588
979,0.1218,60,388,60,264170,412274,25176,101080,3.26538144721835,0.19690116371938274
980,0.1219,55,486,55,264656,411788,25231,101025,3.261532125205931,0.19700163607396848
981,0.122,74,455,74,265111,411333,25305,100951,3.2579283360790776,0.1970606148152197
982,0.1221,84,560,84,265671,410773,25389,100867,3.2534929033075657,0.1971444765850989
983,0.1222,55,404,55,266075,410369,25444,100812,3.2502930553795464,0.1972139027076515
984,0.1223,55,376,55,266451,409993,25499,100757,3.2473149790901026,0.19727263827704355
985,0.1224,75,537,75,266988,409456,25574,100682,3.2430617158788495,0.19736228236281164
986,0.1225,51,259,51,267247,409197,25625,100631,3.2410103282220253,0.19738225440736876
987,0.1226,69,447,69,267694,408750,25694,100562,3.237469902420479,0.19744675169640613
988,0.1227,93,550,93,268244,408200,25787,100469,3.2331136738056014,0.197513510750606
989,0.1228,90,609,90,268853,407591,25877,100379,3.2282901406665823,0.19760812646416126
990,0.1229,50,356,50,269209,407235,25927,100329,3.225470472690407,0.19766768328723078
991,0.123,61,438,61,269647,406797,25988,100268,3.2220013306298316,0.19774190685612297
992,0.1231,37,333,37,269980,406464,26025,100231,3.2193638322139146,0.19781328017841107
993,0.1232,120,731,120,270711,405733,26145,100111,3.213574008363959,0.1979088414610038
994,0.1233,88,515,88,271226,405218,26233,100023,3.209494994297301,0.19797086934749952
995,0.1234,57,462,57,271688,404756,26290,99966,3.2058357622608034,0.19806150712669549
996,0.1235,93,501,93,272189,404255,26383,99873,3.201867634013433,0.19811040053319792
997,0.1236,117,724,117,272913,403531,26500,99756,3.1961332530731212,0.19820897420358563
998,0.1237,62,588,62,273501,402943,26562,99694,3.191476048663034,0.1983419445842626
999,0.1238,65,417,65,273918,402526,26627,99629,3.1881732353313903,0.19840288357180552
1000,0.1239,59,417,59,274335,402109,26686,99570,3.1848704219997463,0.1984735259000277
1001,0.124,72,446,72,274781,401663,26758,99498,3.181337916613864,0.19853500172599226
1002,0.1241,68,454,68,275235,401209,26826,99430,3.177742047902674,0.19860618130029822
1003,0.1242,62,417,62,275652,400792,26888,99368,3.17443923457103,0.1986724248240563
1004,0.1243,67,470,67,276122,400322,26955,99301,3.1707166392092256,0.19875185890161182
1005,0.1244,74,438,74,276560,399884,27029,99227,3.1672474971486504,0.19880747969890467
1006,0.1245,62,384,62,276944,399500,27091,99165,3.1642060575338995,0.1988609587598889
1007,0.1246,73,499,73,277443,399001,27164,99092,3.1602537701178557,0.19894276771606909
1008,0.1247,44,442,44,277885,398559,27208,99048,3.1567529463946267,0.19904864682369822
1009,0.1248,74,491,74,278376,398068,27282,98974,3.1528640223038904,0.1991260295910607
1010,0.1249,89,509,89,278885,397559,27371,98885,3.148832530731213,0.1991866152073547
1011,0.125,61,309,61,279194,397250,27432,98824,3.146385122291218,0.1992122143067365
1012,0.1251,50,417,50,279611,396833,27482,98774,3.143082308959574,0.1992990413775431
1013,0.1252,98,566,98,280177,396267,27580,98676,3.1385993536940817,0.19936841212018352
1014,0.1253,69,480,69,280657,395787,27649,98607,3.134797554175643,0.19945023604655396
1015,0.1254,55,444,55,281101,395343,27704,98552,3.1312808896210873,0.19954038813917938
1016,0.1255,46,308,46,281409,395035,27750,98506,3.128841401596756,0.19959030759349275
1017,0.1256,44,345,44,281754,394690,27794,98462,3.126108858192878,0.1996585231328272
1018,0.1257,34,274,34,282028,394416,27828,98428,3.1239386643011025,0.1997143112222123
1019,0.1258,90,548,90,282576,393868,27918,98338,3.119598276517552,0.1997903316903898
1020,0.1259,143,896,143,283472,392972,28061,98195,3.1125015840831325,0.19992181885183655
1021,0.126,80,502,80,283974,392470,28141,98115,3.1085255354200987,0.19999592323450574
1022,0.1261,85,479,85,284453,391991,28226,98030,3.1047316563173237,0.20005265080476142
1023,0.1262,85,536,85,284989,391455,28311,97945,3.1004863135217335,0.20013281569268493
1024,0.1263,80,505,80,285494,390950,28391,97865,3.0964865036117097,0.20020866790094413
1025,0.1264,55,406,55,285900,390544,28446,97810,3.0932708148523633,0.20028503913144974
1026,0.1265,86,656,86,286556,389888,28532,97724,3.088075022177164,0.20041344347555023
1027,0.1266,93,585,93,287141,389303,28625,97631,3.0834415790140666,0.200501505337479
1028,0.1267,81,499,81,287640,388804,28706,97550,3.079489291598023,0.200574067448813
1029,0.1268,50,338,50,287978,388466,28756,97500,3.076812191103789,0.20063131988657643
1030,0.1269,59,337,59,288315,388129,28815,97441,3.074143011025219,0.20067343534402868
1031,0.127,64,508,64,288823,387621,28879,97377,3.070119439868204,0.20077814753875273
1032,0.1271,45,381,45,289204,387240,28924,97332,3.0671017615004437,0.2008617914365667
1033,0.1272,47,384,47,289588,386856,28971,97285,3.0640603218856928,0.20094352678248692
1034,0.1273,72,398,72,289986,386458,29043,97213,3.060907996451654,0.20098992910470134
1035,0.1274,86,499,86,290485,385959,29129,97127,3.05695570903561,0.20105529864247773
1036,0.1275,48,435,48,290920,385524,29177,97079,3.0535103282220253,0.2011570587004225
1037,0.1276,43,300,43,291220,385224,29220,97036,3.051134203523001,0.2012109650396052
1038,0.1277,47,292,47,291512,384932,29267,96989,3.048821442149284,0.20125497747556134
1039,0.1278,76,388,76,291900,384544,29343,96913,3.0457483208718794,0.20129108103112012
1040,0.1279,67,477,67,292377,384067,29410,96846,3.0419702826004307,0.20137945948643518
1041,0.128,65,422,65,292799,383645,29475,96781,3.03862786719047,0.20144829796888594
1042,0.1281,67,423,67,293222,383222,29542,96714,3.035277531364846,0.20151436858247768
1043,0.1282,61,448,61,293670,382774,29603,96653,3.0317291851476367,0.20160107795347362
1044,0.1283,63,341,63,294011,382433,29666,96590,3.029028323406412,0.20163958724320127
1045,0.1284,37,254,37,294265,382179,29703,96553,3.027016537827905,0.20168486752504533
1046,0.1285,78,540,78,294805,381639,29781,96475,3.0227395133696615,0.20178242009227926
1047,0.1286,53,342,53,295147,381297,29834,96422,3.020030731212774,0.20183831917926648
1048,0.1287,49,428,49,295575,380869,29883,96373,3.016640793308833,0.20193738187334728
1049,0.1288,82,535,82,296110,380334,29965,96291,3.012403370928906,0.20202675059008654
1050,0.1289,83,517,83,296627,379817,30048,96208,3.008308516030921,0.2021070321936873
1051,0.129,38,312,38,296939,379505,30086,96170,3.0058373463439363,0.2021758553634309
1052,0.1291,61,383,61,297322,379122,30147,96109,3.0028038271448487,0.2022363860943415
1053,0.1292,135,708,135,298030,378414,30282,95974,2.9971961728551513,0.20231118830999098
1054,0.1293,62,430,62,298460,377984,30344,95912,2.9937903941198836,0.20239039789320865
1055,0.1294,59,410,59,298870,377574,30403,95853,2.990543023697884,0.20246627251931132
1056,0.1295,53,387,53,299257,377187,30456,95800,2.9874778228361425,0.20254256459479858
1057,0.1296,83,582,83,299839,376605,30539,95717,2.9828681409200355,0.2026520043529626
1058,0.1297,77,479,77,300318,376126,30616,95640,2.97907426181726,0.20272762344043446
1059,0.1298,57,463,57,300781,375663,30673,95583,2.9754071093650993,0.2028303688519372
1060,0.1299,79,569,79,301350,375094,30752,95504,2.970900392852617,0.20294178895787912
1061,0.13,84,483,84,301833,374611,30836,95420,2.967074832087188,0.20300788671385506
1062,0.1301,78,477,78,302310,374134,30914,95342,2.9632967938157395,0.2030817336775469
1063,0.1302,79,543,79,302853,373591,30993,95263,2.9589960081105056,0.20318265387519355
1064,0.1303,83,569,83,303422,373022,31076,95180,2.954489291598023,0.20328832427029359
1065,0.1304,60,491,60,303913,372531,31136,95120,2.950600367507287,0.20339954367680171
1066,0.1305,81,461,81,304374,372070,31217,95039,2.946949055886453,0.20346214695071171
1067,0.1306,76,443,76,304817,371627,31293,94963,2.9434403117475605,0.20352557920229752
1068,0.1307,59,528,59,305345,371099,31352,94904,2.939258332277278,0.20365534127462698
1069,0.1308,56,374,56,305719,370725,31408,94848,2.936296096819161,0.2037231540488817
1070,0.1309,61,588,61,306307,370137,31469,94787,2.9316388924090737,0.20387633247584552
1071,0.131,79,493,79,306800,369644,31548,94708,2.9277341274870103,0.20395734270553373
1072,0.1311,66,390,66,307190,369254,31614,94642,2.924645165378279,0.20401555521065065
1073,0.1312,88,633,88,307823,368621,31702,94554,2.919631542263338,0.20414314244076212
1074,0.1313,57,351,57,308174,368270,31759,94497,2.91685147636548,0.20419995375642602
1075,0.1314,72,610,72,308784,367660,31831,94425,2.9120200228107973,0.20434552084573185
1076,0.1315,70,563,70,309347,367097,31901,94355,2.907560828792295,0.2044741381552144
1077,0.1316,79,612,79,309959,366485,31980,94276,2.9027135344062858,0.20460933108487914
1078,0.1317,87,641,87,310600,365844,32067,94189,2.8976365479660373,0.20474400749511448
1079,0.1318,42,334,42,310934,365510,32109,94147,2.894991129134457,0.20482011586900667
1080,0.1319,64,450,64,311384,365060,32173,94083,2.891426942085921,0.2049100171406294
1081,0.132,63,488,63,311872,364572,32236,94020,2.8875617792421746,0.20501884027632405
1082,0.1321,77,406,77,312278,364166,32313,93943,2.8843460904828286,0.20506691638889435
1083,0.1322,86,513,86,312791,363653,32399,93857,2.8802829172474973,0.20514742847150882
1084,0.1323,82,502,82,313293,363151,32481,93775,2.8763068685844635,0.20523016856121123
1085,0.1324,52,366,52,313659,362785,32533,93723,2.873407996451654,0.20530417867813927
1086,0.1325,72,476,72,314135,362309,32605,93651,2.8696378785958685,0.20539301693130976
1087,0.1326,55,409,55,314544,361900,32660,93596,2.8663984285895325,0.20548149709327854
1088,0.1327,52,368,52,314912,361532,32712,93544,2.863483715625396,0.20555687401664777
1089,0.1328,67,500,67,315412,361032,32779,93477,2.859523507793689,0.20566589440473126
1090,0.1329,113,654,113,316066,360378,32892,93364,2.854343555949816,0.20576450934672127
1091,0.133,89,606,89,316672,359772,32981,93275,2.8495437840577873,0.2058837162590195
1092,0.1331,87,563,87,317235,359209,33068,93188,2.8450845900392854,0.2059872191902245
1093,0.1332,46,436,46,317671,358773,33114,93142,2.841631288810037,0.2061051303895644
1094,0.1333,49,324,49,317995,358449,33163,93093,2.8390650741350907,0.20616686819830712
1095,0.1334,60,369,60,318364,358080,33223,93033,2.8361424407552907,0.20622992465302487
1096,0.1335,101,618,101,318982,357462,33324,92932,2.831247623875301,0.2063348978894035
1097,0.1336,74,463,74,319445,356999,33398,92858,2.8275804714231403,0.20641670575316157
1098,0.1337,65,475,65,319920,356524,33463,92793,2.8238182739830187,0.20652011831290604
1099,0.1338,86,486,86,320406,356038,33549,92707,2.8199689519705995,0.20659171689935263
1100,0.1339,35,345,35,320751,355693,33584,92672,2.8172364085667216,0.2066887468914835
1101,0.134,95,514,95,321265,355179,33679,92577,2.813165314915727,0.2067576983893013
1102,0.1341,65,430,65,321695,354749,33744,92512,2.809759536180459,0.20684119563297493
1103,0.1342,79,492,79,322187,354257,33823,92433,2.805862691674059,0.20692874252837537
1104,0.1343,75,470,75,322657,353787,33898,92358,2.8021400963122542,0.2070134149211579
1105,0.1344,62,419,62,323076,353368,33960,92296,2.798821442149284,0.20709772384576722
1106,0.1345,58,411,58,323487,352957,34018,92238,2.795566151311621,0.20718561529217533
1107,0.1346,73,500,73,323987,352457,34091,92165,2.791605943479914,0.20728843826891158
1108,0.1347,40,301,40,324288,352156,34131,92125,2.789221898365226,0.20735750572272954
1109,0.1348,70,433,70,324721,351723,34201,92055,2.785792358382968,0.20743479848032123
1110,0.1349,75,490,75,325211,351233,34276,91980,2.781911354707895,0.20753001378569672
1111,0.135,34,244,34,325455,350989,34310,91946,2.779978773286022,0.2075835054804881
1112,0.1351,93,483,93,325938,350506,34403,91853,2.776153212520593,0.20764356552031268
1113,0.1352,62,315,62,326253,350191,34465,91791,2.7736582815866178,0.20768040327434148
1114,0.1353,82,464,82,326717,349727,34547,91709,2.7699832087187937,0.20775152003914496
1115,0.1354,58,437,58,327154,349290,34605,91651,2.7665219870738817,0.20785320485053557
1116,0.1355,87,502,87,327656,348788,34692,91564,2.762545938410848,0.20793365307753797
1117,0.1356,62,339,62,327995,348449,34754,91502,2.7598609175009505,0.2079822525690361
1118,0.1357,106,446,106,328441,348003,34860,91396,2.7563284121150677,0.20800229404254447
1119,0.1358,102,482,102,328923,347521,34962,91294,2.7525107717653023,0.20804667114843384
1120,0.1359,66,453,66,329376,347068,35028,91228,2.748922823469776,0.20814244255024003
1121,0.136,54,359,54,329735,346709,35082,91174,2.74607939424661,0.2082154365435516
1122,0.1361,81,571,81,330306,346138,35163,91093,2.7415568369028005,0.2083406711783931
1123,0.1362,66,438,66,330744,345700,35229,91027,2.7380876948422253,0.2084299802851667
1124,0.1363,64,366,64,331110,345334,35293,90963,2.7351888227094157,0.20848871296387553
1125,0.1364,92,499,92,331609,344835,35385,90871,2.7312365352933723,0.2085603595084759
1126,0.1365,57,357,57,331966,344478,35442,90814,2.7284089469015336,0.20862777170267316
1127,0.1366,103,714,103,332680,343764,35545,90711,2.7227537701178557,0.20878301398239255
1128,0.1367,59,386,59,333066,343378,35604,90652,2.719696489671778,0.20886113863097022
1129,0.1368,85,513,85,333579,342865,35689,90567,2.715633316436447,0.2089531921962384
1130,0.1369,75,518,75,334097,342347,35764,90492,2.7115305411227983,0.20906618858282178
1131,0.137,75,472,75,334569,341875,35839,90417,2.7077921049296667,0.20915723631249247
1132,0.1371,54,257,54,334826,341618,35893,90363,2.705756558104169,0.2091828112810517
1133,0.1372,65,505,65,335331,341113,35958,90298,2.7017567481941454,0.2093085248174015
1134,0.1373,91,527,91,335858,340586,36049,90207,2.697582689139526,0.20939755288502832
1135,0.1374,73,548,73,336406,340038,36122,90134,2.693242301355975,0.20953014143179938
1136,0.1375,95,582,95,336988,339456,36217,90039,2.6886326194398684,0.20963922746481334
1137,0.1376,75,378,75,337366,339078,36292,89964,2.6856387023190975,0.20968576502999706
1138,0.1377,60,415,60,337781,338663,36352,89904,2.6823517298187807,0.20977816770773297
1139,0.1378,89,567,89,338348,338096,36441,89815,2.677860854137625,0.20989177656101385
1140,0.1379,64,466,64,338814,337630,36505,89751,2.6741699404384742,0.2100023164342823
1141,0.138,84,531,84,339345,337099,36589,89667,2.6699641997212016,0.21010811545437078
1142,0.1381,42,279,42,339624,336820,36631,89625,2.667754403751109,0.21016778248074194
1143,0.1382,79,412,79,340036,336408,36710,89546,2.664491192497782,0.2102245782408429
1144,0.1383,90,620,90,340656,335788,36800,89456,2.6595805347864654,0.21036393223655125
1145,0.1384,73,519,73,341175,335269,36873,89383,2.6554698390571536,0.2104852914857342
1146,0.1385,45,350,45,341525,334919,36918,89338,2.6526976935749587,0.2105751938094127
1147,0.1386,86,488,86,342013,334431,37004,89252,2.648832530731213,0.21065749628849872
1148,0.1387,71,391,71,342404,334040,37075,89181,2.6457356482068177,0.21071969491116935
1149,0.1388,77,348,77,342752,333692,37152,89104,2.64297934355595,0.21074939214183672
1150,0.1389,108,711,108,343463,332981,37260,88996,2.6373479280192624,0.2109024899461345
1151,0.139,67,435,67,343898,332546,37327,88929,2.633902547205677,0.21099472092057656
1152,0.1391,67,395,67,344293,332151,37394,88862,2.6307739830186287,0.21106711669235867
1153,0.1392,49,322,49,344615,331829,37443,88813,2.6282236091750093,0.21113678615069345
1154,0.1393,74,465,74,345080,331364,37517,88739,2.624540615891522,0.21123153131493944
1155,0.1394,73,363,73,345443,331001,37590,88666,2.6216655050057027,0.21127703631688935
1156,0.1395,61,437,61,345880,330564,37651,88605,2.618204283360791,0.2113825211310951
1157,0.1396,66,435,66,346315,330129,37717,88539,2.6147589025472056,0.21147782968844048
1158,0.1397,61,294,61,346609,329835,37778,88478,2.612430300342162,0.2115114758565954
1159,0.1398,104,543,104,347152,329292,37882,88374,2.608129514636928,0.21159012225079368
1160,0.1399,67,447,67,347599,328845,37949,88307,2.604589088835382,0.21169022322798403
1161,0.14,47,316,47,347915,328529,37996,88260,2.6020862374857434,0.21176182672767274
1162,0.1401,118,623,118,348538,327906,38114,88142,2.5971518185274363,0.21185536284274892
1163,0.1402,76,448,76,348986,327458,38190,88066,2.593603472310227,0.211939623222726
1164,0.1403,108,594,108,349580,326864,38298,87958,2.588898745406159,0.21203793434292298
1165,0.1404,43,278,43,349858,326586,38341,87915,2.5866968698517296,0.21209840265765342
1166,0.1405,87,591,87,350449,325995,38428,87828,2.582015904194652,0.21223566597313345
1167,0.1406,100,671,100,351120,325324,38528,87728,2.576701305284501,0.21238972332781345
1168,0.1407,54,353,54,351473,324971,38582,87674,2.573905398555316,0.212468344460735
1169,0.1408,102,642,102,352115,324329,38684,87572,2.5688204916994044,0.21260448505830284
1170,0.1409,76,424,76,352539,323905,38760,87496,2.5654622354581167,0.2126781412782176
1171,0.141,54,317,54,352856,323588,38814,87442,2.562951463692815,0.21273872953312412
1172,0.1411,64,494,64,353350,323094,38878,87378,2.559038778355088,0.2128720107583465
1173,0.1412,40,239,40,353589,322855,38918,87338,2.5571457990115323,0.2129192843368853
1174,0.1413,87,499,87,354088,322356,39005,87251,2.5531935115954885,0.21301149638555983
1175,0.1414,60,394,60,354482,321962,39065,87191,2.5500728678241034,0.2131012115272282
1176,0.1415,57,418,57,354900,321544,39122,87134,2.5467621340767965,0.21320942159842224
1177,0.1416,73,412,73,355312,321132,39195,87061,2.5434989228234697,0.21328391226699134
1178,0.1417,60,345,60,355657,320787,39255,87001,2.540766379419592,0.21334860270532727
1179,0.1418,78,382,78,356039,320405,39333,86923,2.5377407806361676,0.2133980477649462
1180,0.1419,101,595,101,356634,319810,39434,86822,2.5330281333164364,0.2135149225835645
1181,0.142,83,479,83,357113,319331,39517,86739,2.529234254213661,0.21360602851725072
1182,0.1421,61,289,61,357402,319042,39578,86678,2.5269452540869346,0.21363994873311642
1183,0.1422,84,389,84,357791,318653,39662,86594,2.5238642123938666,0.21368202602363498
1184,0.1423,65,363,65,358154,318290,39727,86529,2.520989101508047,0.2137473784580269
1185,0.1424,26,203,26,358357,318087,39753,86503,2.5193812571283742,0.21380409797572852
1186,0.1425,38,354,38,358711,317733,39791,86465,2.5165774299835255,0.21391743650389167
1187,0.1426,46,324,46,359035,317409,39837,86419,2.5140112153085794,0.21399952455005597
1188,0.1427,63,417,63,359452,316992,39900,86356,2.510708401976936,0.21409799974215812
1189,0.1428,60,307,60,359759,316685,39960,86296,2.5082768343682678,0.21414409116062544
1190,0.1429,54,267,54,360026,316418,40014,86242,2.506162083386136,0.21418069835593304
1191,0.143,57,272,57,360298,316146,40071,86185,2.5040077303256876,0.21421416694214465
1192,0.1431,59,390,59,360688,315756,40130,86126,2.5009187682169562,0.21430668703748862
1193,0.1432,65,375,65,361063,315381,40195,86061,2.497948612343176,0.21437966132093803
1194,0.1433,79,490,79,361553,314891,40274,85982,2.494067608668103,0.21448688237920738
1195,0.1434,76,409,76,361962,314482,40350,85906,2.4908281586617664,0.21455687982656824
1196,0.1435,47,305,47,362267,314177,40397,85859,2.4884124318844254,0.21462818346348828
1197,0.1436,63,327,63,362594,313850,40460,85796,2.485822455962489,0.21467999179273659
1198,0.1437,57,391,57,362985,313459,40517,85739,2.482725573438094,0.21477813015095265
1199,0.1438,44,210,44,363195,313249,40561,85695,2.481062286148777,0.21480458410202935
1200,0.1439,59,365,59,363560,312884,40620,85636,2.478171334431631,0.21488507477667368
1201,0.144,62,380,62,363940,312504,40682,85574,2.475161576479534,0.21496792085973102
1202,0.1441,53,312,53,364252,312192,40735,85521,2.4726904067925486,0.2150319451463744
1203,0.1442,55,266,55,364518,311926,40790,85466,2.47058357622608,0.21506723839433103
1204,0.1443,42,292,42,364810,311634,40832,85424,2.4682708148523633,0.21514237214714224
1205,0.1444,53,357,53,365167,311277,40885,85371,2.4654432264605246,0.21523113692745205
1206,0.1445,87,559,87,365726,310718,40972,85284,2.461015714104676,0.2153625486739966
1207,0.1446,78,568,78,366294,310150,41050,85206,2.456516918007857,0.21551715415979522
1208,0.1447,90,540,90,366834,309610,41140,85116,2.4522398935496135,0.21563312272310411
1209,0.1448,89,617,89,367451,308993,41229,85027,2.447352997085287,0.21579361453733312
1210,0.1449,93,436,93,367887,308557,41322,84934,2.4438996958560386,0.21584737643300608
1211,0.145,66,449,66,368336,308108,41388,84868,2.440343429223166,0.21596229795203778
1212,0.1451,80,417,80,368753,307691,41468,84788,2.437040615891522,0.216031940562425
1213,0.1452,80,417,80,369170,307274,41548,84708,2.4337378025598784,0.21610175977468354
1214,0.1453,97,508,97,369678,306766,41645,84611,2.429714231402864,0.21618797221093727
1215,0.1454,60,480,60,370158,306286,41705,84551,2.4259124318844254,0.2163331516719246
1216,0.1455,60,286,60,370444,306000,41765,84491,2.423647193004689,0.2163711839709494
1217,0.1456,64,353,64,370797,305647,41829,84427,2.4208512862755036,0.2164384193768362
1218,0.1457,62,332,62,371129,305315,41891,84365,2.4182217082752504,0.21649815233011702
1219,0.1458,59,346,59,371475,304969,41950,84306,2.415481244455709,0.2165718322522638
1220,0.1459,104,529,104,372004,304440,42054,84202,2.4112913445697632,0.2166569747994298
1221,0.146,91,476,91,372480,303964,42145,84111,2.407521226713978,0.21673903240353024
1222,0.1461,54,412,54,372892,303552,42199,84057,2.4042580154606514,0.21686028962175802
1223,0.1462,42,268,42,373160,303284,42241,84015,2.4021353440628563,0.2169254245427951
1224,0.1463,64,315,64,373475,302969,42305,83951,2.399640413128881,0.21697250077535407
1225,0.1464,103,549,103,374024,302420,42408,83848,2.3952921049296667,0.21707208466660452
1226,0.1465,73,374,73,374398,302046,42481,83775,2.39232986947155,0.21713437060191124
1227,0.1466,68,382,68,374780,301664,42549,83707,2.389304270688126,0.2172114663532025
1228,0.1467,86,416,86,375196,301248,42635,83621,2.3860093777721456,0.21727133128415124
1229,0.1468,101,530,101,375726,300718,42736,83520,2.381811557470536,0.21736527881156992
1230,0.1469,58,363,58,376089,300355,42794,83462,2.3789364465847167,0.21745258808234133
1231,0.147,51,377,51,376466,299978,42845,83411,2.3759504498796096,0.2175623192110363
1232,0.1471,104,613,104,377079,299365,42949,83307,2.371095235077937,0.21769818539114438
1233,0.1472,81,504,81,377583,298861,43030,83226,2.367103345583576,0.21781950184120372
1234,0.1473,67,322,67,377905,298539,43097,83159,2.3645529717399567,0.2178659568559437
1235,0.1474,69,370,69,378275,298169,43166,83090,2.361622417944494,0.21793583889167206
1236,0.1475,57,334,57,378609,297835,43223,83033,2.3589769991129135,0.21800991419599441
1237,0.1476,54,308,54,378917,297527,43277,82979,2.356537511088582,0.2180754048556396
1238,0.1477,76,429,76,379346,297098,43353,82903,2.353139652768977,0.21816521535469643
1239,0.1478,63,360,63,379706,296738,43416,82840,2.3502883031301485,0.21824236388831808
1240,0.1479,68,389,68,380095,296349,43484,82772,2.34720726143708,0.2183260753163238
1241,0.148,85,410,85,380505,295939,43569,82687,2.3439598910150803,0.21838700987253912
1242,0.1481,94,513,94,381018,295426,43663,82593,2.339896717779749,0.21848901774778517
1243,0.1482,68,382,68,381400,295044,43731,82525,2.3368711189963247,0.218569321104222
1244,0.1483,52,302,52,381702,294742,43783,82473,2.3344791534659737,0.2186365865620402
1245,0.1484,85,498,85,382200,294244,43868,82388,2.3305347864655936,0.21874933622209478
1246,0.1485,70,417,70,382617,293827,43938,82318,2.32723197313395,0.21884645548923953
1247,0.1486,73,410,73,383027,293417,44011,82245,2.3239846027119504,0.21893350937811118
1248,0.1487,81,362,81,383389,293055,44092,82164,2.3211174122417946,0.21897611794711888
1249,0.1488,75,373,75,383762,292682,44167,82089,2.318163097199341,0.2190377590581982
1250,0.1489,76,478,76,384240,292204,44243,82013,2.314377138512229,0.21915893719419482
1251,0.149,72,355,72,384595,291849,44315,81941,2.311565390951717,0.21921667246314774
1252,0.1491,81,534,81,385129,291315,44396,81860,2.307335888987454,0.21936088966302672
1253,0.1492,52,363,52,385492,290952,44448,81808,2.304460778101635,0.2194656078978431
1254,0.1493,72,404,72,385896,290548,44520,81736,2.3012609301736155,0.21955281451794867
1255,0.1494,43,250,43,386146,290298,44563,81693,2.299280826257762,0.2196101518585127
1256,0.1495,69,351,69,386497,289947,44632,81624,2.2965007603599035,0.21967268705038875
1257,0.1496,67,399,67,386896,289548,44699,81557,2.2933405145102017,0.21976799019145524
1258,0.1497,61,372,61,387268,289176,44760,81496,2.2903941198834117,0.21986014589718134
1259,0.1498,77,451,77,387719,288725,44837,81419,2.286822012419212,0.2199657430621596
1260,0.1499,64,398,64,388117,288327,44901,81355,2.283669686985173,0.2200675174880032
1261,0.15,43,331,43,388448,287996,44944,81312,2.281048029400583,0.22017394694942974
1262,0.1501,50,255,50,388703,287741,44994,81262,2.279028323406412,0.2202204318122075
1263,0.1502,77,385,77,389088,287356,45071,81185,2.275978963375998,0.22028756637660396
1264,0.1503,106,555,106,389643,286801,45177,81079,2.271583132682803,0.22039523757747093
1265,0.1504,65,498,65,390141,286303,45242,81014,2.267638765682423,0.22055608643215532
1266,0.1505,79,557,79,390698,285746,45321,80935,2.2632270941579016,0.2207231899116671
1267,0.1506,69,417,69,391115,285329,45390,80866,2.2599242808262576,0.22082770108821803
1268,0.1507,42,316,42,391431,285013,45432,80824,2.257421429476619,0.2209289929668131
1269,0.1508,95,488,95,391919,284525,45527,80729,2.253556266632873,0.22102153569844546
1270,0.1509,50,354,50,392273,284171,45577,80679,2.2507524394880245,0.22112923119090036
1271,0.151,92,481,92,392754,283690,45669,80587,2.246942719553922,0.2212245077235181
1272,0.1511,50,394,50,393148,283296,45719,80537,2.243822075782537,0.22135705117457735
1273,0.1512,77,467,77,393615,282829,45796,80460,2.240123241667723,0.22147656548918354
1274,0.1513,83,625,83,394240,282204,45879,80377,2.235172981878089,0.22168012113155405
1275,0.1514,65,445,65,394685,281759,45944,80312,2.2316483969078695,0.22181284886113498
1276,0.1515,60,302,60,394987,281457,46004,80252,2.2292564313775185,0.22186896096033
1277,0.1516,55,407,55,395394,281050,46059,80197,2.226032822202509,0.22200045951938702
1278,0.1517,47,228,47,395622,280822,46106,80150,2.224226967431251,0.22203938255598774
1279,0.1518,78,516,78,396138,280306,46184,80072,2.220140032948929,0.22218892385217742
1280,0.1519,51,276,51,396414,280030,46235,80021,2.217953998225827,0.22224907027060056
1281,0.152,85,505,85,396919,279525,46320,79936,2.2139541883158027,0.22237739281869243
1282,0.1521,61,346,61,397265,279179,46381,79875,2.2112137244962615,0.2224595743258674
1283,0.1522,62,319,62,397584,278860,46443,79813,2.2086871118996325,0.22252302236298802
1284,0.1523,59,353,59,397937,278507,46502,79754,2.2058912051704476,0.22261423933947597
1285,0.1524,63,346,63,398283,278161,46565,79691,2.203150741350906,0.22269262153068867
1286,0.1525,69,404,69,398687,277757,46634,79622,2.1999508934228866,0.222794288416499
1287,0.1526,52,307,52,398994,277450,46686,79570,2.197519325814219,0.22287266819786006
1288,0.1527,79,418,79,399412,277032,46765,79491,2.1942085920669117,0.22296177245226817
1289,0.1528,77,482,77,399894,276550,46842,79414,2.1903909517171463,0.2230955939364655
1290,0.1529,79,422,79,400316,276128,46921,79335,2.187048536307185,0.2231877860705615
1291,0.153,69,385,69,400701,275743,46990,79266,2.183999176276771,0.2232788464517801
1292,0.1531,101,491,101,401192,275252,47091,79165,2.1801102521860347,0.2233668249547849
1293,0.1532,42,247,42,401439,275005,47133,79123,2.1781539095171714,0.22343051100167172
1294,0.1533,50,241,50,401680,274764,47183,79073,2.176245089342289,0.22347295506122875
1295,0.1534,28,192,28,401872,274572,47211,79045,2.174724369534913,0.22353280526671512
1296,0.1535,113,616,113,402488,273956,47324,78932,2.1698453934862503,0.22367436693795198
1297,0.1536,74,417,74,402905,273539,47398,78858,2.1665425801546063,0.22377602533506244
1298,0.1537,63,384,63,403289,273155,47461,78795,2.1635011405398554,0.22388123312970593
1299,0.1538,62,365,62,403654,272790,47523,78733,2.1606101888227096,0.2239768094833055
1300,0.1539,65,320,65,403974,272470,47588,78668,2.158075655810417,0.22403727309490856
1301,0.154,92,422,92,404396,272048,47680,78576,2.154733240400456,0.22410331295062516
1302,0.1541,70,402,70,404798,271646,47750,78506,2.1515492333037636,0.22420548790239667
1303,0.1542,69,408,69,405206,271238,47819,78437,2.148317703713091,0.22431400586258668
1304,0.1543,72,353,72,405559,270885,47891,78365,2.1455217969839055,0.22438081603435933
1305,0.1544,63,289,63,405848,270596,47954,78302,2.143232796857179,0.22442662325378765
1306,0.1545,55,280,55,406128,270316,48009,78247,2.141015080471423,0.22448452647010728
1307,0.1546,58,318,58,406446,269998,48067,78189,2.1384963882904575,0.22456036555069547
1308,0.1547,59,347,59,406793,269651,48126,78130,2.135748004055253,0.2246528706283552
1309,0.1548,86,447,86,407240,269204,48212,78044,2.132207578253707,0.22475003455743445
1310,0.1549,51,271,51,407511,268933,48263,77993,2.1300611456089213,0.2248116312988937
1311,0.155,67,280,67,407791,268653,48330,77926,2.127843429223166,0.2248433978977376
1312,0.1551,74,374,74,408165,268279,48404,77852,2.1248811937650487,0.22492062253886536
1313,0.1552,45,220,45,408385,268059,48449,77807,2.1231387023190975,0.22496284688289683
1314,0.1553,64,316,64,408701,267743,48513,77743,2.120635850969459,0.22502503719398181
1315,0.1554,72,398,72,409099,267345,48585,77671,2.11748352553542,0.225122892851346
1316,0.1555,92,503,92,409602,266842,48677,77579,2.113499556456723,0.22524468600927353
1317,0.1556,51,282,51,409884,266560,48728,77528,2.1112659992396403,0.22531445444188697
1318,0.1557,138,603,138,410487,265957,48866,77390,2.1064899885946016,0.22539879480525532
1319,0.1558,48,342,48,410829,265615,48914,77342,2.1037812064377137,0.22551515204530015
1320,0.1559,56,340,56,411169,265275,48970,77286,2.101088265112153,0.2256123726869083
1321,0.156,54,313,54,411482,264962,49024,77232,2.0986091750095044,0.22569653471422643
1322,0.1561,61,321,61,411803,264641,49085,77171,2.0960667215815487,0.22577030648426621
1323,0.1562,60,303,60,412106,264338,49145,77111,2.0936668356355344,0.2258346048751058
1324,0.1563,44,263,44,412369,264075,49189,77067,2.0915837663160564,0.2259088590674851
1325,0.1564,88,479,88,412848,263596,49277,76979,2.087789887213281,0.22602657270792043
1326,0.1565,52,288,52,413136,263308,49329,76927,2.085508807502218,0.22609960762414213
1327,0.1566,39,259,39,413395,263049,49368,76888,2.0834574198453937,0.22618308686609578
1328,0.1567,73,353,73,413748,262696,49441,76815,2.0806615131162083,0.22625187401880942
1329,0.1568,54,286,54,414034,262410,49495,76761,2.078396274236472,0.2263194671714268
1330,0.1569,71,377,71,414411,262033,49566,76690,2.0754102775313648,0.22640918980996272
1331,0.157,51,327,51,414738,261706,49617,76639,2.0728203016094287,0.22651140108469167
1332,0.1571,45,297,45,415035,261409,49662,76594,2.0704679381573947,0.22660745614683894
1333,0.1572,32,221,32,415256,261188,49694,76562,2.06871752629578,0.22668245743893412
1334,0.1573,55,273,55,415529,260915,49749,76507,2.066555252819668,0.22673980949671332
1335,0.1574,59,315,59,415844,260600,49808,76448,2.0640603218856928,0.22681635850086634
1336,0.1575,64,373,64,416217,260227,49872,76384,2.061106006843239,0.22692068886637692
1337,0.1576,75,437,75,416654,259790,49947,76309,2.057644785198327,0.22704322238388094
1338,0.1577,44,218,44,416872,259572,49991,76265,2.055918134583703,0.22708933202714413
1339,0.1578,49,197,49,417069,259375,50040,76216,2.05435781269801,0.2271097854233278
1340,0.1579,55,269,55,417338,259106,50095,76161,2.0522272208845522,0.22716521459016248
1341,0.158,65,317,65,417655,258789,50160,76096,2.04971644911925,0.22723024321782104
1342,0.1581,64,417,64,418072,258372,50224,76032,2.046413635787606,0.22736570136720852
1343,0.1582,46,267,46,418339,258105,50270,75986,2.0442988848054746,0.22744102654665943
1344,0.1583,64,344,64,418683,257761,50334,75922,2.04157426181726,0.22752732383729468
1345,0.1584,65,284,65,418967,257477,50399,75857,2.039324863768851,0.2275705448589103
1346,0.1585,92,412,92,419379,257065,50491,75765,2.036061652515524,0.2276387344890785
1347,0.1586,44,257,44,419636,256808,50535,75721,2.0340261056900264,0.22771247019056984
1348,0.1587,53,296,53,419932,256512,50588,75668,2.0316816626536562,0.22779216087663315
1349,0.1588,70,330,70,420262,256182,50658,75598,2.0290679254847293,0.22785580806558564
1350,0.1589,66,353,66,420615,255829,50724,75532,2.0262720187555443,0.22794474908030818
1351,0.159,86,411,86,421026,255418,50810,75446,2.0230167279178812,0.22802722568789593
1352,0.1591,48,278,48,421304,255140,50858,75398,2.020814852363452,0.22810690450114662
1353,0.1592,69,408,69,421712,254732,50927,75329,2.0175833227727793,0.22822750946037249
1354,0.1593,59,336,59,422048,254396,50986,75270,2.014922063109872,0.22832199862891533
1355,0.1594,61,301,61,422349,254095,51047,75209,2.012538017995184,0.22838775113572868
1356,0.1595,71,392,71,422741,253703,51118,75138,2.009433215055126,0.22849340562764375
1357,0.1596,49,231,49,422972,253472,51167,75089,2.0076035990368775,0.2285389927593354
1358,0.1597,76,286,76,423258,253186,51243,75013,2.005338360157141,0.22855950200945158
1359,0.1598,35,244,35,423502,252942,51278,74978,2.003405778735268,0.22864723103195903
1360,0.1599,89,462,89,423964,252480,51367,74889,1.9997465466987707,0.2287602063726254
1361,0.16,65,409,65,424373,252071,51432,74824,1.9965070966924343,0.2288930696400985
1362,0.1601,81,399,81,424772,251672,51513,74743,1.9933468508427323,0.22898151126633273
1363,0.1602,76,308,76,425080,251364,51589,74667,1.9909073628184006,0.2290180995058752
1364,0.1603,71,431,71,425511,250933,51660,74596,1.9874936636674694,0.22915316300544653
1365,0.1604,62,327,62,425838,250606,51722,74534,1.9849036877455328,0.22923663652580428
1366,0.1605,34,262,34,426100,250344,51756,74500,1.9828285388417184,0.2293408528401325
1367,0.1606,59,279,59,426379,250065,51815,74441,1.980618742871626,0.2293979156009442
1368,0.1607,47,250,47,426629,249815,51862,74394,1.9786386389557724,0.22946309325157538
1369,0.1608,47,283,47,426912,249532,51909,74347,1.9763971613230262,0.22955177705254123
1370,0.1609,57,311,57,427223,249221,51966,74290,1.9739339120517045,0.22963670477974474
1371,0.161,52,242,52,427465,248979,52018,74238,1.9720171714611583,0.22968470099035632
1372,0.1611,113,449,113,427914,248530,52131,74125,1.9684609048282853,0.22973454618710387
1373,0.1612,78,459,78,428373,248071,52209,74047,1.9648254340387783,0.2298753872804376
1374,0.1613,57,268,57,428641,247803,52266,73990,1.9627027626409834,0.22993042110922238
1375,0.1614,54,304,54,428945,247499,52320,73936,1.9602949562793055,0.2300185107408963
1376,0.1615,33,191,33,429136,247308,52353,73903,1.9587821568875934,0.23007618045459216
1377,0.1616,84,388,84,429524,246920,52437,73819,1.9557090356101887,0.23015286572571467
1378,0.1617,46,277,46,429801,246643,52483,73773,1.9535150804714232,0.23024131129531608
1379,0.1618,66,288,66,430089,246355,52549,73707,1.95123400076036,0.2302897563597053
1380,0.1619,76,369,76,430458,245986,52625,73631,1.94831136738056,0.23037260220826802
1381,0.162,50,272,50,430730,245714,52675,73581,1.9461570143201115,0.2304483314802925
1382,0.1621,40,199,40,430929,245515,52715,73541,1.944580851603092,0.2304955869815957
1383,0.1622,46,251,46,431180,245264,52761,73495,1.9425928272715751,0.2305660389196854
1384,0.1623,86,434,86,431614,244830,52847,73409,1.9391553668736534,0.2306725448483687
1385,0.1624,65,239,65,431853,244591,52912,73344,1.9372623875300976,0.23068866277698272
1386,0.1625,74,333,74,432186,244258,52986,73270,1.9346248891141806,0.23075130382202513
1387,0.1626,88,456,88,432642,243802,53074,73182,1.9310131795716639,0.2308696968932186
1388,0.1627,54,245,54,432887,243557,53128,73128,1.9290726777341274,0.23091715742772786
1389,0.1628,51,212,51,433099,243345,53179,73077,1.9273935496134837,0.2309479113335988
1390,0.1629,49,265,49,433364,243080,53228,73028,1.925294639462679,0.23102230883115898
1391,0.163,51,318,51,433682,242762,53279,72977,1.9227759472817134,0.23113077573565508
1392,0.1631,55,277,55,433959,242485,53334,72922,1.9205819921429477,0.23119968802214283
1393,0.1632,47,269,47,434228,242216,53381,72875,1.9184514003294892,0.2312823914361248
1394,0.1633,110,708,110,434936,241508,53491,72765,1.9128437460397922,0.2315343666175586
1395,0.1634,85,296,85,435232,241212,53576,72680,1.9104993030034216,0.2315446076994635
1396,0.1635,65,297,65,435529,240915,53641,72615,1.9081469395513877,0.23160463113577648
1397,0.1636,61,284,61,435813,240631,53702,72554,1.905897541502978,0.23166499034117216
1398,0.1637,87,370,87,436183,240261,53789,72467,1.9029669877075148,0.23172533319689953
1399,0.1638,55,277,55,436460,239984,53844,72412,1.9007730325687493,0.23179554155622992
1400,0.1639,64,332,64,436792,239652,53908,72348,1.8981434545684956,0.23188461538461538
1401,0.164,62,251,62,437043,239401,53970,72286,1.8961554302369787,0.23191855932393715
1402,0.1641,53,199,53,437242,239202,54023,72233,1.8945792675199595,0.23193603801756385
1403,0.1642,54,220,54,437462,238982,54077,72179,1.8928367760740084,0.2319667310491996
1404,0.1643,67,334,67,437796,238648,54144,72112,1.890191357242428,0.23205045694426568
1405,0.1644,51,172,51,437968,238476,54195,72061,1.8888290457483208,0.23205286326589103
1406,0.1645,37,233,37,438201,238243,54232,72024,1.8869835888987454,0.23213554777014636
1407,0.1646,57,201,57,438402,238042,54289,71967,1.885391585350399,0.23214487321335833
1408,0.1647,56,321,56,438723,237721,54345,71911,1.8828491319224432,0.23224666701116164
1409,0.1648,53,271,53,438994,237450,54398,71858,1.880702699277658,0.23231859505735383
1410,0.1649,73,354,73,439348,237096,54471,71785,1.8778988721328096,0.23240341749735335
1411,0.165,62,299,62,439647,236797,54533,71723,1.8755306678494488,0.23247439388046157
1412,0.1651,66,352,66,439999,236445,54599,71657,1.872742681535927,0.23257557562106057
1413,0.1652,44,190,44,440189,236255,54643,71613,1.8712378025598784,0.23260943001546117
1414,0.1653,48,255,48,440444,236000,54691,71565,1.8692180965657077,0.23268252239364037
1415,0.1654,78,386,78,440830,235614,54769,71487,1.86616081611963,0.2327800951478504
1416,0.1655,76,384,76,441214,235230,54845,71411,1.863119376504879,0.23288144768638244
1417,0.1656,70,340,70,441554,234890,54915,71341,1.8604264351793183,0.23296465739915292
1418,0.1657,76,412,76,441966,234478,54991,71265,1.8571632239259916,0.23308792024674319
1419,0.1658,71,313,71,442279,234165,55062,71194,1.854684133823343,0.23314852354114338
1420,0.1659,72,285,72,442564,233880,55134,71122,1.85242681535927,0.23318535616159894
1421,0.166,108,480,108,443044,233400,55242,71014,1.8486250158408313,0.2332809923328099
1422,0.1661,38,298,38,443342,233102,55280,70976,1.846264731973134,0.23341379514466684
1423,0.1662,86,421,86,443763,232681,55366,70890,1.8429302369788367,0.23352032967575953
1424,0.1663,65,272,65,444035,232409,55431,70825,1.840775883918388,0.23356549727273326
1425,0.1664,68,405,68,444440,232004,55499,70757,1.8375681155747055,0.23370579433942945
1426,0.1665,73,371,73,444811,231633,55572,70684,1.8346296413635788,0.23380755961457675
1427,0.1666,51,246,51,445057,231387,55623,70633,1.832681219110379,0.23386861797231973
1428,0.1667,52,261,52,445318,231126,55675,70581,1.8306139906222278,0.233938887728823
1429,0.1668,65,325,65,445643,230801,55740,70516,1.8280398555316184,0.2340259593716916
1430,0.1669,42,189,42,445832,230612,55782,70474,1.826542896971233,0.23406601436134528
1431,0.167,48,241,48,446073,230371,55830,70426,1.8246340767963503,0.23413132444804968
1432,0.1671,66,337,66,446410,230034,55896,70360,1.8219648967177797,0.23422571689181543
1433,0.1672,63,274,63,446684,229760,55959,70297,1.8197947028260044,0.23427882035746542
1434,0.1673,43,216,43,446900,229544,56002,70254,1.8180838930427068,0.23433778744354533
1435,0.1674,61,271,61,447171,229273,56063,70193,1.8159374603979217,0.2343938877869274
1436,0.1675,61,343,61,447514,228930,56124,70132,1.8132207578253707,0.23450655716874763
1437,0.1676,51,276,51,447790,228654,56175,70081,1.8110347231022683,0.23459253184260298
1438,0.1677,64,242,64,448032,228412,56239,70017,1.8091179825117223,0.23461861950413665
1439,0.1678,46,225,46,448257,228187,56285,69971,1.807335888987454,0.2346775870511608
1440,0.1679,75,319,75,448576,227868,56360,69896,1.804809276390825,0.2347362340645612
1441,0.168,68,322,68,448898,227546,56428,69828,1.8022589025472058,0.23481541762225347
1442,0.1681,53,270,53,449168,227276,56481,69775,1.8001203903180838,0.23489232488697226
1443,0.1682,43,213,43,449381,227063,56524,69732,1.7984333417817766,0.23495004969760272
1444,0.1683,74,353,74,449734,226710,56598,69658,1.7956374350525917,0.2350388705933164
1445,0.1684,68,307,68,450041,226403,56666,69590,1.7932058674439235,0.23510691131209183
1446,0.1685,42,252,42,450293,226151,56708,69548,1.791209922696743,0.23519863104034847
1447,0.1686,60,279,60,450572,225872,56768,69488,1.7890001267266507,0.23526543878656556
1448,0.1687,41,269,41,450841,225603,56809,69447,1.7868695349131922,0.23537366548042704
1449,0.1688,37,185,37,451026,225418,56846,69410,1.7854042580154605,0.23542540057253722
1450,0.1689,75,384,75,451410,225034,56921,69335,1.7823628184007096,0.23553770947348396
1451,0.169,66,383,66,451793,224651,56987,69269,1.779329299201622,0.2356729722373435
1452,0.1691,79,420,79,452213,224231,57066,69190,1.7760027246229881,0.2358045266017088
1453,0.1692,71,322,71,452535,223909,57137,69119,1.773452350779369,0.23587848260234517
1454,0.1693,44,213,44,452748,223696,57181,69075,1.7717653022430617,0.23593525315007294
1455,0.1694,59,251,59,452999,223445,57240,69016,1.7697772779115448,0.23598360123230105
1456,0.1695,63,320,63,453319,223125,57303,68953,1.7672427448992523,0.23607734920124077
1457,0.1696,71,307,71,453626,222818,57374,68882,1.7648111772905841,0.2361398697291738
1458,0.1697,48,282,48,453908,222536,57422,68834,1.7625776200735015,0.23624257816521949
1459,0.1698,65,285,65,454193,222251,57487,68769,1.7603203016094284,0.2363033468490138
1460,0.1699,38,212,38,454405,222039,57525,68731,1.7586411734887848,0.23637582969357224
1461,0.17,74,347,74,454752,221692,57599,68657,1.75589278925358,0.23646370402515593
1462,0.1701,71,339,71,455091,221353,57670,68586,1.7532077683436826,0.23655320601919713
1463,0.1702,66,253,66,455344,221100,57736,68520,1.7512039031808389,0.23658587114149576
1464,0.1703,35,199,35,455543,220901,57771,68485,1.7496277404638196,0.23665623077826847
1465,0.1704,77,288,77,455831,220613,57848,68408,1.7473466607527564,0.23668868352126662
1466,0.1705,67,244,67,456075,220369,57915,68341,1.7454140793308832,0.23671157909320772
1467,0.1706,31,161,31,456236,220208,57946,68310,1.7441388924090737,0.2367616578515032
1468,0.1707,32,196,32,456432,220012,57978,68278,1.7425864909390445,0.23683790627493148
1469,0.1708,54,256,54,456688,219756,58032,68224,1.7405588645292105,0.23690534064865615
1470,0.1709,38,159,38,456847,219597,58070,68186,1.7392995184387277,0.2369354687385982
1471,0.171,61,269,61,457116,219328,58131,68125,1.7371689266252692,0.2369952653129381
1472,0.1711,35,212,35,457328,219116,58166,68090,1.7354897985046256,0.23707721983524022
1473,0.1712,86,414,86,457742,218702,58252,68004,1.732210746419972,0.2371907110419733
1474,0.1713,52,290,52,458032,218412,58304,67952,1.7299138258775821,0.23729239708901956
1475,0.1714,71,349,71,458381,218063,58375,67881,1.7271496008110505,0.2373926363203984
1476,0.1715,87,469,87,458850,217594,58462,67794,1.7234349258649093,0.23755028242252652
1477,0.1716,69,303,69,459153,217291,58531,67725,1.721035039918895,0.2376182389760575
1478,0.1717,55,313,55,459466,216978,58586,67670,1.7185559498162464,0.23773221663247238
1479,0.1718,55,239,55,459705,216739,58641,67615,1.7166629704726903,0.23778459244462888
1480,0.1719,84,371,84,460076,216368,58725,67531,1.7137244962615639,0.2378698058112216
1481,0.172,53,274,53,460350,216094,58778,67478,1.7115543023697883,0.2379572031089106
1482,0.1721,71,307,71,460657,215787,58849,67407,1.7091227347611202,0.238024110680311
1483,0.1722,50,232,50,460889,215555,58899,67357,1.7072851983272082,0.23808463409116615
1484,0.1723,52,232,52,461121,215323,58951,67305,1.705447661893296,0.23813988706002237
1485,0.1724,56,335,56,461456,214988,59007,67249,1.7027943226460525,0.23827138185284
1486,0.1725,96,354,96,461810,214634,59103,67153,1.699990495501204,0.2383112066915791
1487,0.1726,71,320,71,462130,214314,59174,67082,1.6974559624889114,0.23839002686605354
1488,0.1727,39,229,39,462359,214085,59213,67043,1.6956421873019896,0.23847855780996557
1489,0.1728,82,259,82,462618,213826,59295,66961,1.6935907996451653,0.23847614027714958
1490,0.1729,42,208,42,462826,213618,59337,66919,1.6919433531871753,0.23853894495200276
1491,0.173,77,357,77,463183,213261,59414,66842,1.6891157647953365,0.23863364548041258
1492,0.1731,54,241,54,463424,213020,59468,66788,1.6872069446204536,0.2386922461116194
1493,0.1732,54,298,54,463722,212722,59522,66734,1.6848466607527564,0.23879966792625673
1494,0.1733,46,241,46,463963,212481,59568,66688,1.6829378405778734,0.23888039144747447
1495,0.1734,58,285,58,464248,212196,59626,66630,1.6806805221138006,0.23896623700802652
1496,0.1735,62,256,62,464504,211940,59688,66568,1.6786528957039666,0.23901647349447772
1497,0.1736,68,360,68,464864,211580,59756,66500,1.6758015460651374,0.2391398158803222
1498,0.1737,41,211,41,465075,211369,59797,66459,1.6741303383601571,0.23920915098550183
1499,0.1738,44,213,44,465288,211156,59841,66415,1.67244328982385,0.23927211416178204
1500,0.1739,47,194,47,465482,210962,59888,66368,1.6709067291851476,0.23931056863664227
1501,0.174,84,292,84,465774,210670,59972,66284,1.6685939678114308,0.23933216346396874
1502,0.1741,85,302,85,466076,210368,60057,66199,1.6662020022810797,0.23935972115255977
1503,0.1742,56,245,56,466321,210123,60113,66143,1.6642615004435433,0.23941780747540414
1504,0.1743,71,443,71,466764,209680,60184,66072,1.660752756304651,0.23960660303461082
1505,0.1744,66,259,66,467023,209421,60250,66006,1.6587013686478267,0.23964970754501191
1506,0.1745,34,304,34,467327,209117,60284,65972,1.6562935622861488,0.23982056716190034
1507,0.1746,53,224,53,467551,208893,60337,65919,1.654519389177544,0.23986943801580718
1508,0.1747,53,294,53,467845,208599,60390,65866,1.6521907869725003,0.23997959666988505
1509,0.1748,48,203,48,468048,208396,60438,65818,1.6505829425928273,0.24002421466445914
1510,0.1749,62,349,62,468397,208047,60500,65756,1.6478187175262957,0.2401580698531426
1511,0.175,49,188,49,468585,207859,60549,65707,1.646329679381574,0.2401870115438322
1512,0.1751,30,147,30,468732,207712,60579,65677,1.645165378279052,0.2402327818602797
1513,0.1752,58,268,58,469000,207444,60637,65619,1.6430427068812572,0.2403071818591314
1514,0.1753,53,243,53,469243,207201,60690,65566,1.6411180458750476,0.24037365223799068
1515,0.1754,62,278,62,469521,206923,60752,65504,1.6389161703206183,0.2404460644502931
1516,0.1755,47,258,47,469779,206665,60799,65457,1.6368727030794576,0.24054284475345616
1517,0.1756,39,196,39,469975,206469,60838,65418,1.6353203016094284,0.2406073111255779
1518,0.1757,55,286,55,470261,206183,60893,65363,1.633055062729692,0.2407069152187843
1519,0.1758,64,272,64,470533,205911,60957,65299,1.6309007096692434,0.240769145680469
1520,0.1759,94,347,94,470880,205564,61051,65205,1.6281523254340389,0.24081412569385713
1521,0.176,55,268,55,471148,205296,61106,65150,1.6260296540362438,0.24089836788120364
1522,0.1761,49,229,49,471377,205067,61155,65101,1.624215878849322,0.2409648811110124
1523,0.1762,53,286,53,471663,204781,61208,65048,1.6219506399695856,0.24107119694324924
1524,0.1763,52,245,52,471908,204536,61260,64996,1.620010138132049,0.24114390870100766
1525,0.1764,44,184,44,472092,204352,61304,64952,1.618552781649981,0.24118468348037905
1526,0.1765,43,177,43,472269,204175,61347,64909,1.6171508680775568,0.24122207191806277
1527,0.1766,54,257,54,472526,203918,61401,64855,1.6151153212520593,0.2413002794179475
1528,0.1767,35,153,35,472679,203765,61436,64820,1.613903497655557,0.24133886851462294
1529,0.1768,69,280,69,472959,203485,61505,64751,1.611685781269801,0.2413956366781491
1530,0.1769,66,365,66,473324,203120,61571,64685,1.6087948295526548,0.24153768600287523
1531,0.177,50,211,50,473535,202909,61621,64635,1.6071236218476745,0.2415864306431839
1532,0.1771,50,183,50,473718,202726,61671,64585,1.6056741857812697,0.24160995993430873
1533,0.1772,46,222,46,473940,202504,61717,64539,1.603915853503992,0.24168017884760132
1534,0.1773,87,300,87,474240,202204,61804,64452,1.6015397288049678,0.24170466818672748
1535,0.1774,33,178,33,474418,202026,61837,64419,1.60012989481688,0.24177222316050218
1536,0.1775,49,220,49,474638,201806,61886,64370,1.5983874033709289,0.24183247174801634
1537,0.1776,92,367,92,475005,201439,61978,64278,1.595480610822456,0.2419039805507363
1538,0.1777,61,340,61,475345,201099,62039,64217,1.5927876694968952,0.2420396809841849
1539,0.1778,55,251,55,475596,200848,62094,64162,1.5907996451653783,0.24211161842949322
1540,0.1779,47,243,47,475839,200605,62141,64115,1.5888749841591687,0.2421993049259595
1541,0.178,35,162,35,476001,200443,62176,64080,1.5875918768216957,0.24224736601354135
1542,0.1781,57,270,57,476271,200173,62233,64023,1.585453364592574,0.2423314508925192
1543,0.1782,54,235,54,476506,199938,62287,63969,1.5835920669116714,0.24239220634541714
1544,0.1783,83,376,83,476882,199562,62370,63886,1.5806139906222278,0.242499468585831
1545,0.1784,70,317,70,477199,199245,62440,63816,1.5781032188569255,0.2425901216828036
1546,0.1785,116,446,116,477645,198799,62556,63700,1.574570713471043,0.24266759111463282
1547,0.1786,61,279,61,477924,198520,62617,63639,1.5723609175009505,0.2427496290419173
1548,0.1787,41,236,41,478160,198284,62658,63598,1.5704916994043847,0.2428498331309521
1549,0.1788,54,259,54,478419,198025,62712,63544,1.5684403117475605,0.24293398682565595
1550,0.1789,48,270,48,478689,197755,62760,63496,1.5663017995184387,0.2430459596326904
1551,0.179,67,332,67,479021,197423,62827,63429,1.5636722215181853,0.24316087283210402
1552,0.1791,39,172,39,479193,197251,62866,63390,1.562309910024078,0.2432080908222421
1553,0.1792,38,210,38,479403,197041,62904,63352,1.560646622734761,0.24329379053968425
1554,0.1793,62,273,62,479676,196768,62966,63290,1.558484349258649,0.24336878696290828
1555,0.1794,58,335,58,480011,196433,63024,63232,1.5558310100114054,0.2435137581114128
1556,0.1795,58,286,58,480297,196147,63082,63174,1.553565771131669,0.2436131281307723
1557,0.1796,50,209,50,480506,195938,63132,63124,1.5519104042580154,0.243663678964881
1558,0.1797,61,275,61,480781,195663,63193,63063,1.5497322899505765,0.2437443473017787
1559,0.1798,49,236,49,481017,195427,63242,63014,1.547863071854011,0.24382354193026648
1560,0.1799,64,253,64,481270,195174,63306,62950,1.5458592066911672,0.24387503680401668
1561,0.18,52,252,52,481522,194922,63358,62898,1.543863261943987,0.2439609029555504
1562,0.1801,62,257,62,481779,194665,63420,62836,1.5418277151184894,0.24402235331124927
1563,0.1802,71,290,71,482069,194375,63491,62765,1.5395307945760994,0.24408882320914677
1564,0.1803,66,298,66,482367,194077,63557,62699,1.537170510708402,0.24417780477926285
1565,0.1804,64,285,64,482652,193792,63621,62635,1.5349131922443289,0.24426054978609896
1566,0.1805,70,395,70,483047,193397,63691,62565,1.5317846280572804,0.24443081394894556
1567,0.1806,49,223,49,483270,193174,63740,62516,1.530018375364339,0.2444991982478783
1568,0.1807,44,257,44,483527,192917,63784,62472,1.5279828285388417,0.24461507739174357
1569,0.1808,40,265,40,483792,192652,63824,62432,1.525883918388037,0.24475074877295322
1570,0.1809,60,241,60,484033,192411,63884,62372,1.5239750982131541,0.24480440217753932
1571,0.181,68,334,68,484367,192077,63952,62304,1.521329679381574,0.24492395265369662
1572,0.1811,65,219,65,484586,191858,64017,62239,1.5195951083512862,0.24494189226948765
1573,0.1812,40,234,40,484820,191624,64057,62199,1.5177417310860475,0.2450487150494636
1574,0.1813,65,274,65,485094,191350,64122,62134,1.515571537194272,0.24512000757444258
1575,0.1814,56,257,56,485351,191093,64178,62078,1.5135359903687746,0.24520185961267285
1576,0.1815,56,215,56,485566,190878,64234,62022,1.5118331010011405,0.2452431791221827
1577,0.1816,47,251,47,485817,190627,64281,61975,1.5098450766696236,0.245346434311684
1578,0.1817,25,161,25,485978,190466,64306,61950,1.508569889747814,0.24542818204868155
1579,0.1818,69,282,69,486260,190184,64375,61881,1.5063363325307313,0.24549620137662903
1580,0.1819,98,413,98,486673,189771,64473,61783,1.5030652008617413,0.24560531734736876
1581,0.182,68,297,68,486970,189474,64541,61715,1.5007128374097072,0.24569149126753162
1582,0.1821,43,244,43,487214,189230,64584,61672,1.4987802559878343,0.2458011494527744
1583,0.1822,60,301,60,487515,188929,64644,61612,1.4963962108731466,0.2459158381262947
1584,0.1823,54,299,54,487814,188630,64698,61558,1.4940280065897857,0.24604697267654724
1585,0.1824,39,203,39,488017,188427,64737,61519,1.4924201622101128,0.24612916389940226
1586,0.1825,55,212,55,488229,188215,64792,61464,1.4907410340894691,0.2461720849570849
1587,0.1826,50,208,50,488437,188007,64842,61414,1.4890935876314788,0.24622626001820216
1588,0.1827,52,279,52,488716,187728,64894,61362,1.4868837916613864,0.24634469468866674
1589,0.1828,55,251,55,488967,187477,64949,61307,1.4848957673298695,0.24642661907518168
1590,0.1829,84,318,84,489285,187159,65033,61223,1.4823770751489038,0.24648726558285222
1591,0.183,49,224,49,489509,186935,65082,61174,1.480602902040299,0.2465609873079977
1592,0.1831,61,209,61,489718,186726,65143,61113,1.4789475351666455,0.24658346749300958
1593,0.1832,48,261,48,489979,186465,65191,61065,1.4768803066784946,0.24669737001575567
1594,0.1833,48,145,48,490124,186320,65239,61017,1.4757318464072995,0.24669580370102331
1595,0.1834,54,242,54,490366,186078,65293,60963,1.4738151058167532,0.246772802895066
1596,0.1835,72,292,72,490658,185786,65365,60891,1.4715023444430364,0.2468450645986452
1597,0.1836,67,258,67,490916,185528,65432,60824,1.4694588772018755,0.2468987465090602
1598,0.1837,54,256,54,491172,185272,65486,60770,1.4674312507920415,0.24699035124084506
1599,0.1838,90,353,90,491525,184919,65576,60680,1.4646353440628563,0.2470694098917341
1600,0.1839,45,177,45,491702,184742,65621,60635,1.4632334304904322,0.24710954979480554
1601,0.184,53,270,53,491972,184472,65674,60582,1.4610949182613104,0.24721898030638145
1602,0.1841,88,351,88,492323,184121,65762,60494,1.458314852363452,0.24730290456431536
1603,0.1842,59,267,59,492590,183854,65821,60435,1.4562001013813204,0.24739140935531276
1604,0.1843,57,269,57,492859,183585,65878,60378,1.4540695095678622,0.24748834864303193
1605,0.1844,48,228,48,493087,183357,65926,60330,1.4522636547966037,0.2475716800650014
1606,0.1845,56,204,56,493291,183153,65982,60274,1.4506478900012674,0.2476060584898142
1607,0.1846,58,283,58,493574,182870,66040,60216,1.4484064123685212,0.2477148005232716
1608,0.1847,71,282,71,493856,182588,66111,60145,1.4461728551514383,0.2477825429587242
1609,0.1848,34,212,34,494068,182376,66145,60111,1.4444937270307945,0.2478937015180195
1610,0.1849,53,273,53,494341,182103,66198,60058,1.4423314535546825,0.24800855629106255
1611,0.185,42,224,42,494565,181879,66240,60016,1.4405572804460778,0.24810765001343557
1612,0.1851,76,280,76,494845,181599,66316,59940,1.4383395640603218,0.2481586824487971
1613,0.1852,83,339,83,495184,181260,66399,59857,1.4356545431504246,0.24824877549073687
1614,0.1853,70,369,70,495553,180891,66469,59787,1.4327319097706248,0.2484107396604592
1615,0.1854,44,224,44,495777,180667,66513,59743,1.43095773666202,0.2485046379102367
1616,0.1855,50,263,50,496040,180404,66563,59693,1.428874667342542,0.24862034927550114
1617,0.1856,68,280,68,496320,180124,66631,59625,1.4266569509567861,0.24869759623606355
1618,0.1857,43,224,43,496544,179900,66674,59582,1.4248827778481814,0.2487953165582382
1619,0.1858,66,264,66,496808,179636,66740,59516,1.42279178811304,0.24886264802301467
1620,0.1859,37,142,37,496950,179494,66777,59479,1.4216670890888354,0.24889422654442134
1621,0.186,64,296,64,497246,179198,66841,59415,1.4193226460524648,0.24900152129179887
1622,0.1861,70,267,70,497513,178931,66911,59345,1.4172078950703333,0.2490599137135087
1623,0.1862,35,190,35,497703,178741,66946,59310,1.4157030160942847,0.24914829175260764
1624,0.1863,70,299,70,498002,178442,67016,59240,1.413334811810924,0.24924058195403942
1625,0.1864,44,241,44,498243,178201,67060,59196,1.411425991636041,0.24935445688024702
1626,0.1865,57,261,57,498504,177940,67117,59139,1.40935876314789,0.24944849607092995
1627,0.1866,54,175,54,498679,177765,67171,59085,1.4079726904067926,0.249461684610513
1628,0.1867,42,176,42,498855,177589,67213,59043,1.4065786972500316,0.249514013320261
1629,0.1868,53,251,53,499106,177338,67266,58990,1.4045906729185147,0.2496107105378965
1630,0.1869,66,262,66,499368,177076,67332,58924,1.4025155240147003,0.2496779661016949
1631,0.187,69,312,69,499680,176764,67401,58855,1.400044354327715,0.24978885403978457
1632,0.1871,46,239,46,499919,176525,67447,58809,1.3981513749841592,0.24989589264619647
1633,0.1872,43,216,43,500135,176309,67490,58766,1.3964405652008618,0.24998830160587046
1634,0.1873,44,253,44,500388,176056,67534,58722,1.394436700038018,0.250117131928886
1635,0.1874,35,162,35,500550,175894,67569,58687,1.393153592700545,0.2501779769035003
1636,0.1875,56,226,56,500776,175668,67625,58631,1.3913635787606133,0.2502400778492439
1637,0.1876,56,279,56,501055,175389,67681,58575,1.389153782790521,0.25035902959429657
1638,0.1877,69,241,69,501296,175148,67750,58506,1.387244962615638,0.2503958845129978
1639,0.1878,65,237,65,501533,174911,67815,58441,1.3853678241034089,0.2504413932599678
1640,0.1879,62,288,62,501821,174623,67877,58379,1.3830867443923458,0.25055149741203936
1641,0.188,45,170,45,501991,174453,67922,58334,1.3817402737295654,0.2505895947797772
1642,0.1881,64,261,64,502252,174192,67986,58270,1.3796730452414143,0.2506646247558741
1643,0.1882,58,230,58,502482,173962,68044,58212,1.377851349638829,0.2507257487918544
1644,0.1883,53,248,53,502730,173714,68097,58159,1.3758870865543025,0.2508226486050554
1645,0.1884,76,391,76,503121,173323,68173,58083,1.3727902040299076,0.2510004062124578
1646,0.1885,88,332,88,503453,172991,68261,57995,1.370160626029654,0.251075822777138
1647,0.1886,55,206,55,503659,172785,68316,57940,1.3685290204029907,0.25112146494744825
1648,0.1887,54,165,54,503824,172620,68370,57886,1.3672221518185275,0.2511257841444474
1649,0.1888,31,171,31,503995,172449,68401,57855,1.3658677607400835,0.2512114422676115
1650,0.1889,48,244,48,504239,172205,68449,57807,1.3639351793182106,0.2513216701737301
1651,0.189,70,245,70,504484,171960,68519,57737,1.3619946774806742,0.25136157633752293
1652,0.1891,59,256,59,504740,171704,68578,57678,1.3599670510708401,0.25144954704379596
1653,0.1892,44,234,44,504974,171470,68622,57634,1.3581136738056012,0.2515626091207487
1654,0.1893,46,188,46,505162,171282,68668,57588,1.3566246356608795,0.25161882291257043
1655,0.1894,59,279,59,505441,171003,68727,57529,1.354414839690787,0.2517327989078116
1656,0.1895,64,229,64,505670,170774,68791,57465,1.352601064503865,0.2517755510670832
1657,0.1896,60,279,60,505949,170495,68851,57405,1.3503912685337727,0.2518867924528302
1658,0.1897,52,240,52,506189,170255,68903,57353,1.3484903687745533,0.25198147692523987
1659,0.1898,74,317,74,506506,169938,68977,57279,1.345979597009251,0.2520894123239018
1660,0.1899,54,271,54,506777,169667,69031,57225,1.3438331643644659,0.2522125063907057
1661,0.19,59,216,59,506993,169451,69090,57166,1.3421223545811685,0.25225821540308097
1662,0.1901,75,293,75,507286,169158,69165,57091,1.339801672791788,0.2523370269039863
1663,0.1902,76,265,76,507551,168893,69241,57015,1.3377027626409834,0.2523815004338049
1664,0.1903,50,194,50,507745,168699,69291,56965,1.336166202002281,0.2524328204764606
1665,0.1904,70,329,70,508074,168370,69361,56895,1.3335603852490179,0.25256919627993696
1666,0.1905,39,192,39,508266,168178,69400,56856,1.3320396654416424,0.25265515433223423
1667,0.1906,43,171,43,508437,168007,69443,56813,1.3306852743631985,0.2527043857308069
1668,0.1907,40,188,40,508625,167819,69483,56773,1.3291962362184768,0.2527828239652347
1669,0.1908,66,319,66,508944,167500,69549,56707,1.3266696236218476,0.2529225224903772
1670,0.1909,39,157,39,509101,167343,69588,56668,1.3254261183626916,0.25296972023695263
1671,0.191,56,232,56,509333,167111,69644,56612,1.3235885819287796,0.2530450601860336
1672,0.1911,54,240,54,509573,166871,69698,56558,1.3216876821695602,0.25313634308885596
1673,0.1912,57,268,57,509841,166603,69755,56501,1.3195650107717654,0.2532496055651176
1674,0.1913,53,231,53,510072,166372,69808,56448,1.3177353947535166,0.2533345301139934
1675,0.1914,48,204,48,510276,166168,69856,56400,1.31611962995818,0.2534057007296646
1676,0.1915,74,283,74,510559,165885,69930,56326,1.3138781523254341,0.25347980072993687
1677,0.1916,42,171,42,510730,165714,69972,56284,1.3125237612469902,0.2535338156199605
1678,0.1917,64,265,64,510995,165449,70036,56220,1.3104248510961856,0.2536213904515291
1679,0.1918,60,243,60,511238,165206,70096,56160,1.308500190089976,0.25369749645383666
1680,0.1919,60,267,60,511505,164939,70156,56100,1.3063854391078444,0.2538013653699121
1681,0.192,96,442,96,511947,164497,70252,56004,1.3028846153846154,0.25398524269731204
1682,0.1921,72,281,72,512228,164216,70324,55932,1.3006589785831961,0.25406544688118904
1683,0.1922,52,232,52,512460,163984,70376,55880,1.298821442149284,0.25415711530764473
1684,0.1923,60,274,60,512734,163710,70436,55820,1.2966512482575085,0.25427048694939186
1685,0.1924,69,301,69,513035,163409,70505,55751,1.2942672031428208,0.25438492425625114
1686,0.1925,37,145,37,513180,163264,70542,55714,1.293118742871626,0.25442738539944654
1687,0.1926,75,240,75,513420,163024,70617,55639,1.2912178431124066,0.25445091304884687
1688,0.1927,58,247,58,513667,162777,70675,55581,1.2892615004435433,0.25454070837798476
1689,0.1928,39,191,39,513858,162586,70714,55542,1.2877487010518311,0.2546303088095063
1690,0.1929,42,238,42,514096,162348,70756,55500,1.2858636421239387,0.2547647901288972
1691,0.193,63,250,63,514346,162098,70819,55437,1.283883538208085,0.2548417496035121
1692,0.1931,69,276,69,514622,161822,70888,55368,1.281697503484983,0.2549288641281827
1693,0.1932,53,216,53,514838,161606,70941,55315,1.2799866937016855,0.25500066844611635
1694,0.1933,46,202,46,515040,161404,70987,55269,1.2783867697376758,0.2550802361161751
1695,0.1934,74,341,74,515381,161063,71061,55195,1.2756859079964518,0.25522755227552274
1696,0.1935,46,168,46,515549,160895,71107,55149,1.274355278164998,0.25526744552035696
1697,0.1936,68,269,68,515818,160626,71175,55081,1.2722246863515396,0.25535100854399717
1698,0.1937,34,161,34,515979,160465,71209,55047,1.2709494994297301,0.25542429191877947
1699,0.1938,32,163,32,516142,160302,71241,55015,1.2696584716765935,0.25550699666073745
1700,0.1939,49,199,49,516341,160103,71290,54966,1.2680823089595743,0.2555737925967945
1701,0.194,46,235,46,516576,159868,71336,54920,1.2662210112786718,0.2556939866286757
1702,0.1941,76,304,76,516880,159564,71412,54844,1.2638132049169941,0.2557926943024514
1703,0.1942,35,201,35,517081,159363,71447,54809,1.2622212013686478,0.2559111368432848
1704,0.1943,52,231,52,517312,159132,71499,54757,1.260391585350399,0.25600662025630117
1705,0.1944,61,205,61,517517,158927,71560,54696,1.2587679001393992,0.25603984589674333
1706,0.1945,56,290,56,517807,158637,71616,54640,1.2564709795970093,0.2561926508718709
1707,0.1946,46,218,46,518025,158419,71662,54594,1.254744328982385,0.25629421678489106
1708,0.1947,60,221,60,518246,158198,71722,54534,1.2529939171207705,0.2563507135738864
1709,0.1948,60,252,60,518498,157946,71782,54474,1.2509979723735902,0.25644477921099706
1710,0.1949,57,203,57,518701,157743,71839,54417,1.249390127993917,0.2564903846153846
1711,0.195,70,302,70,519003,157441,71909,54347,1.246998162463566,0.25661038396887453
1712,0.1951,62,229,62,519232,157212,71971,54285,1.2451843872766444,0.25667030738024654
1713,0.1952,53,204,53,519436,157008,72024,54232,1.2435686224813078,0.2567316796061352
1714,0.1953,69,248,69,519684,156760,72093,54163,1.2416043593967812,0.2567903927025502
1715,0.1954,61,286,61,519970,156474,72154,54102,1.2393391205170448,0.2569238659676316
1716,0.1955,55,273,55,520243,156201,72209,54047,1.2371768470409328,0.2570630874015448
1717,0.1956,48,195,48,520438,156006,72257,53999,1.235632365986567,0.25713197304826074
1718,0.1957,30,136,30,520574,155870,72287,53969,1.2345551894563427,0.25719241894976624
1719,0.1958,73,286,73,520860,155584,72360,53896,1.2322899505766063,0.2572847049837693
1720,0.1959,42,156,42,521016,155428,72402,53854,1.2310543657331137,0.25732743379745987
1721,0.196,34,119,34,521135,155309,72436,53820,1.2301118362691674,0.2573531169756466
1722,0.1961,54,181,54,521316,155128,72490,53766,1.2286782410340895,0.25738412783517
1723,0.1962,65,253,65,521569,154875,72555,53701,1.2266743758712457,0.2574649048787972
1724,0.1963,42,192,42,521761,154683,72597,53659,1.2251536560638703,0.25755248581659
1725,0.1964,54,164,54,521925,154519,72651,53605,1.2238547078950703,0.2575627991005362
1726,0.1965,80,298,80,522223,154221,72731,53525,1.2214944240273728,0.25764635660855084
1727,0.1966,70,236,70,522459,153985,72801,53455,1.2196252059308073,0.2576889703046664
1728,0.1967,38,236,38,522695,153749,72839,53417,1.2177559878342414,0.25784636475097267
1729,0.1968,74,337,74,523032,153412,72913,53343,1.2150868077556711,0.2580010156949046
1730,0.1969,75,362,75,523394,153050,72988,53268,1.212219617285515,0.25818396843707286
1731,0.197,85,321,85,523715,152729,73073,53183,1.2096771638575592,0.25828023621741325
1732,0.1971,52,264,52,523979,152465,73125,53131,1.2075861741224179,0.25842428841028037
1733,0.1972,64,215,64,524194,152250,73189,53067,1.205883284754784,0.2584637414339777
1734,0.1973,64,221,64,524415,152029,73253,53003,1.2041328728931695,0.25851086659643374
1735,0.1974,60,229,60,524644,151800,73313,52943,1.2023190977062477,0.25858271100843494
1736,0.1975,41,162,41,524806,151638,73354,52902,1.2010359903687746,0.25863889703725434
1737,0.1976,47,204,47,525010,151434,73401,52855,1.199420225573438,0.2587266078937192
1738,0.1977,68,188,68,525198,151246,73469,52787,1.1979311874287162,0.2587179524880779
1739,0.1978,61,320,61,525518,150926,73530,52726,1.1953966544164238,0.2589024414196767
1740,0.1979,56,255,56,525773,150671,73586,52670,1.1933769484222532,0.25902302044349146
1741,0.198,61,194,61,525967,150477,73647,52609,1.1918403877835508,0.25904789104123377
1742,0.1981,86,342,86,526309,150135,73733,52523,1.1891316056266632,0.25917062242793276
1743,0.1982,53,254,53,526563,149881,73786,52470,1.187119820048156,0.2593019060938666
1744,0.1983,63,266,63,526829,149615,73849,52407,1.185012989481688,0.25941234123016305
1745,0.1984,50,165,50,526994,149450,73899,52357,1.1837061208972246,0.2594409510076459
1746,0.1985,39,168,39,527162,149282,73938,52318,1.1823754910657711,0.2595138888888889
1747,0.1986,69,225,69,527387,149057,74007,52249,1.180593397541503,0.25955013760146245
1748,0.1987,53,229,53,527616,148828,74060,52196,1.1787796223545812,0.25965058898439985
1749,0.1988,66,216,66,527832,148612,74126,52130,1.1770688125712838,0.25968656285181974
1750,0.1989,62,241,62,528073,148371,74188,52068,1.175159992396401,0.25976980527741605
1751,0.199,82,346,82,528419,148025,74270,51986,1.1724195285768597,0.259915704636245
1752,0.1991,47,191,47,528610,147834,74317,51939,1.1709067291851476,0.2599900887507321
1753,0.1992,79,319,79,528929,147515,74396,51860,1.1683801165885186,0.2601128526645768
1754,0.1993,70,267,70,529196,147248,74466,51790,1.166265365606387,0.2602015695495333
1755,0.1994,73,226,73,529422,147022,74539,51717,1.1644753516664554,0.2602257231846794
1756,0.1995,66,235,66,529657,146787,74605,51651,1.1626140539855532,0.2602878480936111
1757,0.1996,37,202,37,529859,146585,74642,51614,1.1610141300215435,0.2604150374118941
1758,0.1997,52,232,52,530091,146353,74694,51562,1.1591765935876315,0.26052598337670213
1759,0.1998,47,167,47,530258,146186,74741,51515,1.1578538841718413,0.2605702550821695
1760,0.1999,41,203,41,530461,145983,74782,51474,1.1562460397921683,0.2606846047493885
1761,0.2,59,204,59,530665,145779,74841,51415,1.1546302749968318,0.2607330851851476
1762,0.2001,74,285,74,530950,145494,74915,51341,1.1523729565327587,0.2608326771153504
1763,0.2002,71,269,71,531219,145225,74986,51270,1.1502423647193005,0.2609226697880353
1764,0.2003,63,272,63,531491,144953,75049,51207,1.1480880116588519,0.2610471044045677
1765,0.2004,54,195,54,531686,144758,75103,51153,1.1465435306044862,0.2611032560703585
1766,0.2005,65,237,65,531923,144521,75168,51088,1.144666392092257,0.2611740768574043
1767,0.2006,54,241,54,532164,144280,75222,51034,1.1427575719173741,0.26129207327687726
1768,0.2007,57,212,57,532376,144068,75279,50977,1.1410784437967305,0.2613601989284524
1769,0.2008,49,199,49,532575,143869,75328,50928,1.139502281079711,0.2614413979681412
1770,0.2009,45,190,45,532765,143679,75373,50883,1.1379974021036623,0.2615258889197274
1771,0.201,39,175,39,532940,143504,75412,50844,1.136611329362565,0.26161318871303024
1772,0.2011,48,193,48,533133,143311,75460,50796,1.135082689139526,0.2616907169756887
1773,0.2012,40,159,40,533292,143152,75500,50756,1.1338233430490432,0.2617529962662706
1774,0.2013,54,186,54,533478,142966,75554,50702,1.1323501457356482,0.26179854183447965
1775,0.2014,62,273,62,533751,142693,75616,50640,1.1301878722595362,0.2619314860887691
1776,0.2015,40,234,40,533985,142459,75656,50600,1.1283344949942973,0.2620960431785102
1777,0.2016,71,275,71,534260,142184,75727,50529,1.1261563806868584,0.26219819109245357
1778,0.2017,74,227,74,534487,141957,75801,50455,1.1243584463312635,0.2622237698272457
1779,0.2018,60,287,60,534774,141670,75861,50395,1.1220852870358637,0.262385130034103
1780,0.2019,54,198,54,534972,141472,75915,50341,1.1205170447345076,0.2624483220636766
1781,0.202,64,268,64,535240,141204,75979,50277,1.1183943733367128,0.26256913218543876
1782,0.2021,53,197,53,535437,141007,76032,50224,1.1168340514510202,0.26263524219399575
1783,0.2022,45,191,45,535628,140816,76077,50179,1.115321252059308,0.2627241550825938
1784,0.2023,57,175,57,535803,140641,76134,50122,1.1139351793182106,0.2627448719091228
1785,0.2024,50,209,50,536012,140432,76184,50072,1.112279812444557,0.26283962541468947
1786,0.2025,31,175,31,536187,140257,76215,50041,1.1108937397034597,0.26296125024960854
1787,0.2026,61,207,61,536394,140050,76276,49980,1.109254213661133,0.2630111035099721
1788,0.2027,70,255,70,536649,139795,76346,49910,1.1072345076669623,0.26309269655517775
1789,0.2028,32,123,32,536772,139672,76378,49878,1.1062602965403625,0.2631390134529148
1790,0.2029,73,273,73,537045,139399,76451,49805,1.1040980230642503,0.263234392507558
1791,0.203,55,208,55,537253,139191,76506,49750,1.1024505766062602,0.2633097104387084
1792,0.2031,62,240,62,537493,138951,76568,49688,1.1005496768470409,0.26340258377111836
1793,0.2032,38,176,38,537669,138775,76606,49650,1.09915568369028,0.2635000663393923
1794,0.2033,80,366,80,538035,138409,76686,49570,1.0962568115574705,0.26369966858000093
1795,0.2034,49,217,49,538252,138192,76735,49521,1.0945380813585097,0.26381230921672977
1796,0.2035,44,207,44,538459,137985,76779,49477,1.092898555316183,0.26393082331352485
1797,0.2036,48,181,48,538640,137804,76827,49429,1.091464960081105,0.26399726543931895
1798,0.2037,32,177,32,538817,137627,76859,49397,1.0900630465086807,0.26412118230815296
1799,0.2038,63,230,63,539047,137397,76922,49334,1.0882413509060955,0.26419823168086715
1800,0.2039,39,105,39,539152,137292,76961,49295,1.087409707261437,0.2641931109884397
1801,0.204,42,174,42,539326,137118,77003,49253,1.0860315549360031,0.26427394820009553
1802,0.2041,45,176,45,539502,136942,77048,49208,1.084637561779242,0.2643459575611066
1803,0.2042,49,196,49,539698,136746,77097,49159,1.083085160309213,0.26443075764503376
1804,0.2043,48,232,48,539930,136514,77145,49111,1.081247623875301,0.2645710437710438
1805,0.2044,38,167,38,540097,136347,77183,49073,1.0799249144595109,0.2646586128788696
1806,0.2045,50,187,50,540284,136160,77233,49023,1.0784437967304523,0.26472732378242064
1807,0.2046,67,223,67,540507,135937,77300,48956,1.0766775440375111,0.2647801701524666
1808,0.2047,63,195,63,540702,135742,77363,48893,1.0751330629831453,0.2648089473826739
1809,0.2048,68,189,68,540891,135553,77431,48825,1.07363610442276,0.2648092505613468
1810,0.2049,47,171,47,541062,135382,77478,48778,1.0722817133443163,0.264867506516073
1811,0.205,38,138,38,541200,135244,77516,48740,1.0711886959827652,0.2649143403774241
1812,0.2051,21,112,21,541312,135132,77537,48719,1.0703016094284628,0.26499175963144067
1813,0.2052,58,227,58,541539,134905,77595,48661,1.0685036750728678,0.26508721658694967
1814,0.2053,68,231,68,541770,134674,77663,48593,1.066674059054619,0.26514866287984196
1815,0.2054,47,189,47,541959,134485,77710,48546,1.0651771004942339,0.26523375821582135
1816,0.2055,40,149,40,542108,134336,77750,48506,1.0639969585603852,0.26528915675829406
1817,0.2056,37,151,37,542259,134185,77787,48469,1.0628009757952097,0.26535964172698107
1818,0.2057,23,143,23,542402,134042,77810,48446,1.0616683563553415,0.26547499013633774
1819,0.2058,52,228,52,542630,133814,77862,48394,1.0598625015840832,0.2655975588338602
1820,0.2059,68,257,68,542887,133557,77930,48326,1.0578269547585857,0.26569827856369205
1821,0.206,35,159,35,543046,133398,77965,48291,1.0565676086681028,0.26578934332843485
1822,0.2061,44,199,44,543245,133199,78009,48247,1.0549914459510834,0.26590280303781844
1823,0.2062,49,238,49,543483,132961,78058,48198,1.053106387023191,0.26605357724429923
1824,0.2063,43,218,43,543701,132743,78101,48155,1.0513797364085666,0.2661997368682904
1825,0.2064,65,210,65,543911,132533,78166,48090,1.0497164491192499,0.2662451625761946
1826,0.2065,22,135,22,544046,132398,78188,48068,1.0486471930046888,0.2663548812518702
1827,0.2066,37,231,37,544277,132167,78225,48031,1.0468175769864403,0.26654568863139433
1828,0.2067,48,249,48,544526,131918,78273,47983,1.04484539348625,0.266718917626917
1829,0.2068,33,168,33,544694,131750,78306,47950,1.0435147636547966,0.266833611574847
1830,0.2069,54,199,54,544893,131551,78360,47896,1.0419386009377771,0.2669088923191806
1831,0.207,49,161,49,545054,131390,78409,47847,1.0406634140159676,0.2669482305550751
1832,0.2071,44,144,44,545198,131246,78453,47803,1.0395228741604359,0.26698278124982544
1833,0.2072,55,166,55,545364,131080,78508,47748,1.0382080851603093,0.2670051669760888
1834,0.2073,48,197,48,545561,130883,78556,47700,1.0366477632746167,0.2671026917455749
1835,0.2074,47,192,47,545753,130691,78603,47653,1.0351270434672413,0.26719710222939935
1836,0.2075,55,221,55,545974,130470,78658,47598,1.0333766316056268,0.26730237886650043
1837,0.2076,51,161,51,546135,130309,78709,47547,1.032101444683817,0.2673342479309104
1838,0.2077,35,150,35,546285,130159,78744,47512,1.0309133823343049,0.2674156165046631
1839,0.2078,50,143,50,546428,130016,78794,47462,1.0297807628944367,0.26742469489176124
1840,0.2079,61,256,61,546684,129760,78855,47401,1.0277531364846026,0.26755888711398107
1841,0.208,60,224,60,546908,129536,78915,47341,1.025978963375998,0.26764927039694253
1842,0.2081,38,158,38,547066,129378,78953,47303,1.0247275377011786,0.2677311086081695
1843,0.2082,67,212,67,547278,129166,79020,47236,1.0230484095805348,0.267774741782973
1844,0.2083,68,218,68,547496,128948,79088,47168,1.0213217589659105,0.26782347997910466
1845,0.2084,70,248,70,547744,128700,79158,47098,1.0193574958813838,0.26790976006552975
1846,0.2085,58,192,58,547936,128508,79216,47040,1.0178367760740084,0.26796089958302005
1847,0.2086,48,178,48,548114,128330,79264,46992,1.0164269420859207,0.2680325344223771
1848,0.2087,54,190,54,548304,128140,79318,46938,1.014922063109872,0.268097647905505
1849,0.2088,45,156,45,548460,127984,79363,46893,1.0136864782663795,0.2681484700675332
1850,0.2089,27,92,27,548552,127892,79390,46866,1.0129578000253454,0.268176564163014
1851,0.209,56,184,56,548736,127708,79446,46810,1.011500443543277,0.26822448114234637
1852,0.2091,48,175,48,548911,127533,79494,46762,1.0101143708021798,0.268292263117129
1853,0.2092,64,190,64,549101,127343,79558,46698,1.008609491826131,0.2683160864394022
1854,0.2093,79,298,79,549399,127045,79637,46619,1.0062492079584338,0.26844366132301456
1855,0.2094,65,203,65,549602,126842,79702,46554,1.0046413635787605,0.2684837020461833
1856,0.2095,46,168,46,549770,126674,79748,46508,1.003310733747307,0.26854984929149683
1857,0.2096,48,190,48,549960,126484,79796,46460,1.0018058547712585,0.268641872513646
1858,0.2097,46,150,46,550110,126334,79842,46414,1.0006177924217463,0.2686803899321555
1859,0.2098,72,273,72,550383,126061,79914,46342,0.9984555189456342,0.26880042690672434
1860,0.2099,42,162,42,550545,125899,79956,46300,0.9971724116081612,0.26887496443068776
1861,0.21,78,237,78,550782,125662,80034,46222,0.995295273095932,0.2689139186893486
1862,0.2101,66,265,66,551047,125397,80100,46156,0.9931963629451274,0.2690480492908897
1863,0.2102,34,162,34,551209,125235,80134,46122,0.9919132556076543,0.2691573732033124
1864,0.2103,35,162,35,551371,125073,80169,46087,0.9906301482701813,0.26926267819584015
1865,0.2104,30,109,30,551480,124964,80199,46057,0.9897668229628691,0.2693061086065454
1866,0.2105,36,151,36,551631,124813,80235,46021,0.9885708401976936,0.2693901682334898
1867,0.2106,58,304,58,551935,124509,80293,45963,0.9861630338360157,0.26962199070815146
1868,0.2107,34,146,34,552081,124363,80327,45929,0.9850066531491573,0.26970732623963545
1869,0.2108,38,133,38,552214,124230,80365,45891,0.9839532378659233,0.26975505669494065
1870,0.2109,56,187,56,552401,124043,80421,45835,0.9824721201368648,0.26981127632771756
1871,0.211,74,242,74,552643,123801,80495,45761,0.9805553795463186,0.2698776848586358
1872,0.2111,43,196,43,552839,123605,80538,45718,0.9790029780762894,0.2700046656390449
1873,0.2112,45,191,45,553030,123414,80583,45673,0.9774901786845773,0.27011538438791866
1874,0.2113,39,166,39,553196,123248,80622,45634,0.9761753896844506,0.2702123376085077
1875,0.2114,61,253,61,553449,122995,80683,45573,0.9741715245216069,0.2703538038061791
1876,0.2115,70,208,70,553657,122787,80753,45503,0.9725240780636167,0.2703844554043615
1877,0.2116,62,226,62,553883,122561,80815,45441,0.9707340641236852,0.27047892286996583
1878,0.2117,34,109,34,553992,122452,80849,45407,0.9698707388163731,0.2705067943929131
1879,0.2118,71,217,71,554209,122235,80920,45336,0.9681520086174122,0.2705480065166407
1880,0.2119,46,208,46,554417,122027,80966,45290,0.9665045621594222,0.27068379184422386
1881,0.212,46,135,46,554552,121892,81012,45244,0.9654353060448613,0.2707017040015317
1882,0.2121,53,226,53,554778,121666,81065,45191,0.9636452921049297,0.27083670448347985
1883,0.2122,40,194,40,554972,121472,81105,45151,0.9621087314662273,0.2709769959729449
1884,0.2123,39,144,39,555116,121328,81144,45112,0.9609681916106957,0.27104061523672196
1885,0.2124,59,184,59,555300,121144,81203,45053,0.9595108351286276,0.2710819088190521
1886,0.2125,51,216,51,555516,120928,81254,45002,0.9578000253453302,0.271210751521726
1887,0.2126,52,268,52,555784,120660,81306,44950,0.9556773539475352,0.2714208079222269
1888,0.2127,56,172,56,555956,120488,81362,44894,0.9543150424534279,0.27145638582191534
1889,0.2128,82,303,82,556259,120185,81444,44812,0.9519151565074135,0.27159281683909403
1890,0.2129,45,163,45,556422,120022,81489,44767,0.950624128754277,0.271662550291585
1891,0.213,58,194,58,556616,119828,81547,44709,0.9490875681155747,0.2717261163142637
1892,0.2131,37,124,37,556740,119704,81584,44672,0.9481054365733114,0.27176716795639266
1893,0.2132,47,159,47,556899,119545,81631,44625,0.9468460904828285,0.27182189194128037
1894,0.2133,44,170,44,557069,119375,81675,44581,0.9454996198200482,0.2719083168655005
1895,0.2134,43,186,43,557255,119189,81718,44538,0.9440264225066531,0.27202599449082926
1896,0.2135,43,199,43,557454,118990,81761,44495,0.9424502597896338,0.2721656421078386
1897,0.2136,39,193,39,557647,118797,81800,44456,0.9409216195665948,0.2723135256319945
1898,0.2137,52,176,52,557823,118621,81852,44404,0.939527626409834,0.2723754025456218
1899,0.2138,55,180,55,558003,118441,81907,44349,0.9381019515904194,0.27243073898888137
1900,0.2139,43,178,43,558181,118263,81950,44306,0.9366921176023317,0.272536584465673
1901,0.214,18,88,18,558269,118175,81968,44288,0.9359951210239513,0.2726036082061762
1902,0.2141,46,164,46,558433,118011,82014,44242,0.9346961728551514,0.2726729243835245
1903,0.2142,49,203,49,558636,117808,82063,44193,0.9330883284754784,0.27279461237893593
1904,0.2143,30,170,30,558806,117638,82093,44163,0.931741857812698,0.2729463971174467
1905,0.2144,62,181,62,558987,117457,82155,44101,0.9303082625776201,0.2729731737208928
1906,0.2145,40,144,40,559131,117313,82195,44061,0.9291677227220885,0.2730365486385663
1907,0.2146,43,147,43,559278,117166,82238,44018,0.9280034216195666,0.2730916219972206
1908,0.2147,59,217,59,559495,116949,82297,43959,0.9262846914206058,0.2731933775822209
1909,0.2148,47,229,47,559724,116720,82344,43912,0.9244709162336839,0.2733701877583545
1910,0.2149,46,159,46,559883,116561,82390,43866,0.9232115701432011,0.27343277627830725
1911,0.215,61,178,61,560061,116383,82451,43805,0.9218017361551134,0.2734599345768722
1912,0.2151,63,232,63,560293,116151,82514,43742,0.9199641997212014,0.27357045023859705
1913,0.2152,45,188,45,560481,115963,82559,43697,0.9184751615764796,0.2736878366528874
1914,0.2153,64,259,64,560740,115704,82623,43633,0.9164237739196553,0.2738409785548868
1915,0.2154,62,335,62,561075,115369,82685,43571,0.9137704346724116,0.27413489367056754
1916,0.2155,37,212,37,561287,115157,82722,43534,0.9120913065517678,0.27433187767422224
1917,0.2156,54,166,54,561453,114991,82776,43480,0.9107765175516411,0.27437196711070166
1918,0.2157,61,199,61,561652,114792,82837,43419,0.9092003548346217,0.2744373020839259
1919,0.2158,56,185,56,561837,114607,82893,43363,0.9077350779368901,0.27450148762423243
1920,0.2159,54,190,54,562027,114417,82947,43309,0.9062301989608414,0.2745837718575251
1921,0.216,34,137,34,562164,114280,82981,43275,0.9051451020149538,0.2746659896544064
1922,0.2161,49,164,49,562328,114116,83030,43226,0.9038461538461539,0.2747263921902607
1923,0.2162,89,253,89,562581,113863,83119,43137,0.9018422886833101,0.2747579617834395
1924,0.2163,35,123,35,562704,113740,83154,43102,0.9008680775567102,0.27481159383328446
1925,0.2164,62,266,62,562970,113474,83216,43040,0.8987612469902421,0.2749913745735206
1926,0.2165,47,158,47,563128,113316,83263,42993,0.8975098213154227,0.2750513406137842
1927,0.2166,90,187,90,563315,113129,83353,42903,0.8960287035863642,0.27496282813781786
1928,0.2167,37,192,37,563507,112937,83390,42866,0.8945079837789888,0.27512949044626867
1929,0.2168,57,191,57,563698,112746,83447,42809,0.8929951843872767,0.2752016971489184
1930,0.2169,48,190,48,563888,112556,83495,42761,0.891490305411228,0.2753143570890501
1931,0.217,28,108,28,563996,112448,83523,42733,0.8906349005195793,0.2753752070163229
1932,0.2171,56,201,56,564197,112247,83579,42677,0.8890428969712331,0.2754705533035553
1933,0.2172,53,208,53,564405,112039,83632,42624,0.887395450513243,0.2755927403451375
1934,0.2173,68,245,68,564650,111794,83700,42556,0.8854549486757065,0.27571104632329124
1935,0.2174,57,203,57,564853,111591,83757,42499,0.8838471042960334,0.2758063469400999
1936,0.2175,55,207,55,565060,111384,83812,42444,0.8822075782537068,0.27591855838989
1937,0.2176,41,211,41,565271,111173,83853,42403,0.8805363705487264,0.27610433921966976
1938,0.2177,55,232,55,565503,110941,83908,42348,0.8786988341148143,0.27626248458793523
1939,0.2178,23,87,23,565590,110854,83931,42325,0.8780097579520973,0.2763107214435399
1940,0.2179,40,140,40,565730,110714,83971,42285,0.8769008997592194,0.2763743553879437
1941,0.218,35,114,35,565844,110600,84006,42250,0.8759979723735901,0.27641478573765127
1942,0.2181,81,204,81,566048,110396,84087,42169,0.8743822075782537,0.27640022285583193
1943,0.2182,41,166,41,566214,110230,84128,42128,0.873067418578127,0.27650664881397763
1944,0.2183,51,234,51,566448,109996,84179,42077,0.8712140413128882,0.2766894846553958
1945,0.2184,53,170,53,566618,109826,84232,42024,0.8698675706501077,0.27674678959499505
1946,0.2185,37,124,37,566742,109702,84269,41987,0.8688854391078443,0.2767966035770557
1947,0.2186,83,252,83,566994,109450,84352,41904,0.8668894943606641,0.2768608692205029
1948,0.2187,32,155,32,567149,109295,84384,41872,0.8656618299328349,0.27699167146268694
1949,0.2188,60,186,60,567335,109109,84444,41812,0.8641886326194399,0.2770456066418855
1950,0.2189,60,235,60,567570,108874,84504,41752,0.8623273349385375,0.27718986098017606
1951,0.219,60,190,60,567760,108684,84564,41692,0.860822455962489,0.27725168909932435
1952,0.2191,28,125,28,567885,108559,84592,41664,0.8598324040045622,0.2773476764543379
1953,0.2192,30,99,30,567984,108460,84622,41634,0.8590482828538841,0.27738617133263155
1954,0.2193,38,125,38,568109,108335,84660,41596,0.8580582308959575,0.2774342864384283
1955,0.2194,30,107,30,568216,108228,84690,41566,0.8572107464199721,0.27748774984311786
1956,0.2195,52,224,52,568440,108004,84742,41514,0.8554365733113674,0.2776521890340962
1957,0.2196,61,178,61,568618,107826,84803,41453,0.8540267393232797,0.277688087406802
1958,0.2197,39,180,39,568798,107646,84842,41414,0.8526010645038652,0.27783442908895745
1959,0.2198,86,273,86,569071,107373,84928,41328,0.8504387910277531,0.27792684649060867
1960,0.2199,37,119,37,569190,107254,84965,41291,0.8494962615638069,0.27796963882998416
1961,0.22,44,121,44,569311,107133,85009,41247,0.8485378912685337,0.277982207844723
1962,0.2201,49,133,49,569444,107000,85058,41198,0.8474844759852997,0.2779929553705178
1963,0.2202,50,151,50,569595,106849,85108,41148,0.8462884932201242,0.27803266282424643
1964,0.2203,45,148,45,569743,106701,85153,41103,0.8451162717019389,0.2780912559876593
1965,0.2204,54,154,54,569897,106547,85207,41049,0.8438965276897732,0.2781172931515759
1966,0.2205,77,243,77,570140,106304,85284,40972,0.8419718666835636,0.27819875607702543
1967,0.2206,58,188,58,570328,106116,85342,40914,0.8404828285388417,0.27826974086921036
1968,0.2207,41,180,41,570508,105936,85383,40873,0.8390571537194272,0.2784093618238664
1969,0.2208,26,139,26,570647,105797,85409,40847,0.8379562159422127,0.2785453206404626
1970,0.2209,47,192,47,570839,105605,85456,40800,0.8364354961348371,0.27867900686451963
1971,0.221,34,135,34,570974,105470,85490,40766,0.8353662400202763,0.2787685658798107
1972,0.2211,35,117,35,571091,105353,85525,40731,0.8344395513876568,0.27881903562334
1973,0.2212,47,134,47,571225,105219,85572,40684,0.8333782156887594,0.2788427928144041
1974,0.2213,52,198,52,571423,105021,85624,40632,0.8318099733874034,0.27896438796317274
1975,0.2214,50,169,50,571592,104852,85674,40582,0.8304714231402864,0.2790406644938598
1976,0.2215,53,169,53,571761,104683,85727,40529,0.8291328728931694,0.2791022780486461
1977,0.2216,32,123,32,571884,104560,85759,40497,0.8281586617665695,0.2791799085876586
1978,0.2217,41,184,41,572068,104376,85800,40456,0.8267013052845014,0.27933053468846664
1979,0.2218,38,155,38,572223,104221,85838,40418,0.8254736408566722,0.2794405381674375
1980,0.2219,36,116,36,572339,104105,85874,40382,0.8245548726397162,0.27948535162332944
1981,0.222,38,102,38,572441,104003,85912,40344,0.8237469902420479,0.27949316577414146
1982,0.2221,39,117,39,572558,103886,85951,40305,0.8228203016094284,0.27952507438050916
1983,0.2222,43,164,43,572722,103722,85994,40262,0.8215213534406286,0.27962829203244804
1984,0.2223,64,233,64,572955,103489,86058,40198,0.8196758965910531,0.27976086911133224
1985,0.2224,33,122,33,573077,103367,86091,40165,0.8187096058801165,0.27983306858400914
1986,0.2225,40,117,40,573194,103250,86131,40125,0.8177829172474972,0.2798605056669573
1987,0.2226,44,171,44,573365,103079,86175,40081,0.8164285261690534,0.27997345627270187
1988,0.2227,45,159,45,573524,102920,86220,40036,0.8151691800785705,0.28005819972578977
1989,0.2228,48,175,48,573699,102745,86268,39988,0.813783107337473,0.28015945856949687
1990,0.2229,40,195,40,573894,102550,86308,39948,0.8122386262831074,0.2803407767126556
1991,0.223,59,154,59,574048,102396,86367,39889,0.8110188822709415,0.28034578486839795
1992,0.2231,59,119,59,574167,102277,86426,39830,0.8100763528069953,0.2802817595192355
1993,0.2232,58,210,58,574377,102067,86484,39772,0.8084130655176783,0.2804024281051051
1994,0.2233,51,167,51,574544,101900,86535,39721,0.8070903561018882,0.28047394101157314
1995,0.2234,46,185,46,574729,101715,86581,39675,0.8056250792041566,0.2806068321663484
1996,0.2235,37,103,37,574832,101612,86618,39638,0.804809276390825,0.28062300884955754
1997,0.2236,61,220,61,575052,101392,86679,39577,0.8030667849448739,0.28074966836680404
1998,0.2237,62,188,62,575240,101204,86741,39515,0.801577746800152,0.2808078511075264
1999,0.2238,31,118,31,575358,101086,86772,39484,0.8006431377518692,0.2808849683431742
2000,0.2239,44,166,44,575524,100920,86816,39440,0.7993283487517425,0.2809917355371901
2001,0.224,37,105,37,575629,100815,86853,39403,0.798496705107084,0.28101242351195993
2002,0.2241,38,147,38,575776,100668,86891,39365,0.7973324040045622,0.2811123092413931
2003,0.2242,38,162,38,575938,100506,86929,39327,0.7960492966670891,0.28124262513140674
2004,0.2243,39,127,39,576065,100379,86968,39288,0.7950434038778356,0.28129765800081624
2005,0.2244,55,196,55,576261,100183,87023,39233,0.7934910024078063,0.2814095943076835
2006,0.2245,40,170,40,576431,100013,87063,39193,0.792144531745026,0.28154677240923526
2007,0.2246,56,201,56,576632,99812,87119,39137,0.7905525281966798,0.2816644956063016
2008,0.2247,47,150,47,576782,99662,87166,39090,0.7893644658471677,0.2817256688191882
2009,0.2248,25,121,25,576903,99541,87191,39065,0.7884060955518946,0.281842055899456
2010,0.2249,39,154,39,577057,99387,87230,39026,0.7871863515397288,0.28195328473481535
2011,0.225,45,187,45,577244,99200,87275,38981,0.7857052338106704,0.28210101244020525
2012,0.2251,39,100,39,577344,99100,87314,38942,0.784913192244329,0.282102548499732
2013,0.2252,49,115,49,577459,98985,87363,38893,0.7840023444430364,0.28208271080230346
2014,0.2253,38,134,38,577593,98851,87401,38855,0.7829410087441389,0.2821590925595108
2015,0.2254,56,161,56,577754,98690,87457,38799,0.7816658218223292,0.2821971212242434
2016,0.2255,44,165,44,577919,98525,87501,38755,0.780358953237866,0.28230623543123545
2017,0.2256,38,133,38,578052,98392,87539,38717,0.7793055379546319,0.28238117118496964
2018,0.2257,38,106,38,578158,98286,87577,38679,0.7784659738943099,0.2824006132953674
2019,0.2258,57,161,57,578319,98125,87634,38622,0.7771907869725003,0.28243398392652125
2020,0.2259,47,165,47,578484,97960,87681,38575,0.775883918388037,0.2825282894495917
2021,0.226,44,141,44,578625,97819,87725,38531,0.7747671397794956,0.2825889255592226
2022,0.2261,47,155,47,578780,97664,87772,38484,0.7735394753516665,0.28266298439933013
2023,0.2262,47,152,47,578932,97512,87819,38437,0.7723355721708275,0.28273102413405027
2024,0.2263,63,238,63,579170,97274,87882,38374,0.770450513242935,0.2828939608398207
2025,0.2264,34,69,34,579239,97205,87916,38340,0.7699040045621595,0.28285809140875723
2026,0.2265,44,183,44,579422,97022,87960,38296,0.7684545684957547,0.2830074343398513
2027,0.2266,75,228,75,579650,96794,88035,38221,0.7666487137244963,0.28308706440025183
2028,0.2267,46,178,46,579828,96616,88081,38175,0.7652388797364086,0.28321623847289507
2029,0.2268,45,153,45,579981,96463,88126,38130,0.7640270561399062,0.28329853707102154
2030,0.2269,22,121,22,580102,96342,88148,38108,0.7630686858446332,0.2834362216437337
2031,0.227,51,157,51,580259,96185,88199,38057,0.7618251805854771,0.2834954783152814
2032,0.2271,39,113,39,580372,96072,88238,38018,0.7609301736155113,0.2835259900067119
2033,0.2272,43,133,43,580505,95939,88281,37975,0.7598767583322773,0.28357751990083185
2034,0.2273,39,137,39,580642,95802,88320,37936,0.7587916613863895,0.2836590946477441
2035,0.2274,43,196,43,580838,95606,88363,37893,0.7572392599163604,0.2838448228076615
2036,0.2275,44,147,44,580985,95459,88407,37849,0.7560749588138386,0.2839214450745642
2037,0.2276,54,167,54,581152,95292,88461,37795,0.7547522493980484,0.28398716628972026
2038,0.2277,49,171,49,581323,95121,88510,37746,0.7533978583196046,0.28408859987807356
2039,0.2278,41,132,41,581455,94989,88551,37705,0.7523523634520339,0.2841499992463864
2040,0.2279,60,153,60,581608,94836,88611,37645,0.7511405398555316,0.28415395415191613
2041,0.228,23,93,23,581701,94743,88634,37622,0.7504039411988341,0.28422921467155216
2042,0.2281,46,166,46,581867,94577,88680,37576,0.7490891521987074,0.2843370941257482
2043,0.2282,32,103,32,581970,94474,88712,37544,0.7482733493853757,0.2843854625884349
2044,0.2283,34,123,34,582093,94351,88746,37510,0.7472991382587758,0.28446621821463514
2045,0.2284,35,77,35,582170,94274,88781,37475,0.7466892662526929,0.2844423866594813
2046,0.2285,58,190,58,582360,94084,88839,37417,0.7451843872766443,0.2845377601691242
2047,0.2286,33,134,33,582494,93950,88872,37384,0.7441230515777468,0.2846483012776585
2048,0.2287,37,173,37,582667,93777,88909,37347,0.7427528196679761,0.28482200054909856
2049,0.2288,44,201,44,582868,93576,88953,37303,0.7411608161196299,0.28501898700326256
2050,0.2289,47,176,47,583044,93400,89000,37256,0.7397668229628691,0.2851457261817291
2051,0.229,51,154,51,583198,93246,89051,37205,0.7385470789507034,0.28520287310944337
2052,0.2291,41,128,41,583326,93118,89092,37164,0.7375332657457864,0.2852581323590366
2053,0.2292,40,178,40,583504,92940,89132,37124,0.7361234317576987,0.28542871201869846
2054,0.2293,50,201,50,583705,92739,89182,37074,0.7345314282093525,0.2855954334311664
2055,0.2294,36,109,36,583814,92630,89218,37038,0.7336681029020403,0.2856371656846716
2056,0.2295,48,129,48,583943,92501,89266,36990,0.7326463692814599,0.2856569182414222
2057,0.2296,49,197,49,584140,92304,89315,36941,0.7310860473957673,0.28582150179890903
2058,0.2297,38,106,38,584246,92198,89353,36903,0.7302464833354454,0.28584596556184694
2059,0.2298,56,245,56,584491,91953,89409,36847,0.728305981497909,0.28607919254658387
2060,0.2299,28,153,28,584644,91800,89437,36819,0.7270941579014066,0.28626408228955286
2061,0.23,35,106,35,584750,91694,89472,36784,0.7262545938410848,0.28630582667849747
2062,0.2301,31,105,31,584855,91589,89503,36753,0.7254229501964263,0.2863676738713749
2063,0.2302,30,128,30,584983,91461,89533,36723,0.7244091369915093,0.2864866129938214
2064,0.2303,40,192,40,585175,91269,89573,36683,0.7228884171841338,0.28669344754282855
2065,0.2304,41,146,41,585321,91123,89614,36642,0.7217320364972754,0.28679215747661724
2066,0.2305,30,118,30,585439,91005,89644,36612,0.7207974274489926,0.28688967770751544
2067,0.2306,55,172,55,585611,90833,89699,36557,0.7194351159548853,0.2869691498547767
2068,0.2307,33,167,33,585778,90666,89732,36524,0.7181124065390951,0.28716094032549727
2069,0.2308,72,230,72,586008,90436,89804,36452,0.71629071093651,0.28727696866527963
2070,0.2309,40,139,40,586147,90297,89844,36412,0.7151897731592954,0.28736711677939214
2071,0.231,25,117,25,586264,90180,89869,36387,0.714263084526676,0.28749200028443433
2072,0.2311,41,144,41,586408,90036,89910,36346,0.7131225446711443,0.28758842240192434
2073,0.2312,69,182,69,586590,89854,89979,36277,0.711681029020403,0.2876136715002656
2074,0.2313,41,155,41,586745,89699,90020,36236,0.7104533645925738,0.2877357366895621
2075,0.2314,32,107,32,586852,89592,90052,36204,0.7096058801165885,0.2877992940952018
2076,0.2315,24,84,24,586936,89508,90076,36180,0.7089405652008618,0.2878556425434409
2077,0.2316,46,90,46,587026,89418,90122,36134,0.7082277277911545,0.28780107047279213
2078,0.2317,28,97,28,587123,89321,90150,36106,0.7074594474718033,0.2878646543407719
2079,0.2318,57,168,57,587291,89153,90207,36049,0.7061288176403497,0.28792671043593554
2080,0.2319,31,121,31,587412,89032,90238,36018,0.7051704473450767,0.28802878848460617
2081,0.232,45,130,45,587542,88902,90283,35973,0.7041407933088328,0.2880720720720721
2082,0.2321,44,155,44,587697,88747,90327,35929,0.7029131288810037,0.2881789598639674
2083,0.2322,29,112,29,587809,88635,90356,35900,0.7020260423267013,0.2882723732284097
2084,0.2323,49,142,49,587951,88493,90405,35851,0.7009013433024965,0.2883211091809818
2085,0.2324,32,151,32,588102,88342,90437,35819,0.699705360537321,0.288488333695766
2086,0.2325,33,107,33,588209,88235,90470,35786,0.6988578760613356,0.28854790720926293
2087,0.2326,38,119,38,588328,88116,90508,35748,0.6979153465973894,0.2886068591358264
2088,0.2327,47,170,47,588498,87946,90555,35701,0.696568875934609,0.28873324868375294
2089,0.2328,35,115,35,588613,87831,90590,35666,0.6956580281333165,0.28880053766488256
2090,0.2329,33,116,33,588729,87715,90623,35633,0.6947392599163604,0.28888186269740895
2091,0.233,32,98,32,588827,87617,90655,35601,0.6939630591813458,0.2889269424921683
2092,0.2331,18,92,18,588919,87525,90673,35583,0.6932343809403118,0.2890388926795984
2093,0.2332,54,201,54,589120,87324,90727,35529,0.6916423773919655,0.2891992869526996
2094,0.2333,27,118,27,589238,87206,90754,35502,0.6907077683436826,0.2893209896665254
2095,0.2334,34,123,34,589361,87083,90788,35468,0.6897335572170827,0.28941420306647847
2096,0.2335,44,141,44,589502,86942,90832,35424,0.6886167786085414,0.2894921792001046
2097,0.2336,25,101,25,589603,86841,90857,35399,0.6878168166265366,0.28958606020942407
2098,0.2337,65,225,65,589828,86616,90922,35334,0.6860347231022684,0.28974169741697414
2099,0.2338,53,149,53,589977,86467,90975,35281,0.6848545811684197,0.2897871012254821
2100,0.2339,40,127,40,590104,86340,91015,35241,0.6838486883791661,0.2898561452858588
2101,0.234,23,72,23,590176,86268,91038,35218,0.6832784184514004,0.2898934856691306
2102,0.2341,46,161,46,590337,86107,91084,35172,0.6820032315295906,0.2900089875411242
2103,0.2342,55,124,55,590461,85983,91139,35117,0.6810210999873273,0.2899834847233691
2104,0.2343,36,107,36,590568,85876,91175,35081,0.680173615511342,0.29002868788081715
2105,0.2344,28,64,28,590632,85812,91203,35053,0.6796667089088836,0.29001778844164977
2106,0.2345,29,98,29,590730,85714,91232,35024,0.678890508173869,0.2900826583180109
2107,0.2346,39,73,39,590803,85641,91271,34985,0.6783123178304398,0.2900286837000315
2108,0.2347,44,146,44,590949,85495,91315,34941,0.6771559371435812,0.2901208940848251
2109,0.2348,45,120,45,591069,85375,91360,34896,0.6762054872639716,0.29014475642507337
2110,0.2349,64,213,64,591282,85162,91424,34832,0.6745184387276645,0.29028118072570297
2111,0.235,27,113,27,591395,85049,91451,34805,0.6736234317576987,0.29039498055968094
2112,0.2351,29,106,29,591501,84943,91480,34776,0.6727838676973767,0.29048020781997846
2113,0.2352,34,116,34,591617,84827,91514,34742,0.6718650994804207,0.29056026227533893
2114,0.2353,41,131,41,591748,84696,91555,34701,0.6708275250285135,0.29063544310158546
2115,0.2354,34,136,34,591884,84560,91589,34667,0.6697503484982892,0.2907646757865249
2116,0.2355,41,103,41,591987,84457,91630,34626,0.6689345456849576,0.29077198256678116
2117,0.2356,31,94,31,592081,84363,91661,34595,0.6681900266125966,0.2908169269826325
2118,0.2357,31,113,31,592194,84250,91692,34564,0.6672950196426308,0.2909084787987948
2119,0.2358,42,125,42,592319,84125,91734,34522,0.666304967684704,0.2909639518909033
2120,0.2359,58,172,58,592491,83953,91792,34464,0.6649426561905969,0.2910392933447056
2121,0.236,24,66,24,592557,83887,91816,34440,0.6644199087568116,0.29105783126420853
2122,0.2361,29,126,29,592683,83761,91845,34411,0.6634219363832214,0.29119419151744913
2123,0.2362,18,77,18,592760,83684,91863,34393,0.6628120643771385,0.29127603174199884
2124,0.2363,34,92,34,592852,83592,91897,34359,0.6620833861361044,0.2912989292163695
2125,0.2364,56,151,56,593003,83441,91953,34303,0.6608874033709289,0.2913354395977714
2126,0.2365,38,138,38,593141,83303,91991,34265,0.6597943860093778,0.2914483532934132
2127,0.2366,48,121,48,593262,83182,92039,34217,0.6588360157141047,0.2914590413887682
2128,0.2367,67,179,67,593441,83003,92106,34150,0.6574182613103535,0.2914991506832945
2129,0.2368,35,109,35,593550,82894,92141,34115,0.6565549360030415,0.29155876898358246
2130,0.2369,38,122,38,593672,82772,92179,34077,0.6555886452921049,0.2916327910380063
2131,0.237,28,123,28,593795,82649,92207,34049,0.654614434165505,0.2917702102863802
2132,0.2371,25,126,25,593921,82523,92232,34024,0.6536164617919148,0.2919337263078415
2133,0.2372,33,105,33,594026,82418,92265,33991,0.6527848181472564,0.29199632330833525
2134,0.2373,46,92,46,594118,82326,92311,33945,0.6520561399062222,0.2919472611399231
2135,0.2374,46,124,46,594242,82202,92357,33899,0.6510740083639589,0.29197853592992307
2136,0.2375,32,128,32,594370,82074,92389,33867,0.6500601951590419,0.2921054674360235
2137,0.2376,60,163,60,594533,81911,92449,33807,0.6487691674059055,0.2921498816087385
2138,0.2377,36,112,36,594645,81799,92485,33771,0.647882080851603,0.29221251189755126
2139,0.2378,54,124,54,594769,81675,92539,33717,0.6468999493093398,0.29219529950083195
2140,0.2379,34,131,34,594900,81544,92573,33683,0.6458623748574325,0.292318640596388
2141,0.238,39,136,39,595036,81408,92612,33644,0.6447851983272083,0.2924242951013455
2142,0.2381,13,52,13,595088,81356,92625,33631,0.6443733367127107,0.29247654082635427
2143,0.2382,59,191,59,595279,81165,92684,33572,0.6428605373209986,0.2925995973400037
2144,0.2383,53,166,53,595445,80999,92737,33519,0.6415457483208719,0.29269634467943906
2145,0.2384,28,97,28,595542,80902,92765,33491,0.6407774680015207,0.29277141083807573
2146,0.2385,48,152,48,595694,80750,92813,33443,0.6395735648206818,0.29286383578678205
2147,0.2386,31,117,31,595811,80633,92844,33412,0.6386468761880624,0.2929720724275505
2148,0.2387,39,113,39,595924,80520,92883,33373,0.6377518692180966,0.2930206421816969
2149,0.2388,29,133,29,596057,80387,92912,33344,0.6366984539348625,0.2931830371666476
2150,0.2389,36,133,36,596190,80254,92948,33308,0.6356450386516285,0.2933023370493651
2151,0.239,18,94,18,596284,80160,92966,33290,0.6349005195792675,0.29343323049801673
2152,0.2391,47,113,47,596397,80047,93013,33243,0.6340055126093017,0.2934327831229588
2153,0.2392,31,142,31,596539,79905,93044,33212,0.632880813585097,0.2936075037350708
2154,0.2393,28,136,28,596675,79769,93072,33184,0.6318036370548726,0.29378591095411366
2155,0.2394,29,109,29,596784,79660,93101,33155,0.6309403117475605,0.2938882240836768
2156,0.2395,56,172,56,596956,79488,93157,33099,0.6295780002534533,0.29398598417224014
2157,0.2396,26,112,26,597068,79376,93183,33073,0.628690913699151,0.29411555460697736
2158,0.2397,39,121,39,597189,79255,93222,33034,0.6277325434038779,0.29418732021836513
2159,0.2398,37,112,37,597301,79143,93259,32997,0.6268454568495755,0.2942482611021937
2160,0.2399,54,158,54,597459,78985,93313,32943,0.6255940311747561,0.2943231363019084
2161,0.24,32,129,32,597588,78856,93345,32911,0.6245722975541756,0.2944607979099376
2162,0.2401,40,169,40,597757,78687,93385,32871,0.6232337473070587,0.29465390200613134
2163,0.2402,46,123,46,597880,78564,93431,32825,0.6222595361804587,0.29468798534864304
2164,0.2403,41,118,41,597998,78446,93472,32784,0.6213249271321759,0.29474062752854446
2165,0.2404,37,109,37,598107,78337,93509,32747,0.6204616018248638,0.29479492996291096
2166,0.2405,34,114,34,598221,78223,93543,32713,0.6195586744392346,0.2948817336121728
2167,0.2406,31,116,31,598337,78107,93574,32682,0.6186399062222785,0.2949931852440224
2168,0.2407,42,137,42,598474,77970,93616,32640,0.6175548092763908,0.29509085977759697
2169,0.2408,60,118,60,598592,77852,93676,32580,0.6166202002281079,0.2950231816864677
2170,0.2409,38,117,38,598709,77735,93714,32542,0.6156935115954886,0.2950932651414166
2171,0.241,56,142,56,598851,77593,93770,32486,0.6145688125712837,0.29511532626568193
2172,0.2411,38,142,38,598993,77451,93808,32448,0.613444113547079,0.29525291403925424
2173,0.2412,51,131,51,599124,77320,93859,32397,0.6124065390951717,0.2952778511989938
2174,0.2413,61,224,61,599348,77096,93920,32336,0.610632365986567,0.2954894363623072
2175,0.2414,26,111,26,599459,76985,93946,32310,0.609753199847928,0.2956219406194245
2176,0.2415,53,152,53,599611,76833,93999,32257,0.6085492966670891,0.2956916307635897
2177,0.2416,41,88,41,599699,76745,94040,32216,0.6078523000887086,0.29566542157285636
2178,0.2417,41,81,41,599780,76664,94081,32175,0.6072107464199721,0.29562013616442634
2179,0.2418,56,205,56,599985,76459,94137,32119,0.6055870612089722,0.2958149901453333
2180,0.2419,54,136,54,600121,76323,94191,32065,0.6045098846787479,0.29583533232461157
2181,0.242,44,112,44,600233,76211,94235,32021,0.6036227981244455,0.2958551999408678
2182,0.2421,20,100,20,600333,76111,94255,32001,0.6028307565581041,0.2959985940506142
2183,0.2422,26,59,26,600392,76052,94281,31975,0.6023634520339627,0.2959908171105372
2184,0.2423,31,89,31,600481,75963,94312,31944,0.6016585350399188,0.2960326948205399
2185,0.2424,49,129,49,600610,75834,94361,31895,0.6006368014193385,0.2960669828922574
2186,0.2425,20,57,20,600667,75777,94381,31875,0.6001853377265239,0.29609296622450115
2187,0.2426,31,119,31,600786,75658,94412,31844,0.5992428082625776,0.2962177447861435
2188,0.2427,38,92,38,600878,75566,94450,31806,0.5985141300215435,0.29622247885854786
2189,0.2428,34,93,34,600971,75473,94484,31772,0.597777531364846,0.2962562357219451
2190,0.2429,33,96,33,601067,75377,94517,31739,0.5970171714611583,0.2963049404384032
2191,0.243,56,164,56,601231,75213,94573,31683,0.5957182232923584,0.2963908845981141
2192,0.2431,38,145,38,601376,75068,94611,31645,0.5945697630211634,0.29654306410652875
2193,0.2432,18,62,18,601438,75006,94629,31627,0.5940786972500317,0.2965967383455403
2194,0.2433,45,145,45,601583,74861,94674,31582,0.5929302369788366,0.2967033999417529
2195,0.2434,35,97,35,601680,74764,94709,31547,0.5921619566594855,0.2967425760269398
2196,0.2435,39,130,39,601810,74634,94748,31508,0.5911323026232417,0.29684761922707315
2197,0.2436,29,84,29,601894,74550,94777,31479,0.5904669877075149,0.2968904733610616
2198,0.2437,29,118,29,602012,74432,94806,31450,0.589532378659232,0.29702876787367066
2199,0.2438,31,78,31,602090,74354,94837,31419,0.5889145862374857,0.2970417781475424
2200,0.2439,41,93,41,602183,74261,94878,31378,0.5881779875807882,0.29703045276839046
2201,0.244,23,79,23,602262,74182,94901,31355,0.5875522747433786,0.29709959540256026
2202,0.2441,43,126,43,602388,74056,94944,31312,0.5865543023697883,0.29716802065143116
2203,0.2442,27,80,27,602468,73976,94971,31285,0.5859206691167153,0.297213592878654
2204,0.2443,28,124,28,602592,73852,94999,31257,0.5849385375744519,0.29737700862913735
2205,0.2444,54,155,54,602747,73697,95053,31203,0.5837108731466227,0.2974547187797903
2206,0.2445,26,102,26,602849,73595,95079,31177,0.5829029907489545,0.2975699614400794
2207,0.2446,42,103,42,602952,73492,95121,31135,0.5820871879356229,0.29758093035258587
2208,0.2447,50,127,50,603079,73365,95171,31085,0.5810812951463693,0.29760651029200574
2209,0.2448,42,122,42,603201,73243,95213,31043,0.5801150044354327,0.297671787200583
2210,0.2449,53,176,53,603377,73067,95266,30990,0.5787210112786719,0.29781754230854246
2211,0.245,45,127,45,603504,72940,95311,30945,0.5777151184894184,0.2978774606536074
2212,0.2451,22,96,22,603600,72844,95333,30923,0.5769547585857305,0.2980041824472135
2213,0.2452,40,153,40,603753,72691,95373,30883,0.5757429349892282,0.29817328673219146
2214,0.2453,49,161,49,603914,72530,95422,30834,0.5744677480674186,0.2983050191556054
2215,0.2454,23,103,23,604017,72427,95445,30811,0.5736519452540869,0.2984463085298049
2216,0.2455,43,126,43,604143,72301,95488,30768,0.5726539728804968,0.2985184682106162
2217,0.2456,74,175,74,604318,72126,95562,30694,0.5712679001393993,0.2985216883874732
2218,0.2457,40,110,40,604428,72016,95602,30654,0.5703966544164237,0.2985682283042758
2219,0.2458,34,83,34,604511,71933,95636,30620,0.5697392599163604,0.29857732099499773
2220,0.2459,48,150,48,604661,71783,95684,30572,0.5685511975668484,0.29868594597235115
2221,0.246,32,139,32,604800,71644,95716,30540,0.5674502597896338,0.2988726219368981
2222,0.2461,22,76,22,604876,71568,95738,30518,0.5668483081992143,0.29894402758458555
2223,0.2462,41,89,41,604965,71479,95779,30477,0.5661433912051704,0.29892306485150455
2224,0.2463,51,131,51,605096,71348,95830,30426,0.5651058167532632,0.2989565114862342
2225,0.2464,55,189,55,605285,71159,95885,30371,0.563608858192878,0.2991332611050921
2226,0.2465,38,131,38,605416,71028,95923,30333,0.5625712837409708,0.29925711072305916
2227,0.2466,32,116,32,605532,70912,95955,30301,0.5616525155240147,0.2993785383300564
2228,0.2467,31,114,31,605646,70798,95986,30270,0.5607495881383855,0.2995013258400285
2229,0.2468,37,106,37,605752,70692,96023,30233,0.5599100240780636,0.29955907852365615
2230,0.2469,31,77,31,605829,70615,96054,30202,0.5593001520719807,0.29957249273436026
2231,0.247,65,170,65,605999,70445,96119,30137,0.5579536814092003,0.29962617565767236
2232,0.2471,38,147,38,606146,70298,96157,30099,0.5567893803066785,0.2997997948145861
2233,0.2472,39,169,39,606315,70129,96196,30060,0.5554508300595615,0.30003293774765694
2234,0.2473,37,101,37,606416,70028,96233,30023,0.5546508680775567,0.3000769607500175
2235,0.2474,53,147,53,606563,69881,96286,29970,0.5534865669750348,0.3001472193568417
2236,0.2475,54,177,54,606740,69704,96340,29916,0.5520846534026106,0.3003011443485244
2237,0.2476,57,213,57,606953,69491,96397,29859,0.5503976048663034,0.3005435329642677
2238,0.2477,37,92,37,607045,69399,96434,29822,0.5496689266252693,0.3005613730964211
2239,0.2478,33,144,33,607189,69255,96467,29789,0.5485283867697377,0.30076531642502324
2240,0.2479,30,97,30,607286,69158,96497,29759,0.5477601064503865,0.30084818585278567
2241,0.248,46,104,46,607390,69054,96543,29713,0.5469363832213915,0.30083934917533184
2242,0.2481,38,102,38,607492,68952,96581,29675,0.5461285008237232,0.30088109746823893
2243,0.2482,43,136,43,607628,68816,96624,29632,0.5450513242934989,0.3009913863156184
2244,0.2483,42,94,42,607722,68722,96666,29590,0.5443068052211381,0.300980551712914
2245,0.2484,29,85,29,607807,68637,96695,29561,0.5436335698897478,0.30103464429010773
2246,0.2485,26,78,26,607885,68559,96721,29535,0.5430157774680016,0.3010887516056028
2247,0.2486,44,122,44,608007,68437,96765,29491,0.542049486757065,0.3011498243607548
2248,0.2487,38,83,38,608090,68354,96803,29453,0.5413920922570017,0.301133865674236
2249,0.2488,31,97,31,608187,68257,96834,29422,0.5406238119376505,0.30121110985984706
2250,0.2489,40,130,40,608317,68127,96874,29382,0.5395941579014066,0.3013260314432514
2251,0.249,29,92,29,608409,68035,96903,29353,0.5388654796603726,0.3014026368751797
2252,0.2491,24,82,24,608491,67953,96927,29329,0.5382160055759726,0.3014843444830493
2253,0.2492,56,145,56,608636,67808,96983,29273,0.5370675453047776,0.3015317106333886
2254,0.2493,45,162,45,608798,67646,97028,29228,0.5357844379673046,0.3017115015380804
2255,0.2494,25,71,25,608869,67575,97053,29203,0.5352220884552021,0.3017524644030668
2256,0.2495,34,115,34,608984,67460,97087,29169,0.5343112406539096,0.30186589947117326
2257,0.2496,27,95,27,609079,67365,97114,29142,0.5335588011658852,0.30196773291056606
2258,0.2497,42,128,42,609207,67237,97156,29100,0.5325449879609682,0.30206462729792294
2259,0.2498,44,133,44,609340,67104,97200,29056,0.5314915726777342,0.3021630615640599
2260,0.2499,17,69,17,609409,67035,97217,29039,0.5309450639969585,0.30225659387555426
2261,0.25,24,101,24,609510,66934,97241,29015,0.5301451020149538,0.30240023345735756
2262,0.2501,36,78,36,609588,66856,97277,28979,0.5295273095932075,0.3023843063598894
2263,0.2502,32,82,32,609670,66774,97309,28947,0.5288778355088075,0.3024101294386812
2264,0.2503,63,126,63,609796,66648,97372,28884,0.5278798631352173,0.3023489511367919
2265,0.2504,26,81,26,609877,66567,97398,28858,0.5272383094664808,0.30241550956248364
2266,0.2505,19,88,19,609965,66479,97417,28839,0.5265413128881004,0.3025556558047798
2267,0.2506,69,162,69,610127,66317,97486,28770,0.5252582055506273,0.3025650194032833
2268,0.2507,32,77,32,610204,66240,97518,28738,0.5246483335445444,0.30257533323506497
2269,0.2508,37,123,37,610327,66117,97555,28701,0.5236741224179445,0.3026956906916408
2270,0.2509,55,147,55,610474,65970,97610,28646,0.5225098213154227,0.3027606324511711
2271,0.251,31,125,31,610599,65845,97641,28615,0.5215197693574959,0.302932458183358
2272,0.2511,49,94,49,610693,65751,97690,28566,0.5207752502851349,0.3028722287604568
2273,0.2512,51,142,51,610835,65609,97741,28515,0.5196505512609302,0.30295142577875994
2274,0.2513,52,162,52,610997,65447,97793,28463,0.5183674439234571,0.30308806303908
2275,0.2514,29,95,29,611092,65352,97822,28434,0.5176150044354327,0.303179579041648
2276,0.2515,27,85,27,611177,65267,97849,28407,0.5169417691040425,0.3032538377778252
2277,0.2516,41,119,41,611296,65148,97890,28366,0.5159992396400963,0.30333426011078557
2278,0.2517,58,163,58,611459,64985,97948,28308,0.5147082118869598,0.30343112559356006
2279,0.2518,18,76,18,611535,64909,97966,28290,0.5141062602965404,0.303544029442376
2280,0.2519,42,104,42,611639,64805,98008,28248,0.5132825370675453,0.3035689338334068
2281,0.252,38,129,38,611768,64676,98046,28210,0.5122608034469649,0.3037056176388261
2282,0.2521,45,120,45,611888,64556,98091,28165,0.5113103535673552,0.30376074459938956
2283,0.2522,26,93,26,611981,64463,98117,28139,0.5105737549106577,0.3038703267747997
2284,0.2523,20,86,20,612067,64377,98137,28119,0.5098925991636041,0.3040023352361183
2285,0.2524,39,121,39,612188,64256,98176,28080,0.5089342288683311,0.30410674059954945
2286,0.2525,39,126,39,612314,64130,98215,28041,0.5079362564947408,0.3042280109795923
2287,0.2526,26,82,26,612396,64048,98241,28015,0.5072867824103409,0.30430248851330066
2288,0.2527,28,82,28,612478,63966,98269,27987,0.5066373083259409,0.3043620110273727
2289,0.2528,50,143,50,612621,63823,98319,27937,0.5055046888860727,0.3044572798605057
2290,0.2529,35,129,35,612750,63694,98354,27902,0.5044829552654924,0.3046202890955937
2291,0.253,45,117,45,612867,63577,98399,27857,0.5035562666328729,0.3046678478465341
2292,0.2531,50,132,50,612999,63445,98449,27807,0.5025107717653022,0.3047275676149564
2293,0.2532,40,118,40,613117,63327,98489,27767,0.5015761627170194,0.30481700221748964
2294,0.2533,43,89,43,613206,63238,98532,27724,0.5008712457229756,0.3047866141905411
2295,0.2534,35,98,35,613304,63140,98567,27689,0.500095044987961,0.30484757070979535
2296,0.2535,38,106,38,613410,63034,98605,27651,0.4992554809276391,0.3049126095826212
2297,0.2536,48,114,48,613524,62920,98653,27603,0.49835255354200986,0.3049280293406096
2298,0.2537,38,91,38,613615,62829,98691,27565,0.49763179571663924,0.30494280593844725
2299,0.2538,35,104,35,613719,62725,98726,27530,0.49680807248764414,0.3050246523738297
2300,0.2539,31,81,31,613800,62644,98757,27499,0.4961665188189076,0.3050597384156285
2301,0.254,41,109,41,613909,62535,98798,27458,0.49530319351159546,0.30511261987043437
2302,0.2541,32,127,32,614036,62408,98830,27426,0.4942973007223419,0.30529643564797293
2303,0.2542,60,159,60,614195,62249,98890,27366,0.49303795463185907,0.3053729844334096
2304,0.2543,40,105,40,614300,62144,98930,27326,0.49220631098720063,0.30542081144517713
2305,0.2544,15,80,15,614380,62064,98945,27311,0.4915726777341275,0.30557762237762237
2306,0.2545,27,67,27,614447,61997,98972,27284,0.4910420098846787,0.30559693551819533
2307,0.2546,49,141,49,614588,61856,99021,27235,0.48992523127613735,0.3056986676544208
2308,0.2547,30,77,30,614665,61779,99051,27205,0.4893153592700545,0.3057291198417693
2309,0.2548,24,81,24,614746,61698,99075,27181,0.48867380560131796,0.30582027250531624
2310,0.2549,31,92,31,614838,61606,99106,27150,0.4879451273602839,0.30589481274505387
2311,0.255,29,78,29,614916,61528,99135,27121,0.4873273349385376,0.30593689720132206
2312,0.2551,40,92,40,615008,61436,99175,27081,0.48659865669750346,0.3059412316278229
2313,0.2552,48,128,48,615136,61308,99223,27033,0.4855848434925865,0.306007403131049
2314,0.2553,34,116,34,615252,61192,99257,26999,0.4846660752756305,0.30614235012643015
2315,0.2554,23,75,23,615327,61117,99280,26976,0.4840720441008744,0.3062218337438843
2316,0.2555,44,131,44,615458,60986,99324,26932,0.4830344696489672,0.3063308992470256
2317,0.2556,47,93,47,615551,60893,99371,26885,0.4822978709922697,0.3062840347239627
2318,0.2557,63,149,63,615700,60744,99434,26822,0.481117729058421,0.30630610054130597
2319,0.2558,39,97,39,615797,60647,99473,26783,0.4803494487390698,0.3063364977696443
2320,0.2559,40,139,40,615936,60508,99513,26743,0.4792485109618553,0.306506515684634
2321,0.256,40,118,40,616054,60390,99553,26703,0.4783139019135724,0.3066032861423995
2322,0.2561,29,84,29,616138,60306,99582,26674,0.4776485869978456,0.30666819958611174
2323,0.2562,28,89,28,616227,60217,99610,26646,0.4769436700038018,0.30675891921761855
2324,0.2563,17,114,17,616341,60103,99627,26629,0.4760407426181726,0.30702624175621457
2325,0.2564,35,74,35,616415,60029,99662,26594,0.47545463185908,0.30700853122150007
2326,0.2565,35,116,35,616531,59913,99697,26559,0.4745358636421239,0.3071398834304746
2327,0.2566,18,71,18,616602,59842,99715,26541,0.47397351413002153,0.3072479538798143
2328,0.2567,32,96,32,616698,59746,99747,26509,0.4732131542263338,0.30733290823720366
2329,0.2568,42,106,42,616804,59640,99789,26467,0.47237359016601194,0.307373384277701
2330,0.2569,29,97,29,616901,59543,99818,26438,0.47160530984666077,0.3074865377234505
2331,0.257,28,108,28,617009,59435,99846,26410,0.47074990495501207,0.307647504222727
2332,0.2571,25,82,25,617091,59353,99871,26385,0.4701004308706121,0.30773985863910985
2333,0.2572,56,145,56,617236,59208,99927,26329,0.46895197059941707,0.30780831686872345
2334,0.2573,34,77,34,617313,59131,99961,26295,0.4683420985933342,0.3078102685365111
2335,0.2574,26,88,26,617401,59043,99987,26269,0.46764510201495374,0.3079168229557389
2336,0.2575,46,93,46,617494,58950,100033,26223,0.46690850335825623,0.3078792575111831
2337,0.2576,21,62,21,617556,58888,100054,26202,0.46641743758712456,0.307932777059584
2338,0.2577,24,107,24,617663,58781,100078,26178,0.46556995311113925,0.3081250956343648
2339,0.2578,42,91,42,617754,58690,100120,26136,0.4648491952857686,0.30811307853724096
2340,0.2579,59,135,59,617889,58555,100179,26077,0.4637799391712077,0.30812222327252103
2341,0.258,37,102,37,617991,58453,100216,26040,0.4629720567735395,0.3081912111062455
2342,0.2581,37,150,37,618141,58303,100253,26003,0.4617839944240274,0.30843593575783457
2343,0.2582,48,167,48,618308,58136,100301,25955,0.46046128500823724,0.30865372037435634
2344,0.2583,38,114,38,618422,58022,100339,25917,0.45955835762260805,0.3087599328083489
2345,0.2584,41,99,41,618521,57923,100380,25876,0.45877423647193005,0.3087865010322319
2346,0.2585,29,73,29,618594,57850,100409,25847,0.45819604612850084,0.30881632555527677
2347,0.2586,29,60,29,618654,57790,100438,25818,0.457720821188696,0.3087982011290786
2348,0.2587,19,67,19,618721,57723,100457,25799,0.45719015333924723,0.30888867603745124
2349,0.2588,25,82,25,618803,57641,100482,25774,0.4565406792548473,0.30898519450938083
2350,0.2589,42,90,42,618893,57551,100524,25732,0.45582784184514,0.3089706182534251
2351,0.259,29,95,29,618988,57456,100553,25703,0.4550754023571157,0.3090826008008754
2352,0.2591,40,74,40,619062,57382,100593,25663,0.45448929159802304,0.30902522728641096
2353,0.2592,38,116,38,619178,57266,100631,25625,0.453570523381067,0.30914092000337795
2354,0.2593,27,70,27,619248,57196,100658,25598,0.4530160942846281,0.3091769935019446
2355,0.2594,10,52,10,619300,57144,100668,25588,0.4526042326701305,0.3092878209157279
2356,0.2595,40,101,40,619401,57043,100708,25548,0.45180427068812573,0.30933152522671964
2357,0.2596,36,104,36,619505,56939,100744,25512,0.45098054745913063,0.3094201404470534
2358,0.2597,34,101,34,619606,56838,100778,25478,0.45018058547712586,0.3095145536712182
2359,0.2598,25,70,25,619676,56768,100803,25453,0.44962615638068687,0.30956811520171246
2360,0.2599,47,102,47,619778,56666,100850,25406,0.44881827398301866,0.3095574617409104
2361,0.26,26,87,26,619865,56579,100876,25380,0.4481291978203016,0.3096670286362694
2362,0.2601,27,73,27,619938,56506,100903,25353,0.4475510074768724,0.30971548638512564
2363,0.2602,36,93,36,620031,56413,100939,25317,0.44681440882017487,0.3097638566010033
2364,0.2603,25,58,25,620089,56355,100964,25292,0.44635502471169686,0.3097725574730241
2365,0.2604,34,64,34,620153,56291,100998,25258,0.44584811810923836,0.3097278936590271
2366,0.2605,25,66,25,620219,56225,101023,25233,0.445325370675453,0.3097669964889882
2367,0.2606,39,89,39,620308,56136,101062,25194,0.4446204536814092,0.3097749907783106
2368,0.2607,65,142,65,620450,55994,101127,25129,0.4434957546572044,0.3097641852495593
2369,0.2608,48,124,48,620574,55870,101175,25081,0.4425136231149411,0.3098294029721683
2370,0.2609,40,115,40,620689,55755,101215,25041,0.44160277531364844,0.30992870934204664
2371,0.261,36,91,36,620780,55664,101251,25005,0.44088201748827777,0.3099703727578128
2372,0.2611,26,84,26,620864,55580,101277,24979,0.440216702572551,0.3100708797279013
2373,0.2612,25,72,25,620936,55508,101302,24954,0.4396464326447852,0.3101339762869429
2374,0.2613,37,122,37,621058,55386,101339,24917,0.4386801419338487,0.310287286900863
2375,0.2614,46,134,46,621192,55252,101385,24871,0.4376188062349512,0.31041024424946645
2376,0.2615,29,101,29,621293,55151,101414,24842,0.43681884425294637,0.3105521733151651
2377,0.2616,30,70,30,621363,55081,101444,24812,0.43626441515650743,0.31056538119735144
2378,0.2617,37,77,37,621440,55004,101481,24775,0.4356545431504245,0.3105453816167162
2379,0.2618,49,99,49,621539,54905,101530,24726,0.43487042199974657,0.3105072145270058
2380,0.2619,45,108,45,621647,54797,101575,24681,0.4340150171080978,0.3105387654445255
2381,0.262,47,91,47,621738,54706,101622,24634,0.43329425928272713,0.3104865137383413
2382,0.2621,46,69,46,621807,54637,101668,24588,0.4327477506019516,0.31035657936257494
2383,0.2622,21,75,21,621882,54562,101689,24567,0.43215371942719555,0.3104677172717967
2384,0.2623,38,88,38,621970,54474,101727,24529,0.4314567228488151,0.3104818804349202
2385,0.2624,53,89,53,622059,54385,101780,24476,0.43075180585477124,0.31036887688464515
2386,0.2625,41,100,41,622159,54285,101821,24435,0.42995976428842986,0.31040396341463417
2387,0.2626,29,104,29,622263,54181,101850,24406,0.4291360410594348,0.31056027078269943
2388,0.2627,30,77,30,622340,54104,101880,24376,0.42852616905335195,0.31060142711518857
2389,0.2628,26,88,26,622428,54016,101906,24350,0.4278291724749715,0.31072148635888014
2390,0.2629,38,119,38,622547,53897,101944,24312,0.42688664301102525,0.3108593640118145
2391,0.263,39,171,39,622718,53726,101983,24273,0.42553225193258143,0.3111962973884281
2392,0.2631,25,109,25,622827,53617,102008,24248,0.4246689266252693,0.3114107750593977
2393,0.2632,33,94,33,622921,53523,102041,24215,0.4239244075529084,0.31149502173968974
2394,0.2633,37,112,37,623033,53411,102078,24178,0.423037320998606,0.31161633736741035
2395,0.2634,31,95,31,623128,53316,102109,24147,0.4222848815105817,0.31172301614964565
2396,0.2635,31,90,31,623218,53226,102140,24116,0.4215720441008744,0.311809883375139
2397,0.2636,31,64,31,623282,53162,102171,24085,0.4210651374984159,0.31179204370396263
2398,0.2637,39,113,39,623395,53049,102210,24046,0.42017013052845015,0.3119009014851806
2399,0.2638,32,81,32,623476,52968,102242,24014,0.4195285768597136,0.3119430516224572
2400,0.2639,26,82,26,623558,52886,102268,23988,0.41887910277531365,0.3120430834872649
2401,0.264,57,107,57,623665,52779,102325,23931,0.41803161829932833,0.3119671490027376
2402,0.2641,41,92,41,623757,52687,102366,23890,0.41730294005829427,0.3119735690873239
2403,0.2642,45,106,45,623863,52581,102411,23845,0.4164633759979724,0.3120011514406092
2404,0.2643,33,94,33,623957,52487,102444,23812,0.41571885692561145,0.31208796969816116
2405,0.2644,28,69,28,624026,52418,102472,23784,0.4151723482448359,0.3121177921839322
2406,0.2645,36,97,36,624123,52321,102508,23748,0.41440406792548473,0.3121902483271766
2407,0.2646,42,117,42,624240,52204,102550,23706,0.41347737929286527,0.31229087076801476
2408,0.2647,48,78,48,624318,52126,102598,23658,0.412859586871119,0.3121767127625884
2409,0.2648,36,106,36,624424,52020,102634,23622,0.41202002281079714,0.3122868247798842
2410,0.2649,24,110,24,624534,51910,102658,23598,0.41114877708782155,0.3125231763521746
2411,0.265,36,106,36,624640,51804,102694,23562,0.4103092130274997,0.31263434439933124
2412,0.2651,20,54,20,624694,51750,102714,23542,0.4098815105816753,0.31267598151198
2413,0.2652,25,79,25,624773,51671,102739,23517,0.4092557977442656,0.31277597488961006
2414,0.2653,33,79,33,624852,51592,102772,23484,0.40863008490685593,0.3128030262667164
2415,0.2654,26,70,26,624922,51522,102798,23458,0.40807565581041694,0.31285676180314753
2416,0.2655,22,78,22,625000,51444,102820,23436,0.4074578633886706,0.31298076923076923
2417,0.2656,31,103,31,625103,51341,102851,23405,0.40664206057533897,0.3131271238594707
2418,0.2657,59,107,59,625210,51234,102910,23346,0.4057945760993537,0.31303298471440066
2419,0.2658,46,132,46,625342,51102,102956,23300,0.40474908123178305,0.3131636246337464
2420,0.2659,45,95,45,625437,51007,103001,23255,0.4039966417437587,0.31314804341385905
2421,0.266,29,81,29,625518,50926,103030,23226,0.4033550880750222,0.31322149099147695
2422,0.2661,20,59,20,625577,50867,103050,23206,0.40288778355088073,0.3132855426403683
2423,0.2662,55,126,55,625703,50741,103105,23151,0.40188981117729056,0.31330861256969633
2424,0.2663,39,99,39,625802,50642,103144,23112,0.4011056900266126,0.3133660547224557
2425,0.2664,22,90,22,625892,50552,103166,23090,0.4003928526169053,0.3135439015779039
2426,0.2665,34,80,34,625972,50472,103200,23056,0.39975921936383224,0.31356762049831355
2427,0.2666,23,64,23,626036,50408,103223,23033,0.39925231276137374,0.3136259037867131
2428,0.2667,59,158,59,626194,50250,103282,22974,0.3980008870865543,0.3137495902982629
2429,0.2668,26,100,26,626294,50150,103308,22948,0.3972088455202129,0.31393471777613613
2430,0.2669,43,81,43,626375,50069,103351,22905,0.3965672918514764,0.31387891577822236
2431,0.267,30,68,30,626443,50001,103381,22875,0.3960287035863642,0.3138893462868434
2432,0.2671,38,76,38,626519,49925,103419,22837,0.39542675199594474,0.3138588823836618
2433,0.2672,52,110,52,626629,49815,103471,22785,0.3945555062729692,0.3138429752066116
2434,0.2673,56,125,56,626754,49690,103527,22729,0.3935654543150425,0.31385409906240075
2435,0.2674,32,109,32,626863,49581,103559,22697,0.3927021290077303,0.31402363098038133
2436,0.2675,50,127,50,626990,49454,103609,22647,0.39169623621847677,0.31410105268997657
2437,0.2676,25,65,25,627055,49389,103634,22622,0.3911814092003548,0.3141464498479399
2438,0.2677,31,71,31,627126,49318,103665,22591,0.39061905968825245,0.3141609534272483
2439,0.2678,35,84,35,627210,49234,103700,22556,0.38995374477252565,0.3141941774620421
2440,0.2679,28,76,28,627286,49158,103728,22528,0.3893517931821062,0.31425940908964095
2441,0.268,26,43,26,627329,49115,103754,22502,0.3890112153085794,0.31419914266165855
2442,0.2681,34,86,34,627415,49029,103788,22468,0.3883300595615258,0.3142509475922067
2443,0.2682,37,95,37,627510,48934,103825,22431,0.38757762007350144,0.31431373922791284
2444,0.2683,45,116,45,627626,48818,103870,22386,0.3866588518565454,0.3143924498623673
2445,0.2684,31,115,31,627741,48703,103901,22355,0.38574800405525284,0.3146021559852515
2446,0.2685,36,80,36,627821,48623,103937,22319,0.3851143708021797,0.31460911730709595
2447,0.2686,46,106,46,627927,48517,103983,22273,0.3842748067418578,0.3146348354287329
2448,0.2687,29,114,29,628041,48403,104012,22244,0.38337187935622863,0.3148612113748638
2449,0.2688,46,114,46,628155,48289,104058,22198,0.38246895197059944,0.31492331919361016
2450,0.2689,43,116,43,628271,48173,104101,22155,0.3815501837536434,0.3150238880673416
2451,0.269,38,113,38,628384,48060,104139,22117,0.3806551767836776,0.3151602376847115
2452,0.2691,43,107,43,628491,47953,104182,22074,0.3798076923076923,0.31522127179516474
2453,0.2692,27,101,27,628592,47852,104209,22047,0.3790077303256875,0.31541223765719106
2454,0.2693,35,122,35,628714,47730,104244,22012,0.378041439614751,0.31562042958332137
2455,0.2694,32,103,32,628817,47627,104276,21980,0.37722563680141935,0.3157728389386125
2456,0.2695,52,138,52,628955,47489,104328,21928,0.3761326194398682,0.3158880389529942
2457,0.2696,33,90,33,629045,47399,104361,21895,0.37541978203016096,0.31597252287355326
2458,0.2697,26,73,26,629118,47326,104387,21869,0.3748415916867317,0.3160488474600766
2459,0.2698,13,55,13,629173,47271,104400,21856,0.37440596882524396,0.31617168400190954
2460,0.2699,41,97,41,629270,47174,104441,21815,0.3736376885058928,0.3162098305526968
2461,0.27,40,98,40,629368,47076,104481,21775,0.37286148777087824,0.3162626541371948
2462,0.2701,31,86,31,629454,46990,104512,21744,0.3721803320238246,0.3163499869060436
2463,0.2702,34,65,34,629519,46925,104546,21710,0.3716655050057027,0.316310920084505
2464,0.2703,31,65,31,629584,46860,104577,21679,0.3711506779875808,0.31630166766366596
2465,0.2704,41,78,41,629662,46782,104618,21638,0.37053288556583447,0.3162525577316574
2466,0.2705,25,78,25,629740,46704,104643,21613,0.3699150931440882,0.31636342345243496
2467,0.2706,44,129,44,629869,46575,104687,21569,0.36889335952350777,0.3165208969241606
2468,0.2707,33,107,33,629976,46468,104720,21536,0.3680458750475225,0.31668725369095935
2469,0.2708,20,59,20,630035,46409,104740,21516,0.36757857052338105,0.3167611336032389
2470,0.2709,42,80,42,630115,46329,104782,21474,0.36694493727030797,0.31671164992699435
2471,0.271,38,109,38,630224,46220,104820,21436,0.3660816119629958,0.31683812226557884
2472,0.2711,26,70,26,630294,46150,104846,21410,0.36552718286655683,0.3169034931912374
2473,0.2712,32,86,32,630380,46064,104878,21378,0.36484602711950326,0.3169834821031405
2474,0.2713,27,62,27,630442,46002,104905,21351,0.3643549613483716,0.3170014698677119
2475,0.2714,45,113,45,630555,45889,104950,21306,0.3634599543784058,0.31707716347942555
2476,0.2715,41,92,41,630647,45797,104991,21265,0.3627312761373717,0.3170946288509141
2477,0.2716,55,107,55,630754,45690,105046,21210,0.3618837916613864,0.3170403587443946
2478,0.2717,14,46,14,630800,45644,105060,21196,0.36151945254086937,0.31711549970077796
2479,0.2718,27,85,27,630885,45559,105087,21169,0.3608462172094792,0.31724313631459056
2480,0.2719,36,103,36,630988,45456,105123,21133,0.3600304143961475,0.31736472991034553
2481,0.272,38,97,38,631085,45359,105161,21095,0.35926213407679636,0.3174376260270262
2482,0.2721,52,126,52,631211,45233,105213,21043,0.3582641617032062,0.3175055827147082
2483,0.2722,34,87,34,631298,45146,105247,21009,0.35757508554048917,0.31757236792381527
2484,0.2723,40,83,40,631381,45063,105287,20969,0.3569176910404258,0.3175581536224861
2485,0.2724,39,99,39,631480,44964,105326,20930,0.3561335698897478,0.31763134731538534
2486,0.2725,28,60,28,631540,44904,105354,20902,0.355658344949943,0.317630611190469
2487,0.2726,35,80,35,631620,44824,105389,20867,0.35502471169686983,0.31765386430409037
2488,0.2727,33,66,33,631686,44758,105422,20834,0.3545019642630845,0.3176301988047323
2489,0.2728,22,123,22,631809,44635,105444,20812,0.3535277531364846,0.3179977691872813
2490,0.2729,39,71,39,631880,44564,105483,20773,0.3529654036243822,0.31793623827234185
2491,0.273,24,76,24,631956,44488,105507,20749,0.35236345203396274,0.3180557045848215
2492,0.2731,32,85,32,632041,44403,105539,20717,0.35169021670257256,0.3181357493857494
2493,0.2732,30,73,30,632114,44330,105569,20687,0.35111202635914335,0.31817832259255274
2494,0.2733,20,55,20,632169,44275,105589,20667,0.35067640349765555,0.31823781220165687
2495,0.2734,23,47,23,632216,44228,105612,20644,0.3503041439614751,0.3182266617338759
2496,0.2735,25,62,25,632278,44166,105637,20619,0.3498130781903434,0.3182681176198194
2497,0.2736,33,66,33,632344,44100,105670,20586,0.34929033075655813,0.318245060755032
2498,0.2737,38,97,38,632441,44003,105708,20548,0.34852205043720696,0.31832194698765315
2499,0.2738,24,47,24,632488,43956,105732,20524,0.3481497909010265,0.3183002481389578
2500,0.2739,36,92,36,632580,43864,105768,20488,0.34742111265999237,0.3183739433117852
2501,0.274,46,90,46,632670,43774,105814,20442,0.34670827525028514,0.3183318799053195
2502,0.2741,35,88,35,632758,43686,105849,20407,0.3460112786719047,0.3183967047883544
2503,0.2742,39,108,39,632866,43578,105888,20368,0.345155873780256,0.31851875019547743
2504,0.2743,30,89,30,632955,43489,105918,20338,0.3444509567862121,0.318642580726025
2505,0.2744,30,62,30,633017,43427,105948,20308,0.34395989101508045,0.3186318349415549
2506,0.2745,34,88,34,633105,43339,105982,20274,0.34326289443670005,0.31870844009872196
2507,0.2746,28,88,28,633193,43251,106010,20246,0.3425658978583196,0.31884970943509144
2508,0.2747,25,82,25,633275,43169,106035,20221,0.3419164237739197,0.31899353210285536
2509,0.2748,22,79,22,633354,43090,106057,20199,0.3412907109365099,0.3191549874385754
2510,0.2749,31,122,31,633476,42968,106088,20168,0.34032442022557347,0.31943740496705525
2511,0.275,23,53,23,633529,42915,106111,20145,0.3399046381954125,0.31945765937202664
2512,0.2751,32,70,32,633599,42845,106143,20113,0.3393502090989735,0.31946694621811367
2513,0.2752,24,60,24,633659,42785,106167,20089,0.33887498415916867,0.3195120399529217
2514,0.2753,32,88,32,633747,42697,106199,20057,0.33817798758078826,0.3196130923925168
2515,0.2754,25,72,25,633819,42625,106224,20032,0.33760771765302244,0.31970889126514196
2516,0.2755,24,61,24,633880,42564,106248,20008,0.33712457229755416,0.3197596368982932
2517,0.2756,27,78,27,633958,42486,106275,19981,0.3365067798758079,0.3198648886612131
2518,0.2757,35,99,35,634057,42387,106310,19946,0.3357226587251299,0.31999101599473795
2519,0.2758,41,101,41,634158,42286,106351,19905,0.3349226967431251,0.32006238844848933
2520,0.2759,11,36,11,634194,42250,106362,19894,0.3346375617792422,0.32012744593202885
2521,0.276,36,92,36,634286,42158,106398,19858,0.3339088835382081,0.3202076883384933
2522,0.2761,30,69,30,634355,42089,106428,19828,0.33336237485743253,0.3202351535119596
2523,0.2762,22,48,22,634403,42041,106450,19806,0.33298219490558867,0.3202418872378612
2524,0.2763,19,77,19,634480,41964,106469,19787,0.33237232289950575,0.3204320577804408
2525,0.2764,31,69,31,634549,41895,106500,19756,0.3318258142187302,0.32044897892978214
2526,0.2765,18,54,18,634603,41841,106518,19738,0.33139811177290585,0.32053134997320515
2527,0.2766,44,70,44,634673,41771,106562,19694,0.33084368267646685,0.3204099894248759
2528,0.2767,29,81,29,634754,41690,106591,19665,0.3302021290077303,0.3205117757313992
2529,0.2768,27,46,27,634800,41644,106618,19638,0.3298377898872133,0.32045298782676807
2530,0.2769,38,74,38,634874,41570,106656,19600,0.32925167912812064,0.32041850580349845
2531,0.277,26,60,26,634934,41510,106682,19574,0.3287764541883158,0.32044397878331476
2532,0.2771,28,78,28,635012,41432,106710,19546,0.3281586617665695,0.3205418347600774
2533,0.2772,32,88,32,635100,41344,106742,19514,0.3274616651881891,0.3206480659896809
2534,0.2773,32,70,32,635170,41274,106774,19482,0.3269072360917501,0.32065968793205607
2535,0.2774,34,83,34,635253,41191,106808,19448,0.32624984159168674,0.32071768993552
2536,0.2775,54,156,54,635409,41035,106862,19394,0.3250142567481941,0.32093862218471264
2537,0.2776,25,67,25,635476,40968,106887,19369,0.3244835888987454,0.3210136400550243
2538,0.2777,42,76,42,635552,40892,106929,19327,0.3238816373083259,0.32094521662598186
2539,0.2778,13,47,13,635599,40845,106942,19314,0.3235093777721455,0.3210492195681444
2540,0.2779,28,65,28,635664,40780,106970,19286,0.32299455075402356,0.3210801451736423
2541,0.278,34,64,34,635728,40716,107004,19252,0.32248764415156506,0.32103788687299895
2542,0.2781,34,85,34,635813,40631,107038,19218,0.32181440882017487,0.3211081221073034
2543,0.2782,23,79,23,635892,40552,107061,19195,0.32118869598276517,0.32127136090515007
2544,0.2783,43,130,43,636022,40422,107104,19152,0.32015904194652134,0.32148252593413235
2545,0.2784,10,59,10,636081,40363,107114,19142,0.31969173742237994,0.32168725317200236
2546,0.2785,42,75,42,636156,40288,107156,19100,0.3190977062476239,0.3216137940324645
2547,0.2786,41,102,41,636258,40186,107197,19059,0.31828982384995563,0.3216980335893324
2548,0.2787,33,83,33,636341,40103,107230,19026,0.3176324293498923,0.32177104297383685
2549,0.2788,22,85,22,636426,40018,107252,19004,0.3169591940185021,0.32198163396699536
2550,0.2789,20,74,20,636500,39944,107272,18984,0.31637308325940944,0.32215585120825413
2551,0.279,29,76,29,636576,39868,107301,18955,0.31577113166899,0.32223790014110126
2552,0.2791,39,110,39,636686,39758,107340,18916,0.3148998859460144,0.32239151924191295
2553,0.2792,32,101,32,636787,39657,107372,18884,0.31409992396400965,0.3225773389590202
2554,0.2793,33,63,33,636850,39594,107405,18851,0.31360093777721454,0.3225425613824964
2555,0.2794,26,79,26,636929,39515,107431,18825,0.31297522493980484,0.32267740829619473
2556,0.2795,30,68,30,636997,39447,107461,18795,0.3124366366746927,0.3227052642422994
2557,0.2796,34,90,34,637087,39357,107495,18761,0.31172379926498545,0.3228087683678034
2558,0.2797,31,62,31,637149,39295,107526,18730,0.3112327334938538,0.3227919000430849
2559,0.2798,23,89,23,637238,39206,107549,18707,0.3105278164998099,0.323019011275534
2560,0.2799,37,70,37,637308,39136,107586,18670,0.30997338740337094,0.32297685361381173
2561,0.28,46,105,46,637413,39031,107632,18624,0.30914174375871245,0.3230248894284971
2562,0.2801,31,80,31,637493,38951,107663,18593,0.3085081105056393,0.32310927290421243
2563,0.2802,47,79,47,637572,38872,107710,18546,0.3078823976682296,0.3229997561740221
2564,0.2803,36,64,36,637636,38808,107746,18510,0.3073754910657711,0.32293520360096306
2565,0.2804,47,91,47,637727,38717,107793,18463,0.30665473324040043,0.32289261979713185
2566,0.2805,21,91,21,637818,38626,107814,18442,0.30593397541502976,0.3231583374220228
2567,0.2806,40,101,40,637919,38525,107854,18402,0.305134013433025,0.32325609991743814
2568,0.2807,19,47,19,637966,38478,107873,18383,0.3047617538968445,0.32329716325776897
2569,0.2808,30,98,30,638064,38380,107903,18353,0.30398555316182996,0.32349778788359507
2570,0.2809,20,62,20,638126,38318,107923,18333,0.3034944873906983,0.3236129988879278
2571,0.281,23,44,23,638170,38274,107946,18310,0.30314598910150803,0.3235897073377633
2572,0.2811,23,70,23,638240,38204,107969,18287,0.3025915600050691,0.3237152820803314
2573,0.2812,16,42,16,638282,38162,107985,18271,0.30225890254720567,0.32376446405471976
2574,0.2813,27,114,27,638396,38048,108012,18244,0.3013559751615765,0.3240957862573723
2575,0.2814,24,84,24,638480,37964,108036,18220,0.30069066024584973,0.32429161327068207
2576,0.2815,43,74,43,638554,37890,108079,18177,0.3001045494867571,0.32420140189416236
2577,0.2816,18,71,18,638625,37819,108097,18159,0.29954219997465464,0.32439529815284573
2578,0.2817,47,156,47,638781,37663,108144,18112,0.2983066151311621,0.3247333034513671
2579,0.2818,30,81,30,638862,37582,108174,18082,0.29766506146242555,0.3248419085944237
2580,0.2819,23,53,23,638915,37529,108197,18059,0.2972452794322646,0.3248722745916385
2581,0.282,30,81,30,638996,37448,108227,18029,0.29660372576352806,0.3249815238747589
2582,0.2821,43,85,43,639081,37363,108270,17986,0.29593049043213787,0.3249561871036514
2583,0.2822,26,66,26,639147,37297,108296,17960,0.29540774299835254,0.32502669345060353
2584,0.2823,39,50,39,639197,37247,108335,17921,0.29501172221518185,0.3248441125290023
2585,0.2824,24,73,24,639270,37174,108359,17897,0.29443353187175264,0.32498047974433003
2586,0.2825,46,126,46,639396,37048,108405,17851,0.29343555949816247,0.3251607497404324
2587,0.2826,27,76,27,639472,36972,108432,17824,0.292833607907743,0.32527921746112853
2588,0.2827,26,84,26,639556,36888,108458,17798,0.29216829299201624,0.3254580697070548
2589,0.2828,44,88,44,639644,36800,108502,17754,0.2914712964136358,0.32543901455438645
2590,0.2829,29,84,29,639728,36716,108531,17725,0.290805981497909,0.3255818225234658
2591,0.283,21,49,21,639777,36667,108552,17704,0.29041788113040173,0.3256147578672454
2592,0.2831,27,98,27,639875,36569,108579,17677,0.2896416803953871,0.3258673450577001
2593,0.2832,29,111,29,639986,36458,108608,17648,0.2887625142567482,0.32617454626104314
2594,0.2833,29,57,29,640043,36401,108637,17619,0.2883110505639336,0.3261569788967049
2595,0.2834,37,88,37,640131,36313,108674,17582,0.2876140539855532,0.3262269227201039
2596,0.2835,33,70,33,640201,36243,108707,17549,0.2870596248891142,0.3262381023200476
2597,0.2836,23,113,23,640314,36130,108730,17526,0.2861646179191484,0.32663635008200387
2598,0.2837,28,70,28,640384,36060,108758,17498,0.28561018882270944,0.3267112289480563
2599,0.2838,46,87,46,640471,35973,108804,17452,0.28492111265999237,0.32666354702854467
2600,0.2839,45,100,45,640571,35873,108849,17407,0.284129071093651,0.326707957957958
2601,0.284,21,61,21,640632,35812,108870,17386,0.28364592573818276,0.3268167976239708
2602,0.2841,20,39,20,640671,35773,108890,17366,0.2833370295273096,0.32680328948606485
2603,0.2842,43,107,43,640778,35666,108933,17323,0.2824895450513243,0.32691690728264355
2604,0.2843,32,66,32,640844,35600,108965,17291,0.28196679761753896,0.32691762303605526
2605,0.2844,32,94,32,640938,35506,108997,17259,0.28122227854517806,0.3270918222306453
2606,0.2845,32,59,32,640997,35447,109029,17227,0.2807549740210366,0.32704939818506285
2607,0.2846,34,67,34,641064,35380,109063,17193,0.2802243061715879,0.32703098548684684
2608,0.2847,35,67,35,641131,35313,109098,17158,0.27969363832213917,0.32699967601151114
2609,0.2848,34,74,34,641205,35239,109132,17124,0.2791075275630465,0.32702480759314784
2610,0.2849,30,83,30,641288,35156,109162,17094,0.27845013306298316,0.3271578947368421
2611,0.285,28,83,28,641371,35073,109190,17066,0.2777927385629198,0.3273173632022095
2612,0.2851,34,91,34,641462,34982,109224,17032,0.27707198073754913,0.32745030184181184
2613,0.2852,38,97,38,641559,34885,109262,16994,0.27630370041819796,0.32756992231924287
2614,0.2853,36,94,36,641653,34791,109298,16958,0.275559181345837,0.3276971535681849
2615,0.2854,48,75,48,641728,34716,109346,16910,0.274965150171081,0.3275481346608298
2616,0.2855,23,66,23,641794,34650,109369,16887,0.27444240273729564,0.3276675010186856
2617,0.2856,34,62,34,641856,34588,109403,16853,0.27395133696616397,0.3276180478606559
2618,0.2857,22,48,22,641904,34540,109425,16831,0.2735711570143201,0.3276362149851083
2619,0.2858,23,58,23,641962,34482,109448,16808,0.2731117729058421,0.32770520569311756
2620,0.2859,37,66,37,642028,34416,109485,16771,0.27258902547205677,0.3276417840467306
2621,0.286,36,88,36,642116,34328,109521,16735,0.27189202889367636,0.32773240898497935
2622,0.2861,46,94,46,642210,34234,109567,16689,0.2711475098213154,0.3277301023113328
2623,0.2862,31,83,31,642293,34151,109598,16658,0.27049011532125206,0.32785530122616074
2624,0.2863,21,44,21,642337,34107,109619,16637,0.27014161703206185,0.32786142204004415
2625,0.2864,35,54,35,642391,34053,109654,16602,0.2697139145862375,0.3277465205803968
2626,0.2865,26,44,26,642435,34009,109680,16576,0.26936541629704724,0.32768607294652563
2627,0.2866,17,43,17,642478,33966,109697,16559,0.2690248384235205,0.3277387431964374
2628,0.2867,29,66,29,642544,33900,109726,16530,0.26850209098973515,0.3277810826888757
2629,0.2868,36,81,36,642625,33819,109762,16494,0.2678605373209986,0.3278277979846163
2630,0.2869,40,88,40,642713,33731,109802,16454,0.26716354074261817,0.3278668924977583
2631,0.287,36,75,36,642788,33656,109838,16418,0.26656950956786213,0.32787474537684225
2632,0.2871,17,44,17,642832,33612,109855,16401,0.2662210112786719,0.3279347369683882
2633,0.2872,23,70,23,642902,33542,109878,16378,0.26566658218223294,0.32808493589743587
2634,0.2873,33,78,33,642980,33464,109911,16345,0.2650487897604866,0.32815354654781265
2635,0.2874,21,38,21,643018,33426,109932,16324,0.2647478139652769,0.3281206030150754
2636,0.2875,28,83,28,643101,33343,109960,16296,0.26409041946521356,0.3282902556457624
2637,0.2876,25,69,25,643170,33274,109985,16271,0.26354391078443795,0.328408517509335
2638,0.2877,34,53,34,643223,33221,110019,16237,0.26312412875427704,0.3282987585426018
2639,0.2878,23,50,23,643273,33171,110042,16214,0.26272810797110635,0.3283183152779184
2640,0.2879,28,78,28,643351,33093,110070,16186,0.26211031554936004,0.32845634042898597
2641,0.288,20,64,20,643415,33029,110090,16166,0.26160340894690154,0.3286106311617034
2642,0.2881,22,66,22,643481,32963,110112,16144,0.2610806615131162,0.32875150182255075
2643,0.2882,25,72,25,643553,32891,110137,16119,0.2605103915853504,0.3288920628443175
2644,0.2883,31,72,31,643625,32819,110168,16088,0.25994012165758457,0.3289508659292126
2645,0.2884,25,55,25,643680,32764,110193,16063,0.2595044987960968,0.3289778196489647
2646,0.2885,29,62,29,643742,32702,110222,16034,0.25901343302496516,0.3289970453053184
2647,0.2886,16,35,16,643777,32667,110238,16018,0.25873621847674566,0.3290130430317346
2648,0.2887,30,107,30,643884,32560,110268,15988,0.25788873400076034,0.32932355606822117
2649,0.2888,41,105,41,643989,32455,110309,15947,0.2570570903561019,0.32946985661749517
2650,0.2889,25,51,25,644040,32404,110334,15922,0.2566531491572678,0.3294706783098125
2651,0.289,25,79,25,644119,32325,110359,15897,0.2560274363198581,0.3296628095060346
2652,0.2891,19,55,19,644174,32270,110378,15878,0.2555918134583703,0.32977486084572566
2653,0.2892,29,63,29,644237,32207,110407,15849,0.25509282727157523,0.3298027301481605
2654,0.2893,33,82,33,644319,32125,110440,15816,0.25444335318717526,0.3299055088546338
2655,0.2894,29,48,29,644367,32077,110469,15787,0.2540631732353314,0.3298303526658867
2656,0.2895,17,49,17,644416,32028,110486,15770,0.2536750728678241,0.32993012259927196
2657,0.2896,37,109,37,644525,31919,110523,15733,0.252811747560512,0.33016452614790565
2658,0.2897,15,67,15,644592,31852,110538,15718,0.2522810797110632,0.33041833088080724
2659,0.2898,35,89,35,644681,31763,110573,15683,0.2515761627170194,0.33054419761412973
2660,0.2899,27,59,27,644740,31704,110600,15656,0.251108858192878,0.3305743243243243
2661,0.29,21,59,21,644799,31645,110621,15635,0.2506415536687365,0.33068950930626057
2662,0.2901,18,46,18,644845,31599,110639,15617,0.2502772145482195,0.33075652321247034
2663,0.2902,33,62,33,644907,31537,110672,15584,0.24978614877708782,0.3307230321937141
2664,0.2903,22,57,22,644964,31480,110694,15562,0.24933468508427323,0.3308107648484333
2665,0.2904,37,63,37,645027,31417,110731,15525,0.24883569889747814,0.33072728047377614
2666,0.2905,28,68,28,645095,31349,110759,15497,0.24829711063236598,0.3308073261324339
2667,0.2906,29,69,29,645164,31280,110788,15468,0.24775060195159043,0.3308804654744588
2668,0.2907,12,41,12,645205,31239,110800,15456,0.24742586490939045,0.33099903629938965
2669,0.2908,18,42,18,645247,31197,110818,15438,0.24709320745152705,0.33103891926664525
2670,0.2909,38,91,38,645338,31106,110856,15400,0.24637244962615637,0.33114006794822176
2671,0.291,32,63,32,645401,31043,110888,15368,0.24587346343936128,0.3311283962853634
2672,0.2911,31,52,31,645453,30991,110919,15337,0.24546160182486376,0.33105249525125197
2673,0.2912,28,44,28,645497,30947,110947,15309,0.24511310353567356,0.3309624697336562
2674,0.2913,15,69,15,645566,30878,110962,15294,0.24456659485489798,0.33123971237979727
2675,0.2914,28,60,28,645626,30818,110990,15266,0.24409136991509314,0.3312646471660446
2676,0.2915,23,61,23,645687,30757,111013,15243,0.2436082245596249,0.3313695652173913
2677,0.2916,25,63,25,645750,30694,111038,15218,0.2431092383728298,0.33146018470116745
2678,0.2917,30,75,30,645825,30619,111068,15188,0.24251520719807376,0.33156504464383174
2679,0.2918,27,31,27,645856,30588,111095,15161,0.24226967431250793,0.33139522175348096
2680,0.2919,12,52,12,645908,30536,111107,15149,0.2418578126980104,0.33159680420269233
2681,0.292,31,71,31,645979,30465,111138,15118,0.241295463185908,0.3316587324221749
2682,0.2921,16,60,16,646039,30405,111154,15102,0.24082023824610316,0.33186103236864656
2683,0.2922,21,66,21,646105,30339,111175,15081,0.24029749081231783,0.33203434610303834
2684,0.2923,35,78,35,646183,30261,111210,15046,0.23967969839057154,0.3320899640232194
2685,0.2924,38,115,38,646298,30146,111248,15008,0.23876885058927894,0.33237365460424323
2686,0.2925,18,49,18,646347,30097,111266,14990,0.23838075022177163,0.3324683389890656
2687,0.2926,25,75,25,646422,30022,111291,14965,0.2377867190470156,0.3326516549225332
2688,0.2927,30,80,30,646502,29942,111321,14935,0.23715308579394245,0.3327985382267086
2689,0.2928,36,64,36,646566,29878,111357,14899,0.23664617919148398,0.33273778949014005
2690,0.2929,29,59,29,646625,29819,111386,14870,0.23617887466734255,0.33274407572333237
2691,0.293,17,65,17,646690,29754,111403,14853,0.23566404764922064,0.33297464523505277
2692,0.2931,20,40,20,646730,29714,111423,14833,0.23534723102268407,0.332974162120906
2693,0.2932,26,72,26,646802,29642,111449,14807,0.23477696109491827,0.33312335485612726
2694,0.2933,21,59,21,646861,29583,111470,14786,0.23430965657077685,0.3332506930514548
2695,0.2934,42,74,42,646935,29509,111512,14744,0.2337235458116842,0.3331751519670983
2696,0.2935,18,42,18,646977,29467,111530,14726,0.2333908883538208,0.33322019324327384
2697,0.2936,30,60,30,647037,29407,111560,14696,0.23291566341401596,0.3332199623608371
2698,0.2937,26,35,26,647072,29372,111586,14670,0.2326384488657965,0.3330911402751919
2699,0.2938,28,86,28,647158,29286,111614,14642,0.23195729311874289,0.3333181569841559
2700,0.2939,13,32,13,647190,29254,111627,14629,0.23170383981751363,0.3333637171569856
2701,0.294,21,63,21,647253,29191,111648,14608,0.23120485363071855,0.3335235964291422
2702,0.2941,17,45,17,647298,29146,111665,14591,0.2308484349258649,0.33360770057388484
2703,0.2942,28,56,28,647354,29090,111693,14563,0.23040489164871372,0.33360822852953975
2704,0.2943,21,39,21,647393,29051,111714,14542,0.23009599543784057,0.33358566742366896
2705,0.2944,26,63,26,647456,28988,111740,14516,0.2295970092510455,0.3336704670834866
2706,0.2945,21,37,21,647493,28951,111761,14495,0.22930395387149918,0.3336325553560742
2707,0.2946,32,48,32,647541,28903,111793,14463,0.2289237739196553,0.33351012313794215
2708,0.2947,30,74,30,647615,28829,111823,14433,0.22833766316056267,0.33361841801118763
2709,0.2948,18,70,18,647685,28759,111841,14415,0.22778323406412368,0.33388150275628853
2710,0.2949,29,64,29,647749,28695,111870,14386,0.22727632746166518,0.33392911028063416
2711,0.295,16,38,16,647787,28657,111886,14370,0.22697535166645547,0.33397634043739977
2712,0.2951,48,95,48,647882,28562,111934,14322,0.22622291217843113,0.3339707116873426
2713,0.2952,26,52,26,647934,28510,111960,14296,0.2258110505639336,0.33397187310190163
2714,0.2953,27,93,27,648027,28417,111987,14269,0.2250744519072361,0.33427821768261257
2715,0.2954,28,56,28,648083,28361,112015,14241,0.22463090863008492,0.33428008074738275
2716,0.2955,15,31,15,648114,28330,112030,14226,0.22438537574451908,0.3342889369301626
2717,0.2956,32,81,32,648195,28249,112062,14194,0.22374382207578253,0.3344249935207219
2718,0.2957,23,50,23,648245,28199,112085,14171,0.22334780129261184,0.33445834316733536
2719,0.2958,26,74,26,648319,28125,112111,14145,0.22276169053351919,0.33463449254790634
2720,0.2959,22,44,22,648363,28081,112133,14123,0.22241319224432898,0.3346365273433798
2721,0.296,23,55,23,648418,28026,112156,14100,0.22197756938284122,0.3347101552485401
2722,0.2961,28,48,28,648466,27978,112184,14072,0.22159738943099733,0.33464922711058265
2723,0.2962,23,39,23,648505,27939,112207,14049,0.2212884932201242,0.33459559874249784
2724,0.2963,20,53,20,648558,27886,112227,14029,0.22086871118996326,0.33470118096146967
2725,0.2964,28,61,28,648619,27825,112255,14001,0.220385565834495,0.33474393917658873
2726,0.2965,40,72,40,648691,27753,112295,13961,0.21981529590672919,0.3346837992041041
2727,0.2966,18,44,18,648735,27709,112313,13943,0.21946679761753896,0.3347498319408432
2728,0.2967,42,105,42,648840,27604,112355,13901,0.2186351539728805,0.33492350319238645
2729,0.2968,17,42,17,648882,27562,112372,13884,0.2183024965150171,0.33499010760990205
2730,0.2969,42,67,42,648949,27495,112414,13842,0.21777182866556838,0.3348573916829959
2731,0.297,19,28,19,648977,27467,112433,13823,0.2175500570269928,0.3347783967062243
2732,0.2971,22,64,22,649041,27403,112455,13801,0.2170431504245343,0.3349432093971459
2733,0.2972,19,62,19,649103,27341,112474,13782,0.21655208465340262,0.33514091870729273
2734,0.2973,23,42,23,649145,27299,112497,13759,0.21621942719553922,0.33511130595742605
2735,0.2974,32,73,32,649218,27226,112529,13727,0.21564123685211,0.33518911923424416
2736,0.2975,31,70,31,649288,27156,112560,13696,0.21508680775567102,0.3352589836482914
2737,0.2976,39,75,39,649363,27081,112599,13657,0.21449277658091498,0.335239825224606
2738,0.2977,29,57,29,649420,27024,112628,13628,0.21404131288810035,0.33523565876217654
2739,0.2978,18,37,18,649457,26987,112646,13610,0.21374825750855406,0.3352464467817819
2740,0.2979,29,95,29,649552,26892,112675,13581,0.21299581802052972,0.33555703802535025
2741,0.298,31,66,31,649618,26826,112706,13550,0.2124730705867444,0.3355954032098276
2742,0.2981,32,56,32,649674,26770,112738,13518,0.2120295273095932,0.33553415409054804
2743,0.2982,20,76,20,649750,26694,112758,13498,0.21142757571917375,0.33583797770700635
2744,0.2983,28,61,28,649811,26633,112786,13470,0.2109444303637055,0.3358850958781139
2745,0.2984,23,61,23,649872,26572,112809,13447,0.21046128500823724,0.33601539268847297
2746,0.2985,28,84,28,649956,26488,112837,13419,0.20979597009251044,0.3362567970531486
2747,0.2986,13,56,13,650012,26432,112850,13406,0.20935242681535926,0.33651287715246747
2748,0.2987,21,36,21,650048,26396,112871,13385,0.20906729185147638,0.3364671576883437
2749,0.2988,32,72,32,650120,26324,112903,13353,0.20849702192371056,0.33654258134435566
2750,0.2989,20,54,20,650174,26270,112923,13333,0.2080693194778862,0.3366664141605434
2751,0.299,21,44,21,650218,26226,112944,13312,0.20772082118869598,0.33668875512165514
2752,0.2991,19,55,19,650273,26171,112963,13293,0.2072851983272082,0.33683863774579365
2753,0.2992,20,50,20,650323,26121,112983,13273,0.20688917754403752,0.3369294816469513
2754,0.2993,27,55,27,650378,26066,113010,13246,0.20645355468254975,0.33694546194546193
2755,0.2994,20,56,20,650434,26010,113030,13226,0.20601001140539857,0.33708838821490467
2756,0.2995,30,45,30,650479,25965,113060,13196,0.20565359270054492,0.336967901738975
2757,0.2996,48,115,48,650594,25850,113108,13148,0.20474274489925232,0.33714549464075083
2758,0.2997,42,94,42,650688,25756,113150,13106,0.2039982258268914,0.33724460912974114
2759,0.2998,14,22,14,650710,25734,113164,13092,0.2038239766822963,0.3371967238448462
2760,0.2999,14,17,14,650727,25717,113178,13078,0.20368932961601824,0.33710529707436526
2761,0.3,28,57,28,650784,25660,113206,13050,0.20323786592320364,0.33712219064841126
2762,0.3001,20,47,20,650831,25613,113226,13030,0.2028656063870232,0.33718914162979063
2763,0.3002,17,41,17,650872,25572,113243,13013,0.2025408693448232,0.33725541013347154
2764,0.3003,21,52,21,650924,25520,113264,12992,0.2021290077303257,0.3373493975903614
2765,0.3004,9,25,9,650949,25495,113273,12983,0.20193099733874034,0.33741358698477053
2766,0.3005,27,79,27,651028,25416,113300,12956,0.20130528450133062,0.33764203064734705
2767,0.3006,15,44,15,651072,25372,113315,12941,0.20095678621214041,0.3377704695534153
2768,0.3007,20,46,20,651118,25326,113335,12921,0.20059244709162335,0.33783041807200564
2769,0.3008,23,66,23,651184,25260,113358,12898,0.20006969965783805,0.3380156192672572
2770,0.3009,18,52,18,651236,25208,113376,12880,0.1996578380433405,0.33816425120772947
2771,0.301,25,52,25,651288,25156,113401,12855,0.19924597642884298,0.33819157612270134
2772,0.3011,29,78,29,651366,25078,113430,12826,0.1986281840070967,0.33838117349092445
2773,0.3012,25,58,25,651424,25020,113455,12801,0.19816879989861869,0.3384627587848021
2774,0.3013,7,60,7,651484,24960,113462,12794,0.19769357495881384,0.3388779996821529
2775,0.3014,26,65,26,651549,24895,113488,12768,0.19717874794069193,0.3390064519555001
2776,0.3015,17,41,17,651590,24854,113505,12751,0.19685401089849194,0.33907725036564285
2777,0.3016,31,76,31,651666,24778,113536,12720,0.1962520593080725,0.3392180916315537
2778,0.3017,23,55,23,651721,24723,113559,12697,0.19581643644658472,0.3393105291288081
2779,0.3018,25,69,25,651790,24654,113584,12672,0.19526992776580915,0.33949525799710656
2780,0.3019,24,81,24,651871,24573,113608,12648,0.19462837409707262,0.3398081728056742
2781,0.302,23,35,23,651906,24538,113631,12625,0.19435115954885313,0.33971961359416625
2782,0.3021,26,38,26,651944,24500,113657,12599,0.19405018375364338,0.3396048411008383
2783,0.3022,17,46,17,651990,24454,113674,12582,0.19368584463312635,0.33972351225834324
2784,0.3023,18,61,18,652051,24393,113692,12564,0.1932026992776581,0.3399626593067619
2785,0.3024,28,64,28,652115,24329,113720,12536,0.1926957926751996,0.3400515394005154
2786,0.3025,25,59,25,652174,24270,113745,12511,0.19222848815105817,0.3401484462086403
2787,0.3026,28,60,28,652234,24210,113773,12483,0.19175326321125333,0.34020112828059845
2788,0.3027,25,52,25,652286,24158,113798,12458,0.1913414015967558,0.34023377758357004
2789,0.3028,20,43,20,652329,24115,113818,12438,0.191000823723229,0.3402730282056192
2790,0.3029,34,80,34,652409,24035,113852,12404,0.19036719047015588,0.34040451164960617
2791,0.303,8,30,8,652439,24005,113860,12396,0.19012957800025346,0.34054009505233374
2792,0.3031,23,64,23,652503,23941,113883,12373,0.18962267139779496,0.3407225863303409
2793,0.3032,27,59,27,652562,23882,113910,12346,0.18915536687365353,0.3407861322733797
2794,0.3033,24,52,24,652614,23830,113934,12322,0.188743505259156,0.3408386811241425
2795,0.3034,13,28,13,652642,23802,113947,12309,0.18852173362058042,0.34086566420204367
2796,0.3035,25,51,25,652693,23751,113972,12284,0.18811779242174628,0.3408908006105176
2797,0.3036,14,46,14,652739,23705,113986,12270,0.18775345330122925,0.34107018763029884
2798,0.3037,20,39,20,652778,23666,114006,12250,0.1874445570903561,0.3410736162156142
2799,0.3038,28,53,28,652831,23613,114034,12222,0.18702477506019516,0.34106320636249476
2800,0.3039,24,37,24,652868,23576,114058,12198,0.18673171968064883,0.34097389165315595
2801,0.304,16,48,16,652916,23528,114074,12182,0.18635153972880497,0.34113693643237186
2802,0.3041,14,37,14,652953,23491,114088,12168,0.18605848434925865,0.3412322274881517
2803,0.3042,26,82,26,653035,23409,114114,12142,0.1854090102648587,0.34153750949340383
2804,0.3043,16,47,16,653082,23362,114130,12126,0.18503675072867823,0.3416929666366096
2805,0.3044,19,32,19,653114,23330,114149,12107,0.184783297427449,0.34164855941530037
2806,0.3045,19,60,19,653174,23270,114168,12088,0.18430807248764416,0.34187454041518184
2807,0.3046,29,43,29,653217,23227,114197,12059,0.18396749461411735,0.34175026922858925
2808,0.3047,27,60,27,653277,23167,114224,12032,0.1834922696743125,0.3418278928378647
2809,0.3048,43,75,43,653352,23092,114267,11989,0.18289823849955647,0.34175194549756277
2810,0.3049,12,45,12,653397,23047,114279,11977,0.18254181979470283,0.34196550936500686
2811,0.305,38,54,38,653451,22993,114317,11939,0.18211411734887847,0.3417783121493187
2812,0.3051,22,41,22,653492,22952,114339,11917,0.1817893803066785,0.3417648914508589
2813,0.3052,21,53,21,653545,22899,114360,11896,0.18136959827651755,0.34188820232792067
2814,0.3053,35,80,35,653625,22819,114395,11861,0.18073596502344444,0.34201268742791235
2815,0.3054,34,76,34,653701,22743,114429,11827,0.18013401343302496,0.34211744286954004
2816,0.3055,23,39,23,653740,22704,114452,11804,0.17982511722215183,0.3420656079749623
2817,0.3056,26,40,26,653780,22664,114478,11778,0.17950830059561526,0.3419662040531909
2818,0.3057,16,45,16,653825,22619,114494,11762,0.17915188189076162,0.34210755940781246
2819,0.3058,17,62,17,653887,22557,114511,11745,0.17866081611962994,0.34239986006646844
2820,0.3059,25,56,25,653943,22501,114536,11720,0.17821727284247876,0.3424797638876713
2821,0.306,30,63,30,654006,22438,114566,11690,0.17771828665568368,0.34253398968588844
2822,0.3061,30,60,30,654066,22378,114596,11660,0.17724306171587884,0.34255831717492213
2823,0.3062,20,45,20,654111,22333,114616,11640,0.17688664301102522,0.3426250257557472
2824,0.3063,23,29,23,654140,22304,114639,11617,0.1766569509567862,0.34247221485215645
2825,0.3064,25,80,25,654220,22224,114664,11592,0.1760233177037131,0.34279630943931866
2826,0.3065,27,40,27,654260,22184,114691,11565,0.17570650107717653,0.3426768200539275
2827,0.3066,20,43,20,654303,22141,114711,11545,0.17536592320364972,0.34272398028854717
2828,0.3067,22,41,22,654344,22100,114733,11523,0.17504118616144976,0.3427118341611397
2829,0.3068,15,44,15,654388,22056,114748,11508,0.17469268787225953,0.3428673578834466
2830,0.3069,23,59,23,654447,21997,114771,11485,0.1742253833481181,0.3430201302192223
2831,0.307,27,50,27,654497,21947,114798,11458,0.1738293625649474,0.3430025445292621
2832,0.3071,13,44,13,654541,21903,114811,11445,0.17348086427575718,0.3431989924433249
2833,0.3072,28,70,28,654611,21833,114839,11417,0.17292643517931822,0.3433684210526316
2834,0.3073,7,29,7,654640,21804,114846,11410,0.1726967431250792,0.34352983681580057
2835,0.3074,21,37,21,654677,21767,114867,11389,0.17240368774553289,0.3434974062009893
2836,0.3075,25,56,25,654733,21711,114892,11364,0.1719601444683817,0.3435827664399093
2837,0.3076,25,47,25,654780,21664,114917,11339,0.17158788493220123,0.3435748265309214
2838,0.3077,23,55,23,654835,21609,114940,11316,0.17115226207071346,0.3436902050113895
2839,0.3078,13,45,13,654880,21564,114953,11303,0.17079584336585985,0.3439011774728451
2840,0.3079,31,47,31,654927,21517,114984,11272,0.17042358382967937,0.34377382658818506
2841,0.308,23,43,23,654970,21474,115007,11249,0.17008300595615258,0.34376432478684715
2842,0.3081,27,90,27,655060,21384,115034,11222,0.16937016854644532,0.34416978470220205
2843,0.3082,20,38,20,655098,21346,115054,11202,0.16906919275123558,0.34416861251075337
2844,0.3083,29,59,29,655157,21287,115083,11173,0.16860188822709415,0.3442082563154652
2845,0.3084,18,39,18,655196,21248,115101,11155,0.168292992016221,0.34425824769311486
2846,0.3085,13,32,13,655228,21216,115114,11142,0.16803953871499178,0.344335249397367
2847,0.3086,18,42,18,655270,21174,115132,11124,0.16770688125712838,0.344417610997585
2848,0.3087,23,41,23,655311,21133,115155,11101,0.1673821442149284,0.344387913383384
2849,0.3088,21,44,21,655355,21089,115176,11080,0.1670336459257382,0.34443097391899036
2850,0.3089,17,57,17,655412,21032,115193,11063,0.1665821822329236,0.34469543542607883
2851,0.309,21,31,21,655443,21001,115214,11042,0.16633664934735776,0.3445994444964579
2852,0.3091,20,45,20,655488,20956,115234,11022,0.1659802306425041,0.34467446369378946
2853,0.3092,26,55,26,655543,20901,115260,10996,0.16554460778101635,0.3447346145405524
2854,0.3093,22,37,22,655580,20864,115282,10974,0.16525155240147002,0.34468245492807337
2855,0.3094,17,31,17,655611,20833,115299,10957,0.16500601951590418,0.3446681346335326
2856,0.3095,39,55,39,655666,20778,115338,10918,0.16457039665441642,0.344459868753155
2857,0.3096,26,52,26,655718,20726,115364,10892,0.1641585350399189,0.34448731735087607
2858,0.3097,17,61,17,655779,20665,115381,10875,0.16367538968445064,0.3448002536461636
2859,0.3098,3,31,3,655810,20634,115384,10872,0.1634298567988848,0.3450771281660636
2860,0.3099,29,54,29,655864,20580,115413,10843,0.16300215435306045,0.3450657161951437
2861,0.31,14,34,14,655898,20546,115427,10829,0.16273286022050437,0.3451474103585657
2862,0.3101,17,38,17,655936,20508,115444,10812,0.16243188442529463,0.34521072796934865
2863,0.3102,19,57,19,655993,20451,115463,10793,0.16198042073248003,0.3454423249263859
2864,0.3103,16,44,16,656037,20407,115479,10777,0.16163192244328983,0.34559389430477166
2865,0.3104,19,32,19,656069,20375,115498,10758,0.16137846914206058,0.34554973821989526
2866,0.3105,16,34,16,656103,20341,115514,10742,0.1611091750095045,0.345590837435254
2867,0.3106,18,44,18,656147,20297,115532,10724,0.16076067672031427,0.345701299119951
2868,0.3107,17,72,17,656219,20225,115549,10707,0.16019040679254848,0.34614638562006983
2869,0.3108,27,44,27,656263,20181,115576,10680,0.15984190850335825,0.34606785262953244
2870,0.3109,13,31,13,656294,20150,115589,10667,0.1595963756177924,0.3461401174676315
2871,0.311,15,42,15,656336,20108,115604,10652,0.15926371815992904,0.34629388816644996
2872,0.3111,22,53,22,656389,20055,115626,10630,0.1588439361297681,0.3464233338764869
2873,0.3112,20,45,20,656434,20010,115646,10610,0.15848751742491446,0.3465055519268452
2874,0.3113,23,50,23,656484,19960,115669,10587,0.15809149664174377,0.3465806789537434
2875,0.3114,21,51,21,656535,19909,115690,10566,0.15768755544290963,0.3467104183757178
2876,0.3115,28,51,28,656586,19858,115718,10538,0.15728361424407553,0.3466903539939466
2877,0.3116,25,72,25,656658,19786,115743,10513,0.15671334431630973,0.3469751476946434
2878,0.3117,21,47,21,656705,19739,115764,10492,0.15634108478012926,0.34706096391121694
2879,0.3118,36,51,36,656756,19688,115800,10456,0.15593714358129515,0.3468683651804671
2880,0.3119,19,53,19,656809,19635,115819,10437,0.15551736155113421,0.3470670391061452
2881,0.312,16,28,16,656837,19607,115835,10421,0.15529558991255862,0.3470427600905821
2882,0.3121,10,38,10,656875,19569,115845,10411,0.15499461411734888,0.34726484322881923
2883,0.3122,18,29,18,656904,19540,115863,10393,0.15476492206310988,0.34720876624461294
2884,0.3123,25,54,25,656958,19486,115888,10368,0.15433721961728553,0.3472901453741542
2885,0.3124,27,58,27,657016,19428,115915,10341,0.15387783550880751,0.34737478585105314
2886,0.3125,9,25,9,657041,19403,115924,10332,0.15367982511722214,0.3474693122582815
2887,0.3126,35,64,35,657105,19339,115959,10297,0.15317291851476367,0.34744904845458224
2888,0.3127,16,34,16,657139,19305,115975,10281,0.1529036243822076,0.3474954370310282
2889,0.3128,22,54,22,657193,19251,115997,10259,0.15247592193638324,0.3476448661470688
2890,0.3129,18,49,18,657242,19202,116015,10241,0.15208782156887593,0.3478246102638997
2891,0.313,16,28,16,657270,19174,116031,10225,0.15186604993030034,0.34780094561039493
2892,0.3131,21,37,21,657307,19137,116052,10204,0.15157299455075401,0.34777274121536417
2893,0.3132,19,25,19,657332,19112,116071,10185,0.15137498415916867,0.34764651670819535
2894,0.3133,15,38,15,657370,19074,116086,10170,0.15107400836395893,0.34776364382437425
2895,0.3134,14,31,14,657401,19043,116100,10156,0.1508284754783931,0.3478201308263982
2896,0.3135,14,52,14,657453,18991,116114,10142,0.15041661386389557,0.34812755294683007
2897,0.3136,29,50,29,657503,18941,116143,10113,0.15002059308072488,0.34807599642045844
2898,0.3137,16,30,16,657533,18911,116159,10097,0.14978298061082246,0.34807639271924984
2899,0.3138,29,40,29,657573,18871,116188,10068,0.1494661639842859,0.3479042123086492
2900,0.3139,38,54,38,657627,18817,116226,10030,0.14903846153846154,0.3476964675702846
2901,0.314,14,46,14,657673,18771,116240,10016,0.1486741224179445,0.3479348316948623
2902,0.3141,19,54,19,657727,18717,116259,9997,0.14824641997212012,0.34815769311137423
2903,0.3142,25,56,25,657783,18661,116284,9972,0.14780287669496894,0.3482694792721685
2904,0.3143,18,39,18,657822,18622,116302,9954,0.14749398048409582,0.3483342665173572
2905,0.3144,26,51,26,657873,18571,116328,9928,0.14709003928526168,0.34836310045966523
2906,0.3145,24,51,24,657924,18520,116352,9904,0.14668609808642757,0.3484379397692091
2907,0.3146,19,77,19,658001,18443,116371,9885,0.1460762260803447,0.3489480372776052
2908,0.3147,18,44,18,658045,18399,116389,9867,0.14572772779115448,0.3490766291657822
2909,0.3148,37,62,37,658107,18337,116426,9830,0.1452366620200228,0.34898995278162387
2910,0.3149,11,25,11,658132,18312,116437,9819,0.14503865162843746,0.3490455369521169
2911,0.315,22,44,22,658176,18268,116459,9797,0.14469015333924726,0.34908248708355605
2912,0.3151,24,31,24,658207,18237,116483,9773,0.14444462045368142,0.3489111031774366
2913,0.3152,39,61,39,658268,18176,116522,9734,0.14396147509821317,0.3487638839125761
2914,0.3153,24,57,24,658325,18119,116546,9710,0.14351001140539857,0.34891659779366846
2915,0.3154,26,61,26,658386,18058,116572,9684,0.1430268660499303,0.3490736068055656
2916,0.3155,21,50,21,658436,18008,116593,9663,0.1426308452667596,0.34921036464168265
2917,0.3156,15,37,15,658473,17971,116608,9648,0.14233778988721327,0.3493247402150693
2918,0.3157,12,36,12,658509,17935,116620,9636,0.14205265492333038,0.3494976605853977
2919,0.3158,20,31,20,658540,17904,116640,9616,0.14180712203776455,0.3494186046511628
2920,0.3159,13,43,13,658583,17861,116653,9603,0.14146654416423773,0.34965773376055925
2921,0.316,20,47,20,658630,17814,116673,9583,0.1410942846280573,0.3497828229368179
2922,0.3161,23,65,23,658695,17749,116696,9560,0.14057945760993537,0.35006774323483103
2923,0.3162,13,43,13,658738,17706,116709,9547,0.14023887973640856,0.3503100576083367
2924,0.3163,18,29,18,658767,17677,116727,9529,0.14000918768216955,0.35025362052488423
2925,0.3164,10,46,10,658813,17631,116737,9519,0.13964484856165252,0.3506077348066298
2926,0.3165,37,63,37,658876,17568,116774,9482,0.13914586237485743,0.3505360443622921
2927,0.3166,23,72,23,658948,17496,116797,9459,0.1385755924470916,0.35091819699499166
2928,0.3167,11,22,11,658970,17474,116808,9448,0.1384013433024965,0.3509397518757893
2929,0.3168,50,49,50,659019,17425,116858,9398,0.13801324293498923,0.35037095030384374
2930,0.3169,13,39,13,659058,17386,116871,9385,0.13770434672411608,0.35056591087370664
2931,0.317,12,39,12,659097,17347,116883,9373,0.13739545051324292,0.35078592814371257
2932,0.3171,11,30,11,659127,17317,116894,9362,0.1371578380433405,0.3509127028749203
2933,0.3172,22,35,22,659162,17282,116916,9340,0.13688062349512103,0.35083765306889036
2934,0.3173,18,36,18,659198,17246,116934,9322,0.13659548853123812,0.35087323095453177
2935,0.3174,15,33,15,659231,17213,116949,9307,0.13633411481434546,0.35094268476621415
2936,0.3175,17,31,17,659262,17182,116966,9290,0.13608858192877962,0.3509368389241463
2937,0.3176,22,36,22,659298,17146,116988,9268,0.1358034469648967,0.3508745362307867
2938,0.3177,32,77,32,659375,17069,117020,9236,0.13519357495881384,0.3511119559019198
2939,0.3178,18,24,18,659399,17045,117038,9218,0.1350034849828919,0.3509880820926779
2940,0.3179,16,21,16,659420,17024,117054,9202,0.1348371562539602,0.3508731792877297
2941,0.318,17,44,17,659464,16980,117071,9185,0.13448865796477,0.35104146760940186
2942,0.3181,14,31,14,659495,16949,117085,9171,0.13424312507920416,0.35111026033690657
2943,0.3182,22,68,22,659563,16881,117107,9149,0.133704536814092,0.3514790626200538
2944,0.3183,28,63,28,659626,16818,117135,9121,0.13320555062729691,0.35163267666448206
2945,0.3184,27,45,27,659671,16773,117162,9094,0.1328491319224433,0.35156763443770056
2946,0.3185,16,41,16,659712,16732,117178,9078,0.1325243948802433,0.35172413793103446
2947,0.3186,30,59,30,659771,16673,117208,9048,0.13205709035610189,0.3517748143540298
2948,0.3187,12,36,12,659807,16637,117220,9036,0.13177195539221898,0.35196509952089744
2949,0.3188,19,32,19,659839,16605,117239,9017,0.13151850209098973,0.35192412770275544
2950,0.3189,12,21,12,659860,16584,117251,9005,0.13135217336205804,0.35190902340849584
2951,0.319,13,29,13,659889,16555,117264,8992,0.13112248130781903,0.3519787059145888
2952,0.3191,13,40,13,659929,16515,117277,8979,0.13080566468128246,0.3522005177688868
2953,0.3192,12,17,12,659946,16498,117289,8967,0.13067101761500444,0.3521303750245435
2954,0.3193,6,17,6,659963,16481,117295,8961,0.1305363705487264,0.3522128763461992
2955,0.3194,13,60,13,660023,16421,117308,8948,0.13006114560892157,0.35271394221293706
2956,0.3195,20,25,20,660048,16396,117328,8928,0.1298631352173362,0.3525509398199337
2957,0.3196,11,23,11,660071,16373,117339,8917,0.12968096565707768,0.3525899565045473
2958,0.3197,13,28,13,660099,16345,117352,8904,0.1294591940185021,0.3526476296090934
2959,0.3198,30,66,30,660165,16279,117382,8874,0.12893644658471676,0.35280085874448375
2960,0.3199,15,39,15,660204,16240,117397,8859,0.12862755037384363,0.35296226941312403
2961,0.32,18,38,18,660242,16202,117415,8841,0.1283265745786339,0.35303278361218704
2962,0.3201,26,56,26,660298,16146,117441,8815,0.1278830313014827,0.3531509154280678
2963,0.3202,16,28,16,660326,16118,117457,8799,0.12766125966290712,0.353132399566561
2964,0.3203,25,45,25,660371,16073,117482,8774,0.12730484095805347,0.3531211011389705
2965,0.3204,17,43,17,660414,16030,117499,8757,0.12696426308452669,0.353290031064671
2966,0.3205,13,43,13,660457,15987,117512,8744,0.12662368521099987,0.35356435243217016
2967,0.3206,28,38,28,660495,15949,117540,8716,0.12632270941579013,0.35337522805594973
2968,0.3207,26,37,26,660532,15912,117566,8690,0.12602965403624383,0.35322331517762784
2969,0.3208,13,25,13,660557,15887,117579,8677,0.12583164364465846,0.3532405145741736
2970,0.3209,13,32,13,660589,15855,117592,8664,0.12557819034342924,0.35335861984583383
2971,0.321,11,26,11,660615,15829,117603,8653,0.12537225953618045,0.35344334613185197
2972,0.3211,5,17,5,660632,15812,117608,8648,0.12523761246990242,0.353556827473426
2973,0.3212,14,38,14,660670,15774,117622,8634,0.1249366366746927,0.35373647984267453
2974,0.3213,17,32,17,660702,15742,117639,8617,0.12468318337346344,0.3537501539472064
2975,0.3214,29,70,29,660772,15672,117668,8588,0.12412875427702445,0.35399835119538337
2976,0.3215,25,54,25,660826,15618,117693,8563,0.1237010518312001,0.3541210040941235
2977,0.3216,25,30,25,660856,15588,117718,8538,0.12346343936129768,0.35389206665008704
2978,0.3217,14,31,14,660887,15557,117732,8524,0.12321790647573184,0.3539720111291059
2979,0.3218,12,36,12,660923,15521,117744,8512,0.12293277151184895,0.3541796696209379
2980,0.3219,20,38,20,660961,15483,117764,8492,0.12263179571663921,0.35420229405630865
2981,0.322,34,70,34,661031,15413,117798,8458,0.12207736662020023,0.35432114280926646
2982,0.3221,28,39,28,661070,15374,117826,8430,0.12176847040932708,0.35414216098134765
2983,0.3222,20,42,20,661112,15332,117846,8410,0.12143581295146369,0.3542245809114649
2984,0.3223,10,26,10,661138,15306,117856,8400,0.12122988214421493,0.3543406732472792
2985,0.3224,26,22,26,661160,15284,117882,8374,0.12105563299961981,0.3539606052920788
2986,0.3225,27,44,27,661204,15240,117909,8347,0.1207071347104296,0.3538813753338704
2987,0.3226,31,44,31,661248,15196,117940,8316,0.12035863642123938,0.35369173188159236
2988,0.3227,16,25,16,661273,15171,117956,8300,0.12016062602965404,0.3536278812151165
2989,0.3228,22,22,22,661295,15149,117978,8278,0.11998637688505893,0.3533529687966876
2990,0.3229,17,27,17,661322,15122,117995,8261,0.11977252566214674,0.3532908523286148
2991,0.323,10,23,10,661345,15099,118005,8251,0.11959035610188823,0.35336188436830834
2992,0.3231,10,34,10,661379,15065,118015,8241,0.11932106196933215,0.3535999313481507
2993,0.3232,11,25,11,661404,15040,118026,8230,0.1191230515777468,0.35367425870219166
2994,0.3233,11,45,11,661449,14995,118037,8219,0.11876663287289317,0.35405358835185663
2995,0.3234,10,27,10,661476,14968,118047,8209,0.118552781649981,0.35418734089830434
2996,0.3235,12,42,12,661518,14926,118059,8197,0.1182201241921176,0.3544955239372054
2997,0.3236,18,29,18,661547,14897,118077,8179,0.11799043213787859,0.3544375108337667
2998,0.3237,24,39,24,661586,14858,118101,8155,0.11768153592700545,0.35436492417329335
2999,0.3238,14,34,14,661620,14824,118115,8141,0.11741224179444937,0.35449597213150447
3000,0.3239,6,30,6,661650,14794,118121,8135,0.11717462932454695,0.3547908761829997
3001,0.324,23,34,23,661684,14760,118144,8112,0.11690533519199088,0.3546694648478489
3002,0.3241,17,52,17,661736,14708,118161,8095,0.11649347357749334,0.3549971494978731
3003,0.3242,26,58,26,661794,14650,118187,8069,0.11603408946901533,0.35516528016197896
3004,0.3243,14,20,14,661814,14630,118201,8055,0.11587568115574705,0.35508044963632357
3005,0.3244,15,20,15,661834,14610,118216,8040,0.11571727284247878,0.35496688741721855
3006,0.3245,20,31,20,661865,14579,118236,8020,0.11547173995691294,0.3548829594229833
3007,0.3246,14,33,14,661898,14546,118250,8006,0.11521036624002028,0.3550017736786094
3008,0.3247,15,35,15,661933,14511,118265,7991,0.11493315169180078,0.35512398897875747
3009,0.3248,14,26,14,661959,14485,118279,7977,0.11472722088455202,0.3551331137031431
3010,0.3249,17,45,17,662004,14440,118296,7960,0.11437080217969839,0.35535714285714287
3011,0.325,27,40,27,662044,14400,118323,7933,0.11405398555316183,0.3552142569292079
3012,0.3251,14,34,14,662078,14366,118337,7919,0.11378469142060575,0.3553511330491362
3013,0.3252,20,44,20,662122,14322,118357,7899,0.11343619313141554,0.3554745511003105
3014,0.3253,10,7,10,662129,14315,118367,7889,0.11338075022177165,0.35529634300126106
3015,0.3254,17,23,17,662152,14292,118384,7872,0.11319858066151312,0.35517054683270166
3016,0.3255,13,28,13,662180,14264,118397,7859,0.11297680902293752,0.3552411517425304
3017,0.3256,31,47,31,662227,14217,118428,7828,0.11260454948675706,0.35509185756407347
3018,0.3257,22,44,22,662271,14173,118450,7806,0.11225605119756685,0.3551571955048
3019,0.3258,15,46,15,662317,14127,118465,7791,0.1118917120770498,0.35546126471393374
3020,0.3259,6,25,6,662342,14102,118471,7785,0.11169370168546446,0.3556905925892082
3021,0.326,21,26,21,662368,14076,118492,7764,0.1114877708782157,0.3554945054945055
3022,0.3261,20,51,20,662419,14025,118512,7744,0.11108382967938157,0.35573521980798384
3023,0.3262,9,37,9,662456,13988,118521,7735,0.11079077429983525,0.3560742070616397
3024,0.3263,7,38,7,662494,13950,118528,7728,0.11048979850462552,0.3564904511486299
3025,0.3264,19,54,19,662548,13896,118547,7709,0.11006209605880117,0.35681555195556586
3026,0.3265,20,61,20,662609,13835,118567,7689,0.10957895070333291,0.3572291395651366
3027,0.3266,13,32,13,662641,13803,118580,7676,0.10932549740210366,0.35737231714698076
3028,0.3267,18,36,18,662677,13767,118598,7658,0.10904036243822075,0.3574329054842474
3029,0.3268,25,37,25,662714,13730,118623,7633,0.10874730705867444,0.3573000046809905
3030,0.3269,24,58,24,662772,13672,118647,7609,0.10828792295019643,0.35754898735961654
3031,0.327,11,38,11,662810,13634,118658,7598,0.10798694715498669,0.3578560663149962
3032,0.3271,14,18,14,662828,13616,118672,7584,0.10784437967304523,0.35773584905660377
3033,0.3272,22,44,22,662872,13572,118694,7562,0.10749588138385502,0.35781205640200625
3034,0.3273,27,52,27,662924,13520,118721,7535,0.1070840197693575,0.35787223937307056
3035,0.3274,20,56,20,662980,13464,118741,7515,0.10664047649220632,0.3582153582153582
3036,0.3275,9,20,9,663000,13444,118750,7506,0.10648206817893803,0.3582816229116945
3037,0.3276,16,32,16,663032,13412,118766,7490,0.10622861487770878,0.3583389149363697
3038,0.3277,16,56,16,663088,13356,118782,7474,0.1057850716005576,0.35880940950552087
3039,0.3278,21,52,21,663140,13304,118803,7453,0.10537320998606006,0.359059594353712
3040,0.3279,13,22,13,663162,13282,118816,7440,0.10519896084146496,0.35903870282791234
3041,0.328,22,33,22,663195,13249,118838,7418,0.1049375871245723,0.3589296946823438
3042,0.3281,7,18,7,663213,13231,118845,7411,0.10479501964263084,0.3590252882472629
3043,0.3282,19,37,19,663250,13194,118864,7392,0.10450196426308453,0.35907898571844943
3044,0.3283,18,48,18,663298,13146,118882,7374,0.10412178431124065,0.3593567251461988
3045,0.3284,11,29,11,663327,13117,118893,7363,0.10389209225700165,0.359521484375
3046,0.3285,25,70,25,663397,13047,118918,7338,0.10333766316056267,0.35997056659308313
3047,0.3286,21,43,21,663440,13004,118939,7317,0.10299708528703587,0.3600708626543969
3048,0.3287,11,31,11,663471,12973,118950,7306,0.10275155240147003,0.3602741752551901
3049,0.3288,15,22,15,663493,12951,118965,7291,0.10257730325687492,0.360191680663966
3050,0.3289,15,23,15,663516,12928,118980,7276,0.1023951336966164,0.3601267075826569
3051,0.329,12,26,12,663542,12902,118992,7264,0.10218920288936763,0.360210254884459
3052,0.3291,26,47,26,663589,12855,119018,7238,0.10181694335318718,0.36022495396406706
3053,0.3292,12,25,12,663614,12830,119030,7226,0.10161893296160182,0.3602911846828879
3054,0.3293,10,24,10,663638,12806,119040,7216,0.10142884298567989,0.3604035560883029
3055,0.3294,21,29,21,663667,12777,119061,7195,0.10119915093144088,0.36025435609853795
3056,0.3295,14,14,14,663681,12763,119075,7181,0.10108826511215309,0.3600581628559968
3057,0.3296,18,45,18,663726,12718,119093,7163,0.10073184640729946,0.3602937477994065
3058,0.3297,14,26,14,663752,12692,119107,7149,0.1005259156000507,0.3603145002772038
3059,0.3298,20,30,20,663782,12662,119127,7129,0.10028830313014828,0.36021423879541203
3060,0.3299,17,33,17,663815,12629,119144,7112,0.10002692941325561,0.360265437414518
3061,0.33,12,18,12,663833,12611,119156,7100,0.09988436193131416,0.3602049616965146
3062,0.3301,12,21,12,663854,12590,119168,7088,0.09971803320238246,0.3601992072365078
3063,0.3302,17,44,17,663898,12546,119185,7071,0.09936953491319224,0.360452668603762
3064,0.3303,5,7,5,663905,12539,119190,7066,0.09931409200354835,0.3604182606477939
3065,0.3304,12,19,12,663924,12520,119202,7054,0.09916360410594348,0.36037600899151934
3066,0.3305,12,37,12,663961,12483,119214,7042,0.09887054872639717,0.36066581306017925
3067,0.3306,13,19,13,663980,12464,119227,7029,0.0987200608287923,0.36059098137793055
3068,0.3307,24,47,24,664027,12417,119251,7005,0.09834780129261184,0.36067346308310166
3069,0.3308,17,18,17,664045,12399,119268,6988,0.09820523381067038,0.36044772270077885
3070,0.3309,18,29,18,664074,12370,119286,6970,0.09797554175643138,0.3603929679420889
3071,0.331,8,20,8,664094,12350,119294,6962,0.0978171334431631,0.3605012427506214
3072,0.3311,11,25,11,664119,12325,119305,6951,0.09761912305157774,0.360603859721934
3073,0.3312,27,44,27,664163,12281,119332,6924,0.09727062476238753,0.3605311116896642
3074,0.3313,13,29,13,664192,12252,119345,6911,0.09704093270814852,0.36064290559933204
3075,0.3314,21,45,21,664237,12207,119366,6890,0.09668451400329489,0.36078965282505104
3076,0.3315,15,23,15,664260,12184,119381,6875,0.09650234444303638,0.36072196862374734
3077,0.3316,12,28,12,664288,12156,119393,6863,0.09628057280446078,0.3608496766391503
3078,0.3317,13,20,13,664308,12136,119406,6850,0.0961221644911925,0.3607921626461603
3079,0.3318,16,36,16,664344,12100,119422,6834,0.09583702952730959,0.36093799514101615
3080,0.3319,10,37,10,664381,12063,119432,6824,0.09554397414776328,0.36130671890718485
3081,0.332,16,35,16,664416,12028,119448,6808,0.09526675959954378,0.3614355489488214
3082,0.3321,19,33,19,664449,11995,119467,6789,0.09500538588265112,0.36142461669505965
3083,0.3322,10,14,10,664463,11981,119477,6779,0.09489450006336332,0.36135394456289976
3084,0.3323,14,34,14,664497,11947,119491,6765,0.09462520593080725,0.36153270628473705
3085,0.3324,24,37,24,664534,11910,119515,6741,0.09433215055126093,0.36142834164387966
3086,0.3325,14,25,14,664559,11885,119529,6727,0.09413414015967558,0.3614334837739093
3087,0.3326,17,22,17,664581,11863,119546,6710,0.09395989101508047,0.3612771227050019
3088,0.3327,17,34,17,664615,11829,119563,6693,0.0936905968825244,0.3613540654356981
3089,0.3328,18,47,18,664662,11782,119581,6675,0.09331833734634394,0.36165140597063444
3090,0.3329,13,38,13,664700,11744,119594,6662,0.0930173615511342,0.3619471911333261
3091,0.333,11,25,11,664725,11719,119605,6651,0.09281935115954885,0.36205770277626564
3092,0.3331,15,42,15,664767,11677,119620,6636,0.09248669370168547,0.3623655326817015
3093,0.3332,14,25,14,664792,11652,119634,6622,0.09228868331010011,0.36237277005581703
3094,0.3333,9,21,9,664813,11631,119643,6613,0.09212235458116842,0.36247533435650076
3095,0.3334,13,23,13,664836,11608,119656,6600,0.09194018502090989,0.3624780316344464
3096,0.3335,22,57,22,664893,11551,119678,6578,0.0914887213280953,0.3628440620001103
3097,0.3336,23,39,23,664932,11512,119701,6555,0.09117982511722215,0.36281618420324346
3098,0.3337,17,30,17,664962,11482,119718,6538,0.09094221264731973,0.36281908990011097
3099,0.3338,11,18,11,664980,11464,119729,6527,0.09079964516537828,0.3627925073647935
3100,0.3339,9,18,9,664998,11446,119738,6518,0.09065707768343682,0.36283678468047204
3101,0.334,20,35,20,665033,11411,119758,6498,0.09037986313521734,0.36283432910826957
3102,0.3341,10,21,10,665054,11390,119768,6488,0.09021353440628564,0.36290412797852106
3103,0.3342,9,15,9,665069,11375,119777,6479,0.09009472817133443,0.3628878682648146
3104,0.3343,9,32,9,665101,11343,119786,6470,0.08984127487010518,0.36321787458597654
3105,0.3344,2,17,2,665118,11326,119788,6468,0.08970662780382714,0.36349331235247834
3106,0.3345,13,42,13,665160,11284,119801,6455,0.08937397034596375,0.3638874795648007
3107,0.3346,8,30,8,665190,11254,119809,6447,0.08913635787606133,0.364216710920287
3108,0.3347,12,24,12,665214,11230,119821,6435,0.0889462679001394,0.3642796490234928
3109,0.3348,20,26,20,665240,11204,119841,6415,0.08874033709289063,0.364095578636699
3110,0.3349,11,12,11,665252,11192,119852,6404,0.08864529210492966,0.3639463514435099
3111,0.335,6,17,6,665269,11175,119858,6398,0.08851064503865162,0.36408126102543675
3112,0.3351,23,37,23,665306,11138,119881,6375,0.08821758965910531,0.36401530291783246
3113,0.3352,10,21,10,665327,11117,119891,6365,0.08805126093017361,0.3640887770278
3114,0.3353,17,36,17,665363,11081,119908,6348,0.08776612596629071,0.3642205519536405
3115,0.3354,25,32,25,665395,11049,119933,6323,0.08751267266506146,0.3639765139304628
3116,0.3355,19,37,19,665432,11012,119952,6304,0.08721961728551514,0.36405636405636405
3117,0.3356,8,32,8,665464,10980,119960,6296,0.0869661639842859,0.36443621208613103
3118,0.3357,28,33,28,665497,10947,119988,6268,0.08670479026739324,0.36410107464420566
3119,0.3358,11,22,11,665519,10925,119999,6257,0.08653054112279812,0.3641601676172739
3120,0.3359,15,18,15,665537,10907,120014,6242,0.08638797364085667,0.36398623826462184
3121,0.336,18,36,18,665573,10871,120032,6224,0.08610283867697377,0.3640830652237496
3122,0.3361,31,48,31,665621,10823,120063,6193,0.0857226587251299,0.3639515749882464
3123,0.3362,9,13,9,665634,10810,120072,6184,0.08561969332150551,0.36389313875485463
3124,0.3363,12,29,12,665663,10781,120084,6172,0.08539000126726651,0.3640653571639238
3125,0.3364,11,24,11,665687,10757,120095,6161,0.08519991129134458,0.3641683414115144
3126,0.3365,13,26,13,665713,10731,120108,6148,0.0849939804840958,0.364239587653297
3127,0.3366,18,36,18,665749,10695,120126,6130,0.0847088455202129,0.36433878157503713
3128,0.3367,17,23,17,665772,10672,120143,6113,0.08452667595995438,0.36419422103068216
3129,0.3368,10,27,10,665799,10645,120153,6103,0.0843128247370422,0.3644017196083114
3130,0.3369,21,25,21,665824,10620,120174,6082,0.08411481434545685,0.36414800622679916
3131,0.337,13,22,13,665846,10598,120187,6069,0.08394056520086174,0.3641327173456531
3132,0.3371,3,29,3,665875,10569,120190,6066,0.08371087314662273,0.36465284039675383
3133,0.3372,10,26,10,665901,10543,120200,6056,0.08350494233937397,0.3648412554973191
3134,0.3373,18,20,18,665921,10523,120218,6038,0.08334653402610569,0.36459151017450636
3135,0.3374,5,36,5,665957,10487,120223,6033,0.08306139906222279,0.3651937046004843
3136,0.3375,7,10,7,665967,10477,120230,6026,0.08298219490558864,0.36514573107919773
3137,0.3376,6,10,6,665977,10467,120236,6020,0.0829029907489545,0.3651361678898526
3138,0.3377,8,18,8,665995,10449,120244,6012,0.08276042326701305,0.3652268999453253
3139,0.3378,12,21,12,666016,10428,120256,6000,0.08259409453808136,0.36523009495982467
3140,0.3379,14,30,14,666046,10398,120270,5986,0.08235648206817894,0.3653564453125
3141,0.338,13,32,13,666078,10366,120283,5973,0.08210302876694969,0.3655670481669625
3142,0.3381,3,26,3,666104,10340,120286,5970,0.08189709795970093,0.3660331085223789
3143,0.3382,6,16,6,666120,10324,120292,5964,0.0817703713090863,0.3661591355599214
3144,0.3383,7,21,7,666141,10303,120299,5957,0.0816040425801546,0.3663591635916359
3145,0.3384,20,32,20,666173,10271,120319,5937,0.08135058927892536,0.3663005923000987
3146,0.3385,9,24,9,666197,10247,120328,5928,0.08116049930300342,0.3664914992272025
3147,0.3386,14,36,14,666233,10211,120342,5914,0.08087536433912051,0.36675968992248065
3148,0.3387,19,38,19,666271,10173,120361,5895,0.08057438854391079,0.36687826736370427
3149,0.3388,16,26,16,666297,10147,120377,5879,0.08036845773666201,0.36684138275302636
3150,0.3389,9,18,9,666315,10129,120386,5870,0.08022589025472057,0.366897931120695
3151,0.339,19,23,19,666338,10106,120405,5851,0.08004372069446204,0.3666729335088049
3152,0.3391,12,33,12,666371,10073,120417,5839,0.07978234697756938,0.366955756661639
3153,0.3392,9,20,9,666391,10053,120426,5830,0.0796239386643011,0.3670591198136372
3154,0.3393,18,30,18,666421,10023,120444,5812,0.07938632619439868,0.3670350489422166
3155,0.3394,12,48,12,666469,9975,120456,5800,0.07900614624255481,0.3676703645007924
3156,0.3395,10,9,10,666478,9966,120466,5790,0.07893486250158409,0.3674790555978675
3157,0.3396,20,50,20,666528,9916,120486,5770,0.07853884171841338,0.3678439372689022
3158,0.3397,7,20,7,666548,9896,120493,5763,0.0783804334051451,0.36803116418672965
3159,0.3398,15,14,15,666562,9882,120508,5748,0.0782695475858573,0.36775431861804225
3160,0.3399,13,30,13,666592,9852,120521,5735,0.07803193511595488,0.3679348174761019
3161,0.34,14,30,14,666622,9822,120535,5721,0.07779432264605246,0.3680756610692916
3162,0.3401,7,16,7,666638,9806,120542,5714,0.07766759599543784,0.36817010309278353
3163,0.3402,14,35,14,666673,9771,120556,5700,0.07739038144721835,0.3684312584836145
3164,0.3403,12,13,12,666686,9758,120568,5688,0.07728741604359397,0.3682506797876473
3165,0.3404,10,16,10,666702,9742,120578,5678,0.07716068939297935,0.3682230869001297
3166,0.3405,13,28,13,666730,9714,120591,5665,0.07693891775440376,0.3683594511996879
3167,0.3406,7,15,7,666745,9699,120598,5658,0.07682011151945255,0.3684313342449697
3168,0.3407,17,43,17,666788,9656,120615,5641,0.07647953364592573,0.36876511734326994
3169,0.3408,6,25,6,666813,9631,120621,5635,0.07628152325434039,0.36912092231101795
3170,0.3409,9,28,9,666841,9603,120630,5626,0.0760597516157648,0.36942675159235666
3171,0.341,19,16,19,666857,9587,120649,5607,0.07593302496515017,0.369027247597736
3172,0.3411,9,24,9,666881,9563,120658,5598,0.07574293498922824,0.3692368577270629
3173,0.3412,4,26,4,666907,9537,120662,5594,0.07553700418197946,0.3697045800013218
3174,0.3413,16,13,16,666920,9524,120678,5578,0.07543403877835508,0.36935505231095217
3175,0.3414,12,22,12,666942,9502,120690,5566,0.07525978963375998,0.3693920891956464
3176,0.3415,11,22,11,666964,9480,120701,5555,0.07508554048916487,0.3694712337878284
3177,0.3416,19,32,19,666996,9448,120720,5536,0.07483208718793562,0.3694607581420182
3178,0.3417,10,24,10,667020,9424,120730,5526,0.07464199721201369,0.36963210702341137
3179,0.3418,13,14,13,667034,9410,120743,5513,0.07453111139272589,0.3694297393285532
3180,0.3419,20,46,20,667080,9364,120763,5493,0.07416677227220884,0.36972470889143166
3181,0.342,7,9,7,667089,9355,120770,5486,0.07409548853123812,0.36965164072501855
3182,0.3421,8,17,8,667106,9338,120778,5478,0.07396084146496008,0.3697354211663067
3183,0.3422,18,25,18,667131,9313,120796,5460,0.07376283107337472,0.36959317674135245
3184,0.3423,14,20,14,667151,9293,120810,5446,0.07360442276010645,0.3694958952439107
3185,0.3424,16,36,16,667187,9257,120826,5430,0.07331928779622354,0.369714713692381
3186,0.3425,2,19,2,667206,9238,120828,5428,0.07316879989861869,0.3701077321696441
3187,0.3426,22,27,22,667233,9211,120850,5406,0.0729549486757065,0.3698433331052884
3188,0.3427,13,17,13,667250,9194,120863,5393,0.07282030160942846,0.36971275793514774
3189,0.3428,7,19,7,667269,9175,120870,5386,0.0726698137118236,0.3698921777350457
3190,0.3429,12,22,12,667291,9153,120882,5374,0.07249556456722848,0.3699318510360019
3191,0.343,19,20,19,667311,9133,120901,5355,0.07233715625396021,0.36961623412479294
3192,0.3431,14,32,14,667343,9101,120915,5341,0.07208370295273096,0.36982412408253706
3193,0.3432,8,16,8,667359,9085,120923,5333,0.07195697630211634,0.3698848661395478
3194,0.3433,16,27,16,667386,9058,120939,5317,0.07174312507920416,0.3698782608695652
3195,0.3434,10,28,10,667414,9030,120949,5307,0.07152135344062856,0.37016112157355097
3196,0.3435,7,12,7,667426,9018,120956,5300,0.07142630845266759,0.37016343064673835
3197,0.3436,19,38,19,667464,8980,120975,5281,0.07112533265745787,0.3703106374027067
3198,0.3437,5,30,5,667494,8950,120980,5276,0.07088772018755544,0.3708702375931393
3199,0.3438,13,22,13,667516,8928,120993,5263,0.07071347104296033,0.3708688605454161
3200,0.3439,5,13,5,667529,8915,120998,5258,0.07061050563933595,0.3709870881253087
3201,0.344,19,21,19,667550,8894,121017,5239,0.07044417691040426,0.37069270501662777
3202,0.3441,8,18,8,667568,8876,121025,5231,0.07030160942846281,0.3708088183171475
3203,0.3442,11,25,11,667593,8851,121036,5220,0.07010359903687746,0.37097576575936325
3204,0.3443,8,17,8,667610,8834,121044,5212,0.06996895197059942,0.3710664957995159
3205,0.3444,10,16,10,667626,8818,121054,5202,0.0698422253199848,0.3710413694721826
3206,0.3445,11,21,11,667647,8797,121065,5191,0.0696758965910531,0.3711038032599371
3207,0.3446,7,14,7,667661,8783,121072,5184,0.0695650107717653,0.3711605928259469
3208,0.3447,5,16,5,667677,8767,121077,5179,0.06943828412115068,0.3713609637171949
3209,0.3448,14,15,14,667692,8752,121091,5165,0.06931947788619947,0.37112883523747936
3210,0.3449,10,19,10,667711,8733,121101,5155,0.0691689899885946,0.37118375576036866
3211,0.345,12,7,12,667718,8726,121113,5143,0.0691135470789507,0.3708270242987959
3212,0.3451,23,36,23,667754,8690,121136,5120,0.0688284121150678,0.37074583635047065
3213,0.3452,23,25,23,667779,8665,121159,5097,0.06863040172348245,0.3703676791164075
3214,0.3453,8,25,8,667804,8640,121167,5089,0.0684323913318971,0.37067521305266227
3215,0.3454,14,22,14,667826,8618,121181,5075,0.06825814218730199,0.37062732783173885
3216,0.3455,7,22,7,667848,8596,121188,5068,0.06808389304270689,0.3709016393442623
3217,0.3456,10,20,10,667868,8576,121198,5058,0.0679254847294386,0.37098430394601734
3218,0.3457,7,19,7,667887,8557,121205,5051,0.06777499683183373,0.37117871840094063
3219,0.3458,4,17,4,667904,8540,121209,5047,0.06764034976555569,0.37145801133436374
3220,0.3459,4,15,4,667919,8525,121213,5043,0.06752154353060448,0.3716833726415094
3221,0.346,32,59,32,667978,8466,121245,5011,0.06705423900646305,0.3718186540031164
3222,0.3461,18,22,18,668000,8444,121263,4993,0.06687998986186795,0.3715859194760735
3223,0.3462,10,20,10,668020,8424,121273,4983,0.06672158154859967,0.37167151488028644
3224,0.3463,6,26,6,668046,8398,121279,4977,0.0665156507413509,0.37211214953271027
3225,0.3464,5,9,5,668055,8389,121284,4972,0.06644436700038019,0.37212783474290845
3226,0.3465,11,30,11,668085,8359,121295,4961,0.06620675453047777,0.37244744744744746
3227,0.3466,15,19,15,668104,8340,121310,4946,0.0660562666328729,0.372271564052386
3228,0.3467,4,5,4,668109,8335,121314,4942,0.06601666455455582,0.37222264065677485
3229,0.3468,10,17,10,668126,8318,121324,4932,0.06588201748827778,0.3722264150943396
3230,0.3469,24,27,24,668153,8291,121348,4908,0.0656681662653656,0.37184635199636334
3231,0.347,16,20,16,668173,8271,121364,4892,0.06550975795209732,0.3716478006533465
3232,0.3471,3,8,3,668181,8263,121367,4889,0.06544639462679001,0.3717305352798054
3233,0.3472,18,35,18,668216,8228,121385,4871,0.06516918007857052,0.3718604473623941
3234,0.3473,12,37,12,668253,8191,121397,4859,0.0648761246990242,0.37233716475095785
3235,0.3474,6,16,6,668269,8175,121403,4853,0.06474939804840958,0.37250537304267733
3236,0.3475,9,17,9,668286,8158,121412,4844,0.06461475098213154,0.37255806798954005
3237,0.3476,11,26,11,668312,8132,121423,4833,0.06440882017488278,0.3727728499807173
3238,0.3477,11,14,11,668326,8118,121434,4822,0.06429793435559499,0.37264296754250387
3239,0.3478,6,17,6,668343,8101,121440,4816,0.06416328728931694,0.3728419911744213
3240,0.3479,20,34,20,668377,8067,121460,4796,0.06389399315676086,0.3728523672549172
3241,0.348,20,29,20,668406,8038,121480,4776,0.06366430110252186,0.37271734040892773
3242,0.3481,8,22,8,668428,8016,121488,4768,0.06349005195792676,0.37296620775969963
3243,0.3482,16,24,16,668452,7992,121504,4752,0.06329996198200481,0.3728813559322034
3244,0.3483,4,20,4,668472,7972,121508,4748,0.06314155366873654,0.3732704402515723
3245,0.3484,5,12,5,668484,7960,121513,4743,0.06304650868077556,0.3733763677871369
3246,0.3485,12,36,12,668520,7924,121525,4731,0.06276137371689267,0.3738443303042276
3247,0.3486,5,24,5,668544,7900,121530,4726,0.06257128374097072,0.3743069855853002
3248,0.3487,13,21,13,668565,7879,121543,4713,0.062404955012039035,0.37428526048284627
3249,0.3488,14,27,14,668592,7852,121557,4699,0.06219110378912685,0.37439247868695724
3250,0.3489,14,23,14,668615,7829,121571,4685,0.06200893422886833,0.3743806936231421
3251,0.349,5,20,5,668635,7809,121576,4680,0.06185052591560005,0.37472976219072784
3252,0.3491,14,12,14,668647,7797,121590,4666,0.061755480927639085,0.37438818903955706
3253,0.3492,12,18,12,668665,7779,121602,4654,0.06161291344569763,0.3743263894474383
3254,0.3493,8,16,8,668681,7763,121610,4646,0.061486186795083005,0.37440567330163593
3255,0.3494,23,22,23,668703,7741,121633,4623,0.0613119376504879,0.37390812034940146
3256,0.3495,12,14,12,668717,7727,121645,4611,0.0612010518312001,0.37372345598962553
3257,0.3496,12,22,12,668739,7705,121657,4599,0.06102680268660499,0.3737808842652796
3258,0.3497,7,15,7,668754,7690,121664,4592,0.06090799645165378,0.3738804754925908
3259,0.3498,8,32,8,668786,7658,121672,4584,0.06065454315042453,0.37444861950661656
3260,0.3499,14,26,14,668812,7632,121686,4570,0.06044861234317577,0.3745287657761023
3261,0.35,19,25,19,668837,7607,121705,4551,0.06025060195159042,0.374321434446455
3262,0.3501,26,35,26,668872,7572,121731,4525,0.05997338740337093,0.3740596842192279
3263,0.3502,13,15,13,668887,7557,121744,4512,0.05985458116841972,0.37385036042754166
3264,0.3503,12,13,12,668900,7544,121756,4500,0.05975161576479534,0.37363002324809036
3265,0.3504,13,22,13,668922,7522,121769,4487,0.05957736662020023,0.3736364393371638
3266,0.3505,9,17,9,668939,7505,121778,4478,0.05944271955392219,0.3736960694316949
3267,0.3506,10,16,10,668955,7489,121788,4468,0.059315992903307566,0.37367232583423937
3268,0.3507,11,19,11,668974,7470,121799,4457,0.0591655050057027,0.37368994717867027
3269,0.3508,8,12,8,668986,7458,121807,4449,0.05907046001774173,0.37364575459813554
3270,0.3509,14,23,14,669009,7435,121821,4435,0.05888829045748321,0.37363100252737996
3271,0.351,13,24,13,669033,7411,121834,4422,0.05869820048156127,0.37370066762444015
3272,0.3511,6,5,6,669038,7406,121840,4416,0.0586585984032442,0.3735408560311284
3273,0.3512,12,14,12,669052,7392,121852,4404,0.058547712583956406,0.3733468972533062
3274,0.3513,14,19,14,669071,7373,121866,4390,0.05839722468635154,0.3732041145966165
3275,0.3514,10,20,10,669091,7353,121876,4380,0.05823881637308326,0.3733060598312452
3276,0.3515,17,27,17,669118,7326,121893,4363,0.05802496515017108,0.37325690820429464
3277,0.3516,7,4,7,669122,7322,121900,4356,0.05799328348751742,0.3730090768967289
3278,0.3517,10,10,10,669132,7312,121910,4346,0.057914079330883286,0.3727912163321324
3279,0.3518,11,20,11,669152,7292,121921,4335,0.057755671017615,0.372839081448353
3280,0.3519,6,8,6,669160,7284,121927,4329,0.057692307692307696,0.3727718935675536
3281,0.352,14,23,14,669183,7261,121941,4315,0.05751013813204917,0.3727539737387699
3282,0.3521,13,7,13,669190,7254,121954,4302,0.057454695222405275,0.37227414330218067
3283,0.3522,4,14,4,669204,7240,121958,4298,0.05734380940311747,0.3725082336626798
3284,0.3523,9,19,9,669223,7221,121967,4289,0.05719332150551261,0.372632493483927
3285,0.3524,3,9,3,669232,7212,121970,4286,0.05712203776454188,0.3727604800834928
3286,0.3525,16,25,16,669257,7187,121986,4270,0.056924027372956536,0.37269791393907653
3287,0.3526,14,19,14,669276,7168,122000,4256,0.056773539475351666,0.37254901960784315
3288,0.3527,8,14,8,669290,7154,122008,4248,0.05666265365606387,0.37256621645325383
3289,0.3528,15,22,15,669312,7132,122023,4233,0.05648840451146876,0.372459304883414
3290,0.3529,14,23,14,669335,7109,122037,4219,0.05630623495121024,0.3724399717514124
3291,0.353,8,15,8,669350,7094,122045,4211,0.05618742871625903,0.37249004865103935
3292,0.3531,14,19,14,669369,7075,122059,4197,0.056036940818654166,0.3723385379701916
3293,0.3532,7,20,7,669389,7055,122066,4190,0.05587853250538588,0.37261004891062693
3294,0.3533,13,13,13,669402,7042,122079,4177,0.0557755671017615,0.3723148230680096
3295,0.3534,9,20,9,669422,7022,122088,4168,0.05561715878849322,0.37247542448614834
3296,0.3535,12,13,12,669435,7009,122100,4156,0.055514193384868835,0.3722346618898343
3297,0.3536,3,16,3,669451,6993,122103,4153,0.055387466734254216,0.37260003588731383
3298,0.3537,8,17,8,669468,6976,122111,4145,0.055252819667976176,0.3727182807301502
3299,0.3538,9,21,9,669489,6955,122120,4136,0.05508649093904448,0.3729149761067532
3300,0.3539,9,8,9,669497,6947,122129,4127,0.05502312761373717,0.37267473361025827
3301,0.354,22,20,22,669517,6927,122151,4105,0.054864719300468885,0.3720993473531545
3302,0.3541,7,22,7,669539,6905,122158,4098,0.05469047015587378,0.3724438789421067
3303,0.3542,8,14,8,669553,6891,122166,4090,0.05457958433658598,0.372461524451325
3304,0.3543,9,14,9,669567,6877,122175,4081,0.054468698517298186,0.37242197481292205
3305,0.3544,4,12,4,669579,6865,122179,4077,0.05437365352933722,0.3726009870224822
3306,0.3545,14,34,14,669613,6831,122193,4063,0.05410435939678114,0.37295759133467965
3307,0.3546,7,25,7,669638,6806,122200,4056,0.053906349005195794,0.3734118946786964
3308,0.3547,17,27,17,669665,6779,122217,4039,0.05369249778228361,0.37335921612127937
3309,0.3548,12,18,12,669683,6761,122229,4027,0.05354993030034216,0.3732851316277345
3310,0.3549,10,41,10,669724,6720,122239,4017,0.053225193258142185,0.37412685107571947
3311,0.355,8,19,8,669743,6701,122247,4009,0.05307470536053732,0.3743230625583567
3312,0.3551,5,6,5,669749,6695,122252,4004,0.05302718286655684,0.37424058323207776
3313,0.3552,11,22,11,669771,6673,122263,3993,0.05285293372196173,0.3743671479467467
3314,0.3553,10,17,10,669788,6656,122273,3983,0.05271828665568369,0.3743772910987875
3315,0.3554,11,15,11,669803,6641,122284,3972,0.05259948042073248,0.374257985489494
3316,0.3555,8,13,8,669816,6628,122292,3964,0.0524965150171081,0.37424471299093653
3317,0.3556,6,14,6,669830,6614,122298,3958,0.052385629197820305,0.3743851683692773
3318,0.3557,10,15,10,669845,6599,122308,3948,0.052266822962869094,0.37432445245093393
3319,0.3558,14,26,14,669871,6573,122322,3934,0.05206089215562033,0.374417055296469
3320,0.3559,8,14,8,669885,6559,122330,3926,0.05195000633633253,0.37443967572722936
3321,0.356,6,12,6,669897,6547,122336,3920,0.051854961348371566,0.3745103659119136
3322,0.3561,3,10,3,669907,6537,122339,3917,0.05177575719173742,0.3746891142146547
3323,0.3562,7,20,7,669927,6517,122346,3910,0.051617348878469145,0.37498801189220293
3324,0.3563,14,38,14,669965,6479,122360,3896,0.05131637308325941,0.3755180722891566
3325,0.3564,10,19,10,669984,6460,122370,3886,0.05116588518565454,0.37560409820220375
3326,0.3565,14,12,14,669996,6448,122384,3872,0.051070840197693576,0.3751937984496124
3327,0.3566,7,11,7,670007,6437,122391,3865,0.05098371562539602,0.3751698699281693
3328,0.3567,19,34,19,670041,6403,122410,3846,0.050714421492839945,0.37525612254854135
3329,0.3568,7,11,7,670052,6392,122417,3839,0.05062729692054239,0.3752321376209559
3330,0.3569,5,9,5,670061,6383,122422,3834,0.05055601317957167,0.37525692473328764
3331,0.357,11,12,11,670073,6371,122433,3823,0.050460968191610694,0.3750245242299392
3332,0.3571,3,15,3,670088,6356,122436,3820,0.050342161956659484,0.3753930817610063
3333,0.3572,21,25,21,670113,6331,122457,3799,0.05014415156507414,0.37502467917077986
3334,0.3573,6,9,6,670122,6322,122463,3793,0.05007286782410341,0.3749876421156698
3335,0.3574,14,42,14,670164,6280,122477,3779,0.04974021036624002,0.3756834675415051
3336,0.3575,10,27,10,670191,6253,122487,3769,0.04952635914332784,0.37607264019157854
3337,0.3576,5,14,5,670205,6239,122492,3764,0.049415473324040046,0.37628711386584024
3338,0.3577,9,21,9,670226,6218,122501,3755,0.04924914459510835,0.37651659480597616
3339,0.3578,18,17,18,670243,6201,122519,3737,0.04911449752883031,0.37603139464681024
3340,0.3579,12,17,12,670260,6184,122531,3725,0.04897985046255227,0.37592088000807344
3341,0.358,13,21,13,670281,6163,122544,3712,0.04881352173362058,0.3758987341772152
3342,0.3581,5,8,5,670289,6155,122549,3707,0.04875015840831327,0.375887243966741
3343,0.3582,22,29,22,670318,6126,122571,3685,0.04852046635407426,0.37559881765365405
3344,0.3583,8,15,8,670333,6111,122579,3677,0.04840166011912305,0.3756640784634246
3345,0.3584,15,27,15,670360,6084,122594,3662,0.048187808896210875,0.3757438949312539
3346,0.3585,11,26,11,670386,6058,122605,3651,0.04798187808896211,0.3760428468431352
3347,0.3586,7,9,7,670395,6049,122612,3644,0.04791059434799138,0.3759414010110389
3348,0.3587,8,7,8,670402,6042,122620,3636,0.04785515143834748,0.3756974581525109
3349,0.3588,4,6,4,670408,6036,122624,3632,0.047807628944367,0.37567232105916426
3350,0.3589,10,24,10,670432,6012,122634,3622,0.04761753896844506,0.3759601411667013
3351,0.359,21,39,21,670471,5973,122655,3601,0.04730864275757192,0.3761228326718195
3352,0.3591,12,21,12,670492,5952,122667,3589,0.04714231402864022,0.3761660203332984
3353,0.3592,9,17,9,670509,5935,122676,3580,0.047007666962362187,0.3762480294272202
3354,0.3593,6,16,6,670525,5919,122682,3574,0.04688094031174756,0.376487938480986
3355,0.3594,25,45,25,670570,5874,122707,3549,0.04652452160689393,0.37663164597262017
3356,0.3595,11,21,11,670591,5853,122718,3538,0.04635819287796224,0.3767436907677564
3357,0.3596,19,30,19,670621,5823,122737,3519,0.046120580408059816,0.3766859344894027
3358,0.3597,4,11,4,670632,5812,122741,3515,0.04603345583576226,0.37686287123405166
3359,0.3598,2,7,2,670639,5805,122743,3513,0.04597801292611836,0.37701223438506115
3360,0.3599,14,32,14,670671,5773,122757,3499,0.04572455962488912,0.37737273511647973
3361,0.36,8,13,8,670684,5760,122765,3491,0.04562159422126473,0.37736460923143444
3362,0.3601,12,20,12,670704,5740,122777,3479,0.04546318590799645,0.3773728170083523
3363,0.3602,5,17,5,670721,5723,122782,3474,0.04532853884171841,0.37773186908774603
3364,0.3603,16,27,16,670748,5696,122798,3458,0.045114687618806236,0.37775835700240334
3365,0.3604,3,7,3,670755,5689,122801,3455,0.04505924470916234,0.37784339457567806
3366,0.3605,11,15,11,670770,5674,122812,3444,0.04494043847421113,0.37771441105505593
3367,0.3606,5,20,5,670790,5654,122817,3439,0.04478203016094284,0.3782030133069394
3368,0.3607,9,18,9,670808,5636,122826,3430,0.044639462679001395,0.3783366424001765
3369,0.3608,17,27,17,670835,5609,122843,3413,0.04442561145608922,0.3782974950121924
3370,0.3609,5,7,5,670842,5602,122848,3408,0.044370168546445314,0.37824639289678136
3371,0.361,0,8,0,670850,5594,122848,3408,0.04430680522113801,0.37858253721395246
3372,0.3611,8,14,8,670864,5580,122856,3400,0.044195919401850206,0.37861915367483295
3373,0.3612,10,13,10,670877,5567,122866,3390,0.044092953998225826,0.3784749358043988
3374,0.3613,13,27,13,670904,5540,122879,3377,0.04387910277531365,0.3787148143994617
3375,0.3614,10,11,10,670915,5529,122889,3367,0.04379197820301609,0.37848471223021585
3376,0.3615,1,13,1,670928,5516,122890,3366,0.04368901279939171,0.37896870074307587
3377,0.3616,8,24,8,670952,5492,122898,3358,0.043498922823469774,0.37943502824858755
3378,0.3617,9,19,9,670971,5473,122907,3349,0.04334843492586491,0.3796191339832238
3379,0.3618,6,11,6,670982,5462,122913,3343,0.04326131035356735,0.3796706416808631
3380,0.3619,2,5,2,670987,5457,122915,3341,0.043221708275250285,0.3797453966810639
3381,0.362,11,28,11,671015,5429,122926,3330,0.042999936636674695,0.3801803858888001
3382,0.3621,12,15,12,671030,5414,122938,3318,0.042881130401723484,0.37998167659184606
3383,0.3622,16,36,16,671066,5378,122954,3302,0.04259599543784058,0.3804147465437788
3384,0.3623,2,15,2,671081,5363,122956,3300,0.04247718920288937,0.3809303936280734
3385,0.3624,11,21,11,671102,5342,122967,3289,0.04231086047395767,0.381068242382111
3386,0.3625,8,12,8,671114,5330,122975,3281,0.042215815485996705,0.38102427128091976
3387,0.3626,10,22,10,671136,5308,122985,3271,0.0420415663414016,0.38127986944865366
3388,0.3627,6,10,6,671146,5298,122991,3265,0.041962362184767454,0.38129160341001983
3389,0.3628,4,11,4,671157,5287,122995,3261,0.041875237612469904,0.3814927468413664
3390,0.3629,9,17,9,671174,5270,123004,3252,0.041740590546191864,0.38160056324806385
3391,0.363,5,19,5,671193,5251,123009,3247,0.041590102648587,0.38208990350670746
3392,0.3631,7,14,7,671207,5237,123016,3240,0.041479216829299205,0.3822106877433054
3393,0.3632,4,20,4,671227,5217,123020,3236,0.04132080851603092,0.38282266650893176
3394,0.3633,10,23,10,671250,5194,123030,3226,0.0411386389557724,0.3831353919239905
3395,0.3634,16,21,16,671271,5173,123046,3210,0.040972310226840704,0.3829178098532745
3396,0.3635,2,8,2,671279,5165,123048,3208,0.04090894690153339,0.3831362713483817
3397,0.3636,1,7,1,671286,5158,123049,3207,0.040853503991889493,0.3833831440526001
3398,0.3637,3,13,3,671299,5145,123052,3204,0.04075053858826511,0.38375853395616244
3399,0.3638,8,3,8,671302,5142,123060,3196,0.04072677734127487,0.3833053490045574
3400,0.3639,2,3,2,671305,5139,123062,3194,0.04070301609428463,0.3832953318132725
3401,0.364,5,24,5,671329,5115,123067,3189,0.04051292611836269,0.38403179190751446
3402,0.3641,5,7,5,671336,5108,123072,3184,0.040457483208718795,0.3839845634346358
3403,0.3642,2,6,2,671342,5102,123074,3182,0.04040996071473831,0.3841139546112989
3404,0.3643,11,9,11,671351,5093,123085,3171,0.040338676973767584,0.3837124878993224
3405,0.3644,1,6,1,671357,5087,123086,3170,0.0402911544797871,0.3839166767591135
3406,0.3645,11,15,11,671372,5072,123097,3159,0.04017234824483589,0.3837929777669785
3407,0.3646,3,9,3,671381,5063,123100,3156,0.040101064503865164,0.3839883197469279
3408,0.3647,12,21,12,671402,5042,123112,3144,0.03993473577493347,0.3840703640361593
3409,0.3648,7,11,7,671413,5031,123119,3137,0.03984761120263591,0.3840597453476983
3410,0.3649,5,6,5,671419,5025,123124,3132,0.03980008870865543,0.38396469290180213
3411,0.365,12,20,12,671439,5005,123136,3120,0.03964168039538715,0.384
3412,0.3651,5,16,5,671455,4989,123141,3115,0.03951495374477253,0.3843780848963475
3413,0.3652,4,6,4,671461,4983,123145,3111,0.039467431250792044,0.3843587842846553
3414,0.3653,4,8,4,671469,4975,123149,3107,0.03940406792548473,0.38443454590447906
3415,0.3654,9,10,9,671479,4965,123158,3098,0.03932486376885059,0.3842242341560213
3416,0.3655,19,35,19,671514,4930,123177,3079,0.0390476492206311,0.38444250218504183
3417,0.3656,3,13,3,671527,4917,123180,3076,0.03894468381700671,0.38483673214062303
3418,0.3657,11,13,11,671540,4904,123191,3065,0.03884171841338233,0.38461538461538464
3419,0.3658,4,10,4,671550,4894,123195,3061,0.0387625142567482,0.3847894406033941
3420,0.3659,5,10,5,671560,4884,123200,3056,0.038683310100114054,0.3848866498740554
3421,0.366,5,15,5,671575,4869,123205,3051,0.038564503865162844,0.38522727272727275
3422,0.3661,15,21,15,671596,4848,123220,3036,0.03839817513623115,0.3850837138508371
3423,0.3662,6,11,6,671607,4837,123226,3030,0.038311050563933594,0.38515317147578493
3424,0.3663,15,9,15,671616,4828,123241,3015,0.038239766822962866,0.3844192273364784
3425,0.3664,6,10,6,671626,4818,123247,3009,0.03816056266632873,0.3844384821770793
3426,0.3665,2,11,2,671637,4807,123249,3007,0.03807343809403117,0.3848221141540824
3427,0.3666,5,3,5,671640,4804,123254,3002,0.038049676847040935,0.3845759672047143
3428,0.3667,10,17,10,671657,4787,123264,2992,0.037915029780762895,0.3846252731713588
3429,0.3668,8,20,8,671677,4767,123272,2984,0.03775662146749462,0.38498258289253
3430,0.3669,8,9,8,671686,4758,123280,2976,0.03768533772652389,0.3847944142746315
3431,0.367,7,7,7,671693,4751,123287,2969,0.03762989481687999,0.3845854922279793
3432,0.3671,13,9,13,671702,4742,123300,2956,0.037558611075909264,0.38399584307612367
3433,0.3672,1,3,1,671705,4739,123301,2955,0.03753484982891902,0.38406550558877045
3434,0.3673,5,12,5,671717,4727,123306,2950,0.03743980484095805,0.3842646867265859
3435,0.3674,4,9,4,671726,4718,123310,2946,0.037368521099987326,0.3843945720250522
3436,0.3675,8,17,8,671743,4701,123318,2938,0.03723387403370929,0.3846053148317843
3437,0.3676,24,12,24,671755,4689,123342,2914,0.03713882904574832,0.38326976193607787
3438,0.3677,9,9,9,671764,4680,123351,2905,0.03706754530477759,0.3829927488464074
3439,0.3678,7,14,7,671778,4666,123358,2898,0.0369566594854898,0.38313061872025383
3440,0.3679,5,6,5,671784,4660,123363,2893,0.036909136991509314,0.3830266119422746
3441,0.368,5,10,5,671794,4650,123368,2888,0.03682993283487517,0.3831254974794375
3442,0.3681,6,12,6,671806,4638,123374,2882,0.036734887846914206,0.38324468085106383
3443,0.3682,2,13,2,671819,4625,123376,2880,0.036631922443289826,0.38374417055296467
3444,0.3683,8,13,8,671832,4612,123384,2872,0.03652895703966544,0.38375200427578837
3445,0.3684,7,10,7,671842,4602,123391,2865,0.0364497528830313,0.38368822820409804
3446,0.3685,9,10,9,671852,4592,123400,2856,0.03637054872639716,0.38345864661654133
3447,0.3686,4,11,4,671863,4581,123404,2852,0.03628342415409961,0.38369433606888204
3448,0.3687,9,26,9,671889,4555,123413,2843,0.03607749334685084,0.38429305217626386
3449,0.3688,3,19,3,671908,4536,123416,2840,0.03592700544924598,0.38503253796095444
3450,0.3689,2,5,2,671913,4531,123418,2838,0.035887403370928904,0.3851268828877731
3451,0.369,13,15,13,671928,4516,123431,2825,0.035768597135977694,0.38482495572810244
3452,0.3691,5,10,5,671938,4506,123436,2820,0.03568939297934356,0.38493038493038495
3453,0.3692,10,17,10,671955,4489,123446,2810,0.03555474591306552,0.38498424441704343
3454,0.3693,2,7,2,671962,4482,123448,2808,0.03549930300342162,0.3851851851851852
3455,0.3694,9,7,9,671969,4475,123457,2799,0.03544386009377772,0.3847951608468518
3456,0.3695,6,10,6,671979,4465,123463,2793,0.03536465593714358,0.38481675392670156
3457,0.3696,2,10,2,671989,4455,123465,2791,0.035285451780509444,0.38517802925752137
3458,0.3697,11,13,11,672002,4442,123476,2780,0.03518248637688506,0.3849349210744946
3459,0.3698,15,23,15,672025,4419,123491,2765,0.035000316816626534,0.38488307349665923
3460,0.3699,2,5,2,672030,4414,123493,2763,0.034960714738309466,0.384979796572384
3461,0.37,4,2,4,672032,4412,123497,2759,0.034944873906982636,0.38474410821363825
3462,0.3701,1,5,1,672037,4407,123498,2758,0.03490527182866557,0.38492672714584786
3463,0.3702,5,10,5,672047,4397,123503,2753,0.034826067672031426,0.38503496503496504
3464,0.3703,5,13,5,672060,4384,123508,2748,0.034723102268407045,0.3853056646102075
3465,0.3704,7,10,7,672070,4374,123515,2741,0.0346438981117729,0.3852424455375966
3466,0.3705,8,17,8,672087,4357,123523,2733,0.03450925104549487,0.3854724964739069
3467,0.3706,10,10,10,672097,4347,123533,2723,0.03443004688886073,0.38514851485148516
3468,0.3707,4,14,4,672111,4333,123537,2719,0.03431916106957293,0.38556437889960293
3469,0.3708,11,26,11,672137,4307,123548,2708,0.034113230262324164,0.3860299358517463
3470,0.3709,18,19,18,672156,4288,123566,2690,0.0339627423647193,0.38549727715677845
3471,0.371,8,12,8,672168,4276,123574,2682,0.033867697376758335,0.38545559068697904
3472,0.3711,1,16,1,672184,4260,123575,2681,0.03374097072614371,0.3862555827690535
3473,0.3712,8,10,8,672194,4250,123583,2673,0.03366176656950957,0.3861042900476672
3474,0.3713,15,23,15,672217,4227,123598,2658,0.033479597009251044,0.38605664488017427
3475,0.3714,6,9,6,672226,4218,123604,2652,0.03340831326828032,0.3860262008733624
3476,0.3715,6,8,6,672234,4210,123610,2646,0.033344949942973004,0.38593932322053676
3477,0.3716,6,17,6,672251,4193,123616,2640,0.03321030287669497,0.386360310259037
3478,0.3717,8,11,8,672262,4182,123624,2632,0.03312317830439741,0.3862635749926622
3479,0.3718,3,5,3,672267,4177,123627,2629,0.033083576226080345,0.38627681457537466
3480,0.3719,4,9,4,672276,4168,123631,2625,0.03301229248510962,0.3864272044751951
3481,0.372,8,7,8,672283,4161,123639,2617,0.03295684957546572,0.38610209501327825
3482,0.3721,5,3,5,672286,4158,123644,2612,0.032933088328475475,0.38581979320531756
3483,0.3722,8,14,8,672300,4144,123652,2604,0.03282220250918768,0.38589211618257263
3484,0.3723,6,17,6,672317,4127,123658,2598,0.03268755544290965,0.3863197026022305
3485,0.3724,5,12,5,672329,4115,123663,2593,0.032592510454948674,0.38655336911150867
3486,0.3725,4,18,4,672347,4097,123667,2589,0.032449942973007226,0.3872270415794197
3487,0.3726,11,10,11,672357,4087,123678,2578,0.03237073881637308,0.3867966991747937
3488,0.3727,2,12,2,672369,4075,123680,2576,0.03227569382841212,0.3873101789204631
3489,0.3728,13,20,13,672389,4055,123693,2563,0.03211728551514383,0.3872771229978846
3490,0.3729,7,12,7,672401,4043,123700,2556,0.03202224052718287,0.3873314138505834
3491,0.373,5,15,5,672416,4028,123705,2551,0.03190343429223166,0.38774889800881596
3492,0.3731,9,16,9,672432,4012,123714,2542,0.03177670764161703,0.3878547451937748
3493,0.3732,2,5,2,672437,4007,123716,2540,0.031737105563299964,0.38796395295555214
3494,0.3733,12,20,12,672457,3987,123728,2528,0.03157869725003168,0.3880276285495011
3495,0.3734,8,13,8,672470,3974,123736,2520,0.0314757318464073,0.38805050816137976
3496,0.3735,7,6,7,672476,3968,123743,2513,0.031428209352426816,0.3877488041968832
3497,0.3736,4,2,4,672478,3966,123747,2509,0.031412368521099986,0.3874903474903475
3498,0.3737,5,15,5,672493,3951,123752,2504,0.031293562286148775,0.3879163439194423
3499,0.3738,5,10,5,672503,3941,123757,2499,0.031214358129514636,0.38804347826086955
3500,0.3739,9,17,9,672520,3924,123766,2490,0.0310797110632366,0.3882132834424696
3501,0.374,2,7,2,672527,3917,123768,2488,0.031024268153592702,0.3884465261514442
3502,0.3741,11,17,11,672544,3900,123779,2477,0.03088962108731466,0.3884271601066332
3503,0.3742,5,4,5,672548,3896,123784,2472,0.030857939424661005,0.38819095477386933
3504,0.3743,9,12,9,672560,3884,123793,2463,0.03076289443670004,0.38805734992910035
3505,0.3744,7,5,7,672565,3879,123800,2456,0.03072329235838297,0.38768745067087607
3506,0.3745,8,11,8,672576,3868,123808,2448,0.030636167786085414,0.3875870804306523
3507,0.3746,12,19,12,672595,3849,123820,2436,0.030485679888480548,0.3875894988066826
3508,0.3747,6,15,6,672610,3834,123826,2430,0.030366873653529337,0.3879310344827586
3509,0.3748,10,14,10,672624,3820,123836,2420,0.030255987834241542,0.38782051282051283
3510,0.3749,10,14,10,672638,3806,123846,2410,0.030145102014953743,0.38770913770913773
3511,0.375,4,12,4,672650,3794,123850,2406,0.030050057026992778,0.38806451612903226
3512,0.3751,7,8,7,672658,3786,123857,2399,0.029986693701685465,0.38787388843977366
3513,0.3752,9,10,9,672668,3776,123866,2390,0.029907489545051326,0.387609471294194
3514,0.3753,8,16,8,672684,3760,123874,2382,0.0297807628944367,0.38782155649625527
3515,0.3754,7,20,7,672704,3740,123881,2375,0.02962235458116842,0.3883892068683565
3516,0.3755,1,7,1,672711,3733,123882,2374,0.02956691167152452,0.3887342393974128
3517,0.3756,2,11,2,672722,3722,123884,2372,0.029479787099226967,0.3892353134230391
3518,0.3757,3,4,3,672726,3718,123887,2369,0.02944810543657331,0.38919007721373416
3519,0.3758,9,9,9,672735,3709,123896,2360,0.029376821695602587,0.3888614269237107
3520,0.3759,5,12,5,672747,3697,123901,2355,0.029281776707641618,0.3891275611368143
3521,0.376,6,4,6,672751,3693,123907,2349,0.02925009504498796,0.3887785501489573
3522,0.3761,18,28,18,672779,3665,123925,2331,0.029028323406412367,0.38875917278185457
3523,0.3762,2,4,2,672783,3661,123927,2329,0.02899664174375871,0.38881469115191986
3524,0.3763,10,7,10,672790,3654,123937,2319,0.028941198834114813,0.38824711200401807
3525,0.3764,9,14,9,672804,3640,123946,2310,0.028830313014827018,0.38823529411764707
3526,0.3765,5,13,5,672817,3627,123951,2305,0.028727347611202637,0.3885704652730951
3527,0.3766,13,22,13,672839,3605,123964,2292,0.028553098466607526,0.3886722062065457
3528,0.3767,5,8,5,672847,3597,123969,2287,0.028489735141300217,0.38868116927260365
3529,0.3768,2,6,2,672853,3591,123971,2285,0.02844221264731973,0.38886997957794417
3530,0.3769,19,34,19,672887,3557,123990,2266,0.028172918514763653,0.3891464880645715
3531,0.377,6,9,6,672896,3548,123996,2260,0.02810163477379293,0.3891184573002755
3532,0.3771,8,15,8,672911,3533,124004,2252,0.02798282853884172,0.3892826274848747
3533,0.3772,1,5,1,672916,3528,124005,2251,0.027943226460524648,0.38951375670531235
3534,0.3773,4,5,4,672921,3523,124009,2247,0.02790362438220758,0.3894280762564991
3535,0.3774,6,25,6,672946,3498,124015,2241,0.027705613990622227,0.3904861474124412
3536,0.3775,8,12,8,672958,3486,124023,2233,0.027610569002661258,0.390452876376989
3537,0.3776,10,10,10,672968,3476,124033,2223,0.02753136484602712,0.3900684330584313
3538,0.3777,6,9,6,672977,3467,124039,2217,0.027460081105056395,0.3900422237860662
3539,0.3778,6,14,6,672991,3453,124045,2211,0.027349195285768596,0.3903601694915254
3540,0.3779,5,8,5,672999,3445,124050,2206,0.027285831960461283,0.3903733852415502
3541,0.378,4,4,4,673003,3441,124054,2202,0.02725415029780763,0.3902179691653376
3542,0.3781,7,15,7,673018,3426,124061,2195,0.02713534406285642,0.39049991104785625
3543,0.3782,7,8,7,673026,3418,124068,2188,0.027071980737549108,0.39029611130931147
3544,0.3783,1,6,1,673032,3412,124069,2187,0.02702445824356862,0.39060546526165385
3545,0.3784,4,6,4,673038,3406,124073,2183,0.02697693574958814,0.39058865628913936
3546,0.3785,5,14,5,673052,3392,124078,2178,0.026866049930300343,0.3910233393177738
3547,0.3786,3,9,3,673061,3383,124081,2175,0.026794766189329616,0.3913278157610651
3548,0.3787,1,3,1,673064,3380,124082,2174,0.026771004942339374,0.39142960028808066
3549,0.3788,7,8,7,673072,3372,124089,2167,0.02670764161703206,0.39122585304206536
3550,0.3789,7,14,7,673086,3358,124096,2160,0.026596755797744266,0.39144617615077926
3551,0.379,8,7,8,673093,3351,124104,2152,0.02654131288810037,0.3910594221333818
3552,0.3791,2,18,2,673111,3333,124106,2150,0.026398745406158917,0.3921211015867226
3553,0.3792,5,7,5,673118,3326,124111,2145,0.026343302496515016,0.3920672637543411
3554,0.3793,3,13,3,673131,3313,124114,2142,0.026240337092890635,0.3926672777268561
3555,0.3794,5,8,5,673139,3305,124119,2137,0.026176973767583323,0.39268651231165014
3556,0.3795,9,8,9,673147,3297,124128,2128,0.02611361044227601,0.39225806451612905
3557,0.3796,3,9,3,673156,3288,124131,2125,0.026042326701305286,0.3925734343247737
3558,0.3797,3,10,3,673166,3278,124134,2122,0.025963122544671143,0.39296296296296296
3559,0.3798,8,12,8,673178,3266,124142,2114,0.025868077556710178,0.3929368029739777
3560,0.3799,3,10,3,673188,3256,124145,2111,0.025788873400076035,0.393329606856717
3561,0.38,12,14,12,673202,3242,124157,2099,0.02567798758078824,0.39299756599887664
3562,0.3801,7,27,7,673229,3215,124164,2092,0.02546413635787606,0.39419634445072543
3563,0.3802,3,13,3,673242,3202,124167,2089,0.02536117095425168,0.39482139482139483
3564,0.3803,4,9,4,673251,3193,124171,2085,0.025289887213280952,0.39503599848427434
3565,0.3804,15,25,15,673276,3168,124186,2070,0.025091876821695603,0.3951890034364261
3566,0.3805,3,2,3,673278,3166,124189,2067,0.025076035990368773,0.3949933116759029
3567,0.3806,5,8,5,673286,3158,124194,2062,0.025012672665061464,0.39501915708812263
3568,0.3807,6,11,6,673297,3147,124200,2056,0.02492554809276391,0.3951566403997694
3569,0.3808,5,3,5,673300,3144,124205,2051,0.024901786845773665,0.39480269489894126
3570,0.3809,7,7,7,673307,3137,124212,2044,0.024846343936129767,0.39451843273499326
3571,0.381,2,14,2,673321,3123,124214,2042,0.024735458116841972,0.3953533397870281
3572,0.3811,8,11,8,673332,3112,124222,2034,0.024648333544544418,0.39525845316750874
3573,0.3812,1,3,1,673335,3109,124223,2033,0.024624572297554177,0.39537145079735514
3574,0.3813,15,17,15,673352,3092,124238,2018,0.024489925231276136,0.3949119373776908
3575,0.3814,6,9,6,673361,3083,124244,2012,0.024418641490305412,0.3948969578017664
3576,0.3815,12,8,12,673369,3075,124256,2000,0.0243552781649981,0.39408866995073893
3577,0.3816,8,11,8,673380,3064,124264,1992,0.024268153592700546,0.3939873417721519
3578,0.3817,4,8,4,673388,3056,124268,1988,0.024204790267393233,0.39413164155432195
3579,0.3818,5,20,5,673408,3036,124273,1983,0.02404638195412495,0.39509862522414824
3580,0.3819,3,7,3,673415,3029,124276,1980,0.023990939044481054,0.3952884807346776
3581,0.382,6,6,6,673421,3023,124282,1974,0.02394341655050057,0.395037022213328
3582,0.3821,5,7,5,673428,3016,124287,1969,0.023887973640856673,0.3949849548645938
3583,0.3822,3,12,3,673440,3004,124290,1966,0.023792928652895704,0.3955734406438632
3584,0.3823,6,2,6,673442,3002,124296,1960,0.023777087821568874,0.39500201531640466
3585,0.3824,7,14,7,673456,2988,124303,1953,0.02366620200228108,0.39526411657559196
3586,0.3825,4,4,4,673460,2984,124307,1949,0.023634520339627423,0.39509426312588686
3587,0.3826,2,2,2,673462,2982,124309,1947,0.023618679508300596,0.3950091296409008
3588,0.3827,7,11,7,673473,2971,124316,1940,0.023531554936003042,0.39503156180004073
3589,0.3828,9,9,9,673482,2962,124325,1931,0.023460271195032315,0.3946454118127938
3590,0.3829,0,5,0,673487,2957,124325,1931,0.023420669116715247,0.3950490998363339
3591,0.383,2,6,2,673493,2951,124327,1929,0.02337314662273476,0.39528688524590166
3592,0.3831,8,5,8,673498,2946,124335,1921,0.023333544544417693,0.39469899321964247
3593,0.3832,5,6,5,673504,2940,124340,1916,0.023286022050437206,0.39456342668863265
3594,0.3833,5,7,5,673511,2933,124345,1911,0.02323057914079331,0.3945086705202312
3595,0.3834,9,11,9,673522,2922,124354,1902,0.023143454568495755,0.39427860696517414
3596,0.3835,2,4,2,673526,2918,124356,1900,0.0231117729058421,0.39435450394354504
3597,0.3836,7,11,7,673537,2907,124363,1893,0.023024648333544544,0.394375
3598,0.3837,7,11,7,673548,2896,124370,1886,0.02293752376124699,0.3943956503554998
3599,0.3838,5,11,5,673559,2885,124375,1881,0.022850399188949436,0.3946705832983634
3600,0.3839,5,4,5,673563,2881,124380,1876,0.02281871752629578,0.39436619718309857
3601,0.384,11,21,11,673584,2860,124391,1865,0.022652388797364087,0.39470899470899473
3602,0.3841,3,4,3,673588,2856,124394,1862,0.02262070713471043,0.39465875370919884
3603,0.3842,1,5,1,673593,2851,124395,1861,0.02258110505639336,0.3949490662139219
3604,0.3843,2,3,2,673596,2848,124397,1859,0.022557343809403118,0.39494370087104314
3605,0.3844,4,8,4,673604,2840,124401,1855,0.022493980484095805,0.3951011714589989
3606,0.3845,1,9,1,673613,2831,124402,1854,0.022422696743125078,0.39573105656350055
3607,0.3846,3,6,3,673619,2825,124405,1851,0.022375174249144595,0.3958511548331908
3608,0.3847,2,8,2,673627,2817,124407,1849,0.022311810923837282,0.39627089584226316
3609,0.3848,8,12,8,673639,2805,124415,1841,0.022216765935876313,0.39625484287559193
3610,0.3849,2,12,2,673651,2793,124417,1839,0.022121720947915348,0.39702072538860106
3611,0.385,7,11,7,673662,2782,124424,1832,0.022034596375617794,0.39705244906805376
3612,0.3851,2,7,2,673669,2775,124426,1830,0.021979153465973893,0.3973941368078176
3613,0.3852,9,14,9,673683,2761,124435,1821,0.021868267646686097,0.39742470536883456
3614,0.3853,5,10,5,673693,2751,124440,1816,0.021789063490051958,0.39763520910882416
3615,0.3854,9,14,9,673707,2737,124449,1807,0.021678177670764163,0.39766725352112675
3616,0.3855,6,4,6,673711,2733,124455,1801,0.021646496008110507,0.3972209969122188
3617,0.3856,9,16,9,673727,2717,124464,1792,0.02151976935749588,0.3974273674872477
3618,0.3857,8,5,8,673732,2712,124472,1784,0.02148016727917881,0.39679715302491103
3619,0.3858,6,3,6,673735,2709,124478,1778,0.02145640603218857,0.3962558502340094
3620,0.3859,4,2,4,673737,2707,124482,1774,0.021440565200861742,0.3958937737112252
3621,0.386,4,10,4,673747,2697,124486,1770,0.0213613610442276,0.3962390866353257
3622,0.3861,9,6,9,673753,2691,124495,1761,0.021313838550247117,0.39555256064690025
3623,0.3862,9,17,9,673770,2674,124504,1752,0.02117919148396908,0.3958427474017171
3624,0.3863,9,5,9,673775,2669,124513,1743,0.02113958940565201,0.39505893019038985
3625,0.3864,1,1,1,673776,2668,124514,1742,0.021131668989988594,0.39501133786848075
3626,0.3865,7,11,7,673787,2657,124521,1735,0.02104454441769104,0.39503642987249543
3627,0.3866,4,11,4,673798,2646,124525,1731,0.020957419845393486,0.39547635366689515
3628,0.3867,5,8,5,673806,2638,124530,1726,0.020894056520086173,0.39550870760769935
3629,0.3868,1,9,1,673815,2629,124531,1725,0.02082277277911545,0.39618741387230133
3630,0.3869,8,10,8,673825,2619,124539,1717,0.020743568622481307,0.3959870848708487
3631,0.387,0,3,0,673828,2616,124539,1717,0.020719807375491065,0.39626125086545116
3632,0.3871,2,6,2,673834,2610,124541,1715,0.020672284881510582,0.3965317919075145
3633,0.3872,1,2,1,673836,2608,124542,1714,0.020656444050183752,0.3965756594169366
3634,0.3873,6,11,6,673847,2597,124548,1708,0.0205693194778862,0.3967479674796748
3635,0.3874,6,12,6,673859,2585,124554,1702,0.020474274489925233,0.3970142290646139
3636,0.3875,9,19,9,673878,2566,124563,1693,0.020323786592320366,0.3975111528527823
3637,0.3876,4,5,4,673883,2561,124567,1689,0.020284184514003295,0.39741176470588235
3638,0.3877,5,12,5,673895,2549,124572,1684,0.020189139526042326,0.39782660051972596
3639,0.3878,2,2,2,673897,2547,124574,1682,0.0201732986947155,0.3977299598013715
3640,0.3879,2,4,2,673901,2543,124576,1680,0.020141617032061843,0.39782145394269475
3641,0.388,2,9,2,673910,2534,124578,1678,0.020070333291091116,0.3983855650522317
3642,0.3881,6,4,6,673914,2530,124584,1672,0.02003865162843746,0.39790575916230364
3643,0.3882,1,6,1,673920,2524,124585,1671,0.019991129134456977,0.398331346841478
3644,0.3883,2,7,2,673927,2517,124587,1669,0.01993568622481308,0.3987099856665074
3645,0.3884,10,12,10,673939,2505,124597,1659,0.01984064123685211,0.3984149855907781
3646,0.3885,1,5,1,673944,2500,124598,1658,0.01980103915853504,0.39874939874939874
3647,0.3886,3,17,3,673961,2483,124601,1655,0.019666392092257002,0.3999516674722088
3648,0.3887,1,3,1,673964,2480,124602,1654,0.01964263084526676,0.40009675858732463
3649,0.3888,7,9,7,673973,2471,124609,1647,0.019571347104296033,0.39995143273433703
3650,0.3889,8,5,8,673978,2466,124617,1639,0.01953174502597896,0.3992691839220463
3651,0.389,5,10,5,673988,2456,124622,1634,0.019452540869344823,0.3995110024449878
3652,0.3891,3,5,3,673993,2451,124625,1631,0.019412938791027755,0.3995590396864282
3653,0.3892,3,5,3,673998,2446,124628,1628,0.019373336712710684,0.39960726558664705
3654,0.3893,5,4,5,674002,2442,124633,1623,0.019341655050057027,0.3992619926199262
3655,0.3894,1,3,1,674005,2439,124634,1622,0.019317893803066786,0.39940901255848316
3656,0.3895,2,5,2,674010,2434,124636,1620,0.019278291724749715,0.39960532807104093
3657,0.3896,1,3,1,674013,2431,124637,1619,0.019254530477759473,0.3997530864197531
3658,0.3897,9,25,9,674038,2406,124646,1610,0.019056520086174124,0.40089641434262946
3659,0.3898,5,5,5,674043,2401,124651,1605,0.019016918007857053,0.40064902646030953
3660,0.3899,5,13,5,674056,2388,124656,1600,0.01891395260423267,0.4012036108324975
3661,0.39,7,13,7,674069,2375,124663,1593,0.018810987200608288,0.4014616935483871
3662,0.3901,0,5,0,674074,2370,124663,1593,0.018771385122291217,0.40196820590461774
3663,0.3902,1,3,1,674077,2367,124664,1592,0.018747623875300976,0.4021217479161404
3664,0.3903,8,6,8,674083,2361,124672,1584,0.018700101381320493,0.40152091254752853
3665,0.3904,5,6,5,674089,2355,124677,1579,0.018652578887340007,0.40137264870360956
3666,0.3905,2,3,2,674092,2352,124679,1577,0.018628817640349765,0.40137439552048865
3667,0.3906,3,10,3,674102,2342,124682,1574,0.018549613483715626,0.40194075587334016
3668,0.3907,4,9,4,674111,2333,124686,1570,0.0184783297427449,0.40225467589034075
3669,0.3908,5,10,5,674121,2323,124691,1565,0.01839912558611076,0.40252057613168724
3670,0.3909,1,4,1,674125,2319,124692,1564,0.018367443923457103,0.4027813546227144
3671,0.391,2,3,2,674128,2316,124694,1562,0.018343682676466862,0.4027849406910779
3672,0.3911,2,7,2,674135,2309,124696,1560,0.018288239766822964,0.4032049625226157
3673,0.3912,3,9,3,674144,2300,124699,1557,0.018216956025852236,0.4036816178376977
3674,0.3913,8,6,8,674150,2294,124707,1549,0.018169433531871754,0.40307051782461617
3675,0.3914,5,4,5,674154,2290,124712,1544,0.018137751869218097,0.40271257172665625
3676,0.3915,10,12,10,674166,2278,124722,1534,0.01804270688125713,0.4024134312696747
3677,0.3916,1,7,1,674173,2271,124723,1533,0.01798726397161323,0.4029968454258675
3678,0.3917,4,7,4,674180,2264,124727,1529,0.017931821061969333,0.40311099393619826
3679,0.3918,8,7,8,674187,2257,124735,1521,0.017876378152325435,0.40259396506087874
3680,0.3919,1,6,1,674193,2251,124736,1520,0.01782885565834495,0.4030761071333864
3681,0.392,5,7,5,674200,2244,124741,1515,0.01777341274870105,0.4030327214684757
3682,0.3921,0,6,0,674206,2238,124741,1515,0.01772589025472057,0.40367705835331735
3683,0.3922,5,11,5,674217,2227,124746,1510,0.017638765682423015,0.40406743377040405
3684,0.3923,2,2,2,674219,2225,124748,1508,0.017622924851096185,0.4039646396999732
3685,0.3924,9,21,9,674240,2204,124757,1499,0.01745659612216449,0.4048069133135296
3686,0.3925,18,17,18,674257,2187,124775,1481,0.01732194905588645,0.4037622682660851
3687,0.3926,9,12,9,674269,2175,124784,1472,0.017226904067925486,0.4036194132163422
3688,0.3927,2,3,2,674272,2172,124786,1470,0.01720314282093524,0.40362438220757824
3689,0.3928,6,5,6,674277,2167,124792,1464,0.017163540742618173,0.40319471220049574
3690,0.3929,1,1,1,674278,2166,124793,1463,0.01715562032695476,0.4031413612565445
3691,0.393,5,10,5,674288,2156,124798,1458,0.01707641617032062,0.4034311012728279
3692,0.3931,5,4,5,674292,2152,124803,1453,0.017044734507666963,0.4030513176144244
3693,0.3932,5,7,5,674299,2145,124808,1448,0.016989291598023065,0.4030058446980239
3694,0.3933,8,11,8,674310,2134,124816,1440,0.01690216702572551,0.4029099048684947
3695,0.3934,2,1,2,674311,2133,124818,1438,0.016894246610062096,0.40268832259871185
3696,0.3935,2,3,2,674314,2130,124820,1436,0.016870485363071855,0.4026920919798093
3697,0.3936,2,3,2,674317,2127,124822,1434,0.016846724116081613,0.4026958719460826
3698,0.3937,2,0,2,674317,2127,124824,1432,0.016846724116081613,0.4023602135431301
3699,0.3938,5,12,5,674329,2115,124829,1427,0.016751679128120645,0.4028797289666855
3700,0.3939,2,8,2,674337,2107,124831,1425,0.016688315802813332,0.4034541336353341
3701,0.394,5,17,5,674354,2090,124836,1420,0.01655366873653529,0.4045584045584046
3702,0.3941,2,6,2,674360,2084,124838,1418,0.01650614624255481,0.4049114791547687
3703,0.3942,4,1,4,674361,2083,124842,1414,0.016498225826891394,0.4043465827852445
3704,0.3943,2,9,2,674370,2074,124844,1412,0.01642694208592067,0.40504876649454963
3705,0.3944,11,15,11,674385,2059,124855,1401,0.01630813585096946,0.40491329479768784
3706,0.3945,1,5,1,674390,2054,124856,1400,0.016268533772652388,0.4053271569195136
3707,0.3946,3,8,3,674398,2046,124859,1397,0.016205170447345076,0.4057507987220447
3708,0.3947,2,4,2,674402,2042,124861,1395,0.01617348878469142,0.40587721850450975
3709,0.3948,3,6,3,674408,2036,124864,1392,0.016125966290710936,0.40606767794632437
3710,0.3949,6,17,6,674425,2019,124870,1386,0.0159913192244329,0.40704845814977975
3711,0.395,3,3,3,674428,2016,124873,1383,0.015967557977442655,0.40688437775816416
3712,0.3951,11,11,11,674439,2005,124884,1372,0.0158804334051451,0.40627776132662125
3713,0.3952,3,11,3,674450,1994,124887,1369,0.015793308832847547,0.40707701457032414
3714,0.3953,6,17,6,674467,1977,124893,1363,0.01565866176656951,0.40808383233532936
3715,0.3954,4,5,4,674472,1972,124897,1359,0.015619059688252439,0.40798558991293904
3716,0.3955,3,4,3,674476,1968,124900,1356,0.015587378025598784,0.40794223826714804
3717,0.3956,1,3,1,674479,1965,124901,1355,0.015563616778608541,0.40813253012048195
3718,0.3957,3,10,3,674489,1955,124904,1352,0.015484412621974402,0.4088297550650136
3719,0.3958,7,7,7,674496,1948,124911,1345,0.015428969712330503,0.40844215001518375
3720,0.3959,1,2,1,674498,1946,124912,1344,0.015413128881003674,0.4085106382978723
3721,0.396,2,4,2,674502,1942,124914,1342,0.01538144721835002,0.40864799025578563
3722,0.3961,6,6,6,674508,1936,124920,1336,0.015333924724369535,0.4083129584352078
3723,0.3962,2,5,2,674513,1931,124922,1334,0.015294322646052464,0.4085758039816233
3724,0.3963,8,9,8,674522,1922,124930,1326,0.015223038905081738,0.4082512315270936
3725,0.3964,1,7,1,674529,1915,124931,1325,0.01516759599543784,0.4089506172839506
3726,0.3965,9,10,9,674539,1905,124940,1316,0.0150883918388037,0.40856876746352067
3727,0.3966,2,5,2,674544,1900,124942,1314,0.01504878976048663,0.40883634100808963
3728,0.3967,3,12,3,674556,1888,124945,1311,0.014953744772525663,0.4098155673648015
3729,0.3968,8,7,8,674563,1881,124953,1303,0.014898301862881764,0.40923366834170855
3730,0.3969,4,6,4,674569,1875,124957,1299,0.01485077936890128,0.40926275992438566
3731,0.397,3,2,3,674571,1873,124960,1296,0.014834938537574453,0.40896181760807826
3732,0.3971,1,2,1,674573,1871,124961,1295,0.014819097706247624,0.40903348073278584
3733,0.3972,0,2,0,674575,1869,124961,1295,0.014803256874920796,0.4092920353982301
3734,0.3973,4,3,4,674578,1866,124965,1291,0.014779495627930553,0.4089325308837504
3735,0.3974,6,3,6,674581,1863,124971,1285,0.014755734380940312,0.4081956797966963
3736,0.3975,8,5,8,674586,1858,124979,1277,0.014716132302623242,0.40733652312599683
3737,0.3976,5,5,5,674591,1853,124984,1272,0.014676530224306171,0.40704
3738,0.3977,2,0,2,674591,1853,124986,1270,0.014676530224306171,0.40666026256804355
3739,0.3978,1,3,1,674594,1850,124987,1269,0.01465276897731593,0.4068611734530298
3740,0.3979,6,13,6,674607,1837,124993,1263,0.014549803573691547,0.40741935483870967
3741,0.398,2,3,2,674610,1834,124995,1261,0.014526042326701306,0.4074313408723748
3742,0.3981,1,5,1,674615,1829,124996,1260,0.014486440248384235,0.40789899643897704
3743,0.3982,1,4,1,674619,1825,124997,1259,0.014454758585730578,0.4082360570687419
3744,0.3983,4,11,4,674630,1814,125001,1255,0.014367634013433024,0.40892798957315085
3745,0.3984,18,18,18,674648,1796,125019,1237,0.014225066531491573,0.4078470161556215
3746,0.3985,0,1,0,674649,1795,125019,1237,0.01421714611582816,0.40798153034300794
3747,0.3986,5,7,5,674656,1788,125024,1232,0.01416170320618426,0.40794701986754967
3748,0.3987,7,8,7,674664,1780,125031,1225,0.01409833988087695,0.40765391014975044
3749,0.3988,3,5,3,674669,1775,125034,1222,0.014058737802559878,0.4077410744077411
3750,0.3989,1,2,1,674671,1773,125035,1221,0.01404289697123305,0.40781563126252507
3751,0.399,5,5,5,674676,1768,125040,1216,0.01400329489291598,0.4075067024128686
3752,0.3991,3,2,3,674678,1766,125043,1213,0.013987454061589152,0.40718361866398123
3753,0.3992,16,14,16,674692,1752,125059,1197,0.013876568242301357,0.4059003051881994
3754,0.3993,2,6,2,674698,1746,125061,1195,0.013829045748320872,0.4063243794627678
3755,0.3994,3,3,3,674701,1743,125064,1192,0.013805284501330629,0.4061328790459966
3756,0.3995,2,6,2,674707,1737,125066,1190,0.013757762007350146,0.40655961735565427
3757,0.3996,8,11,8,674718,1726,125074,1182,0.013670637435052592,0.40646492434663
3758,0.3997,1,9,1,674727,1717,125075,1181,0.013599353694081865,0.4075224292615597
3759,0.3998,1,0,1,674727,1717,125076,1180,0.013599353694081865,0.40731791508457027
3760,0.3999,4,11,4,674738,1706,125080,1176,0.01351222912178431,0.4080499653018737
3761,0.4,3,3,3,674741,1703,125083,1173,0.01348846787479407,0.40785813630041723
3762,0.4001,5,11,5,674752,1692,125088,1168,0.013401343302496515,0.4083916083916084
3763,0.4002,4,8,4,674760,1684,125092,1164,0.013337979977189203,0.40870786516853935
3764,0.4003,1,6,1,674766,1678,125093,1163,0.013290457483208718,0.4093629003871876
3765,0.4004,2,4,2,674770,1674,125095,1161,0.013258775820555064,0.4095238095238095
3766,0.4005,7,12,7,674782,1662,125102,1154,0.013163730832594095,0.40980113636363635
3767,0.4006,6,10,6,674792,1652,125108,1148,0.013084526675959954,0.41
3768,0.4007,3,2,3,674794,1650,125111,1145,0.013068685844633126,0.40966010733452596
3769,0.4008,1,6,1,674800,1644,125112,1144,0.013021163350652643,0.4103299856527977
3770,0.4009,3,1,3,674801,1643,125115,1141,0.013013242934989228,0.4098419540229885
3771,0.401,1,4,1,674805,1639,125116,1140,0.012981561272335572,0.41021950341849583
3772,0.4011,4,5,4,674810,1634,125120,1136,0.012941959194018502,0.41010830324909747
3773,0.4012,0,3,0,674813,1631,125120,1136,0.01291819794702826,0.41055294542826165
3774,0.4013,3,7,3,674820,1624,125123,1133,0.012862755037384361,0.41095393543706926
3775,0.4014,2,5,2,674825,1619,125125,1131,0.012823152959067292,0.4112727272727273
3776,0.4015,3,2,3,674827,1617,125128,1128,0.012807312127740464,0.41092896174863386
3777,0.4016,2,13,2,674840,1604,125130,1126,0.012704346724116081,0.41245421245421243
3778,0.4017,3,4,3,674844,1600,125133,1123,0.012672665061462425,0.4124127800220345
3779,0.4018,1,0,1,674844,1600,125134,1122,0.012672665061462425,0.41219691403379866
3780,0.4019,3,5,3,674849,1595,125137,1119,0.012633062983145356,0.4123065585851142
3781,0.402,4,7,4,674856,1588,125141,1115,0.012577620073501458,0.412504624491306
3782,0.4021,1,0,1,674856,1588,125142,1114,0.012577620073501458,0.41228719467061437
3783,0.4023,7,11,7,674867,1577,125149,1107,0.012490495501203904,0.4124441132637854
3784,0.4024,1,5,1,674872,1572,125150,1106,0.012450893422886833,0.4129947722180732
3785,0.4025,7,4,7,674876,1568,125157,1099,0.012419211760233176,0.4120734908136483
3786,0.4026,1,2,1,674878,1566,125158,1098,0.01240337092890635,0.41216216216216217
3787,0.4027,8,3,8,674881,1563,125166,1090,0.012379609681916107,0.4108556351300415
3788,0.4028,3,3,3,674884,1560,125169,1087,0.012355848434925865,0.4106535700793351
3789,0.4029,1,3,1,674887,1557,125170,1086,0.012332087187935622,0.4108967082860386
3790,0.403,3,3,3,674890,1554,125173,1083,0.01230832594094538,0.41069397042093286
3791,0.4031,0,2,0,674892,1552,125173,1083,0.012292485109618553,0.4110056925996205
3792,0.4032,5,6,5,674898,1546,125178,1078,0.012244962615638068,0.4108231707317073
3793,0.4033,13,25,13,674923,1521,125191,1065,0.012046952224052719,0.41183294663573083
3794,0.4034,3,3,3,674926,1518,125194,1062,0.012023190977062476,0.4116279069767442
3795,0.4035,8,6,8,674932,1512,125202,1054,0.011975668483081993,0.4107560405300078
3796,0.4037,2,6,2,674938,1506,125204,1052,0.011928145989101508,0.4112587959343237
3797,0.4038,3,3,3,674941,1503,125207,1049,0.011904384742111265,0.41105015673981193
3798,0.4039,3,6,3,674947,1497,125210,1046,0.011856862248130783,0.4113252064490759
3799,0.404,10,7,10,674954,1490,125220,1036,0.011801419338486883,0.4101346001583531
3800,0.4041,2,7,2,674961,1483,125222,1034,0.011745976428842985,0.41080651569328563
3801,0.4042,0,2,0,674963,1481,125222,1034,0.011730135597516157,0.41113320079522864
3802,0.4043,13,20,13,674983,1461,125235,1021,0.011571727284247877,0.41136180499597097
3803,0.4044,1,3,1,674986,1458,125236,1020,0.011547966037257636,0.4116222760290557
3804,0.4045,4,2,4,674988,1456,125240,1016,0.011532125205930808,0.4110032362459547
3805,0.4046,7,5,7,674993,1451,125247,1009,0.011492523127613737,0.41016260162601625
3806,0.4048,3,1,3,674994,1450,125250,1006,0.011484602711950323,0.40960912052117265
3807,0.4049,10,7,10,675001,1443,125260,996,0.011429159802306426,0.40836408364083643
3808,0.405,4,7,4,675008,1436,125264,992,0.011373716892662526,0.4085667215815486
3809,0.4051,0,4,0,675012,1432,125264,992,0.011342035230008872,0.40924092409240925
3810,0.4052,0,6,0,675018,1426,125264,992,0.011294512736028387,0.41025641025641024
3811,0.4053,2,6,2,675024,1420,125266,990,0.011246990242047903,0.4107883817427386
3812,0.4054,2,2,2,675026,1418,125268,988,0.011231149410721075,0.4106400665004156
3813,0.4055,5,3,5,675029,1415,125273,983,0.011207388163730833,0.4099249374478732
3814,0.4056,3,9,3,675038,1406,125276,980,0.011136104422760107,0.4107292539815591
3815,0.4057,0,3,0,675041,1403,125276,980,0.011112343175769864,0.4112463281577843
3816,0.4058,1,18,1,675059,1385,125277,979,0.010969775693828412,0.41412859560067683
3817,0.4059,1,1,1,675060,1384,125278,978,0.010961855278164997,0.4140558848433531
3818,0.406,4,1,4,675061,1383,125282,974,0.010953934862501584,0.41323716588884174
3819,0.4061,2,4,2,675065,1379,125284,972,0.010922253199847928,0.41344108889834114
3820,0.4062,2,2,2,675067,1377,125286,970,0.0109064123685211,0.41329356625479335
3821,0.4063,2,1,2,675068,1376,125288,968,0.010898491952857687,0.4129692832764505
3822,0.4064,2,9,2,675077,1367,125290,966,0.010827208211886959,0.4140591513073296
3823,0.4065,0,6,0,675083,1361,125290,966,0.010779685717906476,0.4151267726686721
3824,0.4066,1,0,1,675083,1361,125291,965,0.010779685717906476,0.41487532244196046
3825,0.4067,5,6,5,675089,1355,125296,960,0.010732163223925992,0.4146868250539957
3826,0.4068,2,1,2,675090,1354,125298,958,0.010724242808262577,0.4143598615916955
3827,0.4069,2,6,2,675096,1348,125300,956,0.010676720314282094,0.4149305555555556
3828,0.407,4,2,4,675098,1346,125304,952,0.010660879482955266,0.4142732811140122
3829,0.4071,2,7,2,675105,1339,125306,950,0.010605436573311368,0.4150283966797728
3830,0.4072,2,9,2,675114,1330,125308,948,0.01053415283234064,0.4161545215100966
3831,0.4073,3,7,3,675121,1323,125311,945,0.010478709922696743,0.4166666666666667
3832,0.4074,0,2,0,675123,1321,125311,945,0.010462869091369915,0.4170344218887908
3833,0.4075,0,3,0,675126,1318,125311,945,0.010439107844379673,0.41758727353071146
3834,0.4076,1,1,1,675127,1317,125312,944,0.010431187428716258,0.4175143741707209
3835,0.4077,4,6,4,675133,1311,125316,940,0.010383664934735776,0.41759218125277653
3836,0.4078,1,3,1,675136,1308,125317,939,0.010359903687745533,0.417890520694259
3837,0.4079,5,0,5,675136,1308,125322,934,0.010359903687745533,0.41659232827832293
3838,0.408,4,3,4,675139,1305,125326,930,0.010336142440755291,0.4161073825503356
3839,0.4081,3,10,3,675149,1295,125329,927,0.01025693828412115,0.4171917191719172
3840,0.4082,1,3,1,675152,1292,125330,926,0.010233177037130909,0.4174932371505861
3841,0.4083,1,2,1,675154,1290,125331,925,0.01021733620580408,0.417607223476298
3842,0.4084,11,8,11,675162,1282,125342,914,0.010153972880496768,0.41621129326047357
3843,0.4085,1,5,1,675167,1277,125343,913,0.010114370802179699,0.4168949771689498
3844,0.4086,1,3,1,675170,1274,125344,912,0.010090609555189456,0.4172003659652333
3845,0.4087,3,0,3,675170,1274,125347,909,0.010090609555189456,0.4163994502977554
3846,0.4088,7,5,7,675175,1269,125354,902,0.010051007476872386,0.4154767388300322
3847,0.4089,2,8,2,675183,1261,125356,900,0.009987644151565073,0.41647385469689957
3848,0.409,1,5,1,675188,1256,125357,899,0.009948042073248004,0.417169373549884
3849,0.4091,3,0,3,675188,1256,125360,896,0.009948042073248004,0.4163568773234201
3850,0.4092,2,7,2,675195,1249,125362,894,0.009892599163604106,0.41717218852076526
3851,0.4093,1,1,1,675196,1248,125363,893,0.009884678747940691,0.4170948155067725
3852,0.4094,3,3,3,675199,1245,125366,890,0.00986091750095045,0.4168618266978923
3853,0.4095,4,10,4,675209,1235,125370,886,0.009781713344316309,0.41772748703441775
3854,0.4096,0,5,0,675214,1230,125370,886,0.00974211126599924,0.41871455576559546
3855,0.4097,0,4,0,675218,1226,125370,886,0.009710429603345583,0.41950757575757575
3856,0.4098,0,6,0,675224,1220,125370,886,0.009662907109365099,0.42070275403608737
3857,0.4099,1,3,1,675227,1217,125371,885,0.009639145862374857,0.42102759276879165
3858,0.41,0,2,0,675229,1215,125371,885,0.009623305031048029,0.42142857142857143
3859,0.4101,3,4,3,675233,1211,125374,882,0.009591623368394373,0.4214046822742475
3860,0.4102,2,1,2,675234,1210,125376,880,0.00958370295273096,0.42105263157894735
3861,0.4103,4,6,4,675240,1204,125380,876,0.009536180458750475,0.42115384615384616
3862,0.4104,3,4,3,675244,1200,125383,873,0.009504498796096819,0.4211287988422576
3863,0.4105,3,2,3,675246,1198,125386,870,0.00948865796476999,0.4206963249516441
3864,0.4106,2,2,2,675248,1196,125388,868,0.009472817133443162,0.42054263565891475
3865,0.4107,1,2,1,675250,1194,125389,867,0.009456976302116334,0.42066957787481807
3866,0.4108,1,0,1,675250,1194,125390,866,0.009456976302116334,0.4203883495145631
3867,0.4109,1,1,1,675251,1193,125391,865,0.009449055886452921,0.4203109815354713
3868,0.411,4,2,4,675253,1191,125395,861,0.009433215055126093,0.4195906432748538
3869,0.4111,1,2,1,675255,1189,125396,860,0.009417374223799265,0.41971693509028796
3870,0.4112,0,1,0,675256,1188,125396,860,0.009409453808135852,0.419921875
3871,0.4113,4,1,4,675257,1187,125400,856,0.009401533392472437,0.4189916789035732
3872,0.4114,2,6,2,675263,1181,125402,854,0.009354010898491952,0.4196560196560197
3873,0.4115,1,2,1,675265,1179,125403,853,0.009338170067165124,0.4197834645669291
3874,0.4116,0,3,0,675268,1176,125403,853,0.009314408820174883,0.4204041399704288
3875,0.4117,1,3,1,675271,1173,125404,852,0.009290647573184641,0.42074074074074075
3876,0.4118,1,5,1,675276,1168,125405,851,0.00925104549486757,0.42149578999504705
3877,0.4119,6,0,6,675276,1168,125411,845,0.00925104549486757,0.4197714853452558
3878,0.412,5,11,5,675287,1157,125416,840,0.009163920922570016,0.42063094641962945
3879,0.4121,1,5,1,675292,1152,125417,839,0.009124318844252946,0.4213962832747363
3880,0.4122,2,3,2,675295,1149,125419,837,0.009100557597262705,0.4214501510574018
3881,0.4123,3,5,3,675300,1144,125422,834,0.009060955518945634,0.42163801820020225
3882,0.4124,4,4,4,675304,1140,125426,830,0.009029273856291977,0.4213197969543147
3883,0.4125,1,0,1,675304,1140,125427,829,0.009029273856291977,0.42102590147282887
3884,0.4126,4,7,4,675311,1133,125431,825,0.00897383094664808,0.42134831460674155
3885,0.4127,2,3,2,675314,1130,125433,823,0.008950069699657838,0.4214029697900666
3886,0.4128,8,4,8,675318,1126,125441,815,0.008918388037004182,0.4198866563626996
3887,0.4129,4,8,4,675326,1118,125445,811,0.00885502471169687,0.4204250907205806
3888,0.413,10,12,10,675338,1106,125455,801,0.008759979723735902,0.42003146303093863
3889,0.4131,1,1,1,675339,1105,125456,800,0.008752059308072487,0.4199475065616798
3890,0.4132,3,1,3,675340,1104,125459,797,0.008744138892409074,0.4192530247238296
3891,0.4133,2,2,2,675342,1102,125461,795,0.008728298061082246,0.419082762256194
3892,0.4134,1,2,1,675344,1100,125462,794,0.008712457229755418,0.4192185850052798
3893,0.4135,1,3,1,675347,1097,125463,793,0.008688695982765176,0.4195767195767196
3894,0.4136,0,4,0,675351,1093,125463,793,0.00865701432011152,0.42046659597030756
3895,0.4137,6,5,6,675356,1088,125469,787,0.008617412241794449,0.41973333333333335
3896,0.4138,1,2,1,675358,1086,125470,786,0.00860157141046762,0.4198717948717949
3897,0.4139,3,3,3,675361,1083,125473,783,0.00857781016347738,0.41961414790996787
3898,0.414,1,5,1,675366,1078,125474,782,0.00853820808516031,0.4204301075268817
3899,0.4141,5,3,5,675369,1075,125479,777,0.008514446838170067,0.4195464362850972
3900,0.4142,3,0,3,675369,1075,125482,774,0.008514446838170067,0.4186046511627907
3901,0.4143,4,2,4,675371,1073,125486,770,0.008498606006843238,0.41779706999457406
3902,0.4144,0,3,0,675374,1070,125486,770,0.008474844759852997,0.41847826086956524
3903,0.4145,2,0,2,675374,1070,125488,768,0.008474844759852997,0.4178454842219804
3904,0.4146,3,4,3,675378,1066,125491,765,0.00844316309719934,0.417804478427089
3905,0.4147,4,4,4,675382,1062,125495,761,0.008411481434545684,0.4174437739989029
3906,0.4148,0,2,0,675384,1060,125495,761,0.008395640603218856,0.41790225151015925
3907,0.415,0,2,0,675386,1058,125495,761,0.00837979977189203,0.41836173721825176
3908,0.4151,4,15,4,675401,1043,125499,757,0.00826099353694082,0.42055555555555557
3909,0.4152,3,3,3,675404,1040,125502,754,0.008237232289950576,0.42028985507246375
3910,0.4153,4,3,4,675407,1037,125506,750,0.008213471042960335,0.4196978175713486
3911,0.4154,2,4,2,675411,1033,125508,748,0.008181789380306679,0.41998877035373383
3912,0.4155,0,1,0,675412,1032,125508,748,0.008173868964643264,0.4202247191011236
3913,0.4156,1,1,1,675413,1031,125509,747,0.00816594854897985,0.4201349831271091
3914,0.4158,2,6,2,675419,1025,125511,745,0.008118426054999366,0.4209039548022599
3915,0.4159,0,3,0,675422,1022,125511,745,0.008094664808009125,0.42161856253537067
3916,0.416,1,0,1,675422,1022,125512,744,0.008094664808009125,0.42129105322763305
3917,0.4161,1,3,1,675425,1019,125513,743,0.008070903561018881,0.4216799091940976
3918,0.4162,0,8,0,675433,1011,125513,743,0.00800754023571157,0.42360319270239455
3919,0.4163,2,0,2,675433,1011,125515,741,0.00800754023571157,0.4229452054794521
3920,0.4164,7,9,7,675442,1002,125522,734,0.007936256494740845,0.4228110599078341
3921,0.4165,1,3,1,675445,999,125523,733,0.007912495247750602,0.42321016166281755
3922,0.4166,0,4,0,675449,995,125523,733,0.007880813585096945,0.4241898148148148
3923,0.4167,1,1,1,675450,994,125524,732,0.007872893169433532,0.4241019698725377
3924,0.4168,1,2,1,675452,992,125525,731,0.007857052338106704,0.4242600116076611
3925,0.4169,1,0,1,675452,992,125526,730,0.007857052338106704,0.42392566782810687
3926,0.417,1,4,1,675456,988,125527,729,0.007825370675453048,0.42457775189283636
3927,0.4171,1,9,1,675465,979,125528,728,0.007754086934482322,0.42647920328060923
3928,0.4172,0,2,0,675467,977,125528,728,0.0077382461031554935,0.4269794721407625
3929,0.4173,5,9,5,675476,968,125533,723,0.007666962362184768,0.42755765819041985
3930,0.4174,0,1,0,675477,967,125533,723,0.007659041946521354,0.427810650887574
3931,0.4175,3,3,3,675480,964,125536,720,0.007635280699531111,0.42755344418052255
3932,0.4176,1,3,1,675483,961,125537,719,0.007611519452540869,0.42797619047619045
3933,0.4177,5,10,5,675493,951,125542,714,0.007532315295906729,0.42882882882882883
3934,0.4178,3,1,3,675494,950,125545,711,0.007524394880243315,0.428055388320289
3935,0.4179,2,0,2,675494,950,125547,709,0.007524394880243315,0.4273658830620856
3936,0.418,1,1,1,675495,949,125548,708,0.007516474464579901,0.42727821363910684
3937,0.4181,3,8,3,675503,941,125551,705,0.007453111139272589,0.42831105710814094
3938,0.4182,0,4,0,675507,937,125551,705,0.007421429476618933,0.42935444579780757
3939,0.4183,1,3,1,675510,934,125552,704,0.007397668229628691,0.4297924297924298
3940,0.4184,5,6,5,675516,928,125557,699,0.007350145735648207,0.42962507682851875
3941,0.4185,3,1,3,675517,927,125560,696,0.007342225319984793,0.4288354898336414
3942,0.4186,0,2,0,675519,925,125560,696,0.007326384488657965,0.4293645897594078
3943,0.4187,5,9,5,675528,916,125565,691,0.007255100747687239,0.4299937772246422
3944,0.4189,1,6,1,675534,910,125566,690,0.0072075782537067545,0.43125
3945,0.419,1,5,1,675539,905,125567,689,0.007167976175389684,0.43224592220828106
3946,0.4191,6,8,6,675547,897,125573,683,0.007104612850082372,0.43227848101265826
3947,0.4192,4,4,4,675551,893,125577,679,0.007072931187428716,0.43193384223918574
3948,0.4193,0,1,0,675552,892,125577,679,0.007065010771765302,0.4322087842138765
3949,0.4194,1,9,1,675561,883,125578,678,0.006993727030794576,0.43433696348494555
3950,0.4195,2,0,2,675561,883,125580,676,0.006993727030794576,0.43361128928800513
3951,0.4196,2,3,2,675564,880,125582,674,0.006969965783804334,0.4337194337194337
3952,0.4197,4,3,4,675567,877,125586,670,0.006946204536814092,0.43309631544925664
3953,0.4198,1,3,1,675570,874,125587,669,0.00692244328982385,0.4335709656513286
3954,0.42,1,1,1,675571,873,125588,668,0.006914522874160436,0.4334847501622323
3955,0.4201,6,2,6,675573,871,125594,662,0.006898682042833608,0.4318330071754729
3956,0.4202,3,4,3,675577,867,125597,659,0.006867000380179952,0.43184796854521623
3957,0.4203,1,4,1,675581,863,125598,658,0.006835318717526296,0.43261012491781725
3958,0.4204,1,0,1,675581,863,125599,657,0.006835318717526296,0.43223684210526314
3959,0.4205,2,4,2,675585,859,125601,655,0.00680363705487264,0.43262879788639363
3960,0.4206,1,1,1,675586,858,125602,654,0.006795716639209226,0.43253968253968256
3961,0.4207,0,1,0,675587,857,125602,654,0.006787796223545812,0.4328259430840503
3962,0.4209,3,4,3,675591,853,125605,651,0.006756114560892155,0.4328457446808511
3963,0.421,6,12,6,675603,841,125611,645,0.006661069572931187,0.43405114401076716
3964,0.4211,7,1,7,675604,840,125618,638,0.006653149157267773,0.4316644113667118
3965,0.4212,0,1,0,675605,839,125618,638,0.006645228741604359,0.43195666892349355
3966,0.4213,5,6,5,675611,833,125623,633,0.0065977062476238755,0.43178717598908595
3967,0.4215,0,1,0,675612,832,125623,633,0.006589785831960461,0.43208191126279866
3968,0.4216,2,0,2,675612,832,125625,631,0.006589785831960461,0.43130553656869447
3969,0.4217,2,2,2,675614,830,125627,629,0.006573945000633633,0.431117203564085
3970,0.4218,3,3,3,675617,827,125630,626,0.006550183753643391,0.43083275980729524
3971,0.4219,1,4,1,675621,823,125631,625,0.0065185020909897355,0.43162983425414364
3972,0.422,0,1,0,675622,822,125631,625,0.0065105816753263214,0.43192812715964063
3973,0.4221,3,0,3,675622,822,125634,622,0.0065105816753263214,0.4307479224376731
3974,0.4222,0,1,0,675623,821,125634,622,0.006502661259662907,0.43104643104643103
3975,0.4223,2,3,2,675626,818,125636,620,0.006478900012672665,0.43115438108484005
3976,0.4224,1,0,1,675626,818,125637,619,0.006478900012672665,0.43075852470424497
3977,0.4225,2,3,2,675629,815,125639,617,0.006455138765682423,0.4308659217877095
3978,0.4226,4,3,4,675632,812,125643,613,0.006431377518692181,0.4301754385964912
3979,0.4227,0,6,0,675638,806,125643,613,0.006383855024711697,0.4319943622269204
3980,0.4229,0,2,0,675640,804,125643,613,0.006368014193384869,0.4326040931545519
3981,0.423,3,1,3,675641,803,125646,610,0.006360093777721455,0.4317055909412597
3982,0.4231,1,1,1,675642,802,125647,609,0.006352173362058041,0.4316087880935507
3983,0.4233,4,1,4,675643,801,125651,605,0.006344252946394627,0.43029871977240397
3984,0.4234,2,4,2,675647,797,125653,603,0.006312571283740971,0.4307142857142857
3985,0.4235,1,0,1,675647,797,125654,602,0.006312571283740971,0.4303073624017155
3986,0.4236,2,1,2,675648,796,125656,600,0.006304650868077557,0.4297994269340974
3987,0.4237,2,1,2,675649,795,125658,598,0.006296730452414143,0.42928930366116297
3988,0.4238,3,1,3,675650,794,125661,595,0.006288810036750729,0.42836573074154066
3989,0.4239,12,5,12,675655,789,125673,583,0.0062492079584336585,0.4249271137026239
3990,0.4241,5,3,5,675658,786,125678,578,0.006225446711443416,0.4237536656891496
3991,0.4243,1,0,1,675658,786,125679,577,0.006225446711443416,0.42333088774761557
3992,0.4244,2,2,2,675660,784,125681,575,0.006209605880116588,0.42310522442972776
3993,0.4245,2,0,2,675660,784,125683,573,0.006209605880116588,0.42225497420781133
3994,0.4246,0,2,0,675662,782,125683,573,0.006193765048789761,0.4228782287822878
3995,0.4247,0,3,0,675665,779,125683,573,0.0061700038017995186,0.4238165680473373
3996,0.4248,0,8,0,675673,771,125683,573,0.006106640476492206,0.4263392857142857
3997,0.4249,7,6,7,675679,765,125690,566,0.006059117982511722,0.425244177310293
3998,0.425,0,5,0,675684,760,125690,566,0.006019515904194652,0.42684766214177977
3999,0.4251,1,6,1,675690,754,125691,565,0.005971993410214168,0.42835481425322214
4000,0.4252,0,1,0,675691,753,125691,565,0.005964072994550754,0.4286798179059181
4001,0.4253,2,4,2,675695,749,125693,563,0.005932391331897098,0.4291158536585366
4002,0.4254,1,2,1,675697,747,125694,562,0.00591655050057027,0.4293353705118411
4003,0.4255,1,5,1,675702,742,125695,561,0.0058769484222532,0.43054489639293936
4004,0.4256,1,1,1,675703,741,125696,560,0.005869028006589786,0.4304381245196003
4005,0.4257,2,1,2,675704,740,125698,558,0.005861107590926372,0.42989214175654855
4006,0.4258,4,11,4,675715,729,125702,554,0.005773983018628818,0.4318004676539361
4007,0.4259,2,7,2,675722,722,125704,552,0.0057185401089849194,0.43328100470957615
4008,0.426,4,3,4,675725,719,125708,548,0.005694778861994677,0.4325177584846093
4009,0.4261,1,0,1,675725,719,125709,547,0.005694778861994677,0.4320695102685624
4010,0.4262,0,1,0,675726,718,125709,547,0.005686858446331263,0.4324110671936759
4011,0.4263,1,2,1,675728,716,125710,546,0.005671017615004436,0.4326465927099842
4012,0.4264,4,5,4,675733,711,125714,542,0.005631415536687365,0.432561851556265
4013,0.4265,0,1,0,675734,710,125714,542,0.005623495121023951,0.4329073482428115
4014,0.4266,2,4,2,675738,706,125716,540,0.005591813458370295,0.4333868378812199
4015,0.4267,1,5,1,675743,701,125717,539,0.0055522113800532255,0.4346774193548387
4016,0.4268,6,2,6,675745,699,125723,533,0.005536370548726397,0.43262987012987014
4017,0.4269,3,4,3,675749,695,125726,530,0.005504688886072741,0.4326530612244898
4018,0.427,0,2,0,675751,693,125726,530,0.005488848054745913,0.4333605887162715
4019,0.4271,4,2,4,675753,691,125730,526,0.005473007223419085,0.4322103533278554
4020,0.4272,0,1,0,675754,690,125730,526,0.005465086807755671,0.43256578947368424
4021,0.4273,4,8,4,675762,682,125734,522,0.005401723482448359,0.4335548172757475
4022,0.4274,1,0,1,675762,682,125735,521,0.005401723482448359,0.43308395677472983
4023,0.4275,0,4,0,675766,678,125735,521,0.0053700418197947025,0.43452877397831524
4024,0.4276,1,2,1,675768,676,125736,520,0.005354200988467875,0.43478260869565216
4025,0.4277,0,2,0,675770,674,125736,520,0.005338360157141047,0.4355108877721943
4026,0.4278,1,1,1,675771,673,125737,519,0.005330439741477633,0.4354026845637584
4027,0.4279,3,10,3,675781,663,125740,516,0.005251235584843493,0.43765903307888043
4028,0.428,2,2,2,675783,661,125742,514,0.005235394753516665,0.4374468085106383
4029,0.4281,2,1,2,675784,660,125744,512,0.005227474337853251,0.43686006825938567
4030,0.4282,2,2,2,675786,658,125746,510,0.005211633506526423,0.4366438356164384
4031,0.4283,1,4,1,675790,654,125747,509,0.005179951843872766,0.4376612209802236
4032,0.4284,0,1,0,675791,653,125747,509,0.005172031428209352,0.4380378657487091
4033,0.4285,1,2,1,675793,651,125748,508,0.005156190596882524,0.4383088869715272
4034,0.4286,5,6,5,675799,645,125753,503,0.00510866810290204,0.4381533101045296
4035,0.4287,1,2,1,675801,643,125754,502,0.005092827271575212,0.43842794759825326
4036,0.4288,2,2,2,675803,641,125756,500,0.005076986440248384,0.43821209465381245
4037,0.4289,1,0,1,675803,641,125757,499,0.005076986440248384,0.437719298245614
4038,0.4291,7,4,7,675807,637,125764,492,0.005045304777594728,0.4357838795394154
4039,0.4292,2,2,2,675809,635,125766,490,0.0050294639462679005,0.43555555555555553
4040,0.4294,0,2,0,675811,633,125766,490,0.005013623114941072,0.4363312555654497
4041,0.4296,2,4,2,675815,629,125768,488,0.004981941452287416,0.4368845120859445
4042,0.4297,4,5,4,675820,624,125772,484,0.004942339373970346,0.4368231046931408
4043,0.4298,3,3,3,675823,621,125775,481,0.004918578126980104,0.4364791288566243
4044,0.4299,1,5,1,675828,616,125776,480,0.004878976048663034,0.43795620437956206
4045,0.43,2,6,2,675834,610,125778,478,0.004831453554682549,0.43933823529411764
4046,0.4301,2,3,2,675837,607,125780,476,0.004807692307692308,0.43951985226223456
4047,0.4302,1,2,1,675839,605,125781,475,0.00479185147636548,0.4398148148148148
4048,0.4303,0,2,0,675841,603,125781,475,0.004776010645038652,0.44063079777365494
4049,0.4304,3,1,3,675842,602,125784,472,0.0047680902293752376,0.43947858472998136
4050,0.4305,3,1,3,675843,601,125787,469,0.0047601698137118235,0.4383177570093458
4051,0.4306,2,3,2,675846,598,125789,467,0.004736408566721581,0.4384976525821596
4052,0.4307,0,1,0,675847,597,125789,467,0.004728488151058167,0.43890977443609025
4053,0.4309,0,3,0,675850,594,125789,467,0.004704726904067926,0.44015080113100846
4054,0.431,0,2,0,675852,592,125789,467,0.004688886072741098,0.4409820585457979
4055,0.4311,1,0,1,675852,592,125790,466,0.004688886072741098,0.44045368620037806
4056,0.4312,0,1,0,675853,591,125790,466,0.0046809656570776835,0.44087038789025546
4057,0.4313,3,6,3,675859,585,125793,463,0.004633443163097199,0.44179389312977096
4058,0.4314,2,3,2,675862,582,125795,461,0.004609681916106958,0.4419942473633749
4059,0.4315,1,3,1,675865,579,125796,460,0.0045859206691167154,0.44273339749759383
4060,0.4316,1,2,1,675867,577,125797,459,0.004570079837789887,0.44305019305019305
4061,0.4317,0,2,0,675869,575,125797,459,0.004554239006463059,0.44390715667311414
4062,0.4319,1,2,1,675871,573,125798,458,0.004538398175136231,0.44422890397672166
4063,0.4321,2,1,2,675872,572,125800,456,0.004530477759472817,0.44357976653696496
4064,0.4322,0,1,0,675873,571,125800,456,0.004522557343809403,0.44401168451801365
4065,0.4323,1,1,1,675874,570,125801,455,0.004514636928145989,0.44390243902439025
4066,0.4325,3,5,3,675879,565,125804,452,0.004475034849828919,0.4444444444444444
4067,0.4327,0,3,0,675882,562,125804,452,0.004451273602838677,0.4457593688362919
4068,0.4328,1,1,1,675883,561,125805,451,0.004443353187175263,0.44565217391304346
4069,0.4329,1,1,1,675884,560,125806,450,0.004435432771511849,0.44554455445544555
4070,0.433,1,7,1,675891,553,125807,449,0.004379989861867951,0.4481037924151697
4071,0.4331,2,1,2,675892,552,125809,447,0.004372069446204537,0.44744744744744747
4072,0.4332,0,1,0,675893,551,125809,447,0.004364149030541123,0.44789579158316634
4073,0.4334,1,0,1,675893,551,125810,446,0.004364149030541123,0.4473420260782347
4074,0.4335,1,1,1,675894,550,125811,445,0.004356228614877709,0.4472361809045226
4075,0.4336,4,10,4,675904,540,125815,441,0.004277024458243569,0.44954128440366975
4076,0.4338,7,4,7,675908,536,125822,434,0.0042453427955899126,0.44742268041237115
4077,0.4339,5,4,5,675912,532,125827,429,0.004213661132936256,0.4464099895941727
4078,0.434,7,2,7,675914,530,125834,422,0.004197820301609428,0.4432773109243697
4079,0.4341,1,1,1,675915,529,125835,421,0.004189899885946015,0.4431578947368421
4080,0.4342,1,0,1,675915,529,125836,420,0.004189899885946015,0.44257112750263433
4081,0.4343,2,4,2,675919,525,125838,418,0.0041582182232923585,0.4432661717921527
4082,0.4344,5,4,5,675923,521,125843,413,0.004126536560638702,0.4421841541755889
4083,0.4345,0,1,0,675924,520,125843,413,0.004118616144975288,0.44265809217577706
4084,0.4346,1,0,1,675924,520,125844,412,0.004118616144975288,0.44206008583690987
4085,0.4348,1,4,1,675928,516,125845,411,0.004086934482321632,0.44336569579288027
4086,0.4349,2,5,2,675933,511,125847,409,0.004047332404004562,0.44456521739130433
4087,0.435,0,3,0,675936,508,125847,409,0.00402357115701432,0.44601962922573607
4088,0.4352,1,0,1,675936,508,125848,408,0.00402357115701432,0.44541484716157204
4089,0.4353,2,5,2,675941,503,125850,406,0.00398396907869725,0.44664466446644663
4090,0.4356,0,1,0,675942,502,125850,406,0.003976048663033836,0.44713656387665196
4091,0.4357,0,2,0,675944,500,125850,406,0.003960207831707008,0.4481236203090508
4092,0.4358,1,3,1,675947,497,125851,405,0.003936446584716766,0.4490022172949002
4093,0.4359,1,0,1,675947,497,125852,404,0.003936446584716766,0.4483906770255272
4094,0.436,6,6,6,675953,491,125858,398,0.003888924090736282,0.44769403824521936
4095,0.4361,1,4,1,675957,487,125859,397,0.0038572424280826256,0.4490950226244344
4096,0.4362,0,1,0,675958,486,125859,397,0.0038493220124192116,0.44960362400906
4097,0.4363,1,7,1,675965,479,125860,396,0.0037938791027753134,0.45257142857142857
4098,0.4364,2,3,2,675968,476,125862,394,0.0037701178557850716,0.4528735632183908
4099,0.4365,1,3,1,675971,473,125863,393,0.0037463566087948294,0.45381062355658197
4100,0.4367,3,1,3,675972,472,125866,390,0.0037384361931314157,0.45243619489559167
4101,0.4368,0,1,0,675973,471,125866,390,0.0037305157774680017,0.4529616724738676
4102,0.437,4,0,4,675973,471,125870,386,0.0037305157774680017,0.45040840140023336
4103,0.4371,0,1,0,675974,470,125870,386,0.0037225953618045876,0.45093457943925236
4104,0.4372,2,1,2,675975,469,125872,384,0.0037146749461411735,0.4501758499413834
4105,0.4373,1,0,1,675975,469,125873,383,0.0037146749461411735,0.4495305164319249
4106,0.4374,4,6,4,675981,463,125877,379,0.0036671524521606894,0.4501187648456057
4107,0.4375,3,1,3,675982,462,125880,376,0.0036592320364972754,0.4486873508353222
4108,0.4376,1,3,1,675985,459,125881,375,0.003635470789507033,0.44964028776978415
4109,0.4377,1,2,1,675987,457,125882,374,0.0036196299581802054,0.4500601684717208
4110,0.4378,3,4,3,675991,453,125885,371,0.003587948295526549,0.45024271844660196
4111,0.4379,1,0,1,675991,453,125886,370,0.003587948295526549,0.44957472660996356
4112,0.438,0,1,0,675992,452,125886,370,0.0035800278798631354,0.45012165450121655
4113,0.4381,4,2,4,675994,450,125890,366,0.0035641870485363073,0.4485294117647059
4114,0.4382,5,11,5,676005,439,125895,361,0.003477062476238753,0.45125
4115,0.4383,1,3,1,676008,436,125896,360,0.003453301229248511,0.45226130653266333
4116,0.4386,3,2,3,676010,434,125899,357,0.003437460397921683,0.45132743362831856
4117,0.4387,0,2,0,676012,432,125899,357,0.003421619566594855,0.4524714828897338
4118,0.4388,2,2,2,676014,430,125901,355,0.003405778735268027,0.45222929936305734
4119,0.4389,4,5,4,676019,425,125905,351,0.003366176656950957,0.452319587628866
4120,0.439,4,1,4,676020,424,125909,347,0.003358256241287543,0.45006485084306097
4121,0.4391,0,3,0,676023,421,125909,347,0.0033344949942973007,0.4518229166666667
4122,0.4392,2,7,2,676030,414,125911,345,0.0032790520846534025,0.45454545454545453
4123,0.4394,1,1,1,676031,413,125912,344,0.0032711316689899884,0.45442536327608984
4124,0.4395,1,3,1,676034,410,125913,343,0.0032473704219997466,0.4555112881806109
4125,0.4396,2,4,2,676038,406,125915,341,0.0032156887593460903,0.4564926372155288
4126,0.4397,2,4,2,676042,402,125917,339,0.0031840070966924344,0.4574898785425101
4127,0.4398,2,0,2,676042,402,125919,337,0.0031840070966924344,0.456021650879567
4128,0.4399,0,2,0,676044,400,125919,337,0.0031681662653656063,0.45725915875169604
4129,0.44,1,1,1,676045,399,125920,336,0.003160245849702192,0.45714285714285713
4130,0.4401,0,1,0,676046,398,125920,336,0.0031523254340387785,0.45776566757493187
4131,0.4403,7,1,7,676047,397,125927,329,0.0031444050183753645,0.453168044077135
4132,0.4404,5,2,5,676049,395,125932,324,0.0031285641870485363,0.4506258692628651
4133,0.4406,0,1,0,676050,394,125932,324,0.003120643771385122,0.45125348189415043
4134,0.4407,0,2,0,676052,392,125932,324,0.003104802940058294,0.45251396648044695
4135,0.4408,0,1,0,676053,391,125932,324,0.0030968825243948804,0.45314685314685316
4136,0.4409,1,0,1,676053,391,125933,323,0.0030968825243948804,0.4523809523809524
4137,0.4411,2,0,2,676053,391,125935,321,0.0030968825243948804,0.4508426966292135
4138,0.4412,3,1,3,676054,390,125938,318,0.0030889621087314663,0.4491525423728814
4139,0.4413,0,1,0,676055,389,125938,318,0.0030810416930680522,0.4497878359264498
4140,0.4414,0,1,0,676056,388,125938,318,0.003073121277404638,0.45042492917847027
4141,0.4415,1,0,1,676056,388,125939,317,0.003073121277404638,0.44964539007092197
4142,0.4416,2,1,2,676057,387,125941,315,0.003065200861741224,0.44871794871794873
4143,0.4417,0,3,0,676060,384,125941,315,0.0030414396147509823,0.45064377682403434
4144,0.4418,1,0,1,676060,384,125942,314,0.0030414396147509823,0.4498567335243553
4145,0.4419,0,1,0,676061,383,125942,314,0.003033519199087568,0.45050215208034433
4146,0.442,1,2,1,676063,381,125943,313,0.00301767836776074,0.4510086455331412
4147,0.4421,1,0,1,676063,381,125944,312,0.00301767836776074,0.45021645021645024
4148,0.4422,0,1,0,676064,380,125944,312,0.003009757952097326,0.4508670520231214
4149,0.4423,2,0,2,676064,380,125946,310,0.003009757952097326,0.4492753623188406
4150,0.4424,0,1,0,676065,379,125946,310,0.003001837536433912,0.44992743105950656
4151,0.4425,3,1,3,676066,378,125949,307,0.0029939171207704982,0.4481751824817518
4152,0.4426,1,3,1,676069,375,125950,306,0.002970155873780256,0.44933920704845814
4153,0.4427,1,0,1,676069,375,125951,305,0.002970155873780256,0.4485294117647059
4154,0.4428,1,2,1,676071,373,125952,304,0.002954315042453428,0.44903988183161003
4155,0.4429,3,2,3,676073,371,125955,301,0.0029384742111266,0.4479166666666667
4156,0.443,3,3,3,676076,368,125958,298,0.002914712964136358,0.44744744744744747
4157,0.4432,2,0,2,676076,368,125960,296,0.002914712964136358,0.4457831325301205
4158,0.4433,0,1,0,676077,367,125960,296,0.0029067925484729438,0.4464555052790347
4159,0.4434,1,1,1,676078,366,125961,295,0.0028988721328095297,0.4462934947049924
4160,0.4435,0,2,0,676080,364,125961,295,0.002883031301482702,0.44764795144157815
4161,0.4436,0,1,0,676081,363,125961,295,0.002875110885819288,0.44832826747720367
4162,0.4438,1,1,1,676082,362,125962,294,0.002867190470155874,0.4481707317073171
4163,0.4439,1,3,1,676085,359,125963,293,0.0028434292231656316,0.4493865030674847
4164,0.444,0,2,0,676087,357,125963,293,0.002827588391838804,0.45076923076923076
4165,0.4441,2,4,2,676091,353,125965,291,0.0027959067291851475,0.4518633540372671
4166,0.4442,3,1,3,676092,352,125968,288,0.0027879863135217334,0.45
4167,0.4443,2,4,2,676096,348,125970,286,0.0027563046508680775,0.45110410094637227
4168,0.4444,1,1,1,676097,347,125971,285,0.0027483842352046635,0.4509493670886076
4169,0.4446,1,0,1,676097,347,125972,284,0.0027483842352046635,0.4500792393026941
4170,0.4448,3,1,3,676098,346,125975,281,0.0027404638195412494,0.4481658692185008
4171,0.4449,3,2,3,676100,344,125978,278,0.0027246229882144216,0.44694533762057875
4172,0.445,4,1,4,676101,343,125982,274,0.0027167025725510076,0.44408427876823336
4173,0.4451,0,3,0,676104,340,125982,274,0.0026929413255607653,0.44625407166123776
4174,0.4452,1,0,1,676104,340,125983,273,0.0026929413255607653,0.4453507340946166
4175,0.4453,1,2,1,676106,338,125984,272,0.0026771004942339376,0.4459016393442623
4176,0.4454,4,2,4,676108,336,125988,268,0.0026612596629071094,0.44370860927152317
4177,0.4455,1,0,1,676108,336,125989,267,0.0026612596629071094,0.4427860696517413
4178,0.4456,1,4,1,676112,332,125990,266,0.002629578000253453,0.44481605351170567
4179,0.4457,0,3,0,676115,329,125990,266,0.0026058167532632113,0.4470588235294118
4180,0.4458,0,2,0,676117,327,125990,266,0.002589975921936383,0.448566610455312
4181,0.446,0,2,0,676119,325,125990,266,0.002574135090609555,0.4500846023688663
4182,0.4461,1,1,1,676120,324,125991,265,0.0025662146749461413,0.44991511035653653
4183,0.4462,3,0,3,676120,324,125994,262,0.0025662146749461413,0.447098976109215
4184,0.4463,0,2,0,676122,322,125994,262,0.002550373843619313,0.4486301369863014
4185,0.4464,1,1,1,676123,321,125995,261,0.002542453427955899,0.4484536082474227
4186,0.4465,1,0,1,676123,321,125996,260,0.002542453427955899,0.4475043029259897
4187,0.4466,0,2,0,676125,319,125996,260,0.002526612596629071,0.44905008635578586
4188,0.4467,2,1,2,676126,318,125998,258,0.0025186921809656573,0.4479166666666667
4189,0.447,2,1,2,676127,317,126000,256,0.002510771765302243,0.4467713787085515
4190,0.4471,4,0,4,676127,317,126004,252,0.002510771765302243,0.4428822495606327
4191,0.4473,0,1,0,676128,316,126004,252,0.002502851349638829,0.44366197183098594
4192,0.4476,1,5,1,676133,311,126005,251,0.002463249271321759,0.44661921708185054
4193,0.4477,3,6,3,676139,305,126008,248,0.0024157267773412747,0.4484629294755877
4194,0.4478,1,1,1,676140,304,126009,247,0.002407806361677861,0.4482758620689655
4195,0.4479,0,3,0,676143,301,126009,247,0.0023840451146876188,0.45072992700729925
4196,0.448,0,1,0,676144,300,126009,247,0.0023761246990242047,0.4515539305301645
4197,0.4482,1,2,1,676146,298,126010,246,0.002360283867697377,0.4522058823529412
4198,0.4483,3,2,3,676148,296,126013,243,0.002344443036370549,0.45083487940630795
4199,0.4484,1,0,1,676148,296,126014,242,0.002344443036370549,0.44981412639405205
4200,0.4486,6,1,6,676149,295,126020,236,0.0023365226207071347,0.4444444444444444
4201,0.4487,5,2,5,676151,293,126025,231,0.0023206817893803066,0.44083969465648853
4202,0.4488,0,3,0,676154,290,126025,231,0.0022969205423900648,0.44337811900191937
4203,0.4489,1,0,1,676154,290,126026,230,0.0022969205423900648,0.4423076923076923
4204,0.449,3,4,3,676158,286,126029,227,0.0022652388797364084,0.442495126705653
4205,0.4491,3,3,3,676161,283,126032,224,0.0022414776327461666,0.4418145956607495
4206,0.4492,1,2,1,676163,281,126033,223,0.0022256368014193385,0.44246031746031744
4207,0.4493,2,1,2,676164,280,126035,221,0.0022177163857559244,0.4411177644710579
4208,0.4494,3,2,3,676166,278,126038,218,0.0022018755544290962,0.43951612903225806
4209,0.4495,1,2,1,676168,276,126039,217,0.0021860347231022685,0.44016227180527384
4210,0.4496,0,2,0,676170,274,126039,217,0.0021701938917754403,0.4419551934826884
4211,0.4497,0,1,0,676171,273,126039,217,0.0021622734761120263,0.44285714285714284
4212,0.4498,0,2,0,676173,271,126039,217,0.0021464326447851985,0.444672131147541
4213,0.45,1,2,1,676175,269,126040,216,0.0021305918134583704,0.44536082474226807
4214,0.4502,1,3,1,676178,266,126041,215,0.002106830566468128,0.446985446985447
4215,0.4503,0,2,0,676180,264,126041,215,0.0020909897351413004,0.4488517745302714
4216,0.4504,1,0,1,676180,264,126042,214,0.0020909897351413004,0.4476987447698745
4217,0.4506,0,1,0,676181,263,126042,214,0.0020830693194778863,0.44863731656184486
4218,0.4507,1,2,1,676183,261,126043,213,0.002067228488151058,0.44936708860759494
4219,0.4509,0,1,0,676184,260,126043,213,0.002059308072487644,0.4503171247357294
4220,0.451,1,2,1,676186,258,126044,212,0.002043467241160816,0.451063829787234
4221,0.4511,1,1,1,676187,257,126045,211,0.0020355468254974023,0.45085470085470086
4222,0.4514,1,1,1,676188,256,126046,210,0.002027626409833988,0.45064377682403434
4223,0.4515,1,0,1,676188,256,126047,209,0.002027626409833988,0.44946236559139785
4224,0.4517,1,3,1,676191,253,126048,208,0.002003865162843746,0.4511930585683297
4225,0.4518,1,0,1,676191,253,126049,207,0.002003865162843746,0.45
4226,0.4519,0,2,0,676193,251,126049,207,0.001988024331516918,0.4519650655021834
4227,0.452,3,1,3,676194,250,126052,204,0.001980103915853504,0.44933920704845814
4228,0.4521,3,5,3,676199,245,126055,201,0.001940501837536434,0.45067264573991034
4229,0.4522,4,12,4,676211,233,126059,197,0.0018454568495754656,0.45813953488372094
4230,0.4523,0,1,0,676212,232,126059,197,0.0018375364339120518,0.4592074592074592
4231,0.4524,1,0,1,676212,232,126060,196,0.0018375364339120518,0.45794392523364486
4232,0.4525,1,1,1,676213,231,126061,195,0.0018296160182486377,0.45774647887323944
4233,0.4527,2,3,2,676216,228,126063,193,0.0018058547712583957,0.4584323040380047
4234,0.4528,0,1,0,676217,227,126063,193,0.0017979343555949816,0.4595238095238095
4235,0.4529,1,1,1,676218,226,126064,192,0.0017900139399315677,0.45933014354066987
4236,0.453,2,0,2,676218,226,126066,190,0.0017900139399315677,0.4567307692307692
4237,0.4531,1,1,1,676219,225,126067,189,0.0017820935242681536,0.45652173913043476
4238,0.4533,2,4,2,676223,221,126069,187,0.0017504118616144975,0.4583333333333333
4239,0.4534,1,0,1,676223,221,126070,186,0.0017504118616144975,0.457002457002457
4240,0.4541,1,2,1,676225,219,126071,185,0.0017345710302876696,0.45792079207920794
4241,0.4543,0,2,0,676227,217,126071,185,0.0017187301989608414,0.4601990049751244
4242,0.4546,1,2,1,676229,215,126072,184,0.0017028893676340135,0.46115288220551376
4243,0.4548,2,0,2,676229,215,126074,182,0.0017028893676340135,0.45843828715365237
4244,0.4549,1,2,1,676231,213,126075,181,0.0016870485363071853,0.4593908629441624
4245,0.455,1,2,1,676233,211,126076,180,0.0016712077049803574,0.46035805626598464
4246,0.4551,1,0,1,676233,211,126077,179,0.0016712077049803574,0.45897435897435895
4247,0.4552,1,0,1,676233,211,126078,178,0.0016712077049803574,0.45758354755784064
4248,0.4553,2,2,2,676235,209,126080,176,0.0016553668736535294,0.45714285714285713
4249,0.4555,0,1,0,676236,208,126080,176,0.0016474464579901153,0.4583333333333333
4250,0.4557,0,1,0,676237,207,126080,176,0.0016395260423267013,0.4595300261096606
4251,0.4558,3,4,3,676241,203,126083,173,0.0016078443796730452,0.4601063829787234
4252,0.4559,1,4,1,676245,199,126084,172,0.0015761627170193893,0.4636118598382749
4253,0.456,4,2,4,676247,197,126088,168,0.001560321885692561,0.4602739726027397
4254,0.4561,0,1,0,676248,196,126088,168,0.001552401470029147,0.46153846153846156
4255,0.4562,2,7,2,676255,189,126090,166,0.0014969585603852491,0.4676056338028169
4256,0.4563,1,0,1,676255,189,126091,165,0.0014969585603852491,0.4661016949152542
4257,0.4565,3,2,3,676257,187,126094,162,0.001481117729058421,0.46418338108882523
4258,0.4566,3,1,3,676258,186,126097,159,0.0014731973133950069,0.4608695652173913
4259,0.4567,1,3,1,676261,183,126098,158,0.0014494360664047648,0.4633431085043988
4260,0.4568,1,0,1,676261,183,126099,157,0.0014494360664047648,0.46176470588235297
4261,0.4569,0,3,0,676264,180,126099,157,0.0014256748194145228,0.4658753709198813
4262,0.457,1,0,1,676264,180,126100,156,0.0014256748194145228,0.4642857142857143
4263,0.4573,0,2,0,676266,178,126100,156,0.0014098339880876949,0.46706586826347307
4264,0.4574,2,2,2,676268,176,126102,154,0.0013939931567608667,0.4666666666666667
4265,0.4575,1,0,1,676268,176,126103,153,0.0013939931567608667,0.46504559270516715
4266,0.4576,0,1,0,676269,175,126103,153,0.0013860727410974528,0.46646341463414637
4267,0.458,1,1,1,676270,174,126104,152,0.0013781523254340388,0.4662576687116564
4268,0.4582,0,1,0,676271,173,126104,152,0.0013702319097706247,0.4676923076923077
4269,0.4583,0,1,0,676272,172,126104,152,0.0013623114941072108,0.4691358024691358
4270,0.4584,3,2,3,676274,170,126107,149,0.0013464706627803827,0.4670846394984326
4271,0.4585,1,2,1,676276,168,126108,148,0.0013306298314535547,0.46835443037974683
4272,0.4586,0,2,0,676278,166,126108,148,0.0013147890001267266,0.4713375796178344
4273,0.4588,0,1,0,676279,165,126108,148,0.0013068685844633127,0.4728434504792332
4274,0.4593,0,2,0,676281,163,126108,148,0.0012910277531364845,0.4758842443729904
4275,0.4594,1,0,1,676281,163,126109,147,0.0012910277531364845,0.47419354838709676
4276,0.4598,1,1,1,676282,162,126110,146,0.0012831073374730707,0.474025974025974
4277,0.4603,1,3,1,676285,159,126111,145,0.0012593460904828286,0.4769736842105263
4278,0.4605,1,0,1,676285,159,126112,144,0.0012593460904828286,0.4752475247524752
4279,0.4606,2,0,2,676285,159,126114,142,0.0012593460904828286,0.4717607973421927
4280,0.4607,2,0,2,676285,159,126116,140,0.0012593460904828286,0.4682274247491639
4281,0.4608,2,1,2,676286,158,126118,138,0.0012514256748194146,0.46621621621621623
4282,0.4609,4,1,4,676287,157,126122,134,0.0012435052591560005,0.46048109965635736
4283,0.4612,3,5,3,676292,152,126125,131,0.0012039031808389305,0.4628975265017668
4284,0.4617,1,1,1,676293,151,126126,130,0.0011959827651755164,0.4626334519572954
4285,0.4618,1,0,1,676293,151,126127,129,0.0011959827651755164,0.4607142857142857
4286,0.4626,1,0,1,676293,151,126128,128,0.0011959827651755164,0.45878136200716846
4287,0.4627,1,0,1,676293,151,126129,127,0.0011959827651755164,0.4568345323741007
4288,0.4628,1,1,1,676294,150,126130,126,0.0011880623495121023,0.45652173913043476
4289,0.4633,3,0,3,676294,150,126133,123,0.0011880623495121023,0.45054945054945056
4290,0.4634,0,3,0,676297,147,126133,123,0.0011643011025218603,0.45555555555555555
4291,0.4637,0,1,0,676298,146,126133,123,0.0011563806868584462,0.45724907063197023
4292,0.4639,1,2,1,676300,144,126134,122,0.0011405398555316183,0.45864661654135336
4293,0.464,1,2,1,676302,142,126135,121,0.0011246990242047904,0.4600760456273764
4294,0.4641,1,1,1,676303,141,126136,120,0.0011167786085413763,0.45977011494252873
4295,0.4645,0,2,0,676305,139,126136,120,0.0011009377772145481,0.46332046332046334
4296,0.4648,4,4,4,676309,135,126140,116,0.0010692561145608922,0.46215139442231074
4297,0.465,3,1,3,676310,134,126143,113,0.0010613356988974781,0.4574898785425101
4298,0.4652,0,1,0,676311,133,126143,113,0.001053415283234064,0.45934959349593496
4299,0.4653,1,0,1,676311,133,126144,112,0.001053415283234064,0.45714285714285713
4300,0.4654,2,0,2,676311,133,126146,110,0.001053415283234064,0.45267489711934156
4301,0.4655,0,2,0,676313,131,126146,110,0.0010375744519072361,0.45643153526970953
4302,0.4656,4,7,4,676320,124,126150,106,0.000982131542263338,0.4608695652173913
4303,0.466,1,0,1,676320,124,126151,105,0.000982131542263338,0.4585152838427948
4304,0.4662,1,1,1,676321,123,126152,104,0.000974211126599924,0.4581497797356828
4305,0.4666,2,2,2,676323,121,126154,102,0.000958370295273096,0.45739910313901344
4306,0.4667,0,1,0,676324,120,126154,102,0.0009504498796096819,0.4594594594594595
4307,0.4668,1,1,1,676325,119,126155,101,0.0009425294639462679,0.4590909090909091
4308,0.4669,0,1,0,676326,118,126155,101,0.0009346090482828539,0.4611872146118721
4309,0.467,0,2,0,676328,116,126155,101,0.0009187682169560259,0.46543778801843316
4310,0.4671,5,5,5,676333,111,126160,96,0.0008791661386389558,0.463768115942029
4311,0.4674,0,1,0,676334,110,126160,96,0.0008712457229755417,0.46601941747572817
4312,0.4675,1,2,1,676336,108,126161,95,0.0008554048916487138,0.46798029556650245
4313,0.4676,0,1,0,676337,107,126161,95,0.0008474844759852997,0.47029702970297027
4314,0.4678,2,5,2,676342,102,126163,93,0.0008078823976682296,0.47692307692307695
4315,0.468,3,0,3,676342,102,126166,90,0.0008078823976682296,0.46875
4316,0.4682,1,2,1,676344,100,126167,89,0.0007920415663414016,0.4708994708994709
4317,0.4685,2,2,2,676346,98,126169,87,0.0007762007350145735,0.4702702702702703
4318,0.4686,4,3,4,676349,95,126173,83,0.0007524394880243315,0.46629213483146065
4319,0.4687,0,1,0,676350,94,126173,83,0.0007445190723609175,0.4689265536723164
4320,0.469,1,0,1,676350,94,126174,82,0.0007445190723609175,0.4659090909090909
4321,0.4692,3,4,3,676354,90,126177,79,0.0007128374097072614,0.46745562130177515
4322,0.4693,2,1,2,676355,89,126179,77,0.0007049169940438474,0.463855421686747
4323,0.4694,0,3,0,676358,86,126179,77,0.0006811557470536054,0.4723926380368098
4324,0.4698,0,4,0,676362,82,126179,77,0.0006494740843999493,0.48427672955974843
4325,0.47,2,1,2,676363,81,126181,75,0.0006415536687365353,0.4807692307692308
4326,0.4701,2,2,2,676365,79,126183,73,0.0006257128374097073,0.48026315789473684
4327,0.4702,1,0,1,676365,79,126184,72,0.0006257128374097073,0.4768211920529801
4328,0.4703,0,1,0,676366,78,126184,72,0.0006177924217462932,0.48
4329,0.4708,1,0,1,676366,78,126185,71,0.0006177924217462932,0.47651006711409394
4330,0.471,2,1,2,676367,77,126187,69,0.0006098720060828792,0.4726027397260274
4331,0.4712,0,2,0,676369,75,126187,69,0.0005940311747560512,0.4791666666666667
4332,0.4714,1,0,1,676369,75,126188,68,0.0005940311747560512,0.4755244755244755
4333,0.4715,4,2,4,676371,73,126192,64,0.0005781903434292231,0.46715328467153283
4334,0.472,0,1,0,676372,72,126192,64,0.0005702699277658091,0.47058823529411764
4335,0.4721,1,0,1,676372,72,126193,63,0.0005702699277658091,0.4666666666666667
4336,0.4723,0,1,0,676373,71,126193,63,0.0005623495121023952,0.4701492537313433
4337,0.4725,3,1,3,676374,70,126196,60,0.0005544290964389811,0.46153846153846156
4338,0.4728,1,1,1,676375,69,126197,59,0.0005465086807755671,0.4609375
4339,0.4735,1,0,1,676375,69,126198,58,0.0005465086807755671,0.4566929133858268
4340,0.4736,2,0,2,676375,69,126200,56,0.0005465086807755671,0.448
4341,0.4738,0,1,0,676376,68,126200,56,0.000538588265112153,0.45161290322580644
4342,0.474,3,0,3,676376,68,126203,53,0.000538588265112153,0.4380165289256198
4343,0.4741,1,0,1,676376,68,126204,52,0.000538588265112153,0.43333333333333335
4344,0.4745,1,0,1,676376,68,126205,51,0.000538588265112153,0.42857142857142855
4345,0.4751,3,0,3,676376,68,126208,48,0.000538588265112153,0.41379310344827586
4346,0.4757,1,0,1,676376,68,126209,47,0.000538588265112153,0.40869565217391307
4347,0.4758,2,5,2,676381,63,126211,45,0.000498986186795083,0.4166666666666667
4348,0.4763,1,1,1,676382,62,126212,44,0.000491065771131669,0.41509433962264153
4349,0.4765,1,0,1,676382,62,126213,43,0.000491065771131669,0.4095238095238095
4350,0.4766,1,5,1,676387,57,126214,42,0.0004514636928145989,0.42424242424242425
4351,0.4768,1,1,1,676388,56,126215,41,0.0004435432771511849,0.422680412371134
4352,0.4772,1,4,1,676392,52,126216,40,0.00041186161449752884,0.43478260869565216
4353,0.4779,1,0,1,676392,52,126217,39,0.00041186161449752884,0.42857142857142855
4354,0.4782,3,1,3,676393,51,126220,36,0.0004039411988341148,0.41379310344827586
4355,0.4786,0,2,0,676395,49,126220,36,0.00038810036750728676,0.4235294117647059
4356,0.4788,0,1,0,676396,48,126220,36,0.0003801799518438728,0.42857142857142855
4357,0.4795,1,1,1,676397,47,126221,35,0.00037225953618045876,0.4268292682926829
4358,0.4796,0,2,0,676399,45,126221,35,0.0003564187048536307,0.4375
4359,0.4803,0,2,0,676401,43,126221,35,0.0003405778735268027,0.44871794871794873
4360,0.4807,0,1,0,676402,42,126221,35,0.0003326574578633887,0.45454545454545453
4361,0.4815,0,5,0,676407,37,126221,35,0.0002930553795463186,0.4861111111111111
4362,0.4818,0,1,0,676408,36,126221,35,0.0002851349638829046,0.49295774647887325
4363,0.4822,3,0,3,676408,36,126224,32,0.0002851349638829046,0.47058823529411764
4364,0.4826,0,1,0,676409,35,126224,32,0.00027721454821949055,0.47761194029850745
4365,0.4827,0,2,0,676411,33,126224,32,0.00026137371689266255,0.49230769230769234
4366,0.4828,1,0,1,676411,33,126225,31,0.00026137371689266255,0.484375
4367,0.483,1,0,1,676411,33,126226,30,0.00026137371689266255,0.47619047619047616
4368,0.484,1,0,1,676411,33,126227,29,0.00026137371689266255,0.46774193548387094
4369,0.4844,1,0,1,676411,33,126228,28,0.00026137371689266255,0.45901639344262296
4370,0.4848,0,2,0,676413,31,126228,28,0.0002455328855658345,0.4745762711864407
4371,0.4849,1,2,1,676415,29,126229,27,0.00022969205423900647,0.48214285714285715
4372,0.4855,1,0,1,676415,29,126230,26,0.00022969205423900647,0.4727272727272727
4373,0.4859,0,1,0,676416,28,126230,26,0.00022177163857559244,0.48148148148148145
4374,0.4863,1,2,1,676418,26,126231,25,0.00020593080724876442,0.49019607843137253
4375,0.4865,1,1,1,676419,25,126232,24,0.0001980103915853504,0.4897959183673469
4376,0.4872,3,2,3,676421,23,126235,21,0.00018216956025852237,0.4772727272727273
4377,0.4882,1,0,1,676421,23,126236,20,0.00018216956025852237,0.46511627906976744
4378,0.4887,6,9,6,676430,14,126242,14,0.00011088581928779622,0.5
4379,0.4889,2,1,2,676431,13,126244,12,0.00010296540362438221,0.48
4380,0.4897,0,1,0,676432,12,126244,12,9.50449879609682e-05,0.5
4381,0.4918,1,0,1,676432,12,126245,11,9.50449879609682e-05,0.4782608695652174
4382,0.4952,1,3,1,676435,9,126246,10,7.128374097072614e-05,0.5263157894736842
4383,0.4956,1,0,1,676435,9,126247,9,7.128374097072614e-05,0.5
4384,0.4957,3,1,3,676436,8,126250,6,6.336332530731213e-05,0.42857142857142855
4385,0.4958,0,1,0,676437,7,126250,6,5.544290964389811e-05,0.46153846153846156
4386,0.502,3,5,3,676442,2,126253,3,1.5840831326828033e-05,0.6
4387,0.5022,0,1,0,676443,1,126253,3,7.920415663414016e-06,0.75
4388,0.5079,0,1,0,676444,0,126253,3,0.0,1.0
4389,0.5082,3,0,3,676444,0,126256,0,0.0,
