,y_proba,y_test,Neg,Pos,TN,FP,FN,TP,FP/P,Prec
0,0.0,4,344,4,344,605266,4,107952,5.606598984771574,0.15135905151019743
1,0.0016666666666666,0,1,0,345,605265,4,107952,5.606589721738486,0.1513592637303934
2,0.0025,0,6,0,351,605259,4,107952,5.606534143539961,0.1513605370640666
3,0.0033333333333333,1,7,1,358,605252,5,107951,5.606469302308348,0.1513608327502829
4,0.0041071428571428,0,3,0,361,605249,5,107951,5.606441513209085,0.15136146943353898
5,0.005,2,40,2,401,605209,7,107949,5.606070991885583,0.15136757913393667
6,0.0054285714285714,1,4,1,405,605205,8,107948,5.606033939753233,0.15136723816628408
7,0.0057142857142857,0,2,0,407,605203,8,107948,5.606015413687057,0.15136766266891585
8,0.0058333333333333,0,6,0,413,605197,8,107948,5.605959835488532,0.15136893619109718
9,0.006,0,7,0,420,605190,8,107948,5.60589499425692,0.15137042199406006
10,0.0066666666666666,0,11,0,431,605179,8,107948,5.6057931008929565,0.15137275688622082
11,0.0071428571428571,2,2,2,433,605177,10,107946,5.605774574826781,0.15137080139050346
12,0.0073015873015873,0,2,0,435,605175,10,107946,5.605756048760606,0.15137122592098676
13,0.0075,0,9,0,444,605166,10,107946,5.605672681462818,0.15137313633763
14,0.008,0,2,0,446,605164,10,107946,5.6056541553966435,0.15137356088121048
15,0.0083333333333333,0,9,0,455,605155,10,107946,5.605570788098855,0.15137547135679238
16,0.00875,0,1,0,456,605154,10,107946,5.6055615250657675,0.15137568363483384
17,0.009,0,1,0,457,605153,10,107946,5.60555226203268,0.15137589591347064
18,0.0098333333333333,0,2,0,459,605151,10,107946,5.605533735966505,0.15137632047253038
19,0.01,8,357,8,816,604794,18,107938,5.602226833154248,0.15144261798263584
20,0.0107142857142857,0,1,0,817,604793,18,107938,5.6022175701211605,0.15144283046478965
21,0.011,0,3,0,820,604790,18,107938,5.602189781021898,0.15144346791482866
22,0.0116666666666666,0,1,0,821,604789,18,107938,5.602180517988811,0.1514436803993675
23,0.012,1,8,1,829,604781,19,107937,5.60210641372411,0.15144418970757018
24,0.0125,0,14,0,843,604767,19,107937,5.601976731260884,0.1514471646012931
25,0.0132142857142857,1,2,1,845,604765,20,107936,5.601958205194709,0.15144639898077875
26,0.0133333333333333,0,36,0,881,604729,20,107936,5.601624736003557,0.15145404923772038
27,0.0139999999999999,0,12,0,893,604717,20,107936,5.6015135796065065,0.15145659949512597
28,0.0141666666666666,0,7,0,900,604710,20,107936,5.601448738374893,0.15145808718494175
29,0.0142857142857142,0,5,0,905,604705,20,107936,5.601402423209456,0.15145914983841793
30,0.0144444444444444,0,1,0,906,604704,20,107936,5.601393160176368,0.15145936237090257
31,0.0144999999999999,0,4,0,910,604700,20,107936,5.601356108044018,0.15146021250680572
32,0.015,0,58,0,968,604642,20,107936,5.60081885212494,0.1514725405499468
33,0.0158333333333333,0,12,0,980,604630,20,107936,5.600707695727889,0.15147509143012716
34,0.016,0,3,0,983,604627,20,107936,5.600679906628627,0.15147572916359675
35,0.0164285714285714,0,1,0,984,604626,20,107936,5.600670643595539,0.15147594174261328
36,0.0166666666666666,2,25,2,1009,604601,22,107934,5.60043906776835,0.1514788747219435
37,0.017,0,2,0,1011,604599,22,107934,5.600420541702175,0.15147929990610962
38,0.0171428571428571,0,1,0,1012,604598,22,107934,5.600411278669087,0.15147951249908775
39,0.0175,1,13,1,1025,604585,23,107933,5.6002908592389495,0.15148108539012348
40,0.0175714285714285,0,2,0,1027,604583,23,107933,5.600272333172774,0.15148151059063936
41,0.0179166666666666,0,1,0,1028,604582,23,107933,5.600263070139687,0.15148172319179246
42,0.0183333333333333,0,22,0,1050,604560,23,107933,5.600059283411761,0.15148640056814594
43,0.019,0,3,0,1053,604557,23,107933,5.600031494312498,0.15148703841457423
44,0.0191666666666666,0,5,0,1058,604552,23,107933,5.59998517914706,0.1514881015038913
45,0.0195,0,2,0,1060,604550,23,107933,5.599966653080885,0.15148852674379598
46,0.0199999999999999,0,1,0,1061,604549,23,107933,5.5999573900477975,0.1514887393646436
47,0.02,9,595,9,1656,603954,32,107924,5.594445885360702,0.15160462888303894
48,0.0203333333333333,0,1,0,1657,603953,32,107924,5.594436622327615,0.15160484184767875
49,0.0206666666666666,1,2,1,1659,603951,33,107923,5.59441809626144,0.15160407600221387
50,0.0208333333333333,1,4,1,1663,603947,34,107922,5.59438104412909,0.15160373608065528
51,0.021,1,4,1,1667,603943,35,107921,5.594343991996739,0.1516033961543216
52,0.0211666666666666,0,2,0,1669,603941,35,107921,5.594325465930564,0.15160382208911277
53,0.0214285714285714,0,8,0,1677,603933,35,107921,5.594251361665864,0.15160552585221126
54,0.0215,0,1,0,1678,603932,35,107921,5.594242098632776,0.1516057388252912
55,0.0216666666666666,0,8,0,1686,603924,35,107921,5.5941679943680755,0.15160744263147174
56,0.022,0,11,0,1697,603913,35,107921,5.594066101004112,0.15160978542750136
57,0.0223809523809523,0,1,0,1698,603912,35,107921,5.594056837971025,0.15160999841254902
58,0.0225,0,23,0,1721,603889,35,107921,5.593843788210012,0.15161489723381238
59,0.0228571428571428,0,1,0,1722,603888,35,107921,5.593834525176924,0.1516151102332227
60,0.023095238095238,0,1,0,1723,603887,35,107921,5.593825262143836,0.15161532323323143
61,0.0233333333333333,2,57,2,1780,603830,37,107919,5.593297269257846,0.15162508131377775
62,0.0236666666666666,0,3,0,1783,603827,37,107919,5.593269480158583,0.1516257204114951
63,0.02375,0,5,0,1788,603822,37,107919,5.593223164993145,0.15162678558632986
64,0.0239285714285714,0,1,0,1789,603821,37,107919,5.593213901960058,0.1516269986230927
65,0.024,0,14,0,1803,603807,37,107919,5.593084219496832,0.1516299812006306
66,0.0241666666666666,0,4,0,1807,603803,37,107919,5.593047167364482,0.15163083338719333
67,0.0242857142857142,0,2,0,1809,603801,37,107919,5.593028641298306,0.15163125948406678
68,0.0246666666666666,0,2,0,1811,603799,37,107919,5.593010115232132,0.15163168558333498
69,0.0247619047619047,0,1,0,1812,603798,37,107919,5.593000852199044,0.1516318986338671
70,0.0248333333333333,0,1,0,1813,603797,37,107919,5.5929915891659565,0.15163211168499796
71,0.025,1,99,1,1912,603698,38,107918,5.592074548890289,0.15165201456965555
72,0.0258333333333333,1,5,1,1917,603693,39,107917,5.592028233724851,0.1516518879723444
73,0.026,0,5,0,1922,603688,39,107917,5.591981918559413,0.15165295353461541
74,0.02625,0,5,0,1927,603683,39,107917,5.591935603393975,0.1516540191118606
75,0.0265,0,2,0,1929,603681,39,107917,5.591917077327801,0.15165444534695152
76,0.0266025641025641,0,1,0,1930,603680,39,107917,5.5919078142947125,0.15165465846539544
77,0.0266666666666666,1,54,1,1984,603626,40,107916,5.591407610507985,0.1516649755039056
78,0.0268333333333333,0,2,0,1986,603624,40,107916,5.5913890844418095,0.15166540180453664
79,0.027,0,3,0,1989,603621,40,107916,5.591361295342547,0.15166604125997665
80,0.0273333333333333,0,2,0,1991,603619,40,107916,5.5913427692763715,0.15166646756659896
81,0.0275,0,29,0,2020,603590,40,107916,5.591074141316833,0.15167264928194563
82,0.0279999999999999,0,9,0,2029,603581,40,107916,5.590990774019045,0.15167456784779135
83,0.028095238095238,0,1,0,2030,603580,40,107916,5.590981510985957,0.15167478102477033
84,0.0281666666666666,0,1,0,2031,603579,40,107916,5.59097224795287,0.1516749942023486
85,0.0283333333333333,0,22,0,2053,603557,40,107916,5.590768461224943,0.1516796842606817
86,0.0287619047619047,0,3,0,2056,603554,40,107916,5.590740672125681,0.15168032383656374
87,0.0289999999999999,0,8,0,2064,603546,40,107916,5.59066656786098,0.1516820293986186
88,0.0291666666666666,0,3,0,2067,603543,40,107916,5.5906387787617176,0.15168266899427796
89,0.0293333333333333,0,2,0,2069,603541,40,107916,5.590620252695542,0.15168309539438082
90,0.0296190476190476,0,2,0,2071,603539,40,107916,5.590601726629368,0.15168352179688105
91,0.0297142857142857,0,1,0,2072,603538,40,107916,5.59059246359628,0.15168373499903015
92,0.0298333333333333,0,3,0,2075,603535,40,107916,5.590564674497017,0.15168437460907358
93,0.03,18,617,18,2692,602918,58,107898,5.5848493830819965,0.15179455724125512
94,0.0301785714285714,2,6,2,2698,602912,60,107896,5.584793804883471,0.15179345195889749
95,0.0301919191919191,0,2,0,2700,602910,60,107896,5.584775278817296,0.1517938790612347
96,0.0308333333333333,0,1,0,2701,602909,60,107896,5.584766015784209,0.15179409261330462
97,0.031,0,3,0,2704,602906,60,107896,5.584738226684946,0.15179473327311965
98,0.0314285714285714,0,3,0,2707,602903,60,107896,5.584710437585683,0.15179537393834264
99,0.0316666666666666,0,13,0,2720,602890,60,107896,5.584590018155545,0.15179815021680224
100,0.032,0,10,0,2730,602880,60,107896,5.584497387824669,0.15180028588472316
101,0.0325,0,26,0,2756,602854,60,107896,5.584256548964393,0.1518058389025677
102,0.0326666666666666,2,5,2,2761,602849,62,107894,5.584210233798955,0.15180452005858658
103,0.0328571428571428,0,1,0,2762,602848,62,107894,5.584200970765868,0.15180473364455738
104,0.033,0,4,0,2766,602844,62,107894,5.584163918633517,0.15180558799445085
105,0.0332619047619047,0,1,0,2767,602843,62,107894,5.58415465560043,0.15180580158342677
106,0.0332857142857142,0,1,0,2768,602842,62,107894,5.5841453925673425,0.15180601517300377
107,0.0333333333333333,3,88,3,2856,602754,65,107891,5.583330245655637,0.1518212328237024
108,0.0334523809523809,0,1,0,2857,602753,65,107891,5.58332098262255,0.15182144646264514
109,0.0335,0,1,0,2858,602752,65,107891,5.583311719589462,0.15182166010218914
110,0.0339285714285714,0,1,0,2859,602751,65,107891,5.583302456556375,0.15182187374233438
111,0.034,0,15,0,2874,602736,65,107891,5.583163511060062,0.15182507841666584
112,0.0341666666666666,0,5,0,2879,602731,65,107891,5.583117195894624,0.15182614667150748
113,0.0342857142857142,0,5,0,2884,602726,65,107891,5.583070880729186,0.15182721494138193
114,0.0345454545454545,0,1,0,2885,602725,65,107891,5.5830616176960985,0.15182742859716078
115,0.035,0,144,0,3029,602581,65,107891,5.58172774093149,0.15185820130842595
116,0.0350595238095238,0,1,0,3030,602580,65,107891,5.581718477898403,0.15185841505142364
117,0.0353333333333333,1,2,1,3032,602578,66,107890,5.581699951832228,0.1518576487610983
118,0.0355,0,3,0,3035,602575,66,107890,5.581672162732965,0.1518582899931735
119,0.0357142857142857,0,3,0,3038,602572,66,107890,5.5816443736337025,0.151858931230664
120,0.0358333333333333,0,5,0,3043,602567,66,107890,5.5815980584682645,0.1518599999718491
121,0.036,0,15,0,3058,602552,66,107890,5.5814591129719515,0.1518632062856644
122,0.0365,0,4,0,3062,602548,66,107890,5.581422060839602,0.15186406132554847
123,0.0366666666666666,1,74,1,3136,602474,67,107889,5.580736596391122,0.15187868737532784
124,0.037,0,7,0,3143,602467,67,107889,5.58067175515951,0.15188018402040668
125,0.0370454545454545,0,4,0,3147,602463,67,107889,5.580634703027159,0.1518810392594094
126,0.0373333333333333,0,5,0,3152,602458,67,107889,5.580588387861721,0.15188210832170757
127,0.0375,1,33,1,3185,602425,68,107888,5.5802827077698325,0.15188797051440703
128,0.0376111111111111,0,2,0,3187,602423,68,107888,5.580264181703657,0.1518883981805153
129,0.0376666666666666,0,2,0,3189,602421,68,107888,5.580245655637482,0.1518888258490319
130,0.0378333333333333,0,5,0,3194,602416,68,107888,5.580199340472044,0.15188989503086003
131,0.0378571428571428,1,2,1,3196,602414,69,107887,5.580180814405869,0.1518891286933286
132,0.038,0,3,0,3199,602411,69,107887,5.580153025306607,0.1518897702091235
133,0.0381060606060606,0,4,0,3203,602407,69,107887,5.580115973174256,0.15189062557194627
134,0.0383333333333333,1,42,1,3245,602365,70,107886,5.579726925784579,0.15189841337780588
135,0.0388571428571428,0,2,0,3247,602363,70,107886,5.579708399718403,0.15189884111065274
136,0.0389999999999999,0,1,0,3248,602362,70,107886,5.579699136685316,0.15189905497797954
137,0.039,0,1,0,3249,602361,70,107886,5.579689873652229,0.15189926884590854
138,0.0391666666666666,1,5,1,3254,602356,71,107885,5.579643558486791,0.15189914409334296
139,0.0393333333333333,0,4,0,3258,602352,71,107885,5.579606506354441,0.15189999957760578
140,0.0395,0,3,0,3261,602349,71,107885,5.579578717255178,0.15190064119712657
141,0.0398809523809523,0,1,0,3262,602348,71,107885,5.57956945422209,0.1519008550715047
142,0.0399999999999999,0,6,0,3268,602342,71,107885,5.579513876023565,0.15190213833042113
143,0.04,18,775,18,4043,601567,89,107867,5.572335025380711,0.15204656106135314
144,0.0406666666666666,0,5,0,4048,601562,89,107867,5.572288710215273,0.15204763267360089
145,0.0408333333333333,0,9,0,4057,601553,89,107867,5.572205342917485,0.1520495616137126
146,0.0409523809523809,0,1,0,4058,601552,89,107867,5.572196079884398,0.15204977594341285
147,0.0409999999999999,0,8,0,4066,601544,89,107867,5.572121975619697,0.15205149060276765
148,0.0413333333333333,0,2,0,4068,601542,89,107867,5.572103449553522,0.15205191927364892
149,0.0415,0,3,0,4071,601539,89,107867,5.572075660454259,0.1520525622845028
150,0.0416190476190476,0,1,0,4072,601538,89,107867,5.572066397421172,0.15205277662266264
151,0.0416666666666666,0,21,0,4093,601517,89,107867,5.571871873726333,0.15205727786361126
152,0.0417142857142857,0,2,0,4095,601515,89,107867,5.5718533476601575,0.1520577065671246
153,0.0418333333333333,0,1,0,4096,601514,89,107867,5.57184408462707,0.15205792091978781
154,0.042,0,15,0,4111,601499,89,107867,5.571705139130757,0.15206113628225768
155,0.0423333333333333,0,1,0,4112,601498,89,107867,5.571695876097669,0.1520613506445906
156,0.0425,0,68,0,4180,601430,89,107867,5.571065989847716,0.15207592870123518
157,0.0426666666666666,0,3,0,4183,601427,89,107867,5.571038200748453,0.152076571915172
158,0.0428571428571428,0,1,0,4184,601426,89,107867,5.571028937715366,0.15207678632102672
159,0.043,0,3,0,4187,601423,89,107867,5.571001148616103,0.15207742954221828
160,0.0433333333333333,6,96,6,4283,601327,95,107861,5.5701118974396975,0.15209084192061909
161,0.044,2,17,2,4300,601310,97,107859,5.569954425877209,0.15209209652424174
162,0.0441111111111111,0,1,0,4301,601309,97,107859,5.569945162844122,0.15209231098977957
163,0.0441428571428571,0,1,0,4302,601308,97,107859,5.569935899811034,0.15209252545592222
164,0.0441666666666666,0,8,0,4310,601300,97,107859,5.569861795546334,0.15209424120683795
165,0.0442857142857142,0,3,0,4313,601297,97,107859,5.569834006447071,0.1520948846234115
166,0.0443333333333333,0,3,0,4316,601294,97,107859,5.569806217347808,0.15209552804542883
167,0.0445,0,2,0,4318,601292,97,107859,5.5697876912816335,0.15209595699646478
168,0.0446666666666666,2,4,2,4322,601288,99,107857,5.569750639149283,0.15209442356640743
169,0.0449999999999999,0,1,0,4323,601287,99,107857,5.569741376116196,0.15209463804248502
170,0.045,2,181,2,4504,601106,101,107855,5.568064767127348,0.1521310763215466
171,0.0453333333333333,0,2,0,4506,601104,101,107855,5.568046241061173,0.15213150548903392
172,0.0455,0,1,0,4507,601103,101,107855,5.568036978028085,0.1521317200736856
173,0.0455833333333333,0,2,0,4509,601101,101,107855,5.56801845196191,0.15213214924480503
174,0.0456666666666666,1,3,1,4512,601098,102,107854,5.567990662862647,0.15213159706157822
175,0.0457142857142857,0,1,0,4513,601097,102,107854,5.56798139982956,0.15213181164847783
176,0.0458333333333333,0,13,0,4526,601084,102,107854,5.567860980399422,0.15213460133326187
177,0.046,0,10,0,4536,601074,102,107854,5.567768350068547,0.15213674731425475
178,0.0461666666666666,0,1,0,4537,601073,102,107854,5.5677590870354585,0.15213696191568385
179,0.0461904761904761,0,2,0,4539,601071,102,107854,5.567740560969284,0.1521373911203583
180,0.04625,0,3,0,4542,601068,102,107854,5.5677127718700214,0.1521380349319107
181,0.0463333333333333,0,1,0,4543,601067,102,107854,5.567703508836933,0.1521382495369724
182,0.0465,0,1,0,4544,601066,102,107854,5.567694245803846,0.1521384641426395
183,0.0466666666666666,4,125,4,4669,600941,106,107850,5.5665363666679015,0.15216050993875488
184,0.0468333333333333,0,2,0,4671,600939,106,107850,5.566517840601727,0.15216093929222943
185,0.047,0,8,0,4679,600931,106,107850,5.5664437363370265,0.15216265673035817
186,0.0471428571428571,0,2,0,4681,600929,106,107850,5.566425210270851,0.1521630860959481
187,0.0473333333333333,1,4,1,4685,600925,107,107849,5.566388158138501,0.15216274863355597
188,0.0475,1,64,1,4749,600861,108,107848,5.565795324020898,0.15217529338557856
189,0.0478333333333333,0,2,0,4751,600859,108,107848,5.565776797954722,0.1521757228304504
190,0.048,0,8,0,4759,600851,108,107848,5.565702693690022,0.15217744063417615
191,0.0483333333333333,2,47,2,4806,600804,110,107846,5.565267331134907,0.15218514076060113
192,0.0486666666666666,0,1,0,4807,600803,110,107846,5.565258068101819,0.15218535551450718
193,0.0488095238095238,0,2,0,4809,600801,110,107846,5.565239542035644,0.15218578502413754
194,0.0488888888888888,0,2,0,4811,600799,110,107846,5.565221015969469,0.1521862145361923
195,0.049,0,14,0,4825,600785,110,107846,5.565091333506243,0.15218922118846057
196,0.0491666666666666,0,17,0,4842,600768,110,107846,5.5649338619437545,0.15219287228307654
197,0.0493333333333333,0,2,0,4844,600766,110,107846,5.56491533587758,0.15219330183513685
198,0.0494444444444444,0,6,0,4850,600760,110,107846,5.564859757679055,0.15219459050586645
199,0.0495,0,1,0,4851,600759,110,107846,5.564850494645967,0.15219480528644308
200,0.049547619047619,0,3,0,4854,600756,110,107846,5.564822705546704,0.15219544963181025
201,0.0495790598290598,0,5,0,4859,600751,110,107846,5.564776390381266,0.15219652355287985
202,0.0498333333333333,0,2,0,4861,600749,110,107846,5.564757864315092,0.15219695312555126
203,0.0499999999999999,1,1,1,4862,600748,111,107845,5.5647486012820035,0.15219597145328842
204,0.05,21,896,21,5758,599852,132,107824,5.556448923635555,0.15236351098525314
205,0.0501666666666666,0,3,0,5761,599849,132,107824,5.556421134536293,0.1523641568916717
206,0.0503571428571428,0,2,0,5763,599847,132,107824,5.556402608470117,0.15236458749899318
207,0.0504999999999999,1,3,1,5766,599844,133,107823,5.556374819370855,0.15236403562692621
208,0.0506666666666666,0,3,0,5769,599841,133,107823,5.556347030271592,0.1523646815437835
209,0.0506904761904761,0,1,0,5770,599840,133,107823,5.556337767238505,0.15236489685061957
210,0.0508333333333333,1,3,1,5773,599837,134,107822,5.556309978139242,0.15236434497406237
211,0.051,0,6,0,5779,599831,134,107822,5.556254399940717,0.1523656368304805
212,0.0511666666666666,0,2,0,5781,599829,134,107822,5.556235873874542,0.15236606745415465
213,0.0512857142857142,1,3,1,5784,599826,135,107821,5.556208084775279,0.15236551557485584
214,0.0513333333333333,0,1,0,5785,599825,135,107821,5.556198821742191,0.1523657308880429
215,0.0514285714285714,0,4,0,5789,599821,135,107821,5.556161769609841,0.15236659214687653
216,0.0515,0,1,0,5790,599820,135,107821,5.556152506576754,0.1523668074631063
217,0.0516666666666666,1,25,1,5815,599795,136,107820,5.555920930749565,0.15237099270083307
218,0.0519444444444444,0,1,0,5816,599794,136,107820,5.555911667716477,0.1523712080314974
219,0.0519999999999999,0,1,0,5817,599793,136,107820,5.55590240468339,0.15237142336277032
220,0.052,1,13,1,5830,599780,137,107819,5.555781985253251,0.15237302483468745
221,0.0522222222222222,0,2,0,5832,599778,137,107819,5.555763459187077,0.15237345551210646
222,0.0523333333333333,0,3,0,5835,599775,137,107819,5.555735670087814,0.15237410153279987
223,0.0523809523809523,0,1,0,5836,599774,137,107819,5.555726407054726,0.15237431687424832
224,0.0525,2,72,2,5908,599702,139,107817,5.555059468672422,0.15238742705142902
225,0.0526666666666666,0,7,0,5915,599695,139,107817,5.554994627440809,0.1523889347459831
226,0.0527380952380952,0,1,0,5916,599694,139,107817,5.554985364407722,0.15238915013335483
227,0.0527777777777777,1,0,1,5916,599694,140,107816,5.554985364407722,0.15238795211375103
228,0.0528571428571428,0,1,0,5917,599693,140,107816,5.554976101374634,0.15238816750034276
229,0.0529523809523809,0,1,0,5918,599692,140,107816,5.554966838341547,0.15238838288754333
230,0.053,0,2,0,5920,599690,140,107816,5.554948312275371,0.15238881366377105
231,0.0531666666666666,0,1,0,5921,599689,140,107816,5.554939049242284,0.15238902905279822
232,0.0533333333333333,2,112,2,6033,599577,142,107814,5.553901589536478,0.15241076010296992
233,0.0535,0,3,0,6036,599574,142,107814,5.5538738004372155,0.15241140646999948
234,0.0535714285714285,0,4,0,6040,599570,142,107814,5.553836748304865,0.15241226830123383
235,0.0536666666666666,0,4,0,6044,599566,142,107814,5.553799696172515,0.15241313014221494
236,0.05375,0,1,0,6045,599565,142,107814,5.553790433139427,0.15241334560398315
237,0.054,0,29,0,6074,599536,142,107814,5.553521805179888,0.1524195942602672
238,0.0541666666666666,1,12,1,6086,599524,143,107813,5.553410648782838,0.15242098179509908
239,0.0541904761904761,0,5,0,6091,599519,143,107813,5.5533643336174,0.1524220592310259
240,0.0542857142857142,0,6,0,6097,599513,143,107813,5.5533087554188745,0.15242335217424496
241,0.0543333333333333,0,2,0,6099,599511,143,107813,5.553290229352699,0.1524237831601925
242,0.0544444444444444,0,2,0,6101,599509,143,107813,5.553271703286524,0.15242421414857732
243,0.0545,0,1,0,6102,599508,143,107813,5.5532624402534365,0.1524244296436837
244,0.0545833333333333,0,1,0,6103,599507,143,107813,5.553253177220349,0.15242464513939943
245,0.0546666666666666,0,3,0,6106,599504,143,107813,5.553225388121087,0.15242529163020258
246,0.0547619047619047,0,3,0,6109,599501,143,107813,5.553197599021824,0.1524259381264898
247,0.0548333333333333,0,1,0,6110,599500,143,107813,5.553188335988736,0.15242615362647088
248,0.0549999999999999,0,8,0,6118,599492,143,107813,5.553114231724035,0.1524278776482564
249,0.055,5,236,5,6354,599256,148,107808,5.550928155915373,0.15247276059875767
250,0.0553333333333333,0,6,0,6360,599250,148,107808,5.550872577716848,0.15247405446229306
251,0.0556666666666666,0,2,0,6362,599248,148,107808,5.550854051650672,0.15247448575501799
252,0.0557142857142857,0,4,0,6366,599244,148,107808,5.5508169995183225,0.15247534834778773
253,0.0558333333333333,0,8,0,6374,599236,148,107808,5.550742895253622,0.15247707356260715
254,0.0559999999999999,2,19,2,6393,599217,150,107806,5.550566897624958,0.1524787736749724
255,0.0561666666666666,0,2,0,6395,599215,150,107806,5.550548371558783,0.1524792050023974
256,0.0562857142857142,0,1,0,6396,599214,150,107806,5.550539108525696,0.15247942066702497
257,0.0563333333333333,0,4,0,6400,599210,150,107806,5.550502056393346,0.15248028333163605
258,0.0565,0,2,0,6402,599208,150,107806,5.5504835303271705,0.15248071466760205
259,0.0566666666666666,4,111,4,6513,599097,154,107802,5.549455333654452,0.15249986207364843
260,0.0568960761460761,0,3,0,6516,599094,154,107802,5.549427544555189,0.15250050926869016
261,0.0569047619047618,0,2,0,6518,599092,154,107802,5.549409018489014,0.15250094073510315
262,0.057,0,12,0,6530,599080,154,107802,5.549297862091963,0.15250352958485291
263,0.0570238095238095,0,1,0,6531,599079,154,107802,5.549288599058876,0.15250374532629962
264,0.0571428571428571,0,2,0,6533,599077,154,107802,5.549270072992701,0.15250417681102424
265,0.0573333333333333,0,6,0,6539,599071,154,107802,5.5492144947941755,0.152505471279848
266,0.0573809523809523,0,1,0,6540,599070,154,107802,5.549205231761088,0.15250568702678843
267,0.0575,2,57,2,6597,599013,156,107800,5.548677238875097,0.15251558757408254
268,0.0576190476190476,0,3,0,6600,599010,156,107800,5.5486494497758345,0.15251623491461638
269,0.0576666666666666,1,1,1,6601,599009,157,107799,5.548640186742747,0.1525152516666478
270,0.0579999999999999,0,10,0,6611,598999,157,107799,5.548547556411871,0.15251740950030984
271,0.0581666666666666,1,4,1,6615,598995,158,107798,5.5485105042795215,0.15251707359863495
272,0.0583333333333333,1,44,1,6659,598951,159,107797,5.548102930823669,0.15252536972159808
273,0.0584999999999999,0,5,0,6664,598946,159,107797,5.548056615658231,0.15252644879397462
274,0.0585714285714285,0,1,0,6665,598945,159,107797,5.548047352625144,0.1525266646102821
275,0.0586666666666666,1,1,1,6666,598944,160,107796,5.5480380895920565,0.15252568129722388
276,0.05875,0,6,0,6672,598938,160,107796,5.54798251139353,0.15252697620321082
277,0.0588333333333333,0,4,0,6676,598934,160,107796,5.5479454592611805,0.15252783948608378
278,0.0588571428571428,0,2,0,6678,598932,160,107796,5.547926933195005,0.15252827113118483
279,0.0589285714285714,0,3,0,6681,598929,160,107796,5.547899144095743,0.15252891860341716
280,0.059,1,12,1,6693,598917,161,107795,5.547787987698692,0.15253030937637962
281,0.0591666666666666,1,12,1,6705,598905,162,107794,5.547676831301642,0.15253170020050968
282,0.0592857142857142,0,1,0,6706,598904,162,107794,5.547667568268554,0.15253191603768512
283,0.0593333333333333,0,12,0,6718,598892,162,107794,5.547556411871503,0.15253450613143602
284,0.0594761904761904,0,1,0,6719,598891,162,107794,5.547547148838416,0.1525347219765525
285,0.0595,0,3,0,6722,598888,162,107794,5.5475193597391526,0.15253536951556712
286,0.0595238095238095,0,2,0,6724,598886,162,107794,5.547500833672978,0.1525358012112979
287,0.0596666666666666,0,3,0,6727,598883,162,107794,5.5474730445737155,0.1525364487594757
288,0.0598333333333333,0,6,0,6733,598877,162,107794,5.54741746637519,0.1525377438723253
289,0.06,24,1071,24,7804,597806,186,107770,5.53749675793842,0.15274045602458133
290,0.0603333333333333,0,3,0,7807,597803,186,107770,5.537468968839157,0.15274110545613281
291,0.0605,0,1,0,7808,597802,186,107770,5.537459705806069,0.1527413219345439
292,0.0606666666666666,0,6,0,7814,597796,186,107770,5.537404127607544,0.15274262081789655
293,0.0607142857142857,0,2,0,7816,597794,186,107770,5.537385601541368,0.15274305378392322
294,0.0608333333333333,1,19,1,7835,597775,187,107769,5.5372096039127054,0.15274596623314776
295,0.0609523809523809,0,2,0,7837,597773,187,107769,5.53719107784653,0.1527463992221583
296,0.061,0,9,0,7846,597764,187,107769,5.537107710548742,0.15274834770308404
297,0.0611666666666666,1,5,1,7851,597759,188,107768,5.537061395383304,0.15274822933778578
298,0.0611904761904761,0,2,0,7853,597757,188,107768,5.537042869317129,0.15274866234364481
299,0.06125,0,4,0,7857,597753,188,107768,5.537005817184779,0.15274952836272768
300,0.0613333333333333,0,4,0,7861,597749,188,107768,5.536968765052428,0.15275039439163055
301,0.0614285714285714,1,6,1,7867,597743,189,107767,5.536913186853903,0.15275049255148757
302,0.0615,0,6,0,7873,597737,189,107767,5.536857608655378,0.15275179162697872
303,0.0615238095238095,0,3,0,7876,597734,189,107767,5.536829819556115,0.15275244117301037
304,0.0616666666666666,2,56,2,7932,597678,191,107765,5.536311089703212,0.1527621650508971
305,0.0617619047619047,0,1,0,7933,597677,191,107765,5.536301826670125,0.1527623815990542
306,0.0618333333333333,0,2,0,7935,597675,191,107765,5.53628330060395,0.15276281469721026
307,0.062,1,14,1,7949,597661,192,107764,5.536153618140724,0.15276464542651594
308,0.0621428571428571,0,1,0,7950,597660,192,107764,5.536144355107637,0.15276486198371475
309,0.0622619047619047,0,1,0,7951,597659,192,107764,5.536135092074549,0.15276507854152757
310,0.0623333333333333,0,7,0,7958,597652,192,107764,5.536070250842936,0.15276659446340882
311,0.0623571428571428,0,1,0,7959,597651,192,107764,5.536060987809848,0.15276681102613354
312,0.0624999999999999,0,3,0,7962,597648,192,107764,5.5360331987105855,0.15276746071799174
313,0.0625,1,63,1,8025,597585,193,107763,5.53544962762607,0.15277990438762143
314,0.0626666666666666,0,7,0,8032,597578,193,107763,5.535384786394457,0.15278142061782882
315,0.0628333333333333,1,2,1,8034,597576,194,107762,5.535366260328282,0.15278065267999172
316,0.0628571428571428,0,1,0,8035,597575,194,107762,5.535356997295194,0.15278086928659634
317,0.0629761904761904,0,1,0,8036,597574,194,107762,5.535347734262107,0.15278108589381514
318,0.063,0,4,0,8040,597570,194,107762,5.535310682129756,0.15278195232883238
319,0.0631666666666666,0,2,0,8042,597568,194,107762,5.535292156063582,0.15278238555002624
320,0.0633333333333333,1,120,1,8162,597448,195,107761,5.534180592093075,0.1528071819843479
321,0.0634761904761904,0,2,0,8164,597446,195,107761,5.5341620660269,0.15280761535265533
322,0.0635,0,1,0,8165,597445,195,107761,5.5341528029938125,0.15280783203773082
323,0.0635674603174603,0,3,0,8168,597442,195,107761,5.53412501389455,0.15280848209664452
324,0.06375,0,1,0,8169,597441,195,107761,5.534115750861462,0.15280869878417816
325,0.0638333333333333,0,1,0,8170,597440,195,107761,5.5341064878283746,0.15280891547232633
326,0.064,1,30,1,8200,597410,196,107760,5.533828596835748,0.15281421501198292
327,0.064047619047619,2,1,2,8201,597409,198,107758,5.5338193338026604,0.15281202892364504
328,0.0641666666666666,0,18,0,8219,597391,198,107758,5.533652599207084,0.15281592968294644
329,0.0642857142857143,1,8,1,8227,597383,199,107757,5.533578494942384,0.15281646197918144
330,0.0643333333333333,0,3,0,8230,597380,199,107757,5.533550705843122,0.1528171121356559
331,0.0645238095238095,0,2,0,8232,597378,199,107757,5.533532179776946,0.152817545576379
332,0.0646666666666666,0,5,0,8237,597373,199,107757,5.533485864611508,0.15281862918894387
333,0.0647142857142857,1,0,1,8237,597373,200,107756,5.533485864611508,0.15281742773308146
334,0.0647619047619047,0,2,0,8239,597371,200,107756,5.533467338545333,0.1528178611796173
335,0.0647857142857142,0,4,0,8243,597367,200,107756,5.533430286412983,0.15281872808006547
336,0.0649999999999999,1,0,1,8243,597367,201,107755,5.533430286412983,0.15281752661241602
337,0.065,12,321,12,8564,597046,213,107743,5.530456852791878,0.1528727037453763
338,0.0651666666666666,0,3,0,8567,597043,213,107743,5.530429063692615,0.1528733544650433
339,0.0652272727272727,0,1,0,8568,597042,213,107743,5.530419800659528,0.15287357137283
340,0.0653333333333333,0,5,0,8573,597037,213,107743,5.53037348549409,0.1528746559209966
341,0.0655555555555555,0,1,0,8574,597036,213,107743,5.530364222461003,0.15287487283247655
342,0.0656666666666666,0,4,0,8578,597032,213,107743,5.530327170328652,0.1528757404845518
343,0.0657142857142857,0,6,0,8584,597026,213,107743,5.530271592130127,0.15287704198113142
344,0.0658333333333333,0,29,0,8613,596997,213,107743,5.530002964170588,0.15288333286034567
345,0.0659523809523809,0,2,0,8615,596995,213,107743,5.529984438104413,0.15288376673316892
346,0.066,0,32,0,8647,596963,213,107743,5.529688021045611,0.15289070903327062
347,0.0661666666666666,0,2,0,8649,596961,213,107743,5.529669494979436,0.15289114294796113
348,0.0661904761904761,0,1,0,8650,596960,213,107743,5.529660231946348,0.15289135990623
349,0.06625,1,2,1,8652,596958,214,107742,5.529641705880174,0.15289059174116645
350,0.0664285714285714,0,1,0,8653,596957,214,107742,5.5296324428470855,0.15289080869988464
351,0.0664393939393939,0,2,0,8655,596955,214,107742,5.529613916780911,0.15289124261916823
352,0.0664444444444444,0,1,0,8656,596954,214,107742,5.529604653747823,0.15289145957973369
353,0.0664999999999999,0,2,0,8658,596952,214,107742,5.5295861276816485,0.15289189350271182
354,0.0665,0,7,0,8665,596945,214,107742,5.529521286450035,0.15289341225253197
355,0.0666190476190476,0,1,0,8666,596944,214,107742,5.529512023416948,0.1528936292192551
356,0.0666666666666666,4,157,4,8823,596787,218,107738,5.528057727222202,0.1529228913097477
357,0.0667058823529411,0,3,0,8826,596784,218,107738,5.528029938122939,0.1529235424869628
358,0.0667857142857142,0,2,0,8828,596782,218,107738,5.528011412056764,0.15292397660818713
359,0.0668333333333333,0,6,0,8834,596776,218,107738,5.527955833858239,0.15292527898664895
360,0.0669047619047619,0,1,0,8835,596775,218,107738,5.527946570825151,0.15292549605188266
361,0.0669999999999999,0,1,0,8836,596774,218,107738,5.5279373077920635,0.15292571311773256
362,0.067,0,7,0,8843,596767,218,107738,5.52787246656045,0.15292723259593616
363,0.0671428571428571,0,3,0,8846,596764,218,107738,5.527844677461188,0.15292788381012404
364,0.0671666666666666,0,1,0,8847,596763,218,107738,5.5278354144281,0.15292810088275247
365,0.0672301587301587,0,2,0,8849,596761,218,107738,5.527816888361925,0.1529285350298581
366,0.0673333333333333,0,5,0,8854,596756,218,107738,5.527770573196487,0.1529296204084066
367,0.0675,3,73,3,8927,596683,221,107735,5.527094371781096,0.15294186122444345
368,0.0676190476190476,0,1,0,8928,596682,221,107735,5.527085108748008,0.1529420783427998
369,0.0676666666666666,0,8,0,8936,596674,221,107735,5.527011004483308,0.15294381531184298
370,0.0678333333333333,0,1,0,8937,596673,221,107735,5.527001741450221,0.15294403243574747
371,0.0678571428571428,0,1,0,8938,596672,221,107735,5.5269924784171325,0.15294424956026842
372,0.068,0,23,0,8961,596649,221,107735,5.526779428656119,0.15294924359440304
373,0.0681666666666666,0,1,0,8962,596648,221,107735,5.526770165623032,0.15294946073372015
374,0.0683333333333333,3,65,3,9027,596583,224,107732,5.526168068472341,0.15295996819604865
375,0.0684415584415584,0,1,0,9028,596582,224,107732,5.526158805439253,0.1529601853718654
376,0.0684999999999999,0,5,0,9033,596577,224,107732,5.526112490273816,0.1529612712601997
377,0.0686666666666666,0,7,0,9040,596570,224,107732,5.526047649042202,0.1529627915297699
378,0.06875,0,4,0,9044,596566,224,107732,5.5260105969098525,0.15296366026880667
379,0.0688571428571428,0,1,0,9045,596565,224,107732,5.526001333876764,0.15296387745510773
380,0.069,1,15,1,9060,596550,225,107731,5.525862388380451,0.15296593263200342
381,0.0691190476190476,0,2,0,9062,596548,225,107731,5.525843862314276,0.15296636702216027
382,0.0691666666666666,0,17,0,9079,596531,225,107731,5.525686390751788,0.15297005943810685
383,0.0692857142857142,0,2,0,9081,596529,225,107731,5.525667864685612,0.1529704938517025
384,0.0693333333333333,0,9,0,9090,596520,225,107731,5.5255844973878245,0.15297244874341676
385,0.0695,0,1,0,9091,596519,225,107731,5.525575234354737,0.1529726659566915
386,0.0695238095238095,0,3,0,9094,596516,225,107731,5.525547445255475,0.15297331760021696
387,0.0696666666666666,0,6,0,9100,596510,225,107731,5.5254918670569495,0.15297462090392352
388,0.0697063492063492,1,3,1,9103,596507,226,107730,5.525464077957687,0.15297406980888537
389,0.0697619047619047,0,1,0,9104,596506,226,107730,5.525454814924599,0.15297428702878013
390,0.0697857142857142,0,1,0,9105,596505,226,107730,5.5254455518915115,0.1529745042492918
391,0.0698333333333333,0,3,0,9108,596502,226,107730,5.525417762792249,0.15297515591452818
392,0.0699999999999999,0,4,0,9112,596498,226,107730,5.525380710659898,0.15297602481014672
393,0.07,35,1350,35,10462,595148,261,107695,5.5128756159917005,0.15322767673577173
394,0.070060606060606,0,2,0,10464,595146,261,107695,5.512857089925525,0.15322811275950038
395,0.0701666666666666,0,1,0,10465,595145,261,107695,5.512847826892438,0.15322833077229525
396,0.07025,0,2,0,10467,595143,261,107695,5.5128293008262625,0.15322876679974617
397,0.0703095238095238,0,1,0,10468,595142,261,107695,5.512820037793175,0.1532289848144022
398,0.0703333333333333,0,5,0,10473,595137,261,107695,5.512773722627737,0.15323007489698817
399,0.0704285714285714,0,1,0,10474,595136,261,107695,5.51276445959465,0.15323029291536658
400,0.0705,1,1,1,10475,595135,262,107694,5.512755196561562,0.1532293061327862
401,0.0705555555555555,0,1,0,10476,595134,262,107694,5.512745933528475,0.15322952415100138
402,0.0706666666666666,0,7,0,10483,595127,262,107694,5.512681092296861,0.15323105029587902
403,0.0707142857142857,0,1,0,10484,595126,262,107694,5.512671829263774,0.1532312683190575
404,0.0708333333333333,1,17,1,10501,595109,263,107693,5.512514357701286,0.1532337699665055
405,0.0709848484848484,0,2,0,10503,595107,263,107693,5.5124958316351105,0.1532342060330108
406,0.071,0,11,0,10514,595096,263,107693,5.512393938271147,0.15323660444315435
407,0.0711746031746031,0,2,0,10516,595094,263,107693,5.512375412204972,0.15323704052579232
408,0.07125,0,2,0,10518,595092,263,107693,5.5123568861387975,0.1532374766109123
409,0.0713333333333333,0,5,0,10523,595087,263,107693,5.5123105709733595,0.15323856683457127
410,0.0714285714285714,0,1,0,10524,595086,263,107693,5.512301307940272,0.15323878488116463
411,0.0715,0,2,0,10526,595084,263,107693,5.512282781874097,0.15323922097621293
412,0.0716666666666666,2,59,2,10585,595025,265,107691,5.511736262921931,0.15324967696765124
413,0.0719444444444444,1,2,1,10587,595023,266,107690,5.511717736855756,0.15324890816023043
414,0.072,1,16,1,10603,595007,267,107689,5.511569528326355,0.15325119254983663
415,0.0720833333333333,0,2,0,10605,595005,267,107689,5.51155100226018,0.15325162873170967
416,0.0723333333333333,0,3,0,10608,595002,267,107689,5.511523213160918,0.15325228300917473
417,0.0723809523809523,1,6,1,10614,594996,268,107688,5.511467634962392,0.1532523865635193
418,0.0724285714285714,0,2,0,10616,594994,268,107688,5.511449108896217,0.15325282275623966
419,0.0725,1,69,1,10685,594925,269,107687,5.510809959613176,0.15326666780527518
420,0.0726428571428571,0,1,0,10686,594924,269,107687,5.510800696580088,0.15326688594400031
421,0.0726666666666666,0,8,0,10694,594916,269,107687,5.510726592315388,0.15326863107615538
422,0.0728571428571428,0,5,0,10699,594911,269,107687,5.51068027714995,0.1532697218039334
423,0.0729166666666666,0,1,0,10700,594910,269,107687,5.510671014116863,0.1532699399513519
424,0.073,1,5,1,10705,594905,270,107686,5.510624698951425,0.15326982554573002
425,0.0731666666666666,0,4,0,10709,594901,270,107686,5.510587646819075,0.15327069814841435
426,0.0733333333333333,5,168,5,10877,594733,275,107681,5.509031457260365,0.153301329415416
427,0.0733809523809523,0,1,0,10878,594732,275,107681,5.509022194227278,0.15330154766497772
428,0.0735,0,1,0,10879,594731,275,107681,5.50901293119419,0.1533017659151609
429,0.0736666666666666,0,6,0,10885,594725,275,107681,5.508957352995665,0.15330307542931013
430,0.0738095238095238,0,1,0,10886,594724,275,107681,5.508948089962577,0.15330329368384338
431,0.074,0,37,0,10923,594687,275,107681,5.508605357738338,0.15331136953847554
432,0.0741666666666666,1,16,1,10939,594671,276,107680,5.508457149208937,0.15331365656203239
433,0.0742857142857142,1,5,1,10944,594666,277,107679,5.5084108340435,0.15331354248980203
434,0.0743333333333333,0,7,0,10951,594659,277,107679,5.508345992811886,0.1533150705216007
435,0.0744642857142857,1,2,1,10953,594657,278,107678,5.508327466745711,0.15331430157973047
436,0.0745833333333333,0,2,0,10955,594655,278,107678,5.5083089406795365,0.15331473816551408
437,0.0746666666666666,0,7,0,10962,594648,278,107678,5.508244099447923,0.153316266235338
438,0.0747142857142857,0,4,0,10966,594644,278,107678,5.508207047315573,0.1533171394317706
439,0.0747619047619047,0,1,0,10967,594643,278,107678,5.508197784282485,0.15331735773243288
440,0.0748333333333333,0,1,0,10968,594642,278,107678,5.508188521249398,0.15331757603371682
441,0.0749761904761904,0,1,0,10969,594641,278,107678,5.508179258216311,0.15331779433562243
442,0.075,12,321,12,11290,594320,290,107666,5.505205824595206,0.15337342909972562
443,0.0751666666666666,0,1,0,11291,594319,290,107666,5.505196561562118,0.15337364758506236
444,0.0753333333333333,0,6,0,11297,594313,290,107666,5.505140983363592,0.15337495851015487
445,0.0754761904761904,0,1,0,11298,594312,290,107666,5.505131720330505,0.153375176999849
446,0.0755555555555555,0,1,0,11299,594311,290,107666,5.505122457297418,0.15337539549016563
447,0.0756666666666666,0,7,0,11306,594304,290,107666,5.5050576160658045,0.15337692493981225
448,0.0757142857142857,0,2,0,11308,594302,290,107666,5.505039089999629,0.1533773619310282
449,0.0758333333333333,0,19,0,11327,594283,290,107666,5.504863092370966,0.15338151347177645
450,0.076,1,29,1,11356,594254,291,107665,5.504594464411427,0.15338664432790677
451,0.0761666666666666,1,3,1,11359,594251,292,107664,5.504566675312164,0.1533860937577912
452,0.0761904761904761,0,3,0,11362,594248,292,107664,5.504538886212901,0.1533867493360991
453,0.07625,0,1,0,11363,594247,292,107664,5.504529623179814,0.15338696786344708
454,0.0764285714285714,0,4,0,11367,594243,292,107664,5.5044925710474635,0.1533878419790656
455,0.0765,0,3,0,11370,594240,292,107664,5.504464781948201,0.1533884975723176
456,0.0766666666666666,7,168,7,11538,594072,299,107657,5.502908592389492,0.15341677485183028
457,0.0768333333333333,0,5,0,11543,594067,299,107657,5.502862277224054,0.15341786799368412
458,0.077,0,11,0,11554,594056,299,107657,5.502760383860092,0.15342027296059785
459,0.0773333333333333,1,9,1,11563,594047,300,107656,5.502677016562303,0.15342103425523335
460,0.0774358974358974,0,1,0,11564,594046,300,107656,5.502667753529216,0.15342125289652872
461,0.0774999999999999,0,7,0,11571,594039,300,107656,5.502602912297602,0.1534227834030455
462,0.0775,5,105,5,11676,593934,305,107651,5.50163029382341,0.1534397115103658
463,0.0776666666666666,0,10,0,11686,593924,305,107651,5.501537663492534,0.15344189858532586
464,0.0778333333333333,0,4,0,11690,593920,305,107651,5.501500611360184,0.15344277343276733
465,0.0778571428571428,0,2,0,11692,593918,305,107651,5.5014820852940085,0.153443210860229
466,0.0779166666666666,0,2,0,11694,593916,305,107651,5.501463559227833,0.1534436482901847
467,0.078,1,10,1,11704,593906,306,107650,5.501370928896958,0.1534446287965608
468,0.0781666666666666,0,8,0,11712,593898,306,107650,5.5012968246322576,0.15344637857994037
469,0.0782142857142857,0,1,0,11713,593897,306,107650,5.50128756159917,0.15344659730566876
470,0.0782857142857142,0,1,0,11714,593896,306,107650,5.501278298566082,0.1534468160320207
471,0.0783333333333333,4,86,4,11800,593810,310,107646,5.500481677720553,0.15346080153281175
472,0.0785,0,1,0,11801,593809,310,107646,5.500472414687465,0.1534610203077888
473,0.0786666666666666,0,6,0,11807,593803,310,107646,5.50041683648894,0.15346233297075054
474,0.079,0,11,0,11818,593792,310,107646,5.500314943124977,0.15346473957783865
475,0.079047619047619,0,1,0,11819,593791,310,107646,5.5003056800918895,0.15346495836404409
476,0.0791666666666666,1,25,1,11844,593766,311,107645,5.500074104264701,0.1534692213267257
477,0.0792857142857142,0,2,0,11846,593764,311,107645,5.500055578198525,0.15346965892938358
478,0.0793333333333333,2,11,2,11857,593753,313,107643,5.499953684834562,0.1534696519512515
479,0.0795,0,2,0,11859,593751,313,107643,5.499935158768387,0.15347008956449584
480,0.0795238095238095,0,2,0,11861,593749,313,107643,5.499916632702212,0.15347052718023588
481,0.0795833333333333,1,0,1,11861,593749,314,107642,5.499916632702212,0.15346932025075885
482,0.0796666666666666,0,3,0,11864,593746,314,107642,5.49988884360295,0.15346997667482193
483,0.0797619047619047,0,6,0,11870,593740,314,107642,5.499833265404424,0.1534712895397943
484,0.0798333333333333,0,4,0,11874,593736,314,107642,5.499796213272074,0.15347216479558812
485,0.0798888888888888,0,1,0,11875,593735,314,107642,5.4997869502389864,0.15347238361109647
486,0.0799999999999999,1,3,1,11878,593732,315,107641,5.499759161139724,0.15347183310449647
487,0.08,49,1360,49,13238,592372,364,107592,5.48716143614065,0.15371076226777378
488,0.0801190476190476,2,3,2,13241,592369,366,107590,5.487133647041388,0.1537090029558874
489,0.0801666666666666,0,2,0,13243,592367,366,107590,5.487115120975212,0.15370944215144644
490,0.0803174603174603,0,1,0,13244,592366,366,107590,5.487105857942124,0.15370966175016715
491,0.0803333333333333,0,4,0,13248,592362,366,107590,5.487068805809774,0.15371054015132465
492,0.0803809523809523,0,1,0,13249,592361,366,107590,5.487059542776687,0.1537107597531827
493,0.0804761904761904,0,1,0,13250,592360,366,107590,5.487050279743599,0.15371097935566827
494,0.0805,0,3,0,13253,592357,366,107590,5.487022490644336,0.1537116381668898
495,0.0806666666666666,0,11,0,13264,592346,366,107590,5.486920597280373,0.1537140538563526
496,0.0807142857142857,0,3,0,13267,592343,366,107590,5.486892808181111,0.15371471269392928
497,0.0807857142857142,0,1,0,13268,592342,366,107590,5.486883545148023,0.15371493230770988
498,0.0808333333333333,1,25,1,13293,592317,367,107589,5.486651969320834,0.15371921372298566
499,0.0809523809523809,0,5,0,13298,592312,367,107589,5.4866056541553965,0.15372031187267915
500,0.081,0,25,0,13323,592287,367,107589,5.486374078328208,0.153725802856506
501,0.0811428571428571,1,1,1,13324,592286,368,107588,5.48636481529512,0.1537248133235411
502,0.0811904761904761,0,1,0,13325,592285,368,107588,5.486355552262033,0.15372503297026746
503,0.08125,1,1,1,13326,592284,369,107587,5.486346289228945,0.15372404343086082
504,0.0813333333333333,0,7,0,13333,592277,369,107587,5.4862814479973325,0.15372558097001704
505,0.0813636363636363,1,3,1,13336,592274,370,107586,5.48625365889807,0.1537250307204298
506,0.0814285714285714,0,3,0,13339,592271,370,107586,5.486225869798807,0.15372568967660535
507,0.0815,0,1,0,13340,592270,370,107586,5.486216606765719,0.1537259093299193
508,0.0816666666666666,2,74,2,13414,592196,372,107584,5.485531142317241,0.15373974677755867
509,0.0817857142857143,0,1,0,13415,592195,372,107584,5.4855218792841525,0.15373996647513
510,0.0818333333333333,0,1,0,13416,592194,372,107584,5.485512616251065,0.15374018617332927
511,0.0818571428571428,0,2,0,13418,592192,372,107584,5.48549409018489,0.1537406255716115
512,0.0819999999999999,1,40,1,13458,592152,373,107583,5.485123568861388,0.15374820467748504
513,0.082,0,2,0,13460,592150,373,107583,5.485105042795213,0.15374864412568795
514,0.0821904761904761,0,3,0,13463,592147,373,107583,5.48507725369595,0.15374930330270248
515,0.0822222222222222,0,2,0,13465,592145,373,107583,5.4850587276297755,0.15374974275718564
516,0.0823333333333333,0,4,0,13469,592141,373,107583,5.485021675497425,0.15375062167368847
517,0.0823571428571428,0,1,0,13470,592140,373,107583,5.485012412464338,0.1537508414043843
518,0.0823809523809523,0,3,0,13473,592137,373,107583,5.484984623365075,0.1537515006002401
519,0.0825,1,78,1,13551,592059,374,107582,5.484262106784246,0.15376743215449065
520,0.0825238095238095,0,1,0,13552,592058,374,107582,5.4842528437511575,0.153767651935281
521,0.0826190476190476,0,1,0,13553,592057,374,107582,5.48424358071807,0.15376787171669962
522,0.0826666666666666,0,7,0,13560,592050,374,107582,5.484178739486458,0.15376941020422163
523,0.0827777777777777,0,1,0,13561,592049,374,107582,5.48416947645337,0.1537696299906665
524,0.0828333333333333,0,8,0,13569,592041,374,107582,5.484095372188669,0.1537713883048442
525,0.0828571428571428,0,5,0,13574,592036,374,107582,5.484049057023232,0.15377248727162537
526,0.083,0,15,0,13589,592021,374,107582,5.483910111526918,0.15377578426621955
527,0.083047619047619,0,2,0,13591,592019,374,107582,5.483891585460743,0.15377622387618084
528,0.0830952380952381,0,3,0,13594,592016,374,107582,5.48386379636148,0.1537768832958356
529,0.0831507936507936,0,1,0,13595,592015,374,107582,5.483854533328393,0.15377710310364395
530,0.0831666666666666,0,3,0,13598,592012,374,107582,5.48382674422913,0.15377776253083933
531,0.083270202020202,0,2,0,13600,592010,374,107582,5.483808218162955,0.15377820215211152
532,0.0833333333333333,3,160,3,13760,591850,377,107579,5.4823261328689465,0.15380975052507118
533,0.0834999999999999,1,3,1,13763,591847,378,107578,5.482298343769684,0.1538092004146263
534,0.0835,0,1,0,13764,591846,378,107578,5.482289080736597,0.15380942032300865
535,0.0835714285714285,0,6,0,13770,591840,378,107578,5.482233502538071,0.15381073978650822
536,0.0835952380952381,0,1,0,13771,591839,378,107578,5.482224239504983,0.1538109596992924
537,0.0836111111111111,0,1,0,13772,591838,378,107578,5.482214976471896,0.15381117961270546
538,0.0836666666666666,0,8,0,13780,591830,378,107578,5.482140872207196,0.15381293894264864
539,0.08375,0,3,0,13783,591827,378,107578,5.482113083107933,0.15381359870175362
540,0.0837662337662337,0,4,0,13787,591823,378,107578,5.482076030975582,0.1538144783893646
541,0.0838333333333333,1,0,1,13787,591823,379,107577,5.482076030975582,0.15381326851587074
542,0.0838809523809523,0,1,0,13788,591822,379,107577,5.482066767942495,0.15381348843793027
543,0.0839285714285714,0,3,0,13791,591819,379,107577,5.482038978843232,0.15381414820788222
544,0.084,1,50,1,13841,591769,380,107576,5.481575827188855,0.15382393525370167
545,0.084047619047619,0,1,0,13842,591768,380,107576,5.481566564155767,0.1538241552083095
546,0.0841666666666666,2,21,2,13863,591747,382,107574,5.481372040460928,0.15382635442093115
547,0.0842857142857142,0,5,0,13868,591742,382,107574,5.48132572529549,0.1538274542553009
548,0.0843333333333333,0,2,0,13870,591740,382,107574,5.481307199229316,0.15382789419345244
549,0.0844444444444444,0,1,0,13871,591739,382,107574,5.481297936196228,0.15382811416347186
550,0.0844999999999999,0,2,0,13873,591737,382,107574,5.481279410130053,0.15382855410539803
551,0.0846666666666666,0,3,0,13876,591734,382,107574,5.481251621030791,0.1538292140230056
552,0.0847142857142857,0,1,0,13877,591733,382,107574,5.4812423579977025,0.15382943399679969
553,0.0848333333333333,0,1,0,13878,591732,382,107574,5.481233094964615,0.1538296539712229
554,0.085,10,426,10,14304,591306,392,107564,5.4772870428693174,0.15391131397827923
555,0.0850714285714285,0,4,0,14308,591302,392,107564,5.477249990736967,0.15391219489859287
556,0.0851666666666666,0,1,0,14309,591301,392,107564,5.4772407277038795,0.1539124151302469
557,0.0852380952380952,0,1,0,14310,591300,392,107564,5.477231464670791,0.1539126353625312
558,0.0852857142857142,0,1,0,14311,591299,392,107564,5.477222201637704,0.15391285559544574
559,0.0853333333333333,0,8,0,14319,591291,392,107564,5.477148097373004,0.1539146174814518
560,0.0855,0,4,0,14323,591287,392,107564,5.477111045240654,0.15391549843958155
561,0.0856666666666666,0,5,0,14328,591282,392,107564,5.477064730075216,0.15391659965142535
562,0.0857142857142857,0,3,0,14331,591279,392,107564,5.477036940975953,0.1539172603860953
563,0.0857261904761904,0,1,0,14332,591278,392,107564,5.477027677942866,0.15391748063224592
564,0.0858333333333333,1,19,1,14351,591259,393,107563,5.476851680314202,0.15392045470806587
565,0.0858690476190476,0,1,0,14352,591258,393,107563,5.476842417281114,0.153920674965406
566,0.086,1,37,1,14389,591221,394,107562,5.476499685056875,0.1539276141520329
567,0.0861111111111111,1,1,1,14390,591220,395,107561,5.4764904220237876,0.15392662364889714
568,0.0861428571428571,0,1,0,14391,591219,395,107561,5.4764811589907,0.15392684392798878
569,0.0861666666666666,0,2,0,14393,591217,395,107561,5.476462632924525,0.15392728448806345
570,0.08625,0,3,0,14396,591214,395,107561,5.476434843825262,0.15392794533290402
571,0.0863095238095238,0,1,0,14397,591213,395,107561,5.476425580792174,0.1539281656157785
572,0.0863333333333333,1,3,1,14400,591210,396,107560,5.476397791692912,0.15392761566753008
573,0.0863571428571428,0,4,0,14404,591206,396,107560,5.476360739560562,0.15392849680722875
574,0.0865,0,4,0,14408,591202,396,107560,5.476323687428211,0.15392937795701542
575,0.0865238095238095,0,1,0,14409,591201,396,107560,5.476314424395124,0.15392959824603836
576,0.0866489898989898,0,2,0,14411,591199,396,107560,5.4762958983289485,0.15393003882597578
577,0.0866666666666666,4,192,4,14603,591007,400,107556,5.474517395976139,0.15396750185738436
578,0.0867619047619047,0,1,0,14604,591006,400,107556,5.4745081329430505,0.15396772226373606
579,0.0867857142857142,0,1,0,14605,591005,400,107556,5.474498869909963,0.1539679426707188
580,0.0868095238095238,0,1,0,14606,591004,400,107556,5.474489606876876,0.15396816307833258
581,0.087,0,13,0,14619,590991,400,107556,5.4743691874467375,0.15397102843473667
582,0.0870833333333333,0,1,0,14620,590990,400,107556,5.47435992441365,0.15397124885118518
583,0.0871428571428571,1,1,1,14621,590989,401,107555,5.474350661380562,0.1539702581369248
584,0.0871666666666666,2,5,2,14626,590984,403,107553,5.474304346215125,0.15396893793743208
585,0.0872727272727272,0,1,0,14627,590983,403,107553,5.474295083182037,0.15396915835404332
586,0.0872857142857142,0,3,0,14630,590980,403,107553,5.474267294082774,0.15396981960766348
587,0.0873333333333333,0,8,0,14638,590972,403,107553,5.474193189818074,0.15397158297841881
588,0.0875,1,100,1,14738,590872,404,107552,5.473266886509319,0.15399241721361237
589,0.0876190476190476,0,3,0,14741,590869,404,107552,5.4732390974100555,0.1539930786731785
590,0.0876666666666666,0,3,0,14744,590866,404,107552,5.473211308310793,0.15399374013842712
591,0.0876785714285714,0,1,0,14745,590865,404,107552,5.473202045277706,0.15399396062810614
592,0.0878571428571428,0,4,0,14749,590861,404,107552,5.473164993145356,0.15399484259313614
593,0.0879166666666666,0,2,0,14751,590859,404,107552,5.4731464670791805,0.15399528357943962
594,0.0879285714285714,0,2,0,14753,590857,404,107552,5.473127941013005,0.15399572456826874
595,0.088,0,23,0,14776,590834,404,107552,5.472914891251992,0.15400079612134263
596,0.0882857142857142,0,2,0,14778,590832,404,107552,5.472896365185816,0.15400123714174438
597,0.0883333333333333,4,105,4,14883,590727,408,107548,5.4719237467116235,0.1540195481722817
598,0.0884166666666666,0,2,0,14885,590725,408,107548,5.471905220645448,0.15401998931649943
599,0.0884444444444444,0,1,0,14886,590724,408,107548,5.471895957612361,0.15402020988955592
600,0.0884523809523809,0,2,0,14888,590722,408,107548,5.4718774315461856,0.15402065103756427
601,0.0885,2,6,2,14894,590716,410,107546,5.47182185334766,0.15401955140047718
602,0.0885714285714285,0,2,0,14896,590714,410,107546,5.471803327281485,0.15401999255291726
603,0.0886666666666666,0,8,0,14904,590706,410,107546,5.471729223016784,0.15402175718794933
604,0.08875,0,4,0,14908,590702,410,107546,5.471692170884435,0.15402263952062878
605,0.0888333333333333,0,2,0,14910,590700,410,107546,5.471673644818259,0.15402308069075943
606,0.0888888888888888,0,2,0,14912,590698,410,107546,5.471655118752084,0.15402352186341736
607,0.0889285714285714,0,1,0,14913,590697,410,107546,5.471645855718997,0.1540237424506941
608,0.0889999999999999,0,3,0,14916,590694,410,107546,5.471618066619734,0.1540244042163153
609,0.089,0,16,0,14932,590678,410,107546,5.471469858090333,0.15402793372900386
610,0.0891666666666666,0,32,0,14964,590646,410,107546,5.471173441031532,0.15403499323968192
611,0.0892857142857142,0,4,0,14968,590642,410,107546,5.471136388899181,0.15403587572401703
612,0.0892857142857143,0,1,0,14969,590641,410,107546,5.471127125866094,0.15403609634668075
613,0.0893333333333333,0,15,0,14984,590626,410,107546,5.470988180369781,0.15403940576247688
614,0.0894444444444444,0,1,0,14985,590625,410,107546,5.4709789173366925,0.15403962639525273
615,0.0894523809523809,0,2,0,14987,590623,410,107546,5.470960391270518,0.1540400676627006
616,0.0895,0,5,0,14992,590618,410,107546,5.47091407610508,0.15404117084238086
617,0.0895238095238095,2,2,2,14994,590616,412,107544,5.470895550038905,0.15403918872464764
618,0.0896111111111111,0,1,0,14995,590615,412,107544,5.4708862870058175,0.1540394093609049
619,0.0896190476190476,0,1,0,14996,590614,412,107544,5.470877023972729,0.1540396299977942
620,0.0896666666666666,0,5,0,15001,590609,412,107544,5.470830708807292,0.1540407331917216
621,0.0896904761904761,0,3,0,15004,590606,412,107544,5.470802919708029,0.1540413951156628
622,0.0897142857142857,0,1,0,15005,590605,412,107544,5.4707936566749416,0.1540416157582407
623,0.0897619047619047,0,1,0,15006,590604,412,107544,5.470784393641854,0.1540418364014507
624,0.0897777777777777,0,2,0,15008,590602,412,107544,5.470765867575679,0.1540422776897669
625,0.0898333333333333,0,2,0,15010,590600,412,107544,5.470747341509504,0.15404271898061145
626,0.0899523809523809,0,2,0,15012,590598,412,107544,5.470728815443329,0.15404316027398438
627,0.0899999999999999,0,7,0,15019,590591,412,107544,5.470663974211716,0.15404470482070087
628,0.09,35,1526,35,16545,589065,447,107509,5.4565285857201085,0.15433966814724637
629,0.0901190476190476,0,1,0,16546,589064,447,107509,5.45651932268702,0.15433988971722992
630,0.0901666666666666,0,5,0,16551,589059,447,107509,5.456473007521583,0.1543409975766903
631,0.0902380952380952,0,1,0,16552,589058,447,107509,5.456463744488495,0.1543412191504909
632,0.0903333333333333,1,6,1,16558,589052,448,107508,5.45640816628997,0.1543413345584013
633,0.0903571428571428,0,1,0,16559,589051,448,107508,5.456398903256883,0.15434155613523046
634,0.0904166666666666,0,1,0,16560,589050,448,107508,5.456389640223795,0.15434177771269586
635,0.0905,0,3,0,16563,589047,448,107508,5.456361851124532,0.15434244244890927
636,0.0905833333333333,1,0,1,16563,589047,449,107507,5.456361851124532,0.15434122839004585
637,0.0906666666666666,2,14,2,16577,589033,451,107505,5.456232168661306,0.1543419023800568
638,0.0907142857142857,0,5,0,16582,589028,451,107505,5.456185853495868,0.15434301030963357
639,0.0907619047619047,0,1,0,16583,589027,451,107505,5.456176590462781,0.1543432318974577
640,0.0908333333333333,2,31,2,16614,588996,453,107503,5.455889436437067,0.15434767314813086
641,0.0909523809523809,0,2,0,16616,588994,453,107503,5.455870910370892,0.15434811635943874
642,0.091,1,14,1,16630,588980,454,107502,5.455741227907666,0.15435000473809804
643,0.0911111111111111,0,1,0,16631,588979,454,107502,5.455731964874579,0.1543502263521905
644,0.09125,0,4,0,16635,588975,454,107502,5.455694912742229,0.15435111281492425
645,0.0913333333333333,0,2,0,16637,588973,454,107502,5.455676386676053,0.15435155605010947
646,0.0913690476190476,0,1,0,16638,588972,454,107502,5.455667123642965,0.15435177766865668
647,0.0914285714285714,0,4,0,16642,588968,454,107502,5.455630071510615,0.1543526641492096
648,0.0915,0,9,0,16651,588959,454,107502,5.455546704212828,0.15435465876768406
649,0.0915079365079365,0,1,0,16652,588958,454,107502,5.4555374411797395,0.15435488039514114
650,0.091538961038961,0,2,0,16654,588956,454,107502,5.455518915113565,0.15435532365196467
651,0.0916527777777777,1,2,1,16656,588954,455,107501,5.45550038904739,0.1543545526990258
652,0.0916666666666666,6,107,6,16763,588847,461,107495,5.454509244507022,0.1543709843726215
653,0.0918333333333333,0,3,0,16766,588844,461,107495,5.454481455407759,0.15437164944086143
654,0.091845238095238,0,3,0,16769,588841,461,107495,5.454453666308496,0.1543723145148319
655,0.092,0,25,0,16794,588816,461,107495,5.4542220904813075,0.15437785702078524
656,0.0921428571428571,0,3,0,16797,588813,461,107495,5.454194301382045,0.15437852214824474
657,0.09225,0,1,0,16798,588812,461,107495,5.454185038348957,0.15437874385867154
658,0.0923571428571428,0,1,0,16799,588811,461,107495,5.4541757753158695,0.15437896556973515
659,0.0923809523809523,0,2,0,16801,588809,461,107495,5.454157249249694,0.15437940899377284
660,0.0924999999999999,0,1,0,16802,588808,461,107495,5.454147986216607,0.15437963070674693
661,0.0925,3,116,3,16918,588692,464,107492,5.45307347437845,0.15440170989278695
662,0.0926666666666666,0,13,0,16931,588679,464,107492,5.4529530549483125,0.15440459312439042
663,0.0927380952380952,0,3,0,16934,588676,464,107492,5.45292526584905,0.15440525850082165
664,0.0927777777777777,0,2,0,16936,588674,464,107492,5.4529067397828745,0.15440570208829504
665,0.0928095238095238,0,1,0,16937,588673,464,107492,5.452897476749787,0.15440592388298752
666,0.0928333333333333,0,2,0,16939,588671,464,107492,5.452878950683612,0.15440636747428405
667,0.0928571428571428,0,4,0,16943,588667,464,107492,5.452841898551261,0.15440725466452349
668,0.0929999999999999,0,1,0,16944,588666,464,107492,5.452832635518174,0.15440747646367636
669,0.093,0,10,0,16954,588656,464,107492,5.452740005187299,0.15440969449025208
670,0.093047619047619,0,1,0,16955,588655,464,107492,5.452730742154211,0.1544099162964144
671,0.0930757575757575,0,1,0,16956,588654,464,107492,5.452721479121124,0.15441013810321397
672,0.0930952380952381,0,1,0,16957,588653,464,107492,5.4527122160880355,0.1544103599106508
673,0.0931666666666666,0,2,0,16959,588651,464,107492,5.452693690021861,0.15441080352743616
674,0.0931904761904762,0,2,0,16961,588649,464,107492,5.452675163955686,0.15441124714677054
675,0.0933333333333333,7,228,7,17189,588421,471,107485,5.450563192411724,0.15445333134072706
676,0.0934285714285714,0,2,0,17191,588419,471,107485,5.450544666345548,0.1544537752333655
677,0.0935,0,4,0,17195,588415,471,107485,5.450507614213198,0.15445466302629687
678,0.0935714285714285,0,1,0,17196,588414,471,107485,5.45049835118011,0.15445488497612442
679,0.0936666666666666,0,3,0,17199,588411,471,107485,5.450470562080848,0.1544555508294343
680,0.0936785714285714,1,0,1,17199,588411,472,107484,5.450470562080848,0.1544543357834156
681,0.09375,0,5,0,17204,588406,472,107484,5.45042424691541,0.15445544554455445
682,0.0938571428571428,0,2,0,17206,588404,472,107484,5.4504057208492345,0.15445588945347527
683,0.0939285714285714,0,3,0,17209,588401,472,107484,5.450377931749972,0.1544565553216408
684,0.0939999999999999,0,1,0,17210,588400,472,107484,5.450368668716885,0.15445677727897178
685,0.094,2,35,2,17245,588365,474,107482,5.450044462558821,0.15446211595365072
686,0.0941666666666666,1,31,1,17276,588334,475,107481,5.449757308533106,0.1544677823846856
687,0.0942857142857142,2,10,2,17286,588324,477,107479,5.449664678202231,0.15446757199954586
688,0.0943333333333333,0,7,0,17293,588317,477,107479,5.449599836970617,0.15446912600819782
689,0.0944444444444444,0,1,0,17294,588316,477,107479,5.44959057393753,0.15446934801198628
690,0.0945833333333333,0,2,0,17296,588314,477,107479,5.449572047871355,0.15446979202147765
691,0.0946666666666666,1,5,1,17301,588309,478,107478,5.449525732705918,0.1544696868438186
692,0.0947222222222222,0,2,0,17303,588307,478,107478,5.449507206639742,0.15447013085938904
693,0.0948333333333333,0,9,0,17312,588298,478,107478,5.4494238393419545,0.15447212896104492
694,0.095,12,491,12,17803,587807,490,107466,5.444875690095965,0.15456662347020522
695,0.0951666666666666,0,6,0,17809,587801,490,107466,5.44482011189744,0.15456795734588294
696,0.0953030303030303,0,1,0,17810,587800,490,107466,5.4448108488643525,0.15456817966073416
697,0.0953333333333333,0,15,0,17825,587785,490,107466,5.444671903368039,0.15457151446024528
698,0.0953571428571428,1,3,1,17828,587782,491,107465,5.444644114268776,0.1545709654266757
699,0.0953888888888889,0,2,0,17830,587780,491,107465,5.444625588202601,0.15457141007846156
700,0.0955,0,9,0,17839,587771,491,107465,5.444542220904813,0.15457341104315656
701,0.0955555555555555,0,1,0,17840,587770,491,107465,5.444532957871726,0.15457363337576502
702,0.0956666666666666,0,5,0,17845,587765,491,107465,5.444486642706288,0.15457474504840124
703,0.0957142857142857,0,6,0,17851,587759,491,107465,5.4444310645077625,0.1545760790766717
704,0.0958015873015872,0,1,0,17852,587758,491,107465,5.444421801474675,0.15457630141695541
705,0.0958333333333333,2,35,2,17887,587723,493,107463,5.44409759531661,0.15458165152923103
706,0.0958928571428571,0,1,0,17888,587722,493,107463,5.444088332283523,0.15458187388968403
707,0.096,1,41,1,17929,587681,494,107462,5.443708547926933,0.1545897750534782
708,0.096047619047619,0,1,0,17930,587680,494,107462,5.443699284893846,0.1545899974393721
709,0.0961904761904761,0,5,0,17935,587675,494,107462,5.443652969728408,0.15459110937843906
710,0.09625,0,1,0,17936,587674,494,107462,5.443643706695321,0.154591331768172
711,0.0963333333333333,1,4,1,17940,587670,495,107461,5.44360665456297,0.15459100514866983
712,0.0963636363636363,0,3,0,17943,587667,495,107461,5.443578865463707,0.15459167232509696
713,0.0964285714285714,1,1,1,17944,587666,496,107460,5.44356960243062,0.15459067852446895
714,0.0964444444444444,1,1,1,17945,587665,497,107459,5.443560339397532,0.15458968471812223
715,0.0964761904761904,0,1,0,17946,587664,497,107459,5.443551076364445,0.1545899071099647
716,0.0964999999999999,0,2,0,17948,587662,497,107459,5.443532550298269,0.15459035189556927
717,0.0965,0,3,0,17951,587659,497,107459,5.443504761199007,0.15459101907877512
718,0.0966666666666666,5,231,5,18182,587428,502,107454,5.441365000555782,0.15463632674324562
719,0.09675,0,1,0,18183,587427,502,107454,5.441355737522694,0.15463654927966083
720,0.0967857142857143,0,1,0,18184,587426,502,107454,5.441346474489607,0.15463677181671656
721,0.0968333333333333,0,2,0,18186,587424,502,107454,5.441327948423432,0.1546372168927495
722,0.0969999999999999,0,13,0,18199,587411,502,107454,5.441207528993294,0.15464010994941463
723,0.097,0,1,0,18200,587410,502,107454,5.441198265960206,0.15464033249671877
724,0.0970833333333333,0,1,0,18201,587409,502,107454,5.441189002927119,0.15464055504466348
725,0.0971428571428571,0,1,0,18202,587408,502,107454,5.4411797398940305,0.15464077759324873
726,0.0971666666666666,0,1,0,18203,587407,502,107454,5.441170476860943,0.15464100014247453
727,0.0972142857142857,0,1,0,18204,587406,502,107454,5.441161213827856,0.1546412226923409
728,0.0972619047619047,0,2,0,18206,587404,502,107454,5.441142687761681,0.15464166779399532
729,0.0973333333333333,1,17,1,18223,587387,503,107453,5.440985216199192,0.1546442346439468
730,0.0973571428571428,0,3,0,18226,587384,503,107453,5.44095742709993,0.15464490232961112
731,0.0973809523809523,0,1,0,18227,587383,503,107453,5.4409481640668425,0.15464512489278046
732,0.0974404761904761,0,1,0,18228,587382,503,107453,5.440938901033754,0.15464534745659042
733,0.0975,8,107,8,18335,587275,511,107445,5.439947756493386,0.15465943113772454
734,0.0975833333333333,0,1,0,18336,587274,511,107445,5.439938493460299,0.15465965375928972
735,0.0976666666666666,2,15,2,18351,587259,513,107443,5.439799547963985,0.15466055949169571
736,0.0977738095238095,1,1,1,18352,587258,514,107442,5.439790284930898,0.15465956527997696
737,0.0977777777777777,0,3,0,18355,587255,514,107442,5.439762495831635,0.15466023316640204
738,0.0978095238095238,0,2,0,18357,587253,514,107442,5.43974396976546,0.15466067842722345
739,0.0978333333333333,0,1,0,18358,587252,514,107442,5.439734706732373,0.1546609010585956
740,0.0978571428571428,0,4,0,18362,587248,514,107442,5.439697654600022,0.1546617915904936
741,0.0979166666666666,1,5,1,18367,587243,515,107441,5.439651339434585,0.1546616879041406
742,0.0979761904761904,0,3,0,18370,587240,515,107441,5.439623550335321,0.15466235581511514
743,0.0979761904761905,0,3,0,18373,587237,515,107441,5.439595761236059,0.1546630237318585
744,0.098,1,25,1,18398,587212,516,107440,5.43936418540887,0.1546673730155531
745,0.0980952380952381,0,2,0,18400,587210,516,107440,5.439345659342695,0.15466781832577556
746,0.0981666666666666,0,2,0,18402,587208,516,107440,5.43932713327652,0.15466826363856226
747,0.0982142857142857,0,2,0,18404,587206,516,107440,5.439308607210345,0.15466870895391321
748,0.0983333333333333,4,88,4,18492,587118,520,107436,5.43849346029864,0.15468343714095664
749,0.0984999999999999,1,6,1,18498,587112,521,107435,5.438437882100115,0.15468355633240083
750,0.0985714285714285,0,6,0,18504,587106,521,107435,5.43838230390159,0.15468489261253116
751,0.0986666666666666,1,18,1,18522,587088,522,107434,5.4382155693060135,0.15468768447939735
752,0.0988333333333333,0,2,0,18524,587086,522,107434,5.438197043239838,0.15468812993146347
753,0.0988571428571428,2,1,2,18525,587085,524,107432,5.438187780206751,0.15468591841524398
754,0.0988888888888888,0,1,0,18526,587084,524,107432,5.438178517173664,0.15468614114001694
755,0.0989126984126984,0,1,0,18527,587083,524,107432,5.4381692541405755,0.15468636386543128
756,0.0989285714285714,0,2,0,18529,587081,524,107432,5.438150728074401,0.1546868093181841
757,0.0989880952380952,0,1,0,18530,587080,524,107432,5.438141465041313,0.15468703204552262
758,0.099,1,16,1,18546,587064,525,107431,5.437993256511913,0.15468937861323695
759,0.099047619047619,0,1,0,18547,587063,525,107431,5.4379839934788246,0.15468960135004767
760,0.0991666666666666,1,39,1,18586,587024,526,107430,5.43762273518841,0.15469707136829797
761,0.09925,0,2,0,18588,587022,526,107430,5.437604209122235,0.1546975168910162
762,0.0992857142857142,0,9,0,18597,587013,526,107430,5.437520841824447,0.1546995217750053
763,0.0993055555555555,0,1,0,18598,587012,526,107430,5.4375115787913595,0.1546997445431008
764,0.0993333333333333,0,15,0,18613,586997,526,107430,5.4373726332950465,0.15470308614152387
765,0.0994999999999999,0,2,0,18615,586995,526,107430,5.437354107228871,0.15470353169888756
766,0.0995238095238095,0,1,0,18616,586994,526,107430,5.437344844195784,0.15470375447853185
767,0.0995833333333333,0,2,0,18618,586992,526,107430,5.4373263181296085,0.15470420003974528
768,0.0996666666666666,0,5,0,18623,586987,526,107430,5.437280002964171,0.15470531395400747
769,0.0997058823529411,0,1,0,18624,586986,526,107430,5.437270739931083,0.15470553673878482
770,0.0997142857142857,0,1,0,18625,586985,526,107430,5.437261476897995,0.15470575952420382
771,0.0997499999999999,0,2,0,18627,586983,526,107430,5.437242950831821,0.15470620509696678
772,0.0999523809523809,0,1,0,18628,586982,526,107430,5.437233687798733,0.15470642788431074
773,0.0999999999999999,0,5,0,18633,586977,526,107430,5.437187372633295,0.15470754183065552
774,0.1,51,1738,51,20371,585239,577,107379,5.421088221127126,0.1550335105353889
775,0.1000238095238095,0,1,0,20372,585238,577,107379,5.421078958094038,0.1550337343726764
776,0.1001666666666666,1,1,1,20373,585237,578,107378,5.421069695060951,0.1550327382456343
777,0.1002142857142857,1,0,1,20373,585237,579,107377,5.421069695060951,0.1550315182771356
778,0.1002380952380952,0,1,0,20374,585236,579,107377,5.421060432027863,0.15503174211283935
779,0.1002499999999999,0,1,0,20375,585235,579,107377,5.421051168994776,0.15503196594918944
780,0.1002777777777777,0,1,0,20376,585234,579,107377,5.421041905961688,0.1550321897861859
781,0.1003333333333333,2,11,2,20387,585223,581,107375,5.420940012597725,0.1550322120479701
782,0.1003571428571428,0,3,0,20390,585220,581,107375,5.420912223498462,0.15503288357553838
783,0.1005,1,2,1,20392,585218,582,107374,5.420893697432287,0.1550321112574214
784,0.1005555555555555,0,1,0,20393,585217,582,107374,5.420884434399199,0.1550323351010914
785,0.1005952380952381,0,1,0,20394,585216,582,107374,5.420875171366112,0.15503255894540782
786,0.1006666666666666,0,9,0,20403,585207,582,107374,5.420791804068324,0.15503457357334377
787,0.1007142857142857,1,9,1,20412,585198,583,107373,5.4207084367705365,0.1550353682149556
788,0.1008333333333333,1,40,1,20452,585158,584,107372,5.420337915447034,0.15504310282587036
789,0.1009523809523809,0,1,0,20453,585157,584,107372,5.4203286524139465,0.15504332670545204
790,0.1009999999999999,1,11,1,20464,585146,585,107371,5.420226759049983,0.15504456930299185
791,0.1010238095238095,0,1,0,20465,585145,585,107371,5.420217496016896,0.15504479318889383
792,0.1011111111111111,0,1,0,20466,585144,585,107371,5.420208232983808,0.1550450170754424
793,0.1011666666666666,0,3,0,20469,585141,585,107371,5.420180443884545,0.1550456887389677
794,0.1011904761904762,0,1,0,20470,585140,585,107371,5.420171180851458,0.15504591262810266
795,0.1012222222222222,0,1,0,20471,585139,585,107371,5.420161917818371,0.1550461365178842
796,0.1012380952380952,0,1,0,20472,585138,585,107371,5.420152654785283,0.15504636040831238
797,0.10125,0,1,0,20473,585137,585,107371,5.4201433917521955,0.15504658429938714
798,0.1012619047619047,0,1,0,20474,585136,585,107371,5.420134128719107,0.15504680819110853
799,0.1013333333333333,0,7,0,20481,585129,585,107371,5.420069287487495,0.15504837545126354
800,0.1014285714285714,0,6,0,20487,585123,585,107371,5.42001370928897,0.15504971884232932
801,0.1014523809523809,0,1,0,20488,585122,585,107371,5.420004446255882,0.15504994274310355
802,0.1014545454545454,0,1,0,20489,585121,585,107371,5.419995183222794,0.15505016664452442
803,0.1015,2,12,2,20501,585109,587,107369,5.419884026825744,0.15505041315391968
804,0.1015873015873015,0,1,0,20502,585108,587,107369,5.419874763792656,0.15505063706086988
805,0.1015952380952381,0,2,0,20504,585106,587,107369,5.419856237726481,0.15505108487671035
806,0.1016666666666666,9,112,9,20616,584994,596,107360,5.418818778020675,0.1550651834177314
807,0.10175,0,1,0,20617,584993,596,107360,5.418809514987587,0.15506540738611663
808,0.1019047619047619,0,1,0,20618,584992,596,107360,5.4188002519545,0.15506563135514884
809,0.1019924242424242,0,8,0,20626,584984,596,107360,5.418726147689799,0.15506742313069805
810,0.102,2,36,2,20662,584948,598,107358,5.418392678498647,0.1550730457341118
811,0.1020833333333333,0,2,0,20664,584946,598,107358,5.418374152432473,0.15507349372529985
812,0.1021428571428571,0,4,0,20668,584942,598,107358,5.418337100300122,0.1550743897154413
813,0.1021666666666666,0,1,0,20669,584941,598,107358,5.418327837267035,0.1550746137145944
814,0.1022222222222222,0,1,0,20670,584940,598,107358,5.418318574233947,0.15507483771439468
815,0.1022499999999999,0,1,0,20671,584939,598,107358,5.41830931120086,0.15507506171484203
816,0.1022619047619047,0,1,0,20672,584938,598,107358,5.418300048167772,0.15507528571593654
817,0.1023015873015873,1,0,1,20672,584938,599,107357,5.418300048167772,0.15507406524675174
818,0.1023333333333333,0,5,0,20677,584933,599,107357,5.418253733002334,0.1550751852547343
819,0.1023809523809523,0,2,0,20679,584931,599,107357,5.418235206936159,0.15507563326245724
820,0.1024999999999999,0,1,0,20680,584930,599,107357,5.418225943903072,0.15507585726728942
821,0.1025,7,119,7,20799,584811,606,107350,5.417123642965652,0.15509397380089315
822,0.1026666666666666,1,7,1,20806,584804,607,107349,5.41705880173404,0.15509432163120004
823,0.1027142857142857,0,1,0,20807,584803,607,107349,5.417049538700952,0.15509454570672337
824,0.1028333333333333,0,3,0,20810,584800,607,107349,5.417021749601689,0.15509521793717826
825,0.1028571428571428,0,8,0,20818,584792,607,107349,5.41694764533699,0.15509701058021413
826,0.1029166666666666,0,1,0,20819,584791,607,107349,5.4169383823039015,0.1550972346635074
827,0.103,0,9,0,20828,584782,607,107349,5.416855015006114,0.15509925144228476
828,0.1030238095238095,0,1,0,20829,584781,607,107349,5.416845751973026,0.15509947553205322
829,0.1031428571428571,0,5,0,20834,584776,607,107349,5.4167994368075885,0.15510059599060863
830,0.1031666666666666,0,1,0,20835,584775,607,107349,5.4167901737745,0.15510082008426235
831,0.10325,0,2,0,20837,584773,607,107349,5.416771647708326,0.15510126827351248
832,0.1032738095238095,0,3,0,20840,584770,607,107349,5.416743858609063,0.15510194056224436
833,0.1033333333333333,5,231,5,21071,584539,612,107344,5.414604097965838,0.15514761888932088
834,0.1034880952380952,0,1,0,21072,584538,612,107344,5.414594834932751,0.15514784312931973
835,0.1034999999999999,0,1,0,21073,584537,612,107344,5.4145855718996625,0.1551480673699668
836,0.1035,0,6,0,21079,584531,612,107344,5.414529993701137,0.1551494128274616
837,0.1035714285714285,0,1,0,21080,584530,612,107344,5.41452073066805,0.15514963707264617
838,0.1036666666666666,0,7,0,21087,584523,612,107344,5.414455889436437,0.15515120680708863
839,0.10375,0,2,0,21089,584521,612,107344,5.414437363370262,0.1551516553084778
840,0.1037857142857143,1,0,1,21089,584521,613,107343,5.414437363370262,0.15515043418937827
841,0.1038333333333333,1,2,1,21091,584519,614,107342,5.414418837304087,0.15514966156496754
842,0.1039285714285714,0,1,0,21092,584518,614,107342,5.414409574271,0.1551498858150493
843,0.1039999999999999,0,1,0,21093,584517,614,107342,5.4144003112379115,0.1551501100657793
844,0.104,1,47,1,21140,584470,615,107341,5.413964948682796,0.1551594293817242
845,0.1040833333333333,0,1,0,21141,584469,615,107341,5.413955685649709,0.15515965366213266
846,0.1041190476190476,0,1,0,21142,584468,615,107341,5.413946422616622,0.15515987794318953
847,0.1041666666666666,2,34,2,21176,584434,617,107339,5.413631479491645,0.155165061371288
848,0.1041904761904761,0,3,0,21179,584431,617,107339,5.413603690392382,0.15516573427584313
849,0.1041904761904762,0,1,0,21180,584430,617,107339,5.413594427359294,0.15516595857865847
850,0.1042142857142856,0,1,0,21181,584429,617,107339,5.413585164326207,0.15516618288212233
851,0.1042857142857142,1,4,1,21185,584425,618,107338,5.4135481121938565,0.15516585882737297
852,0.1043333333333333,1,3,1,21188,584422,619,107337,5.413520323094594,0.15516531046216964
853,0.1044444444444444,0,1,0,21189,584421,619,107337,5.413511060061507,0.15516553476793907
854,0.1045,0,6,0,21195,584415,619,107337,5.413455481862981,0.1551668806161746
855,0.1045238095238095,0,4,0,21199,584411,619,107337,5.413418429730631,0.1551677778613021
856,0.1046666666666666,0,4,0,21203,584407,619,107337,5.413381377598281,0.1551686751168062
857,0.1047142857142857,0,2,0,21205,584405,619,107337,5.4133628515321055,0.15516912374844957
858,0.1047619047619047,0,1,0,21206,584404,619,107337,5.413353588499018,0.15516934806524407
859,0.1048333333333333,0,4,0,21210,584400,619,107337,5.4133165363666675,0.15517024533890772
860,0.1048571428571428,0,1,0,21211,584399,619,107337,5.41330727333358,0.15517046965894504
861,0.1048809523809524,0,1,0,21212,584398,619,107337,5.413298010300493,0.15517069397963093
862,0.105,23,498,23,21710,583900,642,107314,5.408685019822891,0.1552543785282127
863,0.1051666666666666,0,1,0,21711,583899,642,107314,5.408675756789803,0.15525460313969788
864,0.1052380952380952,1,2,1,21713,583897,643,107313,5.4086572307236285,0.15525383023972453
865,0.10525,0,1,0,21714,583896,643,107313,5.40864796769054,0.15525405485171634
866,0.1053333333333333,1,5,1,21719,583891,644,107312,5.408601652525102,0.15525395578433543
867,0.1053888888888888,0,1,0,21720,583890,644,107312,5.408592389492015,0.15525418039878358
868,0.1054761904761904,0,4,0,21724,583886,644,107312,5.408555337359665,0.1552550788630754
869,0.1055,0,1,0,21725,583885,644,107312,5.408546074326577,0.1552553034807732
870,0.1056666666666666,0,3,0,21728,583882,644,107312,5.408518285227315,0.15525597733776625
871,0.1057142857142857,0,5,0,21733,583877,644,107312,5.408471970061877,0.1552571004457536
872,0.1057936507936507,0,1,0,21734,583876,644,107312,5.408462707028789,0.15525732506930098
873,0.1058333333333333,1,35,1,21769,583841,645,107311,5.4081385008707255,0.1552639650901683
874,0.1058412698412698,1,0,1,21769,583841,646,107310,5.4081385008707255,0.15526274287384378
875,0.1058809523809523,0,1,0,21770,583840,646,107310,5.408129237837637,0.15526296751790494
876,0.106,2,42,2,21812,583798,648,107308,5.40774019044796,0.15526995858811818
877,0.1060714285714285,0,2,0,21814,583796,648,107308,5.407721664381786,0.1552704079270269
878,0.106111111111111,0,1,0,21815,583795,648,107308,5.4077124013486975,0.15527063259745652
879,0.1061111111111111,1,1,1,21816,583794,649,107307,5.40770313831561,0.15526963497375926
880,0.1061666666666666,0,4,0,21820,583790,649,107307,5.4076660861832595,0.15527053365880622
881,0.1061904761904761,0,2,0,21822,583788,649,107307,5.407647560117085,0.15527098300523082
882,0.10625,0,4,0,21826,583784,649,107307,5.407610507984734,0.15527188170588244
883,0.1063333333333333,0,8,0,21834,583776,649,107307,5.407536403720034,0.15527367913839582
884,0.1064285714285714,0,2,0,21836,583774,649,107307,5.407517877653859,0.1552741285030264
885,0.1064444444444444,0,7,0,21843,583767,649,107307,5.407453036422246,0.1552757012997161
886,0.1065,0,7,0,21850,583760,649,107307,5.4073881951906335,0.1552772741282683
887,0.106547619047619,0,1,0,21851,583759,649,107307,5.407378932157545,0.15527749882066258
888,0.106595238095238,0,2,0,21853,583757,649,107307,5.407360406091371,0.15527794820740193
889,0.1066111111111111,0,2,0,21855,583755,649,107307,5.407341880025196,0.15527839759674242
890,0.1066190476190476,0,1,0,21856,583754,649,107307,5.407332616992108,0.1552786222923881
891,0.1066666666666666,5,279,5,22135,583475,654,107302,5.4047482307606804,0.1553352239579488
892,0.1067857142857142,0,1,0,22136,583474,654,107302,5.404738967727592,0.15533544882856382
893,0.1068333333333333,0,1,0,22137,583473,654,107302,5.404729704694505,0.1553356736998299
894,0.1068571428571428,0,1,0,22138,583472,654,107302,5.404720441661418,0.15533589857174707
895,0.1069166666666666,1,0,1,22138,583472,655,107301,5.404720441661418,0.15533467579074456
896,0.107,0,21,0,22159,583451,655,107301,5.404525917966579,0.1553393982210692
897,0.1070833333333333,0,1,0,22160,583450,655,107301,5.4045166549334915,0.15533962310586594
898,0.1071190476190476,0,1,0,22161,583449,655,107301,5.404507391900404,0.15533984799131378
899,0.1071428571428571,0,3,0,22164,583446,655,107301,5.404479602801141,0.15534052265156417
900,0.1073333333333333,0,20,0,22184,583426,655,107301,5.40429434213939,0.15534502053633345
901,0.1073809523809523,0,2,0,22186,583424,655,107301,5.404275816073215,0.15534547033913643
902,0.1074285714285714,0,2,0,22188,583422,655,107301,5.40425729000704,0.1553459201445442
903,0.1074999999999999,0,3,0,22191,583419,655,107301,5.404229500907777,0.15534659485753996
904,0.1075,5,123,5,22314,583296,660,107296,5.403090147838008,0.15536814790788192
905,0.107595238095238,0,1,0,22315,583295,660,107296,5.40308088480492,0.15536837288641178
906,0.1076190476190476,0,3,0,22318,583292,660,107296,5.4030530957056575,0.15536904782591068
907,0.1076666666666666,0,5,0,22323,583287,660,107296,5.40300678054022,0.1553701727381068
908,0.1077222222222222,0,1,0,22324,583286,660,107296,5.402997517507132,0.15537039772250072
909,0.10775,0,1,0,22325,583285,660,107296,5.402988254474045,0.15537062270754626
910,0.1078333333333333,0,8,0,22333,583277,660,107296,5.4029141502093445,0.15537242261136766
911,0.1078571428571428,1,6,1,22339,583271,661,107295,5.402858572010819,0.1553725494739098
912,0.1079010989010989,1,5,1,22344,583266,662,107294,5.402812256845381,0.1553724513438369
913,0.108,2,30,2,22374,583236,664,107292,5.4025343658527545,0.1553767551786459
914,0.1080714285714285,0,1,0,22375,583235,664,107292,5.402525102819667,0.15537698019049218
915,0.1081666666666666,0,3,0,22378,583232,664,107292,5.402497313720405,0.15537765522994132
916,0.1082142857142857,0,1,0,22379,583231,664,107292,5.402488050687317,0.15537788024439447
917,0.1083333333333333,11,136,11,22515,583095,675,107281,5.40122827818741,0.1553950311134802
918,0.1084126984126984,0,2,0,22517,583093,675,107281,5.401209752121234,0.1553954812898516
919,0.1085,1,5,1,22522,583088,676,107280,5.401163436955796,0.15539538333178826
920,0.108595238095238,0,4,0,22526,583084,676,107280,5.4011263848234465,0.15539628369961353
921,0.1086071428571428,0,4,0,22530,583080,676,107280,5.401089332691097,0.15539718407787242
922,0.1086666666666666,1,5,1,22535,583075,677,107279,5.401043017525659,0.15539708613262182
923,0.1086904761904761,0,2,0,22537,583073,677,107279,5.401024491459483,0.15539753632929287
924,0.1087142857142857,0,2,0,22539,583071,677,107279,5.401005965393308,0.15539798652857245
925,0.10875,0,1,0,22540,583070,677,107279,5.400996702360221,0.15539821162919046
926,0.1088095238095238,0,2,0,22542,583068,677,107279,5.400978176294045,0.15539866183238285
927,0.1088333333333333,0,3,0,22545,583065,677,107279,5.400950387194783,0.1553993371420625
928,0.1088888888888888,0,1,0,22546,583064,677,107279,5.400941124161696,0.15539956224659335
929,0.1089285714285714,0,1,0,22547,583063,677,107279,5.400931861128608,0.15539978735177637
930,0.1089696969696969,0,1,0,22548,583062,677,107279,5.40092259809552,0.15540001245761154
931,0.109,0,12,0,22560,583050,677,107279,5.40081144169847,0.1554027137785027
932,0.109047619047619,0,3,0,22563,583047,677,107279,5.400783652599207,0.15540338912339968
933,0.1091666666666666,3,45,3,22608,583002,680,107276,5.400366816110267,0.15540984936503843
934,0.1092142857142857,1,0,1,22608,583002,681,107275,5.400366816110267,0.15540862581253612
935,0.1092857142857142,0,7,0,22615,582995,681,107275,5.400301974878654,0.15541020180509077
936,0.1093333333333333,1,13,1,22628,582982,682,107274,5.400181555448516,0.15541190514823486
937,0.1094285714285714,0,1,0,22629,582981,682,107274,5.400172292415428,0.15541213029967185
938,0.1094523809523809,0,1,0,22630,582980,682,107274,5.400163029382341,0.15541235545176124
939,0.1094761904761904,0,2,0,22632,582978,682,107274,5.400144503316166,0.15541280575789712
940,0.1094999999999999,0,2,0,22634,582976,682,107274,5.40012597724999,0.15541325606664252
941,0.1095119047619047,0,2,0,22636,582974,682,107274,5.400107451183816,0.15541370637799748
942,0.1095238095238095,1,2,1,22638,582972,683,107273,5.4000889251176405,0.15541293308897566
943,0.1095833333333333,1,4,1,22642,582968,684,107272,5.400051872985291,0.15541261010662957
944,0.1096190476190476,0,2,0,22644,582966,684,107272,5.400033346919115,0.15541306042263683
945,0.1096428571428571,1,0,1,22644,582966,685,107271,5.400033346919115,0.1554118368038804
946,0.1096666666666666,0,6,0,22650,582960,685,107271,5.39997776872059,0.15541318775888072
947,0.1097170329670329,0,1,0,22651,582959,685,107271,5.399968505687502,0.1554134129203309
948,0.1098333333333333,0,3,0,22654,582956,685,107271,5.399940716588239,0.15541408840859602
949,0.1098571428571428,0,1,0,22655,582955,685,107271,5.399931453555152,0.15541431357265592
950,0.1099999999999999,0,5,0,22660,582950,685,107271,5.399885138389714,0.15541543940274202
951,0.11,50,1843,50,24503,581107,735,107221,5.3828133684093515,0.15577021420020687
952,0.1101666666666666,0,5,0,24508,581102,735,107221,5.3827670532439145,0.15577134571995996
953,0.11025,0,1,0,24509,581101,735,107221,5.382757790210826,0.15577157202588324
954,0.1102857142857142,0,3,0,24512,581098,735,107221,5.382730001111564,0.15577225094759842
955,0.1103174603174603,0,1,0,24513,581097,735,107221,5.3827207380784765,0.15577247725615195
956,0.1103333333333333,0,10,0,24523,581087,735,107221,5.382628107747601,0.1557747403778541
957,0.1103571428571428,0,2,0,24525,581085,735,107221,5.382609581681426,0.15577519301008563
958,0.1103968253968254,0,3,0,24528,581082,735,107221,5.3825817925821635,0.15577587196336498
959,0.1104166666666666,0,2,0,24530,581080,735,107221,5.382563266515988,0.15577632460217258
960,0.1104761904761904,0,1,0,24531,581079,735,107221,5.3825540034829,0.15577655092256285
961,0.1105,0,7,0,24538,581072,735,107221,5.382489162251288,0.1557781351837081
962,0.1105714285714285,1,1,1,24539,581071,736,107220,5.3824798992182,0.1557771349618112
963,0.110595238095238,0,1,0,24540,581070,736,107220,5.382470636185112,0.15577736128666697
964,0.1106666666666666,0,14,0,24554,581056,736,107220,5.3823409537218865,0.15578052990370142
965,0.1107142857142857,1,2,1,24556,581054,737,107219,5.382322427655712,0.15577975599798335
966,0.1108333333333333,3,33,3,24589,581021,740,107216,5.3820167475638225,0.15578354549377613
967,0.1109523809523809,0,2,0,24591,581019,740,107216,5.381998221497647,0.15578399819828984
968,0.111,0,19,0,24610,581000,740,107216,5.3818222238689835,0.15578829902239993
969,0.1110833333333333,0,1,0,24611,580999,740,107216,5.381812960835896,0.15578852538814178
970,0.1111111111111111,1,1,1,24612,580998,741,107215,5.381803697802809,0.15578752508307747
971,0.1111428571428571,0,1,0,24613,580997,741,107215,5.381794434769721,0.1557877514486815
972,0.1111666666666666,0,3,0,24616,580994,741,107215,5.381766645670458,0.15578843054944064
973,0.1111904761904761,0,1,0,24617,580993,741,107215,5.381757382637371,0.15578865691767604
974,0.11125,0,7,0,24624,580986,741,107215,5.381692541405758,0.1557902415137438
975,0.1113333333333333,2,7,2,24631,580979,743,107213,5.381627700174145,0.15578937273319074
976,0.1114285714285714,0,7,0,24638,580972,743,107213,5.381562858942532,0.1557909573733807
977,0.1115,1,8,1,24646,580964,744,107212,5.381488754677831,0.15579154169863524
978,0.1116666666666666,6,153,6,24799,580811,750,107206,5.380071510615436,0.15581882424416837
979,0.1117207792207792,0,1,0,24800,580810,750,107206,5.380062247582348,0.1558190507197507
980,0.11175,0,1,0,24801,580809,750,107206,5.380052984549261,0.15581927719599137
981,0.1118333333333333,0,2,0,24803,580807,750,107206,5.3800344584830855,0.15581973015044773
982,0.1118571428571428,0,2,0,24805,580805,750,107206,5.380015932416911,0.15582018310753754
983,0.1119047619047619,0,1,0,24806,580804,750,107206,5.380006669383823,0.15582040958706997
984,0.1119444444444444,0,2,0,24808,580802,750,107206,5.3799881433176475,0.1558208625481099
985,0.1119523809523809,1,1,1,24809,580801,751,107205,5.37997888028456,0.1558198620360869
986,0.1119999999999999,1,51,1,24860,580750,752,107204,5.379506465597095,0.155830186320597
987,0.112,0,2,0,24862,580748,752,107204,5.37948793953092,0.15583063934693117
988,0.1120833333333333,0,4,0,24866,580744,752,107204,5.37945088739857,0.15583154540750174
989,0.1121428571428571,0,5,0,24871,580739,752,107204,5.379404572233132,0.15583267799803183
990,0.1121666666666666,0,1,0,24872,580738,752,107204,5.379395309200045,0.15583290451811344
991,0.1123333333333333,1,11,1,24883,580727,753,107203,5.379293415836082,0.15583416917418924
992,0.1123809523809523,0,5,0,24888,580722,753,107203,5.379247100670644,0.15583530181342442
993,0.1124166666666666,0,1,0,24889,580721,753,107203,5.3792378376375565,0.1558355283432472
994,0.1124285714285714,0,1,0,24890,580720,753,107203,5.379228574604468,0.1558357548737286
995,0.1124999999999999,0,1,0,24891,580719,753,107203,5.379219311571381,0.15583598140486857
996,0.1125,3,122,3,25013,580597,756,107200,5.378089221534699,0.15585994123266023
997,0.1126666666666666,0,10,0,25023,580587,756,107200,5.377996591203824,0.15586220734035391
998,0.1127619047619047,0,2,0,25025,580585,756,107200,5.377978065137649,0.15586266056980017
999,0.1127777777777777,0,2,0,25027,580583,756,107200,5.377959539071473,0.15586311380188228
1000,0.1128015873015873,0,1,0,25028,580582,756,107200,5.377950276038386,0.1558633404189118
1001,0.1128333333333333,0,6,0,25034,580576,756,107200,5.377894697839861,0.15586470013492765
1002,0.1128571428571428,0,3,0,25037,580573,756,107200,5.377866908740598,0.155865380001832
1003,0.1129166666666666,0,1,0,25038,580572,756,107200,5.37785764570751,0.15586560662545146
1004,0.1129444444444444,0,1,0,25039,580571,756,107200,5.377848382674423,0.1558658332497299
1005,0.1129999999999999,0,1,0,25040,580570,756,107200,5.377839119641336,0.1558660598746674
1006,0.113,0,12,0,25052,580558,756,107200,5.3777279632442845,0.15586877942532112
1007,0.1131428571428571,0,1,0,25053,580557,756,107200,5.377718700211197,0.155869006058826
1008,0.1131666666666666,0,2,0,25055,580555,756,107200,5.377700174145022,0.15586945932781296
1009,0.1132142857142857,0,3,0,25058,580552,756,107200,5.377672385045759,0.15587013923623633
1010,0.1133333333333333,8,285,8,25343,580267,764,107192,5.375032420615806,0.15592493515976952
1011,0.1133809523809523,0,2,0,25345,580265,764,107192,5.375013894549632,0.15592538878795328
1012,0.1134848484848484,0,1,0,25346,580264,764,107192,5.375004631516544,0.15592561560303494
1013,0.1134999999999999,0,7,0,25353,580257,764,107192,5.374939790284931,0.15592720332708318
1014,0.113560606060606,0,1,0,25354,580256,764,107192,5.374930527251843,0.15592743014744387
1015,0.1135714285714285,0,1,0,25355,580255,764,107192,5.374921264218756,0.15592765696846447
1016,0.1136428571428571,0,1,0,25356,580254,764,107192,5.374912001185669,0.15592788379014497
1017,0.1136666666666666,0,5,0,25361,580249,764,107192,5.374865686020231,0.15592901790844596
1018,0.1136666666666667,0,1,0,25362,580248,764,107192,5.3748564229871425,0.15592924473408587
1019,0.11375,0,3,0,25365,580245,764,107192,5.37482863388788,0.15592992521496515
1020,0.1138095238095237,0,1,0,25366,580244,764,107192,5.374819370854793,0.15593015204324476
1021,0.1138333333333333,0,2,0,25368,580242,764,107192,5.374800844788617,0.15593060570178374
1022,0.1139285714285714,0,1,0,25369,580241,764,107192,5.37479158175553,0.15593083253204312
1023,0.1139999999999999,0,2,0,25371,580239,764,107192,5.374773055689355,0.15593128619454172
1024,0.114,0,66,0,25437,580173,764,107192,5.374161695505577,0.1559462585380402
1025,0.1140833333333333,0,2,0,25439,580171,764,107192,5.374143169439401,0.15594671229030366
1026,0.1141428571428571,0,1,0,25440,580170,764,107192,5.374133906406314,0.1559469391674256
1027,0.1141666666666666,2,26,2,25466,580144,766,107190,5.373893067546037,0.15595038220137517
1028,0.1142857142857142,0,7,0,25473,580137,766,107190,5.373828226314425,0.15595197045947562
1029,0.1143333333333333,0,6,0,25479,580131,766,107190,5.373772648115899,0.1559533318493106
1030,0.1143928571428571,0,2,0,25481,580129,766,107190,5.373754122049724,0.15595378565120419
1031,0.1144166666666666,0,2,0,25483,580127,766,107190,5.373735595983549,0.15595423945573877
1032,0.1144444444444444,0,1,0,25484,580126,766,107190,5.373726332950461,0.15595446635899646
1033,0.1144999999999999,0,1,0,25485,580125,766,107190,5.373717069917373,0.1559546932629144
1034,0.114500222000222,0,2,0,25487,580123,766,107190,5.373698543851199,0.15595514707273106
1035,0.1145238095238095,0,1,0,25488,580122,766,107190,5.373689280818111,0.1559553739786298
1036,0.1145833333333333,0,1,0,25489,580121,766,107190,5.3736800177850235,0.1559556008851888
1037,0.1145897435897435,0,2,0,25491,580119,766,107190,5.373661491718848,0.15595605470028764
1038,0.1146153846153846,0,1,0,25492,580118,766,107190,5.373652228685761,0.1559562816088275
1039,0.1146666666666666,1,8,1,25500,580110,767,107189,5.37357812442106,0.155956868844564
1040,0.1148333333333333,0,2,0,25502,580108,767,107189,5.373559598354885,0.15595732267127602
1041,0.1148571428571428,0,2,0,25504,580106,767,107189,5.3735410722887105,0.15595777650062928
1042,0.1148809523809523,0,3,0,25507,580103,767,107189,5.373513283189448,0.15595845724961152
1043,0.1149999999999999,0,7,0,25514,580096,767,107189,5.3734484419578346,0.15596004568701485
1044,0.115,18,553,18,26067,579543,785,107171,5.368325984660417,0.1560635140684477
1045,0.1151666666666666,0,4,0,26071,579539,785,107171,5.368288932528067,0.1560644231189294
1046,0.1152380952380952,0,1,0,26072,579538,785,107171,5.36827966949498,0.15606465038320452
1047,0.1153333333333333,0,4,0,26076,579534,785,107171,5.368242617362629,0.15606555944692407
1048,0.1154166666666666,0,2,0,26078,579532,785,107171,5.3682240912964545,0.15606601398275527
1049,0.1154523809523809,0,2,0,26080,579530,785,107171,5.368205565230279,0.15606646852123413
1050,0.1154761904761904,0,2,0,26082,579528,785,107171,5.368187039164104,0.15606692306236067
1051,0.1155,0,2,0,26084,579526,785,107171,5.368168513097928,0.15606737760613487
1052,0.1155238095238095,0,1,0,26085,579525,785,107171,5.368159250064841,0.1560676048790149
1053,0.115547619047619,1,3,1,26088,579522,786,107170,5.368131460965579,0.1560670577202006
1054,0.1155555555555555,0,6,0,26094,579516,786,107170,5.368075882767053,0.15606842137454383
1055,0.1155833333333333,0,1,0,26095,579515,786,107170,5.368066619733965,0.15606864865258452
1056,0.1156666666666666,1,15,1,26110,579500,787,107169,5.367927674237652,0.15607082888553292
1057,0.1157142857142857,0,3,0,26113,579497,787,107169,5.36789988513839,0.15607151074903955
1058,0.1158333333333333,0,58,0,26171,579439,787,107169,5.367362629219311,0.15608469461468552
1059,0.1159523809523809,0,2,0,26173,579437,787,107169,5.367344103153137,0.15608514927046951
1060,0.1159999999999999,1,64,1,26237,579373,788,107168,5.366751269035533,0.15609847044823252
1061,0.116,1,2,1,26239,579371,789,107167,5.366732742969358,0.15609769597604212
1062,0.1161111111111111,0,1,0,26240,579370,789,107167,5.366723479936271,0.15609792334571918
1063,0.1161666666666666,0,7,0,26247,579363,789,107167,5.366658638704657,0.156099514952005
1064,0.1161666666666667,0,1,0,26248,579362,789,107167,5.36664937567157,0.1560997423269811
1065,0.1161904761904761,0,1,0,26249,579361,789,107167,5.366640112638482,0.15609996970261955
1066,0.11625,0,5,0,26254,579356,789,107167,5.366593797473045,0.15610110659074786
1067,0.1163333333333333,0,7,0,26261,579349,789,107167,5.366528956241432,0.15610269826194872
1068,0.1164285714285714,0,1,0,26262,579348,789,107167,5.366519693208344,0.15610292564619854
1069,0.1164523809523809,0,1,0,26263,579347,789,107167,5.366510430175256,0.1561031530311108
1070,0.1164999999999999,0,1,0,26264,579346,789,107167,5.366501167142169,0.15610338041668548
1071,0.1165,0,4,0,26268,579342,789,107167,5.366464115009819,0.1561042899656086
1072,0.1165238095238095,1,3,1,26271,579339,790,107166,5.3664363259105565,0.1561037428715013
1073,0.1165277777777777,0,2,0,26273,579337,790,107166,5.366417799844381,0.1561041976509935
1074,0.116560606060606,0,1,0,26274,579336,790,107166,5.366408536811294,0.1561044250417333
1075,0.1165714285714285,0,1,0,26275,579335,790,107166,5.366399273778206,0.15610465243313557
1076,0.1166666666666666,4,277,4,26552,579058,794,107162,5.363833413612953,0.15616274664101892
1077,0.1168333333333333,1,3,1,26555,579055,795,107161,5.363805624513691,0.15616219965725078
1078,0.1169166666666666,0,3,0,26558,579052,795,107161,5.363777835414428,0.15616288237034273
1079,0.1169999999999999,0,17,0,26575,579035,795,107161,5.36362036385194,0.15616675119062193
1080,0.117,0,1,0,26576,579034,795,107161,5.3636111008188525,0.15616697877425514
1081,0.1170800865800865,0,2,0,26578,579032,795,107161,5.363592574752677,0.1561674339435115
1082,0.1171428571428571,0,4,0,26582,579028,795,107161,5.363555522620326,0.15616834428998425
1083,0.1171666666666666,0,3,0,26585,579025,795,107161,5.363527733521064,0.15616902705680383
1084,0.1172222222222222,0,1,0,26586,579024,795,107161,5.363518470487977,0.1561692546470704
1085,0.11725,0,1,0,26587,579023,795,107161,5.363509207454889,0.1561694822380003
1086,0.1173333333333333,1,16,1,26603,579007,796,107160,5.363360998925488,0.15617189401413942
1087,0.1173809523809523,0,2,0,26605,579005,796,107160,5.363342472859313,0.15617234921629639
1088,0.1174285714285714,0,1,0,26606,579004,796,107160,5.363333209826226,0.15617257681836996
1089,0.1174404761904761,0,1,0,26607,579003,796,107160,5.3633239467931375,0.15617280442110693
1090,0.1174999999999999,0,2,0,26609,579001,796,107160,5.363305420726963,0.15617325962857115
1091,0.1175,3,128,3,26737,578873,799,107157,5.362119752491756,0.15619870851128959
1092,0.1175555555555555,0,1,0,26738,578872,799,107157,5.362110489458669,0.15619893619657477
1093,0.1176190476190476,0,3,0,26741,578869,799,107157,5.362082700359406,0.156199619256413
1094,0.1176666666666666,1,15,1,26756,578854,800,107156,5.361943754863092,0.15620180463841635
1095,0.1176753246753246,0,2,0,26758,578852,800,107156,5.361925228796918,0.15620226003195298
1096,0.1176862745098039,0,1,0,26759,578851,800,107156,5.36191596576383,0.15620248772971704
1097,0.1176904761904762,0,1,0,26760,578850,800,107156,5.361906702730742,0.15620271542814496
1098,0.11775,0,2,0,26762,578848,800,107156,5.361888176664567,0.15620317082699225
1099,0.1177777777777777,0,1,0,26763,578847,800,107156,5.36187891363148,0.1562033985274117
1100,0.1177857142857142,0,1,0,26764,578846,800,107156,5.361869650598392,0.15620362622849496
1101,0.1178333333333333,0,3,0,26767,578843,800,107156,5.361841861499129,0.1562043093357279
1102,0.1178571428571428,0,1,0,26768,578842,800,107156,5.361832598466042,0.1562045370394666
1103,0.1179166666666666,1,2,1,26770,578840,801,107155,5.361814072399866,0.15620376241809342
1104,0.118,1,27,1,26797,578813,802,107154,5.361563970506503,0.15620868059250664
1105,0.1181666666666666,0,7,0,26804,578806,802,107154,5.36149912927489,0.1562102746515832
1106,0.1183333333333333,3,168,3,26972,578638,805,107151,5.359942939716181,0.15624485082146258
1107,0.1183888888888888,0,1,0,26973,578637,805,107151,5.359933676683093,0.1562450786540447
1108,0.1184166666666666,0,1,0,26974,578636,805,107151,5.359924413650005,0.15624530648729124
1109,0.1185,0,15,0,26989,578621,805,107151,5.359785468153692,0.15624872406572446
1110,0.1185714285714285,0,1,0,26990,578620,805,107151,5.359776205120605,0.15624895190960247
1111,0.1186111111111111,0,2,0,26992,578618,805,107151,5.35975767905443,0.15624940759935196
1112,0.1186666666666666,1,17,1,27009,578601,806,107150,5.359600207491941,0.15625205067145365
1113,0.1187142857142857,0,2,0,27011,578599,806,107150,5.359581681425766,0.156252506383531
1114,0.11875,0,2,0,27013,578597,806,107150,5.359563155359591,0.15625296209826656
1115,0.1187777777777777,0,1,0,27014,578596,806,107150,5.359553892326503,0.15625318995663118
1116,0.1187857142857143,0,2,0,27016,578594,806,107150,5.359535366260328,0.15625364567535407
1117,0.1188174603174603,0,2,0,27018,578592,806,107150,5.3595168401941535,0.1562541013967352
1118,0.1188333333333333,0,2,0,27020,578590,806,107150,5.359498314127978,0.15625455712077463
1119,0.1188571428571428,0,1,0,27021,578589,806,107150,5.359489051094891,0.15625478498379122
1120,0.1188888888888888,0,2,0,27023,578587,806,107150,5.359470525028716,0.1562552407118181
1121,0.1189285714285714,0,1,0,27024,578586,806,107150,5.3594612619956274,0.1562554685768284
1122,0.1189999999999999,0,2,0,27026,578584,806,107150,5.359442735929453,0.15625592430884278
1123,0.119,0,29,0,27055,578555,806,107150,5.359174107969913,0.15626253272179727
1124,0.1191190476190476,0,1,0,27056,578554,806,107150,5.359164844936826,0.15626276060807578
1125,0.1191428571428571,0,2,0,27058,578552,806,107150,5.359146318870651,0.15626321638262686
1126,0.1191666666666666,5,43,5,27101,578509,811,107145,5.358748008447886,0.156266863461746
1127,0.1192857142857142,0,6,0,27107,578503,811,107145,5.358692430249361,0.1562682309289898
1128,0.1193333333333333,0,7,0,27114,578496,811,107145,5.358627589017748,0.15626982633768985
1129,0.1193809523809523,0,4,0,27118,578492,811,107145,5.358590536885398,0.15627073801443037
1130,0.1194444444444444,0,6,0,27124,578486,811,107145,5.358534958686873,0.15627210554948653
1131,0.1194523809523809,0,2,0,27126,578484,811,107145,5.358516432620697,0.1562725613998241
1132,0.1195,0,8,0,27134,578476,811,107145,5.358442328355997,0.15627438482776929
1133,0.1195238095238095,0,5,0,27139,578471,811,107145,5.358396013190559,0.15627552449184384
1134,0.1195454545454545,0,3,0,27142,578468,811,107145,5.358368224091296,0.15627620829826738
1135,0.1195833333333333,0,5,0,27147,578463,811,107145,5.358321908925858,0.15627734798893828
1136,0.1196428571428571,0,1,0,27148,578462,811,107145,5.358312645892771,0.15627757592906724
1137,0.1196666666666666,0,3,0,27151,578459,811,107145,5.358284856793508,0.15627825975344367
1138,0.1197142857142857,0,1,0,27152,578458,811,107145,5.358275593760421,0.15627848769623237
1139,0.1197619047619047,0,1,0,27153,578457,811,107145,5.358266330727333,0.156278715639686
1140,0.1198333333333333,0,4,0,27157,578453,811,107145,5.358229278594983,0.15627962742015
1141,0.1198809523809523,0,1,0,27158,578452,811,107145,5.358220015561896,0.15627985536692837
1142,0.1199358974358974,0,1,0,27159,578451,811,107145,5.358210752528808,0.15628008331437174
1143,0.1199523809523809,1,1,1,27160,578450,812,107144,5.358201489495721,0.1562790806220591
1144,0.1199999999999999,0,7,0,27167,578443,812,107144,5.358136648264107,0.15628067626719877
1145,0.12,48,1977,48,29144,576466,860,107096,5.339823631850013,0.15667342538057996
1146,0.1201190476190476,1,2,1,29146,576464,861,107095,5.339805105783838,0.1566726500565423
1147,0.1201666666666666,0,3,0,29149,576461,861,107095,5.339777316684575,0.15667333766362962
1148,0.1202777777777778,0,1,0,29150,576460,861,107095,5.339768053651488,0.15667356686733327
1149,0.1202857142857142,0,2,0,29152,576458,861,107095,5.339749527585313,0.1566740252767525
1150,0.1203015873015873,0,1,0,29153,576457,861,107095,5.339740264552225,0.15667425448246805
1151,0.1203333333333333,2,9,2,29162,576448,863,107093,5.339656897254437,0.15667384984953353
1152,0.1203571428571428,0,1,0,29163,576447,863,107093,5.3396476342213495,0.15667407905901629
1153,0.1204761904761904,0,1,0,29164,576446,863,107093,5.339638371188262,0.15667430826916973
1154,0.1205,0,7,0,29171,576439,863,107093,5.339573529956649,0.15667591275902226
1155,0.1206666666666666,0,15,0,29186,576424,863,107093,5.339434584460336,0.1566793510622267
1156,0.1207142857142857,1,7,1,29193,576417,864,107092,5.339369743228723,0.1566797218471154
1157,0.12075,0,1,0,29194,576416,864,107092,5.339360480195635,0.15667995107592012
1158,0.1208333333333333,0,43,0,29237,576373,864,107092,5.338962169772871,0.15668980854908446
1159,0.1209090909090909,0,1,0,29238,576372,864,107092,5.338952906739783,0.15669003780740462
1160,0.1209166666666666,0,1,0,29239,576371,864,107092,5.3389436437066955,0.1566902670663957
1161,0.1209523809523809,0,2,0,29241,576369,864,107092,5.33892511764052,0.15669072558639044
1162,0.121,1,32,1,29273,576337,865,107091,5.338628700581719,0.1566968283418297
1163,0.121047619047619,0,1,0,29274,576336,865,107091,5.338619437548631,0.15669705762283317
1164,0.1210526695526695,0,3,0,29277,576333,865,107091,5.338591648449368,0.15669774546986937
1165,0.1211111111111111,0,2,0,29279,576331,865,107091,5.338573122383194,0.15669820403791507
1166,0.1211666666666666,0,4,0,29283,576327,865,107091,5.338536070250843,0.15669912118205842
1167,0.1211904761904761,0,1,0,29284,576326,865,107091,5.338526807217756,0.15669935046977174
1168,0.1211904761904762,0,2,0,29286,576324,865,107091,5.33850828115158,0.15669980904721142
1169,0.1212499999999999,0,3,0,29289,576321,865,107091,5.338480492052318,0.15670049691840354
1170,0.12125,0,2,0,29291,576319,865,107091,5.338461965986142,0.15670095550255336
1171,0.1212777777777777,0,1,0,29292,576318,865,107091,5.338452702953055,0.15670118479563483
1172,0.1213333333333333,0,4,0,29296,576314,865,107091,5.338415650820704,0.15670210197467094
1173,0.1214047619047619,0,1,0,29297,576313,865,107091,5.338406387787617,0.15670233127110758
1174,0.1214285714285714,0,3,0,29300,576310,865,107091,5.3383785986883545,0.1567030191644437
1175,0.1215,1,10,1,29310,576300,866,107090,5.338285968357479,0.1567040781983933
1176,0.121547619047619,0,1,0,29311,576299,866,107090,5.338276705324391,0.15670430750275466
1177,0.1215952380952381,0,3,0,29314,576296,866,107090,5.338248916225129,0.1567049954198652
1178,0.1216190476190476,0,2,0,29316,576294,866,107090,5.338230390158953,0.15670545403462768
1179,0.1216666666666666,7,142,7,29458,576152,873,107083,5.336915039460521,0.15672938300877443
1180,0.1217619047619047,0,1,0,29459,576151,873,107083,5.336905776427433,0.1567296124021931
1181,0.1217857142857142,1,3,1,29462,576148,874,107082,5.336877987328171,0.15672906634661826
1182,0.1218333333333333,1,8,1,29470,576140,875,107081,5.33680388306347,0.1567296672672532
1183,0.1218650793650793,0,2,0,29472,576138,875,107081,5.336785356997296,0.15673012606499526
1184,0.122,1,55,1,29527,576083,876,107080,5.33627589017748,0.15674150971290893
1185,0.1220833333333333,0,4,0,29531,576079,876,107080,5.336238838045129,0.1567424274583223
1186,0.1221428571428571,0,2,0,29533,576077,876,107080,5.336220311978955,0.15674288633505915
1187,0.1221666666666666,0,6,0,29539,576071,876,107080,5.336164733780429,0.15674426298139063
1188,0.1223333333333333,0,15,0,29554,576056,876,107080,5.336025788284116,0.1567477047030167
1189,0.1223809523809524,0,1,0,29555,576055,876,107080,5.336016525251028,0.15674793415649907
1190,0.1225,7,159,7,29714,575896,883,107073,5.334543702990107,0.1567757833810905
1191,0.1225238095238095,0,1,0,29715,575895,883,107073,5.33453443995702,0.15677601293179183
1192,0.1225714285714285,0,1,0,29716,575894,883,107073,5.334525176923932,0.15677624248316538
1193,0.1226666666666666,0,4,0,29720,575890,883,107073,5.334488124791582,0.15677716069538175
1194,0.1227777777777777,0,2,0,29722,575888,883,107073,5.3344695987254065,0.1567776198055233
1195,0.1228333333333333,0,6,0,29728,575882,883,107073,5.334414020526881,0.15677899715208177
1196,0.1228571428571428,0,5,0,29733,575877,883,107073,5.334367705361443,0.15678014495936746
1197,0.1229047619047619,0,3,0,29736,575874,883,107073,5.334339916262181,0.15678083365180606
1198,0.1229761904761904,0,1,0,29737,575873,883,107073,5.3343306532290935,0.15678106321729682
1199,0.123,1,12,1,29749,575861,884,107072,5.334219496832043,0.1567825833573718
1200,0.1230952380952381,0,1,0,29750,575860,884,107072,5.334210233798955,0.15678281293013066
1201,0.1231666666666666,0,3,0,29753,575857,884,107072,5.334182444699692,0.15678350165244118
1202,0.1232142857142857,0,6,0,29759,575851,884,107072,5.334126866501167,0.15678487911521505
1203,0.1233333333333333,9,319,9,30078,575532,893,107063,5.331171958946237,0.15684703228122093
1204,0.1233571428571428,0,1,0,30079,575531,893,107063,5.33116269591315,0.15684726206207497
1205,0.1233809523809523,0,3,0,30082,575528,893,107063,5.331134906813888,0.15684795140867663
1206,0.1234285714285714,0,1,0,30083,575527,893,107063,5.3311256437807995,0.15684818119222374
1207,0.1235,1,11,1,30094,575516,894,107062,5.331023750416836,0.15684947361327203
1208,0.1235714285714285,0,1,0,30095,575515,894,107062,5.331014487383749,0.15684970340342555
1209,0.1236666666666666,1,6,1,30101,575509,895,107061,5.330958909185224,0.15684984690214923
1210,0.12375,0,4,0,30105,575505,895,107061,5.330921857052873,0.15685076607976373
1211,0.1237619047619047,0,2,0,30107,575503,895,107061,5.330903330986699,0.15685122567261092
1212,0.1238181818181818,0,2,0,30109,575501,895,107061,5.330884804920523,0.15685168526815146
1213,0.1238333333333333,0,5,0,30114,575496,895,107061,5.330838489755085,0.15685283426878635
1214,0.1239285714285714,0,2,0,30116,575494,895,107061,5.33081996368891,0.15685329387375377
1215,0.124,4,59,4,30175,575435,899,107057,5.330273444736744,0.15686191193449886
1216,0.124047619047619,0,1,0,30176,575434,899,107057,5.330264181703657,0.15686214177183289
1217,0.1241666666666666,0,56,0,30232,575378,899,107057,5.329745451850754,0.15687501373757207
1218,0.1241666666666667,0,1,0,30233,575377,899,107057,5.329736188817667,0.1568752436133018
1219,0.1242777777777777,1,1,1,30234,575376,900,107056,5.329726925784579,0.15687423801931913
1220,0.1242857142857142,0,10,0,30244,575366,900,107056,5.329634295453704,0.15687653680567157
1221,0.1243333333333333,0,11,0,30255,575355,900,107056,5.3295324020897406,0.15687906554847444
1222,0.1244444444444444,0,2,0,30257,575353,900,107056,5.329513876023565,0.15687952532865188
1223,0.1244523809523809,0,1,0,30258,575352,900,107056,5.329504612990478,0.15687975521975123
1224,0.1245,1,3,1,30261,575349,901,107055,5.329476823891215,0.15687920938329786
1225,0.1245833333333333,0,4,0,30265,575345,901,107055,5.329439771758865,0.15688012895662368
1226,0.1246428571428571,0,1,0,30266,575344,901,107055,5.329430508725777,0.1568803588516396
1227,0.1246666666666666,2,13,2,30279,575331,903,107053,5.329310089295639,0.15688087645665783
1228,0.1247142857142857,0,1,0,30280,575330,903,107053,5.329300826262552,0.15688110635815958
1229,0.12475,0,1,0,30281,575329,903,107053,5.3292915632294635,0.15688133626033512
1230,0.1247619047619047,0,2,0,30283,575327,903,107053,5.329273037163289,0.1568817960667077
1231,0.1248333333333333,0,6,0,30289,575321,903,107053,5.329217458964764,0.15688317550199743
1232,0.1249166666666666,0,1,0,30290,575320,903,107053,5.329208195931676,0.15688340541023751
1233,0.1249999999999999,0,6,0,30296,575314,903,107053,5.3291526177331505,0.1568847848738289
1234,0.125,26,607,26,30903,574707,929,107027,5.323529956649005,0.15699231665136257
1235,0.1251190476190476,0,2,0,30905,574705,929,107027,5.32351143058283,0.156992777220374
1236,0.1252380952380952,0,1,0,30906,574704,929,107027,5.3235021675497425,0.1569930075058931
1237,0.1252747252747252,0,1,0,30907,574703,929,107027,5.323492904516655,0.15699323779208776
1238,0.1252857142857142,0,2,0,30909,574701,929,107027,5.32347437845048,0.15699369836650395
1239,0.1253095238095238,0,1,0,30910,574700,929,107027,5.323465115417393,0.15699392865472542
1240,0.1253333333333333,1,16,1,30926,574684,930,107026,5.3233169068879915,0.15699637675844566
1241,0.1253571428571428,0,1,0,30927,574683,930,107026,5.323307643854904,0.15699660705667667
1242,0.1254166666666666,0,1,0,30928,574682,930,107026,5.323298380821816,0.15699683735558334
1243,0.1254761904761904,0,2,0,30930,574680,930,107026,5.323279854755641,0.1569972979554236
1244,0.1255,1,5,1,30935,574675,931,107025,5.323233539590204,0.15699721285022739
1245,0.1256428571428571,0,1,0,30936,574674,931,107025,5.323224276557116,0.15699744315306316
1246,0.1256666666666666,1,7,1,30943,574667,932,107024,5.323159435325503,0.156997818659774
1247,0.1257142857142857,0,9,0,30952,574658,932,107024,5.323076068027715,0.1569998914449846
1248,0.1258333333333333,1,39,1,30991,574619,933,107023,5.322714809737301,0.1570076374401812
1249,0.1259444444444444,1,5,1,30996,574614,934,107022,5.322668494571863,0.1570075524180061
1250,0.1259523809523809,1,7,1,31003,574607,935,107021,5.322603653340249,0.1570079280780719
1251,0.126,1,46,1,31049,574561,936,107020,5.322177553818222,0.1570172877471643
1252,0.1261111111111111,0,1,0,31050,574560,936,107020,5.322168290785135,0.15701751811966314
1253,0.1261666666666666,0,2,0,31052,574558,936,107020,5.32214976471896,0.15701797886668878
1254,0.1261904761904762,1,8,1,31060,574550,937,107019,5.322075660454259,0.1570185850588862
1255,0.1262499999999999,0,1,0,31061,574549,937,107019,5.322066397421172,0.15701881543734447
1256,0.12625,0,4,0,31065,574545,937,107019,5.322029345288821,0.15701973695793792
1257,0.1263095238095238,0,3,0,31068,574542,937,107019,5.322001556189559,0.1570204281054814
1258,0.1263333333333333,2,3,2,31071,574539,939,107017,5.321973767090296,0.15701864556984313
1259,0.1264285714285714,1,1,1,31072,574538,940,107016,5.321964504057209,0.15701763910123043
1260,0.1264999999999999,0,1,0,31073,574537,940,107016,5.321955241024121,0.15701786948337107
1261,0.1265,0,15,0,31088,574522,940,107016,5.321816295527808,0.15702132529660856
1262,0.1265238095238095,0,1,0,31089,574521,940,107016,5.32180703249472,0.15702155568956638
1263,0.1265714285714285,0,1,0,31090,574520,940,107016,5.321797769461632,0.1570217860832003
1264,0.1266309523809523,0,3,0,31093,574517,940,107016,5.32176998036237,0.15702247726815868
1265,0.1266666666666666,12,333,12,31426,574184,952,107004,5.318685390344214,0.15708438786355602
1266,0.1268253968253968,0,1,0,31427,574183,952,107004,5.318676127311127,0.1570846184674693
1267,0.1268333333333333,0,3,0,31430,574180,952,107004,5.318648338211864,0.15708531028327147
1268,0.1268571428571428,0,1,0,31431,574179,952,107004,5.318639075178776,0.15708554088989302
1269,0.1269047619047619,0,1,0,31432,574178,952,107004,5.318629812145689,0.15708577149719163
1270,0.1269166666666666,0,1,0,31433,574177,952,107004,5.318620549112602,0.15708600210516735
1271,0.1269444444444444,0,1,0,31434,574176,952,107004,5.318611286079514,0.15708623271382013
1272,0.1269682539682539,0,1,0,31435,574175,952,107004,5.318602023046426,0.15708646332315002
1273,0.127,2,26,2,31461,574149,954,107002,5.31836118418615,0.15708998445278655
1274,0.1270119047619047,0,2,0,31463,574147,954,107002,5.318342658119975,0.15709044570277575
1275,0.1270238095238095,0,3,0,31466,574144,954,107002,5.318314869020712,0.15709113758283832
1276,0.1270833333333333,0,1,0,31467,574143,954,107002,5.318305605987625,0.1570913682108802
1277,0.1271428571428571,0,6,0,31473,574137,954,107002,5.318250027789099,0.15709275199335232
1278,0.1271666666666666,0,6,0,31479,574131,954,107002,5.318194449590574,0.15709413580020348
1279,0.1271904761904762,0,1,0,31480,574130,954,107002,5.3181851865574865,0.1570943664370489
1280,0.1272222222222222,0,1,0,31481,574129,954,107002,5.318175923524398,0.15709459707457155
1281,0.1272619047619047,0,2,0,31483,574127,954,107002,5.318157397458224,0.15709505835164853
1282,0.1272857142857142,0,1,0,31484,574126,954,107002,5.318148134425136,0.15709528899120284
1283,0.1273333333333333,0,14,0,31498,574112,954,107002,5.31801845196191,0.15709851801607366
1284,0.1273809523809523,0,1,0,31499,574111,954,107002,5.318009188928823,0.15709874866578674
1285,0.1274166666666666,0,5,0,31504,574106,954,107002,5.317962873763385,0.15709990192451123
1286,0.1274285714285714,0,1,0,31505,574105,954,107002,5.317953610730298,0.157100132578288
1287,0.1274444444444444,0,2,0,31507,574103,954,107002,5.317935084664122,0.15710059388787337
1288,0.1274999999999999,0,3,0,31510,574100,954,107002,5.31790729556486,0.1571012858573312
1289,0.1275,8,187,8,31697,573913,962,106994,5.316175108377487,0.15713452791644086
1290,0.1275714285714285,1,1,1,31698,573912,963,106993,5.3161658453444,0.15713352082889684
1291,0.1276190476190476,0,1,0,31699,573911,963,106993,5.316156582311312,0.15713375160081303
1292,0.1276666666666666,1,9,1,31708,573902,964,106992,5.316073215013524,0.15713459069987398
1293,0.1276746031746031,2,1,2,31709,573901,966,106990,5.3160639519804365,0.1571323457058472
1294,0.1277142857142857,0,1,0,31710,573900,966,106990,5.316054688947349,0.1571325764807825
1295,0.1277777777777778,0,3,0,31713,573897,966,106990,5.316026899848087,0.15713326880965564
1296,0.1278095238095238,0,2,0,31715,573895,966,106990,5.316008373781911,0.15713373036562708
1297,0.1278333333333333,2,8,2,31723,573887,968,106988,5.315934269517211,0.15713310078942538
1298,0.1278571428571428,1,8,1,31731,573879,969,106987,5.31586016525251,0.15713370912925598
1299,0.1279166666666666,0,4,0,31735,573875,969,106987,5.31582311312016,0.15713463227496907
1300,0.128,1,36,1,31771,573839,970,106986,5.315489643929008,0.15714170308082107
1301,0.1280555555555555,0,1,0,31772,573838,970,106986,5.31548038089592,0.1571419338918722
1302,0.1280952380952381,0,3,0,31775,573835,970,106986,5.3154525917966575,0.15714262632909384
1303,0.1281666666666666,1,9,1,31784,573826,971,106985,5.31536922449887,0.15714346566080747
1304,0.1282051282051282,0,1,0,31785,573825,971,106985,5.3153599614657825,0.1571436964791939
1305,0.1282142857142857,0,2,0,31787,573823,971,106985,5.315341435399607,0.15714415811800098
1306,0.1282857142857142,0,5,0,31792,573818,971,106985,5.315295120234169,0.15714531222688502
1307,0.1283333333333333,4,144,4,31936,573674,975,106981,5.313961243469562,0.15717360483651777
1308,0.1283571428571428,0,2,0,31938,573672,975,106981,5.313942717403386,0.15717406666833172
1309,0.1283787878787878,0,2,0,31940,573670,975,106981,5.313924191337211,0.15717452850285976
1310,0.1284523809523809,1,1,1,31941,573669,976,106980,5.313914928304124,0.157173521154075
1311,0.1285,2,5,2,31946,573664,978,106978,5.313868613138686,0.1571721991884133
1312,0.1285714285714286,0,2,0,31948,573662,978,106978,5.313850087072511,0.15717266102491773
1313,0.1286111111111111,0,2,0,31950,573660,978,106978,5.313831561006336,0.1571731228641363
1314,0.1286363636363636,0,2,0,31952,573658,978,106978,5.313813034940161,0.15717358470606904
1315,0.1286666666666666,0,15,0,31967,573643,978,106978,5.313674089443848,0.1571770486070809
1316,0.1287142857142857,0,1,0,31968,573642,978,106978,5.3136648264107595,0.15717727953924363
1317,0.1287499999999999,0,2,0,31970,573640,978,106978,5.313646300344585,0.1571777414056049
1318,0.1287878787878787,0,1,0,31971,573639,978,106978,5.313637037311497,0.15717797233980343
1319,0.1288095238095238,0,1,0,31972,573638,978,106978,5.31362777427841,0.15717820327468057
1320,0.1288333333333333,0,2,0,31974,573636,978,106978,5.313609248212234,0.1571786651464707
1321,0.1289285714285714,0,4,0,31978,573632,978,106978,5.3135721960798845,0.15717958889819428
1322,0.1289682539682539,1,0,1,31978,573632,979,106977,5.3135721960798845,0.15717835056544946
1323,0.1289999999999999,0,3,0,31981,573629,979,106977,5.313544406980622,0.15717904338192729
1324,0.129,1,33,1,32014,573596,980,106976,5.313238726888732,0.15718542637663613
1325,0.129047619047619,0,1,0,32015,573595,980,106976,5.313229463855645,0.1571856573377355
1326,0.1290833333333333,0,1,0,32016,573594,980,106976,5.313220200822557,0.15718588829951363
1327,0.1291428571428571,0,1,0,32017,573593,980,106976,5.31321093778947,0.15718611926197049
1328,0.1291666666666666,1,56,1,32073,573537,981,106975,5.312692207936567,0.1571978157622496
1329,0.1292857142857142,0,6,0,32079,573531,981,106975,5.312636629738042,0.15719920177044727
1330,0.1293095238095238,0,2,0,32081,573529,981,106975,5.312618103671866,0.15719966377861114
1331,0.1293333333333333,1,12,1,32093,573517,982,106974,5.312506947274816,0.15720119737072202
1332,0.1293571428571428,0,1,0,32094,573516,982,106974,5.312497684241728,0.1572014283824891
1333,0.1294372294372294,0,1,0,32095,573515,982,106974,5.3124884212086405,0.1572016593949351
1334,0.1294444444444444,0,1,0,32096,573514,982,106974,5.312479158175553,0.1572018904080601
1335,0.1294523809523809,0,1,0,32097,573513,982,106974,5.312469895142465,0.15720212142186404
1336,0.1294761904761904,0,2,0,32099,573511,982,106974,5.312451369076291,0.15720258345150884
1337,0.1295,1,10,1,32109,573501,983,106973,5.312358738745415,0.15720365509923964
1338,0.1295238095238095,0,3,0,32112,573498,983,106973,5.312330949646152,0.1572043481647271
1339,0.1295952380952381,0,3,0,32115,573495,983,106973,5.31230316054689,0.1572050412363256
1340,0.1296428571428571,0,1,0,32116,573494,983,106973,5.312293897513802,0.1572052722615498
1341,0.1296666666666666,0,5,0,32121,573489,983,106973,5.312247582348364,0.15720642739785617
1342,0.1297619047619047,0,5,0,32126,573484,983,106973,5.312201267182926,0.15720758255113843
1343,0.1298333333333333,0,1,0,32127,573483,983,106973,5.312192004149839,0.157207813583832
1344,0.1298571428571428,0,3,0,32130,573480,983,106973,5.312164215050577,0.15720850668598713
1345,0.1298611111111111,1,1,1,32131,573479,984,106972,5.312154952017488,0.1572074991439501
1346,0.1298809523809523,1,5,1,32136,573474,985,106971,5.3121086368520505,0.15720741573529087
1347,0.1299285714285714,0,1,0,32137,573473,985,106971,5.312099373818963,0.1572076467718137
1348,0.1299999999999999,0,15,0,32152,573458,985,106971,5.31196042832265,0.15721111240114694
1349,0.13,81,2087,81,34239,571371,1066,106890,5.292628478268925,0.15759420046265377
1350,0.1300714285714286,0,1,0,34240,571370,1066,106890,5.2926192152358364,0.1575944328133754
1351,0.1301666666666666,0,2,0,34242,571368,1066,106890,5.292600689169662,0.1575948975168741
1352,0.1302499999999999,0,2,0,34244,571366,1066,106890,5.292582163103487,0.1575953622231134
1353,0.1302777777777777,1,1,1,34245,571365,1067,106889,5.292572900070399,0.15759435255818616
1354,0.1302857142857142,0,1,0,34246,571364,1067,106889,5.292563637037311,0.15759458491153006
1355,0.1303181818181818,0,1,0,34247,571363,1067,106889,5.292554374004224,0.1575948172655591
1356,0.1303333333333333,1,8,1,34255,571355,1068,106888,5.2924802697395235,0.1575954340848339
1357,0.1303571428571428,0,1,0,34256,571354,1068,106888,5.292471006706436,0.1575956664435408
1358,0.1304761904761904,0,1,0,34257,571353,1068,106888,5.292461743673348,0.15759589880293287
1359,0.1305,0,5,0,34262,571348,1068,106888,5.292415428507911,0.1575970606101711
1360,0.1305952380952381,0,2,0,34264,571346,1068,106888,5.292396902441736,0.15759752533786275
1361,0.1306666666666666,1,24,1,34288,571322,1069,106887,5.292174589647634,0.15760186019353917
1362,0.1307142857142857,0,2,0,34290,571320,1069,106887,5.2921560635814595,0.15760232495388576
1363,0.1308333333333333,1,58,1,34348,571262,1070,106886,5.291618807662381,0.1576145620130119
1364,0.1309523809523809,0,5,0,34353,571257,1070,106886,5.291572492496943,0.15761572411718472
1365,0.131,0,28,0,34381,571229,1070,106886,5.291313127570492,0.15762223221724928
1366,0.1310238095238095,0,1,0,34382,571228,1070,106886,5.291303864537404,0.15762246465933458
1367,0.1311111111111111,0,1,0,34383,571227,1070,106886,5.291294601504316,0.1576226971021054
1368,0.1311666666666666,1,3,1,34386,571224,1071,106885,5.291266812405054,0.15762215219087197
1369,0.1311904761904762,0,5,0,34391,571219,1071,106885,5.291220497239616,0.1576233144178474
1370,0.13125,0,7,0,34398,571212,1071,106885,5.291155656008003,0.15762494156440746
1371,0.1313333333333333,3,15,3,34413,571197,1074,106882,5.29101671051169,0.15762470154657496
1372,0.1314285714285714,0,6,0,34419,571191,1074,106882,5.290961132313164,0.15762609630526506
1373,0.1315,0,7,0,34426,571184,1074,106882,5.290896291081552,0.15762772355493418
1374,0.1316190476190476,0,1,0,34427,571183,1074,106882,5.290887028048465,0.15762795602191532
1375,0.1316428571428571,0,3,0,34430,571180,1074,106882,5.290859238949202,0.15762865342697274
1376,0.1316666666666666,6,167,6,34597,571013,1080,106876,5.28931231242358,0.1576600298868989
1377,0.1317142857142857,0,4,0,34601,571009,1080,106876,5.289275260291229,0.157660960192363
1378,0.13175,0,1,0,34602,571008,1080,106876,5.289265997258142,0.1576611927704445
1379,0.1317857142857142,0,5,0,34607,571003,1080,106876,5.289219682092704,0.15766235567114484
1380,0.1318571428571428,1,0,1,34607,571003,1081,106875,5.289219682092704,0.15766111306164235
1381,0.1319047619047618,0,2,0,34609,571001,1081,106875,5.28920115602653,0.15766157822374594
1382,0.1319285714285714,0,1,0,34610,571000,1081,106875,5.289191892993442,0.15766181080582703
1383,0.1319444444444444,0,1,0,34611,570999,1081,106875,5.289182629960354,0.15766204338859435
1384,0.1319696969696969,0,2,0,34613,570997,1081,106875,5.289164103894179,0.1576625085561876
1385,0.132,1,53,1,34666,570944,1082,106874,5.288673163140539,0.15767359379656487
1386,0.1320238095238095,0,1,0,34667,570943,1082,106874,5.288663900107451,0.1576738264162746
1387,0.132063492063492,0,1,0,34668,570942,1082,106874,5.288654637074363,0.15767405903667073
1388,0.1320952380952381,0,1,0,34669,570941,1082,106874,5.288645374041276,0.15767429165775323
1389,0.1321428571428571,0,1,0,34670,570940,1082,106874,5.288636111008189,0.1576745242795221
1390,0.1322222222222222,0,2,0,34672,570938,1082,106874,5.288617584942013,0.15767498952511905
1391,0.13225,0,1,0,34673,570937,1082,106874,5.288608321908926,0.15767522214894714
1392,0.1322727272727272,0,1,0,34674,570936,1082,106874,5.288599058875838,0.1576754547734616
1393,0.1323333333333333,1,21,1,34695,570915,1083,106873,5.288404535181,0.1576790972988604
1394,0.1323809523809523,0,2,0,34697,570913,1083,106873,5.2883860091148245,0.15767956257579827
1395,0.1325,8,210,8,34907,570703,1091,106865,5.286440772166438,0.15771848729574006
1396,0.1326190476190476,0,2,0,34909,570701,1091,106865,5.286422246100263,0.15771895284001855
1397,0.1326666666666666,0,14,0,34923,570687,1091,106865,5.286292563637037,0.1577222117269228
1398,0.1327857142857142,0,1,0,34924,570686,1091,106865,5.28628330060395,0.15772244450971218
1399,0.1328333333333333,0,8,0,34932,570678,1091,106865,5.286209196339249,0.1577243067967642
1400,0.1328571428571428,0,3,0,34935,570675,1091,106865,5.286181407239987,0.15772500516574667
1401,0.1329166666666666,0,3,0,34938,570672,1091,106865,5.286153618140724,0.15772570354091364
1402,0.1329444444444444,0,1,0,34939,570671,1091,106865,5.286144355107637,0.1577259363340103
1403,0.1329999999999999,0,2,0,34941,570669,1091,106865,5.286125829041461,0.15772640192226517
1404,0.133,0,18,0,34959,570651,1091,106865,5.285959094445885,0.1577305923402547
1405,0.1330238095238095,0,1,0,34960,570650,1091,106865,5.285949831412798,0.1577308251477827
1406,0.1330454545454545,0,1,0,34961,570649,1091,106865,5.2859405683797105,0.15773105795599796
1407,0.133047619047619,0,1,0,34962,570648,1091,106865,5.285931305346622,0.15773129076490044
1408,0.1330555555555555,0,1,0,34963,570647,1091,106865,5.285922042313535,0.1577315235744902
1409,0.1330714285714285,0,1,0,34964,570646,1091,106865,5.285912779280448,0.1577317563847672
1410,0.133095238095238,0,1,0,34965,570645,1091,106865,5.28590351624736,0.15773198919573142
1411,0.1330952380952381,0,1,0,34966,570644,1091,106865,5.2858942532142725,0.15773222200738293
1412,0.1331428571428571,0,2,0,34968,570642,1091,106865,5.285875727148097,0.1577326876327477
1413,0.1331666666666666,0,8,0,34976,570634,1091,106865,5.285801622883397,0.15773455016169766
1414,0.1332142857142857,0,1,0,34977,570633,1091,106865,5.285792359850309,0.15773478298090918
1415,0.1332499999999999,1,0,1,34977,570633,1092,106864,5.285792359850309,0.15773353977951193
1416,0.1333333333333333,11,343,11,35320,570290,1103,106853,5.282615139501278,0.15779975573844815
1417,0.1333571428571428,0,1,0,35321,570289,1103,106853,5.282605876468191,0.1577999887763571
1418,0.1334285714285714,0,2,0,35323,570287,1103,106853,5.282587350402015,0.15780045485423988
1419,0.1334920634920635,0,1,0,35324,570286,1103,106853,5.282578087368928,0.15780068789421375
1420,0.1335,0,6,0,35330,570280,1103,106853,5.282522509170403,0.15780208614851143
1421,0.1336111111111111,0,3,0,35333,570277,1103,106853,5.28249472007114,0.15780278528495267
1422,0.1336507936507936,0,1,0,35334,570276,1103,106853,5.282485457038052,0.15780301833180974
1423,0.1336666666666666,0,7,0,35341,570269,1103,106853,5.28242061580644,0.15780464967908295
1424,0.1336904761904762,0,1,0,35342,570268,1103,106853,5.2824113527733525,0.15780488273144683
1425,0.13375,0,5,0,35347,570263,1103,106853,5.2823650376079145,0.15780604800359171
1426,0.1338333333333333,0,4,0,35351,570259,1103,106853,5.282327985475564,0.1578069802336984
1427,0.134,2,80,2,35431,570179,1105,106851,5.28158694282856,0.1578231392995879
1428,0.1340238095238095,0,1,0,35432,570178,1105,106851,5.281577679795472,0.1578233724109307
1429,0.134047619047619,0,6,0,35438,570172,1105,106851,5.281522101596947,0.1578247710934488
1430,0.1341666666666666,1,50,1,35488,570122,1106,106850,5.281058949942569,0.15783518372990316
1431,0.13425,0,3,0,35491,570119,1106,106850,5.281031160843306,0.15783588317928887
1432,0.1342619047619047,0,1,0,35492,570118,1106,106850,5.281021897810219,0.1578361163304617
1433,0.1342857142857142,0,10,0,35502,570108,1106,106850,5.280929267479343,0.15783844788007528
1434,0.1343333333333333,0,16,0,35518,570092,1106,106850,5.280781058949943,0.15784217850273732
1435,0.1344285714285714,0,1,0,35519,570091,1106,106850,5.280771795916855,0.15784241167250912
1436,0.1344444444444444,0,1,0,35520,570090,1106,106850,5.2807625328837675,0.15784264484296984
1437,0.1344999999999999,0,3,0,35523,570087,1106,106850,5.280734743784505,0.15784334435848535
1438,0.1345238095238095,0,4,0,35527,570083,1106,106850,5.280697691652154,0.15784427705548407
1439,0.1345833333333333,0,1,0,35528,570082,1106,106850,5.280688428619067,0.15784451023145604
1440,0.1346428571428571,0,1,0,35529,570081,1106,106850,5.28067916558598,0.15784474340811694
1441,0.1346666666666666,2,16,2,35545,570065,1108,106848,5.280530957056579,0.15784598611638423
1442,0.1347619047619047,0,1,0,35546,570064,1108,106848,5.280521694023491,0.1578462193017704
1443,0.1348095238095238,0,2,0,35548,570062,1108,106848,5.280503167957316,0.15784668567460963
1444,0.1348333333333333,0,1,0,35549,570061,1108,106848,5.280493904924229,0.1578469188620627
1445,0.1348809523809523,0,1,0,35550,570060,1108,106848,5.280484641891141,0.15784715205020475
1446,0.1349047619047619,0,1,0,35551,570059,1108,106848,5.280475378858053,0.1578473852390358
1447,0.1349999999999999,0,5,0,35556,570054,1108,106848,5.280429063692615,0.1578485511935258
1448,0.135,30,687,30,36243,569367,1138,106818,5.274065359961466,0.1579715610372901
1449,0.135047619047619,0,2,0,36245,569365,1138,106818,5.274046833895291,0.15797202828228452
1450,0.1351190476190476,0,1,0,36246,569364,1138,106818,5.274037570862203,0.15797226190581826
1451,0.1351515151515151,0,1,0,36247,569363,1138,106818,5.2740283078291155,0.157972495530043
1452,0.1351666666666666,0,2,0,36249,569361,1138,106818,5.27400978176294,0.1579729627805655
1453,0.1352380952380952,0,2,0,36251,569359,1138,106818,5.273991255696766,0.15797343003385209
1454,0.1352857142857143,0,1,0,36252,569358,1138,106818,5.2739819926636775,0.1579736636615319
1455,0.1353333333333333,1,7,1,36259,569351,1139,106817,5.273917151432065,0.15797405378544976
1456,0.1353571428571428,0,4,0,36263,569347,1139,106817,5.273880099299714,0.15797498831644394
1457,0.1354166666666666,1,1,1,36264,569346,1140,106816,5.273870836266627,0.15797397665056598
1458,0.1354365079365079,0,1,0,36265,569345,1140,106816,5.27386157323354,0.15797421028423703
1459,0.1354761904761904,0,2,0,36267,569343,1140,106816,5.2738430471673645,0.15797467755365233
1460,0.1354999999999999,0,1,0,36268,569342,1140,106816,5.273833784134277,0.15797491118939655
1461,0.1355,0,1,0,36269,569341,1140,106816,5.273824521101189,0.15797514482583186
1462,0.1355265151515151,1,6,1,36275,569335,1141,106815,5.273768942902664,0.1579753013384604
1463,0.1355384615384615,0,1,0,36276,569334,1141,106815,5.273759679869577,0.15797553497823705
1464,0.1355555555555555,0,1,0,36277,569333,1141,106815,5.273750416836489,0.15797576861870477
1465,0.1356666666666666,0,14,0,36291,569319,1141,106815,5.273620734373263,0.15797903965781931
1466,0.1357142857142857,0,6,0,36297,569313,1141,106815,5.273565156174738,0.15798044157319324
1467,0.1358333333333333,3,63,3,36360,569250,1144,106812,5.272981585090222,0.15799142682180037
1468,0.1359047619047619,0,1,0,36361,569249,1144,106812,5.272972322057134,0.15799166051584101
1469,0.1359523809523809,0,2,0,36363,569247,1144,106812,5.27295379599096,0.15799212790599637
1470,0.1359841269841269,0,1,0,36364,569246,1144,106812,5.2729445329578715,0.15799236160211105
1471,0.1359999999999999,0,4,0,36368,569242,1144,106812,5.272907480825522,0.15799329639348336
1472,0.136,0,70,0,36438,569172,1144,106812,5.272259068509393,0.15800965703330255
1473,0.136047619047619,1,0,1,36438,569172,1145,106811,5.272259068509393,0.1580084114541342
1474,0.136060606060606,0,1,0,36439,569171,1145,106811,5.272249805476305,0.15800864520061186
1475,0.1360833333333333,0,1,0,36440,569170,1145,106811,5.2722405424432175,0.15800887894778107
1476,0.1361111111111111,0,2,0,36442,569168,1145,106811,5.272222016377042,0.15800934644419426
1477,0.1361666666666666,1,1,1,36443,569167,1146,106810,5.272212753343955,0.1580083346031004
1478,0.1361904761904762,0,3,0,36446,569164,1146,106810,5.272184964244692,0.15800903585049128
1479,0.1362380952380952,0,2,0,36448,569162,1146,106810,5.272166438178517,0.15800950335220987
1480,0.13625,0,1,0,36449,569161,1146,106810,5.27215717514543,0.15800973710410654
1481,0.1362857142857143,0,2,0,36451,569159,1146,106810,5.272138649079254,0.15801020460997472
1482,0.1363333333333333,0,6,0,36457,569153,1146,106810,5.272083070880729,0.158011607144178
1483,0.1363690476190476,0,1,0,36458,569152,1146,106810,5.272073807847642,0.15801184090229925
1484,0.1363888888888889,0,1,0,36459,569151,1146,106810,5.272064544814554,0.1580120746611121
1485,0.1364285714285714,0,1,0,36460,569150,1146,106810,5.2720552817814665,0.15801230842061662
1486,0.1364841269841269,0,1,0,36461,569149,1146,106810,5.272046018748379,0.15801254218081273
1487,0.1365,0,5,0,36466,569144,1146,106810,5.271999703582941,0.1580137109921681
1488,0.1365833333333333,0,2,0,36468,569142,1146,106810,5.271981177516766,0.15801417852155183
1489,0.1366666666666666,7,226,7,36694,568916,1153,106803,5.2698877320389785,0.15805830530146406
1490,0.1366666666666667,5,112,5,36806,568804,1158,106798,5.2688502723331725,0.15807827685530831
1491,0.1367142857142857,0,1,0,36807,568803,1158,106798,5.268841009300085,0.1580785108370177
1492,0.1367857142857142,1,0,1,36807,568803,1159,106797,5.268841009300085,0.15807726465364122
1493,0.1368333333333333,0,5,0,36812,568798,1159,106797,5.268794694134647,0.15807843456508708
1494,0.1368419913419913,1,0,1,36812,568798,1160,106796,5.268794694134647,0.15807718837053022
1495,0.1368571428571428,1,1,1,36813,568797,1161,106795,5.26878543110156,0.15807617615365488
1496,0.1369523809523809,0,2,0,36815,568795,1161,106795,5.268766905035385,0.15807664411847422
1497,0.1369999999999999,2,18,2,36833,568777,1163,106793,5.268600170439809,0.15807836345604453
1498,0.137,0,2,0,36835,568775,1163,106793,5.268581644373634,0.1580788314425787
1499,0.1370238095238095,0,3,0,36838,568772,1163,106793,5.268553855274371,0.15807953342757544
1500,0.137047619047619,0,1,0,36839,568771,1163,106793,5.268544592241284,0.15807976742395982
1501,0.1371031746031746,0,1,0,36840,568770,1163,106793,5.268535329208196,0.15808000142103698
1502,0.1371309523809523,0,1,0,36841,568769,1163,106793,5.2685260661751085,0.15808023541880686
1503,0.1371428571428571,1,3,1,36844,568766,1164,106792,5.268498277075846,0.15807969115901224
1504,0.1371666666666666,1,5,1,36849,568761,1165,106791,5.268451961910408,0.15807961489270997
1505,0.1371904761904762,0,2,0,36851,568759,1165,106791,5.268433435844233,0.15808008289541856
1506,0.1372777777777777,2,0,2,36851,568759,1167,106789,5.268433435844233,0.15807759034147092
1507,0.1373055555555555,0,4,0,36855,568755,1167,106789,5.268396383711883,0.15807852634321376
1508,0.1373333333333333,0,15,0,36870,568740,1167,106789,5.268257438215569,0.15808203644847224
1509,0.1373809523809523,0,1,0,36871,568739,1167,106789,5.268248175182482,0.15808227046103196
1510,0.1374523809523809,0,1,0,36872,568738,1167,106789,5.268238912149394,0.1580825044742845
1511,0.1374761904761904,0,1,0,36873,568737,1167,106789,5.268229649116306,0.1580827384882299
1512,0.1374999999999999,0,3,0,36876,568734,1167,106789,5.268201860017044,0.1580834405342231
1513,0.1375,6,180,6,37056,568554,1173,106783,5.266534514061284,0.15811809511399494
1514,0.1375974025974026,0,1,0,37057,568553,1173,106783,5.266525251028197,0.15811832924647878
1515,0.1376190476190476,0,3,0,37060,568550,1173,106783,5.266497461928934,0.15811903164809066
1516,0.1376666666666666,1,10,1,37070,568540,1174,106782,5.2664048315980585,0.15812012639896228
1517,0.1376666666666667,0,8,0,37078,568532,1174,106782,5.266330727333358,0.15812199954391587
1518,0.1377272727272727,0,2,0,37080,568530,1174,106782,5.266312201267183,0.15812246783708864
1519,0.1377380952380952,0,1,0,37081,568529,1174,106782,5.266302938234095,0.1581227019847152
1520,0.1377777777777777,0,1,0,37082,568528,1174,106782,5.266293675201008,0.15812293613303519
1521,0.1378333333333333,0,4,0,37086,568524,1174,106782,5.266256623068657,0.15812387273324982
1522,0.1378571428571428,0,4,0,37090,568520,1174,106782,5.2662195709363075,0.1581248093445599
1523,0.1379166666666667,0,3,0,37093,568517,1174,106782,5.266191781837045,0.15812551181032403
1524,0.1379999999999999,0,6,0,37099,568511,1174,106782,5.26613620363852,0.15812691676057652
1525,0.138,2,43,2,37142,568468,1176,106780,5.265737893215754,0.15813449280856812
1526,0.1380952380952381,0,1,0,37143,568467,1176,106780,5.265728630182667,0.15813472699619546
1527,0.1381666666666666,0,8,0,37151,568459,1176,106780,5.265654525917967,0.15813660052218548
1528,0.1381666666666667,0,1,0,37152,568458,1176,106780,5.265645262884879,0.15813683471605566
1529,0.1382142857142857,0,5,0,37157,568453,1176,106780,5.265598947719441,0.15813800569581166
1530,0.1382222222222222,0,1,0,37158,568452,1176,106780,5.265589684686354,0.1581382398938439
1531,0.13825,0,1,0,37159,568451,1176,106780,5.265580421653266,0.15813847409256981
1532,0.1382857142857142,0,1,0,37160,568450,1176,106780,5.265571158620179,0.1581387082919894
1533,0.1382936507936508,0,1,0,37161,568449,1176,106780,5.265561895587091,0.15813894249210267
1534,0.1383333333333333,10,196,10,37357,568253,1186,106770,5.26374634110193,0.15817238820010576
1535,0.1383809523809523,0,1,0,37358,568252,1186,106770,5.263737078068843,0.15817262252193262
1536,0.1384285714285714,0,1,0,37359,568251,1186,106770,5.263727815035756,0.15817285684445373
1537,0.1384999999999999,0,8,0,37367,568243,1186,106770,5.263653710771055,0.15817473144961652
1538,0.1385,0,4,0,37371,568239,1186,106770,5.263616658638704,0.15817566876886086
1539,0.1385238095238095,0,1,0,37372,568238,1186,106770,5.263607395605617,0.1581759031004077
1540,0.1385714285714285,0,1,0,37373,568237,1186,106770,5.26359813257253,0.15817613743264886
1541,0.1385833333333333,0,1,0,37374,568236,1186,106770,5.263588869539442,0.1581763717655843
1542,0.1386190476190476,0,1,0,37375,568235,1186,106770,5.2635796065063545,0.15817660609921408
1543,0.1386666666666666,1,17,1,37392,568218,1187,106769,5.263422134943866,0.15817934271326706
1544,0.13875,0,4,0,37396,568214,1187,106769,5.263385082811515,0.15818028009594315
1545,0.1387857142857143,0,1,0,37397,568213,1187,106769,5.263375819778428,0.15818051444334813
1546,0.1389166666666667,0,1,0,37398,568212,1187,106769,5.263366556745341,0.15818074879144747
1547,0.1389285714285714,0,2,0,37400,568210,1187,106769,5.263348030679166,0.1581812174897293
1548,0.1389999999999999,0,1,0,37401,568209,1187,106769,5.263338767646078,0.1581814518399118
1549,0.139,1,31,1,37432,568178,1188,106768,5.263051613620364,0.1581874698123998
1550,0.139047619047619,0,3,0,37435,568175,1188,106768,5.263023824521102,0.15818817292719534
1551,0.1390555555555555,0,2,0,37437,568173,1188,106768,5.263005298454926,0.15818864167386482
1552,0.1391190476190476,0,1,0,37438,568172,1188,106768,5.262996035421838,0.15818887604824133
1553,0.1391666666666666,3,38,3,37476,568134,1191,106765,5.262644040164512,0.15819404088611777
1554,0.1391666666666667,1,24,1,37500,568110,1192,106764,5.26242172737041,0.15819841926048417
1555,0.1392619047619047,0,1,0,37501,568109,1192,106764,5.262412464337323,0.15819865367261693
1556,0.1392857142857143,0,4,0,37505,568105,1192,106764,5.262375412204972,0.15819959132809477
1557,0.1393333333333333,0,24,0,37529,568081,1192,106764,5.262153099410871,0.1582052174943876
1558,0.1393571428571428,0,1,0,37530,568080,1192,106764,5.262143836377784,0.1582054519266675
1559,0.1393650793650794,0,3,0,37533,568077,1192,106764,5.2621160472785204,0.15820615522767587
1560,0.1394285714285714,1,0,1,37533,568077,1193,106763,5.2621160472785204,0.15820490783000415
1561,0.1394444444444444,0,1,0,37534,568076,1193,106763,5.262106784245433,0.15820514226356214
1562,0.1394999999999999,0,11,0,37545,568065,1193,106763,5.26200489088147,0.15820772107855632
1563,0.1395,0,6,0,37551,568059,1193,106763,5.261949312682945,0.15820912774035228
1564,0.1395238095238095,0,3,0,37554,568056,1193,106763,5.261921523583682,0.1582098310806305
1565,0.1395555555555555,0,1,0,37555,568055,1193,106763,5.261912260550595,0.15821006552877961
1566,0.1395833333333333,0,1,0,37556,568054,1193,106763,5.261902997517507,0.15821029997762356
1567,0.1396666666666666,0,7,0,37563,568047,1193,106763,5.2618381562858945,0.15821194113898726
1568,0.1396666666666667,1,0,1,37563,568047,1194,106762,5.2618381562858945,0.1582106936925856
1569,0.1396904761904761,0,1,0,37564,568046,1194,106762,5.261828893252806,0.15821092814548732
1570,0.1397222222222222,0,1,0,37565,568045,1194,106762,5.261819630219719,0.15821116259908388
1571,0.1397499999999999,0,1,0,37566,568044,1194,106762,5.261810367186632,0.15821139705337534
1572,0.1397619047619047,1,3,1,37569,568041,1195,106761,5.261782578087369,0.1582108529613131
1573,0.1397775443510737,0,1,0,37570,568040,1195,106761,5.261773315054281,0.1582110874168829
1574,0.1398333333333333,0,6,0,37576,568034,1195,106761,5.261717736855756,0.15821249416489452
1575,0.1398571428571428,0,1,0,37577,568033,1195,106761,5.261708473822669,0.15821272862532862
1576,0.1399545454545454,0,1,0,37578,568032,1195,106761,5.261699210789581,0.15821296308645763
1577,0.1399999999999999,1,18,1,37596,568014,1196,106760,5.261532476194005,0.15821593600227632
1578,0.14,77,2342,77,39938,565672,1273,106683,5.239838452702953,0.158670642740814
1579,0.1400833333333333,0,1,0,39939,565671,1273,106683,5.239829189669866,0.1586708787335243
1580,0.1401428571428571,0,1,0,39940,565670,1273,106683,5.239819926636778,0.1586711147269366
1581,0.1401666666666666,0,1,0,39941,565669,1273,106683,5.2398106636036905,0.15867135072105087
1582,0.1403333333333333,0,9,0,39950,565660,1273,106683,5.239727296305903,0.15867347469966966
1583,0.1403571428571428,0,2,0,39952,565658,1273,106683,5.239708770239727,0.15867394670264048
1584,0.1403787878787878,0,1,0,39953,565657,1273,106683,5.23969950720664,0.15867418270517894
1585,0.1404166666666666,0,1,0,39954,565656,1273,106683,5.239690244173552,0.15867441870841942
1586,0.1404166666666667,0,1,0,39955,565655,1273,106683,5.239680981140465,0.15867465471236195
1587,0.1404444444444444,0,2,0,39957,565653,1273,106683,5.239662455074289,0.15867512672235312
1588,0.1404761904761905,0,1,0,39958,565652,1273,106683,5.239653192041202,0.15867536272840177
1589,0.1405,0,11,0,39969,565641,1273,106683,5.239551298677239,0.15867795884127295
1590,0.1405555555555555,0,1,0,39970,565640,1273,106683,5.239542035644151,0.1586781948557464
1591,0.1405833333333333,0,2,0,39972,565638,1273,106683,5.239523509577976,0.1586786668867996
1592,0.140595238095238,0,1,0,39973,565637,1273,106683,5.239514246544888,0.15867890290337935
1593,0.1406428571428571,0,1,0,39974,565636,1273,106683,5.239504983511801,0.15867913892066118
1594,0.1406666666666666,0,18,0,39992,565618,1273,106683,5.2393382489162255,0.1586833873517963
1595,0.1406666666666667,0,5,0,39997,565613,1273,106683,5.2392919337507875,0.15868456751192928
1596,0.1406904761904762,0,4,0,40001,565609,1273,106683,5.239254881618437,0.15868551165267472
1597,0.1407142857142857,0,5,0,40006,565604,1273,106683,5.239208566453,0.15868669184440573
1598,0.14075,0,2,0,40008,565602,1273,106683,5.239190040386824,0.1586871639260135
1599,0.1408333333333333,2,50,2,40058,565552,1275,106681,5.2387268887324465,0.1586964638748767
1600,0.140833916083916,0,1,0,40059,565551,1275,106681,5.238717625699359,0.15869669994882718
1601,0.1409523809523809,1,0,1,40059,565551,1276,106680,5.238717625699359,0.15869544843959887
1602,0.141,3,30,3,40089,565521,1279,106677,5.238439734706732,0.15869877625342532
1603,0.1410714285714285,1,2,1,40091,565519,1280,106676,5.238421208640557,0.15869799686102992
1604,0.1411111111111111,0,2,0,40093,565517,1280,106676,5.238402682574383,0.15869846904088558
1605,0.1411363636363636,1,1,1,40094,565516,1281,106675,5.2383934195412944,0.15869745355114842
1606,0.1411666666666666,0,3,0,40097,565513,1281,106675,5.238365630442032,0.1586981618237755
1607,0.1411904761904762,0,3,0,40100,565510,1281,106675,5.238337841342769,0.1586988701027247
1608,0.14125,0,4,0,40104,565506,1281,106675,5.238300789210419,0.15869981448449152
1609,0.1413095238095238,0,1,0,40105,565505,1281,106675,5.238291526177331,0.15870005058168943
1610,0.1413333333333333,0,17,0,40122,565488,1281,106675,5.238134054614843,0.1587040643415362
1611,0.1414166666666666,0,1,0,40123,565487,1281,106675,5.238124791581756,0.1587043004513793
1612,0.1414285714285714,0,9,0,40132,565478,1281,106675,5.238041424283968,0.15870642547158162
1613,0.1414393939393939,0,2,0,40134,565476,1281,106675,5.2380228982177925,0.15870689770602142
1614,0.1415,0,7,0,40141,565469,1281,106675,5.237958056986179,0.15870855054869196
1615,0.1415235042735042,0,1,0,40142,565468,1281,106675,5.237948793953092,0.15870878667188382
1616,0.1415555555555555,0,1,0,40143,565467,1281,106675,5.237939530920005,0.15870902279577828
1617,0.1416666666666666,7,118,7,40261,565349,1288,106668,5.236846493015673,0.15872812741344342
1618,0.1416666666666667,2,47,2,40308,565302,1290,106666,5.236411130460558,0.1587367255583599
1619,0.1417857142857143,0,1,0,40309,565301,1290,106666,5.23640186742747,0.15873696178532576
1620,0.1418095238095238,0,1,0,40310,565300,1290,106666,5.236392604394383,0.1587371980129947
1621,0.1418333333333333,0,5,0,40315,565295,1290,106666,5.236346289228945,0.15873837916188588
1622,0.1419761904761904,0,1,0,40316,565294,1290,106666,5.236337026195858,0.15873861539377343
1623,0.142,5,41,5,40357,565253,1295,106661,5.235957241839268,0.15874204139220197
1624,0.1420714285714285,0,1,0,40358,565252,1295,106661,5.2359479788061805,0.1587422776460643
1625,0.1420833333333333,0,4,0,40362,565248,1295,106661,5.23591092667383,0.1587432226685459
1626,0.1421111111111111,0,1,0,40363,565247,1295,106661,5.2359016636407425,0.15874345892592437
1627,0.1421428571428571,0,7,0,40370,565240,1295,106661,5.23583682240913,0.15874511274726485
1628,0.1421515151515151,0,2,0,40372,565238,1295,106661,5.235818296342955,0.1587455852739772
1629,0.1421666666666666,1,2,1,40374,565236,1296,106660,5.235799770276779,0.15874480574374605
1630,0.1422142857142857,0,1,0,40375,565235,1296,106660,5.235790507243692,0.15874504200805184
1631,0.1422222222222222,0,1,0,40376,565234,1296,106660,5.235781244210604,0.15874527827306092
1632,0.1422424242424242,0,2,0,40378,565232,1296,106660,5.2357627181444295,0.15874575080518893
1633,0.14225,0,1,0,40379,565231,1296,106660,5.235753455111341,0.15874598707230786
1634,0.1422857142857143,0,1,0,40380,565230,1296,106660,5.235744192078254,0.15874622334013008
1635,0.1423333333333333,0,21,0,40401,565209,1296,106660,5.235549668383415,0.15875118512686254
1636,0.1423809523809523,0,6,0,40407,565203,1296,106660,5.23549409018489,0.15875260283718556
1637,0.1425,11,190,11,40597,565013,1307,106649,5.2337341138982545,0.15878373348499691
1638,0.142547619047619,0,1,0,40598,565012,1307,106649,5.233724850865167,0.15878396988957227
1639,0.1426190476190476,0,9,0,40607,565003,1307,106649,5.2336414835673795,0.15878609756242817
1640,0.1426666666666666,0,23,0,40630,564980,1307,106649,5.233428433806366,0.15879153520768163
1641,0.1426666666666667,0,1,0,40631,564979,1307,106649,5.233419170773278,0.1587917716354887
1642,0.1427738095238095,0,3,0,40634,564976,1307,106649,5.233391381674015,0.1587924809231342
1643,0.1427777777777777,0,3,0,40637,564973,1307,106649,5.233363592574753,0.1587931902171162
1644,0.1427857142857143,2,1,2,40638,564972,1309,106647,5.233354329541665,0.1587909216386076
1645,0.1428095238095238,0,1,0,40639,564971,1309,106647,5.233345066508577,0.1587911580690214
1646,0.1428333333333333,0,3,0,40642,564968,1309,106647,5.233317277409315,0.15879186736448708
1647,0.1428571428571428,1,6,1,40648,564962,1310,106646,5.233261699210789,0.15879203344808282
1648,0.1428888888888888,0,1,0,40649,564961,1310,106646,5.233252436177702,0.15879226988402445
1649,0.1429166666666667,0,1,0,40650,564960,1310,106646,5.233243173144614,0.15879250632067016
1650,0.1429523809523809,0,2,0,40652,564958,1310,106646,5.23322464707844,0.15879297919607388
1651,0.1429761904761904,0,3,0,40655,564955,1310,106646,5.233196857979177,0.1587936885144602
1652,0.143,2,30,2,40685,564925,1312,106644,5.23291896698655,0.15879827687102888
1653,0.143095238095238,0,1,0,40686,564924,1312,106644,5.232909703953463,0.15879851332999786
1654,0.1430952380952381,0,1,0,40687,564923,1312,106644,5.232900440920375,0.158798749789671
1655,0.1431666666666666,0,4,0,40691,564919,1312,106644,5.232863388788025,0.15879969563540577
1656,0.1431666666666667,0,5,0,40696,564914,1312,106644,5.232817073622587,0.15880087795841907
1657,0.1433333333333333,19,391,19,41087,564523,1331,106625,5.229195227685353,0.15886957869203217
1658,0.1434523809523809,0,1,0,41088,564522,1331,106625,5.229185964652266,0.15886981540556688
1659,0.1435,0,16,0,41104,564506,1331,106625,5.229037756122865,0.15887360291805921
1660,0.1435714285714285,1,2,1,41106,564504,1332,106624,5.229019230056689,0.15887282306802875
1661,0.1436111111111111,1,2,1,41108,564502,1333,106623,5.229000703990515,0.15887204321102627
1662,0.1436666666666666,0,10,0,41118,564492,1333,106623,5.228908073659639,0.15887441049596568
1663,0.1436904761904761,0,1,0,41119,564491,1333,106623,5.228898810626552,0.15887464722833974
1664,0.14375,0,4,0,41123,564487,1333,106623,5.228861758494201,0.158875594164891
1665,0.1438095238095238,0,2,0,41125,564485,1333,106623,5.2288432324280265,0.15887606763739964
1666,0.1438571428571428,0,2,0,41127,564483,1333,106623,5.228824706361851,0.15887654111273034
1667,0.1439285714285714,0,2,0,41129,564481,1333,106623,5.228806180295676,0.15887701459088308
1668,0.144,4,71,4,41200,564410,1337,106619,5.22814850494646,0.1588888110647975
1669,0.144047619047619,0,1,0,41201,564409,1337,106619,5.2281392419133725,0.15888904784897204
1670,0.1440833333333333,0,1,0,41202,564408,1337,106619,5.228129978880284,0.1588892846338523
1671,0.1440930735930735,0,2,0,41204,564406,1337,106619,5.228111452814109,0.15888975820573004
1672,0.1441190476190476,0,1,0,41205,564405,1337,106619,5.228102189781022,0.15888999499272755
1673,0.1441666666666666,1,65,1,41270,564340,1338,106618,5.227500092630331,0.15890413408886994
1674,0.1442857142857143,0,15,0,41285,564325,1338,106618,5.227361147134018,0.1589076866440219
1675,0.1443333333333333,2,14,2,41299,564311,1340,106616,5.227231464670791,0.15890849526103437
1676,0.1443809523809524,1,1,1,41300,564310,1341,106615,5.227222201637704,0.15890747848120132
1677,0.1444444444444444,0,4,0,41304,564306,1341,106615,5.227185149505354,0.1589084258802452
1678,0.1445,1,16,1,41320,564290,1342,106614,5.227036940975953,0.15891096192599835
1679,0.1445238095238095,0,1,0,41321,564289,1342,106614,5.227027677942866,0.15891119878730606
1680,0.1445833333333333,1,1,1,41322,564288,1343,106613,5.227018414909778,0.15891018197915938
1681,0.1446190476190476,0,1,0,41323,564287,1343,106613,5.227009151876691,0.1589104188403637
1682,0.1446428571428571,0,3,0,41326,564284,1343,106613,5.226981362777428,0.15891112942821328
1683,0.1446666666666666,0,11,0,41337,564273,1343,106613,5.226879469413465,0.1589137349713662
1684,0.1446666666666667,0,1,0,41338,564272,1343,106613,5.226870206380378,0.1589139718431624
1685,0.1447142857142857,0,1,0,41339,564271,1343,106613,5.2268609433472895,0.1589142087156647
1686,0.1447857142857142,0,4,0,41343,564267,1343,106613,5.22682389121494,0.1589151562127355
1687,0.1448030303030303,0,2,0,41345,564265,1343,106613,5.226805365148764,0.1589156299655079
1688,0.1448333333333333,0,6,0,41351,564259,1343,106613,5.226749786950239,0.1589170512407732
1689,0.1449166666666666,0,1,0,41352,564258,1343,106613,5.226740523917152,0.15891728812245573
1690,0.1449285714285714,0,1,0,41353,564257,1343,106613,5.226731260884064,0.15891752500484446
1691,0.145,25,802,25,42155,563455,1368,106588,5.219302308347846,0.15907635778599283
1692,0.1450555555555555,1,1,1,42156,563454,1369,106587,5.219293045314758,0.15907534016575106
1693,0.1450757575757575,0,1,0,42157,563453,1369,106587,5.2192837822816704,0.15907557757745805
1694,0.145095238095238,0,2,0,42159,563451,1369,106587,5.219265256215495,0.15907605240299805
1695,0.1451190476190476,0,2,0,42161,563449,1369,106587,5.21924673014932,0.15907652723137264
1696,0.1451666666666666,1,4,1,42165,563445,1370,106586,5.21920967801697,0.15907622184645187
1697,0.1452261904761904,0,3,0,42168,563442,1370,106586,5.219181888917707,0.1590769340982765
1698,0.14525,1,0,1,42168,563442,1371,106585,5.219181888917707,0.15907567903979988
1699,0.1453333333333333,1,13,1,42181,563429,1372,106584,5.219061469487569,0.15907751043636467
1700,0.1453571428571428,0,1,0,42182,563428,1372,106584,5.2190522064544815,0.15907774786123233
1701,0.1454166666666666,0,4,0,42186,563424,1372,106584,5.219015154322131,0.15907869756779022
1702,0.1454444444444444,0,1,0,42187,563423,1372,106584,5.219005891289044,0.15907893499620154
1703,0.1454761904761904,0,2,0,42189,563421,1372,106584,5.218987365222868,0.15907940985515034
1704,0.1455,2,5,2,42194,563416,1374,106582,5.218941050057431,0.15907808680025912
1705,0.1455238095238095,0,1,0,42195,563415,1374,106582,5.218931787024343,0.15907832423130253
1706,0.1455555555555555,0,1,0,42196,563414,1374,106582,5.218922523991256,0.1590785616630547
1707,0.1456666666666666,1,16,1,42212,563398,1375,106581,5.218774315461855,0.15908110552718815
1708,0.1456666666666667,0,5,0,42217,563393,1375,106581,5.218728000296417,0.15908229274568864
1709,0.1457142857142856,0,1,0,42218,563392,1375,106581,5.2187187372633295,0.1590825301915152
1710,0.1457142857142857,1,12,1,42230,563380,1376,106580,5.218607580866279,0.1590841244253388
1711,0.1458333333333333,3,56,3,42286,563324,1379,106577,5.218088851013376,0.15909365712247034
1712,0.1458888888888888,0,2,0,42288,563322,1379,106577,5.218070324947201,0.15909413210051068
1713,0.1459285714285714,0,1,0,42289,563321,1379,106577,5.2180610619141135,0.1590943695905944
1714,0.1459523809523809,0,3,0,42292,563318,1379,106577,5.218033272814851,0.15909508206509976
1715,0.146,4,78,4,42370,563240,1383,106573,5.2173107562340215,0.15910858702354239
1716,0.146047619047619,0,2,0,42372,563238,1383,106573,5.217292230167846,0.15910906210856496
1717,0.1460714285714285,0,3,0,42375,563235,1383,106573,5.217264441068584,0.15910977474141844
1718,0.146095238095238,0,2,0,42377,563233,1383,106573,5.217245915002408,0.1591102498335339
1719,0.1461111111111111,0,1,0,42378,563232,1383,106573,5.217236651969321,0.15911048738065556
1720,0.1461309523809523,0,1,0,42379,563231,1383,106573,5.217227388936234,0.15911072492848655
1721,0.1461601731601731,0,1,0,42380,563230,1383,106573,5.217218125903146,0.15911096247702683
1722,0.1461666666666666,0,5,0,42385,563225,1383,106573,5.217171810737708,0.15911215023036795
1723,0.1461904761904761,0,3,0,42388,563222,1383,106573,5.217144021638445,0.15911286289088453
1724,0.1462142857142857,0,1,0,42389,563221,1383,106573,5.217134758605358,0.1591131004458087
1725,0.14625,0,2,0,42391,563219,1383,106573,5.217116232539182,0.1591135755577851
1726,0.1463333333333333,0,13,0,42404,563206,1383,106573,5.216995813109045,0.1591166638547939
1727,0.1464047619047619,0,4,0,42408,563202,1383,106573,5.216958760976694,0.15911761412414616
1728,0.1464285714285714,0,2,0,42410,563200,1383,106573,5.216940234910519,0.1591180892630787
1729,0.1464444444444444,0,1,0,42411,563199,1383,106573,5.2169309718774315,0.15911832683360905
1730,0.1464523809523809,0,1,0,42412,563198,1383,106573,5.216921708844344,0.1591185644048488
1731,0.1465,1,19,1,42431,563179,1384,106572,5.2167457112156805,0.159121822886416
1732,0.1465238095238095,0,1,0,42432,563178,1384,106572,5.216736448182593,0.15912206047032476
1733,0.1466666666666666,17,391,17,42823,562787,1401,106555,5.213114602245359,0.1591936558590377
1734,0.1467261904761904,0,1,0,42824,562786,1401,106555,5.213105339212271,0.15919389369544074
1735,0.1467619047619047,0,1,0,42825,562785,1401,106555,5.213096076179184,0.15919413153255446
1736,0.1468333333333333,0,5,0,42830,562780,1401,106555,5.213049761013746,0.15919532072878304
1737,0.146845238095238,0,2,0,42832,562778,1401,106555,5.213031234947572,0.1591957964122492
1738,0.1468690476190476,0,1,0,42833,562777,1401,106555,5.2130219719144835,0.15919603425504833
1739,0.1469047619047619,0,1,0,42834,562776,1401,106555,5.213012708881396,0.1591962720985581
1740,0.1469444444444444,0,2,0,42836,562774,1401,106555,5.212994182815221,0.15919674778770979
1741,0.1469523809523809,0,2,0,42838,562772,1401,106555,5.2129756567490455,0.15919722347970425
1742,0.1469999999999999,0,1,0,42839,562771,1401,106555,5.212966393715958,0.15919746132676751
1743,0.147,1,34,1,42873,562737,1402,106554,5.212651450590982,0.15920429230334787
1744,0.1470238095238095,0,2,0,42875,562735,1402,106554,5.212632924524806,0.15920476804489542
1745,0.1471428571428571,0,13,0,42888,562722,1402,106554,5.212512505094669,0.1592078604342603
1746,0.1471666666666666,0,3,0,42891,562719,1402,106554,5.212484715995406,0.15920857407963565
1747,0.1472222222222222,1,1,1,42892,562718,1403,106553,5.212475452962318,0.15920755568372155
1748,0.1472272727272727,0,2,0,42894,562716,1403,106553,5.2124569268961425,0.1592080314492379
1749,0.1472539682539682,1,0,1,42894,562716,1404,106552,5.2124569268961425,0.15920677516331275
1750,0.1472857142857143,0,1,0,42895,562715,1404,106552,5.212447663863055,0.15920701304561558
1751,0.1473333333333333,1,25,1,42920,562690,1405,106551,5.212216088035866,0.15921170400498474
1752,0.1473809523809523,0,1,0,42921,562689,1405,106551,5.212206825002779,0.1592119419042496
1753,0.1473809523809524,1,0,1,42921,562689,1406,106550,5.212206825002779,0.1592106855697292
1754,0.1474285714285714,0,1,0,42922,562688,1406,106550,5.212197561969691,0.15921092346818322
1755,0.1475,5,179,5,43101,562509,1411,106545,5.210539479047019,0.15924723564914042
1756,0.1476190476190476,0,1,0,43102,562508,1411,106545,5.2105302160139315,0.15924747366800537
1757,0.1476666666666666,0,6,0,43108,562502,1411,106545,5.210474637815406,0.1592489017961369
1758,0.14775,0,1,0,43109,562501,1411,106545,5.210465374782319,0.15924913981998248
1759,0.1477777777777777,0,2,0,43111,562499,1411,106545,5.210446848716144,0.15924961586980826
1760,0.1477857142857143,0,2,0,43113,562497,1411,106545,5.210428322649968,0.1592500919224802
1761,0.147797619047619,1,0,1,43113,562497,1412,106544,5.210428322649968,0.1592488352731746
1762,0.1478095238095238,0,1,0,43114,562496,1412,106544,5.210419059616881,0.15924907329905535
1763,0.1478333333333333,0,4,0,43118,562492,1412,106544,5.21038200748453,0.15925002540969393
1764,0.1478571428571428,1,12,1,43130,562480,1413,106543,5.21027085108748,0.15925162513097457
1765,0.148,3,51,3,43181,562429,1416,106540,5.209798436400015,0.1592599956051775
1766,0.1480555555555555,0,4,0,43185,562425,1416,106540,5.209761384267664,0.1592609478821762
1767,0.148095238095238,0,7,0,43192,562418,1416,106540,5.209696543036052,0.1592626143943267
1768,0.1480952380952381,0,2,0,43194,562416,1416,106540,5.209678016969876,0.1592630905470614
1769,0.1481111111111111,0,1,0,43195,562415,1416,106540,5.209668753936789,0.1592633286244964
1770,0.1481666666666666,0,5,0,43200,562410,1416,106540,5.209622438771351,0.15926451902234845
1771,0.1482142857142857,0,3,0,43203,562407,1416,106540,5.209594649672089,0.15926523326960132
1772,0.1483095238095238,0,1,0,43204,562406,1416,106540,5.209585386639001,0.15926547135344257
1773,0.1483174603174603,0,3,0,43207,562403,1416,106540,5.209557597539739,0.15926618560923725
1774,0.1483333333333333,3,202,3,43409,562201,1419,106537,5.207686464856052,0.1593105222075013
1775,0.1483412698412698,1,1,1,43410,562200,1420,106536,5.207677201822965,0.15930950330175137
1776,0.1483571428571428,0,3,0,43413,562197,1420,106536,5.207649412723702,0.15931021797937292
1777,0.1484285714285714,0,1,0,43414,562196,1420,106536,5.207640149690615,0.15931045620667172
1778,0.1484761904761905,0,2,0,43416,562194,1420,106536,5.20762162362444,0.15931093266340676
1779,0.1485,0,12,0,43428,562182,1420,106536,5.207510467227389,0.1593137914636663
1780,0.1485714285714285,0,4,0,43432,562178,1420,106536,5.207473415095039,0.15931474441988652
1781,0.1486190476190476,0,1,0,43433,562177,1420,106536,5.207464152061951,0.15931498266072291
1782,0.1486666666666666,2,18,2,43451,562159,1422,106534,5.207297417466375,0.15931675671795578
1783,0.1486904761904761,0,2,0,43453,562157,1422,106534,5.2072788914002,0.15931723322132346
1784,0.1486904761904762,0,2,0,43455,562155,1422,106534,5.207260365334025,0.1593177097275415
1785,0.1487142857142857,0,2,0,43457,562153,1422,106534,5.20724183926785,0.15931818623660995
1786,0.14875,1,2,1,43459,562151,1423,106533,5.207223313201675,0.1593174055308636
1787,0.1487857142857143,0,1,0,43460,562150,1423,106533,5.207214050168587,0.15931764378636812
1788,0.1488095238095238,0,3,0,43463,562147,1423,106533,5.2071862610693245,0.1593183585571574
1789,0.1488333333333333,0,5,0,43468,562142,1423,106533,5.2071399459038865,0.15931954985605862
1790,0.1488571428571428,0,1,0,43469,562141,1423,106533,5.207130682870799,0.15931978811797678
1791,0.1488888888888888,0,1,0,43470,562140,1423,106533,5.207121419837712,0.15932002638060755
1792,0.1489166666666666,0,1,0,43471,562139,1423,106533,5.207112156804624,0.159320264643951
1793,0.1489285714285714,0,1,0,43472,562138,1423,106533,5.207102893771537,0.1593205029080071
1794,0.149,2,52,2,43524,562086,1425,106531,5.2066212160509835,0.1593303789763048
1795,0.149047619047619,0,2,0,43526,562084,1425,106531,5.206602689984809,0.1593308555745833
1796,0.1491515151515151,0,1,0,43527,562083,1425,106531,5.206593426951721,0.15933109387479175
1797,0.1491666666666666,1,63,1,43590,562020,1426,106530,5.206009855867205,0.15934485079649988
1798,0.1492380952380952,0,1,0,43591,562019,1426,106530,5.206000592834117,0.1593450891408109
1799,0.14925,0,1,0,43592,562018,1426,106530,5.20599132980103,0.15934532748583496
1800,0.1492857142857143,0,7,0,43599,562011,1426,106530,5.205926488569417,0.1593469959209682
1801,0.1493333333333333,1,22,1,43621,561989,1427,106529,5.205722701841491,0.15935098232209155
1802,0.1493625541125541,0,2,0,43623,561987,1427,106529,5.205704175775316,0.15935145905258813
1803,0.1493888888888889,0,1,0,43624,561986,1427,106529,5.205694912742229,0.1593516974189061
1804,0.1494047619047619,0,1,0,43625,561985,1427,106529,5.205685649709141,0.15935193578593718
1805,0.1494444444444444,0,4,0,43629,561981,1427,106529,5.205648597576791,0.15935288926119281
1806,0.1494999999999999,0,1,0,43630,561980,1427,106529,5.205639334543703,0.15935312763178955
1807,0.1495,0,8,0,43638,561972,1427,106529,5.205565230279003,0.1593550346222369
1808,0.1495238095238095,0,8,0,43646,561964,1427,106529,5.205491126014302,0.159356941658327
1809,0.149547619047619,0,3,0,43649,561961,1427,106529,5.20546333691504,0.1593576568086284
1810,0.1496190476190476,0,2,0,43651,561959,1427,106529,5.2054448108488645,0.159358133579062
1811,0.1496666666666666,1,3,1,43654,561956,1428,106528,5.205417021749602,0.15935759120637144
1812,0.1496666666666667,1,1,1,43655,561955,1429,106527,5.205407758716514,0.15935657205429615
1813,0.1497142857142857,0,1,0,43656,561954,1429,106527,5.2053984956834265,0.1593568104403865
1814,0.1497272727272727,0,1,0,43657,561953,1429,106527,5.205389232650339,0.15935704882719004
1815,0.1497619047619047,0,9,0,43666,561944,1429,106527,5.2053058653525515,0.1593591943405174
1816,0.1497727272727272,0,1,0,43667,561943,1429,106527,5.205296602319463,0.1593594327344533
1817,0.1498333333333333,0,6,0,43673,561937,1429,106527,5.205241024120938,0.15936086311304723
1818,0.1498650793650793,0,1,0,43674,561936,1429,106527,5.205231761087851,0.159361101511976
1819,0.1498809523809523,0,2,0,43676,561934,1429,106527,5.2052132350216755,0.1593615783119733
1820,0.1498809523809524,0,1,0,43677,561933,1429,106527,5.205203971988588,0.15936181671304192
1821,0.1499404761904761,0,2,0,43679,561931,1429,106527,5.205185445922413,0.15936229351731895
1822,0.15,94,2441,94,46120,559490,1523,106433,5.182574382155693,0.15982778789739954
1823,0.1500555555555555,0,2,0,46122,559488,1523,106433,5.182555856089518,0.1598282679176659
1824,0.1500714285714285,1,1,1,46123,559487,1524,106432,5.18254659305643,0.15982724625667685
1825,0.1501428571428571,0,1,0,46124,559486,1524,106432,5.182537330023343,0.15982748626707793
1826,0.1501666666666666,0,9,0,46133,559477,1524,106432,5.182453962725555,0.15982964639312577
1827,0.15025,0,1,0,46134,559476,1524,106432,5.182444699692467,0.15982988641073542
1828,0.1502857142857142,0,1,0,46135,559475,1524,106432,5.18243543665938,0.1598301264290659
1829,0.1503333333333333,1,10,1,46145,559465,1525,106431,5.182342806328505,0.15983126494227326
1830,0.1503571428571428,0,2,0,46147,559463,1525,106431,5.182324280262329,0.15983174499244623
1831,0.1504166666666666,1,1,1,46148,559462,1526,106430,5.182315017229241,0.15983072330047515
1832,0.1504285714285714,0,2,0,46150,559460,1526,106430,5.182296491163067,0.15983120335190498
1833,0.1504761904761904,0,2,0,46152,559458,1526,106430,5.182277965096891,0.15983168340621845
1834,0.1505,1,7,1,46159,559451,1527,106429,5.182213123865279,0.15983210188021865
1835,0.1505555555555555,0,1,0,46160,559450,1527,106429,5.182203860832191,0.159832341911969
1836,0.150579365079365,0,2,0,46162,559448,1527,106429,5.182185334766015,0.15983282197763252
1837,0.1505952380952381,0,1,0,46163,559447,1527,106429,5.182176071732928,0.1598330620115457
1838,0.1506190476190476,0,1,0,46164,559446,1527,106429,5.182166808699841,0.15983330204617985
1839,0.1506666666666666,2,35,2,46199,559411,1529,106427,5.181842602541776,0.15983918010086537
1840,0.1507142857142857,0,3,0,46202,559408,1529,106427,5.1818148134425135,0.1598399002755938
1841,0.1507857142857143,0,1,0,46203,559407,1529,106427,5.181805550409426,0.15984014033527877
1842,0.1508333333333333,4,67,4,46270,559340,1533,106423,5.18118492719256,0.1598511782721479
1843,0.1508571428571428,0,3,0,46273,559337,1533,106423,5.1811571380932975,0.1598518985820716
1844,0.1509126984126984,0,1,0,46274,559336,1533,106423,5.181147875060209,0.1598521386868221
1845,0.1509523809523809,0,4,0,46278,559332,1533,106423,5.1811108229278595,0.15985309911303708
1846,0.1509761904761904,2,2,2,46280,559330,1535,106421,5.181092296861684,0.15985105542462572
1847,0.151,1,27,1,46307,559303,1536,106420,5.180842194968321,0.15985627655946993
1848,0.1510952380952381,0,2,0,46309,559301,1536,106420,5.180823668902145,0.15985675680953432
1849,0.1511666666666666,0,5,0,46314,559296,1536,106420,5.1807773537367074,0.15985795744731987
1850,0.1511904761904761,0,1,0,46315,559295,1536,106420,5.18076809070362,0.15985819757704123
1851,0.15125,0,3,0,46318,559292,1536,106420,5.180740301604358,0.1598589179705338
1852,0.1512857142857142,0,1,0,46319,559291,1536,106420,5.1807310385712695,0.15985915810314086
1853,0.1513333333333333,0,13,0,46332,559278,1536,106420,5.180610619141132,0.15986227989268406
1854,0.1513888888888888,0,2,0,46334,559276,1536,106420,5.1805920930749565,0.15986276017882037
1855,0.1514166666666666,0,4,0,46338,559272,1536,106420,5.180555040942607,0.15986372075975075
1856,0.1514285714285714,0,4,0,46342,559268,1536,106420,5.180517988810256,0.15986468135222506
1857,0.1514523809523809,0,2,0,46344,559266,1536,106420,5.180499462744081,0.15986516165279124
1858,0.1515,0,2,0,46346,559264,1536,106420,5.180480936677906,0.1598656419562435
1859,0.151547619047619,0,5,0,46351,559259,1536,106420,5.180434621512468,0.1598668427275008
1860,0.1515555555555555,0,1,0,46352,559258,1536,106420,5.180425358479381,0.15986708288391685
1861,0.1516190476190476,0,1,0,46353,559257,1536,106420,5.180416095446293,0.15986732304105444
1862,0.1516666666666666,8,185,8,46538,559072,1544,106412,5.178702434325095,0.15990166555469404
1863,0.1517222222222222,0,1,0,46539,559071,1544,106412,5.178693171292008,0.15990190583380792
1864,0.15175,0,1,0,46540,559070,1544,106412,5.17868390825892,0.15990214611364395
1865,0.1517857142857143,0,4,0,46544,559066,1544,106412,5.17864685612657,0.15990310724020929
1866,0.1518333333333333,1,5,1,46549,559061,1545,106411,5.178600540961132,0.15990304625889595
1867,0.1518888888888888,0,1,0,46550,559060,1545,106411,5.178591277928045,0.1599032865444174
1868,0.1519047619047619,1,6,1,46556,559054,1546,106410,5.17853569972952,0.15990346585239773
1869,0.1519444444444444,1,0,1,46556,559054,1547,106409,5.17853569972952,0.15990220342828979
1870,0.152,4,56,4,46612,558998,1551,106405,5.178016969876617,0.1599106105623209
1871,0.1520515873015873,0,1,0,46613,558997,1551,106405,5.178007706843529,0.15991085088412718
1872,0.1520555555555555,1,0,1,46613,558997,1552,106404,5.178007706843529,0.1599095883534891
1873,0.1521190476190476,0,3,0,46616,558994,1552,106404,5.177979917744266,0.15991030931863337
1874,0.1521428571428571,0,1,0,46617,558993,1552,106404,5.177970654711179,0.1599105496417928
1875,0.1521666666666666,0,1,0,46618,558992,1552,106404,5.177961391678091,0.15991078996567457
1876,0.1522222222222222,0,5,0,46623,558987,1552,106404,5.177915076512654,0.1599119915959188
1877,0.15225,0,3,0,46626,558984,1552,106404,5.177887287413391,0.15991271258273368
1878,0.1522727272727272,0,1,0,46627,558983,1552,106404,5.177878024380303,0.15991295291311672
1879,0.1522857142857142,0,1,0,46628,558982,1552,106404,5.177868761347216,0.15991319324422215
1880,0.1522857142857143,0,1,0,46629,558981,1552,106404,5.177859498314128,0.15991343357604995
1881,0.1523333333333333,1,18,1,46647,558963,1553,106403,5.177692763718552,0.15991649708581443
1882,0.1523571428571428,0,1,0,46648,558962,1553,106403,5.177683500685465,0.15991673742983176
1883,0.1523809523809523,0,2,0,46650,558960,1553,106403,5.177664974619289,0.15991721812003373
1884,0.1524999999999999,0,3,0,46653,558957,1553,106403,5.177637185520027,0.15991793916075508
1885,0.1525,11,205,11,46858,558752,1564,106392,5.175738263737078,0.15995333341351647
1886,0.1526190476190476,0,1,0,46859,558751,1564,106392,5.17572900070399,0.15995357389313275
1887,0.1526388888888888,0,1,0,46860,558750,1564,106392,5.175719737670903,0.15995381437347214
1888,0.1526428571428571,0,1,0,46861,558749,1564,106392,5.175710474637816,0.1599540548545346
1889,0.1526666666666666,0,24,0,46885,558725,1564,106392,5.175488161843714,0.15995982661697114
1890,0.1526860916860917,0,1,0,46886,558724,1564,106392,5.175478898810627,0.15996006711611208
1891,0.1526904761904761,0,1,0,46887,558723,1564,106392,5.175469635777539,0.15996030761597618
1892,0.1527142857142857,0,1,0,46888,558722,1564,106392,5.1754603727444515,0.1599605481165635
1893,0.1528095238095238,0,1,0,46889,558721,1564,106392,5.175451109711364,0.15996078861787397
1894,0.1528333333333333,0,4,0,46893,558717,1564,106392,5.1754140575790135,0.15996175063034782
1895,0.1528571428571428,0,7,0,46900,558710,1564,106392,5.175349216347401,0.15996343418002051
1896,0.1529166666666666,0,2,0,46902,558708,1564,106392,5.175330690281226,0.1599639152007217
1897,0.1529523809523809,0,1,0,46903,558707,1564,106392,5.1753214272481385,0.15996415571215714
1898,0.153,1,31,1,46934,558676,1565,106391,5.175034273222424,0.15997034885207054
1899,0.1530238095238095,0,1,0,46935,558675,1565,106391,5.175025010189336,0.15997058938511366
1900,0.153047619047619,0,2,0,46937,558673,1565,106391,5.175006484123161,0.1599710704533699
1901,0.1530833333333333,0,1,0,46938,558672,1565,106391,5.174997221090074,0.15997131098858303
1902,0.1530952380952381,0,2,0,46940,558670,1565,106391,5.174978695023898,0.15997179206117934
1903,0.1531428571428571,1,0,1,46940,558670,1566,106390,5.174978695023898,0.15997052897482933
1904,0.1531666666666666,0,7,0,46947,558663,1566,106390,5.174913853792286,0.15997221274093945
1905,0.1531904761904761,0,1,0,46948,558662,1566,106390,5.174904590759199,0.15997245328184864
1906,0.1532142857142857,0,5,0,46953,558657,1566,106390,5.174858275593761,0.1599736559972453
1907,0.15325,0,1,0,46954,558656,1566,106390,5.1748490125606725,0.1599738965424948
1908,0.1533333333333333,15,408,15,47362,558248,1581,106375,5.171069695060951,0.16005314290958936
1909,0.1533928571428571,0,1,0,47363,558247,1581,106375,5.171060432027863,0.16005338372789346
1910,0.1534523809523809,0,1,0,47364,558246,1581,106375,5.171051168994776,0.16005362454692224
1911,0.1534999999999999,0,2,0,47366,558244,1581,106375,5.1710326429286,0.16005410618715385
1912,0.1535,1,13,1,47379,558231,1582,106374,5.170912223498462,0.16005597309680186
1913,0.1535714285714285,0,5,0,47384,558226,1582,106374,5.170865908333025,0.16005717724947335
1914,0.1536363636363636,0,1,0,47385,558225,1582,106374,5.170856645299937,0.16005741808218188
1915,0.1536666666666666,0,16,0,47401,558209,1582,106374,5.1707084367705365,0.16006127150408603
1916,0.1536969696969697,0,2,0,47403,558207,1582,106374,5.170689910704361,0.16006175319487015
1917,0.15375,1,5,1,47408,558202,1583,106373,5.170643595538923,0.16006169356355565
1918,0.1537619047619048,0,1,0,47409,558201,1583,106373,5.170634332505836,0.16006193441211963
1919,0.1538095238095237,0,1,0,47410,558200,1583,106373,5.170625069472748,0.16006217526140845
1920,0.1538095238095238,0,1,0,47411,558199,1583,106373,5.170615806439661,0.16006241611142208
1921,0.1538333333333333,0,4,0,47415,558195,1583,106373,5.170578754307311,0.16006337951872496
1922,0.1538452380952381,1,1,1,47416,558194,1584,106372,5.170569491274223,0.16006235648528513
1923,0.1539285714285714,0,1,0,47417,558193,1584,106372,5.170560228241135,0.16006259733810838
1924,0.154,7,72,7,47489,558121,1591,106365,5.169893289858831,0.16007109254371046
1925,0.1540952380952381,0,1,0,47490,558120,1591,106365,5.169884026825744,0.16007133343867808
1926,0.1541666666666666,2,54,2,47544,558066,1593,106363,5.169383823039016,0.16008181461074095
1927,0.1542222222222222,0,1,0,47545,558065,1593,106363,5.169374560005928,0.16008205554251176
1928,0.1542619047619047,0,1,0,47546,558064,1593,106363,5.169365296972841,0.1600822964750078
1929,0.1542857142857142,1,12,1,47558,558052,1594,106362,5.169254140575791,0.1600839235777693
1930,0.1543333333333333,0,15,0,47573,558037,1594,106362,5.169115195079477,0.1600875377596896
1931,0.1543809523809523,0,1,0,47574,558036,1594,106362,5.1691059320463895,0.16008777871095337
1932,0.1544166666666666,0,1,0,47575,558035,1594,106362,5.169096669013301,0.16008801966294248
1933,0.1544393939393939,0,1,0,47576,558034,1594,106362,5.169087405980214,0.16008826061565692
1934,0.1544444444444444,0,3,0,47579,558031,1594,106362,5.1690596168809515,0.16008898347815223
1935,0.1545,0,12,0,47591,558019,1594,106362,5.168948460483901,0.16009187499341493
1936,0.1545238095238095,0,5,0,47596,558014,1594,106362,5.168902145318463,0.1600930798222693
1937,0.1545833333333333,0,1,0,47597,558013,1594,106362,5.168892882285376,0.16009332079021638
1938,0.1545952380952381,0,1,0,47598,558012,1594,106362,5.168883619252288,0.1600935617588888
1939,0.1546666666666666,0,15,0,47613,557997,1594,106362,5.168744673755975,0.1600971763760256
1940,0.1547499999999999,0,1,0,47614,557996,1594,106362,5.168735410722887,0.1600974173563049
1941,0.1547619047619047,0,3,0,47617,557993,1594,106362,5.168707621623624,0.16009814030149544
1942,0.1548333333333333,0,4,0,47621,557989,1594,106362,5.168670569491274,0.16009910423857268
1943,0.1549999999999999,0,14,0,47635,557975,1594,106362,5.1685408870280485,0.16010247810975453
1944,0.155,37,817,37,48452,557158,1631,106325,5.160972988995517,0.16025278718520294
1945,0.1550714285714286,1,1,1,48453,557157,1632,106324,5.1609637259624295,0.16025176304973315
1946,0.1550833333333333,0,3,0,48456,557154,1632,106324,5.160935936863167,0.1602524876484224
1947,0.1551190476190476,0,1,0,48457,557153,1632,106324,5.160926673830079,0.160252729182775
1948,0.1551666666666666,0,10,0,48467,557143,1632,106324,5.160834043499204,0.16025514456634618
1949,0.1552380952380952,0,2,0,48469,557141,1632,106324,5.160815517433028,0.16025562765179777
1950,0.1553333333333333,1,28,1,48497,557113,1633,106323,5.160556152506577,0.16026112541375506
1951,0.1553571428571428,1,1,1,48498,557112,1634,106322,5.16054688947349,0.16026010123086848
1952,0.1554166666666666,0,4,0,48502,557108,1634,106322,5.160509837341139,0.16026106748262817
1953,0.1554285714285714,1,0,1,48502,557108,1635,106321,5.160509837341139,0.1602598017270876
1954,0.1554761904761904,0,1,0,48503,557107,1635,106321,5.160500574308052,0.1602600432903043
1955,0.1555,0,14,0,48517,557093,1635,106321,5.160370891844826,0.16026342525180354
1956,0.1555555555555555,0,2,0,48519,557091,1635,106321,5.1603523657786505,0.16026390840081275
1957,0.1556666666666666,0,26,0,48545,557065,1635,106321,5.160111526918374,0.16027018960303654
1958,0.1556904761904761,0,1,0,48546,557064,1635,106321,5.160102263885286,0.16027043119757003
1959,0.1557056277056277,1,0,1,48546,557064,1636,106320,5.160102263885286,0.16026916537028327
1960,0.1557142857142857,0,10,0,48556,557054,1636,106320,5.160009633554411,0.16027158134023944
1961,0.1557619047619047,0,2,0,48558,557052,1636,106320,5.159991107488236,0.16027206454297135
1962,0.1558333333333333,2,65,2,48623,556987,1638,106318,5.159389010337545,0.16028523831419936
1963,0.1558354978354978,0,1,0,48624,556986,1638,106318,5.159379747304458,0.1602854799609229
1964,0.1559523809523809,1,1,1,48625,556985,1639,106317,5.15937048427137,0.1602844556476537
1965,0.156,4,73,4,48698,556912,1643,106313,5.158694282855978,0.16029703343510876
1966,0.1560833333333333,1,2,1,48700,556910,1644,106312,5.158675756789803,0.16029625072750903
1967,0.1561111111111111,0,1,0,48701,556909,1644,106312,5.158666493756716,0.16029649242107835
1968,0.1561666666666666,0,6,0,48707,556903,1644,106312,5.1586109155581905,0.1602979425978001
1969,0.1561904761904761,0,3,0,48710,556900,1644,106312,5.158583126458928,0.16029866769600068
1970,0.1561904761904762,0,2,0,48712,556898,1644,106312,5.1585646003927526,0.16029915109844545
1971,0.15625,0,4,0,48716,556894,1644,106312,5.158527548260403,0.16030011791208162
1972,0.1562857142857142,0,2,0,48718,556892,1644,106312,5.158509022194227,0.1603006013232731
1973,0.1562857142857143,0,1,0,48719,556891,1644,106312,5.15849975916114,0.16030084302996217
1974,0.1563333333333333,1,7,1,48726,556884,1645,106311,5.158434917929527,0.1603012688575758
1975,0.1564285714285714,0,3,0,48729,556881,1645,106311,5.158407128830264,0.1603019939926899
1976,0.1564494949494949,0,6,0,48735,556875,1645,106311,5.158351550631739,0.16030344428259946
1977,0.1564523809523809,0,1,0,48736,556874,1645,106311,5.158342287598651,0.1603036860001357
1978,0.1565,0,4,0,48740,556870,1645,106311,5.158305235466301,0.16030465287757037
1979,0.1565238095238095,0,1,0,48741,556869,1645,106311,5.158295972433214,0.16030489459875147
1980,0.1566666666666666,16,458,16,49199,556411,1661,106295,5.154053503279114,0.16039540912561528
1981,0.1567142857142857,0,2,0,49201,556409,1661,106295,5.154034977212938,0.1603958931891161
1982,0.15675,0,2,0,49203,556407,1661,106295,5.154016451146764,0.16039637725553868
1983,0.1567857142857142,0,2,0,49205,556405,1661,106295,5.1539979250805885,0.16039686132488307
1984,0.1568333333333333,0,8,0,49213,556397,1661,106295,5.153923820815888,0.16039879763147888
1985,0.1568571428571428,0,1,0,49214,556396,1661,106295,5.153914557782801,0.16039903967309047
1986,0.1568939393939394,0,2,0,49216,556394,1661,106295,5.153896031716625,0.1603995237585051
1987,0.1569285714285714,0,1,0,49217,556393,1661,106295,5.153886768683538,0.16039976580230816
1988,0.1569415584415584,0,1,0,49218,556392,1661,106295,5.15387750565045,0.16040000784684172
1989,0.157,2,35,2,49253,556357,1663,106293,5.153553299492386,0.1604059458235871
1990,0.1570238095238095,0,1,0,49254,556356,1663,106293,5.153544036459298,0.16040618789132707
1991,0.1570555555555555,0,2,0,49256,556354,1663,106293,5.1535255103931235,0.16040667202899886
1992,0.1570833333333333,0,2,0,49258,556352,1663,106293,5.153506984326948,0.16040715616959306
1993,0.1571031746031746,0,1,0,49259,556351,1663,106293,5.153497721293861,0.1604073982409861
1994,0.1571269841269841,0,2,0,49261,556349,1663,106293,5.1534791952276855,0.16040788238596407
1995,0.1571309523809523,0,1,0,49262,556348,1663,106293,5.153469932194597,0.160408124459549
1996,0.1571428571428571,1,7,1,49269,556341,1664,106292,5.153405090962985,0.16040855194353434
1997,0.1572380952380952,0,1,0,49270,556340,1664,106292,5.153395827929898,0.1604087940214176
1998,0.1572777777777777,0,1,0,49271,556339,1664,106292,5.15338656489681,0.16040903610003154
1999,0.1573333333333333,1,29,1,49300,556310,1665,106291,5.153117936937271,0.16041478959434108
2000,0.1573809523809523,1,1,1,49301,556309,1666,106290,5.153108673904184,0.160413764584613
2001,0.1573809523809524,0,1,0,49302,556308,1666,106290,5.1530994108710955,0.16041400668278505
2002,0.1574166666666666,0,2,0,49304,556306,1666,106290,5.15308088480492,0.16041449088132134
2003,0.1574285714285714,0,2,0,49306,556304,1666,106290,5.153062358738746,0.16041497508278071
2004,0.1574722222222222,0,1,0,49307,556303,1666,106290,5.1530530957056575,0.16041521718460655
2005,0.1574999999999999,0,7,0,49314,556296,1666,106290,5.152988254474045,0.16041691191784915
2006,0.1575,9,200,9,49514,556096,1675,106281,5.151135647856534,0.16045394088260914
2007,0.157547619047619,0,2,0,49516,556094,1675,106281,5.151117121790359,0.1604544253632761
2008,0.1576190476190476,0,3,0,49519,556091,1675,106281,5.151089332691097,0.16045515208976224
2009,0.1576666666666666,0,21,0,49540,556070,1675,106281,5.150894808996258,0.1604602393594937
2010,0.1577142857142857,0,1,0,49541,556069,1675,106281,5.15088554596317,0.16046048161847964
2011,0.1577380952380952,0,1,0,49542,556068,1675,106281,5.150876282930082,0.16046072387819715
2012,0.1577777777777777,0,1,0,49543,556067,1675,106281,5.150867019896995,0.16046096613864616
2013,0.1577777777777778,0,1,0,49544,556066,1675,106281,5.150857756863908,0.16046120839982667
2014,0.1578333333333333,0,8,0,49552,556058,1675,106281,5.150783652599207,0.16046314651560606
2015,0.1578571428571428,1,6,1,49558,556052,1676,106280,5.150728074400682,0.16046333258849035
2016,0.1578571428571429,0,2,0,49560,556050,1676,106280,5.150709548334507,0.16046381713043348
2017,0.1579166666666666,0,3,0,49563,556047,1676,106280,5.150681759235244,0.16046454394883494
2018,0.1579523809523809,0,2,0,49565,556045,1676,106280,5.150663233169069,0.16046502849809383
2019,0.158,1,42,1,49607,556003,1677,106279,5.1502741857793914,0.1604739370842028
2020,0.158076923076923,0,1,0,49608,556002,1677,106279,5.150264922746304,0.16047417938911127
2021,0.1580952380952381,0,1,0,49609,556001,1677,106279,5.150255659713216,0.16047442169475146
2022,0.1581111111111111,0,3,0,49612,555998,1677,106279,5.1502278706139535,0.16047514861606246
2023,0.1581666666666666,1,4,1,49616,555994,1678,106278,5.150190818481604,0.16047485021260147
2024,0.1582142857142857,0,1,0,49617,555993,1678,106278,5.150181555448516,0.1604750925225474
2025,0.15825,0,1,0,49618,555992,1678,106278,5.150172292415428,0.16047533483322513
2026,0.1582619047619047,1,2,1,49620,555990,1679,106277,5.150153766349254,0.16047455180463469
2027,0.1582857142857142,0,2,0,49622,555988,1679,106277,5.1501352402830785,0.16047503642801597
2028,0.1583333333333333,10,209,10,49831,555779,1689,106267,5.148199266367779,0.16051301571189916
2029,0.1583809523809524,0,1,0,49832,555778,1689,106267,5.148190003334692,0.16051325816220952
2030,0.1583928571428571,0,1,0,49833,555777,1689,106267,5.148180740301604,0.16051350061325229
2031,0.1584523809523809,0,1,0,49834,555776,1689,106267,5.148171477268517,0.1605137430650275
2032,0.1585,1,15,1,49849,555761,1690,106266,5.148032531772204,0.16051611188063328
2033,0.158547619047619,0,2,0,49851,555759,1690,106266,5.148014005706028,0.1605165968052566
2034,0.1585714285714285,0,4,0,49855,555755,1690,106266,5.147976953573679,0.16051756666329317
2035,0.1586428571428571,0,1,0,49856,555754,1690,106266,5.1479676905405904,0.16051780912963354
2036,0.1586507936507936,0,1,0,49857,555753,1690,106266,5.147958427507503,0.16051805159670643
2037,0.1586666666666666,0,15,0,49872,555738,1690,106266,5.147819482011189,0.16052168869070277
2038,0.1586868131868132,0,1,0,49873,555737,1690,106266,5.147810218978102,0.1605219311694962
2039,0.1587142857142857,0,2,0,49875,555735,1690,106266,5.147791692911927,0.16052241612928078
2040,0.1587499999999999,0,1,0,49876,555734,1690,106266,5.1477824298788395,0.1605226586102719
2041,0.15875,0,2,0,49878,555732,1690,106266,5.147763903812664,0.16052314357445188
2042,0.1587619047619047,0,2,0,49880,555730,1690,106266,5.14774537774649,0.16052362854156219
2043,0.1588095238095238,0,1,0,49881,555729,1690,106266,5.1477361147134015,0.1605238710262162
2044,0.1588333333333333,0,4,0,49885,555725,1690,106266,5.147699062581052,0.16052484097215824
2045,0.1588888888888888,0,1,0,49886,555724,1690,106266,5.147689799547964,0.16052508346047523
2046,0.1589285714285714,1,3,1,49889,555721,1691,106265,5.147662010448701,0.16052454281510486
2047,0.1589523809523809,0,1,0,49890,555720,1691,106265,5.147652747415614,0.160524785304803
2048,0.1589545454545454,0,2,0,49892,555718,1691,106265,5.147634221349438,0.16052527028639707
2049,0.1589761904761905,0,2,0,49894,555716,1691,106265,5.147615695283264,0.16052575527092167
2050,0.159,0,33,0,49927,555683,1691,106265,5.147310015191374,0.16053375793869004
2051,0.1590079365079365,0,1,0,49928,555682,1691,106265,5.147300752158286,0.16053400045622987
2052,0.159047619047619,0,2,0,49930,555680,1691,106265,5.147282226092112,0.16053448549350777
2053,0.1590555555555555,0,1,0,49931,555679,1691,106265,5.147272963059024,0.16053472801324584
2054,0.1591111111111111,0,1,0,49932,555678,1691,106265,5.1472637000259365,0.16053497053371665
2055,0.1591190476190476,0,1,0,49933,555677,1691,106265,5.147254436992849,0.16053521305492022
2056,0.1591666666666666,7,53,7,49986,555624,1698,106258,5.146763496239209,0.160539189764943
2057,0.1591904761904762,0,1,0,49987,555623,1698,106258,5.146754233206121,0.1605394323148723
2058,0.1592142857142857,0,1,0,49988,555622,1698,106258,5.1467449701730335,0.16053967486553453
2059,0.1592380952380952,1,0,1,49988,555622,1699,106257,5.1467449701730335,0.1605384065667592
2060,0.1592857142857142,1,3,1,49991,555619,1700,106256,5.146717181073771,0.160537865911237
2061,0.1593333333333333,1,20,1,50011,555599,1701,106255,5.14653192041202,0.1605414487182974
2062,0.1593571428571428,0,2,0,50013,555597,1701,106255,5.1465133943458445,0.16054193384623752
2063,0.1593809523809523,0,1,0,50014,555596,1701,106255,5.146504131312757,0.16054217641130708
2064,0.1594166666666666,0,1,0,50015,555595,1701,106255,5.146494868279669,0.1605424189771096
2065,0.1594444444444444,0,1,0,50016,555594,1701,106255,5.146485605246582,0.16054266154364516
2066,0.1595,0,7,0,50023,555587,1701,106255,5.146420764014969,0.16054435952991802
2067,0.1595238095238095,0,4,0,50027,555583,1701,106255,5.146383711882619,0.16054532982391462
2068,0.1595454545454545,0,1,0,50028,555582,1701,106255,5.1463744488495315,0.16054557239924633
2069,0.1595555555555555,0,1,0,50029,555581,1701,106255,5.146365185816443,0.1605458149753111
2070,0.1595833333333333,0,2,0,50031,555579,1701,106255,5.146346659750269,0.16054630012963975
2071,0.1596111111111111,0,1,0,50032,555578,1701,106255,5.146337396717181,0.16054654270790367
2072,0.1596428571428571,0,2,0,50034,555576,1701,106255,5.146318870651006,0.1605470278666306
2073,0.1596666666666666,0,8,0,50042,555568,1701,106255,5.146244766386306,0.16054896853086098
2074,0.1597222222222222,1,0,1,50042,555568,1702,106254,5.146244766386306,0.16054770013689482
2075,0.1597619047619047,0,2,0,50044,555566,1702,106254,5.14622624032013,0.16054818530718323
2076,0.1597857142857143,0,1,0,50045,555565,1702,106254,5.146216977287043,0.16054842789342705
2077,0.1598333333333333,0,10,0,50055,555555,1702,106254,5.146124346956167,0.16055085379618592
2078,0.1598809523809523,0,1,0,50056,555554,1702,106254,5.14611508392308,0.16055109639049392
2079,0.1599166666666666,0,1,0,50057,555553,1702,106254,5.146105820889992,0.16055133898553506
2080,0.1599285714285714,0,2,0,50059,555551,1702,106254,5.146087294823817,0.16055182417781672
2081,0.1599404761904762,0,1,0,50060,555550,1702,106254,5.146078031790729,0.16055206677505726
2082,0.1599444444444444,0,1,0,50061,555549,1702,106254,5.146068768757642,0.16055230937303094
2083,0.1599999999999999,2,12,2,50073,555537,1704,106252,5.145957612360592,0.1605526837103669
2084,0.16,105,2654,105,52727,552883,1809,106147,5.1213735225462225,0.16106550536394398
2085,0.1601190476190476,0,2,0,52729,552881,1809,106147,5.121354996480047,0.16106599416109785
2086,0.1601428571428571,1,0,1,52729,552881,1810,106146,5.121354996480047,0.16106472117227366
2087,0.1603268398268398,0,1,0,52730,552880,1810,106146,5.12134573344696,0.16106496557040237
2088,0.1603333333333333,2,16,2,52746,552864,1812,106144,5.121197524917559,0.16106632999902884
2089,0.1603571428571428,0,1,0,52747,552863,1812,106144,5.1211882618844715,0.16106657440664515
2090,0.1604166666666666,1,4,1,52751,552859,1813,106143,5.121151209752121,0.16106627900977538
2091,0.1604761904761905,0,2,0,52753,552857,1813,106143,5.121132683685946,0.16106676783004553
2092,0.1605,0,6,0,52759,552851,1813,106143,5.121077105487421,0.16106823430865835
2093,0.1605555555555555,0,2,0,52761,552849,1813,106143,5.121058579421246,0.16106872314079684
2094,0.1605833333333333,0,1,0,52762,552848,1813,106143,5.1210493163881585,0.16106896755797878
2095,0.1606666666666666,1,20,1,52782,552828,1814,106142,5.120864055726407,0.1610725829703932
2096,0.1606666666666667,0,1,0,52783,552827,1814,106142,5.1208547926933194,0.16107282740159248
2097,0.1607142857142857,0,3,0,52786,552824,1814,106142,5.120827003594057,0.16107356069964157
2098,0.16075,0,1,0,52787,552823,1814,106142,5.12081774056097,0.1610738051338083
2099,0.1607619047619047,0,2,0,52789,552821,1814,106142,5.120799214494794,0.16107429400436746
2100,0.1608333333333333,3,64,3,52853,552757,1817,106139,5.120206380377191,0.1610861198125349
2101,0.1608571428571429,0,1,0,52854,552756,1817,106139,5.120197117344103,0.16108636429173084
2102,0.1609523809523809,1,3,1,52857,552753,1818,106138,5.120169328244841,0.16108582451422163
2103,0.1609999999999999,0,1,0,52858,552752,1818,106138,5.120160065211753,0.16108606899482464
2104,0.161,2,34,2,52892,552718,1820,106136,5.119845122086776,0.16109183521690693
2105,0.1610714285714286,0,2,0,52894,552716,1820,106136,5.119826596020601,0.1610923242245603
2106,0.1611666666666666,0,9,0,52903,552707,1820,106136,5.119743228722813,0.1610945247957404
2107,0.1611904761904762,0,1,0,52904,552706,1820,106136,5.119733965689726,0.1610947693073605
2108,0.1612142857142857,0,2,0,52906,552704,1820,106136,5.11971543962355,0.1610952583328274
2109,0.16125,0,7,0,52913,552697,1820,106136,5.119650598391938,0.16109696994534276
2110,0.1612619047619047,1,1,1,52914,552696,1821,106135,5.11964133535885,0.1610959411442388
2111,0.1612857142857142,0,1,0,52915,552695,1821,106135,5.1196320723257625,0.16109618566246225
2112,0.1613333333333333,1,19,1,52934,552676,1822,106134,5.119456074697099,0.16109955829450068
2113,0.1613888888888889,2,2,2,52936,552674,1824,106132,5.119437548630923,0.16109750062992748
2114,0.1614285714285714,1,8,1,52944,552666,1825,106131,5.119363444366224,0.16109818350721086
2115,0.1614444444444444,0,1,0,52945,552665,1825,106131,5.119354181333136,0.16109842804145744
2116,0.1614999999999999,0,17,0,52962,552648,1825,106131,5.119196709770647,0.16110258523723434
2117,0.1615,0,1,0,52963,552647,1825,106131,5.11918744673756,0.16110282978484405
2118,0.1615555555555555,0,4,0,52967,552643,1825,106131,5.119150394605209,0.16110380798270726
2119,0.1615833333333333,0,1,0,52968,552642,1825,106131,5.119141131572122,0.16110405253402918
2120,0.161595238095238,0,1,0,52969,552641,1825,106131,5.119131868539035,0.16110429708609353
2121,0.1616666666666666,13,238,13,53207,552403,1838,106118,5.116927266664197,0.16114596193591396
2122,0.1617142857142857,0,3,0,53210,552400,1838,106118,5.1168994775649335,0.1611466960660149
2123,0.1617857142857143,0,3,0,53213,552397,1838,106118,5.116871688465671,0.1611474302028048
2124,0.1618333333333333,0,8,0,53221,552389,1838,106118,5.116797584200971,0.16114938793361347
2125,0.1618571428571428,0,3,0,53224,552386,1838,106118,5.116769795101708,0.16115012209493032
2126,0.1619047619047618,0,4,0,53228,552382,1838,106118,5.116732742969358,0.16115110098709187
2127,0.1619761904761905,0,3,0,53231,552379,1838,106118,5.116704953870095,0.16115183516401746
2128,0.162,3,61,3,53292,552318,1841,106115,5.116139908851754,0.16116294292661515
2129,0.1620021645021644,0,1,0,53293,552317,1841,106115,5.116130645818667,0.16116318769440124
2130,0.1620238095238095,0,5,0,53298,552312,1841,106115,5.116084330653229,0.16116441154448405
2131,0.1620833333333333,0,3,0,53301,552309,1841,106115,5.1160565415539665,0.16116514586345576
2132,0.1621212121212121,0,1,0,53302,552308,1841,106115,5.116047278520879,0.16116539063793336
2133,0.1621428571428571,0,3,0,53305,552305,1841,106115,5.116019489421616,0.16116612496582727
2134,0.1621666666666666,1,2,1,53307,552303,1842,106114,5.116000963355441,0.16116534050609263
2135,0.1622023809523809,0,5,0,53312,552298,1842,106114,5.115954648190003,0.16116656440040583
2136,0.1622222222222222,0,2,0,53314,552296,1842,106114,5.115936122123828,0.16116705396333592
2137,0.1622514985014985,0,2,0,53316,552294,1842,106114,5.1159175960576535,0.16116754352924023
2138,0.1623095238095238,0,2,0,53318,552292,1842,106114,5.115899069991478,0.16116803309811878
2139,0.1623333333333333,0,11,0,53329,552281,1842,106114,5.115797176627515,0.1611707257801168
2140,0.1623809523809523,0,3,0,53332,552278,1842,106114,5.115769387528252,0.16117146016355
2141,0.1624285714285714,0,1,0,53333,552277,1842,106114,5.115760124495164,0.16117170495951494
2142,0.1624545454545454,0,1,0,53334,552276,1842,106114,5.115750861462077,0.1611719497562235
2143,0.1625,13,213,13,53547,552063,1855,106101,5.113777835414428,0.16120754097762868
2144,0.162547619047619,0,1,0,53548,552062,1855,106101,5.113768572381341,0.16120778591321602
2145,0.1625555555555555,1,1,1,53549,552061,1856,106100,5.113759309348253,0.16120675640154916
2146,0.1626190476190475,0,1,0,53550,552060,1856,106100,5.1137500463151655,0.1612070013370609
2147,0.1626666666666666,1,26,1,53576,552034,1857,106099,5.113509207454889,0.16121209542751996
2148,0.1626818181818182,0,2,0,53578,552032,1857,106099,5.113490681388714,0.16121258533635402
2149,0.1626904761904762,0,1,0,53579,552031,1857,106099,5.113481418355627,0.16121283029188763
2150,0.1627142857142857,0,1,0,53580,552030,1857,106099,5.113472155322539,0.16121307524816564
2151,0.1627499999999999,0,1,0,53581,552029,1857,106099,5.113462892289451,0.16121332020518805
2152,0.1628095238095238,0,1,0,53582,552028,1857,106099,5.113453629256363,0.16121356516295487
2153,0.1628333333333333,1,5,1,53587,552023,1858,106098,5.113407314090926,0.1612135154477672
2154,0.1628412698412698,0,1,0,53588,552022,1858,106098,5.113398051057838,0.16121376040843616
2155,0.1628571428571428,0,7,0,53595,552015,1858,106098,5.113333209826226,0.16121547515396292
2156,0.1629166666666666,0,1,0,53596,552014,1858,106098,5.1133239467931375,0.16121572012058738
2157,0.163,0,31,0,53627,551983,1858,106098,5.113036792767423,0.16122331445521143
2158,0.163079365079365,0,1,0,53628,551982,1858,106098,5.113027529734336,0.1612235594456601
2159,0.1630833333333333,0,1,0,53629,551981,1858,106098,5.113018266701249,0.16122380443685333
2160,0.1630952380952381,0,3,0,53632,551978,1858,106098,5.112990477601986,0.16122453941490042
2161,0.1631111111111111,1,1,1,53633,551977,1859,106097,5.112981214568898,0.16122350981804479
2162,0.1631666666666666,0,3,0,53636,551974,1859,106097,5.112953425469636,0.1612242448003331
2163,0.1631666666666667,0,2,0,53638,551972,1859,106097,5.11293489940346,0.16122473479224822
2164,0.1632857142857142,0,1,0,53639,551971,1859,106097,5.112925636370373,0.16122497978932268
2165,0.1633333333333333,23,441,23,54080,551530,1882,106074,5.108840638778762,0.16130376335910365
2166,0.1634285714285714,0,1,0,54081,551529,1882,106074,5.108831375745674,0.16130400864959557
2167,0.1634523809523809,0,5,0,54086,551524,1882,106074,5.108785060580236,0.1613052351132455
2168,0.1635,0,15,0,54101,551509,1882,106074,5.108646115083923,0.1613089146161017
2169,0.1635714285714286,1,2,1,54103,551507,1883,106073,5.108627589017748,0.16130812980930076
2170,0.1636363636363636,0,1,0,54104,551506,1883,106073,5.1086183259846605,0.16130837511538537
2171,0.1636666666666666,3,15,3,54119,551491,1886,106070,5.1084793804883475,0.1613082284381221
2172,0.1636904761904762,1,1,1,54120,551490,1887,106069,5.108470117455259,0.16130719828943108
2173,0.1637023809523809,0,2,0,54122,551488,1887,106069,5.108451591389084,0.1613076889151815
2174,0.1637142857142857,0,3,0,54125,551485,1887,106069,5.108423802289821,0.1613084248594032
2175,0.16375,0,8,0,54133,551477,1887,106069,5.108349698025122,0.16131038741015838
2176,0.1638095238095238,0,2,0,54135,551475,1887,106069,5.108331171958946,0.16131087805530886
2177,0.1638333333333333,3,5,3,54140,551470,1890,106066,5.108284856793508,0.16130827817792487
2178,0.1639166666666666,0,1,0,54141,551469,1890,106066,5.108275593760421,0.16130852350065014
2179,0.1639285714285714,1,1,1,54142,551468,1891,106065,5.108266330727333,0.16130749331212274
2180,0.1639999999999999,3,89,3,54231,551379,1894,106062,5.1074419207825414,0.16132550297289033
2181,0.164,1,0,1,54231,551379,1895,106061,5.1074419207825414,0.16132422730591384
2182,0.164047619047619,0,2,0,54233,551377,1895,106061,5.107423394716366,0.1613247180722745
2183,0.1640833333333333,0,1,0,54234,551376,1895,106061,5.107414131683278,0.16132496345657454
2184,0.1641666666666666,5,70,5,54304,551306,1900,106056,5.106765719367149,0.16133576324764742
2185,0.1642857142857142,0,1,0,54305,551305,1900,106056,5.106756456334062,0.16133600867711959
2186,0.1642857142857143,0,8,0,54313,551297,1900,106056,5.106682352069361,0.16133797213977877
2187,0.1643333333333333,1,18,1,54331,551279,1901,106055,5.106515617473786,0.1613411142585048
2188,0.1643452380952381,0,2,0,54333,551277,1901,106055,5.10649709140761,0.1613416051553857
2189,0.1643571428571428,0,1,0,54334,551276,1901,106055,5.106487828374523,0.16134185060494638
2190,0.1644047619047619,1,1,1,54335,551275,1902,106054,5.106478565341435,0.16134082019810475
2191,0.1644444444444444,0,3,0,54338,551272,1902,106054,5.1064507762421725,0.1613415565488053
2192,0.1644999999999999,1,7,1,54345,551265,1903,106053,5.10638593501056,0.16134199884987174
2193,0.1645,0,2,0,54347,551263,1903,106053,5.106367408944385,0.16134248976139332
2194,0.1645238095238095,0,3,0,54350,551260,1903,106053,5.106339619845122,0.16134322613427698
2195,0.164547619047619,0,3,0,54353,551257,1903,106053,5.1063118307458595,0.16134396251388233
2196,0.1645833333333333,0,4,0,54357,551253,1903,106053,5.10627477861351,0.16134494436381228
2197,0.1646190476190476,1,3,1,54360,551250,1904,106052,5.106246989514246,0.16134440485499815
2198,0.1646428571428571,0,3,0,54363,551247,1904,106052,5.106219200414984,0.16134514125230678
2199,0.1646666666666666,1,16,1,54379,551231,1905,106051,5.106070991885583,0.16134779288037707
2200,0.1646776980329612,0,1,0,54380,551230,1905,106051,5.106061728852495,0.16134803835802344
2201,0.1646825396825396,0,1,0,54381,551229,1905,106051,5.106052465819408,0.16134828383641675
2202,0.1647619047619047,0,2,0,54383,551227,1905,106051,5.106033939753233,0.16134877479544424
2203,0.1648333333333333,0,7,0,54390,551220,1905,106051,5.10596909852162,0.1613504931755699
2204,0.1648809523809524,0,1,0,54391,551219,1905,106051,5.105959835488532,0.1613507386614329
2205,0.1649166666666666,0,1,0,54392,551218,1905,106051,5.105950572455445,0.1613509841480429
2206,0.1649761904761904,0,1,0,54393,551217,1905,106051,5.105941309422358,0.16135122963539986
2207,0.1649999999999999,0,1,0,54394,551216,1905,106051,5.1059320463892695,0.16135147512350384
2208,0.165,35,875,35,55269,550341,1940,106016,5.09782689243766,0.16152185472235384
2209,0.1650238095238095,0,2,0,55271,550339,1940,106016,5.097808366371485,0.16152234690068637
2210,0.1651309523809524,1,0,1,55271,550339,1941,106015,5.097808366371485,0.1615210694229029
2211,0.1651666666666666,0,6,0,55277,550333,1941,106015,5.09775278817296,0.161522545966469
2212,0.1652142857142857,0,2,0,55279,550331,1941,106015,5.097734262106784,0.16152303815365676
2213,0.1652777777777777,0,1,0,55280,550330,1941,106015,5.097724999073697,0.16152328424837548
2214,0.1653333333333333,1,21,1,55301,550309,1942,106014,5.097530475378858,0.16152717488187981
2215,0.1653571428571428,0,1,0,55302,550308,1942,106014,5.097521212345771,0.1615274209915255
2216,0.1654166666666666,0,1,0,55303,550307,1942,106014,5.097511949312683,0.16152766710192115
2217,0.1654285714285714,1,1,1,55304,550306,1943,106013,5.097502686279595,0.16152663567563944
2218,0.1654761904761904,0,1,0,55305,550305,1943,106013,5.097493423246508,0.1615268817859635
2219,0.1654999999999999,0,1,0,55306,550304,1943,106013,5.09748416021342,0.16152712789703755
2220,0.1655,0,10,0,55316,550294,1943,106013,5.097391529882545,0.16152958904902737
2221,0.165547619047619,0,1,0,55317,550293,1943,106013,5.097382266849457,0.16152983516835134
2222,0.1655833333333333,0,1,0,55318,550292,1943,106013,5.09737300381637,0.16153008128842536
2223,0.1656190476190476,0,1,0,55319,550291,1943,106013,5.097363740783282,0.16153032740924939
2224,0.1656666666666666,1,17,1,55336,550274,1944,106012,5.097206269220794,0.16153323398640226
2225,0.1656666666666667,0,1,0,55337,550273,1944,106012,5.097197006187706,0.16153348011915555
2226,0.1657142857142857,0,12,0,55349,550261,1944,106012,5.0970858497906555,0.16153643377070212
2227,0.1658333333333333,3,69,3,55418,550192,1947,106009,5.096446700507614,0.16154958617862514
2228,0.1659166666666666,2,3,2,55421,550189,1949,106007,5.096418911408351,0.16154776926406134
2229,0.1659285714285714,0,1,0,55422,550188,1949,106007,5.096409648375264,0.16154801545272365
2230,0.1659523809523809,0,4,0,55426,550184,1949,106007,5.096372596242913,0.16154900021487645
2231,0.1659999999999999,0,2,0,55428,550182,1949,106007,5.096354070176739,0.16154949260045506
2232,0.166,6,87,6,55515,550095,1955,106001,5.095548186298122,0.16156324684192558
2233,0.1660833333333333,0,1,0,55516,550094,1955,106001,5.095538923265034,0.16156349309170165
2234,0.1661666666666666,0,2,0,55518,550092,1955,106001,5.095520397198859,0.1615639855935058
2235,0.1661904761904761,0,1,0,55519,550091,1955,106001,5.095511134165771,0.16156423184553387
2236,0.1661904761904762,0,1,0,55520,550090,1955,106001,5.095501871132684,0.1615644780983126
2237,0.1662142857142857,0,1,0,55521,550089,1955,106001,5.095492608099596,0.16156472435184197
2238,0.16625,0,4,0,55525,550085,1955,106001,5.095455555967246,0.1615657093734663
2239,0.1662619047619047,0,1,0,55526,550084,1955,106001,5.095446292934159,0.16156595563074908
2240,0.1663333333333333,1,9,1,55535,550075,1956,106000,5.09536292563637,0.16156689402888388
2241,0.1664047619047619,0,1,0,55536,550074,1956,106000,5.095353662603283,0.1615671402921012
2242,0.1664166666666666,0,2,0,55538,550072,1956,106000,5.095335136537107,0.16156763282078795
2243,0.1664285714285714,0,1,0,55539,550071,1956,106000,5.09532587350402,0.16156787908625744
2244,0.1664523809523809,0,1,0,55540,550070,1956,106000,5.095316610470933,0.16156812535247764
2245,0.166468253968254,0,2,0,55542,550068,1956,106000,5.0952980844047575,0.16156861788717022
2246,0.1664999999999999,1,20,1,55562,550048,1957,105999,5.095112823743007,0.16157226540171665
2247,0.1666666666666666,22,427,22,55989,549621,1979,105977,5.091157508614621,0.1616493643970848
2248,0.1667142857142857,0,3,0,55992,549618,1979,105977,5.091129719515358,0.16165010410390562
2249,0.1667777777777777,0,1,0,55993,549617,1979,105977,5.091120456482271,0.1616503506743503
2250,0.1667857142857143,0,3,0,55996,549614,1979,105977,5.091092667383008,0.16165109039019754
2251,0.1668333333333333,0,5,0,56001,549609,1979,105977,5.09104635221757,0.16165232326498735
2252,0.1668571428571428,0,3,0,56004,549606,1979,105977,5.091018563118308,0.16165306299888801
2253,0.1668968253968253,0,1,0,56005,549605,1979,105977,5.09100930008522,0.16165330957835938
2254,0.1669999999999999,1,42,1,56047,549563,1980,105976,5.090620252695542,0.16166238774504643
2255,0.167,0,1,0,56048,549562,1980,105976,5.090610989662455,0.1616626343552929
2256,0.1670238095238095,0,1,0,56049,549561,1980,105976,5.090601726629368,0.16166288096629175
2257,0.1670833333333333,1,4,1,56053,549557,1981,105975,5.090564674497017,0.1616625885540294
2258,0.1671190476190476,0,1,0,56054,549556,1981,105975,5.09055541146393,0.16166283516721558
2259,0.1671428571428571,0,6,0,56060,549550,1981,105975,5.090499833265405,0.1616643148621334
2260,0.1671666666666666,0,3,0,56063,549547,1981,105975,5.090472044166142,0.16166505471975007
2261,0.1671785714285714,0,1,0,56064,549546,1981,105975,5.090462781133054,0.16166530134046048
2262,0.1671904761904762,1,1,1,56065,549545,1982,105974,5.090453518099967,0.16166426907534334
2263,0.1672619047619047,0,3,0,56068,549542,1982,105974,5.090425729000704,0.16166500893952246
2264,0.1672857142857143,0,1,0,56069,549541,1982,105974,5.090416465967617,0.1616652555624204
2265,0.1673095238095238,0,1,0,56070,549540,1982,105974,5.090407202934529,0.1616655021860708
2266,0.1673333333333333,4,28,4,56098,549512,1986,105970,5.090147838008077,0.161667292160578
2267,0.1674285714285714,0,4,0,56102,549508,1986,105970,5.090110785875727,0.16166827872178777
2268,0.1674404761904762,0,2,0,56104,549506,1986,105970,5.090092259809552,0.16166877200690796
2269,0.1674523809523809,0,2,0,56106,549504,1986,105970,5.090073733743377,0.1616692652950384
2270,0.1674761904761904,1,0,1,56106,549504,1987,105969,5.090073733743377,0.16166798632437948
2271,0.1674999999999999,0,2,0,56108,549502,1987,105969,5.090055207677202,0.16166847961237035
2272,0.1675,12,255,12,56363,549247,1999,105957,5.087693134239876,0.16171604568958675
2273,0.1675238095238095,0,2,0,56365,549245,1999,105957,5.0876746081737005,0.16171653932680302
2274,0.167547619047619,0,1,0,56366,549244,1999,105957,5.087665345140612,0.16171678614654128
2275,0.1676190476190476,0,3,0,56369,549241,1999,105957,5.08763755604135,0.16171752661027658
2276,0.1676666666666666,1,19,1,56388,549222,2000,105956,5.087461558412687,0.16172093690569586
2277,0.1677499999999999,0,1,0,56389,549221,2000,105956,5.087452295379599,0.1617211837411875
2278,0.1677777777777777,0,1,0,56390,549220,2000,105956,5.087443032346512,0.16172143057743263
2279,0.1678333333333333,1,8,1,56398,549212,2001,105955,5.087368928081811,0.16172212580914486
2280,0.1678571428571428,0,2,0,56400,549210,2001,105955,5.087350402015636,0.16172261949279954
2281,0.1678852813852814,0,1,0,56401,549209,2001,105955,5.0873411389825485,0.16172286633575716
2282,0.1679166666666666,0,3,0,56404,549206,2001,105955,5.087313349883286,0.16172360686915124
2283,0.1679166666666667,0,2,0,56406,549204,2001,105955,5.0872948238171105,0.16172410056184836
2284,0.1679523809523809,0,2,0,56408,549202,2001,105955,5.087276297750935,0.16172459425755964
2285,0.1679999999999999,0,1,0,56409,549201,2001,105955,5.087267034717848,0.1617248411065456
2286,0.168,1,50,1,56459,549151,2002,105954,5.08680388306347,0.16173590493127055
2287,0.1680555555555555,0,1,0,56460,549150,2002,105954,5.086794620030383,0.16173615181711606
2288,0.1680833333333333,0,1,0,56461,549149,2002,105954,5.086785356997296,0.16173639870371528
2289,0.1680952380952381,0,1,0,56462,549148,2002,105954,5.0867760939642075,0.16173664559106826
2290,0.1681111111111111,0,2,0,56464,549146,2002,105954,5.086757567898032,0.1617371393680354
2291,0.1681666666666666,0,4,0,56468,549142,2002,105954,5.086720515765682,0.1617381269310147
2292,0.1681666666666667,0,1,0,56469,549141,2002,105954,5.086711252732595,0.1617383738236439
2293,0.1682142857142857,0,1,0,56470,549140,2002,105954,5.086701989699507,0.16173862071702688
2294,0.1682222222222222,0,1,0,56471,549139,2002,105954,5.08669272666642,0.1617388676111636
2295,0.1682857142857143,0,1,0,56472,549138,2002,105954,5.0866834636333325,0.1617391145060541
2296,0.1683333333333333,14,239,14,56711,548899,2016,105940,5.0844695987254065,0.16178022384128007
2297,0.1683730158730159,0,1,0,56712,548898,2016,105940,5.084460335692319,0.16178047089509162
2298,0.1683809523809523,0,3,0,56715,548895,2016,105940,5.084432546593057,0.16178121206105356
2299,0.1684166666666667,0,1,0,56716,548894,2016,105940,5.0844232835599685,0.1617814591178833
2300,0.1684523809523809,1,0,1,56716,548894,2017,105939,5.0844232835599685,0.1617801790685564
2301,0.1685,0,16,0,56732,548878,2017,105939,5.084275075030568,0.1617841320552154
2302,0.1685714285714285,0,7,0,56739,548871,2017,105939,5.084210233798955,0.1617858615476245
2303,0.1686666666666666,0,21,0,56760,548850,2017,105939,5.084015710104117,0.1617910502467207
2304,0.1686904761904762,0,2,0,56762,548848,2017,105939,5.083997184037941,0.16179154442589727
2305,0.1687142857142857,0,1,0,56763,548847,2017,105939,5.083987921004854,0.16179179151661766
2306,0.16875,1,5,1,56768,548842,2018,105938,5.083941605839416,0.16179174684626899
2307,0.1687857142857142,0,1,0,56769,548841,2018,105938,5.083932342806328,0.16179199393994004
2308,0.1688095238095238,0,4,0,56773,548837,2018,105938,5.083895290673978,0.16179298232217174
2309,0.1688333333333333,0,3,0,56776,548834,2018,105938,5.083867501574716,0.1617937236167704
2310,0.1688571428571428,0,3,0,56779,548831,2018,105938,5.083839712475453,0.161794464918162
2311,0.1688888888888889,0,2,0,56781,548829,2018,105938,5.083821186409278,0.16179495912286354
2312,0.1689285714285714,0,1,0,56782,548828,2018,105938,5.0838119233761905,0.16179520622634652
2313,0.1689999999999999,1,29,1,56811,548799,2019,105937,5.083543295416651,0.16180109234867182
2314,0.169,0,1,0,56812,548798,2019,105937,5.083534032383564,0.16180133947322198
2315,0.169047619047619,0,1,0,56813,548797,2019,105937,5.083524769350476,0.16180158659852703
2316,0.1691190476190476,0,2,0,56815,548795,2019,105937,5.083506243284301,0.1618020808514018
2317,0.1691428571428571,0,1,0,56816,548794,2019,105937,5.083496980251214,0.1618023279789715
2318,0.1691666666666666,0,54,0,56870,548740,2019,105937,5.082996776464485,0.16181567398885252
2319,0.1691666666666667,1,26,1,56896,548714,2020,105936,5.082755937604209,0.16182082028564881
2320,0.1692857142857143,0,2,0,56898,548712,2020,105936,5.082737411538034,0.16182131466070315
2321,0.1693333333333333,2,24,2,56922,548688,2022,105934,5.082515098743933,0.16182468661303775
2322,0.1694444444444444,0,1,0,56923,548687,2022,105934,5.082505835710845,0.16182493381666643
2323,0.1694761904761905,0,1,0,56924,548686,2022,105934,5.082496572677758,0.16182518102105037
2324,0.169484126984127,0,5,0,56929,548681,2022,105934,5.08245025751232,0.1618264170542991
2325,0.1694999999999999,1,11,1,56940,548670,2023,105933,5.0823483641483564,0.16182785596766283
2326,0.1695,0,1,0,56941,548669,2023,105933,5.082339101115269,0.16182810318330834
2327,0.1695238095238095,2,3,2,56944,548666,2025,105931,5.082311312016007,0.1618262839579161
2328,0.1695833333333333,0,2,0,56946,548664,2025,105931,5.082292785949831,0.16182677838969134
2329,0.1696428571428571,0,2,0,56948,548662,2025,105931,5.082274259883656,0.1618272728244879
2330,0.1696666666666666,0,2,0,56950,548660,2025,105931,5.082255733817481,0.16182776726230577
2331,0.1696666666666667,3,13,3,56963,548647,2028,105928,5.082135314387343,0.1618271397471642
2332,0.16975,0,1,0,56964,548646,2028,105928,5.082126051354256,0.16182738697229038
2333,0.1697619047619047,0,1,0,56965,548645,2028,105928,5.0821167883211675,0.16182763419817195
2334,0.1698076923076923,1,1,1,56966,548644,2029,105927,5.08210752528808,0.16182660093404688
2335,0.1698333333333333,1,15,1,56981,548629,2030,105926,5.081968579791767,0.1618290288822177
2336,0.1698809523809523,0,1,0,56982,548628,2030,105926,5.081959316758679,0.16182927611778403
2337,0.1699285714285714,0,3,0,56985,548625,2030,105926,5.081931527659417,0.16183001782901563
2338,0.1699333721833721,2,8,2,56993,548617,2032,105924,5.081857423394716,0.16182943467254152
2339,0.1699404761904762,0,1,0,56994,548616,2032,105924,5.081848160361629,0.16182968191401595
2340,0.1699999999999999,0,2,0,56996,548614,2032,105924,5.081829634295453,0.16183017639923122
2341,0.17,112,2682,112,59678,545932,2144,105812,5.056986179554634,0.16235208916384347
2342,0.1700238095238095,0,1,0,59679,545931,2144,105812,5.0569769165215455,0.16235233826830514
2343,0.1700555555555555,0,2,0,59681,545929,2144,105812,5.056958390455371,0.16235283647952178
2344,0.1701666666666666,0,5,0,59686,545924,2144,105812,5.056912075289933,0.16235408202094098
2345,0.1702142857142856,0,1,0,59687,545923,2144,105812,5.056902812256846,0.16235433113151818
2346,0.1702499999999999,0,2,0,59689,545921,2144,105812,5.05688428619067,0.16235482935496592
2347,0.1702619047619047,0,4,0,59693,545917,2144,105812,5.05684723405832,0.16235582581103494
2348,0.1703333333333333,0,11,0,59704,545906,2144,105812,5.0567453406943565,0.16235856612829475
2349,0.1703571428571428,0,2,0,59706,545904,2144,105812,5.056726814628182,0.1623590643777351
2350,0.1704047619047619,0,1,0,59707,545903,2144,105812,5.056717551595094,0.16235931350360203
2351,0.1704166666666666,0,2,0,59709,545901,2144,105812,5.0566990255289195,0.1623598117576295
2352,0.1704166666666667,0,1,0,59710,545900,2144,105812,5.056689762495831,0.16236006088579005
2353,0.1704285714285714,0,3,0,59713,545897,2144,105812,5.056661973396569,0.16236080827485888
2354,0.1704444444444444,0,1,0,59714,545896,2144,105812,5.0566527103634815,0.16236105740607756
2355,0.1704999999999999,0,2,0,59716,545894,2144,105812,5.056634184297306,0.16236155567080862
2356,0.1705,0,1,0,59717,545893,2144,105812,5.056624921264219,0.16236180480432097
2357,0.1705555555555555,1,4,1,59721,545889,2145,105811,5.056587869131868,0.16236151603498541
2358,0.1705952380952381,0,3,0,59724,545886,2145,105811,5.056560080032606,0.16236226344451485
2359,0.1706515151515151,0,1,0,59725,545885,2145,105811,5.056550816999518,0.16236251258255383
2360,0.1706666666666666,3,15,3,59740,545870,2148,105808,5.056411871503205,0.1623623936975009
2361,0.1706666666666667,0,3,0,59743,545867,2148,105808,5.056384082403943,0.1623631411363026
2362,0.1707142857142857,1,2,1,59745,545865,2149,105807,5.056365556337767,0.1623623540676905
2363,0.1707619047619047,1,0,1,59745,545865,2150,105806,5.056365556337767,0.16236106869877592
2364,0.1708333333333333,3,74,3,59819,545791,2153,105803,5.055680091889288,0.16237565109562088
2365,0.1709523809523809,1,0,1,59819,545791,2154,105802,5.055680091889288,0.16237436559324608
2366,0.170952380952381,1,0,1,59819,545791,2155,105801,5.055680091889288,0.16237308008692555
2367,0.1709999999999999,0,5,0,59824,545786,2155,105801,5.055633776723851,0.16237432606850657
2368,0.171,0,40,0,59864,545746,2155,105801,5.055263255400348,0.16238429460959838
2369,0.1710555555555555,0,1,0,59865,545745,2155,105801,5.055253992367261,0.16238454383880802
2370,0.1710714285714285,0,1,0,59866,545744,2155,105801,5.055244729334174,0.16238479306878267
2371,0.1711111111111111,0,3,0,59869,545741,2155,105801,5.05521694023491,0.16238554076329692
2372,0.1711428571428571,0,1,0,59870,545740,2155,105801,5.055207677201823,0.16238578999633177
2373,0.1711666666666666,0,6,0,59876,545734,2155,105801,5.055152099003298,0.16238728541060726
2374,0.1711904761904761,0,4,0,59880,545730,2155,105801,5.055115046870948,0.16238828236875913
2375,0.1711904761904762,0,1,0,59881,545729,2155,105801,5.05510578383786,0.1623885316102098
2376,0.17125,1,6,1,59887,545723,2156,105800,5.0550502056393345,0.1623887414565564
2377,0.1712698412698412,0,1,0,59888,545722,2156,105800,5.055040942606247,0.16238899070177215
2378,0.1713095238095238,0,3,0,59891,545719,2156,105800,5.055013153506985,0.16238973844201013
2379,0.1713174603174602,0,1,0,59892,545718,2156,105800,5.0550038904738965,0.16238998769028637
2380,0.1713333333333333,1,19,1,59911,545699,2157,105799,5.054827892845233,0.162393437892365
2381,0.1713571428571428,0,3,0,59914,545696,2157,105799,5.05480010374597,0.16239418568062686
2382,0.1713928571428571,0,2,0,59916,545694,2157,105799,5.054781577679796,0.1623946842099608
2383,0.1714047619047619,0,1,0,59917,545693,2157,105799,5.054772314646708,0.1623949334757756
2384,0.1714285714285713,0,1,0,59918,545692,2157,105799,5.05476305161362,0.16239518274235562
2385,0.1714285714285714,0,4,0,59922,545688,2157,105799,5.0547259994812705,0.16239617981632787
2386,0.1714682539682539,0,2,0,59924,545686,2157,105799,5.054707473415095,0.1623966783579054
2387,0.1714999999999999,0,8,0,59932,545678,2157,105799,5.054633369150395,0.16239867255482543
2388,0.1715454545454545,0,1,0,59933,545677,2157,105799,5.054624106117307,0.1623989218328841
2389,0.171547619047619,0,1,0,59934,545676,2157,105799,5.054614843084219,0.16239917111170804
2390,0.1715833333333333,1,2,1,59936,545674,2158,105798,5.054596317018045,0.16239838396738462
2391,0.1716666666666666,13,147,13,60083,545527,2171,105785,5.053234651154174,0.16241831871668264
2392,0.1716666666666667,1,78,1,60161,545449,2172,105784,5.052512134573345,0.1624364858660418
2393,0.1717142857142857,0,1,0,60162,545448,2172,105784,5.052502871540257,0.16243673529556288
2394,0.17175,0,2,0,60164,545446,2172,105784,5.052484345474082,0.1624372341569031
2395,0.1717619047619047,0,1,0,60165,545445,2172,105784,5.052475082440995,0.16243748358872226
2396,0.1717857142857142,0,1,0,60166,545444,2172,105784,5.052465819407907,0.16243773302130743
2397,0.1717857142857143,0,2,0,60168,545442,2172,105784,5.052447293341732,0.16243823188877593
2398,0.1718095238095238,0,2,0,60170,545440,2172,105784,5.052428767275557,0.16243873075930862
2399,0.1718333333333333,1,10,1,60180,545430,2173,105783,5.052336136944681,0.16243993900613163
2400,0.1719047619047619,0,1,0,60181,545429,2173,105783,5.052326873911594,0.16244018844861582
2401,0.1719444444444444,0,1,0,60182,545428,2173,105783,5.052317610878506,0.16244043789186607
2402,0.1719999999999999,0,1,0,60183,545427,2173,105783,5.052308347845418,0.16244068733588243
2403,0.172,5,47,5,60230,545380,2178,105778,5.051872985290303,0.16244598085257342
2404,0.172030303030303,0,1,0,60231,545379,2178,105778,5.051863722257216,0.1624462303254054
2405,0.1720833333333333,0,1,0,60232,545378,2178,105778,5.051854459224129,0.16244647979900362
2406,0.1721428571428571,0,4,0,60236,545374,2178,105778,5.051817407091778,0.16244747770105905
2407,0.1721515151515151,1,1,1,60237,545373,2179,105777,5.051808144058691,0.1624464409122322
2408,0.1721666666666666,0,1,0,60238,545372,2179,105777,5.051798881025603,0.16244669038883575
2409,0.1721666666666667,0,1,0,60239,545371,2179,105777,5.051789617992515,0.16244693986620554
2410,0.1721785714285714,0,3,0,60242,545368,2179,105777,5.051761828893253,0.16244768830291256
2411,0.1722142857142856,0,1,0,60243,545367,2179,105777,5.051752565860165,0.16244793778334746
2412,0.1722222222222222,0,1,0,60244,545366,2179,105777,5.051743302827077,0.16244818726454865
2413,0.1722619047619047,0,2,0,60246,545364,2179,105777,5.051724776760903,0.16244868622924988
2414,0.1722857142857142,0,1,0,60247,545363,2179,105777,5.051715513727815,0.16244893571274996
2415,0.1723333333333333,2,25,2,60272,545338,2181,105775,5.051483937900626,0.16245260039348008
2416,0.1724047619047619,0,1,0,60273,545337,2181,105775,5.0514746748675385,0.16245284989372027
2417,0.1724285714285714,0,1,0,60274,545336,2181,105775,5.051465411834451,0.16245309939472685
2418,0.1725,7,242,7,60516,545094,2188,105768,5.049223757827263,0.16250449404021128
2419,0.1726190476190476,0,1,0,60517,545093,2188,105768,5.0492144947941755,0.16250474371640028
2420,0.1726428571428571,0,4,0,60521,545089,2188,105768,5.049177442661825,0.16250574242882845
2421,0.1726666666666666,0,29,0,60550,545060,2188,105768,5.048908814702286,0.16251298346106804
2422,0.1726666666666667,0,2,0,60552,545058,2188,105768,5.048890288636111,0.16251348286638825
2423,0.1726785714285714,0,1,0,60553,545057,2188,105768,5.048881025603023,0.16251373257019935
2424,0.1726984126984127,0,1,0,60554,545056,2188,105768,5.048871762569936,0.1625139822747778
2425,0.1727121212121212,0,1,0,60555,545055,2188,105768,5.048862499536848,0.16251423198012363
2426,0.1727619047619047,0,1,0,60556,545054,2188,105768,5.048853236503761,0.16251448168623678
2427,0.1728333333333333,1,1,1,60557,545053,2189,105767,5.048843973470674,0.16251344457760977
2428,0.1728571428571428,3,13,3,60570,545040,2192,105764,5.048723554040535,0.1625128302837721
2429,0.1729166666666666,0,1,0,60571,545039,2192,105764,5.048714291007448,0.16251307999502154
2430,0.1729285714285714,0,2,0,60573,545037,2192,105764,5.0486957649412725,0.16251357941982264
2431,0.1729999999999999,0,3,0,60576,545034,2192,105764,5.04866797584201,0.16251432856277984
2432,0.173,3,31,3,60607,545003,2195,105761,5.048380821816296,0.16251820936622186
2433,0.1730555555555555,0,1,0,60608,545002,2195,105761,5.048371558783208,0.16251845910108595
2434,0.1730833333333333,0,1,0,60609,545001,2195,105761,5.04836229575012,0.16251870883671757
2435,0.1730952380952381,0,2,0,60611,544999,2195,105761,5.048343769683945,0.16251920831028335
2436,0.1731666666666666,0,13,0,60624,544986,2195,105761,5.048223350253807,0.16252245496329604
2437,0.1731666666666667,0,1,0,60625,544985,2195,105761,5.048214087220719,0.16252270471120836
2438,0.1732142857142856,0,2,0,60627,544983,2195,105761,5.048195561154545,0.16252320420933578
2439,0.1732727272727272,0,2,0,60629,544981,2195,105761,5.0481770350883695,0.1625237037105335
2440,0.173297619047619,0,2,0,60631,544979,2195,105761,5.048158509022194,0.1625242032148016
2441,0.1733333333333333,29,496,29,61127,544483,2224,105732,5.0435640446107675,0.16261082872588298
2442,0.173361111111111,0,1,0,61128,544482,2224,105732,5.04355478157768,0.16261107881405198
2443,0.1734285714285714,0,5,0,61133,544477,2224,105732,5.043508466412242,0.16261232926643587
2444,0.1734444444444444,0,1,0,61134,544476,2224,105732,5.043499203379154,0.16261257935922044
2445,0.1734523809523809,1,1,1,61135,544475,2225,105731,5.043489940346067,0.1626115415729784
2446,0.1734761904761904,0,1,0,61136,544474,2225,105731,5.04348067731298,0.16261179166570544
2447,0.1735,1,19,1,61155,544455,2226,105730,5.043304679684316,0.16261525565800503
2448,0.1735714285714285,0,1,0,61156,544454,2226,105730,5.043295416651229,0.16261550576452205
2449,0.1736666666666666,2,10,2,61166,544444,2228,105728,5.043202786320353,0.16261543099364476
2450,0.1736904761904762,0,1,0,61167,544443,2228,105728,5.043193523287266,0.16261568110543226
2451,0.1737142857142857,0,4,0,61171,544439,2228,105728,5.043156471154915,0.16261668156027606
2452,0.17375,2,9,2,61180,544430,2230,105726,5.043073103857127,0.16261635668977906
2453,0.1737777777777777,0,1,0,61181,544429,2230,105726,5.04306384082404,0.16261660680914553
2454,0.1738095238095237,0,1,0,61182,544428,2230,105726,5.043054577790952,0.16261685692928138
2455,0.1738095238095238,0,4,0,61186,544424,2230,105726,5.043017525658602,0.16261785741751902
2456,0.1738333333333333,1,2,1,61188,544422,2231,105725,5.0429989995924265,0.1626170696780882
2457,0.1738690476190476,0,1,0,61189,544421,2231,105725,5.042989736559339,0.1626173198020137
2458,0.1738787878787878,0,4,0,61193,544417,2231,105725,5.0429526844269885,0.1626183203054102
2459,0.1738888888888888,0,1,0,61194,544416,2231,105725,5.042943421393901,0.16261857043318295
2460,0.1739166666666666,0,2,0,61196,544414,2231,105725,5.042924895327726,0.16261907069103684
2461,0.1739523809523809,0,2,0,61198,544412,2231,105725,5.042906369261551,0.16261957095196858
2462,0.174,2,85,2,61283,544327,2233,105723,5.042119011449109,0.16263825859549266
2463,0.174047619047619,0,1,0,61284,544326,2233,105723,5.0421097484160216,0.16263850878933742
2464,0.1740833333333333,0,1,0,61285,544325,2233,105723,5.042100485382933,0.16263875898395194
2465,0.174095238095238,1,1,1,61286,544324,2234,105722,5.042091222349846,0.16263772102281993
2466,0.1741111111111111,0,6,0,61292,544318,2234,105722,5.042035644151321,0.16263922220171068
2467,0.1741666666666666,1,54,1,61346,544264,2235,105721,5.041535440364593,0.16265144580259544
2468,0.1741666666666667,0,26,0,61372,544238,2235,105721,5.041294601504316,0.16265795227083554
2469,0.1742380952380952,0,1,0,61373,544237,2235,105721,5.041285338471229,0.16265820253000962
2470,0.1742857142857142,0,1,0,61374,544236,2235,105721,5.041276075438142,0.1626584527899538
2471,0.1742857142857143,0,16,0,61390,544220,2235,105721,5.041127866908741,0.16266245705379412
2472,0.174297619047619,0,1,0,61391,544219,2235,105721,5.0411186038756535,0.16266270732683016
2473,0.1743333333333333,1,17,1,61408,544202,2236,105720,5.040961132313164,0.16266567372700108
2474,0.1744047619047619,0,1,0,61409,544201,2236,105720,5.040951869280077,0.16266592401230304
2475,0.1744285714285714,0,2,0,61411,544199,2236,105720,5.040933343213902,0.16266642458521754
2476,0.1744444444444444,0,1,0,61412,544198,2236,105720,5.040924080180814,0.1626666748728301
2477,0.1744722222222222,0,1,0,61413,544197,2236,105720,5.040914817147727,0.1626669251612129
2478,0.1744761904761904,0,1,0,61414,544196,2236,105720,5.040905554114639,0.16266717545036588
2479,0.1745,3,13,3,61427,544183,2239,105717,5.040785134684501,0.1626665640867826
2480,0.1745238095238095,3,5,3,61432,544178,2242,105714,5.040738819519063,0.162663950317899
2481,0.174547619047619,0,1,0,61433,544177,2242,105714,5.040729556485976,0.16266420061210266
2482,0.1745714285714286,0,2,0,61435,544175,2242,105714,5.040711030419801,0.16266470120282078
2483,0.1745833333333333,1,8,1,61443,544167,2243,105713,5.0406369261551,0.1626654151535668
2484,0.1746111111111111,0,1,0,61444,544166,2243,105713,5.040627663122013,0.16266566545464617
2485,0.1746428571428571,0,1,0,61445,544165,2243,105713,5.040618400088925,0.16266591575649583
2486,0.1746666666666666,1,2,1,61447,544163,2244,105712,5.0405998740227504,0.1626651279092133
2487,0.1746666666666667,0,11,0,61458,544152,2244,105712,5.040497980658787,0.16266788127977547
2488,0.1747619047619047,1,5,1,61463,544147,2245,105711,5.040451665493349,0.16266784435984477
2489,0.1748095238095238,0,2,0,61465,544145,2245,105711,5.040433139427174,0.16266834498719715
2490,0.1748333333333333,0,5,0,61470,544140,2245,105711,5.040386824261736,0.1626695965690597
2491,0.1748571428571428,0,1,0,61471,544139,2245,105711,5.040377561228649,0.16266984688774333
2492,0.1748690476190476,0,1,0,61472,544138,2245,105711,5.0403682981955615,0.16267009720719736
2493,0.1748809523809524,0,2,0,61474,544136,2245,105711,5.040349772129386,0.16267059784841661
2494,0.1749047619047619,0,1,0,61475,544135,2245,105711,5.040340509096298,0.16267084817018185
2495,0.1749444444444444,0,1,0,61476,544134,2245,105711,5.040331246063211,0.1626710984927175
2496,0.1749999999999999,0,6,0,61482,544128,2245,105711,5.040275667864686,0.16267260044411
2497,0.175,41,946,41,62428,543182,2286,105670,5.0315128385638594,0.1628568610407304
2498,0.175047619047619,1,1,1,62429,543181,2287,105669,5.031503575530772,0.1628558218386376
2499,0.1751190476190476,0,1,0,62430,543180,2287,105669,5.031494312497684,0.1628560728305045
2500,0.1751666666666666,1,9,1,62439,543171,2288,105668,5.031410945199896,0.16285704157734046
2501,0.1751666666666667,0,1,0,62440,543170,2288,105668,5.031401682166809,0.16285729257534237
2502,0.1752380952380952,0,1,0,62441,543169,2288,105668,5.031392419133721,0.162857543574118
2503,0.1753333333333333,0,24,0,62465,543145,2288,105668,5.03117010633962,0.16286356777684788
2504,0.1753571428571428,0,5,0,62470,543140,2288,105668,5.031123791174182,0.16286482287518034
2505,0.1754166666666666,0,3,0,62473,543137,2288,105668,5.03109600207492,0.1628655759434653
2506,0.1754999999999999,0,1,0,62474,543136,2288,105668,5.0310867390418315,0.16286582696777455
2507,0.1755,1,3,1,62477,543133,2289,105667,5.031058949942569,0.16286528976572134
2508,0.1755238095238095,1,5,1,62482,543128,2290,105666,5.031012634777132,0.16286525461086263
2509,0.1755555555555555,0,1,0,62483,543127,2290,105666,5.031003371744044,0.1628655056389326
2510,0.1756666666666666,0,14,0,62497,543113,2290,105666,5.030873689280818,0.16286902011316642
2511,0.1756666666666667,0,1,0,62498,543112,2290,105666,5.030864426247731,0.16286927115284427
2512,0.1757142857142856,0,9,0,62507,543103,2290,105666,5.030781058949943,0.16287153054477016
2513,0.1757142857142857,0,2,0,62509,543101,2290,105666,5.0307625328837675,0.16287203264037783
2514,0.1757619047619047,0,1,0,62510,543100,2290,105666,5.03075326985068,0.16287228368934253
2515,0.1758333333333333,7,71,7,62581,543029,2297,105659,5.030095594501463,0.16288107688133588
2516,0.175845238095238,0,2,0,62583,543027,2297,105659,5.030077068435288,0.16288157906907194
2517,0.1759523809523809,0,2,0,62585,543025,2297,105659,5.0300585423691135,0.16288208125990467
2518,0.176,5,98,5,62683,542927,2302,105654,5.029150765126533,0.16290023913744003
2519,0.1760238095238095,0,1,0,62684,542926,2302,105654,5.029141502093445,0.16290049030189027
2520,0.1760833333333333,0,1,0,62685,542925,2302,105654,5.029132239060358,0.16290074146711503
2521,0.1761111111111111,0,1,0,62686,542924,2302,105654,5.029122976027271,0.16290099263311428
2522,0.1761190476190476,0,1,0,62687,542923,2302,105654,5.0291137129941825,0.16290124379988807
2523,0.1761428571428571,0,2,0,62689,542921,2302,105654,5.029095186928008,0.16290174613575917
2524,0.1761666666666666,0,3,0,62692,542918,2302,105654,5.0290673978287455,0.16290249964537476
2525,0.1761904761904762,0,6,0,62698,542912,2302,105654,5.029011819630219,0.16290400668551852
2526,0.1762380952380952,1,0,1,62698,542912,2303,105653,5.029011819630219,0.16290271599608366
2527,0.17625,0,3,0,62701,542909,2303,105653,5.028984030530957,0.16290346952180362
2528,0.1762619047619047,0,1,0,62702,542908,2303,105653,5.0289747674978695,0.16290372069859274
2529,0.1763333333333333,0,9,0,62711,542899,2303,105653,5.028891400200082,0.1629059813245507
2530,0.1763571428571428,0,1,0,62712,542898,2303,105653,5.028882137166994,0.16290623250908565
2531,0.1763809523809524,1,2,1,62714,542896,2304,105652,5.028863611100819,0.16290544416141906
2532,0.1764285714285714,0,2,0,62716,542894,2304,105652,5.028845085034644,0.16290594653270546
2533,0.1765,2,25,2,62741,542869,2306,105650,5.028613509207455,0.16290964489860743
2534,0.1765238095238095,1,0,1,62741,542869,2307,105649,5.028613509207455,0.16290835412432655
2535,0.176547619047619,0,1,0,62742,542868,2307,105649,5.028604246174368,0.16290860532568924
2536,0.1765833333333333,0,1,0,62743,542867,2307,105649,5.0285949831412795,0.1629088565278266
2537,0.1766666666666666,30,444,30,63187,542423,2337,105619,5.024482196450406,0.16298172032059652
2538,0.1767142857142857,0,1,0,63188,542422,2337,105619,5.024472933417318,0.16298197181968424
2539,0.1767619047619048,0,1,0,63189,542421,2337,105619,5.024463670384231,0.16298222331954818
2540,0.1767857142857143,0,3,0,63192,542418,2337,105619,5.024435881284968,0.1629829778237971
2541,0.1768333333333333,1,11,1,63203,542407,2338,105618,5.024333987921005,0.16298445276031018
2542,0.1769177489177489,0,1,0,63204,542406,2338,105618,5.024324724887918,0.16298470427021222
2543,0.1769404761904762,0,2,0,63206,542404,2338,105618,5.024306198821742,0.162985207292345
2544,0.1769444444444444,0,3,0,63209,542401,2338,105618,5.02427840972248,0.16298596183136604
2545,0.1769523809523809,0,1,0,63210,542400,2338,105618,5.024269146689392,0.16298621334592558
2546,0.1769625652125651,1,4,1,63214,542396,2339,105617,5.024232094557042,0.16298592775144943
2547,0.177,1,47,1,63261,542349,2340,105616,5.023796732001927,0.1629964581420293
2548,0.1770238095238095,0,1,0,63262,542348,2340,105616,5.023787468968839,0.1629967096937484
2549,0.1770833333333333,0,1,0,63263,542347,2340,105616,5.023778205935751,0.162996961246244
2550,0.1771111111111111,1,0,1,63263,542347,2341,105615,5.023778205935751,0.1629956694991373
2551,0.1771428571428571,0,8,0,63271,542339,2341,105615,5.0237041016710515,0.16299768193421138
2552,0.1771666666666667,0,3,0,63274,542336,2341,105615,5.023676312571789,0.16299843661017577
2553,0.1771868686868686,1,4,1,63278,542332,2342,105614,5.023639260439438,0.1629981510804913
2554,0.1772142857142857,0,2,0,63280,542330,2342,105614,5.023620734373263,0.16299865420468435
2555,0.1772222222222222,0,2,0,63282,542328,2342,105614,5.023602208307088,0.16299915733198342
2556,0.17725,0,1,0,63283,542327,2342,105614,5.023592945274,0.1629994088967977
2557,0.1772619047619047,0,2,0,63285,542325,2342,105614,5.023574419207826,0.1629999120287558
2558,0.1772857142857142,0,1,0,63286,542324,2342,105614,5.023565156174738,0.1630001635958996
2559,0.1773333333333333,1,33,1,63319,542291,2343,105613,5.023259476082848,0.1630071739023065
2560,0.1773809523809523,0,3,0,63322,542288,2343,105613,5.023231686983586,0.163007928680462
2561,0.1773809523809524,0,1,0,63323,542287,2343,105613,5.023222423950498,0.16300818027473377
2562,0.1774285714285714,0,1,0,63324,542286,2343,105613,5.023213160917411,0.16300843186978217
2563,0.1774603174603174,0,1,0,63325,542285,2343,105613,5.023203897884323,0.16300868346560723
2564,0.1774999999999999,0,3,0,63328,542282,2343,105613,5.02317610878506,0.1630094382577424
2565,0.1775,6,268,6,63596,542014,2349,105607,5.020693615917596,0.16306914074744333
2566,0.177563492063492,0,2,0,63598,542012,2349,105607,5.020675089851421,0.1630696443433562
2567,0.1775833333333333,0,2,0,63600,542010,2349,105607,5.020656563785246,0.16307014794237953
2568,0.1776190476190476,2,11,2,63611,541999,2351,105605,5.020554670421283,0.1630703331047986
2569,0.1776666666666666,1,14,1,63625,541985,2352,105604,5.020424987958057,0.16307256608744125
2570,0.1776666666666667,0,3,0,63628,541982,2352,105604,5.020397198858794,0.16307332153567247
2571,0.1777142857142857,0,1,0,63629,541981,2352,105604,5.020387935825707,0.16307357335330497
2572,0.17775,0,1,0,63630,541980,2352,105604,5.020378672792619,0.16307382517171518
2573,0.1777777777777777,0,5,0,63635,541975,2352,105604,5.020332357627182,0.16307508427543202
2574,0.1777857142857143,0,1,0,63636,541974,2352,105604,5.020323094594094,0.1630753360985086
2575,0.1778095238095238,0,1,0,63637,541973,2352,105604,5.0203138315610065,0.1630755879223629
2576,0.1778333333333333,0,5,0,63642,541968,2352,105604,5.020267516395569,0.16307684705330064
2577,0.1778571428571428,1,2,1,63644,541966,2353,105603,5.020248990329393,0.1630760583042116
2578,0.1778937728937729,1,1,1,63645,541965,2354,105602,5.020239727296306,0.16307501772017413
2579,0.1779047619047618,0,3,0,63648,541962,2354,105602,5.020211938197043,0.16307577320542835
2580,0.1779166666666666,0,1,0,63649,541961,2354,105602,5.020202675163956,0.16307602503540197
2581,0.1779285714285714,0,1,0,63650,541960,2354,105602,5.020193412130868,0.16307627686615336
2582,0.178,1,48,1,63698,541912,2355,105601,5.0197487865426655,0.163087073155288
2583,0.1780714285714285,0,1,0,63699,541911,2355,105601,5.019739523509578,0.16308732502254786
2584,0.1780952380952381,0,2,0,63701,541909,2355,105601,5.019720997443403,0.1630878287594014
2585,0.1781388888888888,0,1,0,63702,541908,2355,105601,5.019711734410316,0.16308808062899513
2586,0.1781666666666666,1,6,1,63708,541902,2356,105600,5.01965615621179,0.16308829934116034
2587,0.1782142857142857,0,5,0,63713,541897,2356,105600,5.0196098410463525,0.16308955871610217
2588,0.1782954545454545,0,2,0,63715,541895,2356,105600,5.019591314980177,0.16309006247152488
2589,0.1783333333333333,11,285,11,64000,541610,2367,105589,5.016951350550224,0.16314765628500663
2590,0.1783571428571428,0,1,0,64001,541609,2367,105589,5.016942087517137,0.16314790836807283
2591,0.1785,1,15,1,64016,541594,2368,105588,5.016803142020823,0.16315039664267547
2592,0.1785238095238095,0,4,0,64020,541590,2368,105588,5.016766089888473,0.1631514050230385
2593,0.1785714285714285,0,5,0,64025,541585,2368,105588,5.016719774723035,0.16315266551602123
2594,0.1785833333333333,0,1,0,64026,541584,2368,105588,5.016710511689948,0.163152917616955
2595,0.1786190476190476,0,2,0,64028,541582,2368,105588,5.016691985623773,0.16315342182115983
2596,0.1786666666666666,1,21,1,64049,541561,2369,105587,5.016497461928934,0.16315742303151676
2597,0.1786904761904762,1,1,1,64050,541560,2370,105586,5.016488198895846,0.16315638202198576
2598,0.1787063492063492,0,1,0,64051,541559,2370,105586,5.016478935862759,0.16315663413918055
2599,0.1787117604617604,1,0,1,64051,541559,2371,105585,5.016478935862759,0.1631553410060203
2600,0.1787142857142857,0,1,0,64052,541558,2371,105585,5.016469672829671,0.16315559312238562
2601,0.1787182539682539,0,1,0,64053,541557,2371,105585,5.016460409796584,0.1631558452395301
2602,0.17875,0,2,0,64055,541555,2371,105585,5.016441883730408,0.16315634947615662
2603,0.1788095238095238,0,2,0,64057,541553,2371,105585,5.016423357664234,0.16315685371589986
2604,0.1788333333333333,0,7,0,64064,541546,2371,105585,5.0163585164326205,0.16315861857954572
2605,0.1788571428571428,0,2,0,64066,541544,2371,105585,5.016339990366445,0.16315912283331455
2606,0.1788809523809523,0,2,0,64068,541542,2371,105585,5.016321464300271,0.1631596270902002
2607,0.1789285714285714,0,1,0,64069,541541,2371,105585,5.016312201267183,0.1631598792198119
2608,0.1789523809523809,0,2,0,64071,541539,2371,105585,5.016293675201008,0.16316038348137296
2609,0.1789761904761904,0,1,0,64072,541538,2371,105585,5.01628441216792,0.16316063561332236
2610,0.179,1,61,1,64133,541477,2372,105584,5.01571936714958,0.1631747238668379
2611,0.179047619047619,0,2,0,64135,541475,2372,105584,5.0157008410834045,0.16317522822493777
2612,0.1790476190476191,0,1,0,64136,541474,2372,105584,5.015691578050316,0.1631754804051569
2613,0.1790833333333333,0,1,0,64137,541473,2372,105584,5.015682315017229,0.16317573258615548
2614,0.1791428571428571,0,1,0,64138,541472,2372,105584,5.015673051984142,0.16317598476793355
2615,0.1791666666666666,4,81,4,64219,541391,2376,105580,5.01492274630405,0.16319124041108488
2616,0.1792481684981685,0,1,0,64220,541390,2376,105580,5.014913483270962,0.16319149265035474
2617,0.17925,0,1,0,64221,541389,2376,105580,5.014904220237875,0.16319174489040433
2618,0.1792857142857142,0,2,0,64223,541387,2376,105580,5.014885694171699,0.16319224937284282
2619,0.1792857142857143,0,8,0,64231,541379,2376,105580,5.014811589906999,0.16319426733378778
2620,0.1793333333333333,2,30,2,64261,541349,2378,105578,5.014533698914373,0.16319924813773423
2621,0.1793571428571428,0,1,0,64262,541348,2378,105578,5.014524435881285,0.163199500406538
2622,0.1794047619047619,0,1,0,64263,541347,2378,105578,5.014515172848197,0.16319975267612166
2623,0.1794329004329004,0,1,0,64264,541346,2378,105578,5.01450590981511,0.1632000049464852
2624,0.1794444444444444,0,3,0,64267,541343,2378,105578,5.0144781207158475,0.16320076176225537
2625,0.1794523809523809,0,3,0,64270,541340,2378,105578,5.014450331616585,0.16320151858504478
2626,0.1795,2,19,2,64289,541321,2380,105576,5.014274333987921,0.16320372485882606
2627,0.1795238095238095,0,5,0,64294,541316,2380,105576,5.014228018822483,0.16320498630374158
2628,0.1795833333333333,1,2,1,64296,541314,2381,105575,5.014209492756308,0.16320419731978747
2629,0.1796428571428571,0,1,0,64297,541313,2381,105575,5.014200229723221,0.16320444961106095
2630,0.1796666666666666,0,2,0,64299,541311,2381,105575,5.014181703657045,0.16320495419594797
2631,0.1796666666666667,0,5,0,64304,541306,2381,105575,5.014135388491607,0.16320621567181598
2632,0.1797142857142857,0,4,0,64308,541302,2381,105575,5.0140983363592575,0.16320722486655115
2633,0.1797619047619047,1,2,1,64310,541300,2382,105574,5.014079810293082,0.16320643587468348
2634,0.1798333333333333,0,7,0,64317,541293,2382,105574,5.01401496906147,0.16320820199515512
2635,0.1798531746031745,0,1,0,64318,541292,2382,105574,5.014005706028382,0.16320845430119993
2636,0.1798571428571428,0,2,0,64320,541290,2382,105574,5.013987179962207,0.16320895891562986
2637,0.1798809523809524,0,2,0,64322,541288,2382,105574,5.013968653896032,0.1632094635331802
2638,0.1799166666666666,0,1,0,64323,541287,2382,105574,5.0139593908629445,0.1632097158431255
2639,0.1799935064935064,0,2,0,64325,541285,2382,105574,5.013940864796769,0.16321022046535644
2640,0.1799999999999999,3,10,3,64335,541275,2385,105571,5.013848234465893,0.16320886269683973
2641,0.18,104,2849,104,67184,538426,2489,105467,4.987457853199452,0.16379584806792433
2642,0.1800021645021645,0,1,0,67185,538425,2489,105467,4.987448590166364,0.163796102451964
2643,0.1801190476190476,1,3,1,67188,538422,2490,105466,4.987420801067102,0.1637955669308948
2644,0.1801428571428571,0,1,0,67189,538421,2490,105466,4.987411538034014,0.16379582131647324
2645,0.1801666666666666,0,8,0,67197,538413,2490,105466,4.987337433769313,0.16379785642954656
2646,0.1802380952380952,0,1,0,67198,538412,2490,105466,4.987328170736226,0.1637981108222365
2647,0.1802857142857142,0,2,0,67200,538410,2490,105466,4.9873096446700504,0.163798619609987
2648,0.1803333333333333,0,19,0,67219,538391,2490,105466,4.987133647041388,0.1638034532512654
2649,0.1803571428571428,0,3,0,67222,538388,2490,105466,4.987105857942124,0.16380421648386126
2650,0.1803809523809524,0,1,0,67223,538387,2490,105466,4.987096594909037,0.16380447089630706
2651,0.1804166666666666,0,1,0,67224,538386,2490,105466,4.98708733187595,0.16380472530954318
2652,0.1804285714285714,0,3,0,67227,538383,2490,105466,4.987059542776687,0.16380548855399324
2653,0.1804999999999999,1,0,1,67227,538383,2491,105465,4.987059542776687,0.16380418980877473
2654,0.1805,1,6,1,67233,538377,2492,105464,4.987003964578162,0.16380441755029582
2655,0.1805238095238095,0,1,0,67234,538376,2492,105464,4.986994701545074,0.16380467196819085
2656,0.1805396825396825,0,2,0,67236,538374,2492,105464,4.986976175478898,0.1638051808063519
2657,0.1805555555555555,0,2,0,67238,538372,2492,105464,4.986957649412724,0.16380568964767425
2658,0.1805952380952381,0,3,0,67241,538369,2492,105464,4.986929860313461,0.16380645291558527
2659,0.1806666666666666,4,25,4,67266,538344,2496,105460,4.986698284486272,0.16380761846773242
2660,0.1806666666666667,0,5,0,67271,538339,2496,105460,4.986651969320834,0.16380889066307963
2661,0.1807142857142857,0,4,0,67275,538335,2496,105460,4.986614917188485,0.16380990843358523
2662,0.1807857142857143,0,1,0,67276,538334,2496,105460,4.9866056541553965,0.16381016287818775
2663,0.1808333333333333,5,76,5,67352,538258,2501,105455,4.9859016636407425,0.1638230080796877
2664,0.1809285714285714,0,1,0,67353,538257,2501,105455,4.985892400607655,0.1638232625770531
2665,0.1809523809523809,0,2,0,67355,538255,2501,105455,4.98587387454148,0.16382377157415606
2666,0.181,4,40,4,67395,538215,2505,105451,4.985503353217978,0.16382875590756696
2667,0.1810714285714285,0,2,0,67397,538213,2505,105451,4.985484827151803,0.16382926495811478
2668,0.1810714285714286,0,1,0,67398,538212,2505,105451,4.985475564118715,0.163829519484575
2669,0.1810833333333333,0,1,0,67399,538211,2505,105451,4.985466301085627,0.16382977401182608
2670,0.1811111111111111,0,1,0,67400,538210,2505,105451,4.98545703805254,0.16383002853986803
2671,0.1811547619047619,0,3,0,67403,538207,2505,105451,4.985429248953277,0.1638307921287392
2672,0.1811666666666666,1,6,1,67409,538201,2506,105450,4.985373670754752,0.16383102022679993
2673,0.1811904761904762,1,6,1,67415,538195,2507,105449,4.985318092556227,0.16383124832982207
2674,0.1812069597069596,0,1,0,67416,538194,2507,105449,4.985308829523139,0.1638315028672727
2675,0.18125,1,2,1,67418,538192,2508,105448,4.985290303456964,0.16383071282083153
2676,0.1812857142857142,0,1,0,67419,538191,2508,105448,4.985281040423876,0.163830967359032
2677,0.1813095238095238,1,2,1,67421,538189,2509,105447,4.985262514357701,0.16383017730518493
2678,0.1813333333333333,1,19,1,67440,538170,2510,105446,4.985086516729038,0.16383371451300155
2679,0.1814285714285714,2,4,2,67444,538166,2512,105444,4.985049464596687,0.16383213436708566
2680,0.1814365079365079,0,1,0,67445,538165,2512,105444,4.9850402015636,0.16383238891935942
2681,0.1815,0,25,0,67470,538140,2512,105444,4.984808625736411,0.16383875298329356
2682,0.1815238095238094,0,1,0,67471,538139,2512,105444,4.984799362703323,0.16383900755613495
2683,0.181547619047619,0,1,0,67472,538138,2512,105444,4.984790099670236,0.16383926212976746
2684,0.1815833333333333,0,1,0,67473,538137,2512,105444,4.984780836637149,0.16383951670419108
2685,0.1815952380952381,0,1,0,67474,538136,2512,105444,4.9847715736040605,0.16383977127940583
2686,0.1816190476190476,0,1,0,67475,538135,2512,105444,4.984762310570973,0.1638400258554117
2687,0.1816363636363636,0,2,0,67477,538133,2512,105444,4.984743784504798,0.1638405350097968
2688,0.1816666666666666,11,298,11,67775,537835,2523,105433,4.981983400644707,0.16390213721186192
2689,0.1816904761904761,0,1,0,67776,537834,2523,105433,4.981974137611619,0.16390239200829515
2690,0.1817142857142857,0,1,0,67777,537833,2523,105433,4.981964874578532,0.16390264680552058
2691,0.1817857142857143,0,1,0,67778,537832,2523,105433,4.981955611545445,0.1639029016035382
2692,0.1818333333333333,2,16,2,67794,537816,2525,105431,4.9818074030160435,0.16390437887778722
2693,0.1818571428571428,0,1,0,67795,537815,2525,105431,4.981798139982956,0.1639046336860237
2694,0.1818809523809524,0,1,0,67796,537814,2525,105431,4.981788876949868,0.16390488849505244
2695,0.1819047619047619,0,2,0,67798,537812,2525,105431,4.981770350883694,0.16390539811548668
2696,0.1819444444444444,0,1,0,67799,537811,2525,105431,4.981761087850606,0.16390565292689221
2697,0.182,3,59,3,67858,537752,2528,105428,4.98121456889844,0.16391678845735252
2698,0.1820238095238095,0,1,0,67859,537751,2528,105428,4.981205305865353,0.16391704331142654
2699,0.182047619047619,0,1,0,67860,537750,2528,105428,4.981196042832265,0.163917298166293
2700,0.1820833333333333,0,3,0,67863,537747,2528,105428,4.981168253733002,0.16391806273564738
2701,0.1821428571428571,0,5,0,67868,537742,2528,105428,4.981121938567565,0.1639193370337547
2702,0.1821666666666666,0,3,0,67871,537739,2528,105428,4.981094149468302,0.16392010162212925
2703,0.1821666666666667,0,2,0,67873,537737,2528,105428,4.981075623402127,0.16392061135167493
2704,0.1822222222222222,0,2,0,67875,537735,2528,105428,4.981057097335952,0.16392112108439075
2705,0.1822499999999999,0,1,0,67876,537734,2528,105428,4.981047834302864,0.16392137595193745
2706,0.1822777777777778,0,1,0,67877,537733,2528,105428,4.981038571269776,0.16392163082027672
2707,0.1822857142857143,0,3,0,67880,537730,2528,105428,4.981010782170514,0.16392239543004986
2708,0.1823095238095238,1,0,1,67880,537730,2529,105427,4.981010782170514,0.16392109547124575
2709,0.1823333333333333,1,19,1,67899,537711,2530,105426,4.980834784541851,0.16392463814086267
2710,0.1823650793650793,0,1,0,67900,537710,2530,105426,4.980825521508763,0.1639248930241815
2711,0.1823809523809523,0,1,0,67901,537709,2530,105426,4.980816258475675,0.16392514790829296
2712,0.1823888888888888,0,2,0,67903,537707,2530,105426,4.9807977324095,0.16392565767889378
2713,0.1824166666666666,0,1,0,67904,537706,2530,105426,4.980788469376413,0.16392591256538316
2714,0.1824523809523809,0,1,0,67905,537705,2530,105426,4.980779206343325,0.16392616745266517
2715,0.1824999999999999,0,4,0,67909,537701,2530,105426,4.980742154210975,0.1639271870097197
2716,0.1825,11,277,11,68186,537424,2541,105415,4.978176294045722,0.16398351686814272
2717,0.1825595238095237,1,1,1,68187,537423,2542,105414,4.978167031012635,0.16398247145077213
2718,0.1826190476190476,0,1,0,68188,537422,2542,105414,4.978157767979547,0.1639827265430063
2719,0.1826666666666666,1,32,1,68220,537390,2543,105413,4.977861350920746,0.16398958934541374
2720,0.1826666666666667,0,5,0,68225,537385,2543,105413,4.977815035755308,0.16399086493735202
2721,0.1827272727272727,0,2,0,68227,537383,2543,105413,4.977796509689132,0.16399137517968376
2722,0.18275,0,2,0,68229,537381,2543,105413,4.977777983622958,0.16399188542519066
2723,0.1827619047619047,0,3,0,68232,537378,2543,105413,4.977750194523695,0.16399265079940448
2724,0.1827777777777778,0,1,0,68233,537377,2543,105413,4.977740931490607,0.16399290592573001
2725,0.1827896825396825,1,1,1,68234,537376,2544,105412,4.97773166845752,0.16399186045788036
2726,0.1828095238095238,0,2,0,68236,537374,2544,105412,4.9777131423913445,0.1639923707112476
2727,0.1828333333333333,1,9,1,68245,537365,2545,105411,4.977629775093557,0.16399336627378744
2728,0.1828511488511488,0,1,0,68246,537364,2545,105411,4.9776205120604695,0.1639936214071798
2729,0.1828571428571428,2,11,2,68257,537353,2547,105409,4.977518618696506,0.16399382664189854
2730,0.1829047619047619,0,1,0,68258,537352,2547,105409,4.977509355663418,0.16399408178156422
2731,0.1829166666666666,0,2,0,68260,537350,2547,105409,4.977490829597244,0.1639945920632772
2732,0.1829444444444444,0,1,0,68261,537349,2547,105409,4.977481566564156,0.16399484720532456
2733,0.1829523809523809,0,2,0,68263,537347,2547,105409,4.97746304049798,0.16399535749180094
2734,0.1829761904761904,0,2,0,68265,537345,2547,105409,4.977444514431806,0.16399586778145295
2735,0.1829999999999999,0,1,0,68266,537344,2547,105409,4.977435251398718,0.16399612292746982
2736,0.183,2,33,2,68299,537311,2549,105407,4.977129571306829,0.16400194175361513
2737,0.1830952380952381,0,7,0,68306,537304,2549,105407,4.977064730075216,0.16400372795860035
2738,0.1831666666666666,0,6,0,68312,537298,2549,105407,4.977009151876691,0.16400525902241309
2739,0.1831666666666667,0,2,0,68314,537296,2549,105407,4.976990625810515,0.16400576938336991
2740,0.1832535014005602,1,1,1,68315,537295,2550,105406,4.976981362777428,0.1640047238140286
2741,0.1832857142857143,0,1,0,68316,537294,2550,105406,4.97697209974434,0.1640049789948654
2742,0.1833333333333333,29,489,29,68805,536805,2579,105377,4.9724424765645265,0.16409211095919848
2743,0.1833452380952381,0,2,0,68807,536803,2579,105377,4.972423950498351,0.16409262200629107
2744,0.1834047619047618,0,1,0,68808,536802,2579,105377,4.972414687465264,0.16409287753103108
2745,0.1834126984126984,0,1,0,68809,536801,2579,105377,4.972405424432176,0.16409313305656686
2746,0.1834307359307359,0,1,0,68810,536800,2579,105377,4.972396161399089,0.1640933885828985
2747,0.1834682539682539,0,1,0,68811,536799,2579,105377,4.972386898366001,0.16409364411002592
2748,0.1834999999999999,0,1,0,68812,536798,2579,105377,4.972377635332913,0.16409389963794915
2749,0.1835,1,9,1,68821,536789,2580,105376,4.972294268035125,0.16409489772877686
2750,0.1835238095238095,0,1,0,68822,536788,2580,105376,4.972285005002038,0.16409515326302937
2751,0.1835714285714285,0,1,0,68823,536787,2580,105376,4.97227574196895,0.16409540879807774
2752,0.1835833333333333,0,1,0,68824,536786,2580,105376,4.972266478935863,0.16409566433392198
2753,0.1835952380952381,0,2,0,68826,536784,2580,105376,4.9722479528696875,0.164096175407998
2754,0.1836190476190476,0,2,0,68828,536782,2580,105376,4.972229426803513,0.16409668648525752
2755,0.1836428571428571,0,1,0,68829,536781,2580,105376,4.972220163770425,0.1640969420250811
2756,0.1836666666666666,0,11,0,68840,536770,2580,105376,4.972118270406462,0.16409975301566934
2757,0.1836904761904761,0,1,0,68841,536769,2580,105376,4.9721090073733745,0.16410000856504373
2758,0.1837380952380952,0,2,0,68843,536767,2580,105376,4.972090481307199,0.16410051966618028
2759,0.18375,0,6,0,68849,536761,2580,105376,4.972034903108674,0.16410205298869243
2760,0.1837777777777778,0,1,0,68850,536760,2580,105376,4.972025640075587,0.1641023085452303
2761,0.1837857142857142,0,1,0,68851,536759,2580,105376,4.9720163770424985,0.1641025641025641
2762,0.1838095238095237,0,3,0,68854,536756,2580,105376,4.971988587943236,0.1641033307793413
2763,0.1838095238095238,0,4,0,68858,536752,2580,105376,4.971951535810886,0.16410435302618792
2764,0.1838333333333333,0,8,0,68866,536744,2580,105376,4.9718774315461856,0.16410639755808884
2765,0.1838571428571428,0,1,0,68867,536743,2580,105376,4.971868168513098,0.16410665312815848
2766,0.1839285714285714,0,1,0,68868,536742,2580,105376,4.97185890548001,0.16410690869902417
2767,0.1839444444444444,0,1,0,68869,536741,2580,105376,4.971849642446923,0.16410716427068586
2768,0.184,6,95,6,68964,536646,2586,105370,4.970969654303605,0.16412363554802373
2769,0.184047619047619,0,1,0,68965,536645,2586,105370,4.970960391270518,0.164123891186343
2770,0.184090909090909,0,1,0,68966,536644,2586,105370,4.97095112823743,0.16412414682545864
2771,0.1841428571428571,1,0,1,68966,536644,2587,105369,4.97095112823743,0.1641228448645121
2772,0.1841547619047619,0,1,0,68967,536643,2587,105369,4.970941865204343,0.16412310050279433
2773,0.1841666666666666,4,88,4,69055,536555,2591,105365,4.970126718292637,0.16414039132602193
2774,0.1842142857142857,0,1,0,69056,536554,2591,105365,4.97011745525955,0.16414064702867495
2775,0.1842857142857142,0,1,0,69057,536553,2591,105365,4.970108192226463,0.16414090273212467
2776,0.1842857142857143,0,6,0,69063,536547,2591,105365,4.970052614027938,0.16414243696955347
2777,0.1843095238095238,0,1,0,69064,536546,2591,105365,4.97004335099485,0.16414269267858006
2778,0.1843333333333333,0,21,0,69085,536525,2591,105365,4.969848827300011,0.16414806275218496
2779,0.1843809523809523,0,1,0,69086,536524,2591,105365,4.969839564266923,0.1641483184787401
2780,0.1844047619047619,0,1,0,69087,536523,2591,105365,4.969830301233836,0.16414857420609202
2781,0.1844444444444444,0,1,0,69088,536522,2591,105365,4.969821038200749,0.16414882993424076
2782,0.1844920634920634,0,1,0,69089,536521,2591,105365,4.969811775167661,0.1641490856631863
2783,0.1844999999999999,0,1,0,69090,536520,2591,105365,4.9698025121345735,0.16414934139292864
2784,0.1845,2,9,2,69099,536511,2593,105363,4.969719144836786,0.16414903859636004
2785,0.1845238095238095,0,2,0,69101,536509,2593,105363,4.96970061877061,0.16414955006605678
2786,0.1845357142857143,0,1,0,69102,536508,2593,105363,4.969691355737523,0.16414980580210042
2787,0.1845555555555555,0,2,0,69104,536506,2593,105363,4.969672829671348,0.16415031727657825
2788,0.1845714285714285,0,2,0,69106,536504,2593,105363,4.969654303605172,0.16415082875424347
2789,0.1845833333333333,0,2,0,69108,536502,2593,105363,4.969635777538997,0.16415134023509617
2790,0.1846428571428571,0,2,0,69110,536500,2593,105363,4.9696172514728225,0.16415185171913632
2791,0.1846666666666666,0,12,0,69122,536488,2593,105363,4.969506095075771,0.16415492069031598
2792,0.1847121212121212,0,2,0,69124,536486,2593,105363,4.969487569009597,0.1641554321966693
2793,0.1847142857142857,0,1,0,69125,536485,2593,105363,4.969478305976509,0.16415568795104138
2794,0.1847619047619047,1,3,1,69128,536482,2594,105362,4.969450516877246,0.1641551529655181
2795,0.1848095238095238,0,2,0,69130,536480,2594,105362,4.969431990811072,0.16415566447817376
2796,0.1848181818181818,0,1,0,69131,536479,2594,105362,4.969422727777983,0.164155920235697
2797,0.1848333333333333,0,8,0,69139,536471,2594,105362,4.969348623513283,0.16415796632457352
2798,0.1848809523809523,0,1,0,69140,536470,2594,105362,4.969339360480196,0.16415822208926947
2799,0.1848888888888888,0,1,0,69141,536469,2594,105362,4.969330097447108,0.1641584778547624
2800,0.1848928571428571,0,1,0,69142,536468,2594,105362,4.96932083441402,0.1641587336210523
2801,0.1849166666666666,0,1,0,69143,536467,2594,105362,4.969311571380933,0.16415898938813922
2802,0.1849285714285714,0,1,0,69144,536466,2594,105362,4.969302308347846,0.16415924515602312
2803,0.1849999999999999,0,5,0,69149,536461,2594,105362,4.969255993182408,0.16416052400739767
2804,0.185,58,949,58,70098,535512,2652,105304,4.960465374782319,0.16432798182317546
2805,0.185030303030303,1,0,1,70098,535512,2653,105303,4.960465374782319,0.16432667774630744
2806,0.1850952380952381,1,1,1,70099,535511,2654,105302,4.960456111749231,0.16432563009801612
2807,0.1851190476190476,0,1,0,70100,535510,2654,105302,4.960446848716144,0.1643258865314632
2808,0.1851428571428571,0,1,0,70101,535509,2654,105302,4.9604375856830565,0.16432614296571063
2809,0.1851666666666666,0,8,0,70109,535501,2654,105302,4.960363481418356,0.1643281944685028
2810,0.1851666666666667,0,4,0,70113,535497,2654,105302,4.960326429286005,0.16432922023910773
2811,0.1852207792207792,0,1,0,70114,535496,2654,105302,4.960317166252918,0.16432947668375994
2812,0.1852222222222222,0,3,0,70117,535493,2654,105302,4.960289377153655,0.1643302460225189
2813,0.1852380952380952,0,2,0,70119,535491,2654,105302,4.96027085108748,0.1643307589190269
2814,0.1853333333333332,0,1,0,70120,535490,2654,105302,4.960261588054393,0.1643310153684815
2815,0.1853333333333333,2,15,2,70135,535475,2656,105300,4.960122642558079,0.1643322539112793
2816,0.1853571428571428,0,1,0,70136,535474,2656,105300,4.960113379524992,0.16433251037027094
2817,0.1853690476190476,0,2,0,70138,535472,2656,105300,4.960094853458816,0.16433302329065563
2818,0.1854166666666666,0,1,0,70139,535471,2656,105300,4.960085590425729,0.1643332797520487
2819,0.1854444444444444,0,1,0,70140,535470,2656,105300,4.960076327392642,0.16433353621424224
2820,0.1854761904761904,0,4,0,70144,535466,2656,105300,4.960039275260291,0.16433456207102123
2821,0.1855,0,4,0,70148,535462,2656,105300,4.960002223127941,0.1643355879406082
2822,0.1855238095238095,0,3,0,70151,535459,2656,105300,4.959974434028679,0.1643363573512038
2823,0.1855555555555555,0,1,0,70152,535458,2656,105300,4.9599651709955905,0.16433661382300338
2824,0.1856666666666666,1,18,1,70170,535440,2657,105299,4.959798436400015,0.1643399262414181
2825,0.1856666666666667,2,5,2,70175,535435,2659,105297,4.959752121234577,0.16433860022599153
2826,0.1856796536796537,0,1,0,70176,535434,2659,105297,4.95974285820149,0.16433885671209916
2827,0.1857142857142857,0,7,0,70183,535427,2659,105297,4.959678016969876,0.16434065213726973
2828,0.1857380952380952,0,1,0,70184,535426,2659,105297,4.959668753936789,0.1643409086297823
2829,0.1857857142857143,0,1,0,70185,535425,2659,105297,4.959659490903702,0.16434116512309552
2830,0.1858333333333333,6,75,6,70260,535350,2665,105291,4.958964763422135,0.1643525781209757
2831,0.1858571428571429,0,2,0,70262,535348,2665,105291,4.95894623735596,0.16435309121049452
2832,0.1858800505050505,0,1,0,70263,535347,2665,105291,4.958936974322873,0.16435334775645527
2833,0.1859047619047619,1,1,1,70264,535346,2666,105290,4.9589277112897845,0.16435229990197242
2834,0.1859523809523809,1,7,1,70271,535339,2667,105289,4.958862870058172,0.1643527913235138
2835,0.1859999999999999,0,6,0,70277,535333,2667,105289,4.958807291859647,0.1643543306349142
2836,0.186,6,94,6,70371,535239,2673,105283,4.957936566749416,0.16437062271085146
2837,0.1860248917748918,0,1,0,70372,535238,2673,105283,4.957927303716329,0.16437087933104458
2838,0.1860714285714285,0,1,0,70373,535237,2673,105283,4.957918040683241,0.16437113595203898
2839,0.1861111111111111,0,6,0,70379,535231,2673,105283,4.957862462484716,0.16437267569483258
2840,0.1861666666666666,0,10,0,70389,535221,2673,105283,4.957769832153841,0.1643752419969274
2841,0.1861904761904761,0,3,0,70392,535218,2673,105283,4.957742043054578,0.16437601190318205
2842,0.1861904761904762,1,3,1,70395,535215,2674,105282,4.957714253955315,0.16437547716851134
2843,0.18625,0,3,0,70398,535212,2674,105282,4.957686464856052,0.1643762470842818
2844,0.1862619047619047,0,1,0,70399,535211,2674,105282,4.957677201822965,0.16437650372447474
2845,0.1862626262626262,1,0,1,70399,535211,2675,105281,4.957677201822965,0.16437519906571824
2846,0.1862857142857142,0,1,0,70400,535210,2675,105281,4.957667938789878,0.16437545570507625
2847,0.1863095238095238,0,1,0,70401,535209,2675,105281,4.9576586757567895,0.16437571234523568
2848,0.1863214285714286,0,2,0,70403,535207,2675,105281,4.957640149690615,0.16437622562795867
2849,0.1863333333333333,1,17,1,70420,535190,2676,105280,4.957482678128127,0.16437928396333942
2850,0.1863888888888888,0,1,0,70421,535189,2676,105280,4.957473415095039,0.16437954061789095
2851,0.1864047619047619,0,1,0,70422,535188,2676,105280,4.957464152061951,0.16437979727324395
2852,0.1864166666666666,0,2,0,70424,535186,2676,105280,4.957445625995776,0.1643803105863543
2853,0.1864285714285714,0,2,0,70426,535184,2676,105280,4.957427099929601,0.16438082390267056
2854,0.1865,0,19,0,70445,535165,2676,105280,4.957251102300938,0.16438570056757412
2855,0.1865079365079365,0,1,0,70446,535164,2676,105280,4.95724183926785,0.16438595724216326
2856,0.1865238095238095,0,2,0,70448,535162,2676,105280,4.957223313201675,0.1643864705937462
2857,0.1865714285714285,0,1,0,70449,535161,2676,105280,4.957214050168587,0.16438672727074
2858,0.1865833333333333,0,1,0,70450,535160,2676,105280,4.9572047871355,0.16438698394853538
2859,0.1866428571428571,0,3,0,70453,535157,2676,105280,4.957176998036237,0.16438775398673094
2860,0.1866666666666666,18,522,18,70975,534635,2694,105262,4.952341694764534,0.16449834895303464
2861,0.1866904761904762,0,2,0,70977,534633,2694,105262,4.952323168698358,0.16449886309472647
2862,0.1867222222222222,0,4,0,70981,534629,2694,105262,4.952286116566008,0.16449989138775198
2863,0.1867777777777778,0,2,0,70983,534627,2694,105262,4.952267590499833,0.16450040553908568
2864,0.1867857142857143,0,2,0,70985,534625,2694,105262,4.9522490644336585,0.1645009196936334
2865,0.1868095238095238,0,2,0,70987,534623,2694,105262,4.952230538367483,0.16450143385139518
2866,0.1868333333333333,0,3,0,70990,534620,2694,105262,4.952202749268221,0.1645022050940642
2867,0.1868571428571428,0,1,0,70991,534619,2694,105262,4.9521934862351324,0.16450246217656095
2868,0.1868690476190476,0,2,0,70993,534617,2694,105262,4.952174960168958,0.16450297634396502
2869,0.1869523809523809,0,1,0,70994,534616,2694,105262,4.95216569713587,0.16450323342887238
2870,0.1869761904761905,0,1,0,70995,534615,2694,105262,4.952156434102783,0.16450349051458327
2871,0.1869999999999999,0,2,0,70997,534613,2694,105262,4.952137908036607,0.1645040046884157
2872,0.187,1,35,1,71032,534578,2695,105261,4.951813701878543,0.16451169747389577
2873,0.1870238095238095,1,3,1,71035,534575,2696,105260,4.951785912779281,0.16451116303421975
2874,0.1870833333333333,0,2,0,71037,534573,2696,105260,4.951767386713105,0.16451167726578655
2875,0.1871111111111111,0,2,0,71039,534571,2696,105260,4.95174886064693,0.16451219150056812
2876,0.1871428571428571,0,14,0,71053,534557,2696,105260,4.951619178183704,0.164515791234056
2877,0.1871666666666666,1,3,1,71056,534554,2697,105259,4.951591389084442,0.1645152568015967
2878,0.1872142857142857,0,1,0,71057,534553,2697,105259,4.951582126051354,0.16451551393221758
2879,0.1872222222222222,0,1,0,71058,534552,2697,105259,4.951572863018266,0.16451577106364224
2880,0.1873333333333333,1,33,1,71091,534519,2698,105258,4.951267182926378,0.1645229509657271
2881,0.1873809523809523,0,1,0,71092,534518,2698,105258,4.95125791989329,0.164523208122843
2882,0.1874285714285714,0,2,0,71094,534516,2698,105258,4.951239393827115,0.16452372243948643
2883,0.1874761904761904,0,2,0,71096,534514,2698,105258,4.95122086776094,0.16452423675934552
2884,0.1874999999999999,0,4,0,71100,534510,2698,105258,4.951183815628589,0.16452526540871065
2885,0.1875,17,279,17,71379,534231,2715,105241,4.948599429397162,0.16457483674031076
2886,0.1875595238095238,1,0,1,71379,534231,2716,105240,4.948599429397162,0.16457353030864574
2887,0.1876190476190476,1,5,1,71384,534226,2717,105239,4.948553114231724,0.16457351066907494
2888,0.1876666666666666,3,7,3,71391,534219,2720,105236,4.948488273000111,0.164571392826704
2889,0.1876666666666667,1,3,1,71394,534216,2721,105235,4.948460483900848,0.16457085843950514
2890,0.1877023809523809,0,1,0,71395,534215,2721,105235,4.948451220867761,0.1645711158026429
2891,0.1877619047619047,0,1,0,71396,534214,2721,105235,4.948441957834674,0.1645713731665856
2892,0.1877777777777777,0,2,0,71398,534212,2721,105235,4.948423431768498,0.1645718878968859
2893,0.1877777777777778,0,2,0,71400,534210,2721,105235,4.948404905702323,0.16457240263040607
2894,0.1877857142857142,0,1,0,71401,534209,2721,105235,4.948395642669236,0.1645726599983736
2895,0.1878333333333333,0,7,0,71408,534202,2721,105235,4.948330801437622,0.16457446159668584
2896,0.1878571428571428,0,9,0,71417,534193,2721,105235,4.948247434139835,0.16457677799533332
2897,0.1879166666666666,0,4,0,71421,534189,2721,105235,4.948210382007485,0.1645778075267741
2898,0.1879285714285714,1,2,1,71423,534187,2722,105234,4.948191855941309,0.16457701576895348
2899,0.1879696969696969,0,1,0,71424,534186,2722,105234,4.948182592908222,0.16457727315379564
2900,0.1879999999999999,0,1,0,71425,534185,2722,105234,4.948173329875134,0.16457753053944285
2901,0.188,1,63,1,71488,534122,2723,105233,4.947589758790619,0.16459244081926316
2902,0.1880238095238095,0,4,0,71492,534118,2723,105233,4.947552706658268,0.1645934705662461
2903,0.1880555555555555,0,1,0,71493,534117,2723,105233,4.947543443625181,0.16459372800500507
2904,0.1880952380952381,0,3,0,71496,534114,2723,105233,4.947515654525918,0.164594500326114
2905,0.1881428571428571,0,1,0,71497,534113,2723,105233,4.947506391492831,0.16459475776809426
2906,0.1881666666666666,3,12,3,71509,534101,2726,105230,4.9473952350957795,0.16459392708941065
2907,0.1882619047619047,0,1,0,71510,534100,2726,105230,4.947385972062692,0.1645941845369371
2908,0.1883041125541126,1,1,1,71511,534099,2727,105229,4.947376709029605,0.16459313529205666
2909,0.1883333333333333,14,294,14,71805,533805,2741,105215,4.944653377301864,0.1646505586679603
2910,0.188345238095238,0,1,0,71806,533804,2741,105215,4.944644114268776,0.16465081632940493
2911,0.1883809523809523,0,1,0,71807,533803,2741,105215,4.944634851235689,0.16465107399165596
2912,0.1884166666666666,0,1,0,71808,533802,2741,105215,4.944625588202601,0.1646513316547134
2913,0.1884285714285714,0,1,0,71809,533801,2741,105215,4.944616325169513,0.16465158931857732
2914,0.1884523809523809,0,2,0,71811,533799,2741,105215,4.944597799103338,0.16465210464872443
2915,0.1884761904761905,0,1,0,71812,533798,2741,105215,4.944588536070251,0.16465236231500768
2916,0.1885,1,23,1,71835,533775,2742,105214,4.944375486309237,0.16465698157558267
2917,0.1885238095238095,0,1,0,71836,533774,2742,105214,4.944366223276149,0.1646572392595792
2918,0.188547619047619,0,1,0,71837,533773,2742,105214,4.944356960243062,0.16465749694438228
2919,0.1885714285714285,0,10,0,71847,533763,2742,105214,4.944264329912186,0.16466007383677347
2920,0.1886428571428571,0,1,0,71848,533762,2742,105214,4.944255066879099,0.1646603315304487
2921,0.1886666666666666,1,25,1,71873,533737,2743,105213,4.94402349105191,0.16466546678143829
2922,0.1886904761904762,1,2,1,71875,533735,2744,105212,4.9440049649857345,0.1646646748478356
2923,0.1887142857142857,0,1,0,71876,533734,2744,105212,4.943995701952647,0.16466493256081108
2924,0.1887222222222222,1,2,1,71878,533732,2745,105211,4.943977175886472,0.1646641406197423
2925,0.18875,0,4,0,71882,533728,2745,105211,4.943940123754122,0.1646651714795935
2926,0.1888095238095238,0,1,0,71883,533727,2745,105211,4.943930860721035,0.16466542919657307
2927,0.1888333333333333,1,3,1,71886,533724,2746,105210,4.943903071621772,0.1646648949656772
2928,0.1888787878787878,0,2,0,71888,533722,2746,105210,4.943884545555597,0.16466541040361102
2929,0.1888888888888888,0,3,0,71891,533719,2746,105210,4.943856756456334,0.16466618356656218
2930,0.1889285714285714,0,2,0,71893,533717,2746,105210,4.943838230390159,0.16466669901256326
2931,0.1889404761904761,0,1,0,71894,533716,2746,105210,4.943828967357072,0.1646669567367739
2932,0.1889999999999999,7,53,7,71947,533663,2753,105203,4.943338026603431,0.16467146475160677
2933,0.189,0,6,0,71953,533657,2753,105203,4.943282448404906,0.1646730113013806
2934,0.189047619047619,0,4,0,71957,533653,2753,105203,4.943245396272555,0.16467404235070188
2935,0.1890714285714285,0,1,0,71958,533652,2753,105203,4.943236133239468,0.16467430011504958
2936,0.1890753968253968,0,1,0,71959,533651,2753,105203,4.94322687020638,0.16467455788020424
2937,0.1890952380952381,0,1,0,71960,533650,2753,105203,4.943217607173293,0.16467481564616587
2938,0.1891666666666666,4,113,4,72073,533537,2757,105199,4.9421708844343994,0.16469871746699732
2939,0.1892142857142857,0,3,0,72076,533534,2757,105199,4.942143095335137,0.16469949102363585
2940,0.1892857142857142,0,1,0,72077,533533,2757,105199,4.942133832302049,0.16469974887746347
2941,0.1892857142857143,0,9,0,72086,533524,2757,105199,4.942050465004261,0.16470206959824524
2942,0.1893333333333333,4,27,4,72113,533497,2761,105195,4.941800363110897,0.16470380089307524
2943,0.1893571428571428,0,4,0,72117,533493,2761,105195,4.941763310978547,0.1647048324064332
2944,0.1893939393939393,0,1,0,72118,533492,2761,105195,4.94175404794546,0.1647050902867915
2945,0.1894285714285714,0,1,0,72119,533491,2761,105195,4.9417447849123715,0.16470534816795734
2946,0.1894444444444444,0,2,0,72121,533489,2761,105195,4.941726258846197,0.16470586393271164
2947,0.1895,1,11,1,72132,533478,2762,105194,4.941624365482234,0.1647073928401433
2948,0.1895238095238094,0,2,0,72134,533476,2762,105194,4.9416058394160585,0.16470790862260634
2949,0.1895238095238095,0,4,0,72138,533472,2762,105194,4.941568787283708,0.1647089401972236
2950,0.1895555555555555,0,1,0,72139,533471,2762,105194,4.9415595242506205,0.1647091980928969
2951,0.1895833333333333,0,2,0,72141,533469,2762,105194,4.941540998184445,0.16470971388666636
2952,0.1896190476190476,2,2,2,72143,533467,2764,105192,4.941522472118271,0.16470761392229658
2953,0.1896428571428571,0,3,0,72146,533464,2764,105192,4.941494683019008,0.16470838761398937
2954,0.1896666666666666,2,18,2,72164,533446,2766,105190,4.941327948423432,0.16471041406998665
2955,0.1897056277056277,0,3,0,72167,533443,2766,105190,4.941300159324169,0.16471118780269733
2956,0.18975,0,3,0,72170,533440,2766,105190,4.941272370224906,0.16471196154267728
2957,0.1897619047619047,0,2,0,72172,533438,2766,105190,4.941253844158731,0.16471247737336916
2958,0.1897777777777777,0,1,0,72173,533437,2766,105190,4.941244581125644,0.16471273528992667
2959,0.1898333333333333,0,11,0,72184,533426,2766,105190,4.941142687761681,0.16471557242536985
2960,0.1899999999999999,1,12,1,72196,533414,2767,105189,4.94103153136463,0.16471735961152703
2961,0.19,139,3016,139,75212,530398,2906,105050,4.913094223572567,0.16531643816645894
2962,0.1900714285714285,0,1,0,75213,530397,2906,105050,4.913084960539479,0.1653166983241718
2963,0.1901190476190476,0,1,0,75214,530396,2906,105050,4.913075697506391,0.16531695848270347
2964,0.1901666666666666,0,4,0,75218,530392,2906,105050,4.913038645374042,0.1653179991250185
2965,0.1901666666666667,0,2,0,75220,530390,2906,105050,4.913020119307866,0.165318519451089
2966,0.1901904761904762,0,1,0,75221,530389,2906,105050,4.913010856274779,0.16531877961535255
2967,0.1902272727272727,0,1,0,75222,530388,2906,105050,4.913001593241691,0.1653190397804349
2968,0.1902380952380952,0,3,0,75225,530385,2906,105050,4.912973804142428,0.1653198202805952
2969,0.1902619047619047,0,1,0,75226,530384,2906,105050,4.912964541109341,0.165320080448953
2970,0.1903095238095238,0,1,0,75227,530383,2906,105050,4.912955278076253,0.1653203406181297
2971,0.1903333333333333,0,16,0,75243,530367,2906,105050,4.912807069546853,0.16532450343632607
2972,0.1903571428571428,0,2,0,75245,530365,2906,105050,4.912788543480677,0.16532502380334113
2973,0.1904166666666666,0,7,0,75252,530358,2906,105050,4.912723702249065,0.16532684511369072
2974,0.1904285714285714,0,2,0,75254,530356,2906,105050,4.9127051761828895,0.165327365495447
2975,0.1904444444444444,0,1,0,75255,530355,2906,105050,4.912695913149801,0.1653276256875536
2976,0.1904523809523809,0,1,0,75256,530354,2906,105050,4.912686650116714,0.1653278858804792
2977,0.1904761904761904,0,3,0,75259,530351,2906,105050,4.9126588610174515,0.16532866646416988
2978,0.1904999999999999,0,3,0,75262,530348,2906,105050,4.912631071918189,0.16532944705523153
2979,0.1905,1,16,1,75278,530332,2907,105049,4.912482863388788,0.16533229668498114
2980,0.190547619047619,0,1,0,75279,530331,2907,105049,4.912473600355701,0.1653325568950864
2981,0.1905833333333333,0,1,0,75280,530330,2907,105049,4.912464337322613,0.16533281710601075
2982,0.1906190476190476,0,2,0,75282,530328,2907,105049,4.912445811256438,0.16533333753031665
2983,0.1906428571428571,0,2,0,75284,530326,2907,105049,4.912427285190263,0.16533385795789887
2984,0.1906666666666666,1,25,1,75309,530301,2908,105048,4.912195709363074,0.16533904987652456
2985,0.1906666666666667,0,7,0,75316,530294,2908,105048,4.912130868131461,0.16534087153060872
2986,0.1906746031746032,1,0,1,75316,530294,2909,105047,4.912130868131461,0.16533955781226145
2987,0.1907142857142857,0,4,0,75320,530290,2909,105047,4.9120938159991105,0.16534059876884236
2988,0.1908333333333333,4,88,4,75408,530202,2913,105043,4.911278669087406,0.16535824760525467
2989,0.1908571428571428,0,1,0,75409,530201,2913,105043,4.911269406054318,0.16535850791192047
2990,0.1909523809523809,0,2,0,75411,530199,2913,105043,4.911250879988144,0.1653590285277107
2991,0.1909999999999999,0,4,0,75415,530195,2913,105043,4.911213827855793,0.1653600697691259
2992,0.191,0,44,0,75459,530151,2913,105043,4.910806254399941,0.16537152429021684
2993,0.1910238095238095,0,1,0,75460,530150,2913,105043,4.910796991366853,0.16537178463868463
2994,0.1910833333333333,0,1,0,75461,530149,2913,105043,4.910787728333766,0.16537204498797214
2995,0.1911666666666666,0,9,0,75470,530140,2913,105043,4.910704361035978,0.1653743881684491
2996,0.1911904761904761,0,1,0,75471,530139,2913,105043,4.91069509800289,0.1653746485259343
2997,0.1911904761904762,0,1,0,75472,530138,2913,105043,4.910685834969803,0.1653749088842393
2998,0.19125,0,3,0,75475,530135,2913,105043,4.91065804587054,0.16537568996407306
2999,0.1912513597513597,0,2,0,75477,530133,2913,105043,4.910639519804365,0.16537621068806127
3000,0.1912698412698412,0,1,0,75478,530132,2913,105043,4.910630256771277,0.16537647105128508
3001,0.1913095238095238,0,2,0,75480,530130,2913,105043,4.910611730705102,0.16537699178019216
3002,0.1913333333333333,0,23,0,75503,530107,2913,105043,4.9103986809440885,0.1653829803983311
3003,0.1913809523809524,0,1,0,75504,530106,2913,105043,4.910389417911,0.16538324078287142
3004,0.1913888888888888,0,1,0,75505,530105,2913,105043,4.910380154877913,0.16538350116823167
3005,0.1914166666666666,1,0,1,75505,530105,2914,105042,4.910380154877913,0.16538218711573857
3006,0.1914285714285714,0,7,0,75512,530098,2914,105042,4.910315313646301,0.1653840098246056
3007,0.1914393939393939,0,1,0,75513,530097,2914,105042,4.910306050613213,0.16538427021486635
3008,0.1914761904761904,0,3,0,75516,530094,2914,105042,4.91027826151395,0.16538505139056833
3009,0.1914999999999999,2,10,2,75526,530084,2916,105040,4.910185631183075,0.1653850271757956
3010,0.1915,0,5,0,75531,530079,2916,105040,4.910139316017637,0.16538632917610716
3011,0.191547619047619,0,1,0,75532,530078,2916,105040,4.910130052984549,0.16538658957862948
3012,0.1915714285714286,0,1,0,75533,530077,2916,105040,4.910120789951462,0.1653868499819718
3013,0.1916071428571428,0,3,0,75536,530074,2916,105040,4.910093000852199,0.165387631196919
3014,0.1916666666666666,25,263,25,75799,529811,2941,105015,4.907656823150172,0.16542328134008374
3015,0.1917619047619047,1,0,1,75799,529811,2942,105014,4.907656823150172,0.16542196668373174
3016,0.1917857142857143,0,2,0,75801,529809,2942,105014,4.907638297083997,0.16542248784306807
3017,0.1918095238095238,0,1,0,75802,529808,2942,105014,4.90762903405091,0.16542274842396767
3018,0.1918181818181818,0,1,0,75803,529807,2942,105014,4.907619771017822,0.1654230090056882
3019,0.1918333333333333,1,7,1,75810,529800,2943,105013,4.907554929786209,0.16542351842196049
3020,0.1918571428571428,1,0,1,75810,529800,2944,105012,4.907554929786209,0.16542220373905975
3021,0.1919126984126984,1,0,1,75810,529800,2945,105011,4.907554929786209,0.16542088905201704
3022,0.1919999999999999,0,1,0,75811,529799,2945,105011,4.907545666753122,0.16542114963532395
3023,0.192,2,60,2,75871,529739,2947,105009,4.906989884767868,0.16543415654716517
3024,0.1920238095238095,0,1,0,75872,529738,2947,105009,4.906980621734781,0.16543441717723756
3025,0.1920555555555555,0,1,0,75873,529737,2947,105009,4.906971358701694,0.16543467780813112
3026,0.1920833333333333,0,3,0,75876,529734,2947,105009,4.906943569602431,0.16543545970573917
3027,0.1920952380952381,0,2,0,75878,529732,2947,105009,4.906925043536256,0.16543598097491732
3028,0.1921428571428571,0,4,0,75882,529728,2947,105009,4.906887991403905,0.16543702352312847
3029,0.1921666666666666,0,5,0,75887,529723,2947,105009,4.906841676238468,0.16543832672687056
3030,0.1922222222222222,0,1,0,75888,529722,2947,105009,4.90683241320538,0.16543858737008277
3031,0.1923076923076923,0,1,0,75889,529721,2947,105009,4.9068231501722925,0.16543884801411624
3032,0.1923333333333333,0,20,0,75909,529701,2947,105009,4.906637889510542,0.16544406106725906
3033,0.1923809523809523,2,4,2,75913,529697,2949,105007,4.906600837378191,0.16544247397211928
3034,0.1923888888888888,0,1,0,75914,529696,2949,105007,4.906591574345104,0.16544273463336395
3035,0.1924404761904762,0,2,0,75916,529694,2949,105007,4.906573048278928,0.16544325595831738
3036,0.1924444444444444,0,1,0,75917,529693,2949,105007,4.906563785245841,0.16544351662202617
3037,0.1924999999999999,1,3,1,75920,529690,2950,105006,4.906535996146578,0.16544298372764285
3038,0.1925,8,262,8,76182,529428,2958,104998,4.904109081477639,0.1655007833852963
3039,0.1925238095238095,0,1,0,76183,529427,2958,104998,4.904099818444552,0.16550104425266973
3040,0.1925555555555555,0,1,0,76184,529426,2958,104998,4.9040905554114635,0.16550130512086553
3041,0.1926190476190476,0,1,0,76185,529425,2958,104998,4.904081292378376,0.16550156598988372
3042,0.1926428571428571,0,2,0,76187,529423,2958,104998,4.904062766312201,0.16550208773038724
3043,0.1926666666666666,0,38,0,76225,529385,2958,104998,4.903710771054874,0.16551200142500666
3044,0.1927777777777778,0,1,0,76226,529384,2958,104998,4.903701508021786,0.16551226232774574
3045,0.1927857142857142,0,1,0,76227,529383,2958,104998,4.903692244988699,0.16551252323130736
3046,0.1928333333333333,0,11,0,76238,529372,2958,104998,4.903590351624736,0.16551539322477418
3047,0.1928571428571428,0,12,0,76250,529360,2958,104998,4.9034791952276855,0.1655185242402555
3048,0.1929047619047618,0,1,0,76251,529359,2958,104998,4.903469932194597,0.16551878516355933
3049,0.1929166666666666,0,7,0,76258,529352,2958,104998,4.903405090962985,0.16552061164972018
3050,0.1929999999999999,0,6,0,76264,529346,2958,104998,4.90334951276446,0.1655221772413706
3051,0.193,1,25,1,76289,529321,2959,104997,4.903117936937271,0.16552738531777436
3052,0.1930238095238095,0,2,0,76291,529319,2959,104997,4.9030994108710955,0.16552790722605137
3053,0.193047619047619,1,0,1,76291,529319,2960,104996,4.9030994108710955,0.1655265916776365
3054,0.1930555555555555,0,1,0,76292,529318,2960,104996,4.903090147838008,0.16552685263134662
3055,0.1930952380952381,0,2,0,76294,529316,2960,104996,4.903071621771833,0.16552737454123523
3056,0.1931666666666666,0,5,0,76299,529311,2960,104996,4.903025306606395,0.1655286793303558
3057,0.1931666666666667,0,1,0,76300,529310,2960,104996,4.903016043573308,0.16552894029064835
3058,0.1931904761904762,0,1,0,76301,529309,2960,104996,4.90300678054022,0.16552920125176374
3059,0.1932142857142857,0,1,0,76302,529308,2960,104996,4.902997517507132,0.16552946221370196
3060,0.1932222222222222,0,1,0,76303,529307,2960,104996,4.902988254474045,0.16552972317646297
3061,0.19325,0,1,0,76304,529306,2960,104996,4.902978991440958,0.16552998414004685
3062,0.1932619047619047,0,1,0,76305,529305,2960,104996,4.90296972840787,0.16553024510445358
3063,0.1932900432900432,0,1,0,76306,529304,2960,104996,4.9029604653747825,0.16553050606968311
3064,0.1933333333333332,0,2,0,76308,529302,2960,104996,4.902941939308607,0.16553102800261077
3065,0.1933333333333333,30,507,30,76815,528795,2990,104966,4.898245581533217,0.16562394972237168
3066,0.1933712121212121,0,1,0,76816,528794,2990,104966,4.89823631850013,0.1656242110578137
3067,0.1934523809523809,0,1,0,76817,528793,2990,104966,4.898227055467042,0.1656244723940804
3068,0.1934999999999999,1,1,1,76818,528792,2991,104965,4.898217792433955,0.16562341717724616
3069,0.1935,0,11,0,76829,528781,2991,104965,4.898115899069992,0.16562629192136913
3070,0.1935714285714286,0,1,0,76830,528780,2991,104965,4.898106636036904,0.16562655326669243
3071,0.1935833333333333,0,1,0,76831,528779,2991,104965,4.898097373003816,0.1656268146128405
3072,0.1936190476190476,0,1,0,76832,528778,2991,104965,4.898088109970729,0.16562707595981335
3073,0.1936309523809523,0,1,0,76833,528777,2991,104965,4.898078846937641,0.16562733730761098
3074,0.1936666666666666,1,12,1,76845,528765,2992,104964,4.8979676905405904,0.16562915694247857
3075,0.1936904761904762,0,2,0,76847,528763,2992,104964,4.897949164474415,0.1656296796570132
3076,0.19375,2,5,2,76852,528758,2994,104962,4.897902849308978,0.16562835321593133
3077,0.1937619047619047,0,1,0,76853,528757,2994,104962,4.89789358627589,0.1656286145752297
3078,0.1938095238095238,1,2,1,76855,528755,2995,104961,4.897875060209715,0.16562782066414608
3079,0.1938333333333333,0,3,0,76858,528752,2995,104961,4.897847271110453,0.1656286047469438
3080,0.1938888888888888,0,2,0,76860,528750,2995,104961,4.8978287450442775,0.16562912747293324
3081,0.1938888888888889,0,2,0,76862,528748,2995,104961,4.897810218978102,0.16562965020222215
3082,0.1939999999999999,6,100,6,76962,528648,3001,104955,4.896883915669346,0.16564788992476362
3083,0.194,0,2,0,76964,528646,3001,104955,4.896865389603172,0.1656484128023788
3084,0.1940238095238095,0,2,0,76966,528644,3001,104955,4.896846863536997,0.16564893568329495
3085,0.194047619047619,0,3,0,76969,528641,3001,104955,4.896819074437734,0.16564972001085865
3086,0.194063492063492,0,2,0,76971,528639,3001,104955,4.896800548371559,0.16565024290002747
3087,0.1941190476190476,0,1,0,76972,528638,3001,104955,4.896791285338471,0.16565050434584977
3088,0.1941363636363636,0,1,0,76973,528637,3001,104955,4.896782022305383,0.16565076579249738
3089,0.1941666666666666,3,112,3,77085,528525,3004,104952,4.895744562599577,0.16567610189478071
3090,0.1941825396825396,0,1,0,77086,528524,3004,104952,4.89573529956649,0.16567636342971162
3091,0.1942142857142857,0,1,0,77087,528523,3004,104952,4.895726036533403,0.16567662496546826
3092,0.1942258297258297,0,1,0,77088,528522,3004,104952,4.895716773500315,0.1656768865020506
3093,0.1942857142857142,0,4,0,77092,528518,3004,104952,4.895679721367965,0.16567793265663724
3094,0.1942857142857143,0,11,0,77103,528507,3004,104952,4.895577828004002,0.16568080964987472
3095,0.1943333333333333,0,15,0,77118,528492,3004,104952,4.895438882507689,0.16568473298349973
3096,0.1944047619047618,0,4,0,77122,528488,3004,104952,4.895401830375338,0.1656857792371811
3097,0.1944285714285714,0,2,0,77124,528486,3004,104952,4.895383304309163,0.1656863023689769
3098,0.1944444444444444,0,3,0,77127,528483,3004,104952,4.8953555152099,0.16568708707286461
3099,0.1944523809523809,0,3,0,77130,528480,3004,104952,4.895327726110637,0.1656878717841852
3100,0.1944642857142857,0,1,0,77131,528479,3004,104952,4.89531846307755,0.16568813335627716
3101,0.1944999999999999,0,1,0,77132,528478,3004,104952,4.895309200044463,0.16568839492919502
3102,0.1945,0,12,0,77144,528466,3004,104952,4.895198043647412,0.1656915338686302
3103,0.1945238095238095,0,2,0,77146,528464,3004,104952,4.895179517581237,0.16569205703676573
3104,0.194595238095238,0,2,0,77148,528462,3004,104952,4.895160991515062,0.16569258020820507
3105,0.1945952380952381,0,1,0,77149,528461,3004,104952,4.8951517284819746,0.16569284179516366
3106,0.1946428571428571,0,2,0,77151,528459,3004,104952,4.895133202415799,0.16569336497155876
3107,0.1946666666666666,3,22,3,77173,528437,3007,104949,4.894929415687873,0.16569516850703994
3108,0.1946904761904762,0,1,0,77174,528436,3007,104949,4.894920152654786,0.16569543010964896
3109,0.1947142857142857,0,3,0,77177,528433,3007,104949,4.894892363555523,0.16569621492243228
3110,0.19475,1,1,1,77178,528432,3008,104948,4.894883100522435,0.1656951593040513
3111,0.1947619047619047,0,2,0,77180,528430,3008,104948,4.8948645744562596,0.16569568251502262
3112,0.1948333333333332,0,1,0,77181,528429,3008,104948,4.894855311423172,0.1656959441217474
3113,0.1948333333333333,1,16,1,77197,528413,3009,104947,4.894707102893771,0.1656988126815713
3114,0.1948571428571428,1,0,1,77197,528413,3010,104946,4.894707102893771,0.16569749541729098
3115,0.1948809523809523,0,1,0,77198,528412,3010,104946,4.894697839860684,0.16569775703472603
3116,0.1949166666666666,0,1,0,77199,528411,3010,104946,4.894688576827597,0.16569801865298717
3117,0.1949444444444444,1,0,1,77199,528411,3011,104945,4.894688576827597,0.16569670138121373
3118,0.1949523809523809,0,1,0,77200,528410,3011,104945,4.894679313794509,0.16569696299863426
3119,0.1949999999999999,0,14,0,77214,528396,3011,104945,4.894549631331283,0.1657006257292675
3120,0.195,54,1023,54,78237,527373,3065,104891,4.8850735484827155,0.16589747320739437
3121,0.1950238095238095,0,1,0,78238,527372,3065,104891,4.885064285449627,0.16589773559420684
3122,0.1950952380952381,0,1,0,78239,527371,3065,104891,4.88505502241654,0.1658979979818493
3123,0.1951111111111111,0,1,0,78240,527370,3065,104891,4.885045759383453,0.16589826037032174
3124,0.1951269841269841,0,3,0,78243,527367,3065,104891,4.88501797028419,0.16589904754071913
3125,0.1951428571428571,0,1,0,78244,527366,3065,104891,4.885008707251102,0.16589930993251162
3126,0.1951666666666666,1,8,1,78252,527358,3066,104890,4.884934602986402,0.16590008983816476
3127,0.1952142857142856,0,1,0,78253,527357,3066,104890,4.884925339953314,0.16590035223575597
3128,0.1952344322344322,0,3,0,78256,527354,3066,104890,4.884897550854052,0.16590113943350984
3129,0.1952380952380952,0,7,0,78263,527347,3066,104890,4.884832709622438,0.16590297625732123
3130,0.1952499999999999,0,1,0,78264,527346,3066,104890,4.884823446589351,0.16590323866404316
3131,0.1952777777777777,0,1,0,78265,527345,3066,104890,4.884814183556264,0.1659035010715952
3132,0.1952857142857142,0,3,0,78268,527342,3066,104890,4.884786394457001,0.16590428829923193
3133,0.1953333333333333,1,19,1,78287,527323,3067,104889,4.884610396828338,0.165907954926512
3134,0.1953333333333334,0,1,0,78288,527322,3067,104889,4.8846011337952495,0.1659082173514855
3135,0.1953571428571428,0,1,0,78289,527321,3067,104889,4.884591870762162,0.1659084797772892
3136,0.1953571428571429,0,3,0,78292,527318,3067,104889,4.8845640816629,0.1659092670596814
3137,0.1953809523809524,0,1,0,78293,527317,3067,104889,4.8845548186298124,0.16590952948880586
3138,0.1954166666666666,0,2,0,78295,527315,3067,104889,4.884536292563637,0.1659100543495454
3139,0.1954285714285714,0,3,0,78298,527312,3067,104889,4.8845085034643745,0.1659108416468813
3140,0.1954761904761904,1,0,1,78298,527312,3068,104888,4.8845085034643745,0.16590952230306866
3141,0.1954761904761905,0,1,0,78299,527311,3068,104888,4.884499240431287,0.16590978473550258
3142,0.1954999999999999,0,1,0,78300,527310,3068,104888,4.884489977398199,0.16591004716876676
3143,0.1955,2,16,2,78316,527294,3070,104886,4.884341768868798,0.16591160745357336
3144,0.1955238095238095,0,1,0,78317,527293,3070,104886,4.884332505835711,0.16591186989760812
3145,0.1956666666666666,1,17,1,78334,527276,3071,104885,4.884175034273222,0.16591501215671325
3146,0.1956666666666667,0,5,0,78339,527271,3071,104885,4.8841287191077845,0.16591632445155943
3147,0.1956839826839827,0,2,0,78341,527269,3071,104885,4.88411019304161,0.16591684937531045
3148,0.1957142857142857,0,14,0,78355,527255,3071,104885,4.883980510578384,0.16592052393457146
3149,0.1957499999999999,0,4,0,78359,527251,3071,104885,4.8839434584460335,0.1659215738385411
3150,0.1957619047619047,0,2,0,78361,527249,3071,104885,4.883924932379858,0.16592209879550854
3151,0.1958333333333333,3,87,3,78448,527162,3074,104882,4.883119048501241,0.1659409787926157
3152,0.1958571428571428,0,1,0,78449,527161,3074,104882,4.883109785468154,0.1659412413395924
3153,0.1959090909090909,0,2,0,78451,527159,3074,104882,4.883091259401978,0.16594176643603817
3154,0.1959285714285714,0,2,0,78453,527157,3074,104882,4.883072733335803,0.1659422915358071
3155,0.1959523809523809,0,1,0,78454,527156,3074,104882,4.883063470302716,0.1659425540869378
3156,0.1959999999999999,0,7,0,78461,527149,3074,104882,4.882998629071103,0.1659443919681155
3157,0.196,6,92,6,78553,527057,3080,104876,4.882146430027048,0.16596063190243268
3158,0.1960119047619047,0,1,0,78554,527056,3080,104876,4.88213716699396,0.1659608945266263
3159,0.196063492063492,0,1,0,78555,527055,3080,104876,4.882127903960873,0.16596115715165105
3160,0.1960714285714285,0,1,0,78556,527054,3080,104876,4.882118640927786,0.165961419777507
3161,0.1960714285714286,0,1,0,78557,527053,3080,104876,4.882109377894698,0.16596168240419415
3162,0.1961111111111111,0,2,0,78559,527051,3080,104876,4.882090851828523,0.165962207660062
3163,0.1961666666666666,0,9,0,78568,527042,3080,104876,4.882007484530734,0.1659645713526122
3164,0.1961839826839826,0,1,0,78569,527041,3080,104876,4.881998221497647,0.16596483398927392
3165,0.1961904761904761,0,1,0,78570,527040,3080,104876,4.88198895846456,0.16596509662676684
3166,0.1961904761904762,0,2,0,78572,527038,3080,104876,4.881970432398385,0.16596562190424646
3167,0.1962499999999999,0,1,0,78573,527037,3080,104876,4.881961169365297,0.16596588454423314
3168,0.19625,1,3,1,78576,527034,3081,104875,4.881933380266035,0.16596535260615056
3169,0.1962619047619047,0,1,0,78577,527033,3081,104875,4.881924117232947,0.16596561524778924
3170,0.1962857142857142,0,2,0,78579,527031,3081,104875,4.881905591166771,0.16596614053356037
3171,0.1963333333333333,1,11,1,78590,527020,3082,104874,4.881803697802809,0.16596770977410769
3172,0.1963636363636363,2,0,2,78590,527020,3084,104872,4.881803697802809,0.1659650699803131
3173,0.1963888888888888,0,1,0,78591,527019,3084,104872,4.881794434769721,0.16596533262857044
3174,0.1964285714285714,0,6,0,78597,527013,3084,104872,4.881738856571196,0.16596690853557214
3175,0.1964761904761904,0,1,0,78598,527012,3084,104872,4.881729593538108,0.16596717118964874
3176,0.1964761904761905,0,1,0,78599,527011,3084,104872,4.88172033050502,0.16596743384455667
3177,0.1964989177489177,0,2,0,78601,527009,3084,104872,4.881701804438846,0.16596795915686657
3178,0.1964999999999999,2,23,2,78624,526986,3086,104870,4.881488754677831,0.1659713605631663
3179,0.196547619047619,0,2,0,78626,526984,3086,104870,4.881470228611657,0.1659718859103527
3180,0.1965833333333333,0,3,0,78629,526981,3086,104870,4.881442439512394,0.16597267393736814
3181,0.1966666666666666,20,527,20,79156,526454,3106,104850,4.876560821075253,0.16608480225057975
3182,0.1966666666666667,0,2,0,79158,526452,3106,104850,4.876542295009078,0.16608532841651064
3183,0.1967619047619047,0,2,0,79160,526450,3106,104850,4.876523768942903,0.16608585458577538
3184,0.1967857142857142,0,1,0,79161,526449,3106,104850,4.876514505909815,0.16608611767165796
3185,0.1967857142857143,0,5,0,79166,526444,3106,104850,4.876468190744378,0.16608743311357307
3186,0.1967916666666666,1,0,1,79166,526444,3107,104849,4.876468190744378,0.16608611215394437
3187,0.1968055555555555,1,2,1,79168,526442,3108,104848,4.876449664678202,0.1660853173660283
3188,0.1968214285714285,0,1,0,79169,526441,3108,104848,4.876440401645115,0.1660855804552273
3189,0.1968333333333333,0,17,0,79186,526424,3108,104848,4.876282930082627,0.16609005309913952
3190,0.1968571428571428,0,1,0,79187,526423,3108,104848,4.876273667049539,0.16609031620334214
3191,0.1968809523809523,0,2,0,79189,526421,3108,104848,4.876255140983363,0.16609084241424812
3192,0.1969166666666667,0,2,0,79191,526419,3108,104848,4.876236614917189,0.16609136862848842
3193,0.1969444444444444,0,1,0,79192,526418,3108,104848,4.876227351884101,0.16609163173685895
3194,0.1969523809523808,0,1,0,79193,526417,3108,104848,4.876218088851013,0.16609189484606307
3195,0.1969999999999999,1,29,1,79222,526388,3109,104847,4.875949460891475,0.16609820431376587
3196,0.197,0,1,0,79223,526387,3109,104847,4.8759401978583865,0.16609846744630358
3197,0.1970238095238095,0,6,0,79229,526381,3109,104847,4.875884619659861,0.16610004625903793
3198,0.1970714285714285,0,1,0,79230,526380,3109,104847,4.875875356626774,0.16610030939741172
3199,0.1970833333333333,1,1,1,79231,526379,3110,104846,4.875866093593686,0.1660992514555032
3200,0.1971190476190476,0,1,0,79232,526378,3110,104846,4.875856830560599,0.16609951459386843
3201,0.1971428571428571,0,6,0,79238,526372,3110,104846,4.8758012523620735,0.16610109344156854
3202,0.1971666666666666,2,15,2,79253,526357,3112,104844,4.8756623068657605,0.16610239844360195
3203,0.1971893939393939,0,1,0,79254,526356,3112,104844,4.875653043832672,0.16610266159695816
3204,0.1972222222222222,0,1,0,79255,526355,3112,104844,4.875643780799585,0.1661029247511482
3205,0.1972499999999999,0,1,0,79256,526354,3112,104844,4.875634517766497,0.16610318790617207
3206,0.19725,0,1,0,79257,526353,3112,104844,4.87562525473341,0.16610345106202976
3207,0.1972619047619047,0,2,0,79259,526351,3112,104844,4.875606728667234,0.16610397737624663
3208,0.1972698412698413,0,1,0,79260,526350,3112,104844,4.875597465634147,0.16610424053460585
3209,0.1972738095238094,0,1,0,79261,526349,3112,104844,4.87558820260106,0.1661045036937989
3210,0.1973333333333333,1,44,1,79305,526305,3113,104843,4.875180629145207,0.16611476230614688
3211,0.1973484848484848,0,1,0,79306,526304,3113,104843,4.87517136611212,0.1661150255011907
3212,0.1973809523809523,0,3,0,79309,526301,3113,104843,4.8751435770128575,0.16611581509132622
3213,0.1973809523809524,0,1,0,79310,526300,3113,104843,4.875134313979769,0.16611607828970615
3214,0.1973888888888888,0,2,0,79312,526298,3113,104843,4.875115787913594,0.16611660468896808
3215,0.1974285714285714,0,1,0,79313,526297,3113,104843,4.875106524880507,0.1661168678898501
3216,0.1974999999999999,0,4,0,79317,526293,3113,104843,4.875069472748157,0.1661179207017188
3217,0.1975,7,261,7,79578,526032,3120,104836,4.872651821112305,0.16617739368615939
3218,0.1975873015873016,0,1,0,79579,526031,3120,104836,4.872642558079217,0.16617765709729626
3219,0.1975952380952381,0,1,0,79580,526030,3120,104836,4.87263329504613,0.16617792050926822
3220,0.1976190476190475,0,1,0,79581,526029,3120,104836,4.872624032013042,0.16617818392207526
3221,0.1976190476190476,0,3,0,79584,526026,3120,104836,4.8725962429137795,0.16617897416550687
3222,0.1976363636363636,0,2,0,79586,526024,3120,104836,4.872577716847605,0.1661795009986368
3223,0.1976666666666666,2,27,2,79613,525997,3122,104834,4.872327614954241,0.16618397003317845
3224,0.1976785714285714,0,1,0,79614,525996,3122,104834,4.8723183519211535,0.16618423347019007
3225,0.1977142857142857,0,1,0,79615,525995,3122,104834,4.872309088888065,0.16618449690803688
3226,0.1977499999999999,1,1,1,79616,525994,3123,104833,4.872299825854978,0.16618343856556553
3227,0.1977777777777777,1,6,1,79622,525988,3124,104832,4.872244247656453,0.1661836974097207
3228,0.1978333333333333,0,6,0,79628,525982,3124,104832,4.872188669457928,0.16618527806928826
3229,0.1978571428571428,1,6,1,79634,525976,3125,104831,4.872133091259402,0.16618553693919058
3230,0.1979166666666666,0,1,0,79635,525975,3125,104831,4.872123828226314,0.16618580038870906
3231,0.1979365079365079,0,1,0,79636,525974,3125,104831,4.872114565193227,0.1661860638390628
3232,0.1979761904761904,0,1,0,79637,525973,3125,104831,4.872105302160139,0.16618632729025182
3233,0.1979999999999999,0,3,0,79640,525970,3125,104831,4.872077513060876,0.16618711764883062
3234,0.198,0,59,0,79699,525911,3125,104831,4.871530994108711,0.16620266289544694
3235,0.1980238095238095,0,1,0,79700,525910,3125,104831,4.871521731075624,0.1662029263992669
3236,0.1980952380952381,0,1,0,79701,525909,3125,104831,4.8715124680425355,0.16620318990392238
3237,0.1981666666666666,0,10,0,79711,525899,3125,104831,4.87141983771166,0.16620582499643272
3238,0.1981666666666667,0,2,0,79713,525897,3125,104831,4.871401311645485,0.16620635202496165
3239,0.1982023809523809,0,2,0,79715,525895,3125,104831,4.87138278557931,0.16620687905683293
3240,0.1982142857142857,0,1,0,79716,525894,3125,104831,4.8713735225462225,0.16620714257402197
3241,0.1982539682539682,0,4,0,79720,525890,3125,104831,4.871336470413873,0.16620819665113418
3242,0.1982619047619047,0,1,0,79721,525889,3125,104831,4.8713272073807845,0.16620846017250127
3243,0.1982857142857143,0,1,0,79722,525888,3125,104831,4.871317944347697,0.166208723694704
3244,0.1983333333333332,0,2,0,79724,525886,3125,104831,4.871299418281522,0.1662092507416163
3245,0.1983333333333333,15,280,15,80004,525606,3140,104816,4.868705769017007,0.16626323319934902
3246,0.1983809523809523,1,0,1,80004,525606,3141,104815,4.868705769017007,0.16626191069142685
3247,0.1984761904761904,0,1,0,80005,525605,3141,104815,4.86869650598392,0.16626217442340027
3248,0.1984999999999999,0,3,0,80008,525602,3141,104815,4.868668716884657,0.1662629656243407
3249,0.1985,0,17,0,80025,525585,3141,104815,4.868511245322169,0.16626744923857867
3250,0.1985238095238095,0,2,0,80027,525583,3141,104815,4.868492719255993,0.16626797673850488
3251,0.1985454545454545,0,1,0,80028,525582,3141,104815,4.868483456222906,0.16626824048972313
3252,0.198547619047619,0,1,0,80029,525581,3141,104815,4.868474193189818,0.1662685042417782
3253,0.1985714285714285,1,4,1,80033,525577,3142,104814,4.868437141057468,0.16626823669754168
3254,0.1986111111111111,0,3,0,80036,525574,3142,104814,4.8684093519582055,0.16626902796373028
3255,0.1986190476190476,0,2,0,80038,525572,3142,104814,4.86839082589203,0.1662695554787067
3256,0.1986666666666666,2,27,2,80065,525545,3144,104812,4.868140723998666,0.1662740320167778
3257,0.1986904761904761,0,1,0,80066,525544,3144,104812,4.868131460965579,0.16627429579475725
3258,0.1986904761904762,0,3,0,80069,525541,3144,104812,4.868103671866316,0.16627508713371714
3259,0.19875,0,5,0,80074,525536,3144,104812,4.868057356700878,0.1662764060487223
3260,0.1988333333333333,0,7,0,80081,525529,3144,104812,4.867992515469266,0.16627825256488155
3261,0.1988571428571428,0,3,0,80084,525526,3144,104812,4.867964726370003,0.1662790439415044
3262,0.1988809523809523,1,1,1,80085,525525,3145,104811,4.867955463336915,0.16627798507462688
3263,0.1988888888888888,0,2,0,80087,525523,3145,104811,4.8679369372707395,0.16627851266154134
3264,0.1988888888888889,0,1,0,80088,525522,3145,104811,4.867927674237652,0.16627877645625408
3265,0.1989285714285714,0,10,0,80098,525512,3145,104811,4.867835043906777,0.16628141444941721
3266,0.1989999999999999,4,32,4,80130,525480,3149,104807,4.867538626847975,0.16628456560265403
3267,0.199,0,5,0,80135,525475,3149,104807,4.867492311682537,0.1662858847309617
3268,0.1990396825396825,0,2,0,80137,525473,3149,104807,4.867473785616363,0.16628641238814496
3269,0.199047619047619,0,3,0,80140,525470,3149,104807,4.8674459965171,0.16628720388019871
3270,0.199095238095238,0,2,0,80142,525468,3149,104807,4.867427470450925,0.16628773154575383
3271,0.1991190476190476,0,1,0,80143,525467,3149,104807,4.8674182074178365,0.1662879953797872
3272,0.1991428571428571,0,1,0,80144,525466,3149,104807,4.867408944384749,0.16628825921465779
3273,0.1991666666666666,1,42,1,80186,525424,3150,104806,4.867019896995072,0.16629801818383766
3274,0.1991666666666667,1,38,1,80224,525386,3151,104805,4.866667901737745,0.1663067228824277
3275,0.1992023809523809,0,2,0,80226,525384,3151,104805,4.86664937567157,0.16630725068193827
3276,0.1992380952380952,0,3,0,80229,525381,3151,104805,4.8666215865723075,0.1663080423874856
3277,0.1992474747474747,0,3,0,80232,525378,3151,104805,4.866593797473045,0.1663088341005708
3278,0.1992777777777778,0,1,0,80233,525377,3151,104805,4.866584534439957,0.16630909800660762
3279,0.1992857142857142,0,1,0,80234,525376,3151,104805,4.8665752714068695,0.166309361913482
3280,0.1992857142857143,1,4,1,80238,525372,3152,104804,4.86653821927452,0.16630909460214288
3281,0.1993333333333333,1,33,1,80271,525339,3153,104803,4.86623253918263,0.16631648104712907
3282,0.1993650793650793,0,1,0,80272,525338,3153,104803,4.866223276149542,0.16631674498247218
3283,0.1994285714285714,0,3,0,80275,525335,3153,104803,4.8661954870502795,0.16631753679352776
3284,0.1994444444444444,0,3,0,80278,525332,3153,104803,4.866167697951017,0.1663183286121228
3285,0.1994999999999999,2,9,2,80287,525323,3155,104801,4.866084330653229,0.16631805803302208
3286,0.1995238095238095,1,3,1,80290,525320,3156,104800,4.8660565415539665,0.1663175268202882
3287,0.1995833333333333,0,1,0,80291,525319,3156,104800,4.866047278520879,0.16631779076650602
3288,0.1996031746031746,0,1,0,80292,525318,3156,104800,4.866038015487791,0.1663180547135616
3289,0.1996190476190475,0,1,0,80293,525317,3156,104800,4.866028752454704,0.16631831866145494
3290,0.1996666666666666,0,5,0,80298,525312,3156,104800,4.865982437289266,0.1663196384134884
3291,0.1996666666666667,2,14,2,80312,525298,3158,104798,4.86585275482604,0.16632068764124833
3292,0.1997222222222222,0,2,0,80314,525296,3158,104798,4.865834228759865,0.16632121556466178
3293,0.1997619047619047,0,3,0,80317,525293,3158,104798,4.865806439660602,0.16632200745606587
3294,0.1998333333333333,0,4,0,80321,525289,3158,104798,4.865769387528252,0.16632306332300142
3295,0.1998809523809523,0,4,0,80325,525285,3158,104798,4.865732335395902,0.16632411920334306
3296,0.1999047619047619,0,1,0,80326,525284,3158,104798,4.865723072362814,0.1663243831755232
3297,0.1999999999999999,3,16,3,80342,525268,3161,104795,4.865574863833413,0.1663246373775321
3298,0.2,139,3105,139,83447,522163,3300,104656,4.836813146096558,0.16696366893792308
3299,0.200047619047619,0,1,0,83448,522162,3300,104656,4.83680388306347,0.16696393530498485
3300,0.2000952380952381,0,1,0,83449,522161,3300,104656,4.836794620030383,0.16696420167289655
3301,0.2001190476190476,0,2,0,83451,522159,3300,104656,4.8367760939642075,0.16696473441126966
3302,0.2001666666666666,2,7,2,83458,522152,3302,104654,4.836711252732595,0.16696394099609768
3303,0.2001666666666667,0,1,0,83459,522151,3302,104654,4.836701989699507,0.166964207369118
3304,0.2002499999999999,0,1,0,83460,522150,3302,104654,4.83669272666642,0.16696447374298823
3305,0.2002857142857143,0,1,0,83461,522149,3302,104654,4.8366834636333325,0.16696474011770843
3306,0.2003333333333333,1,16,1,83477,522133,3303,104653,4.836535255103931,0.16696767317712904
3307,0.2003571428571428,0,1,0,83478,522132,3303,104653,4.836525992070844,0.16696793956460348
3308,0.2003809523809523,0,2,0,83480,522130,3303,104653,4.836507466004669,0.16696847234210244
3309,0.2004166666666666,0,5,0,83485,522125,3303,104653,4.836461150839231,0.1669698043007253
3310,0.2004166666666667,0,1,0,83486,522124,3303,104653,4.8364518878061435,0.16697007069499997
3311,0.2004285714285714,0,1,0,83487,522123,3303,104653,4.836442624773055,0.1669703370901247
3312,0.2004523809523809,0,3,0,83490,522120,3303,104653,4.836414835673793,0.1669711362805992
3313,0.2004761904761904,0,2,0,83492,522118,3303,104653,4.836396309607618,0.16697166907849917
3314,0.2004999999999999,1,1,1,83493,522117,3304,104652,4.83638704657453,0.16697060639565772
3315,0.2005,2,9,2,83502,522108,3306,104650,4.836303679276742,0.16697034581130196
3316,0.2005555555555555,0,3,0,83505,522105,3306,104650,4.83627589017748,0.16697114502477045
3317,0.2005674603174603,0,1,0,83506,522104,3306,104650,4.836266627144393,0.16697141143096014
3318,0.2006060606060606,0,1,0,83507,522103,3306,104650,4.8362573641113045,0.166971677838
3319,0.2006428571428571,1,1,1,83508,522102,3307,104649,4.836248101078217,0.16697061512466674
3320,0.2006666666666666,4,35,4,83543,522067,3311,104645,4.835923894920152,0.1669746231123706
3321,0.2006666666666667,0,4,0,83547,522063,3311,104645,4.835886842787803,0.16697568883754477
3322,0.2006904761904761,0,1,0,83548,522062,3311,104645,4.835877579754715,0.16697595527096395
3323,0.2006904761904762,0,1,0,83549,522061,3311,104645,4.835868316721627,0.1669762217052334
3324,0.2007142857142857,0,4,0,83553,522057,3311,104645,4.835831264589277,0.16697728745081394
3325,0.2007499999999999,1,0,1,83553,522057,3312,104644,4.835831264589277,0.1669759582320756
3326,0.2007619047619047,0,1,0,83554,522056,3312,104644,4.835822001556189,0.16697622466890058
3327,0.2008333333333333,9,87,9,83641,521969,3321,104635,4.835016117677572,0.1669874434251936
3328,0.2008571428571429,0,2,0,83643,521967,3321,104635,4.834997591611398,0.16698797641884322
3329,0.2008809523809523,0,1,0,83644,521966,3321,104635,4.8349883285783095,0.16698824291694395
3330,0.2008888888888889,0,1,0,83645,521965,3321,104635,4.834979065545222,0.1669885094158953
3331,0.2008968253968254,0,1,0,83646,521964,3321,104635,4.834969802512134,0.16698877591569727
3332,0.2009523809523809,0,1,0,83647,521963,3321,104635,4.834960539479047,0.16698904241634988
3333,0.2009999999999999,0,3,0,83650,521960,3321,104635,4.834932750379784,0.16698984192341146
3334,0.201,2,48,2,83698,521912,3323,104633,4.834488124791582,0.1669999760591817
3335,0.2011428571428571,0,1,0,83699,521911,3323,104633,4.834478861758495,0.16700024260067928
3336,0.2011666666666666,0,14,0,83713,521897,3323,104633,4.834349179295269,0.16700397427098462
3337,0.2011904761904762,0,1,0,83714,521896,3323,104633,4.834339916262181,0.16700424082524512
3338,0.20125,0,5,0,83719,521891,3323,104633,4.834293601096743,0.16700557360931106
3339,0.2013333333333332,0,1,0,83720,521890,3323,104633,4.8342843380636555,0.16700584016867698
3340,0.2013333333333333,0,17,0,83737,521873,3323,104633,4.834126866501167,0.16701037180809122
3341,0.2013571428571428,0,1,0,83738,521872,3323,104633,4.83411760346808,0.16701063838277427
3342,0.2013809523809523,1,0,1,83738,521872,3324,104632,4.83411760346808,0.16700930879930534
3343,0.2014285714285714,0,8,0,83746,521864,3324,104632,4.834043499203379,0.16701144141383184
3344,0.2014999999999999,0,19,0,83765,521845,3324,104632,4.833867501574716,0.16701650659162268
3345,0.2015,0,1,0,83766,521844,3324,104632,4.833858238541628,0.1670167731884382
3346,0.2015555555555556,0,1,0,83767,521843,3324,104632,4.83384897550854,0.1670170397861048
3347,0.2016666666666666,10,182,10,83949,521661,3334,104622,4.8321631034866055,0.16705227508969586
3348,0.2016666666666667,3,135,3,84084,521526,3337,104619,4.830912594019786,0.16708430155954293
3349,0.201765873015873,0,4,0,84088,521522,3337,104619,4.830875541887436,0.16708536895044407
3350,0.2017806637806637,0,1,0,84089,521521,3337,104619,4.830866278854348,0.16708563580030025
3351,0.2017857142857142,0,1,0,84090,521520,3337,104619,4.830857015821261,0.1670859026510088
3352,0.2018333333333333,0,3,0,84093,521517,3337,104619,4.830829226721998,0.1670867032082487
3353,0.2018571428571428,0,1,0,84094,521516,3337,104619,4.83081996368891,0.16708697006236675
3354,0.2018888888888888,1,0,1,84094,521516,3338,104618,4.83081996368891,0.16708563981511945
3355,0.2019047619047619,0,1,0,84095,521515,3338,104618,4.830810700655823,0.16708590666839154
3356,0.2019166666666666,0,1,0,84096,521514,3338,104618,4.8308014376227355,0.167086173522516
3357,0.2019523809523809,0,3,0,84099,521511,3338,104618,4.830773648523473,0.1670869740900038
3358,0.2019999999999999,6,48,6,84147,521463,3344,104612,4.83032902293527,0.16709180210038732
3359,0.202,1,2,1,84149,521461,3345,104611,4.830310496869095,0.16709100550735378
3360,0.2020238095238095,0,1,0,84150,521460,3345,104611,4.830301233836007,0.16709127239562285
3361,0.202047619047619,1,0,1,84150,521460,3346,104610,4.830301233836007,0.16708994201926303
3362,0.2020833333333333,1,3,1,84153,521457,3347,104609,4.830273444736744,0.16708941229838387
3363,0.202095238095238,0,1,0,84154,521456,3347,104609,4.830264181703657,0.16708967918666592
3364,0.2021428571428571,0,6,0,84160,521450,3347,104609,4.830208603505132,0.16709128053426275
3365,0.2021666666666666,0,1,0,84161,521449,3347,104609,4.830199340472044,0.167091547428513
3366,0.2021666666666667,0,3,0,84164,521446,3347,104609,4.830171551372781,0.16709234811637955
3367,0.2021904761904761,0,1,0,84165,521445,3347,104609,4.830162288339694,0.16709261501404032
3368,0.2022222222222222,0,4,0,84169,521441,3347,104609,4.830125236207344,0.1670936826132098
3369,0.2022499999999999,0,1,0,84170,521440,3347,104609,4.830115973174256,0.1670939495151338
3370,0.2022619047619047,0,3,0,84173,521437,3347,104609,4.830088184074993,0.16709475022602174
3371,0.2023095238095238,0,1,0,84174,521436,3347,104609,4.830078921041906,0.16709501713135638
3372,0.2023333333333333,4,21,4,84195,521415,3351,104605,4.829884397347067,0.16709530046963356
3373,0.2023809523809523,0,4,0,84199,521411,3351,104605,4.829847345214717,0.1670963681439452
3374,0.2024999999999999,1,1,1,84200,521410,3352,104604,4.829838082181629,0.1670953045778529
3375,0.2025,12,304,12,84504,521106,3364,104592,4.827022120123013,0.16716051513669533
3376,0.2025555555555555,0,1,0,84505,521105,3364,104592,4.827012857089925,0.16716078229558395
3377,0.2026190476190476,0,4,0,84509,521101,3364,104592,4.826975804957575,0.16716185093967809
3378,0.2026666666666666,0,13,0,84522,521088,3364,104592,4.826855385527437,0.16716532412734944
3379,0.2026666666666667,0,11,0,84533,521077,3364,104592,4.826753492163474,0.16716826309118718
3380,0.2027499999999999,0,1,0,84534,521076,3364,104592,4.826744229130386,0.16716853027484224
3381,0.2027738095238095,1,0,1,84534,521076,3365,104591,4.826744229130386,0.16716719916505104
3382,0.2028282828282828,0,1,0,84535,521075,3365,104591,4.826734966097299,0.16716746634785973
3383,0.2028333333333333,0,9,0,84544,521066,3365,104591,4.826651598799511,0.1671698710315716
3384,0.2028571428571428,1,10,1,84554,521056,3366,104590,4.826558968468635,0.1671712118354469
3385,0.2029047619047619,0,2,0,84556,521054,3366,104590,4.82654044240246,0.16717174623268186
3386,0.2029166666666666,0,1,0,84557,521053,3366,104590,4.826531179369373,0.16717201343258056
3387,0.2029999999999999,0,5,0,84562,521048,3366,104590,4.826484864203935,0.16717334944488665
3388,0.203,3,32,3,84594,521016,3369,104587,4.8261884471451335,0.16717790675556224
3389,0.203047619047619,0,1,0,84595,521015,3369,104587,4.826179184112045,0.16717817398281976
3390,0.2030833333333333,0,1,0,84596,521014,3369,104587,4.826169921078958,0.16717844121093156
3391,0.203095238095238,0,2,0,84598,521012,3369,104587,4.826151395012783,0.16717897566971815
3392,0.2031428571428571,0,1,0,84599,521011,3369,104587,4.8261421319796955,0.1671792429003929
3393,0.2031666666666666,1,5,1,84604,521006,3370,104586,4.826095816814258,0.16717924781646823
3394,0.2032142857142856,0,1,0,84605,521005,3370,104586,4.82608655378117,0.1671795150505682
3395,0.2032167277167277,2,2,2,84607,521003,3372,104584,4.826068027714995,0.16717738699813137
3396,0.2032619047619047,0,3,0,84610,521000,3372,104584,4.826040238615732,0.16717818870047826
3397,0.2033333333333332,0,2,0,84612,520998,3372,104584,4.826021712549557,0.16717872317298133
3398,0.2033333333333333,20,524,20,85136,520474,3392,104564,4.821167883211679,0.16729222863249915
3399,0.2033928571428571,0,3,0,85139,520471,3392,104564,4.821140094112416,0.16729303159023096
3400,0.2034523809523809,0,5,0,85144,520466,3392,104564,4.821093778946978,0.16729436987024623
3401,0.203452380952381,0,2,0,85146,520464,3392,104564,4.821075252880803,0.16729490518824758
3402,0.2035,3,20,3,85166,520444,3395,104561,4.820889992219052,0.16729626162990696
3403,0.2035714285714285,0,1,0,85167,520443,3395,104561,4.820880729185965,0.16729652930221248
3404,0.2036111111111111,0,1,0,85168,520442,3395,104561,4.8208714661528775,0.16729679697537453
3405,0.2036190476190476,0,1,0,85169,520441,3395,104561,4.820862203119789,0.16729706464939312
3406,0.2036363636363636,0,1,0,85170,520440,3395,104561,4.820852940086702,0.16729733232426827
3407,0.2036666666666666,0,18,0,85188,520422,3395,104561,4.820686205491126,0.16730215061849682
3408,0.2036904761904762,0,2,0,85190,520420,3395,104561,4.820667679424951,0.16730268600165446
3409,0.2037142857142857,0,1,0,85191,520419,3395,104561,4.820658416391863,0.16730295369451822
3410,0.20375,1,5,1,85196,520414,3396,104560,4.820612101226425,0.16730295980312782
3411,0.2038095238095238,1,1,1,85197,520413,3397,104559,4.820602838193338,0.1673018951249016
3412,0.2038333333333333,0,10,0,85207,520403,3397,104559,4.820510207862463,0.16730457211798477
3413,0.2038571428571428,0,1,0,85208,520402,3397,104559,4.820500944829375,0.1673048398220049
3414,0.2038809523809523,0,3,0,85211,520399,3397,104559,4.820473155730112,0.16730564293920552
3415,0.2038888888888889,0,1,0,85212,520398,3397,104559,4.820463892697025,0.16730591064665248
3416,0.2038961038961038,0,1,0,85213,520397,3397,104559,4.820454629663937,0.16730617835495618
3417,0.2039166666666666,0,1,0,85214,520396,3397,104559,4.8204453666308495,0.16730644606411663
3418,0.2039285714285714,0,1,0,85215,520395,3397,104559,4.820436103597762,0.16730671377413378
3419,0.2039523809523809,0,1,0,85216,520394,3397,104559,4.820426840564674,0.16730698148500767
3420,0.2039999999999999,0,1,0,85217,520393,3397,104559,4.820417577531587,0.1673072491967383
3421,0.204,4,127,4,85344,520266,3401,104555,4.819241172329468,0.16733592500892255
3422,0.204047619047619,1,3,1,85347,520263,3402,104554,4.819213383230205,0.16733539580389137
3423,0.2040476190476191,0,2,0,85349,520261,3402,104554,4.81919485716403,0.16733593143570497
3424,0.2040909090909091,0,1,0,85350,520260,3402,104554,4.819185594130942,0.16733619925289767
3425,0.204095238095238,0,1,0,85351,520259,3402,104554,4.819176331097855,0.16733646707094763
3426,0.2041428571428571,0,1,0,85352,520258,3402,104554,4.819167068064767,0.16733673488985487
3427,0.2041666666666666,2,48,2,85400,520210,3404,104552,4.818722442476565,0.16734692570931012
3428,0.2041666666666667,2,38,2,85438,520172,3406,104550,4.8183704472192375,0.16735443925458043
3429,0.2041904761904761,0,2,0,85440,520170,3406,104550,4.818351921153062,0.1673549750288129
3430,0.2042619047619047,0,1,0,85441,520169,3406,104550,4.818342658119975,0.16735524291721557
3431,0.2042857142857142,0,1,0,85442,520168,3406,104550,4.818333395086888,0.16735551080647587
3432,0.2042857142857143,0,7,0,85449,520161,3406,104550,4.818268553855274,0.16735738605531197
3433,0.2043333333333333,3,26,3,85475,520135,3409,104547,4.818027714994998,0.16736035294757973
3434,0.2044285714285714,0,1,0,85476,520134,3409,104547,4.81801845196191,0.1673606208608874
3435,0.2044318181818182,0,1,0,85477,520133,3409,104547,4.818009188928823,0.16736088877505284
3436,0.2044444444444444,0,5,0,85482,520128,3409,104547,4.817962873763385,0.16736222835874656
3437,0.2045,2,23,2,85505,520105,3411,104545,4.817749824002371,0.1673657248058913
3438,0.2045238095238095,0,9,0,85514,520096,3411,104545,4.8176664567045835,0.1673681362574663
3439,0.204547619047619,0,1,0,85515,520095,3411,104545,4.817657193671495,0.16736840420081966
3440,0.2045714285714286,1,0,1,85515,520095,3412,104544,4.817657193671495,0.16736707122033687
3441,0.2045833333333333,1,1,1,85516,520094,3413,104543,4.817647930638408,0.16736600617638725
3442,0.204595238095238,0,1,0,85517,520093,3413,104543,4.817638667605321,0.16736627411804636
3443,0.2046666666666666,0,6,0,85523,520087,3413,104543,4.817583089406796,0.16736788178601733
3444,0.2046666666666667,1,12,1,85535,520075,3414,104542,4.817471933009744,0.16736976419149655
3445,0.2047142857142857,0,1,0,85536,520074,3414,104542,4.817462669976657,0.1673700321477516
3446,0.20475,1,1,1,85537,520073,3415,104541,4.81745340694357,0.16736896707406496
3447,0.2047619047619047,1,3,1,85540,520070,3416,104540,4.817425617844307,0.16736843790525288
3448,0.2048333333333333,2,13,2,85553,520057,3418,104538,4.817305198414169,0.16736925527741978
3449,0.2048373015873016,0,1,0,85554,520056,3418,104538,4.817295935381082,0.1673695232422982
3450,0.2048484848484848,0,1,0,85555,520055,3418,104538,4.8172866723479935,0.16736979120803466
3451,0.2048809523809524,0,1,0,85556,520054,3418,104538,4.817277409314906,0.1673700591746292
3452,0.2049166666666667,0,2,0,85558,520052,3418,104538,4.817258883248731,0.16737059511039243
3453,0.2049404761904762,0,1,0,85559,520051,3418,104538,4.817249620215644,0.16737086307956112
3454,0.2049444444444444,1,1,1,85560,520050,3419,104537,4.8172403571825555,0.16736979796249363
3455,0.2049999999999999,1,21,1,85581,520029,3420,104536,4.817045833487717,0.16737409236828832
3456,0.205,62,1053,62,86634,518976,3482,104474,4.807291859646523,0.167573983479028
3457,0.2050238095238095,0,1,0,86635,518975,3482,104474,4.807282596613435,0.16757425226441938
3458,0.2050714285714286,0,2,0,86637,518973,3482,104474,4.80726407054726,0.16757478983778895
3459,0.2051190476190476,0,2,0,86639,518971,3482,104474,4.807245544481085,0.16757532741460754
3460,0.2051428571428571,1,0,1,86639,518971,3483,104473,4.807245544481085,0.16757399221100852
3461,0.2051666666666666,1,11,1,86650,518960,3484,104472,4.807143651117122,0.16757561369964968
3462,0.2051666666666667,0,1,0,86651,518959,3484,104472,4.807134388084034,0.1675758824954165
3463,0.2051904761904762,0,1,0,86652,518958,3484,104472,4.807125125050947,0.16757615129204562
3464,0.2052023809523809,0,1,0,86653,518957,3484,104472,4.807115862017859,0.16757642008953705
3465,0.2052222222222222,0,1,0,86654,518956,3484,104472,4.807106598984771,0.16757668888789082
3466,0.2052380952380952,0,7,0,86661,518949,3484,104472,4.807041757753159,0.1675785705005125
3467,0.20525,0,4,0,86665,518945,3484,104472,4.807004705620808,0.16757964572669656
3468,0.2052857142857143,1,0,1,86665,518945,3485,104471,4.807004705620808,0.1675783104700553
3469,0.2053333333333333,1,15,1,86680,518930,3486,104470,4.806865760124495,0.16758100737888995
3470,0.2053571428571428,0,3,0,86683,518927,3486,104470,4.8068379710252325,0.16758181383612689
3471,0.2054166666666666,0,2,0,86685,518925,3486,104470,4.806819444959057,0.16758235147859704
3472,0.2054523809523809,0,1,0,86686,518924,3486,104470,4.80681018192597,0.16758262030112578
3473,0.2055,0,14,0,86700,518910,3486,104470,4.806680499462744,0.16758638390708716
3474,0.2055555555555555,0,4,0,86704,518906,3486,104470,4.806643447330394,0.1675874592541259
3475,0.2055952380952381,0,2,0,86706,518904,3486,104470,4.806624921264219,0.16758799693282042
3476,0.2056428571428571,0,1,0,86707,518903,3486,104470,4.806615658231131,0.16758826577346148
3477,0.2056547619047619,0,3,0,86710,518900,3486,104470,4.806587869131868,0.16758907230055986
3478,0.2056666666666666,0,22,0,86732,518878,3486,104470,4.806384082403943,0.16759498706982295
3479,0.2056666666666667,1,0,1,86732,518878,3487,104469,4.806384082403943,0.1675936516899897
3480,0.2056904761904762,0,1,0,86733,518877,3487,104469,4.806374819370855,0.1675939205513471
3481,0.2057142857142856,0,14,0,86747,518863,3487,104469,4.806245136907629,0.16759768470092984
3482,0.2057142857142857,1,0,1,86747,518863,3488,104468,4.806245136907629,0.16759634929114708
3483,0.2057222222222222,0,3,0,86750,518860,3488,104468,4.806217347808366,0.16759715591149443
3484,0.2057467532467532,0,1,0,86751,518859,3488,104468,4.806208084775279,0.16759742478666895
3485,0.2057777777777777,0,1,0,86752,518858,3488,104468,4.806198821742191,0.1675976936627062
3486,0.2057857142857143,0,4,0,86756,518854,3488,104468,4.806161769609841,0.16759876917548233
3487,0.2058333333333332,0,3,0,86759,518851,3488,104468,4.8061339805105785,0.1675995758191231
3488,0.2058333333333333,3,73,3,86832,518778,3491,104465,4.805457779095187,0.16761519984981782
3489,0.2058571428571428,0,2,0,86834,518776,3491,104465,4.805439253029012,0.1676157377322737
3490,0.2059285714285714,1,3,1,86837,518773,3492,104464,4.805411463929749,0.167615208981495
3491,0.2059523809523809,0,3,0,86840,518770,3492,104464,4.805383674830487,0.16761601581428484
3492,0.206,6,94,6,86934,518676,3498,104458,4.804512949720256,0.16763328593849797
3493,0.2060436507936507,0,1,0,86935,518675,3498,104458,4.804503686687169,0.16763355495536267
3494,0.206047619047619,0,1,0,86936,518674,3498,104458,4.804494423654082,0.16763382397309076
3495,0.2060714285714285,0,5,0,86941,518669,3498,104458,4.804448108488644,0.167635169074683
3496,0.2061666666666666,0,7,0,86948,518662,3498,104458,4.80438326725703,0.16763705225317757
3497,0.2061904761904761,1,1,1,86949,518661,3499,104457,4.804374004223943,0.1676359854794758
3498,0.2061904761904762,0,1,0,86950,518660,3499,104457,4.804364741190856,0.16763625450758043
3499,0.2062142857142857,0,1,0,86951,518659,3499,104457,4.804355478157768,0.16763652353654857
3500,0.20625,0,6,0,86957,518653,3499,104457,4.804299899959243,0.16763813772849095
3501,0.2062619047619047,0,1,0,86958,518652,3499,104457,4.804290636926155,0.16763840676350367
3502,0.2063095238095238,0,2,0,86960,518650,3499,104457,4.80427211085998,0.16763894483611963
3503,0.2063333333333333,1,13,1,86973,518637,3500,104456,4.804151691429841,0.16764110654428793
3504,0.2064285714285714,1,4,1,86977,518633,3501,104455,4.804114639297492,0.16764084687877154
3505,0.2065,1,10,1,86987,518623,3502,104454,4.804022008966616,0.16764220152565412
3506,0.2065238095238095,0,2,0,86989,518621,3502,104454,4.804003482900441,0.1676427396380853
3507,0.2066666666666666,35,529,35,87518,518092,3537,104419,4.799103338397125,0.16773840140977428
3508,0.2067142857142857,0,2,0,87520,518090,3537,104419,4.79908481233095,0.16773894032054154
3509,0.2067619047619047,0,2,0,87522,518088,3537,104419,4.799066286264774,0.16773947923477164
3510,0.2068333333333333,1,10,1,87532,518078,3538,104418,4.798973655933899,0.16774083688891173
3511,0.2068571428571428,0,2,0,87534,518076,3538,104418,4.798955129867724,0.16774137582048984
3512,0.2069047619047619,0,1,0,87535,518075,3538,104418,4.798945866834637,0.16774164528757754
3513,0.2069523809523809,0,1,0,87536,518074,3538,104418,4.798936603801549,0.167741914755531
3514,0.207,1,44,1,87580,518030,3539,104417,4.798529030345696,0.16775243514708882
3515,0.207047619047619,0,1,0,87581,518029,3539,104417,4.798519767312609,0.1677527046522911
3516,0.2070833333333333,0,2,0,87583,518027,3539,104417,4.798501241246433,0.1677532436652936
3517,0.207095238095238,0,2,0,87585,518025,3539,104417,4.798482715180259,0.16775378268175992
3518,0.2071212121212121,0,1,0,87586,518024,3539,104417,4.798473452147171,0.16775405219129202
3519,0.2071428571428571,1,9,1,87595,518015,3540,104416,4.798390084849383,0.16775514073045847
3520,0.2071666666666667,1,2,1,87597,518013,3541,104415,4.798371558783208,0.16775434267095954
3521,0.2071904761904762,0,1,0,87598,518012,3541,104415,4.79836229575012,0.1677546121874533
3522,0.2072142857142857,0,1,0,87599,518011,3541,104415,4.798353032717033,0.1677548817048131
3523,0.2072222222222222,1,2,1,87601,518009,3542,104414,4.798334506650858,0.1677540836376548
3524,0.20725,0,1,0,87602,518008,3542,104414,4.798325243617771,0.16775435315589746
3525,0.2072857142857142,0,2,0,87604,518006,3542,104414,4.798306717551595,0.16775489219498088
3526,0.2073095238095238,0,1,0,87605,518005,3542,104414,4.798297454518508,0.16775516171582167
3527,0.2073333333333333,3,37,3,87642,517968,3545,104411,4.797954722294268,0.16776112304560403
3528,0.2073348318348318,0,1,0,87643,517967,3545,104411,4.7979454592611805,0.16776139259421124
3529,0.2073809523809523,0,3,0,87646,517964,3545,104411,4.797917670161918,0.16776220124522997
3530,0.2074999999999999,0,7,0,87653,517957,3545,104411,4.797852828930305,0.16776408812792432
3531,0.2075,20,316,20,87969,517641,3565,104391,4.7949257104746374,0.1678225557527587
3532,0.2075238095238095,0,2,0,87971,517639,3565,104391,4.794907184408463,0.16782309534909892
3533,0.2075555555555555,0,1,0,87972,517638,3565,104391,4.794897921375375,0.16782336514857024
3534,0.2075595238095238,0,1,0,87973,517637,3565,104391,4.794888658342288,0.16782363494890906
3535,0.2075714285714286,0,1,0,87974,517636,3565,104391,4.7948793953092,0.16782390475011535
3536,0.2076190476190476,0,5,0,87979,517631,3565,104391,4.794833080143762,0.1678252537691593
3537,0.2076666666666666,1,19,1,87998,517612,3566,104390,4.794657082515099,0.16782904235034615
3538,0.2076666666666667,0,10,0,88008,517602,3566,104390,4.794564452184223,0.1678317406011653
3539,0.2076904761904762,0,2,0,88010,517600,3566,104390,4.794545926118048,0.16783228026174055
3540,0.2077142857142857,0,5,0,88015,517595,3566,104390,4.79449961095261,0.1678336294283624
3541,0.20775,0,1,0,88016,517594,3566,104390,4.794490347919523,0.16783389926428977
3542,0.2077619047619047,0,2,0,88018,517592,3566,104390,4.794471821853348,0.16783443893874742
3543,0.2077857142857143,0,2,0,88020,517590,3566,104390,4.794453295787172,0.1678349786166758
3544,0.2078333333333333,0,9,0,88029,517581,3566,104390,4.794369928489385,0.16783740721030402
3545,0.2078571428571428,0,2,0,88031,517579,3566,104390,4.794351402423209,0.16783794690732176
3546,0.2078888888888888,0,1,0,88032,517578,3566,104390,4.794342139390122,0.1678382167571322
3547,0.2079047619047619,0,1,0,88033,517577,3566,104390,4.794332876357035,0.1678384866078104
3548,0.2079166666666666,0,1,0,88034,517576,3566,104390,4.794323613323947,0.1678387564593563
3549,0.2079523809523809,0,3,0,88037,517573,3566,104390,4.794295824224684,0.1678395660192005
3550,0.2079761904761905,0,1,0,88038,517572,3566,104390,4.794286561191597,0.16783983587421739
3551,0.2079999999999999,1,1,1,88039,517571,3567,104389,4.794277298158509,0.16783876776641585
3552,0.208,4,59,4,88098,517512,3571,104385,4.793730779206343,0.1678493383952648
3553,0.2080555555555555,0,3,0,88101,517509,3571,104385,4.7937029901070805,0.16785014809597776
3554,0.2080952380952381,0,1,0,88102,517508,3571,104385,4.793693727073993,0.16785041799795142
3555,0.208102564102564,0,1,0,88103,517507,3571,104385,4.793684464040906,0.16785068790079308
3556,0.2081547619047619,0,1,0,88104,517506,3571,104385,4.793675201007818,0.1678509578045027
3557,0.2081666666666666,2,13,2,88117,517493,3573,104383,4.79355478157768,0.16785179038908077
3558,0.2082142857142856,0,1,0,88118,517492,3573,104383,4.793545518544592,0.16785206030150754
3559,0.2082857142857143,0,2,0,88120,517490,3573,104383,4.793526992478417,0.16785260012896525
3560,0.2083018925518925,0,1,0,88121,517489,3573,104383,4.7935177294453295,0.16785287004399618
3561,0.2083095238095238,0,2,0,88123,517487,3573,104383,4.793499203379154,0.16785340987666234
3562,0.2083333333333333,12,300,12,88423,517187,3585,104371,4.790720293452888,0.16791835999214877
3563,0.2083571428571428,2,2,2,88425,517185,3587,104369,4.790701767386713,0.16791622288650704
3564,0.2083809523809524,1,2,1,88427,517183,3588,104368,4.790683241320538,0.16791542447844182
3565,0.2084285714285714,0,1,0,88428,517182,3588,104368,4.79067397828745,0.1679156946343818
3566,0.2085,1,19,1,88447,517163,3589,104367,4.790497980658787,0.16791948900294434
3567,0.2085238095238095,0,1,0,88448,517162,3589,104367,4.790488717625699,0.1679197591745518
3568,0.2085714285714285,0,4,0,88452,517158,3589,104367,4.790451665493349,0.1679208398696754
3569,0.2086190476190476,0,4,0,88456,517154,3589,104367,4.790414613360999,0.16792192057870933
3570,0.2086666666666666,0,23,0,88479,517131,3589,104367,4.790201563599985,0.1679281349256152
3571,0.20875,0,7,0,88486,517124,3589,104367,4.790136722368373,0.16793002633988263
3572,0.2087857142857143,0,1,0,88487,517123,3589,104367,4.7901274593352845,0.16793029654539895
3573,0.2088095238095238,0,3,0,88490,517120,3589,104367,4.790099670236022,0.1679311071671652
3574,0.2088333333333333,1,8,1,88498,517112,3590,104366,4.790025565971321,0.16793193001200366
3575,0.2088809523809523,0,1,0,88499,517111,3590,104366,4.790016302938234,0.16793220022623526
3576,0.2089999999999999,0,2,0,88501,517109,3590,104366,4.789997776872059,0.1679327406573072
3577,0.209,1,68,1,88569,517041,3591,104365,4.789367890622105,0.1679497784057444
3578,0.209047619047619,0,4,0,88573,517037,3591,104365,4.7893308384897555,0.16795085950801575
3579,0.2090833333333333,0,2,0,88575,517035,3591,104365,4.78931231242358,0.1679514000643708
3580,0.2091111111111111,0,1,0,88576,517034,3591,104365,4.789303049390492,0.16795167034385314
3581,0.2091666666666666,4,81,4,88657,516953,3595,104361,4.788552743710401,0.16796820931123393
3582,0.2091904761904761,0,1,0,88658,516952,3595,104361,4.788543480677313,0.16796847965518186
3583,0.2092222222222222,0,1,0,88659,516951,3595,104361,4.788534217644226,0.16796875
3584,0.2092380952380952,0,2,0,88661,516949,3595,104361,4.78851569157805,0.16796929069224703
3585,0.2092857142857142,0,1,0,88662,516948,3595,104361,4.788506428544963,0.16796956103967592
3586,0.2092857142857143,2,10,2,88672,516938,3597,104359,4.788413798214087,0.1679695862043435
3587,0.2093333333333333,4,42,4,88714,516896,3601,104355,4.78802475082441,0.1679755847475497
3588,0.2093571428571428,0,2,0,88716,516894,3601,104355,4.7880062247582345,0.16797612551489016
3589,0.2094047619047618,1,0,1,88716,516894,3602,104354,4.7880062247582345,0.16797478623673637
3590,0.2094166666666666,0,1,0,88717,516893,3602,104354,4.787996961725147,0.16797505661999174
3591,0.2094285714285714,0,2,0,88719,516891,3602,104354,4.787978435658972,0.1679755973891138
3592,0.2094444444444444,1,1,1,88720,516890,3603,104353,4.787969172625885,0.16797452848563282
3593,0.2094523809523809,1,1,1,88721,516889,3604,104352,4.787959909592797,0.1679734595752695
3594,0.2094761904761905,0,1,0,88722,516888,3604,104352,4.787950646559709,0.16797372995943596
3595,0.2094999999999999,0,3,0,88725,516885,3604,104352,4.787922857460447,0.16797454111715818
3596,0.2095,1,14,1,88739,516871,3605,104351,4.787793174997221,0.16797698729278746
3597,0.2095238095238095,0,6,0,88745,516865,3605,104351,4.787737596798696,0.1679786096945346
3598,0.2095555555555555,0,1,0,88746,516864,3605,104351,4.7877283337656085,0.1679788800978727
3599,0.2095833333333333,0,6,0,88752,516858,3605,104351,4.787672755567083,0.16798050253618346
3600,0.2096190476190476,0,1,0,88753,516857,3605,104351,4.787663492533995,0.16798077294561564
3601,0.2096666666666666,0,4,0,88757,516853,3605,104351,4.787626440401645,0.16798185459205028
3602,0.2096666666666667,1,8,1,88765,516845,3606,104350,4.787552336136945,0.1679826785469941
3603,0.2097023809523809,0,1,0,88766,516844,3606,104350,4.7875430731038575,0.1679829489660235
3604,0.2097222222222222,0,1,0,88767,516843,3606,104350,4.787533810070769,0.16798321938592353
3605,0.20975,0,4,0,88771,516839,3606,104350,4.78749675793842,0.16798430107423024
3606,0.2097619047619047,1,7,1,88778,516832,3607,104349,4.787431916706806,0.16798485465588936
3607,0.2097619047619048,0,1,0,88779,516831,3607,104349,4.787422653673719,0.16798512508451657
3608,0.2098333333333333,0,7,0,88786,516824,3607,104349,4.787357812442106,0.1679870181092868
3609,0.2098809523809523,0,2,0,88788,516822,3607,104349,4.787339286375931,0.1679875589813433
3610,0.2099047619047619,0,2,0,88790,516820,3607,104349,4.787320760309756,0.16798809985688276
3611,0.2099166666666666,0,1,0,88791,516819,3607,104349,4.787311497276669,0.1679883702959586
3612,0.2099285714285714,0,1,0,88792,516818,3607,104349,4.7873022342435805,0.16798864073590516
3613,0.2099523809523809,0,1,0,88793,516817,3607,104349,4.787292971210493,0.1679889111767225
3614,0.2099999999999999,1,9,1,88802,516808,3608,104348,4.7872096039127054,0.16799000573124948
3615,0.21,146,3249,146,92051,513559,3754,104202,4.757114009411241,0.16867688313117857
3616,0.2100833333333333,0,1,0,92052,513558,3754,104202,4.757104746378154,0.16867715617715617
3617,0.2101071428571428,0,1,0,92053,513557,3754,104202,4.757095483345067,0.1686774292240178
3618,0.210111111111111,0,2,0,92055,513555,3754,104202,4.757076957278891,0.16867797532039297
3619,0.2101111111111111,0,1,0,92056,513554,3754,104202,4.757067694245804,0.16867824836990655
3620,0.2101190476190476,0,5,0,92061,513549,3754,104202,4.757021379080366,0.16867961363073472
3621,0.2101666666666666,0,8,0,92069,513541,3754,104202,4.756947274815666,0.1686817980940294
3622,0.2101666666666667,0,2,0,92071,513539,3754,104202,4.75692874874949,0.1686823442186936
3623,0.2101796536796536,0,1,0,92072,513538,3754,104202,4.756919485716403,0.1686826172823518
3624,0.2101904761904761,0,4,0,92076,513534,3754,104202,4.756882433584053,0.1686837095458254
3625,0.2102222222222222,0,1,0,92077,513533,3754,104202,4.756873170550965,0.16868398261390402
3626,0.2102380952380952,0,2,0,92079,513531,3754,104202,4.75685464448479,0.16868452875271356
3627,0.2102727272727272,0,2,0,92081,513529,3754,104202,4.756836118418615,0.1686850748950595
3628,0.2102857142857143,0,2,0,92083,513527,3754,104202,4.75681759235244,0.1686856210409419
3629,0.2103333333333333,3,18,3,92101,513509,3757,104199,4.756650857756864,0.16868649912256276
3630,0.2103391053391053,0,4,0,92105,513505,3757,104199,4.7566138056245135,0.16868759146775802
3631,0.2103571428571428,0,1,0,92106,513504,3757,104199,4.756604542591426,0.16868786455626733
3632,0.2104166666666666,0,4,0,92110,513500,3757,104199,4.756567490459076,0.1686889569191467
3633,0.2104285714285714,0,1,0,92111,513499,3757,104199,4.756558227425988,0.1686892300120771
3634,0.2104761904761904,1,3,1,92114,513496,3758,104198,4.756530438326726,0.16868870346806022
3635,0.2104761904761905,0,1,0,92115,513495,3758,104198,4.7565211752936385,0.1686889765627909
3636,0.2104999999999999,0,2,0,92117,513493,3758,104198,4.756502649227463,0.16868952275490495
3637,0.2105,1,16,1,92133,513477,3759,104197,4.756354440698062,0.16869254655368365
3638,0.2105357142857143,0,3,0,92136,513474,3759,104197,4.756326651598799,0.16869336588572234
3639,0.2105515873015872,0,1,0,92137,513473,3759,104197,4.756317388565712,0.16869363899817055
3640,0.2105555555555555,0,1,0,92138,513472,3759,104197,4.756308125532624,0.16869391211150309
3641,0.2105992063492063,0,1,0,92139,513471,3759,104197,4.756298862499537,0.16869418522571997
3642,0.2106190476190476,0,3,0,92142,513468,3759,104197,4.756271073400274,0.16869500457367667
3643,0.2106666666666666,1,32,1,92174,513436,3760,104196,4.755974656341473,0.16870239883943838
3644,0.2106666666666667,0,3,0,92177,513433,3760,104196,4.755946867242209,0.1687032182750486
3645,0.2106746031746031,0,1,0,92178,513432,3760,104196,4.755937604209122,0.168703491422021
3646,0.2106944444444444,1,0,1,92178,513432,3761,104195,4.755937604209122,0.16870214546967668
3647,0.2107142857142857,1,4,1,92182,513428,3762,104194,4.755900552076772,0.16870189209581266
3648,0.21075,0,1,0,92183,513427,3762,104194,4.755891289043684,0.1687021652437336
3649,0.2107539682539682,0,2,0,92185,513425,3762,104194,4.75587276297751,0.1687027115422291
3650,0.2107619047619047,0,1,0,92186,513424,3762,104194,4.755863499944422,0.16870298469280365
3651,0.2107857142857143,1,1,1,92187,513423,3763,104193,4.755854236911334,0.1687019118675682
3652,0.2108333333333333,6,93,6,92280,513330,3769,104187,4.754992774834192,0.16871924173747443
3653,0.2108571428571428,1,2,1,92282,513328,3770,104186,4.754974248768017,0.16871844201103134
3654,0.2109285714285714,0,2,0,92284,513326,3770,104186,4.754955722701841,0.16871898845690447
3655,0.2109523809523809,0,5,0,92289,513321,3770,104186,4.754909407536403,0.16872035458707352
3656,0.2109999999999999,0,5,0,92294,513316,3770,104186,4.754863092370966,0.16872172073936603
3657,0.211,4,67,4,92361,513249,3774,104182,4.7542424691541,0.16873464403309843
3658,0.2110833333333333,0,1,0,92362,513248,3774,104182,4.754233206121012,0.16873491731856244
3659,0.2110952380952381,1,2,1,92364,513246,3775,104181,4.7542146800548375,0.16873411755559767
3660,0.2111071428571428,0,2,0,92366,513244,3775,104181,4.754196153988662,0.16873466412924648
3661,0.2111666666666666,1,12,1,92378,513232,3776,104180,4.754084997591612,0.1687365972802602
3662,0.2111904761904762,0,2,0,92380,513230,3776,104180,4.754066471525436,0.16873714387522068
3663,0.2112380952380952,0,1,0,92381,513229,3776,104180,4.754057208492349,0.16873741717402888
3664,0.21125,0,5,0,92386,513224,3776,104180,4.754010893326911,0.16873878368134965
3665,0.2112619047619047,0,1,0,92387,513223,3776,104180,4.754001630293823,0.1687390569854698
3666,0.2112857142857142,0,1,0,92388,513222,3776,104180,4.753992367260736,0.16873933029047525
3667,0.2113095238095238,0,1,0,92389,513221,3776,104180,4.753983104227649,0.16873960359636606
3668,0.2113333333333333,0,17,0,92406,513204,3776,104180,4.75382563266516,0.168744249931971
3669,0.2113690476190476,0,4,0,92410,513200,3776,104180,4.7537885805328095,0.16874534322459425
3670,0.2114285714285713,0,1,0,92411,513199,3776,104180,4.753779317499722,0.16874561654996365
3671,0.2114285714285714,0,5,0,92416,513194,3776,104180,4.753733002334284,0.16874698319009224
3672,0.2115,0,28,0,92444,513166,3776,104180,4.753473637407833,0.16875463678391048
3673,0.2115238095238095,0,1,0,92445,513165,3776,104180,4.753464374374746,0.1687549101393872
3674,0.2115555555555555,0,1,0,92446,513164,3776,104180,4.753455111341657,0.16875518349574953
3675,0.2115714285714285,0,1,0,92447,513163,3776,104180,4.75344584830857,0.16875545685299745
3676,0.2115952380952381,0,1,0,92448,513162,3776,104180,4.753436585275483,0.16875573021113094
3677,0.2116071428571428,0,1,0,92449,513161,3776,104180,4.753427322242395,0.16875600357015005
3678,0.2116190476190476,0,1,0,92450,513160,3776,104180,4.753418059209308,0.16875627693005474
3679,0.2116666666666666,18,297,18,92747,512863,3794,104162,4.750666938382304,0.1688132571613792
3680,0.2116984126984127,0,2,0,92749,512861,3794,104162,4.750648412316129,0.16881380434764992
3681,0.2117142857142857,1,1,1,92750,512860,3795,104161,4.7506391492830415,0.16881273084708623
3682,0.2117738095238095,0,1,0,92751,512859,3795,104161,4.750629886249953,0.16881300444069886
3683,0.2117777777777777,0,1,0,92752,512858,3795,104161,4.750620623216866,0.16881327803519827
3684,0.2117857142857142,0,2,0,92754,512856,3795,104161,4.750602097150691,0.16881382522685762
3685,0.2117857142857143,1,5,1,92759,512851,3796,104160,4.750555781985253,0.16881384610647135
3686,0.2118333333333333,0,3,0,92762,512848,3796,104160,4.75052799288599,0.16881466690869487
3687,0.2119444444444444,0,1,0,92763,512847,3796,104160,4.750518729852903,0.16881494051120977
3688,0.2119841269841269,0,4,0,92767,512843,3796,104160,4.750481677720553,0.1688160349301381
3689,0.212,5,65,5,92832,512778,3801,104155,4.7498795805698615,0.16882708495087798
3690,0.2120714285714285,1,2,1,92834,512776,3802,104154,4.749861054503687,0.16882628499181432
3691,0.2120833333333333,0,5,0,92839,512771,3802,104154,4.749814739338249,0.16882765328038254
3692,0.2120952380952381,0,1,0,92840,512770,3802,104154,4.749805476305161,0.16882792694075768
3693,0.2121428571428571,0,5,0,92845,512765,3802,104154,4.749759161139724,0.16882929525594123
3694,0.2121616161616161,0,1,0,92846,512764,3802,104154,4.749749898106636,0.1688295689216395
3695,0.2121666666666666,0,1,0,92847,512763,3802,104154,4.7497406350735485,0.168829842588225
3696,0.2122222222222222,0,1,0,92848,512762,3802,104154,4.749731372040461,0.1688301162556977
3697,0.2122619047619047,0,1,0,92849,512761,3802,104154,4.749722109007373,0.1688303899240576
3698,0.2122777777777778,0,1,0,92850,512760,3802,104154,4.749712845974286,0.16883066359330473
3699,0.2123333333333333,1,25,1,92875,512735,3803,104153,4.749481270147097,0.16883615826535772
3700,0.2123412698412699,0,2,0,92877,512733,3803,104153,4.749462744080922,0.16883670564739675
3701,0.2123452380952381,0,1,0,92878,512732,3803,104153,4.749453481047834,0.16883697933974728
3702,0.2123809523809523,0,4,0,92882,512728,3803,104153,4.749416428915484,0.16883807411802276
3703,0.2123809523809524,0,1,0,92883,512727,3803,104153,4.749407165882396,0.16883834781481002
3704,0.2124047619047619,0,1,0,92884,512726,3803,104153,4.749397902849309,0.16883862151248463
3705,0.2124404761904761,0,1,0,92885,512725,3803,104153,4.749388639816221,0.16883889521104659
3706,0.2124523809523809,0,1,0,92886,512724,3803,104153,4.749379376783134,0.16883916891049594
3707,0.2124999999999999,0,1,0,92887,512723,3803,104153,4.749370113750047,0.16883944261083264
3708,0.2125,16,293,16,93180,512430,3819,104137,4.746656045055393,0.16889810839697875
3709,0.2125238095238095,0,1,0,93181,512429,3819,104137,4.746646782022306,0.16889838233052099
3710,0.2125833333333333,0,1,0,93182,512428,3819,104137,4.746637518989218,0.1688986562649518
3711,0.2126190476190476,0,1,0,93183,512427,3819,104137,4.74662825595613,0.1688989302002712
3712,0.2126666666666666,2,28,2,93211,512399,3821,104135,4.746368891029679,0.16890390473193692
3713,0.2126666666666667,2,12,2,93223,512387,3823,104133,4.7462577346326285,0.16890449620450268
3714,0.2126785714285714,0,1,0,93224,512386,3823,104133,4.74624847159954,0.16890477016928918
3715,0.2127142857142857,0,1,0,93225,512385,3823,104133,4.746239208566453,0.16890504413496443
3716,0.21275,0,1,0,93226,512384,3823,104133,4.746229945533366,0.16890531810152842
3717,0.2127777777777778,0,2,0,93228,512382,3823,104133,4.7462114194671905,0.1689058660373227
3718,0.2127857142857142,0,1,0,93229,512381,3823,104133,4.746202156434102,0.16890614000655296
3719,0.2128333333333333,2,16,2,93245,512365,3825,104131,4.746053947904702,0.16890782746360072
3720,0.2128571428571428,1,10,1,93255,512355,3826,104130,4.745961317573826,0.1689092192024137
3721,0.2129166666666666,0,5,0,93260,512350,3826,104130,4.745915002408388,0.16891058915131066
3722,0.2129523809523809,0,1,0,93261,512349,3826,104130,4.745905739375301,0.16891086314375672
3723,0.2129999999999999,0,5,0,93266,512344,3826,104130,4.745859424209863,0.16891223311932052
3724,0.213,3,34,3,93300,512310,3829,104127,4.745544481084886,0.16891750495184424
3725,0.213047619047619,1,0,1,93300,512310,3830,104126,4.745544481084886,0.16891615674619911
3726,0.2130952380952381,0,1,0,93301,512309,3830,104126,4.745535218051799,0.16891643076723417
3727,0.2131666666666666,1,11,1,93312,512298,3831,104125,4.745433324687836,0.1689180968263676
3728,0.2131666666666667,0,1,0,93313,512297,3831,104125,4.745424061654748,0.16891837085632894
3729,0.2132142857142857,0,4,0,93317,512293,3831,104125,4.745387009522398,0.16891946698506533
3730,0.2132222222222222,1,0,1,93317,512293,3832,104124,4.745387009522398,0.16891811874104706
3731,0.2132738095238095,0,1,0,93318,512292,3832,104124,4.745377746489311,0.16891839277371126
3732,0.2132857142857143,0,1,0,93319,512291,3832,104124,4.745368483456223,0.16891866680726458
3733,0.2133333333333333,37,624,37,93943,511667,3869,104087,4.739588350809589,0.16903990879474595
3734,0.2133809523809523,0,1,0,93944,511666,3869,104087,4.739579087776502,0.1690401833202599
3735,0.2134166666666666,0,2,0,93946,511664,3869,104087,4.739560561710326,0.16904073237396286
3736,0.2134523809523809,0,2,0,93948,511662,3869,104087,4.739542035644151,0.16904128143123254
3737,0.2134999999999999,0,5,0,93953,511657,3869,104087,4.739495720478714,0.16904265409001143
3738,0.2135,0,10,0,93963,511647,3869,104087,4.739403090147838,0.16904539947444838
3739,0.2135238095238095,0,1,0,93964,511646,3869,104087,4.739393827114751,0.1690456740177967
3740,0.2135714285714285,0,5,0,93969,511641,3869,104087,4.739347511949313,0.16904704674791465
3741,0.2136111111111111,2,1,2,93970,511640,3871,104085,4.7393382489162255,0.16904462219334931
3742,0.2136190476190476,0,1,0,93971,511639,3871,104085,4.739328985883137,0.1690448967394482
3743,0.2136363636363636,0,2,0,93973,511637,3871,104085,4.739310459816963,0.16904544583432132
3744,0.2136428571428571,0,2,0,93975,511635,3871,104085,4.7392919337507875,0.16904599493276165
3745,0.2136666666666666,3,25,3,94000,511610,3874,104082,4.739060357923599,0.1690488101193454
3746,0.2136666666666667,0,1,0,94001,511609,3874,104082,4.739051094890511,0.16904908468696148
3747,0.2136904761904762,0,3,0,94004,511606,3874,104082,4.739023305791248,0.16904990839516118
3748,0.2137142857142857,0,1,0,94005,511605,3874,104082,4.739014042758161,0.16905018296634491
3749,0.21375,0,8,0,94013,511597,3874,104082,4.73893993849346,0.16905237956792418
3750,0.2137689393939393,0,1,0,94014,511596,3874,104082,4.738930675460373,0.16905265414713536
3751,0.2137698412698413,0,2,0,94016,511594,3874,104082,4.7389121493941975,0.16905320330823356
3752,0.2138095238095237,0,4,0,94020,511590,3874,104082,4.738875097261848,0.16905430164113358
3753,0.2138095238095238,0,1,0,94021,511589,3874,104082,4.7388658342287595,0.16905457622658854
3754,0.2138333333333333,0,4,0,94025,511585,3874,104082,4.73882878209641,0.16905567457732834
3755,0.2138813131313131,0,1,0,94026,511584,3874,104082,4.738819519063322,0.16905594916724329
3756,0.2139047619047618,0,1,0,94027,511583,3874,104082,4.738810256030234,0.16905622375805024
3757,0.2139166666666666,1,2,1,94029,511581,3875,104081,4.73879172996406,0.16905542326796197
3758,0.2139285714285714,0,4,0,94033,511577,3875,104081,4.738754677831709,0.1690565216402613
3759,0.214,6,94,6,94127,511483,3881,104075,4.7378839527214796,0.16907423833334959
3760,0.214047619047619,0,4,0,94131,511479,3881,104075,4.737846900589129,0.16907533701348704
3761,0.2140833333333333,0,2,0,94133,511477,3881,104075,4.7378283745229535,0.16907588635891038
3762,0.2140952380952381,0,1,0,94134,511476,3881,104075,4.737819111489866,0.16907616103296072
3763,0.2141666666666666,8,84,8,94218,511392,3889,104067,4.737041016710512,0.1690884364352459
3764,0.2142261904761905,0,1,0,94219,511391,3889,104067,4.7370317536774245,0.16908871117119284
3765,0.2142857142857142,0,6,0,94225,511385,3889,104067,4.736976175478898,0.1690903596056232
3766,0.2142857142857143,2,6,2,94231,511379,3891,104065,4.736920597280373,0.1690893078817894
3767,0.2143333333333333,1,15,1,94246,511364,3892,104064,4.73678165178406,0.1690920790084299
3768,0.2143452380952381,0,1,0,94247,511363,3892,104064,4.736772388750973,0.1690923537641345
3769,0.2143571428571428,0,1,0,94248,511362,3892,104064,4.736763125717885,0.16909262852073198
3770,0.2143589743589743,0,1,0,94249,511361,3892,104064,4.736753862684798,0.16909290327822238
3771,0.2144166666666666,0,1,0,94250,511360,3892,104064,4.73674459965171,0.16909317803660565
3772,0.2145,0,21,0,94271,511339,3892,104064,4.736550075956871,0.16909894816892346
3773,0.2145238095238095,1,4,1,94275,511335,3893,104063,4.736513023824521,0.169098697103338
3774,0.2145555555555555,0,1,0,94276,511334,3893,104063,4.736503760791433,0.16909897188319084
3775,0.2145833333333333,0,6,0,94282,511328,3893,104063,4.736448182592908,0.16910062058106148
3776,0.2146428571428571,0,5,0,94287,511323,3893,104063,4.73640186742747,0.16910199452051233
3777,0.2146666666666666,0,25,0,94312,511298,3893,104063,4.736170291600281,0.1691088645526772
3778,0.2146865079365079,0,1,0,94313,511297,3893,104063,4.736161028567194,0.16910913936557462
3779,0.2146904761904761,0,2,0,94315,511295,3893,104063,4.736142502501019,0.169109688994049
3780,0.21475,0,1,0,94316,511294,3893,104063,4.736133239467931,0.16910996380962595
3781,0.2147777777777778,0,1,0,94317,511293,3893,104063,4.736123976434844,0.16911023862609612
3782,0.2147857142857142,0,1,0,94318,511292,3893,104063,4.736114713401756,0.16911051344345945
3783,0.2148095238095238,0,1,0,94319,511291,3893,104063,4.736105450368669,0.16911078826171602
3784,0.2148333333333333,0,7,0,94326,511284,3893,104063,4.7360406091370555,0.16911271201452188
3785,0.2148571428571428,0,2,0,94328,511282,3893,104063,4.736022083070881,0.16911326166621976
3786,0.2148928571428571,0,1,0,94329,511281,3893,104063,4.736012820037793,0.16911353649340857
3787,0.2149383394383394,0,1,0,94330,511280,3893,104063,4.736003557004706,0.16911381132149061
3788,0.2149523809523809,0,2,0,94332,511278,3893,104063,4.73598503093853,0.16911436098033447
3789,0.2149999999999999,1,14,1,94346,511264,3894,104062,4.7358553484753045,0.16911685838076077
3790,0.215,53,1097,53,95443,510167,3947,104009,4.725693801178258,0.16934722294586568
3791,0.2150151515151515,0,1,0,95444,510166,3947,104009,4.72568453814517,0.16934749867708715
3792,0.2151190476190476,1,1,1,95445,510165,3948,104008,4.725675275112082,0.16934642193649022
3793,0.2151515151515152,0,1,0,95446,510164,3948,104008,4.725666012078995,0.16934669766775431
3794,0.2151666666666666,0,4,0,95450,510160,3948,104008,4.725628959946645,0.16934780060178975
3795,0.2151666666666667,0,1,0,95451,510159,3948,104008,4.725619696913557,0.16934807633754337
3796,0.2151904761904761,0,1,0,95452,510158,3948,104008,4.72561043388047,0.16934835207419494
3797,0.2151984126984127,0,1,0,95453,510157,3948,104008,4.725601170847383,0.1693486278117444
3798,0.2152124819624819,0,3,0,95456,510154,3948,104008,4.72557338174812,0.1693494550297804
3799,0.2152380952380952,1,2,1,95458,510152,3949,104007,4.725554855681945,0.16934865401304874
3800,0.2152857142857142,0,1,0,95459,510151,3949,104007,4.7255455926488565,0.16934892975423263
3801,0.2153333333333332,0,1,0,95460,510150,3949,104007,4.725536329615769,0.16934920549631446
3802,0.2153333333333333,2,24,2,95484,510126,3951,104005,4.7253140168216685,0.1693531184714662
3803,0.2153571428571428,0,1,0,95485,510125,3951,104005,4.72530475378858,0.1693533942324915
3804,0.2154166666666666,1,3,1,95488,510122,3952,104004,4.725276964689318,0.1693528689552307
3805,0.2154761904761905,0,1,0,95489,510121,3952,104004,4.725267701656231,0.16935314471809484
3806,0.2154999999999999,0,1,0,95490,510120,3952,104004,4.725258438623142,0.1693534204818571
3807,0.2155,0,13,0,95503,510107,3952,104004,4.725138019193005,0.1693570054924924
3808,0.2155952380952381,0,2,0,95505,510105,3952,104004,4.725119493126829,0.16935755704606187
3809,0.2156666666666666,1,26,1,95531,510079,3953,104003,4.724878654266553,0.1693633749238701
3810,0.2156785714285714,0,1,0,95532,510078,3953,104003,4.724869391233465,0.1693636507236016
3811,0.2157142857142857,0,11,0,95543,510067,3953,104003,4.724767497869502,0.1693666845799339
3812,0.2158333333333333,6,111,6,95654,509956,3959,103997,4.723739301196784,0.1693891877717024
3813,0.2158571428571428,0,1,0,95655,509955,3959,103997,4.723730038163696,0.16938946367142707
3814,0.2158809523809524,0,2,0,95657,509953,3959,103997,4.7237115120975215,0.16939001547357277
3815,0.2158928571428571,0,1,0,95658,509952,3959,103997,4.723702249064433,0.16939029137599376
3816,0.2159285714285714,0,2,0,95660,509950,3959,103997,4.723683722998259,0.16939084318353212
3817,0.2159523809523809,1,3,1,95663,509947,3960,103996,4.723655933898996,0.16939031799368998
3818,0.2159761904761905,0,1,0,95664,509946,3960,103996,4.723646670865908,0.16939059389974948
3819,0.2159999999999999,0,8,0,95672,509938,3960,103996,4.723572566601208,0.16939280118058292
3820,0.216,11,99,11,95771,509839,3971,103985,4.72265552632554,0.16940523668022103
3821,0.216047619047619,0,1,0,95772,509838,3971,103985,4.722646263292453,0.16940551266407416
3822,0.2160714285714285,0,1,0,95773,509837,3971,103985,4.722637000259365,0.16940578864882652
3823,0.2161111111111111,0,2,0,95775,509835,3971,103985,4.72261847419319,0.16940634062102897
3824,0.2161190476190476,0,1,0,95776,509834,3971,103985,4.722609211160102,0.16940661660847905
3825,0.2161547619047619,0,1,0,95777,509833,3971,103985,4.722599948127015,0.16940689259682837
3826,0.2161666666666666,1,3,1,95780,509830,3972,103984,4.722572159027752,0.16940636740119971
3827,0.2161904761904761,0,2,0,95782,509828,3972,103984,4.722553632961577,0.16940691938248192
3828,0.2161904761904762,0,2,0,95784,509826,3972,103984,4.722535106895402,0.16940747136736123
3829,0.2162380952380952,0,1,0,95785,509825,3972,103984,4.722525843862314,0.1694077473611498
3830,0.2162499999999999,0,2,0,95787,509823,3972,103984,4.722507317796139,0.1694082993514248
3831,0.21625,1,4,1,95791,509819,3973,103983,4.722470265663789,0.16940805015298094
3832,0.2162857142857143,0,1,0,95792,509818,3973,103983,4.722461002630701,0.16940832615130963
3833,0.2163095238095237,1,2,1,95794,509816,3974,103982,4.7224424765645265,0.16940752495120545
3834,0.2163333333333333,3,17,3,95811,509799,3977,103979,4.722285005002038,0.16940815734679315
3835,0.2164285714285714,0,3,0,95814,509796,3977,103979,4.722257215902776,0.1694089853773777
3836,0.2164761904761905,0,2,0,95816,509794,3977,103979,4.7222386898366,0.16940953740226436
3837,0.2164978354978355,0,4,0,95820,509790,3977,103979,4.7222016377042495,0.16941064146283047
3838,0.2165,2,19,2,95839,509771,3979,103977,4.722025640075587,0.1694131793504826
3839,0.2165238095238094,0,1,0,95840,509770,3979,103977,4.7220163770424985,0.16941345538145197
3840,0.2165238095238095,0,1,0,95841,509769,3979,103977,4.722007114009411,0.16941373141332083
3841,0.2165357142857142,0,1,0,95842,509768,3979,103977,4.721997850976324,0.16941400744608917
3842,0.2165714285714285,0,1,0,95843,509767,3979,103977,4.721988587943236,0.16941428347975704
3843,0.2166111111111111,0,1,0,95844,509766,3979,103977,4.721979324910149,0.1694145595143244
3844,0.2166666666666666,45,636,45,96480,509130,4024,103932,4.7160880358664645,0.1695293461346487
3845,0.2167051282051282,0,1,0,96481,509129,4024,103932,4.716078772833376,0.16952962266397634
3846,0.2167142857142857,0,1,0,96482,509128,4024,103932,4.716069509800289,0.1695298991942061
3847,0.2167380952380952,1,1,1,96483,509127,4025,103931,4.716060246767201,0.1695288210903373
3848,0.2167900432900433,0,1,0,96484,509126,4025,103931,4.716050983734114,0.16952909762061277
3849,0.2168333333333333,1,9,1,96493,509117,4026,103930,4.715967616436326,0.1695302317766827
3850,0.2168571428571428,1,2,1,96495,509115,4027,103929,4.715949090370151,0.169529430187719
3851,0.2168888888888889,0,1,0,96496,509114,4027,103929,4.715939827337063,0.16952970672530313
3852,0.2169047619047619,0,2,0,96498,509112,4027,103929,4.715921301270888,0.16953025980317793
3853,0.217,1,33,1,96531,509079,4028,103928,4.715615621178999,0.16953803137647694
3854,0.2170238095238095,2,1,2,96532,509078,4030,103926,4.715606358145911,0.16953559846265276
3855,0.217047619047619,0,1,0,96533,509077,4030,103926,4.715597095112824,0.16953587502834408
3856,0.2170714285714285,0,1,0,96534,509076,4030,103926,4.715587832079736,0.1695361515949377
3857,0.2170833333333333,0,4,0,96538,509072,4030,103926,4.715550779947386,0.16953725787033563
3858,0.2171111111111111,0,1,0,96539,509071,4030,103926,4.715541516914298,0.16953753444144098
3859,0.2171428571428571,1,6,1,96545,509065,4031,103925,4.715485938715773,0.16953783911646192
3860,0.2171666666666666,0,7,0,96552,509058,4031,103925,4.71542109748416,0.16953977516505353
3861,0.2171904761904762,0,1,0,96553,509057,4031,103925,4.715411834451072,0.16954005174703335
3862,0.2172142857142857,0,2,0,96555,509055,4031,103925,4.715393308384898,0.1695406049137003
3863,0.2172222222222222,0,1,0,96556,509054,4031,103925,4.71538404535181,0.1695408814983874
3864,0.2172380952380952,0,1,0,96557,509053,4031,103925,4.715374782318722,0.1695411580839769
3865,0.21725,0,1,0,96558,509052,4031,103925,4.715365519285635,0.16954143467046887
3866,0.2172619047619047,1,0,1,96558,509052,4032,103924,4.715365519285635,0.16954007987262143
3867,0.2172727272727272,0,1,0,96559,509051,4032,103924,4.715356256252547,0.16954035645825685
3868,0.2172857142857142,0,1,0,96560,509050,4032,103924,4.71534699321946,0.16954063304479472
3869,0.2173333333333333,1,34,1,96594,509016,4033,103923,4.715032050094483,0.1695486826584701
3870,0.2173571428571428,0,2,0,96596,509014,4033,103923,4.715013524028308,0.16954923589210635
3871,0.2173690476190476,1,0,1,96596,509014,4034,103922,4.715013524028308,0.1695478810185729
3872,0.2173809523809523,0,4,0,96600,509010,4034,103922,4.714976471895958,0.16954898748963995
3873,0.2173809523809524,0,4,0,96604,509006,4034,103922,4.714939419763607,0.16955009397514878
3874,0.2174761904761904,0,1,0,96605,509005,4034,103922,4.71493015673052,0.16955037059878256
3875,0.2174761904761905,0,1,0,96606,509004,4034,103922,4.714920893697433,0.16955064722331897
3876,0.2174999999999999,0,8,0,96614,508996,4034,103922,4.714846789432732,0.1695528602521055
3877,0.2175,15,260,15,96874,508736,4049,103907,4.712438400829968,0.1696044841775716
3878,0.2175238095238095,1,1,1,96875,508735,4050,103906,4.71242913779688,0.16960340558336776
3879,0.2175714285714285,0,1,0,96876,508734,4050,103906,4.712419874763793,0.1696036824236093
3880,0.2176111111111111,0,1,0,96877,508733,4050,103906,4.712410611730705,0.1696039592647546
3881,0.2176190476190476,0,4,0,96881,508729,4050,103906,4.712373559598355,0.16960506663837357
3882,0.2176587301587301,0,1,0,96882,508728,4050,103906,4.7123642965652675,0.16960534348403777
3883,0.2176666666666666,3,15,3,96897,508713,4053,103903,4.7122253510689545,0.16960542982879978
3884,0.2176666666666667,0,7,0,96904,508706,4053,103903,4.712160509837341,0.16960736783168384
3885,0.2177142857142857,0,1,0,96905,508705,4053,103903,4.712151246804254,0.16960764469285416
3886,0.21775,0,1,0,96906,508704,4053,103903,4.712141983771166,0.16960792155492838
3887,0.2177777777777778,0,5,0,96911,508699,4053,103903,4.712095668605728,0.16960930587885772
3888,0.217797619047619,0,1,0,96912,508698,4053,103903,4.712086405572641,0.1696095827463553
3889,0.2178095238095238,0,1,0,96913,508697,4053,103903,4.712077142539553,0.16960985961475677
3890,0.2178333333333333,0,18,0,96931,508679,4053,103903,4.711910407943977,0.169614843400557
3891,0.2178571428571428,1,9,1,96940,508670,4054,103902,4.711827040646189,0.1696159798358397
3892,0.2178809523809523,0,1,0,96941,508669,4054,103902,4.711817777613102,0.16961625672779154
3893,0.2179166666666666,0,4,0,96945,508665,4054,103902,4.711780725480751,0.16961736430463933
3894,0.2179523809523809,0,1,0,96946,508664,4054,103902,4.711771462447664,0.1696176412011114
3895,0.2179642857142857,0,1,0,96947,508663,4054,103902,4.711762199414577,0.1696179180984875
3896,0.2179761904761904,0,1,0,96948,508662,4054,103902,4.7117529363814885,0.1696181949967677
3897,0.2179999999999999,1,4,1,96952,508658,4055,103901,4.711715884249139,0.16961794700592106
3898,0.218,2,60,2,97012,508598,4057,103899,4.711160102263885,0.16963185125804697
3899,0.218047619047619,0,1,0,97013,508597,4057,103899,4.711150839230798,0.16963212820981688
3900,0.2180555555555555,0,1,0,97014,508596,4057,103899,4.7111415761977105,0.16963240516249112
3901,0.2180833333333333,1,3,1,97017,508593,4058,103898,4.711113787098448,0.16963188030518
3902,0.218095238095238,0,2,0,97019,508591,4058,103898,4.7110952610322725,0.1696324342151451
3903,0.2181666666666666,0,13,0,97032,508578,4058,103898,4.710974841602134,0.16963603471809507
3904,0.2181666666666667,0,3,0,97035,508575,4058,103898,4.710947052502871,0.16963686562509694
3905,0.2181904761904761,0,2,0,97037,508573,4058,103898,4.710928526436696,0.16963741956762035
3906,0.2182142857142857,0,9,0,97046,508564,4058,103898,4.710845159138908,0.16963991235374604
3907,0.2182619047619047,0,3,0,97049,508561,4058,103898,4.710817370039646,0.1696407432987351
3908,0.2182619047619048,0,2,0,97051,508559,4058,103898,4.71079884397347,0.1696412972665836
3909,0.2182857142857143,0,1,0,97052,508558,4058,103898,4.710789580940383,0.16964157425186463
3910,0.2183095238095238,1,1,1,97053,508557,4059,103897,4.710780317907296,0.16964049544945417
3911,0.2183333333333333,14,305,14,97358,508252,4073,103883,4.707955092815592,0.169706028898854
3912,0.2183571428571428,1,0,1,97358,508252,4074,103882,4.707955092815592,0.16970467250634666
3913,0.2184365079365079,0,2,0,97360,508250,4074,103882,4.707936566749416,0.16970522697718793
3914,0.2184523809523809,0,1,0,97361,508249,4074,103882,4.707927303716329,0.16970550421396727
3915,0.2184999999999999,0,2,0,97363,508247,4074,103882,4.707908777650154,0.16970605869024338
3916,0.2185,3,22,3,97385,508225,4077,103879,4.7077049909222275,0.16970808882150745
3917,0.2185714285714285,1,4,1,97389,508221,4078,103878,4.707667938789878,0.1697078413786005
3918,0.2185833333333333,0,1,0,97390,508220,4078,103878,4.7076586757567895,0.16970811863459773
3919,0.2186190476190476,0,1,0,97391,508219,4078,103878,4.707649412723702,0.16970839589150086
3920,0.2186428571428571,0,2,0,97393,508217,4078,103878,4.707630886657527,0.1697089504080249
3921,0.2186666666666666,2,21,2,97414,508196,4080,103876,4.707436362962689,0.16971206001908273
3922,0.2186666666666667,0,1,0,97415,508195,4080,103876,4.707427099929601,0.1697123372942028
3923,0.2186904761904761,0,1,0,97416,508194,4080,103876,4.707417836896513,0.1697126145702289
3924,0.2186904761904762,0,1,0,97417,508193,4080,103876,4.707408573863426,0.169712891847161
3925,0.21875,1,4,1,97421,508189,4081,103875,4.707371521731075,0.16971264442934073
3926,0.2188095238095238,0,2,0,97423,508187,4081,103875,4.707352995664901,0.16971319898964485
3927,0.2188333333333333,0,7,0,97430,508180,4081,103875,4.707288154433288,0.16971513997925022
3928,0.2188571428571428,0,1,0,97431,508179,4081,103875,4.7072788914002,0.16971541726710387
3929,0.2189285714285714,0,1,0,97432,508178,4081,103875,4.707269628367112,0.16971569455586363
3930,0.2189999999999999,1,65,1,97497,508113,4082,103874,4.7066675312164215,0.16973236359595872
3931,0.219,0,1,0,97498,508112,4082,103874,4.706658268183334,0.16973264094276666
3932,0.219047619047619,0,3,0,97501,508109,4082,103874,4.706630479084072,0.16973347298862876
3933,0.2190674603174602,0,1,0,97502,508108,4082,103874,4.7066212160509835,0.16973375033906227
3934,0.2191111111111111,0,1,0,97503,508107,4082,103874,4.706611953017896,0.16973402769040216
3935,0.2191666666666666,9,111,9,97614,507996,4091,103865,4.7055837563451774,0.16975260720980745
3936,0.2192222222222222,0,1,0,97615,507995,4091,103865,4.70557449331209,0.16975288464681462
3937,0.2192460317460317,0,1,0,97616,507994,4091,103865,4.705565230279003,0.16975316208472868
3938,0.2192857142857142,1,2,1,97618,507992,4092,103864,4.705546704212828,0.16975236003242594
3939,0.2192857142857143,0,2,0,97620,507990,4092,103864,4.705528178146652,0.16975291491107355
3940,0.2193333333333333,1,39,1,97659,507951,4093,103863,4.705166919856238,0.16976237876217282
3941,0.2193452380952381,1,1,1,97660,507950,4094,103862,4.70515765682315,0.16976129922263702
3942,0.2194047619047619,0,2,0,97662,507948,4094,103862,4.705139130756975,0.1697618541704124
3943,0.2194444444444444,0,2,0,97664,507946,4094,103862,4.7051206046908,0.169762409121816
3944,0.2194999999999999,0,3,0,97667,507943,4094,103862,4.705092815591537,0.16976324155572445
3945,0.2195,0,10,0,97677,507933,4094,103862,4.705000185260662,0.16976601639438046
3946,0.2195238095238095,0,2,0,97679,507931,4094,103862,4.704981659194487,0.16976657137299708
3947,0.2195833333333333,0,2,0,97681,507929,4094,103862,4.704963133128311,0.16976712635524224
3948,0.2196071428571428,0,2,0,97683,507927,4094,103862,4.704944607062137,0.16976768134111597
3949,0.2196190476190476,0,5,0,97688,507922,4094,103862,4.704898291896699,0.1697690688216756
3950,0.2196428571428571,1,1,1,97689,507921,4095,103861,4.704889028863611,0.1697679892510731
3951,0.2196666666666666,1,14,1,97703,507907,4096,103860,4.704759346400385,0.16977051720671432
3952,0.2197142857142856,0,1,0,97704,507906,4096,103860,4.704750083367298,0.16977079471562656
3953,0.21975,0,1,0,97705,507905,4096,103860,4.7047408203342105,0.16977107222544605
3954,0.2197619047619047,0,5,0,97710,507900,4096,103860,4.7046945051687725,0.16977245978815222
3955,0.2198333333333333,2,12,2,97722,507888,4098,103858,4.704583348771722,0.16977307575366246
3956,0.2198690476190476,0,1,0,97723,507887,4098,103858,4.704574085738634,0.16977335327628343
3957,0.2198809523809523,0,3,0,97726,507884,4098,103858,4.704546296639371,0.1697741858495902
3958,0.2198888888888888,0,1,0,97727,507883,4098,103858,4.704537033606284,0.16977446337584043
3959,0.2199047619047619,0,1,0,97728,507882,4098,103858,4.704527770573196,0.16977474090299802
3960,0.2199166666666666,0,2,0,97730,507880,4098,103858,4.704509244507022,0.16977529596003518
3961,0.2199523809523809,0,1,0,97731,507879,4098,103858,4.7044999814739334,0.1697755734899148
3962,0.2199999999999999,1,22,1,97753,507857,4099,103857,4.704296194746008,0.1697803221767035
3963,0.22,183,3413,183,101166,504444,4282,103674,4.672681462818185,0.17048336013734178
3964,0.2200205627705627,0,1,0,101167,504443,4282,103674,4.672672199785097,0.17048364048365694
3965,0.2200833333333333,0,1,0,101168,504442,4282,103674,4.67266293675201,0.17048392083089411
3966,0.2200992063492063,0,1,0,101169,504441,4282,103674,4.672653673718923,0.1704842011790533
3967,0.2201666666666666,0,2,0,101171,504439,4282,103674,4.6726351476527475,0.17048476187813777
3968,0.2201666666666667,0,6,0,101177,504433,4282,103674,4.672579569454222,0.17048644399752017
3969,0.2202380952380952,0,1,0,101178,504432,4282,103674,4.672570306421134,0.17048672435397777
3970,0.2202499999999999,0,1,0,101179,504431,4282,103674,4.672561043388047,0.17048700471135741
3971,0.2202857142857142,0,1,0,101180,504430,4282,103674,4.67255178035496,0.17048728506965913
3972,0.2203030303030302,0,1,0,101181,504429,4282,103674,4.6725425173218715,0.17048756542888294
3973,0.2203333333333333,3,18,3,101199,504411,4285,103671,4.672375782726296,0.17048851964044323
3974,0.2203441003441002,1,7,1,101206,504404,4286,103670,4.672310941494683,0.17048911810075748
3975,0.2204166666666666,0,2,0,101208,504402,4286,103670,4.672292415428508,0.17048967885381994
3976,0.2204285714285714,1,0,1,101208,504402,4287,103669,4.672292415428508,0.17048831468693623
3977,0.2204761904761904,0,6,0,101214,504396,4287,103669,4.672236837229983,0.1704899969575621
3978,0.2205,1,12,1,101226,504384,4288,103668,4.672125680832932,0.17049199739495965
3979,0.2205238095238095,0,3,0,101229,504381,4288,103668,4.672097891733669,0.17049283857057573
3980,0.2205555555555555,0,1,0,101230,504380,4288,103668,4.672088628700582,0.17049311896429228
3981,0.2206666666666666,5,27,5,101257,504353,4293,103663,4.671838526807218,0.17049386858240573
3982,0.2206666666666667,0,6,0,101263,504347,4293,103663,4.671782948608692,0.17049555106001546
3983,0.2207121212121212,0,2,0,101265,504345,4293,103663,4.671764422542517,0.17049611189326455
3984,0.2207142857142857,0,4,0,101269,504341,4293,103663,4.671727370410167,0.17049723357083177
3985,0.22075,0,1,0,101270,504340,4293,103663,4.67171810737708,0.17049751399252963
3986,0.2207619047619048,0,1,0,101271,504339,4293,103663,4.671708844343992,0.17049779441514995
3987,0.2208333333333333,6,98,6,101369,504241,4299,103657,4.6708010671014115,0.17051709332815704
3988,0.2208571428571428,1,1,1,101370,504240,4300,103656,4.670791804068324,0.17051600931738323
3989,0.2209444444444445,0,1,0,101371,504239,4300,103656,4.670782541035236,0.17051628981978795
3990,0.2209523809523809,0,5,0,101376,504234,4300,103656,4.670736225869799,0.17051769234565464
3991,0.2209999999999999,1,3,1,101379,504231,4301,103655,4.6707084367705365,0.17051716933767186
3992,0.221,3,58,3,101437,504173,4304,103652,4.670171180851458,0.17052934644017603
3993,0.2210238095238095,0,1,0,101438,504172,4304,103652,4.670161917818371,0.17052962699728869
3994,0.2210833333333333,2,0,2,101438,504172,4306,103650,4.670161917818371,0.17052689767728052
3995,0.2210952380952381,0,2,0,101440,504170,4306,103650,4.6701433917521955,0.17052745878714093
3996,0.2211111111111111,0,3,0,101443,504167,4306,103650,4.670115602652933,0.17052830045885523
3997,0.2211428571428571,1,2,1,101445,504165,4307,103649,4.6700970765867575,0.17052749689872232
3998,0.2211666666666666,2,8,2,101453,504157,4309,103647,4.670022972322057,0.1705270119972886
3999,0.2211904761904761,0,2,0,101455,504155,4309,103647,4.670004446255882,0.1705275731241424
4000,0.2212142857142857,0,1,0,101456,504154,4309,103647,4.669995183222794,0.17052785368895412
4001,0.22125,0,8,0,101464,504146,4309,103647,4.669921078958094,0.1705300982406839
4002,0.2212857142857142,0,2,0,101466,504144,4309,103647,4.669902552891919,0.17053065938784878
4003,0.2212857142857143,0,1,0,101467,504143,4309,103647,4.669893289858831,0.1705309399628161
4004,0.2212878787878787,0,1,0,101468,504142,4309,103647,4.669884026825744,0.1705312205387067
4005,0.2213095238095238,0,1,0,101469,504141,4309,103647,4.669874763792656,0.17053150111552054
4006,0.2213333333333333,4,25,4,101494,504116,4313,103643,4.669643187965468,0.17053305668858873
4007,0.2213611111111111,0,1,0,101495,504115,4313,103643,4.66963392493238,0.17053333728227354
4008,0.2214166666666666,0,1,0,101496,504114,4313,103643,4.6696246618992925,0.1705336178768817
4009,0.2214285714285714,1,3,1,101499,504111,4314,103642,4.66959687280003,0.17053309485926027
4010,0.2214632034632034,0,1,0,101500,504110,4314,103642,4.669587609766942,0.170533375455778
4011,0.2214999999999999,0,23,0,101523,504087,4314,103642,4.669374560005928,0.1705398294305521
4012,0.221547619047619,0,1,0,101524,504086,4314,103642,4.669365296972841,0.17054011004923256
4013,0.2215714285714285,1,0,1,101524,504086,4315,103641,4.669365296972841,0.17053874519315415
4014,0.221595238095238,0,1,0,101525,504085,4315,103641,4.669356033939753,0.17053902581097402
4015,0.2216212121212121,0,1,0,101526,504084,4315,103641,4.669346770906666,0.1705393064297174
4016,0.2216428571428571,1,3,1,101529,504081,4316,103640,4.669318981807403,0.17053878342199794
4017,0.2216538461538461,1,0,1,101529,504081,4317,103639,4.669318981807403,0.17053741854801555
4018,0.2216666666666666,18,341,18,101870,503740,4335,103621,4.666160287524547,0.1706085836924004
4019,0.2216666666666667,0,1,0,101871,503739,4335,103621,4.66615102449146,0.1706088645943098
4020,0.2216818181818181,0,1,0,101872,503738,4335,103621,4.666141761458372,0.1706091454971442
4021,0.2217380952380952,0,1,0,101873,503737,4335,103621,4.666132498425284,0.1706094264009036
4022,0.22175,0,1,0,101874,503736,4335,103621,4.666123235392197,0.17060970730558797
4023,0.2217857142857142,0,3,0,101877,503733,4335,103621,4.6660954462929345,0.17061055002519124
4024,0.2217857142857143,0,2,0,101879,503731,4335,103621,4.666076920226759,0.1706111118428852
4025,0.2218333333333333,0,13,0,101892,503718,4335,103621,4.665956500796621,0.17061476374808798
4026,0.2218571428571428,0,2,0,101894,503716,4335,103621,4.665937974730446,0.17061532559353373
4027,0.2218888888888889,0,2,0,101896,503714,4335,103621,4.665919448664271,0.17061588744267991
4028,0.2219047619047619,0,4,0,101900,503710,4335,103621,4.66588239653192,0.1706170111520736
4029,0.2219126984126984,0,1,0,101901,503709,4335,103621,4.665873133498833,0.17061729208173482
4030,0.2219444444444444,0,1,0,101902,503708,4335,103621,4.665863870465746,0.17061757301232117
4031,0.2219999999999999,0,1,0,101903,503707,4335,103621,4.6658546074326575,0.17061785394383266
4032,0.222,6,68,6,101971,503639,4341,103615,4.665224721182704,0.1706287648990373
4033,0.2220238095238095,0,2,0,101973,503637,4341,103615,4.665206195116529,0.17062932686924046
4034,0.2220555555555555,0,1,0,101974,503636,4341,103615,4.665196932083441,0.17062960785573017
4035,0.2220833333333333,0,3,0,101977,503633,4341,103615,4.665169142984179,0.17063045082075198
4036,0.2221428571428571,1,3,1,101980,503630,4342,103614,4.665141353884916,0.17062992800258217
4037,0.2221666666666666,0,4,0,101984,503626,4342,103614,4.6651043017525655,0.17063105197286083
4038,0.2221865079365079,0,2,0,101986,503624,4342,103614,4.665085775686391,0.170631613963553
4039,0.2221904761904762,0,1,0,101987,503623,4342,103614,4.665076512653303,0.17063189496028733
4040,0.2222142857142856,0,1,0,101988,503622,4342,103614,4.665067249620216,0.17063217595794716
4041,0.2222222222222222,0,4,0,101992,503618,4342,103614,4.665030197487866,0.1706332999578415
4042,0.2222619047619047,0,5,0,101997,503613,4342,103614,4.664983882322428,0.17063470497853356
4043,0.2222857142857142,0,1,0,101998,503612,4342,103614,4.66497461928934,0.17063498598544857
4044,0.2223095238095238,0,1,0,101999,503611,4342,103614,4.6649653562562525,0.17063526699328915
4045,0.2223333333333333,1,32,1,102031,503579,4343,103613,4.664668939197451,0.17064289384576872
4046,0.2223412698412698,0,3,0,102034,503576,4343,103613,4.664641150098189,0.17064373695834412
4047,0.2223809523809523,0,3,0,102037,503573,4343,103613,4.664613360998925,0.17064458007925085
4048,0.2224999999999999,0,7,0,102044,503566,4343,103613,4.664548519767313,0.17064654739376692
4049,0.2225,19,286,19,102330,503280,4362,103594,4.661899292304272,0.17070100218496756
4050,0.2225238095238094,0,1,0,102331,503279,4362,103594,4.661890029271184,0.1707012834645799
4051,0.2226190476190476,0,3,0,102334,503276,4362,103594,4.661862240171922,0.17070212730897885
4052,0.2226666666666666,0,41,0,102375,503235,4362,103594,4.6614824558153325,0.17071366068530014
4053,0.2227142857142857,0,2,0,102377,503233,4362,103594,4.661463929749157,0.17071422332888944
4054,0.2227301587301587,0,1,0,102378,503232,4362,103594,4.66145466671607,0.17071450465207488
4055,0.2227380952380952,0,1,0,102379,503231,4362,103594,4.661445403682982,0.17071478597618753
4056,0.2227777777777777,1,0,1,102379,503231,4363,103593,4.661445403682982,0.17071341937695278
4057,0.2227792207792207,0,1,0,102380,503230,4363,103593,4.6614361406498945,0.17071370070020417
4058,0.2227857142857142,0,1,0,102381,503229,4363,103593,4.661426877616806,0.17071398202438276
4059,0.2228333333333333,0,11,0,102392,503218,4363,103593,4.661324984252844,0.1707170766515439
4060,0.2228571428571428,2,8,2,102400,503210,4365,103591,4.661250879988144,0.1707165940728509
4061,0.2228571428571429,0,1,0,102401,503209,4365,103591,4.6612416169550555,0.17071687541199737
4062,0.2229047619047619,0,1,0,102402,503208,4365,103591,4.661232353921968,0.1707171567520711
4063,0.2229166666666666,0,3,0,102405,503205,4365,103591,4.661204564822706,0.17071800077785615
4064,0.2229285714285714,0,1,0,102406,503204,4365,103591,4.661195301789618,0.17071828212163911
4065,0.222969696969697,0,2,0,102408,503202,4365,103591,4.661176775723443,0.17071884481198696
4066,0.2229761904761904,0,2,0,102410,503200,4365,103591,4.661158249657268,0.17071940750604409
4067,0.2229999999999999,1,3,1,102413,503197,4366,103590,4.661130460558005,0.17071888488052644
4068,0.223,1,34,1,102447,503163,4367,103589,4.660815517433028,0.17072708454195454
4069,0.223015873015873,0,1,0,102448,503162,4367,103589,4.660806254399941,0.17072736592111096
4070,0.2230238095238095,1,0,1,102448,503162,4368,103588,4.660806254399941,0.17072599917593737
4071,0.223047619047619,1,0,1,102448,503162,4369,103587,4.660806254399941,0.17072463242625863
4072,0.2230952380952381,1,0,1,102448,503162,4370,103586,4.660806254399941,0.17072326567207474
4073,0.2231428571428571,0,1,0,102449,503161,4370,103586,4.660796991366853,0.17072354704679216
4074,0.2231666666666666,0,10,0,102459,503151,4370,103586,4.660704361035978,0.17072636084497897
4075,0.2231666666666667,0,1,0,102460,503150,4370,103586,4.66069509800289,0.170726642229899
4076,0.2231818181818181,0,3,0,102463,503147,4370,103586,4.660667308903627,0.17072748639022436
4077,0.2232222222222222,0,1,0,102464,503146,4370,103586,4.66065804587054,0.1707277677788546
4078,0.2232619047619047,0,1,0,102465,503145,4370,103586,4.660648782837452,0.17072804916841236
4079,0.2233333333333333,31,592,31,103057,502553,4401,103555,4.65516506724962,0.17085238934315336
4080,0.2234523809523809,0,1,0,103058,502552,4401,103555,4.655155804216533,0.1708526712280175
4081,0.2234999999999999,0,2,0,103060,502550,4401,103555,4.655137278150358,0.1708532350005362
4082,0.2235,0,26,0,103086,502524,4401,103555,4.654896439290082,0.170860564381871
4083,0.2235238095238095,0,1,0,103087,502523,4401,103555,4.654887176256993,0.17086084629371137
4084,0.2235396825396825,0,1,0,103088,502522,4401,103555,4.654877913223906,0.17086112820648203
4085,0.223547619047619,0,3,0,103091,502519,4401,103555,4.654850124124644,0.1708619739503757
4086,0.2235714285714286,0,7,0,103098,502512,4401,103555,4.65478528289303,0.1708639473853551
4087,0.223611111111111,0,1,0,103099,502511,4401,103555,4.654776019859943,0.17086422930835915
4088,0.2236190476190476,0,3,0,103102,502508,4401,103555,4.6547482307606804,0.17086507508295343
4089,0.2236666666666666,1,21,1,103123,502487,4402,103554,4.654553707065841,0.17086962763245392
4090,0.2236666666666667,0,1,0,103124,502486,4402,103554,4.654544444032754,0.1708699095769256
4091,0.2236904761904762,0,2,0,103126,502484,4402,103554,4.654525917966579,0.17087047346866038
4092,0.2237121212121212,0,1,0,103127,502483,4402,103554,4.6545166549334915,0.17087075541592345
4093,0.2237179487179487,0,1,0,103128,502482,4402,103554,4.654507391900404,0.170871037364117
4094,0.2237499999999999,0,1,0,103129,502481,4402,103554,4.654498128867316,0.17087131931324098
4095,0.22375,0,6,0,103135,502475,4402,103554,4.654442550668791,0.17087301102752508
4096,0.2237777777777777,1,0,1,103135,502475,4403,103553,4.654442550668791,0.17087164289438772
4097,0.2237777777777778,0,1,0,103136,502474,4403,103553,4.654433287635704,0.17087192484823283
4098,0.2238333333333333,3,12,3,103148,502462,4406,103550,4.6543221312386525,0.1708712038705504
4099,0.2238571428571429,0,1,0,103149,502461,4406,103550,4.654312868205565,0.17087148583111528
4100,0.2238690476190475,0,3,0,103152,502458,4406,103550,4.654285079106303,0.17087233171839317
4101,0.2238809523809524,0,3,0,103155,502455,4406,103550,4.65425729000704,0.17087317761404608
4102,0.2239444444444444,0,1,0,103156,502454,4406,103550,4.654248026973953,0.17087345958112488
4103,0.2239549062049061,1,4,1,103160,502450,4407,103549,4.654210974841602,0.17087321926273805
4104,0.2239999999999999,5,122,5,103282,502328,4412,103544,4.65308088480492,0.17090078432408165
4105,0.224,0,3,0,103285,502325,4412,103544,4.6530530957056575,0.17090163055049853
4106,0.224047619047619,0,6,0,103291,502319,4412,103544,4.652997517507132,0.17090332302847344
4107,0.2240555555555556,0,1,0,103292,502318,4412,103544,4.652988254474045,0.170903605111395
4108,0.2241666666666666,6,100,6,103392,502218,4418,103538,4.652061951165289,0.17092360620447838
4109,0.2241666666666667,0,1,0,103393,502217,4418,103538,4.652052688132202,0.17092388837071093
4110,0.2242142857142857,0,2,0,103395,502215,4418,103538,4.652034162066027,0.17092445270597093
4111,0.2242380952380952,1,0,1,103395,502215,4419,103537,4.652034162066027,0.1709230840343903
4112,0.2242530525030525,0,2,0,103397,502213,4419,103537,4.6520156359998515,0.17092364836978952
4113,0.2242857142857142,0,6,0,103403,502207,4419,103537,4.651960057801326,0.1709253413983465
4114,0.2242857142857143,1,14,1,103417,502193,4420,103536,4.6518303753381005,0.1709279232131861
4115,0.2243333333333333,4,18,4,103435,502175,4424,103532,4.651663640742525,0.17092752766601674
4116,0.2243809523809523,0,1,0,103436,502174,4424,103532,4.651654377709437,0.17092780986154998
4117,0.2244126984126984,0,1,0,103437,502173,4424,103532,4.65164511467635,0.17092809205801504
4118,0.2244166666666666,0,1,0,103438,502172,4424,103532,4.651635851643262,0.17092837425541188
4119,0.2244444444444444,0,2,0,103440,502170,4424,103532,4.651617325577087,0.170928938653001
4120,0.2244999999999999,0,1,0,103441,502169,4424,103532,4.651608062544,0.17092922085319323
4121,0.2245,3,26,3,103467,502143,4427,103529,4.651367223683723,0.17093245188815068
4122,0.2245238095238095,0,2,0,103469,502141,4427,103529,4.651348697617548,0.17093301632902405
4123,0.2245454545454545,0,1,0,103470,502140,4427,103529,4.65133943458446,0.17093329855085865
4124,0.224547619047619,0,4,0,103474,502136,4427,103529,4.65130238245211,0.17093442744751636
4125,0.2245714285714285,0,1,0,103475,502135,4427,103529,4.651293119419022,0.17093470967401067
4126,0.2245714285714286,0,1,0,103476,502134,4427,103529,4.651283856385935,0.17093499190143693
4127,0.2245833333333333,0,3,0,103479,502131,4427,103529,4.651256067286672,0.17093583858930753
4128,0.2245917415917415,0,1,0,103480,502130,4427,103529,4.651246804253585,0.17093612082046167
4129,0.2245952380952381,0,1,0,103481,502129,4427,103529,4.651237541220497,0.17093640305254781
4130,0.2246153846153846,0,1,0,103482,502128,4427,103529,4.65122827818741,0.1709366852855659
4131,0.2246190476190475,0,1,0,103483,502127,4427,103529,4.6512190151543225,0.17093696751951604
4132,0.2246190476190476,0,1,0,103484,502126,4427,103529,4.651209752121234,0.17093724975439814
4133,0.2246428571428571,0,2,0,103486,502124,4427,103529,4.65119122605506,0.17093781422695833
4134,0.2246666666666666,2,27,2,103513,502097,4429,103527,4.650941124161696,0.17094269711900453
4135,0.22475,1,1,1,103514,502096,4430,103526,4.650931861128608,0.17094161044347794
4136,0.2247619047619047,1,1,1,103515,502095,4431,103525,4.65092259809552,0.1709405237607741
4137,0.2248095238095238,0,1,0,103516,502094,4431,103525,4.650913335062433,0.17094080601830525
4138,0.2248333333333333,1,13,1,103529,502081,4432,103524,4.6507929156322945,0.17094310648029656
4139,0.2248571428571428,0,2,0,103531,502079,4432,103524,4.650774389566119,0.17094367101880276
4140,0.2248809523809523,0,1,0,103532,502078,4432,103524,4.650765126533032,0.17094395328945414
4141,0.2249999999999999,0,21,0,103553,502057,4432,103524,4.650570602838194,0.1709498811884785
4142,0.225,69,1139,69,104692,500918,4501,103455,4.6400200081514695,0.1711774020348361
4143,0.225021645021645,0,1,0,104693,500917,4501,103455,4.640010745118381,0.17117768526669006
4144,0.2251071428571428,1,1,1,104694,500916,4502,103454,4.640001482085294,0.1711765971176597
4145,0.2251190476190476,0,2,0,104696,500914,4502,103454,4.639982956019119,0.17117716358245308
4146,0.2251428571428571,1,0,1,104696,500914,4503,103453,4.639982956019119,0.17117579219249232
4147,0.2251666666666666,2,11,2,104707,500903,4505,103451,4.639881062655156,0.1711761649629191
4148,0.2251904761904762,0,2,0,104709,500901,4505,103451,4.63986253658898,0.17117673144127926
4149,0.2252380952380952,0,1,0,104710,500900,4505,103451,4.639853273555893,0.17117701468186533
4150,0.2252499999999999,0,1,0,104711,500899,4505,103451,4.639844010522806,0.17117729792338876
4151,0.2252857142857142,0,1,0,104712,500898,4505,103451,4.639834747489718,0.17117758116584952
4152,0.2253333333333333,1,19,1,104731,500879,4506,103450,4.639658749861055,0.17118159148410883
4153,0.2253571428571428,0,3,0,104734,500876,4506,103450,4.639630960761792,0.17118244126514498
4154,0.2253809523809523,0,1,0,104735,500875,4506,103450,4.639621697728704,0.17118272452736524
4155,0.2254166666666666,0,2,0,104737,500873,4506,103450,4.639603171662529,0.17118329105461813
4156,0.2254285714285714,0,1,0,104738,500872,4506,103450,4.6395939086294415,0.17118357431965078
4157,0.2254761904761904,0,1,0,104739,500871,4506,103450,4.639584645596354,0.17118385758562088
4158,0.2254920634920635,0,1,0,104740,500870,4506,103450,4.639575382563266,0.17118414085252845
4159,0.2254999999999999,0,1,0,104741,500869,4506,103450,4.639566119530179,0.17118442412037352
4160,0.2255,1,8,1,104749,500861,4507,103449,4.639492015265478,0.17118531879333454
4161,0.2255555555555555,0,1,0,104750,500860,4507,103449,4.639482752232391,0.1711856020678163
4162,0.2255833333333333,0,1,0,104751,500859,4507,103449,4.639473489199303,0.17118588534323556
4163,0.225595238095238,0,1,0,104752,500858,4507,103449,4.639464226166216,0.17118616861959235
4164,0.2256428571428571,0,5,0,104757,500853,4507,103449,4.639417911000778,0.1711875850154393
4165,0.2256565656565656,0,1,0,104758,500852,4507,103449,4.639408647967691,0.17118786829742133
4166,0.2256666666666666,1,25,1,104783,500827,4508,103448,4.639177072140502,0.17119357908237143
4167,0.2256666666666667,0,1,0,104784,500826,4508,103448,4.639167809107414,0.17119386238693043
4168,0.2257142857142857,1,15,1,104799,500811,4509,103447,4.639028863611101,0.17119674046516553
4169,0.2257619047619047,0,1,0,104800,500810,4509,103447,4.639019600578013,0.1711970237829268
4170,0.2257857142857142,0,1,0,104801,500809,4509,103447,4.639010337544926,0.1711973071016258
4171,0.2258095238095238,2,0,2,104801,500809,4511,103445,4.639010337544926,0.17119456387545634
4172,0.2258333333333333,6,99,6,104900,500710,4517,103439,4.638093297269258,0.171214385855145
4173,0.2258452380952381,0,1,0,104901,500709,4517,103439,4.63808403423617,0.17121466925322934
4174,0.2258571428571428,0,1,0,104902,500708,4517,103439,4.638074771203082,0.17121495265225184
4175,0.2258809523809523,0,1,0,104903,500707,4517,103439,4.638065508169995,0.17121523605221253
4176,0.2258888888888888,0,1,0,104904,500706,4517,103439,4.638056245136908,0.17121551945311142
4177,0.2258928571428571,0,1,0,104905,500705,4517,103439,4.63804698210382,0.1712158028549485
4178,0.2259047619047619,0,1,0,104906,500704,4517,103439,4.6380377190707325,0.17121608625772375
4179,0.2259166666666666,1,0,1,104906,500704,4518,103438,4.6380377190707325,0.17121471442144395
4180,0.225948717948718,0,1,0,104907,500703,4518,103438,4.638028456037645,0.1712149978233558
4181,0.2259523809523809,0,3,0,104910,500700,4518,103438,4.638000666938383,0.17121584803472054
4182,0.2259999999999999,0,9,0,104919,500691,4518,103438,4.637917299640594,0.17121839871947878
4183,0.226,3,107,3,105026,500584,4521,103435,4.636926155100226,0.17124461316614212
4184,0.226047619047619,0,1,0,105027,500583,4521,103435,4.636916892067139,0.17124489667526466
4185,0.2260714285714286,1,2,1,105029,500581,4522,103434,4.636898366000963,0.1712440916202412
4186,0.2260833333333333,0,3,0,105032,500578,4522,103434,4.636870576901701,0.17124494215346714
4187,0.2261111111111111,0,1,0,105033,500577,4522,103434,4.636861313868613,0.17124522566641998
4188,0.2261666666666666,0,9,0,105042,500568,4522,103434,4.636777946570825,0.17124777732524066
4189,0.2261666666666667,0,1,0,105043,500567,4522,103434,4.6367686835377375,0.17124806084758137
4190,0.2261904761904762,0,3,0,105046,500564,4522,103434,4.636740894438475,0.1712489114202365
4191,0.2262142857142857,0,3,0,105049,500561,4522,103434,4.636713105339212,0.17124976200134107
4192,0.22625,0,12,0,105061,500549,4522,103434,4.636601948942162,0.1712531644102566
4193,0.2262777777777778,0,1,0,105062,500548,4522,103434,4.636592685909074,0.17125344795043562
4194,0.2262857142857142,0,2,0,105064,500546,4522,103434,4.636574159842899,0.17125401503361037
4195,0.2263095238095238,1,2,1,105066,500544,4523,103433,4.636555633776724,0.17125320997322746
4196,0.2263333333333333,1,26,1,105092,500518,4524,103432,4.636314794916448,0.17125921019951984
4197,0.2263809523809524,0,1,0,105093,500517,4524,103432,4.63630553188336,0.17125949376520203
4198,0.2263888888888889,0,1,0,105094,500516,4524,103432,4.6362962688502725,0.17125977733182327
4199,0.2264166666666666,0,4,0,105098,500512,4524,103432,4.636259216717922,0.17126091160769874
4200,0.2264285714285714,0,5,0,105103,500507,4524,103432,4.636212901552485,0.171262329473672
4201,0.2264444444444444,0,1,0,105104,500506,4524,103432,4.6362036385193965,0.1712626130496839
4202,0.2264999999999999,2,18,2,105122,500488,4526,103430,4.636036903923821,0.1712649730592564
4203,0.2265,0,1,0,105123,500487,4526,103430,4.636027640890733,0.17126525664950648
4204,0.226547619047619,1,1,1,105124,500486,4527,103429,4.636018377857646,0.17126416797065813
4205,0.2265555555555555,0,1,0,105125,500485,4527,103429,4.636009114824558,0.17126445156098385
4206,0.2265833333333333,0,1,0,105126,500484,4527,103429,4.63599985179147,0.17126473515224874
4207,0.2266666666666666,45,591,45,105717,499893,4572,103384,4.630525399236726,0.17137069704298358
4208,0.2266666666666667,1,3,1,105720,499890,4573,103383,4.630497610137463,0.17137017569160232
4209,0.2267142857142857,0,2,0,105722,499888,4573,103383,4.630479084071288,0.17137074382822975
4210,0.2267619047619047,1,2,1,105724,499886,4574,103382,4.6304605580051135,0.17136993840216952
4211,0.2267857142857143,0,1,0,105725,499885,4574,103382,4.630451294972025,0.17137022247197345
4212,0.2268333333333333,1,13,1,105738,499872,4575,103381,4.630330875541888,0.17137254186883447
4213,0.2268571428571428,0,2,0,105740,499870,4575,103381,4.630312349475712,0.1713731100321425
4214,0.2268730158730158,0,1,0,105741,499869,4575,103381,4.630303086442625,0.17137339411520927
4215,0.2268809523809523,0,1,0,105742,499868,4575,103381,4.630293823409537,0.1713736781992179
4216,0.2269015151515151,0,1,0,105743,499867,4575,103381,4.63028456037645,0.17137396228416837
4217,0.2269047619047619,1,0,1,105743,499867,4576,103380,4.63028456037645,0.17137258867429095
4218,0.2269166666666666,0,1,0,105744,499866,4576,103380,4.6302752973433625,0.17137287275837718
4219,0.2269444444444444,0,1,0,105745,499865,4576,103380,4.630266034310274,0.17137315684340526
4220,0.2269999999999999,2,35,2,105780,499830,4578,103378,4.6299418281522104,0.17138035304571558
4221,0.227,1,2,1,105782,499828,4579,103377,4.629923302086035,0.17137954758332574
4222,0.2270238095238095,0,1,0,105783,499827,4579,103377,4.629914039052948,0.17137983169872878
4223,0.2270833333333332,0,1,0,105784,499826,4579,103377,4.62990477601986,0.17138011581507387
4224,0.2270833333333333,0,4,0,105788,499822,4579,103377,4.62986772388751,0.1713812522898745
4225,0.2271428571428571,1,19,1,105807,499803,4580,103376,4.629691726258846,0.17138527700732287
4226,0.2271666666666666,1,6,1,105813,499797,4581,103375,4.629636148060321,0.17138560808525594
4227,0.2271746031746031,0,1,0,105814,499796,4581,103375,4.629626885027234,0.17138589222625092
4228,0.2272222222222222,0,5,0,105819,499791,4581,103375,4.629580569861796,0.17138731294535833
4229,0.22725,0,1,0,105820,499790,4581,103375,4.629571306828708,0.17138759709200632
4230,0.2272619047619047,0,2,0,105822,499788,4581,103375,4.629552780762533,0.17138816538812893
4231,0.2272820512820512,1,0,1,105822,499788,4582,103374,4.629552780762533,0.17138679160822465
4232,0.2273095238095238,0,1,0,105823,499787,4582,103374,4.629543517729445,0.1713870757558927
4233,0.2273333333333333,1,37,1,105860,499750,4583,103373,4.629200785505206,0.1713962160289029
4234,0.2273333333333334,1,2,1,105862,499748,4584,103372,4.62918225943903,0.17139541053190077
4235,0.2273809523809523,0,3,0,105865,499745,4584,103372,4.629154470339768,0.17139626307996625
4236,0.2273809523809524,0,2,0,105867,499743,4584,103372,4.629135944273593,0.17139683145005513
4237,0.2273888888888888,1,0,1,105867,499743,4585,103371,4.629135944273593,0.1713954575751848
4238,0.2274166666666666,0,1,0,105868,499742,4585,103371,4.629126681240505,0.17139574175983605
4239,0.2274523809523809,0,2,0,105870,499740,4585,103371,4.629108155174331,0.17139631013196577
4240,0.2274999999999999,1,10,1,105880,499730,4586,103370,4.629015524843455,0.1713977781462444
4241,0.2275,19,313,19,106193,499417,4605,103351,4.62611619548705,0.17146066148169778
4242,0.2275641025641025,0,2,0,106195,499415,4605,103351,4.626097669420875,0.1714612303945478
4243,0.2275833333333333,0,1,0,106196,499414,4605,103351,4.626088406387788,0.17146151485238859
4244,0.2276190476190476,0,3,0,106199,499411,4605,103351,4.626060617288525,0.17146236823157399
4245,0.2276428571428571,0,1,0,106200,499410,4605,103351,4.626051354255438,0.17146265269319017
4246,0.2276666666666666,3,24,3,106224,499386,4608,103348,4.625829041461336,0.1714653561936111
4247,0.2277272727272727,0,1,0,106225,499385,4608,103348,4.625819778428249,0.17146564067339934
4248,0.2277380952380952,0,1,0,106226,499384,4608,103348,4.625810515395161,0.17146592515413153
4249,0.2277499999999999,0,1,0,106227,499383,4608,103348,4.6258012523620735,0.1714662096358077
4250,0.2277619047619047,0,3,0,106230,499380,4608,103348,4.625773463262811,0.17146706308650006
4251,0.2277777777777777,0,4,0,106234,499376,4608,103348,4.62573641113046,0.17146820103397242
4252,0.2277857142857142,0,1,0,106235,499375,4608,103348,4.625727148097373,0.17146848552320054
4253,0.227797619047619,0,1,0,106236,499374,4608,103348,4.625717885064286,0.17146877001337266
4254,0.2278095238095238,0,2,0,106238,499372,4608,103348,4.62569935899811,0.17146933899654898
4255,0.2278333333333333,1,6,1,106244,499366,4609,103347,4.625643780799585,0.1714696713029253
4256,0.2278571428571428,0,6,0,106250,499360,4609,103347,4.62558820260106,0.1714713782982444
4257,0.2279166666666666,0,6,0,106256,499354,4609,103347,4.625532624402535,0.17147308532755048
4258,0.2279285714285714,0,1,0,106257,499353,4609,103347,4.625523361369447,0.1714733698357392
4259,0.2279999999999999,0,2,0,106259,499351,4609,103347,4.625504835303271,0.1714739388549489
4260,0.228,3,66,3,106325,499285,4612,103344,4.624893475119493,0.17148859414332865
4261,0.228047619047619,0,1,0,106326,499284,4612,103344,4.624884212086406,0.17148887871124474
4262,0.2280555555555555,1,0,1,106326,499284,4613,103343,4.624884212086406,0.17148750387885042
4263,0.2280833333333333,0,1,0,106327,499283,4613,103343,4.624874949053318,0.17148778844590176
4264,0.228095238095238,0,2,0,106329,499281,4613,103343,4.6248564229871425,0.17148835758283773
4265,0.2280952380952381,0,1,0,106330,499280,4613,103343,4.624847159954055,0.17148864215272236
4266,0.2281121933621933,0,2,0,106332,499278,4613,103343,4.62482863388788,0.17148921129532493
4267,0.2281428571428571,0,1,0,106333,499277,4613,103343,4.624819370854793,0.17148949586804288
4268,0.2281666666666666,0,10,0,106343,499267,4613,103343,4.624726740523917,0.17149234164716814
4269,0.2281904761904762,0,1,0,106344,499266,4613,103343,4.6247174774908295,0.17149262623027536
4270,0.2282142857142857,0,1,0,106345,499265,4613,103343,4.624708214457742,0.17149291081432705
4271,0.2282857142857143,0,2,0,106347,499263,4613,103343,4.624689688391567,0.171493479985264
4272,0.2283333333333332,0,1,0,106348,499262,4613,103343,4.62468042535848,0.17149376457214927
4273,0.2283333333333333,24,339,24,106687,498923,4637,103319,4.621540257141799,0.17155728096014558
4274,0.2283571428571428,0,1,0,106688,498922,4637,103319,4.621530994108711,0.17155756582497705
4275,0.2283571428571429,0,1,0,106689,498921,4637,103319,4.621521731075624,0.17155785069075452
4276,0.2284285714285714,1,0,1,106689,498921,4638,103318,4.621521731075624,0.17155647508713318
4277,0.2284523809523809,1,2,1,106691,498919,4639,103317,4.621503205009448,0.17155566920609197
4278,0.2284761904761904,0,1,0,106692,498918,4639,103317,4.621493941976361,0.1715559540710852
4279,0.2284888167388167,0,2,0,106694,498916,4639,103317,4.621475415910186,0.1715565238039098
4280,0.2285,3,27,3,106721,498889,4642,103314,4.621225314016821,0.17156008854157154
4281,0.2285714285714285,1,6,1,106727,498883,4643,103313,4.621169735818296,0.17156042218812478
4282,0.2285714285714286,0,1,0,106728,498882,4643,103313,4.621160472785209,0.17156070707993257
4283,0.2285833333333333,0,2,0,106730,498880,4643,103313,4.6211419467190336,0.1715612768663867
4284,0.2286111111111111,0,1,0,106731,498879,4643,103313,4.621132683685946,0.17156156176103302
4285,0.2286666666666666,2,20,2,106751,498859,4645,103311,4.620947423024195,0.17156450836142617
4286,0.2286904761904761,0,1,0,106752,498858,4645,103311,4.620938159991107,0.17156479327232055
4287,0.22875,0,3,0,106755,498855,4645,103311,4.620910370891845,0.17156564801068144
4288,0.2287777777777778,0,1,0,106756,498854,4645,103311,4.620901107858757,0.171565932925361
4289,0.2288095238095238,1,0,1,106756,498854,4646,103310,4.620901107858757,0.17156455716382912
4290,0.2288333333333333,2,7,2,106763,498847,4648,103308,4.620836266627144,0.1715638000182677
4291,0.2288571428571428,0,3,0,106766,498844,4648,103308,4.6208084775278815,0.1715646547715527
4292,0.2288888888888889,0,3,0,106769,498841,4648,103308,4.620780688428619,0.1715655095333547
4293,0.2289285714285714,0,2,0,106771,498839,4648,103308,4.6207621623624435,0.17156607937928778
4294,0.2289523809523809,1,1,1,106772,498838,4649,103307,4.620752899329356,0.17156498849944782
4295,0.2289999999999999,1,57,1,106829,498781,4650,103306,4.620224906443366,0.1715798547386009
4296,0.229,0,3,0,106832,498778,4650,103306,4.620197117344103,0.17158070966841835
4297,0.2290238095238095,0,1,0,106833,498777,4650,103306,4.620187854311015,0.17158099464691745
4298,0.229047619047619,0,4,0,106837,498773,4650,103306,4.6201508021786655,0.1715821345703803
4299,0.2291190476190476,0,1,0,106838,498772,4650,103306,4.620141539145578,0.17158241955361264
4300,0.2291666666666666,6,88,6,106926,498684,4656,103300,4.619326392233873,0.17159924516266212
4301,0.2291666666666667,0,1,0,106927,498683,4656,103300,4.619317129200786,0.17159953021929192
4302,0.2292222222222222,0,3,0,106930,498680,4656,103300,4.619289340101523,0.1716003853948636
4303,0.2292424242424242,0,1,0,106931,498679,4656,103300,4.619280077068435,0.17160067045528166
4304,0.2292582417582417,0,1,0,106932,498678,4656,103300,4.619270814035348,0.17160095551664678
4305,0.2292857142857142,0,2,0,106934,498676,4656,103300,4.619252287969172,0.17160152564221828
4306,0.2292857142857143,0,6,0,106940,498670,4656,103300,4.619196709770647,0.1716032360416632
4307,0.2293333333333333,1,38,1,106978,498632,4657,103299,4.618844714513321,0.1716126931492148
4308,0.2293809523809523,0,1,0,106979,498631,4657,103299,4.618835451480233,0.17161297825328525
4309,0.2294166666666666,0,1,0,106980,498630,4657,103299,4.618826188447145,0.17161326335830304
4310,0.2294285714285714,0,2,0,106982,498628,4657,103299,4.61880766238097,0.17161383357118057
4311,0.2294999999999999,1,14,1,106996,498614,4658,103298,4.618677979917744,0.17161644891612063
4312,0.2295,1,2,1,106998,498612,4659,103297,4.618659453851569,0.1716156428961853
4313,0.2295238095238095,0,7,0,107005,498605,4659,103297,4.618594612619956,0.1716176387518234
4314,0.2295833333333333,0,5,0,107010,498600,4659,103297,4.6185482974545184,0.1716190643914158
4315,0.229595238095238,0,1,0,107011,498599,4659,103297,4.618539034421431,0.17161934952217658
4316,0.2296428571428571,0,3,0,107014,498596,4659,103297,4.618511245322169,0.17162020492014363
4317,0.2296666666666666,2,15,2,107029,498581,4661,103295,4.618372299825855,0.1716217293927653
4318,0.2297222222222222,0,1,0,107030,498580,4661,103295,4.6183630367927675,0.17162201453790238
4319,0.2297619047619047,0,6,0,107036,498574,4661,103295,4.618307458594242,0.17162372542862317
4320,0.2298095238095237,0,1,0,107037,498573,4661,103295,4.618298195561154,0.17162401058039303
4321,0.2298095238095238,0,2,0,107039,498571,4661,103295,4.61827966949498,0.17162458088677546
4322,0.2298333333333333,1,8,1,107047,498563,4662,103294,4.618205565230279,0.17162548578815234
4323,0.2298809523809523,0,1,0,107048,498562,4662,103294,4.618196302197191,0.17162577094853254
4324,0.2299047619047618,0,1,0,107049,498561,4662,103294,4.618187039164104,0.17162605610986034
4325,0.2299285714285714,0,2,0,107051,498559,4662,103294,4.618168513097928,0.1716266264353588
4326,0.2299404761904761,0,2,0,107053,498557,4662,103294,4.618149987031754,0.17162719676464772
4327,0.2299444444444444,0,1,0,107054,498556,4662,103294,4.618140723998666,0.17162748193071364
4328,0.229984126984127,0,1,0,107055,498555,4662,103294,4.618131460965579,0.17162776709772717
4329,0.2299999999999999,3,32,3,107087,498523,4665,103291,4.617835043906777,0.17163276361134835
4330,0.23,166,3389,166,110476,495134,4831,103125,4.586442624773055,0.17237517530032978
4331,0.2300833333333333,0,1,0,110477,495133,4831,103125,4.586433361739968,0.17237546342882168
4332,0.2301111111111111,0,1,0,110478,495132,4831,103125,4.586424098706881,0.1723757515582768
4333,0.2301190476190475,0,2,0,110480,495130,4831,103125,4.586405572640706,0.17237632782007672
4334,0.2301190476190476,0,4,0,110484,495126,4831,103125,4.586368520508355,0.1723774803552355
4335,0.2301428571428571,0,1,0,110485,495125,4831,103125,4.586359257475268,0.17237776849143335
4336,0.2301666666666666,4,7,4,110492,495118,4835,103121,4.586294416243655,0.17237425176225554
4337,0.2302142857142857,1,1,1,110493,495117,4836,103120,4.586285153210567,0.17237315645805926
4338,0.2302380952380952,0,2,0,110495,495115,4836,103120,4.586266627144393,0.17237373273044873
4339,0.2302777777777777,0,1,0,110496,495114,4836,103120,4.5862573641113045,0.1723740208680884
4340,0.2302857142857143,0,1,0,110497,495113,4836,103120,4.586248101078217,0.17237430900669137
4341,0.230297619047619,0,1,0,110498,495112,4836,103120,4.586238838045129,0.17237459714625764
4342,0.2303333333333333,1,23,1,110521,495089,4837,103119,4.586025788284116,0.17237984112549481
4343,0.2303571428571428,2,3,2,110524,495086,4839,103117,4.585997999184853,0.17237793859275197
4344,0.2304166666666666,0,1,0,110525,495085,4839,103117,4.585988736151766,0.172378226752836
4345,0.2304166666666667,0,1,0,110526,495084,4839,103117,4.585979473118678,0.17237851491388345
4346,0.230468253968254,0,2,0,110528,495082,4839,103117,4.585960947052503,0.17237909123886866
4347,0.2304761904761904,0,3,0,110531,495079,4839,103117,4.5859331579532405,0.1723799557335723
4348,0.2304999999999999,1,5,1,110536,495074,4840,103116,4.585886842787803,0.17238001303933534
4349,0.2305,1,19,1,110555,495055,4841,103115,4.585710845159139,0.1723841048531354
4350,0.2305297619047619,0,7,0,110562,495048,4841,103115,4.585646003927526,0.1723861221773998
4351,0.2305555555555555,0,2,0,110564,495046,4841,103115,4.585627477861351,0.1723866985644333
4352,0.2306666666666666,2,24,2,110588,495022,4843,103113,4.585405165067249,0.17239084821988346
4353,0.2306666666666667,0,1,0,110589,495021,4843,103113,4.585395902034162,0.1723911364343107
4354,0.2307142857142857,0,2,0,110591,495019,4843,103113,4.585377375967987,0.1723917128660563
4355,0.2307619047619047,0,5,0,110596,495014,4843,103113,4.585331060802549,0.1723931539622856
4356,0.2307857142857142,0,1,0,110597,495013,4843,103113,4.585321797769462,0.17239344218442268
4357,0.2308333333333333,6,107,6,110704,494906,4849,103107,4.5843306532290935,0.17241598426790053
4358,0.2308571428571428,0,3,0,110707,494903,4849,103107,4.584302864129831,0.17241684921656827
4359,0.2308571428571429,0,1,0,110708,494902,4849,103107,4.584293601096743,0.17241713753471938
4360,0.2309166666666666,0,1,0,110709,494901,4849,103107,4.5842843380636555,0.17241742585383474
4361,0.2309523809523809,1,2,1,110711,494899,4850,103106,4.58426581199748,0.17241661859014557
4362,0.230952380952381,0,2,0,110713,494897,4850,103106,4.584247285931306,0.17241719523146204
4363,0.2309761904761904,0,1,0,110714,494896,4850,103106,4.584238022898218,0.1724174835535667
4364,0.2309999999999999,1,8,1,110722,494888,4851,103105,4.584163918633517,0.17241840623552449
4365,0.231,1,61,1,110783,494827,4852,103104,4.583598873615177,0.17243461202045052
4366,0.231047619047619,0,1,0,110784,494826,4852,103104,4.583589610582089,0.17243490040640208
4367,0.2310595238095237,0,1,0,110785,494825,4852,103104,4.583580347549002,0.17243518879331826
4368,0.2310714285714285,1,0,1,110785,494825,4853,103103,4.583580347549002,0.17243380473903214
4369,0.2311111111111111,0,3,0,110788,494822,4853,103103,4.583552558449739,0.17243466990007109
4370,0.2311309523809524,0,2,0,110790,494820,4853,103103,4.583534032383564,0.17243524667892018
4371,0.2311428571428571,0,1,0,110791,494819,4853,103103,4.583524769350476,0.1724355350697917
4372,0.2311666666666666,0,7,0,110798,494812,4853,103103,4.583459928118863,0.17243755383290266
4373,0.2311904761904762,0,1,0,110799,494811,4853,103103,4.583450665085776,0.17243784223149147
4374,0.2312142857142857,0,1,0,110800,494810,4853,103103,4.583441402052689,0.172438130631045
4375,0.2312222222222222,0,1,0,110801,494809,4853,103103,4.5834321390196004,0.17243841903156318
4376,0.2312308802308802,0,1,0,110802,494808,4853,103103,4.583422875986513,0.17243870743304607
4377,0.23125,0,3,0,110805,494805,4853,103103,4.583395086887251,0.1724395726432829
4378,0.2312619047619047,0,1,0,110806,494804,4853,103103,4.5833858238541625,0.17243986104862463
4379,0.2312857142857143,0,1,0,110807,494803,4853,103103,4.583376560821075,0.17244014945493105
4380,0.2313073593073593,0,1,0,110808,494802,4853,103103,4.583367297787988,0.1724404378622022
4381,0.2313095238095237,1,1,1,110809,494801,4854,103102,4.5833580347549,0.17243934216754223
4382,0.2313095238095238,1,1,1,110810,494800,4855,103101,4.583348771721813,0.172438246465552
4383,0.2313333333333333,0,24,0,110834,494776,4855,103101,4.583126458927711,0.17244516848783278
4384,0.2313809523809523,0,1,0,110835,494775,4855,103101,4.583117195894624,0.17244545691748792
4385,0.2313888888888889,1,2,1,110837,494773,4856,103100,4.583098669828448,0.17244464961622286
4386,0.2314285714285714,0,7,0,110844,494766,4856,103100,4.583033828596836,0.17244666865150385
4387,0.2314999999999999,3,21,3,110865,494745,4859,103097,4.582839304901997,0.17244857336888342
4388,0.2315,1,7,1,110872,494738,4860,103096,4.582774463670384,0.17244920830866092
4389,0.2315555555555555,0,1,0,110873,494737,4860,103096,4.582765200637296,0.17244949676581922
4390,0.2315833333333333,1,0,1,110873,494737,4861,103095,4.582765200637296,0.1724481125132144
4391,0.231586691086691,0,2,0,110875,494735,4861,103095,4.582746674571122,0.17244868942676012
4392,0.2316666666666666,17,202,17,111077,494533,4878,103078,4.580875541887436,0.172483438223192
4393,0.2316666666666667,7,165,7,111242,494368,4885,103071,4.57934714142799,0.17252137875163825
4394,0.2316785714285714,0,1,0,111243,494367,4885,103071,4.5793378783949015,0.17252166752031173
4395,0.2317142857142857,0,2,0,111245,494365,4885,103071,4.579319352328726,0.1725222450605588
4396,0.2317499999999999,1,0,1,111245,494365,4886,103070,4.579319352328726,0.17252086000987554
4397,0.23175,0,2,0,111247,494363,4886,103070,4.579300826262552,0.17252143755031946
4398,0.2317619047619047,0,1,0,111248,494362,4886,103070,4.5792915632294635,0.17252172632199145
4399,0.2317857142857142,0,3,0,111251,494359,4886,103070,4.579263774130201,0.17252259264280775
4400,0.2317857142857143,0,1,0,111252,494358,4886,103070,4.579254511097114,0.17252288141834665
4401,0.2318333333333333,0,12,0,111264,494346,4886,103070,4.579143354700063,0.1725263468002196
4402,0.2318412698412698,0,1,0,111265,494345,4886,103070,4.579134091666975,0.17252663558832637
4403,0.2318571428571428,1,0,1,111265,494345,4887,103069,4.579134091666975,0.17252525049630574
4404,0.2319047619047619,0,5,0,111270,494340,4887,103069,4.579087776501538,0.1725266944421661
4405,0.2319444444444444,0,1,0,111271,494339,4887,103069,4.57907851346845,0.17252698323423857
4406,0.2319523809523809,0,1,0,111272,494338,4887,103069,4.579069250435363,0.17252727202727788
4407,0.2319761904761905,0,1,0,111273,494337,4887,103069,4.579059987402275,0.172527560821284
4408,0.2319999999999999,6,61,6,111334,494276,4893,103063,4.5784949423839345,0.17253686767480442
4409,0.232,0,3,0,111337,494273,4893,103063,4.578467153284672,0.17253773420654372
4410,0.2320238095238095,1,2,1,111339,494271,4894,103062,4.5784486272184965,0.17253692663890996
4411,0.2320833333333333,0,2,0,111341,494269,4894,103062,4.578430101152321,0.17253750433176915
4412,0.2321428571428571,0,7,0,111348,494262,4894,103062,4.578365259920709,0.1725395262872411
4413,0.2321666666666666,0,8,0,111356,494254,4894,103062,4.578291155656008,0.1725418371515245
4414,0.2321666666666667,0,6,0,111362,494248,4894,103062,4.578235577457483,0.17254357034035928
4415,0.2321904761904761,0,1,0,111363,494247,4894,103062,4.578226314424395,0.17254385920855034
4416,0.2322142857142856,0,1,0,111364,494246,4894,103062,4.578217051391308,0.17254414807770865
4417,0.2322222222222222,0,4,0,111368,494242,4894,103062,4.578179999258957,0.1725453035640143
4418,0.2322857142857143,0,3,0,111371,494239,4894,103062,4.578152210159694,0.17254617018889973
4419,0.2323015873015873,0,2,0,111373,494237,4894,103062,4.57813368409352,0.1725467479436597
4420,0.2323333333333333,1,26,1,111399,494211,4895,103061,4.577892845233243,0.17255287373257075
4421,0.2323333333333334,0,2,0,111401,494209,4895,103061,4.577874319167068,0.17255345153783047
4422,0.2323571428571429,0,1,0,111402,494208,4895,103061,4.57786505613398,0.17255374044191144
4423,0.2323809523809523,2,6,2,111408,494202,4897,103059,4.577809477935455,0.17255270308960405
4424,0.2323928571428571,0,1,0,111409,494201,4897,103059,4.577800214902368,0.1725529919967853
4425,0.2324047619047619,0,1,0,111410,494200,4897,103059,4.57779095186928,0.17255328090493405
4426,0.2324444444444444,0,2,0,111412,494198,4897,103059,4.577772425803105,0.17255385872413384
4427,0.2324725274725274,1,0,1,111412,494198,4898,103058,4.577772425803105,0.1725524733112769
4428,0.2324999999999999,0,6,0,111418,494192,4898,103058,4.57771684760458,0.17255420678107994
4429,0.2325,19,301,19,111719,493891,4917,103039,4.574928674645226,0.17261487946660412
4430,0.232547619047619,0,1,0,111720,493890,4917,103039,4.5749194116121386,0.17261516863814624
4431,0.2325952380952381,0,1,0,111721,493889,4917,103039,4.57491014857905,0.17261545781065724
4432,0.2326190476190476,0,6,0,111727,493883,4917,103039,4.574854570380525,0.1726171928660696
4433,0.2326666666666666,1,13,1,111740,493870,4918,103038,4.574734150950388,0.17261956616430002
4434,0.2326666666666667,0,11,0,111751,493859,4918,103038,4.5746322575864244,0.17262274730816204
4435,0.2327301587301587,0,1,0,111752,493858,4918,103038,4.574622994553336,0.17262303650887256
4436,0.2327380952380952,0,1,0,111753,493857,4918,103038,4.574613731520249,0.1726233257105521
4437,0.2327777777777777,0,2,0,111755,493855,4918,103038,4.574595205454074,0.17262390411681824
4438,0.2327820512820512,0,2,0,111757,493853,4918,103038,4.574576679387898,0.17262448252696053
4439,0.2327857142857143,0,5,0,111762,493848,4918,103038,4.574530364222461,0.17262592856927453
4440,0.2328333333333333,0,2,0,111764,493846,4918,103038,4.574511838156286,0.17262650699298357
4441,0.2328506493506493,0,2,0,111766,493844,4918,103038,4.574493312090111,0.1726270854205689
4442,0.2328571428571428,1,14,1,111780,493830,4919,103037,4.574363629626885,0.17262974833589392
4443,0.2329166666666667,2,2,2,111782,493828,4921,103035,4.57434510356071,0.17262755439690516
4444,0.2329285714285714,0,1,0,111783,493827,4921,103035,4.574335840527622,0.1726278436221438
4445,0.2329761904761904,1,2,1,111785,493825,4922,103034,4.574317314461447,0.17262703586609232
4446,0.2329761904761905,0,1,0,111786,493824,4922,103034,4.57430805142836,0.17262732509240053
4447,0.2329880952380952,0,1,0,111787,493823,4922,103034,4.574298788395272,0.1726276143196779
4448,0.2329999999999999,0,3,0,111790,493820,4922,103034,4.57427099929601,0.17262848200732508
4449,0.233,1,47,1,111837,493773,4923,103033,4.5738356367408946,0.17264069060967885
4450,0.2330555555555555,1,1,1,111838,493772,4924,103032,4.573826373707807,0.17263959356840772
4451,0.2330952380952381,0,1,0,111839,493771,4924,103032,4.573817110674719,0.172639882842412
4452,0.2331388888888889,0,1,0,111840,493770,4924,103032,4.573807847641632,0.17264017211738567
4453,0.2331666666666666,0,9,0,111849,493761,4924,103032,4.573724480343844,0.1726427756357732
4454,0.2331785714285714,0,1,0,111850,493760,4924,103032,4.573715217310756,0.1726430649204413
4455,0.2332142857142857,0,2,0,111852,493758,4924,103032,4.573696691244582,0.17264364349268588
4456,0.2332460317460317,0,2,0,111854,493756,4924,103032,4.573678165178406,0.17264422206880836
4457,0.2332499999999999,0,1,0,111855,493755,4924,103032,4.573668902145318,0.17264451135832382
4458,0.23325,0,1,0,111856,493754,4924,103032,4.573659639112231,0.1726448006488088
4459,0.2332857142857143,0,1,0,111857,493753,4924,103032,4.573650376079144,0.17264508994026326
4460,0.2333333333333332,0,1,0,111858,493752,4924,103032,4.5736411130460555,0.1726453792326872
4461,0.2333333333333333,31,572,31,112430,493180,4955,103001,4.568342658119975,0.1727680016639242
4462,0.2333333333333334,0,1,0,112431,493179,4955,103001,4.568333395086888,0.17276829145560066
4463,0.2333809523809523,0,2,0,112433,493177,4955,103001,4.568314869020712,0.17276887104187005
4464,0.2334523809523809,0,1,0,112434,493176,4955,103001,4.568305605987625,0.172769160836463
4465,0.2334999999999999,0,4,0,112438,493172,4955,103001,4.568268553855274,0.17277032002455664
4466,0.2335,2,24,2,112462,493148,4957,102999,4.568046241061173,0.17277450024909963
4467,0.2335238095238095,0,1,0,112463,493147,4957,102999,4.568036978028085,0.17277479006820476
4468,0.2335714285714285,0,2,0,112465,493145,4957,102999,4.56801845196191,0.17277536970933197
4469,0.2335833333333333,0,1,0,112466,493144,4957,102999,4.568009188928823,0.17277565953135404
4470,0.2335952380952381,0,1,0,112467,493143,4957,102999,4.567999925895736,0.17277594935434845
4471,0.2336111111111111,0,1,0,112468,493142,4957,102999,4.567990662862647,0.1727762391783152
4472,0.2336275946275946,0,2,0,112470,493140,4957,102999,4.567972136796473,0.17277681882916568
4473,0.2336439393939394,0,1,0,112471,493139,4957,102999,4.567962873763385,0.17277710865604945
4474,0.2336666666666666,0,14,0,112485,493125,4957,102999,4.567833191300159,0.172781166334521
4475,0.2336666666666667,0,1,0,112486,493124,4957,102999,4.567823928267072,0.17278145617599053
4476,0.2336904761904761,0,1,0,112487,493123,4957,102999,4.567814665233985,0.17278174601843246
4477,0.2337142857142857,0,2,0,112489,493121,4957,102999,4.567796139167809,0.17278232570623364
4478,0.23375,0,6,0,112495,493115,4957,102999,4.567740560969284,0.17278406479297584
4479,0.2338095238095238,0,3,0,112498,493112,4957,102999,4.5677127718700214,0.17278493434947517
4480,0.2338333333333333,1,9,1,112507,493103,4958,102998,4.567629404572233,0.1727861553662886
4481,0.2339285714285714,0,2,0,112509,493101,4958,102998,4.567610878506058,0.17278673508930564
4482,0.2339523809523809,0,3,0,112512,493098,4958,102998,4.567583089406796,0.1727876046811252
4483,0.2339761904761904,0,2,0,112514,493096,4958,102998,4.56756456334062,0.17278818441386762
4484,0.2339880952380952,0,3,0,112517,493093,4958,102998,4.567536774241358,0.17278905402027542
4485,0.2339999999999999,7,128,7,112645,492965,4965,102991,4.566351106006151,0.17281644953654296
4486,0.234,0,10,0,112655,492955,4965,102991,4.5662584756752755,0.17281934940414065
4487,0.234047619047619,0,4,0,112659,492951,4965,102991,4.566221423542925,0.17282050937842944
4488,0.2340476190476191,0,1,0,112660,492950,4965,102991,4.566212160509838,0.17282079937443473
4489,0.2340714285714286,0,1,0,112661,492949,4965,102991,4.5662028974767495,0.17282108937141322
4490,0.2340952380952381,0,1,0,112662,492948,4965,102991,4.566193634443662,0.17282137936936498
4491,0.2341111111111111,0,1,0,112663,492947,4965,102991,4.566184371410575,0.17282166936829
4492,0.2341428571428571,0,1,0,112664,492946,4965,102991,4.566175108377487,0.17282195936818825
4493,0.2341666666666666,4,43,4,112707,492903,4969,102987,4.565776797954722,0.17282887781301917
4494,0.2341666666666667,2,47,2,112754,492856,4971,102985,4.565341435399607,0.17283973409013478
4495,0.2341825396825396,0,1,0,112755,492855,4971,102985,4.56533217236652,0.17284002416756175
4496,0.2341904761904761,0,1,0,112756,492854,4971,102985,4.565322909333432,0.1728403142459624
4497,0.2341904761904762,0,1,0,112757,492853,4971,102985,4.5653136463003445,0.17284060432533677
4498,0.2342063492063492,0,1,0,112758,492852,4971,102985,4.565304383267257,0.1728408944056848
4499,0.2342857142857142,1,6,1,112764,492846,4972,102984,4.565248805068732,0.172841246664317
4500,0.2342857142857143,2,6,2,112770,492840,4974,102982,4.565193226870206,0.17284021066694416
4501,0.2343232323232322,0,1,0,112771,492839,4974,102982,4.565183963837119,0.1728405007544212
4502,0.2343333333333333,2,24,2,112795,492815,4976,102980,4.564961651043017,0.17284468651130003
4503,0.2343888888888888,1,3,1,112798,492812,4977,102979,4.5649338619437545,0.17284416850875559
4504,0.2344047619047619,0,1,0,112799,492811,4977,102979,4.564924598910667,0.17284445861796943
4505,0.2344285714285714,0,1,0,112800,492810,4977,102979,4.56491533587758,0.1728447487281571
4506,0.2344444444444444,1,1,1,112801,492809,4978,102978,4.564906072844492,0.1728436504992556
4507,0.2344999999999999,0,1,0,112802,492808,4978,102978,4.564896809811405,0.17284394060954772
4508,0.2345,0,10,0,112812,492798,4978,102978,4.564804179480529,0.17284684176603288
4509,0.2345238095238095,1,4,1,112816,492794,4979,102977,4.564767127348179,0.17284661388352235
4510,0.2345454545454545,0,1,0,112817,492793,4979,102977,4.564757864315092,0.17284690400657973
4511,0.2345714285714285,0,1,0,112818,492792,4979,102977,4.5647486012820035,0.17284719413061103
4512,0.2345833333333333,1,4,1,112822,492788,4980,102976,4.564711549149654,0.17284696624838022
4513,0.234595238095238,0,1,0,112823,492787,4980,102976,4.564702286116566,0.17284725637543788
4514,0.2346071428571428,0,1,0,112824,492786,4980,102976,4.564693023083478,0.1728475465034695
4515,0.2346190476190476,0,1,0,112825,492785,4980,102976,4.564683760050391,0.1728478366324751
4516,0.2346428571428571,0,4,0,112829,492781,4980,102976,4.56464670791804,0.17284899715823734
4517,0.2346666666666666,0,15,0,112844,492766,4980,102976,4.564507762421727,0.17285334926864312
4518,0.2346666666666667,0,18,0,112862,492748,4980,102976,4.564341027826152,0.17285857209043115
4519,0.2346904761904762,0,1,0,112863,492747,4980,102976,4.564331764793064,0.17285886225645142
4520,0.2347619047619047,0,6,0,112869,492741,4980,102976,4.5642761865945385,0.17286060327303066
4521,0.2347727272727272,0,2,0,112871,492739,4980,102976,4.564257660528363,0.17286118361968392
4522,0.2348333333333333,0,11,0,112882,492728,4980,102976,4.5641557671644,0.17286437559593354
4523,0.2348412698412698,0,2,0,112884,492726,4980,102976,4.5641372410982255,0.17286495596791684
4524,0.2348931623931623,0,1,0,112885,492725,4980,102976,4.564127978065137,0.17286524615536988
4525,0.2349047619047619,0,1,0,112886,492724,4980,102976,4.56411871503205,0.17286553634379723
4526,0.2349166666666666,0,1,0,112887,492723,4980,102976,4.564109451998963,0.17286582653319882
4527,0.2349523809523809,1,4,1,112891,492719,4981,102975,4.564072399866612,0.17286559878058197
4528,0.2349999999999999,0,15,0,112906,492704,4981,102975,4.563933454370299,0.17286995176932543
4529,0.235,71,1267,71,114173,491437,5052,102904,4.552197191448368,0.17313966224776686
4530,0.2350238095238095,0,2,0,114175,491435,5052,102904,4.5521786653821925,0.17314024487708193
4531,0.235047619047619,0,3,0,114178,491432,5052,102904,4.55215087628293,0.17314111882840683
4532,0.2351190476190476,0,2,0,114180,491430,5052,102904,4.5521323502167546,0.173141701467525
4533,0.2351245421245421,1,2,1,114182,491428,5053,102903,4.55211382415058,0.17314089286946163
4534,0.2351428571428571,0,1,0,114183,491427,5053,102903,4.552104561117492,0.17314118419060118
4535,0.2351666666666666,0,2,0,114185,491425,5053,102903,4.5520860350513175,0.1731417668358213
4536,0.2351666666666667,2,4,2,114189,491421,5055,102901,4.552048982918967,0.1731401496158648
4537,0.2352380952380952,0,3,0,114192,491418,5055,102901,4.552021193819704,0.1731410235917075
4538,0.23525,0,1,0,114193,491417,5055,102901,4.552011930786617,0.1731413149189491
4539,0.2352619047619047,0,1,0,114194,491416,5055,102901,4.552002667753529,0.17314160624717112
4540,0.2352777777777777,0,1,0,114195,491415,5055,102901,4.551993404720442,0.17314189757637352
4541,0.2352857142857142,0,1,0,114196,491414,5055,102901,4.551984141687354,0.17314218890655628
4542,0.2353333333333333,2,29,2,114225,491385,5057,102899,4.551715513727815,0.1731478552341978
4543,0.2353809523809524,0,1,0,114226,491384,5057,102899,4.5517062506947275,0.1731481465900926
4544,0.2354166666666666,1,1,1,114227,491383,5058,102898,4.55169698766164,0.17314704659916774
4545,0.2354166666666667,0,2,0,114229,491381,5058,102898,4.551678461595465,0.1731476293121581
4546,0.2354285714285714,0,1,0,114230,491380,5058,102898,4.551669198562378,0.17314792067012408
4547,0.2354761904761904,0,6,0,114236,491374,5058,102898,4.5516136203638515,0.17314966883851166
4548,0.2354920634920635,0,1,0,114237,491373,5058,102898,4.551604357330764,0.17314996020334159
4549,0.2354999999999999,0,1,0,114238,491372,5058,102898,4.551595094297677,0.17315025156915206
4550,0.2355,0,9,0,114247,491363,5058,102898,4.551511726999889,0.1731528739055735
4551,0.2355238095238095,0,1,0,114248,491362,5058,102898,4.551502463966801,0.17315316528119004
4552,0.2355357142857142,0,1,0,114249,491361,5058,102898,4.551493200933714,0.17315345665778725
4553,0.2355357142857143,0,1,0,114250,491360,5058,102898,4.551483937900626,0.17315374803536512
4554,0.2355555555555555,0,2,0,114252,491358,5058,102898,4.551465411834451,0.17315433079346276
4555,0.2355952380952381,0,1,0,114253,491357,5058,102898,4.551456148801363,0.17315462217398256
4556,0.2356190476190476,0,4,0,114257,491353,5058,102898,4.551419096669013,0.1731557877058684
4557,0.2356428571428571,0,2,0,114259,491351,5058,102898,4.551400570602838,0.1731563704776954
4558,0.2356587301587301,0,2,0,114261,491349,5058,102898,4.5513820445366635,0.17315695325344513
4559,0.2356666666666666,0,24,0,114285,491325,5058,102898,4.551159731742562,0.17316394686843156
4560,0.2356666666666667,0,6,0,114291,491319,5058,102898,4.551104153544037,0.17316569536044912
4561,0.2357142857142856,1,15,1,114306,491304,5059,102897,4.550965208047723,0.17316867524625507
4562,0.2357142857142857,0,7,0,114313,491297,5059,102897,4.55090036681611,0.17317071528827285
4563,0.23575,0,1,0,114314,491296,5059,102897,4.550891103783023,0.1731710067267706
4564,0.2357619047619047,0,1,0,114315,491295,5059,102897,4.550881840749935,0.1731712981662493
4565,0.2357777777777777,0,1,0,114316,491294,5059,102897,4.550872577716848,0.17317158960670895
4566,0.2357857142857143,0,2,0,114318,491292,5059,102897,4.550854051650672,0.17317217249057118
4567,0.2358333333333333,7,113,7,114431,491179,5066,102890,4.549807328911779,0.17319536956144824
4568,0.2358730158730159,1,0,1,114431,491179,5067,102889,4.549807328911779,0.17319397779378792
4569,0.2358888888888889,0,1,0,114432,491178,5067,102889,4.549798065878691,0.17319426933325702
4570,0.2359047619047619,0,1,0,114433,491177,5067,102889,4.549788802845604,0.17319456087370763
4571,0.2359090909090909,1,3,1,114436,491174,5068,102888,4.549761013746341,0.17319404371934244
4572,0.2359285714285714,0,1,0,114437,491173,5068,102888,4.549751750713254,0.17319433526186706
4573,0.2359289877219443,0,1,0,114438,491172,5068,102888,4.549742487680166,0.1731946268053732
4574,0.2359297924297924,0,1,0,114439,491171,5068,102888,4.5497332246470785,0.17319491834986087
4575,0.2359404761904761,0,2,0,114441,491169,5068,102888,4.549714698580903,0.17319550144178084
4576,0.2359523809523809,0,4,0,114445,491165,5068,102888,4.549677646448553,0.17319666763739935
4577,0.235952380952381,0,2,0,114447,491163,5068,102888,4.549659120382378,0.17319725074109799
4578,0.236,7,111,7,114558,491052,5075,102881,4.548630923709659,0.17321987496906216
4579,0.2360079365079365,0,2,0,114560,491050,5075,102881,4.548612397643485,0.17322045826872146
4580,0.2360238095238094,0,1,0,114561,491049,5075,102881,4.548603134610397,0.17322074992002426
4581,0.2360833333333333,0,1,0,114562,491048,5075,102881,4.548593871577309,0.17322104157230914
4582,0.2361111111111111,0,2,0,114564,491046,5075,102881,4.548575345511134,0.1732216248798253
4583,0.2361190476190476,0,1,0,114565,491045,5075,102881,4.548566082478047,0.17322191653505656
4584,0.2361666666666666,0,8,0,114573,491037,5075,102881,4.548491978213346,0.17322424981226364
4585,0.2361904761904761,0,9,0,114582,491028,5075,102881,4.548408610915558,0.17322687482425758
4586,0.2361904761904762,1,2,1,114584,491026,5076,102880,4.548390084849383,0.17322606607779684
4587,0.2362142857142857,0,1,0,114585,491025,5076,102880,4.548380821816296,0.17322635775081874
4588,0.23625,0,8,0,114593,491017,5076,102880,4.548306717551595,0.17322869117035444
4589,0.2362857142857142,0,1,0,114594,491016,5076,102880,4.548297454518508,0.17322898285221655
4590,0.2363095238095238,0,1,0,114595,491015,5076,102880,4.54828819148542,0.1732292745350609
4591,0.2363333333333333,2,22,2,114617,490993,5078,102878,4.5480844047574935,0.173232907483275
4592,0.2363571428571428,1,1,1,114618,490992,5079,102877,4.548075141724406,0.17323180701467833
4593,0.2364047619047619,0,1,0,114619,490991,5079,102877,4.548065878691319,0.1732320987155395
4594,0.2364246031746031,0,1,0,114620,490990,5079,102877,4.548056615658231,0.173232390417383
4595,0.2364285714285714,0,7,0,114627,490983,5079,102877,4.5479917744266185,0.17323443235779476
4596,0.2364523809523809,1,0,1,114627,490983,5080,102876,4.5479917744266185,0.17323304016610003
4597,0.2365,2,22,2,114649,490961,5082,102874,4.547787987698692,0.17323667348674296
4598,0.236547619047619,0,1,0,114650,490960,5082,102874,4.547778724665604,0.17323696521250045
4599,0.236563492063492,0,1,0,114651,490959,5082,102874,4.547769461632517,0.1732372569392405
4600,0.2365714285714285,0,1,0,114652,490958,5082,102874,4.54776019859943,0.17323754866696306
4601,0.236595238095238,0,2,0,114654,490956,5082,102874,4.547741672533254,0.17323813212535574
4602,0.2366190476190476,0,3,0,114657,490953,5082,102874,4.547713883433992,0.17323900732031383
4603,0.2366666666666666,15,314,15,114971,490639,5097,102859,4.5448052910445,0.17330976683998936
4604,0.2366666666666667,23,324,23,115295,490315,5120,102836,4.541804068324132,0.1733723790400758
4605,0.2367777777777778,0,1,0,115296,490314,5120,102836,4.541794805291045,0.17337267133102924
4606,0.2367857142857142,0,2,0,115298,490312,5120,102836,4.5417762792248695,0.17337325591589284
4607,0.2367857142857143,0,3,0,115301,490309,5120,102836,4.541748490125607,0.17337413280057995
4608,0.2368333333333333,0,18,0,115319,490291,5120,102836,4.54158175553003,0.17337939429498236
4609,0.2368571428571428,0,2,0,115321,490289,5120,102836,4.541563229463856,0.1733799789251844
4610,0.2369047619047619,0,3,0,115324,490286,5120,102836,4.541535440364593,0.1733808558778801
4611,0.2369134199134199,1,0,1,115324,490286,5121,102835,4.541535440364593,0.17337946220079883
4612,0.2369166666666666,0,1,0,115325,490285,5121,102835,4.541526177331505,0.17337975451847856
4613,0.2369642857142857,0,2,0,115327,490283,5121,102835,4.541507651265331,0.1733803391567951
4614,0.2369696969696969,1,1,1,115328,490282,5122,102834,4.541498388232243,0.17337923778822356
4615,0.237,1,33,1,115361,490249,5123,102833,4.541192708140353,0.173387491105783
4616,0.2370238095238095,1,2,1,115363,490247,5124,102832,4.541174182074179,0.17338668204404473
4617,0.2370833333333333,0,1,0,115364,490246,5124,102832,4.5411649190410905,0.17338697439459902
4618,0.237095238095238,0,3,0,115367,490243,5124,102832,4.541137129941828,0.17338785145217722
4619,0.2371428571428571,0,8,0,115375,490235,5124,102832,4.541063025677127,0.17339019031576533
4620,0.2371666666666666,0,3,0,115378,490232,5124,102832,4.541035236577865,0.17339106740587862
4621,0.2371666666666667,0,5,0,115383,490227,5124,102832,4.540988921412428,0.1733925292424531
4622,0.2372222222222222,0,2,0,115385,490225,5124,102832,4.540970395346252,0.1733931139839847
4623,0.23725,0,2,0,115387,490223,5124,102832,4.540951869280077,0.17339369872946017
4624,0.2372619047619047,0,1,0,115388,490222,5124,102832,4.54094260624699,0.1733939911036769
4625,0.2372727272727272,0,1,0,115389,490221,5124,102832,4.540933343213902,0.17339428347887964
4626,0.2373333333333333,4,43,4,115432,490178,5128,102828,4.540535032791137,0.17340128093139023
4627,0.2373571428571428,0,1,0,115433,490177,5128,102828,4.54052576975805,0.1734015733425519
4628,0.2373809523809523,0,1,0,115434,490176,5128,102828,4.540516506724962,0.1734018657546998
4629,0.2373809523809524,0,2,0,115436,490174,5128,102828,4.540497980658787,0.1734024505819542
4630,0.2374848484848484,0,2,0,115438,490172,5128,102828,4.540479454592612,0.17340303541315347
4631,0.2374999999999999,1,6,1,115444,490166,5129,102827,4.540423876394087,0.17340339599287008
4632,0.2375,15,339,15,115783,489827,5144,102812,4.537283708177406,0.17348166421717098
4633,0.2375555555555555,0,1,0,115784,489826,5144,102812,4.537274445144318,0.1734819569450491
4634,0.2376190476190476,0,4,0,115788,489822,5144,102812,4.537237393011968,0.17348312786644032
4635,0.2376428571428571,0,1,0,115789,489821,5144,102812,4.53722812997888,0.1734834205992579
4636,0.2376666666666666,3,19,3,115808,489802,5147,102809,4.537052132350217,0.1734847986284426
4637,0.2376666666666667,2,15,2,115823,489787,5149,102807,4.536913186853903,0.17348640046979888
4638,0.2376865079365079,0,1,0,115824,489786,5149,102807,4.536903923820816,0.1734866932278984
4639,0.2377380952380952,0,1,0,115825,489785,5149,102807,4.536894660787729,0.17348698598698598
4640,0.2377619047619047,0,1,0,115826,489784,5149,102807,4.536885397754641,0.17348727874706163
4641,0.2377777777777777,0,2,0,115828,489782,5149,102807,4.536866871688465,0.17348786427017715
4642,0.2378333333333333,0,14,0,115842,489768,5149,102807,4.5367371892252395,0.17349196304265282
4643,0.2378571428571428,0,6,0,115848,489762,5149,102807,4.536681611026714,0.1734937197187163
4644,0.2379166666666666,2,3,2,115851,489759,5151,102805,4.536653821927452,0.17349180847975915
4645,0.2379285714285714,0,1,0,115852,489758,5151,102805,4.5366445588943645,0.17349210126180675
4646,0.2379761904761904,0,2,0,115854,489756,5151,102805,4.536626032828189,0.17349268682886657
4647,0.2379999999999999,0,4,0,115858,489752,5151,102805,4.536588980695839,0.17349385797484462
4648,0.238,6,97,6,115955,489655,5157,102799,4.535690466486346,0.1735138930617398
4649,0.2380064935064935,0,2,0,115957,489653,5157,102799,4.535671940420171,0.17351447881009768
4650,0.238047619047619,0,4,0,115961,489649,5157,102799,4.535634888287821,0.17351565031867774
4651,0.2380952380952381,0,1,0,115962,489648,5157,102799,4.535625625254734,0.17351594319829453
4652,0.2381190476190476,0,1,0,115963,489647,5157,102799,4.535616362221646,0.17351623607890002
4653,0.2381428571428571,0,1,0,115964,489646,5157,102799,4.535607099188558,0.17351652896049422
4654,0.2381666666666666,1,11,1,115975,489635,5158,102798,4.535505205824595,0.17351835566215926
4655,0.2381666666666667,0,2,0,115977,489633,5158,102798,4.53548667975842,0.17351894144634564
4656,0.2382142857142856,0,1,0,115978,489632,5158,102798,4.535477416725333,0.17351923433992203
4657,0.2382142857142857,0,1,0,115979,489631,5158,102798,4.535468153692245,0.17351952723448716
4658,0.2382857142857143,0,1,0,115980,489630,5158,102798,4.535458890659157,0.1735198201300411
4659,0.2383333333333333,25,362,25,116342,489268,5183,102773,4.532105672681463,0.1735910181896186
4660,0.2383571428571428,0,2,0,116344,489266,5183,102773,4.532087146615288,0.1735916046071289
4661,0.2384285714285714,0,3,0,116347,489263,5183,102773,4.532059357516025,0.17359248424082319
4662,0.2384523809523809,0,1,0,116348,489262,5183,102773,4.532050094482938,0.17359277745403565
4663,0.2385,1,30,1,116378,489232,5184,102772,4.531772203490311,0.17360017837717312
4664,0.2385238095238094,0,1,0,116379,489231,5184,102772,4.531762940457224,0.17360047161923167
4665,0.2385714285714285,1,5,1,116384,489226,5185,102771,4.531716625291786,0.17360054189463797
4666,0.2385952380952381,0,1,0,116385,489225,5185,102771,4.531707362258698,0.17360083514077798
4667,0.238608225108225,1,0,1,116385,489225,5186,102770,4.531707362258698,0.17359943918445256
4668,0.2386666666666666,0,30,0,116415,489195,5186,102770,4.531429471266072,0.17360823697346972
4669,0.2386904761904762,0,4,0,116419,489191,5186,102770,4.531392419133721,0.17360941007938022
4670,0.2387499999999999,0,1,0,116420,489190,5186,102770,4.531383156100634,0.17360970335833503
4671,0.23875,1,9,1,116429,489181,5187,102769,4.531299788802846,0.1736109468705127
4672,0.2387857142857142,1,2,1,116431,489179,5188,102768,4.5312812627366705,0.17361013739405723
4673,0.2387857142857143,0,1,0,116432,489178,5188,102768,4.531271999703583,0.17361043068117699
4674,0.2388095238095238,0,2,0,116434,489176,5188,102768,4.531253473637408,0.17361101725838932
4675,0.2388333333333333,1,7,1,116441,489169,5189,102767,4.531188632405795,0.17361167423505244
4676,0.2388571428571428,0,1,0,116442,489168,5189,102767,4.531179369372707,0.17361196753021868
4677,0.2388888888888889,0,2,0,116444,489166,5189,102767,4.531160843306532,0.1736125541235241
4678,0.2389285714285714,0,1,0,116445,489165,5189,102767,4.531151580273445,0.1736128474216633
4679,0.2389999999999999,0,3,0,116448,489162,5189,102767,4.531123791174182,0.1736137273220268
4680,0.239,5,60,5,116508,489102,5194,102762,4.530568009188928,0.17362434613357122
4681,0.239047619047619,0,10,0,116518,489092,5194,102762,4.530475378858053,0.17362727970073702
4682,0.2390833333333333,0,1,0,116519,489091,5194,102762,4.530466115824966,0.17362757306290583
4683,0.239095238095238,0,1,0,116520,489090,5194,102762,4.530456852791878,0.17362786642606598
4684,0.239112018829124,0,1,0,116521,489089,5194,102762,4.530447589758791,0.17362815979021748
4685,0.2391428571428571,0,2,0,116523,489087,5194,102762,4.530429063692615,0.17362874652149451
4686,0.2391666666666666,7,92,7,116615,488995,5201,102755,4.52957686464856,0.17364596535699198
4687,0.2392142857142857,1,4,1,116619,488991,5202,102754,4.5295398125162105,0.1736457426763217
4688,0.2392857142857142,0,2,0,116621,488989,5202,102754,4.529521286450035,0.17364632957212844
4689,0.2392857142857143,1,5,1,116626,488984,5203,102753,4.529474971284597,0.1736464003433958
4690,0.2393055555555555,0,1,0,116627,488983,5203,102753,4.52946570825151,0.17364669379588193
4691,0.2393333333333333,2,44,2,116671,488939,5205,102751,4.529058134795657,0.17365681353411414
4692,0.2393452380952381,0,1,0,116672,488938,5205,102751,4.52904887176257,0.1736571070275094
4693,0.2393809523809523,0,1,0,116673,488937,5205,102751,4.529039608729482,0.17365740052189668
4694,0.2394047619047619,0,1,0,116674,488936,5205,102751,4.529030345696395,0.17365769401727602
4695,0.2394166666666667,0,1,0,116675,488935,5205,102751,4.5290210826633075,0.17365798751364744
4696,0.2394999999999999,0,2,0,116677,488933,5205,102751,4.529002556597132,0.17365857450936648
4697,0.2395,1,19,1,116696,488914,5206,102750,4.528826558968468,0.17366275453635846
4698,0.2395238095238095,0,3,0,116699,488911,5206,102750,4.528798769869206,0.17366363508833604
4699,0.2395454545454545,0,1,0,116700,488910,5206,102750,4.528789506836119,0.1736639286076463
4700,0.2395833333333333,1,2,1,116702,488908,5207,102749,4.528770980769943,0.17366311900307105
4701,0.2396428571428571,0,1,0,116703,488907,5207,102749,4.528761717736856,0.17366341252349338
4702,0.2396666666666666,1,3,1,116706,488904,5208,102748,4.528733928637593,0.17366289643236227
4703,0.2396666666666667,0,11,0,116717,488893,5208,102748,4.52863203527363,0.1736661252347285
4704,0.2397142857142856,0,1,0,116718,488892,5208,102748,4.528622772240542,0.17366641876816982
4705,0.2397222222222222,1,0,1,116718,488892,5209,102747,4.528622772240542,0.17366502208272275
4706,0.2397619047619047,1,3,1,116721,488889,5210,102746,4.5285949831412795,0.1736645059876444
4707,0.2397857142857143,0,2,0,116723,488887,5210,102746,4.528576457075105,0.17366509305599925
4708,0.2398333333333333,2,11,2,116734,488876,5212,102744,4.528474563711142,0.1736655285487306
4709,0.2398571428571428,0,1,0,116735,488875,5212,102744,4.528465300678054,0.1736658220915826
4710,0.2399999999999999,2,28,2,116763,488847,5214,102742,4.528205935751602,0.1736712481131326
4711,0.24,202,3488,202,120251,485359,5416,102540,4.495896476342214,0.17441771460744107
4712,0.2400396825396825,1,1,1,120252,485358,5417,102539,4.495887213309126,0.17441660699068035
4713,0.2400555555555555,0,1,0,120253,485357,5417,102539,4.495877950276038,0.17441690367003687
4714,0.2400714285714286,0,2,0,120255,485355,5417,102539,4.495859424209863,0.17441749703177784
4715,0.2400833333333333,0,3,0,120258,485352,5417,102539,4.4958316351106005,0.17441838708195906
4716,0.2401190476190476,1,3,1,120261,485349,5418,102538,4.495803846011338,0.1744178728224982
4717,0.2401666666666666,2,13,2,120274,485336,5420,102536,4.495683426581199,0.17441892112568722
4718,0.2401666666666667,0,4,0,120278,485332,5420,102536,4.4956463744488495,0.17442010791538237
4719,0.2401904761904761,0,1,0,120279,485331,5420,102536,4.495637111415762,0.17442040461532965
4720,0.2402380952380952,1,2,1,120281,485329,5421,102535,4.495618585349587,0.1744195936475103
4721,0.2402857142857143,0,1,0,120282,485328,5421,102535,4.4956093223165,0.17441989034860164
4722,0.2403095238095238,0,1,0,120283,485327,5421,102535,4.4956000592834116,0.17442018705070236
4723,0.2403333333333333,2,18,2,120301,485309,5423,102533,4.495433324687836,0.1744227190299434
4724,0.2403571428571428,0,2,0,120303,485307,5423,102533,4.495414798621661,0.17442331246597714
4725,0.2404047619047618,0,1,0,120304,485306,5423,102533,4.495405535588573,0.17442360918550828
4726,0.2404166666666666,0,5,0,120309,485301,5423,102533,4.495359220423135,0.174425092798307
4727,0.2404285714285714,0,5,0,120314,485296,5423,102533,4.4953129052576974,0.17442657643634457
4728,0.2404761904761904,0,1,0,120315,485295,5423,102533,4.49530364222461,0.17442687316698083
4729,0.2404761904761905,0,1,0,120316,485294,5423,102533,4.495294379191522,0.17442716989862664
4730,0.2404999999999999,0,3,0,120319,485291,5423,102533,4.4952665900922595,0.17442806009962167
4731,0.2405,0,7,0,120326,485284,5423,102533,4.495201748860647,0.17443013727061313
4732,0.2405238095238095,0,2,0,120328,485282,5423,102533,4.495183222794472,0.17443073075712598
4733,0.240547619047619,0,1,0,120329,485281,5423,102533,4.4951739597613845,0.17443102750189685
4734,0.2405555555555555,0,2,0,120331,485279,5423,102533,4.495155433695209,0.17443162099446763
4735,0.2405952380952381,0,1,0,120332,485278,5423,102533,4.495146170662122,0.1744319177422675
4736,0.2406190476190476,0,3,0,120335,485275,5423,102533,4.495118381562859,0.1744328079917252
4737,0.2406666666666666,6,39,6,120374,485236,5429,102527,4.494757123272445,0.1744359546279708
4738,0.2406666666666667,1,11,1,120385,485225,5430,102526,4.494655229908481,0.17443781465280364
4739,0.2406904761904762,1,0,1,120385,485225,5431,102525,4.494655229908481,0.1744364100382816
4740,0.2407142857142857,0,8,0,120393,485217,5431,102525,4.494581125643781,0.17443878436456814
4741,0.2407380952380952,0,1,0,120394,485216,5431,102525,4.494571862610694,0.17443908115989867
4742,0.2408116883116883,0,1,0,120395,485215,5431,102525,4.4945625995776055,0.17443937795623915
4743,0.2408333333333333,6,123,6,120518,485092,5437,102519,4.493423246507836,0.17446746231775784
4744,0.2408809523809524,0,1,0,120519,485091,5437,102519,4.493413983474749,0.17446775922805943
4745,0.2408888888888888,0,2,0,120521,485089,5437,102519,4.493395457408574,0.17446835305169434
4746,0.2409523809523809,0,3,0,120524,485086,5437,102519,4.493367668309311,0.17446924379472606
4747,0.2409848484848484,0,2,0,120526,485084,5437,102519,4.493349142243136,0.17446983762846685
4748,0.2409848484848485,0,1,0,120527,485083,5437,102519,4.4933398792100485,0.17447013454685315
4749,0.241,3,54,3,120581,485029,5440,102516,4.492839675423321,0.17448195457369223
4750,0.2410952380952381,1,0,1,120581,485029,5441,102515,4.492839675423321,0.17448054954182154
4751,0.2411428571428571,0,1,0,120582,485028,5441,102515,4.492830412390233,0.17448084650825557
4752,0.2411666666666666,1,10,1,120592,485018,5442,102514,4.492737782059358,0.1744824111707958
4753,0.2411666666666667,0,1,0,120593,485017,5442,102514,4.49272851902627,0.17448270814646377
4754,0.2411904761904762,0,6,0,120599,485011,5442,102514,4.492672940827744,0.17448449002170122
4755,0.2412142857142857,0,1,0,120600,485010,5442,102514,4.492663677794657,0.17448478700444578
4756,0.2412181152181152,1,4,1,120604,485006,5443,102513,4.492626625662307,0.1744845698607194
4757,0.24125,0,3,0,120607,485003,5443,102513,4.492598836563044,0.17448546082149252
4758,0.2413095238095238,0,2,0,120609,485001,5443,102513,4.492580310496869,0.17448605480039625
4759,0.2413333333333333,4,33,4,120642,484968,5447,102509,4.49227463040498,0.17449023536240568
4760,0.2413809523809523,0,1,0,120643,484967,5447,102509,4.492265367371893,0.17449053237919507
4761,0.2413809523809524,0,3,0,120646,484964,5447,102509,4.492237578272629,0.17449142343563023
4762,0.2414166666666666,0,1,0,120647,484963,5447,102509,4.492228315239542,0.1744917204564643
4763,0.2414166666666667,0,2,0,120649,484961,5447,102509,4.4922097891733666,0.174492314501166
4764,0.2414285714285714,0,5,0,120654,484956,5447,102509,4.4921634740079295,0.1744937996306163
4765,0.2415,3,16,3,120670,484940,5450,102506,4.492015265478528,0.17449433650071666
4766,0.2415238095238095,0,1,0,120671,484939,5450,102506,4.492006002445441,0.1744946335401612
4767,0.2415396825396825,0,1,0,120672,484938,5450,102506,4.491996739412353,0.17449493058061705
4768,0.241547619047619,1,3,1,120675,484935,5451,102505,4.49196895031309,0.1744944164510418
4769,0.2415476190476191,0,1,0,120676,484934,5451,102505,4.491959687280003,0.17449471349365636
4770,0.2415555555555555,0,1,0,120677,484933,5451,102505,4.491950424246915,0.17449501053728222
4771,0.2416428571428571,0,1,0,120678,484932,5451,102505,4.491941161213828,0.17449530758191942
4772,0.2416666666666666,19,351,19,121029,484581,5470,102486,4.488689836600097,0.174572919274972
4773,0.2416666666666667,0,1,0,121030,484580,5470,102486,4.488680573567009,0.17457321664003705
4774,0.2417142857142857,0,1,0,121031,484579,5470,102486,4.488671310533921,0.17457351400611518
4775,0.2417597402597402,0,1,0,121032,484578,5470,102486,4.488662047500834,0.17457381137320632
4776,0.2417857142857143,0,4,0,121036,484574,5470,102486,4.488624995368483,0.1745750008517017
4777,0.2418333333333333,1,18,1,121054,484556,5471,102485,4.488458260772908,0.17457894763738818
4778,0.241845238095238,0,1,0,121055,484555,5471,102485,4.48844899773982,0.17457924502589262
4779,0.2418452380952381,0,2,0,121057,484553,5471,102485,4.488430471673645,0.17457983980594102
4780,0.2418571428571428,0,1,0,121058,484552,5471,102485,4.488421208640557,0.174580137197485
4781,0.2418888888888889,0,1,0,121059,484551,5471,102485,4.48841194560747,0.1745804345900422
4782,0.2419047619047619,0,2,0,121061,484549,5471,102485,4.4883934195412944,0.17458102937819614
4783,0.2419285714285714,0,1,0,121062,484548,5471,102485,4.488384156508207,0.17458132677379296
4784,0.241968253968254,0,1,0,121063,484547,5471,102485,4.488374893475119,0.174581624170403
4785,0.2419761904761904,0,2,0,121065,484545,5471,102485,4.488356367408945,0.1745822189666627
4786,0.2419999999999999,0,1,0,121066,484544,5471,102485,4.4883471043758565,0.1745825163663124
4787,0.242,3,106,3,121172,484438,5474,102482,4.487365222868576,0.17460982757445648
4788,0.2420238095238095,0,2,0,121174,484436,5474,102482,4.487346696802401,0.17461042258032639
4789,0.2420454545454545,0,1,0,121175,484435,5474,102482,4.487337433769313,0.174610720084782
4790,0.242047619047619,0,2,0,121177,484433,5474,102482,4.487318907703139,0.1746113150967346
4791,0.2420833333333333,0,4,0,121181,484429,5474,102482,4.487281855570788,0.1746125051328055
4792,0.242095238095238,0,1,0,121182,484428,5474,102482,4.487272592537701,0.17461280264435775
4793,0.2421428571428571,0,4,0,121186,484424,5474,102482,4.48723554040535,0.17461399270070505
4794,0.2421666666666666,0,6,0,121192,484418,5474,102482,4.487179962206825,0.1746157778156415
4795,0.2421666666666667,1,7,1,121199,484411,5475,102481,4.487115120975212,0.17461645413466192
4796,0.2421944444444444,0,1,0,121200,484410,5475,102481,4.487105857942124,0.17461675166257448
4797,0.2422142857142857,0,2,0,121202,484408,5475,102481,4.48708733187595,0.17461734672144136
4798,0.2422222222222222,0,1,0,121203,484407,5475,102481,4.4870780688428615,0.17461764425239568
4799,0.2422857142857143,0,2,0,121205,484405,5475,102481,4.487059542776687,0.17461823931734613
4800,0.2423214285714285,0,1,0,121206,484404,5475,102481,4.487050279743599,0.17461853685134227
4801,0.2423333333333333,0,36,0,121242,484368,5475,102481,4.486716810552447,0.17462924875053037
4802,0.2423571428571428,0,1,0,121243,484367,5475,102481,4.48670754751936,0.17462954632204591
4803,0.2423809523809523,1,7,1,121250,484360,5476,102480,4.486642706287747,0.17463022288869198
4804,0.2423809523809524,0,1,0,121251,484359,5476,102480,4.486633443254659,0.17463052046643116
4805,0.2424285714285713,0,1,0,121252,484358,5476,102480,4.486624180221572,0.17463081804518454
4806,0.2424285714285714,0,1,0,121253,484357,5476,102480,4.486614917188485,0.17463111562495207
4807,0.2424999999999999,1,2,1,121255,484355,5477,102479,4.486596391122309,0.1746303043109295
4808,0.2425,23,327,23,121582,484028,5500,102456,4.483567379302679,0.17469530285566187
4809,0.2425595238095238,0,1,0,121583,484027,5500,102456,4.483558116269592,0.1746956007249997
4810,0.2425714285714286,0,2,0,121585,484025,5500,102456,4.483539590203416,0.17469619646672271
4811,0.2426190476190476,0,4,0,121589,484021,5500,102456,4.483502538071066,0.17469738796235829
4812,0.2426428571428571,0,2,0,121591,484019,5500,102456,4.483484012004891,0.17469798371627093
4813,0.2426666666666666,3,20,3,121611,483999,5503,102453,4.48329875134314,0.17469971967015202
4814,0.2426666666666667,1,15,1,121626,483984,5504,102452,4.483159805846826,0.17470278086611327
4815,0.2426984126984127,1,0,1,121626,483984,5505,102451,4.483159805846826,0.17470137355376128
4816,0.2427777777777778,0,1,0,121627,483983,5505,102451,4.483150542813739,0.17470167145833973
4817,0.2427857142857142,0,1,0,121628,483982,5505,102451,4.483141279780652,0.17470196936393415
4818,0.2428095238095237,0,1,0,121629,483981,5505,102451,4.483132016747564,0.17470226727054458
4819,0.2428095238095238,0,1,0,121630,483980,5505,102451,4.483122753714476,0.174702565178171
4820,0.2428333333333333,2,12,2,121642,483968,5507,102449,4.483011597317426,0.17470332544929632
4821,0.2428571428571428,1,9,1,121651,483959,5508,102448,4.482928230019637,0.17470459936528726
4822,0.2428975468975468,0,5,0,121656,483954,5508,102448,4.4828819148542,0.17470608899696796
4823,0.2429166666666666,0,3,0,121659,483951,5508,102448,4.482854125754937,0.17470698278816982
4824,0.2429404761904762,0,1,0,121660,483950,5508,102448,4.48284486272185,0.17470728072060274
4825,0.2429761904761904,0,4,0,121664,483946,5508,102448,4.4828078105895,0.17470847246049584
4826,0.243,2,50,2,121714,483896,5510,102446,4.482344658935122,0.1747205555801904
4827,0.2430238095238095,0,1,0,121715,483895,5510,102446,4.482335395902034,0.17472085356473452
4828,0.243047619047619,0,2,0,121717,483893,5510,102446,4.482316869835859,0.17472144953687202
4829,0.2430952380952381,0,4,0,121721,483889,5510,102446,4.482279817703509,0.17472264149334424
4830,0.2431190476190476,0,3,0,121724,483886,5510,102446,4.482252028604246,0.17472353547137118
4831,0.2431666666666666,1,15,1,121739,483871,5511,102445,4.482113083107933,0.17472659794377093
4832,0.2431666666666667,0,2,0,121741,483869,5511,102445,4.482094557041758,0.17472719396091513
4833,0.24325,0,1,0,121742,483868,5511,102445,4.48208529400867,0.17472749197101206
4834,0.2432857142857142,0,1,0,121743,483867,5511,102445,4.482076030975582,0.17472778998212557
4835,0.2432857142857143,0,1,0,121744,483866,5511,102445,4.482066767942495,0.1747280879942556
4836,0.2433095238095238,0,1,0,121745,483865,5511,102445,4.482057504909408,0.17472838600740223
4837,0.2433333333333333,55,680,55,122425,483185,5566,102390,4.475758642409871,0.1748537762028775
4838,0.2433571428571428,0,4,0,122429,483181,5566,102390,4.47572159027752,0.174854970618422
4839,0.2433809523809523,0,1,0,122430,483180,5566,102390,4.475712327244433,0.17485526922485783
4840,0.2434285714285714,0,1,0,122431,483179,5566,102390,4.475703064211346,0.17485556783231354
4841,0.2434404761904761,1,1,1,122432,483178,5567,102389,4.475693801178258,0.17485445730377566
4842,0.2434523809523809,1,4,1,122436,483174,5568,102388,4.475656749045908,0.1748542425908785
4843,0.2434761904761904,0,1,0,122437,483173,5568,102388,4.47564748601282,0.17485454120066057
4844,0.2434999999999999,0,6,0,122443,483167,5568,102388,4.4755919078142945,0.17485633288077124
4845,0.2435,3,27,3,122470,483140,5571,102385,4.475341805920931,0.17486016822509715
4846,0.2435714285714285,0,1,0,122471,483139,5571,102385,4.475332542887843,0.17486046686386894
4847,0.2436111111111111,0,1,0,122472,483138,5571,102385,4.475323279854756,0.17486076550366084
4848,0.2436190476190476,0,1,0,122473,483137,5571,102385,4.4753140168216685,0.1748610641444728
4849,0.2436309523809523,0,1,0,122474,483136,5571,102385,4.47530475378858,0.17486136278630485
4850,0.2436666666666666,3,14,3,122488,483122,5574,102382,4.475175071325355,0.17486131606274252
4851,0.2436666666666667,0,1,0,122489,483121,5574,102382,4.475165808292267,0.17486161471418593
4852,0.2436904761904761,0,2,0,122491,483119,5574,102382,4.475147282226092,0.1748622120201332
4853,0.2436904761904762,0,3,0,122494,483116,5574,102382,4.475119493126829,0.17486310798670535
4854,0.24375,0,4,0,122498,483112,5574,102382,4.47508244099448,0.17486430262308408
4855,0.2438095238095237,0,1,0,122499,483111,5574,102382,4.4750731779613915,0.17486460128472928
4856,0.2438095238095238,0,2,0,122501,483109,5574,102382,4.475054651895217,0.17486519861108027
4857,0.2438333333333333,0,9,0,122510,483100,5574,102382,4.474971284597428,0.17486788663016115
4858,0.2438410364145658,0,1,0,122511,483099,5574,102382,4.474962021564341,0.17486818530404916
4859,0.2438571428571428,0,1,0,122512,483098,5574,102382,4.474952758531254,0.17486848397895743
4860,0.2438690476190476,1,0,1,122512,483098,5575,102381,4.474952758531254,0.17486707465169546
4861,0.2439285714285714,0,1,0,122513,483097,5575,102381,4.474943495498166,0.17486737332572702
4862,0.2439761904761904,0,1,0,122514,483096,5575,102381,4.4749342324650785,0.17486767200077885
4863,0.2439999999999999,0,1,0,122515,483095,5575,102381,4.474924969431991,0.17486797067685098
4864,0.244,9,135,9,122650,482960,5584,102372,4.473674459965171,0.17489561479638907
4865,0.2440079365079364,0,3,0,122653,482957,5584,102372,4.473646670865908,0.17489651119285052
4866,0.244047619047619,1,2,1,122655,482955,5585,102371,4.473628144799733,0.1748956991488504
4867,0.2440833333333333,0,2,0,122657,482953,5585,102371,4.473609618733558,0.17489629675188442
4868,0.2441190476190476,0,1,0,122658,482952,5585,102371,4.47360035570047,0.17489659555493292
4869,0.2441237373737373,0,1,0,122659,482951,5585,102371,4.473591092667383,0.1748968943590024
4870,0.2441666666666666,6,117,6,122776,482834,5591,102365,4.472507317796139,0.1749234021247473
4871,0.2441666666666667,0,1,0,122777,482833,5591,102365,4.472498054763052,0.1749237010379393
4872,0.2442142857142857,0,1,0,122778,482832,5591,102365,4.4724887917299645,0.17492399995215285
4873,0.24425,0,2,0,122780,482830,5591,102365,4.472470265663789,0.17492459778364478
4874,0.2442619047619047,0,3,0,122783,482827,5591,102365,4.4724424765645265,0.1749254945385446
4875,0.2442857142857142,0,5,0,122788,482822,5591,102365,4.472396161399089,0.1749269891504767
4876,0.2442857142857143,0,2,0,122790,482820,5591,102365,4.472377635332913,0.17492758700240096
4877,0.2442948717948718,0,1,0,122791,482819,5591,102365,4.472368372299826,0.17492788592989555
4878,0.2443333333333333,1,33,1,122824,482786,5592,102364,4.4720626922079365,0.17493634110911732
4879,0.244340909090909,0,1,0,122825,482785,5592,102364,4.472053429174849,0.1749366400694524
4880,0.2443492063492063,0,1,0,122826,482784,5592,102364,4.472044166141761,0.1749369390308093
4881,0.2443571428571428,0,1,0,122827,482783,5592,102364,4.472034903108674,0.17493723799318803
4882,0.2443650793650793,0,2,0,122829,482781,5592,102364,4.4720163770424985,0.17493783592101103
4883,0.2443809523809524,0,2,0,122831,482779,5592,102364,4.471997850976324,0.17493843385292143
4884,0.2443948412698412,0,1,0,122832,482778,5592,102364,4.471988587943236,0.1749387328204094
4885,0.2444047619047619,0,1,0,122833,482777,5592,102364,4.471979324910149,0.17493903178891926
4886,0.2444444444444444,0,1,0,122834,482776,5592,102364,4.471970061877061,0.17493933075845097
4887,0.2445,0,14,0,122848,482762,5592,102364,4.471840379413835,0.17494351643919429
4888,0.2445238095238094,0,1,0,122849,482761,5592,102364,4.471831116380748,0.17494381542405468
4889,0.2445238095238095,0,6,0,122855,482755,5592,102364,4.471775538182222,0.1749456093546783
4890,0.2445714285714285,0,1,0,122856,482754,5592,102364,4.471766275149135,0.17494590834669246
4891,0.2445833333333333,0,1,0,122857,482753,5592,102364,4.471757012116047,0.17494620733972863
4892,0.2446428571428571,0,6,0,122863,482747,5592,102364,4.471701433917522,0.17494800131940777
4893,0.2446666666666666,0,9,0,122872,482738,5592,102364,4.471618066619734,0.17495069235791366
4894,0.2446666666666667,1,16,1,122888,482722,5593,102363,4.471469858090333,0.17495406650315767
4895,0.2447142857142857,0,5,0,122893,482717,5593,102363,4.471423542924895,0.17495556163259726
4896,0.2447619047619047,1,4,1,122897,482713,5594,102362,4.471386490792545,0.17495534760500792
4897,0.2447857142857142,0,1,0,122898,482712,5594,102362,4.471377227759458,0.174955646636152
4898,0.2448095238095238,0,2,0,122900,482710,5594,102362,4.4713587016932825,0.17495624470150684
4899,0.2448333333333333,2,25,2,122925,482685,5596,102360,4.471127125866094,0.1749609004435556
4900,0.2448571428571428,0,1,0,122926,482684,5596,102360,4.471117862833006,0.17496119949952482
4901,0.2448809523809523,0,1,0,122927,482683,5596,102360,4.471108599799918,0.17496149855651635
4902,0.2448939393939394,0,4,0,122931,482679,5596,102360,4.471071547667568,0.174962694794706
4903,0.2448968253968253,0,1,0,122932,482678,5596,102360,4.47106228463448,0.1749629938568093
4904,0.2449036796536796,1,5,1,122937,482673,5597,102359,4.471015969469043,0.1749630789426903
4905,0.2449206349206349,0,1,0,122938,482672,5597,102359,4.471006706435955,0.1749633780090286
4906,0.2449404761904761,0,2,0,122940,482670,5597,102359,4.470988180369781,0.1749639761447723
4907,0.2449999999999999,2,26,2,122966,482644,5599,102357,4.470747341509504,0.17496893167703986
4908,0.245,79,1162,79,124128,481482,5678,102278,4.459983697061766,0.17520556393038234
4909,0.2450238095238095,0,3,0,124131,481479,5678,102278,4.459955907962503,0.17520646433361828
4910,0.2450595238095237,1,2,1,124133,481477,5679,102277,4.459937381896328,0.17520565169574856
4911,0.2450952380952381,0,2,0,124135,481475,5679,102277,4.4599188558301535,0.17520625197001466
4912,0.245111111111111,0,1,0,124136,481474,5679,102277,4.459909592797065,0.17520655210869018
4913,0.2451190476190476,0,2,0,124138,481472,5679,102277,4.45989106673089,0.17520715238912615
4914,0.2451666666666666,0,7,0,124145,481465,5679,102277,4.4598262254992775,0.1752092534030445
4915,0.2451666666666667,1,8,1,124153,481457,5680,102276,4.459752121234577,0.17521024166870813
4916,0.2452380952380952,2,1,2,124154,481456,5682,102274,4.45974285820149,0.17520771589604783
4917,0.2452857142857143,0,1,0,124155,481455,5682,102274,4.459733595168402,0.17520801604854308
4918,0.2453095238095237,0,2,0,124157,481453,5682,102274,4.459715069102227,0.17520861635661877
4919,0.2453333333333333,2,20,2,124177,481433,5684,102272,4.459529808440475,0.1752117936286309
4920,0.2453571428571428,0,3,0,124180,481430,5684,102272,4.459502019341213,0.1752126941487266
4921,0.2454166666666666,0,2,0,124182,481428,5684,102272,4.459483493275038,0.17521329450059964
4922,0.2454285714285714,0,2,0,124184,481426,5684,102272,4.459464967208863,0.1752138948565868
4923,0.2454523809523809,0,1,0,124185,481425,5684,102272,4.459455704175776,0.1752141950361232
4924,0.2454761904761905,0,1,0,124186,481424,5684,102272,4.4594464411426875,0.17521449521668814
4925,0.2454999999999999,0,4,0,124190,481420,5684,102272,4.459409389010338,0.1752156959492335
4926,0.2455,1,12,1,124202,481408,5685,102271,4.459298232613287,0.17521788517318596
4927,0.2455079365079365,0,2,0,124204,481406,5685,102271,4.459279706547112,0.17521848556650338
4928,0.2455238095238095,0,1,0,124205,481405,5685,102271,4.459270443514024,0.17521878576470507
4929,0.2455357142857142,1,0,1,124205,481405,5686,102270,4.459270443514024,0.175217372681715
4930,0.2455714285714285,0,3,0,124208,481402,5686,102270,4.459242654414761,0.1752182732767719
4931,0.2455952380952381,0,1,0,124209,481401,5686,102270,4.459233391381674,0.1752185734771815
4932,0.2456666666666666,2,18,2,124227,481383,5688,102268,4.459066656786098,0.17522115099605756
4933,0.2456666666666667,1,2,1,124229,481381,5689,102267,4.459048130719923,0.17522033828609024
4934,0.2456746031746031,0,1,0,124230,481380,5689,102267,4.459038867686836,0.17522063850238243
4935,0.2457063492063492,0,2,0,124232,481378,5689,102267,4.45902034162066,0.1752212389380531
4936,0.2457142857142857,0,17,0,124249,481361,5689,102267,4.458862870058172,0.1752263428074047
4937,0.2457272727272727,1,0,1,124249,481361,5690,102266,4.458862870058172,0.17522492962114503
4938,0.2457424242424243,0,1,0,124250,481360,5690,102266,4.458853607025084,0.17522522985610647
4939,0.24575,0,1,0,124251,481359,5690,102266,4.458844343991997,0.17522553009209682
4940,0.2457857142857142,0,1,0,124252,481358,5690,102266,4.4588350809589095,0.175225830329116
4941,0.2458095238095238,0,2,0,124254,481356,5690,102266,4.458816554892734,0.17522643080624103
4942,0.2458333333333333,10,118,10,124372,481238,5700,102256,4.457723516988403,0.17524773176759315
4943,0.2458333333333334,0,2,0,124374,481236,5700,102256,4.4577049909222275,0.17524833245357263
4944,0.2458571428571428,0,1,0,124375,481235,5700,102256,4.45769572788914,0.17524863279810657
4945,0.2459285714285713,0,1,0,124376,481234,5700,102256,4.457686464856052,0.17524893314367
4946,0.2459523809523809,1,7,1,124383,481227,5701,102255,4.45762162362444,0.17524962209631145
4947,0.2459999999999999,3,14,3,124397,481213,5704,102252,4.457491941161214,0.17524958652189934
4948,0.246,4,110,4,124507,481103,5708,102248,4.456473007521583,0.17527697732582956
4949,0.246095238095238,0,1,0,124508,481102,5708,102248,4.456463744488495,0.1752772777920631
4950,0.2461190476190476,0,1,0,124509,481101,5708,102248,4.456454481455408,0.17527757825932674
4951,0.2461428571428571,0,2,0,124511,481099,5708,102248,4.4564359553892325,0.17527817919694452
4952,0.2461666666666666,1,8,1,124519,481091,5709,102247,4.456361851124532,0.17527916919521785
4953,0.2461666666666667,0,2,0,124521,481089,5709,102247,4.4563433250583575,0.17527977014962218
4954,0.2461904761904761,0,1,0,124522,481088,5709,102247,4.456334062025269,0.17528007062836964
4955,0.2461904761904762,0,2,0,124524,481086,5709,102247,4.456315535959094,0.1752806715889552
4956,0.2462121212121212,0,1,0,124525,481085,5709,102247,4.456306272926007,0.1752809720707933
4957,0.2462222222222222,0,1,0,124526,481084,5709,102247,4.4562970098929195,0.17528127255366163
4958,0.24625,0,4,0,124530,481080,5709,102247,4.456259957760569,0.17528247449543738
4959,0.2462857142857142,1,0,1,124530,481080,5710,102246,4.456259957760569,0.17528106067619137
4960,0.2462857142857143,0,1,0,124531,481079,5710,102246,4.456250694727482,0.1752813611623023
4961,0.2463095238095238,0,2,0,124533,481077,5710,102246,4.456232168661306,0.17528196213761502
4962,0.2463333333333333,1,20,1,124553,481057,5711,102245,4.456046907999555,0.17528655824941455
4963,0.2464285714285714,0,4,0,124557,481053,5711,102245,4.456009855867205,0.17528776028719453
4964,0.2464444444444444,0,1,0,124558,481052,5711,102245,4.456000592834117,0.1752880607992155
4965,0.2464523809523809,0,1,0,124559,481051,5711,102245,4.45599132980103,0.17528836131226685
4966,0.2464657287157287,0,1,0,124560,481050,5711,102245,4.455982066767943,0.17528866182634859
4967,0.2465,3,30,3,124590,481020,5714,102242,4.455704175775316,0.17529343588301655
4968,0.2465238095238094,0,1,0,124591,481019,5714,102242,4.455694912742229,0.1752937364233165
4969,0.246547619047619,0,1,0,124592,481018,5714,102242,4.455685649709141,0.175294036964647
4970,0.2466666666666666,37,668,37,125260,480350,5751,102205,4.449497943606654,0.17544266206624268
4971,0.2466666666666667,0,4,0,125264,480346,5751,102205,4.449460891474304,0.1754438667172488
4972,0.2467142857142857,0,3,0,125267,480343,5751,102205,4.449433102375042,0.17544477021635985
4973,0.2467857142857142,0,3,0,125270,480340,5751,102205,4.449405313275779,0.17544567372477662
4974,0.2467857142857143,0,1,0,125271,480339,5751,102205,4.449396050242691,0.17544597489631686
4975,0.2467867965367965,0,1,0,125272,480338,5751,102205,4.449386787209604,0.17544627606889104
4976,0.2468333333333333,1,16,1,125288,480322,5752,102204,4.449238578680203,0.17544967949928414
4977,0.2469047619047619,0,1,0,125289,480321,5752,102204,4.449229315647115,0.17544998068752415
4978,0.247,6,52,6,125341,480269,5758,102198,4.448747637926562,0.17545715036216644
4979,0.2470238095238094,0,1,0,125342,480268,5758,102198,4.448738374893475,0.1754574515937411
4980,0.2470238095238095,1,1,1,125343,480267,5759,102197,4.448729111860388,0.1754563372156906
4981,0.2470833333333333,0,1,0,125344,480266,5759,102197,4.4487198488273,0.17545663844742068
4982,0.2471190476190476,0,1,0,125345,480265,5759,102197,4.448710585794212,0.17545693968018514
4983,0.2471363636363636,1,0,1,125345,480265,5760,102196,4.448710585794212,0.17545552406083842
4984,0.2471428571428571,2,7,2,125352,480258,5762,102194,4.4486457445626,0.1754548014256969
4985,0.2471666666666666,1,9,1,125361,480249,5763,102193,4.448562377264811,0.1754560969160878
4986,0.2472222222222222,0,1,0,125362,480248,5763,102193,4.448553114231724,0.17545639815878347
4987,0.24725,0,1,0,125363,480247,5763,102193,4.448543851198637,0.17545669940251357
4988,0.2473333333333333,2,42,2,125405,480205,5765,102191,4.44815480380896,0.17546652106127103
4989,0.2473571428571428,0,1,0,125406,480204,5765,102191,4.448145540775871,0.17546682234565888
4990,0.2473809523809523,0,3,0,125409,480201,5765,102191,4.448117751676609,0.1754677262050303
4991,0.2474166666666667,0,1,0,125410,480200,5765,102191,4.448108488643522,0.17546802749355672
4992,0.2474285714285714,0,1,0,125411,480199,5765,102191,4.4480992256104335,0.17546832878311786
4993,0.2474444444444444,0,2,0,125413,480197,5765,102191,4.448080699544259,0.17546893136534406
4994,0.2474523809523809,0,2,0,125415,480195,5765,102191,4.448062173478084,0.175469533951709
4995,0.2474999999999999,1,14,1,125429,480181,5766,102190,4.447932491014858,0.1754723363629027
4996,0.2475,19,339,19,125768,479842,5785,102171,4.444792322798177,0.1755476252248661
4997,0.2475093795093794,0,2,0,125770,479840,5785,102171,4.444773796732002,0.17554822846990864
4998,0.2475515873015873,0,1,0,125771,479839,5785,102171,4.4447645336989146,0.17554853009398463
4999,0.2475555555555555,0,2,0,125773,479837,5785,102171,4.444746007632739,0.1755491333452461
5000,0.2475793650793651,0,2,0,125775,479835,5785,102171,4.444727481566564,0.1755497366006536
5001,0.2475833333333333,0,1,0,125776,479834,5785,102171,4.444718218533477,0.1755500382299121
5002,0.2476190476190476,1,4,1,125780,479830,5786,102170,4.444681166401127,0.17554982817869416
5003,0.2476666666666666,1,17,1,125797,479813,5787,102169,4.444523694838638,0.17555353945654675
5004,0.2476666666666667,1,13,1,125810,479800,5788,102168,4.4444032754085,0.17555604431858796
5005,0.2477142857142857,0,1,0,125811,479799,5788,102168,4.444394012375412,0.1755563459783802
5006,0.2477222222222222,0,3,0,125814,479796,5788,102168,4.444366223276149,0.17555725096397715
5007,0.24775,0,2,0,125816,479794,5788,102168,4.444347697209975,0.17555785429289197
5008,0.2477619047619047,0,1,0,125817,479793,5788,102168,4.444338434176887,0.17555815595890445
5009,0.2477777777777778,1,2,1,125819,479791,5789,102167,4.444319908110712,0.17555734262610018
5010,0.2478095238095238,0,2,0,125821,479789,5789,102167,4.444301382044537,0.17555794596155036
5011,0.2478333333333333,0,15,0,125836,479774,5789,102167,4.444162436548224,0.1755624711096142
5012,0.2478571428571428,1,9,1,125845,479765,5790,102166,4.444079069250435,0.17556376958780337
5013,0.2478571428571429,0,1,0,125846,479764,5790,102166,4.444069806217348,0.17556407128005086
5014,0.2479166666666666,0,1,0,125847,479763,5790,102166,4.444060543184261,0.17556437297333524
5015,0.2479365079365079,1,0,1,125847,479763,5791,102165,4.444060543184261,0.17556295624200932
5016,0.2479999999999999,0,4,0,125851,479759,5791,102165,4.44402349105191,0.17556416301785113
5017,0.248,7,79,7,125930,479680,5798,102158,4.443291711437993,0.17557808187158624
5018,0.2480555555555555,0,2,0,125932,479678,5798,102158,4.443273185371818,0.17557868540275953
5019,0.2480952380952381,0,4,0,125936,479674,5798,102158,4.443236133239468,0.17557989247755365
5020,0.2481111111111111,0,1,0,125937,479673,5798,102158,4.44322687020638,0.17558019424884547
5021,0.2481349206349206,0,1,0,125938,479672,5798,102158,4.443217607173293,0.17558049602117456
5022,0.2481428571428571,0,1,0,125939,479671,5798,102158,4.4432083441402055,0.175580797794541
5023,0.2481666666666666,1,16,1,125955,479655,5799,102157,4.443060135610804,0.17558420933222416
5024,0.2481666666666667,0,2,0,125957,479653,5799,102157,4.443041609544629,0.17558481291143158
5025,0.2481904761904761,0,2,0,125959,479651,5799,102157,4.4430230834784545,0.17558541649478865
5026,0.2482142857142857,0,2,0,125961,479649,5799,102157,4.443004557412279,0.17558602008229549
5027,0.24825,0,1,0,125962,479648,5799,102157,4.442995294379192,0.17558632187760503
5028,0.2483333333333333,25,327,25,126289,479321,5824,102132,4.439966282559562,0.17564962258342462
5029,0.2483571428571428,0,1,0,126290,479320,5824,102132,4.4399570195264735,0.17564992467134002
5030,0.2483809523809524,0,1,0,126291,479319,5824,102132,4.439947756493386,0.17565022676029451
5031,0.2483928571428571,0,1,0,126292,479318,5824,102132,4.439938493460299,0.17565052885028806
5032,0.2484523809523809,0,2,0,126294,479316,5824,102132,4.439919967394124,0.1756511330333925
5033,0.2484999999999999,0,4,0,126298,479312,5824,102132,4.439882915261773,0.17565234141207064
5034,0.2485,1,20,1,126318,479292,5825,102131,4.439697654600022,0.1756569657547087
5035,0.2485238095238095,0,1,0,126319,479291,5825,102131,4.439688391566935,0.1756572678708408
5036,0.2485714285714285,0,4,0,126323,479287,5825,102131,4.439651339434585,0.17565847634576157
5037,0.2485714285714286,0,1,0,126324,479286,5825,102131,4.439642076401497,0.17565877846708988
5038,0.2486666666666666,3,27,3,126351,479259,5828,102128,4.4393919745081325,0.17566268251612094
5039,0.2486666666666667,0,1,0,126352,479258,5828,102128,4.439382711475045,0.17566298466079336
5040,0.2486904761904762,0,3,0,126355,479255,5828,102128,4.439354922375783,0.175663891101047
5041,0.2487142857142857,0,2,0,126357,479253,5828,102128,4.439336396309607,0.17566449539974646
5042,0.24875,1,11,1,126368,479242,5829,102127,4.439234502945644,0.17566640120130245
5043,0.2487619047619047,0,1,0,126369,479241,5829,102127,4.439225239912557,0.17566670336172613
5044,0.2487857142857142,0,3,0,126372,479238,5829,102127,4.439197450813294,0.17566760984923413
5045,0.2488095238095238,0,2,0,126374,479236,5829,102127,4.439178924747119,0.17566821417943695
5046,0.2488333333333333,1,7,1,126381,479229,5830,102126,4.4391140835155065,0.17566891142245272
5047,0.2488571428571428,0,1,0,126382,479228,5830,102126,4.439104820482418,0.17566921359447085
5048,0.2488888888888888,0,1,0,126383,479227,5830,102126,4.439095557449331,0.1756695157675285
5049,0.2489166666666666,0,1,0,126384,479226,5830,102126,4.439086294416244,0.17566981794162573
5050,0.2489166666666667,0,1,0,126385,479225,5830,102126,4.439077031383156,0.1756701201167625
5051,0.2489230769230769,0,1,0,126386,479224,5830,102126,4.4390677683500686,0.17567042229293886
5052,0.2489444444444444,0,3,0,126389,479221,5830,102126,4.439039979250806,0.1756713288277053
5053,0.2489523809523809,0,1,0,126390,479220,5830,102126,4.439030716217719,0.17567163100803995
5054,0.249,7,69,7,126459,479151,5837,102119,4.438391566934677,0.17568255715932354
5055,0.249047619047619,0,4,0,126463,479147,5837,102119,4.4383545148023265,0.17568376612428732
5056,0.2490555555555555,0,2,0,126465,479145,5837,102119,4.438335988736152,0.1756843706130089
5057,0.2490833333333333,0,1,0,126466,479144,5837,102119,4.438326725703064,0.1756846728589296
5058,0.2490952380952381,0,2,0,126468,479142,5837,102119,4.438308199636889,0.17568527735389095
5059,0.2491428571428571,0,2,0,126470,479140,5837,102119,4.438289673570714,0.17568588185301218
5060,0.2491666666666666,8,113,8,126583,479027,5845,102111,4.437242950831821,0.17570869569706335
5061,0.2491666666666667,0,3,0,126586,479024,5845,102111,4.437215161732558,0.175709602760116
5062,0.24925,0,1,0,126587,479023,5845,102111,4.43720589869947,0.175709905116548
5063,0.2492857142857142,0,4,0,126591,479019,5845,102111,4.43716884656712,0.17571111455268185
5064,0.2492857142857143,0,5,0,126596,479014,5845,102111,4.437122531401682,0.17571262637126264
5065,0.2493333333333333,2,59,2,126655,478955,5847,102109,4.436576012449517,0.17572763069128358
5066,0.2493571428571428,0,3,0,126658,478952,5847,102109,4.436548223350254,0.17572853796761442
5067,0.2493809523809523,0,3,0,126661,478949,5847,102109,4.436520434250991,0.17572944525331377
5068,0.2494047619047619,1,0,1,126661,478949,5848,102108,4.436520434250991,0.17572802668240808
5069,0.2494166666666666,0,1,0,126662,478948,5848,102108,4.436511171217903,0.1757283291111356
5070,0.2494285714285714,0,2,0,126664,478946,5848,102108,4.436492645151729,0.17572893397171346
5071,0.2494444444444444,1,4,1,126668,478942,5849,102107,4.436455593019378,0.17572872511612617
5072,0.2494999999999999,0,1,0,126669,478941,5849,102107,4.436446329986291,0.1757290275502196
5073,0.2495,2,21,2,126690,478920,5851,102105,4.436251806291452,0.1757325416290177
5074,0.2495238095238095,0,3,0,126693,478917,5851,102105,4.436224017192189,0.17573344899160445
5075,0.249547619047619,0,1,0,126694,478916,5851,102105,4.436214754159102,0.17573375144788225
5076,0.2495555555555555,0,1,0,126695,478915,5851,102105,4.436205491126015,0.1757340539052012
5077,0.2495833333333333,1,2,1,126697,478913,5852,102104,4.436186965059839,0.17573324016336872
5078,0.2495844155844155,0,1,0,126698,478912,5852,102104,4.436177702026751,0.17573354262188992
5079,0.2496190476190476,0,1,0,126699,478911,5852,102104,4.436168438993664,0.1757338450814523
5080,0.2496428571428571,0,5,0,126704,478906,5852,102104,4.436122123828226,0.17573535739488133
5081,0.2496666666666666,3,20,3,126724,478886,5855,102101,4.435936863166475,0.17573715074519738
5082,0.2496785714285714,0,1,0,126725,478885,5855,102101,4.435927600133388,0.1757374532260674
5083,0.2497619047619047,0,2,0,126727,478883,5855,102101,4.4359090740672125,0.17573805819093125
5084,0.2498214285714285,0,1,0,126728,478882,5855,102101,4.435899811034125,0.17573836067492507
5085,0.2498333333333333,1,16,1,126744,478866,5856,102100,4.435751602504724,0.17574178179101704
5086,0.2498809523809523,0,2,0,126746,478864,5856,102100,4.435733076438549,0.17574238679160842
5087,0.2498809523809524,1,1,1,126747,478863,5857,102099,4.4357238134054615,0.17574127051338986
5088,0.2499523809523809,0,2,0,126749,478861,5857,102099,4.435705287339286,0.17574187551638668
5089,0.2499999999999999,3,28,3,126777,478833,5860,102096,4.435445922412835,0.17574608945327225
5090,0.25,208,3570,208,130347,475263,6068,101888,4.402376894290266,0.17653612312895586
5091,0.2500043859649122,0,1,0,130348,475262,6068,101888,4.402367631257179,0.17653642900459152
5092,0.2500555555555556,2,1,2,130349,475261,6070,101886,4.402358368224092,0.17653388131619846
5093,0.2500606060606061,0,1,0,130350,475260,6070,101886,4.4023491051910035,0.17653418719006975
5094,0.2500714285714286,0,2,0,130352,475258,6070,101886,4.402330579124829,0.1765347989409922
5095,0.2501190476190476,0,2,0,130354,475256,6070,101886,4.402312053058654,0.1765354106961545
5096,0.2501428571428571,0,2,0,130356,475254,6070,101886,4.402293526992478,0.17653602245555672
5097,0.2501666666666666,0,3,0,130359,475251,6070,101886,4.402265737893216,0.17653694010260995
5098,0.2501666666666667,1,7,1,130366,475244,6071,101885,4.402200896661603,0.17653765449318956
5099,0.2501904761904762,0,1,0,130367,475243,6071,101885,4.402191633628515,0.17653796038313857
5100,0.2502222222222222,0,1,0,130368,475242,6071,101885,4.402182370595428,0.17653826627414762
5101,0.2502380952380952,0,3,0,130371,475239,6071,101885,4.402154581496165,0.17653918395353513
5102,0.2502420634920634,0,1,0,130372,475238,6071,101885,4.402145318463077,0.1765394898487844
5103,0.25025,0,1,0,130373,475237,6071,101885,4.40213605542999,0.17653979574509376
5104,0.2502698412698412,0,1,0,130374,475236,6071,101885,4.402126792396903,0.1765401016424632
5105,0.250297619047619,0,1,0,130375,475235,6071,101885,4.402117529363815,0.1765404075408927
5106,0.2503333333333333,2,20,2,130395,475215,6073,101883,4.401932268702064,0.17654367195866214
5107,0.2503333333333334,0,1,0,130396,475214,6073,101883,4.401923005668976,0.1765439778754698
5108,0.2503571428571428,0,2,0,130398,475212,6073,101883,4.401904479602801,0.17654458971226575
5109,0.2504444444444444,0,1,0,130399,475211,6073,101883,4.401895216569714,0.176544895632254
5110,0.2504761904761904,0,1,0,130400,475210,6073,101883,4.401885953536626,0.1765452015533025
5111,0.2504761904761905,0,1,0,130401,475209,6073,101883,4.4018766905035385,0.1765455074754112
5112,0.2504999999999999,0,1,0,130402,475208,6073,101883,4.401867427470451,0.1765458133985801
5113,0.2505,0,17,0,130419,475191,6073,101883,4.401709955907963,0.17655101425467098
5114,0.250547619047619,1,0,1,130419,475191,6074,101882,4.401709955907963,0.17654958731391002
5115,0.2505555555555556,1,0,1,130419,475191,6075,101881,4.401709955907963,0.17654816036820362
5116,0.2505952380952381,0,1,0,130420,475190,6075,101881,4.401700692874875,0.17654846630657234
5117,0.2506190476190476,0,2,0,130422,475188,6075,101881,4.4016821668087,0.1765490781864907
5118,0.2506428571428571,0,1,0,130423,475187,6075,101881,4.401672903775612,0.17654938412804036
5119,0.2506666666666666,2,37,2,130460,475150,6077,101879,4.401330171551373,0.1765578506452882
5120,0.2507142857142856,0,2,0,130462,475148,6077,101879,4.4013116454851975,0.1765584626022699
5121,0.2507142857142857,1,2,1,130464,475146,6078,101878,4.401293119419022,0.17655764751552794
5122,0.25075,0,2,0,130466,475144,6078,101878,4.401274593352848,0.17655825947710832
5123,0.2507619047619047,0,2,0,130468,475142,6078,101878,4.401256067286672,0.17655887144293092
5124,0.2508333333333333,7,124,7,130592,475018,6085,101871,4.400107451183816,0.1765868303954487
5125,0.2508571428571428,0,3,0,130595,475015,6085,101871,4.400079662084553,0.1765877487059835
5126,0.2509166666666667,0,1,0,130596,475014,6085,101871,4.400070399051465,0.17658805481161757
5127,0.2509523809523809,0,5,0,130601,475009,6085,101871,4.400024083886028,0.17658958535570657
5128,0.250952380952381,0,1,0,130602,475008,6085,101871,4.40001482085294,0.17658989146770812
5129,0.2509880952380952,0,1,0,130603,475007,6085,101871,4.400005557819853,0.176590197580771
5130,0.2509999999999999,0,1,0,130604,475006,6085,101871,4.399996294786765,0.1765905036948951
5131,0.251,2,64,2,130668,474942,6087,101869,4.399403460669162,0.17660724223359126
5132,0.2510119047619047,0,2,0,130670,474940,6087,101869,4.3993849346029865,0.17660785459311487
5133,0.2510714285714285,1,2,1,130672,474938,6088,101868,4.399366408536811,0.17660703945520678
5134,0.2510833333333333,0,4,0,130676,474934,6088,101868,4.399329356404461,0.17660826418771086
5135,0.2511666666666666,2,15,2,130691,474919,6090,101866,4.399190410908147,0.17661000199381052
5136,0.2511666666666667,0,1,0,130692,474918,6090,101866,4.39918114787506,0.17661030819162807
5137,0.2511904761904762,0,2,0,130694,474916,6090,101866,4.399162621808885,0.1766109205904484
5138,0.2512142857142857,2,1,2,130695,474915,6092,101864,4.399153358775798,0.17660837166401688
5139,0.25125,1,7,1,130702,474908,6093,101863,4.399088517544184,0.1766090874887954
5140,0.2513333333333333,1,29,1,130731,474879,6094,101862,4.3988198895846455,0.17661654018008083
5141,0.2513571428571428,0,2,0,130733,474877,6094,101862,4.39880136351847,0.17661715264617098
5142,0.2513636363636363,0,1,0,130734,474876,6094,101862,4.398792100485383,0.17661745888080896
5143,0.2513809523809523,0,2,0,130736,474874,6094,101862,4.398773574419208,0.17661807135327082
5144,0.2514047619047619,0,1,0,130737,474873,6094,101862,4.39876431138612,0.1766183775910947
5145,0.2514166666666667,0,2,0,130739,474871,6094,101862,4.398745785319945,0.17661899006992837
5146,0.2514285714285714,1,9,1,130748,474862,6095,101861,4.398662418022157,0.17662031859315477
5147,0.2514999999999999,0,1,0,130749,474861,6095,101861,4.39865315498907,0.17662062484177818
5148,0.2515,0,28,0,130777,474833,6095,101861,4.398393790062618,0.17662920023443976
5149,0.2515238095238095,0,1,0,130778,474832,6095,101861,4.39838452702953,0.1766295065138644
5150,0.2515357142857143,0,1,0,130779,474831,6095,101861,4.398375263996443,0.17662981279435122
5151,0.2515670995670996,0,1,0,130780,474830,6095,101861,4.398366000963356,0.17663011907590026
5152,0.2516071428571428,1,1,1,130781,474829,6096,101860,4.398356737930268,0.17662899760529505
5153,0.2516190476190476,0,3,0,130784,474826,6096,101860,4.398328948831005,0.17662991645366802
5154,0.2516547619047619,2,0,2,130784,474826,6098,101858,4.398328948831005,0.1766270609207122
5155,0.2516666666666666,6,165,6,130949,474661,6104,101852,4.396800548371559,0.17666904302244701
5156,0.2516666666666667,13,207,13,131156,474454,6117,101839,4.394883100522435,0.17671392850511805
5157,0.2517142857142857,0,1,0,131157,474453,6117,101839,4.394873837489348,0.1767142351446836
5158,0.2517380952380952,0,3,0,131160,474450,6117,101839,4.394846048390085,0.17671515506976535
5159,0.25175,0,1,0,131161,474449,6117,101839,4.394836785356997,0.17671546171358765
5160,0.2517619047619048,0,1,0,131162,474448,6117,101839,4.39482752232391,0.17671576835847416
5161,0.2517857142857143,1,3,1,131165,474445,6118,101838,4.394799733224647,0.17671525969011753
5162,0.2518095238095238,0,1,0,131166,474444,6118,101838,4.39479047019156,0.17671556633731403
5163,0.2518333333333333,2,12,2,131178,474432,6120,101836,4.394679313794509,0.1767163889023857
5164,0.2518452380952381,1,0,1,131178,474432,6121,101835,4.394679313794509,0.17671496025279948
5165,0.2518571428571428,0,1,0,131179,474431,6121,101835,4.394670050761421,0.17671526690799041
5166,0.2518571428571429,1,3,1,131182,474428,6122,101834,4.394642261662159,0.17671475821761629
5167,0.2518888888888889,0,2,0,131184,474426,6122,101834,4.394623735595983,0.17671537153368272
5168,0.2518968253968253,0,1,0,131185,474425,6122,101834,4.394614472562896,0.17671567819331238
5169,0.2519047619047619,0,1,0,131186,474424,6122,101834,4.394605209529808,0.17671598485400636
5170,0.2519444444444444,0,1,0,131187,474423,6122,101834,4.394595946496721,0.17671629151576468
5171,0.251952380952381,0,1,0,131188,474422,6122,101834,4.394586683463634,0.1767165981785873
5172,0.2519999999999999,0,1,0,131189,474421,6122,101834,4.3945774204305454,0.17671690484247427
5173,0.252,2,101,2,131290,474320,6124,101832,4.393641854088703,0.17674502561823963
5174,0.2520238095238095,0,4,0,131294,474316,6124,101832,4.393604801956353,0.1767462526989593
5175,0.2520833333333333,0,1,0,131295,474315,6124,101832,4.393595538923265,0.17674655947180146
5176,0.2520833333333334,0,1,0,131296,474314,6124,101832,4.393586275890177,0.17674686624570854
5177,0.2520952380952381,0,1,0,131297,474313,6124,101832,4.39357701285709,0.17674717302068055
5178,0.252111111111111,0,1,0,131298,474312,6124,101832,4.393567749824002,0.17674747979671748
5179,0.2521428571428571,1,4,1,131302,474308,6125,101831,4.393530697691652,0.17674727800062137
5180,0.2521666666666666,0,2,0,131304,474306,6125,101831,4.393512171625477,0.17674789156051426
5181,0.2521666666666667,0,8,0,131312,474298,6125,101831,4.393438067360776,0.17675034584268454
5182,0.2521904761904762,0,1,0,131313,474297,6125,101831,4.393428804327689,0.17675065263274828
5183,0.2522222222222222,0,1,0,131314,474296,6125,101831,4.393419541294602,0.17675095942387703
5184,0.25225,0,3,0,131317,474293,6125,101831,4.393391752195339,0.17675187980365337
5185,0.2522619047619048,0,2,0,131319,474291,6125,101831,4.393373226129164,0.1767524933954961
5186,0.2522857142857143,0,1,0,131320,474290,6125,101831,4.393363963096077,0.176752800193015
5187,0.2523333333333333,0,34,0,131354,474256,6125,101831,4.393049019971099,0.1767632319423976
5188,0.2523571428571429,1,0,1,131354,474256,6126,101830,4.393049019971099,0.1767618029252577
5189,0.2523809523809524,2,9,2,131363,474247,6128,101828,4.392965652673311,0.17676170637503796
5190,0.2524761904761905,1,1,1,131364,474246,6129,101827,4.392956389640224,0.17676058416207668
5191,0.2524999999999999,1,12,1,131376,474234,6130,101826,4.3928452332431736,0.17676283720445787
5192,0.2525,25,324,25,131700,473910,6155,101801,4.389844010522806,0.17682656749653905
5193,0.2525476190476191,0,1,0,131701,473909,6155,101801,4.389834747489718,0.1768268746417467
5194,0.252563492063492,0,4,0,131705,473905,6155,101801,4.389797695357368,0.17682810323324752
5195,0.2525714285714285,0,2,0,131707,473903,6155,101801,4.3897791692911925,0.17682871753540014
5196,0.2525952380952381,0,2,0,131709,473901,6155,101801,4.389760643225018,0.17682933184182095
5197,0.2526111111111111,0,1,0,131710,473900,6155,101801,4.38975138019193,0.17682963899663193
5198,0.2526190476190476,0,3,0,131713,473897,6155,101801,4.389723591092667,0.1768305604674673
5199,0.2526666666666666,3,33,3,131746,473864,6158,101798,4.389417911000778,0.17683640747521984
5200,0.2526666666666667,4,13,4,131759,473851,6162,101794,4.38929749157064,0.17683468109685657
5201,0.2526904761904761,0,1,0,131760,473850,6162,101794,4.389288228537552,0.17683498829137453
5202,0.2527142857142857,0,1,0,131761,473849,6162,101794,4.389278965504465,0.1768352954869598
5203,0.2527272727272727,0,2,0,131763,473847,6162,101794,4.3892604394382895,0.1768359098813323
5204,0.25275,0,1,0,131764,473846,6162,101794,4.389251176405202,0.1768362170801195
5205,0.2527857142857143,0,1,0,131765,473845,6162,101794,4.389241913372115,0.1768365242799741
5206,0.2528333333333333,1,5,1,131770,473840,6163,101793,4.389195598206677,0.17683663028353136
5207,0.2528571428571428,0,16,0,131786,473824,6163,101793,4.389047389677276,0.176841545680548
5208,0.2528571428571429,0,2,0,131788,473822,6163,101793,4.389028863611101,0.1768421601243887
5209,0.2528787878787878,0,1,0,131789,473821,6163,101793,4.389019600578013,0.17684246734791023
5210,0.2529166666666666,0,1,0,131790,473820,6163,101793,4.389010337544926,0.17684277457249922
5211,0.2529166666666667,0,2,0,131792,473818,6163,101793,4.388991811478751,0.17684338902487964
5212,0.2529264069264069,0,2,0,131794,473816,6163,101793,4.388973285412575,0.17684400348153
5213,0.2529285714285714,0,1,0,131795,473815,6163,101793,4.388964022379488,0.1768443107114564
5214,0.2529365079365079,1,0,1,131795,473815,6164,101792,4.388964022379488,0.17684288064599632
5215,0.2529523809523809,0,1,0,131796,473814,6164,101792,4.3889547593464,0.17684318787503953
5216,0.2529999999999999,1,4,1,131800,473810,6165,101791,4.38891770721405,0.1768429867217048
5217,0.253,1,44,1,131844,473766,6166,101790,4.3885101337581975,0.17685507578758627
5218,0.2530497835497835,0,1,0,131845,473765,6166,101790,4.38850087072511,0.17685538306504156
5219,0.2530577200577201,0,1,0,131846,473764,6166,101790,4.388491607692023,0.17685569034356463
5220,0.2530952380952381,0,3,0,131849,473761,6166,101790,4.38846381859276,0.17685661218554047
5221,0.2531428571428571,0,1,0,131850,473760,6166,101790,4.388454555559672,0.17685691946833465
5222,0.2531666666666666,0,12,0,131862,473748,6166,101790,4.388343399162622,0.17686060694515393
5223,0.2531666666666667,0,2,0,131864,473746,6166,101790,4.388324873096447,0.17686122153957354
5224,0.2532142857142856,1,2,1,131866,473744,6167,101789,4.388306347030271,0.17686040591938257
5225,0.2532142857142857,0,1,0,131867,473743,6167,101789,4.388297083997184,0.17686071321837882
5226,0.25325,0,1,0,131868,473742,6167,101789,4.388287820964097,0.17686102051844296
5227,0.2533333333333333,52,712,52,132580,473030,6219,101737,4.381692541405758,0.17700563880668166
5228,0.2534285714285714,0,2,0,132582,473028,6219,101737,4.381674015339583,0.17700625473019407
5229,0.2534523809523809,1,4,1,132586,473024,6220,101736,4.3816369632072325,0.17700605470109262
5230,0.2535,3,28,3,132614,472996,6223,101733,4.381377598280781,0.17701038228452018
5231,0.2535714285714285,0,2,0,132616,472994,6223,101733,4.381359072214606,0.17701099826526334
5232,0.2535833333333333,0,1,0,132617,472993,6223,101733,4.381349809181518,0.1770113062572426
5233,0.2535952380952381,0,1,0,132618,472992,6223,101733,4.381340546148431,0.17701161425029363
5234,0.2536071428571428,0,1,0,132619,472991,6223,101733,4.381331283115343,0.17701192224441645
5235,0.2536111111111111,0,2,0,132621,472989,6223,101733,4.381312757049169,0.1770125382358775
5236,0.2536190476190476,0,1,0,132622,472988,6223,101733,4.38130349401608,0.17701284623321578
5237,0.2536363636363636,0,1,0,132623,472987,6223,101733,4.381294230982993,0.17701315423162584
5238,0.2536666666666666,2,36,2,132659,472951,6225,101731,4.380960761791841,0.17702137877991656
5239,0.2536904761904762,0,1,0,132660,472950,6225,101731,4.380951498758754,0.17702168681407598
5240,0.2537380952380952,0,1,0,132661,472949,6225,101731,4.380942235725666,0.17702199484930745
5241,0.25375,1,4,1,132665,472945,6226,101730,4.380905183593316,0.17702179492756775
5242,0.2538095238095238,1,4,1,132669,472941,6227,101729,4.380868131460965,0.17702159500234918
5243,0.2538333333333333,0,8,0,132677,472933,6227,101729,4.3807940271962655,0.1770240593601108
5244,0.2538809523809524,0,2,0,132679,472931,6227,101729,4.38077550113009,0.17702467546027217
5245,0.2538888888888888,1,0,1,132679,472931,6228,101728,4.38077550113009,0.17702324334953423
5246,0.2538888888888889,0,1,0,132680,472930,6228,101728,4.380766238097002,0.17702355139926704
5247,0.2539166666666667,0,2,0,132682,472928,6228,101728,4.380747712030828,0.177024167501949
5248,0.2539285714285714,0,3,0,132685,472925,6228,101728,4.380719922931565,0.1770250916640129
5249,0.2539999999999999,0,1,0,132686,472924,6228,101728,4.380710659898477,0.17702539972017847
5250,0.254,5,157,5,132843,472767,6233,101723,4.379256363703731,0.1770666156068861
5251,0.254047619047619,0,1,0,132844,472766,6233,101723,4.379247100670644,0.17706692382273637
5252,0.2540476190476191,0,4,0,132848,472762,6233,101723,4.379210048538293,0.17706815669686762
5253,0.2540555555555555,0,1,0,132849,472761,6233,101723,4.379200785505206,0.177068464918083
5254,0.2540833333333333,0,1,0,132850,472760,6233,101723,4.3791915224721185,0.17706877314037142
5255,0.2541666666666666,6,126,6,132976,472634,6239,101717,4.378024380303087,0.17709902133016223
5256,0.2542142857142857,0,2,0,132978,472632,6239,101717,4.378005854236911,0.17709963802496392
5257,0.2542460317460317,0,1,0,132979,472631,6239,101717,4.377996591203824,0.17709994637397536
5258,0.2542619047619048,0,1,0,132980,472630,6239,101717,4.377987328170736,0.17710025472406055
5259,0.2542857142857143,0,12,0,132992,472618,6239,101717,4.377876171773686,0.1771039550088363
5260,0.2543333333333333,1,20,1,133012,472598,6240,101716,4.377690911111935,0.17710868967150376
5261,0.2543809523809524,0,1,0,133013,472597,6240,101716,4.3776816480788465,0.17710899805506752
5262,0.2544444444444444,0,1,0,133014,472596,6240,101716,4.377672385045759,0.17710930643970524
5263,0.2544761904761904,0,2,0,133016,472594,6240,101716,4.377653858979584,0.17710992321220248
5264,0.254484126984127,0,2,0,133018,472592,6240,101716,4.3776353329134094,0.17711053998899545
5265,0.2545,1,20,1,133038,472572,6241,101715,4.3774500722516585,0.1771152751150557
5266,0.2545021645021644,0,5,0,133043,472567,6241,101715,4.3774037570862205,0.1771168171734444
5267,0.2545238095238095,1,3,1,133046,472564,6242,101714,4.377375967986958,0.1771163095225657
5268,0.2545454545454545,0,1,0,133047,472563,6242,101714,4.37736670495387,0.1771166179387299
5269,0.2545833333333333,0,4,0,133051,472559,6242,101714,4.37732965282152,0.17711785161412777
5270,0.2545833333333334,1,1,1,133052,472558,6243,101713,4.377320389788433,0.17711672712012272
5271,0.2545952380952381,0,2,0,133054,472556,6243,101713,4.377301863722257,0.17711734396249842
5272,0.2546428571428571,1,4,1,133058,472552,6244,101712,4.377264811589907,0.17711714472786036
5273,0.2546666666666666,0,6,0,133064,472546,6244,101712,4.3772092333913815,0.1771189952947978
5274,0.2546666666666667,0,21,0,133085,472525,6244,101712,4.377014709696543,0.17712547258361966
5275,0.2546904761904762,0,1,0,133086,472524,6244,101712,4.377005446663455,0.17712578103776147
5276,0.2547142857142856,0,1,0,133087,472523,6244,101712,4.376996183630368,0.17712608949297762
5277,0.2547142857142857,0,1,0,133088,472522,6244,101712,4.376986920597281,0.17712639794926807
5278,0.2547222222222222,0,5,0,133093,472517,6244,101712,4.376940605431843,0.1771279402468353
5279,0.2547857142857143,0,1,0,133094,472516,6244,101712,4.3769313423987555,0.1771282487095718
5280,0.2548333333333333,2,19,2,133113,472497,6246,101710,4.376755344770092,0.1771312436107536
5281,0.2548412698412698,1,0,1,133113,472497,6247,101709,4.376755344770092,0.17712981055579358
5282,0.2548553113553113,0,3,0,133116,472494,6247,101709,4.376727555670829,0.17713073599406481
5283,0.2548571428571428,0,1,0,133117,472493,6247,101709,4.376718292637741,0.1771310444756375
5284,0.2548730158730158,0,1,0,133118,472492,6247,101709,4.376709029604654,0.17713135295828464
5285,0.2549047619047619,0,1,0,133119,472491,6247,101709,4.376699766571567,0.17713166144200626
5286,0.2549999999999999,3,28,3,133147,472463,6250,101706,4.376440401645115,0.17713600002786636
5287,0.255,79,1351,79,134498,471112,6329,101627,4.363926043943829,0.17744033495187161
5288,0.2550714285714285,0,1,0,134499,471111,6329,101627,4.363916780910741,0.17744064476252666
5289,0.2551071428571428,0,1,0,134500,471110,6329,101627,4.363907517877654,0.1774409545742636
5290,0.2551376678876678,0,6,0,134506,471104,6329,101627,4.363851939679129,0.17744281346740443
5291,0.2551666666666666,5,6,5,134512,471098,6334,101622,4.3637963614806035,0.1774374912697304
5292,0.2551666666666667,0,6,0,134518,471092,6334,101622,4.363740783282078,0.17743935018176613
5293,0.2551904761904761,0,1,0,134519,471091,6334,101622,4.36373152024899,0.1774396600042255
5294,0.2552380952380952,0,4,0,134523,471087,6334,101622,4.36369446811664,0.17744089930488258
5295,0.25525,0,1,0,134524,471086,6334,101622,4.363685205083552,0.17744120913275177
5296,0.2552619047619047,0,1,0,134525,471085,6334,101622,4.363675942050465,0.17744151896170293
5297,0.2552857142857143,0,2,0,134527,471083,6334,101622,4.36365741598429,0.17744213862285121
5298,0.2553174603174603,0,2,0,134529,471081,6334,101622,4.363638889918115,0.17744275828832745
5299,0.2553333333333333,2,35,2,134564,471046,6336,101620,4.36331468376005,0.1774507304432252
5300,0.2553333333333334,0,1,0,134565,471045,6336,101620,4.363305420726963,0.17745104031152595
5301,0.2553571428571428,0,3,0,134568,471042,6336,101620,4.3632776316277,0.17745196992292137
5302,0.2553809523809524,0,3,0,134571,471039,6336,101620,4.363249842528438,0.17745289954405677
5303,0.2554166666666666,1,2,1,134573,471037,6337,101619,4.3632313164622625,0.17745208292587522
5304,0.2554166666666667,0,2,0,134575,471035,6337,101619,4.363212790396087,0.17745270267910465
5305,0.2554285714285714,0,2,0,134577,471033,6337,101619,4.363194264329912,0.1774533224366631
5306,0.2554761904761904,0,1,0,134578,471032,6337,101619,4.3631850012968245,0.1774536323170657
5307,0.2554999999999999,0,2,0,134580,471030,6337,101619,4.363166475230649,0.17745425208111776
5308,0.2555,0,12,0,134592,471018,6337,101619,4.363055318833599,0.17745797075634304
5309,0.2555238095238095,0,1,0,134593,471017,6337,101619,4.3630460558005115,0.17745828065298025
5310,0.2555555555555556,0,1,0,134594,471016,6337,101619,4.363036792767423,0.17745859055069985
5311,0.2555714285714286,0,2,0,134596,471014,6337,101619,4.363018266701249,0.17745921034938608
5312,0.2555833333333334,0,1,0,134597,471013,6337,101619,4.363009003668161,0.17745952025035275
5313,0.255595238095238,0,1,0,134598,471012,6337,101619,4.362999740635074,0.1774598301524018
5314,0.2556666666666666,3,29,3,134627,470983,6340,101616,4.362731112675535,0.17746450832083185
5315,0.2556666666666667,1,3,1,134630,470980,6341,101615,4.362703323576272,0.1774640016067203
5316,0.2556904761904761,0,1,0,134631,470979,6341,101615,4.362694060543184,0.17746431153662107
5317,0.2557142857142856,2,9,2,134640,470970,6343,101613,4.362610693245396,0.17746422789359795
5318,0.2557142857142857,0,3,0,134643,470967,6343,101613,4.362582904146134,0.17746515770721996
5319,0.2557619047619047,0,1,0,134644,470966,6343,101613,4.3625736411130465,0.17746546764725915
5320,0.2558333333333333,7,118,7,134762,470848,6350,101606,4.361480603208714,0.17749199062282733
5321,0.2558636363636363,0,1,0,134763,470847,6350,101606,4.361471340175627,0.1774923006779596
5322,0.2559166666666667,0,1,0,134764,470846,6350,101606,4.36146207714254,0.1774926107341751
5323,0.2559523809523809,0,3,0,134767,470843,6350,101606,4.361434288043277,0.17749354090932118
5324,0.256,10,140,10,134907,470703,6360,101596,4.36013746341102,0.17752258871673723
5325,0.2560119047619048,0,1,0,134908,470702,6360,101596,4.360128200377932,0.17752289890930947
5326,0.256060606060606,0,1,0,134909,470701,6360,101596,4.360118937344844,0.17752320910296576
5327,0.2560714285714285,0,1,0,134910,470700,6360,101596,4.360109674311756,0.17752351929770607
5328,0.256111111111111,0,1,0,134911,470699,6360,101596,4.360100411278669,0.17752382949353043
5329,0.2561111111111111,0,1,0,134912,470698,6360,101596,4.360091148245582,0.17752413969043884
5330,0.2561190476190476,1,1,1,134913,470697,6361,101595,4.360081885212494,0.17752301272776835
5331,0.2561309523809523,0,4,0,134917,470693,6361,101595,4.360044833080144,0.17752425352270185
5332,0.2561428571428571,0,1,0,134918,470692,6361,101595,4.3600355700470566,0.1775245637241454
5333,0.2561666666666666,2,11,2,134929,470681,6363,101593,4.359933676683093,0.1775251016121648
5334,0.2561785714285714,0,1,0,134930,470680,6363,101593,4.359924413650005,0.17752541182267903
5335,0.2561904761904762,1,4,1,134934,470676,6364,101592,4.359887361517655,0.17752521545849148
5336,0.2561984126984126,0,3,0,134937,470673,6364,101592,4.359859572418393,0.1775261461036408
5337,0.2562380952380952,0,3,0,134940,470670,6364,101592,4.35983178331913,0.17752707675854765
5338,0.25625,0,7,0,134947,470663,6364,101592,4.359766942087517,0.17752924832461053
5339,0.2563095238095238,0,1,0,134948,470662,6364,101592,4.35975767905443,0.17752955855267066
5340,0.2563333333333333,0,25,0,134973,470637,6364,101592,4.359526103227241,0.17753731460656486
5341,0.2563888888888888,0,2,0,134975,470635,6364,101592,4.359507577161065,0.17753793512015337
5342,0.2564087301587301,0,1,0,134976,470634,6364,101592,4.359498314127978,0.1775382453785742
5343,0.2564285714285714,0,3,0,134979,470631,6364,101592,4.359470525028716,0.1775391761603431
5344,0.2564722222222222,0,1,0,134980,470630,6364,101592,4.3594612619956274,0.17753948642310152
5345,0.2564761904761905,0,1,0,134981,470629,6364,101592,4.35945199896254,0.1775397966869444
5346,0.2564981684981685,0,1,0,134982,470628,6364,101592,4.359442735929453,0.17754010695187167
5347,0.2565,2,24,2,135006,470604,6366,101590,4.359220423135351,0.17754467890260994
5348,0.256547619047619,1,2,1,135008,470602,6367,101589,4.359201897069176,0.1775438621019904
5349,0.2566190476190476,0,1,0,135009,470601,6367,101589,4.359192634036089,0.17754417239028994
5350,0.2566666666666666,49,717,49,135726,469884,6416,101540,4.352551039312313,0.17769642157137258
5351,0.2566666666666667,0,1,0,135727,469883,6416,101540,4.3525417762792245,0.1776967325431423
5352,0.2567142857142857,1,1,1,135728,469882,6417,101539,4.352532513246137,0.1776956044667592
5353,0.2567777777777777,0,1,0,135729,469881,6417,101539,4.35252325021305,0.1776959154387316
5354,0.2567857142857143,0,4,0,135733,469877,6417,101539,4.352486198080699,0.17769715933750543
5355,0.2568055555555555,1,0,1,135733,469877,6418,101538,4.352486198080699,0.1776957202733565
5356,0.2568095238095238,0,1,0,135734,469876,6418,101538,4.352476935047612,0.17769603124879685
5357,0.2568333333333333,0,20,0,135754,469856,6418,101538,4.352291674385861,0.17770225098618467
5358,0.2568571428571428,0,1,0,135755,469855,6418,101538,4.352282411352773,0.17770256198448353
5359,0.2569047619047619,0,2,0,135757,469853,6418,101538,4.3522638852865985,0.17770318398434698
5360,0.2569166666666667,0,1,0,135758,469852,6418,101538,4.35225462225351,0.17770349498591154
5361,0.2569642857142857,0,1,0,135759,469851,6418,101538,4.352245359220423,0.1777038059885647
5362,0.2569999999999999,0,2,0,135761,469849,6418,101538,4.352226833154248,0.1777044279971368
5363,0.257,3,36,3,135797,469813,6421,101535,4.351893363963096,0.1777113072943285
5364,0.2570238095238095,0,1,0,135798,469812,6421,101535,4.351884100930008,0.17771161833351712
5365,0.2570833333333333,0,3,0,135801,469809,6421,101535,4.351856311830746,0.17771255145761572
5366,0.2571428571428572,2,10,2,135811,469799,6423,101533,4.35176368149987,0.1777127834604048
5367,0.2571666666666666,0,2,0,135813,469797,6423,101533,4.3517451554336954,0.17771340556245951
5368,0.2571666666666667,0,6,0,135819,469791,6423,101533,4.35168957723517,0.17771527189475675
5369,0.2572222222222222,0,4,0,135823,469787,6423,101533,4.3516525251028195,0.17771651613806624
5370,0.25725,0,1,0,135824,469786,6423,101533,4.351643262069732,0.1777168272016159
5371,0.2572619047619047,0,1,0,135825,469785,6423,101533,4.351633999036644,0.17771713826625452
5372,0.2572727272727272,0,1,0,135826,469784,6423,101533,4.351624736003557,0.17771744933198208
5373,0.2573095238095238,0,1,0,135827,469783,6423,101533,4.35161547297047,0.17771776039879855
5374,0.2573333333333333,5,48,5,135875,469735,6428,101528,4.351170847382267,0.17772549596245513
5375,0.2573809523809524,1,2,1,135877,469733,6429,101527,4.351152321316092,0.17772467878024018
5376,0.2573928571428571,0,1,0,135878,469732,6429,101527,4.351143058283005,0.17772498989075008
5377,0.2574166666666666,0,2,0,135880,469730,6429,101527,4.351124532216829,0.17772561211503754
5378,0.2574166666666667,0,1,0,135881,469729,6429,101527,4.351115269183741,0.1777259232288151
5379,0.2574285714285714,0,1,0,135882,469728,6429,101527,4.351106006150654,0.1777262343436819
5380,0.2574761904761904,0,1,0,135883,469727,6429,101527,4.351096743117567,0.17772654545963792
5381,0.2574999999999999,1,10,1,135893,469717,6430,101526,4.351004112786691,0.17772821723854823
5382,0.2575,17,347,17,136240,469370,6447,101509,4.3477898403053095,0.177811760460623
5383,0.2575555555555555,0,2,0,136242,469368,6447,101509,4.347771314239134,0.1778123834030798
5384,0.2575595238095238,0,1,0,136243,469367,6447,101509,4.347762051206047,0.17781269487594503
5385,0.2575833333333333,0,1,0,136244,469366,6447,101509,4.34775278817296,0.17781300634990146
5386,0.2575952380952381,0,1,0,136245,469365,6447,101509,4.3477435251398715,0.1778133178249491
5387,0.2576190476190476,1,10,1,136255,469355,6448,101508,4.3476508948089965,0.17781499238871673
5388,0.2576287878787878,0,1,0,136256,469354,6448,101508,4.347641631775908,0.17781530387379085
5389,0.2576428571428571,0,1,0,136257,469353,6448,101508,4.347632368742821,0.17781561535995627
5390,0.2576587301587301,0,2,0,136259,469351,6448,101508,4.347613842676646,0.17781623833556098
5391,0.2576666666666666,1,21,1,136280,469330,6449,101507,4.347419318981808,0.1778213395417606
5392,0.2576666666666667,0,14,0,136294,469316,6449,101507,4.347289636518582,0.17782570078640839
5393,0.2577142857142857,0,2,0,136296,469314,6449,101507,4.347271110452406,0.17782632383882163
5394,0.2577380952380952,0,1,0,136297,469313,6449,101507,4.347261847419319,0.1778266353666655
5395,0.2577777777777778,0,9,0,136306,469304,6449,101507,4.347178480121531,0.17782943916637906
5396,0.2578333333333333,1,9,1,136315,469295,6450,101506,4.347095112823743,0.17783080267904225
5397,0.2578571428571428,1,7,1,136322,469288,6451,101505,4.34703027159213,0.17783154313385063
5398,0.2579047619047619,0,1,0,136323,469287,6451,101505,4.347021008559042,0.17783185468612034
5399,0.2579166666666667,1,4,1,136327,469283,6452,101504,4.346983956426692,0.1778316604968228
5400,0.2579285714285714,1,2,1,136329,469281,6453,101503,4.346965430360517,0.17783084319111958
5401,0.2579365079365079,0,1,0,136330,469280,6453,101503,4.34695616732743,0.1778311547470755
5402,0.2579761904761904,0,1,0,136331,469279,6453,101503,4.3469469042943425,0.1778314663041231
5403,0.2579999999999999,0,4,0,136335,469275,6453,101503,4.346909852161992,0.17783271254323046
5404,0.258,6,81,6,136416,469194,6459,101497,4.3461595464819,0.17784930899558604
5405,0.2580238095238095,0,1,0,136417,469193,6459,101497,4.346150283448813,0.1778496206346703
5406,0.258031746031746,0,3,0,136420,469190,6459,101497,4.34612249434955,0.177850555558476
5407,0.2580555555555556,0,1,0,136421,469189,6459,101497,4.346113231316462,0.1778508672019289
5408,0.2580952380952381,0,3,0,136424,469186,6459,101497,4.346085442217199,0.17785180213884066
5409,0.2581111111111111,0,1,0,136425,469185,6459,101497,4.346076179184112,0.17785211378666227
5410,0.2581190476190476,0,1,0,136426,469184,6459,101497,4.346066916151025,0.17785242543557608
5411,0.2581428571428572,0,1,0,136427,469183,6459,101497,4.346057653117937,0.1778527370855821
5412,0.2581666666666666,1,7,1,136434,469176,6460,101496,4.345992811886324,0.17785347800487847
5413,0.2581904761904762,0,1,0,136435,469175,6460,101496,4.345983548853236,0.17785378966164392
5414,0.2582142857142857,0,6,0,136441,469169,6460,101496,4.345927970654711,0.17785565962517413
5415,0.2582619047619047,0,1,0,136442,469168,6460,101496,4.345918707621624,0.17785597128958547
5416,0.2582857142857142,0,1,0,136443,469167,6460,101496,4.3459094445885365,0.17785628295508907
5417,0.2582857142857143,0,3,0,136446,469164,6460,101496,4.345881655489273,0.1778572179581537
5418,0.2583333333333333,26,379,26,136825,468785,6486,101470,4.34237096594909,0.1779379400443661
5419,0.2584166666666666,0,1,0,136826,468784,6486,101470,4.342361702916003,0.17793825207714456
5420,0.2584285714285714,0,1,0,136827,468783,6486,101470,4.342352439882915,0.17793856411101738
5421,0.2584444444444445,0,2,0,136829,468781,6486,101470,4.3423339138167405,0.17793918818204615
5422,0.2584523809523809,1,0,1,136829,468781,6487,101469,4.3423339138167405,0.17793774660236739
5423,0.2584615384615384,0,1,0,136830,468780,6487,101469,4.342324650783652,0.17793805863754256
5424,0.2584999999999999,0,6,0,136836,468774,6487,101469,4.342269072585127,0.1779399308715758
5425,0.2585,3,25,3,136861,468749,6490,101466,4.342037496757938,0.17794340731127734
5426,0.2585238095238095,0,3,0,136864,468746,6490,101466,4.342009707658676,0.1779443435073271
5427,0.2585714285714285,0,8,0,136872,468738,6490,101466,4.341935603393975,0.17794684007828776
5428,0.258595238095238,0,2,0,136874,468736,6490,101466,4.341917077327801,0.17794746423197394
5429,0.2586666666666666,4,38,4,136912,468698,6494,101462,4.341565082070473,0.17795355689630982
5430,0.2586904761904762,0,1,0,136913,468697,6494,101462,4.341555819037386,0.17795386900846957
5431,0.25875,1,6,1,136919,468691,6495,101461,4.34150024083886,0.17795429990599
5432,0.2587738095238095,0,2,0,136921,468689,6495,101461,4.341481714772685,0.17795492414276945
5433,0.2587777777777778,0,1,0,136922,468688,6495,101461,4.341472451739597,0.1779552362628015
5434,0.2587857142857143,0,1,0,136923,468687,6495,101461,4.34146318870651,0.17795554838392838
5435,0.2588095238095238,0,2,0,136925,468685,6495,101461,4.341444662640335,0.17795617262946684
5436,0.2588214285714285,0,1,0,136926,468684,6495,101461,4.3414353996072474,0.1779564847538784
5437,0.2588333333333333,0,10,0,136936,468674,6495,101461,4.3413427692763715,0.1779596060582143
5438,0.2588571428571428,0,2,0,136938,468672,6495,101461,4.341324243210197,0.17796023033222072
5439,0.2588690476190476,0,1,0,136939,468671,6495,101461,4.341314980177109,0.1779605424708664
5440,0.2588888888888888,0,1,0,136940,468670,6495,101461,4.341305717144022,0.17796085461060704
5441,0.2589166666666667,0,2,0,136942,468668,6495,101461,4.341287191077846,0.17796147889337324
5442,0.2589285714285714,0,1,0,136943,468667,6495,101461,4.341277928044759,0.17796179103639884
5443,0.2589523809523809,0,1,0,136944,468666,6495,101461,4.341268665011672,0.17796210318051942
5444,0.2589999999999999,0,1,0,136945,468665,6495,101461,4.341259401978584,0.177962415325735
5445,0.259,5,96,5,137041,468569,6500,101456,4.340370150802179,0.17798517608876804
5446,0.259047619047619,1,2,1,137043,468567,6501,101455,4.3403516247360034,0.1779843584984439
5447,0.2590714285714286,0,2,0,137045,468565,6501,101455,4.340333098669828,0.17798498298305324
5448,0.2591190476190476,0,1,0,137046,468564,6501,101455,4.340323835636741,0.1779852952270012
5449,0.2591428571428571,0,1,0,137047,468563,6501,101455,4.340314572603654,0.17798560747204475
5450,0.2591666666666666,4,131,4,137178,468432,6505,101451,4.339101115269184,0.17802075162796574
5451,0.2591785714285714,1,0,1,137178,468432,6506,101450,4.339101115269184,0.17801930926051357
5452,0.2592142857142857,0,1,0,137179,468431,6506,101450,4.339091852236097,0.17801962164030735
5453,0.2592323020117137,2,1,2,137180,468430,6508,101448,4.3390825892030085,0.17801704926317563
5454,0.2592380952380952,0,1,0,137181,468429,6508,101448,4.339073326169921,0.17801736164119625
5455,0.25925,2,5,2,137186,468424,6510,101446,4.339027011004483,0.17801603874567884
5456,0.2592857142857143,1,7,1,137193,468417,6511,101445,4.338962169772871,0.17801678301062362
5457,0.2593333333333333,3,46,3,137239,468371,6514,101442,4.338536070250843,0.17802682634478328
5458,0.2593809523809524,0,1,0,137240,468370,6514,101442,4.338526807217756,0.17802713877559617
5459,0.2594166666666667,0,1,0,137241,468369,6514,101442,4.3385175441846675,0.17802745120750565
5460,0.2594358974358974,0,1,0,137242,468368,6514,101442,4.33850828115158,0.17802776364051176
5461,0.2594444444444444,1,1,1,137243,468367,6515,101441,4.338499018118493,0.17802663353269874
5462,0.2594523809523809,0,1,0,137244,468366,6515,101441,4.338489755085405,0.17802694596591478
5463,0.2594999999999999,0,4,0,137248,468362,6515,101441,4.338452702953055,0.1780281957097453
5464,0.2595,5,17,5,137265,468345,6520,101436,4.338295231390567,0.17802629431307818
5465,0.2595238095238095,0,4,0,137269,468341,6520,101436,4.338258179258216,0.17802754410936208
5466,0.2595833333333333,0,1,0,137270,468340,6520,101436,4.338248916225129,0.17802785656117492
5467,0.2596031746031746,1,0,1,137270,468340,6521,101435,4.338248916225129,0.17802641393532534
5468,0.2596190476190476,0,2,0,137272,468338,6521,101435,4.338230390158953,0.1780270388382742
5469,0.2596428571428572,1,1,1,137273,468337,6522,101434,4.338221127125866,0.17802590865452964
5470,0.2596666666666666,2,7,2,137280,468330,6524,101432,4.338156285894253,0.17802521052650053
5471,0.2596666666666667,1,20,1,137300,468310,6525,101431,4.337971025232502,0.17803001714814276
5472,0.2596904761904762,0,1,0,137301,468309,6525,101431,4.337961762199415,0.17803032962403903
5473,0.2597142857142857,2,0,2,137301,468309,6527,101429,4.337961762199415,0.1780274441936469
5474,0.2597222222222222,0,1,0,137302,468308,6527,101429,4.337952499166327,0.1780277566666725
5475,0.2597424242424242,1,0,1,137302,468308,6528,101428,4.337952499166327,0.1780263139418959
5476,0.2598095238095238,1,0,1,137302,468308,6529,101427,4.337952499166327,0.17802487121205474
5477,0.2598333333333333,1,8,1,137310,468300,6530,101426,4.337878394901627,0.1780259282532305
5478,0.2598571428571429,1,0,1,137310,468300,6531,101425,4.337878394901627,0.17802448549738908
5479,0.2598717948717949,0,2,0,137312,468298,6531,101425,4.3378598688354515,0.1780251104484109
5480,0.2598809523809524,0,4,0,137316,468294,6531,101425,4.337822816703102,0.17802636036361785
5481,0.2599166666666667,0,1,0,137317,468293,6531,101425,4.3378135536700135,0.178026672845162
5482,0.2599999999999999,0,45,0,137362,468248,6531,101425,4.337396717181074,0.17804073565010103
5483,0.26,217,3622,217,140984,464626,6748,101208,4.303846011337953,0.17886517954028922
5484,0.2600476190476191,0,2,0,140986,464624,6748,101208,4.3038274852717775,0.17886581176038116
5485,0.2600714285714285,1,0,1,140986,464624,6749,101207,4.3038274852717775,0.1788643605599552
5486,0.2601190476190476,0,1,0,140987,464623,6749,101207,4.30381822223869,0.1788646766696711
5487,0.2601428571428572,1,0,1,140987,464623,6750,101206,4.30381822223869,0.1788632254621096
5488,0.2601666666666666,1,10,1,140997,464613,6751,101205,4.303725591907814,0.17886493536790982
5489,0.2601666666666667,0,4,0,141001,464609,6751,101205,4.3036885397754645,0.1788661998465927
5490,0.2601904761904761,0,1,0,141002,464608,6751,101205,4.303679276742376,0.17886651596905692
5491,0.2601904761904762,0,1,0,141003,464607,6751,101205,4.303670013709289,0.17886683209263854
5492,0.2602380952380952,0,6,0,141009,464601,6751,101205,4.303614435510764,0.1788687288575943
5493,0.2602777777777778,1,0,1,141009,464601,6752,101204,4.303614435510764,0.17886727759563809
5494,0.2602857142857143,0,2,0,141011,464599,6752,101204,4.303595909444589,0.17886790985555043
5495,0.2603333333333333,0,23,0,141034,464576,6752,101204,4.303382859683575,0.17887518116582418
5496,0.2603571428571428,0,3,0,141037,464573,6752,101204,4.303355070584312,0.1788761296411837
5497,0.2603809523809524,0,3,0,141040,464570,6752,101204,4.30332728148505,0.17887707812660178
5498,0.2604166666666666,0,4,0,141044,464566,6752,101204,4.303290229352699,0.17887834278947276
5499,0.2604166666666667,0,2,0,141046,464564,6752,101204,4.303271703286524,0.17887897512761414
5500,0.2604761904761905,0,3,0,141049,464561,6752,101204,4.303243914187261,0.17887992364320876
5501,0.2604999999999999,0,2,0,141051,464559,6752,101204,4.303225388121087,0.17888055599252692
5502,0.2605,0,9,0,141060,464550,6752,101204,4.303142020823298,0.17888340161978528
5503,0.2605454545454545,0,1,0,141061,464549,6752,101204,4.303132757790211,0.17888371780618043
5504,0.2605555555555555,1,0,1,141061,464549,6753,101203,4.303132757790211,0.17888226643476293
5505,0.2605952380952381,0,3,0,141064,464546,6753,101203,4.303104968690948,0.17888321499463544
5506,0.2606507936507936,0,1,0,141065,464545,6753,101203,4.303095705657861,0.17888353118349512
5507,0.2606666666666666,2,62,2,141127,464483,6755,101201,4.302521397606432,0.17890023405293415
5508,0.2607142857142857,0,11,0,141138,464472,6755,101201,4.3024195042424696,0.17890371292248347
5509,0.2607261904761905,0,1,0,141139,464471,6755,101201,4.302410241209381,0.17890402919006068
5510,0.26075,0,1,0,141140,464470,6755,101201,4.302400978176294,0.17890434545875605
5511,0.2608333333333333,14,132,14,141272,464338,6769,101187,4.301178257808737,0.17892577693293843
5512,0.2608354978354978,0,2,0,141274,464336,6769,101187,4.301159731742562,0.17892640971277915
5513,0.2608585858585859,0,1,0,141275,464335,6769,101187,4.301150468709475,0.1789267261043779
5514,0.2609523809523809,0,5,0,141280,464330,6769,101187,4.301104153544037,0.17892830807915588
5515,0.260952380952381,0,1,0,141281,464329,6769,101187,4.3010948905109485,0.17892862447746838
5516,0.2609999999999999,1,5,1,141286,464324,6770,101186,4.301048575345511,0.1789287545755159
5517,0.261,3,60,3,141346,464264,6773,101183,4.300492793360258,0.1789433846142963
5518,0.2610833333333333,0,1,0,141347,464263,6773,101183,4.3004835303271705,0.17894370107844074
5519,0.261111111111111,0,1,0,141348,464262,6773,101183,4.300474267294082,0.1789440175437045
5520,0.2611111111111111,0,1,0,141349,464261,6773,101183,4.300465004260995,0.17894433401008764
5521,0.2611190476190475,0,1,0,141350,464260,6773,101183,4.300455741227908,0.17894465047759014
5522,0.2611428571428571,0,2,0,141352,464258,6773,101183,4.3004372151617325,0.1789452834159532
5523,0.2611666666666666,2,16,2,141368,464242,6775,101181,4.300289006632331,0.17894744288789102
5524,0.2611904761904762,0,5,0,141373,464237,6775,101181,4.300242691466894,0.17894902532285847
5525,0.2612142857142857,1,0,1,141373,464237,6776,101180,4.300242691466894,0.17894757320703128
5526,0.2612380952380953,0,2,0,141375,464235,6776,101180,4.300224165400719,0.1789482061848377
5527,0.26125,0,7,0,141382,464228,6776,101180,4.300159324169106,0.17895042164242458
5528,0.2612857142857143,0,4,0,141386,464224,6776,101180,4.300122272036756,0.17895168764281824
5529,0.2613333333333333,3,24,3,141410,464200,6779,101177,4.299899959242654,0.17895492742011082
5530,0.2613809523809524,0,4,0,141414,464196,6779,101177,4.299862907110304,0.1789561935217989
5531,0.2613928571428571,0,1,0,141415,464195,6779,101177,4.299853644077217,0.17895651005002017
5532,0.2614044566544566,0,1,0,141416,464194,6779,101177,4.299844381044129,0.17895682657936116
5533,0.2614166666666667,0,1,0,141417,464193,6779,101177,4.299835118011042,0.1789571431098219
5534,0.2614285714285714,1,16,1,141433,464177,6780,101176,4.299686909481641,0.17896075549258605
5535,0.2614696969696969,0,2,0,141435,464175,6780,101176,4.299668383415465,0.17896138858868207
5536,0.2615,3,20,3,141455,464155,6783,101173,4.299483122753714,0.1789633628619138
5537,0.2615238095238095,0,4,0,141459,464151,6783,101173,4.299446070621364,0.17896462913302813
5538,0.261547619047619,0,2,0,141461,464149,6783,101173,4.299427544555189,0.17896526227530504
5539,0.2615909090909091,0,1,0,141462,464148,6783,101173,4.299418281522102,0.17896557884812345
5540,0.2616071428571428,0,1,0,141463,464147,6783,101173,4.299409018489014,0.17896589542206184
5541,0.2616190476190476,0,1,0,141464,464146,6783,101173,4.2993997554559265,0.1789662119971202
5542,0.2616666666666666,28,376,28,141840,463770,6811,101145,4.295916855015006,0.1790446350335891
5543,0.2616666666666667,0,1,0,141841,463769,6811,101145,4.295907591981918,0.17904495197499087
5544,0.2617142857142857,0,1,0,141842,463768,6811,101145,4.295898328948831,0.17904526891751474
5545,0.26175,0,1,0,141843,463767,6811,101145,4.295889065915744,0.17904558586116068
5546,0.2617857142857143,0,3,0,141846,463764,6811,101145,4.295861276816481,0.17904653669883114
5547,0.2618095238095238,1,0,1,141846,463764,6812,101144,4.295861276816481,0.17904508344721617
5548,0.2618333333333333,1,10,1,141856,463754,6813,101143,4.295768646485605,0.17904679968206594
5549,0.2618571428571428,0,3,0,141859,463751,6813,101143,4.295740857386343,0.17904775055143088
5550,0.2618809523809523,0,1,0,141860,463750,6813,101143,4.2957315943532555,0.17904806751013025
5551,0.2619047619047619,0,2,0,141862,463748,6813,101143,4.29571306828708,0.17904870143089552
5552,0.2619166666666667,0,2,0,141864,463746,6813,101143,4.295694542220905,0.1790493353561496
5553,0.2619999999999999,0,3,0,141867,463743,6813,101143,4.295666753121642,0.1790502862524474
5554,0.262,2,84,2,141951,463659,6815,101141,4.294888658342288,0.17907400849858357
5555,0.2620238095238095,0,1,0,141952,463658,6815,101141,4.2948793953092,0.17907432555652542
5556,0.2620476190476191,0,1,0,141953,463657,6815,101141,4.294870132276112,0.17907464261559
5557,0.2620555555555555,0,1,0,141954,463656,6815,101141,4.294860869243025,0.1790749596757773
5558,0.2620833333333333,0,7,0,141961,463649,6815,101141,4.294796028011412,0.17907717912852564
5559,0.2621190476190476,0,2,0,141963,463647,6815,101141,4.294777501945237,0.17907781326798727
5560,0.2621428571428571,0,1,0,141964,463646,6815,101141,4.294768238912149,0.17907813033940229
5561,0.2621428571428572,0,3,0,141967,463643,6815,101141,4.2947404498128865,0.17907908156038416
5562,0.2621666666666666,1,4,1,141971,463639,6816,101140,4.294703397680537,0.17907889634706672
5563,0.2621904761904762,0,1,0,141972,463638,6816,101140,4.2946941346474485,0.17907921342545213
5564,0.2622222222222222,0,2,0,141974,463636,6816,101140,4.294675608581274,0.17907984758559145
5565,0.2622727272727272,0,1,0,141975,463635,6816,101140,4.294666345548186,0.17908016466734542
5566,0.2623333333333333,0,24,0,141999,463611,6816,101140,4.294444032754085,0.1790877749663126
5567,0.2623571428571428,0,1,0,142000,463610,6816,101140,4.294434769720997,0.17908809207613988
5568,0.2623571428571429,0,1,0,142001,463609,6816,101140,4.29442550668791,0.17908840918709018
5569,0.2623611111111111,0,1,0,142002,463608,6816,101140,4.2944162436548226,0.17908872629916353
5570,0.2623809523809524,0,2,0,142004,463606,6816,101140,4.294397717588647,0.17908936052667926
5571,0.2623888888888889,0,2,0,142006,463604,6816,101140,4.294379191522472,0.17908999475868712
5572,0.2624166666666666,0,2,0,142008,463602,6816,101140,4.294360665456297,0.17909062899518718
5573,0.2624166666666667,0,4,0,142012,463598,6816,101140,4.294323613323947,0.17909189748166407
5574,0.2624285714285714,0,1,0,142013,463597,6816,101140,4.294314350290859,0.17909221460609098
5575,0.262478354978355,0,1,0,142014,463596,6816,101140,4.294305087257771,0.17909253173164097
5576,0.2624999999999999,0,16,0,142030,463580,6816,101140,4.294156878728371,0.179097605893186
5577,0.2625,22,321,22,142351,463259,6838,101118,4.291183445107266,0.1791674713888057
5578,0.2625476190476191,0,1,0,142352,463258,6838,101118,4.291174182074179,0.17916778884998652
5579,0.2625595238095238,0,1,0,142353,463257,6838,101118,4.2911649190410905,0.17916810631229235
5580,0.2626071428571429,0,1,0,142354,463256,6838,101118,4.291155656008003,0.1791684237757232
5581,0.2626111111111111,0,1,0,142355,463255,6838,101118,4.291146392974916,0.17916874124027904
5582,0.2626190476190476,0,7,0,142362,463248,6838,101118,4.291081551743303,0.17917096352367082
5583,0.2626363636363636,0,2,0,142364,463246,6838,101118,4.291063025677127,0.1791715984719082
5584,0.2626666666666666,1,26,1,142390,463220,6839,101117,4.290822186816851,0.179178398722749
5585,0.2626666666666667,0,24,0,142414,463196,6839,101117,4.2905998740227504,0.1791860191064179
5586,0.2626785714285714,0,2,0,142416,463194,6839,101117,4.290581347956575,0.1791866541676487
5587,0.2627142857142857,0,2,0,142418,463192,6839,101117,4.2905628218904,0.179187289233381
5588,0.2627179487179487,0,1,0,142419,463191,6839,101117,4.2905535588573125,0.17918760676793524
5589,0.26275,0,1,0,142420,463190,6839,101117,4.290544295824224,0.17918792430361488
5590,0.2627777777777778,0,3,0,142423,463187,6839,101117,4.290516506724962,0.17918887691740623
5591,0.2628030303030302,0,1,0,142424,463186,6839,101117,4.2905072436918745,0.1791891944575875
5592,0.2628333333333333,1,7,1,142431,463179,6840,101116,4.290442402460261,0.1791899626968164
5593,0.2628571428571428,0,15,0,142446,463164,6840,101116,4.290303456963948,0.179194726022542
5594,0.2628571428571429,0,1,0,142447,463163,6840,101116,4.290294193930861,0.17919504358659458
5595,0.2628939393939394,0,1,0,142448,463162,6840,101116,4.290284930897773,0.1791953611517727
5596,0.2629166666666666,0,4,0,142452,463158,6840,101116,4.290247878765423,0.17919663142374095
5597,0.2629285714285714,0,1,0,142453,463157,6840,101116,4.290238615732336,0.17919694899454697
5598,0.2629372294372294,0,2,0,142455,463155,6840,101116,4.29022008966616,0.1791975841395358
5599,0.2629444444444444,0,1,0,142456,463154,6840,101116,4.290210826633072,0.1791979017137186
5600,0.262952380952381,0,1,0,142457,463153,6840,101116,4.290201563599985,0.17919821928902704
5601,0.2629999999999999,0,1,0,142458,463152,6840,101116,4.290192300566898,0.17919853686546108
5602,0.263,6,39,6,142497,463113,6846,101110,4.289831042276483,0.17920219487684833
5603,0.263047619047619,0,1,0,142498,463112,6846,101110,4.289821779243395,0.17920251248621996
5604,0.2630608607079195,0,1,0,142499,463111,6846,101110,4.289812516210308,0.17920283009671742
5605,0.2630952380952381,1,3,1,142502,463108,6847,101109,4.289784727111045,0.17920232818224194
5606,0.2631071428571428,0,1,0,142503,463107,6847,101109,4.289775464077958,0.17920264579522735
5607,0.2631428571428572,0,2,0,142505,463105,6847,101109,4.289756938011783,0.17920328102457578
5608,0.2631666666666666,0,10,0,142515,463095,6847,101109,4.289664307680907,0.17920645723887105
5609,0.2632142857142857,0,2,0,142517,463093,6847,101109,4.289645781614732,0.17920709249524105
5610,0.26325,0,1,0,142518,463092,6847,101109,4.289636518581644,0.17920741012511499
5611,0.2632619047619047,0,1,0,142519,463091,6847,101109,4.289627255548557,0.17920772775611485
5612,0.2633333333333333,49,744,49,143263,462347,6896,101060,4.282735558931416,0.17937299323579578
5613,0.2633571428571428,0,4,0,143267,462343,6896,101060,4.282698506799067,0.179374266732694
5614,0.2633989898989898,0,1,0,143268,462342,6896,101060,4.2826892437659785,0.17937458510974402
5615,0.2634523809523809,0,2,0,143270,462340,6896,101060,4.282670717699804,0.17937522186723465
5616,0.2634999999999999,0,5,0,143275,462335,6896,101060,4.282624402534366,0.17937681378073997
5617,0.2635,2,27,2,143302,462308,6898,101058,4.282374300641002,0.17938249734630773
5618,0.2635238095238095,0,1,0,143303,462307,6898,101058,4.2823650376079145,0.17938281575887746
5619,0.263547619047619,0,1,0,143304,462306,6898,101058,4.282355774574826,0.1793831341725776
5620,0.2635714285714285,0,6,0,143310,462300,6898,101058,4.282300196376301,0.17938504467851704
5621,0.2635714285714286,0,1,0,143311,462299,6898,101058,4.282290933343214,0.17938536310013012
5622,0.2635871628371627,0,4,0,143315,462295,6898,101058,4.282253881210863,0.17938663679788694
5623,0.2635952380952381,0,1,0,143316,462294,6898,101058,4.282244618177776,0.1793869552251523
5624,0.2636111111111111,0,1,0,143317,462293,6898,101058,4.282235355144689,0.17938727365354815
5625,0.2636190476190476,0,1,0,143318,462292,6898,101058,4.282226092111601,0.17938759208307448
5626,0.2636428571428571,0,3,0,143321,462289,6898,101058,4.282198303012338,0.17938854737843637
5627,0.2636666666666666,1,36,1,143357,462253,6899,101057,4.281864833821186,0.17939855496973248
5628,0.2636666666666667,0,1,0,143358,462252,6899,101057,4.281855570788099,0.1793988734424623
5629,0.2636904761904762,0,1,0,143359,462251,6899,101057,4.2818463077550115,0.17939919191632286
5630,0.2637142857142857,1,0,1,143359,462251,6900,101056,4.2818463077550115,0.179397735160401
5631,0.2637380952380952,0,1,0,143360,462250,6900,101056,4.281837044721923,0.17939805363337155
5632,0.26375,0,4,0,143364,462246,6900,101056,4.2817999925895736,0.1793993275365612
5633,0.2637777777777778,0,2,0,143366,462244,6900,101056,4.281781466523398,0.17939996449494053
5634,0.2637857142857143,0,2,0,143368,462242,6900,101056,4.281762940457224,0.17940060145784292
5635,0.2638095238095237,0,5,0,143373,462237,6900,101056,4.281716625291786,0.17940219388488762
5636,0.2638095238095238,0,1,0,143374,462236,6900,101056,4.281707362258698,0.17940251237368895
5637,0.2638333333333333,0,12,0,143386,462224,6900,101056,4.281596205861647,0.1794063343275103
5638,0.2638809523809524,0,1,0,143387,462223,6900,101056,4.28158694282856,0.1794066528310127
5639,0.2638888888888889,0,1,0,143388,462222,6900,101056,4.281577679795472,0.17940697133564598
5640,0.2639285714285714,0,1,0,143389,462221,6900,101056,4.281568416762385,0.1794072898414102
5641,0.2639999999999999,0,3,0,143392,462218,6900,101056,4.281540627663122,0.1794082453654882
5642,0.264,7,139,7,143531,462079,6907,101049,4.280253066063952,0.17944232927504936
5643,0.264047619047619,1,6,1,143537,462073,6908,101048,4.2801974878654265,0.17944278405529185
5644,0.2640595238095238,0,1,0,143538,462072,6908,101048,4.280188224832339,0.17944310271345362
5645,0.2640833333333333,0,1,0,143539,462071,6908,101048,4.280178961799251,0.17944342137274716
5646,0.2640952380952381,0,1,0,143540,462070,6908,101048,4.280169698766164,0.17944374003317246
5647,0.2641428571428571,0,1,0,143541,462069,6908,101048,4.280160435733077,0.1794440586947295
5648,0.2641666666666666,8,122,8,143663,461947,6916,101040,4.279030345696395,0.1794712844168693
5649,0.2641666666666667,0,1,0,143664,461946,6916,101040,4.2790210826633075,0.17947160320150057
5650,0.26425,0,1,0,143665,461945,6916,101040,4.279011819630219,0.1794719219872643
5651,0.2642619047619047,0,1,0,143666,461944,6916,101040,4.279002556597132,0.17947224077416055
5652,0.264281746031746,0,1,0,143667,461943,6916,101040,4.278993293564045,0.17947255956218927
5653,0.2642857142857143,0,19,0,143686,461924,6916,101040,4.278817295935381,0.17947861674991653
5654,0.264297619047619,0,2,0,143688,461922,6916,101040,4.278798769869206,0.1794792543724088
5655,0.2643333333333333,3,24,3,143712,461898,6919,101037,4.278576457075105,0.17948253350742094
5656,0.2643888888888888,0,1,0,143713,461897,6919,101037,4.278567194042017,0.1794828523414823
5657,0.2644166666666666,0,1,0,143714,461896,6919,101037,4.27855793100893,0.17948317117667645
5658,0.2644761904761905,2,0,2,143714,461896,6921,101035,4.27855793100893,0.1794802560171673
5659,0.2645,2,13,2,143727,461883,6923,101033,4.278437511578791,0.17948148569235908
5660,0.2645238095238095,0,6,0,143733,461877,6923,101033,4.278381933380266,0.17948339876712086
5661,0.2645714285714285,0,1,0,143734,461876,6923,101033,4.278372670347179,0.17948371761687945
5662,0.2645833333333333,0,2,0,143736,461874,6923,101033,4.278354144281003,0.17948435531979529
5663,0.2646428571428572,0,1,0,143737,461873,6923,101033,4.278344881247916,0.1794846741729525
5664,0.2646666666666666,0,28,0,143765,461845,6923,101033,4.278085516321465,0.1794936025213279
5665,0.2646904761904762,0,1,0,143766,461844,6923,101033,4.2780762532883765,0.17949392140734122
5666,0.2647142857142857,1,3,1,143769,461841,6924,101032,4.278048464189114,0.17949342036303037
5667,0.2647222222222222,0,2,0,143771,461839,6924,101032,4.278029938122939,0.1794940581412082
5668,0.2647261904761905,0,1,0,143772,461838,6924,101032,4.278020675089851,0.17949437703199672
5669,0.26475,0,1,0,143773,461837,6924,101032,4.278011412056764,0.17949469592391834
5670,0.2647619047619047,0,10,0,143783,461827,6924,101032,4.277918781725888,0.1794978849054559
5671,0.2648333333333333,2,12,2,143795,461815,6926,101030,4.277807625328838,0.17949879629382867
5672,0.2648571428571428,0,1,0,143796,461814,6926,101030,4.2777983622957505,0.17949911520776626
5673,0.2648888888888889,0,1,0,143797,461813,6926,101030,4.277789099262662,0.1794994341228371
5674,0.264952380952381,0,2,0,143799,461811,6926,101030,4.277770573196487,0.17950007195637843
5675,0.2649999999999999,1,18,1,143817,461793,6927,101029,4.277603838600911,0.17950435484042912
5676,0.265,98,1359,98,145176,460434,7025,100931,4.265015376634925,0.17979567660969245
5677,0.265047619047619,0,1,0,145177,460433,7025,100931,4.265006113601838,0.17979599689328135
5678,0.2650952380952381,1,1,1,145178,460432,7026,100930,4.2649968505687506,0.17979485608217158
5679,0.2651111111111111,0,1,0,145179,460431,7026,100930,4.264987587535662,0.17979517636601047
5680,0.2651190476190476,1,2,1,145181,460429,7027,100929,4.264969061469488,0.17979435582996947
5681,0.2651428571428572,0,1,0,145182,460428,7027,100929,4.2649597984364,0.17979467611519942
5682,0.2651666666666666,1,4,1,145186,460424,7028,100928,4.26492274630405,0.1797944961450213
5683,0.2651666666666667,0,5,0,145191,460419,7028,100928,4.264876431138612,0.17979609760094914
5684,0.2651825396825397,0,1,0,145192,460418,7028,100928,4.264867168105525,0.17979641789555817
5685,0.2652110389610389,0,2,0,145194,460416,7028,100928,4.264848642039349,0.17979705848819974
5686,0.2652424242424243,0,1,0,145195,460415,7028,100928,4.264839379006262,0.1797973787862323
5687,0.2652460317460318,0,1,0,145196,460414,7028,100928,4.264830115973174,0.17979769908540605
5688,0.26525,1,2,1,145198,460412,7029,100927,4.264811589906999,0.17979687853507417
5689,0.2652857142857143,0,1,0,145199,460411,7029,100927,4.2648023268739115,0.17979719883563913
5690,0.2653333333333333,3,30,3,145229,460381,7032,100924,4.264524435881285,0.17980242470671026
5691,0.2653571428571428,0,6,0,145235,460375,7032,100924,4.264468857682759,0.17980434670291592
5692,0.2653809523809524,0,1,0,145236,460374,7032,100924,4.264459594649672,0.17980466703961176
5693,0.2654166666666666,0,2,0,145238,460372,7032,100924,4.264441068583497,0.1798053077164277
5694,0.2654166666666667,1,3,1,145241,460369,7033,100923,4.264413279484234,0.1798048074798857
5695,0.2654523809523809,0,1,0,145242,460368,7033,100923,4.264404016451147,0.17980512782139746
5696,0.2654761904761905,0,1,0,145243,460367,7033,100923,4.264394753418059,0.17980544816405067
5697,0.2655,0,17,0,145260,460350,7033,100923,4.2642372818555705,0.17981089416380264
5698,0.265510101010101,0,2,0,145262,460348,7033,100923,4.264218755789396,0.17981153489134483
5699,0.2655238095238095,0,1,0,145263,460347,7033,100923,4.264209492756308,0.17981185525682827
5700,0.2655555555555555,1,3,1,145266,460344,7034,100922,4.264181703657045,0.17981135504377604
5701,0.2655833333333333,0,1,0,145267,460343,7034,100922,4.264172440623958,0.179811675411793
5702,0.265595238095238,0,2,0,145269,460341,7034,100922,4.264153914557783,0.17981231615125173
5703,0.2655952380952381,0,1,0,145270,460340,7034,100922,4.2641446515246955,0.1798126365226935
5704,0.2656060606060605,0,1,0,145271,460339,7034,100922,4.264135388491607,0.17981295689527688
5705,0.2656280663780664,1,3,1,145274,460336,7035,100921,4.264107599392345,0.17981245668205476
5706,0.2656666666666666,3,29,3,145303,460307,7038,100918,4.263838971432806,0.17981736380239655
5707,0.2656666666666667,0,4,0,145307,460303,7038,100918,4.263801919300456,0.17981864541775877
5708,0.2657142857142857,1,17,1,145324,460286,7039,100917,4.263644447737967,0.17982263102656257
5709,0.26575,0,1,0,145325,460285,7039,100917,4.26363518470488,0.17982295145063631
5710,0.2657738095238094,0,1,0,145326,460284,7039,100917,4.263625921671792,0.17982327187585198
5711,0.2658095238095238,0,2,0,145328,460282,7039,100917,4.263607395605617,0.17982391272970907
5712,0.2658333333333333,8,120,8,145448,460162,7047,100909,4.2624958316351105,0.17985067843463662
5713,0.2658888888888889,0,1,0,145449,460161,7047,100909,4.262486568602023,0.179850998984084
5714,0.2659047619047619,0,3,0,145452,460158,7047,100909,4.262458779502761,0.17985196063928194
5715,0.2659166666666667,0,1,0,145453,460157,7047,100909,4.2624495164696725,0.1798522811932999
5716,0.2659285714285714,0,4,0,145457,460153,7047,100909,4.262412464337323,0.17985356342079842
5717,0.2659466089466089,0,1,0,145458,460152,7047,100909,4.2624032013042354,0.17985388398052973
5718,0.2659523809523809,1,2,1,145460,460150,7048,100908,4.26238467523806,0.17985306331965678
5719,0.265952380952381,0,2,0,145462,460148,7048,100908,4.262366149171885,0.17985370444305024
5720,0.2659999999999999,0,8,0,145470,460140,7048,100908,4.262292044907184,0.17985626898233306
5721,0.266,6,145,6,145615,459995,7054,100902,4.260948905109489,0.17989399123190175
5722,0.2660714285714285,0,2,0,145617,459993,7054,100902,4.260930379043314,0.17989463268526196
5723,0.2660793650793651,0,1,0,145618,459992,7054,100902,4.260921116010226,0.1798949534136575
5724,0.2660833333333333,0,1,0,145619,459991,7054,100902,4.260911852977139,0.17989527414319664
5725,0.2661111111111111,0,2,0,145621,459989,7054,100902,4.2608933269109635,0.17989591560570592
5726,0.2661428571428571,0,1,0,145622,459988,7054,100902,4.260884063877876,0.17989623633867605
5727,0.2661428571428572,0,1,0,145623,459987,7054,100902,4.260874800844789,0.17989655707278981
5728,0.2661587301587301,0,1,0,145624,459986,7054,100902,4.260865537811701,0.17989687780804725
5729,0.2661666666666666,1,5,1,145629,459981,7055,100901,4.260819222646263,0.17989701933740074
5730,0.2661904761904761,0,3,0,145632,459978,7055,100901,4.260791433547,0.17989798156108536
5731,0.2661904761904762,1,5,1,145637,459973,7056,100900,4.260745118381563,0.17989812310451742
5732,0.2662380952380953,0,1,0,145638,459972,7056,100900,4.260735855348475,0.1798984438517166
5733,0.26625,0,11,0,145649,459961,7056,100900,4.260633961984512,0.17990197214639633
5734,0.2663030303030302,0,1,0,145650,459960,7056,100900,4.260624698951425,0.1799022929073209
5735,0.2663095238095238,2,0,2,145650,459960,7058,100898,4.260624698951425,0.17989936846759785
5736,0.2663333333333333,3,14,3,145664,459946,7061,100895,4.260495016488199,0.17989947239948578
5737,0.2663452380952381,0,3,0,145667,459943,7061,100895,4.260467227388936,0.17990043470663541
5738,0.2663571428571428,0,3,0,145670,459940,7061,100895,4.260439438289674,0.17990139702408017
5739,0.2663809523809524,0,3,0,145673,459937,7061,100895,4.260411649190411,0.17990235935182014
5740,0.2664285714285714,0,5,0,145678,459932,7061,100895,4.260365334024973,0.17990396325426558
5741,0.2664523809523809,0,1,0,145679,459931,7061,100895,4.260356070991886,0.17990428403818653
5742,0.2664761904761905,0,1,0,145680,459930,7061,100895,4.260346807958798,0.17990460482325146
5743,0.2664999999999999,1,25,1,145705,459905,7062,100894,4.260115232131609,0.17991116246640954
5744,0.2665,0,4,0,145709,459901,7062,100894,4.260078179999259,0.17991244572437343
5745,0.2665238095238095,0,1,0,145710,459900,7062,100894,4.260068916966171,0.17991276654172478
5746,0.2665324675324675,0,1,0,145711,459899,7062,100894,4.260059653933084,0.17991308736022027
5747,0.266551948051948,0,3,0,145714,459896,7062,100894,4.260031864833821,0.17991404982257173
5748,0.2665714285714285,0,1,0,145715,459895,7062,100894,4.260022601800734,0.17991437064564392
5749,0.2665833333333333,0,1,0,145716,459894,7062,100894,4.260013338767646,0.17991469146986028
5750,0.2666666666666666,62,710,62,146426,459184,7124,100832,4.253436585275483,0.18005199851432815
5751,0.2666666666666667,1,5,1,146431,459179,7125,100831,4.253390270110045,0.18005214192603702
5752,0.2667142857142857,0,1,0,146432,459178,7125,100831,4.253381007076957,0.18005246344255182
5753,0.2667619047619047,0,1,0,146433,459177,7125,100831,4.25337174404387,0.18005278496021485
5754,0.2667857142857143,0,1,0,146434,459176,7125,100831,4.253362481010782,0.18005310647902614
5755,0.2668095238095238,0,1,0,146435,459175,7125,100831,4.253353217977694,0.18005342799898572
5756,0.2668333333333333,2,10,2,146445,459165,7127,100829,4.253260587646819,0.18005371486123065
5757,0.2668571428571428,0,3,0,146448,459162,7127,100829,4.253232798547557,0.18005467945020545
5758,0.2668888888888889,0,1,0,146449,459161,7127,100829,4.2532235355144685,0.1800550009821604
5759,0.2669047619047619,0,4,0,146453,459157,7127,100829,4.253186483382119,0.18005628712146374
5760,0.2669285714285714,0,1,0,146454,459156,7127,100829,4.2531772203490315,0.1800566086591605
5761,0.2669444444444444,0,1,0,146455,459155,7127,100829,4.253167957315943,0.18005693019800564
5762,0.2669761904761905,0,1,0,146456,459154,7127,100829,4.253158694282856,0.1800572517379992
5763,0.2669957264957265,1,1,1,146457,459153,7128,100828,4.253149431249769,0.18005610904655694
5764,0.2669999999999999,1,0,1,146457,459153,7129,100827,4.253149431249769,0.18005464480874317
5765,0.267,6,46,6,146503,459107,7135,100821,4.252723331727741,0.18006065065508423
5766,0.2670119047619048,0,1,0,146504,459106,7135,100821,4.252714068694654,0.18006097223388048
5767,0.2670238095238095,0,5,0,146509,459101,7135,100821,4.252667753529216,0.18006258014509163
5768,0.267047619047619,0,2,0,146511,459099,7135,100821,4.25264922746304,0.18006322331761682
5769,0.2670833333333333,0,1,0,146512,459098,7135,100821,4.252639964429953,0.18006354490560242
5770,0.2670952380952381,0,1,0,146513,459097,7135,100821,4.252630701396866,0.18006386649473674
5771,0.2671190476190476,0,1,0,146514,459096,7135,100821,4.252621438363778,0.18006418808501976
5772,0.2671428571428571,1,13,1,146527,459083,7136,100820,4.252501018933639,0.18006690444594867
5773,0.2671666666666666,2,19,2,146546,459064,7138,100818,4.252325021304976,0.1800700861967343
5774,0.2671904761904762,0,2,0,146548,459062,7138,100818,4.252306495238801,0.1800707294420233
5775,0.2672222222222222,0,1,0,146549,459061,7138,100818,4.252297232205714,0.18007105106639112
5776,0.2672619047619047,0,1,0,146550,459060,7138,100818,4.252287969172626,0.18007137269190787
5777,0.2672857142857143,0,1,0,146551,459059,7138,100818,4.252278706139538,0.18007169431857353
5778,0.2673333333333332,0,1,0,146552,459058,7138,100818,4.252269443106451,0.18007201594638814
5779,0.2673333333333333,5,64,5,146616,458994,7143,100813,4.251676608988848,0.18008527939093294
5780,0.2673571428571428,0,1,0,146617,458993,7143,100813,4.2516673459557595,0.1800856010832324
5781,0.2673809523809524,0,3,0,146620,458990,7143,100813,4.251639556856497,0.18008656616702662
5782,0.2674047619047619,0,1,0,146621,458989,7143,100813,4.25163029382341,0.18008688786392332
5783,0.2674166666666666,0,1,0,146622,458988,7143,100813,4.251621030790322,0.18008720956196933
5784,0.2674285714285714,0,4,0,146626,458984,7143,100813,4.251583978657972,0.18008849636564683
5785,0.2674523809523809,0,1,0,146627,458983,7143,100813,4.251574715624884,0.18008881806943958
5786,0.2674999999999999,1,4,1,146631,458979,7144,100812,4.251537663492534,0.18008864022465526
5787,0.2675,20,360,20,146991,458619,7164,100792,4.248202971581015,0.18017522000818717
5788,0.2675238095238095,0,1,0,146992,458618,7164,100792,4.248193708547927,0.18017554208898662
5789,0.2675595238095238,0,1,0,146993,458617,7164,100792,4.248184445514839,0.18017586417093753
5790,0.2676190476190476,0,8,0,147001,458609,7164,100792,4.248110341250139,0.1801784408679999
5791,0.2676666666666666,5,13,5,147014,458596,7169,100787,4.24798992182,0.1801753002862082
5792,0.2676666666666667,1,16,1,147030,458580,7170,100786,4.2478417132906,0.18017898835467297
5793,0.2677777777777778,0,2,0,147032,458578,7170,100786,4.247823187224425,0.18017963258271893
5794,0.2678095238095238,0,2,0,147034,458576,7170,100786,4.247804661158249,0.1801802768153718
5795,0.2678333333333333,0,14,0,147048,458562,7170,100786,4.247674978695024,0.1801847865729385
5796,0.2678571428571428,0,5,0,147053,458557,7170,100786,4.247628663529587,0.18018639725535138
5797,0.2678571428571429,0,4,0,147057,458553,7170,100786,4.247591611397236,0.18018768582201491
5798,0.2679047619047619,0,1,0,147058,458552,7170,100786,4.247582348364149,0.18018800796656048
5799,0.2679166666666666,2,1,2,147059,458551,7172,100784,4.2475730853310605,0.1801853987324233
5800,0.2679166666666667,1,6,1,147065,458545,7173,100783,4.247517507132535,0.18018586589621832
5801,0.2679999999999999,0,7,0,147072,458538,7173,100783,4.247452665900923,0.18018812095379935
5802,0.268,10,81,10,147153,458457,7183,100773,4.246702360220831,0.1801995601094362
5803,0.2680476190476191,0,1,0,147154,458456,7183,100773,4.246693097187743,0.18019988233800466
5804,0.2680833333333333,0,2,0,147156,458454,7183,100773,4.246674571121568,0.18020052679859877
5805,0.268095238095238,0,1,0,147157,458453,7183,100773,4.24666530808848,0.18020084903062447
5806,0.2680952380952381,0,3,0,147160,458450,7183,100773,4.246637518989218,0.1802018157336161
5807,0.2681111111111111,0,1,0,147161,458449,7183,100773,4.24662825595613,0.18020213797025153
5808,0.2681190476190476,0,1,0,147162,458448,7183,100773,4.246618992923043,0.1802024602080394
5809,0.2681428571428571,0,1,0,147163,458447,7183,100773,4.246609729889955,0.1802027824469797
5810,0.2681547619047619,0,2,0,147165,458445,7183,100773,4.24659120382378,0.18020342692831776
5811,0.2681666666666666,2,22,2,147187,458423,7185,100771,4.246387417095854,0.18020758448767332
5812,0.2681666666666667,0,3,0,147190,458420,7185,100771,4.246359627996592,0.18020855128212007
5813,0.2682142857142857,0,7,0,147197,458413,7185,100771,4.246294786764978,0.180210807176171
5814,0.2682380952380953,0,1,0,147198,458412,7185,100771,4.246285523731891,0.18021112945136028
5815,0.2682857142857143,1,0,1,147198,458412,7186,100770,4.246285523731891,0.18020966340118244
5816,0.2683333333333333,30,423,30,147621,457989,7216,100740,4.242367260735855,0.18030207846737864
5817,0.2683611111111111,0,1,0,147622,457988,7216,100740,4.242357997702768,0.18030240116836815
5818,0.2683611388611389,0,1,0,147623,457987,7216,100740,4.24234873466968,0.1803027238705128
5819,0.2683888888888889,0,1,0,147624,457986,7216,100740,4.242339471636592,0.18030304657381258
5820,0.268452380952381,0,1,0,147625,457985,7216,100740,4.242330208603505,0.18030336927826748
5821,0.2684632034632034,0,1,0,147626,457984,7216,100740,4.242320945570418,0.18030369198387755
5822,0.2684999999999999,0,1,0,147627,457983,7216,100740,4.24231168253733,0.18030401469064278
5823,0.2685,2,31,2,147658,457952,7218,100738,4.242024528511616,0.18031108485922426
5824,0.2685714285714285,0,10,0,147668,457942,7218,100738,4.241931898180741,0.18031431230758216
5825,0.2686190476190476,0,2,0,147670,457940,7218,100738,4.241913372114565,0.1803149578111184
5826,0.2686363636363636,0,1,0,147671,457939,7218,100738,4.241904109081478,0.18031528056461962
5827,0.2686666666666666,4,38,4,147709,457901,7222,100734,4.2415521138241505,0.18032167694469556
5828,0.2686666666666667,0,2,0,147711,457899,7222,100734,4.241533587757975,0.18032232252659616
5829,0.2686904761904761,0,2,0,147713,457897,7222,100734,4.241515061691801,0.1803229681131194
5830,0.2686904761904762,0,1,0,147714,457896,7222,100734,4.241505798658713,0.1803232909081145
5831,0.2687142857142857,0,1,0,147715,457895,7222,100734,4.241496535625625,0.18032361370426525
5832,0.26875,1,3,1,147718,457892,7223,100733,4.241468746526363,0.18032311479078095
5833,0.2688095238095238,1,6,1,147724,457886,7224,100732,4.2414131683278375,0.18032358427404774
5834,0.2688333333333333,1,12,1,147736,457874,7225,100731,4.241302011930786,0.18032599063739135
5835,0.2688571428571428,0,2,0,147738,457872,7225,100731,4.241283485864612,0.1803266362694078
5836,0.2689285714285714,1,2,1,147740,457870,7226,100730,4.241264959798436,0.18032581453634086
5837,0.2689523809523809,0,2,0,147742,457868,7226,100730,4.241246433732261,0.18032646017350581
5838,0.2689545454545455,0,1,0,147743,457867,7226,100730,4.241237170699174,0.18032678299382202
5839,0.2689761904761905,0,1,0,147744,457866,7226,100730,4.241227907666087,0.18032710581529407
5840,0.2689999999999999,5,65,5,147809,457801,7231,100725,4.240625810515395,0.18034075405621225
5841,0.269,0,2,0,147811,457799,7231,100725,4.24060728444922,0.18034139983241543
5842,0.2690238095238095,0,1,0,147812,457798,7231,100725,4.240598021416132,0.18034172272225138
5843,0.269047619047619,0,3,0,147815,457795,7231,100725,4.24057023231687,0.18034269139869655
5844,0.2690714285714286,0,2,0,147817,457793,7231,100725,4.240551706250694,0.18034333718877457
5845,0.269095238095238,0,1,0,147818,457792,7231,100725,4.240542443217607,0.18034366008554797
5846,0.2691428571428571,0,3,0,147821,457789,7231,100725,4.2405146541183445,0.1803446287828058
5847,0.2691468253968254,0,1,0,147822,457788,7231,100725,4.240505391085257,0.1803449516842043
5848,0.2691666666666666,4,107,4,147929,457681,7235,100721,4.239514246544888,0.18037363763023773
5849,0.2691904761904762,0,2,0,147931,457679,7235,100721,4.239495720478714,0.1803742836676218
5850,0.26925,0,1,0,147932,457678,7235,100721,4.239486457445626,0.18037460668804922
5851,0.2692857142857143,0,9,0,147941,457669,7235,100721,4.239403090147838,0.18037751392395995
5852,0.2693333333333332,0,1,0,147942,457668,7235,100721,4.239393827114751,0.18037783695595722
5853,0.2693333333333333,2,53,2,147995,457615,7237,100719,4.23890288636111,0.18039202341250934
5854,0.2694166666666666,0,1,0,147996,457614,7237,100719,4.238893623328022,0.18039234650289343
5855,0.2694285714285714,0,2,0,147998,457612,7237,100719,4.238875097261848,0.18039299268713363
5856,0.2694444444444444,0,1,0,147999,457611,7237,100719,4.2388658342287595,0.18039331578098974
5857,0.2694444444444445,0,1,0,148000,457610,7237,100719,4.238856571195672,0.1803936388760032
5858,0.2694523809523809,0,1,0,148001,457609,7237,100719,4.238847308162585,0.18039396197217406
5859,0.2695,2,17,2,148018,457592,7239,100717,4.238689836600097,0.180396518773654
5860,0.2695238095238095,2,9,2,148027,457583,7241,100715,4.238606469302308,0.18039649076299755
5861,0.2695335497835498,0,4,0,148031,457579,7241,100715,4.238569417169958,0.18039778324681977
5862,0.269547619047619,0,3,0,148034,457576,7241,100715,4.238541628070696,0.18039875262184057
5863,0.2695555555555555,0,1,0,148035,457575,7241,100715,4.238532365037608,0.1803990757491626
5864,0.2695714285714286,0,1,0,148036,457574,7241,100715,4.23852310200452,0.18039939887764223
5865,0.2695833333333333,0,6,0,148042,457568,7241,100715,4.238467523805995,0.180401337672829
5866,0.2695930735930736,0,1,0,148043,457567,7241,100715,4.238458260772908,0.18040166080941172
5867,0.2696190476190476,1,0,1,148043,457567,7242,100714,4.238458260772908,0.18040019273448318
5868,0.2696428571428571,0,4,0,148047,457563,7242,100714,4.238421208640557,0.18040148528418687
5869,0.2696666666666666,0,18,0,148065,457545,7242,100714,4.2382544740449815,0.18040730198707053
5870,0.2696666666666667,1,3,1,148068,457542,7243,100713,4.238226684945719,0.1804068033425585
5871,0.2696904761904761,0,1,0,148069,457541,7243,100713,4.238217421912631,0.18040712650513924
5872,0.2697142857142857,0,1,0,148070,457540,7243,100713,4.2382081588795435,0.18040744966887773
5873,0.2697222222222222,0,1,0,148071,457539,7243,100713,4.238198895846456,0.180407772833774
5874,0.2697619047619047,1,2,1,148073,457537,7244,100712,4.238180369780281,0.18040695102006452
5875,0.2697777777777777,0,1,0,148074,457536,7244,100712,4.238171106747194,0.1804072741863831
5876,0.2698333333333333,2,24,2,148098,457512,7246,100710,4.237948793953092,0.18041209411309478
5877,0.2698571428571428,0,1,0,148099,457511,7246,100710,4.237939530920005,0.18041241730425764
5878,0.2698809523809524,1,3,1,148102,457508,7247,100709,4.237911741820742,0.18041191866245565
5879,0.2698885836385837,0,1,0,148103,457507,7247,100709,4.237902478787654,0.18041224185619903
5880,0.2699047619047618,0,2,0,148105,457505,7247,100709,4.2378839527214796,0.1804128882471597
5881,0.2699523809523809,0,2,0,148107,457503,7247,100709,4.237865426655304,0.18041353464275223
5882,0.269989898989899,1,0,1,148107,457503,7248,100708,4.237865426655304,0.1804120664049974
5883,0.2699999999999999,1,42,1,148149,457461,7249,100707,4.237476379265627,0.18042417336715827
5884,0.27,234,3718,234,151867,453743,7483,100473,4.2030364222461,0.18128852288638364
5885,0.2701071428571429,1,0,1,151867,453743,7484,100472,4.2030364222461,0.18128704564113204
5886,0.2701428571428572,0,2,0,151869,453741,7484,100472,4.203017896179925,0.18128769985547072
5887,0.2701666666666666,1,13,1,151882,453728,7485,100471,4.202897476749787,0.18129047508205537
5888,0.2701904761904761,0,3,0,151885,453725,7485,100471,4.202869687650525,0.1812914564522299
5889,0.2701904761904762,0,1,0,151886,453724,7485,100471,4.202860424617437,0.18129178357798248
5890,0.2702023809523809,0,1,0,151887,453723,7485,100471,4.202851161584349,0.1812921107049156
5891,0.2702222222222222,1,1,1,151888,453722,7486,100470,4.202841898551261,0.1812909605335335
5892,0.2702380952380952,0,1,0,151889,453721,7486,100470,4.202832635518174,0.18129128766075234
5893,0.2702380952380953,0,1,0,151890,453720,7486,100470,4.202823372485087,0.18129161478915173
5894,0.2702857142857143,0,1,0,151891,453719,7486,100470,4.202814109451999,0.18129194191873169
5895,0.2703095238095238,0,1,0,151892,453718,7486,100470,4.202804846418911,0.18129226904949222
5896,0.2703333333333333,2,31,2,151923,453687,7488,100468,4.202517692393197,0.1812994559283955
5897,0.2703571428571428,0,2,0,151925,453685,7488,100468,4.202499166327022,0.18130011025835824
5898,0.2703809523809524,1,3,1,151928,453682,7489,100467,4.202471377227759,0.1812996143636459
5899,0.2704166666666666,0,1,0,151929,453681,7489,100467,4.202462114194672,0.18129994153186513
5900,0.2704285714285714,0,1,0,151930,453680,7489,100467,4.202452851161584,0.1813002687012652
5901,0.2704444444444445,1,0,1,151930,453680,7490,100466,4.202452851161584,0.18129879129326928
5902,0.2704545454545454,0,1,0,151931,453679,7490,100466,4.202443588128497,0.18129911846177443
5903,0.2704761904761904,0,1,0,151932,453678,7490,100466,4.2024343250954095,0.18129944563146042
5904,0.2704761904761905,0,4,0,151936,453674,7490,100466,4.202397272963059,0.18130075432201248
5905,0.2704999999999999,0,1,0,151937,453673,7490,100466,4.2023880099299715,0.1813010814976026
5906,0.2705,0,17,0,151954,453656,7490,100466,4.202230538367483,0.18130664366330881
5907,0.2705454545454545,0,3,0,151957,453653,7490,100466,4.202202749268221,0.18130762525739055
5908,0.270547619047619,1,1,1,151958,453652,7491,100465,4.2021934862351324,0.1813064749863296
5909,0.2705555555555555,0,1,0,151959,453651,7491,100465,4.202184223202045,0.1813068021858239
5910,0.2705714285714286,1,0,1,151959,453651,7492,100464,4.202184223202045,0.18130532470696517
5911,0.2705833333333333,0,1,0,151960,453650,7492,100464,4.202174960168958,0.18130565190556455
5912,0.2705952380952381,0,1,0,151961,453649,7492,100464,4.20216569713587,0.18130597910534493
5913,0.2706038961038961,0,1,0,151962,453648,7492,100464,4.202156434102783,0.18130630630630631
5914,0.2706111111111111,0,1,0,151963,453647,7492,100464,4.202147171069695,0.18130663350844867
5915,0.2706666666666666,3,44,3,152007,453603,7495,100461,4.201739597613843,0.18131659880447024
5916,0.2706666666666667,0,3,0,152010,453600,7495,100461,4.20171180851458,0.18131758055520963
5917,0.2706916906622789,0,1,0,152011,453599,7495,100461,4.201702545481492,0.18131790780781865
5918,0.2707142857142857,0,3,0,152014,453596,7495,100461,4.201674756382229,0.18131888957273348
5919,0.27075,0,2,0,152016,453594,7495,100461,4.201656230316055,0.18131954408858325
5920,0.2707619047619047,0,1,0,152017,453593,7495,100461,4.201646967282967,0.18131987134828012
5921,0.2707857142857142,0,2,0,152019,453591,7495,100461,4.201628441216792,0.18132052587121786
5922,0.2708333333333332,1,1,1,152020,453590,7496,100460,4.201619178183704,0.18131937550762567
5923,0.2708333333333333,14,126,14,152146,453464,7510,100446,4.200452036014672,0.1813399288693109
5924,0.2709047619047618,0,1,0,152147,453463,7510,100446,4.200442772981585,0.18134025625147812
5925,0.2709285714285714,0,1,0,152148,453462,7510,100446,4.200433509948498,0.18134058363482744
5926,0.2709523809523809,2,14,2,152162,453448,7512,100444,4.200303827485272,0.18134221111696866
5927,0.2709761904761905,0,1,0,152163,453447,7512,100444,4.200294564452184,0.18134253851389534
5928,0.2709999999999999,0,6,0,152169,453441,7512,100444,4.200238986253659,0.1813445029202813
5929,0.271,1,70,1,152239,453371,7513,100443,4.19959057393753,0.18136594596741867
5930,0.271047619047619,0,1,0,152240,453370,7513,100443,4.199581310904443,0.18136627345331366
5931,0.2710714285714286,0,1,0,152241,453369,7513,100443,4.199572047871355,0.18136660094039134
5932,0.2711111111111111,0,1,0,152242,453368,7513,100443,4.1995627848382675,0.18136692842865165
5933,0.2711190476190476,0,1,0,152243,453367,7513,100443,4.19955352180518,0.18136725591809466
5934,0.2711428571428572,1,2,1,152245,453365,7514,100442,4.199534995739005,0.18136643271031244
5935,0.2711666666666666,0,7,0,152252,453358,7514,100442,4.199470154507392,0.18136872517154207
5936,0.2711904761904761,0,2,0,152254,453356,7514,100442,4.199451628441217,0.18136938017110932
5937,0.2711904761904762,0,1,0,152255,453355,7514,100442,4.199442365408129,0.18136970767266705
5938,0.2712142857142857,0,3,0,152258,453352,7514,100442,4.199414576308866,0.1813706901844368
5939,0.2712222222222222,0,3,0,152261,453349,7514,100442,4.199386787209604,0.1813716727068515
5940,0.2712380952380953,0,1,0,152262,453348,7514,100442,4.1993775241765166,0.18137200021668864
5941,0.27125,0,10,0,152272,453338,7514,100442,4.199284893845641,0.18137527538011486
5942,0.2712597402597402,0,1,0,152273,453337,7514,100442,4.199275630812553,0.1813756029029631
5943,0.2712857142857142,0,2,0,152275,453335,7514,100442,4.199257104746378,0.1813762579522082
5944,0.2712857142857143,0,1,0,152276,453334,7514,100442,4.199247841713291,0.18137658547860508
5945,0.2713095238095238,0,2,0,152278,453332,7514,100442,4.199229315647115,0.18137724053494747
5946,0.2713333333333333,2,23,2,152301,453309,7516,100440,4.199016265886102,0.18138181739380116
5947,0.2713412698412698,0,3,0,152304,453306,7516,100440,4.198988476786839,0.18138280005634352
5948,0.2713492063492063,0,1,0,152305,453305,7516,100440,4.198979213753751,0.1813831276128904
5949,0.2713636363636363,0,1,0,152306,453304,7516,100440,4.198969950720664,0.18138345517062035
5950,0.2713809523809523,0,1,0,152307,453303,7516,100440,4.198960687687577,0.18138378272953337
5951,0.2713809523809524,0,1,0,152308,453302,7516,100440,4.198951424654489,0.18138411028962947
5952,0.2714166666666666,0,1,0,152309,453301,7516,100440,4.198942161621401,0.18138443785090863
5953,0.2714285714285714,1,2,1,152311,453299,7517,100439,4.198923635555226,0.1813836146336354
5954,0.2714999999999999,1,16,1,152327,453283,7518,100438,4.198775427025826,0.1813873773976425
5955,0.2715,1,5,1,152332,453278,7519,100437,4.198729111860388,0.1813875369097821
5956,0.2715079365079365,0,3,0,152335,453275,7519,100437,4.198701322761125,0.18138851966365185
5957,0.2715238095238095,0,3,0,152338,453272,7519,100437,4.198673533661863,0.18138950242817076
5958,0.271547619047619,1,0,1,152338,453272,7520,100436,4.198673533661863,0.1813880240126565
5959,0.2715595238095238,0,1,0,152339,453271,7520,100436,4.1986642706287745,0.18138835160111755
5960,0.2716071428571428,0,1,0,152340,453270,7520,100436,4.198655007595687,0.18138867919076188
5961,0.2716190476190476,0,6,0,152346,453264,7520,100436,4.198599429397162,0.1813906447534766
5962,0.2716666666666666,30,402,30,152748,452862,7550,100406,4.194875690095965,0.18147805403529574
5963,0.2716666666666667,0,3,0,152751,452859,7550,100406,4.194847900996702,0.18147903807397903
5964,0.2716785714285714,0,1,0,152752,452858,7550,100406,4.194838637963615,0.18147936608924492
5965,0.2716944444444444,0,2,0,152754,452856,7550,100406,4.19482011189744,0.18148002212333397
5966,0.2716991341991342,0,2,0,152756,452854,7550,100406,4.194801585831264,0.18148067816216606
5967,0.2717063492063492,0,1,0,152757,452853,7550,100406,4.194792322798177,0.18148100618336077
5968,0.2717857142857143,0,3,0,152760,452850,7550,100406,4.1947645336989146,0.18148199025405962
5969,0.2718055555555555,1,2,1,152762,452848,7551,100405,4.194746007632739,0.18148116684410207
5970,0.2718095238095238,0,1,0,152763,452847,7551,100405,4.194736744599652,0.18148149487033033
5971,0.2718333333333333,0,9,0,152772,452838,7551,100405,4.194653377301864,0.18148444715974715
5972,0.2719047619047618,1,0,1,152772,452838,7552,100404,4.194653377301864,0.18148296767056732
5973,0.2719999999999999,1,1,1,152773,452837,7553,100403,4.194644114268776,0.18148181620996312
5974,0.272,3,92,3,152865,452745,7556,100400,4.193791915224721,0.18150756130851767
5975,0.2720238095238095,1,2,1,152867,452743,7557,100399,4.1937733891585465,0.18150673787201116
5976,0.272079365079365,0,2,0,152869,452741,7557,100399,4.193754863092371,0.18150739414976316
5977,0.2720833333333333,0,4,0,152873,452737,7557,100399,4.19371781096002,0.18150870671950478
5978,0.2721071428571428,0,2,0,152875,452735,7557,100399,4.193699284893846,0.1815093630114945
5979,0.2721428571428571,0,6,0,152881,452729,7557,100399,4.193643706695321,0.18151133191593988
5980,0.2721666666666666,1,19,1,152900,452710,7558,100398,4.193467709066657,0.18151608727409474
5981,0.2721666666666667,0,1,0,152901,452709,7558,100398,4.193458446033569,0.1815164154494519
5982,0.2721818181818182,0,1,0,152902,452708,7558,100398,4.193449183000482,0.18151674362599574
5983,0.2721825396825397,0,1,0,152903,452707,7558,100398,4.193439919967394,0.18151707180372623
5984,0.2721904761904762,0,4,0,152907,452703,7558,100398,4.193402867835044,0.18151838452651506
5985,0.2722222222222222,0,3,0,152910,452700,7558,100398,4.193375078735781,0.181519369081067
5986,0.27225,0,1,0,152911,452699,7558,100398,4.193365815702694,0.1815196972682911
5987,0.2722619047619047,0,1,0,152912,452698,7558,100398,4.193356552669606,0.1815200254567019
5988,0.2722777777777777,0,1,0,152913,452697,7558,100398,4.1933472896365185,0.18152035364629945
5989,0.2722777777777778,0,2,0,152915,452695,7558,100398,4.193328763570343,0.1815210100290548
5990,0.2723214285714286,0,1,0,152916,452694,7558,100398,4.193319500537256,0.18152133822221259
5991,0.2723333333333332,1,0,1,152916,452694,7559,100397,4.193319500537256,0.18151985839581553
5992,0.2723333333333333,3,27,3,152943,452667,7562,100394,4.193069398643892,0.18152428032350862
5993,0.2723809523809524,0,3,0,152946,452664,7562,100394,4.193041609544629,0.1815252649812497
5994,0.2724166666666667,0,2,0,152948,452662,7562,100394,4.1930230834784545,0.18152592142567842
5995,0.2724761904761905,0,4,0,152952,452658,7562,100394,4.192986031346104,0.1815272343287792
5996,0.2724999999999999,0,6,0,152958,452652,7562,100394,4.192930453147579,0.18152920371903963
5997,0.2725,35,361,35,153319,452291,7597,100359,4.189586498202972,0.18159594680177327
5998,0.2726071428571429,0,1,0,153320,452290,7597,100359,4.189577235169884,0.18159627539360426
5999,0.2726190476190476,4,10,4,153330,452280,7601,100355,4.189484604839008,0.18159363775367104
6000,0.2726666666666666,4,44,4,153374,452236,7605,100351,4.189077031383156,0.1816021730514833
6001,0.2726818181818182,1,0,1,153374,452236,7606,100350,4.189077031383156,0.18160069201897985
6002,0.2726904761904762,0,1,0,153375,452235,7606,100350,4.1890677683500686,0.18160102065745543
6003,0.2727142857142857,0,4,0,153379,452231,7606,100350,4.189030716217719,0.18160233522325234
6004,0.2727272727272727,0,1,0,153380,452230,7606,100350,4.189021453184631,0.18160266386767526
6005,0.2727366522366523,0,1,0,153381,452229,7606,100350,4.189012190151543,0.18160299251328768
6006,0.2727380952380953,0,2,0,153383,452227,7606,100350,4.188993664085368,0.18160364980808105
6007,0.2727857142857143,0,1,0,153384,452226,7606,100350,4.188984401052281,0.18160397845726198
6008,0.2728333333333333,0,12,0,153396,452214,7606,100350,4.1888732446552295,0.1816079223402176
6009,0.2728529411764705,0,4,0,153400,452210,7606,100350,4.18883619252288,0.181609237005936
6010,0.2728571428571428,2,12,2,153412,452198,7608,100348,4.188725036125829,0.1816102188777043
6011,0.2728888888888888,0,1,0,153413,452197,7608,100348,4.188715773092741,0.18161054755721254
6012,0.2729166666666666,0,3,0,153416,452194,7608,100348,4.1886879839934785,0.18161153360287544
6013,0.2729523809523809,1,0,1,153416,452194,7609,100347,4.1886879839934785,0.1816100524666948
6014,0.2729603174603175,0,1,0,153417,452193,7609,100347,4.188678720960391,0.1816103811488761
6015,0.2729999999999999,2,5,2,153422,452188,7611,100345,4.188632405794953,0.18160906226415435
6016,0.273,1,48,1,153470,452140,7612,100344,4.188187780206751,0.18162335922850253
6017,0.2730238095238095,0,3,0,153473,452137,7612,100344,4.188159991107488,0.1816243454526038
6018,0.2730277777777777,0,2,0,153475,452135,7612,100344,4.188141465041313,0.18162500294128828
6019,0.273047619047619,1,2,1,153477,452133,7613,100343,4.188122938975138,0.18162417914986353
6020,0.2730555555555555,0,1,0,153478,452132,7613,100343,4.18811367594205,0.1816245078962849
6021,0.2730833333333333,0,1,0,153479,452131,7613,100343,4.188104412908963,0.18162483664389636
6022,0.273095238095238,0,3,0,153482,452128,7613,100343,4.1880766238097005,0.18162582289387136
6023,0.2730952380952381,0,2,0,153484,452126,7613,100343,4.188058097743525,0.18162648039980525
6024,0.2730974025974026,0,1,0,153485,452125,7613,100343,4.188048834710438,0.18162680915455737
6025,0.2731190476190476,0,3,0,153488,452122,7613,100343,4.188021045611175,0.18162779542595459
6026,0.2731428571428572,0,2,0,153490,452120,7613,100343,4.188002519545,0.18162845294617014
6027,0.2731547619047619,0,1,0,153491,452119,7613,100343,4.187993256511913,0.18162878170806318
6028,0.2731666666666666,1,13,1,153504,452106,7614,100342,4.187872837081774,0.18163157437442076
6029,0.2731666666666667,0,4,0,153508,452102,7614,100342,4.187835784949423,0.18163288948744127
6030,0.2731904761904761,0,1,0,153509,452101,7614,100342,4.187826521916336,0.18163321826867207
6031,0.2732857142857143,0,1,0,153510,452100,7614,100342,4.187817258883249,0.18163354705109314
6032,0.2733095238095238,0,4,0,153514,452096,7614,100342,4.187780206750898,0.18163486219268044
6033,0.2733333333333332,0,4,0,153518,452092,7614,100342,4.187743154618548,0.1816361773533128
6034,0.2733333333333333,34,474,34,153992,451618,7648,100308,4.183352476935047,0.18174175523530328
6035,0.2733333333333334,17,265,17,154257,451353,7665,100291,4.180897773166846,0.18180384450841486
6036,0.2734285714285714,0,3,0,154260,451350,7665,100291,4.180869984067583,0.1818048332158052
6037,0.2734545454545454,0,1,0,154261,451349,7665,100291,4.180860721034495,0.18180516278732506
6038,0.2734718614718615,0,1,0,154262,451348,7665,100291,4.180851458001408,0.18180549236003982
6039,0.2734999999999999,1,2,1,154264,451346,7666,100290,4.180832931935233,0.18180466829576025
6040,0.2735,0,23,0,154287,451323,7666,100290,4.180619882174219,0.18181224880486863
6041,0.273530303030303,0,2,0,154289,451321,7666,100290,4.180601356108044,0.1818129080094487
6042,0.2735833333333333,0,2,0,154291,451319,7666,100290,4.180582830041869,0.18181356721880898
6043,0.2736111111111111,0,3,0,154294,451316,7666,100290,4.180555040942607,0.18181455604181246
6044,0.2736666666666666,4,32,4,154326,451284,7670,100286,4.180258623883804,0.18181917073082293
6045,0.2736904761904762,0,1,0,154327,451283,7670,100286,4.180249360850717,0.1818195003707605
6046,0.2737142857142857,0,2,0,154329,451281,7670,100286,4.180230834784542,0.18182015965422152
6047,0.27375,0,7,0,154336,451274,7670,100286,4.180165993552929,0.18182246718398723
6048,0.2737619047619047,0,1,0,154337,451273,7670,100286,4.180156730519841,0.18182279683587793
6049,0.2737857142857142,0,1,0,154338,451272,7670,100286,4.180147467486754,0.18182312648896398
6050,0.2737948717948718,0,2,0,154340,451270,7670,100286,4.180128941420579,0.18182378579872216
6051,0.2738095238095238,1,1,1,154341,451269,7671,100285,4.180119678387491,0.1818226320541597
6052,0.2738333333333333,1,21,1,154362,451248,7672,100284,4.179925154692652,0.18182807162594372
6053,0.2738888888888889,0,1,0,154363,451247,7672,100284,4.179915891659565,0.18182840130473174
6054,0.2739285714285714,0,2,0,154365,451245,7672,100284,4.17989736559339,0.18182906066589427
6055,0.2739523809523809,0,2,0,154367,451243,7672,100284,4.179878839527214,0.18182972003183887
6056,0.2739880952380952,1,0,1,154367,451243,7673,100283,4.179878839527214,0.18182823656545657
6057,0.2739999999999999,8,115,8,154482,451128,7681,100275,4.178813590722146,0.18185428806154483
6058,0.274,0,4,0,154486,451124,7681,100275,4.178776538589796,0.1818556072825667
6059,0.2740277777777777,0,1,0,154487,451123,7681,100275,4.178767275556709,0.1818559370908128
6060,0.2740357142857143,0,1,0,154488,451122,7681,100275,4.178758012523621,0.18185626690025516
6061,0.274047619047619,0,3,0,154491,451119,7681,100275,4.178730223424358,0.18185725633575991
6062,0.2740714285714286,0,1,0,154492,451118,7681,100275,4.178720960391271,0.1818575861499874
6063,0.2740952380952381,0,1,0,154493,451117,7681,100275,4.178711697358183,0.18185791596541118
6064,0.2741031746031746,0,2,0,154495,451115,7681,100275,4.178693171292008,0.18185857559984767
6065,0.2741190476190476,0,2,0,154497,451113,7681,100275,4.178674645225833,0.1818592352390694
6066,0.2741666666666666,11,125,11,154622,450988,7692,100264,4.177516766089888,0.18188414735910255
6067,0.2741666666666667,0,2,0,154624,450986,7692,100264,4.177498240023714,0.18188480725623582
6068,0.2741904761904762,0,1,0,154625,450985,7692,100264,4.177488976990626,0.1818851372065981
6069,0.27425,0,2,0,154627,450983,7692,100264,4.177470450924451,0.181885797110914
6070,0.2742857142857142,0,5,0,154632,450978,7692,100264,4.177424135759013,0.18188744689265332
6071,0.2742857142857143,0,14,0,154646,450964,7692,100264,4.177294453295787,0.18189206644074685
6072,0.2743095238095238,0,3,0,154649,450961,7692,100264,4.177266664196525,0.18189305637443876
6073,0.2743333333333333,0,29,0,154678,450932,7692,100264,4.176998036236985,0.18190262628901516
6074,0.2743333333333334,1,4,1,154682,450928,7693,100263,4.176960984104635,0.18190246212293015
6075,0.2743650793650793,0,1,0,154683,450927,7693,100263,4.176951721071548,0.18190279214064115
6076,0.2743809523809524,0,2,0,154685,450925,7693,100263,4.176933195005373,0.1819034521796556
6077,0.2744285714285714,0,1,0,154686,450924,7693,100263,4.176923931972285,0.181903782200959
6078,0.2744444444444444,0,4,0,154690,450920,7693,100263,4.176886879839935,0.1819051022981478
6079,0.2744999999999999,1,9,1,154699,450911,7694,100262,4.176803512542147,0.18190658831256248
6080,0.2745,0,3,0,154702,450908,7694,100262,4.176775723442884,0.18190757842407967
6081,0.2745238095238095,0,2,0,154704,450906,7694,100262,4.176757197376709,0.18190823850441246
6082,0.2745454545454545,0,1,0,154705,450905,7694,100262,4.176747934343622,0.18190856854637524
6083,0.2745555555555555,0,1,0,154706,450904,7694,100262,4.176738671310534,0.18190889858953563
6084,0.2745714285714286,0,2,0,154708,450902,7694,100262,4.176720145244359,0.1819095586794493
6085,0.2745833333333333,0,1,0,154709,450901,7694,100262,4.176710882211271,0.1819098887262026
6086,0.2746153846153846,0,3,0,154712,450898,7694,100262,4.1766830931120085,0.18191087887364832
6087,0.2746190476190476,0,1,0,154713,450897,7694,100262,4.176673830078921,0.1819112089251922
6088,0.2746666666666666,1,36,1,154749,450861,7695,100261,4.176340360887769,0.1819216071940514
6089,0.2746825396825396,0,1,0,154750,450860,7695,100261,4.176331097854682,0.18192193728781883
6090,0.2747142857142857,0,2,0,154752,450858,7695,100261,4.176312571788507,0.18192259747894737
6091,0.27475,0,1,0,154753,450857,7695,100261,4.176303308755418,0.1819229275763085
6092,0.2747619047619047,0,2,0,154755,450855,7695,100261,4.176284782689244,0.18192358777462458
6093,0.2747777777777778,0,1,0,154756,450854,7695,100261,4.176275519656156,0.18192391787557952
6094,0.2747857142857143,0,1,0,154757,450853,7695,100261,4.176266256623069,0.18192424797773238
6095,0.2748333333333333,0,17,0,154774,450836,7695,100261,4.17610878506058,0.1819298598976224
6096,0.2748571428571428,0,3,0,154777,450833,7695,100261,4.176080995961318,0.18193085027236733
6097,0.2748809523809524,0,2,0,154779,450831,7695,100261,4.176062469895142,0.18193151052818768
6098,0.2749047619047619,0,2,0,154781,450829,7695,100261,4.176043943828967,0.1819321707888004
6099,0.2749285714285714,0,1,0,154782,450828,7695,100261,4.17603468079588,0.18193250092090388
6100,0.2749999999999999,2,29,2,154811,450799,7697,100259,4.175766052836341,0.1819391062283825
6101,0.275,89,1346,89,156157,449453,7786,100170,4.163298010300493,0.1822521983250337
6102,0.2750238095238095,0,1,0,156158,449452,7786,100170,4.163288747267405,0.1822525299205636
6103,0.275047619047619,0,2,0,156160,449450,7786,100170,4.1632702212012305,0.18225319311524327
6104,0.2750714285714286,0,1,0,156161,449449,7786,100170,4.163260958168142,0.18225352471439307
6105,0.2751190476190476,0,3,0,156164,449446,7786,100170,4.16323316906888,0.18225451951908242
6106,0.2751666666666666,4,9,4,156173,449437,7790,100166,4.163149801771092,0.1822515524842477
6107,0.275202380952381,0,2,0,156175,449435,7790,100166,4.163131275704917,0.1822522156982975
6108,0.2752380952380952,0,2,0,156177,449433,7790,100166,4.163112749638742,0.18225287891717415
6109,0.2752380952380953,0,2,0,156179,449431,7790,100166,4.163094223572567,0.18225354214087777
6110,0.2752777777777778,0,2,0,156181,449429,7790,100166,4.163075697506391,0.1822542053694084
6111,0.2753030303030303,0,1,0,156182,449428,7790,100166,4.163066434473304,0.18225453698548383
6112,0.2753095238095238,0,1,0,156183,449427,7790,100166,4.163057171440216,0.18225486860276605
6113,0.2753333333333332,0,2,0,156185,449425,7790,100166,4.163038645374042,0.1822555318409508
6114,0.2753333333333333,2,27,2,156212,449398,7792,100164,4.162788543480677,0.18226151007529634
6115,0.2753333333333334,1,8,1,156220,449390,7793,100163,4.162714439215977,0.18226267530156326
6116,0.2753571428571428,1,1,1,156221,449389,7794,100162,4.1627051761828895,0.18226151894910572
6117,0.2754166666666667,1,3,1,156224,449386,7795,100161,4.162677387083627,0.1822610258995136
6118,0.2754545454545454,0,1,0,156225,449385,7795,100161,4.162668124050539,0.1822613575569652
6119,0.2754761904761905,0,4,0,156229,449381,7795,100161,4.162631071918189,0.18226268419884195
6120,0.2754999999999999,0,4,0,156233,449377,7795,100161,4.162594019785839,0.18226401086003152
6121,0.2755,1,19,1,156252,449358,7796,100160,4.162418022157175,0.1822688246790824
6122,0.2755476190476191,0,1,0,156253,449357,7796,100160,4.162408759124087,0.18226915636822882
6123,0.2755555555555555,0,4,0,156257,449353,7796,100160,4.162371706991737,0.18227048313688665
6124,0.2755714285714286,0,1,0,156258,449352,7796,100160,4.16236244395865,0.1822708148320692
6125,0.2755833333333333,0,3,0,156261,449349,7796,100160,4.162334654859388,0.1822718099248602
6126,0.275595238095238,0,1,0,156262,449348,7796,100160,4.1623253918262995,0.1822721416248717
6127,0.2756031746031746,0,1,0,156263,449347,7796,100160,4.162316128793212,0.18227247332609048
6128,0.2756666666666666,5,20,5,156283,449327,7801,100155,4.162130868131461,0.1822716667697941
6129,0.2756666666666667,0,3,0,156286,449324,7801,100155,4.162103079032199,0.18227266192156572
6130,0.2757142857142857,1,15,1,156301,449309,7802,100154,4.161964133535885,0.18227614962244956
6131,0.2757857142857143,0,2,0,156303,449307,7802,100154,4.16194560746971,0.18227681309501492
6132,0.2758333333333332,0,1,0,156304,449306,7802,100154,4.161936344436622,0.18227714483310886
6133,0.2758333333333333,5,85,5,156389,449221,7807,100149,4.16114898662418,0.18229790487285435
6134,0.2758333333333334,6,34,6,156423,449187,7813,100143,4.160834043499204,0.18230025667631478
6135,0.2758571428571428,0,1,0,156424,449186,7813,100143,4.160824780466116,0.182300588536196
6136,0.2758809523809524,0,3,0,156427,449183,7813,100143,4.160796991366853,0.18230158412308903
6137,0.2759523809523809,1,3,1,156430,449180,7814,100142,4.16076920226759,0.18230109116328858
6138,0.2759761904761905,0,1,0,156431,449179,7814,100142,4.160759939234503,0.1823014230295219
6139,0.2759920634920634,0,1,0,156432,449178,7814,100142,4.160750676201415,0.1823017548969635
6140,0.2759999999999999,0,10,0,156442,449168,7814,100142,4.16065804587054,0.18230507363783655
6141,0.276,8,135,8,156577,449033,7822,100134,4.15940753640372,0.18233797733658433
6142,0.276047619047619,1,2,1,156579,449031,7823,100133,4.159389010337545,0.18233715247175708
6143,0.2760714285714286,0,1,0,156580,449030,7823,100133,4.159379747304458,0.18233748449913778
6144,0.2761111111111111,0,2,0,156582,449028,7823,100133,4.1593612212382824,0.18233814855752684
6145,0.2761666666666666,2,16,2,156598,449012,7825,100131,4.159213012708881,0.18234048326210112
6146,0.2761666666666667,0,1,0,156599,449011,7825,100131,4.159203749675794,0.1823408153082445
6147,0.2761904761904761,0,3,0,156602,449008,7825,100131,4.1591759605765315,0.1823418114539306
6148,0.2761904761904762,0,4,0,156606,449004,7825,100131,4.159138908444181,0.18234313966510968
6149,0.2762142857142857,0,1,0,156607,449003,7825,100131,4.1591296454110935,0.18234347172092785
6150,0.27625,0,9,0,156616,448994,7825,100131,4.159046278113306,0.18234646027771453
6151,0.2762857142857142,0,1,0,156617,448993,7825,100131,4.159037015080218,0.18234679234562684
6152,0.2762857142857143,0,2,0,156619,448991,7825,100131,4.159018489014043,0.18234745648507983
6153,0.2763095238095238,1,2,1,156621,448989,7826,100130,4.158999962947868,0.18234663160444275
6154,0.2763333333333333,1,17,1,156638,448972,7827,100129,4.158842491385379,0.18235078792426165
6155,0.2763333333333334,0,2,0,156640,448970,7827,100129,4.158823965319204,0.18235145210608653
6156,0.2763888888888889,0,1,0,156641,448969,7827,100129,4.158814702286117,0.18235178419881332
6157,0.2764285714285714,1,5,1,156646,448964,7828,100128,4.158768387120679,0.1823519555921412
6158,0.2764880952380952,0,1,0,156647,448963,7828,100128,4.158759124087592,0.1823522876900186
6159,0.2764999999999999,0,22,0,156669,448941,7828,100128,4.158555337359665,0.1823595941493692
6160,0.2765,1,2,1,156671,448939,7829,100127,4.15853681129349,0.1823587692554265
6161,0.276547619047619,2,1,2,156672,448938,7831,100125,4.158527548260403,0.18235612306784468
6162,0.2765476190476191,0,1,0,156673,448937,7831,100125,4.158518285227315,0.18235645519085275
6163,0.2765714285714286,0,1,0,156674,448936,7831,100125,4.158509022194227,0.18235678731507063
6164,0.2765833333333333,1,4,1,156678,448932,7832,100124,4.158471970061877,0.1823566266464623
6165,0.2766071428571429,0,1,0,156679,448931,7832,100124,4.158462707028789,0.18235695877462185
6166,0.2766111111111111,0,1,0,156680,448930,7832,100124,4.158453443995702,0.18235729090399122
6167,0.2766190476190476,0,1,0,156681,448929,7832,100124,4.158444180962614,0.18235762303457043
6168,0.2766666666666666,49,730,49,157411,448199,7881,100075,4.1516821668087,0.18252734946395416
6169,0.2766666666666667,0,7,0,157418,448192,7881,100075,4.151617325577087,0.18252967988224716
6170,0.2767142857142857,0,3,0,157421,448189,7881,100075,4.151589536477824,0.18253067865116077
6171,0.2767619047619047,0,1,0,157422,448188,7881,100075,4.151580273444737,0.18253101157656088
6172,0.2767857142857142,0,4,0,157426,448184,7881,100075,4.151543221312386,0.18253234329030624
6173,0.2768095238095238,0,1,0,157427,448183,7881,100075,4.151533958279299,0.1825326762217788
6174,0.2768333333333333,0,11,0,157438,448172,7881,100075,4.151432064915336,0.18253633854813614
6175,0.2768333333333334,0,3,0,157441,448169,7881,100075,4.151404275816073,0.18253733738992128
6176,0.2768571428571428,0,1,0,157442,448168,7881,100075,4.151395012782985,0.18253767033961218
6177,0.2769047619047619,0,2,0,157444,448166,7881,100075,4.151376486716811,0.18253833624263782
6178,0.2769523809523809,0,1,0,157445,448165,7881,100075,4.151367223683723,0.18253866919597256
6179,0.2769642857142857,1,0,1,157445,448165,7882,100074,4.151367223683723,0.18253717812851694
6180,0.276969696969697,0,2,0,157447,448163,7882,100074,4.151348697617548,0.18253784403460546
6181,0.2769963369963369,0,1,0,157448,448162,7882,100074,4.15133943458446,0.1825381769894717
6182,0.2769999999999999,4,53,4,157501,448109,7886,100070,4.15084849383082,0.18254986053825484
6183,0.277,1,5,1,157506,448104,7887,100069,4.150802178665383,0.1825500343869545
6184,0.2770357142857143,0,1,0,157507,448103,7887,100069,4.1507929156322945,0.18255036740293193
6185,0.2770555555555555,0,1,0,157508,448102,7887,100069,4.150783652599207,0.1825507004201244
6186,0.2770833333333333,1,0,1,157508,448102,7888,100068,4.150783652599207,0.18254920918693107
6187,0.2771428571428571,0,17,0,157525,448085,7888,100068,4.150626181036719,0.18255487062918566
6188,0.2771428571428572,0,1,0,157526,448084,7888,100068,4.150616918003631,0.1825552036661364
6189,0.2771666666666667,0,17,0,157543,448067,7888,100068,4.150459446441142,0.1825608654802193
6190,0.2771746031746031,0,2,0,157545,448065,7888,100068,4.150440920374968,0.1825615315990827
6191,0.2771904761904762,0,1,0,157546,448064,7888,100068,4.15043165734188,0.1825618646603373
6192,0.2772142857142857,0,1,0,157547,448063,7888,100068,4.150422394308793,0.18256219772280713
6193,0.27725,0,2,0,157549,448061,7888,100068,4.150403868242617,0.18256286385139264
6194,0.2772857142857143,0,1,0,157550,448060,7888,100068,4.15039460520953,0.18256319691750833
6195,0.2773333333333333,2,57,2,157607,448003,7890,100066,4.149866612323539,0.1825792007940606
6196,0.2773333333333334,0,1,0,157608,448002,7890,100066,4.149857349290452,0.18257953392644707
6197,0.2773809523809524,1,3,1,157611,447999,7891,100065,4.149829560191189,0.18257904186372395
6198,0.2774285714285714,0,1,0,157612,447998,7891,100065,4.149820297158102,0.18257937499885962
6199,0.2774761904761905,0,1,0,157613,447997,7891,100065,4.149811034125014,0.182579708135211
6200,0.2774999999999999,0,8,0,157621,447989,7891,100065,4.149736929860313,0.1825823732697873
6201,0.2775,29,351,29,157972,447638,7920,100036,4.146485605246582,0.18265610563948625
6202,0.2776190476190476,0,8,0,157980,447630,7920,100036,4.146411500981881,0.18265877377817868
6203,0.2776428571428571,0,1,0,157981,447629,7920,100036,4.146402237948794,0.18265910730099605
6204,0.2776547619047619,0,1,0,157982,447628,7920,100036,4.146392974915706,0.1826594408250314
6205,0.2776666666666666,0,1,0,157983,447627,7920,100036,4.146383711882619,0.18265977435028474
6206,0.2776666666666667,5,21,5,158004,447606,7925,100031,4.146189188187781,0.18265931629893525
6207,0.2777359307359307,0,1,0,158005,447605,7925,100031,4.1461799251546925,0.18265964984040495
6208,0.2777380952380952,0,4,0,158009,447601,7925,100031,4.146142873022343,0.18266098401846495
6209,0.27775,0,1,0,158010,447600,7925,100031,4.1461336099892545,0.1826613175660253
6210,0.2777619047619047,0,2,0,158012,447598,7925,100031,4.14611508392308,0.18266198466480044
6211,0.2777777777777777,0,1,0,158013,447597,7925,100031,4.146105820889992,0.18266231821601525
6212,0.2777857142857143,0,1,0,158014,447596,7925,100031,4.146096557856905,0.18266265176844823
6213,0.2778030303030303,0,1,0,158015,447595,7925,100031,4.146087294823817,0.1826629853220994
6214,0.2778333333333332,0,1,0,158016,447594,7925,100031,4.146078031790729,0.18266331887696874
6215,0.2778333333333333,0,7,0,158023,447587,7925,100031,4.146013190559117,0.18266565379516378
6216,0.2778333333333334,0,11,0,158034,447576,7925,100031,4.145911297195154,0.18266932307293368
6217,0.2778571428571428,0,8,0,158042,447568,7925,100031,4.145837192930453,0.18267199173117554
6218,0.2779166666666666,0,2,0,158044,447566,7925,100031,4.145818666864278,0.1826726589079195
6219,0.2779166666666667,0,3,0,158047,447563,7925,100031,4.145790877765015,0.18267365968217328
6220,0.2779444444444444,0,1,0,158048,447562,7925,100031,4.145781614731928,0.182673993276028
6221,0.2779761904761904,0,2,0,158050,447560,7925,100031,4.145763088665753,0.18267466046739264
6222,0.2779772727272727,0,1,0,158051,447559,7925,100031,4.145753825632665,0.18267499406490256
6223,0.2779999999999999,0,7,0,158058,447552,7925,100031,4.145688984401052,0.18267732928158836
6224,0.278,6,100,6,158158,447452,7931,100025,4.144762681092297,0.18270173906849055
6225,0.2780238095238095,0,3,0,158161,447449,7931,100025,4.144734891993034,0.18270274022145344
6226,0.2780357142857143,0,1,0,158162,447448,7931,100025,4.144725628959947,0.18270307394154597
6227,0.2780833333333333,0,1,0,158163,447447,7931,100025,4.144716365926859,0.18270340766285764
6228,0.2780952380952381,1,2,1,158165,447445,7932,100024,4.144697839860684,0.18270258224666602
6229,0.2781666666666666,0,3,0,158168,447442,7932,100024,4.144670050761421,0.182703583418879
6230,0.2781666666666667,1,21,1,158189,447421,7933,100023,4.144475527066582,0.18270909901286708
6231,0.2782142857142857,0,4,0,158193,447417,7933,100023,4.1444384749342325,0.1827104340201666
6232,0.2782222222222222,0,4,0,158197,447413,7933,100023,4.144401422801883,0.18271176904697536
6233,0.27825,1,3,1,158200,447410,7934,100022,4.14437363370262,0.18271127738239634
6234,0.2782575757575757,1,0,1,158200,447410,7935,100021,4.14437363370262,0.1827097844294532
6235,0.2782739205239204,1,4,1,158204,447406,7936,100020,4.144336581570269,0.18270962650659633
6236,0.2782777777777778,0,1,0,158205,447405,7936,100020,4.144327318537182,0.18270996026852993
6237,0.2782857142857143,0,1,0,158206,447404,7936,100020,4.144318055504094,0.18271029403168293
6238,0.2783095238095238,0,2,0,158208,447402,7936,100020,4.1442995294379195,0.18271096156164715
6239,0.2783333333333332,0,2,0,158210,447400,7936,100020,4.144281003371744,0.182711629096489
6240,0.2783333333333333,26,260,26,158470,447140,7962,99994,4.14187261476898,0.18275961647420924
6241,0.2783333333333334,19,145,19,158615,446995,7981,99975,4.140529474971284,0.18277967713037277
6242,0.2783809523809524,0,1,0,158616,446994,7981,99975,4.140520211938197,0.18278001129862936
6243,0.2783910533910534,0,2,0,158618,446992,7981,99975,4.140501685872022,0.1827806796388082
6244,0.2784126984126984,0,4,0,158622,446988,7981,99975,4.140464633739672,0.1827820163338288
6245,0.2784285714285714,0,2,0,158624,446986,7981,99975,4.140446107673497,0.18278268468867068
6246,0.2784523809523809,0,1,0,158625,446985,7981,99975,4.140436844640409,0.18278301886792453
6247,0.278452380952381,0,1,0,158626,446984,7981,99975,4.140427581607321,0.18278335304840035
6248,0.2784545454545454,0,3,0,158629,446981,7981,99975,4.140399792508059,0.18278435559715955
6249,0.2784999999999999,0,4,0,158633,446977,7981,99975,4.140362740375709,0.18278569234594627
6250,0.2785,5,13,5,158646,446964,7986,99970,4.14024232094557,0.1827825660865845
6251,0.2785248917748917,0,1,0,158647,446963,7986,99970,4.140233057912483,0.18278290028211866
6252,0.2785357142857142,0,1,0,158648,446962,7986,99970,4.140223794879395,0.1827832344788749
6253,0.2785714285714286,1,4,1,158652,446958,7987,99969,4.140186742747045,0.18278307708341332
6254,0.2785833333333333,0,4,0,158656,446954,7987,99969,4.140149690614695,0.1827844138937291
6255,0.2786666666666666,2,11,2,158667,446943,7989,99967,4.140047797250732,0.18278510175348778
6256,0.2786666666666667,3,28,3,158695,446915,7992,99964,4.139788432324281,0.18278997730759455
6257,0.2786904761904762,0,2,0,158697,446913,7992,99964,4.139769906258105,0.18279064579420967
6258,0.2787142857142857,0,1,0,158698,446912,7992,99964,4.139760643225018,0.1827909800393508
6259,0.27875,0,2,0,158700,446910,7992,99964,4.139742117158843,0.18279164853330018
6260,0.2787619047619047,0,1,0,158701,446909,7992,99964,4.1397328541257545,0.18279198278210845
6261,0.2787698412698413,0,2,0,158703,446907,7992,99964,4.13971432805958,0.18279265128339225
6262,0.2788095238095238,0,1,0,158704,446906,7992,99964,4.139705065026492,0.18279298553586776
6263,0.2788333333333332,0,1,0,158705,446905,7992,99964,4.139695801993405,0.1827933197895657
6264,0.2788333333333333,1,3,1,158708,446902,7993,99963,4.139668012894142,0.18279282821171586
6265,0.2788333333333334,0,1,0,158709,446901,7993,99963,4.139658749861055,0.18279316246818222
6266,0.2788888888888889,0,1,0,158710,446900,7993,99963,4.139649486827967,0.182793496725871
6267,0.278904761904762,0,3,0,158713,446897,7993,99963,4.139621697728704,0.18279449950627216
6268,0.2789166666666667,0,1,0,158714,446896,7993,99963,4.139612434695617,0.18279483376885083
6269,0.2789523809523809,0,2,0,158716,446894,7993,99963,4.1395939086294415,0.18279550229767563
6270,0.2789999999999999,1,49,1,158765,446845,7994,99962,4.139140020008152,0.18281038830885485
6271,0.279,0,7,0,158772,446838,7994,99962,4.1390751787765385,0.1828127286027798
6272,0.279047619047619,1,5,1,158777,446833,7995,99961,4.139028863611101,0.1828129057743867
6273,0.2790476190476191,0,1,0,158778,446832,7995,99961,4.139019600578013,0.18281324011097436
6274,0.2791666666666666,10,59,10,158837,446773,8005,99951,4.138473081625848,0.1828180215245718
6275,0.2791666666666667,2,55,2,158892,446718,8007,99949,4.137963614806032,0.18283342510157005
6276,0.2791916971916972,0,1,0,158893,446717,8007,99949,4.137954351772945,0.1828337595533653
6277,0.27925,0,2,0,158895,446715,8007,99949,4.137935825706769,0.18283442846062664
6278,0.2792857142857142,0,9,0,158904,446706,8007,99949,4.1378524584089815,0.18283743860387264
6279,0.2792857142857143,1,6,1,158910,446700,8008,99948,4.137796880210456,0.1828379505641656
6280,0.2793333333333333,3,43,3,158953,446657,8011,99945,4.137398569787691,0.1828478490748296
6281,0.2793333333333334,1,20,1,158973,446637,8012,99944,4.13721330912594,0.18285304465394883
6282,0.2794285714285714,0,1,0,158974,446636,8012,99944,4.137204046092853,0.1828533791942625
6283,0.2794444444444444,0,2,0,158976,446634,8012,99944,4.137185520026677,0.18285404827856225
6284,0.2794479789216631,0,2,0,158978,446632,8012,99944,4.137166993960502,0.18285471736775855
6285,0.2794523809523809,0,3,0,158981,446629,8012,99944,4.137139204861239,0.18285572101073416
6286,0.2794642857142857,0,1,0,158982,446628,8012,99944,4.137129941828152,0.18285605556084103
6287,0.2794722222222222,0,1,0,158983,446627,8012,99944,4.137120678795065,0.18285639011217206
6288,0.2794761904761904,0,1,0,158984,446626,8012,99944,4.137111415761977,0.1828567246647273
6289,0.2794999999999999,1,19,1,159003,446607,8013,99943,4.136935418133314,0.18286158631415242
6290,0.2795,0,2,0,159005,446605,8013,99943,4.136916892067139,0.18286225546521073
6291,0.279515873015873,0,1,0,159006,446604,8013,99943,4.1369076290340505,0.1828625900425764
6292,0.2795238095238095,0,4,0,159010,446600,8013,99943,4.136870576901701,0.18286392836428242
6293,0.279547619047619,0,2,0,159012,446598,8013,99943,4.136852050835525,0.18286459753248155
6294,0.2795833333333333,0,5,0,159017,446593,8013,99943,4.136805735670088,0.18286627047440607
6295,0.279595238095238,0,1,0,159018,446592,8013,99943,4.136796472637,0.18286660506646418
6296,0.2796190476190476,1,2,1,159020,446590,8014,99942,4.136777946570825,0.18286577913095664
6297,0.2796428571428571,0,1,0,159021,446589,8014,99942,4.1367686835377375,0.18286611372456457
6298,0.2796587301587301,0,1,0,159022,446588,8014,99942,4.13675942050465,0.1828664483193969
6299,0.2796666666666667,0,18,0,159040,446570,8014,99942,4.136592685909074,0.18287247123576428
6300,0.2796904761904761,0,2,0,159042,446568,8014,99942,4.136574159842899,0.1828731404731844
6301,0.2797222222222222,0,1,0,159043,446567,8014,99942,4.136564896809811,0.1828734750937313
6302,0.27975,0,1,0,159044,446566,8014,99942,4.136555633776724,0.1828738097155028
6303,0.2797619047619047,0,2,0,159046,446564,8014,99942,4.136537107710549,0.18287447896271952
6304,0.2798333333333333,1,16,1,159062,446548,8015,99941,4.1363888991811475,0.1828783378988415
6305,0.2798333333333334,0,1,0,159063,446547,8015,99941,4.13637963614806,0.18287867254175755
6306,0.2798571428571428,0,1,0,159064,446546,8015,99941,4.136370373114973,0.18287900718589828
6307,0.2798611111111111,0,1,0,159065,446545,8015,99941,4.136361110081885,0.18287934183126375
6308,0.2798690476190476,0,1,0,159066,446544,8015,99941,4.136351847048798,0.18287967647785391
6309,0.2798809523809524,0,1,0,159067,446543,8015,99941,4.13634258401571,0.18288001112566882
6310,0.2799166666666666,0,2,0,159069,446541,8015,99941,4.136324057949535,0.18288068042497282
6311,0.2799206349206349,0,1,0,159070,446540,8015,99941,4.136314794916448,0.18288101507646196
6312,0.2799444444444444,0,1,0,159071,446539,8015,99941,4.13630553188336,0.18288134972917583
6313,0.2799523809523809,0,1,0,159072,446538,8015,99941,4.1362962688502725,0.18288168438311445
6314,0.2799999999999999,3,40,3,159112,446498,8018,99938,4.135925747526771,0.18289058553975213
6315,0.28,249,3784,249,162896,442714,8267,99689,4.100874430323465,0.1837913875845082
6316,0.2800357142857143,0,2,0,162898,442712,8267,99689,4.10085590425729,0.18379206528011563
6317,0.2801666666666666,1,1,1,162899,442711,8268,99688,4.100846641224202,0.18379089931950465
6318,0.2801666666666667,2,12,2,162911,442699,8270,99686,4.100735484827152,0.1837919558984854
6319,0.2802380952380952,0,3,0,162914,442696,8270,99686,4.100707695727889,0.18379297248065016
6320,0.2802619047619047,0,1,0,162915,442695,8270,99686,4.100698432694801,0.1837933113438708
6321,0.2802777777777778,0,1,0,162916,442694,8270,99686,4.100689169661714,0.18379365020834101
6322,0.2802857142857143,0,1,0,162917,442693,8270,99686,4.100679906628627,0.18379398907406075
6323,0.2803333333333332,0,1,0,162918,442692,8270,99686,4.100670643595539,0.18379432794103007
6324,0.2803333333333333,2,17,2,162935,442675,8272,99684,4.10051317203305,0.1837970790564921
6325,0.2803333333333334,0,1,0,162936,442674,8272,99684,4.100503908999963,0.18379741794165477
6326,0.2803571428571428,0,5,0,162941,442669,8272,99684,4.100457593834525,0.1837991123862134
6327,0.2803809523809524,0,2,0,162943,442667,8272,99684,4.10043906776835,0.18379979017278478
6328,0.2804166666666667,0,1,0,162944,442666,8272,99684,4.1004298047352625,0.18380012906794505
6329,0.2804761904761905,0,3,0,162947,442663,8272,99684,4.100402015636,0.18380114576092427
6330,0.2805,0,19,0,162966,442644,8272,99684,4.100226018007336,0.18380758507766518
6331,0.280547619047619,2,3,2,162969,442641,8274,99682,4.100198228908074,0.18380559187052734
6332,0.280595238095238,0,1,0,162970,442640,8274,99682,4.100188965874986,0.1838059307938826
6333,0.2806666666666666,0,6,0,162976,442634,8274,99682,4.100133387676461,0.18380796436026228
6334,0.2806666666666667,3,41,3,163017,442593,8277,99679,4.099753603319871,0.18381734627640742
6335,0.2807142857142857,0,6,0,163023,442587,8277,99679,4.099698025121346,0.1838193801566021
6336,0.2807380952380953,0,1,0,163024,442586,8277,99679,4.099688762088258,0.1838197191410104
6337,0.28075,0,3,0,163027,442583,8277,99679,4.099660972988995,0.1838207361017368
6338,0.2807777777777778,0,1,0,163028,442582,8277,99679,4.099651709955908,0.18382107509114615
6339,0.2808095238095238,0,1,0,163029,442581,8277,99679,4.099642446922821,0.18382141408180577
6340,0.2808333333333332,0,1,0,163030,442580,8277,99679,4.099633183889733,0.1838217530737157
6341,0.2808333333333333,9,88,9,163118,442492,8286,99670,4.098818036978028,0.18383804102832732
6342,0.2808333333333334,4,44,4,163162,442448,8290,99666,4.098410463522176,0.18384693994252133
6343,0.2808888888888889,0,1,0,163163,442447,8290,99666,4.098401200489088,0.18384727907281323
6344,0.2809523809523809,0,5,0,163168,442442,8290,99666,4.09835488532365,0.18384897474304013
6345,0.280952380952381,0,1,0,163169,442441,8290,99666,4.098345622290563,0.18384931388083903
6346,0.2809999999999999,0,6,0,163175,442435,8290,99666,4.098290044092037,0.18385134873390752
6347,0.281,2,70,2,163245,442365,8292,99664,4.097641631775908,0.18387208064513152
6348,0.281047619047619,0,2,0,163247,442363,8292,99664,4.097623105709734,0.18387275910609618
6349,0.281060606060606,0,2,0,163249,442361,8292,99664,4.0976045796435585,0.1838734375720677
6350,0.2810714285714286,0,4,0,163253,442357,8292,99664,4.097567527511209,0.18387479451903155
6351,0.2810833333333333,0,1,0,163254,442356,8292,99664,4.0975582644781205,0.18387513375890188
6352,0.2811190476190476,0,1,0,163255,442355,8292,99664,4.097549001445033,0.183875473000024
6353,0.2811428571428571,0,2,0,163257,442353,8292,99664,4.097530475378858,0.18387615148602351
6354,0.2811666666666666,0,6,0,163263,442347,8292,99664,4.097474897180333,0.1838781869740651
6355,0.2811666666666667,1,4,1,163267,442343,8293,99663,4.097437845047983,0.18387803825049906
6356,0.2811904761904761,0,2,0,163269,442341,8293,99663,4.097419318981808,0.1838787167622379
6357,0.2812222222222222,0,2,0,163271,442339,8293,99663,4.097400792915632,0.1838793952789842
6358,0.28125,0,4,0,163275,442335,8293,99663,4.097363740783282,0.18388075232749937
6359,0.2812619047619047,1,1,1,163276,442334,8294,99662,4.097354477750194,0.18387958582720168
6360,0.2812857142857143,0,4,0,163280,442330,8294,99662,4.097317425617844,0.18388094289214602
6361,0.2813095238095238,1,5,1,163285,442325,8295,99661,4.097271110452406,0.1838811334610119
6362,0.2813333333333332,0,1,0,163286,442324,8295,99661,4.097261847419319,0.18388147273448527
6363,0.2813333333333333,3,20,3,163306,442304,8298,99658,4.097076586757568,0.18388374092648563
6364,0.2813333333333334,0,4,0,163310,442300,8298,99658,4.0970395346252175,0.1838850981072334
6365,0.2813406593406594,0,1,0,163311,442299,8298,99658,4.09703027159213,0.18388543740555063
6366,0.2813571428571428,0,2,0,163313,442297,8298,99658,4.097011745525955,0.18388611600594146
6367,0.2814166666666666,0,1,0,163314,442296,8298,99658,4.097002482492868,0.18388645530801506
6368,0.2814166666666667,0,1,0,163315,442295,8298,99658,4.09699321945978,0.18388679461134083
6369,0.2814285714285713,0,1,0,163316,442294,8298,99658,4.096983956426692,0.18388713391591877
6370,0.2814285714285714,0,5,0,163321,442289,8298,99658,4.096937641261254,0.18388883045759088
6371,0.2814523809523809,0,1,0,163322,442288,8298,99658,4.096928378228167,0.18388916976968184
6372,0.2814761904761905,0,1,0,163323,442287,8298,99658,4.09691911519508,0.18388950908302504
6373,0.2815,3,32,3,163355,442255,8301,99655,4.096622698136278,0.18389584986436863
6374,0.281547619047619,0,5,0,163360,442250,8301,99655,4.09657638297084,0.18389754661794963
6375,0.2816082251082252,0,1,0,163361,442249,8301,99655,4.0965671199377525,0.18389788597242315
6376,0.2816428571428571,0,1,0,163362,442248,8301,99655,4.096557856904665,0.18389822532814915
6377,0.2816666666666666,14,181,14,163543,442067,8315,99641,4.094881247915818,0.18393857945609074
6378,0.2816666666666667,24,246,24,163789,441821,8339,99617,4.092602541776279,0.1839859780805928
6379,0.2817142857142857,0,1,0,163790,441820,8339,99617,4.092593278743192,0.18398631789109351
6380,0.2817619047619047,0,1,0,163791,441819,8339,99617,4.092584015710104,0.18398665770284947
6381,0.2817777777777777,0,1,0,163792,441818,8339,99617,4.092574752677017,0.18398699751586062
6382,0.2817857142857142,0,6,0,163798,441812,8339,99617,4.0925191744784915,0.1839890364202878
6383,0.2817857142857143,0,1,0,163799,441811,8339,99617,4.092509911445403,0.18398937624208575
6384,0.2818333333333333,1,14,1,163813,441797,8340,99616,4.092380228982178,0.18399262670087346
6385,0.2818333333333334,1,3,1,163816,441794,8341,99615,4.092352439882915,0.18399213902982772
6386,0.2818690476190476,0,1,0,163817,441793,8341,99615,4.092343176849828,0.18399247886990958
6387,0.2818809523809523,1,2,1,163819,441791,8342,99614,4.092324650783652,0.183991651351576
6388,0.2818888888888889,0,1,0,163820,441790,8342,99614,4.092315387750565,0.18399199119326787
6389,0.2819047619047619,0,3,0,163823,441787,8342,99614,4.0922875986513025,0.183993010725876
6390,0.2819166666666666,0,3,0,163826,441784,8342,99614,4.09225980955204,0.18399403026978303
6391,0.282,4,93,4,163919,441691,8346,99610,4.091398347474898,0.18401961200884537
6392,0.2820238095238095,1,1,1,163920,441690,8347,99609,4.0913890844418095,0.18401844451957236
6393,0.2820277777777777,0,2,0,163922,441688,8347,99609,4.091370558375634,0.1840191244363076
6394,0.282047619047619,0,1,0,163923,441687,8347,99609,4.091361295342547,0.18401946439655936
6395,0.282060606060606,0,1,0,163924,441686,8347,99609,4.09135203230946,0.18401980435806722
6396,0.2820689033189033,0,1,0,163925,441685,8347,99609,4.0913427692763715,0.1840201443208312
6397,0.2820833333333333,0,3,0,163928,441682,8347,99609,4.091314980177109,0.1840211642166598
6398,0.282095238095238,0,1,0,163929,441681,8347,99609,4.091305717144022,0.18402150418444826
6399,0.2821428571428571,0,5,0,163934,441676,8347,99609,4.091259401978584,0.18402320404223282
6400,0.2821666666666667,0,6,0,163940,441670,8347,99609,4.0912038237800585,0.1840252439130282
6401,0.2822222222222222,0,1,0,163941,441669,8347,99609,4.091194560746971,0.18402558389589083
6402,0.2822619047619047,0,1,0,163942,441668,8347,99609,4.091185297713883,0.18402592388000968
6403,0.2823333333333333,2,29,2,163971,441639,8349,99607,4.090916669754344,0.18403276883339553
6404,0.2823809523809524,0,8,0,163979,441631,8349,99607,4.090842565489644,0.18403548900853228
6405,0.2824166666666666,0,1,0,163980,441630,8349,99607,4.090833302456557,0.18403582903607846
6406,0.2824285714285714,0,2,0,163982,441628,8349,99607,4.090814776390381,0.18403650909494026
6407,0.2824523809523809,0,1,0,163983,441627,8349,99607,4.090805513357294,0.18403684912625592
6408,0.2825,21,387,21,164370,441240,8370,99586,4.08722071955241,0.18413685732564633
6409,0.2825238095238095,0,1,0,164371,441239,8370,99586,4.087211456519323,0.18413719779965793
6410,0.2825634920634921,0,1,0,164372,441238,8370,99586,4.0872021934862355,0.18413753827492862
6411,0.2826150793650794,0,2,0,164374,441236,8370,99586,4.08718366742006,0.18413821922924734
6412,0.2826190476190476,0,3,0,164377,441233,8370,99586,4.0871558783207975,0.18413924067016876
6413,0.2826666666666666,0,2,0,164379,441231,8370,99586,4.087137352254622,0.1841399216370787
6414,0.2826666666666667,4,48,4,164427,441183,8374,99582,4.08669272666642,0.18415023161632132
6415,0.2827222222222222,0,6,0,164433,441177,8374,99582,4.0866371484678945,0.18415227485811608
6416,0.2827777777777777,1,0,1,164433,441177,8375,99581,4.0866371484678945,0.18415076614677914
6417,0.2827777777777778,0,2,0,164435,441175,8375,99581,4.086618622401719,0.18415144723313287
6418,0.2828333333333333,2,5,2,164440,441170,8377,99579,4.086572307236281,0.18415013250140083
6419,0.2828333333333334,1,0,1,164440,441170,8378,99578,4.086572307236281,0.1841486237582016
6420,0.2828571428571428,2,15,2,164455,441155,8380,99576,4.086433361739968,0.18415071449574744
6421,0.2829047619047619,0,1,0,164456,441154,8380,99576,4.086424098706881,0.18415105505520316
6422,0.2829166666666666,0,2,0,164458,441152,8380,99576,4.086405572640706,0.18415173617789352
6423,0.2829166666666667,0,4,0,164462,441148,8380,99576,4.086368520508355,0.18415309843839
6424,0.2829444444444444,0,1,0,164463,441147,8380,99576,4.086359257475268,0.1841534390066633
6425,0.2829523809523809,1,4,1,164467,441143,8381,99575,4.086322205342918,0.18415329247408077
6426,0.2829545454545454,0,1,0,164468,441142,8381,99575,4.08631294230983,0.18415363304649196
6427,0.2829563492063491,0,2,0,164470,441140,8381,99575,4.086294416243655,0.18415431419509354
6428,0.2829761904761905,0,1,0,164471,441139,8381,99575,4.086285153210567,0.1841546547712839
6429,0.283,1,43,1,164514,441096,8382,99574,4.085886842787803,0.1841677918138606
6430,0.2830555555555555,0,2,0,164516,441094,8382,99574,4.085868316721627,0.18416847307404913
6431,0.2830952380952381,0,3,0,164519,441091,8382,99574,4.085840527622365,0.1841694949737823
6432,0.2831080586080586,0,2,0,164521,441089,8382,99574,4.085822001556189,0.18417017624657134
6433,0.2831428571428571,0,1,0,164522,441088,8382,99574,4.085812738523102,0.18417051688485597
6434,0.2831601731601731,0,1,0,164523,441087,8382,99574,4.085803475490015,0.18417085752440068
6435,0.2831666666666666,1,4,1,164527,441083,8383,99573,4.085766423357664,0.18417071113610134
6436,0.2831666666666667,0,8,0,164535,441075,8383,99573,4.0856923190929635,0.18417343632085942
6437,0.283202380952381,0,2,0,164537,441073,8383,99573,4.085673793026789,0.18417411762965047
6438,0.2832142857142857,0,2,0,164539,441071,8383,99573,4.085655266960614,0.1841747989434822
6439,0.2832380952380953,0,1,0,164540,441070,8383,99573,4.085646003927526,0.18417513960228837
6440,0.28325,1,1,1,164541,441069,8384,99572,4.085636740894438,0.18417397126743995
6441,0.2832857142857143,1,0,1,164541,441069,8385,99571,4.085636740894438,0.1841724622669429
6442,0.2833333333333332,1,5,1,164546,441064,8386,99570,4.085590425729,0.18417265654768292
6443,0.2833333333333333,35,514,35,165060,440550,8421,99535,4.080829226721998,0.18429506466574705
6444,0.2833333333333334,22,262,22,165322,440288,8443,99513,4.078402312053059,0.18435127019031086
6445,0.2833452380952381,0,1,0,165323,440287,8443,99513,4.078393049019971,0.18435161170804001
6446,0.2833571428571428,0,2,0,165325,440285,8443,99513,4.078374522953796,0.18435229474729437
6447,0.2834523809523809,0,1,0,165326,440284,8443,99513,4.078365259920709,0.18435263626881956
6448,0.2835,3,24,3,165350,440260,8446,99510,4.078142947126607,0.1843562999055153
6449,0.2835079365079365,0,1,0,165351,440259,8446,99510,4.07813368409352,0.18435664145217676
6450,0.2835238095238095,0,1,0,165352,440258,8446,99510,4.078124421060432,0.18435698300010375
6451,0.2835714285714286,0,7,0,165359,440251,8446,99510,4.078059579828819,0.1843593738710281
6452,0.2835873015873015,1,0,1,165359,440251,8447,99509,4.078059579828819,0.18435786275381652
6453,0.2836666666666666,2,8,2,165367,440243,8449,99507,4.077985475564119,0.18435757295044003
6454,0.2836666666666667,1,14,1,165381,440229,8450,99506,4.077855793100893,0.18436084374739456
6455,0.2836904761904761,0,4,0,165385,440225,8450,99506,4.077818740968543,0.18436221006390222
6456,0.28375,1,6,1,165391,440219,8451,99505,4.077763162770017,0.18436274836768424
6457,0.2837619047619047,1,1,1,165392,440218,8452,99504,4.07775389973693,0.184361578738684
6458,0.2837777777777777,0,1,0,165393,440217,8452,99504,4.077744636703843,0.1843619203255015
6459,0.2837857142857143,0,2,0,165395,440215,8452,99504,4.077726110637667,0.18436260350293393
6460,0.2838095238095238,0,8,0,165403,440207,8452,99504,4.077652006372967,0.18436533626329646
6461,0.2838333333333333,1,2,1,165405,440205,8453,99503,4.077633480306791,0.18436450821555359
6462,0.2838571428571428,0,2,0,165407,440203,8453,99503,4.077614954240617,0.18436519141903185
6463,0.2838787878787878,0,1,0,165408,440202,8453,99503,4.077605691207529,0.18436553302266978
6464,0.2838888888888889,0,1,0,165409,440201,8453,99503,4.0775964281744415,0.18436587462757364
6465,0.2838928571428571,0,3,0,165412,440198,8453,99503,4.077568639075179,0.18436689944988058
6466,0.2839285714285714,0,3,0,165415,440195,8453,99503,4.077540849975916,0.18436792428358081
6467,0.2839285714285715,0,1,0,165416,440194,8453,99503,4.077531586942828,0.1843682658973461
6468,0.2839523809523809,0,1,0,165417,440193,8453,99503,4.077522323909741,0.18436860751237732
6469,0.2839761904761904,0,1,0,165418,440192,8453,99503,4.077513060876654,0.18436894912867452
6470,0.284,3,149,3,165567,440043,8456,99500,4.076132868946608,0.1844153292694002
6471,0.2840238095238094,0,2,0,165569,440041,8456,99500,4.076114342880433,0.18441601287019893
6472,0.284047619047619,0,2,0,165571,440039,8456,99500,4.076095816814258,0.18441669647606568
6473,0.2840555555555555,0,1,0,165572,440038,8456,99500,4.07608655378117,0.1844170382808996
6474,0.2840833333333333,0,1,0,165573,440037,8456,99500,4.076077290748082,0.1844173800870005
6475,0.284095238095238,0,2,0,165575,440035,8456,99500,4.076058764681908,0.1844180637030035
6476,0.2841666666666666,10,67,10,165642,439968,8466,99490,4.075438141465042,0.18442584964909223
6477,0.2841666666666667,7,79,7,165721,439889,8473,99483,4.074706361851124,0.1844422773150998
6478,0.2841904761904761,0,2,0,165723,439887,8473,99483,4.07468783578495,0.18444296123254908
6479,0.2841904761904762,0,1,0,165724,439886,8473,99483,4.0746785727518615,0.18444330319317573
6480,0.2842142857142857,0,2,0,165726,439884,8473,99483,4.074660046685687,0.18444398711823304
6481,0.2842380952380952,0,1,0,165727,439883,8473,99483,4.074650783652599,0.18444432908266373
6482,0.2842857142857142,1,8,1,165735,439875,8474,99482,4.074576679387898,0.18444555276004576
6483,0.2842857142857143,1,15,1,165750,439860,8475,99481,4.074437733891585,0.18444917037644087
6484,0.2843333333333333,3,33,3,165783,439827,8478,99478,4.074132053799696,0.18445592011941295
6485,0.2843333333333334,1,8,1,165791,439819,8479,99477,4.074057949534995,0.18445714412864178
6486,0.2843350815850815,0,1,0,165792,439818,8479,99477,4.074048686501908,0.18445748616248991
6487,0.2843809523809524,0,1,0,165793,439817,8479,99477,4.074039423468821,0.1844578281976065
6488,0.2844047619047619,0,3,0,165796,439814,8479,99477,4.074011634369558,0.18445885431056702
6489,0.2844343434343434,0,1,0,165797,439813,8479,99477,4.07400237133647,0.18445919635075747
6490,0.2844444444444444,0,1,0,165798,439812,8479,99477,4.073993108303383,0.1844595383922164
6491,0.2844761904761904,0,2,0,165800,439810,8479,99477,4.0739745822372075,0.18446022247893978
6492,0.2845,5,14,5,165814,439796,8484,99472,4.073844899773982,0.18445744972815
6493,0.2845238095238095,1,2,1,165816,439794,8485,99471,4.073826373707807,0.18445662151261438
6494,0.2845454545454545,0,1,0,165817,439793,8485,99471,4.073817110674719,0.18445696356515548
6495,0.2845833333333333,0,3,0,165820,439790,8485,99471,4.073789321575457,0.1844579897303903
6496,0.2846428571428571,0,3,0,165823,439787,8485,99471,4.073761532476194,0.18445901590704264
6497,0.2846666666666666,1,8,1,165831,439779,8486,99470,4.073687428211493,0.1844602400746223
6498,0.2846666666666667,1,24,1,165855,439755,8487,99469,4.073465115417393,0.18446693767339734
6499,0.2846969696969696,0,1,0,165856,439754,8487,99469,4.0734558523843045,0.18446727977107802
6500,0.2847142857142857,0,1,0,165857,439753,8487,99469,4.073446589351217,0.18446762187002755
6501,0.2847272727272727,0,1,0,165858,439752,8487,99469,4.07343732631813,0.18446796397024598
6502,0.284734126984127,0,1,0,165859,439751,8487,99469,4.073428063285042,0.18446830607173326
6503,0.28475,0,1,0,165860,439750,8487,99469,4.073418800251955,0.1844686481744894
6504,0.2847619047619047,1,4,1,165864,439746,8488,99468,4.073381748119604,0.18446850415604937
6505,0.2847857142857142,0,1,0,165865,439745,8488,99468,4.073372485086517,0.18446884626297957
6506,0.2848333333333332,0,1,0,165866,439744,8488,99468,4.0733632220534295,0.18446918837117868
6507,0.2848333333333333,0,9,0,165875,439735,8488,99468,4.073279854755641,0.18447226740207306
6508,0.2848333333333334,0,2,0,165877,439733,8488,99468,4.073261328689466,0.18447295164511934
6509,0.2848571428571428,0,1,0,165878,439732,8488,99468,4.073252065656378,0.184473293768546
6510,0.2849523809523809,1,3,1,165881,439729,8489,99467,4.073224276557116,0.1844728076617779
6511,0.285,107,1386,107,167267,438343,8596,99360,4.060385712697766,0.18478602499893063
6512,0.285047619047619,0,1,0,167268,438342,8596,99360,4.060376449664679,0.18478636865773235
6513,0.2850595238095238,0,1,0,167269,438341,8596,99360,4.0603671866315905,0.18478671231781232
6514,0.2851190476190476,0,1,0,167270,438340,8596,99360,4.060357923598503,0.18478705597917053
6515,0.2851282051282051,0,1,0,167271,438339,8596,99360,4.060348660565415,0.18478739964180704
6516,0.2851428571428571,0,2,0,167273,438337,8596,99360,4.060330134499241,0.18478808697091484
6517,0.2851515151515151,0,1,0,167274,438336,8596,99360,4.0603208714661525,0.18478843063738618
6518,0.2851666666666666,0,5,0,167279,438331,8596,99360,4.060274556300715,0.18479014898891744
6519,0.2851666666666667,1,7,1,167286,438324,8597,99359,4.060209715069102,0.1847910385859326
6520,0.2852222222222222,0,1,0,167287,438323,8597,99359,4.060200452036015,0.18479138226684175
6521,0.2852380952380952,0,2,0,167289,438321,8597,99359,4.0601819259698395,0.18479206963249517
6522,0.2852424242424242,0,1,0,167290,438320,8597,99359,4.060172662936752,0.18479241331723947
6523,0.2852777777777778,0,1,0,167291,438319,8597,99359,4.060163399903664,0.18479275700326217
6524,0.2852857142857143,0,3,0,167294,438316,8597,99359,4.0601356108044016,0.1847937880690008
6525,0.2853095238095238,0,1,0,167295,438315,8597,99359,4.060126347771314,0.18479413176013718
6526,0.2853333333333333,4,33,4,167328,438282,8601,99355,4.059820667679425,0.18479940926684735
6527,0.2853571428571428,0,1,0,167329,438281,8601,99355,4.059811404646338,0.18479975299273113
6528,0.2853690476190476,0,1,0,167330,438280,8601,99355,4.0598021416132495,0.18480009671989361
6529,0.2853821733821734,0,2,0,167332,438278,8601,99355,4.059783615547075,0.18480078417805454
6530,0.2854047619047619,0,1,0,167333,438277,8601,99355,4.059774352513987,0.18480112790905304
6531,0.2854166666666666,0,1,0,167334,438276,8601,99355,4.0597650894809,0.1848014716413302
6532,0.2854285714285714,0,1,0,167335,438275,8601,99355,4.059755826447812,0.18480181537488607
6533,0.2854444444444444,0,1,0,167336,438274,8601,99355,4.059746563414724,0.18480215910972064
6534,0.2854444444444445,0,1,0,167337,438273,8601,99355,4.059737300381637,0.1848025028458339
6535,0.2854761904761905,0,5,0,167342,438268,8601,99355,4.059690985216199,0.1848042215455812
6536,0.2855,0,18,0,167360,438250,8601,99355,4.0595242506206235,0.18481040912937938
6537,0.2855119047619047,0,1,0,167361,438249,8601,99355,4.059514987587535,0.18481075289618382
6538,0.2855238095238095,0,1,0,167362,438248,8601,99355,4.059505724554448,0.18481109666426712
6539,0.2855357142857143,0,1,0,167363,438247,8601,99355,4.059496461521361,0.18481144043362935
6540,0.2855454545454545,0,1,0,167364,438246,8601,99355,4.059487198488273,0.18481178420427044
6541,0.2855555555555555,1,2,1,167366,438244,8602,99354,4.059468672422098,0.18481095539789955
6542,0.285595238095238,0,2,0,167368,438242,8602,99354,4.059450146355923,0.1848116429437719
6543,0.2855952380952381,0,2,0,167370,438240,8602,99354,4.059431620289748,0.18481233049475998
6544,0.2856190476190476,0,1,0,167371,438239,8602,99354,4.05942235725666,0.18481267427217243
6545,0.2856212121212121,1,0,1,167371,438239,8603,99353,4.05942235725666,0.18481115790413546
6546,0.2856666666666666,1,6,1,167377,438233,8604,99352,4.059366779058135,0.18481170419561557
6547,0.2856666666666667,2,29,2,167406,438204,8606,99350,4.0590981510985955,0.18481864147601915
6548,0.2857142857142857,2,13,2,167419,438191,8608,99348,4.058977731668458,0.18482007817107224
6549,0.2857222222222222,0,1,0,167420,438190,8608,99348,4.05896846863537,0.1848204219980727
6550,0.2857380952380952,0,3,0,167423,438187,8608,99348,4.058940679536107,0.1848214534867497
6551,0.2857619047619047,0,1,0,167424,438186,8608,99348,4.05893141650302,0.18482179731886728
6552,0.2858333333333333,9,109,9,167533,438077,8617,99339,4.0579217458964765,0.1848456316894175
6553,0.2858333333333334,2,37,2,167570,438040,8619,99337,4.057579013672237,0.18485532503251906
6554,0.2858419913419913,0,1,0,167571,438039,8619,99337,4.057569750639149,0.184855669028762
6555,0.2858809523809524,0,2,0,167573,438037,8619,99337,4.057551224572975,0.18485635702508868
6556,0.2858888888888889,0,1,0,167574,438036,8619,99337,4.057541961539886,0.18485670102517246
6557,0.2859126984126984,0,1,0,167575,438035,8619,99337,4.057532698506799,0.18485704502653655
6558,0.2859523809523809,0,2,0,167577,438033,8619,99337,4.057514172440624,0.18485773303310568
6559,0.2859722222222222,0,1,0,167578,438032,8619,99337,4.057504909407537,0.18485807703831073
6560,0.2859761904761905,0,1,0,167579,438031,8619,99337,4.0574956463744485,0.1848584210447961
6561,0.286,9,139,9,167718,437892,8628,99328,4.056208084775279,0.1848925952123897
6562,0.2860238095238095,0,1,0,167719,437891,8628,99328,4.056198821742191,0.18489293937854023
6563,0.2860714285714285,0,1,0,167720,437890,8628,99328,4.056189558709104,0.18489328354597204
6564,0.2860714285714286,0,1,0,167721,437889,8628,99328,4.0561802956760165,0.18489362771468512
6565,0.2860833333333333,0,2,0,167723,437887,8628,99328,4.056161769609841,0.18489431605595524
6566,0.2861111111111111,1,0,1,167723,437887,8629,99327,4.056161769609841,0.18489279877292847
6567,0.2861190476190476,0,2,0,167725,437885,8629,99327,4.056143243543666,0.18489348711495648
6568,0.2861428571428572,0,2,0,167727,437883,8629,99327,4.056124717477491,0.1848941754621098
6569,0.2861666666666666,0,6,0,167733,437877,8629,99327,4.056069139278965,0.18489624053432216
6570,0.2861666666666667,1,7,1,167740,437870,8630,99326,4.056004298047353,0.18489713251774026
6571,0.2861904761904761,0,1,0,167741,437869,8630,99326,4.0559950350142655,0.18489747670771323
6572,0.2861904761904762,0,4,0,167745,437865,8630,99326,4.055957982881915,0.18489885348041943
6573,0.2861944444444444,0,1,0,167746,437864,8630,99326,4.0559487198488275,0.18489919767679963
6574,0.286234126984127,0,1,0,167747,437863,8630,99326,4.055939456815739,0.1848995418744613
6575,0.2862380952380953,0,1,0,167748,437862,8630,99326,4.055930193782652,0.18489988607340446
6576,0.2862499999999999,0,1,0,167749,437861,8630,99326,4.055920930749565,0.18490023027362912
6577,0.28625,1,6,1,167755,437855,8631,99325,4.05586535255104,0.18490077813768196
6578,0.2862662337662338,0,1,0,167756,437854,8631,99325,4.055856089517952,0.1849011223446933
6579,0.2862857142857142,0,1,0,167757,437853,8631,99325,4.055846826484864,0.18490146655298617
6580,0.2862857142857143,0,1,0,167758,437852,8631,99325,4.055837563451776,0.18490181076256057
6581,0.2863055555555556,0,1,0,167759,437851,8631,99325,4.055828300418689,0.18490215497341653
6582,0.2863095238095238,1,2,1,167761,437849,8632,99324,4.055809774352514,0.18490132601601347
6583,0.2863333333333333,2,34,2,167795,437815,8634,99322,4.055494831227537,0.1849099950292011
6584,0.2863333333333334,0,8,0,167803,437807,8634,99322,4.055420726962836,0.1849127490788991
6585,0.2863571428571428,0,1,0,167804,437806,8634,99322,4.055411463929749,0.18491309334087963
6586,0.2863888888888889,1,1,1,167805,437805,8635,99321,4.055402200896662,0.18491192010813104
6587,0.2864166666666666,0,1,0,167806,437804,8635,99321,4.055392937863574,0.18491226437049105
6588,0.2864285714285714,0,3,0,167809,437801,8635,99321,4.055365148764311,0.18491329716526228
6589,0.2864404761904762,0,1,0,167810,437800,8635,99321,4.055355885731224,0.1849136414327498
6590,0.2865,1,35,1,167845,437765,8636,99320,4.055031679573159,0.18492417401342431
6591,0.286547619047619,0,1,0,167846,437764,8636,99320,4.055022416540072,0.18492451832488027
6592,0.2865714285714286,0,1,0,167847,437763,8636,99320,4.055013153506985,0.1849248626376184
6593,0.2866428571428572,0,1,0,167848,437762,8636,99320,4.0550038904738965,0.18492520695163867
6594,0.2866666666666666,17,348,17,168196,437414,8653,99303,4.051780354959428,0.1850192932215674
6595,0.2866666666666667,32,447,32,168643,436967,8685,99271,4.047639779169291,0.18512488857559517
6596,0.2867142857142857,0,1,0,168644,436966,8685,99271,4.047630516136204,0.1851252338052018
6597,0.2867222222222222,0,1,0,168645,436965,8685,99271,4.047621253103116,0.18512557903609606
6598,0.2867499999999999,0,1,0,168646,436964,8685,99271,4.0476119900700285,0.1851259242682779
6599,0.2867857142857142,0,3,0,168649,436961,8685,99271,4.047584200970766,0.1851269599725492
6600,0.2867857142857143,0,3,0,168652,436958,8685,99271,4.047556411871503,0.18512799568840924
6601,0.2868333333333333,0,13,0,168665,436945,8685,99271,4.047435992441365,0.1851324839243887
6602,0.2868333333333334,0,2,0,168667,436943,8685,99271,4.04741746637519,0.1851331744415476
6603,0.2868406593406593,1,0,1,168667,436943,8686,99270,4.04741746637519,0.18513165477151802
6604,0.2868809523809523,0,1,0,168668,436942,8686,99270,4.047408203342102,0.18513200002983896
6605,0.2869047619047619,1,2,1,168670,436940,8687,99269,4.047389677275927,0.1851311708680757
6606,0.2869155844155844,1,0,1,168670,436940,8688,99268,4.047389677275927,0.18512965118013905
6607,0.2869166666666666,1,0,1,168670,436940,8689,99267,4.047389677275927,0.18512813148653412
6608,0.286936507936508,0,1,0,168671,436939,8689,99267,4.04738041424284,0.1851284767421476
6609,0.2869523809523809,0,1,0,168672,436938,8689,99267,4.047371151209752,0.18512882199904887
6610,0.2869642857142857,0,1,0,168673,436937,8689,99267,4.047361888176664,0.1851291672572379
6611,0.2869761904761904,0,1,0,168674,436936,8689,99267,4.047352625143577,0.18512951251671475
6612,0.287,6,57,6,168731,436879,8695,99261,4.046824632257587,0.18514007535345245
6613,0.2870238095238095,0,3,0,168734,436876,8695,99261,4.046796843158324,0.18514111132042743
6614,0.287047619047619,0,1,0,168735,436875,8695,99261,4.046787580125236,0.1851414566453288
6615,0.2870833333333333,0,6,0,168741,436869,8695,99261,4.046732001926711,0.18514352862178948
6616,0.2871190476190476,0,8,0,168749,436861,8695,99261,4.04665789766201,0.18514629132921237
6617,0.2871428571428571,2,11,2,168760,436850,8697,99259,4.046556004298047,0.1851470503199909
6618,0.2871666666666666,0,3,0,168763,436847,8697,99259,4.0465282151987845,0.1851480863859013
6619,0.2871666666666667,1,12,1,168775,436835,8698,99258,4.046417058801734,0.18515071079085157
6620,0.2872619047619047,0,1,0,168776,436834,8698,99258,4.046407795768647,0.18515105616200203
6621,0.2872619047619048,0,1,0,168777,436833,8698,99258,4.046398532735559,0.18515140153444098
6622,0.2872857142857142,0,1,0,168778,436832,8698,99258,4.0463892697024715,0.1851517469081684
6623,0.2873095238095238,0,1,0,168779,436831,8698,99258,4.046380006669384,0.18515209228318433
6624,0.2873333333333333,4,38,4,168817,436793,8702,99254,4.046028011412057,0.18515913716521126
6625,0.2873333333333334,1,1,1,168818,436792,8703,99253,4.04601874837897,0.1851579624844929
6626,0.2873690476190476,0,1,0,168819,436791,8703,99253,4.0460094853458815,0.18515830790009774
6627,0.2874285714285714,0,1,0,168820,436790,8703,99253,4.046000222312794,0.18515865331699136
6628,0.2874523809523809,0,2,0,168822,436788,8703,99253,4.045981696246619,0.18515934415464488
6629,0.2874551282051281,0,1,0,168823,436787,8703,99253,4.045972433213532,0.18515968957540482
6630,0.2874761904761904,0,3,0,168826,436784,8703,99253,4.045944644114269,0.1851607258454174
6631,0.2875,28,339,28,169165,436445,8731,99225,4.042804475897588,0.18523531278585698
6632,0.2875714285714286,0,1,0,169166,436444,8731,99225,4.0427952128645,0.1852356585876726
6633,0.2876190476190476,0,15,0,169181,436429,8731,99225,4.042656267368187,0.18524084576984395
6634,0.2876666666666666,0,1,0,169182,436428,8731,99225,4.042647004335099,0.18524119159231817
6635,0.2876666666666667,3,38,3,169220,436390,8734,99222,4.0422950090777725,0.18524977035615334
6636,0.2876785714285714,0,1,0,169221,436389,8734,99222,4.042285746044685,0.18525011622240767
6637,0.2877777777777777,0,1,0,169222,436388,8734,99222,4.042276483011597,0.18525046208995352
6638,0.2877777777777778,0,4,0,169226,436384,8734,99222,4.042239430879247,0.18525184557305183
6639,0.2877857142857142,0,2,0,169228,436382,8734,99222,4.042220904813072,0.18525253732235009
6640,0.2878095238095238,0,1,0,169229,436381,8734,99222,4.042211641779985,0.1852528831989365
6641,0.2878333333333333,1,11,1,169240,436370,8735,99221,4.0421097484160216,0.1852551667223684
6642,0.2878571428571428,1,8,1,169248,436362,8736,99220,4.042035644151321,0.18525641265016374
6643,0.2879285714285714,0,1,0,169249,436361,8736,99220,4.042026381118234,0.18525675854819346
6644,0.2879365079365079,0,1,0,169250,436360,8736,99220,4.042017118085146,0.18525710444751484
6645,0.2879761904761905,0,2,0,169252,436358,8736,99220,4.04199859201897,0.18525779625003266
6646,0.288,6,103,6,169355,436255,8742,99214,4.041044499610953,0.18528430217248804
6647,0.288047619047619,0,1,0,169356,436254,8742,99214,4.041035236577865,0.18528464819559712
6648,0.2880833333333333,0,1,0,169357,436253,8742,99214,4.0410259735447775,0.1852849942199986
6649,0.288095238095238,0,2,0,169359,436251,8742,99214,4.041007447478602,0.18528568627267888
6650,0.2880952380952381,0,4,0,169363,436247,8742,99214,4.040970395346252,0.18528707039354875
6651,0.2881190476190476,0,3,0,169366,436244,8742,99214,4.04094260624699,0.185288108497772
6652,0.2881428571428571,2,3,2,169369,436241,8744,99212,4.040914817147727,0.18528610354223432
6653,0.2881666666666666,0,5,0,169374,436236,8744,99212,4.040868501982289,0.18528783373922397
6654,0.2881666666666667,1,9,1,169383,436227,8745,99211,4.040785134684501,0.18528942660027864
6655,0.2882142857142857,1,4,1,169387,436223,8746,99210,4.040748082552151,0.18528928922946475
6656,0.2882222222222222,0,2,0,169389,436221,8746,99210,4.040729556485976,0.18528998134213373
6657,0.2882251082251082,1,0,1,169389,436221,8747,99209,4.040729556485976,0.18528845974263675
6658,0.2882272727272727,0,1,0,169390,436220,8747,99209,4.040720293452888,0.18528880579871468
6659,0.2882857142857143,0,1,0,169391,436219,8747,99209,4.040711030419801,0.18528915185608522
6660,0.2883333333333333,27,429,27,169820,435790,8774,99182,4.0367371892252395,0.1853966188884652
6661,0.2883333333333334,0,3,0,169823,435787,8774,99182,4.036709400125977,0.18539765855591633
6662,0.2883690476190476,0,2,0,169825,435785,8774,99182,4.036690874059802,0.1853983516740285
6663,0.2883809523809524,0,1,0,169826,435784,8774,99182,4.036681611026714,0.18539869823502803
6664,0.2884523809523809,0,3,0,169829,435781,8774,99182,4.036653821927452,0.18539973792580047
6665,0.2884761904761905,0,1,0,169830,435780,8774,99182,4.0366445588943645,0.18540008449198261
6666,0.2885,0,19,0,169849,435761,8774,99182,4.036468561265701,0.1854066694956285
6667,0.2885238095238095,0,2,0,169851,435759,8774,99182,4.036450035199525,0.1854073626811181
6668,0.2885714285714286,0,7,0,169858,435752,8774,99182,4.036385193967913,0.18540978887115045
6669,0.2885952380952381,0,2,0,169860,435750,8774,99182,4.036366667901738,0.1854104820799653
6670,0.2886038961038961,0,1,0,169861,435749,8774,99182,4.03635740486865,0.18541082868631656
6671,0.2886190476190476,0,3,0,169864,435746,8774,99182,4.036329615769388,0.1854118685131457
6672,0.2886309523809524,0,2,0,169866,435744,8774,99182,4.036311089703212,0.18541256173751136
6673,0.2886666666666666,1,9,1,169875,435735,8775,99181,4.036227722405425,0.18541415848469667
6674,0.2886666666666667,2,34,2,169909,435701,8777,99179,4.035912779280448,0.18542289859407718
6675,0.2886904761904761,0,1,0,169910,435700,8777,99179,4.03590351624736,0.18542324525733858
6676,0.2887142857142857,0,1,0,169911,435699,8777,99179,4.0358942532142725,0.1854235919218962
6677,0.2887499999999999,0,1,0,169912,435698,8777,99179,4.035884990181185,0.18542393858775008
6678,0.28875,0,4,0,169916,435694,8777,99179,4.035847938048835,0.1854253252641281
6679,0.2887619047619048,0,1,0,169917,435693,8777,99179,4.035838675015747,0.1854256719364633
6680,0.2887777777777777,0,1,0,169918,435692,8777,99179,4.035829411982659,0.18542601861009478
6681,0.2888095238095238,0,4,0,169922,435688,8777,99179,4.035792359850309,0.18542740531758362
6682,0.2888333333333333,2,6,2,169928,435682,8779,99177,4.035736781651784,0.18542643949152954
6683,0.2888333333333334,0,1,0,169929,435681,8779,99177,4.035727518618697,0.18542678617502215
6684,0.2888571428571428,0,4,0,169933,435677,8779,99177,4.035690466486346,0.18542817292195626
6685,0.2888763736263736,0,2,0,169935,435675,8779,99177,4.035671940420171,0.18542886630320163
6686,0.2888888888888889,0,1,0,169936,435674,8779,99177,4.035662677387084,0.18542921299576892
6687,0.2889523809523809,0,1,0,169937,435673,8779,99177,4.035653414353996,0.1854295596896326
6688,0.2889722222222222,0,1,0,169938,435672,8779,99177,4.035644151320908,0.18542990638479273
6689,0.2889999999999999,0,3,0,169941,435669,8779,99177,4.035616362221646,0.18543094647805164
6690,0.289,11,92,11,170033,435577,8790,99166,4.034764163177591,0.18544609279597862
6691,0.289047619047619,1,4,1,170037,435573,8791,99165,4.034727111045241,0.18544595671151107
6692,0.2890476190476191,0,3,0,170040,435570,8791,99165,4.034699321945978,0.18544699711071838
6693,0.2890555555555555,0,2,0,170042,435568,8791,99165,4.034680795879803,0.1854476907166754
6694,0.2890714285714286,0,1,0,170043,435567,8791,99165,4.0346715328467155,0.1854480375215996
6695,0.2891428571428571,0,1,0,170044,435566,8791,99165,4.034662269813627,0.1854483843278209
6696,0.2891666666666666,6,57,6,170101,435509,8797,99159,4.034134276927637,0.18545901381792065
6697,0.2891666666666667,6,79,6,170180,435430,8803,99153,4.033402497313721,0.18547727855169358
6698,0.2892857142857142,0,2,0,170182,435428,8803,99153,4.033383971247545,0.1854779724681573
6699,0.2892857142857143,1,7,1,170189,435421,8804,99152,4.033319130015933,0.18547887753403183
6700,0.2893333333333333,7,44,7,170233,435377,8811,99145,4.03291155656008,0.1854834786968544
6701,0.2893333333333334,0,4,0,170237,435373,8811,99145,4.032874504427729,0.1854848667397543
6702,0.2893571428571428,0,2,0,170239,435371,8811,99145,4.032855978361555,0.18548556076899475
6703,0.2893809523809524,0,1,0,170240,435370,8811,99145,4.032846715328467,0.18548590778556262
6704,0.2894047619047619,0,1,0,170241,435369,8811,99145,4.03283745229538,0.1854862548034289
6705,0.2894444444444444,0,1,0,170242,435368,8811,99145,4.032828189262292,0.18548660182259366
6706,0.2894451659451659,0,1,0,170243,435367,8811,99145,4.032818926229204,0.18548694884305683
6707,0.2895,3,18,3,170261,435349,8814,99142,4.032652191633629,0.1854886237560595
6708,0.2895238095238095,0,5,0,170266,435344,8814,99142,4.032605876468191,0.18549035896169405
6709,0.2895476190476191,0,1,0,170267,435343,8814,99142,4.0325966134351034,0.18549070600671674
6710,0.2895833333333333,0,1,0,170268,435342,8814,99142,4.032587350402015,0.18549105305303806
6711,0.2895952380952381,0,2,0,170270,435340,8814,99142,4.032568824335841,0.18549174714957659
6712,0.2896428571428571,0,1,0,170271,435339,8814,99142,4.032559561302753,0.18549209419979382
6713,0.2896547619047618,0,1,0,170272,435338,8814,99142,4.0325502982696655,0.18549244125130968
6714,0.2896666666666666,1,6,1,170278,435332,8815,99141,4.03249472007114,0.18549299964638064
6715,0.2896666666666667,4,13,4,170291,435319,8819,99137,4.032374300641002,0.18549141557022467
6716,0.2896746031746031,0,2,0,170293,435317,8819,99137,4.032355774574826,0.18549210970448346
6717,0.2897222222222222,0,1,0,170294,435316,8819,99137,4.032346511541739,0.185492456773561
6718,0.2897619047619047,0,4,0,170298,435312,8819,99137,4.032309459409389,0.18549384506285913
6719,0.2897619047619048,1,2,1,170300,435310,8820,99136,4.032290933343214,0.18549301519704517
6720,0.2897727272727273,0,1,0,170301,435309,8820,99136,4.032281670310127,0.1854933622730122
6721,0.2898333333333333,1,17,1,170318,435292,8821,99135,4.0321241987476375,0.18549773869957917
6722,0.2898333333333334,0,2,0,170320,435290,8821,99135,4.032105672681463,0.1854984328951677
6723,0.2898571428571428,0,1,0,170321,435289,8821,99135,4.032096409648375,0.1854987799949104
6724,0.2898888888888888,0,2,0,170323,435287,8821,99135,4.0320778835822,0.18549947419829274
6725,0.2899047619047619,0,3,0,170326,435284,8821,99135,4.032050094482938,0.18550051551310862
6726,0.2899285714285714,0,1,0,170327,435283,8821,99135,4.03204083144985,0.18550086262064527
6727,0.2899285714285715,1,0,1,170327,435283,8822,99134,4.03204083144985,0.18549933853152126
6728,0.2899761904761904,0,1,0,170328,435282,8822,99134,4.0320315684167625,0.18549968563815455
6729,0.29,252,3742,252,174070,431540,9074,98882,3.9973692986031346,0.18642137769549527
6730,0.2900133477633477,0,1,0,174071,431539,9074,98882,3.997360035570047,0.18642172915476574
6731,0.2900238095238095,0,1,0,174072,431538,9074,98882,3.9973507725369597,0.18642208061536142
6732,0.290047619047619,0,1,0,174073,431537,9074,98882,3.997341509503872,0.1864224320772823
6733,0.2900714285714285,0,1,0,174074,431536,9074,98882,3.9973322464707843,0.1864227835405284
6734,0.2901190476190476,0,1,0,174075,431535,9074,98882,3.9973229834376967,0.18642313500509977
6735,0.2901428571428571,0,2,0,174077,431533,9074,98882,3.9973044573715217,0.18642383793821818
6736,0.2901666666666667,0,13,0,174090,431520,9074,98882,3.9971840379413837,0.18642840713270312
6737,0.2902380952380952,0,1,0,174091,431519,9074,98882,3.997174774908296,0.1864287586184792
6738,0.2902619047619048,0,2,0,174093,431517,9074,98882,3.997156248842121,0.18642946159400753
6739,0.2902777777777777,0,1,0,174094,431516,9074,98882,3.9971469858090334,0.18642981308375975
6740,0.2902777777777778,0,1,0,174095,431515,9074,98882,3.9971377227759457,0.18643016457483733
6741,0.2902857142857142,0,2,0,174097,431513,9074,98882,3.997119196709771,0.18643086756096872
6742,0.2902857142857143,0,1,0,174098,431512,9074,98882,3.997109933676683,0.1864312190560225
6743,0.2903095238095238,1,0,1,174098,431512,9075,98881,3.997109933676683,0.18642968515798664
6744,0.2903333333333333,2,28,2,174126,431484,9077,98879,3.9968505687502316,0.18643645955694496
6745,0.2903571428571428,1,4,1,174130,431480,9078,98878,3.9968135166178813,0.18643633168538987
6746,0.2903809523809524,0,2,0,174132,431478,9078,98878,3.9967949905517064,0.1864370347464722
6747,0.2904166666666666,0,1,0,174133,431477,9078,98878,3.9967857275186187,0.1864373862790018
6748,0.2904285714285714,0,1,0,174134,431476,9078,98878,3.996776464485531,0.18643773781285708
6749,0.2904393939393939,0,1,0,174135,431475,9078,98878,3.996767201452444,0.18643808934803802
6750,0.2904761904761905,4,1,4,174136,431474,9082,98874,3.996757938419356,0.18643230482626502
6751,0.2905,1,24,1,174160,431450,9083,98873,3.996535625625255,0.18643920780354614
6752,0.2905555555555555,0,2,0,174162,431448,9083,98873,3.9965170995590795,0.18643991092187562
6753,0.290595238095238,0,1,0,174163,431447,9083,98873,3.9965078365259923,0.1864402624830291
6754,0.2905952380952381,0,1,0,174164,431446,9083,98873,3.9964985734929046,0.18644061404550846
6755,0.2906190476190476,0,1,0,174165,431445,9083,98873,3.996489310459817,0.18644096560931367
6756,0.2906666666666666,0,12,0,174177,431433,9083,98873,3.9963781540627665,0.1864451844783955
6757,0.2906666666666667,2,37,2,174214,431396,9085,98871,3.996035421838527,0.18645512543680826
6758,0.2906904761904762,1,0,1,174214,431396,9086,98870,3.996035421838527,0.1864535912164838
6759,0.2907142857142857,1,4,1,174218,431392,9087,98869,3.9959983697061765,0.1864534634830772
6760,0.2907380952380952,0,1,0,174219,431391,9087,98869,3.995989106673089,0.1864538151095689
6761,0.2908030303030303,1,0,1,174219,431391,9088,98868,3.995989106673089,0.18645228086651994
6762,0.2908333333333333,12,131,12,174350,431260,9100,98856,3.9947756493386195,0.18647994023949474
6763,0.2908333333333334,0,1,0,174351,431259,9100,98856,3.994766386305532,0.18648029201211058
6764,0.2908571428571428,0,3,0,174354,431256,9100,98856,3.9947385972062692,0.18648134733792104
6765,0.2909166666666667,0,1,0,174355,431255,9100,98856,3.9947293341731815,0.18648169911584556
6766,0.2909285714285713,0,1,0,174356,431254,9100,98856,3.9947200711400943,0.18648205089509726
6767,0.2909523809523809,0,7,0,174363,431247,9100,98856,3.9946552299084814,0.18648451338702102
6768,0.2909761904761904,0,1,0,174364,431246,9100,98856,3.9946459668753937,0.18648486517689047
6769,0.2909920634920635,0,4,0,174368,431242,9100,98856,3.9946089147430435,0.18648627234964102
6770,0.2909999999999999,0,1,0,174369,431241,9100,98856,3.994599651709956,0.18648662414614683
6771,0.291,4,83,4,174452,431158,9104,98852,3.993830819963689,0.18650968849644348
6772,0.291047619047619,0,2,0,174454,431156,9104,98852,3.993812293897514,0.18651039229596533
6773,0.2910714285714286,1,0,1,174454,431156,9105,98851,3.993812293897514,0.1865088574301849
6774,0.2911111111111111,1,1,1,174455,431155,9106,98850,3.9938030308644263,0.18650767445590136
6775,0.2911190476190476,0,1,0,174456,431154,9106,98850,3.9937937678313387,0.18650802635451807
6776,0.2911428571428571,1,0,1,174456,431154,9107,98849,3.9937937678313387,0.18650649147268977
6777,0.2911666666666667,0,3,0,174459,431151,9107,98849,3.993765978732076,0.18650754716981133
6778,0.2911825396825396,0,1,0,174460,431150,9107,98849,3.9937567156989884,0.1865078990715077
6779,0.2911904761904761,0,5,0,174465,431145,9107,98849,3.993710400533551,0.18650965859990867
6780,0.2911904761904762,0,1,0,174466,431144,9107,98849,3.993701137500463,0.18651001050957278
6781,0.2912222222222222,0,3,0,174469,431141,9107,98849,3.9936733484012006,0.18651106624653296
6782,0.2912380952380952,1,0,1,174469,431141,9108,98848,3.9936733484012006,0.18650953132989553
6783,0.29125,0,5,0,174474,431136,9108,98848,3.9936270332357626,0.1865112909068953
6784,0.2913095238095238,0,1,0,174475,431135,9108,98848,3.993617770202675,0.18651164282627933
6785,0.2913333333333333,4,25,4,174500,431110,9112,98844,3.9933861943754865,0.1865143012412398
6786,0.2913333333333334,0,7,0,174507,431103,9112,98844,3.9933213531438736,0.18651676488403557
6787,0.2914166666666666,0,1,0,174508,431102,9112,98844,3.993312090110786,0.18651711683831937
6788,0.2914285714285714,0,4,0,174512,431098,9112,98844,3.9932750379784356,0.18651852466873733
6789,0.2914285714285715,0,1,0,174513,431097,9112,98844,3.993265774945348,0.18651887662966254
6790,0.2914563492063493,0,1,0,174514,431096,9112,98844,3.9932565119122607,0.18651922859191605
6791,0.2914761904761905,0,2,0,174516,431094,9112,98844,3.9932379858460854,0.18651993252040805
6792,0.2915,2,30,2,174546,431064,9114,98842,3.992960094853459,0.18652742184462906
6793,0.2915151515151515,0,2,0,174548,431062,9114,98842,3.9929415687872836,0.1865281258492104
6794,0.291547619047619,0,6,0,174554,431056,9114,98842,3.9928859905887584,0.18653023789484013
6795,0.2915476190476191,0,2,0,174556,431054,9114,98842,3.9928674645225835,0.18653094192067876
6796,0.2915833333333333,0,2,0,174558,431052,9114,98842,3.992848938456408,0.1865316459518319
6797,0.2915952380952381,0,2,0,174560,431050,9114,98842,3.992830412390233,0.1865323499882995
6798,0.2916666666666666,17,183,17,174743,430867,9131,98825,3.9911352773352107,0.1865706863611306
6799,0.2916666666666667,21,238,21,174981,430629,9152,98804,3.988930675460373,0.18662229215028153
6800,0.2917142857142857,0,1,0,174982,430628,9152,98804,3.988921412427285,0.18662264464558243
6801,0.2917222222222222,0,3,0,174985,430625,9152,98804,3.9888936233280226,0.1866237021394748
6802,0.2917380952380953,0,1,0,174986,430624,9152,98804,3.988884360294935,0.18662405464010215
6803,0.2917777777777777,0,2,0,174988,430622,9152,98804,3.98886583422876,0.18662475964535175
6804,0.2917857142857142,0,2,0,174990,430620,9152,98804,3.9888473081625846,0.18662546465592794
6805,0.2917857142857143,0,2,0,174992,430618,9152,98804,3.9888287820964097,0.1866261696718308
6806,0.2918095238095238,0,3,0,174995,430615,9152,98804,3.988800992997147,0.18662722720567262
6807,0.2918333333333333,0,10,0,175005,430605,9152,98804,3.9887083626662716,0.18663075240504035
6808,0.2918333333333334,1,3,1,175008,430602,9153,98803,3.988680573567009,0.18663027360905168
6809,0.2918571428571428,1,1,1,175009,430601,9154,98802,3.9886713105339213,0.18662908974826362
6810,0.2918809523809524,0,2,0,175011,430599,9154,98802,3.988652784467746,0.18662979480582773
6811,0.2919047619047619,1,1,1,175012,430598,9155,98801,3.9886435214346587,0.18662861093428587
6812,0.2919166666666666,0,1,0,175013,430597,9155,98801,3.988634258401571,0.1866289634641612
6813,0.2919285714285714,0,1,0,175014,430596,9155,98801,3.9886249953684834,0.1866293159953683
6814,0.2919404761904762,0,1,0,175015,430595,9155,98801,3.9886157323353957,0.18662966852790727
6815,0.2919444444444444,0,2,0,175017,430593,9155,98801,3.9885972062692208,0.1866303735969807
6816,0.2919523809523809,0,1,0,175018,430592,9155,98801,3.988587943236133,0.18663072613351517
6817,0.291969696969697,1,0,1,175018,430592,9156,98800,3.988587943236133,0.18662918971197148
6818,0.292,9,83,9,175101,430509,9165,98791,3.9878191114898662,0.1866446249763839
6819,0.2920238095238096,0,1,0,175102,430508,9165,98791,3.9878098484567785,0.18664497760245155
6820,0.2920628815628815,0,1,0,175103,430507,9165,98791,3.9878005854236913,0.1866453302298516
6821,0.2920833333333333,1,1,1,175104,430506,9166,98790,3.9877913223906036,0.1866441461866328
6822,0.2920952380952381,0,1,0,175105,430505,9166,98790,3.987782059357516,0.18664449881446074
6823,0.2921428571428571,1,10,1,175115,430495,9167,98789,3.9876894290266405,0.18664648846366033
6824,0.2921666666666666,1,6,1,175121,430489,9168,98788,3.9876338508281153,0.1866470676035422
6825,0.2921666666666667,2,2,2,175123,430487,9170,98786,3.98761532476194,0.18664469942732767
6826,0.2922023809523809,0,2,0,175125,430485,9170,98786,3.987596798695765,0.1866454047170542
6827,0.2922142857142857,0,1,0,175126,430484,9170,98786,3.9875875356626773,0.18664575736391634
6828,0.2922222222222222,1,2,1,175128,430482,9171,98785,3.9875690095965024,0.18664492590696188
6829,0.29225,0,1,0,175129,430481,9171,98785,3.9875597465634147,0.18664527855558452
6830,0.2922619047619047,0,2,0,175131,430479,9171,98785,3.98754122049724,0.1866459838568276
6831,0.2923333333333333,3,41,3,175172,430438,9174,98782,3.9871614361406498,0.1866558331128831
6832,0.2923809523809523,3,0,3,175172,430438,9177,98779,3.9871614361406498,0.18665122246639848
6833,0.2923809523809524,0,1,0,175173,430437,9177,98779,3.9871521731075625,0.18665157516023703
6834,0.2924166666666666,0,1,0,175174,430436,9177,98779,3.987142910074475,0.1866519278554085
6835,0.2924642857142857,0,1,0,175175,430435,9177,98779,3.987133647041387,0.18665228055191282
6836,0.2925,27,372,27,175547,430063,9204,98752,3.983687798732817,0.18674205535016972
6837,0.292547619047619,0,2,0,175549,430061,9204,98752,3.983669272666642,0.1867427616189466
6838,0.2926190476190476,1,3,1,175552,430058,9205,98751,3.9836414835673795,0.1867422831305821
6839,0.2926666666666666,4,31,4,175583,430027,9209,98747,3.983354329541665,0.18674707909239108
6840,0.2926666666666667,0,23,0,175606,430004,9209,98747,3.9831412797806514,0.18675520235422724
6841,0.2927380952380952,0,1,0,175607,430003,9209,98747,3.9831320167475637,0.18675555555555556
6842,0.29275,0,1,0,175608,430002,9209,98747,3.9831227537144764,0.18675590875821987
6843,0.2927857142857142,0,1,0,175609,430001,9209,98747,3.9831134906813888,0.1867562619622202
6844,0.2928333333333333,1,12,1,175621,429989,9210,98746,3.983002334284338,0.1867589624291942
6845,0.2928571428571428,2,11,2,175632,429978,9212,98744,3.9829004409203748,0.18675977167585234
6846,0.2929166666666666,0,6,0,175638,429972,9212,98744,3.9828448627218496,0.18676189107195545
6847,0.293,5,59,5,175697,429913,9217,98739,3.982298343769684,0.1867750429394006
6848,0.2930238095238095,0,2,0,175699,429911,9217,98739,3.982279817703509,0.18677574955074247
6849,0.293047619047619,0,1,0,175700,429910,9217,98739,3.9822705546704213,0.18677610285841834
6850,0.2930714285714286,0,1,0,175701,429909,9217,98739,3.9822612916373337,0.18677645616743088
6851,0.2930833333333333,0,1,0,175702,429908,9217,98739,3.982252028604246,0.18677680947778008
6852,0.2930952380952381,0,2,0,175704,429906,9217,98739,3.982233502538071,0.18677751610248844
6853,0.2931111111111111,0,3,0,175707,429903,9217,98739,3.9822057134388085,0.1867785760495761
6854,0.2931428571428571,0,3,0,175710,429900,9217,98739,3.982177924339546,0.18677963600869402
6855,0.2931666666666666,0,2,0,175712,429898,9217,98739,3.9821593982733705,0.18678034265478957
6856,0.2931666666666667,0,11,0,175723,429887,9217,98739,3.9820575049094074,0.1867842293038935
6857,0.2932142857142857,2,3,2,175726,429884,9219,98737,3.9820297158101448,0.1867822125870898
6858,0.29325,0,1,0,175727,429883,9219,98737,3.9820204527770575,0.18678256592637432
6859,0.2932539682539682,0,1,0,175728,429882,9219,98737,3.98201118974397,0.1867829192669957
6860,0.2932619047619048,0,2,0,175730,429880,9219,98737,3.9819926636777945,0.18678362595224898
6861,0.2932857142857143,2,1,2,175731,429879,9221,98735,3.9819834006447072,0.18678090251109505
6862,0.2933333333333333,60,753,60,176484,429126,9281,98675,3.9750083367297786,0.1869549318777342
6863,0.2933888888888888,0,1,0,176485,429125,9281,98675,3.9749990736966914,0.18695528609321713
6864,0.2934285714285713,0,2,0,176487,429123,9281,98675,3.974980547630516,0.18695599452820966
6865,0.2934285714285714,0,2,0,176489,429121,9281,98675,3.974962021564341,0.1869567029685712
6866,0.2934444444444444,1,0,1,176489,429121,9282,98674,3.974962021564341,0.18695516251574948
6867,0.2934523809523809,0,5,0,176494,429116,9282,98674,3.974915706398903,0.18695693362890545
6868,0.2934848484848485,0,1,0,176495,429115,9282,98674,3.974906443365816,0.18695728785556348
6869,0.2934999999999999,0,1,0,176496,429114,9282,98674,3.974897180332728,0.18695764208356386
6870,0.2935,2,34,2,176530,429080,9284,98672,3.9745822372077515,0.18696660552683836
6871,0.2935714285714286,0,6,0,176536,429074,9284,98672,3.974526659009226,0.18696873116991886
6872,0.2936111111111111,0,1,0,176537,429073,9284,98672,3.9745173959761386,0.1869690854484647
6873,0.2936666666666666,0,13,0,176550,429060,9284,98672,3.974396976546,0.18697369119174126
6874,0.2936666666666667,3,19,3,176569,429041,9287,98669,3.974220978917337,0.18697580110287848
6875,0.2936904761904762,0,1,0,176570,429040,9287,98669,3.974211715884249,0.1869761554189904
6876,0.2937142857142857,0,3,0,176573,429037,9287,98669,3.9741839267849866,0.18697721837538325
6877,0.2937380952380952,0,1,0,176574,429036,9287,98669,3.974174663751899,0.18697757269686663
6878,0.2937499999999999,0,1,0,176575,429035,9287,98669,3.974165400718811,0.18697792701969285
6879,0.29375,4,6,4,176581,429029,9291,98665,3.974109822520286,0.1869738901711977
6880,0.2937857142857142,0,2,0,176583,429027,9291,98665,3.974091296454111,0.18697459881900805
6881,0.2937976190476191,0,3,0,176586,429024,9291,98665,3.9740635073548485,0.18697566180079556
6882,0.2938095238095238,2,6,2,176592,429018,9293,98663,3.974007929156323,0.1869747063093043
6883,0.2938333333333333,0,6,0,176598,429012,9293,98663,3.9739523509577976,0.18697683233050647
6884,0.2938333333333334,0,5,0,176603,429007,9293,98663,3.9739060357923597,0.18697860405177477
6885,0.2938571428571429,0,1,0,176604,429006,9293,98663,3.9738967727592724,0.1869789584000576
6886,0.2938888888888888,0,1,0,176605,429005,9293,98663,3.9738875097261848,0.18697931274968352
6887,0.2939285714285714,0,7,0,176612,428998,9293,98663,3.973822668494572,0.1869817932346715
6888,0.2939365079365079,0,2,0,176614,428996,9293,98663,3.973804142428397,0.18698250195675617
6889,0.2939523809523809,0,3,0,176617,428993,9293,98663,3.973776353329134,0.18698356504995678
6890,0.2939999999999999,0,1,0,176618,428992,9293,98663,3.9737670902960467,0.18698391941704334
6891,0.294,8,145,8,176763,428847,9301,98655,3.972423950498351,0.18702298759056837
6892,0.2940196078431372,0,1,0,176764,428846,9301,98655,3.9724146874652635,0.1870233421358443
6893,0.294047619047619,0,4,0,176768,428842,9301,98655,3.972377635332913,0.1870247603303905
6894,0.2941190476190476,0,1,0,176769,428841,9301,98655,3.972368372299826,0.18702511488238774
6895,0.2941428571428572,0,1,0,176770,428840,9301,98655,3.9723591092667383,0.18702546943572926
6896,0.2941666666666666,3,61,3,176831,428779,9304,98652,3.9717940642483973,0.187042475698243
6897,0.2941666666666667,5,71,5,176902,428708,9309,98647,3.9711363888991813,0.18705995012847132
6898,0.2941904761904761,0,1,0,176903,428707,9309,98647,3.9711271258660936,0.18706030484266736
6899,0.2942380952380952,0,1,0,176904,428706,9309,98647,3.971117862833006,0.18706065955820864
6900,0.2942619047619047,0,1,0,176905,428705,9309,98647,3.9711085997999187,0.1870610142750952
6901,0.2942857142857142,0,10,0,176915,428695,9309,98647,3.971015969469043,0.1870645615179523
6902,0.2942857142857143,1,7,1,176922,428688,9310,98646,3.97095112823743,0.1870655030777458
6903,0.2943203463203463,0,1,0,176923,428687,9310,98646,3.9709418652043427,0.18706585781659787
6904,0.2943333333333333,1,34,1,176957,428653,9311,98645,3.9706269220793655,0.18707637806325836
6905,0.2943333333333334,0,10,0,176967,428643,9311,98645,3.97053429174849,0.18707992596076528
6906,0.2943809523809523,0,1,0,176968,428642,9311,98645,3.9705250287154024,0.1870802807579174
6907,0.2943809523809524,0,1,0,176969,428641,9311,98645,3.970515765682315,0.1870806355564153
6908,0.2944166666666666,1,3,1,176972,428638,9312,98644,3.9704879765830525,0.18708015824549293
6909,0.2944285714285714,1,2,1,176974,428636,9313,98643,3.970469450516877,0.18707932612525816
6910,0.2944444444444444,0,1,0,176975,428635,9313,98643,3.9704601874837895,0.18707968092732866
6911,0.2944523809523809,0,1,0,176976,428634,9313,98643,3.9704509244507022,0.18708003573074494
6912,0.2944696969696969,0,1,0,176977,428633,9313,98643,3.9704416614176146,0.187080390535507
6913,0.2945,0,19,0,176996,428614,9313,98643,3.970265663788951,0.1870871320816983
6914,0.2945238095238094,0,2,0,176998,428612,9313,98643,3.970247137722776,0.18708784174640355
6915,0.2945238095238095,0,1,0,176999,428611,9313,98643,3.9702378746896883,0.1870881965807751
6916,0.294547619047619,0,1,0,177000,428610,9313,98643,3.970228611656601,0.18708855141649264
6917,0.2945833333333333,0,3,0,177003,428607,9313,98643,3.970200822557338,0.1870896159317212
6918,0.2945952380952381,0,1,0,177004,428606,9313,98643,3.9701915595242507,0.18708997077282272
6919,0.2946031746031746,0,1,0,177005,428605,9313,98643,3.970182296491163,0.18709032561527023
6920,0.2946190476190476,0,2,0,177007,428603,9313,98643,3.970163770424988,0.18709103530420335
6921,0.2946428571428571,0,4,0,177011,428599,9313,98643,3.970126718292638,0.18709245469822208
6922,0.2946428571428572,1,0,1,177011,428599,9314,98642,3.970126718292638,0.1870909128842408
6923,0.2946666666666666,0,13,0,177024,428586,9314,98642,3.9700062988624993,0.1870955260342774
6924,0.2946666666666667,2,27,2,177051,428559,9316,98640,3.9697561969691355,0.18710202409336893
6925,0.2946904761904761,0,1,0,177052,428558,9316,98640,3.969746933936048,0.18710237899233306
6926,0.2947142857142857,0,2,0,177054,428556,9316,98640,3.969728407869873,0.1871030887943004
6927,0.29475,0,1,0,177055,428555,9316,98640,3.9697191448367852,0.18710344369730367
6928,0.2947619047619047,1,4,1,177059,428551,9317,98639,3.969682092704435,0.18710332138318253
6929,0.2947619047619048,0,3,0,177062,428548,9317,98639,3.9696543036051724,0.18710438610967267
6930,0.2947777777777778,0,1,0,177063,428547,9317,98639,3.969645040572085,0.18710474102119556
6931,0.2948333333333333,1,17,1,177080,428530,9318,98638,3.9694875690095963,0.187109232730363
6932,0.2948571428571428,0,1,0,177081,428529,9318,98638,3.969478305976509,0.18710958766387123
6933,0.2948571428571429,0,1,0,177082,428528,9318,98638,3.9694690429434214,0.18710994259872601
6934,0.2948809523809523,0,4,0,177086,428524,9318,98638,3.969431990811071,0.18711136235161108
6935,0.2948809523809524,0,3,0,177089,428521,9318,98638,3.9694042017118085,0.18711242718041426
6936,0.295,108,1474,108,178563,427047,9426,98530,3.9557504909407535,0.18747015185215488
6937,0.2950238095238095,0,1,0,178564,427046,9426,98530,3.9557412279076662,0.1874705085468134
6938,0.2950833333333333,0,1,0,178565,427045,9426,98530,3.9557319648745786,0.18747086524282927
6939,0.2951190476190476,2,5,2,178570,427040,9428,98528,3.9556856497091406,0.18746955674622504
6940,0.2951363636363636,0,1,0,178571,427039,9428,98528,3.9556763866760534,0.18746991344585942
6941,0.2951428571428571,0,1,0,178572,427038,9428,98528,3.9556671236429657,0.1874702701468512
6942,0.2951666666666666,1,9,1,178581,427029,9429,98527,3.9555837563451774,0.187471934484622
6943,0.2951666666666667,0,10,0,178591,427019,9429,98527,3.955491126014302,0.1874755016687407
6944,0.2952222222222222,0,1,0,178592,427018,9429,98527,3.9554818629812147,0.18747585839461892
6945,0.2952380952380952,1,2,1,178594,427016,9430,98526,3.9554633369150394,0.18747502578290604
6946,0.2952777777777778,0,1,0,178595,427015,9430,98526,3.9554540738819517,0.18747538251059384
6947,0.2952857142857142,0,1,0,178596,427014,9430,98526,3.9554448108488645,0.18747573923963923
6948,0.2952857142857143,0,1,0,178597,427013,9430,98526,3.9554355478157768,0.1874760959700422
6949,0.2953333333333333,5,37,5,178634,426976,9435,98521,3.9550928155915375,0.18748156507078062
6950,0.2953333333333334,0,1,0,178635,426975,9435,98521,3.95508355255845,0.18748192184146026
6951,0.2953528138528138,0,1,0,178636,426974,9435,98521,3.955074289525362,0.18748227861349775
6952,0.2953571428571429,0,2,0,178638,426972,9435,98521,3.955055763459187,0.1874829921616463
6953,0.2954007936507936,0,1,0,178639,426971,9435,98521,3.9550465004260995,0.18748334893775737
6954,0.2954166666666666,0,3,0,178642,426968,9435,98521,3.955018711326837,0.1874844192742379
6955,0.2954285714285714,0,1,0,178643,426967,9435,98521,3.9550094482937492,0.18748477605578054
6956,0.2954761904761904,0,3,0,178646,426964,9435,98521,3.9549816591944866,0.1874858464085559
6957,0.2954761904761905,0,2,0,178648,426962,9435,98521,3.9549631331283117,0.18748655998386246
6958,0.2955,2,31,2,178679,426931,9437,98519,3.954675979102597,0.18749452849938147
6959,0.2955238095238095,0,1,0,178680,426930,9437,98519,3.95466671606951,0.18749488532664446
6960,0.2955357142857143,0,1,0,178681,426929,9437,98519,3.9546574530364222,0.1874952421552656
6961,0.295547619047619,0,1,0,178682,426928,9437,98519,3.9546481900033346,0.18749559898524495
6962,0.2955555555555555,0,4,0,178686,426924,9437,98519,3.9546111378709843,0.18749702631874438
6963,0.2955714285714286,0,1,0,178687,426923,9437,98519,3.954601874837897,0.18749738315551479
6964,0.2955833333333333,1,1,1,178688,426922,9438,98518,3.9545926118048094,0.18749619366626066
6965,0.2955952380952381,0,1,0,178689,426921,9438,98518,3.9545833487717217,0.18749655050348377
6966,0.2956190476190476,1,1,1,178690,426920,9439,98517,3.9545740857386344,0.18749536100426883
6967,0.2956349206349206,0,1,0,178691,426919,9439,98517,3.9545648227055468,0.1874957178419446
6968,0.2956666666666666,2,9,2,178700,426910,9441,98515,3.9544814554077585,0.18749583670362088
6969,0.2956666666666667,3,27,3,178727,426883,9444,98512,3.9542313535143947,0.18750083270682058
6970,0.2957142857142857,1,14,1,178741,426869,9445,98511,3.954101671051169,0.18750428261448857
6971,0.29575,1,0,1,178741,426869,9446,98510,3.954101671051169,0.18750273612002002
6972,0.2957777777777778,1,1,1,178742,426868,9447,98509,3.9540924080180813,0.18750154650850723
6973,0.2958333333333333,12,128,12,178870,426740,9459,98497,3.9529067397828745,0.18752867753033392
6974,0.2958809523809524,0,1,0,178871,426739,9459,98497,3.952897476749787,0.18752903456731831
6975,0.2959206349206349,0,4,0,178875,426735,9459,98497,3.9528604246174366,0.18753046272885124
6976,0.2959523809523809,0,3,0,178878,426732,9459,98497,3.952832635518174,0.18753153386427635
6977,0.296,11,141,11,179019,426591,9470,98486,3.9515265478528288,0.1875648714379034
6978,0.2960357142857143,0,2,0,179021,426589,9470,98486,3.951508021786654,0.18756558586868544
6979,0.2960714285714286,0,4,0,179025,426585,9470,98486,3.9514709696543036,0.18756701474657714
6980,0.2960952380952381,0,3,0,179028,426582,9470,98486,3.951443180555041,0.18756808641928283
6981,0.2961111111111111,0,2,0,179030,426580,9470,98486,3.951424654488866,0.1875688008745567
6982,0.2961190476190476,0,2,0,179032,426578,9470,98486,3.9514061284226907,0.1875695153352734
6983,0.2961428571428571,1,0,1,179032,426578,9471,98485,3.9514061284226907,0.18756796803431208
6984,0.2961666666666666,0,9,0,179041,426569,9471,98485,3.951322761124903,0.1875711831544946
6985,0.2961666666666667,0,7,0,179048,426562,9471,98485,3.95125791989329,0.18757368387972886
6986,0.2961785714285714,0,3,0,179051,426559,9471,98485,3.9512301307940274,0.18757475563952736
6987,0.2961904761904761,2,4,2,179055,426555,9473,98483,3.951193078661677,0.18757308994777522
6988,0.2961904761904762,0,5,0,179060,426550,9473,98483,3.951146763496239,0.18757487624587407
6989,0.2962380952380952,0,2,0,179062,426548,9473,98483,3.9511282374300642,0.18757559077463998
6990,0.29625,2,11,2,179073,426537,9475,98481,3.951026344066101,0.18757642595111024
6991,0.2963095238095238,1,1,1,179074,426536,9476,98480,3.9510170810330134,0.18757523580233745
6992,0.2963333333333333,3,32,3,179106,426504,9479,98477,3.9507206639742116,0.18758202677811198
6993,0.2963492063492063,1,3,1,179109,426501,9480,98476,3.950692874874949,0.1875815511917665
6994,0.2963823529411765,0,1,0,179110,426500,9480,98476,3.9506836118418613,0.1875819085062936
6995,0.2963888888888888,0,1,0,179111,426499,9480,98476,3.950674348808774,0.18758226582218201
6996,0.2964166666666666,1,0,1,179111,426499,9481,98475,3.950674348808774,0.18758071828319117
6997,0.2964285714285714,1,7,1,179118,426492,9482,98474,3.9506095075771612,0.1875816719558981
6998,0.2964285714285715,0,2,0,179120,426490,9482,98474,3.950590981510986,0.18758238660174792
6999,0.2964404761904761,0,1,0,179121,426489,9482,98474,3.950581718477898,0.18758274392671484
7000,0.2964999999999999,0,1,0,179122,426488,9482,98474,3.950572455444811,0.1875831012530431
7001,0.2965,4,36,4,179158,426452,9486,98470,3.950238986253659,0.187589775242798
7002,0.2965238095238095,0,1,0,179159,426451,9486,98470,3.950229723220571,0.1875901326104309
7003,0.296547619047619,0,3,0,179162,426448,9486,98470,3.9502019341213086,0.18759120472149937
7004,0.2965595238095238,0,3,0,179165,426445,9486,98470,3.950174145022046,0.1875922768448225
7005,0.2966071428571428,0,5,0,179170,426440,9486,98470,3.950127829856608,0.1875940637442609
7006,0.2966428571428571,0,1,0,179171,426439,9486,98470,3.950118566823521,0.18759442112823366
7007,0.2966666666666666,30,359,30,179530,426080,9516,98440,3.9467931379450887,0.18767635171204147
7008,0.2966666666666667,35,465,35,179995,425615,9551,98405,3.942485827559376,0.18778863402160223
7009,0.2967142857142857,0,1,0,179996,425614,9551,98405,3.9424765645262885,0.18778899238386396
7010,0.2967539682539682,0,1,0,179997,425613,9551,98405,3.942467301493201,0.1877893507474934
7011,0.2967857142857142,2,2,2,179999,425611,9553,98403,3.942448775427026,0.18778696752376844
7012,0.2967857142857143,0,1,0,180000,425610,9553,98403,3.942439512393938,0.18778732588695318
7013,0.2968333333333333,1,9,1,180009,425601,9554,98402,3.9423561450961504,0.18778900120800834
7014,0.2968333333333334,0,6,0,180015,425595,9554,98402,3.9423005668976248,0.18779115147605807
7015,0.2968571428571428,0,1,0,180016,425594,9554,98402,3.9422913038645375,0.18779150985885387
7016,0.2968888888888888,0,4,0,180020,425590,9554,98402,3.9422542517321872,0.18779294340371608
7017,0.2969047619047619,0,2,0,180022,425588,9554,98402,3.942235725666012,0.18779366018435467
7018,0.2969523809523809,0,1,0,180023,425587,9554,98402,3.9422264626329246,0.18779401857672584
7019,0.2969761904761904,0,1,0,180024,425586,9554,98402,3.942217199599837,0.18779437697046497
7020,0.2969920634920635,1,0,1,180024,425586,9555,98401,3.942217199599837,0.18779282692127858
7021,0.2969999999999999,0,1,0,180025,425585,9555,98401,3.9422079365667493,0.18779318531411143
7022,0.297,4,47,4,180072,425538,9559,98397,3.9417725740116345,0.18780383062784506
7023,0.2970238095238095,0,2,0,180074,425536,9559,98397,3.941754047945459,0.1878045475280236
7024,0.2970238095238096,0,1,0,180075,425535,9559,98397,3.941744784912372,0.18780490598016536
7025,0.297047619047619,0,1,0,180076,425534,9559,98397,3.941735521879284,0.18780526443367543
7026,0.2970714285714286,0,2,0,180078,425532,9559,98397,3.941716995813109,0.18780598134480053
7027,0.2970833333333333,0,3,0,180081,425529,9559,98397,3.9416892067138463,0.18780705672175077
7028,0.2970952380952381,0,2,0,180083,425527,9559,98397,3.9416706806476713,0.18780777364655943
7029,0.2971428571428571,2,14,2,180097,425513,9561,98395,3.9415409981844456,0.18780969177794574
7030,0.2971666666666666,0,6,0,180103,425507,9561,98395,3.9414854199859204,0.1878118426728663
7031,0.2971666666666667,1,8,1,180111,425499,9562,98394,3.94141131572122,0.18781316032090523
7032,0.2972142857142857,0,1,0,180112,425498,9562,98394,3.941402052688132,0.18781351881685537
7033,0.29725,0,1,0,180113,425497,9562,98394,3.9413927896550445,0.18781387731417412
7034,0.2972619047619047,0,1,0,180114,425496,9562,98394,3.9413835266219572,0.18781423581286147
7035,0.2973333333333333,4,53,4,180167,425443,9566,98390,3.940892585868317,0.18782703647918325
7036,0.2973538961038961,0,3,0,180170,425440,9566,98390,3.940864796769054,0.18782811217379683
7037,0.2973701298701298,0,1,0,180171,425439,9566,98390,3.9408555337359665,0.18782847074140607
7038,0.2973809523809523,0,7,0,180178,425432,9566,98390,3.9407906925043537,0.1878309807530039
7039,0.2973809523809524,0,2,0,180180,425430,9566,98390,3.9407721664381787,0.18783169791149631
7040,0.2974285714285714,0,2,0,180182,425428,9566,98390,3.9407536403720034,0.18783241507546514
7041,0.2975,29,371,29,180553,425057,9595,98361,3.937317055096521,0.1879205529806006
7042,0.297547619047619,0,3,0,180556,425054,9595,98361,3.9372892659972583,0.1879216300640983
7043,0.2975714285714285,0,1,0,180557,425053,9595,98361,3.9372800029641706,0.18792198909467459
7044,0.2975984848484849,0,2,0,180559,425051,9595,98361,3.9372614768979957,0.18792270715994283
7045,0.2975999278499278,0,2,0,180561,425049,9595,98361,3.9372429508318203,0.1879234252306987
7046,0.2976190476190476,0,4,0,180565,425045,9595,98361,3.93720589869947,0.18792486138867343
7047,0.2976666666666666,3,27,3,180592,425018,9598,98358,3.936955796806106,0.18792990125645806
7048,0.2976666666666667,0,23,0,180615,424995,9598,98358,3.9367427470450926,0.18793816028569627
7049,0.2976904761904761,0,1,0,180616,424994,9598,98358,3.936733484012005,0.18793851939039116
7050,0.2977142857142857,0,1,0,180617,424993,9598,98358,3.9367242209789173,0.1879388784964584
7051,0.2977619047619048,0,1,0,180618,424992,9598,98358,3.9367149579458296,0.18793923760389797
7052,0.2977777777777778,1,4,1,180622,424988,9599,98357,3.9366779058134798,0.18793912237625277
7053,0.2977857142857142,0,1,0,180623,424987,9599,98357,3.936668642780392,0.1879394814882754
7054,0.2978333333333333,1,13,1,180636,424974,9600,98356,3.936548223350254,0.18794259836049912
7055,0.2978571428571428,2,3,2,180639,424971,9602,98354,3.936520434250991,0.18794057230210673
7056,0.2979047619047619,0,1,0,180640,424970,9602,98354,3.9365111712179037,0.18794093143062424
7057,0.2979166666666666,0,3,0,180643,424967,9602,98354,3.936483382118641,0.18794200882441178
7058,0.2979206349206349,0,1,0,180644,424966,9602,98354,3.9364741190855534,0.18794236795841932
7059,0.2979523809523809,0,1,0,180645,424965,9602,98354,3.9364648560524658,0.1879427270937994
7060,0.2979999999999999,0,2,0,180647,424963,9602,98354,3.936446329986291,0.1879434453686771
7061,0.298,7,86,7,180733,424877,9609,98347,3.935649709140761,0.18796347262357996
7062,0.298047619047619,0,1,0,180734,424876,9609,98347,3.9356404461076737,0.18796383186518942
7063,0.2980634920634921,0,1,0,180735,424875,9609,98347,3.935631183074586,0.18796419110817206
7064,0.2980714285714285,0,1,0,180736,424874,9609,98347,3.9356219200414984,0.1879645503525279
7065,0.2980952380952381,1,2,1,180738,424872,9610,98346,3.9356033939753234,0.18796371684460397
7066,0.2981428571428571,0,1,0,180739,424871,9610,98346,3.9355941309422358,0.1879640760907998
7067,0.2981666666666666,0,3,0,180742,424868,9610,98346,3.935566341842973,0.18796515383762666
7068,0.2981666666666667,2,12,2,180754,424856,9612,98344,3.9354551854459223,0.1879663608562691
7069,0.2981818181818182,0,1,0,180755,424855,9612,98344,3.9354459224128346,0.18796672011987792
7070,0.2982063492063492,0,2,0,180757,424853,9612,98344,3.9354273963466597,0.1879674386512155
7071,0.2982142857142857,1,5,1,180762,424848,9613,98343,3.9353810811812218,0.18796768293032565
7072,0.2982261904761905,0,1,0,180763,424847,9613,98343,3.9353718181481345,0.1879680422026415
7073,0.2982380952380952,0,1,0,180764,424846,9613,98343,3.935362555115047,0.18796840147633073
7074,0.2982391774891775,1,1,1,180765,424845,9614,98342,3.935353292081959,0.18796720866535294
7075,0.2982619047619048,0,1,0,180766,424844,9614,98342,3.935344029048872,0.18796756793950908
7076,0.2982857142857142,1,1,1,180767,424843,9615,98341,3.9353347660157842,0.18796637511850514
7077,0.2983095238095238,0,1,0,180768,424842,9615,98341,3.9353255029826966,0.18796673439312822
7078,0.2983333333333333,29,414,29,181182,424428,9644,98312,3.931490607284449,0.18807055132570685
7079,0.2984166666666666,0,1,0,181183,424427,9644,98312,3.931481344251362,0.18807091110477694
7080,0.2984285714285714,1,1,1,181184,424426,9645,98311,3.931472081218274,0.18806971765916705
7081,0.2984444444444444,1,2,1,181186,424424,9646,98310,3.931453555152099,0.1880688839830583
7082,0.2984761904761905,0,1,0,181187,424423,9646,98310,3.9314442921190116,0.18806924376306833
7083,0.2985,1,27,1,181214,424396,9647,98309,3.9311941902256473,0.18807740503725812
7084,0.2985119047619047,0,2,0,181216,424394,9647,98309,3.9311756641594724,0.18807812467118037
7085,0.2985238095238095,0,2,0,181218,424392,9647,98309,3.9311571380932975,0.1880788443106097
7086,0.2985714285714285,1,0,1,181218,424392,9648,98308,3.9311571380932975,0.1880772909890951
7087,0.2985714285714286,0,5,0,181223,424387,9648,98308,3.9311108229278595,0.18807909010034532
7088,0.2985952380952381,2,2,2,181225,424385,9650,98306,3.9310922968616846,0.18807670306165594
7089,0.2986190476190476,1,1,1,181226,424384,9651,98305,3.931083033828597,0.1880755095286107
7090,0.2986666666666666,0,6,0,181232,424378,9651,98305,3.9310274556300717,0.188077668491227
7091,0.2986666666666667,2,20,2,181252,424358,9653,98303,3.9308421949683203,0.18808175853947395
7092,0.2986904761904762,0,2,0,181254,424356,9653,98303,3.9308236689021454,0.1880824782506376
7093,0.2987142857142857,0,2,0,181256,424354,9653,98303,3.93080514283597,0.18808319796730935
7094,0.29875,0,8,0,181264,424346,9653,98303,3.93073103857127,0.18808607688907852
7095,0.2987619047619048,0,1,0,181265,424345,9653,98303,3.9307217755381822,0.18808643676049655
7096,0.2987857142857142,0,3,0,181268,424342,9653,98303,3.9306939864389197,0.18808751638301333
7097,0.2988095238095238,0,3,0,181271,424339,9653,98303,3.930666197339657,0.18808859601792433
7098,0.2988333333333333,0,11,0,181282,424328,9653,98303,3.930564303975694,0.18809255478530743
7099,0.2988571428571429,1,1,1,181283,424327,9654,98302,3.930555040942606,0.18809136117590106
7100,0.2989999999999999,0,2,0,181285,424325,9654,98302,3.9305365148764313,0.18809208096787958
7101,0.299,8,73,8,181358,424252,9662,98294,3.9298603134610395,0.18810592751642918
7102,0.2990079365079365,1,0,1,181358,424252,9663,98293,3.9298603134610395,0.18810437378598974
7103,0.2990277777777777,0,1,0,181359,424251,9663,98293,3.9298510504279522,0.18810473376404666
7104,0.299047619047619,0,5,0,181364,424246,9663,98293,3.9298047352625143,0.1881065336749984
7105,0.2990833333333333,0,1,0,181365,424245,9663,98293,3.9297954722294266,0.18810689366132224
7106,0.2990952380952381,0,1,0,181366,424244,9663,98293,3.9297862091963394,0.1881072536490239
7107,0.2991428571428571,0,2,0,181368,424242,9663,98293,3.929767683130164,0.18810797362856077
7108,0.2991666666666666,4,67,4,181435,424175,9667,98289,3.929147059913298,0.18812588044343725
7109,0.2991666666666667,4,63,4,181498,424112,9671,98285,3.928563488828782,0.1881423515066128
7110,0.2991904761904762,0,1,0,181499,424111,9671,98285,3.9285542257956947,0.1881427116593542
7111,0.2991984126984127,0,1,0,181500,424110,9671,98285,3.928544962762607,0.18814307181347448
7112,0.2992142857142857,0,2,0,181502,424108,9671,98285,3.928526436696432,0.1881437921258516
7113,0.2992222222222222,0,1,0,181503,424107,9671,98285,3.9285171736633444,0.1881441522841085
7114,0.2992380952380952,0,1,0,181504,424106,9671,98285,3.9285079106302567,0.18814451244374425
7115,0.29925,0,1,0,181505,424105,9671,98285,3.928498647597169,0.1881448726047589
7116,0.2992777777777777,0,2,0,181507,424103,9671,98285,3.928480121530994,0.1881455929309249
7117,0.2992857142857142,0,7,0,181514,424096,9671,98285,3.9284152802993813,0.1881481141159422
7118,0.2992857142857143,0,4,0,181518,424092,9671,98285,3.928378228167031,0.18814955482343212
7119,0.2993052503052503,0,1,0,181519,424091,9671,98285,3.9283689651339433,0.18814991500375208
7120,0.2993333333333333,5,40,5,181559,424051,9676,98280,3.9279984438104414,0.18815655207138768
7121,0.2993333333333334,0,6,0,181565,424045,9676,98280,3.9279428656119157,0.1881587134446944
7122,0.2993675213675213,1,2,1,181567,424043,9677,98279,3.927924339545741,0.18815787962214878
7123,0.2994047619047619,0,1,0,181568,424042,9677,98279,3.927915076512653,0.18815823985633356
7124,0.2994761904761905,1,0,1,181568,424042,9678,98278,3.927915076512653,0.18815668555674683
7125,0.2995,4,11,4,181579,424031,9682,98274,3.92781318314869,0.18815443084021788
7126,0.2995238095238094,1,2,1,181581,424029,9683,98273,3.927794657082515,0.1881535969611451
7127,0.2995238095238095,0,1,0,181582,424028,9683,98273,3.9277853940494274,0.18815395720092437
7128,0.2995238095238096,0,1,0,181583,424027,9683,98273,3.92777613101634,0.1881543174420831
7129,0.2995454545454545,0,1,0,181584,424026,9683,98273,3.9277668679832525,0.18815467768462127
7130,0.2995714285714286,0,1,0,181585,424025,9683,98273,3.927757604950165,0.18815503792853888
7131,0.2995833333333333,0,3,0,181588,424022,9683,98273,3.927729815850902,0.18815611866856852
7132,0.2996190476190476,0,1,0,181589,424021,9683,98273,3.9277205528178145,0.18815647891800405
7133,0.2996363636363636,0,1,0,181590,424020,9683,98273,3.9277112897847273,0.18815683916881903
7134,0.2996428571428571,0,3,0,181593,424017,9683,98273,3.9276835006854642,0.18815791992954106
7135,0.2996666666666666,0,11,0,181604,424006,9683,98273,3.9275816073215015,0.1881618828250801
7136,0.2996666666666667,1,15,1,181619,423991,9684,98272,3.927442661825188,0.18816573259066793
7137,0.2997063492063492,0,1,0,181620,423990,9684,98272,3.9274333987921004,0.18816609288058483
7138,0.2997222222222222,0,1,0,181621,423989,9684,98272,3.9274241357590127,0.1881664531718815
7139,0.2997619047619047,0,1,0,181622,423988,9684,98272,3.9274148727259255,0.18816681346455788
7140,0.2997619047619048,0,1,0,181623,423987,9684,98272,3.927405609692838,0.18816717375861403
7141,0.2998095238095238,0,1,0,181624,423986,9684,98272,3.92739634665975,0.1881675340540499
7142,0.2998333333333333,1,23,1,181647,423963,9685,98271,3.9271832968987366,0.18817426670802745
7143,0.2998398268398268,0,2,0,181649,423961,9685,98271,3.927164770832561,0.18817498736193874
7144,0.2998809523809523,0,2,0,181651,423959,9685,98271,3.9271462447663863,0.1881757080213699
7145,0.2999285714285714,1,0,1,181651,423959,9686,98270,3.9271462447663863,0.18817415348439095
7146,0.3,283,3856,283,185507,420103,9969,97987,3.8914279891807775,0.18913123202532378
7147,0.3000238095238096,0,2,0,185509,420101,9969,97987,3.891409463114602,0.18913196213770633
7148,0.3000357142857143,0,1,0,185510,420100,9969,97987,3.891400200081515,0.18913232719601147
7149,0.300047619047619,1,1,1,185511,420099,9970,97986,3.891390937048427,0.18913112713164829
7150,0.3001111111111111,0,4,0,185515,420095,9970,97986,3.891353884916077,0.1891325873753332
7151,0.3001190476190476,0,3,0,185518,420092,9970,97986,3.8913260958168143,0.18913368257289442
7152,0.3001666666666666,0,9,0,185527,420083,9970,97986,3.891242728519026,0.18913696824168208
7153,0.3001666666666667,1,4,1,185531,420079,9971,97985,3.8912056763866762,0.1891368633991167
7154,0.3002222222222223,1,2,1,185533,420077,9972,97984,3.891187150320501,0.189136028382758
7155,0.30025,0,2,0,185535,420075,9972,97984,3.891168624254326,0.18913675855452758
7156,0.3003333333333333,2,39,2,185574,420036,9974,97982,3.8908073659639113,0.18914786744862147
7157,0.3003333333333334,0,1,0,185575,420035,9974,97982,3.8907981029308236,0.18914823258696142
7158,0.3003571428571428,1,6,1,185581,420029,9975,97981,3.8907425247322984,0.18914885813015192
7159,0.3004166666666666,1,1,1,185582,420028,9976,97980,3.8907332616992107,0.18914765795122856
7160,0.3004761904761904,0,7,0,185589,420021,9976,97980,3.890668420467598,0.18915021399572587
7161,0.3004761904761905,0,1,0,185590,420020,9976,97980,3.89065915743451,0.18915057915057915
7162,0.3005,0,25,0,185615,419995,9976,97980,3.8904275816073217,0.189159708480139
7163,0.3005555555555556,0,2,0,185617,419993,9976,97980,3.8904090555411464,0.189160438864574
7164,0.3005714285714285,0,1,0,185618,419992,9976,97980,3.8903997925080587,0.18916080405890665
7165,0.3005897435897435,1,1,1,185619,419991,9977,97979,3.8903905294749714,0.18915960383806013
7166,0.3005952380952381,1,2,1,185621,419989,9978,97978,3.890372003408796,0.1891587688018735
7167,0.3006060606060606,0,1,0,185622,419988,9978,97978,3.890362740375709,0.18915913399721218
7168,0.3006190476190476,1,1,1,185623,419987,9979,97977,3.890353477342621,0.18915793375601392
7169,0.3006547619047619,0,1,0,185624,419986,9979,97977,3.8903442143095335,0.18915829895185562
7170,0.3006666666666666,4,53,4,185677,419933,9983,97973,3.889853273555893,0.1891713940367557
7171,0.3006666666666667,1,3,1,185680,419930,9984,97972,3.8898254844566305,0.18917092422890816
7172,0.3007142857142857,1,10,1,185690,419920,9985,97971,3.889732854125755,0.18917301130932956
7173,0.3007222222222221,0,1,0,185691,419919,9985,97971,3.8897235910926673,0.18917337658576144
7174,0.3007539682539683,0,1,0,185692,419918,9985,97971,3.8897143280595796,0.18917374186360397
7175,0.3007673160173159,0,2,0,185694,419916,9985,97971,3.8896958019934047,0.18917447242352095
7176,0.3007777777777778,0,1,0,185695,419915,9985,97971,3.889686538960317,0.18917483770559543
7177,0.3007857142857142,0,5,0,185700,419910,9985,97971,3.8896402237948795,0.18917666413712803
7178,0.3007936507936508,0,2,0,185702,419908,9985,97971,3.889621697728704,0.18917739471961598
7179,0.3008095238095238,1,2,1,185704,419906,9986,97970,3.8896031716625292,0.18917655963975932
7180,0.3008333333333333,14,127,14,185831,419779,10000,97956,3.8884267664604097,0.18920103914164582
7181,0.3008452380952381,0,1,0,185832,419778,10000,97956,3.888417503427322,0.18920140458227583
7182,0.3008571428571429,0,3,0,185835,419775,10000,97956,3.8883897143280595,0.1892025009126361
7183,0.300861111111111,0,1,0,185836,419774,10000,97956,3.8883804512949722,0.18920286635891295
7184,0.3009523809523809,1,3,1,185839,419771,10001,97955,3.888352662195709,0.18920239663451324
7185,0.301,5,83,5,185922,419688,10006,97950,3.8875838304494423,0.18922490234488196
7186,0.3010833333333333,0,1,0,185923,419687,10006,97950,3.8875745674163547,0.18922526790009214
7187,0.3010873015873015,0,2,0,185925,419685,10006,97950,3.8875560413501797,0.18922599901474976
7188,0.3010952380952381,0,3,0,185928,419682,10006,97950,3.887528252250917,0.18922709569732937
7189,0.3011190476190476,0,1,0,185929,419681,10006,97950,3.8875189892178295,0.1892274612610141
7190,0.3011428571428571,1,3,1,185932,419678,10007,97949,3.887491200118567,0.189226991636835
7191,0.3011547619047619,0,1,0,185933,419677,10007,97949,3.887481937085479,0.1892273572038499
7192,0.3011666666666666,2,3,2,185936,419674,10009,97947,3.8874541479862166,0.18922532122923916
7193,0.3011666666666667,0,9,0,185945,419665,10009,97947,3.887370780688429,0.18922861139231703
7194,0.3011904761904762,0,2,0,185947,419663,10009,97947,3.8873522546222534,0.18922934255520565
7195,0.3012121212121212,0,1,0,185948,419662,10009,97947,3.8873429915891657,0.18922970813876883
7196,0.30125,0,5,0,185953,419657,10009,97947,3.8872966764237282,0.18923153607777374
7197,0.3012828282828282,0,1,0,185954,419656,10009,97947,3.8872874133906405,0.18923190166981257
7198,0.3012857142857143,0,1,0,185955,419655,10009,97947,3.887278150357553,0.18923226726326406
7199,0.3013095238095238,0,2,0,185957,419653,10009,97947,3.887259624291378,0.18923299845440494
7200,0.3013333333333333,4,32,4,185989,419621,10013,97943,3.886963207232576,0.1892384323484632
7201,0.3013809523809523,0,1,0,185990,419620,10013,97943,3.8869539441994885,0.1892387979820814
7202,0.3013809523809524,0,2,0,185992,419618,10013,97943,3.8869354181333136,0.18923952925355658
7203,0.3013888888888889,0,1,0,185993,419617,10013,97943,3.886926155100226,0.18923989489141355
7204,0.3014047619047618,0,1,0,185994,419616,10013,97943,3.8869168920671386,0.18924026053068346
7205,0.3014285714285714,1,8,1,186002,419608,10014,97942,3.886842787802438,0.18924161916723023
7206,0.3014999999999999,0,2,0,186004,419606,10014,97942,3.8868242617362627,0.1892423504679759
7207,0.3015,2,22,2,186026,419584,10016,97940,3.886620475008337,0.18924726196273023
7208,0.301547619047619,0,4,0,186030,419580,10016,97940,3.8865834228759866,0.18924872468696863
7209,0.3015952380952381,0,2,0,186032,419578,10016,97940,3.886564896809811,0.18924945605756707
7210,0.3015966533466535,0,5,0,186037,419573,10016,97940,3.8865185816443737,0.18925128450879494
7211,0.3016190476190476,0,2,0,186039,419571,10016,97940,3.8865000555781983,0.18925201589917895
7212,0.3016309523809523,0,2,0,186041,419569,10016,97940,3.8864815295120234,0.18925274729521613
7213,0.3016428571428571,0,1,0,186042,419568,10016,97940,3.8864722664789357,0.18925311299535466
7214,0.3016666666666666,16,200,16,186242,419368,10032,97924,3.884619659861425,0.18930120705520287
7215,0.3016666666666667,13,232,13,186474,419136,10045,97911,3.8824706361851122,0.18936576365398117
7216,0.3017222222222223,0,1,0,186475,419135,10045,97911,3.882461373152025,0.18936612989946736
7217,0.30175,0,1,0,186476,419134,10045,97911,3.8824521101189373,0.18936649614637024
7218,0.3017777777777777,0,1,0,186477,419133,10045,97911,3.8824428470858496,0.1893668623946898
7219,0.3017857142857142,0,2,0,186479,419131,10045,97911,3.8824243210196747,0.18936759489557908
7220,0.3017857142857143,0,2,0,186481,419129,10045,97911,3.8824057949534994,0.18936832740213524
7221,0.3018333333333333,1,11,1,186492,419118,10046,97910,3.8823039015895366,0.18937078842925334
7222,0.3018333333333334,0,5,0,186497,419113,10046,97910,3.8822575864240987,0.18937261978674064
7223,0.3018571428571428,1,2,1,186499,419111,10047,97909,3.8822390603579238,0.18937178445708097
7224,0.3018571428571429,0,1,0,186500,419110,10047,97909,3.882229797324836,0.18937215073333863
7225,0.3018888888888889,0,1,0,186501,419109,10047,97909,3.8822205342917484,0.18937251701101315
7226,0.3019047619047619,1,2,1,186503,419107,10048,97908,3.8822020082255735,0.18937168167267873
7227,0.3019404761904761,0,1,0,186504,419106,10048,97908,3.882192745192486,0.18937204795227983
7228,0.3019444444444444,0,1,0,186505,419105,10048,97908,3.882183482159398,0.18937241423329781
7229,0.3019523809523809,0,1,0,186506,419104,10048,97908,3.882174219126311,0.1893727805157327
7230,0.3019999999999999,0,2,0,186508,419102,10048,97908,3.8821556930601355,0.18937351308485328
7231,0.302,8,103,8,186611,418999,10056,97900,3.8812016006521177,0.18939870264790606
7232,0.3020238095238094,0,3,0,186614,418996,10056,97900,3.8811738115528547,0.18939980189438493
7233,0.3020238095238096,0,1,0,186615,418995,10056,97900,3.8811645485197674,0.18940016831271342
7234,0.3020454545454545,0,1,0,186616,418994,10056,97900,3.8811552854866798,0.18940053473245966
7235,0.3020833333333333,1,10,1,186626,418984,10057,97899,3.8810626551558043,0.1894026307694391
7236,0.3021428571428571,1,12,1,186638,418972,10058,97898,3.8809514987587534,0.18940545978679357
7237,0.3021666666666666,0,4,0,186642,418968,10058,97898,3.880914446626403,0.1894069255861287
7238,0.3021666666666667,1,6,1,186648,418962,10059,97897,3.880858868427878,0.1894075560259181
7239,0.3021746031746032,0,1,0,186649,418961,10059,97897,3.8808496053947903,0.18940792248547958
7240,0.3021904761904761,0,1,0,186650,418960,10059,97897,3.880840342361703,0.18940828894645909
7241,0.3021904761904762,0,1,0,186651,418959,10059,97897,3.8808310793286154,0.18940865540885662
7242,0.3022142857142856,0,1,0,186652,418958,10059,97897,3.8808218162955277,0.18940902187267222
7243,0.3022222222222222,0,2,0,186654,418956,10059,97897,3.8808032902293528,0.18940975480455757
7244,0.3022307692307692,0,1,0,186655,418955,10059,97897,3.880794027196265,0.18941012127262738
7245,0.30225,0,1,0,186656,418954,10059,97897,3.8807847641631774,0.18941048774211522
7246,0.3022619047619048,0,1,0,186657,418953,10059,97897,3.88077550113009,0.18941085421302117
7247,0.3023333333333333,0,41,0,186698,418912,10059,97897,3.8803957167735,0.18942588074124095
7248,0.3023571428571428,0,1,0,186699,418911,10059,97897,3.880386453740413,0.18942624727171406
7249,0.3023809523809523,0,8,0,186707,418903,10059,97897,3.8803123494757124,0.18942917956656347
7250,0.3023809523809524,0,4,0,186711,418899,10059,97897,3.880275297343362,0.18943064574803212
7251,0.3025,35,407,35,187118,418492,10094,97862,3.8765052428767275,0.18952501578374525
7252,0.3025238095238095,0,2,0,187120,418490,10094,97862,3.8764867168105526,0.18952574987605356
7253,0.3025238095238096,0,1,0,187121,418489,10094,97862,3.876477453777465,0.18952611692434024
7254,0.3025952380952381,0,1,0,187122,418488,10094,97862,3.876468190744377,0.18952648397404862
7255,0.3026190476190476,0,2,0,187124,418486,10094,97862,3.8764496646782023,0.1895272180777305
7256,0.3026666666666666,2,30,2,187154,418456,10096,97860,3.8761717736855754,0.18953509091331666
7257,0.3026666666666667,2,29,2,187183,418427,10098,97858,3.8759031457260367,0.18954259759628886
7258,0.3026855089355089,1,0,1,187183,418427,10099,97857,3.8759031457260367,0.18954102780640114
7259,0.3027142857142857,0,1,0,187184,418426,10099,97857,3.875893882692949,0.18954139493262417
7260,0.3027380952380952,0,2,0,187186,418424,10099,97857,3.875875356626774,0.18954212918933683
7261,0.3027499999999999,0,1,0,187187,418423,10099,97857,3.8758660935936864,0.18954249631982645
7262,0.3027619047619047,0,1,0,187188,418422,10099,97857,3.8758568305605987,0.1895428634517383
7263,0.3027777777777777,0,1,0,187189,418421,10099,97857,3.875847567527511,0.1895432305850724
7264,0.3027777777777778,0,1,0,187190,418420,10099,97857,3.875838304494424,0.1895435977198287
7265,0.3027857142857142,0,1,0,187191,418419,10099,97857,3.875829041461336,0.18954396485600725
7266,0.3028174603174603,0,1,0,187192,418418,10099,97857,3.8758197784282484,0.18954433199360807
7267,0.3028333333333333,0,7,0,187199,418411,10099,97857,3.8757549371966356,0.1895469019966374
7268,0.3028571428571428,4,14,4,187213,418397,10103,97853,3.87562525473341,0.1895457627118644
7269,0.3028690476190476,0,1,0,187214,418396,10103,97853,3.8756159917003226,0.189546129871438
7270,0.3029166666666666,0,4,0,187218,418392,10103,97853,3.8755789395679723,0.18954759852395664
7271,0.3029166666666667,0,1,0,187219,418391,10103,97853,3.8755696765348846,0.18954796569064242
7272,0.3029285714285714,0,4,0,187223,418387,10103,97853,3.8755326244025343,0.1895494343716101
7273,0.3029444444444444,0,2,0,187225,418385,10103,97853,3.8755140983363594,0.18955016872062885
7274,0.3029523809523809,0,1,0,187226,418384,10103,97853,3.8755048353032717,0.189550535897272
7275,0.3029761904761904,0,1,0,187227,418383,10103,97853,3.875495572270184,0.18955090307533765
7276,0.303,5,54,5,187281,418329,10108,97848,3.8749953684834564,0.1895628824996077
7277,0.3030238095238095,0,1,0,187282,418328,10108,97848,3.8749861054503687,0.18956324974427327
7278,0.3030555555555556,0,2,0,187284,418326,10108,97848,3.8749675793841933,0.18956398423787327
7279,0.3030833333333333,0,2,0,187286,418324,10108,97848,3.8749490533180184,0.18956471873716513
7280,0.3030952380952381,0,1,0,187287,418323,10108,97848,3.8749397902849307,0.18956508598894553
7281,0.3031428571428571,0,2,0,187289,418321,10108,97848,3.874921264218756,0.18956582049677528
7282,0.3031666666666666,2,21,2,187310,418300,10110,97846,3.874726740523917,0.1895703928733343
7283,0.3031666666666667,0,3,0,187313,418297,10110,97846,3.8746989514246546,0.1895714947214241
7284,0.3032142857142857,1,2,1,187315,418295,10111,97845,3.8746804253584792,0.18957065912349363
7285,0.3032222222222222,0,1,0,187316,418294,10111,97845,3.874671162325392,0.18957102640955248
7286,0.30325,1,0,1,187316,418294,10112,97844,3.874671162325392,0.18956945623069799
7287,0.3032619047619047,0,2,0,187318,418292,10112,97844,3.8746526362592166,0.18957019080242415
7288,0.3032705627705628,0,1,0,187319,418291,10112,97844,3.874643373226129,0.1895705580904221
7289,0.3032857142857142,0,1,0,187320,418290,10112,97844,3.8746341101930417,0.1895709253798432
7290,0.3033095238095238,0,1,0,187321,418289,10112,97844,3.874624847159954,0.1895712926706876
7291,0.3033333333333333,64,769,64,188090,417520,10176,97780,3.8675015747156247,0.18975354162623714
7292,0.3033333333333334,0,1,0,188091,417519,10176,97780,3.8674923116825375,0.1897539098659225
7293,0.3033373015873015,0,2,0,188093,417517,10176,97780,3.867473785616362,0.18975464634958092
7294,0.3033383458646616,0,1,0,188094,417516,10176,97780,3.867464522583275,0.18975501459355398
7295,0.3033571428571428,0,1,0,188095,417515,10176,97780,3.867455259550187,0.18975538283895632
7296,0.3033571428571429,1,1,1,188096,417514,10177,97779,3.8674459965170995,0.1897541786905702
7297,0.3033809523809523,0,3,0,188099,417511,10177,97779,3.867418207417837,0.18975528343263018
7298,0.3034015151515151,0,2,0,188101,417509,10177,97779,3.8673996813516616,0.18975601993448324
7299,0.3034523809523809,0,1,0,188102,417508,10177,97779,3.8673904183185743,0.18975638818755372
7300,0.303452380952381,0,1,0,188103,417507,10177,97779,3.8673811552854866,0.18975675644205353
7301,0.3034642857142857,0,1,0,188104,417506,10177,97779,3.867371892252399,0.18975712469798267
7302,0.3034761904761904,0,2,0,188106,417504,10177,97779,3.867353366186224,0.18975786121412894
7303,0.3034761904761905,1,0,1,188106,417504,10178,97778,3.867353366186224,0.18975628878943956
7304,0.3035,2,32,2,188138,417472,10180,97776,3.8670569491274223,0.18976492873334783
7305,0.3035714285714285,0,2,0,188140,417470,10180,97776,3.8670384230612473,0.18976566533267605
7306,0.3035714285714286,1,7,1,188147,417463,10181,97775,3.8669735818296345,0.18976667093653807
7307,0.3035833333333333,1,1,1,188148,417462,10182,97774,3.866964318796547,0.18976546669875552
7308,0.3036071428571428,0,1,0,188149,417461,10182,97774,3.866955055763459,0.18976583500732674
7309,0.3036309523809524,0,1,0,188150,417460,10182,97774,3.8669457927303714,0.18976620331732766
7310,0.3036363636363636,0,1,0,188151,417459,10182,97774,3.866936529697284,0.18976657162875826
7311,0.3036666666666666,1,9,1,188160,417450,10183,97773,3.866853162399496,0.1897683139145574
7312,0.3036666666666667,2,19,2,188179,417431,10185,97771,3.8666771647708327,0.18977216703351307
7313,0.3036904761904761,1,0,1,188179,417431,10186,97770,3.8666771647708327,0.18977059438937424
7314,0.3036904761904762,1,4,1,188183,417427,10187,97769,3.8666401126384824,0.18977049511253968
7315,0.3037142857142857,0,1,0,188184,417426,10187,97769,3.8666308496053947,0.1897708634594668
7316,0.30375,1,5,1,188189,417421,10188,97768,3.866584534439957,0.18977113253582667
7317,0.3037554112554113,0,1,0,188190,417420,10188,97768,3.8665752714068695,0.18977150088899586
7318,0.3037857142857142,0,1,0,188191,417419,10188,97768,3.866566008373782,0.18977186924359504
7319,0.3038095238095238,1,5,1,188196,417414,10189,97767,3.8665196932083443,0.18977213833584702
7320,0.3038333333333333,2,6,2,188202,417408,10191,97765,3.8664641150098187,0.18977120307158954
7321,0.3038571428571429,0,1,0,188203,417407,10191,97765,3.8664548519767314,0.18977157143633583
7322,0.303952380952381,0,1,0,188204,417406,10191,97765,3.8664455889436438,0.18977193980251217
7323,0.3039761904761905,0,2,0,188206,417404,10191,97765,3.8664270628774684,0.1897726765391551
7324,0.3039999999999999,0,4,0,188210,417400,10191,97765,3.8663900107451186,0.18977415002960216
7325,0.304,13,137,13,188347,417263,10204,97752,3.8651209752121236,0.18980418046076328
7326,0.3040238095238095,0,4,0,188351,417259,10204,97752,3.8650839230797733,0.1898056546365029
7327,0.304047619047619,1,8,1,188359,417251,10205,97751,3.8650098188150728,0.18980702987561213
7328,0.3041190476190476,0,1,0,188360,417250,10205,97751,3.865000555781985,0.18980739843223604
7329,0.3041666666666666,8,58,8,188418,417192,10213,97743,3.864463299862907,0.18981619039296221
7330,0.3041666666666667,2,72,2,188490,417120,10215,97741,3.863796361480603,0.18983958777223367
7331,0.3041746031746031,0,1,0,188491,417119,10215,97741,3.8637870984475158,0.18983995649302723
7332,0.3041904761904762,0,1,0,188492,417118,10215,97741,3.863777835414428,0.1898403252152531
7333,0.3042142857142857,0,6,0,188498,417112,10215,97741,3.863722257215903,0.18984253757868752
7334,0.3042380952380952,0,1,0,188499,417111,10215,97741,3.863712994182815,0.18984290631093984
7335,0.3042857142857142,0,5,0,188504,417106,10215,97741,3.8636666790173773,0.18984474999368744
7336,0.3042857142857143,2,14,2,188518,417092,10217,97739,3.8635369965541515,0.18984676524917884
7337,0.3043333333333333,1,39,1,188557,417053,10218,97738,3.8631757382637373,0.18985957407957793
7338,0.3043571428571428,0,1,0,188558,417052,10218,97738,3.8631664752306496,0.18985994288933353
7339,0.3043571428571429,0,1,0,188559,417051,10218,97738,3.863157212197562,0.18986031170052195
7340,0.3043809523809523,0,1,0,188560,417050,10218,97738,3.8631479491644742,0.18986068051314328
7341,0.3044047619047619,0,2,0,188562,417048,10218,97738,3.8631294230982993,0.18986141814268453
7342,0.3044285714285714,0,1,0,188563,417047,10218,97738,3.8631201600652116,0.18986178695960448
7343,0.3044444444444444,0,1,0,188564,417046,10218,97738,3.8631108970321244,0.18986215577795737
7344,0.3044484126984126,0,2,0,188566,417044,10218,97738,3.863092370965949,0.18986289341896181
7345,0.3044761904761904,0,2,0,188568,417042,10218,97738,3.863073844899774,0.18986363106569798
7346,0.3044761904761905,0,2,0,188570,417040,10218,97738,3.8630553188335988,0.1898643687181659
7347,0.3044999999999999,1,0,1,188570,417040,10219,97737,3.8630553188335988,0.1898627949578167
7348,0.3045,1,21,1,188591,417019,10220,97736,3.86286079513876,0.18986896679002632
7349,0.3045238095238095,0,2,0,188593,417017,10220,97736,3.862842269072585,0.189869704499051
7350,0.3045238095238096,0,2,0,188595,417015,10220,97736,3.86282374300641,0.18987044221380822
7351,0.3045714285714286,1,0,1,188595,417015,10221,97735,3.86282374300641,0.18986886838271005
7352,0.3045833333333333,0,2,0,188597,417013,10221,97735,3.862805216940235,0.1898696060985181
7353,0.3046428571428571,0,2,0,188599,417011,10221,97735,3.86278669087406,0.18987034382005882
7354,0.3046641414141414,0,1,0,188600,417010,10221,97735,3.8627774278409723,0.18987071268297895
7355,0.3046666666666666,2,11,2,188611,416999,10223,97733,3.862675534477009,0.18987162251424042
7356,0.3046666666666667,4,16,4,188627,416983,10227,97729,3.8625273259476085,0.18987122895910724
7357,0.3047142857142857,0,5,0,188632,416978,10227,97729,3.8624810107821705,0.18987307341846915
7358,0.3047222222222222,0,1,0,188633,416977,10227,97729,3.862471747749083,0.18987344231464176
7359,0.30475,0,1,0,188634,416976,10227,97729,3.8624624847159956,0.1898738112122478
7360,0.3047619047619048,0,1,0,188635,416975,10227,97729,3.862453221682908,0.18987418011128726
7361,0.3047857142857142,0,1,0,188636,416974,10227,97729,3.8624439586498203,0.18987454901176018
7362,0.3048015873015873,0,1,0,188637,416973,10227,97729,3.8624346956167326,0.18987491791366654
7363,0.3048095238095238,0,1,0,188638,416972,10227,97729,3.8624254325836453,0.18987528681700638
7364,0.3048333333333333,2,27,2,188665,416945,10229,97727,3.862175330690281,0.18988209966736097
7365,0.3048333333333334,0,2,0,188667,416943,10229,97727,3.862156804624106,0.18988283754638896
7366,0.3048571428571428,0,1,0,188668,416942,10229,97727,3.8621475415910185,0.18988320648805349
7367,0.3048571428571429,0,1,0,188669,416941,10229,97727,3.862138278557931,0.18988357543115172
7368,0.3048809523809523,0,2,0,188671,416939,10229,97727,3.862119752491756,0.18988431332164937
7369,0.3049166666666666,0,2,0,188673,416937,10229,97727,3.862101226425581,0.18988505121788196
7370,0.3049999999999999,2,33,2,188706,416904,10231,97725,3.8617955463336915,0.1898940790355771
7371,0.305,89,1430,89,190136,415474,10320,97636,3.848549409018489,0.19028278536765997
7372,0.305047619047619,0,3,0,190139,415471,10320,97636,3.8485216199192265,0.19028389790043793
7373,0.3050555555555555,0,1,0,190140,415470,10320,97636,3.848512356886139,0.19028426874758822
7374,0.3051190476190476,0,2,0,190142,415468,10320,97636,3.848493830819964,0.19028501044622534
7375,0.3051428571428571,0,2,0,190144,415466,10320,97636,3.8484753047537885,0.1902857521506445
7376,0.3051547619047619,1,1,1,190145,415465,10321,97635,3.848466041720701,0.19028454492301697
7377,0.3051666666666666,0,9,0,190154,415456,10321,97635,3.848382674422913,0.19028788265629293
7378,0.3051666666666667,0,5,0,190159,415451,10321,97635,3.848336359257475,0.19028973700315346
7379,0.3051785714285714,0,1,0,190160,415450,10321,97635,3.848327096224388,0.1902901078768625
7380,0.3052261904761905,1,1,1,190161,415449,10322,97634,3.8483178331913,0.19028890062621448
7381,0.3052380952380952,0,3,0,190164,415446,10322,97634,3.8482900440920376,0.19029001325329384
7382,0.3052499999999999,0,3,0,190167,415443,10322,97634,3.848262254992775,0.19029112589338443
7383,0.3052857142857142,0,4,0,190171,415439,10322,97634,3.8482252028604247,0.1902926094337453
7384,0.3053333333333333,4,34,4,190205,415405,10326,97630,3.847910259735448,0.19029890748194567
7385,0.3053333333333334,0,2,0,190207,415403,10326,97630,3.8478917336692726,0.19029964934029586
7386,0.3053809523809523,0,1,0,190208,415402,10326,97630,3.847882470636185,0.19030002027163997
7387,0.3054047619047619,0,1,0,190209,415401,10326,97630,3.8478732076030977,0.19030039120443015
7388,0.3054166666666666,1,3,1,190212,415398,10327,97629,3.847845418503835,0.19029992573490284
7389,0.3054523809523809,0,1,0,190213,415397,10327,97629,3.8478361554707474,0.1903002966711239
7390,0.3054545454545455,0,1,0,190214,415396,10327,97629,3.8478268924376597,0.190300667608791
7391,0.3054761904761904,0,2,0,190216,415394,10327,97629,3.847808366371485,0.19030140948846347
7392,0.3054761904761905,0,1,0,190217,415393,10327,97629,3.847799103338397,0.19030178043046886
7393,0.3055,2,19,2,190236,415374,10329,97627,3.8476231057097334,0.19030567191876818
7394,0.3055357142857143,0,1,0,190237,415373,10329,97627,3.847613842676646,0.19030604288499026
7395,0.3055555555555555,0,1,0,190238,415372,10329,97627,3.8476045796435585,0.1903064138526586
7396,0.3055555555555556,0,1,0,190239,415371,10329,97627,3.847595316610471,0.19030678482177318
7397,0.3055714285714285,0,2,0,190241,415369,10329,97627,3.847576790544296,0.19030752676434123
7398,0.3055952380952381,0,1,0,190242,415368,10329,97627,3.8475675275112082,0.19030789773779472
7399,0.3056190476190475,0,1,0,190243,415367,10329,97627,3.8475582644781205,0.1903082687126945
7400,0.3056190476190476,0,1,0,190244,415366,10329,97627,3.8475490014450333,0.1903086396890406
7401,0.3056666666666666,1,35,1,190279,415331,10330,97626,3.847224795286969,0.19032004631967203
7402,0.3056666666666667,1,8,1,190287,415323,10331,97625,3.8471506910222684,0.19032143609098778
7403,0.3057142857142857,1,13,1,190300,415310,10332,97624,3.8470302715921303,0.19032468114806195
7404,0.3057380952380952,1,3,1,190303,415307,10333,97623,3.8470024824928672,0.19032421577993097
7405,0.3057961972667855,0,4,0,190307,415303,10333,97623,3.8469654303605174,0.1903257000035093
7406,0.3058253968253968,0,1,0,190308,415302,10333,97623,3.8469561673274297,0.1903260710630209
7407,0.3058333333333333,14,144,14,190452,415158,10347,97609,3.845622290562822,0.19035741379612964
7408,0.3058571428571428,1,0,1,190452,415158,10348,97608,3.845622290562822,0.19035583482524193
7409,0.305952380952381,1,2,1,190454,415156,10349,97607,3.845603764496647,0.1903549983130608
7410,0.306,10,167,10,190621,414989,10359,97597,3.844056837971025,0.19040122047812463
7411,0.3060238095238095,1,2,1,190623,414987,10360,97596,3.8440383119048502,0.1904003839378208
7412,0.3060714285714285,0,4,0,190627,414983,10360,97596,3.8440012597725,0.19040186976056372
7413,0.3060833333333333,0,1,0,190628,414982,10360,97596,3.8439919967394123,0.19040224121987287
7414,0.3061111111111111,0,1,0,190629,414981,10360,97596,3.8439827337063246,0.1904026126806314
7415,0.3061428571428571,1,0,1,190629,414981,10361,97595,3.8439827337063246,0.1904010332126358
7416,0.3061666666666666,0,1,0,190630,414980,10361,97595,3.8439734706732374,0.19040140467248695
7417,0.3061666666666667,0,2,0,190632,414978,10361,97595,3.843954944607062,0.19040214759653748
7418,0.3061825396825397,1,0,1,190632,414978,10362,97594,3.843954944607062,0.19040056811530867
7419,0.3061904761904762,0,1,0,190633,414977,10362,97594,3.8439456815739748,0.19040093957715126
7420,0.3062103174603174,0,1,0,190634,414976,10362,97594,3.843936418540887,0.19040131104044325
7421,0.3062142857142857,0,1,0,190635,414975,10362,97594,3.8439271555077994,0.19040168250518466
7422,0.30625,0,7,0,190642,414968,10362,97594,3.8438623142761865,0.19040428279895896
7423,0.3062727272727273,0,1,0,190643,414967,10362,97594,3.843853051243099,0.19040465427529601
7424,0.3063095238095237,0,1,0,190644,414966,10362,97594,3.8438437882100116,0.19040502575308257
7425,0.3063095238095238,0,4,0,190648,414962,10362,97594,3.8438067360776613,0.19040651167872388
7426,0.3063333333333333,1,25,1,190673,414937,10363,97593,3.8435751602504724,0.1904142196554348
7427,0.3063809523809524,1,2,1,190675,414935,10364,97592,3.8435566341842975,0.19041338309981717
7428,0.3063888888888889,0,1,0,190676,414934,10364,97592,3.84354737115121,0.19041375461927784
7429,0.3064047619047619,0,1,0,190677,414933,10364,97592,3.843538108118122,0.1904141261401883
7430,0.3064126984126984,0,1,0,190678,414932,10364,97592,3.8435288450850345,0.19041449766254848
7431,0.3064206349206348,1,2,1,190680,414930,10365,97591,3.8435103190188595,0.19041366109876473
7432,0.3064285714285714,0,3,0,190683,414927,10365,97591,3.843482529919597,0.19041477567617138
7433,0.306452380952381,0,1,0,190684,414926,10365,97591,3.8434732668865093,0.1904151472048732
7434,0.3064761904761905,0,1,0,190685,414925,10365,97591,3.8434640038534216,0.19041551873502485
7435,0.3065,2,28,2,190713,414897,10367,97589,3.84320463892697,0.19042276276815367
7436,0.3065151515151515,0,1,0,190714,414896,10367,97589,3.843195375893883,0.1904231343356391
7437,0.3065238095238095,1,4,1,190718,414892,10368,97588,3.8431583237615325,0.19042304089915704
7438,0.306547619047619,0,2,0,190720,414890,10368,97588,3.843139797695357,0.1904237840453639
7439,0.3065833333333333,0,1,0,190721,414889,10368,97588,3.84313053466227,0.1904241556206425
7440,0.306611111111111,0,1,0,190722,414888,10368,97588,3.8431212716291823,0.19042452719737119
7441,0.3066111111111111,1,4,1,190726,414884,10369,97587,3.843084219496832,0.19042443377283788
7442,0.3066190476190476,0,1,0,190727,414883,10369,97587,3.8430749564637443,0.19042480535445977
7443,0.3066666666666666,29,329,29,191056,414554,10398,97558,3.840027418577939,0.19050129659137063
7444,0.3066666666666667,40,458,40,191514,414096,10438,97518,3.8357849494238394,0.1906085447231702
7445,0.30675,0,1,0,191515,414095,10438,97518,3.8357756863907517,0.19060891728709004
7446,0.3067619047619048,0,2,0,191517,414093,10438,97518,3.835757160324577,0.19060966241929903
7447,0.3067777777777777,0,2,0,191519,414091,10438,97518,3.8357386342584014,0.19061040755733383
7448,0.3067857142857143,0,2,0,191521,414089,10438,97518,3.8357201081922265,0.19061115270119447
7449,0.3068015873015872,1,3,1,191524,414086,10439,97517,3.835692319092964,0.19061068836578363
7450,0.3068333333333333,2,29,2,191553,414057,10441,97515,3.8354236911334247,0.19061832938472004
7451,0.306845238095238,0,1,0,191554,414056,10441,97515,3.835414428100337,0.1906187019983541
7452,0.3068571428571428,0,2,0,191556,414054,10441,97515,3.835395902034162,0.19061944722999244
7453,0.3068939393939394,0,1,0,191557,414053,10441,97515,3.8353866390010745,0.19061981984799675
7454,0.3069047619047619,0,1,0,191558,414052,10441,97515,3.835377375967987,0.19062019246745784
7455,0.3069166666666666,1,2,1,191560,414050,10442,97514,3.835358849901812,0.19061935554495626
7456,0.3069444444444444,1,1,1,191561,414049,10443,97513,3.835349586868724,0.19061814599207916
7457,0.306952380952381,0,2,0,191563,414047,10443,97513,3.8353310608025493,0.19061889123465478
7458,0.3069673382173382,1,1,1,191564,414046,10444,97512,3.8353217977694616,0.1906176816705046
7459,0.3069999999999999,0,2,0,191566,414044,10444,97512,3.8353032717032867,0.19061842691709216
7460,0.307,5,57,5,191623,413987,10449,97507,3.834775278817296,0.19063175716626196
7461,0.3070238095238095,1,0,1,191623,413987,10450,97506,3.834775278817296,0.1906301748020012
7462,0.307047619047619,1,0,1,191623,413987,10451,97505,3.834775278817296,0.1906285924315532
7463,0.3070833333333334,0,3,0,191626,413984,10451,97505,3.8347474897180334,0.1906297105118585
7464,0.3070952380952381,0,1,0,191627,413983,10451,97505,3.8347382266849457,0.1906300832082082
7465,0.3071190476190477,0,1,0,191628,413982,10451,97505,3.834728963651858,0.1906304559060152
7466,0.3071428571428571,1,13,1,191641,413969,10452,97504,3.83460854422172,0.1906337186909182
7467,0.3071544011544012,0,1,0,191642,413968,10452,97504,3.8345992811886322,0.1906340914067632
7468,0.3071666666666666,0,2,0,191644,413966,10452,97504,3.8345807551224573,0.1906348368428256
7469,0.3071666666666667,0,4,0,191648,413962,10452,97504,3.834543702990107,0.1906363277324397
7470,0.3072222222222222,1,3,1,191651,413959,10453,97503,3.8345159138908445,0.19063586346590752
7471,0.30725,0,1,0,191652,413958,10453,97503,3.8345066508577568,0.190636236193962
7472,0.3072619047619047,0,1,0,191653,413957,10453,97503,3.834497387824669,0.19063660892347398
7473,0.3072727272727272,0,1,0,191654,413956,10453,97503,3.834488124791582,0.19063698165444345
7474,0.3072857142857143,0,1,0,191655,413955,10453,97503,3.834478861758494,0.1906373543868705
7475,0.307297619047619,0,2,0,191657,413953,10453,97503,3.8344603356923193,0.19063809985609712
7476,0.3073333333333333,3,62,3,191719,413891,10456,97500,3.8338860276408906,0.19065646442741463
7477,0.3073333333333334,0,3,0,191722,413888,10456,97500,3.833858238541628,0.19065758289205065
7478,0.3073571428571428,0,2,0,191724,413886,10456,97500,3.833839712475453,0.19065832854243175
7479,0.3073809523809523,0,3,0,191727,413883,10456,97500,3.8338119233761905,0.19065944702893917
7480,0.3073809523809524,0,1,0,191728,413882,10456,97500,3.833802660343103,0.19065981986069122
7481,0.3074166666666666,0,3,0,191731,413879,10456,97500,3.83377487124384,0.19066093836469625
7482,0.3074285714285715,1,1,1,191732,413878,10457,97499,3.8337656082107525,0.19065972853687202
7483,0.3074523809523809,0,2,0,191734,413876,10457,97499,3.8337470821445776,0.1906604742116842
7484,0.3074999999999999,0,13,0,191747,413863,10457,97499,3.833626662714439,0.19066532124013907
7485,0.3075,27,381,27,192128,413482,10484,97472,3.830097447108081,0.19076472637458558
7486,0.3075833333333333,0,1,0,192129,413481,10484,97472,3.8300881840749934,0.19076509972541505
7487,0.3076190476190475,0,2,0,192131,413479,10484,97472,3.8300696580088185,0.1907658464314582
7488,0.3076309523809523,0,1,0,192132,413478,10484,97472,3.830060394975731,0.19076621978667188
7489,0.3076325618825619,2,0,2,192132,413478,10486,97470,3.830060394975731,0.19076305220883535
7490,0.3076428571428571,0,1,0,192133,413477,10486,97470,3.830051131942643,0.19076342556077244
7491,0.3076666666666666,4,10,4,192143,413467,10490,97466,3.8299585016117677,0.19076082382621595
7492,0.3076666666666667,1,17,1,192160,413450,10491,97465,3.8298010300492793,0.19076558723075268
7493,0.3076904761904762,0,1,0,192161,413449,10491,97465,3.8297917670161916,0.19076596061176637
7494,0.3077106227106226,0,2,0,192163,413447,10491,97465,3.8297732409500167,0.19076670737817863
7495,0.3077142857142856,0,1,0,192164,413446,10491,97465,3.829763977916929,0.1907670807635772
7496,0.3077142857142857,0,1,0,192165,413445,10491,97465,3.829754714883842,0.19076745415043744
7497,0.3077499999999999,0,1,0,192166,413444,10491,97465,3.829745451850754,0.19076782753875934
7498,0.3077777777777777,0,2,0,192168,413442,10491,97465,3.8297269257845787,0.19076857431978814
7499,0.3077777777777779,0,1,0,192169,413441,10491,97465,3.8297176627514915,0.19076894771249506
7500,0.3077857142857143,0,1,0,192170,413440,10491,97465,3.829708399718404,0.19076932110666367
7501,0.3078095238095237,0,1,0,192171,413439,10491,97465,3.829699136685316,0.19076969450229397
7502,0.3078333333333333,1,5,1,192176,413434,10492,97464,3.8296528215198786,0.19076997756890807
7503,0.3078571428571428,0,8,0,192184,413426,10492,97464,3.829578717255178,0.1907729648260878
7504,0.3079166666666666,0,3,0,192187,413423,10492,97464,3.8295509281559155,0.1907740850716499
7505,0.3079285714285714,0,1,0,192188,413422,10492,97464,3.829541665122828,0.19077445848976093
7506,0.3079444444444444,1,0,1,192188,413422,10493,97463,3.829541665122828,0.1907728745216634
7507,0.3079761904761904,0,1,0,192189,413421,10493,97463,3.82953240208974,0.19077324793886674
7508,0.3079761904761905,0,4,0,192193,413417,10493,97463,3.82949534995739,0.19077474162229877
7509,0.308,11,99,11,192292,413318,10504,97452,3.8285783096817223,0.19079429097245335
7510,0.3080357142857143,0,2,0,192294,413316,10504,97452,3.828559783615547,0.19079503806033268
7511,0.3080476190476189,0,2,0,192296,413314,10504,97452,3.828541257549372,0.19079578515406273
7512,0.308047619047619,1,1,1,192297,413313,10505,97451,3.8285319945162843,0.19079457440226796
7513,0.3080555555555556,0,1,0,192298,413312,10505,97451,3.8285227314831967,0.19079494795041926
7514,0.3080714285714285,0,1,0,192299,413311,10505,97451,3.8285134684501094,0.19079532150003328
7515,0.3080952380952381,1,5,1,192304,413306,10506,97450,3.8284671532846715,0.1907956049463932
7516,0.3081428571428571,0,1,0,192305,413305,10506,97450,3.828457890251584,0.1907959785024131
7517,0.3081439393939393,1,0,1,192305,413305,10507,97449,3.828457890251584,0.1907943941701876
7518,0.3081666666666666,0,27,0,192332,413278,10507,97449,3.82820778835822,0.19080448067167
7519,0.3082142857142857,0,2,0,192334,413276,10507,97449,3.828189262292045,0.19080522786235254
7520,0.3082261904761905,0,1,0,192335,413275,10507,97449,3.8281799992589574,0.1908056014598883
7521,0.3083059995559994,0,7,0,192342,413268,10507,97449,3.8281151580273445,0.19080821668360365
7522,0.3083253968253968,0,1,0,192343,413267,10507,97449,3.828105894994257,0.19080859029284378
7523,0.3083333333333333,34,435,34,192778,412832,10541,97415,3.8240764756011707,0.1909173400333564
7524,0.3083333333333334,0,1,0,192779,412831,10541,97415,3.8240672125680835,0.19091771420060127
7525,0.3083881118881119,0,1,0,192780,412830,10541,97415,3.824057949534996,0.1909180883693128
7526,0.3083928571428571,1,0,1,192780,412830,10542,97414,3.824057949534996,0.1909165026928293
7527,0.3084523809523809,0,2,0,192782,412828,10542,97414,3.8240394234688204,0.19091725102990345
7528,0.308452380952381,0,1,0,192783,412827,10542,97414,3.824030160435733,0.19091762520064048
7529,0.3084603174603174,0,1,0,192784,412826,10542,97414,3.8240208974026455,0.19091799937284415
7530,0.3085,6,26,6,192810,412800,10548,97408,3.823780058542369,0.1909182137481184
7531,0.3085238095238095,0,1,0,192811,412799,10548,97408,3.8237707955092817,0.19091858794567695
7532,0.3085277777777777,0,2,0,192813,412797,10548,97408,3.8237522694431063,0.1909193363451946
7533,0.3085396825396825,0,1,0,192814,412796,10548,97408,3.823743006410019,0.19091971054715368
7534,0.308547619047619,0,1,0,192815,412795,10548,97408,3.8237337433769314,0.19092008475057967
7535,0.3085714285714285,0,5,0,192820,412790,10548,97408,3.8236874282114934,0.19092195578971302
7536,0.3085833333333332,0,1,0,192821,412789,10548,97408,3.823678165178406,0.19092233000194042
7537,0.3085833333333333,1,0,1,192821,412789,10549,97407,3.823678165178406,0.19092074418458788
7538,0.3086428571428571,0,2,0,192823,412787,10549,97407,3.823659639112231,0.19092149260869395
7539,0.3086666666666666,0,30,0,192853,412757,10549,97407,3.8233817481196044,0.19093271967445763
7540,0.3086666666666667,0,1,0,192854,412756,10549,97407,3.8233724850865167,0.19093309393272345
7541,0.3086904761904762,0,6,0,192860,412750,10549,97407,3.8233169068879915,0.19093533951313027
7542,0.3086984126984127,0,2,0,192862,412748,10549,97407,3.823298380821816,0.19093608805167056
7543,0.30875,2,5,2,192867,412743,10551,97405,3.8232520656563787,0.1909347875518477
7544,0.3087619047619048,0,2,0,192869,412741,10551,97405,3.8232335395902033,0.1909355361014298
7545,0.3088095238095238,0,1,0,192870,412740,10551,97405,3.823224276557116,0.1909359103784218
7546,0.3088333333333333,0,6,0,192876,412734,10551,97405,3.8231686983585904,0.19093815607118844
7547,0.3088571428571428,0,2,0,192878,412732,10551,97405,3.8231501722924155,0.19093890464718302
7548,0.3088888888888889,0,2,0,192880,412730,10551,97405,3.82313164622624,0.1909396532290472
7549,0.3089166666666667,0,1,0,192881,412729,10551,97405,3.823122383193153,0.19094002752218045
7550,0.3089285714285714,1,1,1,192882,412728,10552,97404,3.823113120160065,0.1909388158359013
7551,0.308952380952381,0,1,0,192883,412727,10552,97404,3.8231038571269775,0.19093919012959415
7552,0.3089999999999999,0,2,0,192885,412725,10552,97404,3.8230853310608026,0.19093993872138224
7553,0.309,4,87,4,192972,412638,10556,97400,3.8222794471821855,0.1909661633054792
7554,0.3090357142857142,0,1,0,192973,412637,10556,97400,3.822270184149098,0.19096653772177313
7555,0.309047619047619,0,4,0,192977,412633,10556,97400,3.8222331320167475,0.19096803540163088
7556,0.3090555555555555,0,1,0,192978,412632,10556,97400,3.82222386898366,0.19096840982526586
7557,0.3091428571428571,0,2,0,192980,412630,10556,97400,3.822205342917485,0.19096915867694056
7558,0.3091666666666666,6,52,6,193032,412578,10562,97394,3.821723665196932,0.19097911257872982
7559,0.3091666666666667,8,71,8,193103,412507,10570,97386,3.8210659898477157,0.19099301225943482
7560,0.3091883116883117,0,2,0,193105,412505,10570,97386,3.821047463781541,0.1909937614117527
7561,0.3091904761904762,0,3,0,193108,412502,10570,97386,3.8210196746822778,0.1909948851512489
7562,0.3092142857142857,0,1,0,193109,412501,10570,97386,3.8210104116491905,0.19099525973401948
7563,0.3092380952380952,0,1,0,193110,412500,10570,97386,3.821001148616103,0.1909956343182594
7564,0.3092857142857143,1,12,1,193122,412488,10571,97385,3.820889992219052,0.19099854277437714
7565,0.3093095238095237,0,2,0,193124,412486,10571,97385,3.820871466152877,0.19099929197777477
7566,0.3093214285714284,0,1,0,193125,412485,10571,97385,3.8208622031197894,0.1909996665816777
7567,0.3093224683812919,0,1,0,193126,412484,10571,97385,3.820852940086702,0.19100004118705
7568,0.3093333333333333,7,48,7,193174,412436,10578,97378,3.8204083144984993,0.1910069162478865
7569,0.3093888888888889,0,1,0,193175,412435,10578,97378,3.820399051465412,0.19100729090862728
7570,0.3094047619047618,0,1,0,193176,412434,10578,97378,3.8203897884323244,0.19100766557083787
7571,0.3094166666666667,0,1,0,193177,412433,10578,97378,3.8203805253992367,0.19100804023451828
7572,0.3094285714285714,0,1,0,193178,412432,10578,97378,3.820371262366149,0.1910084148996685
7573,0.309452380952381,0,1,0,193179,412431,10578,97378,3.8203619993330618,0.19100878956628856
7574,0.3094761904761905,0,1,0,193180,412430,10578,97378,3.820352736299974,0.19100916423437844
7575,0.3094999999999999,1,1,1,193181,412429,10579,97377,3.8203434732668864,0.19100795204450322
7576,0.3095,3,14,3,193195,412415,10582,97374,3.8202137908036606,0.19100843682386243
7577,0.3095238095238095,0,3,0,193198,412412,10582,97374,3.820186001704398,0.19100956087456306
7578,0.3095714285714286,0,1,0,193199,412411,10582,97374,3.8201767386713104,0.19100993556106985
7579,0.3095833333333333,0,3,0,193202,412408,10582,97374,3.8201489495720478,0.19101105962941023
7580,0.3095833333333334,0,1,0,193203,412407,10582,97374,3.8201396865389605,0.191011434321797
7581,0.3095945165945165,1,0,1,193203,412407,10583,97373,3.8201396865389605,0.19100984738514654
7582,0.3095952380952381,0,3,0,193206,412404,10583,97373,3.8201118974396975,0.19101097146399307
7583,0.3096190476190476,0,1,0,193207,412403,10583,97373,3.8201026344066102,0.191011346159882
7584,0.3096428571428571,0,2,0,193209,412401,10583,97373,3.820084108340435,0.19101209555606993
7585,0.3096666666666666,1,13,1,193222,412388,10584,97372,3.819963688910297,0.19101537978656621
7586,0.3096666666666667,0,16,0,193238,412372,10584,97372,3.819815480380896,0.19102137543551273
7587,0.3097142857142857,1,5,1,193243,412367,10585,97371,3.819769165215458,0.1910216621087696
7588,0.3097460317460317,0,1,0,193244,412366,10585,97371,3.8197599021823705,0.1910220368542994
7589,0.3097510822510822,0,2,0,193246,412364,10585,97371,3.8197413761161956,0.19102278634977
7590,0.3097619047619047,0,1,0,193247,412363,10585,97371,3.819732113083108,0.19102316109971082
7591,0.3097619047619048,1,2,1,193249,412361,10586,97370,3.819713587016933,0.19102232353927856
7592,0.3097777777777777,0,2,0,193251,412359,10586,97370,3.8196950609507576,0.1910230730446963
7593,0.3097857142857143,0,1,0,193252,412358,10586,97370,3.8196857979176704,0.19102344779961078
7594,0.3098174603174603,1,0,1,193252,412358,10587,97369,3.8196857979176704,0.1910218607215235
7595,0.3098333333333333,1,10,1,193262,412348,10588,97368,3.8195931675867945,0.19102402121965958
7596,0.3098412698412698,0,1,0,193263,412347,10588,97368,3.819583904553707,0.19102439598599216
7597,0.3098571428571429,0,1,0,193264,412346,10588,97368,3.8195746415206195,0.19102477075379526
7598,0.3098809523809524,0,2,0,193266,412344,10588,97368,3.8195561154544446,0.19102552029381298
7599,0.3098888888888889,0,1,0,193267,412343,10588,97368,3.819546852421357,0.1910258950660276
7600,0.3099047619047619,0,2,0,193269,412341,10588,97368,3.8195283263551816,0.19102664461486848
7601,0.3099166666666667,0,1,0,193270,412340,10588,97368,3.8195190633220943,0.19102701939149475
7602,0.3099523809523809,0,2,0,193272,412338,10588,97368,3.819500537255919,0.19102776894915893
7603,0.309952380952381,0,1,0,193273,412337,10588,97368,3.8194912742228317,0.1910281437301969
7604,0.3099891774891775,0,2,0,193275,412335,10588,97368,3.8194727481566564,0.19102889329668454
7605,0.3099999999999999,5,48,5,193323,412287,10593,97363,3.819028122568454,0.19103894829785148
7606,0.31,249,3726,249,197049,408561,10842,97114,3.7845140612842267,0.19204825233598655
7607,0.310031746031746,0,1,0,197050,408560,10842,97114,3.7845047982511395,0.19204863212267193
7608,0.3100833333333334,0,1,0,197051,408559,10842,97114,3.784495535218052,0.19204901191085938
7609,0.310095238095238,0,1,0,197052,408558,10842,97114,3.784486272184964,0.19204939170054897
7610,0.3101071428571428,0,1,0,197053,408557,10842,97114,3.784477009151877,0.19204977149174068
7611,0.3101190476190475,0,1,0,197054,408556,10842,97114,3.784467746118789,0.1920501512844345
7612,0.3101190476190476,0,3,0,197057,408553,10842,97114,3.7844399570195266,0.1920512906715289
7613,0.3101666666666666,2,13,2,197070,408540,10844,97112,3.784319537589388,0.19205303252038952
7614,0.3101666666666667,1,9,1,197079,408531,10845,97111,3.7842361702916003,0.19205485303831565
7615,0.3101904761904762,0,1,0,197080,408530,10845,97111,3.7842269072585126,0.19205523286284143
7616,0.3102121212121212,0,1,0,197081,408529,10845,97111,3.7842176442254254,0.19205561268886956
7617,0.3102380952380952,0,5,0,197086,408524,10845,97111,3.7841713290599874,0.1920575118415458
7618,0.3102499999999999,0,1,0,197087,408523,10845,97111,3.7841620660268998,0.1920578916765882
7619,0.3102857142857143,1,0,1,197087,408523,10846,97110,3.7841620660268998,0.19205629379411548
7620,0.3103333333333333,3,19,3,197106,408504,10849,97107,3.7839860683982365,0.19205871707696232
7621,0.3103571428571428,0,3,0,197109,408501,10849,97107,3.7839582792989734,0.19205985664783784
7622,0.3103888888888889,1,0,1,197109,408501,10850,97106,3.7839582792989734,0.19205825868708304
7623,0.3104157509157509,0,1,0,197110,408500,10850,97106,3.783949016265886,0.19205863854463753
7624,0.3104166666666666,1,0,1,197110,408500,10851,97105,3.783949016265886,0.19205704057515255
7625,0.3104166666666667,0,4,0,197114,408496,10851,97105,3.783911964133536,0.19205856001075947
7626,0.3104285714285714,0,1,0,197115,408495,10851,97105,3.7839027011004482,0.1920589398734177
7627,0.3104761904761904,0,3,0,197118,408492,10851,97105,3.7838749120011856,0.19206007947040826
7628,0.3105,4,18,4,197136,408474,10855,97101,3.7837081774056096,0.19206052514463728
7629,0.3105476190476191,0,1,0,197137,408473,10855,97101,3.783698914372522,0.19206090503071757
7630,0.3105555555555556,0,1,0,197138,408472,10855,97101,3.7836896513394347,0.19206128491830063
7631,0.310564935064935,0,1,0,197139,408471,10855,97101,3.783680388306347,0.19206166480738648
7632,0.3105833333333333,0,2,0,197141,408469,10855,97101,3.783661862240172,0.19206242459006664
7633,0.3105952380952381,0,2,0,197143,408467,10855,97101,3.7836433361739967,0.19206318437875816
7634,0.3106428571428571,0,2,0,197145,408465,10855,97101,3.783624810107822,0.19206394417346104
7635,0.3106666666666666,3,48,3,197193,408417,10858,97098,3.783180184519619,0.19207738642770245
7636,0.3106666666666667,2,2,2,197195,408415,10860,97096,3.783161658453444,0.1920749499021782
7637,0.3106969696969697,0,1,0,197196,408414,10860,97096,3.7831523954203563,0.19207532986488893
7638,0.3107142857142857,4,13,4,197209,408401,10864,97092,3.7830319759902182,0.19207387639393622
7639,0.3107380952380952,0,1,0,197210,408400,10864,97092,3.7830227129571306,0.1920742563680533
7640,0.3107857142857143,0,2,0,197212,408398,10864,97092,3.7830041868909556,0.19207501632079765
7641,0.3108333333333333,14,144,14,197356,408254,10878,97078,3.781670310126348,0.19210736703790776
7642,0.3108333333333334,1,1,1,197357,408253,10879,97077,3.78166104709326,0.19210614845744364
7643,0.3109166666666667,0,1,0,197358,408252,10879,97077,3.781651784060173,0.19210652861798946
7644,0.3109444444444444,0,1,0,197359,408251,10879,97077,3.781642521027085,0.1921069087800399
7645,0.3109523809523809,2,4,2,197363,408247,10881,97075,3.781605468894735,0.19210523191153364
7646,0.310952380952381,2,0,2,197363,408247,10883,97073,3.781605468894735,0.19210203435446846
7647,0.3109761904761905,0,1,0,197364,408246,10883,97073,3.7815962058616472,0.19210241451439586
7648,0.3109920634920635,0,1,0,197365,408245,10883,97073,3.78158694282856,0.1921027946758279
7649,0.3109999999999999,0,2,0,197367,408243,10883,97073,3.7815684167623846,0.19210355500320592
7650,0.311,6,89,6,197456,408154,10889,97067,3.780744006817592,0.19212780149677072
7651,0.3110238095238095,0,1,0,197457,408153,10889,97067,3.780734743784505,0.1921281817821939
7652,0.3110714285714285,0,8,0,197465,408145,10889,97067,3.7806606395198044,0.19213122411977546
7653,0.3110952380952381,0,1,0,197466,408144,10889,97067,3.7806513764867167,0.1921316044187478
7654,0.311111111111111,0,1,0,197467,408143,10889,97067,3.7806421134536294,0.19213198471922566
7655,0.3111111111111111,0,2,0,197469,408141,10889,97067,3.780623587387454,0.19213274532469796
7656,0.3111547619047619,0,2,0,197471,408139,10889,97067,3.780605061321279,0.19213350593619236
7657,0.3111666666666666,0,11,0,197482,408128,10889,97067,3.780503167957316,0.19213768940706064
7658,0.3111666666666667,1,0,1,197482,408128,10890,97066,3.780503167957316,0.19213609029402567
7659,0.3111904761904762,0,4,0,197486,408124,10890,97066,3.7804661158249657,0.1921376115916784
7660,0.3112142857142857,0,1,0,197487,408123,10890,97066,3.780456852791878,0.19213799191985573
7661,0.3112380952380952,0,1,0,197488,408122,10890,97066,3.780447589758791,0.19213837224953878
7662,0.31125,0,10,0,197498,408112,10890,97066,3.780354959427915,0.19214217562918418
7663,0.3112857142857141,0,4,0,197502,408108,10890,97066,3.780317907295565,0.19214369702320389
7664,0.3112857142857143,0,1,0,197503,408107,10890,97066,3.7803086442624774,0.19214407737547334
7665,0.3113095238095238,2,0,2,197503,408107,10892,97064,3.7803086442624774,0.19214087902908125
7666,0.3113333333333333,3,45,3,197548,408062,10895,97061,3.7798918077735375,0.19215319832991173
7667,0.3113571428571429,0,1,0,197549,408061,10895,97061,3.77988254474045,0.19215357873939365
7668,0.3114047619047619,0,1,0,197550,408060,10895,97061,3.779873281707362,0.1921539591503818
7669,0.3114166666666667,0,1,0,197551,408059,10895,97061,3.779864018674275,0.19215433956287614
7670,0.3114285714285714,1,7,1,197558,408052,10896,97060,3.779799177442662,0.19215540315811147
7671,0.3114761904761904,1,5,1,197563,408047,10897,97059,3.779752862277224,0.1921557059310323
7672,0.3114999999999999,0,1,0,197564,408046,10897,97059,3.7797435992441364,0.19215608635828194
7673,0.3115,0,33,0,197597,408013,10897,97059,3.7794379191522474,0.19216864130262615
7674,0.3115238095238095,0,3,0,197600,408010,10897,97059,3.7794101300529848,0.19216978274255597
7675,0.3115476190476191,0,5,0,197605,408005,10897,97059,3.779363814887547,0.1921716851725722
7676,0.3116190476190476,0,1,0,197606,408004,10897,97059,3.779354551854459,0.1921720656630955
7677,0.311626984126984,0,1,0,197607,408003,10897,97059,3.779345288821372,0.19217244615512552
7678,0.3116666666666666,10,166,10,197773,407837,10907,97049,3.7778076253288377,0.19221962977781124
7679,0.3116666666666667,24,253,24,198026,407584,10931,97025,3.7754640779576865,0.19227758521944713
7680,0.3117045454545454,0,1,0,198027,407583,10931,97025,3.775454814924599,0.19227796626292093
7681,0.31175,0,1,0,198028,407582,10931,97025,3.7754455518915115,0.19227834730790497
7682,0.3117619047619047,0,1,0,198029,407581,10931,97025,3.775436288858424,0.19227872835439927
7683,0.3117857142857143,0,4,0,198033,407577,10931,97025,3.7753992367260736,0.19228025255547937
7684,0.3118095238095238,0,1,0,198034,407576,10931,97025,3.775389973692986,0.19228063360952516
7685,0.3118253968253969,0,1,0,198035,407575,10931,97025,3.7753807106598987,0.19228101466508124
7686,0.3118333333333333,1,16,1,198051,407559,10932,97024,3.7752325021304975,0.19228551100611793
7687,0.3118809523809524,0,1,0,198052,407558,10932,97024,3.77522323909741,0.19228589208493366
7688,0.3119047619047619,0,4,0,198056,407554,10932,97024,3.77518618696506,0.1922874164153015
7689,0.3119166666666667,0,1,0,198057,407553,10932,97024,3.7751769239319724,0.19228779750166972
7690,0.311952380952381,0,1,0,198058,407552,10932,97024,3.7751676608988847,0.19228817858954844
7691,0.3119999999999999,1,1,1,198059,407551,10933,97023,3.775158397865797,0.19228695889998296
7692,0.312,15,90,15,198149,407461,10948,97008,3.7743247248879173,0.1922972472044863
7693,0.3120119047619047,0,1,0,198150,407460,10948,97008,3.7743154618548296,0.192297628392683
7694,0.3120238095238095,0,2,0,198152,407458,10948,97008,3.7742969357886547,0.1922983907736101
7695,0.3120476190476191,0,1,0,198153,407457,10948,97008,3.774287672755567,0.19229877196634057
7696,0.3120606060606061,0,1,0,198154,407456,10948,97008,3.7742784097224797,0.19229915316058233
7697,0.3120833333333333,0,2,0,198156,407454,10948,97008,3.7742598836563044,0.19229991555359968
7698,0.3120833333333334,0,1,0,198157,407453,10948,97008,3.7742506206232167,0.1923002967523753
7699,0.3121190476190476,0,2,0,198159,407451,10948,97008,3.774232094557042,0.19230105915446052
7700,0.3121428571428571,0,12,0,198171,407439,10948,97008,3.774120938159991,0.19230563369392623
7701,0.3121547619047619,0,1,0,198172,407438,10948,97008,3.7741116751269037,0.1923060149153725
7702,0.3121666666666666,0,4,0,198176,407434,10948,97008,3.7740746229945534,0.19230753981627224
7703,0.3121666666666667,0,4,0,198180,407430,10948,97008,3.774037570862203,0.19230906474135573
7704,0.3122222222222222,0,1,0,198181,407429,10948,97008,3.7740283078291155,0.19230944597640537
7705,0.3122777777777777,0,1,0,198182,407428,10948,97008,3.7740190447960282,0.19230982721296655
7706,0.3122857142857143,1,0,1,198182,407428,10949,97007,3.7740190447960282,0.19230822603506895
7707,0.3123095238095238,0,1,0,198183,407427,10949,97007,3.7740097817629406,0.19230860727072321
7708,0.3123333333333333,4,39,4,198222,407388,10953,97003,3.773648523472526,0.19231707147827776
7709,0.3123809523809523,2,3,2,198225,407385,10955,97001,3.7736207343732633,0.19231501270852086
7710,0.3123809523809524,0,2,0,198227,407383,10955,97001,3.773602208307088,0.19231577528232457
7711,0.3123888888888889,0,2,0,198229,407381,10955,97001,3.773583682240913,0.1923165378621759
7712,0.3124285714285714,0,1,0,198230,407380,10955,97001,3.7735744192078253,0.1923169191543694
7713,0.3124999999999999,0,11,0,198241,407369,10955,97001,3.773472525843862,0.19232111346828717
7714,0.3125,33,394,33,198635,406975,10988,96968,3.769822890807366,0.19241858702273867
7715,0.3125079365079365,0,1,0,198636,406974,10988,96968,3.7698136277742784,0.19241896884958984
7716,0.3125238095238095,0,2,0,198638,406972,10988,96968,3.7697951017081035,0.19241973250783823
7717,0.3125714285714285,0,1,0,198639,406971,10988,96968,3.769785838675016,0.1924201143392355
7718,0.3125833333333333,0,1,0,198640,406970,10988,96968,3.769776575641928,0.19242049617214815
7719,0.3126190476190476,0,4,0,198644,406966,10988,96968,3.769739523509578,0.19242202351895288
7720,0.3126666666666666,4,14,4,198658,406952,10992,96964,3.769609841046352,0.19242095904873036
7721,0.3126666666666667,3,19,3,198677,406933,10995,96961,3.769433843417689,0.19242340651009934
7722,0.3127142857142856,1,0,1,198677,406933,10996,96960,3.769433843417689,0.19242180383533805
7723,0.3127142857142857,0,3,0,198680,406930,10996,96960,3.7694060543184262,0.1924229494532537
7724,0.3127380952380952,0,1,0,198681,406929,10996,96960,3.7693967912853386,0.19242333132892364
7725,0.31275,1,0,1,198681,406929,10997,96959,3.7693967912853386,0.19242172863811005
7726,0.3127777777777777,0,3,0,198684,406926,10997,96959,3.769369002186076,0.19242287426694582
7727,0.3127992562992562,0,3,0,198687,406923,10997,96959,3.7693412130868134,0.19242401990942323
7728,0.3128095238095238,0,1,0,198688,406922,10997,96959,3.7693319500537257,0.19242440179328055
7729,0.3128333333333333,3,14,3,198702,406908,11000,96956,3.7692022675905,0.19242494006319166
7730,0.3128484848484849,0,1,0,198703,406907,11000,96956,3.7691930045574122,0.19242532196251758
7731,0.3128571428571428,3,12,3,198715,406895,11003,96953,3.769081848160362,0.19242509645766184
7732,0.3128571428571429,0,1,0,198716,406894,11003,96953,3.769072585127274,0.19242547836942564
7733,0.3128809523809523,0,1,0,198717,406893,11003,96953,3.7690633220941865,0.19242586028270542
7734,0.3128831168831169,0,1,0,198718,406892,11003,96953,3.769054059061099,0.1924262421975012
7735,0.3128968253968254,0,1,0,198719,406891,11003,96953,3.7690447960280116,0.192426624113813
7736,0.3129166666666666,0,2,0,198721,406889,11003,96953,3.769026269961836,0.19242738795098463
7737,0.3129166666666667,1,3,1,198724,406886,11004,96952,3.7689984808625736,0.19242693087857604
7738,0.312952380952381,0,1,0,198725,406885,11004,96952,3.768989217829486,0.19242731280156083
7739,0.3129761904761904,0,1,0,198726,406884,11004,96952,3.7689799547963987,0.19242769472606167
7740,0.3129999999999999,0,5,0,198731,406879,11004,96952,3.7689336396309607,0.19242960437130704
7741,0.313,4,60,4,198791,406819,11008,96948,3.7683778576457074,0.19244611099972805
7742,0.3130238095238095,0,1,0,198792,406818,11008,96948,3.7683685946126197,0.19244649301461392
7743,0.313047619047619,0,1,0,198793,406817,11008,96948,3.7683593315795325,0.19244687503101646
7744,0.313079365079365,0,1,0,198794,406816,11008,96948,3.768350068546445,0.19244725704893562
7745,0.3130952380952381,0,4,0,198798,406812,11008,96948,3.7683130164140946,0.19244878513577895
7746,0.3131428571428571,0,3,0,198801,406809,11008,96948,3.768285227314832,0.19244993121683668
7747,0.3131666666666666,1,17,1,198818,406792,11009,96947,3.7681277557523436,0.19245482283484106
7748,0.3131666666666667,1,3,1,198821,406789,11010,96946,3.768099966653081,0.1924543658868254
7749,0.3132142857142856,0,2,0,198823,406787,11010,96946,3.7680814405869056,0.1924551299994243
7750,0.3132142857142857,1,6,1,198829,406781,11011,96945,3.7680258623883804,0.19245581923506033
7751,0.31325,0,2,0,198831,406779,11011,96945,3.7680073363222055,0.19245658336708196
7752,0.3132683982683982,0,2,0,198833,406777,11011,96945,3.76798881025603,0.19245734750517152
7753,0.3132857142857143,0,1,0,198834,406776,11011,96945,3.7679795472229425,0.19245772957649174
7754,0.3133333333333333,68,784,68,199618,405992,11079,96877,3.7607173292823,0.19264858243399374
7755,0.3133571428571428,0,2,0,199620,405990,11079,96877,3.7606988032161253,0.19264934863492733
7756,0.3133690476190476,0,1,0,199621,405989,11079,96877,3.7606895401830376,0.19264973173767963
7757,0.3133809523809523,0,1,0,199622,405988,11079,96877,3.76068027714995,0.1926501148419556
7758,0.3133809523809524,0,1,0,199623,405987,11079,96877,3.760671014116862,0.19265049794775527
7759,0.3134007936507936,0,1,0,199624,405986,11079,96877,3.760661751083775,0.19265088105507863
7760,0.3134064269064268,0,1,0,199625,405985,11079,96877,3.7606524880506873,0.1926512641639257
7761,0.3134166666666667,0,2,0,199627,405983,11079,96877,3.7606339619845124,0.192652030386191
7762,0.3134285714285714,0,5,0,199632,405978,11079,96877,3.7605876468190744,0.19265394596851976
7763,0.3134487179487179,0,1,0,199633,405977,11079,96877,3.7605783837859867,0.19265432908955682
7764,0.313452380952381,0,1,0,199634,405976,11079,96877,3.7605691207528995,0.19265471221211766
7765,0.3134761904761904,0,1,0,199635,405975,11079,96877,3.760559857719812,0.19265509533620231
7766,0.3134848484848485,2,1,2,199636,405974,11081,96875,3.760550594686724,0.1926522673804661
7767,0.3135,3,40,3,199676,405934,11084,96872,3.7601800733632222,0.19266277649829158
7768,0.3135238095238095,0,4,0,199680,405930,11084,96872,3.760143021230872,0.19266430921118055
7769,0.3135416666666666,0,2,0,199682,405928,11084,96872,3.7601244951646966,0.1926650755767701
7770,0.3135714285714285,1,5,1,199687,405923,11085,96871,3.760078179999259,0.1926653858240154
7771,0.3135833333333333,1,0,1,199687,405923,11086,96870,3.760078179999259,0.19266378012422608
7772,0.3136190476190476,0,1,0,199688,405922,11086,96870,3.7600689169661714,0.19266416331206543
7773,0.3136666666666666,3,25,3,199713,405897,11089,96867,3.7598373411389825,0.19266892617609852
7774,0.3136904761904762,1,3,1,199716,405894,11090,96866,3.75980955203972,0.19266847004534968
7775,0.3136984126984127,0,2,0,199718,405892,11090,96866,3.759791025973545,0.19266923649151282
7776,0.3137142857142857,1,1,1,199719,405891,11091,96865,3.7597817629404573,0.19266801390734273
7777,0.31375,1,5,1,199724,405886,11092,96864,3.7597354477750193,0.19266832421680755
7778,0.3138095238095238,0,9,0,199733,405877,11092,96864,3.7596520804772315,0.19267177333855803
7779,0.3138333333333333,1,10,1,199743,405867,11093,96863,3.759559450146356,0.19267399996021722
7780,0.3138492063492063,0,2,0,199745,405865,11093,96863,3.7595409240801807,0.19267476647411722
7781,0.3138571428571428,0,1,0,199746,405864,11093,96863,3.7595316610470935,0.19267514973335428
7782,0.3138809523809523,0,1,0,199747,405863,11093,96863,3.759522398014006,0.19267553299411608
7783,0.3138888888888889,0,1,0,199748,405862,11093,96863,3.759513134980918,0.1926759162564026
7784,0.3138928571428571,0,1,0,199749,405861,11093,96863,3.7595038719478304,0.19267629952021387
7785,0.3139166666666667,0,1,0,199750,405860,11093,96863,3.759494608914743,0.1926766827855499
7786,0.3139285714285714,0,1,0,199751,405859,11093,96863,3.7594853458816555,0.19267706605241067
7787,0.3139393939393939,0,1,0,199752,405858,11093,96863,3.759476082848568,0.19267744932079622
7788,0.313952380952381,0,1,0,199753,405857,11093,96863,3.7594668198154806,0.19267783259070656
7789,0.3139999999999999,0,4,0,199757,405853,11093,96863,3.7594297676831303,0.19267936568559585
7790,0.314,11,174,11,199931,405679,11104,96852,3.7578179999258956,0.1927284087946813
7791,0.3140238095238095,1,1,1,199932,405678,11105,96851,3.7578087368928084,0.1927271858937494
7792,0.3140476190476191,0,3,0,199935,405675,11105,96851,3.7577809477935453,0.19272833644428347
7793,0.3140714285714285,0,1,0,199936,405674,11105,96851,3.757771684760458,0.1927287199641809
7794,0.3140833333333333,0,3,0,199939,405671,11105,96851,3.7577438956611955,0.1927298705330314
7795,0.3141190476190476,0,2,0,199941,405669,11105,96851,3.75772536959502,0.19273063758656372
7796,0.3141212121212121,0,1,0,199942,405668,11105,96851,3.7577161065619324,0.19273102111561952
7797,0.3141428571428571,0,1,0,199943,405667,11105,96851,3.757706843528845,0.19273140464620173
7798,0.3141666666666666,6,55,6,199998,405612,11111,96845,3.7571973767090294,0.1927428615782047
7799,0.3141666666666667,6,103,6,200101,405509,11117,96839,3.7562432843010116,0.19277273921663868
7800,0.3141904761904762,0,1,0,200102,405508,11117,96839,3.756234021267924,0.1927731229608219
7801,0.3142142857142857,0,2,0,200104,405506,11117,96839,3.756215495201749,0.1927738904537718
7802,0.3142857142857143,1,20,1,200124,405486,11118,96838,3.7560302345399976,0.192779958751722
7803,0.3143333333333333,2,50,2,200174,405436,11120,96836,3.7555670828856202,0.19279593527013253
7804,0.3143571428571428,0,1,0,200175,405435,11120,96836,3.7555578198525326,0.1927963191185635
7805,0.3144047619047619,1,3,1,200178,405432,11121,96835,3.75553003075327,0.19279586355464326
7806,0.3144126984126985,0,1,0,200179,405431,11121,96835,3.7555207677201823,0.1927962474067526
7807,0.3144444444444444,0,2,0,200181,405429,11121,96835,3.7555022416540074,0.19279701511555675
7808,0.3144761904761904,0,1,0,200182,405428,11121,96835,3.7554929786209197,0.1927973989722516
7809,0.3144999999999999,0,2,0,200184,405426,11121,96835,3.7554744525547443,0.19279816669022679
7810,0.3145,3,14,3,200198,405412,11124,96832,3.7553447700915186,0.19279871934756812
7811,0.3145064935064935,0,1,0,200199,405411,11124,96832,3.7553355070584313,0.1927991032229419
7812,0.3145119047619047,1,0,1,200199,405411,11125,96831,3.7553355070584313,0.1927974960278113
7813,0.3145238095238095,1,4,1,200203,405407,11126,96830,3.755298454926081,0.19279742432357633
7814,0.3145595238095238,0,1,0,200204,405406,11126,96830,3.7552891918929934,0.1927978082017219
7815,0.3145714285714286,0,1,0,200205,405405,11126,96830,3.7552799288599057,0.19279819208139615
7816,0.3145833333333332,0,1,0,200206,405404,11126,96830,3.7552706658268185,0.1927985759625991
7817,0.3145833333333333,0,5,0,200211,405399,11126,96830,3.7552243506613805,0.1928004953915445
7818,0.3145833333333334,0,2,0,200213,405397,11126,96830,3.7552058245952056,0.1928012631738238
7819,0.3146190476190476,0,1,0,200214,405396,11126,96830,3.755196561562118,0.19280164706725658
7820,0.3146428571428571,0,5,0,200219,405391,11126,96830,3.75515024639668,0.19280356655735223
7821,0.3146666666666666,2,10,2,200229,405381,11128,96828,3.7550576160658045,0.19280419108379182
7822,0.3146666666666667,1,19,1,200248,405362,11129,96827,3.754881618437141,0.19280987835257243
7823,0.3147023809523809,0,3,0,200251,405359,11129,96827,3.7548538293378786,0.1928110301760702
7824,0.3147063492063491,0,1,0,200252,405358,11129,96827,3.754844566304791,0.19281141412029432
7825,0.3147142857142856,0,1,0,200253,405357,11129,96827,3.7548353032717032,0.1928117980660475
7826,0.3147142857142857,0,2,0,200255,405355,11129,96827,3.7548167772055283,0.19281256596214122
7827,0.3147222222222222,0,1,0,200256,405354,11129,96827,3.7548075141724406,0.19281294991248177
7828,0.3147619047619047,0,5,0,200261,405349,11129,96827,3.7547611990070027,0.19281486968712164
7829,0.3147619047619048,1,0,1,200261,405349,11130,96826,3.7547611990070027,0.19281326230895604
7830,0.3147777777777777,0,1,0,200262,405348,11130,96826,3.7547519359739154,0.19281364626603528
7831,0.3147857142857142,0,1,0,200263,405347,11130,96826,3.7547426729408278,0.1928140302246437
7832,0.3148095238095237,0,1,0,200264,405346,11130,96826,3.75473340990774,0.19281441418478132
7833,0.3148333333333333,1,27,1,200291,405319,11131,96825,3.7544833080143762,0.19282317422890644
7834,0.3148484848484848,0,2,0,200293,405317,11131,96825,3.7544647819482013,0.19282394223148033
7835,0.3148809523809524,0,2,0,200295,405315,11131,96825,3.754446255882026,0.19282471024017206
7836,0.3149166666666667,0,2,0,200297,405313,11131,96825,3.754427729815851,0.1928254782549817
7837,0.3149358974358974,0,1,0,200298,405312,11131,96825,3.7544184667827634,0.19282586226468076
7838,0.314952380952381,0,1,0,200299,405311,11131,96825,3.7544092037496757,0.1928262462759093
7839,0.3149999999999999,2,33,2,200332,405278,11133,96823,3.7541035236577867,0.19283570437023625
7840,0.315,116,1398,116,201730,403880,11249,96707,3.7411538034013856,0.19318719822927882
7841,0.3150476190476191,0,3,0,201733,403877,11249,96707,3.741126014302123,0.19318835600019177
7842,0.3150595238095238,0,1,0,201734,403876,11249,96707,3.7411167512690353,0.1931887419269132
7843,0.3150833333333334,0,1,0,201735,403875,11249,96707,3.741107488235948,0.19318912785517658
7844,0.3151190476190476,0,1,0,201736,403874,11249,96707,3.7410982252028604,0.19318951378498186
7845,0.3151666666666666,1,10,1,201746,403864,11250,96706,3.741005594871985,0.1931917613920131
7846,0.3151666666666667,1,8,1,201754,403856,11251,96705,3.7409314906072844,0.1931932371878752
7847,0.3152380952380952,1,11,1,201765,403845,11252,96704,3.740829597243321,0.1931958709337148
7848,0.3152380952380953,0,1,0,201766,403844,11252,96704,3.740820334210234,0.19319625690243494
7849,0.3152777777777777,1,1,1,201767,403843,11253,96703,3.7408110711771463,0.19319503102611948
7850,0.3152777777777778,0,2,0,201769,403841,11253,96703,3.740792545110971,0.1931958029663726
7851,0.3152857142857143,0,1,0,201770,403840,11253,96703,3.7407832820778837,0.19319618893881246
7852,0.3153333333333333,4,25,4,201795,403815,11257,96699,3.7405517062506948,0.19319939102602524
7853,0.3153333333333334,0,2,0,201797,403813,11257,96699,3.7405331801845194,0.19320016303305415
7854,0.3153571428571428,1,3,1,201800,403810,11258,96698,3.740505391085257,0.19319970909555892
7855,0.3153571428571429,0,1,0,201801,403809,11258,96698,3.7404961280521696,0.19320009510356498
7856,0.3154166666666666,1,3,1,201804,403806,11259,96697,3.7404683389529065,0.19319964116099203
7857,0.3154166666666667,0,3,0,201807,403803,11259,96697,3.740440549853644,0.1932007992007992
7858,0.3154761904761904,0,3,0,201810,403800,11259,96697,3.7404127607543813,0.19320195725448905
7859,0.3154999999999999,0,1,0,201811,403799,11259,96697,3.7404034977212937,0.19320234327547073
7860,0.3155,0,24,0,201835,403775,11259,96697,3.7401811849271924,0.1932116082418197
7861,0.3155357142857143,0,1,0,201836,403774,11259,96697,3.740171921894105,0.19321199430136812
7862,0.3155555555555556,0,1,0,201837,403773,11259,96697,3.7401626588610175,0.1932123803624593
7863,0.3156111111111111,0,1,0,201838,403772,11259,96697,3.74015339582793,0.19321276642509327
7864,0.3156190476190476,0,4,0,201842,403768,11259,96697,3.7401163436955795,0.19321431069105732
7865,0.3156428571428571,1,2,1,201844,403766,11260,96696,3.7400978176294046,0.1932134707530242
7866,0.3156666666666666,5,38,5,201882,403728,11265,96691,3.7397458223720776,0.19322008157164297
7867,0.3156960261960261,0,2,0,201884,403726,11265,96691,3.7397272963059023,0.1932208538079242
7868,0.3157142857142856,0,10,0,201894,403716,11265,96691,3.739634665975027,0.19322471508192332
7869,0.3157142857142857,0,4,0,201898,403712,11265,96691,3.7395976138426765,0.19322625963473442
7870,0.3157142857142858,0,1,0,201899,403711,11265,96691,3.7395883508095893,0.19322664577679546
7871,0.31575,0,6,0,201905,403705,11265,96691,3.7395327726110636,0.19322896266157202
7872,0.3157619047619047,0,5,0,201910,403700,11265,96691,3.739486457445626,0.19323089344132888
7873,0.3157857142857143,0,1,0,201911,403699,11265,96691,3.7394771944125385,0.1932312796019105
7874,0.3158095238095237,0,1,0,201912,403698,11265,96691,3.7394679313794508,0.19323166576403558
7875,0.3158333333333333,19,144,19,202056,403554,11284,96672,3.738134054614843,0.19325664799510622
7876,0.3158571428571429,0,1,0,202057,403553,11284,96672,3.7381247915817557,0.19325703433454947
7877,0.3159523809523809,1,3,1,202060,403550,11285,96671,3.7380970024824927,0.19325658059137862
7878,0.3159999999999999,0,2,0,202062,403548,11285,96671,3.7380784764163177,0.1932573532792637
7879,0.316,10,161,10,202223,403387,11295,96661,3.7365871280892216,0.19330344286948453
7880,0.3160119047619047,1,0,1,202223,403387,11296,96660,3.7365871280892216,0.19330182962801495
7881,0.316047619047619,0,1,0,202224,403386,11296,96660,3.736577865056134,0.19330221619610996
7882,0.3160714285714285,0,4,0,202228,403382,11296,96660,3.7365408129237836,0.19330376248395134
7883,0.3160966810966811,1,0,1,202228,403382,11297,96659,3.7365408129237836,0.19330214922376365
7884,0.3161190476190476,0,2,0,202230,403380,11297,96659,3.7365222868576087,0.19330292237205499
7885,0.3161428571428571,1,0,1,202230,403380,11298,96658,3.7365222868576087,0.19330130910050836
7886,0.3161666666666666,1,8,1,202238,403372,11299,96657,3.736448182592908,0.1933027884382706
7887,0.3161904761904762,0,2,0,202240,403370,11299,96657,3.736429656526733,0.19330356160767317
7888,0.3162261904761905,0,2,0,202242,403368,11299,96657,3.736411130460558,0.19330433478326084
7889,0.31625,1,8,1,202250,403360,11300,96656,3.7363370261958577,0.19330581421394516
7890,0.3162619047619047,0,3,0,202253,403357,11300,96656,3.736309237096595,0.19330697401867553
7891,0.3163333333333333,1,23,1,202276,403334,11301,96655,3.736096187335581,0.1933142529135641
7892,0.3163690476190476,0,1,0,202277,403333,11301,96655,3.7360869243024935,0.19331463955134923
7893,0.3163809523809524,0,1,0,202278,403332,11301,96655,3.736077661269406,0.19331502619068094
7894,0.3164285714285714,2,2,2,202280,403330,11303,96653,3.736059135203231,0.19331257262746934
7895,0.3164523809523809,0,1,0,202281,403329,11303,96653,3.736049872170143,0.1933129592665336
7896,0.3164999999999999,1,2,1,202283,403327,11304,96652,3.7360313461039683,0.1933121191090026
7897,0.3165,3,29,3,202312,403298,11307,96649,3.735762718144429,0.19331849176012658
7898,0.3165238095238095,0,2,0,202314,403296,11307,96649,3.735744192078254,0.19331926511916311
7899,0.316547619047619,0,1,0,202315,403295,11307,96649,3.7357349290451665,0.19331965180100172
7900,0.3165476190476191,0,3,0,202318,403292,11307,96649,3.735707139945904,0.193320811855799
7901,0.3165515873015873,0,2,0,202320,403290,11307,96649,3.735688613879729,0.19332158523339849
7902,0.3165833333333333,0,1,0,202321,403289,11307,96649,3.7356793508466413,0.19332197192451864
7903,0.316611111111111,0,1,0,202322,403288,11307,96649,3.7356700878135536,0.19332235861718577
7904,0.3166114718614718,0,2,0,202324,403286,11307,96649,3.7356515617473787,0.19332313200716092
7905,0.3166190476190476,0,2,0,202326,403284,11307,96649,3.7356330356812033,0.19332390540332406
7906,0.3166428571428571,0,1,0,202327,403283,11307,96649,3.735623772648116,0.19332429210372612
7907,0.3166666666666666,69,838,69,203165,402445,11376,96580,3.7278613509207457,0.19353739792595562
7908,0.3166666666666667,0,5,0,203170,402440,11376,96580,3.7278150357553077,0.1935393371007174
7909,0.3167222222222222,1,1,1,203171,402439,11377,96579,3.72780577272222,0.1935381088457731
7910,0.3167424242424242,1,1,1,203172,402438,11378,96578,3.727796509689133,0.19353688058098337
7911,0.3167460317460317,0,1,0,203173,402437,11378,96578,3.727787246656045,0.19353726841878502
7912,0.31675,0,1,0,203174,402436,11378,96578,3.7277779836229574,0.19353765625814107
7913,0.3167857142857143,1,3,1,203177,402433,11379,96577,3.727750194523695,0.19353720366325325
7914,0.3168059163059162,0,6,0,203183,402427,11379,96577,3.7276946163251696,0.19353953074524452
7915,0.3168181818181818,0,1,0,203184,402426,11379,96577,3.727685353292082,0.19353991859768377
7916,0.3168235375735375,0,1,0,203185,402425,11379,96577,3.7276760902589943,0.19354030645167755
7917,0.3168333333333333,5,21,5,203206,402404,11384,96572,3.7274815665641556,0.1935403706791509
7918,0.3168340548340548,0,1,0,203207,402403,11384,96572,3.7274723035310684,0.19354075855503783
7919,0.3168571428571428,0,1,0,203208,402402,11384,96572,3.7274630404979807,0.19354114643247944
7920,0.3168809523809524,0,1,0,203209,402401,11384,96572,3.727453777464893,0.19354153431147578
7921,0.3169047619047619,0,2,0,203211,402399,11384,96572,3.727435251398718,0.19354231007413256
7922,0.3169285714285714,1,0,1,203211,402399,11385,96571,3.727435251398718,0.19354069382928835
7923,0.3169444444444445,0,1,0,203212,402398,11385,96571,3.7274259883656304,0.19354108171048703
7924,0.316952380952381,0,2,0,203214,402396,11385,96571,3.7274074622994555,0.19354185747754862
7925,0.3169761904761904,1,0,1,203214,402396,11386,96570,3.7274074622994555,0.19354024121884056
7926,0.3169999999999999,0,2,0,203216,402394,11386,96570,3.72738893623328,0.19354101698719747
7927,0.317,4,47,4,203263,402347,11390,96566,3.7269535736781654,0.19355278375187657
7928,0.3170238095238095,0,5,0,203268,402342,11390,96566,3.7269072585127274,0.1935547235161593
7929,0.3170454545454545,0,1,0,203269,402341,11390,96566,3.7268979954796397,0.19355511147368146
7930,0.3170833333333333,1,3,1,203272,402338,11391,96565,3.726870206380377,0.19355465892167414
7931,0.3170952380952381,0,1,0,203273,402337,11391,96565,3.7268609433472895,0.19355504688295497
7932,0.3171428571428571,1,12,1,203285,402325,11392,96564,3.726749786950239,0.1935580860672414
7933,0.3171666666666666,1,6,1,203291,402319,11393,96563,3.726694208751714,0.1935587974711455
7934,0.3171666666666667,0,4,0,203295,402315,11393,96563,3.7266571566193636,0.19356034942410769
7935,0.3171904761904762,0,1,0,203296,402314,11393,96563,3.726647893586276,0.19356073741623686
7936,0.3172142857142856,0,1,0,203297,402313,11393,96563,3.7266386305531882,0.19356112540992151
7937,0.3172222222222222,0,2,0,203299,402311,11393,96563,3.7266201044870133,0.1935619014019572
7938,0.3172619047619048,1,1,1,203300,402310,11394,96562,3.7266108414539256,0.1935606728780128
7939,0.3172857142857143,0,1,0,203301,402309,11394,96562,3.726601578420838,0.19356106087545677
7940,0.3173333333333332,0,1,0,203302,402308,11394,96562,3.7265923153877507,0.19356144887445628
7941,0.3173333333333333,3,38,3,203340,402270,11397,96559,3.7262403201304237,0.19357134408785376
7942,0.3173571428571429,0,1,0,203341,402269,11397,96559,3.726231057097336,0.19357173214013648
7943,0.3173809523809524,0,6,0,203347,402263,11397,96559,3.726175478898811,0.19357406048650622
7944,0.3174166666666666,0,1,0,203348,402262,11397,96559,3.726166215865723,0.19357444854968014
7945,0.3174166666666667,1,0,1,203348,402262,11398,96558,3.726166215865723,0.19357283188324445
7946,0.3174444444444444,0,1,0,203349,402261,11398,96558,3.7261569528326355,0.1935732199455113
7947,0.3174999999999999,0,10,0,203359,402251,11398,96558,3.72606432250176,0.19357710065375724
7948,0.3175,35,381,35,203740,401870,11433,96523,3.722535106895402,0.19366845039958427
7949,0.3175238095238095,1,0,1,203740,401870,11434,96522,3.722535106895402,0.1936668325334275
7950,0.3175277777777778,0,1,0,203741,401869,11434,96522,3.7225258438623143,0.1936672211175563
7951,0.3175714285714285,0,1,0,203742,401868,11434,96522,3.7225165808292267,0.19366760970324445
7952,0.3175833333333333,1,0,1,203742,401868,11435,96521,3.7225165808292267,0.19366599182566227
7953,0.3176190476190476,0,4,0,203746,401864,11435,96521,3.7224795286968764,0.19366754617414247
7954,0.3176309523809523,0,1,0,203747,401863,11435,96521,3.722470265663789,0.193667934765161
7955,0.3176388888888888,0,2,0,203749,401861,11435,96521,3.7224517395976138,0.19366871195187627
7956,0.3176666666666666,2,23,2,203772,401838,11437,96519,3.7222386898366002,0.19367441412481415
7957,0.3176666666666667,2,12,2,203784,401826,11439,96517,3.7221275334395494,0.1936758417395248
7958,0.3176904761904762,0,1,0,203785,401825,11439,96517,3.7221182704064617,0.1936762303799399
7959,0.3177142857142857,0,1,0,203786,401824,11439,96517,3.7221090073733745,0.19367661902191471
7960,0.3177272727272727,0,1,0,203787,401823,11439,96517,3.722099744340287,0.1936770076654493
7961,0.3177380952380952,0,4,0,203791,401819,11439,96517,3.7220626922079365,0.19367856225518526
7962,0.3177619047619047,0,1,0,203792,401818,11439,96517,3.722053429174849,0.1936789509065187
7963,0.3177777777777777,0,3,0,203795,401815,11439,96517,3.7220256400755862,0.1936801168698779
7964,0.3178181818181818,0,1,0,203796,401814,11439,96517,3.722016377042499,0.19368050552745064
7965,0.3178257575757576,0,1,0,203797,401813,11439,96517,3.7220071140094113,0.19368089418658319
7966,0.3178333333333333,0,9,0,203806,401804,11439,96517,3.721923746711623,0.19368439218897057
7967,0.3178571428571428,0,7,0,203813,401797,11439,96517,3.72185890548001,0.19368711294485003
7968,0.3178571428571429,1,4,1,203817,401793,11440,96516,3.7218218533476604,0.19368704960175312
7969,0.3178809523809524,0,1,0,203818,401792,11440,96516,3.7218125903145727,0.19368743829117735
7970,0.3179047619047619,1,2,1,203820,401790,11441,96515,3.7217940642483973,0.19368659756574788
7971,0.3179166666666666,0,1,0,203821,401789,11441,96515,3.72178480121531,0.19368698625738506
7972,0.317952380952381,0,1,0,203822,401788,11441,96515,3.7217755381822224,0.19368737495058228
7973,0.3179761904761904,0,3,0,203825,401785,11441,96515,3.72174774908296,0.19368854103953442
7974,0.3179999999999999,1,8,1,203833,401777,11442,96514,3.7216736448182592,0.1936900325311916
7975,0.318,6,99,6,203932,401678,11448,96508,3.7207566045425913,0.19371881184938958
7976,0.3180476190476191,0,1,0,203933,401677,11448,96508,3.720747341509504,0.19371920069853568
7977,0.3180714285714285,0,1,0,203934,401676,11448,96508,3.7207380784764164,0.19371958954924284
7978,0.3180833333333334,0,1,0,203935,401675,11448,96508,3.7207288154433287,0.1937199784015111
7979,0.318095238095238,0,3,0,203938,401672,11448,96508,3.720701026344066,0.19372114496768236
7980,0.3180952380952381,0,3,0,203941,401669,11448,96508,3.7206732372448035,0.19372231154790365
7981,0.3181428571428571,0,3,0,203944,401666,11448,96508,3.720645448145541,0.19372347814217522
7982,0.3181666666666666,1,8,1,203952,401658,11449,96507,3.7205713438808403,0.19372497064225708
7983,0.3181818181818182,0,2,0,203954,401656,11449,96507,3.7205528178146654,0.1937257483996202
7984,0.3181904761904761,0,1,0,203955,401655,11449,96507,3.7205435547815777,0.19372613728064364
7985,0.3182142857142856,0,2,0,203957,401653,11449,96507,3.7205250287154024,0.19372691504737433
7986,0.3182142857142857,0,2,0,203959,401651,11449,96507,3.7205065026492274,0.19372769282035018
7987,0.3182738095238095,1,0,1,203959,401651,11450,96506,3.7205065026492274,0.19372607430990632
7988,0.3183333333333333,34,466,34,204425,401185,11484,96472,3.7161899292304272,0.19385239231036638
7989,0.3183571428571428,0,2,0,204427,401183,11484,96472,3.7161714031642523,0.19385317137374286
7990,0.3183809523809524,0,1,0,204428,401182,11484,96472,3.7161621401311646,0.1938535609077793
7991,0.3185,2,21,2,204449,401161,11486,96470,3.715967616436326,0.19385850158048834
7992,0.318547619047619,0,4,0,204453,401157,11486,96470,3.7159305643039757,0.19386005984401972
7993,0.3185714285714285,2,9,2,204462,401148,11488,96468,3.7158471970061875,0.19386032603453265
7994,0.3185833333333333,0,1,0,204463,401147,11488,96468,3.7158379339731002,0.1938607156134763
7995,0.3185952380952381,0,3,0,204466,401144,11488,96468,3.7158101448738377,0.19386188435970195
7996,0.3186190476190476,0,1,0,204467,401143,11488,96468,3.71580088184075,0.19386227394490876
7997,0.3186666666666666,4,25,4,204492,401118,11492,96464,3.715569306013561,0.19386553372107512
7998,0.3186666666666667,0,1,0,204493,401117,11492,96464,3.7155600429804734,0.19386592333710492
7999,0.3186904761904762,0,4,0,204497,401113,11492,96464,3.715522990848123,0.19386748181688462
8000,0.3187222222222222,0,1,0,204498,401112,11492,96464,3.715513727815036,0.19386787144074474
8001,0.31875,2,6,2,204504,401106,11494,96462,3.71545814961651,0.19386696893690913
8002,0.3187857142857143,0,1,0,204505,401105,11494,96462,3.715448886583423,0.19386735856678597
8003,0.3188095238095238,0,5,0,204510,401100,11494,96462,3.715402571417985,0.1938693067396626
8004,0.3188333333333333,1,12,1,204522,401088,11495,96461,3.7152914150209346,0.19387236232009308
8005,0.3188888888888889,0,3,0,204525,401085,11495,96461,3.7152636259216716,0.19387353129157908
8006,0.3189166666666666,0,1,0,204526,401084,11495,96461,3.7152543628885843,0.1938739209518737
8007,0.3189166666666667,2,0,2,204526,401084,11497,96459,3.7152543628885843,0.1938706805240954
8008,0.3189523809523809,0,2,0,204528,401082,11497,96459,3.715235836822409,0.1938714598394906
8009,0.318952380952381,0,1,0,204529,401081,11497,96459,3.7152265737893218,0.19387184949953773
8010,0.3189642857142856,0,1,0,204530,401080,11497,96459,3.715217310756234,0.19387223916115118
8011,0.3189999999999999,0,1,0,204531,401079,11497,96459,3.7152080477231464,0.193872628824331
8012,0.319,8,69,8,204600,401010,11505,96451,3.7145688984401053,0.1938865559310177
8013,0.3190238095238095,0,1,0,204601,401009,11505,96451,3.7145596354070176,0.1938869456840751
8014,0.319047619047619,0,5,0,204606,401004,11505,96451,3.71451332024158,0.1938888944728669
8015,0.3190476190476191,0,2,0,204608,401002,11505,96451,3.7144947941754047,0.1938896739993527
8016,0.3190833333333333,0,1,0,204609,401001,11505,96451,3.714485531142317,0.19389006376494616
8017,0.3191666666666666,7,150,7,204759,400851,11512,96444,3.713096076179184,0.19393720025337075
8018,0.3192142857142857,0,1,0,204760,400850,11512,96444,3.7130868131460963,0.19393759023837007
8019,0.31925,0,1,0,204761,400849,11512,96444,3.713077550113009,0.1939379802249378
8020,0.3192857142857142,0,1,0,204762,400848,11512,96444,3.7130682870799214,0.193938370213074
8021,0.3192857142857143,1,7,1,204769,400841,11513,96443,3.7130034458483085,0.193939479251293
8022,0.3193333333333333,6,48,6,204817,400793,11519,96437,3.712558820260106,0.19394847454900146
8023,0.3193571428571428,0,2,0,204819,400791,11519,96437,3.7125402941939307,0.1939492546678787
8024,0.3194444444444444,0,1,0,204820,400790,11519,96437,3.7125310311608435,0.19394964472967074
8025,0.319452380952381,0,1,0,204821,400789,11519,96437,3.712521768127756,0.19395003479303174
8026,0.3194761904761904,0,1,0,204822,400788,11519,96437,3.712512505094668,0.19395042485796168
8027,0.3194999999999999,0,5,0,204827,400783,11519,96437,3.7124661899292306,0.19395237520614617
8028,0.3195,5,27,5,204854,400756,11524,96432,3.7122160880358663,0.1939548018053533
8029,0.3195238095238095,1,7,1,204861,400749,11525,96431,3.7121512468042535,0.19395591133995735
8030,0.3195714285714286,0,1,0,204862,400748,11525,96431,3.712141983771166,0.1939563014527967
8031,0.3195833333333333,0,5,0,204867,400743,11525,96431,3.7120956686057283,0.1939582520405331
8032,0.3196428571428572,0,1,0,204868,400742,11525,96431,3.7120864055726406,0.1939586421627884
8033,0.3196666666666666,0,14,0,204882,400728,11525,96431,3.711956723109415,0.19396410403915046
8034,0.3196666666666667,1,22,1,204904,400706,11526,96430,3.711752936381489,0.1939710662675807
8035,0.3196904761904762,0,3,0,204907,400703,11526,96430,3.711725147282226,0.19397223680584472
8036,0.3197142857142857,0,5,0,204912,400698,11526,96430,3.7116788321167884,0.19397418773434608
8037,0.31975,0,1,0,204913,400697,11526,96430,3.7116695690837007,0.19397457792475564
8038,0.3197619047619047,1,3,1,204916,400694,11527,96429,3.711641779984438,0.1939741271274916
8039,0.3197619047619048,0,1,0,204917,400693,11527,96429,3.7116325169513504,0.19397451732170373
8040,0.3197857142857143,0,1,0,204918,400692,11527,96429,3.711623253918263,0.1939749075174857
8041,0.3198055555555555,0,1,0,204919,400691,11527,96429,3.7116139908851755,0.19397529771483746
8042,0.3198214285714286,0,1,0,204920,400690,11527,96429,3.711604727852088,0.19397568791375908
8043,0.3198333333333332,0,1,0,204921,400689,11527,96429,3.711595464819,0.19397607811425055
8044,0.3198333333333333,1,13,1,204934,400676,11528,96428,3.711475045388862,0.19397952943448454
8045,0.3198571428571429,0,1,0,204935,400675,11528,96428,3.7114657823557744,0.19397991965447806
8046,0.3199047619047619,0,1,0,204936,400674,11528,96428,3.711456519322687,0.19398030987604153
8047,0.3199166666666667,0,1,0,204937,400673,11528,96428,3.7114472562895995,0.193980700099175
8048,0.3199444444444445,0,3,0,204940,400670,11528,96428,3.711419467190337,0.19398187077799547
8049,0.3199523809523809,1,0,1,204940,400670,11529,96427,3.711419467190337,0.19398024932759603
8050,0.3199743589743589,0,2,0,204942,400668,11529,96427,3.7114009411241615,0.19398102978303947
8051,0.3199761904761905,0,1,0,204943,400667,11529,96427,3.7113916780910743,0.19398142001311622
8052,0.3199999999999999,3,47,3,204990,400620,11532,96424,3.710956315535959,0.19399489783600646
8053,0.32,272,3877,272,208867,396743,11804,96152,3.6750435362555116,0.19507603039186844
8054,0.3200476190476191,0,1,0,208868,396742,11804,96152,3.675034273222424,0.1950764261687097
8055,0.3201190476190476,0,1,0,208869,396741,11804,96152,3.6750250101893362,0.1950768219471569
8056,0.3201388888888888,0,1,0,208870,396740,11804,96152,3.675015747156249,0.19507721772721
8057,0.3201666666666666,1,24,1,208894,396716,11805,96151,3.6747934343621473,0.19508508380557027
8058,0.3202380952380952,0,1,0,208895,396715,11805,96151,3.67478417132906,0.19508547962326475
8059,0.3202748917748918,0,1,0,208896,396714,11805,96151,3.6747749082959724,0.19508587544256542
8060,0.3202777777777777,0,1,0,208897,396713,11805,96151,3.6747656452628847,0.19508627126347228
8061,0.3202777777777778,0,3,0,208900,396710,11805,96151,3.674737856163622,0.1950874587358302
8062,0.320297619047619,1,1,1,208901,396709,11806,96150,3.6747285931305345,0.19508622141423815
8063,0.3203333333333333,1,21,1,208922,396688,11807,96149,3.674534069435696,0.19509290089826858
8064,0.3203571428571428,2,6,2,208928,396682,11809,96147,3.6744784912371706,0.1950920096017077
8065,0.3203809523809524,0,2,0,208930,396680,11809,96147,3.6744599651709957,0.1950928013278493
8066,0.3204047619047619,0,1,0,208931,396679,11809,96147,3.674450702137908,0.1950931971933299
8067,0.3204166666666666,0,1,0,208932,396678,11809,96147,3.6744414391048204,0.195093593060417
8068,0.3204166666666667,0,2,0,208934,396676,11809,96147,3.6744229130386454,0.19509438479941074
8069,0.3204444444444444,0,1,0,208935,396675,11809,96147,3.6744136500055578,0.19509478067131744
8070,0.3204761904761905,0,2,0,208937,396673,11809,96147,3.674395123939383,0.19509557241995049
8071,0.3204999999999999,4,18,4,208955,396655,11813,96143,3.674228389343807,0.19509616516300796
8072,0.3205238095238095,0,1,0,208956,396654,11813,96143,3.674219126310719,0.19509656105861034
8073,0.3205357142857143,0,2,0,208958,396652,11813,96143,3.674200600244544,0.19509735285463528
8074,0.3205555555555556,0,2,0,208960,396650,11813,96143,3.674182074178369,0.19509814465708725
8075,0.3205714285714285,0,3,0,208963,396647,11813,96143,3.6741542850791062,0.19509933237281601
8076,0.3205952380952381,0,2,0,208965,396645,11813,96143,3.6741357590129313,0.19510012419133582
8077,0.3206428571428571,0,2,0,208967,396643,11813,96143,3.674117232946756,0.19510091601628293
8078,0.3206515151515151,0,1,0,208968,396642,11813,96143,3.6741079699136687,0.19510131193116673
8079,0.3206666666666666,8,58,8,209026,396584,11821,96135,3.6735707139945903,0.19511120943174506
8080,0.3206666666666667,0,8,0,209034,396576,11821,96135,3.67349660972989,0.19511437739364454
8081,0.3207142857142857,0,7,0,209041,396569,11821,96135,3.673431768498277,0.19511714944469702
8082,0.3207142857142858,0,2,0,209043,396567,11821,96135,3.673413242432102,0.19511794147375086
8083,0.32075,0,1,0,209044,396566,11821,96135,3.6734039793990143,0.19511833749068908
8084,0.3208333333333333,15,158,15,209202,396408,11836,96120,3.6719404201711807,0.19515641750316734
8085,0.3208571428571429,0,1,0,209203,396407,11836,96120,3.6719311571380935,0.1951568137381301
8086,0.3208809523809524,0,1,0,209204,396406,11836,96120,3.671921894105006,0.19515720997470185
8087,0.3208928571428571,0,1,0,209205,396405,11836,96120,3.671912631071918,0.19515760621288258
8088,0.3208968253968254,0,4,0,209209,396401,11836,96120,3.671875578939568,0.1951591911816958
8089,0.3209166666666667,1,5,1,209214,396396,11837,96119,3.6718292637741303,0.19515953828817395
8090,0.3209177489177489,0,1,0,209215,396395,11837,96119,3.6718200007410426,0.19515993453993186
8091,0.3209285714285714,0,1,0,209216,396394,11837,96119,3.671810737707955,0.19516033079329886
8092,0.3209444444444444,0,1,0,209217,396393,11837,96119,3.6718014746748677,0.19516072704827497
8093,0.3209523809523809,1,4,1,209221,396389,11838,96118,3.6717644225425174,0.19516067791929861
8094,0.320952380952381,0,1,0,209222,396388,11838,96118,3.6717551595094298,0.19516107417980694
8095,0.3209761904761904,0,2,0,209224,396386,11838,96118,3.671736633443255,0.1951618667056511
8096,0.3209999999999999,0,10,0,209234,396376,11838,96118,3.671644003112379,0.19516582943142455
8097,0.321,4,73,4,209307,396303,11842,96114,3.6709678016969876,0.19518822461450355
8098,0.3210833333333333,0,4,0,209311,396299,11842,96114,3.6709307495646373,0.19518981017966625
8099,0.3211111111111111,0,2,0,209313,396297,11842,96114,3.6709122234984624,0.1951906029719076
8100,0.3211363636363636,0,1,0,209314,396296,11842,96114,3.6709029604653747,0.19519099937044332
8101,0.3211666666666666,1,8,1,209322,396288,11843,96113,3.6708288562006746,0.19519253616463006
8102,0.3211666666666667,1,1,1,209323,396287,11844,96112,3.670819593167587,0.19519129811392794
8103,0.3211904761904762,0,8,0,209331,396279,11844,96112,3.6707454889028863,0.19519446943587515
8104,0.32125,0,11,0,209342,396268,11844,96112,3.670643595538923,0.19519883017181852
8105,0.3212619047619047,0,2,0,209344,396266,11844,96112,3.6706250694727482,0.19519962305383262
8106,0.3212738095238094,1,1,1,209345,396265,11845,96111,3.6706158064396606,0.19519838497408484
8107,0.3212857142857143,0,1,0,209346,396264,11845,96111,3.670606543406573,0.1951987814166032
8108,0.321293956043956,0,2,0,209348,396262,11845,96111,3.670588017340398,0.19519957430647092
8109,0.3213095238095238,0,2,0,209350,396260,11845,96111,3.670569491274223,0.19520036720278003
8110,0.3213333333333333,3,25,3,209375,396235,11848,96108,3.670337915447034,0.1952053751145035
8111,0.3213333333333334,0,7,0,209382,396228,11848,96108,3.6702730742154213,0.19520815053134444
8112,0.3213571428571428,0,1,0,209383,396227,11848,96108,3.6702638111823336,0.19520854702590715
8113,0.3213636363636364,0,1,0,209384,396226,11848,96108,3.670254548149246,0.19520894352208054
8114,0.3213690476190476,0,2,0,209386,396224,11848,96108,3.670236022083071,0.19520973651925935
8115,0.3213831168831169,0,5,0,209391,396219,11848,96108,3.670189706917633,0.1952117190403939
8116,0.3214166666666667,0,2,0,209393,396217,11848,96108,3.670171180851458,0.19521251206012288
8117,0.3214285714285714,1,5,1,209398,396212,11849,96107,3.67012486568602,0.19521285995462292
8118,0.3214999999999999,0,1,0,209399,396211,11849,96107,3.6701156026529325,0.19521325647244261
8119,0.3215,0,29,0,209428,396182,11849,96107,3.6698469746933937,0.1952247561899616
8120,0.3215238095238095,0,3,0,209431,396179,11849,96107,3.669819185594131,0.1952259458932409
8121,0.321547619047619,0,4,0,209435,396175,11849,96107,3.669782133461781,0.195227532186836
8122,0.3215476190476191,0,2,0,209437,396173,11849,96107,3.6697636073956055,0.19522832534330056
8123,0.3215714285714285,0,2,0,209439,396171,11849,96107,3.6697450813294306,0.19522911850620991
8124,0.321624542124542,0,1,0,209440,396170,11849,96107,3.669735818296343,0.1952295150900814
8125,0.3216269841269841,0,1,0,209441,396169,11849,96107,3.669726555263255,0.1952299116755641
8126,0.3216428571428571,0,1,0,209442,396168,11849,96107,3.669717292230168,0.19523030826265805
8127,0.3216666666666665,0,2,0,209444,396166,11849,96107,3.6696987661639926,0.1952311014416797
8128,0.3216666666666666,24,192,24,209636,395974,11873,96083,3.6679202638111823,0.19526802789107767
8129,0.3216666666666667,27,264,27,209900,395710,11900,96056,3.665474823076068,0.19532867258004824
8130,0.3217142857142857,0,1,0,209901,395709,11900,96056,3.6654655600429806,0.19532906977926448
8131,0.3217362914862915,0,3,0,209904,395706,11900,96056,3.665437770943718,0.19533026138660572
8132,0.3217597402597403,0,2,0,209906,395704,11900,96056,3.6654192448775427,0.19533105579957702
8133,0.3217619047619047,0,2,0,209908,395702,11900,96056,3.6654007188113678,0.19533185021901017
8134,0.3217857142857143,0,3,0,209911,395699,11900,96056,3.6653729297121047,0.19533304186027595
8135,0.3217878787878788,0,1,0,209912,395698,11900,96056,3.6653636666790175,0.19533343907726222
8136,0.3218333333333333,2,17,2,209929,395681,11902,96054,3.665206195116529,0.1953369192756261
8137,0.3218531746031746,0,1,0,209930,395680,11902,96054,3.6651969320834414,0.19533731651665331
8138,0.3218636363636363,0,1,0,209931,395679,11902,96054,3.6651876690503538,0.1953377137592962
8139,0.3218690476190476,0,1,0,209932,395678,11902,96054,3.665178406017266,0.19533811100355478
8140,0.3218888888888889,0,1,0,209933,395677,11902,96054,3.665169142984179,0.19533850824942905
8141,0.3219047619047619,2,4,2,209937,395673,11904,96052,3.6651320908518286,0.19533682444455744
8142,0.3219166666666666,0,1,0,209938,395672,11904,96052,3.665122827818741,0.19533722169347031
8143,0.321952380952381,0,2,0,209940,395670,11904,96052,3.665104301752566,0.19533801619614335
8144,0.3219642857142857,0,1,0,209941,395669,11904,96052,3.6650950387194783,0.1953384134499035
8145,0.3219999999999999,0,3,0,209944,395666,11904,96052,3.6650672496202157,0.19533960522087862
8146,0.322,5,81,5,210025,395585,11909,96047,3.6643169439401237,0.19536360529827188
8147,0.3220238095238095,0,1,0,210026,395584,11909,96047,3.664307680907036,0.19536400267680434
8148,0.3220476190476191,0,3,0,210029,395581,11909,96047,3.6642798918077735,0.19536519482210127
8149,0.3220833333333333,0,5,0,210034,395576,11909,96047,3.664233576642336,0.19536718176326168
8150,0.3221428571428572,0,11,0,210045,395565,11909,96047,3.664131683278373,0.19537155317608196
8151,0.3221666666666667,1,13,1,210058,395552,11910,96046,3.6640112638482343,0.19537508289293284
8152,0.3221904761904762,0,1,0,210059,395551,11910,96046,3.664002000815147,0.1953754803222965
8153,0.3222077922077922,0,1,0,210060,395550,11910,96046,3.6639927377820594,0.19537587775327708
8154,0.3222222222222221,0,2,0,210062,395548,11910,96046,3.6639742117158844,0.19537667262008893
8155,0.3222222222222222,0,3,0,210065,395545,11910,96046,3.6639464226166214,0.19537786493243367
8156,0.3222265512265511,0,10,0,210075,395535,11910,96046,3.663853792285746,0.1953818394120196
8157,0.3222380952380952,0,1,0,210076,395534,11910,96046,3.6638445292526587,0.1953822368688718
8158,0.3222857142857143,0,2,0,210078,395532,11910,96046,3.6638260031864833,0.19538303178742744
8159,0.3223095238095238,0,1,0,210079,395531,11910,96046,3.6638167401533956,0.19538342924913085
8160,0.3223333333333332,1,0,1,210079,395531,11911,96045,3.6638167401533956,0.1953817924390125
8161,0.3223333333333333,6,50,6,210129,395481,11917,96039,3.6633535884990183,0.195391845703125
8162,0.3223571428571429,1,0,1,210129,395481,11918,96038,3.6633535884990183,0.19539020872031396
8163,0.3223809523809523,0,1,0,210130,395480,11918,96038,3.6633443254659306,0.1953906062443288
8164,0.3223809523809524,1,12,1,210142,395468,11919,96037,3.6632331690688797,0.19539373963642281
8165,0.3223888888888889,0,1,0,210143,395467,11919,96037,3.6632239060357925,0.19539413717894463
8166,0.3224126984126984,0,1,0,210144,395466,11919,96037,3.663214643002705,0.1953945347230841
8167,0.3224166666666667,0,3,0,210147,395463,11919,96037,3.6631868539034422,0.19539572736520855
8168,0.3224523809523809,0,1,0,210148,395462,11919,96037,3.6631775908703545,0.19539612491581876
8169,0.3225,42,464,42,210612,394998,11961,95995,3.6588795435177293,0.1955119523088924
8170,0.3225714285714285,0,1,0,210613,394997,11961,95995,3.658870280484642,0.19551235050672924
8171,0.3226190476190476,0,4,0,210617,394993,11961,95995,3.6588332283522917,0.1955139433142969
8172,0.3226382783882783,0,3,0,210620,394990,11961,95995,3.658805439253029,0.19551513793700417
8173,0.3226428571428572,0,1,0,210621,394989,11961,95995,3.6587961762199415,0.19551553614781744
8174,0.3226634199134199,0,2,0,210623,394987,11961,95995,3.6587776501537665,0.19551633257431025
8175,0.3226666666666666,4,65,4,210688,394922,11965,95991,3.6581755530030753,0.19553566517896245
8176,0.3226904761904761,0,1,0,210689,394921,11965,95991,3.6581662899699876,0.19553606348999414
8177,0.3226904761904762,0,1,0,210690,394920,11965,95991,3.6581570269369004,0.19553646180264855
8178,0.3227142857142857,0,2,0,210692,394918,11965,95991,3.658138500870725,0.19553725843282563
8179,0.3227272727272727,0,3,0,210695,394915,11965,95991,3.6581107117714624,0.19553845339026207
8180,0.3227380952380952,1,1,1,210696,394914,11966,95990,3.6581014487383747,0.19553721297850496
8181,0.32275,1,0,1,210696,394914,11967,95989,3.6581014487383747,0.19553557423768037
8182,0.3227619047619048,0,1,0,210697,394913,11967,95989,3.6580921857052875,0.19553597255664062
8183,0.3227777777777778,0,2,0,210699,394911,11967,95989,3.658073659639112,0.1955367691994296
8184,0.3228095238095237,0,1,0,210700,394910,11967,95989,3.658064396606025,0.19553716752325834
8185,0.3228214285714286,0,1,0,210701,394909,11967,95989,3.658055133572937,0.1955375658487099
8186,0.3228333333333333,1,12,1,210713,394897,11968,95988,3.6579439771758864,0.19554070709025537
8187,0.3228571428571428,0,14,0,210727,394883,11968,95988,3.6578142947126606,0.19554628405426272
8188,0.3228888888888889,0,1,0,210728,394882,11968,95988,3.657805031679573,0.1955466824210076
8189,0.3229166666666666,0,2,0,210730,394880,11968,95988,3.657786505613398,0.19554747915936668
8190,0.3229166666666667,0,3,0,210733,394877,11968,95988,3.6577587165141354,0.19554867427907877
8191,0.3229523809523809,0,1,0,210734,394876,11968,95988,3.6577494534810477,0.19554907265556243
8192,0.322952380952381,0,2,0,210736,394874,11968,95988,3.657730927414873,0.19554986941339927
8193,0.3229761904761905,0,1,0,210737,394873,11968,95988,3.657721664381785,0.19555026779475249
8194,0.3229999999999999,6,61,6,210798,394812,11974,95982,3.657156619363444,0.19556473795523172
8195,0.323,0,5,0,210803,394807,11974,95982,3.6571103041980066,0.19556673030569144
8196,0.323047619047619,0,1,0,210804,394806,11974,95982,3.657101041164919,0.1955671287806548
8197,0.3230555555555556,0,2,0,210806,394804,11974,95982,3.657082515098744,0.19556792573545292
8198,0.3230952380952381,0,1,0,210807,394803,11974,95982,3.6570732520656564,0.19556832421528775
8199,0.3231111111111112,0,1,0,210808,394802,11974,95982,3.6570639890325687,0.19556872269674644
8200,0.3231666666666666,1,17,1,210825,394785,11975,95981,3.6569065174700803,0.19557385800972357
8201,0.3231666666666667,0,2,0,210827,394783,11975,95981,3.6568879914039054,0.19557465502767113
8202,0.3232129047423164,0,1,0,210828,394782,11975,95981,3.6568787283708177,0.19557505353908097
8203,0.3232142857142857,1,6,1,210834,394776,11976,95980,3.6568231501722925,0.1955758054919349
8204,0.3232222222222222,0,1,0,210835,394775,11976,95980,3.656813887139205,0.1955762040121853
8205,0.3232313797313797,1,3,1,210838,394772,11977,95979,3.6567860980399423,0.19557576041617847
8206,0.3232380952380952,0,1,0,210839,394771,11977,95979,3.6567768350068546,0.19557615894039734
8207,0.32325,0,3,0,210842,394768,11977,95979,3.656749045907592,0.19557735452279892
8208,0.3232857142857143,1,1,1,210843,394767,11978,95978,3.6567397828745043,0.19557611386769097
8209,0.3233095238095238,0,5,0,210848,394762,11978,95978,3.656693467709067,0.195578106532991
8210,0.3233333333333333,74,784,74,211632,393978,12052,95904,3.649431249768424,0.19576959349394343
8211,0.3233809523809524,0,1,0,211633,393977,12052,95904,3.649421986735337,0.1957699931207783
8212,0.3234166666666667,0,1,0,211634,393976,12052,95904,3.649412723702249,0.1957703927492447
8213,0.3234523809523809,1,3,1,211637,393973,12053,95903,3.6493849346029865,0.19576994994651709
8214,0.3234999999999999,1,8,1,211645,393965,12054,95902,3.649310830338286,0.19577150532695609
8215,0.3235,3,28,3,211673,393937,12057,95899,3.6490514654118344,0.19577777051911252
8216,0.323547619047619,0,1,0,211674,393936,12057,95899,3.6490422023787468,0.19577817020016944
8217,0.3235714285714286,1,1,1,211675,393935,12058,95898,3.6490329393456595,0.19577692805507182
8218,0.3236190476190476,0,2,0,211677,393933,12058,95898,3.649014413279484,0.19577772742027352
8219,0.3236666666666666,2,33,2,211710,393900,12060,95896,3.648708733187595,0.19578763403539431
8220,0.3236666666666667,0,1,0,211711,393899,12060,95896,3.6486994701545075,0.19578803376922999
8221,0.3236904761904762,0,2,0,211713,393897,12060,95896,3.648680944088332,0.19578883324179808
8222,0.3236984126984126,0,3,0,211716,393894,12060,95896,3.6486531549890695,0.19579003246289226
8223,0.3237142857142857,0,3,0,211719,393891,12060,95896,3.648625365889807,0.19579123169867718
8224,0.32375,0,11,0,211730,393880,12060,95896,3.6485234725258437,0.1957956290222469
8225,0.3237777777777777,0,2,0,211732,393878,12060,95896,3.648504946459669,0.1957964285568446
8226,0.3237857142857143,0,1,0,211733,393877,12060,95896,3.648495683426581,0.19579682832659212
8227,0.3237878787878787,0,1,0,211734,393876,12060,95896,3.6484864203934935,0.19579722809797212
8228,0.3237950937950937,0,4,0,211738,393872,12060,95896,3.6484493682611436,0.19579882719981706
8229,0.3238095238095237,0,3,0,211741,393869,12060,95896,3.6484215791618806,0.19580002654334222
8230,0.3238095238095239,0,1,0,211742,393868,12060,95896,3.6484123161287934,0.19580042632778236
8231,0.3238333333333333,2,7,2,211749,393861,12062,95894,3.6483474748971805,0.1957999407867199
8232,0.3238333333333334,0,5,0,211754,393856,12062,95894,3.6483011597317425,0.1958019397651863
8233,0.3238571428571428,0,1,0,211755,393855,12062,95894,3.648291896698655,0.19580233956577758
8234,0.3238888888888888,1,2,1,211757,393853,12063,95893,3.64827337063248,0.1958014971025797
8235,0.3238896103896104,0,1,0,211758,393852,12063,95893,3.6482641075993922,0.19580189690553246
8236,0.3239166666666666,0,1,0,211759,393851,12063,95893,3.648254844566305,0.19580229671011795
8237,0.3239285714285714,0,1,0,211760,393850,12063,95893,3.6482455815332173,0.1958026965163361
8238,0.3239523809523809,1,1,1,211761,393849,12064,95892,3.6482363185001296,0.19580145423805645
8239,0.3239801587301588,0,1,0,211762,393848,12064,95892,3.648227055467042,0.19580185404500347
8240,0.324,4,141,4,211903,393707,12068,95888,3.646920967801697,0.19585167332182724
8241,0.324047619047619,0,2,0,211905,393705,12068,95888,3.646902441735522,0.1958524733809511
8242,0.3240714285714285,0,2,0,211907,393703,12068,95888,3.646883915669347,0.19585327344661155
8243,0.3240833333333333,0,1,0,211908,393702,12068,95888,3.646874652636259,0.195853673481893
8244,0.3240952380952381,0,1,0,211909,393701,12068,95888,3.6468653896031715,0.19585407351880862
8245,0.3241111111111111,0,1,0,211910,393700,12068,95888,3.6468561265700843,0.19585447355735844
8246,0.3241190476190476,0,1,0,211911,393699,12068,95888,3.6468468635369966,0.19585487359754242
8247,0.3241666666666665,0,1,0,211912,393698,12068,95888,3.646837600503909,0.19585527363936062
8248,0.3241666666666666,3,61,3,211973,393637,12071,95885,3.6462725554855684,0.19587475128799114
8249,0.3241666666666667,6,75,6,212048,393562,12077,95879,3.6455778280040017,0.1958949086815367
8250,0.3241904761904762,0,3,0,212051,393559,12077,95879,3.645550038904739,0.19589610941528857
8251,0.3242063492063492,0,1,0,212052,393558,12077,95879,3.6455407758716514,0.19589650966314356
8252,0.3242142857142858,0,1,0,212053,393557,12077,95879,3.6455315128385637,0.19589690991263414
8253,0.3242619047619047,0,1,0,212054,393556,12077,95879,3.6455222498054765,0.19589731016376025
8254,0.3242857142857143,2,23,2,212077,393533,12079,95877,3.6453092000444625,0.195903230420302
8255,0.3243055555555555,0,1,0,212078,393532,12079,95877,3.6452999370113752,0.19590363070560615
8256,0.3243095238095238,0,1,0,212079,393531,12079,95877,3.6452906739782875,0.1959040309925461
8257,0.3243333333333333,3,23,3,212102,393508,12082,95874,3.6450776242172735,0.19590830884666785
8258,0.3243809523809524,0,2,0,212104,393506,12082,95874,3.6450590981510986,0.1959091094854714
8259,0.3244047619047619,0,1,0,212105,393505,12082,95874,3.645049835118011,0.19590950980732724
8260,0.3244242424242424,0,1,0,212106,393504,12082,95874,3.6450405720849233,0.19590991013081913
8261,0.3244285714285713,0,2,0,212108,393502,12082,95874,3.6450220460187484,0.19591071078271105
8262,0.3244444444444444,0,3,0,212111,393499,12082,95874,3.6449942569194858,0.1959119117728195
8263,0.3244523809523809,0,2,0,212113,393497,12082,95874,3.6449757308533104,0.1959127124410723
8264,0.3244761904761904,0,2,0,212115,393495,12082,95874,3.6449572047871355,0.19591351311586963
8265,0.3244999999999999,0,1,0,212116,393494,12082,95874,3.644947941754048,0.19591391345572248
8266,0.3245,1,23,1,212139,393471,12083,95873,3.6447348919930342,0.19592147855087627
8267,0.3245238095238095,0,5,0,212144,393466,12083,95873,3.6446885768275963,0.19592348045015828
8268,0.3245277777777777,0,1,0,212145,393465,12083,95873,3.644679313794509,0.19592388083492393
8269,0.3245555555555555,1,1,1,212146,393464,12084,95872,3.6446700507614214,0.195922638023771
8270,0.3245833333333333,0,5,0,212151,393459,12084,95872,3.6446237355959834,0.19592463996762927
8271,0.324642857142857,0,1,0,212152,393458,12084,95872,3.644614472562896,0.19592504036131037
8272,0.3246428571428572,0,2,0,212154,393456,12084,95872,3.644595946496721,0.19592584115358205
8273,0.3246666666666666,5,35,5,212189,393421,12089,95867,3.6442717403386564,0.19593163944343617
8274,0.3246904761904761,0,1,0,212190,393420,12089,95867,3.6442624773055687,0.1959320398866105
8275,0.3246904761904762,0,1,0,212191,393419,12089,95867,3.6442532142724815,0.1959324403314217
8276,0.3247058823529412,0,1,0,212192,393418,12089,95867,3.644243951239394,0.19593284077786974
8277,0.3247142857142857,0,1,0,212193,393417,12089,95867,3.644234688206306,0.19593324122595465
8278,0.3247222222222222,0,1,0,212194,393416,12089,95867,3.644225425173219,0.19593364167567645
8279,0.3247460317460317,0,1,0,212195,393415,12089,95867,3.644216162140131,0.19593404212703514
8280,0.32475,1,1,1,212196,393414,12090,95866,3.6442068991070435,0.19593279921517331
8281,0.3247619047619047,1,1,1,212197,393413,12091,95865,3.644197636073956,0.19593155629315032
8282,0.3247857142857143,1,0,1,212197,393413,12092,95864,3.644197636073956,0.19592991291231757
8283,0.3248333333333332,0,1,0,212198,393412,12092,95864,3.6441883730408686,0.195930313360966
8284,0.3248333333333333,1,9,1,212207,393403,12093,95863,3.6441050057430804,0.19593227405950955
8285,0.3248690476190476,0,1,0,212208,393402,12093,95863,3.644095742709993,0.19593267452198707
8286,0.3248809523809524,0,3,0,212211,393399,12093,95863,3.64406795361073,0.19593387591924163
8287,0.3248888888888889,0,1,0,212212,393398,12093,95863,3.644058690577643,0.19593427638826721
8288,0.3249166666666667,0,1,0,212213,393397,12093,95863,3.644049427544555,0.19593467685892982
8289,0.3249816017316017,0,3,0,212216,393394,12093,95863,3.6440216384452926,0.19593587828073997
8290,0.3249999999999999,0,1,0,212217,393393,12093,95863,3.644012375412205,0.19593627875795086
8291,0.325,131,1466,131,213683,391927,12224,95732,3.6304327689058504,0.19630930629804844
8292,0.3250476190476191,0,4,0,213687,391923,12224,95732,3.6303957167735,0.19631091652910357
8293,0.3250714285714286,0,1,0,213688,391922,12224,95732,3.630386453740413,0.19631131909099483
8294,0.3250833333333333,0,1,0,213689,391921,12224,95732,3.6303771907073252,0.19631172165453714
8295,0.325095238095238,1,0,1,213689,391921,12225,95731,3.6303771907073252,0.19631007357705904
8296,0.3251190476190476,0,3,0,213692,391918,12225,95731,3.6303494016080626,0.1963112812699298
8297,0.3251414141414141,0,1,0,213693,391917,12225,95731,3.630340138574975,0.19631168383752215
8298,0.3251666666666666,1,11,1,213704,391906,12226,95730,3.630238245211012,0.19631446406746014
8299,0.3251666666666667,0,1,0,213705,391905,12226,95730,3.6302289821779246,0.19631486665231165
8300,0.3251904761904762,0,2,0,213707,391903,12226,95730,3.630210456111749,0.19631567182696824
8301,0.3252142857142857,0,1,0,213708,391902,12226,95730,3.6302011930786615,0.19631607441677332
8302,0.3252331002331002,0,3,0,213711,391899,12226,95730,3.630173403979399,0.19631728219609582
8303,0.3252380952380952,0,1,0,213712,391898,12226,95730,3.6301641409463117,0.19631768479250578
8304,0.32525,0,1,0,213713,391897,12226,95730,3.630154877913224,0.19631808739056697
8305,0.3252777777777778,0,5,0,213718,391892,12226,95730,3.630108562747786,0.19632010040564207
8306,0.3253095238095238,0,1,0,213719,391891,12226,95730,3.630099299714699,0.19632050301361098
8307,0.3253333333333333,3,43,3,213762,391848,12229,95727,3.629700989291934,0.1963328718658668
8308,0.3253571428571428,0,5,0,213767,391843,12229,95727,3.629654674126496,0.19633488524724654
8309,0.3254166666666666,0,4,0,213771,391839,12229,95727,3.6296176219941456,0.19633649598208242
8310,0.3254166666666667,0,2,0,213773,391837,12229,95727,3.6295990959279707,0.19633730135941127
8311,0.3254285714285714,0,1,0,213774,391836,12229,95727,3.629589832894883,0.19633770405055348
8312,0.3254761904761904,1,0,1,213774,391836,12230,95726,3.629589832894883,0.19633605572214405
8313,0.3254761904761905,0,5,0,213779,391831,12230,95726,3.6295435177294455,0.19633806918985883
8314,0.3254920634920635,0,1,0,213780,391830,12230,95726,3.629534254696358,0.19633847188835743
8315,0.3254999999999999,1,15,1,213795,391815,12231,95725,3.6293953092000444,0.19634286417524716
8316,0.3255,0,1,0,213796,391814,12231,95725,3.6293860461669567,0.19634326689762255
8317,0.3255238095238095,0,2,0,213798,391812,12231,95725,3.629367520100782,0.19634407234732953
8318,0.3255555555555556,0,3,0,213801,391809,12231,95725,3.629339731001519,0.1963452805342807
8319,0.3256190476190476,0,1,0,213802,391808,12231,95725,3.6293304679684315,0.19634568326656862
8320,0.3256428571428571,0,1,0,213803,391807,12231,95725,3.629321204935344,0.19634608600050868
8321,0.3256428571428572,0,1,0,213804,391806,12231,95725,3.6293119419022566,0.1963464887361009
8322,0.3256626984126984,0,2,0,213806,391804,12231,95725,3.6292934158360812,0.19634729421224173
8323,0.3256666666666666,3,33,3,213839,391771,12234,95722,3.628987735744192,0.1963556399784202
8324,0.3256666666666667,0,3,0,213842,391768,12234,95722,3.6289599466449296,0.1963568483456071
8325,0.3257142857142857,0,19,0,213861,391749,12234,95722,3.628783949016266,0.19636450168317704
8326,0.3257196969696969,0,1,0,213862,391748,12234,95722,3.628774685983178,0.19636490450694402
8327,0.3257738095238094,0,1,0,213863,391747,12234,95722,3.628765422950091,0.1963653073323637
8328,0.3257777777777778,0,1,0,213864,391746,12234,95722,3.6287561599170033,0.1963657101594361
8329,0.3258055555555555,0,1,0,213865,391745,12234,95722,3.6287468968839156,0.19636611298816126
8330,0.3258095238095238,0,1,0,213866,391744,12234,95722,3.628737633850828,0.19636651581853914
8331,0.3258253968253968,1,0,1,213866,391744,12235,95721,3.628737633850828,0.1963648672212364
8332,0.3258333333333333,15,147,15,214013,391597,12250,95706,3.6273759679869575,0.19639936548718148
8333,0.3259523809523809,0,5,0,214018,391592,12250,95706,3.62732965282152,0.19640138067465904
8334,0.325952380952381,0,1,0,214019,391591,12250,95706,3.6273203897884323,0.19640178371711708
8335,0.3259999999999999,1,10,1,214029,391581,12251,95705,3.627227759457557,0.19640416511042796
8336,0.326,15,139,15,214168,391442,12266,95690,3.625940197858387,0.19643546307776946
8337,0.3260090187590186,0,1,0,214169,391441,12266,95690,3.6259309348252993,0.19643586632753818
8338,0.3260555555555555,0,1,0,214170,391440,12266,95690,3.6259216717922116,0.19643626957896249
8339,0.3260714285714286,0,4,0,214174,391436,12266,95690,3.6258846196598613,0.1964378826012161
8340,0.3260833333333333,0,1,0,214175,391435,12266,95690,3.625875356626774,0.19643828586091866
8341,0.326095238095238,1,0,1,214175,391435,12267,95689,3.625875356626774,0.19643663625688737
8342,0.3261031746031746,0,5,0,214180,391430,12267,95689,3.625829041461336,0.19643865256744245
8343,0.3261190476190476,0,1,0,214181,391429,12267,95689,3.6258197784282484,0.1964390558345206
8344,0.3261666666666666,4,9,4,214190,391420,12271,95685,3.6257364111304606,0.19643608667535747
8345,0.3261666666666667,0,1,0,214191,391419,12271,95685,3.625727148097373,0.19643648994875837
8346,0.3261825396825397,0,2,0,214193,391417,12271,95685,3.625708622031198,0.1964372965005276
8347,0.3261904761904761,0,3,0,214196,391414,12271,95685,3.6256808329319354,0.19643850634060017
8348,0.3261904761904762,0,3,0,214199,391411,12271,95685,3.6256530438326724,0.1964397161955754
8349,0.3262142857142857,0,2,0,214201,391409,12271,95685,3.6256345177664975,0.1964405227738383
8350,0.3262222222222222,0,1,0,214202,391408,12271,95685,3.62562525473341,0.19644092606545363
8351,0.3262370129870129,0,1,0,214203,391407,12271,95685,3.6256159917003226,0.19644132935872485
8352,0.32625,0,11,0,214214,391396,12271,95685,3.6255140983363594,0.1964457656940016
8353,0.3262619047619047,0,1,0,214215,391395,12271,95685,3.6255048353032717,0.19644616900714462
8354,0.3262857142857143,0,1,0,214216,391394,12271,95685,3.625495572270184,0.19644657232194368
8355,0.3263076923076923,0,1,0,214217,391393,12271,95685,3.625486309237097,0.19644697563839877
8356,0.3263095238095237,0,4,0,214221,391389,12271,95685,3.6254492571047465,0.19644858892078002
8357,0.3263333333333333,1,14,1,214235,391375,12272,95684,3.6253195746415208,0.1964525858263578
8358,0.3263333333333334,0,4,0,214239,391371,12272,95684,3.6252825225091705,0.19645419921774748
8359,0.3263571428571428,1,1,1,214240,391370,12273,95683,3.625273259476083,0.19645295275873467
8360,0.3264166666666666,0,1,0,214241,391369,12273,95683,3.625263996442995,0.1964533561098199
8361,0.3264285714285714,0,5,0,214246,391364,12273,95683,3.6252176812775576,0.19645537289009068
8362,0.3264393939393939,0,1,0,214247,391363,12273,95683,3.62520841824447,0.19645577625111385
8363,0.3264761904761905,1,1,1,214248,391362,12274,95682,3.6251991552113823,0.1964545297755439
8364,0.3264999999999999,0,1,0,214249,391361,12274,95682,3.625189892178295,0.19645493313732051
8365,0.3265,3,31,3,214280,391330,12277,95679,3.6249027381525805,0.1964624883729048
8366,0.3265238095238095,0,1,0,214281,391329,12277,95679,3.6248934751194932,0.19646289178001183
8367,0.326547619047619,1,1,1,214282,391328,12278,95678,3.6248842120864055,0.19646164523640366
8368,0.3265476190476191,0,1,0,214283,391327,12278,95678,3.624874949053318,0.19646204864426442
8369,0.3265833333333333,0,3,0,214286,391324,12278,95678,3.6248471599540553,0.19646325887778696
8370,0.3266190476190476,1,0,1,214286,391324,12279,95677,3.6248471599540553,0.1964616089084006
8371,0.3266428571428571,0,2,0,214288,391322,12279,95677,3.6248286338878803,0.1964624157339132
8372,0.3266428571428572,0,1,0,214289,391321,12279,95677,3.6248193708547927,0.19646281914915462
8373,0.3266666666666666,35,322,35,214611,390999,12314,95642,3.6218366742006003,0.19653502273750054
8374,0.3266666666666667,38,519,38,215130,390480,12352,95604,3.6170291600281597,0.19668205495346483
8375,0.3266949161949161,0,6,0,215136,390474,12352,95604,3.6169735818296345,0.19668448273733846
8376,0.3267142857142858,0,1,0,215137,390473,12352,95604,3.616964318796547,0.19668488737381115
8377,0.3267222222222222,0,1,0,215138,390472,12352,95604,3.616955055763459,0.19668529201194876
8378,0.3267515262515262,0,1,0,215139,390471,12352,95604,3.6169457927303714,0.19668569665175129
8379,0.3267777777777778,0,2,0,215141,390469,12352,95604,3.6169272666641965,0.19668650593635112
8380,0.3267857142857143,0,5,0,215146,390464,12352,95604,3.6168809514987585,0.1966885291769876
8381,0.3268030303030303,1,0,1,215146,390464,12353,95603,3.6168809514987585,0.19668687650056474
8382,0.3268333333333333,3,16,3,215162,390448,12356,95600,3.616732742969358,0.196688392915926
8383,0.3268571428571428,1,4,1,215166,390444,12357,95599,3.6166956908370076,0.19668835884890842
8384,0.3268809523809524,0,2,0,215168,390442,12357,95599,3.6166771647708327,0.19668916819774462
8385,0.3269047619047619,0,4,0,215172,390438,12357,95599,3.6166401126384824,0.19669078691539946
8386,0.3269285714285714,0,1,0,215173,390437,12357,95599,3.6166308496053947,0.19669119159897622
8387,0.3269444444444444,0,2,0,215175,390435,12357,95599,3.61661232353922,0.19669200097112546
8388,0.3269999999999999,0,1,0,215176,390434,12357,95599,3.616603060506132,0.196692405659698
8389,0.327,5,46,5,215222,390388,12362,95594,3.6161769609841046,0.19670275853838207
8390,0.3270238095238095,1,1,1,215223,390387,12363,95593,3.616167697951017,0.19670151035022018
8391,0.3270833333333333,0,4,0,215227,390383,12363,95593,3.616130645818667,0.19670312937264392
8392,0.3270952380952381,0,1,0,215228,390382,12363,95593,3.6161213827855794,0.19670353413241423
8393,0.3271111111111111,0,1,0,215229,390381,12363,95593,3.6161121197524917,0.1967039388938503
8394,0.3271428571428572,1,13,1,215242,390368,12364,95592,3.6159917003223536,0.19670754794633302
8395,0.3271666666666666,0,19,0,215261,390349,12364,95592,3.61581570269369,0.1967152390928117
8396,0.3271904761904761,0,4,0,215265,390345,12364,95592,3.6157786505613396,0.19671685835818223
8397,0.3271904761904762,0,1,0,215266,390344,12364,95592,3.6157693875282524,0.1967172631786902
8398,0.3272857142857143,0,1,0,215267,390343,12364,95592,3.6157601244951647,0.19671766800086432
8399,0.3273333333333332,0,1,0,215268,390342,12364,95592,3.615750861462077,0.19671807282470458
8400,0.3273333333333333,1,47,1,215315,390295,12365,95591,3.6153154989069622,0.19673544823271302
8401,0.3273333333333334,0,1,0,215316,390294,12365,95591,3.6153062358738746,0.19673585313397204
8402,0.3273809523809523,0,1,0,215317,390293,12365,95591,3.615296972840787,0.1967362580368977
8403,0.3273809523809524,1,1,1,215318,390292,12366,95590,3.6152877098076996,0.1967350097348739
8404,0.3274047619047618,0,1,0,215319,390291,12366,95590,3.615278446774612,0.19673541463856375
8405,0.3274111721611721,0,3,0,215322,390288,12366,95590,3.6152506576753494,0.19673662935963349
8406,0.3274166666666667,0,1,0,215323,390287,12366,95590,3.6152413946422617,0.19673703426999015
8407,0.3274285714285714,0,3,0,215326,390284,12366,95590,3.615213605542999,0.1967382490110605
8408,0.3274761904761905,0,1,0,215327,390283,12366,95590,3.6152043425099114,0.1967386539280841
8409,0.3274999999999999,0,1,0,215328,390282,12366,95590,3.6151950794768237,0.19673905884677445
8410,0.3275,43,408,43,215736,389874,12409,95547,3.611415761977102,0.19683326432107387
8411,0.3275476190476191,0,2,0,215738,389872,12409,95547,3.6113972359109265,0.1968340753040157
8412,0.3275714285714285,0,1,0,215739,389871,12409,95547,3.6113879728778393,0.19683448079799265
8413,0.3275833333333333,0,1,0,215740,389870,12409,95547,3.6113787098447516,0.19683488629364032
8414,0.3276071428571429,0,1,0,215741,389869,12409,95547,3.611369446811664,0.19683529179095868
8415,0.3276190476190476,1,1,1,215742,389868,12410,95546,3.6113601837785763,0.19683404269345342
8416,0.3276666666666666,4,42,4,215784,389826,12414,95542,3.610971136388899,0.19684445616521898
8417,0.3276666666666667,0,2,0,215786,389824,12414,95542,3.610952610322724,0.196845267282834
8418,0.3277380952380951,1,0,1,215786,389824,12415,95541,3.610952610322724,0.19684361253901703
8419,0.3277380952380953,0,2,0,215788,389822,12415,95541,3.610934084256549,0.19684442365816926
8420,0.32775,0,2,0,215790,389820,12415,95541,3.610915558190374,0.19684523478400612
8421,0.3277619047619048,0,1,0,215791,389819,12415,95541,3.610906295157286,0.19684564034943136
8422,0.3277777777777777,1,1,1,215792,389818,12416,95540,3.610897032124199,0.19684439115044977
8423,0.3277777777777778,0,4,0,215796,389814,12416,95540,3.6108599799918486,0.1968460134252525
8424,0.3277857142857142,1,1,1,215797,389813,12417,95539,3.610850716958761,0.19684476421236546
8425,0.3278333333333333,0,12,0,215809,389801,12417,95539,3.6107395605617105,0.1968496311863848
8426,0.3278571428571428,0,7,0,215816,389794,12417,95539,3.6106747193300976,0.19685247036570766
8427,0.3278571428571429,0,1,0,215817,389793,12417,95539,3.61066545629701,0.19685287596943948
8428,0.3279166666666666,0,1,0,215818,389792,12417,95539,3.6106561932639223,0.19685328157484275
8429,0.3279166666666667,0,3,0,215821,389789,12417,95539,3.6106284041646597,0.19685449840108132
8430,0.3279523809523809,0,1,0,215822,389788,12417,95539,3.610619141131572,0.1968549040131705
8431,0.3279761904761905,0,5,0,215827,389783,12417,95539,3.6105728259661345,0.19685693209868912
8432,0.3279999999999999,10,111,10,215938,389672,12427,95529,3.6095446292934157,0.1968854144983213
8433,0.328,0,6,0,215944,389666,12427,95529,3.6094890510948905,0.19688784921526398
8434,0.3280238095238095,0,2,0,215946,389664,12427,95529,3.6094705250287156,0.19688866080095963
8435,0.328047619047619,1,1,1,215947,389663,12428,95528,3.609461261995628,0.1968874113493449
8436,0.3280952380952381,1,3,1,215950,389660,12429,95527,3.6094334728963653,0.1968869734762061
8437,0.3281190476190476,0,1,0,215951,389659,12429,95527,3.6094242098632776,0.1968873792731035
8438,0.3281230158730159,1,0,1,215951,389659,12430,95526,3.6094242098632776,0.19688572400218474
8439,0.3281507936507936,0,2,0,215953,389657,12430,95526,3.6094056837971027,0.19688653559584735
8440,0.3281666666666666,3,15,3,215968,389642,12433,95523,3.6092667383007893,0.19688765677656056
8441,0.3281666666666667,0,1,0,215969,389641,12433,95523,3.6092574752677016,0.19688806259326744
8442,0.3282056277056276,0,1,0,215970,389640,12433,95523,3.609248212234614,0.19688846841164723
8443,0.3282142857142857,0,2,0,215972,389638,12433,95523,3.609229686168439,0.19688928005342557
8444,0.3282222222222222,0,1,0,215973,389637,12433,95523,3.6092204231353513,0.19688968587682415
8445,0.3282380952380952,0,1,0,215974,389636,12433,95523,3.609211160102264,0.19689009170189567
8446,0.3282442002442003,0,1,0,215975,389635,12433,95523,3.6092018970691764,0.19689049752864016
8447,0.32825,0,1,0,215976,389634,12433,95523,3.6091926340360887,0.1968909033570576
8448,0.3282709235209233,0,3,0,215979,389631,12433,95523,3.609164844936826,0.19689212085234792
8449,0.3282857142857143,0,1,0,215980,389630,12433,95523,3.6091555819037384,0.19689252668745735
8450,0.3282968975468974,0,8,0,215988,389622,12433,95523,3.6090814776390383,0.1968957734285626
8451,0.3283333333333333,47,445,47,216433,389177,12480,95476,3.6049594279150767,0.19699867740424593
8452,0.3283333333333334,0,1,0,216434,389176,12480,95476,3.604950164881989,0.19699908387874185
8453,0.3283571428571429,0,1,0,216435,389175,12480,95476,3.6049409018489014,0.19699949035491518
8454,0.3283809523809523,0,2,0,216437,389173,12480,95476,3.6049223757827265,0.19700030331229404
8455,0.3284285714285714,0,1,0,216438,389172,12480,95476,3.6049131127496388,0.19700070979349962
8456,0.3284523809523809,0,5,0,216443,389167,12480,95476,3.604866797584201,0.1970027422246891
8457,0.328452380952381,0,1,0,216444,389166,12480,95476,3.6048575345511136,0.19700314871595942
8458,0.3284722222222222,0,1,0,216445,389165,12480,95476,3.604848271518026,0.19700355520890722
8459,0.3284761904761905,0,6,0,216451,389159,12480,95476,3.6047926933195007,0.197005994201822
8460,0.3284999999999999,0,6,0,216457,389153,12480,95476,3.604737115120975,0.19700843325512918
8461,0.3285,2,24,2,216481,389129,12482,95474,3.604514802326874,0.19701487609445256
8462,0.3285555555555555,0,1,0,216482,389128,12482,95474,3.604505539293786,0.1970152826443143
8463,0.3285714285714286,0,7,0,216489,389121,12482,95474,3.6044406980621733,0.1970181285403275
8464,0.3285833333333333,0,1,0,216490,389120,12482,95474,3.604431435029086,0.1970185351036125
8465,0.3286190476190476,1,2,1,216492,389118,12483,95473,3.6044129089629107,0.19701769120763696
8466,0.3286666666666666,5,27,5,216519,389091,12488,95468,3.604162807069547,0.19702038348271314
8467,0.3286666666666667,0,2,0,216521,389089,12488,95468,3.604144281003372,0.19702119668067947
8468,0.3286904761904762,0,1,0,216522,389088,12488,95468,3.6041350179702842,0.19702160328217996
8469,0.3287142857142857,0,2,0,216524,389086,12488,95468,3.604116491904109,0.19702241649021573
8470,0.32875,0,6,0,216530,389080,12488,95468,3.6040609137055837,0.1970248561546018
8471,0.3287554112554112,0,1,0,216531,389079,12488,95468,3.604051650672496,0.1970252627712069
8472,0.3287619047619047,0,1,0,216532,389078,12488,95468,3.6040423876394088,0.19702566938949037
8473,0.3287878787878787,0,1,0,216533,389077,12488,95468,3.604033124606321,0.19702607600945216
8474,0.3288095238095238,1,6,1,216539,389071,12489,95467,3.603977546407796,0.19702685857455968
8475,0.3288333333333332,2,1,2,216540,389070,12491,95465,3.603968283374708,0.19702395079818796
8476,0.3288333333333333,2,5,2,216545,389065,12493,95463,3.6039219682092702,0.19702266948452926
8477,0.3288333333333334,0,2,0,216547,389063,12493,95463,3.6039034421430953,0.1970234827439601
8478,0.3288571428571428,0,1,0,216548,389062,12493,95463,3.6038941791100076,0.19702388937619317
8479,0.3288809523809524,0,2,0,216550,389060,12493,95463,3.6038756530438327,0.19702470264569483
8480,0.3288888888888888,0,3,0,216553,389057,12493,95463,3.60384786394457,0.19702592256253612
8481,0.3288968253968254,0,1,0,216554,389056,12493,95463,3.6038386009114824,0.19702632920484026
8482,0.3289365079365079,0,1,0,216555,389055,12493,95463,3.6038293378783948,0.19702673584882296
8483,0.3289761904761905,0,2,0,216557,389053,12493,95463,3.60381081181222,0.197027549141824
8484,0.3289999999999999,5,64,5,216621,388989,12498,95458,3.6032179776946163,0.19704529081612643
8485,0.329,0,5,0,216626,388984,12498,95458,3.6031716625291788,0.19704732455072022
8486,0.329047619047619,0,8,0,216634,388976,12498,95458,3.603097558264478,0.19705057861339212
8487,0.3290555555555555,0,1,0,216635,388975,12498,95458,3.6030882952313905,0.19705098537878304
8488,0.3291428571428571,0,1,0,216636,388974,12498,95458,3.603079032198303,0.1970513921458533
8489,0.3291666666666666,6,61,6,216697,388913,12504,95452,3.6025139871799623,0.19706626201315125
8490,0.3291666666666667,8,79,8,216776,388834,12512,95444,3.6017822075660453,0.19708514530909932
8491,0.3291904761904762,0,1,0,216777,388833,12512,95444,3.601772944532958,0.1970855522768994
8492,0.3292380952380952,0,1,0,216778,388832,12512,95444,3.6017636814998704,0.19708595924638017
8493,0.3292424242424242,0,3,0,216781,388829,12512,95444,3.6017358924006078,0.19708718016490698
8494,0.3292857142857142,0,2,0,216783,388827,12512,95444,3.6017173663344324,0.19708799411899536
8495,0.3292857142857143,1,12,1,216795,388815,12513,95443,3.601606209937382,0.1970912199695204
8496,0.3293095238095238,1,0,1,216795,388815,12514,95442,3.601606209937382,0.19708956194747831
8497,0.3293333333333333,6,50,6,216845,388765,12520,95436,3.601143058283004,0.1970999646840878
8498,0.3293690476190476,0,1,0,216846,388764,12520,95436,3.6011337952499165,0.1971003717472119
8499,0.3293769841269842,0,3,0,216849,388761,12520,95436,3.601106006150654,0.19710159294667254
8500,0.3294047619047619,1,1,1,216850,388760,12521,95435,3.6010967431175662,0.1971003418044383
8501,0.3294285714285714,0,2,0,216852,388758,12521,95435,3.6010782170513913,0.19710115594401406
8502,0.3294444444444444,0,3,0,216855,388755,12521,95435,3.6010504279521287,0.19710237716598855
8503,0.3294761904761905,0,1,0,216856,388754,12521,95435,3.601041164919041,0.197102784243343
8504,0.3294999999999999,0,3,0,216859,388751,12521,95435,3.6010133758197784,0.19710400548549525
8505,0.3295,2,18,2,216877,388733,12523,95433,3.6008466412242024,0.19710801667196787
8506,0.3295000000000001,1,1,1,216878,388732,12524,95432,3.6008373781911147,0.19710676547616096
8507,0.3295238095238095,0,7,0,216885,388725,12524,95432,3.600772536959502,0.19710961526942708
8508,0.3295357142857144,0,1,0,216886,388724,12524,95432,3.6007632739264146,0.19711002238947778
8509,0.3295555555555555,0,3,0,216889,388721,12524,95432,3.600735484827152,0.19711124375972058
8510,0.3295833333333333,0,2,0,216891,388719,12524,95432,3.6007169587609766,0.19711205801495815
8511,0.3295952380952381,0,1,0,216892,388718,12524,95432,3.600707695727889,0.19711246514509967
8512,0.3296031746031746,0,1,0,216893,388717,12524,95432,3.6006984326948017,0.197112872276923
8513,0.3296190476190476,0,4,0,216897,388713,12524,95432,3.6006613805624514,0.19711450082103502
8514,0.3296190476190477,1,0,1,216897,388713,12525,95431,3.6006613805624514,0.19711284246009453
8515,0.3296428571428571,0,3,0,216900,388710,12525,95431,3.600633591463189,0.1971140638780851
8516,0.3296626984126984,0,1,0,216901,388709,12525,95431,3.600624328430101,0.19711447102077911
8517,0.3296666666666666,3,20,3,216921,388689,12528,95428,3.60043906776835,0.1971176389178649
8518,0.3296904761904762,0,1,0,216922,388688,12528,95428,3.6004298047352625,0.19711804608812764
8519,0.3297142857142857,0,3,0,216925,388685,12528,95428,3.600402015636,0.19711926760900864
8520,0.3297222222222223,0,1,0,216926,388684,12528,95428,3.6003927526029122,0.19711967478599993
8521,0.32975,0,3,0,216929,388681,12528,95428,3.6003649635036497,0.19712089632706684
8522,0.3297619047619047,1,1,1,216930,388680,12529,95427,3.600355700470562,0.19711964503715088
8523,0.3297619047619048,0,1,0,216931,388679,12529,95427,3.6003464374374747,0.19712005221996837
8524,0.3298095238095239,1,0,1,216931,388679,12530,95426,3.6003464374374747,0.1971183937368959
8525,0.3298333333333332,0,1,0,216932,388678,12530,95426,3.600337174404387,0.19711880091881084
8526,0.3298333333333333,3,23,3,216955,388655,12533,95423,3.600124124643373,0.19712319089072422
8527,0.3298571428571428,0,3,0,216958,388652,12533,95423,3.6000963355441105,0.19712441253937923
8528,0.3298809523809524,0,4,0,216962,388648,12533,95423,3.60005928341176,0.19712604142780707
8529,0.3298888888888888,0,1,0,216963,388647,12533,95423,3.600050020378673,0.19712644865412027
8530,0.3299047619047618,0,1,0,216964,388646,12533,95423,3.6000407573455853,0.19712685588211598
8531,0.3299090909090909,0,1,0,216965,388645,12533,95423,3.6000314943124976,0.1971272631117942
8532,0.3299531024531024,0,1,0,216966,388644,12533,95423,3.6000222312794103,0.19712767034315498
8533,0.3299761904761905,1,0,1,216966,388644,12534,95422,3.6000222312794103,0.19712601174220043
8534,0.329978354978355,0,1,0,216967,388643,12534,95422,3.6000129682463227,0.19712641897265862
8535,0.3299999999999999,0,2,0,216969,388641,12534,95422,3.5999944421801473,0.19712723343862265
8536,0.33,337,3806,337,220775,384835,12871,95085,3.5647393382489163,0.19812677112852142
8537,0.3300238095238095,0,1,0,220776,384834,12871,95085,3.5647300752158286,0.19812718396229365
8538,0.3300476190476191,0,2,0,220778,384832,12871,95085,3.5647115491496537,0.19812800963499938
8539,0.3300555555555555,0,2,0,220780,384830,12871,95085,3.5646930230834784,0.19812883531458697
8540,0.3300833333333333,1,2,1,220782,384828,12872,95084,3.5646744970173034,0.1981279901315241
8541,0.330095238095238,0,1,0,220783,384827,12872,95084,3.5646652339842158,0.19812840297471823
8542,0.3300952380952381,0,1,0,220784,384826,12872,95084,3.564655970951128,0.19812881581963285
8543,0.3301111111111111,0,1,0,220785,384825,12872,95084,3.564646707918041,0.19812922866626798
8544,0.3301190476190476,1,2,1,220787,384823,12873,95083,3.5646281818518655,0.1981283834750972
8545,0.3301190476190477,1,0,1,220787,384823,12874,95082,3.5646281818518655,0.19812671257853118
8546,0.3301428571428571,0,1,0,220788,384822,12874,95082,3.5646189188187782,0.198127125425085
8547,0.3301666666666666,2,10,2,220798,384812,12876,95080,3.5645262884879023,0.19812791211355887
8548,0.3301666666666667,0,2,0,220800,384810,12876,95080,3.5645077624217274,0.19812873783575402
8549,0.3301904761904762,0,3,0,220803,384807,12876,95080,3.564479973322465,0.19812997643195168
8550,0.3302142857142857,1,0,1,220803,384807,12877,95079,3.564479973322465,0.19812830547254973
8551,0.3302222222222222,0,1,0,220804,384806,12877,95079,3.564470710289377,0.19812871833876866
8552,0.3302380952380951,0,1,0,220805,384805,12877,95079,3.5644614472562894,0.19812913120670828
8553,0.3302380952380953,1,2,1,220807,384803,12878,95078,3.5644429211901145,0.19812828597089696
8554,0.3302817460317459,0,5,0,220812,384798,12878,95078,3.5643966060246766,0.19813035034050464
8555,0.3302857142857143,0,1,0,220813,384797,12878,95078,3.5643873429915893,0.19813076321958845
8556,0.3303095238095238,0,2,0,220815,384795,12878,95078,3.564368816925414,0.1981315889829184
8557,0.3303333333333333,6,31,6,220846,384764,12884,95072,3.5640816628997,0.1981343625738794
8558,0.3303571428571428,0,4,0,220850,384760,12884,95072,3.5640446107673496,0.19813601427166175
8559,0.3303769841269841,0,1,0,220851,384759,12884,95072,3.564035347734262,0.19813642720041014
8560,0.3304166666666666,0,2,0,220853,384757,12884,95072,3.564016821668087,0.1981372530630704
8561,0.3304166666666667,0,4,0,220857,384753,12884,95072,3.5639797695357367,0.19813890480904497
8562,0.3304285714285714,0,1,0,220858,384752,12884,95072,3.563970506502649,0.19813931774984161
8563,0.3304444444444444,0,1,0,220859,384751,12884,95072,3.563961243469562,0.19813973069235946
8564,0.3304761904761904,0,1,0,220860,384750,12884,95072,3.563951980436474,0.19814014363659857
8565,0.3304761904761905,0,2,0,220862,384748,12884,95072,3.563933454370299,0.19814096953024052
8566,0.3304999999999999,3,21,3,220883,384727,12887,95069,3.5637389306754605,0.19814462813362346
8567,0.3305,1,1,1,220884,384726,12888,95068,3.563729667642373,0.1981433698628995
8568,0.3305952380952381,1,1,1,220885,384725,12889,95067,3.563720404609285,0.1981421115816854
8569,0.3306190476190476,0,1,0,220886,384724,12889,95067,3.5637111415761975,0.19814252455756778
8570,0.3306666666666666,3,52,3,220938,384672,12892,95064,3.5632294638556448,0.1981589874430937
8571,0.3306666666666667,2,7,2,220945,384665,12894,95062,3.563164622624032,0.19815853600068373
8572,0.3306774891774891,0,1,0,220946,384664,12894,95062,3.5631553595909446,0.19815894906675893
8573,0.3306904761904761,0,1,0,220947,384663,12894,95062,3.563146096557857,0.19815936213455626
8574,0.3307142857142857,3,9,3,220956,384654,12897,95059,3.5630627292600687,0.1981580653432365
8575,0.3307186147186147,1,0,1,220956,384654,12898,95058,3.5630627292600687,0.1981563938363018
8576,0.3307499999999999,0,1,0,220957,384653,12898,95058,3.5630534662269815,0.19815680691082757
8577,0.33075,0,2,0,220959,384651,12898,95058,3.563034940160806,0.1981576330650457
8578,0.3307619047619047,1,0,1,220959,384651,12899,95057,3.563034940160806,0.19815596154327217
8579,0.3307738095238096,0,1,0,220960,384650,12899,95057,3.563025677127719,0.19815637462034116
8580,0.3307777777777778,0,1,0,220961,384649,12899,95057,3.563016414094631,0.1981567876991324
8581,0.3308214285714286,0,2,0,220963,384647,12899,95057,3.562997888028456,0.1981576138618815
8582,0.3308296703296702,0,1,0,220964,384646,12899,95057,3.5629886249953686,0.1981580269458394
8583,0.3308333333333333,16,158,16,221122,384488,12915,95041,3.561525065767535,0.19819656371147523
8584,0.3308809523809524,0,1,0,221123,384487,12915,95041,3.5615158027344473,0.1981969770274103
8585,0.3308888888888889,0,1,0,221124,384486,12915,95041,3.5615065397013597,0.1981973903450692
8586,0.3308891941391941,0,1,0,221125,384485,12915,95041,3.5614972766682724,0.19819780366445197
8587,0.3309047619047618,0,1,0,221126,384484,12915,95041,3.5614880136351847,0.19819821698555862
8588,0.3309404761904762,0,1,0,221127,384483,12915,95041,3.561478750602097,0.19819863030838916
8589,0.3309444444444445,0,1,0,221128,384482,12915,95041,3.5614694875690094,0.19819904363294358
8590,0.3309523809523809,1,5,1,221133,384477,12916,95040,3.561423172403572,0.19819943818467334
8591,0.330952380952381,0,4,0,221137,384473,12916,95040,3.5613861202712216,0.19820109152410884
8592,0.3309999999999999,2,6,2,221143,384467,12918,95038,3.5613305420726964,0.19820022731775477
8593,0.331,5,78,5,221221,384389,12923,95033,3.560608025491867,0.19822411153430589
8594,0.3310158730158731,1,0,1,221221,384389,12924,95032,3.560608025491867,0.1982224391505587
8595,0.3310238095238095,1,0,1,221221,384389,12925,95031,3.560608025491867,0.1982207667598348
8596,0.331047619047619,1,1,1,221222,384388,12926,95030,3.5605987624587794,0.1982195078198983
8597,0.3310555555555555,1,0,1,221222,384388,12927,95029,3.5605987624587794,0.19821783541259488
8598,0.3310714285714286,0,1,0,221223,384387,12927,95029,3.560589499425692,0.19821824886945785
8599,0.3310833333333333,0,3,0,221226,384384,12927,95029,3.560561710326429,0.1982194892503958
8600,0.3311111111111111,1,2,1,221228,384382,12928,95028,3.560543184260254,0.1982186437496089
8601,0.3311190476190477,0,1,0,221229,384381,12928,95028,3.5605339212271665,0.19821905721419497
8602,0.3311363636363636,0,3,0,221232,384378,12928,95028,3.560506132127904,0.19822029761830265
8603,0.3311428571428571,0,1,0,221233,384377,12928,95028,3.560496869094816,0.1982207110897884
8604,0.3311666666666666,1,18,1,221251,384359,12929,95027,3.5603301344992406,0.19822648137409102
8605,0.3311666666666667,0,1,0,221252,384358,12929,95027,3.560320871466153,0.1982268948757262
8606,0.3311904761904762,0,3,0,221255,384355,12929,95027,3.5602930823668903,0.19822813539098255
8607,0.33125,3,7,3,221262,384348,12932,95024,3.5602282411352775,0.1982260123661791
8608,0.3312857142857142,0,1,0,221263,384347,12932,95024,3.56021897810219,0.19822642587891215
8609,0.3312857142857143,0,1,0,221264,384346,12932,95024,3.560209715069102,0.19822683939337046
8610,0.3313015873015873,0,2,0,221266,384344,12932,95024,3.560191189002927,0.19822766642746284
8611,0.3313095238095238,0,1,0,221267,384343,12932,95024,3.5601819259698395,0.1982280799470969
8612,0.3313095238095239,0,1,0,221268,384342,12932,95024,3.560172662936752,0.19822849346845625
8613,0.3313333333333332,0,1,0,221269,384341,12932,95024,3.5601633999036646,0.1982289069915409
8614,0.3313333333333333,3,24,3,221293,384317,12935,95021,3.5599410871095634,0.1982338141353283
8615,0.3313333333333334,1,1,1,221294,384316,12936,95020,3.5599318240764757,0.19823255503446435
8616,0.3313571428571428,0,1,0,221295,384315,12936,95020,3.559922561043388,0.19823296859190337
8617,0.3313690476190477,1,0,1,221295,384315,12937,95019,3.559922561043388,0.1982312959230933
8618,0.3313809523809524,0,2,0,221297,384313,12937,95019,3.559904034977213,0.1982321230378944
8619,0.3313888888888888,0,1,0,221298,384312,12937,95019,3.5598947719441254,0.1982325365978833
8620,0.3314166666666666,0,1,0,221299,384311,12937,95019,3.5598855089110377,0.19823295015959777
8621,0.3314285714285714,1,8,1,221307,384303,12938,95018,3.5598114046463376,0.198234586008124
8622,0.3314761904761905,0,1,0,221308,384302,12938,95018,3.55980214161325,0.1982349995827422
8623,0.3314999999999999,3,30,3,221338,384272,12941,95015,3.559524250620623,0.1982423892156474
8624,0.3315000000000001,1,3,1,221341,384269,12942,95014,3.5594964615213605,0.19824195725698596
8625,0.3315277777777778,0,1,0,221342,384268,12942,95014,3.559487198488273,0.19824237087977434
8626,0.331547619047619,0,1,0,221343,384267,12942,95014,3.5594779354551855,0.19824278450428873
8627,0.3316190476190476,0,1,0,221344,384266,12942,95014,3.559468672422098,0.19824319813052912
8628,0.3316428571428571,0,1,0,221345,384265,12942,95014,3.55945940938901,0.19824361175849559
8629,0.3316666666666665,0,2,0,221347,384263,12942,95014,3.5594408833228353,0.19824443901960662
8630,0.3316666666666666,18,173,18,221520,384090,12960,94996,3.5578383785986882,0.19828590273980037
8631,0.3316666666666667,31,243,31,221763,383847,12991,94965,3.555587461558413,0.1983346282048069
8632,0.3317142857142857,1,2,1,221765,383845,12992,94964,3.5555689354922375,0.19833378236415775
8633,0.3317777777777778,0,1,0,221766,383844,12992,94964,3.55555967245915,0.198334196588194
8634,0.3317857142857142,0,1,0,221767,383843,12992,94964,3.5555504094260626,0.19833461081396053
8635,0.3317857142857143,0,1,0,221768,383842,12992,94964,3.555541146392975,0.19833502504145728
8636,0.3318160344557403,0,3,0,221771,383839,12992,94964,3.5555133572937123,0.19833626773432916
8637,0.3318333333333333,2,28,2,221799,383811,12994,94962,3.555253992367261,0.1983445181745838
8638,0.3318571428571428,0,1,0,221800,383810,12994,94962,3.555244729334173,0.19834493245219018
8639,0.3318809523809524,0,1,0,221801,383809,12994,94962,3.5552354663010854,0.19834534673152718
8640,0.3319047619047619,0,2,0,221803,383807,12994,94962,3.5552169402349105,0.19834617529539297
8641,0.331904761904762,0,1,0,221804,383806,12994,94962,3.555207677201823,0.1983465895799218
8642,0.3319166666666667,0,2,0,221806,383804,12994,94962,3.555189151135648,0.19834741815417134
8643,0.3319761904761904,0,1,0,221807,383803,12994,94962,3.5551798881025602,0.1983478324438921
8644,0.331987012987013,0,1,0,221808,383802,12994,94962,3.5551706250694726,0.19834824673534351
8645,0.3319999999999999,0,7,0,221815,383795,12994,94962,3.5551057838378597,0.19835114682396288
8646,0.332,8,96,8,221911,383699,13002,94954,3.5542165326614548,0.19837753027767505
8647,0.3320238095238095,0,3,0,221914,383696,13002,94954,3.554188743562192,0.19837877363417947
8648,0.3320476190476191,0,4,0,221918,383692,13002,94954,3.554151691429842,0.19838043146709677
8649,0.3320714285714286,1,0,1,221918,383692,13003,94953,3.554151691429842,0.1983787566985971
8650,0.3320833333333333,1,4,1,221922,383688,13004,94952,3.5541146392974916,0.19837873976266088
8651,0.3320970418470418,0,2,0,221924,383686,13004,94952,3.5540961132313162,0.19837956869283258
8652,0.3321111111111111,0,1,0,221925,383685,13004,94952,3.554086850198229,0.19837998316051622
8653,0.3321190476190476,0,1,0,221926,383684,13004,94952,3.5540775871651413,0.19838039762993173
8654,0.3321190476190477,0,1,0,221927,383683,13004,94952,3.5540683241320536,0.1983808121010791
8655,0.3321428571428571,0,5,0,221932,383678,13004,94952,3.554022008966616,0.19838288448279465
8656,0.3321666666666666,2,18,2,221950,383660,13006,94950,3.55385527437104,0.19838699567497545
8657,0.3322142857142857,0,1,0,221951,383659,13006,94950,3.5538460113379524,0.19838741018242448
8658,0.3322222222222222,0,1,0,221952,383658,13006,94950,3.5538367483048647,0.19838782469160565
8659,0.33225,0,1,0,221953,383657,13006,94950,3.5538274852717775,0.19838823920251897
8660,0.3322619047619047,0,2,0,221955,383655,13006,94950,3.553808959205602,0.1983890682295421
8661,0.3323333333333332,0,1,0,221956,383654,13006,94950,3.553799696172515,0.19838948274565193
8662,0.3323333333333333,2,32,2,221988,383622,13008,94948,3.553503279113713,0.19839939820715882
8663,0.3323333333333334,1,0,1,221988,383622,13009,94947,3.553503279113713,0.19839772321232674
8664,0.3323809523809523,0,1,0,221989,383621,13009,94947,3.5534940160806254,0.1983981377777035
8665,0.3323809523809524,2,2,2,221991,383619,13011,94945,3.5534754900144505,0.19839561688718751
8666,0.3324166666666666,0,1,0,221992,383618,13011,94945,3.553466226981363,0.19839603145249424
8667,0.3324166666666667,0,1,0,221993,383617,13011,94945,3.553456963948275,0.19839644601953352
8668,0.3324285714285714,0,2,0,221995,383615,13011,94945,3.5534384378821002,0.19839727515880975
8669,0.3324444444444445,0,1,0,221996,383614,13011,94945,3.5534291748490126,0.19839768973104674
8670,0.3324761904761905,1,3,1,221999,383611,13012,94944,3.55340138574975,0.19839725841334852
8671,0.3324862914862915,2,1,2,222000,383610,13014,94942,3.5533921227166623,0.19839432287400324
8672,0.3324920634920634,0,1,0,222001,383609,13014,94942,3.5533828596835746,0.19839473744700148
8673,0.3324999999999999,0,1,0,222002,383608,13014,94942,3.5533735966504874,0.19839515202173233
8674,0.3325,44,368,44,222370,383240,13058,94898,3.5499648004742674,0.19847408070473377
8675,0.3325238095238094,0,1,0,222371,383239,13058,94898,3.5499555374411798,0.19847449580350401
8676,0.3325476190476191,0,1,0,222372,383238,13058,94898,3.549946274408092,0.19847491090401057
8677,0.3325595238095238,0,1,0,222373,383237,13058,94898,3.549937011375005,0.19847532600625348
8678,0.3325833333333332,0,3,0,222376,383234,13058,94898,3.549909222275742,0.19847657132340024
8679,0.3325833333333333,0,1,0,222377,383233,13058,94898,3.5498999592426546,0.19847698643258857
8680,0.3326111111111111,0,2,0,222379,383231,13058,94898,3.549881433176479,0.19847781665617437
8681,0.3326190476190476,1,3,1,222382,383228,13059,94897,3.5498536440772166,0.19847738562091502
8682,0.3326428571428571,0,1,0,222383,383227,13059,94897,3.549844381044129,0.1984778007378839
8683,0.3326439393939392,3,3,3,222386,383224,13062,94894,3.5498165919448663,0.19847401687449542
8684,0.3326666666666666,6,59,6,222445,383165,13068,94888,3.5492700729927007,0.19848845211723387
8685,0.3326666666666667,0,4,0,222449,383161,13068,94888,3.5492330208603504,0.19849011293821345
8686,0.3327142857142857,0,1,0,222450,383160,13068,94888,3.5492237578272627,0.19849052814780105
8687,0.332719696969697,0,1,0,222451,383159,13068,94888,3.5492144947941755,0.1984909433591258
8688,0.3327222222222222,0,3,0,222454,383156,13068,94888,3.549186705694913,0.1984921890035227
8689,0.3327380952380953,0,2,0,222456,383154,13068,94888,3.5491681796287375,0.19849301944180636
8690,0.33275,1,1,1,222457,383153,13069,94887,3.54915891659565,0.19849175801188185
8691,0.3327777777777777,1,0,1,222457,383153,13070,94886,3.54915891659565,0.19849008135319504
8692,0.3327777777777778,0,1,0,222458,383152,13070,94886,3.5491496535625626,0.19849049657140228
8693,0.3328333333333333,0,12,0,222470,383140,13070,94886,3.549038497165512,0.19849547932539235
8694,0.3328571428571428,3,12,3,222482,383128,13073,94883,3.5489273407684614,0.19849543211348694
8695,0.3328571428571429,0,1,0,222483,383127,13073,94883,3.5489180777353737,0.1984958473672099
8696,0.3328809523809524,0,1,0,222484,383126,13073,94883,3.548908814702286,0.19849626262267028
8697,0.3328888888888888,0,2,0,222486,383124,13073,94883,3.548890288636111,0.1984970931388034
8698,0.3329166666666666,1,1,1,222487,383123,13074,94882,3.5488810256030234,0.19849583163356033
8699,0.3329166666666667,0,1,0,222488,383122,13074,94882,3.5488717625699358,0.19849624689333142
8700,0.3329285714285714,0,1,0,222489,383121,13074,94882,3.5488624995368485,0.19849666215484002
8701,0.3329999999999999,7,57,7,222546,383064,13081,94875,3.548334506650858,0.19850859628530002
8702,0.333,0,3,0,222549,383061,13081,94875,3.548306717551595,0.19850984232198454
8703,0.3330238095238095,0,1,0,222550,383060,13081,94875,3.5482974545185075,0.1985102576710222
8704,0.3330277777777778,0,4,0,222554,383056,13081,94875,3.5482604023861573,0.19851191908455404
8705,0.333047619047619,0,3,0,222557,383053,13081,94875,3.5482326132868947,0.19851316516295342
8706,0.3330555555555555,0,2,0,222559,383051,13081,94875,3.5482140872207197,0.1985139958905772
8707,0.3330833333333334,0,1,0,222560,383050,13081,94875,3.548204824187632,0.1985144112569964
8708,0.3330952380952381,0,5,0,222565,383045,13081,94875,3.548158509022194,0.19851648811516573
8709,0.3331190476190475,0,1,0,222566,383044,13081,94875,3.548149245989107,0.19851690349201434
8710,0.3331428571428572,1,0,1,222566,383044,13082,94874,3.548149245989107,0.19851522646144318
8711,0.3331666666666666,0,13,0,222579,383031,13082,94874,3.5480288265589683,0.19852062648434313
8712,0.3331666666666667,1,3,1,222582,383028,13083,94873,3.5480010374597057,0.19852019560536596
8713,0.3332142857142857,0,6,0,222588,383022,13083,94873,3.5479454592611805,0.1985226880381674
8714,0.3332222222222222,1,0,1,222588,383022,13084,94872,3.5479454592611805,0.19852101093547941
8715,0.3332499999999999,0,1,0,222589,383021,13084,94872,3.547936196228093,0.1985214263443909
8716,0.33325,0,3,0,222592,383018,13084,94872,3.5479084071288303,0.19852267258155643
8717,0.3332857142857142,0,1,0,222593,383017,13084,94872,3.5478991440957426,0.198523087997422
8718,0.3332857142857143,0,1,0,222594,383016,13084,94872,3.5478898810626553,0.19852350341502611
8719,0.3333333333333332,43,492,43,223086,382524,13127,94829,3.5433324687835785,0.19865592129933193
8720,0.3333333333333333,24,315,24,223401,382209,13151,94805,3.540414613360999,0.19874678730603296
8721,0.3333571428571429,0,1,0,223402,382208,13151,94805,3.5404053503279114,0.1987472039546092
8722,0.3333809523809523,0,3,0,223405,382205,13151,94805,3.5403775612286488,0.19874845391081947
8723,0.3334166666666667,0,2,0,223407,382203,13151,94805,3.5403590351624734,0.19874928722369437
8724,0.3334285714285714,1,1,1,223408,382202,13152,94804,3.540349772129386,0.19874802413386833
8725,0.3334523809523809,1,1,1,223409,382201,13153,94803,3.5403405090962985,0.19874676103345046
8726,0.3334761904761904,0,3,0,223412,382198,13153,94803,3.540312719997036,0.1987480110104591
8727,0.3334999999999999,0,7,0,223419,382191,13153,94803,3.540247878765423,0.19875092768462496
8728,0.3335,1,18,1,223437,382173,13154,94802,3.540081144169847,0.19875674825724618
8729,0.333547619047619,0,3,0,223440,382170,13154,94802,3.5400533550705844,0.19875799837307012
8730,0.3335606060606061,0,2,0,223442,382168,13154,94802,3.540034829004409,0.1987588317923559
8731,0.3335714285714286,1,2,1,223444,382166,13155,94801,3.540016302938234,0.1987579853532844
8732,0.3335833333333333,0,1,0,223445,382165,13155,94801,3.5400070399051464,0.19875840206639467
8733,0.3335898268398268,1,0,1,223445,382165,13156,94800,3.5400070399051464,0.19875672219135576
8734,0.3336111111111111,0,1,0,223446,382164,13156,94800,3.539997776872059,0.19875713890356506
8735,0.3336111111111112,0,1,0,223447,382163,13156,94800,3.5399885138389715,0.1987575556175217
8736,0.3336309523809524,0,2,0,223449,382161,13156,94800,3.539969987772796,0.1987583890506771
8737,0.3336428571428571,0,1,0,223450,382160,13156,94800,3.539960724739709,0.19875880576987587
8738,0.3336428571428572,0,1,0,223451,382159,13156,94800,3.5399514617066212,0.19875922249082206
8739,0.3336666666666666,2,25,2,223476,382134,13158,94798,3.5397198858794323,0.1987662811469979
8740,0.3336666666666667,0,1,0,223477,382133,13158,94798,3.5397106228463446,0.19876669790808313
8741,0.3336717302305537,0,1,0,223478,382132,13158,94798,3.5397013598132574,0.19876711467091607
8742,0.3336904761904762,0,2,0,223480,382130,13158,94798,3.539682833747082,0.198767948201825
8743,0.3337142857142857,0,2,0,223482,382128,13158,94798,3.539664307680907,0.19876878173972481
8744,0.33375,0,13,0,223495,382115,13158,94798,3.539543888250769,0.1987741999064819
8745,0.3337777777777778,0,1,0,223496,382114,13158,94798,3.5395346252176814,0.19877461670077498
8746,0.3338095238095238,0,5,0,223501,382109,13158,94798,3.5394883100522434,0.19877670069845904
8747,0.3338333333333332,0,2,0,223503,382107,13158,94798,3.5394697839860685,0.1987775343097682
8748,0.3338333333333333,1,9,1,223512,382098,13159,94797,3.5393864166882802,0.19877960557355392
8749,0.3338333333333334,1,1,1,223513,382097,13160,94796,3.539377153655193,0.19877834231158772
8750,0.3338568376068376,0,1,0,223514,382096,13160,94796,3.5393678906221053,0.19877875913204668
8751,0.3338571428571428,0,3,0,223517,382093,13160,94796,3.5393401015228427,0.198780009603912
8752,0.3338809523809524,0,1,0,223518,382092,13160,94796,3.539330838489755,0.19878042643136334
8753,0.3338888888888888,0,1,0,223519,382091,13160,94796,3.5393215754566674,0.19878084326056278
8754,0.3339047619047619,0,1,0,223520,382090,13160,94796,3.53931231242358,0.19878126009151034
8755,0.3339126984126984,0,1,0,223521,382089,13160,94796,3.5393030493904925,0.19878167692420604
8756,0.3339285714285714,0,4,0,223525,382085,13160,94796,3.539265997258142,0.1987833442724705
8757,0.333952380952381,1,0,1,223525,382085,13161,94795,3.539265997258142,0.19878166415031034
8758,0.3339999999999999,9,126,9,223651,381959,13170,94786,3.5380988550891104,0.1988190751869448
8759,0.3340000000000001,0,17,0,223668,381942,13170,94786,3.537941383526622,0.19882616502491987
8760,0.3340238095238096,0,1,0,223669,381941,13170,94786,3.5379321204935343,0.19882658208995924
8761,0.334047619047619,1,9,1,223678,381932,13171,94785,3.5378487531957465,0.19882865515599402
8762,0.334095238095238,0,2,0,223680,381930,13171,94785,3.537830227129571,0.19882948931751676
8763,0.3341031746031746,0,2,0,223682,381928,13171,94785,3.5378117010633963,0.19883032348603877
8764,0.3341428571428571,0,1,0,223683,381927,13171,94785,3.5378024380303086,0.19883074057292452
8765,0.3341666666666665,0,1,0,223684,381926,13171,94785,3.537793174997221,0.19883115766156015
8766,0.3341666666666666,6,75,6,223759,381851,13177,94779,3.5370984475156546,0.1988523592723916
8767,0.3341666666666667,3,85,3,223844,381766,13180,94776,3.5363110897032124,0.19888278472831356
8768,0.3341706349206348,0,2,0,223846,381764,13180,94776,3.5362925636370375,0.19888361942334326
8769,0.3342222222222222,0,1,0,223847,381763,13180,94776,3.53628330060395,0.19888403677348548
8770,0.3342460317460316,1,2,1,223849,381761,13181,94775,3.5362647745377744,0.1988831903570769
8771,0.3342579365079365,1,0,1,223849,381761,13182,94774,3.5362647745377744,0.1988815092280735
8772,0.3342857142857143,1,20,1,223869,381741,13183,94773,3.5360795138760235,0.19888817537365114
8773,0.3343333333333333,6,37,6,223906,381704,13189,94767,3.535736781651784,0.1988935318204046
8774,0.3343571428571428,0,1,0,223907,381703,13189,94767,3.5357275186186965,0.1988939492517892
8775,0.3343809523809524,0,1,0,223908,381702,13189,94767,3.535718255585609,0.198894366684926
8776,0.3344007936507936,1,4,1,223912,381698,13190,94766,3.5356812034532585,0.19889435508244063
8777,0.3344047619047618,0,1,0,223913,381697,13190,94766,3.5356719404201713,0.19889477252168583
8778,0.3344166666666666,0,1,0,223914,381696,13190,94766,3.5356626773870836,0.19889518996268327
8779,0.3344206349206349,0,1,0,223915,381695,13190,94766,3.535653414353996,0.19889560740543297
8780,0.3344444444444444,0,4,0,223919,381691,13190,94766,3.5356163622216457,0.19889727719395453
8781,0.3344523809523809,1,0,1,223919,381691,13191,94765,3.5356163622216457,0.19889559581577312
8782,0.3344761904761904,0,2,0,223921,381689,13191,94765,3.5355978361554707,0.19889643071524218
8783,0.3344999999999999,0,4,0,223925,381685,13191,94765,3.5355607840231205,0.19889810053520832
8784,0.3345,5,16,5,223941,381669,13196,94760,3.53541257549372,0.19889637280686104
8785,0.3345238095238095,0,6,0,223947,381663,13196,94760,3.535356997295194,0.19889887767802983
8786,0.3345555555555555,0,1,0,223948,381662,13196,94760,3.535347734262107,0.1988992951626919
8787,0.3345833333333333,0,1,0,223949,381661,13196,94760,3.5353384712290192,0.19889971264910658
8788,0.3345873015873016,0,1,0,223950,381660,13196,94760,3.5353292081959315,0.19890013013727384
8789,0.3345952380952381,0,1,0,223951,381659,13196,94760,3.5353199451628443,0.1989005476271937
8790,0.3346190476190476,0,1,0,223952,381658,13196,94760,3.5353106821297566,0.1989009651188662
8791,0.3346212121212121,0,1,0,223953,381657,13196,94760,3.535301419096669,0.19890138261229134
8792,0.3346428571428571,0,5,0,223958,381652,13196,94760,3.5352551039312314,0.19890347010570683
8793,0.3346666666666666,2,40,2,223998,381612,13198,94758,3.534884582607729,0.19891680836324704
8794,0.3346666666666668,0,1,0,223999,381611,13198,94758,3.5348753195746414,0.1989172259319981
8795,0.334702380952381,0,1,0,224000,381610,13198,94758,3.534866056541554,0.19891764350250227
8796,0.3347142857142857,0,1,0,224001,381609,13198,94758,3.5348567935084665,0.1989180610747596
8797,0.3347777777777777,0,1,0,224002,381608,13198,94758,3.534847530475379,0.19891847864877008
8798,0.3348095238095239,1,0,1,224002,381608,13199,94757,3.534847530475379,0.19891679699390175
8799,0.3348333333333332,0,1,0,224003,381607,13199,94757,3.534838267442291,0.19891721456701178
8800,0.3348333333333333,0,17,0,224020,381590,13199,94757,3.5346807958798028,0.19892431357812687
8801,0.3348333333333334,0,1,0,224021,381589,13199,94757,3.5346715328467155,0.1989247311827957
8802,0.3348571428571428,1,2,1,224023,381587,13200,94756,3.53465300678054,0.19892388467973707
8803,0.3348769841269841,0,1,0,224024,381586,13200,94756,3.5346437437474525,0.19892430228701227
8804,0.3348809523809524,0,2,0,224026,381584,13200,94756,3.5346252176812776,0.19892513750682286
8805,0.3348888888888889,0,2,0,224028,381582,13200,94756,3.5346066916151027,0.19892597273364712
8806,0.3349242424242425,0,1,0,224029,381581,13200,94756,3.534597428582015,0.1989263903496894
8807,0.334952380952381,0,1,0,224030,381580,13200,94756,3.5345881655489273,0.19892680796748513
8808,0.3349999999999999,0,4,0,224034,381576,13200,94756,3.534551113416577,0.19892847845620282
8809,0.335,133,1448,133,225482,380128,13333,94623,3.5211382415057986,0.1993107966070635
8810,0.3350000000000001,1,5,1,225487,380123,13334,94622,3.521091926340361,0.1993112091754521
8811,0.3350555555555555,0,1,0,225488,380122,13334,94622,3.5210826633072734,0.19931162900426336
8812,0.3350714285714285,0,1,0,225489,380121,13334,94622,3.5210734002741857,0.19931204883484327
8813,0.3351071428571427,0,2,0,225491,380119,13334,94622,3.5210548742080108,0.19931288850130913
8814,0.3351111111111111,0,1,0,225492,380118,13334,94622,3.521045611174923,0.1993133083371951
8815,0.3351190476190476,2,6,2,225498,380112,13336,94620,3.520990032976398,0.19931245418467683
8816,0.3351309523809524,0,2,0,225500,380110,13336,94620,3.5209715069102225,0.19931329387230637
8817,0.3351428571428571,0,1,0,225501,380109,13336,94620,3.5209622438771353,0.1993137137187743
8818,0.3351666666666666,3,23,3,225524,380086,13339,94617,3.5207491941161213,0.1993183106068426
8819,0.3352261904761904,0,1,0,225525,380085,13339,94617,3.5207399310830336,0.19931873048775864
8820,0.3352380952380951,1,0,1,225525,380085,13340,94616,3.5207399310830336,0.19931704378124335
8821,0.3352380952380953,0,1,0,225526,380084,13340,94616,3.5207306680499464,0.19931746366125974
8822,0.33525,0,3,0,225529,380081,13340,94616,3.520702878950684,0.19931872331192318
8823,0.3352777777777778,0,1,0,225530,380080,13340,94616,3.520693615917596,0.19931914319901578
8824,0.3353333333333333,3,28,3,225558,380052,13343,94613,3.5204342509911446,0.19932584032949555
8825,0.3353571428571428,0,6,0,225564,380046,13343,94613,3.5203786727926194,0.19932835993839787
8826,0.3353809523809524,0,1,0,225565,380045,13343,94613,3.5203694097595317,0.19932877987940792
8827,0.3354166666666666,0,1,0,225566,380044,13343,94613,3.520360146726444,0.1993291998221874
8828,0.3354166666666667,0,4,0,225570,380040,13343,94613,3.5203230945940938,0.19933087961100004
8829,0.3354523809523809,0,1,0,225571,380039,13343,94613,3.5203138315610065,0.19933129956262693
8830,0.3354563492063491,0,1,0,225572,380038,13343,94613,3.520304568527919,0.19933171951602335
8831,0.3354761904761905,0,2,0,225574,380036,13343,94613,3.5202860424617435,0.19933255942812478
8832,0.3354920634920634,0,1,0,225575,380035,13343,94613,3.5202767794286562,0.1993329793868298
8833,0.3354999999999999,0,24,0,225599,380011,13343,94613,3.520054466634555,0.19934305892664508
8834,0.3355128205128204,1,0,1,225599,380011,13344,94612,3.520054466634555,0.19934137199419327
8835,0.3355555555555555,0,2,0,225601,380009,13344,94612,3.5200359405683797,0.19934221199651933
8836,0.3355714285714286,0,1,0,225602,380008,13344,94612,3.520026677535292,0.1993426320003371
8837,0.3355833333333333,0,3,0,225605,380005,13344,94612,3.5199988884360294,0.19934389202240965
8838,0.3355952380952381,1,3,1,225608,380002,13345,94611,3.5199710993367668,0.19934346509682627
8839,0.3356190476190476,0,1,0,225609,380001,13345,94611,3.519961836303679,0.19934388511036383
8840,0.3356428571428572,0,1,0,225610,380000,13345,94611,3.519952573270592,0.19934430512567133
8841,0.3356666666666666,0,38,0,225648,379962,13345,94611,3.519600578013265,0.19936026701898338
8842,0.3356666666666667,0,5,0,225653,379957,13345,94611,3.519554262847827,0.19936236745840427
8843,0.3357142857142857,1,12,1,225665,379945,13346,94610,3.519443106450776,0.19936572157073468
8844,0.3357619047619047,0,3,0,225668,379942,13346,94610,3.5194153173515135,0.1993669819113606
8845,0.3357658730158729,0,2,0,225670,379940,13346,94610,3.5193967912853386,0.19936782214729745
8846,0.3358333333333332,10,83,10,225753,379857,13356,94600,3.5186279595390713,0.19938582421589313
8847,0.3358333333333334,2,59,2,225812,379798,13358,94598,3.5180814405869056,0.19940724626683193
8848,0.3358571428571429,0,1,0,225813,379797,13358,94598,3.5180721775538184,0.19940766660694148
8849,0.3358589743589744,0,1,0,225814,379796,13358,94598,3.5180629145207307,0.19940808694882314
8850,0.3358650793650793,1,2,1,225816,379794,13359,94597,3.5180443884545554,0.19940724001930896
8851,0.3358888888888889,0,1,0,225817,379793,13359,94597,3.518035125421468,0.19940766036383567
8852,0.3359166666666667,0,3,0,225820,379790,13359,94597,3.5180073363222055,0.1994089214080487
8853,0.3359285714285713,0,1,0,225821,379789,13359,94597,3.517998073289118,0.19940934175966407
8854,0.3359444444444444,0,1,0,225822,379788,13359,94597,3.51798881025603,0.19940976211305164
8855,0.3359523809523809,2,4,2,225826,379784,13361,94595,3.51795175812368,0.19940806823236273
8856,0.335952380952381,0,2,0,225828,379782,13361,94595,3.517933232057505,0.19940890894794647
8857,0.3359761904761905,0,2,0,225830,379780,13361,94595,3.5179147059913296,0.19940974967061922
8858,0.3359999999999999,0,5,0,225835,379775,13361,94595,3.517868390825892,0.1994118515083163
8859,0.336,12,149,12,225984,379626,13373,94583,3.5164881988958463,0.19945424907582943
8860,0.3360000000000001,0,1,0,225985,379625,13373,94583,3.516478935862759,0.19945466968081518
8861,0.3360555555555555,0,1,0,225986,379624,13373,94583,3.5164696728296714,0.19945509028757483
8862,0.3360678210678209,0,1,0,225987,379623,13373,94583,3.5164604097965837,0.19945551089610844
8863,0.3360714285714286,0,2,0,225989,379621,13373,94583,3.516441883730409,0.19945635211849752
8864,0.3361111111111111,0,2,0,225991,379619,13373,94583,3.5164233576642334,0.1994571933479825
8865,0.3361190476190476,0,2,0,225993,379617,13373,94583,3.5164048315980585,0.1994580345845635
8866,0.3361428571428571,0,1,0,225994,379616,13373,94583,3.516395568564971,0.19945845520551497
8867,0.3361450216450216,1,0,1,225994,379616,13374,94582,3.516395568564971,0.19945676700450024
8868,0.3361666666666666,3,13,3,226007,379603,13377,94579,3.5162751491348327,0.19945717045353895
8869,0.3361904761904762,1,7,1,226014,379596,13378,94578,3.51621030790322,0.19945842665350694
8870,0.3362103174603175,2,1,2,226015,379595,13380,94576,3.516201044870132,0.19945547070571587
8871,0.3362142857142857,0,1,0,226016,379594,13380,94576,3.5161917818370445,0.19945589134698527
8872,0.3362301587301587,0,1,0,226017,379593,13380,94576,3.5161825188039573,0.19945631199002886
8873,0.3362380952380952,0,1,0,226018,379592,13380,94576,3.5161732557708696,0.19945673263484673
8874,0.33625,2,14,2,226032,379578,13382,94574,3.516043573307644,0.19945924513658067
8875,0.3363095238095238,1,2,1,226034,379576,13383,94573,3.516025047241469,0.19945839809848803
8876,0.3363333333333332,0,4,0,226038,379572,13383,94573,3.5159879951091186,0.1994600807769775
8877,0.3363333333333333,2,25,2,226063,379547,13385,94571,3.5157564192819297,0.19946722124028196
8878,0.3363333333333334,0,7,0,226070,379540,13385,94571,3.515691578050317,0.19947016626908046
8879,0.3363636363636364,0,2,0,226072,379538,13385,94571,3.5156730519841415,0.199471007721853
8880,0.3363690476190475,0,1,0,226073,379537,13385,94571,3.5156637889510542,0.1994714284509015
8881,0.3364166666666666,0,1,0,226074,379536,13385,94571,3.5156545259179666,0.1994718491817248
8882,0.3364285714285714,0,5,0,226079,379531,13385,94571,3.5156082107525286,0.1994739528624642
8883,0.3364444444444444,0,2,0,226081,379529,13385,94571,3.5155896846863537,0.19947479434718413
8884,0.3364999999999999,1,31,1,226112,379498,13386,94570,3.5153025306606396,0.1994861496662926
8885,0.3365000000000001,0,4,0,226116,379494,13386,94570,3.5152654785282893,0.19948783286644842
8886,0.3365238095238095,0,2,0,226118,379492,13386,94570,3.5152469524621144,0.19948867447717808
8887,0.336547619047619,1,1,1,226119,379491,13387,94569,3.5152376894290267,0.19948740665738515
8888,0.3365476190476191,0,1,0,226120,379490,13387,94569,3.515228426395939,0.1994878274645139
8889,0.336560606060606,0,1,0,226121,379489,13387,94569,3.5152191633628513,0.19948824827341802
8890,0.3365714285714286,0,2,0,226123,379487,13387,94569,3.5152006372966764,0.1994890898965523
8891,0.3365833333333333,0,1,0,226124,379486,13387,94569,3.5151913742635887,0.1994895107107825
8892,0.3366666666666665,0,3,0,226127,379483,13387,94569,3.515163585164326,0.19949077316412545
8893,0.3366666666666666,49,349,49,226476,379134,13436,94520,3.51193078661677,0.1995549493934391
8894,0.3366666666666667,40,472,40,226948,378662,13476,94480,3.507558634999444,0.1996863520888021
8895,0.3366904761904761,0,1,0,226949,378661,13476,94480,3.507549371966357,0.19968677413286948
8896,0.3367142857142857,0,1,0,226950,378660,13476,94480,3.507540108933269,0.19968719617872088
8897,0.3367142857142858,0,1,0,226951,378659,13476,94480,3.5075308459001815,0.1996876182263563
8898,0.3367424242424242,0,1,0,226952,378658,13476,94480,3.507521582867094,0.19968804027577577
8899,0.33675,0,1,0,226953,378657,13476,94480,3.5075123198340066,0.1996884623269793
8900,0.3367619047619047,0,1,0,226954,378656,13476,94480,3.507503056800919,0.19968888437996685
8901,0.3367857142857142,0,1,0,226955,378655,13476,94480,3.507493793767831,0.1996893064347385
8902,0.3367857142857143,0,3,0,226958,378652,13476,94480,3.5074660046685686,0.19969057260975795
8903,0.3368095238095238,0,1,0,226959,378651,13476,94480,3.507456741635481,0.19969099467166598
8904,0.3368333333333333,1,2,1,226961,378649,13477,94479,3.507438215569306,0.199690147275156
8905,0.3368333333333334,0,17,0,226978,378632,13477,94479,3.5072807440068177,0.19969732261562298
8906,0.3368412698412698,0,1,0,226979,378631,13477,94479,3.50727148097373,0.19969774471053242
8907,0.3368571428571428,0,1,0,226980,378630,13477,94479,3.5072622179406423,0.19969816680722624
8908,0.3368690476190476,0,1,0,226981,378629,13477,94479,3.507252954907555,0.1996985889057044
8909,0.3368809523809524,0,1,0,226982,378628,13477,94479,3.5072436918744674,0.19969901100596693
8910,0.336904761904762,0,1,0,226983,378627,13477,94479,3.5072344288413797,0.19969943310801386
8911,0.3369166666666666,0,2,0,226985,378625,13477,94479,3.507215902775205,0.19970027731746084
8912,0.3369285714285714,0,1,0,226986,378624,13477,94479,3.507206639742117,0.19970069942486096
8913,0.3369444444444444,0,4,0,226990,378620,13477,94479,3.507169587609767,0.1997023878723058
8914,0.3369642857142857,0,1,0,226991,378619,13477,94479,3.5071603245766796,0.19970280998862816
8915,0.3369999999999999,0,8,0,226999,378611,13477,94479,3.507086220311979,0.19970618698344925
8916,0.337,6,46,6,227045,378565,13483,94473,3.5066601207899515,0.199715456263556
8917,0.3370238095238095,0,2,0,227047,378563,13483,94473,3.5066415947237766,0.19971630066210605
8918,0.3370833333333333,0,3,0,227050,378560,13483,94473,3.5066138056245135,0.19971756727331919
8919,0.3370952380952381,0,1,0,227051,378559,13483,94473,3.5066045425914263,0.1997179894806271
8920,0.3371363636363637,0,1,0,227052,378558,13483,94473,3.5065952795583386,0.19971841168972013
8921,0.3371428571428571,0,18,0,227070,378540,13483,94473,3.5064285449627626,0.19972601175866203
8922,0.3371428571428572,0,1,0,227071,378539,13483,94473,3.506419281929675,0.19972643400167436
8923,0.3371666666666666,0,13,0,227084,378526,13483,94473,3.506298862499537,0.1997319233233051
8924,0.3371666666666668,0,1,0,227085,378525,13483,94473,3.506289599466449,0.19973234559131328
8925,0.3371764069264069,0,4,0,227089,378521,13483,94473,3.506252547334099,0.19973403468120102
8926,0.3371825396825397,0,2,0,227091,378519,13483,94473,3.506234021267924,0.19973487923685812
8927,0.3371904761904762,0,1,0,227092,378518,13483,94473,3.5062247582348363,0.19973530151736502
8928,0.3372222222222222,0,1,0,227093,378517,13483,94473,3.506215495201749,0.1997357237996575
8929,0.3372287157287157,0,1,0,227094,378516,13483,94473,3.5062062321686613,0.19973614608373555
8930,0.33725,0,1,0,227095,378515,13483,94473,3.5061969691355737,0.19973656836959922
8931,0.3372619047619047,0,1,0,227096,378514,13483,94473,3.506187706102486,0.1997369906572485
8932,0.3373095238095238,0,1,0,227097,378513,13483,94473,3.5061784430693987,0.1997374129466834
8933,0.3373333333333332,0,2,0,227099,378511,13483,94473,3.5061599170032234,0.19973825753091012
8934,0.3373333333333333,6,52,6,227151,378459,13489,94467,3.5056782392826706,0.19975006660661498
8935,0.3373571428571428,0,1,0,227152,378458,13489,94467,3.505668976249583,0.19975048897816777
8936,0.3373809523809524,1,3,1,227155,378455,13490,94466,3.5056411871503204,0.1997500639641716
8937,0.3374444444444445,0,5,0,227160,378450,13490,94466,3.505594871984883,0.19975217586209812
8938,0.3374523809523809,0,1,0,227161,378449,13490,94466,3.505585608951795,0.19975259824704228
8939,0.3374999999999999,1,1,1,227162,378448,13491,94465,3.5055763459187075,0.1997513284684498
8940,0.3375,42,439,42,227601,378009,13533,94423,3.5015098743932715,0.199865800792495
8941,0.3375000000000001,0,1,0,227602,378008,13533,94423,3.501500611360184,0.19986622385067873
8942,0.3375119047619047,0,1,0,227603,378007,13533,94423,3.501491348327096,0.19986664691065342
8943,0.3375238095238094,1,2,1,227605,378005,13534,94422,3.5014728222609213,0.19986579937217813
8944,0.3375238095238095,0,1,0,227606,378004,13534,94422,3.5014635592278336,0.19986622243483634
8945,0.337547619047619,0,1,0,227607,378003,13534,94422,3.501454296194746,0.1998666454992856
8946,0.3375952380952381,0,1,0,227608,378002,13534,94422,3.5014450331616587,0.19986706856552588
8947,0.3376190476190476,0,4,0,227612,377998,13534,94422,3.5014079810293084,0.1998687608483976
8948,0.3376269841269841,1,0,1,227612,377998,13535,94421,3.5014079810293084,0.19986706715860286
8949,0.3376428571428571,0,2,0,227614,377996,13535,94421,3.501389454963133,0.19986791330540604
8950,0.3376428571428572,0,1,0,227615,377995,13535,94421,3.501380191930046,0.1998683363814943
8951,0.3376437728937729,0,1,0,227616,377994,13535,94421,3.501370928896958,0.19986875945937366
8952,0.3376666666666665,0,2,0,227618,377992,13535,94421,3.5013524028307828,0.1998696056205058
8953,0.3376666666666666,3,42,3,227660,377950,13538,94418,3.5009633554411055,0.19988229515970599
8954,0.3376666666666667,1,1,1,227661,377949,13539,94417,3.5009540924080182,0.19988102445984682
8955,0.3376829004329004,0,1,0,227662,377948,13539,94417,3.5009448293749306,0.19988144760936988
8956,0.3377142857142857,0,1,0,227663,377947,13539,94417,3.500935566341843,0.19988187076068456
8957,0.3377380952380953,0,2,0,227665,377945,13539,94417,3.500917040275668,0.19988271706868885
8958,0.33775,1,2,1,227667,377943,13540,94416,3.5008985142094926,0.19988186951026657
8959,0.3377738095238095,0,2,0,227669,377941,13540,94416,3.5008799881433177,0.1998827158272239
8960,0.3377777777777778,2,3,2,227672,377938,13542,94414,3.500852199044055,0.1998805975204932
8961,0.3378333333333333,0,7,0,227679,377931,13542,94414,3.500787357812442,0.19988355968624627
8962,0.3378333333333334,1,1,1,227680,377930,13543,94413,3.5007780947793545,0.19988228892986665
8963,0.3378571428571428,1,4,1,227684,377926,13544,94412,3.5007410426470043,0.19988228768381963
8964,0.3378809523809524,0,3,0,227687,377923,13544,94412,3.5007132535477417,0.19988355722104015
8965,0.3379166666666666,0,1,0,227688,377922,13544,94412,3.500703990514654,0.19988398040369737
8966,0.3379523809523809,0,1,0,227689,377921,13544,94412,3.5006947274815667,0.1998844035881465
8967,0.337952380952381,0,5,0,227694,377916,13544,94412,3.5006484123161288,0.1998865195372707
8968,0.3379999999999999,11,101,11,227795,377815,13555,94401,3.499712845974286,0.1999106341165907
8969,0.338,0,5,0,227800,377810,13555,94401,3.499666530808848,0.1999127508677265
8970,0.338047619047619,1,1,1,227801,377809,13556,94400,3.4996572677757607,0.19991147987437766
8971,0.3380555555555555,0,2,0,227803,377807,13556,94400,3.4996387417095853,0.19991232658558641
8972,0.3380833333333333,0,2,0,227805,377805,13556,94400,3.4996202156434104,0.19991317330396755
8973,0.3380952380952381,0,1,0,227806,377804,13556,94400,3.4996109526103227,0.19991359666584782
8974,0.3381428571428572,0,2,0,227808,377802,13556,94400,3.499592426544148,0.19991444339498773
8975,0.3381547619047619,0,1,0,227809,377801,13556,94400,3.49958316351106,0.19991486676224743
8976,0.3381666666666666,2,13,2,227822,377788,13558,94398,3.499462744080922,0.199916981867315
8977,0.3381666666666667,0,1,0,227823,377787,13558,94398,3.4994534810478344,0.19991740525429652
8978,0.3382142857142857,0,2,0,227825,377785,13558,94398,3.499434954981659,0.1999182520336395
8979,0.3382301587301587,0,1,0,227826,377784,13558,94398,3.499425691948572,0.199918675426001
8980,0.3382857142857142,0,3,0,227829,377781,13558,94398,3.499397902849309,0.1999199456138456
8981,0.3383333333333332,28,255,28,228084,377526,13586,94370,3.4970358294119825,0.19998050417888688
8982,0.3383333333333334,18,164,18,228248,377362,13604,94352,3.4955166919856238,0.2000195033431274
8983,0.3383571428571429,0,1,0,228249,377361,13604,94352,3.495507428952536,0.20001992737109217
8984,0.3383650793650792,0,3,0,228252,377358,13604,94352,3.4954796398532735,0.20002119946577346
8985,0.3383809523809523,0,3,0,228255,377355,13604,94352,3.495451850754011,0.2000224715766355
8986,0.3383888888888889,0,1,0,228256,377354,13604,94352,3.495442587720923,0.20002289561718528
8987,0.3383975468975469,0,2,0,228258,377352,13604,94352,3.4954240616547483,0.2000237437036786
8988,0.3384523809523809,0,1,0,228259,377351,13604,94352,3.4954147986216606,0.20002416774962212
8989,0.3384999999999999,0,4,0,228263,377347,13604,94352,3.4953777464893103,0.20002586395137578
8990,0.3385,2,25,2,228288,377322,13606,94350,3.4951461706621214,0.20003307383096727
8991,0.3385238095238095,0,2,0,228290,377320,13606,94350,3.4951276445959465,0.2000339220217525
8992,0.3385714285714285,0,1,0,228291,377319,13606,94350,3.495118381562859,0.20003434611984253
8993,0.3385714285714286,0,7,0,228298,377312,13606,94350,3.495053540331246,0.20003731485682544
8994,0.3385833333333333,0,1,0,228299,377311,13606,94350,3.4950442772981587,0.2000377389693021
8995,0.3386006493506493,0,1,0,228300,377310,13606,94350,3.495035014265071,0.20003816308357716
8996,0.3386356421356422,0,1,0,228301,377309,13606,94350,3.4950257512319833,0.2000385871996506
8997,0.3386666666666666,4,27,4,228328,377282,13610,94346,3.4947756493386195,0.20004325442933837
8998,0.3386666666666667,1,1,1,228329,377281,13611,94345,3.494766386305532,0.20004198241827212
8999,0.3386904761904762,0,13,0,228342,377268,13611,94345,3.4946459668753937,0.20004749657028115
9000,0.33875,0,10,0,228352,377258,13611,94345,3.4945533365445183,0.20005173843253754
9001,0.3387777777777778,0,1,0,228353,377257,13611,94345,3.4945440735114306,0.20005216262865722
9002,0.3387857142857142,0,2,0,228355,377255,13611,94345,3.4945255474452557,0.20005301102629347
9003,0.3387857142857143,1,0,1,228355,377255,13612,94344,3.4945255474452557,0.20005131478226204
9004,0.3388095238095238,0,1,0,228356,377254,13612,94344,3.494516284412168,0.20005173898108133
9005,0.3388095238095239,0,1,0,228357,377253,13612,94344,3.4945070213790803,0.20005216318169963
9006,0.3388333333333332,0,4,0,228361,377249,13612,94344,3.49446996924673,0.20005386000216288
9007,0.3388333333333333,0,10,0,228371,377239,13612,94344,3.4943773389158546,0.20005810217925582
9008,0.3388333333333334,0,1,0,228372,377238,13612,94344,3.494368075882767,0.2000585264068603
9009,0.3388571428571428,1,2,1,228374,377236,13613,94343,3.494349549816592,0.20005767856499124
9010,0.3388888888888888,0,1,0,228375,377235,13613,94343,3.4943402867835043,0.2000581027952958
9011,0.338905844155844,0,2,0,228377,377233,13613,94343,3.4943217607173294,0.20005895126130252
9012,0.3389166666666666,0,3,0,228380,377230,13613,94343,3.4942939716180668,0.20006022397380682
9013,0.3389285714285714,0,2,0,228382,377228,13613,94343,3.4942754455518914,0.20006107245780594
9014,0.3389523809523809,0,2,0,228384,377226,13613,94343,3.4942569194857165,0.20006192094900216
9015,0.3389880952380952,0,1,0,228385,377225,13613,94343,3.494247656452629,0.20006234519729924
9016,0.3389999999999999,9,70,9,228455,377155,13622,94334,3.4935992441365,0.20007677803723947
9017,0.3390000000000001,0,3,0,228458,377152,13622,94334,3.4935714550372374,0.20007805109801777
9018,0.3390238095238095,0,1,0,228459,377151,13622,94334,3.4935621920041497,0.20007847545521065
9019,0.3390454545454545,0,1,0,228460,377150,13622,94334,3.493552928971062,0.20007889981420365
9020,0.339047619047619,0,3,0,228463,377147,13622,94334,3.4935251398717995,0.20008017290198332
9021,0.3390476190476191,0,2,0,228465,377145,13622,94334,3.4935066138056245,0.20008102163617045
9022,0.3390555555555555,0,1,0,228466,377144,13622,94334,3.493497350772537,0.20008144600596423
9023,0.3390555555555556,0,1,0,228467,377143,13622,94334,3.493488087739449,0.20008187037755817
9024,0.3390833333333333,0,1,0,228468,377142,13622,94334,3.493478824706362,0.20008229475095232
9025,0.339090909090909,0,1,0,228469,377141,13622,94334,3.4934695616732743,0.20008271912614667
9026,0.3391428571428571,0,1,0,228470,377140,13622,94334,3.4934602986401866,0.20008314350314121
9027,0.3391666666666666,6,70,6,228540,377070,13628,94328,3.492811886324058,0.20010267332487622
9028,0.3391666666666667,11,56,11,228596,377014,13639,94317,3.492293156471155,0.20010777988292727
9029,0.3391904761904761,0,2,0,228598,377012,13639,94317,3.49227463040498,0.2001086290043685
9030,0.3391904761904762,0,1,0,228599,377011,13639,94317,3.492265367371892,0.20010905356779143
9031,0.3392142857142858,0,1,0,228600,377010,13639,94317,3.4922561043388045,0.20010947813301594
9032,0.3392460317460318,0,1,0,228601,377009,13639,94317,3.4922468413057173,0.200109902700042
9033,0.33925,0,1,0,228602,377008,13639,94317,3.4922375782726296,0.20011032726886968
9034,0.3392619047619047,0,1,0,228603,377007,13639,94317,3.492228315239542,0.20011075183949895
9035,0.3392857142857143,0,16,0,228619,376991,13639,94317,3.4920801067101412,0.20011754521459427
9036,0.3393333333333333,1,8,1,228627,376983,13640,94316,3.4920060024454407,0.20011924489549096
9037,0.3393333333333334,3,32,3,228659,376951,13643,94313,3.491709585386639,0.20012774156311536
9038,0.3393398268398268,0,1,0,228660,376950,13643,94313,3.4917003223535517,0.2001281662256532
9039,0.3393571428571428,0,1,0,228661,376949,13643,94313,3.491691059320464,0.20012859088999324
9040,0.3393611111111111,0,1,0,228662,376948,13643,94313,3.4916817962873763,0.20012901555613555
9041,0.3393748196248196,0,1,0,228663,376947,13643,94313,3.4916725332542886,0.20012944022408014
9042,0.3393809523809523,0,1,0,228664,376946,13643,94313,3.4916632702212014,0.20012986489382695
9043,0.3393809523809524,1,0,1,228664,376946,13644,94312,3.4916632702212014,0.20012816758548396
9044,0.3394047619047619,1,0,1,228664,376946,13645,94311,3.4916632702212014,0.20012647026993763
9045,0.3394444444444444,0,6,0,228670,376940,13645,94311,3.4916076920226757,0.20012901829386037
9046,0.3394444444444445,0,1,0,228671,376939,13645,94311,3.4915984289895885,0.20012944297082227
9047,0.3394523809523809,1,0,1,228671,376939,13646,94310,3.4915984289895885,0.20012774562916844
9048,0.3394761904761905,0,1,0,228672,376938,13646,94310,3.491589165956501,0.20012817030523206
9049,0.3394999999999999,0,2,0,228674,376936,13646,94310,3.491570639890326,0.20012901966276636
9050,0.3395,0,14,0,228688,376922,13646,94310,3.4914409574271,0.20013496536737743
9051,0.3395151515151515,0,1,0,228689,376921,13646,94310,3.4914316943940125,0.20013539007408257
9052,0.3395238095238095,1,5,1,228694,376916,13647,94309,3.4913853792285745,0.20013581622367235
9053,0.339547619047619,0,1,0,228695,376915,13647,94309,3.4913761161954873,0.2001362409384921
9054,0.3395833333333333,0,2,0,228697,376913,13647,94309,3.491357590129312,0.20013709037353944
9055,0.3396031746031746,0,1,0,228698,376912,13647,94309,3.4913483270962242,0.20013751509376704
9056,0.3396428571428571,0,2,0,228700,376910,13647,94309,3.4913298010300493,0.2001383645396302
9057,0.3396666666666666,0,1,0,228701,376909,13647,94309,3.4913205379969616,0.20013878926526577
9058,0.3396666666666667,1,19,1,228720,376890,13648,94308,3.4911445403682984,0.2001451619064597
9059,0.3397142857142857,1,0,1,228720,376890,13649,94307,3.4911445403682984,0.2001434644108515
9060,0.3397222222222222,0,1,0,228721,376889,13649,94307,3.4911352773352107,0.20014388916714063
9061,0.3397619047619047,0,2,0,228723,376887,13649,94307,3.4911167512690353,0.20014473868512758
9062,0.3397777777777778,1,0,1,228723,376887,13650,94306,3.4911167512690353,0.200143041174211
9063,0.3398333333333332,0,2,0,228725,376885,13650,94306,3.4910982252028604,0.20014389069400731
9064,0.3398333333333333,3,18,3,228743,376867,13653,94303,3.4909314906072844,0.2001464439586561
9065,0.3398809523809524,1,1,1,228744,376866,13654,94302,3.4909222275741967,0.20014517114914426
9066,0.3399285714285714,1,2,1,228746,376864,13655,94301,3.4909037015080218,0.20014432311398342
9067,0.3399444444444444,0,1,0,228747,376863,13655,94301,3.490894438474934,0.2001447479009432
9068,0.3399545454545454,0,1,0,228748,376862,13655,94301,3.490885175441847,0.2001451726897061
9069,0.3399642857142856,0,1,0,228749,376861,13655,94301,3.490875912408759,0.2001455974802722
9070,0.3399999999999999,3,14,3,228763,376847,13658,94298,3.4907462299455334,0.20014645172929776
9071,0.34,343,3896,343,232659,372951,14001,93955,3.4546574530364222,0.20122894115732073
9072,0.3400000000000001,1,4,1,232663,372947,14002,93954,3.454620400904072,0.2012289543179389
9073,0.3400238095238095,0,1,0,232664,372946,14002,93954,3.4546111378709843,0.20122938530734633
9074,0.340047619047619,0,1,0,232665,372945,14002,93954,3.454601874837897,0.2012298162985999
9075,0.3400714285714286,0,1,0,232666,372944,14002,93954,3.4545926118048094,0.2012302472916997
9076,0.3400833333333333,0,1,0,232667,372943,14002,93954,3.4545833487717217,0.20123067828664568
9077,0.3401190476190476,0,4,0,232671,372939,14002,93954,3.4545462966393714,0.20123240228489184
9078,0.3401666666666667,3,10,3,232681,372929,14005,93951,3.454453666308496,0.20123157984921178
9079,0.3402142857142857,0,1,0,232682,372928,14005,93951,3.4544444032754087,0.2012320108636285
9080,0.3402380952380952,1,2,1,232684,372926,14006,93950,3.4544258772092333,0.20123116202160746
9081,0.34025,0,1,0,232685,372925,14006,93950,3.4544166141761457,0.20123159303882196
9082,0.3402777777777777,0,2,0,232687,372923,14006,93950,3.4543980881099707,0.20123245507879017
9083,0.3402857142857142,0,2,0,232689,372921,14006,93950,3.454379562043796,0.20123331712614406
9084,0.3403333333333333,1,24,1,232713,372897,14007,93949,3.454157249249694,0.20124195130728334
9085,0.3403333333333334,0,5,0,232718,372892,14007,93949,3.4541109340842566,0.20124410666586698
9086,0.3403571428571428,0,7,0,232725,372885,14007,93949,3.4540460928526437,0.20124712424544913
9087,0.3404007936507936,1,1,1,232726,372884,14008,93948,3.454036829819556,0.20124584432943757
9088,0.3404166666666666,0,1,0,232727,372883,14008,93948,3.4540275667864684,0.20124627541872755
9089,0.3404166666666667,1,2,1,232729,372881,14009,93947,3.4540090407202935,0.20124542658109626
9090,0.3404285714285714,0,2,0,232731,372879,14009,93947,3.4539905146541185,0.20124628876712095
9091,0.3404444444444444,0,1,0,232732,372878,14009,93947,3.453981251621031,0.20124671986290366
9092,0.3404523809523809,0,1,0,232733,372877,14009,93947,3.453971988587943,0.2012471509605333
9093,0.3404761904761905,0,5,0,232738,372872,14009,93947,3.4539256734225057,0.20124930647638592
9094,0.3404999999999999,3,17,3,232755,372855,14012,93944,3.453768201860017,0.20125150225257551
9095,0.340547619047619,0,2,0,232757,372853,14012,93944,3.453749675793842,0.20125236451819528
9096,0.3405555555555555,0,2,0,232759,372851,14012,93944,3.453731149727667,0.20125322679120386
9097,0.3406190476190475,0,1,0,232760,372850,14012,93944,3.4537218866945794,0.20125365793047897
9098,0.3406349206349206,0,1,0,232761,372849,14012,93944,3.4537126236614917,0.20125408907160133
9099,0.3406428571428571,0,1,0,232762,372848,14012,93944,3.453703360628404,0.20125452021457094
9100,0.3406428571428572,0,2,0,232764,372846,14012,93944,3.453684834562229,0.20125538250605196
9101,0.3406666666666666,5,39,5,232803,372807,14017,93939,3.4533235762718144,0.20126364232366212
9102,0.3406666666666667,0,9,0,232812,372798,14017,93939,3.4532402089740266,0.20126752325185276
9103,0.3406746031746032,0,1,0,232813,372797,14017,93939,3.453230945940939,0.2012679544753351
9104,0.3407099567099567,0,1,0,232814,372796,14017,93939,3.4532216829078513,0.20126838570066527
9105,0.3407142857142857,3,11,3,232825,372785,14020,93936,3.453119789543888,0.2012679952262701
9106,0.3407222222222222,0,1,0,232826,372784,14020,93936,3.453110526510801,0.2012684264655468
9107,0.3407499999999999,0,1,0,232827,372783,14020,93936,3.453101263477713,0.20126885770667147
9108,0.3408095238095238,0,3,0,232830,372780,14020,93936,3.4530734743784506,0.20127015144113336
9109,0.3408333333333332,7,95,7,232925,372685,14027,93929,3.452193486235133,0.20129914661797546
9110,0.3408333333333334,3,55,3,232980,372630,14030,93926,3.4516840194153176,0.20131774106430952
9111,0.3408571428571429,0,2,0,232982,372628,14030,93926,3.451665493349142,0.2013186040629809
9112,0.3408809523809523,0,1,0,232983,372627,14030,93926,3.4516562303160545,0.2013190355650912
9113,0.3409285714285714,0,1,0,232984,372626,14030,93926,3.4516469672829673,0.20131946706905124
9114,0.3409523809523809,0,4,0,232988,372622,14030,93926,3.451609915150617,0.20132119310338914
9115,0.340952380952381,0,1,0,232989,372621,14030,93926,3.4516006521175293,0.2013216246165981
9116,0.3409761904761905,0,1,0,232990,372620,14030,93926,3.4515913890844416,0.2013220561316569
9117,0.3409999999999999,0,7,0,232997,372613,14030,93926,3.4515265478528288,0.20132507678886438
9118,0.341,6,52,6,233049,372561,14036,93920,3.451044870132276,0.20133724631871394
9119,0.3410000000000001,1,3,1,233052,372558,14037,93919,3.4510170810330134,0.2013368290398026
9120,0.3410332494303082,0,1,0,233053,372557,14037,93919,3.4510078179999257,0.20133726065220933
9121,0.3410454545454544,0,1,0,233054,372556,14037,93919,3.4509985549668385,0.20133769226646658
9122,0.3410714285714286,0,2,0,233056,372554,14037,93919,3.450980028900663,0.20133855550053273
9123,0.3410833333333333,0,2,0,233058,372552,14037,93919,3.450961502834488,0.20133941874200112
9124,0.3411111111111111,0,1,0,233059,372551,14037,93919,3.4509522398014005,0.2013398503655112
9125,0.3411428571428571,0,2,0,233061,372549,14037,93919,3.4509337137352256,0.20134071361808312
9126,0.3411666666666666,0,5,0,233066,372544,14037,93919,3.4508873985697877,0.2013428717818991
9127,0.3411666666666667,2,13,2,233079,372531,14039,93917,3.4507669791396496,0.20134505882756493
9128,0.3411818181818182,0,1,0,233080,372530,14039,93917,3.450757716106562,0.20134549048444947
9129,0.3411904761904762,0,1,0,233081,372529,14039,93917,3.450748453073474,0.20134592214318484
9130,0.3412380952380953,1,0,1,233081,372529,14040,93916,3.450748453073474,0.20134420992828736
9131,0.34125,0,6,0,233087,372523,14040,93916,3.450692874874949,0.2013467999030956
9132,0.3412777777777778,0,1,0,233088,372522,14040,93916,3.4506836118418613,0.20134723157204173
9133,0.3413095238095238,0,2,0,233090,372520,14040,93916,3.4506650857756864,0.2013480949154868
9134,0.3413333333333332,0,7,0,233097,372513,14040,93916,3.4506002445440735,0.20135111667584993
9135,0.3413333333333333,2,32,2,233129,372481,14042,93914,3.4503038274852718,0.20136150687721782
9136,0.3413333333333334,1,4,1,233133,372477,14043,93913,3.4502667753529215,0.20136152147344497
9137,0.3413809523809524,0,1,0,233134,372476,14043,93913,3.450257512319834,0.20136195321930836
9138,0.3414047619047619,0,1,0,233135,372475,14043,93913,3.4502482492867466,0.20136238496702316
9139,0.3414285714285714,1,5,1,233140,372470,14044,93912,3.4502019341213086,0.20136283132710953
9140,0.3414682539682537,0,2,0,233142,372468,14044,93912,3.4501834080551337,0.20136369484111669
9141,0.3414880952380952,0,1,0,233143,372467,14044,93912,3.450174145022046,0.20136412660089756
9142,0.3414999999999999,3,24,3,233167,372443,14047,93909,3.4499518322279448,0.20136935190585653
9143,0.3415000000000001,0,8,0,233175,372435,14047,93909,3.449877727963244,0.20137280634038393
9144,0.3415238095238095,0,1,0,233176,372434,14047,93909,3.4498684649301565,0.2013732381530333
9145,0.341547619047619,0,2,0,233178,372432,14047,93909,3.4498499388639816,0.20137410178388776
9146,0.3415476190476191,0,2,0,233180,372430,14047,93909,3.4498314127978067,0.20137496542214997
9147,0.3415833333333333,0,1,0,233181,372429,14047,93909,3.449822149764719,0.20137539724405903
9148,0.3416125541125541,0,1,0,233182,372428,14047,93909,3.4498128867316313,0.20137582906782006
9149,0.3416190476190476,0,1,0,233183,372427,14047,93909,3.4498036236985437,0.20137626089343305
9150,0.3416666666666665,0,1,0,233184,372426,14047,93909,3.4497943606654564,0.20137669272089806
9151,0.3416666666666666,15,216,15,233400,372210,14062,93894,3.4477935455185444,0.20144431285721642
9152,0.3416666666666667,24,233,24,233633,371977,14086,93870,3.4456352588091446,0.2015039272550859
9153,0.3416785714285714,0,1,0,233634,371976,14086,93870,3.445625995776057,0.20150435980989426
9154,0.3416904761904761,0,2,0,233636,371974,14086,93870,3.445607469709882,0.20150522492508222
9155,0.3417619047619047,0,1,0,233637,371973,14086,93870,3.4455982066767943,0.20150565748546184
9156,0.3417857142857143,0,5,0,233642,371968,14086,93870,3.4455518915113563,0.20150782031521688
9157,0.3418095238095238,0,1,0,233643,371967,14086,93870,3.445542628478269,0.20150825288673935
9158,0.3418333333333333,0,4,0,233647,371963,14086,93870,3.445505576345919,0.2015099831914012
9159,0.3418333333333334,3,13,3,233660,371950,14089,93867,3.4453851569157803,0.20151046440984335
9160,0.3418571428571428,0,2,0,233662,371948,14089,93867,3.4453666308496054,0.20151132960510074
9161,0.3418928571428571,0,1,0,233663,371947,14089,93867,3.4453573678165177,0.2015117622055155
9162,0.3419047619047618,0,1,0,233664,371946,14089,93867,3.4453481047834305,0.20151219480778768
9163,0.3419047619047619,2,4,2,233668,371942,14091,93865,3.44531105265108,0.2015104968366727
9164,0.3419166666666666,0,1,0,233669,371941,14091,93865,3.4453017896179925,0.2015109294427294
9165,0.3419444444444444,1,0,1,233669,371941,14092,93864,3.4453017896179925,0.20150921522954884
9166,0.3419999999999999,0,5,0,233674,371936,14092,93864,3.4452554744525545,0.2015113782739373
9167,0.342,8,87,8,233761,371849,14100,93856,3.4444495905739374,0.20153530668556274
9168,0.3420238095238095,0,1,0,233762,371848,14100,93856,3.44444032754085,0.20153573943964406
9169,0.3420259740259739,0,1,0,233763,371847,14100,93856,3.4444310645077625,0.20153617219558387
9170,0.3420476190476191,0,1,0,233764,371846,14100,93856,3.444421801474675,0.20153660495338221
9171,0.3420595238095237,0,1,0,233765,371845,14100,93856,3.444412538441587,0.20153703771303905
9172,0.3420833333333333,0,4,0,233769,371841,14100,93856,3.4443754863092373,0.2015387687702519
9173,0.3421428571428571,1,8,1,233777,371833,14101,93855,3.4443013820445367,0.20154051639724452
9174,0.3421428571428572,1,0,1,233777,371833,14102,93854,3.4443013820445367,0.20153880181323508
9175,0.3421666666666667,0,5,0,233782,371828,14102,93854,3.4442550668790988,0.20154096572339064
9176,0.3422023809523809,1,0,1,233782,371828,14103,93853,3.4442550668790988,0.20153925111825477
9177,0.3422380952380952,0,1,0,233783,371827,14103,93853,3.4442458038460115,0.20153968390310942
9178,0.34225,0,2,0,233785,371825,14103,93853,3.444227277779836,0.20154054947839495
9179,0.3422619047619047,0,1,0,233786,371824,14103,93853,3.4442180147467485,0.20154098226882583
9180,0.3422619047619048,0,1,0,233787,371823,14103,93853,3.4442087517136613,0.20154141506111545
9181,0.3422857142857143,0,1,0,233788,371822,14103,93853,3.4441994886805736,0.20154184785526386
9182,0.3423333333333332,1,5,1,233793,371817,14104,93852,3.4441531735151356,0.20154229721110917
9183,0.3423333333333333,4,37,4,233830,371780,14108,93848,3.4438104412908963,0.20155145309130895
9184,0.3423333333333334,0,1,0,233831,371779,14108,93848,3.4438011782578086,0.20155188595163082
9185,0.3423549783549783,0,1,0,233832,371778,14108,93848,3.4437919152247214,0.20155231881381194
9186,0.3423571428571428,0,2,0,233834,371776,14108,93848,3.443773389158546,0.20155318454375204
9187,0.3423809523809523,0,1,0,233835,371775,14108,93848,3.4437641261254583,0.20155361741151104
9188,0.3423809523809524,1,12,1,233847,371763,14109,93847,3.443652969728408,0.20155709714138442
9189,0.3423888888888889,0,1,0,233848,371762,14109,93847,3.4436437066953203,0.20155753003056212
9190,0.3424025974025974,0,1,0,233849,371761,14109,93847,3.4436344436622326,0.20155796292159928
9191,0.3424285714285714,0,1,0,233850,371760,14109,93847,3.4436251806291454,0.20155839581449592
9192,0.3424444444444445,0,1,0,233851,371759,14109,93847,3.4436159175960577,0.20155882870925204
9193,0.3424523809523809,0,1,0,233852,371758,14109,93847,3.44360665456297,0.20155926160586762
9194,0.3424761904761905,0,1,0,233853,371757,14109,93847,3.4435973915298828,0.20155969450434275
9195,0.3425,26,449,26,234302,371308,14135,93821,3.439438289673571,0.20170963324153085
9196,0.3425000000000001,0,5,0,234307,371303,14135,93821,3.439391974508133,0.20171180158409371
9197,0.3425238095238095,0,1,0,234308,371302,14135,93821,3.4393827114750453,0.2017122352582005
9198,0.342547619047619,0,1,0,234309,371301,14135,93821,3.439373448441958,0.2017126689341721
9199,0.3425714285714286,0,1,0,234310,371300,14135,93821,3.4393641854088703,0.20171310261200848
9200,0.3425833333333334,0,1,0,234311,371299,14135,93821,3.4393549223757827,0.20171353629170966
9201,0.3426111111111111,0,1,0,234312,371298,14135,93821,3.439345659342695,0.20171396997327565
9202,0.3426190476190476,0,2,0,234314,371296,14135,93821,3.43932713327652,0.20171483734200213
9203,0.3426428571428572,0,1,0,234315,371295,14135,93821,3.4393178702434324,0.20171527102916262
9204,0.3426666666666665,0,1,0,234316,371294,14135,93821,3.439308607210345,0.20171570471818798
9205,0.3426666666666667,9,49,9,234365,371245,14144,93812,3.438854718589055,0.20172150940637384
9206,0.3426904761904762,0,4,0,234369,371241,14144,93812,3.4388176664567047,0.20172324444740708
9207,0.3427380952380952,0,1,0,234370,371240,14144,93812,3.438808403423617,0.20172367821232895
9208,0.34275,0,2,0,234372,371238,14144,93812,3.438789877357442,0.20172454574776905
9209,0.3427857142857142,0,1,0,234373,371237,14144,93812,3.4387806143243544,0.20172497951828733
9210,0.3428095238095238,0,2,0,234375,371235,14144,93812,3.438762088258179,0.20172584706492033
9211,0.3428174603174602,0,1,0,234376,371234,14144,93812,3.438752825225092,0.20172628084103508
9212,0.3428333333333332,0,1,0,234377,371233,14144,93812,3.438743562192004,0.20172671461901537
9213,0.3428333333333333,2,11,2,234388,371222,14146,93810,3.438641668828041,0.20172805312322592
9214,0.3428333333333334,1,2,1,234390,371220,14147,93809,3.438623142761866,0.2017272041098512
9215,0.3428571428571427,1,1,1,234391,371219,14148,93808,3.4386138797287784,0.20172592129059172
9216,0.3428571428571428,1,13,1,234404,371206,14149,93807,3.4384934602986403,0.20172984411188505
9217,0.3428571428571429,0,1,0,234405,371205,14149,93807,3.4384841972655527,0.20173027792831152
9218,0.3428690476190476,0,1,0,234406,371204,14149,93807,3.438474934232465,0.20173071174660384
9219,0.3429166666666666,0,2,0,234408,371202,14149,93807,3.43845640816629,0.20173157938878603
9220,0.3429166666666667,0,3,0,234411,371199,14149,93807,3.4384286190670275,0.20173288086605334
9221,0.3429523809523809,0,2,0,234413,371197,14149,93807,3.438410093000852,0.20173374852689438
9222,0.3429761904761905,0,3,0,234416,371194,14149,93807,3.4383823039015895,0.20173505003215048
9223,0.3429999999999999,7,40,7,234456,371154,14156,93800,3.438011782578087,0.20174038722110144
9224,0.343,0,4,0,234460,371150,14156,93800,3.4379747304457373,0.2017421228089042
9225,0.3430476190476191,0,1,0,234461,371149,14156,93800,3.4379654674126496,0.20174255671052094
9226,0.3430833333333333,0,1,0,234462,371148,14156,93800,3.437956204379562,0.20174299061400414
9227,0.3431428571428572,0,4,0,234466,371144,14156,93800,3.4379191522472117,0.20174472624660175
9228,0.3431666666666666,2,18,2,234484,371126,14158,93798,3.4377524176516356,0.20174910307921295
9229,0.3431666666666667,0,3,0,234487,371123,14158,93798,3.437724628552373,0.2017504049075004
9230,0.3432142857142857,0,3,0,234490,371120,14158,93798,3.4376968394531104,0.20175170675258863
9231,0.3432222222222222,1,0,1,234490,371120,14159,93797,3.4376968394531104,0.20174998978312259
9232,0.3432857142857143,1,4,1,234494,371116,14160,93796,3.43765978732076,0.20175000860377879
9233,0.3432976190476189,0,1,0,234495,371115,14160,93796,3.437650524287673,0.2017504425578229
9234,0.343297619047619,1,0,1,234495,371115,14161,93795,3.437650524287673,0.20174872555978576
9235,0.3433015873015873,0,1,0,234496,371114,14161,93795,3.4376412612545852,0.20174915951293695
9236,0.3433333333333332,41,477,41,234973,370637,14202,93754,3.433222794471822,0.20188591079499818
9237,0.3433333333333334,29,329,29,235302,370308,14231,93725,3.4301752565860166,0.20197916958492176
9238,0.3433571428571429,0,2,0,235304,370306,14231,93725,3.4301567305198413,0.20198004012662948
9239,0.3433809523809524,0,1,0,235305,370305,14231,93725,3.430147467486754,0.2019804754002974
9240,0.3433928571428571,0,2,0,235307,370303,14231,93725,3.4301289414205787,0.20198134595326145
9241,0.3434166666666667,0,1,0,235308,370302,14231,93725,3.430119678387491,0.20198178123255758
9242,0.3434444444444444,0,1,0,235309,370301,14231,93725,3.4301104153544038,0.20198221651372983
9243,0.3434523809523809,0,4,0,235313,370297,14231,93725,3.4300733632220535,0.20198395765718005
9244,0.3434999999999999,1,2,1,235315,370295,14232,93724,3.430054837155878,0.2019831084503005
9245,0.3435,5,27,5,235342,370268,14237,93719,3.4298047352625143,0.20198626254614893
9246,0.3435555555555555,0,1,0,235343,370267,14237,93719,3.4297954722294266,0.20198669787450482
9247,0.3435714285714284,0,1,0,235344,370266,14237,93719,3.4297862091963394,0.2019871332047372
9248,0.3435714285714286,0,5,0,235349,370261,14237,93719,3.4297398940309014,0.20198930988404673
9249,0.3435833333333333,1,2,1,235351,370259,14238,93718,3.4297213679647265,0.20198846063490217
9250,0.3436111111111111,1,1,1,235352,370258,14239,93717,3.429712104931639,0.20198717603319144
9251,0.3436190476190475,0,1,0,235353,370257,14239,93717,3.429702841898551,0.2019876113747753
9252,0.3436190476190476,0,2,0,235355,370255,14239,93717,3.429684315832376,0.2019884820635728
9253,0.3436363636363636,0,1,0,235356,370254,14239,93717,3.4296750527992885,0.20198891741078645
9254,0.3436666666666666,1,8,1,235364,370246,14240,93716,3.429600948534588,0.2019906802712291
9255,0.3436666666666667,3,22,3,235386,370224,14243,93713,3.429397161806662,0.2019950984724219
9256,0.3436785714285715,0,1,0,235387,370223,14243,93713,3.4293878987735744,0.20199553386674024
9257,0.3436904761904762,0,1,0,235388,370222,14243,93713,3.4293786357404867,0.20199596926293553
9258,0.3437142857142857,1,1,1,235389,370221,14244,93712,3.4293693727073995,0.20199468457729888
9259,0.34375,0,5,0,235394,370216,14244,93712,3.4293230575419615,0.2019968615819696
9260,0.3437575757575757,1,1,1,235395,370215,14245,93711,3.429313794508874,0.20199557688079564
9261,0.3437619047619047,0,1,0,235396,370214,14245,93711,3.4293045314757866,0.2019960122864687
9262,0.3437777777777777,0,4,0,235400,370210,14245,93711,3.4292674793434363,0.2019977539279317
9263,0.3437857142857143,0,2,0,235402,370208,14245,93711,3.429248953277261,0.20199862475992578
9264,0.3438095238095238,0,6,0,235408,370202,14245,93711,3.429193375078736,0.20200123730095945
9265,0.3438333333333332,0,1,0,235409,370201,14245,93711,3.429184112045648,0.2020016727310352
9266,0.3438333333333333,3,6,3,235415,370195,14248,93708,3.429128533847123,0.2019991248170415
9267,0.3438333333333334,1,2,1,235417,370193,14249,93707,3.429110007780948,0.20199827549040741
9268,0.3438888888888888,0,5,0,235422,370188,14249,93707,3.42906369261551,0.20200045268864722
9269,0.3439166666666666,0,1,0,235423,370187,14249,93707,3.4290544295824223,0.20200088813392714
9270,0.3439285714285713,1,1,1,235424,370186,14250,93706,3.429045166549335,0.20199960335595354
9271,0.3439285714285715,0,1,0,235425,370185,14250,93706,3.4290359035162474,0.20200003880221862
9272,0.3439761904761904,0,1,0,235426,370184,14250,93706,3.4290266404831597,0.20200047425036108
9273,0.3439891774891774,0,1,0,235427,370183,14250,93706,3.429017377450072,0.2020009097003809
9274,0.344,14,139,14,235566,370044,14264,93692,3.427729815850902,0.20203736608760156
9275,0.3440000000000001,0,7,0,235573,370037,14264,93692,3.4276649746192893,0.20204041584632404
9276,0.3440238095238095,0,2,0,235575,370035,14264,93692,3.4276464485531144,0.20204128722287035
9277,0.344047619047619,0,4,0,235579,370031,14264,93692,3.427609396420764,0.20204302999851204
9278,0.3440476190476191,0,4,0,235583,370027,14264,93692,3.427572344288414,0.20204477280421979
9279,0.3440833333333334,0,4,0,235587,370023,14264,93692,3.4275352921560636,0.2020465156399944
9280,0.3440952380952381,0,1,0,235588,370022,14264,93692,3.427526029122976,0.20204695135363607
9281,0.3441071428571428,1,0,1,235588,370022,14265,93691,3.427526029122976,0.20204523056286972
9282,0.3441190476190476,0,1,0,235589,370021,14265,93691,3.4275167660898886,0.20204566627561935
9283,0.3441428571428571,0,1,0,235590,370020,14265,93691,3.427507503056801,0.20204610199024825
9284,0.3441666666666666,4,61,4,235651,369959,14269,93687,3.42694245803846,0.20206580020101542
9285,0.3441666666666667,9,83,9,235734,369876,14278,93678,3.426173626292193,0.20208648830556958
9286,0.3441904761904761,0,2,0,235736,369874,14278,93678,3.426155100226018,0.2020873602098578
9287,0.3442063492063492,0,2,0,235738,369872,14278,93678,3.426136574159843,0.20208823212166974
9288,0.3442499999999999,1,1,1,235739,369871,14279,93677,3.426127311126755,0.20208694676710934
9289,0.3442857142857142,1,0,1,235739,369871,14280,93676,3.426127311126755,0.20208522544639487
9290,0.3442857142857143,2,13,2,235752,369858,14282,93674,3.426006891696617,0.2020874502731203
9291,0.3443055555555556,0,3,0,235755,369855,14282,93674,3.4259791025973545,0.20208875820067354
9292,0.3443333333333333,0,5,0,235760,369850,14282,93674,3.4259327874319165,0.20209093811755163
9293,0.3443333333333334,7,38,7,235798,369812,14289,93667,3.4255807921745896,0.20209545632056683
9294,0.3444047619047619,1,3,1,235801,369809,14290,93666,3.425553003075327,0.20209504288257188
9295,0.3444285714285714,1,1,1,235802,369808,14291,93665,3.4255437400422393,0.2020937573494033
9296,0.3444444444444444,1,1,1,235803,369807,14292,93664,3.425534477009152,0.20209247180513992
9297,0.344469696969697,0,1,0,235804,369806,14292,93664,3.4255252139760644,0.20209290784732561
9298,0.3444761904761905,0,1,0,235805,369805,14292,93664,3.4255159509429767,0.20209334389139294
9299,0.3445,2,18,2,235823,369787,14294,93662,3.4253492163474006,0.20209774969845656
9300,0.3445238095238095,2,4,2,235827,369783,14296,93660,3.4253121642150504,0.20209605064700514
9301,0.3445357142857142,0,1,0,235828,369782,14296,93660,3.425302901181963,0.20209648672325772
9302,0.3445714285714285,1,0,1,235828,369782,14297,93659,3.425302901181963,0.20209476502942122
9303,0.3445833333333333,0,2,0,235830,369780,14297,93659,3.4252843751157878,0.20209563718202395
9304,0.3446031746031746,0,1,0,235831,369779,14297,93659,3.4252751120827005,0.2020960732611482
9305,0.3446071428571429,0,1,0,235832,369778,14297,93659,3.425265849049613,0.20209650934215437
9306,0.3446111111111111,0,1,0,235833,369777,14297,93659,3.425256586016525,0.2020969454250425
9307,0.3446190476190476,0,2,0,235835,369775,14297,93659,3.4252380599503502,0.20209781759646464
9308,0.3446428571428571,0,2,0,235837,369773,14297,93659,3.425219533884175,0.20209868977541473
9309,0.3446428571428572,0,1,0,235838,369772,14297,93659,3.4252102708510876,0.20209912586771278
9310,0.3446666666666666,0,2,0,235840,369770,14297,93659,3.4251917447849123,0.20209999805795495
9311,0.3446666666666667,3,30,3,235870,369740,14300,93656,3.424913853792286,0.2021079163393728
9312,0.3446904761904761,0,1,0,235871,369739,14300,93656,3.424904590759198,0.20210835248546058
9313,0.3447142857142857,0,1,0,235872,369738,14300,93656,3.4248953277261105,0.20210878863343074
9314,0.3447222222222222,0,2,0,235874,369736,14300,93656,3.4248768016599356,0.2021096609350183
9315,0.34475,0,1,0,235875,369735,14300,93656,3.424867538626848,0.20211009708863573
9316,0.3447619047619047,0,2,0,235877,369733,14300,93656,3.424849012560673,0.20211096940151796
9317,0.3447857142857142,1,0,1,235877,369733,14301,93655,3.424849012560673,0.20210924754201662
9318,0.3447988677988678,0,2,0,235879,369731,14301,93655,3.4248304864944976,0.20211011985687957
9319,0.3448095238095238,1,0,1,235879,369731,14302,93654,3.4248304864944976,0.20210839798439742
9320,0.3448095238095239,1,0,1,235879,369731,14303,93653,3.4248304864944976,0.20210667610448355
9321,0.3448333333333333,6,19,6,235898,369712,14309,93647,3.4246544888658343,0.2021046316139322
9322,0.3448333333333334,1,0,1,235898,369712,14310,93646,3.4246544888658343,0.20210290962927155
9323,0.3448571428571428,0,2,0,235900,369710,14310,93646,3.424635962799659,0.20210378197325599
9324,0.3448809523809524,0,1,0,235901,369709,14310,93646,3.4246266997665717,0.20210421814807222
9325,0.3449999999999999,1,3,1,235904,369706,14311,93645,3.4245989106673087,0.20210380467507355
9326,0.345,141,1439,141,237343,368267,14452,93504,3.4112694060543185,0.2024899787990151
9327,0.3450000000000001,0,8,0,237351,368259,14452,93504,3.411195301789618,0.2024934869186141
9328,0.3450238095238095,0,1,0,237352,368258,14452,93504,3.4111860387565303,0.20249392544211087
9329,0.345047619047619,0,1,0,237353,368257,14452,93504,3.411176775723443,0.202494363967507
9330,0.3450952380952381,0,1,0,237354,368256,14452,93504,3.4111675126903553,0.2024948024948025
9331,0.3451103896103895,0,1,0,237355,368255,14452,93504,3.4111582496572677,0.20249524102399738
9332,0.3451428571428572,0,2,0,237357,368253,14452,93504,3.4111397235910927,0.2024961180880853
9333,0.3451666666666667,2,13,2,237370,368240,14454,93502,3.4110193041609547,0.20249836488775116
9334,0.3452023809523809,0,1,0,237371,368239,14454,93502,3.411010041127867,0.2024988034417563
9335,0.3452063492063492,0,1,0,237372,368238,14454,93502,3.4110007780947793,0.20249924199766103
9336,0.3452142857142857,0,1,0,237373,368237,14454,93502,3.4109915150616916,0.20249968055546533
9337,0.3452380952380952,0,4,0,237377,368233,14454,93502,3.410954462929342,0.2025014348056786
9338,0.3452777777777777,0,1,0,237378,368232,14454,93502,3.410945199896254,0.20250187337298098
9339,0.3452857142857142,0,1,0,237379,368231,14454,93502,3.4109359368631664,0.20250231194218304
9340,0.3453102453102453,0,1,0,237380,368230,14454,93502,3.4109266738300787,0.20250275051328476
9341,0.3453333333333333,2,33,2,237413,368197,14456,93500,3.4106209937381897,0.2025137698533887
9342,0.3453333333333334,2,8,2,237421,368189,14458,93498,3.410546889473489,0.20251382430087916
9343,0.3453571428571428,1,4,1,237425,368185,14459,93497,3.410509837341139,0.2025138515255089
9344,0.3453809523809524,2,0,2,237425,368185,14461,93495,3.410509837341139,0.20251039681164443
9345,0.3454166666666666,2,0,2,237425,368185,14463,93493,3.410509837341139,0.20250694206784817
9346,0.3454285714285714,0,1,0,237426,368184,14463,93493,3.4105005743080516,0.20250738070122618
9347,0.3454444444444445,0,1,0,237427,368183,14463,93493,3.410491311274964,0.20250781933650439
9348,0.3454761904761904,0,1,0,237428,368182,14463,93493,3.4104820482418763,0.2025082579736828
9349,0.3454761904761905,0,1,0,237429,368181,14463,93493,3.4104727852087886,0.20250869661276139
9350,0.3455,2,11,2,237440,368170,14465,93491,3.410370891844826,0.20251006691056858
9351,0.3455238095238095,0,1,0,237441,368169,14465,93491,3.410361628811738,0.2025105055668674
9352,0.3455555555555555,0,4,0,237445,368165,14465,93491,3.410324576679388,0.20251226021106625
9353,0.3455952380952381,0,1,0,237446,368164,14465,93491,3.4103153136463003,0.20251269887686693
9354,0.3456428571428571,0,1,0,237447,368163,14465,93491,3.4103060506132126,0.202513137544568
9355,0.3456666666666665,0,2,0,237449,368161,14465,93491,3.4102875245470377,0.20251401488567145
9356,0.3456666666666666,5,35,5,237484,368126,14470,93486,3.4099633183889733,0.20252073169674964
9357,0.3456666666666667,0,1,0,237485,368125,14470,93486,3.4099540553558856,0.20252117042271522
9358,0.3457142857142857,1,15,1,237500,368110,14471,93485,3.4098151098595726,0.20252602389540614
9359,0.34575,1,1,1,237501,368109,14472,93484,3.409805846826485,0.2025247349938149
9360,0.3457857142857143,0,1,0,237502,368108,14472,93484,3.4097965837933972,0.20252517374651208
9361,0.3458095238095238,0,1,0,237503,368107,14472,93484,3.4097873207603095,0.20252561250111029
9362,0.3458214285714285,0,1,0,237504,368106,14472,93484,3.4097780577272223,0.20252605125760956
9363,0.3458333333333332,11,94,11,237598,368012,14483,93473,3.4089073326169923,0.20254829517752473
9364,0.3458333333333334,2,44,2,237642,367968,14485,93471,3.4084997591611397,0.2025641525748799
9365,0.3458690476190476,2,2,2,237644,367966,14487,93469,3.4084812330949648,0.20256157421955423
9366,0.3459047619047619,0,1,0,237645,367965,14487,93469,3.408471970061877,0.20256201320232145
9367,0.3459404761904761,0,1,0,237646,367964,14487,93469,3.4084627070287894,0.2025624521869914
9368,0.3459523809523809,0,2,0,237648,367962,14487,93469,3.4084441809626145,0.2025633301620394
9369,0.345952380952381,0,1,0,237649,367961,14487,93469,3.408434917929527,0.20256376915241747
9370,0.3459999999999999,0,10,0,237659,367951,14487,93469,3.4083422875986513,0.20256815916085127
9371,0.346,10,157,10,237816,367794,14497,93459,3.4068879914039054,0.20261982035889198
9372,0.3460000000000001,0,1,0,237817,367793,14497,93459,3.4068787283708177,0.2026202596411506
9373,0.3460396825396825,0,1,0,237818,367792,14497,93459,3.40686946533773,0.20262069892531398
9374,0.346047619047619,0,2,0,237820,367790,14497,93459,3.406850939271555,0.202621577499355
9375,0.3460476190476191,1,2,1,237822,367788,14498,93458,3.4068324132053798,0.2026207273342208
9376,0.3460714285714286,0,2,0,237824,367786,14498,93458,3.406813887139205,0.20262160591790895
9377,0.346080808080808,0,1,0,237825,367785,14498,93458,3.406804624106117,0.20262204521261026
9378,0.3461111111111111,0,1,0,237826,367784,14498,93458,3.40679536107303,0.2026224845092164
9379,0.3461190476190476,0,2,0,237828,367782,14498,93458,3.4067768350068546,0.20262336310814327
9380,0.3461428571428571,0,1,0,237829,367781,14498,93458,3.406767571973767,0.202623802410464
9381,0.3461666666666666,0,1,0,237830,367780,14498,93458,3.4067583089406797,0.2026242417146896
9382,0.3461666666666667,1,9,1,237839,367771,14499,93457,3.4066749416428914,0.20262646673662485
9383,0.3461742424242424,0,1,0,237840,367770,14499,93457,3.406665678609804,0.2026269060571042
9384,0.3461904761904762,0,4,0,237844,367766,14499,93457,3.406628626477454,0.20262866335807192
9385,0.3462020202020202,0,4,0,237848,367762,14499,93457,3.4065915743451036,0.20263042068952059
9386,0.3462301587301586,0,1,0,237849,367761,14499,93457,3.406582311312016,0.2026308600271455
9387,0.34625,0,9,0,237858,367752,14499,93457,3.406498944014228,0.2026348141515018
9388,0.3462777777777778,0,1,0,237859,367751,14499,93457,3.4064896809811405,0.20263525350817851
9389,0.3462857142857143,0,1,0,237860,367750,14499,93457,3.406480417948053,0.20263569286676048
9390,0.3463095238095238,0,1,0,237861,367749,14499,93457,3.4064711549149655,0.2026361322272477
9391,0.3463181818181818,0,1,0,237862,367748,14499,93457,3.406461891881878,0.20263657158964019
9392,0.3463333333333332,0,1,0,237863,367747,14499,93457,3.40645262884879,0.20263701095393796
9393,0.3463333333333333,1,21,1,237884,367726,14500,93456,3.4062581051539516,0.202644509109202
9394,0.3463333333333334,2,4,2,237888,367722,14502,93454,3.4062210530216013,0.20264280881919267
9395,0.3463809523809524,0,3,0,237891,367719,14502,93454,3.4061932639223387,0.20264412704126217
9396,0.3463888888888888,1,1,1,237892,367718,14503,93453,3.406184000889251,0.2026428374724343
9397,0.3464285714285713,0,8,0,237900,367710,14503,93453,3.406109896624551,0.20264635280800933
9398,0.3464285714285715,0,2,0,237902,367708,14503,93453,3.4060913705583755,0.20264723166096005
9399,0.3464404761904762,0,2,0,237904,367706,14503,93453,3.4060728444922006,0.20264811052153378
9400,0.3464642857142857,1,0,1,237904,367706,14504,93452,3.4060728444922006,0.20264638150048356
9401,0.3464761904761904,0,1,0,237905,367705,14504,93452,3.406063581459113,0.20264682093083267
9402,0.3464999999999999,0,1,0,237906,367704,14504,93452,3.4060543184260252,0.20264726036308756
9403,0.3465,1,34,1,237940,367670,14505,93451,3.4057393753010485,0.20266047306455356
9404,0.346547619047619,0,6,0,237946,367664,14505,93451,3.4056837971025233,0.20266311007015603
9405,0.3465476190476191,0,1,0,237947,367663,14505,93451,3.4056745340694357,0.20266354957776167
9406,0.3465714285714286,1,0,1,237947,367663,14506,93450,3.4056745340694357,0.20266182042145853
9407,0.3466190476190476,0,1,0,237948,367662,14506,93450,3.405665271036348,0.20266225992817363
9408,0.3466428571428571,1,2,1,237950,367660,14507,93449,3.405646744970173,0.2026614097751291
9409,0.3466666666666666,35,356,35,238306,367304,14542,93414,3.4023491051910035,0.20275743513385627
9410,0.3466666666666667,36,444,36,238750,366860,14578,93378,3.3982363185001296,0.20289067830122676
9411,0.3467142857142857,1,1,1,238751,366859,14579,93377,3.398227055467042,0.20288938718396649
9412,0.3467222222222222,0,1,0,238752,366858,14579,93377,3.3982177924339547,0.2028898280226406
9413,0.3467380952380952,0,2,0,238754,366856,14579,93377,3.3981992663677794,0.202890709705736
9414,0.3467698412698413,0,1,0,238755,366855,14579,93377,3.398190003334692,0.2028911505501573
9415,0.3467857142857143,1,1,1,238756,366854,14580,93376,3.3981807403016044,0.20288985941811702
9416,0.3468095238095238,0,1,0,238757,366853,14580,93376,3.3981714772685168,0.20289030026356444
9417,0.3468333333333333,1,3,1,238760,366850,14581,93375,3.398143688169254,0.20288989081427564
9418,0.3468333333333334,1,19,1,238779,366831,14582,93374,3.3979676905405904,0.2028965352397301
9419,0.3468452380952381,0,1,0,238780,366830,14582,93374,3.397958427507503,0.20289697612363214
9420,0.3468571428571428,1,1,1,238781,366829,14583,93373,3.3979491644744155,0.20289568493835317
9421,0.3469047619047619,0,2,0,238783,366827,14583,93373,3.3979306384082406,0.20289656671012604
9422,0.3469166666666667,0,1,0,238784,366826,14583,93373,3.397921375375153,0.20289700759888657
9423,0.3469523809523809,0,1,0,238785,366825,14583,93373,3.3979121123420652,0.20289744848956318
9424,0.3469761904761905,1,1,1,238786,366824,14584,93372,3.3979028493089776,0.20289615728950272
9425,0.3469891774891775,0,2,0,238788,366822,14584,93372,3.3978843232428027,0.20289703907482495
9426,0.347,5,48,5,238836,366774,14589,93367,3.3974396976546,0.2029095429444453
9427,0.3470238095238095,1,3,1,238839,366771,14590,93366,3.397411908555337,0.2029091335841282
9428,0.3470476190476191,0,1,0,238840,366770,14590,93366,3.39740264552225,0.20290957456056471
9429,0.3470833333333333,0,3,0,238843,366767,14590,93366,3.3973748564229873,0.20291089750137462
9430,0.347095238095238,0,1,0,238844,366766,14590,93366,3.3973655933898996,0.20291133848547807
9431,0.3471428571428571,1,23,1,238867,366743,14591,93365,3.3971525436288856,0.2029197492762569
9432,0.3471666666666666,0,2,0,238869,366741,14591,93365,3.3971340175627107,0.20292063133277985
9433,0.3471666666666667,0,10,0,238879,366731,14591,93365,3.3970413872318352,0.20292504173042147
9434,0.3472142857142857,0,2,0,238881,366729,14591,93365,3.39702286116566,0.20292592383295588
9435,0.3472222222222222,0,1,0,238882,366728,14591,93365,3.3970135981325726,0.20292636488709892
9436,0.3472380952380953,1,1,1,238883,366727,14592,93364,3.397004335099485,0.2029250735180649
9437,0.3472619047619048,0,1,0,238884,366726,14592,93364,3.3969950720663973,0.20292551457323568
9438,0.3473095238095238,0,2,0,238886,366724,14592,93364,3.3969765460002224,0.202926396689329
9439,0.3473333333333332,1,6,1,238892,366718,14593,93363,3.396920967801697,0.20292731062573763
9440,0.3473333333333333,4,50,4,238942,366668,14597,93359,3.3964578161473193,0.2029424359874529
9441,0.3473809523809524,0,5,0,238947,366663,14597,93359,3.3964115009818814,0.20294464177800192
9442,0.3474047619047619,0,1,0,238948,366662,14597,93359,3.396402237948794,0.2029450829418657
9443,0.3474285714285714,0,1,0,238949,366661,14597,93359,3.3963929749157065,0.2029455241076475
9444,0.3474523809523809,0,3,0,238952,366658,14597,93359,3.396365185816444,0.20294684761650114
9445,0.3474642857142856,0,1,0,238953,366657,14597,93359,3.396355922783356,0.20294728878995513
9446,0.3475,32,385,32,239338,366272,14629,93327,3.392789655044648,0.2030617995252383
9447,0.3475000000000001,1,5,1,239343,366267,14630,93326,3.39274333987921,0.20306227466475774
9448,0.3475238095238094,0,1,0,239344,366266,14630,93326,3.3927340768461227,0.2030627164963707
9449,0.347547619047619,0,1,0,239345,366265,14630,93326,3.392724813813035,0.20306315832990637
9450,0.3475714285714285,0,1,0,239346,366264,14630,93326,3.3927155507799474,0.2030636001653648
9451,0.3476190476190475,0,1,0,239347,366263,14630,93326,3.3927062877468597,0.20306404200274594
9452,0.3476190476190476,0,7,0,239354,366256,14630,93326,3.392641446515247,0.2030671349182518
9453,0.3476255411255411,0,1,0,239355,366255,14630,93326,3.3926321834821596,0.20306757677101533
9454,0.3476666666666667,2,57,2,239412,366198,14632,93324,3.392104190596169,0.20308929713920118
9455,0.3476904761904762,0,1,0,239413,366197,14632,93324,3.392094927563081,0.20308973909788672
9456,0.3477142857142857,0,1,0,239414,366196,14632,93324,3.3920856645299935,0.20309018105849583
9457,0.3477380952380952,0,2,0,239416,366194,14632,93324,3.3920671384638186,0.2030910649854848
9458,0.34775,0,1,0,239417,366193,14632,93324,3.392057875430731,0.20309150695186468
9459,0.3477777777777778,2,1,2,239418,366192,14634,93322,3.3920486123976437,0.203088480438028
9460,0.3478095238095238,0,1,0,239419,366191,14634,93322,3.392039349364556,0.2030889224026306
9461,0.3478333333333333,3,10,3,239429,366181,14637,93319,3.3919467190336805,0.20308813928182806
9462,0.3478333333333334,0,1,0,239430,366180,14637,93319,3.391937456000593,0.203088581259154
9463,0.3478412698412698,0,2,0,239432,366178,14637,93319,3.391918929934418,0.20308946521957705
9464,0.3478571428571428,1,5,1,239437,366173,14638,93318,3.39187261476898,0.20308994082582685
9465,0.3478571428571429,1,0,1,239437,366173,14639,93317,3.39187261476898,0.2030882064898039
9466,0.3479047619047619,0,1,0,239438,366172,14639,93317,3.3918633517358923,0.20308864847689498
9467,0.3479444444444444,0,2,0,239440,366170,14639,93317,3.3918448256697173,0.2030895324568486
9468,0.3479761904761905,0,1,0,239441,366169,14639,93317,3.3918355626366297,0.2030899744497112
9469,0.348,6,85,6,239526,366084,14645,93311,3.3910482048241875,0.20311714319920765
9470,0.3480357142857143,0,1,0,239527,366083,14645,93311,3.3910389417911,0.20311758534068794
9471,0.3480714285714286,1,0,1,239527,366083,14646,93310,3.3910389417911,0.2031158506986393
9472,0.3480833333333333,0,1,0,239528,366082,14646,93310,3.3910296787580125,0.203116292839231
9473,0.3480952380952381,0,3,0,239531,366079,14646,93310,3.39100188965875,0.2031176192725555
9474,0.3481428571428571,1,0,1,239531,366079,14647,93309,3.39100188965875,0.2031158846117008
9475,0.3481666666666666,1,15,1,239546,366064,14648,93308,3.3908629441624365,0.2031207822853809
9476,0.3481666666666667,0,6,0,239552,366058,14648,93308,3.3908073659639113,0.20312343534349517
9477,0.3481904761904761,0,1,0,239553,366057,14648,93308,3.3907981029308236,0.20312387752658562
9478,0.3481904761904762,0,1,0,239554,366056,14648,93308,3.390788839897736,0.20312431971160125
9479,0.3482142857142857,0,6,0,239560,366050,14648,93308,3.3907332616992107,0.20312697286212497
9480,0.3482857142857142,0,1,0,239561,366049,14648,93308,3.390723998666123,0.20312741506061735
9481,0.3483095238095237,0,1,0,239562,366048,14648,93308,3.390714735633036,0.20312785726103502
9482,0.3483333333333333,24,248,24,239810,365800,14672,93284,3.388417503427322,0.20319592928527241
9483,0.3483333333333334,21,183,21,239993,365617,14693,93263,3.3867223683723,0.20324049860529986
9484,0.3483730158730158,0,2,0,239995,365615,14693,93263,3.3867038423061246,0.20324138442025985
9485,0.3483888888888887,1,1,1,239996,365614,14694,93262,3.386694579273037,0.2032400910049774
9486,0.3484285714285714,0,1,0,239997,365613,14694,93262,3.3866853162399497,0.20324053391446473
9487,0.3484523809523809,0,3,0,240000,365610,14694,93262,3.386657527140687,0.20324186265450933
9488,0.348452380952381,0,1,0,240001,365609,14694,93262,3.3866482641075994,0.2032423055717184
9489,0.3484761904761905,0,1,0,240002,365608,14694,93262,3.3866390010745118,0.20324274849085797
9490,0.3484999999999999,0,3,0,240005,365605,14694,93262,3.386611211975249,0.2032440772598596
9491,0.3485,1,27,1,240032,365578,14695,93261,3.3863611100818853,0.20325430052807195
9492,0.3485000000000001,0,1,0,240033,365577,14695,93261,3.3863518470487977,0.20325474350424333
9493,0.3485238095238094,1,0,1,240033,365577,14696,93260,3.3863518470487977,0.20325300705915172
9494,0.3485238095238095,0,1,0,240034,365576,14696,93260,3.38634258401571,0.20325345003443496
9495,0.3485515873015872,2,2,2,240036,365574,14698,93258,3.386324057949535,0.20325086306098963
9496,0.3485714285714286,0,6,0,240042,365568,14698,93258,3.38626847975101,0.20325352094257954
9497,0.3485833333333333,0,2,0,240044,365566,14698,93258,3.3862499536848345,0.203254406918557
9498,0.3486666666666666,0,9,0,240053,365557,14698,93258,3.3861665863870467,0.20325839390604056
9499,0.3486666666666667,6,28,6,240081,365529,14704,93252,3.385907221460595,0.20326037913514292
9500,0.3486904761904762,0,2,0,240083,365527,14704,93252,3.38588869539442,0.2032612652279202
9501,0.3487142857142856,0,1,0,240084,365526,14704,93252,3.3858794323613326,0.20326170827720597
9502,0.3487222222222222,0,1,0,240085,365525,14704,93252,3.385870169328245,0.20326215132842318
9503,0.3487499999999999,0,3,0,240088,365522,14704,93252,3.3858423802289823,0.20326348049366355
9504,0.34875,0,9,0,240097,365513,14704,93252,3.385759012931194,0.20326746809368632
9505,0.3487698412698413,0,1,0,240098,365512,14704,93252,3.385749749898107,0.20326791117001333
9506,0.3487936507936507,0,1,0,240099,365511,14704,93252,3.385740486865019,0.20326835424827197
9507,0.3488095238095238,0,4,0,240103,365507,14704,93252,3.385703434732669,0.20327012658062293
9508,0.3488333333333333,2,6,2,240109,365501,14706,93250,3.3856478565341437,0.20326931167452497
9509,0.3488333333333334,0,2,0,240111,365499,14706,93250,3.3856293304679683,0.20327019786419154
9510,0.3488888888888888,0,5,0,240116,365494,14706,93250,3.385583015302531,0.203272413372164
9511,0.3489285714285713,0,3,0,240119,365491,14706,93250,3.385555226203268,0.20327374270012927
9512,0.3489302503052503,0,1,0,240120,365490,14706,93250,3.3855459631701805,0.20327418581331475
9513,0.3489642857142857,0,1,0,240121,365489,14706,93250,3.385536700137093,0.20327462892843207
9514,0.3489999999999999,0,2,0,240123,365487,14706,93250,3.385518174070918,0.20327551516446243
9515,0.349,6,79,6,240202,365408,14712,93244,3.384786394457001,0.20330010552663022
9516,0.3490476190476191,0,2,0,240204,365406,14712,93244,3.384767868390826,0.203300992041862
9517,0.3490714285714284,0,1,0,240205,365405,14712,93244,3.3847586053577383,0.2033014353023772
9518,0.3490714285714285,1,3,1,240208,365402,14713,93243,3.3847308162584757,0.20330102802821354
9519,0.3490714285714286,0,1,0,240209,365401,14713,93243,3.384721553225388,0.2033014712936395
9520,0.3491666666666666,6,55,6,240264,365346,14719,93237,3.3842120864055727,0.20331543035829938
9521,0.3491666666666667,8,82,8,240346,365264,14727,93229,3.383452517692393,0.20333789174534836
9522,0.3491904761904761,0,1,0,240347,365263,14727,93229,3.383443254659306,0.20333833523812847
9523,0.3491987179487179,0,1,0,240348,365262,14727,93229,3.383433991626218,0.20333877873284317
9524,0.3492222222222221,0,1,0,240349,365261,14727,93229,3.3834247285931305,0.20333922222949247
9525,0.3492222222222222,0,1,0,240350,365260,14727,93229,3.383415465560043,0.20333966572807635
9526,0.3492261904761905,1,0,1,240350,365260,14728,93228,3.383415465560043,0.20333792814642912
9527,0.3492272727272727,0,1,0,240351,365259,14728,93228,3.3834062025269556,0.20333837164412513
9528,0.3492499999999999,0,1,0,240352,365258,14728,93228,3.383396939493868,0.20333881514375576
9529,0.3492619047619048,0,2,0,240354,365256,14728,93228,3.383378413427693,0.20333970214882088
9530,0.3492857142857143,0,9,0,240363,365247,14728,93228,3.3832950461299047,0.20334369376738098
9531,0.3493333333333333,0,8,0,240371,365239,14728,93228,3.383220941865204,0.20334724200433182
9532,0.3493333333333334,5,42,5,240413,365197,14733,93223,3.382831894475527,0.20335718336896297
9533,0.349345238095238,0,1,0,240414,365196,14733,93223,3.3828226314424397,0.20335762697444915
9534,0.3493809523809524,0,2,0,240416,365194,14733,93223,3.3828041053762643,0.20335851419122764
9535,0.3493888888888889,0,2,0,240418,365192,14733,93223,3.3827855793100894,0.20335940141574774
9536,0.3494047619047619,0,1,0,240419,365191,14733,93223,3.3827763162770017,0.20335984503091092
9537,0.3494166666666666,0,1,0,240420,365190,14733,93223,3.382767053243914,0.20336028864800954
9538,0.3495,2,23,2,240443,365167,14735,93221,3.3825540034829005,0.2033670165885669
9539,0.3495238095238095,1,11,1,240454,365156,14736,93220,3.3824521101189373,0.203370158996108
9540,0.349547619047619,0,2,0,240456,365154,14736,93220,3.3824335840527624,0.2033710463507965
9541,0.3495714285714285,0,1,0,240457,365153,14736,93220,3.3824243210196747,0.2033714900310446
9542,0.3495833333333333,0,4,0,240461,365149,14736,93220,3.3823872688873244,0.20337326477139597
9543,0.3496190476190476,0,1,0,240462,365148,14736,93220,3.3823780058542368,0.20337370846132366
9544,0.3496363636363637,0,1,0,240463,365147,14736,93220,3.3823687428211495,0.2033741521531873
9545,0.3496428571428571,0,4,0,240467,365143,14736,93220,3.3823316906887992,0.2033759269400017
9546,0.3496666666666666,0,1,0,240468,365142,14736,93220,3.3823224276557116,0.20337637064154532
9547,0.3496666666666667,4,19,4,240487,365123,14740,93216,3.382146430027048,0.20337784914659238
9548,0.3496785714285715,0,4,0,240491,365119,14740,93216,3.382109377894698,0.20337962407409427
9549,0.3496948051948052,0,1,0,240492,365118,14740,93216,3.3821001148616103,0.20338006781081044
9550,0.3497413793103448,0,1,0,240493,365117,14740,93216,3.3820908518285226,0.20338051154946293
9551,0.3497499999999999,0,1,0,240494,365116,14740,93216,3.382081588795435,0.20338095529005176
9552,0.34975,0,1,0,240495,365115,14740,93216,3.3820723257623477,0.2033813990325769
9553,0.3497619047619047,0,2,0,240497,365113,14740,93216,3.3820537996961724,0.20338228652343623
9554,0.3497619047619048,0,1,0,240498,365112,14740,93216,3.382044536663085,0.20338273027177042
9555,0.3498015873015874,1,0,1,240498,365112,14741,93215,3.382044536663085,0.20338099217371003
9556,0.3498333333333333,1,19,1,240517,365093,14742,93214,3.3818685390344214,0.20338768554702416
9557,0.3498809523809523,0,1,0,240518,365092,14742,93214,3.3818592760013337,0.20338812932843994
9558,0.3498809523809524,0,5,0,240523,365087,14742,93214,3.381812960835896,0.20339034826456848
9559,0.3499128926628926,0,1,0,240524,365086,14742,93214,3.3818036978028085,0.20339079205760419
9560,0.3499285714285715,0,1,0,240525,365085,14742,93214,3.381794434769721,0.2033912358525766
9561,0.3499523809523809,0,4,0,240529,365081,14742,93214,3.3817573826373706,0.20339301105183344
9562,0.349952380952381,0,1,0,240530,365080,14742,93214,3.3817481196042833,0.2033934548564895
9563,0.3499999999999999,0,6,0,240536,365074,14742,93214,3.3816925414057577,0.20339611772509864
9564,0.35,352,3688,352,244224,361386,15094,92862,3.347530475378858,0.20443017910920908
9565,0.3500000000000001,2,11,2,244235,361375,15096,92860,3.347428582014895,0.20443162680110516
9566,0.3500238095238095,0,1,0,244236,361374,15096,92860,3.3474193189818076,0.20443207685906384
9567,0.3500357142857143,0,4,0,244240,361370,15096,92860,3.3473822668494573,0.20443387711071484
9568,0.3500833333333333,0,2,0,244242,361368,15096,92860,3.347363740783282,0.20443477724843032
9569,0.3500880230880231,0,4,0,244246,361364,15096,92860,3.347326688650932,0.2044365775476417
9570,0.350095238095238,0,1,0,244247,361363,15096,92860,3.3473174256178444,0.20443702762739888
9571,0.3501190476190476,0,6,0,244253,361357,15096,92860,3.347261847419319,0.20443972814755942
9572,0.3501666666666667,0,13,0,244266,361344,15096,92860,3.3471414279891807,0.20444557951933492
9573,0.3501904761904761,0,2,0,244268,361342,15096,92860,3.3471229019230058,0.20444647976010674
9574,0.3501984126984125,0,4,0,244272,361338,15096,92860,3.3470858497906555,0.2044482802654349
9575,0.3502380952380952,0,3,0,244275,361335,15096,92860,3.347058060691393,0.2044496306652429
9576,0.35025,0,1,0,244276,361334,15096,92860,3.347048797658305,0.20445008080247648
9577,0.3502619047619047,0,1,0,244277,361333,15096,92860,3.3470395346252175,0.2044505309416922
9578,0.3502777777777778,0,2,0,244279,361331,15096,92860,3.3470210085590426,0.2044514312260701
9579,0.3502857142857142,0,1,0,244280,361330,15096,92860,3.347011745525955,0.2044518813712323
9580,0.3503095238095238,0,1,0,244281,361329,15096,92860,3.3470024824928672,0.20445233151837672
9581,0.3503333333333333,3,34,3,244315,361295,15099,92857,3.3466875393678905,0.20446238263841182
9582,0.3503333333333334,0,11,0,244326,361284,15099,92857,3.3465856460039274,0.2044673350347139
9583,0.3503571428571428,0,2,0,244328,361282,15099,92857,3.3465671199377525,0.20446823549618068
9584,0.3503571428571429,0,1,0,244329,361281,15099,92857,3.346557856904665,0.20446868572988827
9585,0.3504166666666666,0,1,0,244330,361280,15099,92857,3.346548593871577,0.20446913596557867
9586,0.3504166666666667,1,3,1,244333,361277,15100,92856,3.3465208047723145,0.20446873493007556
9587,0.3504285714285714,0,2,0,244335,361275,15100,92856,3.3465022787061396,0.2044696354135701
9588,0.3504523809523809,0,1,0,244336,361274,15100,92856,3.346493015673052,0.20447008565829167
9589,0.3504761904761904,0,1,0,244337,361273,15100,92856,3.3464837526399642,0.20447053590499617
9590,0.3504761904761905,0,7,0,244344,361266,15100,92856,3.3464189114083513,0.20447368768744964
9591,0.3504999999999999,0,1,0,244345,361265,15100,92856,3.346409648375264,0.20447413795001773
9592,0.3505,3,23,3,244368,361242,15103,92853,3.34619659861425,0.20447923892577544
9593,0.3505238095238095,1,2,1,244370,361240,15104,92852,3.346178072548075,0.20447838763950918
9594,0.350547619047619,1,0,1,244370,361240,15105,92851,3.346178072548075,0.20447663574041328
9595,0.3505555555555555,1,0,1,244370,361240,15106,92850,3.346178072548075,0.20447488383360127
9596,0.3505793650793651,0,1,0,244371,361239,15106,92850,3.3461688095149875,0.20447533413053387
9597,0.3505952380952381,0,2,0,244373,361237,15106,92850,3.3461502834488126,0.20447623473034904
9598,0.3506428571428571,0,1,0,244374,361236,15106,92850,3.346141020415725,0.2044766850332316
9599,0.3506666666666666,5,40,5,244414,361196,15111,92845,3.3457704990922226,0.20448593849454125
9600,0.3506666666666667,1,9,1,244423,361187,15112,92844,3.3456871317944348,0.20448823978979408
9601,0.3506904761904762,0,1,0,244424,361186,15112,92844,3.345677868761347,0.20448869017465807
9602,0.3507142857142857,2,9,2,244433,361177,15114,92842,3.3455945014635593,0.20448923943711605
9603,0.3507619047619048,0,1,0,244434,361176,15114,92842,3.3455852384304716,0.2044896898360858
9604,0.3507777777777778,0,1,0,244435,361175,15114,92842,3.345575975397384,0.20449014023703957
9605,0.3508333333333333,18,140,18,244575,361035,15132,92824,3.3442791507651264,0.2045216686239559
9606,0.3508571428571428,0,2,0,244577,361033,15132,92824,3.3442606246989515,0.20452256988434683
9607,0.3509285714285714,0,1,0,244578,361032,15132,92824,3.344251361665864,0.20452302051752097
9608,0.3509523809523809,1,9,1,244587,361023,15133,92823,3.344167994368076,0.2045253235679063
9609,0.3509642857142857,0,1,0,244588,361022,15133,92823,3.3441587313349883,0.20452577421807006
9610,0.3509999999999999,1,8,1,244596,361014,15134,92822,3.3440846270702878,0.20452762671978425
9611,0.351,6,84,6,244680,360930,15140,92816,3.343306532290933,0.2045549712834934
9612,0.3510238095238094,1,0,1,244680,360930,15141,92815,3.343306532290933,0.20455321821728062
9613,0.3510714285714285,0,1,0,244681,360929,15141,92815,3.343297269257846,0.20455366902923233
9614,0.3510714285714286,0,1,0,244682,360928,15141,92815,3.3432880062247583,0.20455411984317112
9615,0.3511111111111111,0,2,0,244684,360926,15141,92815,3.343269480158583,0.20455502147701002
9616,0.3511190476190476,1,4,1,244688,360922,15142,92814,3.343232428026233,0.20455507167163284
9617,0.3511280663780664,0,1,0,244689,360921,15142,92814,3.3432231649931454,0.20455552249661146
9618,0.3511666666666666,0,1,0,244690,360920,15142,92814,3.3432139019600577,0.20455597332357725
9619,0.3511666666666667,1,9,1,244699,360911,15143,92813,3.34313053466227,0.20455827771949467
9620,0.3511904761904762,0,4,0,244703,360907,15143,92813,3.3430934825299197,0.20456008110729085
9621,0.3512142857142857,0,1,0,244704,360906,15143,92813,3.343084219496832,0.20456053195920823
9622,0.3512222222222222,0,1,0,244705,360905,15143,92813,3.3430749564637443,0.204560982813113
9623,0.35125,4,9,4,244714,360896,15147,92809,3.3429915891659565,0.20455802779338997
9624,0.3512692307692308,0,1,0,244715,360895,15147,92809,3.342982326132869,0.2045584786556874
9625,0.3512857142857142,0,1,0,244716,360894,15147,92809,3.3429730630997816,0.20455892951997232
9626,0.3512857142857143,0,2,0,244718,360892,15147,92809,3.3429545370336062,0.2045598312545046
9627,0.3513095238095238,0,3,0,244721,360889,15147,92809,3.3429267479343436,0.20456118387120947
9628,0.3513333333333333,1,28,1,244749,360861,15148,92808,3.342667383007892,0.20457205583806695
9629,0.3513333333333334,2,8,2,244757,360853,15150,92806,3.3425932787431916,0.20457215661984002
9630,0.3513809523809524,0,1,0,244758,360852,15150,92806,3.3425840157101043,0.2045726075589982
9631,0.3513888888888889,0,1,0,244759,360851,15150,92806,3.3425747526770166,0.20457305850014437
9632,0.3514166666666666,1,4,1,244763,360847,15151,92805,3.3425377005446664,0.20457310890285946
9633,0.3514285714285713,0,5,0,244768,360842,15151,92805,3.3424913853792284,0.2045753636638179
9634,0.3514285714285715,0,2,0,244770,360840,15151,92805,3.3424728593130535,0.20457626558211817
9635,0.3514307359307359,0,1,0,244771,360839,15151,92805,3.342463596279966,0.20457671654425055
9636,0.3514347319347319,0,2,0,244773,360837,15151,92805,3.342445070213791,0.2045776184744799
9637,0.3514603174603175,0,1,0,244774,360836,15151,92805,3.342435807180703,0.20457806944257684
9638,0.3514999999999999,1,2,1,244776,360834,15152,92804,3.3424172811145283,0.2045772179579312
9639,0.3515,5,24,5,244800,360810,15157,92799,3.342194968320427,0.2045792742207496
9640,0.3515151515151515,0,1,0,244801,360809,15157,92799,3.3421857052873394,0.20457972522530468
9641,0.3515238095238095,0,2,0,244803,360807,15157,92799,3.342167179221164,0.20458062724038042
9642,0.351547619047619,0,3,0,244806,360804,15157,92799,3.3421393901219014,0.20458198027790822
9643,0.3515833333333333,0,1,0,244807,360803,15157,92799,3.3421301270888137,0.20458243129439466
9644,0.3516190476190476,0,1,0,244808,360802,15157,92799,3.3421208640557265,0.20458288231286967
9645,0.3516428571428571,0,1,0,244809,360801,15157,92799,3.342111601022639,0.20458333333333334
9646,0.3516666666666666,21,219,21,245028,360582,15178,92778,3.3400829967764647,0.20464531498147168
9647,0.3516666666666667,25,239,25,245267,360343,15203,92753,3.337869131868539,0.20470937726221375
9648,0.3516666666666668,0,1,0,245268,360342,15203,92753,3.3378598688354515,0.20470982906454496
9649,0.3516904761904761,0,2,0,245270,360340,15203,92753,3.3378413427692766,0.2047107326751903
9650,0.3517142857142857,1,0,1,245270,360340,15204,92752,3.3378413427692766,0.20470897742621808
9651,0.35175,0,1,0,245271,360339,15204,92752,3.337832079736189,0.20470942923165544
9652,0.3517575757575757,0,1,0,245272,360338,15204,92752,3.337822816703101,0.20470988103908716
9653,0.3517857142857143,2,1,2,245273,360337,15206,92750,3.3378135536700135,0.20470682231006407
9654,0.3518333333333333,1,9,1,245282,360328,15207,92749,3.3377301863722257,0.20470913332612337
9655,0.3518333333333334,3,8,3,245290,360320,15210,92746,3.337656082107525,0.2047074819121276
9656,0.3518492063492063,0,1,0,245291,360319,15210,92746,3.337646819074438,0.2047079337401918
9657,0.3518571428571428,0,3,0,245294,360316,15210,92746,3.337619029975175,0.20470928923635176
9658,0.3518676046176046,1,0,1,245294,360316,15211,92745,3.337619029975175,0.20470753386409335
9659,0.3519047619047619,0,5,0,245299,360311,15211,92745,3.3375727148097374,0.2047097930498658
9660,0.3519444444444444,0,1,0,245300,360310,15211,92745,3.3375634517766497,0.20471024489300416
9661,0.3519761904761904,0,2,0,245302,360308,15211,92745,3.337544925710475,0.20471114858526485
9662,0.3519761904761905,0,1,0,245303,360307,15211,92745,3.337535662677387,0.20471160043438721
9663,0.352,9,85,9,245388,360222,15220,92736,3.336748304864945,0.20473421376816395
9664,0.3520000000000001,0,1,0,245389,360221,15220,92736,3.336739041831857,0.2047346657629753
9665,0.3520238095238095,0,1,0,245390,360220,15220,92736,3.33672977879877,0.2047351177597824
9666,0.3520459401709402,0,1,0,245391,360219,15220,92736,3.3367205157656823,0.20473556975858528
9667,0.352047619047619,0,1,0,245392,360218,15220,92736,3.3367112527325946,0.20473602175938396
9668,0.3520714285714285,0,1,0,245393,360217,15220,92736,3.3367019896995074,0.2047364737621784
9669,0.3520724275724275,1,2,1,245395,360215,15221,92735,3.336683463633332,0.204735622033337
9670,0.3520833333333333,0,2,0,245397,360213,15221,92735,3.336664937567157,0.20473652604714007
9671,0.3521111111111111,0,1,0,245398,360212,15221,92735,3.3366556745340694,0.20473697805703536
9672,0.3521428571428571,0,5,0,245403,360207,15221,92735,3.3366093593686315,0.20473923813645015
9673,0.3521666666666666,0,2,0,245405,360205,15221,92735,3.3365908333024565,0.20474014218218747
9674,0.3521666666666667,1,14,1,245419,360191,15222,92734,3.336461150839231,0.20474471490864934
9675,0.3522222222222222,1,4,1,245423,360187,15223,92733,3.3364240987068805,0.20474476728782126
9676,0.3522272727272728,0,1,0,245424,360186,15223,92733,3.336414835673793,0.2047452193438562
9677,0.3522380952380952,1,0,1,245424,360186,15224,92732,3.336414835673793,0.2047434634967036
9678,0.3522460317460317,0,1,0,245425,360185,15224,92732,3.3364055726407056,0.2047439155518561
9679,0.3522619047619047,0,2,0,245427,360183,15224,92732,3.3363870465745302,0.20474481966814964
9680,0.3523333333333333,2,58,2,245485,360125,15226,92730,3.3358497906554523,0.20476753044572765
9681,0.3523484848484848,0,1,0,245486,360124,15226,92730,3.3358405276223646,0.20476798261691406
9682,0.3523717948717949,0,1,0,245487,360123,15226,92730,3.335831264589277,0.20476843479009746
9683,0.3523809523809523,0,2,0,245489,360121,15226,92730,3.335812738523102,0.20476933914245524
9684,0.3523809523809524,1,7,1,245496,360114,15227,92729,3.335747897291489,0.20477074836091094
9685,0.3524404761904762,0,1,0,245497,360113,15227,92729,3.3357386342584014,0.2047712005511856
9686,0.3524502164502164,1,1,1,245498,360112,15228,92728,3.335729371225314,0.20476989665223921
9687,0.3524722222222223,0,1,0,245499,360111,15228,92728,3.3357201081922265,0.20477034884362874
9688,0.3525,45,434,45,245933,359677,15273,92683,3.331699951832228,0.2048877000618976
9689,0.3525000000000001,0,4,0,245937,359673,15273,92683,3.331662899699878,0.20488951180044035
9690,0.3525238095238095,0,3,0,245940,359670,15273,92683,3.3316351106006152,0.20489087062537442
9691,0.352547619047619,0,2,0,245942,359668,15273,92683,3.33161658453444,0.20489177651867688
9692,0.3525606060606061,0,1,0,245943,359667,15273,92683,3.331607321501352,0.20489222946833205
9693,0.3525952380952381,0,1,0,245944,359666,15273,92683,3.331598058468265,0.20489268241998987
9694,0.3526190476190476,0,9,0,245953,359657,15273,92683,3.3315146911704767,0.20489675907503205
9695,0.3526666666666666,0,1,0,245954,359656,15273,92683,3.3315054281373895,0.20489721204671718
9696,0.3526666666666667,6,53,6,246007,359603,15279,92677,3.331014487383749,0.20491067480321926
9697,0.3526904761904761,0,4,0,246011,359599,15279,92677,3.3309774352513988,0.20491248706542023
9698,0.3527142857142857,0,1,0,246012,359598,15279,92677,3.330968172218311,0.20491294013597922
9699,0.35275,0,1,0,246013,359597,15279,92677,3.3309589091852234,0.2049133932085417
9700,0.3527777777777777,0,1,0,246014,359596,15279,92677,3.330949646152136,0.20491384628310777
9701,0.3527777777777778,0,2,0,246016,359594,15279,92677,3.330931120085961,0.20491475243825052
9702,0.3527857142857142,1,1,1,246017,359593,15280,92676,3.3309218570528736,0.20491344752790927
9703,0.3527857142857143,0,1,0,246018,359592,15280,92676,3.330912594019786,0.20491390060760434
9704,0.3528095238095238,1,1,1,246019,359591,15281,92675,3.330903330986698,0.20491259568484033
9705,0.3528333333333333,1,10,1,246029,359581,15282,92674,3.3308107006558227,0.20491536854208356
9706,0.3528333333333334,0,1,0,246030,359580,15282,92674,3.330801437622735,0.20491582164005184
9707,0.352845238095238,0,2,0,246032,359578,15282,92674,3.33078291155656,0.2049167278419996
9708,0.3528571428571428,1,11,1,246043,359567,15283,92673,3.330681018192597,0.20491995400672208
9709,0.3528888888888889,0,3,0,246046,359564,15283,92673,3.3306532290933344,0.20492131338214256
9710,0.3529285714285714,1,1,1,246047,359563,15284,92672,3.3306439660602467,0.204920008402711
9711,0.3529722222222222,0,1,0,246048,359562,15284,92672,3.330634703027159,0.20492046153097732
9712,0.3529761904761905,1,0,1,246048,359562,15285,92671,3.330634703027159,0.20491870341173687
9713,0.353,5,60,5,246108,359502,15290,92666,3.330078921041906,0.20493710302365492
9714,0.353015873015873,0,1,0,246109,359501,15290,92666,3.3300696580088185,0.20493755625686969
9715,0.3530238095238095,0,2,0,246111,359499,15290,92666,3.330051131942643,0.2049384627293134
9716,0.3530357142857143,0,1,0,246112,359498,15290,92666,3.330041868909556,0.20493891596854238
9717,0.353047619047619,0,3,0,246115,359495,15290,92666,3.3300140798102933,0.20494027569825793
9718,0.3530555555555555,1,1,1,246116,359494,15291,92665,3.3300048167772056,0.20493897058335675
9719,0.3530714285714286,0,1,0,246117,359493,15291,92665,3.329995553744118,0.20493942382972324
9720,0.353095238095238,0,1,0,246118,359492,15291,92665,3.3299862907110303,0.20493987707809455
9721,0.3530952380952381,1,1,1,246119,359491,15292,92664,3.329977027677943,0.20493857194988443
9722,0.3531428571428571,0,1,0,246120,359490,15292,92664,3.3299677646448553,0.20493902519937898
9723,0.3531666666666666,5,21,5,246141,359469,15297,92659,3.3297732409500167,0.2049397515747753
9724,0.3531666666666667,1,2,1,246143,359467,15298,92658,3.329754714883842,0.20493889964058612
9725,0.3531904761904761,0,1,0,246144,359466,15298,92658,3.329745451850754,0.2049393529208801
9726,0.3532142857142857,0,2,0,246146,359464,15298,92658,3.3297269257845787,0.20494025948748346
9727,0.3532222222222222,0,1,0,246147,359463,15298,92658,3.3297176627514915,0.20494071277379286
9728,0.3532728937728937,2,5,2,246152,359458,15300,92656,3.3296713475860535,0.20493946217104536
9729,0.3532857142857142,0,1,0,246153,359457,15300,92656,3.329662084552966,0.20493991546361198
9730,0.3533095238095238,1,0,1,246153,359457,15301,92655,3.329662084552966,0.20493815691687015
9731,0.3533181818181818,0,1,0,246154,359456,15301,92655,3.3296528215198786,0.20493861020855497
9732,0.3533333333333333,63,788,63,246942,358668,15364,92592,3.3223535514468856,0.20518548065416833
9733,0.3533571428571428,0,1,0,246943,358667,15364,92592,3.3223442884137984,0.20518593534976587
9734,0.3533809523809524,0,1,0,246944,358666,15364,92592,3.3223350253807107,0.20518639004737865
9735,0.3533888888888888,0,1,0,246945,358665,15364,92592,3.322325762347623,0.20518684474700669
9736,0.3534047619047619,0,1,0,246946,358664,15364,92592,3.3223164993145358,0.20518729944865
9737,0.3534285714285714,0,1,0,246947,358663,15364,92592,3.322307236281448,0.20518775415230855
9738,0.3534523809523809,1,1,1,246948,358662,15365,92591,3.3222979732483604,0.20518644751392234
9739,0.353452380952381,0,2,0,246950,358660,15365,92591,3.3222794471821855,0.2051873569255248
9740,0.3534999999999999,0,1,0,246951,358659,15365,92591,3.322270184149098,0.20518781163434904
9741,0.3535,4,27,4,246978,358632,15369,92587,3.322020082255734,0.20519304373264424
9742,0.3535119047619047,0,1,0,246979,358631,15369,92587,3.3220108192226463,0.20519349848631926
9743,0.3535238095238094,0,2,0,246981,358629,15369,92587,3.3219922931564714,0.20519440799971633
9744,0.3535714285714286,0,5,0,246986,358624,15369,92587,3.3219459779910334,0.20519668181848402
9745,0.3536111111111111,1,0,1,246986,358624,15370,92586,3.3219459779910334,0.2051949203253474
9746,0.3536428571428571,0,2,0,246988,358622,15370,92586,3.321927451924858,0.20519582986117268
9747,0.3536666666666666,3,2,3,246990,358620,15373,92583,3.321908925858683,0.20519145484405024
9748,0.3536666666666667,6,27,6,247017,358593,15379,92577,3.3216588239653193,0.20519316443912494
9749,0.3536904761904762,0,1,0,247018,358592,15379,92577,3.3216495609322316,0.20519361924245683
9750,0.3537142857142857,0,1,0,247019,358591,15379,92577,3.321640297899144,0.20519407404780482
9751,0.35375,1,12,1,247031,358579,15380,92576,3.3215291415020936,0.20519777016768073
9752,0.3537857142857142,0,1,0,247032,358578,15380,92576,3.321519878469006,0.20519822499634272
9753,0.3538095238095238,1,3,1,247035,358575,15381,92575,3.3214920893697433,0.20519782777346782
9754,0.3538333333333333,2,12,2,247047,358563,15383,92573,3.3213809329726924,0.20519976237764223
9755,0.3538333333333334,0,1,0,247048,358562,15383,92573,3.321371669939605,0.20520021722987575
9756,0.3538492063492063,0,1,0,247049,358561,15383,92573,3.3213624069065175,0.2052006720841258
9757,0.3538571428571428,1,0,1,247049,358561,15384,92572,3.3213624069065175,0.20519891029918005
9758,0.3538809523809524,0,1,0,247050,358560,15384,92572,3.32135314387343,0.20519936515254958
9759,0.3538888888888889,0,1,0,247051,358559,15384,92572,3.321343880840342,0.2051998200079356
9760,0.3539583333333332,1,0,1,247051,358559,15385,92571,3.321343880840342,0.20519805820938533
9761,0.3539761904761905,0,2,0,247053,358557,15385,92571,3.3213253547741672,0.20519896792041284
9762,0.3539999999999999,0,5,0,247058,358552,15385,92571,3.3212790396087293,0.20520124223327119
9763,0.354,17,149,17,247207,358403,15402,92554,3.319898847678684,0.20523908044447697
9764,0.3540238095238095,0,1,0,247208,358402,15402,92554,3.3198895846455962,0.20523953556444532
9765,0.354047619047619,1,5,1,247213,358397,15403,92553,3.3198432694801587,0.20524004878589644
9766,0.3540681818181817,0,1,0,247214,358396,15403,92553,3.319834006447071,0.20524050391507687
9767,0.3540714285714286,0,1,0,247215,358395,15403,92553,3.3198247434139834,0.20524095904627584
9768,0.3541190476190476,0,1,0,247216,358394,15403,92553,3.319815480380896,0.20524141417949338
9769,0.3541507936507935,0,2,0,247218,358392,15403,92553,3.3197969543147208,0.20524232445198418
9770,0.3541666666666666,9,67,9,247285,358325,15412,92544,3.3191763310978546,0.20525695933852184
9771,0.3541666666666667,7,99,7,247384,358226,15419,92537,3.3182592908221866,0.20528969769036057
9772,0.3542222222222222,0,1,0,247385,358225,15419,92537,3.3182500277890994,0.20529015311849713
9773,0.3542380952380952,0,1,0,247386,358224,15419,92537,3.3182407647560117,0.20529060854865439
9774,0.3542499999999999,0,3,0,247389,358221,15419,92537,3.318212975656749,0.20529197485125056
9775,0.3542857142857143,1,19,1,247408,358202,15420,92536,3.3180369780280854,0.20529886541627287
9776,0.3543174603174604,0,1,0,247409,358201,15420,92536,3.318027714994998,0.20529932089000902
9777,0.3543333333333333,0,11,0,247420,358190,15420,92536,3.317925821631035,0.20530433123449723
9778,0.3543333333333334,3,35,3,247455,358155,15423,92533,3.3176016154729706,0.20531498508946322
9779,0.3543625541125541,1,1,1,247456,358154,15424,92532,3.317592352439883,0.20531367737182873
9780,0.3543690476190476,0,1,0,247457,358153,15424,92532,3.3175830894067952,0.20531413293098283
9781,0.3543816738816739,0,1,0,247458,358152,15424,92532,3.317573826373708,0.20531458849215858
9782,0.3544444444444444,1,3,1,247461,358149,15425,92531,3.317546037274445,0.20531419188781397
9783,0.3544523809523809,0,1,0,247462,358148,15425,92531,3.3175367742413577,0.20531464745417471
9784,0.3545,2,16,2,247478,358132,15427,92529,3.3173885657119566,0.20531841006876567
9785,0.3545238095238094,0,4,0,247482,358128,15427,92529,3.3173515135796063,0.20532023246060752
9786,0.3545454545454545,0,1,0,247483,358127,15427,92529,3.317342250546519,0.2053206880636228
9787,0.3545555555555555,0,2,0,247485,358125,15427,92529,3.3173237244803437,0.20532159927571927
9788,0.3545714285714285,0,1,0,247486,358124,15427,92529,3.3173144614472565,0.20532205488480051
9789,0.3545833333333333,0,6,0,247492,358118,15427,92529,3.317258883248731,0.20532478858175024
9790,0.3546190476190475,0,1,0,247493,358117,15427,92529,3.3172496202156436,0.20532524420498574
9791,0.3546309523809523,0,1,0,247494,358116,15427,92529,3.317240357182556,0.20532569983024332
9792,0.3546666666666666,0,4,0,247498,358112,15427,92529,3.3172033050502057,0.20532752235149487
9793,0.3546666666666667,1,39,1,247537,358073,15428,92528,3.316842046759791,0.20534353008537487
9794,0.3546785714285714,0,6,0,247543,358067,15428,92528,3.316786468561266,0.20534626438375925
9795,0.3547142857142857,0,2,0,247545,358065,15428,92528,3.3167679424950904,0.20534717583273598
9796,0.3547380952380951,0,1,0,247546,358064,15428,92528,3.316758679462003,0.2053476315602585
9797,0.35475,0,3,0,247549,358061,15428,92528,3.31673089036274,0.20534899875496296
9798,0.3547619047619047,0,3,0,247552,358058,15428,92528,3.3167031012634776,0.20535036596787296
9799,0.3547954545454545,0,1,0,247553,358057,15428,92528,3.3166938382303903,0.20535082170955535
9800,0.3548333333333333,2,15,2,247568,358042,15430,92526,3.316554892734077,0.20535413078603007
9801,0.3548333333333334,0,1,0,247569,358041,15430,92526,3.316545629700989,0.20535458655427494
9802,0.3548349567099566,0,7,0,247576,358034,15430,92526,3.3164807884693763,0.20535777698863636
9803,0.3548650793650793,0,1,0,247577,358033,15430,92526,3.3164715254362886,0.20535823277306633
9804,0.3548690476190477,0,1,0,247578,358032,15430,92526,3.3164622624032014,0.20535868855951953
9805,0.3548809523809524,0,3,0,247581,358029,15430,92526,3.316434473303939,0.20536005593101841
9806,0.3549047619047619,0,1,0,247582,358028,15430,92526,3.316425210270851,0.20536051172556452
9807,0.3549166666666666,0,1,0,247583,358027,15430,92526,3.3164159472377635,0.20536096752213392
9808,0.3549444444444444,0,1,0,247584,358026,15430,92526,3.3164066842046758,0.20536142332072657
9809,0.3549523809523809,0,1,0,247585,358025,15430,92526,3.3163974211715885,0.20536187912134254
9810,0.354952380952381,0,1,0,247586,358024,15430,92526,3.316388158138501,0.2053623349239818
9811,0.3549642857142857,0,4,0,247590,358020,15430,92526,3.3163511060061506,0.20536415815477221
9812,0.3549999999999999,0,5,0,247595,358015,15430,92526,3.316304790840713,0.20536643723878625
9813,0.355,140,1541,140,249136,356474,15570,92386,3.302030456852792,0.20582364211558168
9814,0.3550000000000001,2,14,2,249150,356460,15572,92384,3.301900774389566,0.20582652324638404
9815,0.3551190476190476,0,2,0,249152,356458,15572,92384,3.301882248323391,0.20582744039105075
9816,0.3551666666666666,5,17,5,249169,356441,15577,92379,3.3017247767609024,0.2058263891983423
9817,0.3551666666666667,0,1,0,249170,356440,15577,92379,3.301715513727815,0.20582684779387683
9818,0.3551904761904761,0,2,0,249172,356438,15577,92379,3.3016969876616398,0.20582776499107655
9819,0.3551984126984127,1,0,1,249172,356438,15578,92378,3.3016969876616398,0.20582599550818154
9820,0.3552142857142857,0,2,0,249174,356436,15578,92378,3.301678461595465,0.2058269127077141
9821,0.3552380952380952,1,5,1,249179,356431,15579,92377,3.301632146430027,0.20582743623108324
9822,0.35525,0,1,0,249180,356430,15579,92377,3.3016228833969397,0.20582789484121236
9823,0.3552857142857143,0,1,0,249181,356429,15579,92377,3.301613620363852,0.2058283534533852
9824,0.3553095238095238,0,1,0,249182,356428,15579,92377,3.3016043573307643,0.20582881206760173
9825,0.3553333333333333,2,45,2,249227,356383,15581,92375,3.3011875208418244,0.20584591249626746
9826,0.3553333333333334,0,4,0,249231,356379,15581,92375,3.301150468709474,0.20584774731812974
9827,0.3553452380952381,1,0,1,249231,356379,15582,92374,3.301150468709474,0.20584597763134732
9828,0.3553571428571428,0,4,0,249235,356375,15582,92374,3.301113416577124,0.20584781247423392
9829,0.3553809523809523,0,1,0,249236,356374,15582,92374,3.3011041535440366,0.20584827119006657
9830,0.3553809523809524,0,1,0,249237,356373,15582,92374,3.301094890510949,0.20584872990794367
9831,0.3554166666666666,0,3,0,249240,356370,15582,92374,3.3010671014116864,0.20585010607384166
9832,0.3554166666666667,0,3,0,249243,356367,15582,92374,3.3010393123124238,0.20585148225813998
9833,0.3554285714285713,0,1,0,249244,356366,15582,92374,3.301030049279336,0.20585194099032847
9834,0.3554523809523809,0,1,0,249245,356365,15582,92374,3.3010207862462484,0.20585239972456149
9835,0.3554545454545454,0,1,0,249246,356364,15582,92374,3.3010115232131607,0.20585285846083906
9836,0.3554761904761905,1,0,1,249246,356364,15583,92373,3.3010115232131607,0.2058510887223474
9837,0.3555,2,24,2,249270,356340,15585,92371,3.3007892104190595,0.20585855929540395
9838,0.3555238095238095,0,1,0,249271,356339,15585,92371,3.3007799473859722,0.20585901807403445
9839,0.3555238095238096,0,1,0,249272,356338,15585,92371,3.3007706843528846,0.20585947685470984
9840,0.3555555555555555,0,4,0,249276,356334,15585,92371,3.3007336322205343,0.2058613119978605
9841,0.3555714285714286,1,1,1,249277,356333,15586,92370,3.3007243691874466,0.20586000093603118
9842,0.3555833333333333,0,1,0,249278,356332,15586,92370,3.3007151061543594,0.20586045972605427
9843,0.355611111111111,0,1,0,249279,356331,15586,92370,3.3007058431212717,0.20586091851812233
9844,0.3556190476190476,0,3,0,249282,356328,15586,92370,3.300678054022009,0.2058622949065964
9845,0.3556428571428571,1,1,1,249283,356327,15587,92369,3.3006687909889214,0.2058609838286947
9846,0.3556587301587301,0,2,0,249285,356325,15587,92369,3.3006502649227465,0.20586190142948202
9847,0.3556666666666666,2,33,2,249318,356292,15589,92367,3.300344584830857,0.20587350303905638
9848,0.3556666666666667,1,6,1,249324,356286,15590,92366,3.300289006632332,0.2058744862387775
9849,0.3557142857142857,2,18,2,249342,356268,15592,92364,3.300122272036756,0.20587920611993796
9850,0.3557499999999999,0,1,0,249343,356267,15592,92364,3.300113009003668,0.2058796650253772
9851,0.35575,1,1,1,249344,356266,15593,92363,3.3001037459705804,0.20587835382911046
9852,0.3557539682539682,0,1,0,249345,356265,15593,92363,3.300094482937493,0.20587881273571867
9853,0.3557857142857142,1,1,1,249346,356264,15594,92362,3.3000852199044055,0.2058775015268843
9854,0.3557936507936508,0,1,0,249347,356263,15594,92362,3.300075956871318,0.20587796043466147
9855,0.3558174603174603,0,1,0,249348,356262,15594,92362,3.3000666938382306,0.20587841934448448
9856,0.3558333333333333,10,173,10,249521,356089,15604,92352,3.2984641891140836,0.20594013482264112
9857,0.3558333333333334,0,1,0,249522,356088,15604,92352,3.298454926080996,0.20594059405940593
9858,0.3558545343545343,0,1,0,249523,356087,15604,92352,3.298445663047908,0.20594105329821893
9859,0.3559523809523809,1,2,1,249525,356085,15605,92351,3.2984271369817333,0.20594020105433106
9860,0.355952380952381,1,1,1,249526,356084,15606,92350,3.2984178739486456,0.20593888955788367
9861,0.3559999999999999,3,13,3,249539,356071,15609,92347,3.2982974545185075,0.20593954747579268
9862,0.356,17,169,17,249708,355902,15626,92330,3.296732001926711,0.20598707812025915
9863,0.3560714285714286,0,2,0,249710,355900,15626,92330,3.296713475860536,0.20598799723356312
9864,0.3560952380952381,0,3,0,249713,355897,15626,92330,3.2966856867612733,0.20598937591889824
9865,0.356111111111111,1,0,1,249713,355897,15627,92329,3.2966856867612733,0.20598760446738923
9866,0.3561111111111111,0,2,0,249715,355895,15627,92329,3.296667160695098,0.2059885235953452
9867,0.3561666666666666,0,2,0,249717,355893,15627,92329,3.296648634628923,0.20598944273150357
9868,0.3561666666666667,0,6,0,249723,355887,15627,92329,3.2965930564303974,0.2059922001891945
9869,0.3561785714285714,0,1,0,249724,355886,15627,92329,3.29658379339731,0.20599265977265374
9870,0.3561904761904762,0,7,0,249731,355879,15627,92329,3.2965189521656972,0.2059958769142898
9871,0.35625,1,7,1,249738,355872,15628,92328,3.2964541109340844,0.20599732262382864
9872,0.3563095238095238,0,4,0,249742,355868,15628,92328,3.296417058801734,0.20599916108131264
9873,0.3563333333333333,0,27,0,249769,355841,15628,92328,3.2961669569083702,0.20601157152770494
9874,0.3563333333333334,0,7,0,249776,355834,15628,92328,3.2961021156767574,0.20601478929494246
9875,0.3564285714285714,0,4,0,249780,355830,15628,92328,3.296065063544407,0.2060166280642095
9876,0.3564285714285715,0,3,0,249783,355827,15628,92328,3.2960372744451445,0.2060180071627004
9877,0.3564642857142857,0,2,0,249785,355825,15628,92328,3.296018748378969,0.20601892657195198
9878,0.3564761904761904,0,1,0,249786,355824,15628,92328,3.2960094853458815,0.2060193862796551
9879,0.3564761904761905,0,2,0,249788,355822,15628,92328,3.2959909592797065,0.2060203057012161
9880,0.3565,3,49,3,249837,355773,15631,92325,3.2955370706584164,0.20603751857852523
9881,0.356547619047619,0,2,0,249839,355771,15631,92325,3.2955185445922415,0.20603843819181603
9882,0.3565595238095238,0,1,0,249840,355770,15631,92325,3.295509281559154,0.20603889800153985
9883,0.3565714285714286,0,1,0,249841,355769,15631,92325,3.295500018526066,0.20603935781331595
9884,0.3566190476190476,0,1,0,249842,355768,15631,92325,3.2954907554929784,0.20603981762714438
9885,0.3566666666666666,38,341,38,250183,355427,15669,92287,3.292332061210123,0.2061293593678107
9886,0.3566666666666667,37,439,37,250622,354988,15706,92250,3.2882655896846864,0.20626601496295038
9887,0.3567142857142857,0,2,0,250624,354986,15706,92250,3.288247063618511,0.20626693736640164
9888,0.3567380952380952,0,1,0,250625,354985,15706,92250,3.288237800585424,0.20626739857122095
9889,0.3567435897435898,0,1,0,250626,354984,15706,92250,3.288228537552336,0.20626785977810275
9890,0.3567857142857143,1,4,1,250630,354980,15707,92249,3.288191485419986,0.20626792985249168
9891,0.3568333333333333,1,3,1,250633,354977,15708,92248,3.2881636963207233,0.2062675387109397
9892,0.3568333333333334,1,16,1,250649,354961,15709,92247,3.2880154877913226,0.20627314359313786
9893,0.3568571428571428,0,3,0,250652,354958,15709,92247,3.2879876986920595,0.2062745273420467
9894,0.3568809523809523,0,2,0,250654,354956,15709,92247,3.2879691726258846,0.20627544985163337
9895,0.3569444444444444,2,7,2,250661,354949,15711,92245,3.2879043313942717,0.20627512891496755
9896,0.3569523809523809,1,0,1,250661,354949,15712,92244,3.2879043313942717,0.20627335401046082
9897,0.3569999999999999,0,1,0,250662,354948,15712,92244,3.287895068361184,0.20627381527397629
9898,0.357,7,46,7,250708,354902,15719,92237,3.2874689688391565,0.20628261010558238
9899,0.3570238095238096,0,1,0,250709,354901,15719,92237,3.2874597058060693,0.2062830714455045
9900,0.3570833333333333,1,2,1,250711,354899,15720,92236,3.287441179739894,0.20628221901662808
9901,0.3570952380952381,1,0,1,250711,354899,15721,92235,3.287441179739894,0.2062804438937768
9902,0.3571111111111111,0,5,0,250716,354894,15721,92235,3.2873948645744564,0.20628275061559415
9903,0.3571190476190476,1,1,1,250717,354893,15722,92234,3.2873856015413687,0.2062814368177274
9904,0.3571428571428571,3,19,3,250736,354874,15725,92231,3.287209603912705,0.20628487715413604
9905,0.3571666666666666,0,2,0,250738,354872,15725,92231,3.28719107784653,0.20628579991635038
9906,0.3571666666666667,1,13,1,250751,354859,15726,92230,3.287070658416392,0.2062900227918826
9907,0.3572222222222222,0,2,0,250753,354857,15726,92230,3.2870521323502166,0.20629094561013853
9908,0.3572301587301587,0,2,0,250755,354855,15726,92230,3.2870336062840417,0.20629186843665076
9909,0.35725,0,1,0,250756,354854,15726,92230,3.287024343250954,0.20629232985300303
9910,0.3572619047619047,1,3,1,250759,354851,15727,92229,3.2869965541516915,0.2062919388028988
9911,0.3572777777777778,1,0,1,250759,354851,15728,92228,3.2869965541516915,0.2062901634834112
9912,0.357313492063492,0,1,0,250760,354850,15728,92228,3.2869872911186038,0.20629062490214237
9913,0.3573333333333333,9,44,9,250804,354806,15737,92219,3.2865797176627516,0.20629494994687098
9914,0.3573333333333334,1,0,1,250804,354806,15738,92218,3.2865797176627516,0.20629317441569134
9915,0.3573809523809523,1,3,1,250807,354803,15739,92217,3.286551928563489,0.2062927833206568
9916,0.3573809523809524,1,5,1,250812,354798,15740,92216,3.286505613398051,0.20629331519818173
9917,0.3574395881895881,1,0,1,250812,354798,15741,92215,3.286505613398051,0.20629153961965313
9918,0.3574523809523808,0,1,0,250813,354797,15741,92215,3.2864963503649633,0.2062920011095899
9919,0.3574523809523809,0,1,0,250814,354796,15741,92215,3.286487087331876,0.20629246260159145
9920,0.3574761904761904,0,1,0,250815,354795,15741,92215,3.2864778242987884,0.2062929240956578
9921,0.3574999999999999,0,10,0,250825,354785,15741,92215,3.286385193967913,0.20629753914988813
9922,0.3575,41,448,41,251273,354337,15782,92174,3.282235355144689,0.20643164446116669
9923,0.3575000000000001,0,4,0,251277,354333,15782,92174,3.2821983030123385,0.20643349376381556
9924,0.3575595238095237,0,1,0,251278,354332,15782,92174,3.282189039979251,0.20643395609465495
9925,0.3576190476190476,0,12,0,251290,354320,15782,92174,3.2820778835822,0.2064395042262606
9926,0.3576309523809523,0,1,0,251291,354319,15782,92174,3.2820686205491127,0.20643996658402258
9927,0.3576388888888888,0,2,0,251293,354317,15782,92174,3.2820500944829374,0.2064408913057598
9928,0.3576428571428572,0,1,0,251294,354316,15782,92174,3.28204083144985,0.20644135366973504
9929,0.3576666666666666,3,28,3,251322,354288,15785,92171,3.2817814665233986,0.20644896843831123
9930,0.3576666666666667,0,3,0,251325,354285,15785,92171,3.2817536774241356,0.2064503556901464
9931,0.3577142857142857,0,1,0,251326,354284,15785,92171,3.2817444143910484,0.2064508181115678
9932,0.3577380952380952,0,1,0,251327,354283,15785,92171,3.2817351513579607,0.20645128053506073
9933,0.35775,0,1,0,251328,354282,15785,92171,3.281725888324873,0.20645174296062518
9934,0.3577619047619047,0,1,0,251329,354281,15785,92171,3.2817166252917858,0.20645220538826123
9935,0.3577619047619048,1,0,1,251329,354281,15786,92170,3.2817166252917858,0.20645042793050078
9936,0.3577777777777777,0,1,0,251330,354280,15786,92170,3.281707362258698,0.20645089035726286
9937,0.3577777777777778,0,2,0,251332,354278,15786,92170,3.2816888361925227,0.20645181521700176
9938,0.3577857142857142,0,1,0,251333,354277,15786,92170,3.2816795731594355,0.20645227764997862
9939,0.3578333333333333,1,22,1,251355,354255,15787,92169,3.281475786431509,0.20646067415730338
9940,0.3578333333333334,0,1,0,251356,354254,15787,92169,3.2814665233984215,0.2064611366349852
9941,0.3578571428571429,0,7,0,251363,354247,15787,92169,3.2814016821668086,0.20646437403677287
9942,0.3578787878787878,1,0,1,251363,354247,15788,92168,3.2814016821668086,0.20646259646293247
9943,0.3578888888888889,0,1,0,251364,354246,15788,92168,3.281392419133721,0.20646305895424427
9944,0.3579047619047619,0,2,0,251366,354244,15788,92168,3.281373893067546,0.20646398394308396
9945,0.3579166666666666,0,1,0,251367,354243,15788,92168,3.2813646300344583,0.2064644464406119
9946,0.3579166666666667,0,2,0,251369,354241,15788,92168,3.2813461039682834,0.206465371441884
9947,0.3579523809523809,0,1,0,251370,354240,15788,92168,3.2813368409351957,0.2064658339456282
9948,0.3579761904761905,0,2,0,251372,354238,15788,92168,3.281318314869021,0.20646675895933297
9949,0.3579848484848484,0,1,0,251373,354237,15788,92168,3.281309051835933,0.20646722146929358
9950,0.358,9,98,9,251471,354139,15797,92159,3.280401274593353,0.20649655611273185
9951,0.3580238095238095,0,1,0,251472,354138,15797,92159,3.280392011560265,0.20649701880138113
9952,0.3580555555555555,0,1,0,251473,354137,15797,92159,3.280382748527178,0.2064974814921039
9953,0.3580714285714286,0,1,0,251474,354136,15797,92159,3.2803734854940902,0.2064979441849001
9954,0.3580952380952381,0,6,0,251480,354130,15797,92159,3.280317907295565,0.20650072038522124
9955,0.3581190476190476,0,1,0,251481,354129,15797,92159,3.2803086442624774,0.20650118309253218
9956,0.3581428571428571,0,1,0,251482,354128,15797,92159,3.2802993812293897,0.2065016458019167
9957,0.3581547619047619,0,1,0,251483,354127,15797,92159,3.280290118196302,0.20650210851337483
9958,0.3581666666666666,2,9,2,251492,354118,15799,92157,3.280206750898514,0.20650271693462552
9959,0.3581666666666667,1,5,1,251497,354113,15800,92156,3.2801604357330763,0.20650325252258167
9960,0.3581785714285714,0,2,0,251499,354111,15800,92156,3.2801419096669013,0.20650417799209891
9961,0.3582142857142856,0,1,0,251500,354110,15800,92156,3.2801326466338137,0.20650464072996821
9962,0.3582142857142857,0,3,0,251503,354107,15800,92156,3.280104857534551,0.20650602895601922
9963,0.3582380952380953,0,1,0,251504,354106,15800,92156,3.2800955945014634,0.2065064917021839
9964,0.35825,1,1,1,251505,354105,15801,92155,3.280086331468376,0.2065051763545915
9965,0.3582857142857142,0,2,0,251507,354103,15801,92155,3.2800678054022008,0.20650610185139537
9966,0.3582857142857143,0,1,0,251508,354102,15801,92155,3.2800585423691135,0.2065065646029082
9967,0.358297619047619,0,1,0,251509,354101,15801,92155,3.280049279336026,0.20650702735649493
9968,0.3583333333333333,51,493,51,252002,353608,15852,92104,3.2754826040238614,0.20664464945974081
9969,0.3583333333333334,0,1,0,252003,353607,15852,92104,3.275473340990774,0.2066451130889747
9970,0.3583571428571428,0,1,0,252004,353606,15852,92104,3.2754640779576865,0.20664557672028896
9971,0.3583571428571429,0,1,0,252005,353605,15852,92104,3.275454814924599,0.20664604035368367
9972,0.3583809523809524,0,1,0,252006,353604,15852,92104,3.2754455518915115,0.20664650398915882
9973,0.358392857142857,0,1,0,252007,353603,15852,92104,3.275436288858424,0.20664696762671442
9974,0.3583928571428572,1,0,1,252007,353603,15853,92103,3.275436288858424,0.20664518763489834
9975,0.3584166666666666,2,1,2,252008,353602,15855,92101,3.275427025825336,0.20664209125807992
9976,0.3584285714285714,0,1,0,252009,353601,15855,92101,3.2754177627922485,0.2066425548909361
9977,0.3584523809523808,0,1,0,252010,353600,15855,92101,3.2754084997591613,0.20664301852587272
9978,0.3584523809523809,1,1,1,252011,353599,15856,92100,3.2753992367260736,0.2066417021352976
9979,0.3584999999999999,0,2,0,252013,353597,15856,92100,3.2753807106598987,0.2066426294096662
9980,0.3585,2,29,2,252042,353568,15858,92098,3.2751120827003595,0.20665251556098063
9981,0.3585238095238095,0,2,0,252044,353566,15858,92098,3.275093556634184,0.20665344295253824
9982,0.358547619047619,0,1,0,252045,353565,15858,92098,3.275084293601097,0.20665390665143843
9983,0.3585555555555555,0,1,0,252046,353564,15858,92098,3.275075030568009,0.20665437035241954
9984,0.3585714285714285,0,4,0,252050,353560,15858,92098,3.275037978435659,0.2066562251771538
9985,0.3585714285714286,0,13,0,252063,353547,15858,92098,3.274917559005521,0.20666225358749676
9986,0.3585897435897436,0,1,0,252064,353546,15858,92098,3.274908295972433,0.2066627173259373
9987,0.3586111111111111,0,1,0,252065,353545,15858,92098,3.2748990329393455,0.20666318106645903
9988,0.3586125541125541,0,2,0,252067,353543,15858,92098,3.2748805068731706,0.20666410855374617
9989,0.3586190476190476,0,2,0,252069,353541,15858,92098,3.2748619808069956,0.20666503604935835
9990,0.3586666666666666,0,5,0,252074,353536,15858,92098,3.2748156656415577,0.20666735482481138
9991,0.3586666666666667,0,25,0,252099,353511,15858,92098,3.2745840898143688,0.20667894948261817
9992,0.3586904761904762,0,1,0,252100,353510,15858,92098,3.274574826781281,0.2066794132959911
9993,0.3587142857142857,1,0,1,252100,353510,15859,92097,3.274574826781281,0.20667763298152855
9994,0.35875,0,7,0,252107,353503,15859,92097,3.274509985549668,0.20668087971274685
9995,0.3587777777777778,0,1,0,252108,353502,15859,92097,3.274500722516581,0.20668134353981943
9996,0.3588095238095238,0,6,0,252114,353496,15859,92097,3.2744451443180553,0.20668412654597357
9997,0.3588333333333333,0,14,0,252128,353482,15859,92097,3.2743154618548296,0.20669062051847148
9998,0.3588333333333334,1,0,1,252128,353482,15860,92096,3.2743154618548296,0.20668884011329106
9999,0.3588571428571427,0,1,0,252129,353481,15860,92096,3.2743061988217423,0.20668930398113008
10000,0.3588571428571429,0,1,0,252130,353480,15860,92096,3.2742969357886547,0.20668976785105123
10001,0.3588690476190475,0,1,0,252131,353479,15860,92096,3.274287672755567,0.20669023172305448
10002,0.3588809523809524,0,1,0,252132,353478,15860,92096,3.2742784097224797,0.20669069559713987
10003,0.3588888888888888,0,1,0,252133,353477,15860,92096,3.274269146689392,0.2066911594733074
10004,0.3589166666666666,0,1,0,252134,353476,15860,92096,3.2742598836563044,0.2066916233515571
10005,0.3589285714285714,0,4,0,252138,353472,15860,92096,3.274222831523954,0.20669347888537776
10006,0.3589999999999999,0,4,0,252142,353468,15860,92096,3.274185779391604,0.20669533445251412
10007,0.359,12,72,12,252214,353396,15872,92084,3.2735188410093,0.2067073718236509
10008,0.359047619047619,0,4,0,252218,353392,15872,92084,3.27348178887695,0.20670922788208568
10009,0.3590476190476191,0,1,0,252219,353391,15872,92084,3.273472525843862,0.20670969190190247
10010,0.359063492063492,0,1,0,252220,353390,15872,92084,3.273463262810775,0.2067101559238025
10011,0.3591190476190476,0,1,0,252221,353389,15872,92084,3.2734539997776873,0.20671061994778583
10012,0.3591428571428571,0,1,0,252222,353388,15872,92084,3.2734447367445996,0.20671108397385246
10013,0.3591428571428572,0,1,0,252223,353387,15872,92084,3.273435473711512,0.20671154800200237
10014,0.3591666666666666,10,65,10,252288,353322,15882,92074,3.272833376560821,0.20672390412127634
10015,0.3591666666666667,9,60,9,252348,353262,15891,92065,3.2722775945755678,0.2067357245350046
10016,0.3592142857142857,0,1,0,252349,353261,15891,92065,3.27226833154248,0.20673618876957556
10017,0.3592380952380952,0,1,0,252350,353260,15891,92065,3.272259068509393,0.2067366530062314
10018,0.3592857142857143,0,17,0,252367,353243,15891,92065,3.2721015969469045,0.20674454534838807
10019,0.3592948717948718,0,1,0,252368,353242,15891,92065,3.272092333913817,0.206745009622575
10020,0.3593333333333333,1,13,1,252381,353229,15892,92064,3.2719719144836787,0.20674926396776955
10021,0.3593333333333334,5,57,5,252438,353172,15897,92059,3.271443921597688,0.206766824412496
10022,0.3593939393939394,0,1,0,252439,353171,15897,92059,3.2714346585646004,0.20676728881701592
10023,0.3594047619047619,0,3,0,252442,353168,15897,92059,3.2714068694653378,0.20676868204309262
10024,0.3594285714285714,0,1,0,252443,353167,15897,92059,3.27139760643225,0.2067691464559572
10025,0.3594444444444444,0,3,0,252446,353164,15897,92059,3.2713698173329875,0.20677053970706816
10026,0.3594523809523809,0,1,0,252447,353163,15897,92059,3.2713605542999,0.2067710041282776
10027,0.3594761904761904,0,1,0,252448,353162,15897,92059,3.2713512912668126,0.20677146855157327
10028,0.3594761904761905,0,1,0,252449,353161,15897,92059,3.271342028233725,0.2067719329769552
10029,0.3594999999999999,0,6,0,252455,353155,15897,92059,3.2712864500351997,0.20677471957305923
10030,0.3595,2,14,2,252469,353141,15899,92057,3.271156767571974,0.2067776584800471
10031,0.3595000000000001,0,1,0,252470,353140,15899,92057,3.2711475045388863,0.2067781229433262
10032,0.3595238095238094,0,4,0,252474,353136,15899,92057,3.271110452406536,0.20677998081730845
10033,0.3595238095238096,0,1,0,252475,353135,15899,92057,3.2711011893734483,0.2067804452910205
10034,0.3595436507936507,0,1,0,252476,353134,15899,92057,3.271091926340361,0.20678090976681918
10035,0.3595476190476191,0,1,0,252477,353133,15899,92057,3.2710826633072734,0.2067813742447045
10036,0.3595714285714285,0,1,0,252478,353132,15899,92057,3.2710734002741857,0.20678183872467648
10037,0.3595833333333333,0,2,0,252480,353130,15899,92057,3.2710548742080108,0.20678276769088047
10038,0.3596134976134976,1,7,1,252487,353123,15900,92056,3.270990032976398,0.20678423735171694
10039,0.3596190476190476,1,0,1,252487,353123,15901,92055,3.270990032976398,0.206782455557103
10040,0.3596428571428571,0,5,0,252492,353118,15901,92055,3.27094371781096,0.2067847780525773
10041,0.3596666666666666,1,7,1,252499,353111,15902,92054,3.270878876579347,0.20678624779576113
10042,0.3596666666666667,1,16,1,252515,353095,15903,92053,3.2707306680499464,0.20679189842479356
10043,0.3596904761904762,0,1,0,252516,353094,15903,92053,3.2707214050168587,0.20679236297223164
10044,0.3597142857142857,1,2,1,252518,353092,15904,92052,3.270702878950684,0.20679151016300343
10045,0.3597499999999999,0,1,0,252519,353091,15904,92052,3.270693615917596,0.20679197471374366
10046,0.3597619047619047,1,1,1,252520,353090,15905,92051,3.2706843528845084,0.2067906573422803
10047,0.3597857142857142,0,1,0,252521,353089,15905,92051,3.2706750898514207,0.2067911218942355
10048,0.3598174603174603,0,2,0,252523,353087,15905,92051,3.270656563785246,0.20679205100440762
10049,0.3598333333333333,0,14,0,252537,353073,15905,92051,3.27052688132202,0.20679855500939065
10050,0.3598571428571428,0,1,0,252538,353072,15905,92051,3.2705176182889324,0.20679901959683053
10051,0.3598611111111111,0,1,0,252539,353071,15905,92051,3.270508355255845,0.2067994841863579
10052,0.3598809523809524,0,1,0,252540,353070,15905,92051,3.2704990922227575,0.20679994877797273
10053,0.3599166666666666,0,2,0,252542,353068,15905,92051,3.270480566156582,0.20680087796746488
10054,0.3599444444444444,0,1,0,252543,353067,15905,92051,3.270471303123495,0.20680134256534222
10055,0.3599523809523809,0,1,0,252544,353066,15905,92051,3.270462040090407,0.2068018071653071
10056,0.359984126984127,0,1,0,252545,353065,15905,92051,3.2704527770573195,0.20680227176735952
10057,0.3599999999999999,4,19,4,252564,353046,15909,92047,3.2702767794286562,0.20680397130487335
10058,0.36,355,3837,355,256401,349209,16264,91692,3.2347345214717107,0.20796505337933005
10059,0.3600000000000001,0,13,0,256414,349196,16264,91692,3.2346141020415726,0.20797118542577706
10060,0.3600416666666666,0,1,0,256415,349195,16264,91692,3.234604839008485,0.20797165713663593
10061,0.360047619047619,1,1,1,256416,349194,16265,91691,3.2345955759753973,0.20797033239960533
10062,0.3600833333333333,0,4,0,256420,349190,16265,91691,3.234558523843047,0.20797221926097972
10063,0.3600833333333334,0,4,0,256424,349186,16265,91691,3.234521471710697,0.20797410615659243
10064,0.3601190476190476,1,1,1,256425,349185,16266,91690,3.2345122086776095,0.20797278140062375
10065,0.3601269841269841,1,0,1,256425,349185,16267,91689,3.2345122086776095,0.2079709849072524
10066,0.3601666666666666,1,12,1,256437,349173,16268,91688,3.2344010522805586,0.20797484921551238
10067,0.3601666666666667,0,2,0,256439,349171,16268,91688,3.2343825262143837,0.20797579271377017
10068,0.3602380952380952,0,4,0,256443,349167,16268,91688,3.2343454740820334,0.20797767973596762
10069,0.3602777777777777,0,1,0,256444,349166,16268,91688,3.2343362110489458,0.20797815149686744
10070,0.3602857142857142,0,1,0,256445,349165,16268,91688,3.2343269480158585,0.20797862325990749
10071,0.3602857142857143,1,0,1,256445,349165,16269,91687,3.2343269480158585,0.20797682669013637
10072,0.3603333333333332,1,0,1,256445,349165,16270,91686,3.2343269480158585,0.2079750301122148
10073,0.3603333333333333,1,35,1,256480,349130,16271,91685,3.234002741857794,0.20798974626544015
10074,0.3603333333333334,1,4,1,256484,349126,16272,91684,3.233965689725444,0.20798983689117762
10075,0.3603571428571427,0,2,0,256486,349124,16272,91684,3.2339471636592685,0.2079907805665959
10076,0.3603571428571428,0,1,0,256487,349123,16272,91684,3.2339379006261812,0.2079912524075162
10077,0.3603809523809523,0,1,0,256488,349122,16272,91684,3.2339286375930936,0.20799172425057735
10078,0.3603888888888889,0,1,0,256489,349121,16272,91684,3.233919374560006,0.20799219609577932
10079,0.3604166666666666,0,1,0,256490,349120,16272,91684,3.233910111526918,0.2079926679431221
10080,0.3604166666666667,0,1,0,256491,349119,16272,91684,3.233900848493831,0.20799313979260578
10081,0.3604444444444444,0,1,0,256492,349118,16272,91684,3.2338915854607433,0.2079936116442303
10082,0.3604736652236653,0,1,0,256493,349117,16272,91684,3.2338823224276556,0.2079940834979957
10083,0.3604761904761904,1,0,1,256493,349117,16273,91683,3.2338823224276556,0.20799228675136117
10084,0.3604761904761905,0,1,0,256494,349116,16273,91683,3.2338730593945684,0.2079927586042618
10085,0.3605,5,23,5,256517,349093,16278,91678,3.2336600096335544,0.20799462759573564
10086,0.3605238095238095,0,1,0,256518,349092,16278,91678,3.2336507466004667,0.20799509948499217
10087,0.3605555555555555,0,1,0,256519,349091,16278,91678,3.2336414835673795,0.2079955713763899
10088,0.3605555555555556,1,3,1,256522,349088,16279,91677,3.233613694468117,0.20799519018070853
10089,0.3605714285714285,0,1,0,256523,349087,16279,91677,3.233604431435029,0.20799566207766515
10090,0.3605833333333333,0,3,0,256526,349084,16279,91677,3.2335766423357666,0.20799707778138266
10091,0.3606190476190475,1,1,1,256527,349083,16280,91676,3.233567379302679,0.20799575278099824
10092,0.3606190476190476,0,1,0,256528,349082,16280,91676,3.233558116269591,0.20799622468565518
10093,0.3606515151515151,0,1,0,256529,349081,16280,91676,3.2335488532365035,0.20799669659245343
10094,0.3606666666666666,2,37,2,256566,349044,16282,91674,3.2332061210122642,0.2080105645787102
10095,0.3606666666666667,2,10,2,256576,349034,16284,91672,3.2331134906813888,0.20801169033323802
10096,0.3606969696969696,1,0,1,256576,349034,16285,91671,3.2331134906813888,0.20800989323924168
10097,0.3607142857142857,1,11,1,256587,349023,16286,91670,3.2330115973174256,0.20801328816205386
10098,0.3607499999999999,0,1,0,256588,349022,16286,91670,3.233002334284338,0.2080137601771759
10099,0.36075,0,1,0,256589,349021,16286,91670,3.2329930712512507,0.2080142321944401
10100,0.3607619047619048,1,0,1,256589,349021,16287,91669,3.2329930712512507,0.208012435045043
10101,0.3608333333333333,17,169,17,256758,348852,16304,91652,3.231427618659454,0.20806167480885532
10102,0.3609166666666666,1,1,1,256759,348851,16305,91651,3.2314183556263663,0.20806034932872042
10103,0.3609523809523808,0,1,0,256760,348850,16305,91651,3.2314090925932786,0.20806082165534243
10104,0.3609523809523809,1,8,1,256768,348842,16306,91650,3.2313349883285785,0.20806280250265613
10105,0.360952380952381,1,0,1,256768,348842,16307,91649,3.2313349883285785,0.20806100465162738
10106,0.3609761904761905,1,4,1,256772,348838,16308,91648,3.231297936196228,0.20806109615288568
10107,0.3609999999999999,0,11,0,256783,348827,16308,91648,3.231196042832265,0.20806629207105964
10108,0.361,5,79,5,256862,348748,16313,91643,3.230464263218348,0.20809462500368991
10109,0.3610714285714285,0,1,0,256863,348747,16313,91643,3.2304550001852608,0.2080950975271918
10110,0.3610851370851371,0,2,0,256865,348745,16313,91643,3.2304364741190854,0.20809604258063344
10111,0.3611363636363636,0,1,0,256866,348744,16313,91643,3.230427211085998,0.2080965151105732
10112,0.3611428571428571,0,1,0,256867,348743,16313,91643,3.2304179480529105,0.20809698764265894
10113,0.3611666666666667,0,7,0,256874,348736,16313,91643,3.2303531068212976,0.20810029542734781
10114,0.3611904761904762,1,3,1,256877,348733,16314,91642,3.230325317722035,0.2080999148453023
10115,0.3612222222222222,0,2,0,256879,348731,16314,91642,3.2303067916558597,0.20810085995281272
10116,0.3612380952380952,0,1,0,256880,348730,16314,91642,3.2302975286227724,0.20810133250978718
10117,0.36125,2,5,2,256885,348725,16316,91640,3.2302512134573345,0.20810009878169247
10118,0.3612857142857143,0,1,0,256886,348724,16316,91640,3.2302419504242468,0.20810057134552326
10119,0.3613095238095238,0,2,0,256888,348722,16316,91640,3.230223424358072,0.20810151647962358
10120,0.361330808080808,1,5,1,256893,348717,16317,91639,3.230177109192634,0.20810208104351932
10121,0.3613333333333333,3,38,3,256931,348679,16320,91636,3.229825113935307,0.20811464519718836
10122,0.3613333333333334,1,5,1,256936,348674,16321,91635,3.2297787987698694,0.20811521000024982
10123,0.3613571428571429,0,1,0,256937,348673,16321,91635,3.2297695357367817,0.2081156826585027
10124,0.3613809523809524,0,1,0,256938,348672,16321,91635,3.229760272703694,0.20811615531890248
10125,0.3613888888888888,0,2,0,256940,348670,16321,91635,3.229741746637519,0.20811710064614303
10126,0.3614047619047619,0,2,0,256942,348668,16321,91635,3.2297232205713438,0.2081180459819715
10127,0.3614166666666666,0,1,0,256943,348667,16321,91635,3.2297139575382565,0.20811851865310627
10128,0.3614285714285714,0,4,0,256947,348663,16321,91635,3.2296769054059062,0.20812040935911588
10129,0.3614545454545455,0,1,0,256948,348662,16321,91635,3.2296676423728186,0.20812088204098597
10130,0.3614999999999999,0,3,0,256951,348659,16321,91635,3.229639853273556,0.208122300099479
10131,0.3615,5,19,5,256970,348640,16326,91630,3.2294638556448922,0.2081222885956345
10132,0.3615151515151515,0,1,0,256971,348639,16326,91630,3.229454592611805,0.20812276131183435
10133,0.3615238095238095,0,1,0,256972,348638,16326,91630,3.2294453295787173,0.20812323403018163
10134,0.361547619047619,0,2,0,256974,348636,16326,91630,3.229426803512542,0.2081241794733184
10135,0.3615476190476191,0,1,0,256975,348635,16326,91630,3.2294175404794547,0.20812465219810797
10136,0.3615714285714285,0,1,0,256976,348634,16326,91630,3.229408277446367,0.20812512492504498
10137,0.3615833333333333,0,2,0,256978,348632,16326,91630,3.229389751380192,0.20812607038536143
10138,0.3615952380952381,0,1,0,256979,348631,16326,91630,3.2293804883471044,0.20812654311874093
10139,0.3616111111111111,0,2,0,256981,348629,16326,91630,3.229361962280929,0.20812748859194247
10140,0.3616190476190475,0,1,0,256982,348628,16326,91630,3.229352699247842,0.20812796133176456
10141,0.3616666666666666,22,201,22,257183,348427,16348,91608,3.2274908295972433,0.20818343995364005
10142,0.3616666666666667,24,230,24,257413,348197,16372,91584,3.225360331987106,0.20824910580493472
10143,0.3616904761904762,0,1,0,257414,348196,16372,91584,3.2253510689540184,0.20824957933512211
10144,0.3617142857142857,0,1,0,257415,348195,16372,91584,3.2253418059209307,0.20825005286746298
10145,0.3617499999999999,1,0,1,257415,348195,16373,91583,3.2253418059209307,0.20824825252741155
10146,0.3617539682539683,1,2,1,257417,348193,16374,91582,3.2253232798547558,0.20824739923824684
10147,0.3617857142857143,0,4,0,257421,348189,16374,91582,3.2252862277224055,0.20824929338223758
10148,0.3618095238095238,1,1,1,257422,348188,16375,91581,3.225276964689318,0.20824796654607305
10149,0.3618333333333334,0,11,0,257433,348177,16375,91581,3.2251750713253546,0.208253175610222
10150,0.3618571428571428,0,1,0,257434,348176,16375,91581,3.2251658082922674,0.20825364917443043
10151,0.3618939393939393,0,1,0,257435,348175,16375,91581,3.2251565452591797,0.2082541227407926
10152,0.3618939393939394,0,1,0,257436,348174,16375,91581,3.225147282226092,0.2082545963093086
10153,0.3619047619047618,0,1,0,257437,348173,16375,91581,3.2251380191930044,0.20825506987997836
10154,0.3619285714285714,0,1,0,257438,348172,16375,91581,3.225128756159917,0.20825554345280192
10155,0.3619642857142857,1,0,1,257438,348172,16376,91580,3.225128756159917,0.2082537430187924
10156,0.3619999999999999,1,6,1,257444,348166,16377,91579,3.2250731779613915,0.20825478402255854
10157,0.362,10,95,10,257539,348071,16387,91569,3.2241931898180742,0.20828177599854425
10158,0.3620140415140415,0,4,0,257543,348067,16387,91569,3.224156137685724,0.20828367103694875
10159,0.3620238095238094,0,2,0,257545,348065,16387,91569,3.2241376116195486,0.20828461856908245
10160,0.3620238095238096,0,1,0,257546,348064,16387,91569,3.2241283485864614,0.20828509233838224
10161,0.3620512820512821,0,3,0,257549,348061,16387,91569,3.2241005594871983,0.20828651365921344
10162,0.3620555555555554,0,1,0,257550,348060,16387,91569,3.224091296454111,0.2082869874371345
10163,0.3620833333333333,0,2,0,257552,348058,16387,91569,3.2240727703879357,0.2082879349994427
10164,0.3621428571428571,1,4,1,257556,348054,16388,91568,3.2240357182555854,0.20828802926150192
10165,0.3621428571428572,0,1,0,257557,348053,16388,91568,3.224026455222498,0.20828850305149207
10166,0.3621590909090909,0,1,0,257558,348052,16388,91568,3.2240171921894105,0.20828897684363767
10167,0.3621666666666667,2,14,2,257572,348038,16390,91566,3.2238875097261848,0.20829200826198124
10168,0.3621818181818181,0,2,0,257574,348036,16390,91566,3.22386898366001,0.20829295590101957
10169,0.3621904761904762,0,1,0,257575,348035,16390,91566,3.223859720626922,0.20829342972377224
10170,0.3621984126984127,0,3,0,257578,348032,16390,91566,3.2238319315276596,0.20829485120496455
10171,0.3622222222222223,0,1,0,257579,348031,16390,91566,3.223822668494572,0.2082953250363401
10172,0.3622619047619047,0,2,0,257581,348029,16390,91566,3.223804142428397,0.20829627270555853
10173,0.3622857142857142,0,1,0,257582,348028,16390,91566,3.2237948793953093,0.2082967465434014
10174,0.3623333333333333,4,40,4,257622,347988,16394,91562,3.223424358071807,0.2083084973268115
10175,0.3623333333333334,0,1,0,257623,347987,16394,91562,3.2234150950387193,0.20830897124097655
10176,0.3623571428571428,0,1,0,257624,347986,16394,91562,3.223405832005632,0.20830944515729796
10177,0.3623809523809523,0,3,0,257627,347983,16394,91562,3.2233780429063694,0.20831086691920053
10178,0.3623809523809524,0,12,0,257639,347971,16394,91562,3.2232668865093186,0.20831655416089348
10179,0.3624285714285714,0,1,0,257640,347970,16394,91562,3.223257623476231,0.20831702811171882
10180,0.3624999999999999,1,9,1,257649,347961,16395,91561,3.223174256178443,0.2083194925396226
10181,0.3625,41,422,41,258071,347539,16436,91520,3.219265256215495,0.20844578974579725
10182,0.362547619047619,0,1,0,258072,347538,16436,91520,3.219255993182408,0.20844626450263976
10183,0.3625555555555556,0,1,0,258073,347537,16436,91520,3.21924673014932,0.20844673926164484
10184,0.362611111111111,0,1,0,258074,347536,16436,91520,3.2192374671162325,0.20844721402281258
10185,0.3626190476190476,0,5,0,258079,347531,16436,91520,3.219191151950795,0.2084495878610913
10186,0.3626190476190477,0,2,0,258081,347529,16436,91520,3.2191726258846196,0.20845053741154176
10187,0.3626309523809524,0,1,0,258082,347528,16436,91520,3.219163362851532,0.2084510121900111
10188,0.3626428571428572,0,1,0,258083,347527,16436,91520,3.2191540998184447,0.20845148697064322
10189,0.3626666666666666,6,56,6,258139,347471,16442,91514,3.2186353699655417,0.20846725970135654
10190,0.3626666666666667,1,4,1,258143,347467,16443,91513,3.2185983178331914,0.20846735614378786
10191,0.3626904761904762,0,1,0,258144,347466,16443,91513,3.2185890548001037,0.2084678310351976
10192,0.3626984126984126,0,1,0,258145,347465,16443,91513,3.218579791767016,0.20846830592877091
10193,0.3627142857142856,0,1,0,258146,347464,16443,91513,3.218570528733929,0.2084687808245079
10194,0.3627142857142857,0,1,0,258147,347463,16443,91513,3.218561265700841,0.20846925572240851
10195,0.3627380952380952,0,2,0,258149,347461,16443,91513,3.218542739634666,0.20847020552470077
10196,0.3627499999999999,0,1,0,258150,347460,16443,91513,3.2185334766015785,0.20847068042909245
10197,0.3627500000000001,0,1,0,258151,347459,16443,91513,3.218524213568491,0.20847115533564783
10198,0.3627857142857143,0,1,0,258152,347458,16443,91513,3.218514950535403,0.20847163024436693
10199,0.3628333333333333,2,7,2,258159,347451,16445,91511,3.2184501093037903,0.2084713483171664
10200,0.3628333333333334,0,2,0,258161,347449,16445,91511,3.2184315832376154,0.20847229815928559
10201,0.3628571428571427,1,0,1,258161,347449,16446,91510,3.2184315832376154,0.20847049496650027
10202,0.3628571428571428,0,15,0,258176,347434,16446,91510,3.218292637741302,0.2084776190129037
10203,0.3628787878787879,0,1,0,258177,347433,16446,91510,3.2182833747082142,0.2084780939666426
10204,0.3628809523809523,2,8,2,258185,347425,16448,91508,3.218209270443514,0.20847828711899083
10205,0.3629166666666667,0,1,0,258186,347424,16448,91508,3.2182000074104264,0.20847876208615457
10206,0.3629444444444444,0,1,0,258187,347423,16448,91508,3.2181907443773388,0.20847923705548252
10207,0.3629816017316017,0,1,0,258188,347422,16448,91508,3.2181814813442515,0.20847971202697468
10208,0.363,2,54,2,258242,347368,16450,91506,3.2176812775575234,0.20850175676845747
10209,0.3630357142857143,0,1,0,258243,347367,16450,91506,3.2176720145244357,0.20850223185295064
10210,0.3630555555555556,0,1,0,258244,347366,16450,91506,3.2176627514913485,0.20850270693960882
10211,0.3630634920634921,0,1,0,258245,347365,16450,91506,3.217653488458261,0.20850318202843204
10212,0.3630714285714285,0,1,0,258246,347364,16450,91506,3.217644225425173,0.20850365711942032
10213,0.3630833333333333,0,1,0,258247,347363,16450,91506,3.2176349623920855,0.2085041322125737
10214,0.3630952380952381,1,2,1,258249,347361,16451,91505,3.2176164363259105,0.20850327890517834
10215,0.3631190476190476,0,1,0,258250,347360,16451,91505,3.217607173292823,0.2085037540018001
10216,0.3631666666666666,2,17,2,258267,347343,16453,91503,3.2174497017303345,0.208508223841621
10217,0.3631666666666667,1,5,1,258272,347338,16454,91502,3.217403386564897,0.20850879591650714
10218,0.363190476190476,1,2,1,258274,347336,16455,91501,3.2173848604987216,0.2085079425846043
10219,0.3631904761904762,0,1,0,258275,347335,16455,91501,3.217375597465634,0.20850841772324968
10220,0.3632142857142857,2,9,2,258284,347326,16457,91499,3.217292230167846,0.20850908676579502
10221,0.3632380952380952,0,1,0,258285,347325,16457,91499,3.2172829671347585,0.20850956192004083
10222,0.3632575757575758,0,1,0,258286,347324,16457,91499,3.2172737041016712,0.20851003707645224
10223,0.3632857142857142,0,2,0,258288,347322,16457,91499,3.217255178035496,0.20851098739577184
10224,0.3633015873015873,1,1,1,258289,347321,16458,91498,3.217245915002408,0.20850965887985706
10225,0.3633095238095238,0,2,0,258291,347319,16458,91498,3.2172273889362333,0.20851060920611553
10226,0.3633333333333332,0,2,0,258293,347317,16458,91498,3.2172088628700584,0.20851155954103665
10227,0.3633333333333333,79,810,79,259103,346507,16537,91419,3.2097058060691395,0.2087544470983682
10228,0.3633333333333334,0,1,0,259104,346506,16537,91419,3.209696543036052,0.20875492378831992
10229,0.3634166666666666,0,1,0,259105,346505,16537,91419,3.209687280002964,0.20875540048044866
10230,0.3634206349206348,0,1,0,259106,346504,16537,91419,3.2096780169698764,0.20875587717475447
10231,0.3634285714285714,0,1,0,259107,346503,16537,91419,3.209668753936789,0.20875635387123734
10232,0.3634523809523809,2,5,2,259112,346498,16539,91417,3.2096224387713512,0.20875512371122248
10233,0.363452380952381,0,2,0,259114,346496,16539,91417,3.2096039127051763,0.20875607712034125
10234,0.3634603174603174,0,3,0,259117,346493,16539,91417,3.2095761236059137,0.20875750725034825
10235,0.3634761904761905,1,0,1,259117,346493,16540,91416,3.2095761236059137,0.20875570038523986
10236,0.3634999999999999,0,1,0,259118,346492,16540,91416,3.209566860572826,0.20875617709655908
10237,0.3635,2,29,2,259147,346463,16542,91414,3.209298232613287,0.20876638873473602
10238,0.363547619047619,0,1,0,259148,346462,16542,91414,3.209288969580199,0.20876686550530288
10239,0.3635606060606061,1,2,1,259150,346460,16543,91413,3.2092704435140242,0.2087660120628584
10240,0.3635714285714285,1,1,1,259151,346459,16544,91412,3.2092611804809366,0.20876468183551777
10241,0.3635714285714286,0,5,0,259156,346454,16544,91412,3.209214865315499,0.20876706572330347
10242,0.3636017316017316,0,1,0,259157,346453,16544,91412,3.2092056022824114,0.20876754250739382
10243,0.3636190476190476,2,0,2,259157,346453,16546,91410,3.2092056022824114,0.20876392844337155
10244,0.3636190476190477,0,1,0,259158,346452,16546,91410,3.2091963392493237,0.2087644052235636
10245,0.3636428571428571,0,1,0,259159,346451,16546,91410,3.2091870762162364,0.20876488200593338
10246,0.3636666666666666,1,7,1,259166,346444,16547,91409,3.2091222349846236,0.20876641247176564
10247,0.3636666666666667,3,18,3,259184,346426,16550,91406,3.2089555003890475,0.20876957371777302
10248,0.3636904761904762,1,2,1,259186,346424,16551,91405,3.208936974322872,0.2087687202081178
10249,0.3637142857142856,0,2,0,259188,346422,16551,91405,3.2089184482566973,0.20876967386661854
10250,0.3637499999999999,0,1,0,259189,346421,16551,91405,3.2089091852236096,0.20877015069913618
10251,0.36375,0,10,0,259199,346411,16551,91405,3.208816554892734,0.20877491914411533
10252,0.3637777777777778,0,1,0,259200,346410,16551,91405,3.2088072918596464,0.20877539600059386
10253,0.3637857142857142,0,1,0,259201,346409,16551,91405,3.208798028826559,0.20877587285925073
10254,0.3638095238095238,3,1,3,259202,346408,16554,91402,3.2087887657934715,0.20877092802814007
10255,0.3638333333333332,0,2,0,259204,346406,16554,91402,3.208770239727296,0.2087718817381135
10256,0.3638333333333333,1,12,1,259216,346394,16555,91401,3.2086590833302457,0.20877579689123904
10257,0.3638333333333334,1,5,1,259221,346389,16556,91400,3.208612768164808,0.20877637400665616
10258,0.3638809523809523,0,1,0,259222,346388,16556,91400,3.2086035051317205,0.2087768508958674
10259,0.3638888888888889,1,1,1,259223,346387,16557,91399,3.208594242098633,0.20877552045976802
10260,0.3639166666666666,0,1,0,259224,346386,16557,91399,3.208584979065545,0.20877599735029753
10261,0.3639231601731602,1,1,1,259225,346385,16558,91398,3.2085757160324575,0.20877466690118163
10262,0.3639285714285714,0,1,0,259226,346384,16558,91398,3.2085664529993703,0.20877514379302942
10263,0.3639523809523808,0,1,0,259227,346383,16558,91398,3.2085571899662826,0.20877562068705585
10264,0.3639999999999999,1,2,1,259229,346381,16559,91397,3.2085386639001077,0.20877476711940757
10265,0.364,20,158,20,259387,346223,16579,91377,3.207075104672274,0.20881398537477147
10266,0.3640476190476189,0,1,0,259388,346222,16579,91377,3.2070658416391864,0.20881446255590164
10267,0.364047619047619,2,3,2,259391,346219,16581,91375,3.207038052539924,0.20881227804768804
10268,0.3640555555555556,0,1,0,259392,346218,16581,91375,3.207028789506836,0.20881275523145937
10269,0.3640714285714285,0,1,0,259393,346217,16581,91375,3.2070195264737484,0.20881323241741165
10270,0.3640833333333333,0,2,0,259395,346215,16581,91375,3.2070010004075735,0.20881418679585914
10271,0.3640952380952381,0,3,0,259398,346212,16581,91375,3.206973211308311,0.20881561837988788
10272,0.3641190476190475,1,0,1,259398,346212,16582,91374,3.206973211308311,0.20881381031385832
10273,0.3641428571428571,1,0,1,259398,346212,16583,91373,3.206973211308311,0.2088120022395649
10274,0.3641666666666666,5,79,5,259477,346133,16588,91368,3.206241431694394,0.20884066550705027
10275,0.3641666666666667,4,72,4,259549,346061,16592,91364,3.20557449331209,0.2088678059095845
10276,0.3641904761904762,0,1,0,259550,346060,16592,91364,3.2055652302790025,0.20886828340466002
10277,0.3642077922077923,0,5,0,259555,346055,16592,91364,3.2055189151135646,0.20887067091278613
10278,0.3642142857142857,0,3,0,259558,346052,16592,91364,3.205491126014302,0.20887210344386123
10279,0.3642499999999999,0,2,0,259560,346050,16592,91364,3.205472599948127,0.20887305847549462
10280,0.3642619047619048,0,1,0,259561,346049,16592,91364,3.2054633369150394,0.20887353599458636
10281,0.3642857142857142,0,1,0,259562,346048,16592,91364,3.2054540738819517,0.2088740135158615
10282,0.3642857142857143,1,20,1,259582,346028,16593,91363,3.2052688132202007,0.2088817556831302
10283,0.3642878787878789,1,0,1,259582,346028,16594,91362,3.2052688132202007,0.2088799469580923
10284,0.3642976190476191,0,2,0,259584,346026,16594,91362,3.205250287154026,0.20888090208236165
10285,0.3643333333333333,0,12,0,259596,346014,16594,91362,3.205139130756975,0.20888663301141353
10286,0.3643333333333334,2,28,2,259624,345986,16596,91360,3.2048797658305235,0.20889638867166957
10287,0.3643636363636364,0,1,0,259625,345985,16596,91360,3.204870502797436,0.20889686631835278
10288,0.3643809523809524,0,1,0,259626,345984,16596,91360,3.2048612397643486,0.20889734396722032
10289,0.3643982683982683,0,1,0,259627,345983,16596,91360,3.204851976731261,0.20889782161827217
10290,0.3644166666666667,0,1,0,259628,345982,16596,91360,3.204842713698173,0.20889829927150833
10291,0.3644285714285714,0,1,0,259629,345981,16596,91360,3.204833450665086,0.20889877692692888
10292,0.3644444444444444,0,2,0,259631,345979,16596,91360,3.2048149245989106,0.20889973224432307
10293,0.3644761904761905,0,1,0,259632,345978,16596,91360,3.204805661565823,0.20890020990629674
10294,0.3644999999999999,0,3,0,259635,345975,16596,91360,3.2047778724665603,0.2089016429053243
10295,0.3645,1,13,1,259648,345962,16597,91359,3.2046574530364222,0.20890604384422426
10296,0.3645238095238094,0,3,0,259651,345959,16597,91359,3.2046296639371596,0.20890747693897804
10297,0.364560606060606,1,0,1,259651,345959,16598,91358,3.2046296639371596,0.20890566797083124
10298,0.3645833333333332,0,1,0,259652,345958,16598,91358,3.204620400904072,0.20890614567040766
10299,0.3645833333333333,0,2,0,259654,345956,16598,91358,3.204601874837897,0.20890710107611465
10300,0.3645952380952381,0,1,0,259655,345955,16598,91358,3.2045926118048094,0.20890757878224522
10301,0.3646190476190477,0,2,0,259657,345953,16598,91358,3.2045740857386344,0.20890853420106056
10302,0.3646428571428571,0,5,0,259662,345948,16598,91358,3.2045277705731965,0.2089109227863327
10303,0.3646666666666666,1,3,1,259665,345945,16599,91357,3.204499981473934,0.2089105469446744
10304,0.3646666666666667,5,27,5,259692,345918,16604,91352,3.20424987958057,0.20891440071351797
10305,0.3647142857142857,0,1,0,259693,345917,16604,91352,3.2042406165474824,0.2089148784844112
10306,0.36475,0,1,0,259694,345916,16604,91352,3.2042313535143947,0.2089153562574897
10307,0.3647619047619047,1,0,1,259694,345916,16605,91351,3.2042313535143947,0.20891354710051296
10308,0.3647619047619048,1,0,1,259694,345916,16606,91350,3.2042313535143947,0.20891173793526138
10309,0.3647857142857142,0,1,0,259695,345915,16606,91350,3.204222090481307,0.20891221570443552
10310,0.3648095238095238,1,0,1,259695,345915,16607,91349,3.204222090481307,0.20891040652786416
10311,0.3648333333333333,3,19,3,259714,345896,16610,91346,3.2040460928526437,0.20891405674660715
10312,0.3648571428571428,0,1,0,259715,345895,16610,91346,3.204036829819556,0.20891453454730916
10313,0.3648787878787878,1,0,1,259715,345895,16611,91345,3.204036829819556,0.20891272527673588
10314,0.3648809523809523,1,1,1,259716,345894,16612,91344,3.2040275667864684,0.2089113937946839
10315,0.3648809523809524,2,0,2,259716,345894,16614,91342,3.2040275667864684,0.2089077752060672
10316,0.3648888888888889,0,1,0,259717,345893,16614,91342,3.204018303753381,0.20890825299895938
10317,0.3649047619047619,0,1,0,259718,345892,16614,91342,3.2040090407202935,0.20890873079403707
10318,0.364968253968254,0,1,0,259719,345891,16614,91342,3.203999777687206,0.2089092085913003
10319,0.3649999999999999,1,18,1,259737,345873,16615,91341,3.2038330430916298,0.20891599994510698
10320,0.365,146,1430,146,261167,344443,16761,91195,3.1905869057764273,0.2093366510726796
10321,0.365047619047619,0,3,0,261170,344440,16761,91195,3.1905591166771647,0.2093380926693218
10322,0.3650555555555555,0,1,0,261171,344439,16761,91195,3.190549853644077,0.20933857320594812
10323,0.365074916913152,2,4,2,261175,344435,16763,91193,3.190512801511727,0.20933686539891835
10324,0.3650833333333332,0,4,0,261179,344431,16763,91193,3.190475749379377,0.2093387875782785
10325,0.3650833333333334,0,1,0,261180,344430,16763,91193,3.1904664863462893,0.20933926812863415
10326,0.3651190476190475,0,3,0,261183,344427,16763,91193,3.1904386972470267,0.2093407097929388
10327,0.3651309523809523,0,1,0,261184,344426,16763,91193,3.190429434213939,0.20934119035211962
10328,0.3651388888888889,0,1,0,261185,344425,16763,91193,3.1904201711808513,0.20934167091350678
10329,0.3651666666666666,2,13,2,261198,344412,16765,91191,3.1902997517507132,0.20934428826247753
10330,0.3651666666666667,0,2,0,261200,344410,16765,91191,3.1902812256845383,0.20934524943698476
10331,0.3652380952380952,3,5,3,261205,344405,16768,91188,3.1902349105191004,0.20934220706026038
10332,0.3652857142857143,0,3,0,261208,344402,16768,91188,3.1902071214198378,0.2093436488440965
10333,0.3652857142857144,0,1,0,261209,344401,16768,91188,3.19019785838675,0.20934412944312183
10334,0.3653333333333332,0,1,0,261210,344400,16768,91188,3.1901885953536624,0.20934461004435384
10335,0.3653333333333333,4,39,4,261249,344361,16772,91184,3.189827337063248,0.2093560940890149
10336,0.3653333333333334,1,3,1,261252,344358,16773,91183,3.189799547963985,0.20935572081618034
10337,0.365335594960595,0,5,0,261257,344353,16773,91183,3.1897532327985476,0.20935812424231293
10338,0.3653571428571428,0,4,0,261261,344349,16773,91183,3.1897161806661973,0.20936004702295125
10339,0.3653571428571429,0,1,0,261262,344348,16773,91183,3.1897069176331097,0.2093605277236293
10340,0.3654166666666666,0,3,0,261265,344345,16773,91183,3.189679128533847,0.20936196983890817
10341,0.3654166666666667,0,2,0,261267,344343,16773,91183,3.189660602467672,0.20936293126013142
10342,0.3654404761904761,0,2,0,261269,344341,16773,91183,3.1896420764014968,0.2093638926901847
10343,0.3654444444444444,0,1,0,261270,344340,16773,91183,3.1896328133684095,0.20936437340852262
10344,0.365452380952381,0,1,0,261271,344339,16773,91183,3.189623550335322,0.2093648541290681
10345,0.3654642857142857,0,2,0,261273,344337,16773,91183,3.1896050242691465,0.20936581557678177
10346,0.3654682539682539,0,1,0,261274,344336,16773,91183,3.1895957612360593,0.20936629630395
10347,0.3654761904761904,0,2,0,261276,344334,16773,91183,3.189577235169884,0.2093672577649093
10348,0.3654761904761905,0,5,0,261281,344329,16773,91183,3.1895309200044464,0.20936966145594152
10349,0.3655,1,18,1,261299,344311,16774,91182,3.1893641854088703,0.20937649973707959
10350,0.3655238095238095,1,0,1,261299,344311,16775,91181,3.1893641854088703,0.209374684265153
10351,0.3655238095238096,0,3,0,261302,344308,16775,91181,3.1893363963096077,0.20937612660710145
10352,0.3655357142857143,1,0,1,261302,344308,16776,91180,3.1893363963096077,0.20937431111764274
10353,0.365547619047619,0,1,0,261303,344307,16776,91180,3.18932713327652,0.2093747918996434
10354,0.3655555555555556,0,2,0,261305,344305,16776,91180,3.189308607210345,0.2093757534702688
10355,0.3655714285714285,0,1,0,261306,344304,16776,91180,3.1892993441772575,0.20937623425889354
10356,0.3655833333333333,0,2,0,261308,344302,16776,91180,3.189280818111082,0.20937719584276732
10357,0.3655952380952381,0,2,0,261310,344300,16776,91180,3.189262292044907,0.2093781574354735
10358,0.3656071428571428,0,1,0,261311,344299,16776,91180,3.1892530290118195,0.20937863823513878
10359,0.3656428571428571,0,1,0,261312,344298,16776,91180,3.1892437659787323,0.2093791190370122
10360,0.3656666666666666,5,38,5,261350,344260,16781,91175,3.188891770721405,0.2093883128365887
10361,0.3656666666666667,2,9,2,261359,344251,16783,91173,3.188808403423617,0.20938900933343133
10362,0.3657142857142857,3,4,3,261363,344247,16786,91170,3.1887713512912668,0.20938548563790574
10363,0.3657380952380952,0,1,0,261364,344246,16786,91170,3.188762088258179,0.20938596652396788
10364,0.36575,0,2,0,261366,344244,16786,91170,3.188743562192004,0.2093869283027188
10365,0.3657719298245613,0,1,0,261367,344243,16786,91170,3.1887342991589165,0.20938740919540758
10366,0.3657777777777777,0,1,0,261368,344242,16786,91170,3.1887250361258292,0.20938789009030528
10367,0.3657878787878788,0,1,0,261369,344241,16786,91170,3.1887157730927416,0.2093883709874119
10368,0.3658095238095237,1,1,1,261370,344240,16787,91169,3.188706510059654,0.20938703609709491
10369,0.3658095238095238,0,1,0,261371,344239,16787,91169,3.188697247026566,0.2093875169955536
10370,0.3658315018315018,0,1,0,261372,344238,16787,91169,3.188687983993479,0.20938799789622123
10371,0.3658333333333333,15,155,15,261527,344083,16802,91154,3.187252213864908,0.20943531914795846
10372,0.3658333333333334,0,1,0,261528,344082,16802,91154,3.1872429508318203,0.20943580034739773
10373,0.3658571428571428,1,0,1,261528,344082,16803,91153,3.1872429508318203,0.20943398393971074
10374,0.3658571428571429,0,1,0,261529,344081,16803,91153,3.1872336877987326,0.20943446513829342
10375,0.365952380952381,1,5,1,261534,344076,16804,91152,3.187187372633295,0.20943505472993465
10376,0.3659848484848486,0,2,0,261536,344074,16804,91152,3.1871688465671197,0.20943601714971072
10377,0.3659960317460318,0,4,0,261540,344070,16804,91152,3.18713179443477,0.20943794201579882
10378,0.3659999999999999,2,9,2,261549,344061,16806,91150,3.1870484271369817,0.2094386401079017
10379,0.366,10,137,10,261686,343924,16816,91140,3.1857793916039867,0.20948642038872442
10380,0.3660000000000001,1,1,1,261687,343923,16817,91139,3.1857701285708995,0.20948508488445325
10381,0.3660238095238095,0,1,0,261688,343922,16817,91139,3.185760865537812,0.2094855663918393
10382,0.3660714285714285,0,2,0,261690,343920,16817,91139,3.1857423394716364,0.209486529413252
10383,0.3660714285714286,0,1,0,261691,343919,16817,91139,3.185733076438549,0.20948701092727867
10384,0.3661111111111111,0,2,0,261693,343917,16817,91139,3.185714550372374,0.20948797396197272
10385,0.3661428571428571,0,1,0,261694,343916,16817,91139,3.1857052873392866,0.2094884554826401
10386,0.3661666666666666,1,1,1,261695,343915,16818,91138,3.185696024306199,0.2094871199600968
10387,0.3661666666666667,1,19,1,261714,343896,16819,91137,3.185520026677535,0.2094944521450097
10388,0.3661720085470084,0,5,0,261719,343891,16819,91137,3.1854737115120977,0.20949685997223166
10389,0.3661904761904761,0,1,0,261720,343890,16819,91137,3.18546444847901,0.20949734154431793
10390,0.3661904761904762,0,5,0,261725,343885,16819,91137,3.185418133313572,0.20949974943795946
10391,0.36625,1,6,1,261731,343879,16820,91136,3.185362555115047,0.20950082181074217
10392,0.3662698412698412,0,1,0,261732,343878,16820,91136,3.185353292081959,0.20950130340632717
10393,0.3662857142857142,0,1,0,261733,343877,16820,91136,3.185344029048872,0.2095017850041263
10394,0.3663030303030302,0,1,0,261734,343876,16820,91136,3.1853347660157842,0.20950226660413965
10395,0.3663095238095238,0,3,0,261737,343873,16820,91136,3.1853069769165216,0.20950371141746493
10396,0.3663333333333332,0,3,0,261740,343870,16820,91136,3.185279187817259,0.2095051562507184
10397,0.3663333333333333,1,24,1,261764,343846,16821,91135,3.1850568750231574,0.20951489835188203
10398,0.3663333333333334,3,7,3,261771,343839,16824,91132,3.1849920337915445,0.20951281809591904
10399,0.3663571428571429,0,3,0,261774,343836,16824,91132,3.184964244692282,0.2095142631182064
10400,0.3663809523809524,0,2,0,261776,343834,16824,91132,3.184945718626107,0.2095152264774718
10401,0.3664166666666666,0,2,0,261778,343832,16824,91132,3.1849271925599316,0.20951618984559642
10402,0.3664166666666667,0,1,0,261779,343831,16824,91132,3.1849179295268444,0.20951667153298095
10403,0.3664285714285714,0,6,0,261785,343825,16824,91132,3.1848623513283187,0.2095195617038006
10404,0.3664999999999999,0,2,0,261787,343823,16824,91132,3.184843825262144,0.20952052511179317
10405,0.3665,4,39,4,261826,343784,16828,91128,3.184482566971729,0.20953204326392466
10406,0.3665238095238095,0,1,0,261827,343783,16828,91128,3.1844733039386415,0.2095325250453541
10407,0.366547619047619,0,1,0,261828,343782,16828,91128,3.1844640409055542,0.2095330068289991
10408,0.3665476190476191,0,3,0,261831,343779,16828,91128,3.1844362518062916,0.20953445219322753
10409,0.3665515873015873,0,1,0,261832,343778,16828,91128,3.184426988773204,0.20953493398573486
10410,0.3665714285714286,0,4,0,261836,343774,16828,91128,3.1843899366408537,0.20953686117792053
10411,0.3666111111111111,0,1,0,261837,343773,16828,91128,3.184380673607766,0.20953734298150614
10412,0.3666428571428571,0,1,0,261838,343772,16828,91128,3.1843714105746788,0.20953782478730743
10413,0.3666666666666666,42,358,42,262196,343414,16870,91086,3.1810552447293343,0.20963406214039126
10414,0.3666666666666667,40,477,40,262673,342937,16910,91046,3.176636777946571,0.2097916277826551
10415,0.3667142857142857,0,2,0,262675,342935,16910,91046,3.1766182518803956,0.20979259460667632
10416,0.3667619047619048,0,1,0,262676,342934,16910,91046,3.1766089888473084,0.20979307802202868
10417,0.3667857142857143,0,3,0,262679,342931,16910,91046,3.1765811997480453,0.2097945282814527
10418,0.3668095238095237,0,2,0,262681,342929,16910,91046,3.1765626736818704,0.20979549513220808
10419,0.3668333333333333,1,15,1,262696,342914,16911,91045,3.176423728185557,0.20980092589392085
10420,0.3668571428571428,0,1,0,262697,342913,16911,91045,3.1764144651524697,0.20980140935297886
10421,0.3669047619047618,0,2,0,262699,342911,16911,91045,3.1763959390862944,0.2098023762777793
10422,0.3669047619047619,0,4,0,262703,342907,16911,91045,3.176358886953944,0.20980431015411843
10423,0.3669166666666666,0,3,0,262706,342904,16911,91045,3.1763310978546815,0.20980576058476919
10424,0.3669444444444444,0,2,0,262708,342902,16911,91045,3.1763125717885066,0.20980672754967772
10425,0.366952380952381,0,2,0,262710,342900,16911,91045,3.176294045722331,0.2098076945234995
10426,0.3669999999999999,0,8,0,262718,342892,16911,91045,3.176219941457631,0.20981156250792166
10427,0.367,8,47,8,262765,342845,16919,91037,3.175784578902516,0.20981972056918702
10428,0.3670476190476189,0,1,0,262766,342844,16919,91037,3.175775315869428,0.2098202041573611
10429,0.3670833333333332,0,3,0,262769,342841,16919,91037,3.1757475267701656,0.2098216549352583
10430,0.3670873015873014,0,1,0,262770,342840,16919,91037,3.175738263737078,0.20982213853234902
10431,0.3670952380952381,1,0,1,262770,342840,16920,91036,3.175738263737078,0.2098203173256875
10432,0.3671428571428571,1,16,1,262786,342824,16921,91035,3.1755900552076772,0.20982623386860708
10433,0.3671666666666666,0,3,0,262789,342821,16921,91035,3.1755622661084146,0.20982768476176428
10434,0.3671666666666667,2,10,2,262799,342811,16923,91033,3.175469635777539,0.20982887858308516
10435,0.3672222222222222,2,2,2,262801,342809,16925,91031,3.175451109711364,0.20982620320855616
10436,0.3672222222222223,0,2,0,262803,342807,16925,91031,3.175432583645189,0.20982717051065145
10437,0.3672619047619047,0,1,0,262804,342806,16925,91031,3.175423320612101,0.20982765416504356
10438,0.3673333333333333,4,57,4,262861,342749,16929,91027,3.1748953277261105,0.20984793995057358
10439,0.3673333333333334,0,1,0,262862,342748,16929,91027,3.1748860646930233,0.20984842372197568
10440,0.3673809523809523,0,1,0,262863,342747,16929,91027,3.1748768016599356,0.2098489074956083
10441,0.3673809523809524,0,6,0,262869,342741,16929,91027,3.1748212234614104,0.20985181018424595
10442,0.3673809523809525,0,1,0,262870,342740,16929,91027,3.1748119604283227,0.20985229397349267
10443,0.3674444444444444,0,1,0,262871,342739,16929,91027,3.174802697395235,0.20985277776497005
10444,0.3674523809523809,0,1,0,262872,342738,16929,91027,3.1747934343621473,0.2098532615586781
10445,0.367452380952381,0,1,0,262873,342737,16929,91027,3.17478417132906,0.2098537453546168
10446,0.3674999999999999,0,2,0,262875,342735,16929,91027,3.1747656452628847,0.2098547129531863
10447,0.3675,43,424,43,263299,342311,16972,90984,3.170838119233762,0.20998165222308127
10448,0.3675119047619047,0,2,0,263301,342309,16972,90984,3.170819593167587,0.20998262145938199
10449,0.3675714285714286,0,2,0,263303,342307,16972,90984,3.1708010671014115,0.20998359070463038
10450,0.3675952380952381,0,2,0,263305,342305,16972,90984,3.1707825410352366,0.20998455995882656
10451,0.3676190476190475,0,6,0,263311,342299,16972,90984,3.1707269628367114,0.2099874677751031
10452,0.3676428571428571,1,1,1,263312,342298,16973,90983,3.1707176998036237,0.20998612909405212
10453,0.3676551226551228,0,3,0,263315,342295,16973,90983,3.170689910704361,0.20998758302983303
10454,0.3676666666666666,3,34,3,263349,342261,16976,90980,3.170374967579384,0.20999859200768164
10455,0.3676666666666667,1,3,1,263352,342258,16977,90979,3.1703471784801214,0.20999822268181156
10456,0.3677499999999999,0,1,0,263353,342257,16977,90979,3.170337915447034,0.2099987074019703
10457,0.3677619047619048,0,1,0,263354,342256,16977,90979,3.1703286524139465,0.20999919212436668
10458,0.3677777777777777,0,6,0,263360,342250,16977,90979,3.1702730742154213,0.21000210050573714
10459,0.3678095238095238,1,0,1,263360,342250,16978,90978,3.1702730742154213,0.2100002769904069
10460,0.3678333333333333,2,14,2,263374,342236,16980,90976,3.1701433917521955,0.2100034163411909
10461,0.3678333333333334,0,3,0,263377,342233,16980,90976,3.1701156026529325,0.21000487062826487
10462,0.3678571428571427,0,1,0,263378,342232,16980,90976,3.1701063396198452,0.2100053553950989
10463,0.3678571428571428,2,2,2,263380,342230,16982,90974,3.17008781355367,0.21000267772227404
10464,0.3678571428571429,0,1,0,263381,342229,16982,90974,3.1700785505205826,0.21000316248964113
10465,0.3678888888888889,0,1,0,263382,342228,16982,90974,3.170069287487495,0.21000364725924625
10466,0.3679166666666666,0,3,0,263385,342225,16982,90974,3.1700414983882323,0.21000510158149027
10467,0.3679166666666667,0,2,0,263387,342223,16982,90974,3.170022972322057,0.21000607114084355
10468,0.3679438339438339,0,1,0,263388,342222,16982,90974,3.1700137092889697,0.2100065559238774
10469,0.3679523809523809,0,1,0,263389,342221,16982,90974,3.170004446255882,0.21000704070914947
10470,0.368,10,95,10,263484,342126,16992,90964,3.1691244581125644,0.21003486573229582
10471,0.3680000000000001,0,1,0,263485,342125,16992,90964,3.1691151950794767,0.2100353507015879
10472,0.3680357142857143,0,1,0,263486,342124,16992,90964,3.1691059320463895,0.21003583567311956
10473,0.3680476190476189,0,1,0,263487,342123,16992,90964,3.169096669013302,0.21003632064689082
10474,0.3680952380952381,0,3,0,263490,342120,16992,90964,3.169068879914039,0.21003777558164236
10475,0.3681071428571428,0,1,0,263491,342119,16992,90964,3.1690596168809515,0.2100382605643722
10476,0.3681428571428571,0,3,0,263494,342116,16992,90964,3.169031827781689,0.21003971552599981
10477,0.3681507936507935,0,2,0,263496,342114,16992,90964,3.1690133017155135,0.21004068551161684
10478,0.3681666666666665,0,1,0,263497,342113,16992,90964,3.1690040386824263,0.21004117050778498
10479,0.3681666666666666,2,12,2,263509,342101,16994,90962,3.1688928822853755,0.21004334242361966
10480,0.3681666666666667,0,6,0,263515,342095,16994,90962,3.1688373040868503,0.21004625257183235
10481,0.3682142857142857,2,6,2,263521,342089,16996,90960,3.168781725888325,0.21004551447988565
10482,0.3682222222222222,1,0,1,263521,342089,16997,90959,3.168781725888325,0.2100436903068482
10483,0.3682380952380952,0,1,0,263522,342088,16997,90959,3.1687724628552374,0.21004417534355393
10484,0.36825,0,1,0,263523,342087,16997,90959,3.1687631998221497,0.21004466038249978
10485,0.3682857142857142,0,1,0,263524,342086,16997,90959,3.168753936789062,0.21004514542368577
10486,0.3682990620490621,0,1,0,263525,342085,16997,90959,3.168744673755975,0.2100456304671119
10487,0.3683055555555555,0,1,0,263526,342084,16997,90959,3.168735410722887,0.2100461155127782
10488,0.3683095238095237,0,1,0,263527,342083,16997,90959,3.1687261476897994,0.21004660056068464
10489,0.3683217893217894,0,1,0,263528,342082,16997,90959,3.168716884656712,0.2100470856108313
10490,0.3683333333333333,44,445,44,263973,341637,17041,90915,3.16459483493275,0.2101828219497309
10491,0.3683809523809523,0,2,0,263975,341635,17041,90915,3.1645763088665753,0.21018379378106578
10492,0.3683928571428571,1,0,1,263975,341635,17042,90914,3.1645763088665753,0.21018196782329862
10493,0.3684166666666666,0,1,0,263976,341634,17042,90914,3.1645670458334876,0.2101824537392382
10494,0.3684285714285714,0,1,0,263977,341633,17042,90914,3.1645577828004003,0.21018293965742452
10495,0.3684413919413918,0,1,0,263978,341632,17042,90914,3.1645485197673127,0.2101834255778576
10496,0.368452380952381,0,1,0,263979,341631,17042,90914,3.164539256734225,0.21018391150053753
10497,0.3684722222222222,0,1,0,263980,341630,17042,90914,3.1645299937011373,0.21018439742546424
10498,0.3684999999999999,0,7,0,263987,341623,17042,90914,3.1644651524695244,0.2101877989628633
10499,0.3685,2,29,2,264016,341594,17044,90912,3.1641965245099857,0.21019824002441584
10500,0.3685000000000001,0,1,0,264017,341593,17044,90912,3.164187261476898,0.21019872602628872
10501,0.3685555555555555,0,1,0,264018,341592,17044,90912,3.1641779984438103,0.21019921203040898
10502,0.3685714285714285,1,1,1,264019,341591,17045,90911,3.164168735410723,0.21019787191735528
10503,0.3685714285714286,3,3,3,264022,341588,17048,90908,3.16414094631146,0.21019385150382894
10504,0.3685833333333333,0,1,0,264023,341587,17048,90908,3.164131683278373,0.21019433750679198
10505,0.3686190476190476,1,1,1,264024,341586,17049,90907,3.164122420245285,0.2101929973433096
10506,0.3686666666666666,0,10,0,264034,341576,17049,90907,3.1640297899144096,0.21019785748803999
10507,0.3686666666666667,2,45,2,264079,341531,17051,90905,3.1636129534254698,0.21021607821735472
10508,0.3686904761904762,0,4,0,264083,341527,17051,90905,3.1635759012931195,0.21021802271802273
10509,0.36875,2,7,2,264090,341520,17053,90903,3.1635110600615066,0.21021777287517085
10510,0.3687857142857143,1,0,1,264090,341520,17054,90902,3.1635110600615066,0.21021594645970834
10511,0.3688095238095238,0,4,0,264094,341516,17054,90902,3.1634740079291563,0.21021789102211286
10512,0.368813492063492,0,1,0,264095,341515,17054,90902,3.1634647448960687,0.2102183771683352
10513,0.3688333333333332,1,0,1,264095,341515,17055,90901,3.1634647448960687,0.2102165507289277
10514,0.3688333333333333,0,12,0,264107,341503,17055,90901,3.1633535884990183,0.21022238462178888
10515,0.3688333333333334,1,4,1,264111,341499,17056,90900,3.163316536366668,0.21022250282724983
10516,0.3688571428571429,1,1,1,264112,341498,17057,90899,3.1633072733335803,0.21022116249650205
10517,0.3688608058608059,0,1,0,264113,341497,17057,90899,3.1632980103004926,0.21022164867390078
10518,0.3688888888888889,2,1,2,264114,341496,17059,90897,3.1632887472674054,0.21021848179780894
10519,0.3689285714285714,1,3,1,264117,341493,17060,90896,3.163260958168143,0.21021811378180297
10520,0.3689404761904761,0,1,0,264118,341492,17060,90896,3.163251695135055,0.210218599961146
10521,0.3689523809523809,0,1,0,264119,341491,17060,90896,3.1632424321019674,0.21021908614273788
10522,0.3689642857142857,0,1,0,264120,341490,17060,90896,3.1632331690688797,0.21021957232657856
10523,0.3689722222222222,0,1,0,264121,341489,17060,90896,3.1632239060357925,0.21022005851266812
10524,0.3689999999999999,0,1,0,264122,341488,17060,90896,3.163214643002705,0.2102205447010065
10525,0.369,11,96,11,264218,341392,17071,90885,3.1623253918262995,0.21024713320394098
10526,0.3690119047619047,0,1,0,264219,341391,17071,90885,3.1623161287932122,0.21024761957638174
10527,0.369047619047619,0,4,0,264223,341387,17071,90885,3.162279076660862,0.2102495650886479
10528,0.3690833333333333,0,1,0,264224,341386,17071,90885,3.1622698136277743,0.21025005147234027
10529,0.3691190476190476,0,2,0,264226,341384,17071,90885,3.1622512875615993,0.21025102424647615
10530,0.3691428571428571,0,1,0,264227,341383,17071,90885,3.1622420245285117,0.2102515106369197
10531,0.3691666666666666,3,88,3,264315,341295,17074,90882,3.161426877616807,0.2102888399891711
10532,0.3691666666666667,5,96,5,264411,341199,17079,90877,3.1605376264404015,0.21032642405502736
10533,0.3691944444444444,0,1,0,264412,341198,17079,90877,3.1605283634073142,0.2103269108372389
10534,0.3692738095238095,0,1,0,264413,341197,17079,90877,3.1605191003742266,0.2103273976217037
10535,0.3692777777777777,1,0,1,264413,341197,17080,90876,3.1605191003742266,0.21032556998470167
10536,0.3692857142857143,2,7,2,264420,341190,17082,90874,3.1604542591426137,0.21032532217449268
10537,0.3693333333333333,4,56,4,264476,341134,17086,90870,3.1599355292897107,0.21034527458079091
10538,0.3693571428571428,0,4,0,264480,341130,17086,90870,3.1598984771573604,0.2103472222222222
10539,0.3694047619047619,1,2,1,264482,341128,17087,90869,3.1598799510911855,0.2103463681460751
10540,0.3694166666666667,0,1,0,264483,341127,17087,90869,3.159870688058098,0.2103468550634728
10541,0.3694285714285714,0,2,0,264485,341125,17087,90869,3.1598521619919224,0.2103478289050311
10542,0.3694444444444444,1,1,1,264486,341124,17088,90868,3.159842898958835,0.21034648789792404
10543,0.3694696969696969,0,1,0,264487,341123,17088,90868,3.1598336359257475,0.2103469748212347
10544,0.3694999999999999,1,1,1,264488,341122,17089,90867,3.15982437289266,0.21034563380086066
10545,0.3695,1,20,1,264508,341102,17090,90866,3.159639112230909,0.21035354470701534
10546,0.3695238095238095,1,3,1,264511,341099,17091,90865,3.1596113231316463,0.2103531775796131
10547,0.3695238095238096,1,3,1,264514,341096,17092,90864,3.1595835340323837,0.21035281044541163
10548,0.369547619047619,0,1,0,264515,341095,17092,90864,3.159574270999296,0.210353297419431
10549,0.3695714285714285,1,1,1,264516,341094,17093,90863,3.1595650079662083,0.21035195632898646
10550,0.3695833333333332,0,1,0,264517,341093,17093,90863,3.159555744933121,0.21035244330441064
10551,0.3695833333333334,0,1,0,264518,341092,17093,90863,3.1595464819000334,0.21035293028208957
10552,0.3696111111111111,0,1,0,264519,341091,17093,90863,3.1595372188669457,0.21035341726202328
10553,0.3696190476190476,0,1,0,264520,341090,17093,90863,3.159527955833858,0.21035390424421174
10554,0.3696428571428571,0,4,0,264524,341086,17093,90863,3.159490903701508,0.2103558521955138
10555,0.3696507936507938,0,2,0,264526,341084,17093,90863,3.159472377635333,0.21035682618469395
10556,0.3696666666666666,0,6,0,264532,341078,17093,90863,3.1594167994368076,0.21035974820635225
10557,0.3696666666666667,7,21,7,264553,341057,17100,90856,3.159222275741969,0.21035717841324525
10558,0.3697222222222222,0,1,0,264554,341056,17100,90856,3.1592130127088813,0.21035766545036952
10559,0.36975,1,2,1,264556,341054,17101,90855,3.1591944866427064,0.21035681127274494
10560,0.3697619047619047,0,1,0,264557,341053,17101,90855,3.1591852236096187,0.21035729831352973
10561,0.3697781189398834,1,8,1,264565,341045,17102,90854,3.159111119344918,0.2103593664259468
10562,0.3697857142857143,0,1,0,264566,341044,17102,90854,3.159101856311831,0.21035985348392444
10563,0.3698333333333333,2,19,2,264585,341025,17104,90852,3.158925858683167,0.21036545127432116
10564,0.3698333333333334,0,2,0,264587,341023,17104,90852,3.1589073326169923,0.21036642547033285
10565,0.3698809523809524,0,1,0,264588,341022,17104,90852,3.1588980695839046,0.2103669125717223
10566,0.3699166666666666,0,1,0,264589,341021,17104,90852,3.158888806550817,0.21036739967536752
10567,0.3699404761904761,0,1,0,264590,341020,17104,90852,3.1588795435177293,0.21036788678126853
10568,0.3699761904761905,0,1,0,264591,341019,17104,90852,3.158870280484642,0.2103683738894253
10569,0.3699999999999999,1,21,1,264612,340998,17105,90851,3.1586757567898034,0.21037677521541095
10570,0.37,340,3854,340,268466,337144,17445,90511,3.1229760272703695,0.21164490067928587
10571,0.3700238095238095,0,1,0,268467,337143,17445,90511,3.122966764237282,0.21164539557679807
10572,0.3701190476190475,0,1,0,268468,337142,17445,90511,3.122957501204194,0.21164589047662474
10573,0.3701309523809524,0,1,0,268469,337141,17445,90511,3.122948238171107,0.2116463853787659
10574,0.3701428571428571,0,1,0,268470,337140,17445,90511,3.122938975138019,0.2116468802832216
10575,0.3701666666666666,2,14,2,268484,337126,17447,90509,3.1228092926747935,0.2116501221836379
10576,0.3701666666666667,0,3,0,268487,337123,17447,90509,3.122781503575531,0.21165160698918697
10577,0.3701904761904762,0,1,0,268488,337122,17447,90509,3.122772240542443,0.21165210192899953
10578,0.3702121212121212,0,1,0,268489,337121,17447,90509,3.1227629775093555,0.21165259687112692
10579,0.3702142857142856,1,1,1,268490,337120,17448,90508,3.1227537144762683,0.2116512482812164
10580,0.3702380952380952,1,9,1,268499,337111,17449,90507,3.12267034717848,0.21165385928562408
10581,0.3703095238095238,0,1,0,268500,337110,17449,90507,3.122661084145393,0.21165435424690787
10582,0.3703106060606061,0,1,0,268501,337109,17449,90507,3.122651821112305,0.21165484921050662
10583,0.3703333333333333,2,25,2,268526,337084,17451,90505,3.122420245285116,0.21166353671399404
10584,0.3703333333333334,0,5,0,268531,337079,17451,90505,3.1223739301196782,0.21166601182457717
10585,0.3703571428571428,1,4,1,268535,337075,17452,90504,3.122336877987328,0.21166614824395025
10586,0.3703809523809523,0,2,0,268537,337073,17452,90504,3.122318351921153,0.2116671383166073
10587,0.3703809523809525,0,1,0,268538,337072,17452,90504,3.1223090888880654,0.21166763335640915
10588,0.3704166666666667,0,2,0,268540,337070,17452,90504,3.1222905628218904,0.21166862344295959
10589,0.3704761904761904,0,1,0,268541,337069,17452,90504,3.1222812997888028,0.21166911848970818
10590,0.3704761904761905,0,4,0,268545,337065,17452,90504,3.1222442476564525,0.21167109869985898
10591,0.3705,2,29,2,268574,337036,17454,90502,3.1219756196969137,0.21168176863810936
10592,0.3705000000000001,0,1,0,268575,337035,17454,90502,3.121966356663826,0.21168226375728885
10593,0.3705238095238096,0,2,0,268577,337033,17454,90502,3.1219478305976507,0.21168325400259627
10594,0.3705277777777777,0,1,0,268578,337032,17454,90502,3.1219385675645634,0.21168374912872426
10595,0.3705555555555556,0,1,0,268579,337031,17454,90502,3.1219293045314758,0.21168424425716845
10596,0.3705714285714286,1,0,1,268579,337031,17455,90501,3.1219293045314758,0.2116824003817258
10597,0.3705952380952382,0,1,0,268580,337030,17455,90501,3.121920041498388,0.21168289550933148
10598,0.3706666666666666,4,53,4,268633,336977,17459,90497,3.1214291007447477,0.21170176431782986
10599,0.3706666666666667,3,15,3,268648,336962,17462,90494,3.1212901552484347,0.21170366072765384
10600,0.3706944444444444,0,2,0,268650,336960,17462,90494,3.1212716291822593,0.21170465126072044
10601,0.3707041292041292,0,9,0,268659,336951,17462,90494,3.1211882618844715,0.21170910877422827
10602,0.3707142857142857,1,12,1,268671,336939,17463,90493,3.1210771054874207,0.21171320818282205
10603,0.3707380952380952,0,1,0,268672,336938,17463,90493,3.1210678424543334,0.21171370349834243
10604,0.37075,1,0,1,268672,336938,17464,90492,3.1210678424543334,0.21171185925180733
10605,0.3707545232545233,0,1,0,268673,336937,17464,90492,3.1210585794212458,0.2117123545664894
10606,0.3707777777777777,0,1,0,268674,336936,17464,90492,3.121049316388158,0.21171284988348915
10607,0.3708333333333333,15,143,15,268817,336793,17479,90477,3.119724702656638,0.21175603248531374
10608,0.3708571428571428,0,1,0,268818,336792,17479,90477,3.1197154396235502,0.21175652808886206
10609,0.3708571428571429,0,2,0,268820,336790,17479,90477,3.1196969135573753,0.2117575193029183
10610,0.3708888888888889,0,1,0,268821,336789,17479,90477,3.1196876505242876,0.2117580149134263
10611,0.3708993506493505,1,3,1,268824,336786,17480,90476,3.119659861425025,0.21175765689436457
10612,0.3709285714285715,0,1,0,268825,336785,17480,90476,3.1196505983919374,0.21175815251099445
10613,0.3709523809523809,2,3,2,268828,336782,17482,90474,3.1196228092926748,0.21175594959462243
10614,0.3709999999999999,2,5,2,268833,336777,17484,90472,3.119576494127237,0.21175473786948595
10615,0.371,10,92,10,268925,336685,17494,90462,3.118724295083182,0.21178189241642806
10616,0.3710238095238095,0,5,0,268930,336680,17494,90462,3.118677979917744,0.21178437147365514
10617,0.3710555555555555,0,2,0,268932,336678,17494,90462,3.1186594538515693,0.21178536311279675
10618,0.3710714285714285,0,1,0,268933,336677,17494,90462,3.1186501908184816,0.21178585893584992
10619,0.3710714285714286,0,2,0,268935,336675,17494,90462,3.1186316647523067,0.21178685058892113
10620,0.3710833333333332,1,0,1,268935,336675,17495,90461,3.1186316647523067,0.21178500524423136
10621,0.3711190476190476,0,1,0,268936,336674,17495,90461,3.118622401719219,0.21178550107108993
10622,0.3711428571428571,0,1,0,268937,336673,17495,90461,3.1186131386861313,0.21178599690027017
10623,0.3711666666666666,2,14,2,268951,336659,17497,90459,3.1184834562229056,0.21178924793616752
10624,0.3711904761904762,1,5,1,268956,336654,17498,90458,3.118437141057468,0.21178988181085992
10625,0.3712142857142856,0,1,0,268957,336653,17498,90458,3.1184278780243804,0.21179037767699732
10626,0.3712142857142857,1,0,1,268957,336653,17499,90457,3.1184278780243804,0.2117885322282316
10627,0.3712142857142858,0,1,0,268958,336652,17499,90457,3.1184186149912927,0.21178902809353117
10628,0.3712380952380952,0,1,0,268959,336651,17499,90457,3.118409351958205,0.2117895239611527
10629,0.37125,2,3,2,268962,336648,17501,90455,3.1183815628589424,0.21178732062289424
10630,0.3712857142857143,0,1,0,268963,336647,17501,90455,3.118372299825855,0.211787816493484
10631,0.3713095238095238,4,2,4,268965,336645,17505,90451,3.11835377375968,0.21178142618989643
10632,0.3713333333333332,0,4,0,268969,336641,17505,90451,3.1183167216273295,0.2117834096634917
10633,0.3713333333333333,3,13,3,268982,336628,17508,90448,3.1181963021971915,0.21178431941855783
10634,0.3713333333333334,0,9,0,268991,336619,17508,90448,3.1181129348994037,0.21178878255636704
10635,0.3713461538461539,0,1,0,268992,336618,17508,90448,3.118103671866316,0.21178927847217993
10636,0.3713571428571428,0,1,0,268993,336617,17508,90448,3.1180944088332283,0.2117897743903153
10637,0.3713571428571429,0,2,0,268995,336615,17508,90448,3.1180758827670534,0.21179076623355336
10638,0.3713809523809523,0,1,0,268996,336614,17508,90448,3.1180666197339657,0.21179126215865612
10639,0.3713939393939393,0,1,0,268997,336613,17508,90448,3.118057356700878,0.2117917580860814
10640,0.3713961038961039,0,1,0,268998,336612,17508,90448,3.118048093667791,0.21179225401582916
10641,0.3714285714285714,0,10,0,269008,336602,17508,90448,3.117955463336915,0.21179721344104907
10642,0.3714761904761904,0,2,0,269010,336600,17508,90448,3.11793693727074,0.2117982053539649
10643,0.3714880952380952,0,2,0,269012,336598,17508,90448,3.117918411204565,0.21179919727617166
10644,0.3714999999999999,0,2,0,269014,336596,17508,90448,3.1178998851383897,0.21180018920766946
10645,0.3715,6,27,6,269041,336569,17514,90442,3.117649783245026,0.21180250625862096
10646,0.3715238095238094,0,1,0,269042,336568,17514,90442,3.117640520211938,0.21180300227160956
10647,0.371547619047619,0,3,0,269045,336565,17514,90442,3.1176127311126756,0.2118044903245146
10648,0.3715555555555555,0,1,0,269046,336564,17514,90442,3.117603468079588,0.21180498634679606
10649,0.3716031746031744,0,2,0,269048,336562,17514,90442,3.117584942013413,0.21180597839832882
10650,0.3716190476190476,1,0,1,269048,336562,17515,90441,3.117584942013413,0.2118041325236591
10651,0.3716269841269841,1,0,1,269048,336562,17516,90440,3.117584942013413,0.21180228664034362
10652,0.3716666666666666,21,256,21,269304,336306,17537,90419,3.115213605542999,0.2118905618372488
10653,0.3716666666666667,17,232,17,269536,336074,17554,90402,3.1130645818666864,0.21197441356606234
10654,0.3716904761904762,0,1,0,269537,336073,17554,90402,3.1130553188335988,0.21197491060437307
10655,0.3717142857142857,0,1,0,269538,336072,17554,90402,3.1130460558005115,0.2119754076450147
10656,0.3717142857142858,0,2,0,269540,336070,17554,90402,3.113027529734336,0.21197640173329083
10657,0.3717222222222222,0,1,0,269541,336069,17554,90402,3.1130182667012485,0.21197689878092532
10658,0.3717499999999999,0,2,0,269543,336067,17554,90402,3.1129997406350736,0.2119778928831873
10659,0.3717857142857143,0,1,0,269544,336066,17554,90402,3.112990477601986,0.2119783899378148
10660,0.3718333333333333,0,15,0,269559,336051,17554,90402,3.112851532105673,0.2119858460369607
10661,0.3718939393939394,0,2,0,269561,336049,17554,90402,3.1128330060394975,0.21198684022314404
10662,0.3719047619047619,0,4,0,269565,336045,17554,90402,3.1127959539071473,0.2119888286234866
10663,0.3719285714285714,0,2,0,269567,336043,17554,90402,3.1127774278409723,0.2119898228376461
10664,0.3719365079365079,0,1,0,269568,336042,17554,90402,3.1127681648078847,0.21199031994822298
10665,0.3719444444444444,0,3,0,269571,336039,17554,90402,3.112740375708622,0.21199181129394218
10666,0.371952380952381,1,0,1,269571,336039,17555,90401,3.112740375708622,0.21198996341806584
10667,0.3719642857142856,0,2,0,269573,336037,17555,90401,3.112721849642447,0.2119909576538676
10668,0.3719999999999999,2,9,2,269582,336028,17557,90399,3.112638482344659,0.21199173598294668
10669,0.372,7,99,7,269681,335929,17564,90392,3.111721442068991,0.2120280258303016
10670,0.3720238095238095,1,1,1,269682,335928,17565,90391,3.1117121790359037,0.21202667486084364
10671,0.3720454545454545,0,1,0,269683,335927,17565,90391,3.111702916002816,0.2120271722047861
10672,0.3720555555555556,0,1,0,269684,335926,17565,90391,3.1116936529697283,0.21202766955106178
10673,0.372059163059163,1,0,1,269684,335926,17566,90390,3.1116936529697283,0.21202582122181668
10674,0.3720833333333332,0,3,0,269687,335923,17566,90390,3.1116658638704657,0.21202731326513619
10675,0.3720833333333334,0,3,0,269690,335920,17566,90390,3.111638074771203,0.2120288053294551
10676,0.3720952380952381,0,2,0,269692,335918,17566,90390,3.1116195487050278,0.2120298000506676
10677,0.3721190476190476,1,1,1,269693,335917,17567,90389,3.1116102856719405,0.21202844904833618
10678,0.3721428571428571,1,14,1,269707,335903,17568,90388,3.111480603208715,0.21203356392698883
10679,0.3721666666666666,1,2,1,269709,335901,17569,90387,3.1114620771425394,0.21203271028037382
10680,0.3721666666666667,0,11,0,269720,335890,17569,90387,3.1113601837785763,0.2120381817456724
10681,0.3721825396825396,0,1,0,269721,335889,17569,90387,3.111350920745489,0.212038679165611
10682,0.3722142857142858,0,1,0,269722,335888,17569,90387,3.1113416577124013,0.2120391765878834
10683,0.3722222222222222,0,1,0,269723,335887,17569,90387,3.1113323946793137,0.21203967401248963
10684,0.3722222222222223,0,1,0,269724,335886,17569,90387,3.1113231316462264,0.21204017143942966
10685,0.37225,1,2,1,269726,335884,17570,90386,3.111304605580051,0.21203931780327023
10686,0.3722619047619047,0,1,0,269727,335883,17570,90386,3.1112953425469634,0.21203981523404236
10687,0.3723095238095238,1,7,1,269734,335876,17571,90385,3.1112305013153505,0.2120414487837264
10688,0.3723333333333333,5,52,5,269786,335824,17576,90380,3.1107488235947978,0.21205807547559385
10689,0.3723412698412698,0,1,0,269787,335823,17576,90380,3.1107395605617105,0.21205857302740713
10690,0.3723809523809523,0,3,0,269790,335820,17576,90380,3.1107117714624475,0.21206006569685593
10691,0.3723809523809524,3,10,3,269800,335810,17579,90377,3.110619141131572,0.21205949501040622
10692,0.3723928571428571,0,1,0,269801,335809,17579,90377,3.1106098780984848,0.21205999258539698
10693,0.3724444444444444,0,1,0,269802,335808,17579,90377,3.110600615065397,0.21206049016272277
10694,0.3724761904761904,0,2,0,269804,335806,17579,90377,3.1105820889992217,0.21206148532437943
10695,0.3724761904761905,0,1,0,269805,335805,17579,90377,3.1105728259661345,0.21206198290871037
10696,0.3724999999999999,0,8,0,269813,335797,17579,90377,3.110498721701434,0.21206596366742222
10697,0.3725,51,372,51,270185,335425,17630,90326,3.1070528733928637,0.21215687103494765
10698,0.3725320512820512,0,1,0,270186,335424,17630,90326,3.107043610359776,0.21215736934820903
10699,0.372560606060606,0,1,0,270187,335423,17630,90326,3.107034347326689,0.2121578676638113
10700,0.3725833333333334,0,1,0,270188,335422,17630,90326,3.107025084293601,0.21215836598175447
10701,0.372595238095238,0,1,0,270189,335421,17630,90326,3.1070158212605135,0.21215886430203854
10702,0.3726190476190475,0,5,0,270194,335416,17630,90326,3.106969506095076,0.21216135593857313
10703,0.3726190476190477,0,1,0,270195,335415,17630,90326,3.1069602430619883,0.21216185427290302
10704,0.372642857142857,0,1,0,270196,335414,17630,90326,3.1069509800289006,0.21216235260957392
10705,0.3726666666666666,1,41,1,270237,335373,17631,90325,3.106571195672311,0.21218093578076477
10706,0.3726666666666667,1,13,1,270250,335360,17632,90324,3.106450776242173,0.2121855648791122
10707,0.3726904761904762,0,2,0,270252,335358,17632,90324,3.1064322501759976,0.21218656179965326
10708,0.3727142857142857,0,1,0,270253,335357,17632,90324,3.10642298714291,0.2121870602634367
10709,0.3727380952380952,0,1,0,270254,335356,17632,90324,3.1064137241098226,0.2121875587295621
10710,0.3727499999999999,0,1,0,270255,335355,17632,90324,3.106404461076735,0.2121880571980295
10711,0.3728333333333333,4,8,4,270263,335347,17636,90320,3.1063303568120344,0.21218464198540174
10712,0.3728571428571428,1,14,1,270277,335333,17637,90319,3.1062006743488086,0.21218977004689277
10713,0.3729166666666667,2,2,2,270279,335331,17639,90317,3.1061821482826337,0.21218706536856746
10714,0.3729285714285714,1,1,1,270280,335330,17640,90316,3.106172885249546,0.21218571301034192
10715,0.3729841269841269,0,3,0,270283,335327,17640,90316,3.1061450961502834,0.21218720852921344
10716,0.373,6,57,6,270340,335270,17646,90310,3.1056171032642927,0.21220452088913952
10717,0.373047619047619,0,1,0,270341,335269,17646,90310,3.1056078402312055,0.2122050195145907
10718,0.3730555555555556,0,1,0,270342,335268,17646,90310,3.105598577198118,0.21220551814238517
10719,0.3730714285714285,0,1,0,270343,335267,17646,90310,3.10558931416503,0.21220601677252296
10720,0.373095238095238,0,1,0,270344,335266,17646,90310,3.1055800511319425,0.21220651540500404
10721,0.3730952380952381,0,1,0,270345,335265,17646,90310,3.1055707880988552,0.21220701403982847
10722,0.3731111111111111,1,1,1,270346,335264,17647,90309,3.1055615250657675,0.212205661543378
10723,0.3731190476190476,0,1,0,270347,335263,17647,90309,3.10555226203268,0.21220616017971108
10724,0.3731428571428571,0,1,0,270348,335262,17647,90309,3.1055429989995926,0.21220665881838754
10725,0.3731666666666666,0,20,0,270368,335242,17647,90309,3.1053577383378412,0.21221663208405103
10726,0.3731666666666667,0,10,0,270378,335232,17647,90309,3.1052651080069658,0.2122216190684329
10727,0.3731904761904762,0,1,0,270379,335231,17647,90309,3.105255844973878,0.2122221177797622
10728,0.3732142857142857,1,2,1,270381,335229,17648,90308,3.105237318907703,0.21222126395589572
10729,0.3732142857142858,0,4,0,270385,335225,17648,90308,3.105200266775353,0.21222325883069
10730,0.3732222222222222,1,2,1,270387,335223,17649,90307,3.105181740709178,0.2122224050008225
10731,0.3732380952380952,0,4,0,270391,335219,17649,90307,3.1051446885768277,0.21222439991915887
10732,0.37325,0,1,0,270392,335218,17649,90307,3.10513542554374,0.21222489865460314
10733,0.3732857142857144,0,1,0,270393,335217,17649,90307,3.1051261625106523,0.2122253973923915
10734,0.3733333333333333,69,777,69,271170,334440,17718,90238,3.097928785801623,0.21248569504424528
10735,0.3733333333333334,0,2,0,271172,334438,17718,90238,3.097910259735448,0.21248669573981105
10736,0.3733571428571429,0,1,0,271173,334437,17718,90238,3.0979009967023603,0.2124871960911285
10737,0.3733809523809523,0,1,0,271174,334436,17718,90238,3.0978917336692726,0.21248769644480237
10738,0.3734166666666667,0,1,0,271175,334435,17718,90238,3.097882470636185,0.21248819680083264
10739,0.3734761904761904,0,1,0,271176,334434,17718,90238,3.0978732076030977,0.21248869715921936
10740,0.3734999999999999,0,1,0,271177,334433,17718,90238,3.09786394457001,0.2124891975199625
10741,0.3735,6,19,6,271196,334414,17724,90232,3.0976879469413463,0.21248757788840586
10742,0.3735000000000001,0,2,0,271198,334412,17724,90232,3.0976694208751714,0.21248857866824916
10743,0.373525641025641,0,2,0,271200,334410,17724,90232,3.0976508948089965,0.2124895794575195
10744,0.3735555555555555,0,2,0,271202,334408,17724,90232,3.097632368742821,0.21249058025621703
10745,0.3735714285714286,0,5,0,271207,334403,17724,90232,3.0975860535773836,0.2124930822942056
10746,0.3735786435786435,0,1,0,271208,334402,17724,90232,3.097576790544296,0.212493582708874
10747,0.3736190476190476,0,1,0,271209,334401,17724,90232,3.0975675275112082,0.21249408312589932
10748,0.3736309523809524,0,1,0,271210,334400,17724,90232,3.0975582644781205,0.21249458354528156
10749,0.3736666666666666,1,29,1,271239,334371,17725,90231,3.097289636518582,0.2125072420761089
10750,0.3736666666666667,1,3,1,271242,334368,17726,90230,3.097261847419319,0.2125068888690008
10751,0.3736785714285714,0,1,0,271243,334367,17726,90230,3.0972525843862315,0.21250738935979294
10752,0.3736904761904762,0,1,0,271244,334366,17726,90230,3.097243321353144,0.21250788985294256
10753,0.3737142857142856,1,1,1,271245,334365,17727,90229,3.097234058320056,0.21250653565523772
10754,0.37375,1,5,1,271250,334360,17728,90228,3.0971877431546186,0.21250718343429395
10755,0.3737500000000001,0,1,0,271251,334359,17728,90228,3.097178480121531,0.21250768393756755
10756,0.3737619047619047,0,1,0,271252,334358,17728,90228,3.0971692170884433,0.2125081844431988
10757,0.3737698412698412,0,1,0,271253,334357,17728,90228,3.097159954055356,0.21250868495118763
10758,0.3738095238095238,0,7,0,271260,334350,17728,90228,3.097095112823743,0.21251218857312437
10759,0.3738333333333332,0,3,0,271263,334347,17728,90228,3.09706732372448,0.21251369016074897
10760,0.3738333333333333,1,14,1,271277,334333,17729,90227,3.0969376412612544,0.21251884303749766
10761,0.3738333333333334,0,2,0,271279,334331,17729,90227,3.0969191151950795,0.21251984416734582
10762,0.3738571428571429,0,1,0,271280,334330,17729,90227,3.0969098521619918,0.21252034473580697
10763,0.3738888888888889,0,1,0,271281,334329,17729,90227,3.0969005891289045,0.2125208453066262
10764,0.3739047619047619,0,1,0,271282,334328,17729,90227,3.096891326095817,0.21252134587980356
10765,0.3739166666666667,0,1,0,271283,334327,17729,90227,3.096882063062729,0.212521846455339
10766,0.373952380952381,0,1,0,271284,334326,17729,90227,3.0968728000296415,0.2125223470332326
10767,0.3739999999999999,0,1,0,271285,334325,17729,90227,3.0968635369965543,0.21252284761348433
10768,0.374,23,135,23,271420,334190,17752,90204,3.095613027529734,0.21254777400245997
10769,0.3740476190476191,0,1,0,271421,334189,17752,90204,3.095603764496647,0.2125482748301692
10770,0.3740595238095238,0,1,0,271422,334188,17752,90204,3.0955945014635593,0.21254877566023864
10771,0.374095238095238,0,1,0,271423,334187,17752,90204,3.0955852384304716,0.2125492764926683
10772,0.3741515151515152,0,1,0,271424,334186,17752,90204,3.095575975397384,0.21254977732745822
10773,0.3741666666666666,7,57,7,271481,334129,17759,90197,3.0950479825113937,0.21256533891394824
10774,0.3741666666666667,4,64,4,271545,334065,17763,90193,3.09445514839379,0.21258998062499707
10775,0.3742142857142857,1,1,1,271546,334064,17764,90192,3.0944458853607024,0.21258862573540505
10776,0.3742380952380952,0,1,0,271547,334063,17764,90192,3.0944366223276147,0.21258912682231204
10777,0.3742698412698412,0,2,0,271549,334061,17764,90192,3.09441809626144,0.2125901290032127
10778,0.3742857142857143,0,14,0,271563,334047,17764,90192,3.094288413798214,0.21259714453409517
10779,0.3743055555555555,0,1,0,271564,334046,17764,90192,3.0942791507651264,0.2125976456611619
10780,0.3743333333333333,3,41,3,271605,334005,17767,90189,3.093899366408537,0.21261262535537984
10781,0.3743809523809524,0,2,0,271607,334003,17767,90189,3.093880840342362,0.2126136277911889
10782,0.3744047619047618,0,1,0,271608,334002,17767,90189,3.093871577309274,0.21261412901263818
10783,0.3744166666666667,0,1,0,271609,334001,17767,90189,3.0938623142761865,0.21261463023645064
10784,0.3744404761904761,0,1,0,271610,334000,17767,90189,3.093853051243099,0.21261513146262634
10785,0.3744444444444444,0,5,0,271615,333995,17767,90189,3.0938067360776613,0.21261763762895347
10786,0.374452380952381,0,1,0,271616,333994,17767,90189,3.0937974730445736,0.21261813886930878
10787,0.3744761904761904,0,1,0,271617,333993,17767,90189,3.093788210011486,0.21261864011202739
10788,0.3744761904761905,0,2,0,271619,333991,17767,90189,3.093769683945311,0.21261964260455468
10789,0.3744999999999999,0,5,0,271624,333986,17767,90189,3.093723368779873,0.21262214887723227
10790,0.3745,0,21,0,271645,333965,17767,90189,3.0935288450850345,0.2126326758677273
10791,0.3745000000000001,0,1,0,271646,333964,17767,90189,3.093519582051947,0.21263317717898966
10792,0.3745238095238095,0,3,0,271649,333961,17767,90189,3.0934917929526846,0.2126346811269598
10793,0.3745714285714285,0,2,0,271651,333959,17767,90189,3.0934732668865093,0.21263568377075925
10794,0.3745833333333334,2,2,2,271653,333957,17769,90187,3.0934547408203343,0.2126329737070429
10795,0.3745844155844155,0,1,0,271654,333956,17769,90187,3.0934454777872467,0.21263347503082686
10796,0.3746190476190476,0,2,0,271656,333954,17769,90187,3.0934269517210717,0.21263447768548666
10797,0.3746666666666666,0,11,0,271667,333943,17769,90187,3.0933250583571086,0.21263999245514348
10798,0.3746666666666667,1,38,1,271705,333905,17770,90186,3.0929730630997816,0.21265718914100984
10799,0.3747142857142858,0,2,0,271707,333903,17770,90186,3.0929545370336062,0.21265819203044645
10800,0.37475,0,2,0,271709,333901,17770,90186,3.0929360109674313,0.21265919492934232
10801,0.3747619047619047,0,2,0,271711,333899,17770,90186,3.092917484901256,0.21266019783769763
10802,0.3747619047619048,1,1,1,271712,333898,17771,90185,3.0929082218681687,0.21265884272654173
10803,0.3747777777777777,0,1,0,271713,333897,17771,90185,3.092898958835081,0.2126593441834362
10804,0.374797619047619,1,0,1,271713,333897,17772,90184,3.092898958835081,0.21265748760260422
10805,0.3748055555555555,0,1,0,271714,333896,17772,90184,3.0928896958019934,0.21265798905866817
10806,0.3748095238095238,0,2,0,271716,333894,17772,90184,3.0928711697358184,0.21265899197789087
10807,0.3748214285714285,0,1,0,271717,333893,17772,90184,3.0928619067027308,0.21265949344104962
10808,0.3748333333333333,2,13,2,271730,333880,17774,90182,3.0927414872725927,0.21266229938075093
10809,0.3748333333333334,0,1,0,271731,333879,17774,90182,3.092732224239505,0.21266280087062947
10810,0.3748571428571429,0,1,0,271732,333878,17774,90182,3.0927229612064173,0.21266330236287317
10811,0.3748809523809524,0,3,0,271735,333875,17774,90182,3.0926951721071547,0.2126648068537956
10812,0.3748852813852814,1,4,1,271739,333871,17775,90181,3.0926581199748044,0.21266495618461886
10813,0.3748888888888889,0,1,0,271740,333870,17775,90181,3.092648856941717,0.21266545769258885
10814,0.3749166666666667,0,2,0,271742,333868,17775,90181,3.092630330875542,0.21266646071562484
10815,0.3749523809523809,0,1,0,271743,333867,17775,90181,3.092621067842454,0.21266696223069087
10816,0.3749761904761904,0,1,0,271744,333866,17775,90181,3.092611804809367,0.21266746374812226
10817,0.3749761904761905,1,1,1,271745,333865,17776,90180,3.0926025417762792,0.21266610854980014
10818,0.3749999999999999,1,14,1,271759,333851,17777,90179,3.0924728593130535,0.21267127325896754
10819,0.375,128,1499,128,273258,332352,17905,90051,3.0785875727148095,0.2131874063394436
10820,0.3750238095238095,1,0,1,273258,332352,17906,90050,3.0785875727148095,0.21318554362905479
10821,0.3750476190476191,1,0,1,273258,332352,17907,90049,3.0785875727148095,0.21318368090984632
10822,0.3750555555555556,0,1,0,273259,332351,17907,90049,3.0785783096817223,0.21318418560606062
10823,0.3750833333333333,0,1,0,273260,332350,17907,90049,3.0785690466486346,0.21318469030466455
10824,0.3751111111111111,0,1,0,273261,332349,17907,90049,3.078559783615547,0.21318519500565816
10825,0.3751428571428571,0,4,0,273265,332345,17907,90049,3.0785227314831967,0.21318721383352984
10826,0.3751666666666666,1,20,1,273285,332325,17908,90048,3.0783374708214457,0.21319544573161636
10827,0.3751666666666667,0,1,0,273286,332324,17908,90048,3.078328207788358,0.21319595048914228
10828,0.3751904761904762,0,1,0,273287,332323,17908,90048,3.078318944755271,0.21319645524905828
10829,0.3752380952380952,0,3,0,273290,332320,17908,90048,3.078291155656008,0.2131979695431472
10830,0.3752619047619048,1,0,1,273290,332320,17909,90047,3.078291155656008,0.21319610670341196
10831,0.3752857142857142,0,1,0,273291,332319,17909,90047,3.0782818926229205,0.21319661146967323
10832,0.3752857142857143,0,1,0,273292,332318,17909,90047,3.078272629589833,0.21319711623832469
10833,0.3753333333333333,5,30,5,273322,332288,17914,90042,3.0779947385972064,0.21320294556389552
10834,0.3753333333333334,1,6,1,273328,332282,17915,90041,3.0779391603986808,0.21320411154495492
10835,0.3753571428571428,0,9,0,273337,332273,17915,90041,3.077855793100893,0.21320865517127066
10836,0.3753928571428571,0,1,0,273338,332272,17915,90041,3.0778465300678053,0.21320916003059343
10837,0.3754166666666666,1,1,1,273339,332271,17916,90040,3.077837267034718,0.2132078018332461
10838,0.3754444444444444,0,1,0,273340,332270,17916,90040,3.0778280040016304,0.21320830669413465
10839,0.3754523809523809,0,2,0,273342,332268,17916,90040,3.077809477935455,0.21320931642308458
10840,0.3754545454545455,0,2,0,273344,332266,17916,90040,3.07779095186928,0.21321032616159846
10841,0.3754761904761905,0,7,0,273351,332259,17916,90040,3.077726110637667,0.2132138603217152
10842,0.3754999999999999,4,24,4,273375,332235,17920,90036,3.077503797843566,0.21321852554402268
10843,0.3755238095238095,0,1,0,273376,332234,17920,90036,3.0774945348104783,0.2132190304781301
10844,0.3755555555555556,0,1,0,273377,332233,17920,90036,3.0774852717773906,0.21321953541462907
10845,0.3755833333333333,0,1,0,273378,332232,17920,90036,3.0774760087443034,0.21322004035351957
10846,0.3756666666666666,2,34,2,273412,332198,17922,90034,3.0771610656193262,0.21323348301407757
10847,0.3756666666666667,4,5,4,273417,332193,17926,90030,3.0771147504538887,0.2132285545789784
10848,0.3757142857142856,3,7,3,273424,332186,17929,90027,3.077049909222276,0.2132264994209084
10849,0.3757142857142858,0,1,0,273425,332185,17929,90027,3.077040646189188,0.21322700444326548
10850,0.3757380952380952,0,1,0,273426,332184,17929,90027,3.0770313831561005,0.2132275094680148
10851,0.3757543859649122,0,1,0,273427,332183,17929,90027,3.0770221201230132,0.21322801449515644
10852,0.3757738095238095,0,2,0,273429,332181,17929,90027,3.077003594056838,0.21322902455661663
10853,0.3757857142857142,0,1,0,273430,332180,17929,90027,3.07699433102375,0.21322952959093525
10854,0.3758095238095237,0,1,0,273431,332179,17929,90027,3.076985067990663,0.21323003462764623
10855,0.3758333333333333,11,160,11,273591,332019,17940,90016,3.075502982696654,0.21329036691269682
10856,0.3758333333333334,0,2,0,273593,332017,17940,90016,3.075484456630479,0.2132913776884746
10857,0.3759047619047619,0,1,0,273594,332016,17940,90016,3.0754751935973914,0.21329188307995603
10858,0.3759166666666667,0,1,0,273595,332015,17940,90016,3.075465930564304,0.2132923884738325
10859,0.3759523809523808,0,2,0,273597,332013,17940,90016,3.075447404498129,0.21329339926877064
10860,0.3759523809523809,0,2,0,273599,332011,17940,90016,3.075428878431954,0.21329441007328914
10861,0.3759999999999999,0,5,0,273604,332006,17940,90016,3.075382563266516,0.21329693712650052
10862,0.376,13,146,13,273750,331860,17953,90003,3.074030160435733,0.21334651296747997
10863,0.3760000000000001,0,3,0,273753,331857,17953,90003,3.0740023713364706,0.21334803015218318
10864,0.3760238095238095,0,1,0,273754,331856,17953,90003,3.073993108303383,0.21334853588521283
10865,0.3760476190476191,0,1,0,273755,331855,17953,90003,3.0739838452702952,0.2133490416206401
10866,0.3760714285714285,0,1,0,273756,331854,17953,90003,3.0739745822372075,0.21334954735846506
10867,0.3760714285714286,1,1,1,273757,331853,17954,90002,3.0739653192041203,0.21334818835855923
10868,0.3760833333333332,1,0,1,273757,331853,17955,90001,3.0739653192041203,0.21334632360959005
10869,0.3760833333333333,0,1,0,273758,331852,17955,90001,3.0739560561710326,0.21334682934576737
10870,0.3761111111111111,0,1,0,273759,331851,17955,90001,3.073946793137945,0.21334733508434237
10871,0.3761190476190476,0,1,0,273760,331850,17955,90001,3.0739375301048577,0.2133478408253151
10872,0.3761428571428571,0,1,0,273761,331849,17955,90001,3.07392826707177,0.21334834656868557
10873,0.3761666666666666,2,5,2,273766,331844,17957,89999,3.073881951906332,0.21334714573905458
10874,0.3761666666666667,0,2,0,273768,331842,17957,89999,3.073863425840157,0.21334815724408013
10875,0.3761904761904762,1,1,1,273769,331841,17958,89998,3.0738541628070695,0.2133467981860378
10876,0.3761926406926406,0,2,0,273771,331839,17958,89998,3.0738356367408946,0.21334780969900696
10877,0.3762142857142857,1,1,1,273772,331838,17959,89997,3.073826373707807,0.21334645062642976
10878,0.3762142857142858,0,1,0,273773,331837,17959,89997,3.073817110674719,0.21334695638568726
10879,0.37625,2,4,2,273777,331833,17961,89995,3.073780058542369,0.21334524972263577
10880,0.3762500000000001,0,1,0,273778,331832,17961,89995,3.0737707955092817,0.21334575548743917
10881,0.3762857142857143,0,1,0,273779,331831,17961,89995,3.073761532476194,0.21334626125464054
10882,0.3763333333333332,1,8,1,273787,331823,17962,89994,3.0736874282114934,0.21334844257106755
10883,0.3763333333333333,1,24,1,273811,331799,17963,89993,3.073465115417392,0.21335871709278506
10884,0.3763333333333334,0,9,0,273820,331790,17963,89993,3.0733817481196044,0.21336326973823033
10885,0.3763571428571428,0,1,0,273821,331789,17963,89993,3.0733724850865167,0.2133637755997174
10886,0.3763863636363636,0,1,0,273822,331788,17963,89993,3.073363222053429,0.21336428146360314
10887,0.3763888888888889,0,1,0,273823,331787,17963,89993,3.073353959020342,0.21336478732988762
10888,0.3764166666666667,1,1,1,273824,331786,17964,89992,3.073344695987254,0.21336342815414744
10889,0.3764285714285714,1,5,1,273829,331781,17965,89991,3.073298380821816,0.2133640924480525
10890,0.3764523809523809,0,3,0,273832,331778,17965,89991,3.0732705917225536,0.2133656100851414
10891,0.3764761904761904,0,2,0,273834,331776,17965,89991,3.0732520656563787,0.21336662185519492
10892,0.3764960317460317,0,1,0,273835,331775,17965,89991,3.073242802623291,0.21336712774382002
10893,0.3765,0,26,0,273861,331749,17965,89991,3.0730019637630144,0.21338028169014084
10894,0.3765476190476191,0,2,0,273863,331747,17965,89991,3.0729834376968395,0.21338129359934366
10895,0.3765555555555556,0,1,0,273864,331746,17965,89991,3.072974174663752,0.21338179955754416
10896,0.3765714285714285,0,1,0,273865,331745,17965,89991,3.0729649116306645,0.21338230551814405
10897,0.3765912698412698,0,3,0,273868,331742,17965,89991,3.0729371225314015,0.21338382341434034
10898,0.3766190476190476,0,1,0,273869,331741,17965,89991,3.0729278594983143,0.21338432938453805
10899,0.3766428571428571,0,1,0,273870,331740,17965,89991,3.0729185964652266,0.21338483535713523
10900,0.3766666666666666,45,439,45,274309,331301,18010,89946,3.06885212493979,0.21352318236094264
10901,0.3766666666666667,36,382,36,274691,330919,18046,89910,3.0653136463003445,0.21364972471003663
10902,0.3766904761904762,0,2,0,274693,330917,18046,89910,3.0652951202341696,0.2136507400903459
10903,0.3767023809523809,0,2,0,274695,330915,18046,89910,3.0652765941679943,0.21365175548030654
10904,0.3767380952380951,0,2,0,274697,330913,18046,89910,3.0652580681018193,0.21365277087991863
10905,0.3767619047619048,0,1,0,274698,330912,18046,89910,3.0652488050687317,0.21365327858334401
10906,0.3767857142857143,2,4,2,274702,330908,18048,89908,3.0652117529363814,0.21365157218356717
10907,0.3768095238095238,0,1,0,274703,330907,18048,89908,3.065202489903294,0.21365207989258939
10908,0.3768333333333333,1,17,1,274720,330890,18049,89907,3.0650450183408053,0.2136588426248286
10909,0.3769047619047619,0,5,0,274725,330885,18049,89907,3.064998703175368,0.21366138139508356
10910,0.3769444444444444,0,1,0,274726,330884,18049,89907,3.06498944014228,0.21366188915637455
10911,0.3769999999999999,1,6,1,274732,330878,18050,89906,3.064933861943755,0.21366306703676946
10912,0.377,3,58,3,274790,330820,18053,89903,3.0643966060246766,0.21368691514369312
10913,0.3770000000000001,0,1,0,274791,330819,18053,89903,3.0643873429915893,0.2136874230489492
10914,0.3770238095238095,1,3,1,274794,330816,18054,89902,3.0643595538923263,0.21368707780508558
10915,0.3770454545454545,0,1,0,274795,330815,18054,89902,3.064350290859239,0.21368758571676447
10916,0.377047619047619,0,4,0,274799,330811,18054,89902,3.0643132387268888,0.2136896173876253
10917,0.3770714285714285,0,1,0,274800,330810,18054,89902,3.064303975693801,0.2136901253113769
10918,0.3770732959850607,0,1,0,274801,330809,18054,89902,3.0642947126607134,0.21369063323754312
10919,0.3770833333333332,0,2,0,274803,330807,18054,89902,3.0642761865945385,0.21369164909711938
10920,0.3770833333333334,0,2,0,274805,330805,18054,89902,3.0642576605283636,0.21369266496635425
10921,0.377111111111111,1,0,1,274805,330805,18055,89901,3.0642576605283636,0.213690795947764
10922,0.3771153846153847,0,1,0,274806,330804,18055,89901,3.064248397495276,0.21369130388276822
10923,0.3771190476190476,0,1,0,274807,330803,18055,89901,3.064239134462188,0.21369181182018712
10924,0.3771428571428571,3,14,3,274821,330789,18058,89898,3.0641094519989625,0.21369331593322352
10925,0.3771666666666666,0,1,0,274822,330788,18058,89898,3.0641001889658748,0.21369382389715846
10926,0.3771666666666667,2,8,2,274830,330780,18060,89896,3.0640260847011747,0.21369414941665318
10927,0.3772222222222222,2,3,2,274833,330777,18062,89894,3.063998295601912,0.21369193502761066
10928,0.37725,0,1,0,274834,330776,18062,89894,3.0639890325688244,0.21369244300758314
10929,0.3772696192696192,0,1,0,274835,330775,18062,89894,3.0639797695357367,0.21369295098997074
10930,0.3773095238095237,0,1,0,274836,330774,18062,89894,3.063970506502649,0.21369345897477346
10931,0.3773095238095238,0,1,0,274837,330773,18062,89894,3.063961243469562,0.2136939669619913
10932,0.3773181818181818,0,1,0,274838,330772,18062,89894,3.063951980436474,0.21369447495162433
10933,0.3773333333333333,7,54,7,274892,330718,18069,89887,3.063451776649746,0.21370882419372095
10934,0.3773333333333334,0,1,0,274893,330717,18069,89887,3.0634425136166588,0.2137093322935588
10935,0.3773809523809524,0,4,0,274897,330713,18069,89887,3.0634054614843085,0.21371136471707086
10936,0.3774166666666667,1,1,1,274898,330712,18070,89886,3.063396198451221,0.2137100033761454
10937,0.3774246031746033,0,1,0,274899,330711,18070,89886,3.063386935418133,0.21371051148724313
10938,0.3774285714285714,0,1,0,274900,330710,18070,89886,3.063377672385046,0.21371101960075703
10939,0.3774761904761904,0,2,0,274902,330708,18070,89886,3.0633591463188705,0.21371203583503331
10940,0.3774999999999999,1,4,1,274906,330704,18071,89885,3.0633220941865202,0.21371219884495316
10941,0.3775,42,432,42,275338,330272,18113,89843,3.059320463892697,0.21385334967806435
10942,0.377547619047619,0,1,0,275339,330271,18113,89843,3.0593112008596095,0.21385385871453938
10943,0.3775555555555556,0,1,0,275340,330270,18113,89843,3.059301937826522,0.21385436775343777
10944,0.3775569985569986,1,1,1,275341,330269,18114,89842,3.059292674793434,0.21385300551520908
10945,0.3775604395604396,0,2,0,275343,330267,18114,89842,3.0592741487272592,0.2138540235986375
10946,0.3776071428571428,0,1,0,275344,330266,18114,89842,3.0592648856941715,0.2138545326439868
10947,0.3776190476190476,0,5,0,275349,330261,18114,89842,3.059218570528734,0.2138570779070847
10948,0.3776428571428571,0,2,0,275351,330259,18114,89842,3.0592000444625587,0.2138580960292882
10949,0.3776666666666666,3,24,3,275375,330235,18117,89839,3.0589777316684574,0.2138647000290425
10950,0.3776666666666667,0,8,0,275383,330227,18117,89839,3.058903627403757,0.21386877300233773
10951,0.3777142857142857,1,1,1,275384,330226,18118,89838,3.0588943643706696,0.2138674106802773
10952,0.3777142857142858,0,2,0,275386,330224,18118,89838,3.0588758383044943,0.21386842894620317
10953,0.3777222222222222,1,0,1,275386,330224,18119,89837,3.0588758383044943,0.21386655747617608
10954,0.3777380952380952,0,1,0,275387,330223,18119,89837,3.058866575271407,0.21386706660953198
10955,0.37775,0,2,0,275389,330221,18119,89837,3.0588480492052317,0.21386808488351608
10956,0.3777777777777777,0,7,0,275396,330214,18119,89837,3.058783207973619,0.21387164891882177
10957,0.3777857142857143,0,3,0,275399,330211,18119,89837,3.058755418874356,0.21387317639888775
10958,0.3778333333333333,1,8,1,275407,330203,18120,89836,3.0586813146096556,0.21387537823868735
10959,0.3778333333333334,0,4,0,275411,330199,18120,89836,3.0586442624773054,0.21387741497732332
10960,0.3778484848484848,1,0,1,275411,330199,18121,89835,3.0586442624773054,0.21387554340839074
10961,0.3778571428571428,1,7,1,275418,330192,18122,89834,3.0585794212456925,0.21387723617109416
10962,0.3778571428571429,0,1,0,275419,330191,18122,89834,3.0585701582126053,0.21387774537229925
10963,0.3778968253968255,0,1,0,275420,330190,18122,89834,3.0585608951795176,0.213878254575929
10964,0.377984126984127,1,0,1,275420,330190,18123,89833,3.0585608951795176,0.21387638295998077
10965,0.3779999999999999,8,97,8,275517,330093,18131,89825,3.057662380970025,0.21391081115836902
10966,0.378,2,5,2,275522,330088,18133,89823,3.057616065804587,0.2139096141801477
10967,0.378047619047619,0,2,0,275524,330086,18133,89823,3.057597539738412,0.2139106330181063
10968,0.3780476190476191,0,1,0,275525,330085,18133,89823,3.0575882767053244,0.21391114244072512
10969,0.3780833333333333,0,1,0,275526,330084,18133,89823,3.0575790136722367,0.21391165186577027
10970,0.3780833333333334,0,1,0,275527,330083,18133,89823,3.0575697506391495,0.2139121612932418
10971,0.3780952380952381,0,4,0,275531,330079,18133,89823,3.057532698506799,0.21391419902739212
10972,0.3781190476190476,0,1,0,275532,330078,18133,89823,3.0575234354737115,0.21391470846699578
10973,0.3781428571428571,0,3,0,275535,330075,18133,89823,3.057495646374449,0.2139162368003658
10974,0.3781645021645021,0,2,0,275537,330073,18133,89823,3.0574771203082736,0.2139172557014118
10975,0.3781666666666665,0,2,0,275539,330071,18133,89823,3.0574585942420986,0.21391827461216403
10976,0.3781666666666666,1,17,1,275556,330054,18134,89822,3.0573011226796103,0.21392506359020283
10977,0.3781666666666667,3,2,3,275558,330052,18137,89819,3.057282596613435,0.21392046604790518
10978,0.3781904761904762,0,1,0,275559,330051,18137,89819,3.0572733335803477,0.2139209755400481
10979,0.3782095959595959,0,1,0,275560,330050,18137,89819,3.05726407054726,0.21392148503461794
10980,0.3782142857142856,0,4,0,275564,330046,18137,89819,3.0572270184149097,0.21392352303716672
10981,0.378218253968254,0,4,0,275568,330042,18137,89819,3.0571899662825595,0.21392556107854743
10982,0.3782380952380953,0,2,0,275570,330040,18137,89819,3.0571714402163845,0.2139265801138001
10983,0.37825,1,1,1,275571,330039,18138,89818,3.057162177183297,0.21392521739544654
10984,0.3782777777777777,0,1,0,275572,330038,18138,89818,3.057152914150209,0.21392572691589498
10985,0.3782857142857142,0,2,0,275574,330036,18138,89818,3.0571343880840343,0.2139267459640732
10986,0.3783333333333333,48,452,48,276026,329584,18186,89770,3.05294749712846,0.2140673512116255
10987,0.3783333333333334,1,1,1,276027,329583,18187,89769,3.052938234095372,0.21406598752360786
10988,0.3783412698412697,1,2,1,276029,329581,18188,89768,3.052919708029197,0.21406513429148513
10989,0.3783849206349206,0,1,0,276030,329580,18188,89768,3.0529104449961095,0.21406564476282228
10990,0.3783888888888889,0,1,0,276031,329579,18188,89768,3.052901181963022,0.21406615523659403
10991,0.3783928571428571,0,1,0,276032,329578,18188,89768,3.0528919189299346,0.21406666571280042
10992,0.3784166666666667,2,0,2,276032,329578,18190,89766,3.0528919189299346,0.21406291731847837
10993,0.3784206349206349,0,1,0,276033,329577,18190,89766,3.052882655896847,0.21406342779061532
10994,0.3784523809523809,0,6,0,276039,329571,18190,89766,3.0528270776983217,0.21406649067456485
10995,0.378452380952381,1,0,1,276039,329571,18191,89765,3.0528270776983217,0.2140646164412309
10996,0.3784761904761904,0,1,0,276040,329570,18191,89765,3.052817814665234,0.21406512692715848
10997,0.3784999999999999,1,3,1,276043,329567,18192,89764,3.0527900255659715,0.21406478414426788
10998,0.3785,2,23,2,276066,329544,18194,89762,3.0525769758049575,0.21407277739884475
10999,0.3785357142857142,0,1,0,276067,329543,18194,89762,3.0525677127718702,0.2140732879407591
11000,0.3785555555555555,1,1,1,276068,329542,18195,89761,3.0525584497387825,0.2140719241216972
11001,0.3785714285714285,0,2,0,276070,329540,18195,89761,3.052539923672607,0.21407294521119674
11002,0.3785714285714286,0,5,0,276075,329535,18195,89761,3.0524936085071697,0.2140754979775624
11003,0.3785833333333333,0,2,0,276077,329533,18195,89761,3.0524750824409943,0.21407651910115574
11004,0.3786111111111111,1,0,1,276077,329533,18196,89760,3.0524750824409943,0.21407464469952991
11005,0.3786212121212121,0,1,0,276078,329532,18196,89760,3.052465819407907,0.2140751552617269
11006,0.3786666666666666,1,28,1,276106,329504,18197,89759,3.0522064544814556,0.214087577487162
11007,0.3786666666666667,0,2,0,276108,329502,18197,89759,3.05218792841528,0.21408859874875077
11008,0.3786785714285715,0,1,0,276109,329501,18197,89759,3.052178665382193,0.21408910938319897
11009,0.3786904761904762,0,1,0,276110,329500,18197,89759,3.0521694023491053,0.21408962002008305
11010,0.3787142857142857,0,1,0,276111,329499,18197,89759,3.0521601393160176,0.21409013065940305
11011,0.3787222222222223,0,2,0,276113,329497,18197,89759,3.0521416132498427,0.2140911519453508
11012,0.3787380952380952,0,1,0,276114,329496,18197,89759,3.052132350216755,0.21409166259197862
11013,0.37875,1,7,1,276121,329489,18198,89758,3.052067508985142,0.21409336262394246
11014,0.3787619047619047,1,0,1,276121,329489,18199,89757,3.052067508985142,0.21409148805236067
11015,0.3787777777777778,0,1,0,276122,329488,18199,89757,3.0520582459520544,0.21409199871197032
11016,0.3787857142857143,0,2,0,276124,329486,18199,89757,3.0520397198858795,0.21409302003849795
11017,0.3788095238095238,0,1,0,276125,329485,18199,89757,3.052030456852792,0.21409353070541595
11018,0.3788333333333332,0,6,0,276131,329479,18199,89757,3.0519748786542666,0.21409659475808376
11019,0.3788333333333333,0,11,0,276142,329468,18199,89757,3.0518729852903035,0.21410221241576718
11020,0.3788333333333334,1,1,1,276143,329467,18200,89756,3.051863722257216,0.2141008484744396
11021,0.3788571428571428,0,2,0,276145,329465,18200,89756,3.051845196191041,0.21410186989678476
11022,0.3788636363636364,1,0,1,276145,329465,18201,89755,3.051845196191041,0.21409999522923526
11023,0.3788809523809524,1,0,1,276145,329465,18202,89754,3.051845196191041,0.21409812055274213
11024,0.3788888888888888,0,1,0,276146,329464,18202,89754,3.051835933157953,0.21409863126106227
11025,0.3788928571428572,0,1,0,276147,329463,18202,89754,3.0518266701248655,0.2140991419718189
11026,0.3788953823953824,0,1,0,276148,329462,18202,89754,3.0518174070917783,0.21409965268501202
11027,0.378904761904762,0,1,0,276149,329461,18202,89754,3.0518081440586906,0.21410016340064167
11028,0.3789404761904762,1,0,1,276149,329461,18203,89753,3.0518081440586906,0.21409828870219028
11029,0.3789523809523809,0,1,0,276150,329460,18203,89753,3.051798881025603,0.2140987994170028
11030,0.3789761904761904,0,2,0,276152,329458,18203,89753,3.051780354959428,0.21409982085393753
11031,0.379,12,78,12,276230,329380,18215,89741,3.0510578383785987,0.2141171642556684
11032,0.379030303030303,0,1,0,276231,329379,18215,89741,3.051048575345511,0.2141176751288414
11033,0.3790476190476189,0,5,0,276236,329374,18215,89741,3.0510022601800735,0.21412022953127424
11034,0.3790476190476191,3,6,3,276242,329368,18218,89738,3.050946681981548,0.21411766951558794
11035,0.3790833333333333,0,1,0,276243,329367,18218,89738,3.0509374189484606,0.21411818040825092
11036,0.3791071428571428,0,1,0,276244,329366,18218,89738,3.050928155915373,0.2141186913033519
11037,0.3791111111111111,0,1,0,276245,329365,18218,89738,3.0509188928822852,0.21411920220089095
11038,0.3791190476190476,1,0,1,276245,329365,18219,89737,3.0509188928822852,0.21411732704687642
11039,0.3791428571428571,0,1,0,276246,329364,18219,89737,3.050909629849198,0.21411783794359832
11040,0.3791666666666666,8,82,8,276328,329282,18227,89729,3.0501500611360184,0.21414473605704862
11041,0.3791666666666667,7,76,7,276404,329206,18234,89722,3.0494460706213644,0.21417045411144636
11042,0.3791904761904762,0,2,0,276406,329204,18234,89722,3.049427544555189,0.21417147658536353
11043,0.37925,0,3,0,276409,329201,18234,89722,3.0493997554559265,0.21417301031454467
11044,0.3792857142857143,3,13,3,276422,329188,18237,89719,3.0492793360257884,0.21417402908044028
11045,0.3793333333333333,2,51,2,276473,329137,18239,89717,3.048806921338323,0.2141963548157592
11046,0.3794047619047619,0,1,0,276474,329136,18239,89717,3.0487976583052356,0.2141968662036562
11047,0.3794166666666666,0,1,0,276475,329135,18239,89717,3.048788395272148,0.21419737759399501
11048,0.3794444444444444,0,3,0,276478,329132,18239,89717,3.0487606061728854,0.21419891177966283
11049,0.379452380952381,0,1,0,276479,329131,18239,89717,3.0487513431397977,0.21419942317976928
11050,0.379484126984127,0,2,0,276481,329129,18239,89717,3.0487328170736228,0.21420044598730797
11051,0.3794999999999999,0,4,0,276485,329125,18239,89717,3.0486957649412725,0.21420249163168928
11052,0.3795,0,25,0,276510,329100,18239,89717,3.0484641891140836,0.21421527779435887
11053,0.3795238095238095,0,4,0,276514,329096,18239,89717,3.0484271369817333,0.21421732372204302
11054,0.3795833333333333,1,4,1,276518,329092,18240,89716,3.048390084849383,0.2142174934576226
11055,0.3795952380952381,0,1,0,276519,329091,18240,89716,3.0483808218162953,0.21421800495216173
11056,0.3796190476190476,0,2,0,276521,329089,18240,89716,3.0483622957501204,0.21421902794856795
11057,0.3796428571428571,0,5,0,276526,329084,18240,89716,3.0483159805846824,0.21422158548233047
11058,0.3796547619047619,0,2,0,276528,329082,18240,89716,3.0482974545185075,0.21422260851293465
11059,0.3796666666666666,0,2,0,276530,329080,18240,89716,3.0482789284523326,0.21422363155330995
11060,0.3796666666666667,5,20,5,276550,329060,18245,89711,3.048093667790581,0.2142244806827598
11061,0.3796825396825395,1,1,1,276551,329059,18246,89710,3.048084404757494,0.21422311584668396
11062,0.3796904761904762,0,3,0,276554,329056,18246,89710,3.048056615658231,0.21422465052081593
11063,0.3797142857142856,0,5,0,276559,329051,18246,89710,3.0480103004927934,0.2142272083598998
11064,0.3797222222222222,0,1,0,276560,329050,18246,89710,3.0480010374597057,0.21422771993504633
11065,0.3797380952380954,0,1,0,276561,329049,18246,89710,3.047991774426618,0.21422823151263615
11066,0.37975,0,1,0,276562,329048,18246,89710,3.047982511393531,0.2142287430926693
11067,0.3797619047619047,0,2,0,276564,329046,18246,89710,3.0479639853273555,0.21422976626006554
11068,0.3798095238095238,0,1,0,276565,329045,18246,89710,3.0479547222942682,0.21423027784742868
11069,0.3798333333333332,0,5,0,276570,329040,18246,89710,3.0479084071288303,0.21423283582089553
11070,0.3798333333333333,0,16,0,276586,329024,18246,89710,3.0477601985994296,0.21424102174650256
11071,0.3798571428571429,0,2,0,276588,329022,18246,89710,3.0477416725332542,0.2142420450311894
11072,0.3799126984126984,0,1,0,276589,329021,18246,89710,3.0477324095001666,0.2142425566771985
11073,0.3799444444444445,0,1,0,276590,329020,18246,89710,3.0477231464670793,0.21424306832565138
11074,0.3799999999999999,2,22,2,276612,328998,18248,89708,3.047519359739153,0.21425057200040123
11075,0.38,375,3813,375,280425,325185,18623,89333,3.0121994145763087,0.21551054477730763
11076,0.380031746031746,0,1,0,280426,325184,18623,89333,3.0121901515432215,0.21551106468492245
11077,0.3800476190476191,1,0,1,280426,325184,18624,89332,3.0121901515432215,0.21550917214293297
11078,0.3800595238095238,1,0,1,280426,325184,18625,89331,3.0121901515432215,0.21550727959181212
11079,0.380095238095238,0,1,0,280427,325183,18625,89331,3.0121808885101338,0.2155077994953126
11080,0.3801190476190476,0,3,0,280430,325180,18625,89331,3.012153099410871,0.21550935922086506
11081,0.3801666666666666,0,19,0,280449,325161,18625,89331,3.0119771017822075,0.21551923800700618
11082,0.3801666666666667,0,3,0,280452,325158,18625,89331,3.011949312682945,0.2155207978981348
11083,0.3801904761904762,0,1,0,280453,325157,18625,89331,3.011940049649857,0.21552131786686224
11084,0.3802222222222222,0,1,0,280454,325156,18625,89331,3.01193078661677,0.21552183783809867
11085,0.3802229437229437,0,1,0,280455,325155,18625,89331,3.0119215235836823,0.21552235781184406
11086,0.3802380952380952,0,4,0,280459,325151,18625,89331,3.011884471451332,0.21552443773191599
11087,0.3802499999999999,0,1,0,280460,325150,18625,89331,3.0118752084182443,0.21552495771820662
11088,0.3802857142857142,0,1,0,280461,325149,18625,89331,3.011865945385157,0.21552547770700636
11089,0.3802857142857143,0,1,0,280462,325148,18625,89331,3.0118566823520694,0.21552599769831524
11090,0.3803030303030303,0,1,0,280463,325147,18625,89331,3.0118474193189817,0.21552651769213324
11091,0.3803333333333332,0,1,0,280464,325146,18625,89331,3.0118381562858945,0.2155270376884604
11092,0.3803333333333333,1,19,1,280483,325127,18626,89330,3.0116621586572307,0.2155350253464171
11093,0.3803333333333334,1,9,1,280492,325118,18627,89329,3.011578791359443,0.215537813037614
11094,0.3803571428571428,0,1,0,280493,325117,18627,89329,3.0115695283263553,0.21553833310009024
11095,0.3803888888888889,0,1,0,280494,325116,18627,89329,3.0115602652932676,0.21553885316507618
11096,0.3804047619047619,0,1,0,280495,325115,18627,89329,3.01155100226018,0.21553937323257183
11097,0.3804166666666666,1,3,1,280498,325112,18628,89328,3.0115232131609173,0.21553904063314352
11098,0.3804166666666667,0,1,0,280499,325111,18628,89328,3.01151395012783,0.21553956070736585
11099,0.3804285714285714,0,1,0,280500,325110,18628,89328,3.0115046870947424,0.21554008078409798
11100,0.3804761904761904,0,2,0,280502,325108,18628,89328,3.011486161028567,0.21554112094509165
11101,0.3804761904761905,0,6,0,280508,325102,18628,89328,3.011430582830042,0.21554424148830925
11102,0.3804999999999999,0,25,0,280533,325077,18628,89328,3.011199007002853,0.21555724472436386
11103,0.3805,2,6,2,280539,325071,18630,89326,3.0111434288043277,0.2155565798014947
11104,0.3805357142857143,0,1,0,280540,325070,18630,89326,3.01113416577124,0.21555709997200745
11105,0.3805714285714285,0,2,0,280542,325068,18630,89326,3.011115639705065,0.2155581403205645
11106,0.3805833333333334,0,1,0,280543,325067,18630,89326,3.0111063766719774,0.2155586604986088
11107,0.3806031746031745,1,0,1,280543,325067,18631,89325,3.0111063766719774,0.2155567675051642
11108,0.3806190476190476,1,3,1,280546,325064,18632,89324,3.011078587572715,0.21555643503190247
11109,0.3806666666666665,0,1,0,280547,325063,18632,89324,3.011069324539627,0.21555695521336335
11110,0.3806666666666666,4,47,4,280594,325016,18636,89320,3.0106339619845124,0.21557383379672537
11111,0.3806666666666667,2,8,2,280602,325008,18638,89318,3.010559857719812,0.21557420968030006
11112,0.3807070707070707,0,1,0,280603,325007,18638,89318,3.010550594686724,0.21557472998250166
11113,0.3807142857142856,1,4,1,280607,325003,18639,89317,3.010513542554374,0.21557491793782582
11114,0.3807142857142858,0,1,0,280608,325002,18639,89317,3.0105042795212866,0.2155754382492717
11115,0.3807207792207792,0,2,0,280610,325000,18639,89317,3.0104857534551113,0.21557647887969839
11116,0.3807380952380952,0,1,0,280611,324999,18639,89317,3.0104764904220236,0.21557699919867926
11117,0.3807619047619047,0,1,0,280612,324998,18639,89317,3.0104672273889364,0.21557751952017185
11118,0.3807954545454545,0,1,0,280613,324997,18639,89317,3.0104579643558487,0.21557803984417614
11119,0.3808106060606062,0,2,0,280615,324995,18639,89317,3.0104394382896738,0.21557908049972002
11120,0.3808333333333333,18,162,18,280777,324833,18657,89299,3.00893882692949,0.21562931625665246
11121,0.3808333333333334,0,1,0,280778,324832,18657,89299,3.008929563896402,0.21562983693565563
11122,0.3808571428571428,1,0,1,280778,324832,18658,89298,3.008929563896402,0.2156279429164755
11123,0.3808571428571429,0,1,0,280779,324831,18658,89298,3.0089203008633145,0.21562846359467702
11124,0.3808809523809524,0,2,0,280781,324829,18658,89298,3.0089017747971396,0.2156295049586238
11125,0.3809523809523809,2,5,2,280786,324824,18660,89296,3.0088554596317016,0.21562832029363468
11126,0.380952380952381,0,1,0,280787,324823,18660,89296,3.0088461965986144,0.21562884098532065
11127,0.3809761904761904,0,1,0,280788,324822,18660,89296,3.0088369335655267,0.2156293616795213
11128,0.3809761904761906,0,1,0,280789,324821,18660,89296,3.008827670532439,0.21562988237623668
11129,0.3809999999999999,0,2,0,280791,324819,18660,89296,3.008809144466264,0.21563092377721163
11130,0.381,14,101,14,280892,324718,18674,89282,3.0078735781244212,0.21565700483091788
11131,0.3810119047619048,0,2,0,280894,324716,18674,89282,3.007855052058246,0.21565804665723023
11132,0.3810555555555556,0,1,0,280895,324715,18674,89282,3.007845789025158,0.21565856757416116
11133,0.3810714285714286,0,3,0,280898,324712,18674,89282,3.0078179999258956,0.21566013034005324
11134,0.3810833333333333,0,1,0,280899,324711,18674,89282,3.0078087368928084,0.21566065126705042
11135,0.3810952380952381,0,1,0,280900,324710,18674,89282,3.0077994738597207,0.2156611721965642
11136,0.3811309523809523,0,1,0,280901,324709,18674,89282,3.007790210826633,0.2156616931285946
11137,0.3811428571428571,0,2,0,280903,324707,18674,89282,3.007771684760458,0.21566273500020533
11138,0.3811666666666666,2,10,2,280913,324697,18676,89280,3.0076790544295826,0.2156641552550021
11139,0.3811904761904761,0,2,0,280915,324695,18676,89280,3.0076605283634072,0.21566519717374238
11140,0.3811904761904762,0,4,0,280919,324691,18676,89280,3.007623476231057,0.2156672810414256
11141,0.3812222222222222,0,1,0,280920,324690,18676,89280,3.0076142131979697,0.21566780201463875
11142,0.3812499999999999,0,1,0,280921,324689,18676,89280,3.007604950164882,0.21566832299036884
11143,0.38125,0,6,0,280927,324683,18676,89280,3.007549371966357,0.21567144889760678
11144,0.3812500000000001,1,0,1,280927,324683,18677,89279,3.007549371966357,0.21566955421028983
11145,0.3812750305250306,0,3,0,280930,324680,18677,89279,3.007521582867094,0.21567111718793408
11146,0.3812857142857143,0,2,0,280932,324678,18677,89279,3.007503056800919,0.21567215918561589
11147,0.3813095238095238,0,1,0,280933,324677,18677,89279,3.007493793767831,0.21567268018823257
11148,0.3813095238095239,0,1,0,280934,324676,18677,89279,3.007484530734744,0.21567320119336642
11149,0.3813333333333332,1,2,1,280936,324674,18678,89278,3.0074660046685686,0.21567234848484848
11150,0.3813333333333333,3,28,3,280964,324646,18681,89275,3.007206639742117,0.21568125318599443
11151,0.3813333333333334,0,6,0,280970,324640,18681,89275,3.007151061543592,0.21568437964316345
11152,0.3813809523809523,0,1,0,280971,324639,18681,89275,3.0071417985105042,0.2156849007281706
11153,0.3813809523809524,1,0,1,280971,324639,18682,89274,3.0071417985105042,0.21568300584905523
11154,0.3814047619047618,1,0,1,280971,324639,18683,89273,3.0071417985105042,0.21568111096078393
11155,0.3814285714285714,0,6,0,280977,324633,18683,89273,3.007086220311979,0.21568423748387314
11156,0.3814444444444443,0,1,0,280978,324632,18683,89273,3.0070769572788913,0.21568475857986735
11157,0.3814761904761904,0,2,0,280980,324630,18683,89273,3.0070584312127164,0.21568580077940966
11158,0.3814999999999999,0,2,0,280982,324628,18683,89273,3.007039905146541,0.21568684298902394
11159,0.3815,6,30,6,281012,324598,18689,89267,3.0067620141539146,0.21569110700349148
11160,0.3815238095238095,0,2,0,281014,324596,18689,89267,3.0067434880877393,0.21569214933444159
11161,0.381525641025641,0,3,0,281017,324593,18689,89267,3.0067156989884767,0.21569371284975597
11162,0.3815573593073593,1,7,1,281024,324586,18690,89266,3.006650857756864,0.2156954660120043
11163,0.3815634920634921,1,2,1,281026,324584,18691,89265,3.006632331690689,0.2156946132526598
11164,0.3815714285714285,0,1,0,281027,324583,18691,89265,3.006623068657601,0.2156951344454969
11165,0.3816309523809524,1,0,1,281027,324583,18692,89264,3.006623068657601,0.21569323928891596
11166,0.3816666666666666,15,256,15,281283,324327,18707,89249,3.0042517321871873,0.21579830551095808
11167,0.3816666666666667,27,222,27,281505,324105,18734,89222,3.00219533884175,0.21586298499735077
11168,0.3816904761904762,0,1,0,281506,324104,18734,89222,3.002186075808663,0.21586350725577388
11169,0.3817142857142857,0,2,0,281508,324102,18734,89222,3.0021675497424876,0.21586455178020147
11170,0.3817142857142858,0,1,0,281509,324101,18734,89222,3.0021582867094003,0.215865074046206
11171,0.38175,0,1,0,281510,324100,18734,89222,3.0021490236763126,0.21586559631473767
11172,0.3817857142857143,1,2,1,281512,324098,18735,89221,3.0021304976101373,0.21586474369675723
11173,0.3817987012987014,0,4,0,281516,324094,18735,89221,3.0020934454777874,0.21586683280306787
11174,0.3818055555555555,1,0,1,281516,324094,18736,89220,3.0020934454777874,0.21586493561795633
11175,0.3818095238095237,0,1,0,281517,324093,18736,89220,3.0020841824446998,0.2158654578975256
11176,0.3818095238095238,0,1,0,281518,324092,18736,89220,3.002074919411612,0.21586598017962216
11177,0.3818333333333333,2,25,2,281543,324067,18738,89218,3.001843343584423,0.21587524347605164
11178,0.3818571428571428,0,2,0,281545,324065,18738,89218,3.0018248175182483,0.21587628816089702
11179,0.3819047619047619,0,2,0,281547,324063,18738,89218,3.001806291452073,0.21587733285585353
11180,0.3819087301587301,1,3,1,281550,324060,18739,89217,3.0017785023528103,0.21587700259148224
11181,0.3819166666666666,0,3,0,281553,324057,18739,89217,3.0017507132535477,0.21587856966564556
11182,0.3819277111777112,0,2,0,281555,324055,18739,89217,3.001732187187373,0.21587961439439401
11183,0.3819444444444445,0,1,0,281556,324054,18739,89217,3.001722924154285,0.21588013676256015
11184,0.3819487179487179,0,1,0,281557,324053,18739,89217,3.0017136611211974,0.2158806591332543
11185,0.3819642857142857,0,1,0,281558,324052,18739,89217,3.00170439808811,0.21588118150647642
11186,0.3819999999999999,0,8,0,281566,324044,18739,89217,3.0016302938234096,0.21588536058326335
11187,0.382,7,100,7,281666,323944,18746,89210,3.000703990514654,0.2159243284586377
11188,0.3820000000000001,0,1,0,281667,323943,18746,89210,3.0006947274815667,0.21592485108422305
11189,0.3820128205128205,0,1,0,281668,323942,18746,89210,3.000685464448479,0.2159253737123383
11190,0.3820238095238095,1,1,1,281669,323941,18747,89209,3.0006762014153914,0.21592399854774294
11191,0.3820714285714285,1,1,1,281670,323940,18748,89208,3.0006669383823037,0.21592262336983356
11192,0.3820833333333333,1,6,1,281676,323934,18749,89207,3.0006113601837785,0.2159238613451582
11193,0.382111111111111,0,2,0,281678,323932,18749,89207,3.0005928341176036,0.2159249066294879
11194,0.3821190476190477,0,1,0,281679,323931,18749,89207,3.000583571084516,0.21592542927544792
11195,0.3821428571428572,0,8,0,281687,323923,18749,89207,3.0005094668198153,0.21592961053421442
11196,0.3821547619047619,0,2,0,281689,323921,18749,89207,3.0004909407536404,0.21593065587420848
11197,0.3821634199134198,0,2,0,281691,323919,18749,89207,3.000472414687465,0.2159317012243238
11198,0.3821666666666666,0,2,0,281693,323917,18749,89207,3.00045388862129,0.21593274658456058
11199,0.3821666666666667,2,10,2,281703,323907,18751,89205,3.0003612582904147,0.21593417765642248
11200,0.3822222222222222,0,3,0,281706,323904,18751,89205,3.000333469191152,0.21593574577169705
11201,0.38225,0,1,0,281707,323903,18751,89205,3.0003242061580644,0.21593626848184977
11202,0.3822550505050505,0,1,0,281708,323902,18751,89205,3.0003149431249767,0.21593679119453313
11203,0.3822619047619047,0,1,0,281709,323901,18751,89205,3.0003056800918895,0.21593731390974713
11204,0.3822777777777777,0,1,0,281710,323900,18751,89205,3.000296417058802,0.2159378366274918
11205,0.3822857142857143,1,1,1,281711,323899,18752,89204,3.000287154025714,0.21593646136677777
11206,0.3823333333333332,1,3,1,281714,323896,18753,89203,3.0002593649264515,0.21593613153263502
11207,0.3823333333333333,4,43,4,281757,323853,18757,89199,2.9998610545036866,0.21595101827372826
11208,0.3823809523809522,0,1,0,281758,323852,18757,89199,2.9998517914705993,0.21595154109298853
11209,0.3823809523809524,1,2,1,281760,323850,18758,89198,2.999833265404424,0.2159506885398307
11210,0.3823919413919414,0,1,0,281761,323849,18758,89198,2.9998240023713363,0.21595121136335574
11211,0.3824444444444444,0,1,0,281762,323848,18758,89198,2.999814739338249,0.21595173418941233
11212,0.3824523809523809,0,1,0,281763,323847,18758,89198,2.9998054763051614,0.21595225701800047
11213,0.3824642857142857,0,4,0,281767,323843,18758,89198,2.999768424172811,0.2159543483576691
11214,0.3824999999999999,0,7,0,281774,323836,18758,89198,2.999703582941198,0.21595800829955888
11215,0.3825,46,417,46,282191,323419,18804,89152,2.995840898143688,0.2160888671283246
11216,0.3825238095238095,1,0,1,282191,323419,18805,89151,2.995840898143688,0.21608696706013525
11217,0.3825238095238096,1,0,1,282191,323419,18806,89150,2.995840898143688,0.216085066982735
11218,0.3825555555555555,0,1,0,282192,323418,18806,89150,2.9958316351106005,0.2160855907389812
11219,0.3825714285714286,1,3,1,282195,323415,18807,89149,2.995803846011338,0.21608526192299862
11220,0.3825833333333334,0,1,0,282196,323414,18807,89149,2.99579458297825,0.21608578568606493
11221,0.3826143578643579,0,1,0,282197,323413,18807,89149,2.995785319945163,0.2160863094516703
11222,0.3826190476190475,0,2,0,282199,323411,18807,89149,2.9957667938789876,0.21608735699049836
11223,0.3826190476190476,0,2,0,282201,323409,18807,89149,2.9957482678128127,0.21608840453948294
11224,0.3826428571428571,1,3,1,282204,323406,18808,89148,2.99572047871355,0.21608807574281186
11225,0.3826666666666666,5,70,5,282274,323336,18813,89143,2.9950720663974213,0.2161152446548794
11226,0.3826666666666667,0,6,0,282280,323330,18813,89143,2.9950164881988957,0.21611838835511657
11227,0.3827142857142857,0,3,0,282283,323327,18813,89143,2.994988699099633,0.21611996023953256
11228,0.3827261904761904,1,0,1,282283,323327,18814,89142,2.994988699099633,0.21611805978146237
11229,0.3827272727272727,0,1,0,282284,323326,18814,89142,2.994979436066546,0.21611858374467838
11230,0.38275,0,1,0,282285,323325,18814,89142,2.994970173033458,0.21611910771043502
11231,0.3827777777777778,0,2,0,282287,323323,18814,89142,2.9949516469672828,0.21612015564957027
11232,0.382797619047619,0,1,0,282288,323322,18814,89142,2.9949423839341955,0.21612067962294892
11233,0.3827976190476191,1,0,1,282288,323322,18815,89141,2.9949423839341955,0.2161187791389773
11234,0.3828095238095237,0,1,0,282289,323321,18815,89141,2.994933120901108,0.21611930311155936
11235,0.3828333333333333,3,10,3,282299,323311,18818,89138,2.9948404905702324,0.21611884135978024
11236,0.3828571428571428,1,18,1,282317,323293,18819,89137,2.9946737559746563,0.2161263729602599
11237,0.3828888888888888,0,1,0,282318,323292,18819,89137,2.9946644929415687,0.21612689699317944
11238,0.3829087301587301,1,0,1,282318,323292,18820,89136,2.9946644929415687,0.21612499636300153
11239,0.3829166666666666,0,2,0,282320,323290,18820,89136,2.9946459668753937,0.2161260444297886
11240,0.3829166666666667,1,1,1,282321,323289,18821,89135,2.994636703842306,0.2161246678175858
11241,0.382952380952381,0,1,0,282322,323288,18821,89135,2.9946274408092184,0.21612519185399456
11242,0.3829761904761904,0,1,0,282323,323287,18821,89135,2.994618177776131,0.2161257158929446
11243,0.3829761904761905,0,2,0,282325,323285,18821,89135,2.994599651709956,0.21612676397846856
11244,0.3829761904761906,0,1,0,282326,323284,18821,89135,2.9945903886768686,0.2161272880250425
11245,0.3829999999999999,9,47,9,282373,323237,18830,89126,2.9941550261217533,0.21613481325919154
11246,0.383,0,5,0,282378,323232,18830,89126,2.9941087109563154,0.21613743397727217
11247,0.383047619047619,1,1,1,282379,323231,18831,89125,2.994099447923228,0.21613605719329898
11248,0.3830555555555555,0,1,0,282380,323230,18831,89125,2.9940901848901404,0.21613658134374508
11249,0.3830555555555556,0,1,0,282381,323229,18831,89125,2.9940809218570528,0.2161371054967334
11250,0.3831666666666666,2,18,2,282399,323211,18833,89123,2.9939141872614767,0.21614273865361575
11251,0.3831666666666667,0,8,0,282407,323203,18833,89123,2.9938400829967766,0.21614693228173823
11252,0.3831904761904761,0,1,0,282408,323202,18833,89123,2.993830819963689,0.21614745649669556
11253,0.3831904761904762,0,2,0,282410,323200,18833,89123,2.993812293897514,0.21614850493423846
11254,0.383202380952381,0,1,0,282411,323199,18833,89123,2.9938030308644263,0.21614902915682405
11255,0.3832142857142857,1,3,1,282414,323196,18834,89122,2.9937752417651637,0.21614870076009293
11256,0.3832142857142858,1,0,1,282414,323196,18835,89121,2.9937752417651637,0.21614679967112682
11257,0.3832222222222222,0,2,0,282416,323194,18835,89121,2.9937567156989884,0.21614784812582613
11258,0.38325,1,0,1,282416,323194,18836,89120,2.9937567156989884,0.21614594702095977
11259,0.3833269230769231,0,1,0,282417,323193,18836,89120,2.993747452665901,0.2161464712487843
11260,0.3833333333333333,91,848,91,283265,322345,18927,89029,2.985892400607655,0.21641863608298045
11261,0.3833333333333334,0,1,0,283266,322344,18927,89029,2.9858831375745676,0.2164191621715572
11262,0.3833571428571429,1,0,1,283266,322344,18928,89028,2.9858831375745676,0.21641725737288878
11263,0.3833650793650794,0,4,0,283270,322340,18928,89028,2.9858460854422173,0.21641936173936718
11264,0.3833730158730158,0,2,0,283272,322338,18928,89028,2.985827559376042,0.21642041393795305
11265,0.383420634920635,0,1,0,283273,322337,18928,89028,2.9858182963429547,0.21642094004108273
11266,0.3834285714285714,0,1,0,283274,322336,18928,89028,2.985809033309867,0.21642146614677027
11267,0.3834444444444445,0,1,0,283275,322335,18928,89028,2.9857997702767793,0.21642199225501565
11268,0.3834523809523809,0,1,0,283276,322334,18928,89028,2.9857905072436917,0.2164225183658189
11269,0.3834848484848485,0,1,0,283277,322333,18928,89028,2.9857812442106044,0.2164230444791801
11270,0.3834999999999999,0,2,0,283279,322331,18928,89028,2.985762718144429,0.2164240967135762
11271,0.3835,7,22,7,283301,322309,18935,89021,2.985558931416503,0.21642233729608829
11272,0.3835238095238095,1,1,1,283302,322308,18936,89020,2.9855496683834155,0.2164209584565116
11273,0.3835555555555555,0,1,0,283303,322307,18936,89020,2.985540405350328,0.21642148460956853
11274,0.3835595238095238,0,1,0,283304,322306,18936,89020,2.98553114231724,0.21642201076518383
11275,0.3835595238095239,0,1,0,283305,322305,18936,89020,2.985521879284153,0.21642253692335744
11276,0.3835714285714285,0,1,0,283306,322304,18936,89020,2.9855126162510652,0.21642306308408943
11277,0.3835714285714286,0,3,0,283309,322301,18936,89020,2.9854848271518026,0.21642464158163574
11278,0.383611111111111,0,2,0,283311,322299,18936,89020,2.9854663010856273,0.21642569392612546
11279,0.3836363636363636,0,1,0,283312,322298,18936,89020,2.98545703805254,0.21642622010220802
11280,0.3836428571428571,0,1,0,283313,322297,18936,89020,2.9854477750194524,0.21642674628084907
11281,0.3836468253968255,0,1,0,283314,322296,18936,89020,2.9854385119863647,0.21642727246204865
11282,0.3836666666666666,7,29,7,283343,322267,18943,89013,2.985169884026826,0.2164291966543474
11283,0.3836666666666667,0,3,0,283346,322264,18943,89013,2.985142094927563,0.21643077536550792
11284,0.3836904761904762,0,2,0,283348,322262,18943,89013,2.985123568861388,0.2164318278524102
11285,0.3837142857142857,1,3,1,283351,322259,18944,89012,2.9850957797621254,0.2164315013701428
11286,0.3837222222222223,0,1,0,283352,322258,18944,89012,2.9850865167290377,0.216432027621757
11287,0.3837499999999999,0,1,0,283353,322257,18944,89012,2.98507725369595,0.21643255387593036
11288,0.38375,1,5,1,283358,322252,18945,89011,2.9850309385305125,0.21643327992063474
11289,0.3837752525252525,0,1,0,283359,322251,18945,89011,2.985021675497425,0.21643380618681035
11290,0.3837857142857143,2,0,2,283359,322251,18947,89009,2.985021675497425,0.21642999562320672
11291,0.3838095238095238,0,1,0,283360,322250,18947,89009,2.985012412464337,0.21643052188523534
11292,0.3838333333333332,0,1,0,283361,322249,18947,89009,2.98500314943125,0.21643104814982322
11293,0.3838333333333333,0,10,0,283371,322239,18947,89009,2.9849105191003744,0.21643631093646656
11294,0.3838333333333334,0,3,0,283374,322236,18947,89009,2.9848827300011114,0.21643788982236867
11295,0.3838888888888888,0,1,0,283375,322235,18947,89009,2.984873466968024,0.2164384161227884
11296,0.3839206349206349,0,1,0,283376,322234,18947,89009,2.9848642039349365,0.21643894242576772
11297,0.3839285714285714,1,1,1,283377,322233,18948,89008,2.9848549409018488,0.2164375633752471
11298,0.3839999999999999,0,2,0,283379,322231,18948,89008,2.984836414835674,0.2164386159872969
11299,0.384,9,137,9,283516,322094,18957,88999,2.983567379302679,0.21649359147443523
11300,0.3840039682539683,0,2,0,283518,322092,18957,88999,2.9835488532365035,0.21649464473802638
11301,0.3840198412698412,0,3,0,283521,322089,18957,88999,2.983521064137241,0.21649622465262913
11302,0.3840238095238095,0,1,0,283522,322088,18957,88999,2.9835118011041537,0.2164967512959544
11303,0.384047619047619,2,1,2,283523,322087,18959,88997,2.983502538071066,0.21649346605559935
11304,0.3840952380952381,1,1,1,283524,322086,18960,88996,2.9834932750379783,0.21649208673695272
11305,0.3841111111111111,0,1,0,283525,322085,18960,88996,2.9834840120048907,0.21649261337789877
11306,0.3841190476190476,0,1,0,283526,322084,18960,88996,2.9834747489718034,0.21649314002140702
11307,0.3841666666666666,6,64,6,283590,322020,18966,88990,2.9828819148542,0.2165154132502859
11308,0.3841666666666667,15,60,15,283650,321960,18981,88975,2.9823261328689465,0.21651842748853226
11309,0.3841991341991342,0,1,0,283651,321959,18981,88975,2.982316869835859,0.2165189543819689
11310,0.3842261904761905,0,1,0,283652,321958,18981,88975,2.9823076068027716,0.21651948127796988
11311,0.3842747252747252,0,1,0,283653,321957,18981,88975,2.982298343769684,0.2165200081765353
11312,0.3842777777777778,0,1,0,283654,321956,18981,88975,2.9822890807365963,0.2165205350776651
11313,0.3842857142857142,0,1,0,283655,321955,18981,88975,2.982279817703509,0.21652106198135934
11314,0.3842857142857143,1,14,1,283669,321941,18982,88974,2.9821501352402833,0.2165265322511955
11315,0.3842857142857144,1,0,1,283669,321941,18983,88973,2.9821501352402833,0.21652462559075622
11316,0.3843333333333332,0,1,0,283670,321940,18983,88973,2.9821408722071956,0.21652515252620386
11317,0.3843333333333333,6,41,6,283711,321899,18989,88967,2.981761087850606,0.2165353180842416
11318,0.3843571428571428,0,2,0,283713,321897,18989,88967,2.9817425617844306,0.21653637213287122
11319,0.3844166666666666,1,1,1,283714,321896,18990,88966,2.981733298751343,0.21653499228451403
11320,0.3844444444444444,0,3,0,283717,321893,18990,88966,2.9817055096520804,0.21653657337432064
11321,0.3844642857142857,0,1,0,283718,321892,18990,88966,2.981696246618993,0.21653710040938717
11322,0.3844761904761904,1,1,1,283719,321891,18991,88965,2.9816869835859054,0.21653572054442433
11323,0.3844999999999999,1,1,1,283720,321890,18992,88964,2.9816777205528178,0.21653434066602734
11324,0.3845,2,22,2,283742,321868,18994,88962,2.9814739338248915,0.216542122045615
11325,0.3845238095238095,0,5,0,283747,321863,18994,88962,2.981427618659454,0.21654475750015215
11326,0.3845833333333333,1,5,1,283752,321858,18995,88961,2.981381303494016,0.21654548596827314
11327,0.384631014410426,0,7,0,283759,321851,18995,88961,2.981316462262403,0.2165491757787017
11328,0.384642857142857,0,1,0,283760,321850,18995,88961,2.981307199229316,0.21654970290474207
11329,0.3846428571428572,0,3,0,283763,321847,18995,88961,2.981279410130053,0.21655128429826098
11330,0.3846666666666666,1,8,1,283771,321839,18996,88960,2.9812053058653527,0.2165535943368898
11331,0.3846666666666667,2,31,2,283802,321808,18998,88958,2.980918151839638,0.2165661228047112
11332,0.3846785714285715,0,1,0,283803,321807,18998,88958,2.980908888806551,0.21656665003103964
11333,0.3846944444444444,0,1,0,283804,321806,18998,88958,2.9808996257734632,0.21656717725993516
11334,0.3847142857142857,1,0,1,283804,321806,18999,88957,2.9808996257734632,0.21656526999754117
11335,0.3847222222222222,0,1,0,283805,321805,18999,88957,2.9808903627403756,0.21656579722564404
11336,0.38475,0,1,0,283806,321804,18999,88957,2.9808810997072883,0.21656632445631402
11337,0.3847619047619047,0,1,0,283807,321803,18999,88957,2.9808718366742006,0.2165668516895511
11338,0.3847619047619048,0,4,0,283811,321799,18999,88957,2.9808347845418504,0.2165689606481707
11339,0.3847857142857143,0,3,0,283814,321796,18999,88957,2.9808069954425878,0.21657054239409085
11340,0.3848095238095238,1,0,1,283814,321796,19000,88956,2.9808069954425878,0.21656863508881272
11341,0.3848333333333332,0,6,0,283820,321790,19000,88956,2.9807514172440626,0.21657179862981016
11342,0.3848333333333333,4,17,4,283837,321773,19004,88952,2.9805939456815738,0.21657313287479457
11343,0.3848809523809523,0,1,0,283838,321772,19004,88952,2.9805846826484865,0.2165736601708203
11344,0.3848809523809524,0,1,0,283839,321771,19004,88952,2.980575419615399,0.2165741874694137
11345,0.3848928571428571,0,1,0,283840,321770,19004,88952,2.980566156582311,0.21657471477057474
11346,0.3848968253968254,0,1,0,283841,321769,19004,88952,2.980556893549224,0.21657524207430348
11347,0.3849206349206349,0,1,0,283842,321768,19004,88952,2.9805476305161362,0.21657576938059991
11348,0.384952380952381,0,1,0,283843,321767,19004,88952,2.9805383674830486,0.2165762966894641
11349,0.3849999999999999,0,19,0,283862,321748,19004,88952,2.9803623698543853,0.2165863160457755
11350,0.385,163,1471,163,285333,320277,19167,88789,2.966736448182593,0.21705299389340596
11351,0.3850476190476191,0,2,0,285335,320275,19167,88789,2.966717922116418,0.21705405511118064
11352,0.3850952380952381,1,0,1,285335,320275,19168,88788,2.966717922116418,0.21705214111273813
11353,0.3851190476190476,1,3,1,285338,320272,19169,88787,2.9666901330171553,0.2170518189307655
11354,0.3851666666666666,2,25,2,285363,320247,19171,88785,2.9664585571899664,0.21706125682098223
11355,0.3851666666666667,0,3,0,285366,320244,19171,88785,2.966430768090704,0.21706284884445845
11356,0.3852380952380952,0,4,0,285370,320240,19171,88785,2.9663937159583535,0.21706497157875435
11357,0.3852777777777777,0,3,0,285373,320237,19171,88785,2.966365926859091,0.2170665636567226
11358,0.3852857142857142,0,2,0,285375,320235,19171,88785,2.9663474007929156,0.21706762505500954
11359,0.3852857142857143,0,3,0,285378,320232,19171,88785,2.966319611693653,0.2170692171719024
11360,0.385297619047619,2,0,2,285378,320232,19173,88783,2.966319611693653,0.21706538879992177
11361,0.3852976190476191,0,2,0,285380,320230,19173,88783,2.966301085627478,0.217066450210629
11362,0.3853253968253968,0,1,0,285381,320229,19173,88783,2.9662918225943904,0.21706698091987522
11363,0.3853333333333333,4,24,4,285405,320205,19177,88779,2.966069509800289,0.21707206149873834
11364,0.3853571428571428,1,1,1,285406,320204,19178,88778,2.9660602467672015,0.21707067792714593
11365,0.3853571428571429,0,1,0,285407,320203,19178,88778,2.966050983734114,0.21707120868695612
11366,0.3853809523809524,0,1,0,285408,320202,19178,88778,2.9660417207010266,0.21707173944936184
11367,0.3854166666666666,0,3,0,285411,320199,19178,88778,2.9660139316017635,0.21707333175215232
11368,0.3854285714285714,0,1,0,285412,320198,19178,88778,2.9660046685686763,0.21707386252494035
11369,0.3854444444444444,0,1,0,285413,320197,19178,88778,2.9659954055355886,0.217074393300324
11370,0.3854761904761905,1,5,1,285418,320192,19179,88777,2.9659490903701506,0.217075132834029
11371,0.3854999999999999,5,20,5,285438,320172,19184,88772,2.9657638297083997,0.21707617668922885
11372,0.3855,0,3,0,285441,320169,19184,88772,2.965736040609137,0.21707776916474503
11373,0.3855238095238096,1,0,1,285441,320169,19185,88771,2.965736040609137,0.2170758546486037
11374,0.3855357142857142,0,1,0,285442,320168,19185,88771,2.9657267775760494,0.2170763854755844
11375,0.3855555555555556,0,1,0,285443,320167,19185,88771,2.9657175145429617,0.21707691630516118
11376,0.3855833333333333,0,2,0,285445,320165,19185,88771,2.965698988476787,0.2170779779721032
11377,0.3855833333333334,0,1,0,285446,320164,19185,88771,2.965689725443699,0.2170785088094685
11378,0.385595238095238,0,1,0,285447,320163,19185,88771,2.965680462410612,0.21707903964942998
11379,0.3855952380952381,0,4,0,285451,320159,19185,88771,2.9656434102782616,0.2170811630352383
11380,0.3856031746031745,0,2,0,285453,320157,19185,88771,2.9656248842120863,0.21708222474372016
11381,0.3856190476190476,0,1,0,285454,320156,19185,88771,2.965615621178999,0.21708275560185558
11382,0.3856428571428572,0,1,0,285455,320155,19185,88771,2.9656063581459113,0.21708328646258737
11383,0.3856666666666666,2,31,2,285486,320124,19187,88769,2.9653192041201972,0.21709591506824524
11384,0.3856666666666667,0,7,0,285493,320117,19187,88769,2.9652543628885843,0.21709963168218036
11385,0.3857142857142857,0,17,0,285510,320100,19187,88769,2.965096891326096,0.21710865827441064
11386,0.38575,1,2,1,285512,320098,19188,88768,2.9650783652599206,0.21710780549128567
11387,0.3857857142857143,0,1,0,285513,320097,19188,88768,2.965069102226833,0.2171083364924853
11388,0.3858333333333333,16,146,16,285659,319951,19204,88752,2.96371669939605,0.21715524476208886
11389,0.3858333333333334,0,3,0,285662,319948,19204,88752,2.9636889102967876,0.2171568387570345
11390,0.3858571428571428,0,2,0,285664,319946,19204,88752,2.9636703842306127,0.2171579014333322
11391,0.3858690476190476,0,1,0,285665,319945,19204,88752,2.963661121197525,0.21715843277538127
11392,0.3858766233766234,0,2,0,285667,319943,19204,88752,2.9636425951313496,0.21715949546728
11393,0.3858809523809524,0,1,0,285668,319942,19204,88752,2.9636333320982624,0.21716002681712968
11394,0.3859047619047618,0,1,0,285669,319941,19204,88752,2.9636240690651747,0.2171605581695796
11395,0.385904761904762,0,1,0,285670,319940,19204,88752,2.963614806032087,0.21716108952462979
11396,0.3859444444444445,0,1,0,285671,319939,19204,88752,2.963605542999,0.21716162088228025
11397,0.3859523809523809,2,5,2,285676,319934,19206,88750,2.963559227833562,0.21716044670209747
11398,0.3859999999999999,1,13,1,285689,319921,19207,88749,2.9634388084034238,0.21716543910734823
11399,0.386,14,138,14,285827,319783,19221,88735,2.962160509837341,0.2172119710759379
11400,0.3860238095238095,0,2,0,285829,319781,19221,88735,2.962141983771166,0.2172130344955889
11401,0.3860476190476191,0,1,0,285830,319780,19221,88735,2.9621327207380785,0.21721356620931911
11402,0.3860555555555555,0,1,0,285831,319779,19221,88735,2.962123457704991,0.2172140979256525
11403,0.3860714285714286,0,1,0,285832,319778,19221,88735,2.962114194671903,0.21721462964458904
11404,0.3861111111111111,2,0,2,285832,319778,19223,88733,2.962114194671903,0.21721079726127326
11405,0.3861666666666666,2,7,2,285839,319771,19225,88731,2.9620493534402903,0.21721068685098238
11406,0.3861666666666667,0,1,0,285840,319770,19225,88731,2.962040090407203,0.2172112185771883
11407,0.3861904761904761,1,0,1,285840,319770,19226,88730,2.962040090407203,0.2172093023255814
11408,0.3861904761904762,1,3,1,285843,319767,19227,88729,2.9620123013079405,0.2172089812384944
11409,0.3862142857142857,1,1,1,285844,319766,19228,88728,2.962003038274853,0.21720759668440662
11410,0.38625,3,4,3,285848,319762,19231,88725,2.9619659861425025,0.21720397466749247
11411,0.3863095238095237,0,2,0,285850,319760,19231,88725,2.9619474600763276,0.21720503812869504
11412,0.3863333333333333,4,26,4,285876,319734,19235,88721,2.961706621216051,0.21721119829601793
11413,0.3863333333333334,1,3,1,285879,319731,19236,88720,2.9616788321167884,0.21721087719212342
11414,0.3863888888888888,1,0,1,285879,319731,19237,88719,2.9616788321167884,0.21720896070510468
11415,0.3864285714285714,1,8,1,285887,319723,19238,88718,2.961604727852088,0.21721129857188676
11416,0.3864848484848483,0,1,0,285888,319722,19238,88718,2.961595464819,0.21721183037900305
11417,0.3865,1,28,1,285916,319694,19239,88717,2.9613360998925486,0.21722480540435982
11418,0.3865238095238095,1,3,1,285919,319691,19240,88716,2.961308310793286,0.21722448439914105
11419,0.3865277777777778,0,1,0,285920,319690,19240,88716,2.961299047760199,0.2172250162828166
11420,0.386547619047619,0,3,0,285923,319687,19240,88716,2.9612712586609358,0.2172266119494715
11421,0.3865476190476191,0,1,0,285924,319686,19240,88716,2.9612619956278485,0.2172271438435659
11422,0.3865714285714285,1,0,1,285924,319686,19241,88715,2.9612619956278485,0.2172252271664369
11423,0.3865833333333333,0,1,0,285925,319685,19241,88715,2.961252732594761,0.21722575905974534
11424,0.3865952380952381,0,2,0,285927,319683,19241,88715,2.961234206528586,0.21722682285417658
11425,0.3866190476190476,0,1,0,285928,319682,19241,88715,2.9612249434954983,0.2172273547552994
11426,0.3866666666666665,1,1,1,285929,319681,19242,88714,2.9612156804624106,0.21722596995555774
11427,0.3866666666666666,47,411,47,286340,319270,19289,88667,2.9574085738634257,0.2173546405449861
11428,0.3866666666666667,44,369,44,286709,318901,19333,88623,2.9539905146541185,0.21746694673197162
11429,0.3867142857142857,0,1,0,286710,318900,19333,88623,2.953981251621031,0.21746748036307154
11430,0.3867261904761905,0,1,0,286711,318899,19333,88623,2.953971988587943,0.21746801399679036
11431,0.3867619047619047,0,1,0,286712,318898,19333,88623,2.9539627255548555,0.21746854763312812
11432,0.3867857142857143,0,5,0,286717,318893,19333,88623,2.953916410389418,0.21747121585410142
11433,0.3868333333333333,2,22,2,286739,318871,19335,88621,2.9537126236614917,0.21747911615442758
11434,0.3868960483960484,0,1,0,286740,318870,19335,88621,2.953703360628404,0.21747964985729745
11435,0.3869047619047618,0,1,0,286741,318869,19335,88621,2.9536940975953168,0.2174801835627868
11436,0.3869047619047619,0,1,0,286742,318868,19335,88621,2.953684834562229,0.21748071727089566
11437,0.386904761904762,0,1,0,286743,318867,19335,88621,2.9536755715291414,0.217481250981624
11438,0.3869285714285714,1,0,1,286743,318867,19336,88620,2.9536755715291414,0.21747933062895258
11439,0.3869444444444444,0,1,0,286744,318866,19336,88620,2.953666308496054,0.21747986433889754
11440,0.3869999999999999,1,4,1,286748,318862,19337,88619,2.953629256363704,0.2174800788257612
11441,0.387,10,38,10,286786,318824,19347,88609,2.9532772611063765,0.21748115641099272
11442,0.3870238095238096,0,1,0,286787,318823,19347,88609,2.953267998073289,0.21748169019615543
11443,0.3870277777777777,0,2,0,286789,318821,19347,88609,2.953249472007114,0.21748275777434162
11444,0.387047619047619,0,1,0,286790,318820,19347,88609,2.9532402089740266,0.21748329156736512
11445,0.3870833333333333,0,2,0,286792,318818,19347,88609,2.9532216829078513,0.21748435916127307
11446,0.3871031746031745,0,1,0,286793,318817,19347,88609,2.9532124198747636,0.21748489296215753
11447,0.3871038961038961,0,1,0,286794,318816,19347,88609,2.9532031568416763,0.2174854267656624
11448,0.3871190476190476,0,1,0,286795,318815,19347,88609,2.9531938938085887,0.21748596057178762
11449,0.3871190476190477,0,1,0,286796,318814,19347,88609,2.953184630775501,0.21748649438053325
11450,0.387142857142857,0,1,0,286797,318813,19347,88609,2.9531753677424137,0.2174870281918993
11451,0.3871428571428572,1,15,1,286812,318798,19348,88608,2.9530364222461003,0.21749311497621537
11452,0.3871587301587301,1,3,1,286815,318795,19349,88607,2.9530086331468377,0.2174927958134717
11453,0.3871666666666666,0,14,0,286829,318781,19349,88607,2.952878950683612,0.21750027001286243
11454,0.3872222222222221,0,1,0,286830,318780,19349,88607,2.9528696876505243,0.21750080390390464
11455,0.3872222222222222,1,2,1,286832,318778,19350,88606,2.9528511615843493,0.21749995090627025
11456,0.3872294372294372,0,1,0,286833,318777,19350,88606,2.9528418985512617,0.2175004848017713
11457,0.3872380952380952,0,2,0,286835,318775,19350,88606,2.9528233724850863,0.21750155260063675
11458,0.3872619047619047,0,1,0,286836,318774,19350,88606,2.952814109451999,0.21750208650400119
11459,0.3872698412698414,0,1,0,286837,318773,19350,88606,2.9528048464189114,0.21750262040998677
11460,0.3872857142857143,0,1,0,286838,318772,19350,88606,2.9527955833858237,0.21750315431859354
11461,0.3873095238095237,0,1,0,286839,318771,19350,88606,2.9527863203527365,0.21750368822982152
11462,0.3873333333333332,1,9,1,286848,318762,19351,88605,2.9527029530549482,0.2175065726973466
11463,0.3873333333333333,5,45,5,286893,318717,19356,88600,2.9522861165660084,0.21752099715946058
11464,0.3873333333333334,0,4,0,286897,318713,19356,88600,2.952249064433658,0.21752313331516548
11465,0.3873690476190476,0,2,0,286899,318711,19356,88600,2.952230538367483,0.21752420140875153
11466,0.3873809523809523,0,2,0,286901,318709,19356,88600,2.952212012301308,0.21752526951282686
11467,0.3873809523809524,0,5,0,286906,318704,19356,88600,2.9521656971358703,0.21752793981890675
11468,0.3874047619047619,0,1,0,286907,318703,19356,88600,2.9521564341027826,0.21752847388799001
11469,0.3874285714285714,0,2,0,286909,318701,19356,88600,2.9521379080366077,0.21752954203402397
11470,0.3874523809523809,0,1,0,286910,318700,19356,88600,2.95212864500352,0.21753007611097472
11471,0.3874999999999999,0,5,0,286915,318695,19356,88600,2.952082329838082,0.2175327465350667
11472,0.3875,53,429,53,287344,318266,19409,88547,2.9481084886435216,0.21766020259922864
11473,0.3875238095238095,0,1,0,287345,318265,19409,88547,2.948099225610434,0.21766073763802443
11474,0.3875714285714285,0,3,0,287348,318262,19409,88547,2.9480714365111713,0.21766234277019436
11475,0.3875833333333333,0,4,0,287352,318258,19409,88547,2.948034384378821,0.2176644829832475
11476,0.3876071428571429,1,6,1,287358,318252,19410,88546,2.947978806180296,0.21766577023485859
11477,0.3876190476190476,2,2,2,287360,318250,19412,88544,2.9479602801141205,0.21766299404612655
11478,0.3876666666666666,6,35,6,287395,318215,19418,88538,2.947636073956056,0.21767018313325287
11479,0.3876666666666667,1,5,1,287400,318210,19419,88537,2.9475897587906186,0.21767093549552916
11480,0.3876904761904762,0,1,0,287401,318209,19419,88537,2.947580495757531,0.21767147064752942
11481,0.3877142857142857,0,1,0,287402,318208,19419,88537,2.947571232724443,0.21767200580216106
11482,0.3877619047619047,1,0,1,287402,318208,19420,88536,2.947571232724443,0.217670082410558
11483,0.3877698412698414,0,2,0,287404,318206,19420,88536,2.9475527066582683,0.2176711527208894
11484,0.3877727272727273,0,1,0,287405,318205,19420,88536,2.9475434436251806,0.21767168788000227
11485,0.3877777777777778,0,4,0,287409,318201,19420,88536,2.9475063914928303,0.21767382854276843
11486,0.3877857142857143,0,2,0,287411,318199,19420,88536,2.9474878654266554,0.21767489888994063
11487,0.3877976190476191,0,1,0,287412,318198,19420,88536,2.9474786023935677,0.21767543406747408
11488,0.3878333333333333,0,15,0,287427,318183,19420,88536,2.9473396568972543,0.21768346204627764
11489,0.3878571428571428,2,15,2,287442,318168,19422,88534,2.9472007114009413,0.2176876435326111
11490,0.3878888888888888,0,1,0,287443,318167,19422,88534,2.9471914483678536,0.21768817878490587
11491,0.3878888888888889,1,1,1,287444,318166,19423,88533,2.947182185334766,0.2176867904764949
11492,0.3879166666666666,1,1,1,287445,318165,19424,88532,2.9471729223016783,0.21768540215442947
11493,0.3879166666666667,0,1,0,287446,318164,19424,88532,2.947163659268591,0.21768593740779354
11494,0.3879444444444444,0,1,0,287447,318163,19424,88532,2.9471543962355033,0.21768647266378982
11495,0.3879563492063492,0,1,0,287448,318162,19424,88532,2.9471451332024157,0.21768700792241832
11496,0.3879761904761905,1,0,1,287448,318162,19425,88531,2.9471451332024157,0.21768508432650674
11497,0.3879999999999999,8,93,8,287541,318069,19433,88523,2.9462836711252733,0.21771948292145443
11498,0.388,1,8,1,287549,318061,19434,88522,2.946209566860573,0.21772184277257042
11499,0.3880714285714285,0,1,0,287550,318060,19434,88522,2.946200303827485,0.21772237826563892
11500,0.3880952380952381,1,0,1,287550,318060,19435,88521,2.946200303827485,0.21772045422683303
11501,0.3881428571428571,1,0,1,287550,318060,19436,88520,2.946200303827485,0.21771853017856266
11502,0.3881507936507936,0,1,0,287551,318059,19436,88520,2.946191040794398,0.21771906566743487
11503,0.3881666666666666,2,14,2,287565,318045,19438,88518,2.946061358331172,0.21772271456084297
11504,0.3881666666666667,0,8,0,287573,318037,19438,88518,2.9459872540664716,0.2177269988070495
11505,0.3882142857142857,2,5,2,287578,318032,19440,88516,2.9459409389010336,0.21772582819248895
11506,0.38825,0,1,0,287579,318031,19440,88516,2.9459316758679464,0.21772636374146162
11507,0.3882738095238096,1,0,1,287579,318031,19441,88515,2.9459316758679464,0.21772443954681636
11508,0.3882857142857143,0,1,0,287580,318030,19441,88515,2.9459224128348587,0.21772497509500793
11509,0.3883095238095237,0,1,0,287581,318029,19441,88515,2.945913149801771,0.21772551064583415
11510,0.3883214285714287,2,4,2,287585,318025,19443,88513,2.9458760976694207,0.21772380441680728
11511,0.3883333333333333,49,483,49,288068,317542,19492,88464,2.941402052688132,0.21788840559006517
11512,0.3883525641025641,0,1,0,288069,317541,19492,88464,2.9413927896550445,0.21788894225440572
11513,0.3883571428571428,0,1,0,288070,317540,19492,88464,2.9413835266219572,0.21788947892138993
11514,0.3884015151515151,0,1,0,288071,317539,19492,88464,2.9413742635888696,0.2178900155910178
11515,0.3884166666666667,0,2,0,288073,317537,19492,88464,2.9413557375226946,0.21789108893820458
11516,0.3884285714285715,0,1,0,288074,317536,19492,88464,2.941346474489607,0.21789162561576356
11517,0.3884523809523809,0,2,0,288076,317534,19492,88464,2.9413279484234316,0.2178926989788127
11518,0.3884761904761905,0,2,0,288078,317532,19492,88464,2.9413094223572567,0.21789377235243698
11519,0.3884999999999999,0,2,0,288080,317530,19492,88464,2.9412908962910818,0.2178948457366365
11520,0.3885,3,29,3,288109,317501,19495,88461,2.9410222683315426,0.2179046314679699
11521,0.3885158730158729,0,1,0,288110,317500,19495,88461,2.941013005298455,0.21790516823044578
11522,0.388531746031746,0,4,0,288114,317496,19495,88461,2.9409759531661046,0.21790731530679358
11523,0.3885714285714285,0,1,0,288115,317495,19495,88461,2.9409666901330174,0.2179078520824917
11524,0.3885714285714286,2,6,2,288121,317489,19497,88459,2.9409111119344917,0.21790721964389528
11525,0.3886111111111111,1,1,1,288122,317488,19498,88458,2.9409018489014045,0.21790582983943677
11526,0.3886428571428571,0,1,0,288123,317487,19498,88458,2.940892585868317,0.21790636662602075
11527,0.3886435574229692,0,2,0,288125,317485,19498,88458,2.9408740598021414,0.2179074402071227
11528,0.3886666666666666,4,27,4,288152,317458,19502,88454,2.9406239579087776,0.21791422771438143
11529,0.3886666666666667,1,5,1,288157,317453,19503,88453,2.9405776427433397,0.21791498524288874
11530,0.3886802364302364,0,1,0,288158,317452,19503,88453,2.9405683797102524,0.21791552210492604
11531,0.3886904761904761,0,1,0,288159,317451,19503,88453,2.9405591166771647,0.21791605896960858
11532,0.3886904761904762,1,6,1,288165,317445,19504,88452,2.9405035384786395,0.21791735341724625
11533,0.3887121212121212,0,1,0,288166,317444,19504,88452,2.940494275445552,0.2179178902970219
11534,0.3887142857142858,0,1,0,288167,317443,19504,88452,2.940485012412464,0.21791842717944296
11535,0.3887222222222222,0,1,0,288168,317442,19504,88452,2.940475749379377,0.21791896406450945
11536,0.3887380952380952,0,1,0,288169,317441,19504,88452,2.9404664863462893,0.2179195009522214
11537,0.3887499999999999,0,1,0,288170,317440,19504,88452,2.9404572233132016,0.21792003784257882
11538,0.38875,2,6,2,288176,317434,19506,88450,2.9404016451146764,0.21791940554444128
11539,0.3887619047619047,0,2,0,288178,317432,19506,88450,2.940383119048501,0.21792047935114148
11540,0.3887857142857143,1,8,1,288186,317424,19507,88449,2.940309014783801,0.21792284778736207
11541,0.3888095238095237,1,1,1,288187,317423,19508,88448,2.9402997517507132,0.21792145780309508
11542,0.3888095238095239,0,1,0,288188,317422,19508,88448,2.9402904887176255,0.21792199472737575
11543,0.3888333333333332,0,3,0,288191,317419,19508,88448,2.940262699618363,0.21792360551609272
11544,0.3888333333333333,0,9,0,288200,317410,19508,88448,2.940179332320575,0.21792843802512207
11545,0.3888452380952381,0,1,0,288201,317409,19508,88448,2.9401700692874875,0.2179289749837997
11546,0.3888690476190476,0,1,0,288202,317408,19508,88448,2.9401608062544,0.2179295119451234
11547,0.3888888888888888,0,4,0,288206,317404,19508,88448,2.9401237541220495,0.21793165981687906
11548,0.3889047619047619,0,1,0,288207,317403,19508,88448,2.9401144910889623,0.2179321967914333
11549,0.3889285714285714,0,1,0,288208,317402,19508,88448,2.9401052280558746,0.21793273376863373
11550,0.3889484126984128,1,0,1,288208,317402,19509,88447,2.9401052280558746,0.2179308067778903
11551,0.3889761904761905,0,1,0,288209,317401,19509,88447,2.940095965022787,0.21793134375431195
11552,0.3889999999999999,0,2,0,288211,317399,19509,88447,2.940077438956612,0.2179324177150939
11553,0.389,8,82,8,288293,317317,19517,88439,2.9393178702434324,0.21796104062540048
11554,0.3890396825396825,0,2,0,288295,317315,19517,88439,2.9392993441772575,0.21796211497606924
11555,0.389047619047619,2,7,2,288302,317308,19519,88437,2.9392345029456446,0.21796202048084387
11556,0.3890476190476191,0,2,0,288304,317306,19519,88437,2.9392159768794692,0.21796309486546903
11557,0.3891428571428571,0,3,0,288307,317303,19519,88437,2.9391881877802066,0.21796470646226648
11558,0.3891666666666665,0,1,0,288308,317302,19519,88437,2.9391789247471194,0.21796524366649497
11559,0.3891666666666666,9,70,9,288378,317232,19528,88428,2.9385305124309906,0.21798550510279543
11560,0.3891666666666667,4,79,4,288457,317153,19532,88424,2.9377987328170736,0.21802025262773778
11561,0.3891904761904762,0,1,0,288458,317152,19532,88424,2.937789469783986,0.21802079018482357
11562,0.3892380952380952,0,1,0,288459,317151,19532,88424,2.9377802067508987,0.2180213277445602
11563,0.38925,0,1,0,288460,317150,19532,88424,2.937770943717811,0.21802186530694767
11564,0.3892539682539683,0,1,0,288461,317149,19532,88424,2.9377616806847233,0.21802240287198604
11565,0.3892857142857142,0,2,0,288463,317147,19532,88424,2.9377431546185484,0.2180234780100155
11566,0.3892857142857143,0,9,0,288472,317138,19532,88424,2.93765978732076,0.2180283162623717
11567,0.3893095238095238,0,1,0,288473,317137,19532,88424,2.937650524287673,0.21802885385922216
11568,0.3893333333333333,7,61,7,288534,317076,19539,88417,2.937085479269332,0.21804815372891764
11569,0.3893787878787879,0,1,0,288535,317075,19539,88417,2.9370762162362443,0.21804869146616948
11570,0.3894047619047619,0,1,0,288536,317074,19539,88417,2.937066953203157,0.2180492292060736
11571,0.3894285714285714,0,2,0,288538,317072,19539,88417,2.9370484271369817,0.2180503046938388
11572,0.3894444444444444,0,3,0,288541,317069,19539,88417,2.937020638037719,0.21805191794537912
11573,0.3894444444444445,0,1,0,288542,317068,19539,88417,2.9370113750046314,0.21805245570119733
11574,0.3894570707070706,0,1,0,288543,317067,19539,88417,2.937002111971544,0.21805299345966794
11575,0.3894761904761905,0,1,0,288544,317066,19539,88417,2.9369928489384565,0.21805353122079102
11576,0.3894999999999999,0,4,0,288548,317062,19539,88417,2.936955796806106,0.21805568229180797
11577,0.3895,1,17,1,288565,317045,19540,88416,2.936798325243618,0.21806289630815295
11578,0.3895238095238095,0,7,0,288572,317038,19540,88416,2.936733484012005,0.21806666107622566
11579,0.3895243082081316,0,1,0,288573,317037,19540,88416,2.9367242209789173,0.21806719891084786
11580,0.389547619047619,0,1,0,288574,317036,19540,88416,2.9367149579458296,0.21806773674812308
11581,0.3895555555555555,0,1,0,288575,317035,19540,88416,2.9367056949127424,0.21806827458805134
11582,0.389563492063492,0,1,0,288576,317034,19540,88416,2.9366964318796547,0.21806881243063264
11583,0.3895714285714285,0,1,0,288577,317033,19540,88416,2.936687168846567,0.218069350275867
11584,0.3895833333333333,0,2,0,288579,317031,19540,88416,2.936668642780392,0.21807042597429505
11585,0.3896111111111111,0,1,0,288580,317030,19540,88416,2.9366593797473044,0.21807096382748875
11586,0.3896190476190475,0,2,0,288582,317028,19540,88416,2.9366408536811295,0.21807203954183563
11587,0.3896190476190477,0,1,0,288583,317027,19540,88416,2.936631590648042,0.21807257740298883
11588,0.3896428571428572,0,3,0,288586,317024,19540,88416,2.936603801548779,0.2180741910023678
11589,0.3896666666666666,3,25,3,288611,316999,19543,88413,2.9363722257215903,0.21808185253519877
11590,0.3897142857142857,0,1,0,288612,316998,19543,88413,2.9363629626885026,0.21808239046301162
11591,0.3897222222222222,0,1,0,288613,316997,19543,88413,2.9363536996554154,0.2180829283934782
11592,0.38975,0,2,0,288615,316995,19543,88413,2.93633517358924,0.21808400426237273
11593,0.3897619047619047,0,4,0,288619,316991,19543,88413,2.9362981214568897,0.21808615603200757
11594,0.389797619047619,0,4,0,288623,316987,19543,88413,2.9362610693245395,0.2180883078441046
11595,0.3898095238095238,0,1,0,288624,316986,19543,88413,2.936251806291452,0.2180888458037637
11596,0.3898333333333332,0,3,0,288627,316983,19543,88413,2.9362240171921896,0.218090459698665
11597,0.3898333333333333,0,16,0,288643,316967,19543,88413,2.9360758086627885,0.21809906754156594
11598,0.3898333333333334,0,1,0,288644,316966,19543,88413,2.936066545629701,0.21809960555430843
11599,0.3898571428571428,0,1,0,288645,316965,19543,88413,2.9360572825966136,0.2181001435697053
11600,0.3898809523809523,0,1,0,288646,316964,19543,88413,2.936048019563526,0.21810068158775658
11601,0.3898809523809524,0,1,0,288647,316963,19543,88413,2.936038756530438,0.21810121960846227
11602,0.3899047619047618,0,1,0,288648,316962,19543,88413,2.936029493497351,0.21810175763182238
11603,0.3899166666666666,0,1,0,288649,316961,19543,88413,2.9360202304642633,0.21810229565783695
11604,0.389944055944056,0,2,0,288651,316959,19543,88413,2.936001704398088,0.21810337171782954
11605,0.3899523809523809,1,1,1,288652,316958,19544,88412,2.9359924413650007,0.21810198090633248
11606,0.3899880952380952,0,1,0,288653,316957,19544,88412,2.935983178331913,0.2181025189395341
11607,0.3899999999999999,2,21,2,288674,316936,19546,88410,2.9357886546370744,0.21810996037952762
11608,0.39,426,3517,426,292191,313419,19972,87984,2.9032105672681463,0.21919118691190648
11609,0.3900555555555556,0,1,0,292192,313418,19972,87984,2.9032013042350586,0.2191917329759194
11610,0.3900833333333334,0,1,0,292193,313417,19972,87984,2.9031920412019714,0.21919227904265312
11611,0.3901190476190476,0,1,0,292194,313416,19972,87984,2.9031827781688837,0.21919282511210764
11612,0.3901211843711842,0,2,0,292196,313414,19972,87984,2.9031642521027083,0.21919391725917917
11613,0.3901617826617827,0,1,0,292197,313413,19972,87984,2.903154989069621,0.21919446333679624
11614,0.3901666666666666,5,15,5,292212,313398,19977,87979,2.9030160435733077,0.21919292834417517
11615,0.3901666666666667,0,4,0,292216,313394,19977,87979,2.9029789914409574,0.21919511277539844
11616,0.3902222222222222,0,1,0,292217,313393,19977,87979,2.9029697284078697,0.21919565889000728
11617,0.3902380952380953,1,0,1,292217,313393,19978,87978,2.9029697284078697,0.21919371354681827
11618,0.3902857142857143,0,1,0,292218,313392,19978,87978,2.9029604653747825,0.21919425966066222
11619,0.3902976190476191,0,1,0,292219,313391,19978,87978,2.902951202341695,0.21919480577722744
11620,0.3903298923298923,0,6,0,292225,313385,19978,87978,2.9028956241431696,0.2191980825337662
11621,0.3903333333333333,3,34,3,292259,313351,19981,87975,2.9025806810181924,0.21921081614448104
11622,0.3903571428571428,0,4,0,292263,313347,19981,87975,2.902543628885842,0.21921300103159058
11623,0.3903650793650793,0,1,0,292264,313346,19981,87975,2.902534365852755,0.21921354726017328
11624,0.3903809523809524,0,1,0,292265,313345,19981,87975,2.9025251028196672,0.21921409349147813
11625,0.3903888888888888,0,1,0,292266,313344,19981,87975,2.9025158397865796,0.21921463972550514
11626,0.3904166666666666,4,4,4,292270,313340,19985,87971,2.9024787876542293,0.21920904236365313
11627,0.3904166666666667,2,1,2,292271,313339,19987,87969,2.902469524621142,0.2192056973696014
11628,0.3904285714285715,1,4,1,292275,313335,19988,87968,2.9024324724887918,0.21920593666132573
11629,0.3904444444444444,0,1,0,292276,313334,19988,87968,2.902423209455704,0.21920648289816647
11630,0.3904761904761904,0,1,0,292277,313333,19988,87968,2.9024139464226164,0.21920702913772955
11631,0.3904761904761905,0,2,0,292279,313331,19988,87968,2.9023954203564415,0.21920812162502273
11632,0.3904999999999999,4,19,4,292298,313312,19992,87964,2.9022194227277778,0.2192107178101855
11633,0.3905,0,1,0,292299,313311,19992,87964,2.9022101596946905,0.21921126409569497
11634,0.3905555555555555,0,2,0,292301,313309,19992,87964,2.902191633628515,0.21921235667488218
11635,0.3905714285714285,0,1,0,292302,313308,19992,87964,2.902182370595428,0.21921290296855997
11636,0.3905952380952381,0,2,0,292304,313306,19992,87964,2.9021638445292526,0.21921399556408402
11637,0.3906043956043956,0,2,0,292306,313304,19992,87964,2.9021453184630777,0.2192150881704995
11638,0.3906111111111112,0,3,0,292309,313301,19992,87964,2.902117529363815,0.21921672710054452
11639,0.3906428571428572,0,2,0,292311,313299,19992,87964,2.9020990032976397,0.2192178197341893
11640,0.3906666666666666,3,51,3,292362,313248,19995,87961,2.9016265886101746,0.21923984756074763
11641,0.3906666666666667,1,14,1,292376,313234,19996,87960,2.901496906146949,0.2192455520271988
11642,0.3907142857142857,0,11,0,292387,313223,19996,87960,2.9013950127829857,0.21925156350094596
11643,0.3907738095238094,1,1,1,292388,313222,19997,87959,2.901385749749898,0.2192501638911115
11644,0.3907857142857142,0,1,0,292389,313221,19997,87959,2.9013764867168104,0.2192507104043073
11645,0.3907857142857143,0,1,0,292390,313220,19997,87959,2.901367223683723,0.21925125692022762
11646,0.3908333333333333,20,157,20,292547,313063,20017,87939,2.8999129274889768,0.2192981581139246
11647,0.3908571428571429,1,3,1,292550,313060,20018,87938,2.899885138389714,0.21929785185961026
11648,0.3909166666666666,0,2,0,292552,313058,20018,87938,2.8998666123235393,0.21929894562539276
11649,0.3909523809523809,0,4,0,292556,313054,20018,87938,2.899829560191189,0.21930113318968958
11650,0.390952380952381,0,1,0,292557,313053,20018,87938,2.8998202971581013,0.21930168008758302
11651,0.3909999999999999,0,6,0,292563,313047,20018,87938,2.899764718959576,0.2193049615322269
11652,0.391,9,79,9,292642,312968,20027,87929,2.8990329393456595,0.21933065101509863
11653,0.3910119047619046,0,3,0,292645,312965,20027,87929,2.8990051502463965,0.21933229232664994
11654,0.3910555555555555,0,1,0,292646,312964,20027,87929,2.8989958872133093,0.21933283943595921
11655,0.3910714285714286,0,3,0,292649,312961,20027,87929,2.8989680981140467,0.2193344807802639
11656,0.3911111111111111,0,4,0,292653,312957,20027,87929,2.8989310459816964,0.21933666927755022
11657,0.3911190476190476,0,1,0,292654,312956,20027,87929,2.8989217829486087,0.21933721640869577
11658,0.3911363636363636,0,1,0,292655,312955,20027,87929,2.898912519915521,0.21933776354257092
11659,0.3911428571428571,0,1,0,292656,312954,20027,87929,2.8989032568824338,0.21933831067917572
11660,0.3911666666666666,2,11,2,292667,312943,20029,87927,2.8988013635184706,0.21934043455484323
11661,0.3911666666666667,1,2,1,292669,312941,20030,87926,2.8987828374522953,0.21933958145719154
11662,0.3911746031746031,0,1,0,292670,312940,20030,87926,2.898773574419208,0.21934012862153437
11663,0.3911904761904762,1,8,1,292678,312932,20031,87925,2.8986994701545075,0.21934255856826748
11664,0.39125,2,9,2,292687,312923,20033,87923,2.8986161028567192,0.21934358831072281
11665,0.3912500000000001,0,2,0,292689,312921,20033,87923,2.8985975767905443,0.21934468271946195
11666,0.3912698412698412,0,1,0,292690,312920,20033,87923,2.8985883137574566,0.2193452299279269
11667,0.3912857142857142,1,1,1,292691,312919,20034,87922,2.8985790507243694,0.21934382959826965
11668,0.3912857142857143,0,2,0,292693,312917,20034,87922,2.898560524658194,0.21934492402186415
11669,0.3913095238095238,0,3,0,292696,312914,20034,87922,2.8985327355589314,0.21934656567773353
11670,0.3913214285714286,0,1,0,292697,312913,20034,87922,2.8985234725258437,0.21934711290181746
11671,0.3913333333333332,0,6,0,292703,312907,20034,87922,2.8984678943273186,0.21935039630366066
11672,0.3913333333333333,0,32,0,292735,312875,20034,87922,2.8981714772685168,0.21936790944043993
11673,0.3913333333333334,0,7,0,292742,312868,20034,87922,2.898106636036904,0.2193717408118965
11674,0.3914285714285714,1,6,1,292748,312862,20035,87921,2.8980510578383787,0.2193730772013783
11675,0.3914761904761905,0,2,0,292750,312860,20035,87921,2.8980325317722033,0.21937417192930803
11676,0.3914999999999999,0,19,0,292769,312841,20035,87921,2.89785653414354,0.21938457238959783
11677,0.3915,1,3,1,292772,312838,20036,87920,2.8978287450442775,0.21938426681438675
11678,0.3915238095238095,0,1,0,292773,312837,20036,87920,2.8978194820111898,0.2193848142390526
11679,0.391547619047619,0,3,0,292776,312834,20036,87920,2.897791692911927,0.219386456529442
11680,0.3915476190476191,1,0,1,292776,312834,20037,87919,2.897791692911927,0.21938450866244294
11681,0.3915714285714285,0,1,0,292777,312833,20037,87919,2.8977824298788395,0.21938505609454226
11682,0.3915952380952381,0,1,0,292778,312832,20037,87919,2.897773166845752,0.2193856035293736
11683,0.3916071428571428,0,1,0,292779,312831,20037,87919,2.8977639038126646,0.219386150966937
11684,0.3916190476190476,0,1,0,292780,312830,20037,87919,2.897754640779577,0.21938669840723246
11685,0.3916475256769376,0,5,0,292785,312825,20037,87919,2.897708325614139,0.21938943564969157
11686,0.3916666666666665,0,2,0,292787,312823,20037,87919,2.897689799547964,0.21939053056580043
11687,0.3916666666666666,29,253,29,293040,312570,20066,87890,2.8953462521768127,0.2194726065025221
11688,0.3916666666666667,18,225,18,293265,312345,20084,87872,2.893262069732113,0.21956088821814165
11689,0.3916904761904762,0,1,0,293266,312344,20084,87872,2.8932528066990257,0.21956143682411497
11690,0.3917142857142857,0,3,0,293269,312341,20084,87872,2.8932250175997627,0.21956308265848437
11691,0.39175,0,1,0,293270,312340,20084,87872,2.8932157545666755,0.21956363127542403
11692,0.3917619047619047,0,1,0,293271,312339,20084,87872,2.8932064915335878,0.21956417989510532
11693,0.3917857142857143,0,5,0,293276,312334,20084,87872,2.89316017636815,0.21956692303463715
11694,0.3917857142857144,0,1,0,293277,312333,20084,87872,2.8931509133350626,0.21956747167076873
11695,0.3918055555555556,0,1,0,293278,312332,20084,87872,2.893141650301975,0.2195680203096421
11696,0.3918333333333333,3,21,3,293299,312311,20087,87869,2.8929471266071363,0.2195736918386726
11697,0.3918333333333334,0,1,0,293300,312310,20087,87869,2.8929378635740486,0.21957424052736402
11698,0.3918452380952381,0,1,0,293301,312309,20087,87869,2.8929286005409613,0.21957478921879764
11699,0.3918571428571428,1,1,1,293302,312308,20088,87868,2.8929193375078737,0.21957338770940785
11700,0.3918690476190476,1,0,1,293302,312308,20089,87867,2.8929193375078737,0.21957143749609545
11701,0.3918888888888889,0,1,0,293303,312307,20089,87867,2.892910074474786,0.2195719861860091
11702,0.391904761904762,0,1,0,293304,312306,20089,87867,2.8929008114416983,0.219572534878665
11703,0.3919325396825397,0,2,0,293306,312304,20089,87867,2.8928822853755234,0.21957363227220364
11704,0.3919523809523809,0,2,0,293308,312302,20089,87867,2.8928637593093485,0.2195747296767116
11705,0.3919999999999999,1,6,1,293314,312296,20090,87866,2.892808181110823,0.21957607169096516
11706,0.392,14,92,14,293406,312204,20104,87852,2.8919559820667677,0.2195992561041454
11707,0.3920000000000001,0,1,0,293407,312203,20104,87852,2.8919467190336805,0.21959980502680881
11708,0.3920238095238095,0,2,0,293409,312201,20104,87852,2.891928192967505,0.21960090288036835
11709,0.3920555555555555,0,1,0,293410,312200,20104,87852,2.891918929934418,0.21960145181126453
11710,0.3920833333333333,2,2,2,293412,312198,20106,87850,2.8919004038682425,0.21959864816222052
11711,0.3921060606060607,0,1,0,293413,312197,20106,87850,2.891891140835155,0.21959919709434142
11712,0.3921111111111111,0,1,0,293414,312196,20106,87850,2.8918818778020676,0.21959974602920665
11713,0.3921190476190476,1,0,1,293414,312196,20107,87849,2.8918818778020676,0.2195977952480346
11714,0.392142857142857,0,1,0,293415,312195,20107,87849,2.89187261476898,0.21959834418213997
11715,0.3921428571428571,2,9,2,293424,312186,20109,87847,2.891789247471192,0.2195993830508983
11716,0.3921666666666666,2,17,2,293441,312169,20111,87845,2.8916317759087034,0.2196048138315159
11717,0.3921915584415584,0,1,0,293442,312168,20111,87845,2.891622512875616,0.21960536282570817
11718,0.3922023809523809,0,4,0,293446,312164,20111,87845,2.891585460743266,0.21960755882992633
11719,0.3922222222222222,1,6,1,293452,312158,20112,87844,2.8915298825447406,0.2196089019554902
11720,0.3922222222222223,0,1,0,293453,312157,20112,87844,2.891520619511653,0.21960945097637255
11721,0.3922460317460317,0,2,0,293455,312155,20112,87844,2.8915020934454776,0.21961054902637256
11722,0.3922499999999999,0,1,0,293456,312154,20112,87844,2.8914928304123904,0.21961109805549028
11723,0.39225,0,2,0,293458,312152,20112,87844,2.891474304346215,0.21961219612196123
11724,0.3922651515151515,0,1,0,293459,312151,20112,87844,2.8914650413131278,0.2196127451593145
11725,0.3923333333333332,1,7,1,293466,312144,20113,87843,2.891400200081515,0.21961463747571797
11726,0.3923333333333333,2,33,2,293499,312111,20115,87841,2.8910945199896254,0.2196288554626555
11727,0.3923809523809523,0,1,0,293500,312110,20115,87841,2.8910852569565377,0.21962940460206376
11728,0.3923809523809524,0,8,0,293508,312102,20115,87841,2.8910111526918376,0.2196337978161888
11729,0.3924285714285714,0,1,0,293509,312101,20115,87841,2.89100188965875,0.21963434698031215
11730,0.3924444444444445,0,1,0,293510,312100,20115,87841,2.8909926266256623,0.2196348961471817
11731,0.3924523809523809,0,1,0,293511,312099,20115,87841,2.8909833635925746,0.21963544531679752
11732,0.3924999999999999,1,10,1,293521,312089,20116,87840,2.890890733261699,0.2196389859200008
11733,0.3925,55,390,55,293911,311699,20171,87785,2.887278150357553,0.2197459723042725
11734,0.3925396825396826,1,1,1,293912,311698,20172,87784,2.8872688873244656,0.2197445692171362
11735,0.3925714285714285,0,1,0,293913,311697,20172,87784,2.887259624291378,0.21974511929228174
11736,0.3925833333333333,0,1,0,293914,311696,20172,87784,2.8872503612582903,0.21974566937018122
11737,0.3926190476190476,1,4,1,293918,311692,20173,87783,2.88721330912594,0.2197459165154265
11738,0.3926428571428571,0,1,0,293919,311691,20173,87783,2.8872040460928527,0.2197464666035837
11739,0.3926666666666666,5,32,5,293951,311659,20178,87778,2.886907629034051,0.21975430418313777
11740,0.3926666666666667,1,10,1,293961,311649,20179,87777,2.8868149987031755,0.21975785251836386
11741,0.3926904761904762,0,2,0,293963,311647,20179,87777,2.886796472637,0.2197589528921647
11742,0.3927380952380953,0,1,0,293964,311646,20179,87777,2.886787209603913,0.2197595030831975
11743,0.39275,0,1,0,293965,311645,20179,87777,2.886777946570825,0.21976005327698525
11744,0.3927619047619047,0,1,0,293966,311644,20179,87777,2.8867686835377375,0.21976060347352794
11745,0.3927777777777777,0,2,0,293968,311642,20179,87777,2.8867501574715626,0.21976170387487826
11746,0.3927777777777778,0,2,0,293970,311640,20179,87777,2.8867316314053872,0.21976280428724868
11747,0.3928095238095238,0,2,0,293972,311638,20179,87777,2.8867131053392123,0.2197639047106393
11748,0.3928210678210678,0,1,0,293973,311637,20179,87777,2.8867038423061246,0.21976445492646726
11749,0.3928253968253968,0,1,0,293974,311636,20179,87777,2.886694579273037,0.21976500514505037
11750,0.3928333333333332,0,3,0,293977,311633,20179,87777,2.8866667901737744,0.21976665581733057
11751,0.3928333333333333,2,11,2,293988,311622,20181,87775,2.886564896809811,0.21976880146821334
11752,0.3928571428571428,2,11,2,293999,311611,20183,87773,2.8864630034458485,0.21977094725877852
11753,0.3928888888888888,1,2,1,294001,311609,20184,87772,2.886444477379673,0.2197700942208067
11754,0.3928888888888889,1,1,1,294002,311608,20185,87771,2.8864352143465855,0.21976869089261078
11755,0.3929166666666666,0,1,0,294003,311607,20185,87771,2.886425951313498,0.2197692411700194
11756,0.3929166666666667,1,2,1,294005,311605,20186,87770,2.886407425247323,0.21976838810641627
11757,0.3929285714285714,0,1,0,294006,311604,20186,87770,2.8863981622142356,0.2197689383885781
11758,0.3929404761904762,0,2,0,294008,311602,20186,87770,2.8863796361480603,0.21977003896116903
11759,0.3929653679653679,0,1,0,294009,311601,20186,87770,2.8863703731149726,0.21977058925159815
11760,0.3929761904761905,0,2,0,294011,311599,20186,87770,2.8863518470487977,0.21977168984072373
11761,0.3929999999999999,8,33,8,294044,311566,20194,87762,2.886046166956908,0.21977422069076047
11762,0.393,2,6,2,294050,311560,20196,87760,2.885990588758383,0.21977361514574778
11763,0.3930238095238095,0,3,0,294053,311557,20196,87760,2.8859627996591204,0.21977526626715116
11764,0.393047619047619,0,1,0,294054,311556,20196,87760,2.8859535366260327,0.21977581664646545
11765,0.3930555555555555,0,4,0,294058,311552,20196,87760,2.8859164844936824,0.219778018191289
11766,0.3930595238095237,0,1,0,294059,311551,20196,87760,2.885907221460595,0.2197785685843866
11767,0.3930952380952381,1,0,1,294059,311551,20197,87759,2.885907221460595,0.219776614660289
11768,0.3931428571428572,1,3,1,294062,311548,20198,87758,2.8858794323613326,0.2197763119011485
11769,0.3931666666666666,3,11,3,294073,311537,20201,87755,2.8857775389973694,0.21977650441281069
11770,0.3931666666666667,1,4,1,294077,311533,20202,87754,2.885740486865019,0.21977675206054792
11771,0.3931825396825397,0,1,0,294078,311532,20202,87754,2.8857312238319315,0.2197773024849356
11772,0.3932142857142857,0,9,0,294087,311523,20202,87754,2.8856478565341437,0.2197822564284945
11773,0.3932380952380952,0,1,0,294088,311522,20202,87754,2.885638593501056,0.21978280688045362
11774,0.3932727272727273,0,1,0,294089,311521,20202,87754,2.8856293304679683,0.21978335733517
11775,0.3932777777777776,1,0,1,294089,311521,20203,87753,2.8856293304679683,0.2197814032468931
11776,0.3932857142857143,0,2,0,294091,311519,20203,87753,2.8856108044017934,0.21978250415756678
11777,0.393297619047619,0,1,0,294092,311518,20203,87753,2.8856015413687057,0.21978305461703956
11778,0.3933015873015872,0,1,0,294093,311517,20203,87753,2.885592278335618,0.21978360507926967
11779,0.3933333333333333,81,772,81,294865,310745,20284,87672,2.8784412167920266,0.22005085124379734
11780,0.3933333333333334,0,2,0,294867,310743,20284,87672,2.878422690725851,0.2200519558751553
11781,0.3934047619047617,0,1,0,294868,310742,20284,87672,2.8784134276927635,0.22005250819499314
11782,0.3934523809523809,0,2,0,294870,310740,20284,87672,2.8783949016265886,0.22005361284298666
11783,0.3934999999999999,0,10,0,294880,310730,20284,87672,2.878302271295713,0.22005913624931603
11784,0.3935,5,31,5,294911,310699,20289,87667,2.878015117269999,0.2200664715362255
11785,0.3935252525252525,0,1,0,294912,310698,20289,87667,2.8780058542369114,0.22006702396043828
11786,0.3935555555555555,0,2,0,294914,310696,20289,87667,2.8779873281707364,0.22006812881718432
11787,0.3935714285714286,0,2,0,294916,310694,20289,87667,2.877968802104561,0.2200692336850244
11788,0.3935833333333333,1,0,1,294916,310694,20290,87666,2.877968802104561,0.2200672758309067
11789,0.3935952380952381,0,1,0,294917,310693,20290,87666,2.8779595390714734,0.22006782826545904
11790,0.3936031746031745,0,1,0,294918,310692,20290,87666,2.877950276038386,0.22006838070278492
11791,0.3936071428571429,0,1,0,294919,310691,20290,87666,2.8779410130052985,0.2200689331428844
11792,0.3936111111111111,0,4,0,294923,310687,20290,87666,2.877903960872948,0.22007114293101848
11793,0.3936255411255411,0,2,0,294925,310685,20290,87666,2.8778854348067733,0.22007224784172752
11794,0.3936363636363637,0,1,0,294926,310684,20290,87666,2.8778761717736856,0.22007280030124263
11795,0.3936386946386946,1,1,1,294927,310683,20291,87665,2.877866908740598,0.220071394860775
11796,0.3936666666666666,3,19,3,294946,310664,20294,87662,2.8776909111119346,0.22007601813589875
11797,0.3936666666666667,0,2,0,294948,310662,20294,87662,2.8776723850457593,0.22007712314598166
11798,0.3936904761904762,0,1,0,294949,310661,20294,87662,2.877663122012672,0.22007767565518435
11799,0.3936944444444445,1,1,1,294950,310660,20295,87661,2.8776538589795844,0.22007627014392914
11800,0.3937142857142857,0,1,0,294951,310659,20295,87661,2.8776445959464967,0.22007682265515163
11801,0.3937142857142858,0,1,0,294952,310658,20295,87661,2.877635332913409,0.22007737516914835
11802,0.3937222222222222,0,2,0,294954,310656,20295,87661,2.877616806847234,0.2200784802054645
11803,0.3937380952380952,0,1,0,294955,310655,20295,87661,2.8776075438141464,0.22007903272778398
11804,0.3937499999999999,0,2,0,294957,310653,20295,87661,2.8775890177479715,0.22008013778074584
11805,0.39375,1,10,1,294967,310643,20296,87660,2.877496387417096,0.22008370511896722
11806,0.3937619047619048,0,2,0,294969,310641,20296,87660,2.8774778613509207,0.22008481023145812
11807,0.3937857142857142,0,2,0,294971,310639,20296,87660,2.8774593352847457,0.22008591535504735
11808,0.3937857142857143,0,1,0,294972,310638,20296,87660,2.877450072251658,0.22008646792100386
11809,0.3938095238095238,0,6,0,294978,310632,20296,87660,2.877394494053133,0.2200897833750113
11810,0.3938095238095239,1,1,1,294979,310631,20297,87659,2.877385231020045,0.2200883778151598
11811,0.3938333333333332,0,1,0,294980,310630,20297,87659,2.8773759679869575,0.22008893039978508
11812,0.3938333333333333,3,13,3,294993,310617,20300,87656,2.8772555485568194,0.22009023960951407
11813,0.3938492063492063,0,1,0,294994,310616,20300,87656,2.8772462855237317,0.22009079222240077
11814,0.3938571428571428,0,2,0,294996,310614,20300,87656,2.877227759457557,0.22009189745649935
11815,0.3939126984126984,0,1,0,294997,310613,20300,87656,2.877218496424469,0.2200924500777113
11816,0.3939166666666667,1,0,1,294997,310613,20301,87655,2.877218496424469,0.22009049182962226
11817,0.393952380952381,0,1,0,294998,310612,20301,87655,2.8772092333913815,0.22009104445007996
11818,0.3939642857142857,0,1,0,294999,310611,20301,87655,2.8771999703582942,0.2200915970733128
11819,0.3939682539682539,0,1,0,295000,310610,20301,87655,2.8771907073252065,0.2200921496993208
11820,0.3939999999999999,19,136,19,295136,310474,20320,87636,2.8759309348252993,0.22013011479239405
11821,0.3940000000000001,3,7,3,295143,310467,20323,87633,2.8758660935936864,0.22012810851544837
11822,0.3940238095238095,0,1,0,295144,310466,20323,87633,2.8758568305605987,0.2201286614636058
11823,0.394047619047619,3,1,3,295145,310465,20326,87630,2.875847567527511,0.22012333739434053
11824,0.3941111111111111,0,1,0,295146,310464,20326,87630,2.875838304494424,0.220123890337458
11825,0.3941190476190476,0,1,0,295147,310463,20326,87630,2.875829041461336,0.2201244432833534
11826,0.3941212121212121,0,1,0,295148,310462,20326,87630,2.8758197784282484,0.22012499623202678
11827,0.3941428571428572,0,1,0,295149,310461,20326,87630,2.875810515395161,0.22012554918347815
11828,0.3941536796536796,1,0,1,295149,310461,20327,87629,2.875810515395161,0.2201235901429325
11829,0.3941666666666665,0,2,0,295151,310459,20327,87629,2.875791989328986,0.22012469604710516
11830,0.3941666666666666,6,94,6,295245,310365,20333,87623,2.874921264218756,0.22016492959586723
11831,0.3941666666666667,11,76,11,295321,310289,20344,87612,2.874217273704102,0.22018542300723043
11832,0.3941904761904762,0,1,0,295322,310288,20344,87612,2.874208010671014,0.22018597637597387
11833,0.3942142857142857,0,1,0,295323,310287,20344,87612,2.8741987476379265,0.22018652974749875
11834,0.3942142857142858,1,0,1,295323,310287,20345,87611,2.8741987476379265,0.22018456991490282
11835,0.39425,0,1,0,295324,310286,20345,87611,2.874189484604839,0.22018512328567444
11836,0.3942857142857142,0,1,0,295325,310285,20345,87611,2.8741802215717516,0.22018567665922753
11837,0.3942857142857143,0,23,0,295348,310262,20345,87611,2.8739671718107376,0.22019840501868687
11838,0.3943030303030303,1,0,1,295348,310262,20346,87610,2.8739671718107376,0.22019644508786745
11839,0.3943095238095237,0,1,0,295349,310261,20346,87610,2.8739579087776503,0.22019699852464744
11840,0.3943095238095239,0,1,0,295350,310260,20346,87610,2.8739486457445627,0.22019755196420943
11841,0.3943333333333332,0,2,0,295352,310258,20346,87610,2.8739301196783873,0.22019865885167944
11842,0.3943333333333333,5,30,5,295382,310228,20351,87605,2.873652228685761,0.22020546309632433
11843,0.3943571428571428,0,2,0,295384,310226,20351,87605,2.873633702619586,0.22020657012651101
11844,0.3943650793650793,1,0,1,295384,310226,20352,87604,2.873633702619586,0.22020461000930044
11845,0.3943690476190476,0,1,0,295385,310225,20352,87604,2.8736244395864983,0.2202051635250321
11846,0.3944047619047619,0,2,0,295387,310223,20352,87604,2.873605913520323,0.22020627056484351
11847,0.3944166666666666,0,1,0,295388,310222,20352,87604,2.8735966504872357,0.2202068240889233
11848,0.3945,0,15,0,295403,310207,20352,87604,2.8734577049909222,0.22021512728406203
11849,0.3945238095238095,0,4,0,295407,310203,20352,87604,2.873420652858572,0.22021734157518597
11850,0.3945357142857142,0,1,0,295408,310202,20352,87604,2.8734113898254843,0.22021789515492476
11851,0.3945714285714286,0,2,0,295410,310200,20352,87604,2.8733928637593094,0.2202190023227519
11852,0.3945833333333333,0,4,0,295414,310196,20352,87604,2.873355811626959,0.22022121669180492
11853,0.3946111111111111,0,3,0,295417,310193,20352,87604,2.8733280225276965,0.22022287749781924
11854,0.3946428571428571,1,4,1,295421,310189,20353,87603,2.873290970395346,0.22022313168691177
11855,0.3946428571428572,0,1,0,295422,310188,20353,87603,2.8732817073622585,0.22022368530208075
11856,0.3946666666666666,1,40,1,295462,310148,20354,87602,2.8729111860387566,0.2202438717787555
11857,0.3946904761904762,0,1,0,295463,310147,20354,87602,2.872901923005669,0.22024442550452672
11858,0.3947023809523809,0,2,0,295465,310145,20354,87602,2.872883396939494,0.22024553296442212
11859,0.3947142857142857,0,4,0,295469,310141,20354,87602,2.8728463448071437,0.2202477479176252
11860,0.3947380952380953,0,4,0,295473,310137,20354,87602,2.8728092926747935,0.22024996291537918
11861,0.3947619047619047,0,1,0,295474,310136,20354,87602,2.8728000296417058,0.22025051667177892
11862,0.394797619047619,0,1,0,295475,310135,20354,87602,2.8727907666086185,0.22025107043096318
11863,0.3948095238095238,0,1,0,295476,310134,20354,87602,2.872781503575531,0.22025162419293198
11864,0.3948333333333332,0,4,0,295480,310130,20354,87602,2.8727444514431806,0.22025383926865327
11865,0.3948333333333333,2,13,2,295493,310117,20356,87600,2.8726240320130425,0.22025711749812052
11866,0.3948571428571428,1,3,1,295496,310114,20357,87599,2.87259624291378,0.2202568183589674
11867,0.3948809523809524,1,1,1,295497,310113,20358,87598,2.8725869798806922,0.22025541159284004
11868,0.3948888888888888,0,3,0,295500,310110,20358,87598,2.8725591907814296,0.22025707302845304
11869,0.3949047619047618,0,5,0,295505,310105,20358,87598,2.8725128756159917,0.2202598421435091
11870,0.3949166666666666,0,2,0,295507,310103,20358,87598,2.8724943495498168,0.22026094980902738
11871,0.3949166666666667,0,2,0,295509,310101,20358,87598,2.8724758234836414,0.22026205748568642
11872,0.3949880952380952,1,2,1,295511,310099,20359,87597,2.8724572974174665,0.2202612045381397
11873,0.3949999999999999,0,18,0,295529,310081,20359,87597,2.8722905628218904,0.22027117416603384
11874,0.395,173,1443,173,296972,308638,20532,87424,2.8589240060765495,0.22073311754220298
11875,0.3950000000000001,3,21,3,296993,308617,20535,87421,2.858729482381711,0.2207389189926219
11876,0.3950238095238095,0,1,0,296994,308616,20535,87421,2.8587202193486236,0.22073947636205707
11877,0.3950476190476191,0,1,0,296995,308615,20535,87421,2.858710956315536,0.22074003373430698
11878,0.3950555555555554,1,3,1,296998,308612,20536,87420,2.8586831672162734,0.2207397382029735
11879,0.3950833333333333,0,1,0,296999,308611,20536,87420,2.8586739041831857,0.22074029558292155
11880,0.3950912698412696,2,3,2,297002,308608,20538,87418,2.858646115083923,0.22073803235141126
11881,0.3951111111111111,0,2,0,297004,308606,20538,87418,2.858627589017748,0.22073914712239662
11882,0.3951190476190476,0,1,0,297005,308605,20538,87418,2.8586183259846605,0.22073970451211167
11883,0.3951428571428571,0,2,0,297007,308603,20538,87418,2.858599799918485,0.22074081929998662
11884,0.3951666666666666,1,13,1,297020,308590,20539,87417,2.858479380488347,0.22074609792251146
11885,0.3951666666666667,1,0,1,297020,308590,20540,87416,2.858479380488347,0.22074413013944233
11886,0.3951904761904762,0,1,0,297021,308589,20540,87416,2.8584701174552594,0.2207446875670762
11887,0.3952380952380951,0,3,0,297024,308586,20540,87416,2.8584423283559968,0.22074635986686936
11888,0.3952380952380953,2,2,2,297026,308584,20542,87414,2.858423802289822,0.2207435391087834
11889,0.39525,0,3,0,297029,308581,20542,87414,2.8583960131905592,0.22074521142943723
11890,0.3952800255300255,0,2,0,297031,308579,20542,87414,2.858377487124384,0.22074632632395016
11891,0.3953333333333332,0,2,0,297033,308577,20542,87414,2.858358961058209,0.22074744122972492
11892,0.3953333333333333,4,26,4,297059,308551,20546,87410,2.8581181221979324,0.22075406416288473
11893,0.3953571428571428,2,1,2,297060,308550,20548,87408,2.858108859164845,0.22075068567878411
11894,0.3954047619047619,0,1,0,297061,308549,20548,87408,2.8580995961317575,0.22075124319054848
11895,0.3954166666666666,0,4,0,297065,308545,20548,87408,2.858062543999407,0.2207534732657664
11896,0.3954166666666667,1,3,1,297068,308542,20549,87407,2.8580347549001446,0.22075317780825307
11897,0.3954444444444444,0,1,0,297069,308541,20549,87407,2.858025491867057,0.2207537353389839
11898,0.3954761904761904,0,2,0,297071,308539,20549,87407,2.858006965800882,0.22075485040889414
11899,0.3954761904761905,1,6,1,297077,308533,20550,87406,2.8579513876023563,0.22075622760071628
11900,0.3954999999999999,2,21,2,297098,308512,20552,87404,2.8577568639075177,0.22076400044453873
11901,0.3955,0,2,0,297100,308510,20552,87404,2.857738337841343,0.22076511565643045
11902,0.3955238095238095,0,1,0,297101,308509,20552,87404,2.857729074808255,0.22076567326660151
11903,0.3955454545454545,0,2,0,297103,308507,20552,87404,2.85771054874208,0.22076678849539416
11904,0.3955555555555555,0,1,0,297104,308506,20552,87404,2.8577012857089925,0.2207673461140158
11905,0.3956111111111111,1,0,1,297104,308506,20553,87403,2.8577012857089925,0.22076537790249778
11906,0.3956410256410257,0,1,0,297105,308505,20553,87403,2.857692022675905,0.2207659355203734
11907,0.3956666666666666,1,24,1,297129,308481,20554,87402,2.8574697098818036,0.2207773508839733
11908,0.3956666666666667,0,11,0,297140,308470,20554,87402,2.8573678165178404,0.22078348557109367
11909,0.3956666666666668,0,1,0,297141,308469,20554,87402,2.857358553484753,0.2207840432868283
11910,0.3957142857142857,4,10,4,297151,308459,20558,87398,2.8572659231538773,0.22078174694397218
11911,0.3957499999999999,0,1,0,297152,308458,20558,87398,2.85725666012079,0.220782304676448
11912,0.3957777777777778,0,1,0,297153,308457,20558,87398,2.8572473970877024,0.22078286241174166
11913,0.3958174603174603,0,3,0,297156,308454,20558,87398,2.8572196079884398,0.22078453563453007
11914,0.3958333333333332,11,76,11,297232,308378,20569,87387,2.856515617473786,0.22080527585814813
11915,0.3958333333333333,7,75,7,297307,308303,20576,87380,2.855820889992219,0.22083334386364842
11916,0.3958333333333334,0,2,0,297309,308301,20576,87380,2.855802363926044,0.22083446008274343
11917,0.3958571428571428,1,0,1,297309,308301,20577,87379,2.855802363926044,0.2208324909017388
11918,0.3958888888888889,0,1,0,297310,308300,20577,87379,2.8557931008929565,0.2208330490119516
11919,0.3959166666666667,0,1,0,297311,308299,20577,87379,2.855783837859869,0.22083360712498548
11920,0.3959523809523809,0,2,0,297313,308297,20577,87379,2.855765311793694,0.22083472335951637
11921,0.3959999999999999,0,3,0,297316,308294,20577,87379,2.8557375226944313,0.22083639773247102
11922,0.396,16,125,16,297441,308169,20593,87363,2.8545796435584867,0.22087467006462183
11923,0.3960000000000001,1,1,1,297442,308168,20594,87362,2.854570380525399,0.22087325866558793
11924,0.396047619047619,0,1,0,297443,308167,20594,87362,2.854561117492312,0.2208738170905294
11925,0.3960714285714286,0,4,0,297447,308163,20594,87362,2.8545240653599615,0.22087605081853234
11926,0.3960833333333333,0,4,0,297451,308159,20594,87362,2.8544870132276112,0.22087828459171574
11927,0.3960876623376622,1,2,1,297453,308157,20595,87361,2.8544684871614363,0.22087743162131684
11928,0.396095238095238,0,2,0,297455,308155,20595,87361,2.854449961095261,0.2208785485290102
11929,0.3961111111111111,0,1,0,297456,308154,20595,87361,2.8544406980621733,0.2208791069870928
11930,0.3961190476190475,0,1,0,297457,308153,20595,87361,2.854431435029086,0.2208796654479993
11931,0.3961428571428571,1,1,1,297458,308152,20596,87360,2.8544221719959983,0.22087825400999211
11932,0.3961666666666666,1,10,1,297468,308142,20597,87359,2.854329541665123,0.22088186881954786
11933,0.3961793729146671,0,1,0,297469,308141,20597,87359,2.854320278632035,0.22088242730720606
11934,0.3961904761904761,0,2,0,297471,308139,20597,87359,2.8543017525658603,0.22088354429099516
11935,0.3961904761904762,0,5,0,297476,308134,20597,87359,2.8542554374004223,0.22088633679989278
11936,0.3962032967032967,0,2,0,297478,308132,20597,87359,2.8542369113342474,0.22088745382322228
11937,0.3962301587301588,0,1,0,297479,308131,20597,87359,2.8542276483011597,0.2208880123391236
11938,0.3962499999999999,1,2,1,297481,308129,20598,87358,2.854209122234985,0.22088715937565584
11939,0.39625,0,12,0,297493,308117,20598,87358,2.854097965837934,0.22089386181174536
11940,0.3962619047619046,0,1,0,297494,308116,20598,87358,2.8540887028048463,0.22089442036644635
11941,0.3962619047619047,0,2,0,297496,308114,20598,87358,2.8540701767386714,0.22089553748432253
11942,0.3962857142857142,0,1,0,297497,308113,20598,87358,2.8540609137055837,0.2208960960474978
11943,0.3963095238095238,1,4,1,297501,308109,20599,87357,2.8540238615732334,0.22089636024335846
11944,0.3963333333333332,1,4,1,297505,308105,20600,87356,2.853986809440883,0.22089662444589986
11945,0.3963333333333333,1,31,1,297536,308074,20601,87355,2.853699655415169,0.22091197155494413
11946,0.3963333333333334,0,8,0,297544,308066,20601,87355,2.853625551150469,0.22091644095786517
11947,0.3963571428571429,0,1,0,297545,308065,20601,87355,2.853616288117381,0.22091699964594608
11948,0.3963809523809524,1,1,1,297546,308064,20602,87354,2.8536070250842935,0.2209155880612415
11949,0.3963888888888889,0,1,0,297547,308063,20602,87354,2.853597762051206,0.22091614675140422
11950,0.3964047619047619,0,1,0,297548,308062,20602,87354,2.8535884990181186,0.22091670544439274
11951,0.3964285714285714,0,4,0,297552,308058,20602,87354,2.8535514468857683,0.22091894024460562
11952,0.3964523809523809,0,2,0,297554,308056,20602,87354,2.853532920819593,0.22092005766166764
11953,0.396452380952381,0,1,0,297555,308055,20602,87354,2.8535236577865057,0.2209206163744376
11954,0.3964761904761905,0,1,0,297556,308054,20602,87354,2.853514394753418,0.2209211750900336
11955,0.3964999999999999,5,15,5,297571,308039,20607,87349,2.8533754492571046,0.22091970418930265
11956,0.3965000000000001,1,7,1,297578,308032,20608,87348,2.8533106080254917,0.2209216449997471
11957,0.3965238095238094,0,1,0,297579,308031,20608,87348,2.8533013449924045,0.220922203758925
11958,0.3965238095238095,1,1,1,297580,308030,20609,87347,2.853292081959317,0.22092079205416604
11959,0.3965277777777778,0,1,0,297581,308029,20609,87347,2.853282818926229,0.22092135081542633
11960,0.396547619047619,0,4,0,297585,308025,20609,87347,2.853245766793879,0.22092358588873265
11961,0.3966190476190476,0,3,0,297588,308022,20609,87347,2.8532179776946163,0.22092526222339132
11962,0.3966309523809523,0,1,0,297589,308021,20609,87347,2.8532087146615286,0.22092582100726413
11963,0.3966428571428571,0,1,0,297590,308020,20609,87347,2.8531994516284414,0.2209263797939636
11964,0.396654761904762,0,2,0,297592,308018,20609,87347,2.853180925562266,0.22092749737584258
11965,0.3966666666666665,1,2,1,297594,308016,20610,87346,2.853162399496091,0.22092664444230856
11966,0.3966666666666666,49,435,49,298029,307581,20659,87297,2.849132980103005,0.22107334417212404
11967,0.3966666666666667,45,373,45,298402,307208,20704,87252,2.845677868761347,0.22119353039598438
11968,0.3966666666666668,0,2,0,298404,307206,20704,87252,2.845659342695172,0.22119465190210363
11969,0.3967500000000001,0,2,0,298406,307204,20704,87252,2.845640816628997,0.2211957734195956
11970,0.3967857142857143,0,2,0,298408,307202,20704,87252,2.845622290562822,0.2211968949484604
11971,0.3968095238095238,0,4,0,298412,307198,20704,87252,2.8455852384304716,0.2211991380403093
11972,0.3968333333333333,2,17,2,298429,307181,20706,87250,2.8454277668679833,0.22120472275252198
11973,0.3968571428571428,0,1,0,298430,307180,20706,87250,2.8454185038348956,0.22120528357376468
11974,0.3969047619047618,0,1,0,298431,307179,20706,87250,2.8454092408018083,0.22120584439785107
11975,0.396924603174603,1,5,1,298436,307174,20707,87249,2.8453629256363704,0.22120667405298372
11976,0.3969285714285714,0,1,0,298437,307173,20707,87249,2.8453536626032827,0.2212072348905487
11977,0.3969285714285715,0,1,0,298438,307172,20707,87249,2.8453443995701955,0.22120779573095753
11978,0.3969444444444445,0,1,0,298439,307171,20707,87249,2.845335136537108,0.22120835657421023
11979,0.3969523809523809,0,1,0,298440,307170,20707,87249,2.84532587350402,0.22120891742030682
11980,0.396952380952381,0,2,0,298442,307168,20707,87249,2.845307347437845,0.2212100391210318
11981,0.3969642857142857,0,1,0,298443,307167,20707,87249,2.8452980844047575,0.22121059997566023
11982,0.3969761904761905,0,1,0,298444,307166,20707,87249,2.84528882137167,0.2212111608331326
11983,0.3969999999999999,1,7,1,298451,307159,20708,87248,2.845223980140057,0.22121311234334076
11984,0.397,11,44,11,298495,307115,20719,87237,2.8448164066842048,0.22121607092141032
11985,0.3970238095238095,0,1,0,298496,307114,20719,87237,2.844807143651117,0.22121663188377866
11986,0.3970576923076923,0,1,0,298497,307113,20719,87237,2.8447978806180294,0.22121719284899202
11987,0.3970595238095238,0,1,0,298498,307112,20719,87237,2.844788617584942,0.2212177538170504
11988,0.3970833333333333,1,5,1,298503,307107,20720,87236,2.844742302419504,0.22121858382169837
11989,0.3970952380952381,0,2,0,298505,307105,20720,87236,2.8447237763533293,0.2212197057876305
11990,0.3970970418470419,1,6,1,298511,307099,20721,87235,2.8446681981548037,0.22122109683669175
11991,0.3971190476190476,0,1,0,298512,307098,20721,87235,2.8446589351217164,0.22122165783741152
11992,0.3971428571428571,3,11,3,298523,307087,20724,87232,2.8445570417577533,0.22122190409287912
11993,0.3971626984126983,1,0,1,298523,307087,20725,87231,2.8445570417577533,0.2212199290927627
11994,0.3971666666666666,1,8,1,298531,307079,20726,87230,2.8444829374930527,0.22122244229779184
11995,0.3971666666666668,0,1,0,298532,307078,20726,87230,2.844473674459965,0.2212230033374925
11996,0.3971785714285714,0,1,0,298533,307077,20726,87230,2.844464411426878,0.2212235643800389
11997,0.3971904761904761,0,1,0,298534,307076,20726,87230,2.84445514839379,0.22122412542543102
11998,0.3972121212121212,0,4,0,298538,307072,20726,87230,2.84441809626144,0.22122636963545708
11999,0.3972222222222222,0,1,0,298539,307071,20726,87230,2.844408833228352,0.22122693069507812
12000,0.3972380952380953,0,1,0,298540,307070,20726,87230,2.844399570195265,0.22122749175754503
12001,0.39725,0,1,0,298541,307069,20726,87230,2.8443903071621772,0.2212280528228578
12002,0.3972619047619047,0,1,0,298542,307068,20726,87230,2.8443810441290895,0.22122861389101645
12003,0.3972777777777777,0,1,0,298543,307067,20726,87230,2.844371781096002,0.22122917496202102
12004,0.3972857142857143,0,1,0,298544,307066,20726,87230,2.8443625180629146,0.22122973603587154
12005,0.3973095238095238,0,1,0,298545,307065,20726,87230,2.844353255029827,0.221230297112568
12006,0.3973333333333332,3,8,3,298553,307057,20729,87227,2.8442791507651264,0.22122886041533513
12007,0.3973333333333333,5,38,5,298591,307019,20734,87222,2.8439271555077994,0.22124030732470748
12008,0.3973571428571428,1,0,1,298591,307019,20735,87221,2.8439271555077994,0.22123833198051948
12009,0.3973809523809523,0,1,0,298592,307018,20735,87221,2.8439178924747117,0.22123889315871845
12010,0.3973809523809524,0,3,0,298595,307015,20735,87221,2.843890103375449,0.22124057671039682
12011,0.3974047619047618,0,1,0,298596,307014,20735,87221,2.843880840342362,0.2212411378999835
12012,0.3974444444444444,0,1,0,298597,307013,20735,87221,2.843871577309274,0.2212416990924172
12013,0.3974469696969697,0,1,0,298598,307012,20735,87221,2.8438623142761865,0.2212422602876979
12014,0.3974761904761905,0,1,0,298599,307011,20735,87221,2.843853051243099,0.2212428214858256
12015,0.3974999999999999,2,12,2,298611,306999,20737,87219,2.8437418948460484,0.22124560522350578
12016,0.3975,52,367,52,298978,306632,20789,87167,2.840342361702916,0.22134896228786766
12017,0.3975000000000001,1,5,1,298983,306627,20790,87166,2.8402960465374782,0.2213497954509095
12018,0.3975238095238095,0,2,0,298985,306625,20790,87166,2.8402775204713033,0.22135091965027134
12019,0.3975454545454545,0,2,0,298987,306623,20790,87166,2.840258994405128,0.2213520438610525
12020,0.3975476190476191,0,1,0,298988,306622,20790,87166,2.8402497313720403,0.22135260597072537
12021,0.3975555555555555,0,2,0,298990,306620,20790,87166,2.8402312053058654,0.2213537301986358
12022,0.3975555555555556,0,2,0,298992,306618,20790,87166,2.8402126792396905,0.221354854437966
12023,0.3975833333333333,0,1,0,298993,306617,20790,87166,2.8402034162066028,0.22135541656191354
12024,0.3975930735930735,0,1,0,298994,306616,20790,87166,2.840194153173515,0.2213559786887161
12025,0.3976111111111111,0,2,0,298996,306614,20790,87166,2.84017562710734,0.2213571029508863
12026,0.3976190476190475,0,1,0,298997,306613,20790,87166,2.8401663640742525,0.22135766508625396
12027,0.3976190476190476,1,7,1,299004,306606,20791,87165,2.8401015228426396,0.22135962272488324
12028,0.3976666666666666,3,18,3,299022,306588,20794,87162,2.8399347882470636,0.22136380952380952
12029,0.3976666666666667,0,9,0,299031,306579,20794,87162,2.839851420949276,0.22136886938368114
12030,0.3976904761904762,1,0,1,299031,306579,20795,87161,2.839851420949276,0.221366891857571
12031,0.3977142857142857,1,0,1,299031,306579,20796,87160,2.839851420949276,0.22136491432141597
12032,0.3977222222222222,0,1,0,299032,306578,20796,87160,2.839842157916188,0.2213654765351579
12033,0.3977280701754386,0,1,0,299033,306577,20796,87160,2.8398328948831004,0.22136603875175562
12034,0.3977777777777778,0,1,0,299034,306576,20796,87160,2.839823631850013,0.22136660097120914
12035,0.397780303030303,0,2,0,299036,306574,20796,87160,2.839805105783838,0.2213677254186837
12036,0.3977857142857143,0,1,0,299037,306573,20796,87160,2.83979584275075,0.22136828764670474
12037,0.3978095238095238,0,1,0,299038,306572,20796,87160,2.839786579717663,0.2213688498775817
12038,0.3978205128205128,0,2,0,299040,306570,20796,87160,2.8397680536514875,0.2213699743479034
12039,0.3978333333333333,4,7,4,299047,306563,20800,87156,2.8397032124198747,0.22136599960885808
12040,0.3978571428571428,1,11,1,299058,306552,20801,87155,2.8396013190559115,0.22137020677813704
12041,0.3978888888888888,0,1,0,299059,306551,20801,87155,2.8395920560228243,0.22137076905101777
12042,0.3979166666666667,1,2,1,299061,306549,20802,87154,2.839573529956649,0.22136991590107263
12043,0.3979505494505495,0,1,0,299062,306548,20802,87154,2.8395642669235612,0.22137047817892722
12044,0.397952380952381,0,1,0,299063,306547,20802,87154,2.839555003890474,0.22137104045963815
12045,0.3979761904761905,0,1,0,299064,306546,20802,87154,2.8395457408573863,0.2213716027432055
12046,0.3979761904761906,0,1,0,299065,306545,20802,87154,2.8395364778242986,0.22137216502962923
12047,0.3979999999999999,19,86,19,299151,306459,20821,87135,2.838739856978769,0.22138294791079133
12048,0.398,3,3,3,299154,306456,20824,87132,2.8387120678795066,0.22137870057013934
12049,0.3980238095238095,0,3,0,299157,306453,20824,87132,2.838684278780244,0.2213803879721026
12050,0.3980833333333333,0,1,0,299158,306452,20824,87132,2.8386750157471563,0.22138095044514006
12051,0.398095238095238,0,2,0,299160,306450,20824,87132,2.838656489680981,0.22138207539978963
12052,0.3980952380952381,1,2,1,299162,306448,20825,87131,2.838637963614806,0.2213812220672343
12053,0.3981190476190476,0,1,0,299163,306447,20825,87131,2.8386287005817183,0.22138178455096574
12054,0.3981666666666665,0,1,0,299164,306446,20825,87131,2.838619437548631,0.22138234703755555
12055,0.3981666666666666,1,11,1,299175,306435,20826,87130,2.838517544184668,0.2213865562232414
12056,0.3981666666666667,0,6,0,299181,306429,20826,87130,2.8384619659861423,0.22138993136988355
12057,0.3981818181818182,0,2,0,299183,306427,20826,87130,2.8384434399199674,0.22139105644163362
12058,0.3981904761904761,0,2,0,299185,306425,20826,87130,2.8384249138537925,0.22139218152481865
12059,0.3981904761904764,1,2,1,299187,306423,20827,87129,2.838406387787617,0.2213913282107574
12060,0.398202380952381,0,2,0,299189,306421,20827,87129,2.838387861721442,0.22139245330961757
12061,0.3982142857142857,0,8,0,299197,306413,20827,87129,2.8383137574567416,0.22139695381941443
12062,0.3982222222222222,0,1,0,299198,306412,20827,87129,2.838304494423654,0.2213975163960045
12063,0.3982380952380953,0,2,0,299200,306410,20827,87129,2.838285968357479,0.22139864155776173
12064,0.39825,0,2,0,299202,306408,20827,87129,2.8382674422913037,0.2213997667309554
12065,0.3982738095238095,0,1,0,299203,306407,20827,87129,2.8382581792582164,0.22140032932184095
12066,0.3982857142857142,0,1,0,299204,306406,20827,87129,2.8382489162251288,0.22140089191558565
12067,0.3983055555555556,1,0,1,299204,306406,20828,87128,2.8382489162251288,0.2213989134356879
12068,0.3983333333333332,37,239,37,299443,306167,20865,87091,2.8360350513172032,0.22146021187108716
12069,0.3983333333333334,32,222,32,299665,305945,20897,87059,2.833978657971766,0.22152191835197607
12070,0.3983809523809523,1,1,1,299666,305944,20898,87058,2.833969394938679,0.22152050116793298
12071,0.3983809523809524,0,2,0,299668,305942,20898,87058,2.8339508688725035,0.22152162849872772
12072,0.3984444444444444,0,1,0,299669,305941,20898,87058,2.8339416058394162,0.22152219216842792
12073,0.3984523809523809,0,3,0,299672,305938,20898,87058,2.833913816740153,0.2215238831947399
12074,0.398452380952381,0,1,0,299673,305937,20898,87058,2.833904553707066,0.22152444687591444
12075,0.3984642857142856,0,1,0,299674,305936,20898,87058,2.8338952906739783,0.22152501055995766
12076,0.3984999999999999,1,10,1,299684,305926,20899,87057,2.833802660343103,0.22152866663443457
12077,0.3985,3,33,3,299717,305893,20902,87054,2.8334969802512133,0.22154132745637453
12078,0.3985064935064935,1,0,1,299717,305893,20903,87053,2.8334969802512133,0.22153934637329303
12079,0.3985555555555555,0,1,0,299718,305892,20903,87053,2.833487717218126,0.2215399101655448
12080,0.398560606060606,0,1,0,299719,305891,20903,87053,2.8334784541850384,0.22154047396066615
12081,0.3985714285714285,0,1,0,299720,305890,20903,87053,2.8334691911519507,0.2215410377586571
12082,0.3985714285714286,0,6,0,299726,305884,20903,87053,2.8334136129534255,0.22154442060686574
12083,0.3985833333333333,0,1,0,299727,305883,20903,87053,2.833404349920338,0.22154498442494452
12084,0.3986190476190476,0,1,0,299728,305882,20903,87053,2.83339508688725,0.2215455482458931
12085,0.3986274509803921,0,1,0,299729,305881,20903,87053,2.833385823854163,0.22154611206971145
12086,0.3986309523809523,0,4,0,299733,305877,20903,87053,2.8333487717218127,0.22154836739368336
12087,0.3986428571428571,0,1,0,299734,305876,20903,87053,2.833339508688725,0.22154893123185104
12088,0.3986666666666666,3,22,3,299756,305854,20906,87050,2.8331357219607987,0.22155539266589294
12089,0.3986666666666667,0,5,0,299761,305849,20906,87050,2.833089406795361,0.22155821216139518
12090,0.3986904761904762,1,3,1,299764,305846,20907,87049,2.8330616176960985,0.2215579226001858
12091,0.3987142857142857,0,2,0,299766,305844,20907,87049,2.833043091629923,0.22155905042848817
12092,0.3987142857142858,1,0,1,299766,305844,20908,87048,2.833043091629923,0.22155706911823098
12093,0.39875,3,7,3,299773,305837,20911,87045,2.8329782503983103,0.22155507251541176
12094,0.3987619047619047,0,1,0,299774,305836,20911,87045,2.832968987365223,0.22155563643953258
12095,0.3987857142857143,0,1,0,299775,305835,20911,87045,2.8329597243321354,0.22155620036652413
12096,0.3988095238095238,0,6,0,299781,305829,20911,87045,2.83290414613361,0.22155958398875975
12097,0.3988095238095239,0,1,0,299782,305828,20911,87045,2.8328948831005225,0.22156014793584694
12098,0.3988333333333332,0,1,0,299783,305827,20911,87045,2.832885620067435,0.22156071188580503
12099,0.3988333333333333,1,8,1,299791,305819,20912,87044,2.8328115158027343,0.22156324214802617
12100,0.3988333333333334,1,1,1,299792,305818,20913,87043,2.832802252769647,0.22156182466572147
12101,0.3988809523809523,1,0,1,299792,305818,20914,87042,2.832802252769647,0.22155984320114036
12102,0.3988888888888888,0,2,0,299794,305816,20914,87042,2.8327837267034717,0.22156097113969933
12103,0.3989285714285714,1,1,1,299795,305815,20915,87041,2.8327744636703844,0.22155955362779237
12104,0.398952380952381,0,1,0,299796,305814,20915,87041,2.8327652006372968,0.22156011760064145
12105,0.3989761904761905,0,1,0,299797,305813,20915,87041,2.832755937604209,0.2215606815763617
12106,0.3989880952380952,0,2,0,299799,305811,20915,87041,2.832737411538034,0.22156180953641574
12107,0.3989999999999999,11,76,11,299875,305735,20926,87030,2.8320334210233797,0.22158288034829987
12108,0.3990000000000001,0,3,0,299878,305732,20926,87030,2.832005631924117,0.2215845728456419
12109,0.3990238095238095,0,1,0,299879,305731,20926,87030,2.8319963688910295,0.2215851370171682
12110,0.399047619047619,1,7,1,299886,305724,20927,87029,2.8319315276594166,0.22158710436330212
12111,0.3990476190476191,0,2,0,299888,305722,20927,87029,2.8319130015932417,0.22158823274797518
12112,0.399063492063492,0,1,0,299889,305721,20927,87029,2.831903738560154,0.22158879694462125
12113,0.3990714285714286,1,1,1,299890,305720,20928,87028,2.8318944755270667,0.2215873791846171
12114,0.3990714285714287,0,5,0,299895,305715,20928,87028,2.831848160361629,0.22159020020726022
12115,0.3990833333333333,1,1,1,299896,305714,20929,87027,2.831838897328541,0.22158878242913269
12116,0.3990952380952381,0,2,0,299898,305712,20929,87027,2.831820371262366,0.22158991085682858
12117,0.3991111111111112,0,1,0,299899,305711,20929,87027,2.8318111082292785,0.2215904750749864
12118,0.3991428571428571,0,1,0,299900,305710,20929,87027,2.831801845196191,0.22159103929601745
12119,0.3991666666666665,0,1,0,299901,305709,20929,87027,2.8317925821631036,0.22159160351992177
12120,0.3991666666666666,8,70,8,299971,305639,20937,87019,2.831144169846975,0.22161524787474088
12121,0.3991666666666667,9,64,9,300035,305575,20946,87010,2.8305513357293712,0.22163353159188456
12122,0.3992142857142858,0,1,0,300036,305574,20946,87010,2.8305420726962836,0.2216340961424816
12123,0.3992380952380952,0,1,0,300037,305573,20946,87010,2.8305328096631963,0.22163466069595475
12124,0.3992857142857143,0,9,0,300046,305564,20946,87010,2.830449442365408,0.22163974180664028
12125,0.3993333333333333,2,13,2,300059,305551,20948,87008,2.83032902293527,0.22164311606662948
12126,0.3993333333333334,4,50,4,300109,305501,20952,87004,2.829865871280892,0.22166341830040381
12127,0.3993611111111111,0,1,0,300110,305500,20952,87004,2.8298566082478045,0.22166398304221102
12128,0.3993795093795094,0,1,0,300111,305499,20952,87004,2.8298473452147173,0.2216645477868959
12129,0.3993809523809524,0,1,0,300112,305498,20952,87004,2.8298380821816296,0.22166511253445842
12130,0.3994047619047619,0,1,0,300113,305497,20952,87004,2.829828819148542,0.22166567728489864
12131,0.399404761904762,0,3,0,300116,305494,20952,87004,2.8298010300492793,0.22166737155348562
12132,0.3994166666666667,0,3,0,300119,305491,20952,87004,2.8297732409500167,0.22166906584797258
12133,0.3994285714285714,1,5,1,300124,305486,20953,87003,2.8297269257845787,0.2216699066725437
12134,0.3994523809523809,0,2,0,300126,305484,20953,87003,2.829708399718404,0.2216710362381429
12135,0.399452380952381,1,0,1,300126,305484,20954,87002,2.829708399718404,0.2216690531636797
12136,0.3994848484848485,0,1,0,300127,305483,20954,87002,2.829699136685316,0.2216696179471827
12137,0.3994999999999999,0,7,0,300134,305476,20954,87002,2.8296342954537033,0.2216735715122886
12138,0.3995,4,20,4,300154,305456,20958,86998,2.8294490347919523,0.22167693538605798
12139,0.3995238095238095,1,4,1,300158,305452,20959,86997,2.829411982659602,0.22167721156124745
12140,0.3995508658008658,1,0,1,300158,305452,20960,86996,2.829411982659602,0.2216752283105023
12141,0.3995714285714286,0,3,0,300161,305449,20960,86996,2.8293841935603394,0.22167692288091326
12142,0.3995833333333333,0,2,0,300163,305447,20960,86996,2.829365667494164,0.2216780526089139
12143,0.399595238095238,1,0,1,300163,305447,20961,86995,2.829365667494164,0.22167606932999018
12144,0.3996428571428571,0,4,0,300167,305443,20961,86995,2.8293286153618142,0.22167832880607893
12145,0.3996428571428572,0,2,0,300169,305441,20961,86995,2.829310089295639,0.221679458561396
12146,0.3996587301587301,0,3,0,300172,305438,20961,86995,2.8292823001963763,0.221681153215963
12147,0.3996666666666666,1,27,1,300199,305411,20962,86994,2.8290321983030124,0.22169442285393917
12148,0.3996666666666668,0,2,0,300201,305409,20962,86994,2.829013672236837,0.2216955527862937
12149,0.3996969696969696,0,1,0,300202,305408,20962,86994,2.82900440920375,0.22169611775679024
12150,0.3997142857142857,1,1,1,300203,305407,20963,86993,2.828995146170662,0.2216946992864424
12151,0.3997222222222222,0,1,0,300204,305406,20963,86993,2.8289858831375745,0.22169526425908323
12152,0.39975,1,0,1,300204,305406,20964,86992,2.8289858831375745,0.22169328080163508
12153,0.3997539682539682,1,1,1,300205,305405,20965,86991,2.828976620104487,0.221691862302368
12154,0.3997619047619047,1,1,1,300206,305404,20966,86990,2.8289673570713996,0.221690443788641
12155,0.3997777777777777,0,1,0,300207,305403,20966,86990,2.828958094038312,0.22169100875907571
12156,0.3997857142857143,0,2,0,300209,305401,20966,86990,2.828939567972137,0.22169213870858404
12157,0.3998095238095238,0,1,0,300210,305400,20966,86990,2.8289303049390493,0.2216927036876577
12158,0.3998333333333332,0,2,0,300212,305398,20966,86990,2.828911778872874,0.22169383365444406
12159,0.3998333333333333,2,17,2,300229,305381,20968,86988,2.8287543073103856,0.22169947167079967
12160,0.3998479853479854,0,1,0,300230,305380,20968,86988,2.8287450442772983,0.22170003670024058
12161,0.3998571428571428,1,1,1,300231,305379,20969,86987,2.8287357812442107,0.2216986181269529
12162,0.3998629148629147,0,1,0,300232,305378,20969,86987,2.828726518211123,0.2216991831585386
12163,0.3998809523809523,0,2,0,300234,305376,20969,86987,2.828707992144948,0.22170031323035047
12164,0.3999047619047619,0,1,0,300235,305375,20969,86987,2.8286987291118604,0.22170087827057666
12165,0.3999166666666667,0,1,0,300236,305374,20969,86987,2.8286894660787727,0.22170144331368305
12166,0.3999444444444445,0,2,0,300238,305372,20969,86987,2.828670940012598,0.22170257340853658
12167,0.3999523809523809,0,1,0,300239,305371,20969,86987,2.82866167697951,0.22170313846028372
12168,0.399969696969697,0,1,0,300240,305370,20969,86987,2.8286524139464224,0.22170370351491117
12169,0.3999999999999999,2,20,2,300260,305350,20971,86985,2.8284671532846715,0.22171103776109702
12170,0.4,420,3630,420,303890,301720,21391,86565,2.7948423431768497,0.22294191122500226
12171,0.4000000000000001,5,26,5,303916,301694,21396,86560,2.7946015043165735,0.22294683377376665
12172,0.4000119047619047,0,1,0,303917,301693,21396,86560,2.794592241283486,0.22294740800457433
12173,0.4000119047619048,0,3,0,303920,301690,21396,86560,2.7945644521842232,0.22294913071474565
12174,0.4000238095238095,1,0,1,303920,301690,21397,86559,2.7945644521842232,0.22294712929073868
12175,0.4000238095238096,0,2,0,303922,301688,21397,86559,2.7945459261180483,0.22294827777162476
12176,0.4000277777777778,0,1,0,303923,301687,21397,86559,2.7945366630849606,0.222948852016505
12177,0.400047619047619,0,1,0,303924,301686,21397,86559,2.794527400051873,0.2229494262643434
12178,0.4000555555555555,1,0,1,303924,301686,21398,86558,2.794527400051873,0.22294742481532231
12179,0.4000555555555556,0,1,0,303925,301685,21398,86558,2.7945181370187853,0.22294799906244286
12180,0.4000714285714285,0,1,0,303926,301684,21398,86558,2.794508873985698,0.22294857331252158
12181,0.4000952380952381,0,1,0,303927,301683,21398,86558,2.7944996109526103,0.2229491475655585
12182,0.4001190476190476,0,5,0,303932,301678,21398,86558,2.7944532957871724,0.2229520188751172
12183,0.4001349206349207,0,1,0,303933,301677,21398,86558,2.794444032754085,0.2229525931459039
12184,0.40015873015873,0,5,0,303938,301672,21398,86558,2.794397717588647,0.22295546454421347
12185,0.4001666666666665,0,3,0,303941,301669,21398,86558,2.7943699284893846,0.2229571874187009
12186,0.4001666666666666,2,8,2,303949,301661,21400,86556,2.794295824224684,0.22295777876806014
12187,0.4001666666666667,0,3,0,303952,301658,21400,86556,2.7942680351254214,0.22295950171812454
12188,0.4002023809523808,1,5,1,303957,301653,21401,86555,2.794221719959984,0.22296037175946914
12189,0.4002225274725275,0,1,0,303958,301652,21401,86555,2.7942124569268962,0.22296094609319256
12190,0.4002380952380951,1,1,1,303959,301651,21402,86554,2.7942031938938086,0.2229595188109375
12191,0.4002380952380953,0,1,0,303960,301650,21402,86554,2.794193930860721,0.22296009314690216
12192,0.40025,0,2,0,303962,301648,21402,86554,2.794175404794546,0.22296124182770827
12193,0.4002857142857142,0,1,0,303963,301647,21402,86554,2.7941661417614583,0.2229618161725498
12194,0.4003333333333332,0,2,0,303965,301645,21402,86554,2.7941476156952834,0.22296296487110992
12195,0.4003333333333333,0,18,0,303983,301627,21402,86554,2.7939808810997073,0.22297330369080404
12196,0.4003333333333334,2,5,2,303988,301622,21404,86552,2.7939345659342694,0.2229721722732589
12197,0.4003571428571428,1,6,1,303994,301616,21405,86551,2.793878987735744,0.22297361702566162
12198,0.4003809523809524,1,0,1,303994,301616,21406,86550,2.793878987735744,0.22297161523678014
12199,0.4004166666666666,0,3,0,303997,301613,21406,86550,2.7938511986364816,0.22297333852015777
12200,0.4004166666666667,0,1,0,303998,301612,21406,86550,2.793841935603394,0.22297391295386979
12201,0.4004285714285714,1,2,1,304000,301610,21407,86549,2.793823409537219,0.22297306000891387
12202,0.4004444444444444,0,1,0,304001,301609,21407,86549,2.7938141465041313,0.22297363444782795
12203,0.4004545454545454,0,1,0,304002,301608,21407,86549,2.7938048834710436,0.22297420888970185
12204,0.400468253968254,0,1,0,304003,301607,21407,86549,2.7937956204379564,0.2229747833345356
12205,0.4004761904761904,0,3,0,304006,301604,21407,86549,2.7937678313386933,0.2229765066867962
12206,0.4004761904761905,0,3,0,304009,301601,21407,86549,2.7937400422394307,0.22297823006569625
12207,0.4004999999999999,3,25,3,304034,301576,21410,86546,2.793508466412242,0.2229865866918134
12208,0.4005,1,1,1,304035,301575,21411,86545,2.7934992033791546,0.2229851592291044
12209,0.4005238095238095,0,1,0,304036,301574,21411,86545,2.793489940346067,0.22298573375691477
12210,0.4005595515595515,0,7,0,304043,301567,21411,86545,2.793425099114454,0.22298975553448488
12211,0.4005714285714286,0,1,0,304044,301566,21411,86545,2.7934158360813663,0.22299033008598057
12212,0.4005833333333333,1,4,1,304048,301562,21412,86544,2.793378783949016,0.22299062627220398
12213,0.400595238095238,0,1,0,304049,301561,21412,86544,2.793369520915929,0.22299120083482563
12214,0.4005952380952381,0,2,0,304051,301559,21412,86544,2.7933509948497535,0.22299234996895154
12215,0.4006071428571429,0,1,0,304052,301558,21412,86544,2.7933417318166662,0.22299292454045586
12216,0.4006190476190476,0,1,0,304053,301557,21412,86544,2.7933324687835785,0.2229934991149211
12217,0.4006501831501833,0,2,0,304055,301555,21412,86544,2.793313942717403,0.22299464827273455
12218,0.4006666666666665,0,1,0,304056,301554,21412,86544,2.793304679684316,0.22299522285608275
12219,0.4006666666666666,6,47,6,304103,301507,21418,86538,2.7928693171292007,0.2230102178871007
12220,0.4006666666666667,0,8,0,304111,301499,21418,86538,2.7927952128645,0.22301481559748168
12221,0.4006666666666668,1,1,1,304112,301498,21419,86537,2.792785949831413,0.22301338796758025
12222,0.4007142857142856,0,1,0,304113,301497,21419,86537,2.7927766867983252,0.22301396269399074
12223,0.4007142857142857,1,13,1,304126,301484,21420,86536,2.792656267368187,0.22301943198804186
12224,0.4007380952380953,0,1,0,304127,301483,21420,86536,2.7926470043350995,0.22302000675224667
12225,0.40075,0,1,0,304128,301482,21420,86536,2.792637741302012,0.22302058151941404
12226,0.4007619047619047,0,2,0,304130,301480,21420,86536,2.792619215235837,0.2230217310626366
12227,0.4007857142857142,1,1,1,304131,301479,21421,86535,2.792609952202749,0.22302030339111475
12228,0.4008095238095238,0,1,0,304132,301478,21421,86535,2.7926006891696615,0.2230208781664532
12229,0.400830280830281,0,6,0,304138,301472,21421,86535,2.7925451109711363,0.22302432688070062
12230,0.4008333333333332,10,73,10,304211,301399,21431,86525,2.791868909555745,0.22304626679452677
12231,0.4008333333333334,9,80,9,304291,301319,21440,86516,2.7911278669087407,0.2230742454909949
12232,0.4008888888888889,0,1,0,304292,301318,21440,86516,2.791118603875653,0.2230748206706993
12233,0.4009166666666667,1,2,1,304294,301316,21441,86515,2.791100077809478,0.22307396778493727
12234,0.4009285714285714,0,1,0,304295,301315,21441,86515,2.7910908147763904,0.22307454296985793
12235,0.4009316794316795,0,1,0,304296,301314,21441,86515,2.7910815517433027,0.22307511815774478
12236,0.4009444444444444,0,2,0,304298,301312,21441,86515,2.791063025677128,0.2230762685424171
12237,0.4009523809523809,0,1,0,304299,301311,21441,86515,2.79105376264404,0.22307684373920264
12238,0.4009999999999999,1,2,1,304301,301309,21442,86514,2.7910352365778652,0.22307599085149668
12239,0.401,9,66,9,304367,301243,21451,86505,2.7904238763940863,0.22309592828331803
12240,0.4010000000000001,1,0,1,304367,301243,21452,86504,2.7904238763940863,0.2230939246467413
12241,0.4010714285714285,0,1,0,304368,301242,21452,86504,2.790414613360999,0.22309450000773703
12242,0.4010714285714286,1,2,1,304370,301240,21453,86503,2.7903960872948237,0.22309364708066942
12243,0.4010833333333333,0,2,0,304372,301238,21453,86503,2.7903775612286488,0.22309479781606795
12244,0.4011111111111111,0,1,0,304373,301237,21453,86503,2.790368298195561,0.2230953731882189
12245,0.4011190476190476,0,2,0,304375,301235,21453,86503,2.790349772129386,0.22309652394142437
12246,0.4011309523809524,0,1,0,304376,301234,21453,86503,2.7903405090962985,0.2230970993224789
12247,0.4011428571428571,1,4,1,304380,301230,21454,86502,2.790303456963948,0.223097397171242
12248,0.4011428571428572,0,1,0,304381,301229,21454,86502,2.7902941939308605,0.22309797256345248
12249,0.4011547619047618,0,5,0,304386,301224,21454,86502,2.790247878765423,0.22310084956902554
12250,0.4011666666666666,1,14,1,304400,301210,21455,86501,2.7901181963021973,0.22310690179025097
12251,0.4011666666666667,1,4,1,304404,301206,21456,86500,2.790081144169847,0.22310719978540441
12252,0.4011904761904761,0,1,0,304405,301205,21456,86500,2.7900718811367593,0.22310777524148515
12253,0.4011904761904762,0,4,0,304409,301201,21456,86500,2.790034829004409,0.2231100770954937
12254,0.4012222222222222,0,1,0,304410,301200,21456,86500,2.790025565971322,0.22311065256641732
12255,0.4012301587301588,0,1,0,304411,301199,21456,86500,2.790016302938234,0.2231112280403096
12256,0.40125,2,7,2,304418,301192,21458,86498,2.7899514617066212,0.22311124867806753
12257,0.4012619047619047,0,1,0,304419,301191,21458,86498,2.7899421986735335,0.2231118241683411
12258,0.4013095238095238,1,3,1,304422,301188,21459,86497,2.789914409574271,0.22311154674542477
12259,0.4013205128205128,1,1,1,304423,301187,21460,86496,2.7899051465411833,0.22311011831831676
12260,0.4013333333333332,0,6,0,304429,301181,21460,86496,2.789849568342658,0.22311357134934495
12261,0.4013333333333333,3,29,3,304458,301152,21463,86493,2.789580940383119,0.2231242502805402
12262,0.4013333333333334,0,5,0,304463,301147,21463,86493,2.7895346252176814,0.2231271282633371
12263,0.4013571428571428,0,1,0,304464,301146,21463,86493,2.7895253621845937,0.22312770386880576
12264,0.4014166666666666,1,1,1,304465,301145,21464,86492,2.789516099151506,0.2231262753555517
12265,0.4014285714285714,1,10,1,304475,301135,21465,86491,2.7894234688206305,0.22313002739754298
12266,0.4014523809523809,0,1,0,304476,301134,21465,86491,2.7894142057875433,0.22313060303128024
12267,0.4014761904761904,0,1,0,304477,301133,21465,86491,2.7894049427544556,0.22313117866798754
12268,0.4014761904761905,1,1,1,304478,301132,21466,86490,2.789395679721368,0.2231297501173824
12269,0.4014999999999999,5,27,5,304505,301105,21471,86485,2.789145577828004,0.22313527180783818
12270,0.4015119047619048,0,1,0,304506,301104,21471,86485,2.7891363147949164,0.22313584750857224
12271,0.4015151515151515,0,1,0,304507,301103,21471,86485,2.7891270517618287,0.22313642321227695
12272,0.401547619047619,0,3,0,304510,301100,21471,86485,2.789099262662566,0.22313815034121548
12273,0.4015714285714286,0,2,0,304512,301098,21471,86485,2.789080736596391,0.22313930177536168
12274,0.4015790043290043,0,1,0,304513,301097,21471,86485,2.7890714735633035,0.223139877496891
12275,0.4016190476190476,0,1,0,304514,301096,21471,86485,2.789062210530216,0.22314045322139114
12276,0.4016428571428572,1,0,1,304514,301096,21472,86484,2.789062210530216,0.22313844883636927
12277,0.4016666666666665,0,1,0,304515,301095,21472,86484,2.7890529474971286,0.2231390245601542
12278,0.4016666666666666,32,252,32,304767,300843,21504,86452,2.786718663159065,0.2232200260783124
12279,0.4016666666666667,24,230,24,304997,300613,21528,86428,2.7845881655489273,0.22330450779116423
12280,0.4017142857142857,0,4,0,305001,300609,21528,86428,2.784551113416577,0.22330681562744648
12281,0.4017301587301587,0,2,0,305003,300607,21528,86428,2.784532587350402,0.22330796956347618
12282,0.40175,0,3,0,305006,300604,21528,86428,2.7845047982511395,0.22330970048988197
12283,0.4017857142857142,0,1,0,305007,300603,21528,86428,2.784495535218052,0.22331027747131366
12284,0.4017857142857143,0,4,0,305011,300599,21528,86428,2.7844584830857015,0.22331258542685653
12285,0.4018095238095238,0,1,0,305012,300598,21528,86428,2.784449220052614,0.22331316242319638
12286,0.4018174603174603,0,2,0,305014,300596,21528,86428,2.784430693986439,0.2233143164248212
12287,0.4018333333333333,2,9,2,305023,300587,21530,86426,2.784347326688651,0.2233154958618961
12288,0.4018333333333334,2,12,2,305035,300575,21532,86424,2.7842361702916003,0.22331840650751036
12289,0.4018452380952382,0,1,0,305036,300574,21532,86424,2.7842269072585126,0.22331898356063856
12290,0.4018571428571428,0,2,0,305038,300572,21532,86424,2.7842083811923377,0.2233201376758416
12291,0.4018690476190477,0,2,0,305040,300570,21532,86424,2.7841898551261623,0.2233212918029737
12292,0.4019047619047618,0,1,0,305041,300569,21532,86424,2.784180592093075,0.22332186887101316
12293,0.4019047619047619,0,5,0,305046,300564,21532,86424,2.784134276927637,0.22332475425594592
12294,0.4019325396825395,1,5,1,305051,300559,21533,86423,2.784087961762199,0.2233256327167672
12295,0.4019325396825398,0,6,0,305057,300553,21533,86423,2.784032383563674,0.2233290953444141
12296,0.4019444444444444,0,1,0,305058,300552,21533,86423,2.7840231205305863,0.2233296724594612
12297,0.4019523809523809,0,2,0,305060,300550,21533,86423,2.7840045944644114,0.22333082669850352
12298,0.401952380952381,0,1,0,305061,300549,21533,86423,2.7839953314313237,0.22333140382249878
12299,0.4019761904761904,1,0,1,305061,300549,21534,86422,2.7839953314313237,0.22332939677650263
12300,0.4019761904761905,0,1,0,305062,300548,21534,86422,2.7839860683982365,0.2233299738997855
12301,0.4019787157287158,0,1,0,305063,300547,21534,86422,2.783976805365149,0.22333055102605118
12302,0.4019841269841271,0,4,0,305067,300543,21534,86422,2.7839397532327985,0.2233328595609422
12303,0.4019999999999999,1,4,1,305071,300539,21535,86421,2.7839027011004482,0.22333316105023776
12304,0.402,9,76,9,305147,300463,21544,86412,2.7831987105857943,0.2233589660743134
12305,0.4020476190476191,0,1,0,305148,300462,21544,86412,2.7831894475527066,0.22335954341723663
12306,0.4020833333333333,1,2,1,305150,300460,21545,86411,2.7831709214865317,0.2233586906229725
12307,0.4021428571428571,0,8,0,305158,300452,21545,86411,2.783096817221831,0.2233633094919907
12308,0.4021666666666667,0,9,0,305167,300443,21545,86411,2.7830134499240433,0.22336850594798038
12309,0.4021904761904761,1,2,1,305169,300441,21546,86410,2.782994923857868,0.223367653179131
12310,0.4021969696969696,0,1,0,305170,300440,21546,86410,2.7829856608247803,0.2233682305803283
12311,0.4022142857142857,2,3,2,305173,300437,21548,86408,2.7829578717255177,0.22336594760175263
12312,0.4022222222222222,0,2,0,305175,300435,21548,86408,2.7829393456593428,0.2233671024162257
12313,0.4022380952380953,1,2,1,305177,300433,21549,86407,2.7829208195931674,0.2233662496122428
12314,0.4022619047619048,0,1,0,305178,300432,21549,86407,2.78291155656008,0.22336682702623056
12315,0.402267316017316,0,1,0,305179,300431,21549,86407,2.7829022935269925,0.2233674044432036
12316,0.4022709235209236,0,3,0,305182,300428,21549,86407,2.78287450442773,0.22336913671203484
12317,0.4022777777777777,0,2,0,305184,300426,21549,86407,2.7828559783615545,0.22337029157284927
12318,0.402294733044733,0,5,0,305189,300421,21549,86407,2.782809663196117,0.22337317877713092
12319,0.4023333333333332,0,8,0,305197,300413,21549,86407,2.7827355589314164,0.2233777984592317
12320,0.4023333333333333,3,27,3,305224,300386,21552,86404,2.7824854570380526,0.22338736782233254
12321,0.4023333333333334,0,2,0,305226,300384,21552,86404,2.7824669309718773,0.22338852291177597
12322,0.4023571428571428,0,4,0,305230,300380,21552,86404,2.7824298788395274,0.22339083312649954
12323,0.4023809523809524,0,6,0,305236,300374,21552,86404,2.7823743006410018,0.22339429853817952
12324,0.4024047619047619,0,1,0,305237,300373,21552,86404,2.7823650376079145,0.22339487611724584
12325,0.4024285714285714,0,1,0,305238,300372,21552,86404,2.782355774574827,0.2233954536992988
12326,0.4024523809523808,3,2,3,305240,300370,21555,86401,2.7823372485086515,0.22339058512659946
12327,0.4024999999999999,2,3,2,305243,300367,21557,86399,2.782309459409389,0.22338830197070064
12328,0.4025,47,376,47,305619,299991,21604,86352,2.7788265589684684,0.22351123224699296
12329,0.4025000000000001,0,12,0,305631,299979,21604,86352,2.778715402571418,0.22351817482935618
12330,0.4025119047619047,0,1,0,305632,299978,21604,86352,2.7787061395383303,0.22351875339735458
12331,0.402547619047619,0,4,0,305636,299974,21604,86352,2.77866908740598,0.22352106769930058
12332,0.4025595238095238,0,1,0,305637,299973,21604,86352,2.778659824372893,0.22352164628227528
12333,0.4025692640692642,0,2,0,305639,299971,21604,86352,2.7786412983067175,0.22352280345721068
12334,0.4025833333333333,0,1,0,305640,299970,21604,86352,2.77863203527363,0.2235233820491714
12335,0.4025932678432679,1,3,1,305643,299967,21605,86351,2.778604246174367,0.22352310790592206
12336,0.402595238095238,0,1,0,305644,299966,21605,86351,2.77859498314128,0.22352368650615945
12337,0.4026190476190476,0,1,0,305645,299965,21605,86351,2.7785857201081923,0.2235242651093923
12338,0.4026309523809523,0,1,0,305646,299964,21605,86351,2.7785764570751046,0.22352484371562067
12339,0.4026428571428571,0,1,0,305647,299963,21605,86351,2.778567194042017,0.22352542232484457
12340,0.4026428571428572,0,2,0,305649,299961,21605,86351,2.778548667975842,0.22352657955227898
12341,0.4026666666666665,0,1,0,305650,299960,21605,86351,2.7785394049427543,0.22352715817048957
12342,0.4026666666666667,7,58,7,305708,299902,21612,86344,2.7780021490236764,0.2235466516158096
12343,0.4026904761904762,0,1,0,305709,299901,21612,86344,2.7779928859905887,0.22354723038485935
12344,0.4027222222222222,0,2,0,305711,299899,21612,86344,2.7779743599244138,0.2235483879319496
12345,0.4027272727272727,0,2,0,305713,299897,21612,86344,2.7779558338582384,0.22354954549102762
12346,0.4027619047619047,0,1,0,305714,299896,21612,86344,2.777946570825151,0.22355012427506213
12347,0.4028333333333333,0,17,0,305731,299879,21612,86344,2.7777890992626624,0.22355996406221276
12348,0.4028333333333334,1,2,1,305733,299877,21613,86343,2.7777705731964875,0.2235591113872922
12349,0.4028571428571428,1,9,1,305742,299868,21614,86342,2.7776872058986997,0.22356231066000362
12350,0.4029166666666666,0,1,0,305743,299867,21614,86342,2.777677942865612,0.22356288952354814
12351,0.4029166666666667,0,1,0,305744,299866,21614,86342,2.7776686798325243,0.2235634683900903
12352,0.4029285714285714,0,1,0,305745,299865,21614,86342,2.7776594167994366,0.2235640472596302
12353,0.4029523809523809,0,1,0,305746,299864,21614,86342,2.7776501537663494,0.2235646261321678
12354,0.4029761904761905,1,1,1,305747,299863,21615,86341,2.7776408907332617,0.22356319458110221
12355,0.4029999999999999,9,58,9,305805,299805,21624,86332,2.7771036348141838,0.22357867803396203
12356,0.403,0,2,0,305807,299803,21624,86332,2.7770851087480084,0.22357983606769652
12357,0.4030198412698413,0,2,0,305809,299801,21624,86332,2.7770665826818335,0.22358099411342724
12358,0.4030238095238095,1,1,1,305810,299800,21625,86331,2.777057319648746,0.22357956237649917
12359,0.403030303030303,0,1,0,305811,299799,21625,86331,2.777048056615658,0.22358014140315438
12360,0.403047619047619,0,1,0,305812,299798,21625,86331,2.777038793582571,0.22358072043280872
12361,0.4030530303030303,0,2,0,305814,299796,21625,86331,2.7770202675163955,0.2235818785011149
12362,0.4030555555555555,0,2,0,305816,299794,21625,86331,2.7770017414502206,0.22358303658141793
12363,0.4030595238095237,2,0,2,305816,299794,21627,86329,2.7770017414502206,0.2235790149770928
12364,0.4030833333333333,0,1,0,305817,299793,21627,86329,2.776992478417133,0.2235795940143271
12365,0.403095238095238,1,0,1,305817,299793,21628,86328,2.776992478417133,0.22357758319283333
12366,0.4030952380952381,0,1,0,305818,299792,21628,86328,2.7769832153840452,0.22357816222935875
12367,0.4031071428571428,0,6,0,305824,299786,21628,86328,2.77692763718552,0.2235816365114966
12368,0.4031190476190475,0,1,0,305825,299785,21628,86328,2.7769183741524324,0.22358221556901736
12369,0.4031428571428571,0,1,0,305826,299784,21628,86328,2.776909111119345,0.22358279462953753
12370,0.4031428571428572,1,0,1,305826,299784,21629,86327,2.776909111119345,0.22358078376425433
12371,0.4031666666666666,0,21,0,305847,299763,21629,86327,2.7767145874245065,0.2235929446502111
12372,0.4031666666666667,1,3,1,305850,299760,21630,86326,2.7766867983252435,0.2235926710629238
12373,0.4031904761904761,0,1,0,305851,299759,21630,86326,2.776677535292156,0.2235932501910201
12374,0.4032142857142857,0,3,0,305854,299756,21630,86326,2.7766497461928936,0.2235949875933092
12375,0.40325,0,1,0,305855,299755,21630,86326,2.776640483159806,0.2235955667334057
12376,0.4032619047619047,0,6,0,305861,299749,21630,86326,2.7765849049612807,0.22359904163698763
12377,0.4033095238095238,0,1,0,305862,299748,21630,86326,2.776575641928193,0.22359962079808535
12378,0.4033333333333332,32,389,32,306251,299359,21662,86294,2.7729723220571345,0.2237607382802675
12379,0.4033333333333334,47,384,47,306635,298975,21709,86247,2.7694153173515135,0.22388908213964934
12380,0.4033571428571428,0,2,0,306637,298973,21709,86247,2.7693967912853386,0.22389024453559006
12381,0.4033809523809523,0,1,0,306638,298972,21709,86247,2.769387528252251,0.22389082573808664
12382,0.4033809523809524,0,3,0,306641,298969,21709,86247,2.7693597391529883,0.22389256936368168
12383,0.4034047619047619,1,0,1,306641,298969,21710,86246,2.7693597391529883,0.2238905546253391
12384,0.4034069264069264,1,1,1,306642,298968,21711,86245,2.7693504761199006,0.22388912108366021
12385,0.4034285714285714,0,1,0,306643,298967,21711,86245,2.7693412130868134,0.22388970229380187
12386,0.4034404761904762,0,1,0,306644,298966,21711,86245,2.7693319500537257,0.2238902835069611
12387,0.4034523809523809,0,1,0,306645,298965,21711,86245,2.769322687020638,0.22389086472313802
12388,0.4034761904761905,0,3,0,306648,298962,21711,86245,2.7692948979213754,0.22389260838977484
12389,0.4034999999999999,1,1,1,306649,298961,21712,86244,2.7692856348882877,0.22389117482898716
12390,0.4035,4,34,4,306683,298927,21716,86240,2.768970691763311,0.22390287849166726
12391,0.4035000000000001,0,2,0,306685,298925,21716,86240,2.768952165697136,0.22390404112523205
12392,0.4035324675324675,0,2,0,306687,298923,21716,86240,2.7689336396309607,0.22390520377087103
12393,0.403547619047619,0,3,0,306690,298920,21716,86240,2.768905850531698,0.22390694776196904
12394,0.4035714285714285,1,2,1,306692,298918,21717,86239,2.7688873244655228,0.22390609543640647
12395,0.4035714285714286,0,3,0,306695,298915,21717,86239,2.76885953536626,0.22390783946161796
12396,0.4035833333333333,1,0,1,306695,298915,21718,86238,2.76885953536626,0.22390582443859972
12397,0.4035833333333334,0,1,0,306696,298914,21718,86238,2.768850272333173,0.22390640578265206
12398,0.403593795093795,0,1,0,306697,298913,21718,86238,2.7688410093000853,0.22390698712972315
12399,0.4036111111111111,0,1,0,306698,298912,21718,86238,2.7688317462669976,0.22390756847981305
12400,0.4036147186147186,0,1,0,306699,298911,21718,86238,2.76882248323391,0.22390814983292182
12401,0.4036349206349206,0,1,0,306700,298910,21718,86238,2.7688132202008227,0.22390873118904941
12402,0.4036363636363635,1,1,1,306701,298909,21719,86237,2.768803957167735,0.2239072974923795
12403,0.4036428571428571,1,1,1,306702,298908,21720,86236,2.7687946941346473,0.22390586378081964
12404,0.4036666666666666,0,4,0,306706,298904,21720,86236,2.768757642002297,0.22390818922989042
12405,0.4036666666666667,3,14,3,306720,298890,21723,86233,2.7686279595390713,0.2239102832082218
12406,0.4037142857142857,0,1,0,306721,298889,21723,86233,2.768618696505984,0.22391086460913684
12407,0.4037460317460318,0,1,0,306722,298888,21723,86233,2.7686094334728963,0.22391144601307122
12408,0.40375,0,9,0,306731,298879,21723,86233,2.7685260661751085,0.22391667878435365
12409,0.4037738095238095,0,1,0,306732,298878,21723,86233,2.768516803142021,0.22391726021848246
12410,0.4037738095238096,0,4,0,306736,298874,21723,86233,2.7684797510096706,0.22391958598519374
12411,0.4037857142857143,0,1,0,306737,298873,21723,86233,2.768470487976583,0.22392016743442064
12412,0.4038095238095238,0,2,0,306739,298871,21723,86233,2.768451961910408,0.2239213303419336
12413,0.4038333333333332,1,4,1,306743,298867,21724,86232,2.7684149097780577,0.22392164092869626
12414,0.4038333333333333,0,7,0,306750,298860,21724,86232,2.768350068546445,0.22392571125860833
12415,0.4038333333333334,0,2,0,306752,298858,21724,86232,2.76833154248027,0.2239268742371913
12416,0.4038571428571428,0,4,0,306756,298854,21724,86232,2.7682944903479196,0.22392920023059784
12417,0.4038888888888888,0,1,0,306757,298853,21724,86232,2.768285227314832,0.22392978173649974
12418,0.4038888888888889,0,1,0,306758,298852,21724,86232,2.7682759642817443,0.2239303632454218
12419,0.4039047619047619,0,1,0,306759,298851,21724,86232,2.768266701248657,0.223930944757364
12420,0.4039166666666666,0,1,0,306760,298850,21724,86232,2.7682574382155694,0.2239315262723264
12421,0.4039285714285714,0,1,0,306761,298849,21724,86232,2.7682481751824817,0.22393210779030906
12422,0.4039365079365079,1,0,1,306761,298849,21725,86231,2.7682481751824817,0.22393009244832243
12423,0.403939393939394,0,1,0,306762,298848,21725,86231,2.768238912149394,0.22393067396560187
12424,0.4039999999999999,18,130,18,306892,298718,21743,86213,2.7670347178480124,0.22397001020962198
12425,0.4040000000000001,0,12,0,306904,298706,21743,86213,2.7669235614509615,0.22397699256207151
12426,0.4040357142857143,1,0,1,306904,298706,21744,86212,2.7669235614509615,0.22397497648849884
12427,0.4040454545454545,0,1,0,306905,298705,21744,86212,2.766914298417874,0.22397555836712849
12428,0.404047619047619,0,1,0,306906,298704,21744,86212,2.7669050353847866,0.22397614024878154
12429,0.4040530303030302,0,1,0,306907,298703,21744,86212,2.766895772351699,0.22397672213345804
12430,0.4040555555555556,0,1,0,306908,298702,21744,86212,2.7668865093186112,0.22397730402115798
12431,0.4041190476190476,0,1,0,306909,298701,21744,86212,2.7668772462855236,0.2239778859118814
12432,0.4041666666666666,13,76,13,306985,298625,21757,86199,2.7661732557708696,0.2239959046213334
12433,0.4041666666666667,8,67,8,307052,298558,21765,86191,2.7655526325540034,0.22401877587726024
12434,0.4042380952380952,0,2,0,307054,298556,21765,86191,2.7655341064878285,0.2240199403764032
12435,0.40425,1,1,1,307055,298555,21766,86190,2.765524843454741,0.22401850576355767
12436,0.4042857142857142,0,1,0,307056,298554,21766,86190,2.765515580421653,0.22401908801696713
12437,0.4042857142857143,3,18,3,307074,298536,21769,86187,2.765348845826077,0.22402351821960215
12438,0.4043095238095238,1,4,1,307078,298532,21770,86186,2.7653117936937273,0.22402383044203805
12439,0.4043333333333333,1,12,1,307090,298520,21771,86185,2.7652006372966764,0.22402880128929958
12440,0.4043333333333334,4,26,4,307116,298494,21775,86181,2.7649597984364,0.22403587443946188
12441,0.4043571428571428,0,1,0,307117,298493,21775,86181,2.7649505354033126,0.22403645684397697
12442,0.4043752570958453,0,1,0,307118,298492,21775,86181,2.764941272370225,0.22403703925152013
12443,0.4043809523809523,0,2,0,307120,298490,21775,86181,2.76492274630405,0.22403820407569067
12444,0.4043809523809524,0,1,0,307121,298489,21775,86181,2.7649134832709623,0.2240387864923181
12445,0.4044047619047619,1,1,1,307122,298488,21776,86180,2.7649042202378746,0.22403735169028877
12446,0.4044206349206349,0,1,0,307123,298487,21776,86180,2.764894957204787,0.22403793410924253
12447,0.4044285714285714,0,1,0,307124,298486,21776,86180,2.7648856941716997,0.2240385165312245
12448,0.4044444444444444,1,1,1,307125,298485,21777,86179,2.764876431138612,0.22403708171287148
12449,0.4044523809523809,0,1,0,307126,298484,21777,86179,2.7648671681055244,0.22403766413717982
12450,0.4044642857142857,0,1,0,307127,298483,21777,86179,2.764857905072437,0.22403824656451637
12451,0.4044642857142858,1,1,1,307128,298482,21778,86178,2.7648486420393494,0.22403681172983933
12452,0.4044761904761904,1,0,1,307128,298482,21779,86177,2.7648486420393494,0.22403479445430888
12453,0.4044761904761905,0,1,0,307129,298481,21779,86177,2.7648393790062618,0.22403537688024167
12454,0.4044871794871794,0,1,0,307130,298480,21779,86177,2.764830115973174,0.22403595930920275
12455,0.4044999999999999,0,6,0,307136,298474,21779,86177,2.764774537774649,0.22403945394656455
12456,0.4045,1,27,1,307163,298447,21780,86176,2.764524435881285,0.22405316374735781
12457,0.4045238095238095,1,5,1,307168,298442,21781,86175,2.764478120715847,0.2240540589729523
12458,0.4045555555555555,1,2,1,307170,298440,21782,86174,2.764459594649672,0.22405320659154374
12459,0.404595238095238,0,1,0,307171,298439,21782,86174,2.7644503316165845,0.22405378913349264
12460,0.4046044511044511,0,1,0,307172,298438,21782,86174,2.764441068583497,0.22405437167847078
12461,0.4046309523809523,1,0,1,307172,298438,21783,86173,2.764441068583497,0.22405235419683783
12462,0.4046388888888889,0,1,0,307173,298437,21783,86173,2.7644318055504096,0.22405293674111437
12463,0.4046428571428571,0,4,0,307177,298433,21783,86173,2.7643947534180593,0.22405526694851355
12464,0.4046666666666666,1,8,1,307185,298425,21784,86172,2.7643206491533587,0.22405790996809646
12465,0.4046666666666667,5,22,5,307207,298403,21789,86167,2.7641168624254324,0.22406063915542035
12466,0.4046904761904761,1,0,1,307207,298403,21790,86166,2.7641168624254324,0.22405862146974925
12467,0.4047142857142857,0,1,0,307208,298402,21790,86166,2.764107599392345,0.22405920409394436
12468,0.4047222222222222,3,2,3,307210,298400,21793,86163,2.76408907332617,0.22405431619786614
12469,0.4047499999999999,0,1,0,307211,298399,21793,86163,2.7640798102930826,0.22405489881995622
12470,0.40475,0,1,0,307212,298398,21793,86163,2.764070547259995,0.22405548144507634
12471,0.4047619047619047,1,1,1,307213,298397,21794,86162,2.7640612842269072,0.22405404632319098
12472,0.4048095238095238,0,1,0,307214,298396,21794,86162,2.7640520211938195,0.22405462895063943
12473,0.4048333333333332,0,2,0,307216,298394,21794,86162,2.7640334951276446,0.22405579421462674
12474,0.4048333333333333,0,10,0,307226,298384,21794,86162,2.763940864796769,0.22406162071637722
12475,0.4048333333333334,0,1,0,307227,298383,21794,86162,2.7639316017636815,0.22406220338321914
12476,0.4048571428571428,1,1,1,307228,298382,21795,86161,2.763922338730594,0.22406076823658214
12477,0.4048809523809524,0,4,0,307232,298378,21795,86161,2.7638852865982435,0.2240630989314478
12478,0.4049007936507937,0,1,0,307233,298377,21795,86161,2.7638760235651563,0.22406368161274048
12479,0.4049096638655463,0,6,0,307239,298371,21795,86161,2.7638204453666306,0.22406717776413926
12480,0.4049920634920634,0,2,0,307241,298369,21795,86161,2.7638019193004557,0.22406834317218421
12481,0.4049999999999999,3,19,3,307260,298350,21798,86158,2.763625921671792,0.22407336128247007
12482,0.405,194,1395,194,308655,296955,21992,85964,2.750703990514654,0.22449656454759362
12483,0.4050000000000001,1,13,1,308668,296942,21993,85963,2.750583571084516,0.2245021611104582
12484,0.4050097402597402,0,1,0,308669,296941,21993,85963,2.750574308051428,0.22450274742494203
12485,0.4050238095238095,0,1,0,308670,296940,21993,85963,2.750565045018341,0.22450333374248832
12486,0.405047619047619,0,2,0,308672,296938,21993,85963,2.7505465189521656,0.2245045063867684
12487,0.4050476190476191,1,0,1,308672,296938,21994,85962,2.7505465189521656,0.22450248106555237
12488,0.4050833333333333,0,1,0,308673,296937,21994,85962,2.750537255919078,0.22450306738852804
12489,0.40510989010989,0,2,0,308675,296935,21994,85962,2.750518729852903,0.2245042400436671
12490,0.4051190476190476,0,1,0,308676,296934,21994,85962,2.7505094668198153,0.22450482637583052
12491,0.4051666666666667,2,6,2,308682,296928,21996,85960,2.75045388862129,0.22450429368379266
12492,0.4052142857142856,1,0,1,308682,296928,21997,85959,2.75045388862129,0.22450226829325623
12493,0.4052142857142857,1,3,1,308685,296925,21998,85958,2.7504260995220275,0.2245020019170347
12494,0.4052380952380952,0,9,0,308694,296916,21998,85958,2.7503427322242393,0.22450727915711174
12495,0.4052777777777777,0,1,0,308695,296915,21998,85958,2.750333469191152,0.22450786553243504
12496,0.4052777777777778,0,1,0,308696,296914,21998,85958,2.7503242061580644,0.22450845191082136
12497,0.4053333333333332,0,1,0,308697,296913,21998,85958,2.7503149431249767,0.22450903829227076
12498,0.4053333333333333,0,20,0,308717,296893,21998,85958,2.7501296824632258,0.22452076656453815
12499,0.4053333333333334,2,8,2,308725,296885,22000,85956,2.750055578198525,0.2245214070593275
12500,0.4053452380952381,0,1,0,308726,296884,22000,85956,2.750046315165438,0.224521993522098
12501,0.4053571428571428,3,5,3,308731,296879,22003,85953,2.75,0.22451884899903873
12502,0.4053571428571429,0,2,0,308733,296877,22003,85953,2.749981473933825,0.22452002194185408
12503,0.4054166666666666,0,2,0,308735,296875,22003,85953,2.7499629478676497,0.22452119489692499
12504,0.4054285714285713,0,2,0,308737,296873,22003,85953,2.749944421801475,0.22452236786425164
12505,0.4054404761904762,0,3,0,308740,296870,22003,85953,2.749916632702212,0.22452412733822158
12506,0.4054545454545454,0,1,0,308741,296869,22003,85953,2.7499073696691245,0.22452471383567296
12507,0.4054642857142858,0,2,0,308743,296867,22003,85953,2.749888843602949,0.22452588683976804
12508,0.4054761904761904,0,2,0,308745,296865,22003,85953,2.7498703175367742,0.22452705985611962
12509,0.4054761904761905,2,4,2,308749,296861,22005,85951,2.749833265404424,0.22452535448209565
12510,0.4054999999999999,2,25,2,308774,296836,22007,85949,2.749601689577235,0.22453596666536044
12511,0.4055,0,2,0,308776,296834,22007,85949,2.74958316351106,0.2245371398416335
12512,0.405547619047619,0,1,0,308777,296833,22007,85949,2.7495739004779725,0.22453772643436734
12513,0.4055555555555555,0,4,0,308781,296829,22007,85949,2.749536848345622,0.2245400728359519
12514,0.4055952380952381,0,1,0,308782,296828,22007,85949,2.749527585312535,0.22454065944401047
12515,0.4056125541125541,1,1,1,308783,296827,22008,85948,2.7495183222794473,0.2245392201685063
12516,0.4056626984126984,1,0,1,308783,296827,22009,85947,2.7495183222794473,0.22453719427129323
12517,0.4056666666666666,3,33,3,308816,296794,22012,85944,2.749212642187558,0.224550475782389
12518,0.4056666666666667,0,4,0,308820,296790,22012,85944,2.7491755900552075,0.2245528225869664
12519,0.4057142857142857,2,11,2,308831,296779,22014,85942,2.749073696691245,0.22455522430177596
12520,0.4057619047619047,0,1,0,308832,296778,22014,85942,2.749064433658157,0.2245558110367893
12521,0.4057857142857143,0,1,0,308833,296777,22014,85942,2.7490551706250694,0.22455639777486877
12522,0.4058214285714285,0,4,0,308837,296773,22014,85942,2.749018118492719,0.22455874475784854
12523,0.4058333333333332,12,59,12,308896,296714,22026,85930,2.7484715995405535,0.22456905112846406
12524,0.4058333333333334,11,68,11,308964,296646,22037,85919,2.7478417132905997,0.22458667154601178
12525,0.4058571428571428,0,1,0,308965,296645,22037,85919,2.7478324502575124,0.2245872586024822
12526,0.4058809523809524,0,1,0,308966,296644,22037,85919,2.7478231872244248,0.22458784566202167
12527,0.4058928571428571,0,3,0,308969,296641,22037,85919,2.747795398125162,0.2245896068590548
12528,0.4059523809523809,0,4,0,308973,296637,22037,85919,2.747758345992812,0.22459195516473404
12529,0.405952380952381,0,2,0,308975,296635,22037,85919,2.747739819926637,0.22459312933598916
12530,0.4059761904761904,1,0,1,308975,296635,22038,85918,2.747739819926637,0.22459110240933935
12531,0.4059999999999999,1,4,1,308979,296631,22039,85917,2.7477027677942867,0.22459142382132438
12532,0.406,17,106,17,309085,296525,22056,85900,2.746720886287006,0.224619206380336
12533,0.4060000000000001,0,1,0,309086,296524,22056,85900,2.746711623253918,0.22461979373679475
12534,0.4060238095238094,0,2,0,309088,296522,22056,85900,2.7466930971877432,0.22462096845892757
12535,0.4060238095238095,0,2,0,309090,296520,22056,85900,2.746674571121568,0.22462214319334764
12536,0.406047619047619,0,1,0,309091,296519,22056,85900,2.7466653080884806,0.22462273056516543
12537,0.4060800865800866,0,1,0,309092,296518,22056,85900,2.746656045055393,0.22462331794005513
12538,0.4060833333333333,1,3,1,309095,296515,22057,85899,2.7466282559561304,0.22462305250330794
12539,0.406095238095238,0,3,0,309098,296512,22057,85899,2.7466004668568678,0.22462481466275813
12540,0.4061031746031746,1,1,1,309099,296511,22058,85898,2.74659120382378,0.22462337444986913
12541,0.4061111111111111,0,1,0,309100,296510,22058,85898,2.7465819407906924,0.22462396184180247
12542,0.4061190476190475,0,1,0,309101,296509,22058,85898,2.746572677757605,0.2246245492368079
12543,0.4061190476190476,0,2,0,309103,296507,22058,85898,2.74655415169143,0.2246257240360351
12544,0.4061666666666666,2,3,2,309106,296504,22060,85896,2.746526362592167,0.2246234309623431
12545,0.4061666666666667,4,13,4,309119,296491,22064,85892,2.746405943162029,0.22462295656449163
12546,0.4061904761904761,1,1,1,309120,296490,22065,85891,2.7463966801289414,0.22462151623642387
12547,0.4061904761904762,1,3,1,309123,296487,22066,85890,2.746368891029679,0.2246212507551448
12548,0.4062142857142857,0,3,0,309126,296484,22066,85890,2.7463411019304163,0.2246230130709724
12549,0.4062380952380952,0,1,0,309127,296483,22066,85890,2.7463318388973286,0.2246236005157268
12550,0.4062477522477523,1,2,1,309129,296481,22067,85889,2.7463133128311537,0.22462274760049167
12551,0.4062499999999999,0,1,0,309130,296480,22067,85889,2.746304049798066,0.2246233350506971
12552,0.40625,0,7,0,309137,296473,22067,85889,2.746239208566453,0.22462744728817194
12553,0.4062857142857142,0,3,0,309140,296470,22067,85889,2.7462114194671905,0.22462920972175365
12554,0.4062857142857143,0,1,0,309141,296469,22067,85889,2.746202156434103,0.22462979720576004
12555,0.4063095238095238,0,2,0,309143,296467,22067,85889,2.7461836303679275,0.22463097218299177
12556,0.4063333333333332,1,3,1,309146,296464,22068,85888,2.746155841268665,0.22463070678327823
12557,0.4063333333333333,1,28,1,309174,296436,22069,85887,2.7458964763422133,0.22464512990324934
12558,0.4063333333333334,0,3,0,309177,296433,22069,85887,2.7458686872429507,0.22464689265536722
12559,0.4063809523809523,0,1,0,309178,296432,22069,85887,2.745859424209863,0.22464748024555412
12560,0.4064285714285713,0,2,0,309180,296430,22069,85887,2.745840898143688,0.22464865543514936
12561,0.4064285714285715,0,1,0,309181,296429,22069,85887,2.7458316351106005,0.2246492430345578
12562,0.4064523809523809,0,1,0,309182,296428,22069,85887,2.7458223720775132,0.22464983063704014
12563,0.406452380952381,0,2,0,309184,296426,22069,85887,2.745803846011338,0.2246510058512266
12564,0.4064761904761904,0,1,0,309185,296425,22069,85887,2.74579458297825,0.2246515934629308
12565,0.4064761904761905,0,1,0,309186,296424,22069,85887,2.745785319945163,0.22465218107770898
12566,0.4065,0,27,0,309213,296397,22069,85887,2.7455352180517987,0.22466804783877956
12567,0.4065000000000001,0,1,0,309214,296396,22069,85887,2.7455259550187114,0.22466863553963948
12568,0.4065238095238095,1,2,1,309216,296394,22070,85886,2.745507428952536,0.22466778277702207
12569,0.406547619047619,0,2,0,309218,296392,22070,85886,2.745488902886361,0.22466895819272886
12570,0.4066111111111111,0,1,0,309219,296391,22070,85886,2.7454796398532735,0.2246695459051944
12571,0.4066428571428572,0,1,0,309220,296390,22070,85886,2.745470376820186,0.22467013362073476
12572,0.4066666666666665,0,2,0,309222,296388,22070,85886,2.745451850754011,0.22467130906104
12573,0.4066666666666666,47,382,47,309604,296006,22117,85839,2.741913372114565,0.22480063900273672
12574,0.4066666666666667,37,371,37,309975,295635,22154,85802,2.7384767868390827,0.22494409299569784
12575,0.4067142857142857,0,1,0,309976,295634,22154,85802,2.738467523805995,0.22494468272528026
12576,0.4067380952380952,0,4,0,309980,295630,22154,85802,2.7384304716736447,0.22494704167453178
12577,0.4067499999999999,0,1,0,309981,295629,22154,85802,2.738421208640557,0.22494763141957524
12578,0.40675,0,1,0,309982,295628,22154,85802,2.73841194560747,0.224948221167711
12579,0.4067777777777778,0,3,0,309985,295625,22154,85802,2.738384156508207,0.22494999043067218
12580,0.4067857142857143,0,2,0,309987,295623,22154,85802,2.738365630442032,0.22495116995477485
12581,0.4068095238095238,0,1,0,309988,295622,22154,85802,2.738356367408944,0.22495175972146483
12582,0.4068333333333332,0,1,0,309989,295621,22154,85802,2.738347104375857,0.22495234949124726
12583,0.4068333333333333,1,7,1,309996,295614,22155,85801,2.738282263144244,0.2249544459447059
12584,0.4068333333333334,1,13,1,310009,295601,22156,85800,2.7381618437141055,0.22496008138416
12585,0.4068571428571428,0,1,0,310010,295600,22156,85800,2.7381525806810183,0.22496067121132668
12586,0.4068928571428571,0,1,0,310011,295599,22156,85800,2.7381433176479306,0.22496126104158637
12587,0.4069047619047619,0,1,0,310012,295598,22156,85800,2.738134054614843,0.22496185087493903
12588,0.406904761904762,0,1,0,310013,295597,22156,85800,2.7381247915817557,0.22496244071138471
12589,0.4069166666666666,1,1,1,310014,295596,22157,85799,2.738115528548668,0.2249609984399376
12590,0.4069523809523809,0,1,0,310015,295595,22157,85799,2.7381062655155803,0.22496158827878782
12591,0.406952380952381,0,1,0,310016,295594,22157,85799,2.7380970024824927,0.2249621781207311
12592,0.4069642857142856,0,1,0,310017,295593,22157,85799,2.7380877394494054,0.2249627679657675
12593,0.407,8,56,8,310073,295537,22165,85791,2.7375690095965024,0.22497954516846388
12594,0.4070000000000001,0,1,0,310074,295536,22165,85791,2.7375597465634147,0.22498013515958745
12595,0.4070079365079365,0,1,0,310075,295535,22165,85791,2.737550483530327,0.2249807251538054
12596,0.4070238095238095,0,1,0,310076,295534,22165,85791,2.73754122049724,0.2249813151511178
12597,0.4070238095238096,0,1,0,310077,295533,22165,85791,2.737531957464152,0.2249819051515247
12598,0.407047619047619,0,2,0,310079,295531,22165,85791,2.7375134313979768,0.22498308516162194
12599,0.4070555555555555,0,2,0,310081,295529,22165,85791,2.737494905331802,0.22498426518409734
12600,0.4070714285714285,0,1,0,310082,295528,22165,85791,2.737485642298714,0.22498485519997694
12601,0.4070833333333333,0,5,0,310087,295523,22165,85791,2.7374393271332766,0.2249878053257945
12602,0.4070833333333334,1,2,1,310089,295521,22166,85790,2.7374208010671013,0.22498695290720697
12603,0.4071111111111111,0,1,0,310090,295520,22166,85790,2.737411538034014,0.22498754294406126
12604,0.4071428571428571,0,8,0,310098,295512,22166,85790,2.7373374337693135,0.22499226335031025
12605,0.4071666666666666,1,0,1,310098,295512,22167,85789,2.7373374337693135,0.2249902308150254
12606,0.4071666666666667,0,10,0,310108,295502,22167,85789,2.737244803438438,0.22499613156355644
12607,0.4072142857142857,0,1,0,310109,295501,22167,85789,2.7372355404053503,0.22499672165543289
12608,0.4072380952380952,0,1,0,310110,295500,22167,85789,2.7372262773722627,0.22499731175040455
12609,0.40725,0,1,0,310111,295499,22167,85789,2.7372170143391754,0.2249979018484715
12610,0.4072619047619047,1,2,1,310113,295497,22168,85788,2.737198488273,0.22499704945119792
12611,0.4072777777777777,0,1,0,310114,295496,22168,85788,2.7371892252399124,0.22499763955476756
12612,0.4072857142857142,0,1,0,310115,295495,22168,85788,2.737179962206825,0.2249982296614326
12613,0.4072857142857143,0,2,0,310117,295493,22168,85788,2.7371614361406498,0.22499940988404876
12614,0.4073095238095238,1,1,1,310118,295492,22169,85787,2.7371521731075625,0.2249979673677281
12615,0.4073333333333332,0,8,0,310126,295484,22169,85787,2.737078068842862,0.2250026883765091
12616,0.4073333333333333,6,51,6,310177,295433,22175,85781,2.7366056541553965,0.22502059210836958
12617,0.4073452380952381,0,3,0,310180,295430,22175,85781,2.736577865056134,0.22502236294335684
12618,0.4073809523809524,1,11,1,310191,295419,22176,85780,2.7364759716921707,0.22502682326029186
12619,0.4074444444444445,1,0,1,310191,295419,22177,85779,2.7364759716921707,0.22502479026647568
12620,0.407452380952381,0,3,0,310194,295416,22177,85779,2.736448182592908,0.22502656120883013
12621,0.407468253968254,0,3,0,310197,295413,22177,85779,2.7364203934936455,0.22502833217905938
12622,0.4074761904761905,0,1,0,310198,295412,22177,85779,2.736411130460558,0.22502892250866363
12623,0.4074999999999999,2,11,2,310209,295401,22179,85777,2.736309237096595,0.2250313501828542
12624,0.4075,61,412,61,310621,294989,22240,85716,2.7324928674645226,0.2251507072405143
12625,0.4075000000000001,1,11,1,310632,294978,22241,85715,2.7323909741005594,0.22515517753150177
12626,0.4075238095238095,0,2,0,310634,294976,22241,85715,2.7323724480343845,0.22515636040778478
12627,0.4075555555555555,0,1,0,310635,294975,22241,85715,2.732363185001297,0.2251569518505871
12628,0.4075714285714285,0,1,0,310636,294974,22241,85715,2.732353921968209,0.22515754329649662
12629,0.4075833333333333,0,1,0,310637,294973,22241,85715,2.732344658935122,0.22515813474551338
12630,0.4076190476190476,0,10,0,310647,294963,22241,85715,2.732252028604246,0.2251640494065851
12631,0.4076428571428572,0,1,0,310648,294962,22241,85715,2.7322427655711587,0.2251646408897832
12632,0.4076666666666665,0,2,0,310650,294960,22241,85715,2.7322242395049834,0.22516582386550207
12633,0.4076666666666667,5,36,5,310686,294924,22246,85710,2.7318907703138318,0.2251769416289664
12634,0.4077380952380952,1,1,1,310687,294923,22247,85709,2.731881507280744,0.2251754975934761
12635,0.4077777777777778,0,2,0,310689,294921,22247,85709,2.7318629812145687,0.2251766807660983
12636,0.4077857142857142,0,1,0,310690,294920,22247,85709,2.7318537181814815,0.2251772723570721
12637,0.4077857142857143,0,1,0,310691,294919,22247,85709,2.731844455148394,0.2251778639511544
12638,0.4078015873015873,0,1,0,310692,294918,22247,85709,2.731835192115306,0.22517845554834523
12639,0.4078095238095238,1,2,1,310694,294916,22248,85708,2.731816666049131,0.22517760309386692
12640,0.4078333333333332,0,2,0,310696,294914,22248,85708,2.731798139982956,0.22517878630242077
12641,0.4078333333333333,4,15,4,310711,294899,22252,85704,2.731659194486643,0.22517951776523043
12642,0.4078333333333334,0,7,0,310718,294892,22252,85704,2.73159435325503,0.22518365931328757
12643,0.4078571428571428,0,16,0,310734,294876,22252,85704,2.731446144725629,0.22519312628093963
12644,0.4078571428571429,1,0,1,310734,294876,22253,85703,2.731446144725629,0.22519109041749544
12645,0.4079166666666666,0,1,0,310735,294875,22253,85703,2.7314368816925416,0.22519168212560894
12646,0.4079642857142857,0,1,0,310736,294874,22253,85703,2.731427618659454,0.22519227383683196
12647,0.4079761904761905,0,1,0,310737,294873,22253,85703,2.7314183556263663,0.22519286555116455
12648,0.408,17,108,17,310845,294765,22270,85686,2.7304179480529105,0.22522217052918772
12649,0.4080238095238095,0,1,0,310846,294764,22270,85686,2.730408685019823,0.22522276251807072
12650,0.4080299145299144,0,1,0,310847,294763,22270,85686,2.730399421986735,0.22522335451006573
12651,0.4080396825396826,0,2,0,310849,294761,22270,85686,2.73038089592056,0.22522453850339205
12652,0.4080476190476191,0,1,0,310850,294760,22270,85686,2.7303716328874725,0.2252251305047234
12653,0.4080555555555555,0,1,0,310851,294759,22270,85686,2.7303623698543853,0.2252257225091669
12654,0.4080595238095238,0,2,0,310853,294757,22270,85686,2.73034384378821,0.22522690652739044
12655,0.408095238095238,0,1,0,310854,294756,22270,85686,2.7303345807551223,0.22522749854117052
12656,0.4080952380952381,0,5,0,310859,294751,22270,85686,2.7302882655896847,0.22523045865675526
12657,0.4081111111111111,0,2,0,310861,294749,22270,85686,2.7302697395235094,0.22523164272477558
12658,0.4081428571428571,0,1,0,310862,294748,22270,85686,2.730260476490422,0.22523223476345436
12659,0.4081666666666666,2,13,2,310875,294735,22272,85684,2.7301400570602836,0.22523585835618096
12660,0.4081666666666667,2,4,2,310879,294731,22274,85682,2.730103004927934,0.22523415340695507
12661,0.4081666666666668,1,0,1,310879,294731,22275,85681,2.730103004927934,0.2252321167576207
12662,0.4081904761904762,0,2,0,310881,294729,22275,85681,2.7300844788617584,0.2252333009121737
12663,0.4082142857142857,1,2,1,310883,294727,22276,85680,2.7300659527955835,0.2252324484039463
12664,0.4082272727272727,0,1,0,310884,294726,22276,85680,2.730056689762496,0.22523304048832038
12665,0.40825,0,3,0,310887,294723,22276,85680,2.7300289006632332,0.2252348167601202
12666,0.4083095238095238,0,1,0,310888,294722,22276,85680,2.7300196376301455,0.22523540885694607
12667,0.4083134920634921,0,1,0,310889,294721,22276,85680,2.730010374597058,0.22523600095688498
12668,0.4083333333333332,40,248,40,311137,294473,22316,85640,2.7277131423913445,0.22530142352405733
12669,0.4083333333333334,38,253,38,311390,294220,22354,85602,2.7253695950201933,0.22537399097471975
12670,0.4083669108669109,0,1,0,311391,294219,22354,85602,2.725360331987106,0.2253745843436777
12671,0.4083809523809523,1,1,1,311392,294218,22355,85601,2.7253510689540184,0.2253731382579597
12672,0.4084047619047619,0,1,0,311393,294217,22355,85601,2.7253418059209307,0.22537373162935934
12673,0.4084166666666666,0,1,0,311394,294216,22355,85601,2.725332542887843,0.22537432500388344
12674,0.4084285714285714,0,1,0,311395,294215,22355,85601,2.7253232798547558,0.22537491838153212
12675,0.4084523809523809,0,2,0,311397,294213,22355,85601,2.7253047537885804,0.22537610514620315
12676,0.408452380952381,0,3,0,311400,294210,22355,85601,2.725276964689318,0.22537788531664432
12677,0.4084999999999999,1,6,1,311406,294204,22356,85600,2.7252213864907926,0.22537940622005034
12678,0.4085,4,36,4,311442,294168,22360,85596,2.7248879172996405,0.22539261225392612
12679,0.4085000000000001,0,2,0,311444,294166,22360,85596,2.7248693912334656,0.22539379927428232
12680,0.4085454545454545,0,1,0,311445,294165,22360,85596,2.724860128200378,0.22539439278914897
12681,0.4085555555555556,1,0,1,311445,294165,22361,85595,2.724860128200378,0.22539235306509375
12682,0.408560606060606,0,1,0,311446,294164,22361,85595,2.7248508651672902,0.22539294657927791
12683,0.4085714285714286,2,12,2,311458,294152,22363,85593,2.72473970877024,0.22539598941394884
12684,0.4085833333333333,0,1,0,311459,294151,22363,85593,2.724730445737152,0.22539658296115278
12685,0.408595238095238,0,1,0,311460,294150,22363,85593,2.7247211827040645,0.22539717651148278
12686,0.4085952380952381,0,3,0,311463,294147,22363,85593,2.724693393604802,0.22539895718122926
12687,0.4086190476190476,0,1,0,311464,294146,22363,85593,2.724684130571714,0.22539955074406368
12688,0.4086666666666666,1,5,1,311469,294141,22364,85592,2.7246378154062767,0.22540047875744273
12689,0.4086666666666667,5,21,5,311490,294120,22369,85587,2.724443291711438,0.22540274474792404
12690,0.4086904761904761,0,1,0,311491,294119,22369,85587,2.7244340286783504,0.22540333837231963
12691,0.4086904761904762,0,1,0,311492,294118,22369,85587,2.7244247656452627,0.225403931999842
12692,0.4087142857142857,0,1,0,311493,294117,22369,85587,2.7244155026121755,0.22540452563049113
12693,0.40875,0,4,0,311497,294113,22369,85587,2.724378450479825,0.22540690018435608
12694,0.4087738095238095,0,1,0,311498,294112,22369,85587,2.7243691874467375,0.22540749383063954
12695,0.4087976190476191,1,0,1,311498,294112,22370,85586,2.7243691874467375,0.22540545380802637
12696,0.4088095238095238,0,5,0,311503,294107,22370,85586,2.7243228722813,0.22540842206730174
12697,0.4088333333333332,0,3,0,311506,294104,22370,85586,2.724295083182037,0.22541020306039136
12698,0.4088333333333333,0,12,0,311518,294092,22370,85586,2.7241839267849866,0.2254173273141978
12699,0.4088333333333334,0,1,0,311519,294091,22370,85586,2.724174663751899,0.22541792102234268
12700,0.4088888888888888,0,1,0,311520,294090,22370,85586,2.724165400718811,0.225418514733615
12701,0.4088888888888889,0,1,0,311521,294089,22370,85586,2.724156137685724,0.22541910844801474
12702,0.4089285714285713,0,1,0,311522,294088,22370,85586,2.7241468746526363,0.22541970216554202
12703,0.4089989177489177,0,1,0,311523,294087,22370,85586,2.7241376116195486,0.2254202958861968
12704,0.4089999999999999,2,3,2,311526,294084,22372,85584,2.724109822520286,0.22541799677613072
12705,0.409,11,83,11,311609,294001,22383,85573,2.723340990774019,0.22544484079520727
12706,0.409047619047619,2,6,2,311615,293995,22385,85571,2.7232854125754935,0.22544432325339994
12707,0.4090555555555555,0,2,0,311617,293993,22385,85571,2.7232668865093186,0.22544551116544245
12708,0.4091190476190476,1,0,1,311617,293993,22386,85570,2.7232668865093186,0.22544347051741082
12709,0.4091244588744589,0,1,0,311618,293992,22386,85570,2.723257623476231,0.22544406447431514
12710,0.4091666666666665,0,2,0,311620,293990,22386,85570,2.723239097410056,0.2254452523975129
12711,0.4091666666666666,10,87,10,311707,293903,22396,85560,2.722433213531439,0.2254765286734148
12712,0.4091666666666667,6,76,6,311783,293827,22402,85554,2.7217292230167844,0.22550944828549663
12713,0.4091930014430013,0,2,0,311785,293825,22402,85554,2.7217106969506095,0.2255106371201358
12714,0.4092142857142857,0,4,0,311789,293821,22402,85554,2.7216736448182592,0.22551301482701813
12715,0.4092499999999999,0,1,0,311790,293820,22402,85554,2.7216643817851716,0.22551360926157302
12716,0.4092619047619047,0,1,0,311791,293819,22402,85554,2.7216551187520843,0.22551420369926167
12717,0.4092857142857142,0,2,0,311793,293817,22402,85554,2.721636592685909,0.22551539258404044
12718,0.4092857142857143,1,8,1,311801,293809,22403,85553,2.721562488421209,0.22551810671601266
12719,0.4093333333333333,2,11,2,311812,293798,22405,85551,2.7214605950572457,0.22552056285900318
12720,0.4093333333333334,3,51,3,311863,293747,22408,85548,2.72098818036978,0.2255447606744091
12721,0.4093571428571428,0,1,0,311864,293746,22408,85548,2.720978917336693,0.22554535531803824
12722,0.409404761904762,0,2,0,311866,293744,22408,85548,2.7209603912705176,0.2255465446147032
12723,0.4094166666666666,1,2,1,311868,293742,22409,85547,2.7209418652043427,0.22554569207121747
12724,0.4094285714285714,1,0,1,311868,293742,22410,85546,2.7209418652043427,0.22554365020775768
12725,0.4094444444444444,0,1,0,311869,293741,22410,85546,2.720932602171255,0.2255442448594336
12726,0.4094761904761905,0,1,0,311870,293740,22410,85546,2.7209233391381673,0.2255448395142452
12727,0.4095,5,18,5,311888,293722,22415,85541,2.7207566045425913,0.22554533397668636
12728,0.4095000000000001,0,1,0,311889,293721,22415,85541,2.720747341509504,0.22554592867199982
12729,0.4095238095238095,1,8,1,311897,293713,22416,85540,2.7206732372448035,0.2255486443086805
12730,0.409547619047619,1,1,1,311898,293712,22417,85539,2.720663974211716,0.22554719697509037
12731,0.4095555555555555,0,1,0,311899,293711,22417,85539,2.720654711178628,0.22554779169413317
12732,0.4095663831782253,0,1,0,311900,293710,22417,85539,2.720645448145541,0.22554838641631222
12733,0.4095714285714285,0,1,0,311901,293709,22417,85539,2.720636185112453,0.22554898114162764
12734,0.4095833333333333,0,4,0,311905,293705,22417,85539,2.720599132980103,0.225551360074253
12735,0.4096190476190476,0,1,0,311906,293704,22417,85539,2.7205898699470152,0.2255519548152504
12736,0.4096666666666666,2,5,2,311911,293699,22419,85537,2.7205435547815777,0.22555084432912487
12737,0.4096666666666667,3,30,3,311941,293669,22422,85534,2.720265663788951,0.22556256147762543
12738,0.4097222222222222,1,0,1,311941,293669,22423,85533,2.720265663788951,0.22556051919557385
12739,0.4097619047619047,0,4,0,311945,293665,22423,85533,2.720228611656601,0.2255628985384944
12740,0.4097777777777777,0,1,0,311946,293664,22423,85533,2.7202193486235133,0.2255634933820679
12741,0.4098095238095238,0,1,0,311947,293663,22423,85533,2.7202100855904257,0.2255640882287788
12742,0.4098333333333332,0,4,0,311951,293659,22423,85533,2.7201730334580754,0.22556646764699678
12743,0.4098333333333333,2,10,2,311961,293649,22425,85531,2.7200804031272,0.2255683316630624
12744,0.4098571428571428,1,1,1,311962,293648,22426,85530,2.720071140094112,0.2255668841546714
12745,0.4098809523809524,0,3,0,311965,293645,22426,85530,2.7200433509948496,0.22556866882046547
12746,0.4098888888888888,0,1,0,311966,293644,22426,85530,2.7200340879617624,0.22556926371533914
12747,0.4099047619047619,1,2,1,311968,293642,22427,85529,2.720015561895587,0.2255684110862909
12748,0.4099318181818182,0,1,0,311969,293641,22427,85529,2.7200062988624993,0.22556900598676055
12749,0.4099523809523808,0,2,0,311971,293639,22427,85529,2.7199877727963244,0.22557019579711368
12750,0.4099523809523809,2,1,2,311972,293638,22429,85527,2.7199785097632367,0.22556670578771776
12751,0.409952380952381,1,0,1,311972,293638,22430,85526,2.7199785097632367,0.2255646633119178
12752,0.4099603174603174,0,1,0,311973,293637,22430,85526,2.7199692467301495,0.22556525821348603
12753,0.4099682539682541,1,0,1,311973,293637,22431,85525,2.7199692467301495,0.22556321572309462
12754,0.4099761904761905,0,1,0,311974,293636,22431,85525,2.719959983697062,0.22556381062398295
12755,0.4099999999999999,4,48,4,312022,293588,22435,85521,2.7195153581088594,0.22558419873967644
12756,0.41,406,3534,406,315556,290054,22841,85115,2.6867797991774425,0.22687109009539702
12757,0.4100000000000001,1,29,1,315585,290025,22842,85114,2.6865111712179037,0.22688656737902485
12758,0.4100170940170941,1,1,1,315586,290024,22843,85113,2.686501908184816,0.22688511130600286
12759,0.4100714285714285,1,0,1,315586,290024,22844,85112,2.686501908184816,0.22688305041371662
12760,0.4100909090909092,0,1,0,315587,290023,22844,85112,2.6864926451517284,0.22688365521745504
12761,0.4101190476190476,0,1,0,315588,290022,22844,85112,2.686483382118641,0.22688426002441794
12762,0.4101282051282051,0,1,0,315589,290021,22844,85112,2.6864741190855534,0.22688486483460532
12763,0.4101428571428571,0,3,0,315592,290018,22844,85112,2.686446329986291,0.2268866792845147
12764,0.4101428571428572,0,1,0,315593,290017,22844,85112,2.686437066953203,0.2268872841076003
12765,0.4101507936507936,0,1,0,315594,290016,22844,85112,2.6864278039201155,0.22688788893391057
12766,0.4101666666666667,3,15,3,315609,290001,22847,85109,2.6862888584238025,0.22689077870491323
12767,0.4101904761904761,1,1,1,315610,290000,22848,85108,2.686279595390715,0.22688932254177463
12768,0.4101944444444445,1,0,1,315610,290000,22849,85107,2.686279595390715,0.22688726150138494
12769,0.4101984126984127,0,3,0,315613,289997,22849,85107,2.686251806291452,0.22688907609622933
12770,0.4102619047619047,0,1,0,315614,289996,22849,85107,2.6862425432583645,0.22688968096762757
12771,0.4102857142857142,0,2,0,315616,289994,22849,85107,2.6862240171921896,0.22689089072009938
12772,0.4102857142857143,1,4,1,315620,289990,22850,85106,2.6861869650598393,0.22689124917354492
12773,0.4102955377955378,0,1,0,315621,289989,22850,85106,2.6861777020267517,0.2268918540636372
12774,0.4103095238095238,0,2,0,315623,289987,22850,85106,2.6861591759605767,0.22689306385349767
12775,0.4103333333333332,1,1,1,315624,289986,22851,85105,2.686149912927489,0.22689160763654687
12776,0.4103333333333333,1,29,1,315653,289957,22852,85104,2.68588128496795,0.22690708978006244
12777,0.4103333333333334,3,9,3,315662,289948,22855,85101,2.685797917670162,0.22690635090348193
12778,0.4103571428571428,0,3,0,315665,289945,22855,85101,2.6857701285708995,0.22690816593164573
12779,0.4103809523809523,0,2,0,315667,289943,22855,85101,2.685751602504724,0.22690937596655325
12780,0.4103809523809524,1,1,1,315668,289942,22856,85100,2.6857423394716364,0.22690791964633295
12781,0.4103888888888889,0,1,0,315669,289941,22856,85100,2.685733076438549,0.22690852466796962
12782,0.4104047619047618,1,0,1,315669,289941,22857,85099,2.685733076438549,0.2269064633105802
12783,0.4104047619047619,0,1,0,315670,289940,22857,85099,2.6857238134054615,0.22690706833156019
12784,0.4104166666666666,0,1,0,315671,289939,22857,85099,2.685714550372374,0.22690767335576661
12785,0.4104166666666667,1,3,1,315674,289936,22858,85098,2.6856867612731112,0.22690742705994657
12786,0.4104285714285714,0,1,0,315675,289935,22858,85098,2.6856774982400236,0.2269080320931758
12787,0.4104523809523809,0,2,0,315677,289933,22858,85098,2.6856589721738486,0.226909242169314
12788,0.4104761904761904,0,2,0,315679,289931,22858,85098,2.6856404461076737,0.22691045225835868
12789,0.4104761904761905,1,0,1,315679,289931,22859,85097,2.6856404461076737,0.2269083908401506
12790,0.4105,2,25,2,315704,289906,22861,85095,2.685408870280485,0.22691939488161364
12791,0.4105000000000001,0,1,0,315705,289905,22861,85095,2.685399607247397,0.22692
12792,0.4105555555555555,0,2,0,315707,289903,22861,85095,2.6853810811812218,0.22692121024645465
12793,0.4105714285714286,0,2,0,315709,289901,22861,85095,2.685362555115047,0.22692242050581873
12794,0.4106190476190475,0,1,0,315710,289900,22861,85095,2.685353292081959,0.22692302564034186
12795,0.4106428571428571,1,0,1,315710,289900,22862,85094,2.685353292081959,0.22692096406875845
12796,0.4106666666666666,4,38,4,315748,289862,22866,85090,2.685001296824632,0.22693571443811475
12797,0.4106666666666667,1,20,1,315768,289842,22867,85089,2.6848160361628812,0.22694575801947559
12798,0.4106818181818182,0,1,0,315769,289841,22867,85089,2.6848067731297935,0.22694636332115328
12799,0.4106904761904761,1,0,1,315769,289841,22868,85088,2.6848067731297935,0.2269443014544087
12800,0.4106984126984127,0,1,0,315770,289840,22868,85088,2.684797510096706,0.2269449067554304
12801,0.4107142857142857,1,10,1,315780,289830,22869,85087,2.6847048797658304,0.22694889802276236
12802,0.4107380952380952,0,1,0,315781,289829,22869,85087,2.684695616732743,0.22694950335541828
12803,0.4107539682539682,0,1,0,315782,289828,22869,85087,2.6846863536996555,0.22695010869130336
12804,0.4107692307692308,0,1,0,315783,289827,22869,85087,2.684677090666568,0.22695071403041764
12805,0.4107857142857142,0,1,0,315784,289826,22869,85087,2.68466782763348,0.22695131937276114
12806,0.4108333333333333,12,88,12,315872,289738,22881,85075,2.6838526807217757,0.22697985395383832
12807,0.4108333333333334,13,80,13,315952,289658,22894,85062,2.683111638074771,0.22700149444918874
12808,0.4108809523809523,0,1,0,315953,289657,22894,85062,2.683102375041684,0.22700210024044684
12809,0.4108809523809524,0,1,0,315954,289656,22894,85062,2.683093112008596,0.22700270603493827
12810,0.4108888888888888,0,1,0,315955,289655,22894,85062,2.6830838489755084,0.22700331183266306
12811,0.4109047619047619,1,1,1,315956,289654,22895,85061,2.6830745859424208,0.22700185474293796
12812,0.4109166666666666,0,1,0,315957,289653,22895,85061,2.6830653229093335,0.22700246054324097
12813,0.4109166666666667,0,1,0,315958,289652,22895,85061,2.683056059876246,0.2270030663467774
12814,0.4109523809523809,1,3,1,315961,289649,22896,85060,2.6830282707769832,0.22700282085565066
12815,0.410969696969697,0,1,0,315962,289648,22896,85060,2.6830190077438956,0.22700342666823234
12816,0.4109722222222221,0,1,0,315963,289647,22896,85060,2.683009744710808,0.22700403248404755
12817,0.410984126984127,0,2,0,315965,289645,22896,85060,2.682991218644633,0.22700524412537862
12818,0.4109999999999999,0,4,0,315969,289641,22896,85060,2.6829541665122827,0.22700766744684428
12819,0.411,17,85,17,316054,289556,22913,85043,2.6821668086998405,0.22702409776854718
12820,0.4110000000000001,0,1,0,316055,289555,22913,85043,2.6821575456667532,0.2270247038158239
12821,0.4110238095238095,0,1,0,316056,289554,22913,85043,2.6821482826336656,0.22702530986633634
12822,0.411047619047619,0,1,0,316057,289553,22913,85043,2.682139019600578,0.22702591592008456
12823,0.4110476190476191,0,1,0,316058,289552,22913,85043,2.6821297565674906,0.22702652197706857
12824,0.4110714285714286,0,1,0,316059,289551,22913,85043,2.682120493534403,0.22702712803728836
12825,0.4110714285714287,0,1,0,316060,289550,22913,85043,2.6821112305013153,0.227027734100744
12826,0.4111111111111111,1,1,1,316061,289549,22914,85042,2.6821019674682276,0.22702627665907615
12827,0.4111190476190476,0,1,0,316062,289548,22914,85042,2.6820927044351404,0.2270268827251128
12828,0.4111349206349207,0,1,0,316063,289547,22914,85042,2.6820834414020527,0.2270274887943853
12829,0.4111374458874459,1,1,1,316064,289546,22915,85041,2.682074178368965,0.22702603133584454
12830,0.4111428571428571,0,1,0,316065,289545,22915,85041,2.6820649153358778,0.2270266374076981
12831,0.4111666666666666,0,3,0,316068,289542,22915,85041,2.6820371262366147,0.22702845564267465
12832,0.4111666666666667,1,17,1,316085,289525,22916,85040,2.6818796546741264,0.227036695900578
12833,0.4111904761904761,0,2,0,316087,289523,22916,85040,2.6818611286079514,0.2270379081756607
12834,0.4111904761904762,1,2,1,316089,289521,22917,85039,2.681842602541776,0.22703705681332764
12835,0.4112222222222222,0,1,0,316090,289520,22917,85039,2.681833339508689,0.22703766295830563
12836,0.4112380952380953,0,1,0,316091,289519,22917,85039,2.681824076475601,0.22703826910652022
12837,0.41125,0,8,0,316099,289511,22917,85039,2.6817499722109006,0.22704311840875718
12838,0.4112619047619048,0,1,0,316100,289510,22917,85039,2.6817407091778134,0.22704372458610222
12839,0.4112777777777778,0,1,0,316101,289509,22917,85039,2.6817314461447257,0.22704433076668412
12840,0.4112857142857142,0,1,0,316102,289508,22917,85039,2.681722183111638,0.22704493695050287
12841,0.4112857142857143,0,1,0,316103,289507,22917,85039,2.6817129200785503,0.22704554313755854
12842,0.4113095238095238,0,2,0,316105,289505,22917,85039,2.6816943940123754,0.22704675552138068
12843,0.4113333333333333,5,30,5,316135,289475,22922,85034,2.681416503019749,0.22705462352039604
12844,0.4113333333333334,0,5,0,316140,289470,22922,85034,2.681370187854311,0.22705765492491403
12845,0.4113571428571428,0,1,0,316141,289469,22922,85034,2.6813609248212233,0.227058261215531
12846,0.4113809523809524,0,1,0,316142,289468,22922,85034,2.681351661788136,0.2270588675093858
12847,0.4113928571428571,0,1,0,316143,289467,22922,85034,2.6813423987550484,0.22705947380647848
12848,0.4114047619047618,0,2,0,316145,289465,22922,85034,2.681323872688873,0.2270606864103776
12849,0.4114047619047619,0,1,0,316146,289464,22922,85034,2.681314609655786,0.22706129271718406
12850,0.4114166666666666,0,2,0,316148,289462,22922,85034,2.6812960835896105,0.22706250534051098
12851,0.4114285714285713,1,2,1,316150,289460,22923,85033,2.6812775575234356,0.22706165402290562
12852,0.4114285714285715,0,1,0,316151,289459,22923,85033,2.681268294490348,0.22706226034200996
12853,0.4115,8,31,8,316182,289428,22931,85025,2.6809811404646338,0.22706454481603833
12854,0.4115238095238095,0,1,0,316183,289427,22931,85025,2.680971877431546,0.2270651512076314
12855,0.411547619047619,0,2,0,316185,289425,22931,85025,2.680953351365371,0.22706636400053412
12856,0.4115555555555555,0,2,0,316187,289423,22931,85025,2.680934825299196,0.22706757680639233
12857,0.4115833333333332,0,1,0,316188,289422,22931,85025,2.6809255622661086,0.22706818321417985
12858,0.4115833333333334,0,2,0,316190,289420,22931,85025,2.680907036199933,0.22706939603947174
12859,0.411590909090909,0,1,0,316191,289419,22931,85025,2.680897773166846,0.2270700024569762
12860,0.4116190476190476,0,2,0,316193,289417,22931,85025,2.6808792471006706,0.22707121530170227
12861,0.4116666666666665,0,3,0,316196,289414,22931,85025,2.680851458001408,0.2270730345930846
12862,0.4116666666666666,36,232,36,316428,289182,22967,84989,2.6787024343250954,0.2271394629728119
12863,0.4116666666666667,28,194,28,316622,288988,22995,84961,2.6769054059061097,0.22719943093844347
12864,0.4116746031746032,0,3,0,316625,288985,22995,84961,2.676877616806847,0.22720125365694513
12865,0.4116883116883116,0,1,0,316626,288984,22995,84961,2.67686835377376,0.22720186123627806
12866,0.4117142857142857,0,1,0,316627,288983,22995,84961,2.676859090740672,0.22720246881886058
12867,0.4117619047619048,0,1,0,316628,288982,22995,84961,2.6768498277075845,0.2272030764046927
12868,0.4117698412698412,1,0,1,316628,288982,22996,84960,2.6768498277075845,0.2272010097822657
12869,0.4117698412698413,1,0,1,316628,288982,22997,84959,2.6768498277075845,0.2271989431487855
12870,0.4117777777777778,0,1,0,316629,288981,22997,84959,2.676840564674497,0.22719955073006365
12871,0.4117857142857143,1,7,1,316636,288974,22998,84958,2.676775723442884,0.22720173721425285
12872,0.4117896825396825,0,1,0,316637,288973,22998,84958,2.6767664604097967,0.22720234481762677
12873,0.4118095238095238,0,2,0,316639,288971,22998,84958,2.6767479343436213,0.22720356003412412
12874,0.4118333333333333,0,4,0,316643,288967,22998,84958,2.676710882211271,0.22720599050611753
12875,0.4118333333333334,4,22,4,316665,288945,23002,84954,2.676507095483345,0.22721109176542328
12876,0.4118571428571428,0,3,0,316668,288942,23002,84954,2.6764793063840826,0.2272129148212337
12877,0.4118888888888888,0,2,0,316670,288940,23002,84954,2.6764607803179072,0.2272141302080269
12878,0.4119047619047618,0,1,0,316671,288939,23002,84954,2.6764515172848196,0.2272147379062994
12879,0.4119047619047619,1,2,1,316673,288937,23003,84953,2.6764329912186446,0.2272138864371874
12880,0.411904761904762,0,2,0,316675,288935,23003,84953,2.6764144651524697,0.22721510184868196
12881,0.4119166666666666,0,2,0,316677,288933,23003,84953,2.6763959390862944,0.22721631727317954
12882,0.4119444444444444,0,1,0,316678,288932,23003,84953,2.6763866760532067,0.2272169249903045
12883,0.4119523809523808,0,1,0,316679,288931,23003,84953,2.6763774130201194,0.22721753271068032
12884,0.4119523809523809,0,2,0,316681,288929,23003,84953,2.676358886953944,0.22721874816118454
12885,0.412,12,78,12,316759,288851,23015,84941,2.675636370373115,0.22724135348001026
12886,0.4120238095238095,0,1,0,316760,288850,23015,84941,2.6756271073400275,0.22724196141694156
12887,0.4120555555555555,0,1,0,316761,288849,23015,84941,2.67561784430694,0.22724256935712567
12888,0.4120714285714285,0,1,0,316762,288848,23015,84941,2.675608581273852,0.22724317730056262
12889,0.4120833333333333,2,4,2,316766,288844,23017,84939,2.6755715291415023,0.22724147433136338
12890,0.4120952380952382,1,0,1,316766,288844,23018,84938,2.6755715291415023,0.22723940692703234
12891,0.4121031746031745,0,1,0,316767,288843,23018,84938,2.6755622661084146,0.2272400148750204
12892,0.4121428571428571,0,14,0,316781,288829,23018,84938,2.675432583645189,0.22724852648842728
12893,0.4121666666666666,1,7,1,316788,288822,23019,84937,2.675367742413576,0.22725071503294905
12894,0.4121666666666667,2,8,2,316796,288814,23021,84935,2.6752936381488754,0.22725144415102114
12895,0.4121904761904762,0,1,0,316797,288813,23021,84935,2.6752843751157878,0.22725205218489464
12896,0.4122222222222222,0,5,0,316802,288808,23021,84935,2.6752380599503502,0.22725509240306843
12897,0.4122619047619047,0,1,0,316803,288807,23021,84935,2.6752287969172626,0.22725570045646462
12898,0.4122619047619048,0,1,0,316804,288806,23021,84935,2.675219533884175,0.2272563085131147
12899,0.4122777777777778,0,1,0,316805,288805,23021,84935,2.6752102708510876,0.22725691657301866
12900,0.4122857142857142,0,2,0,316807,288803,23021,84935,2.6751917447849123,0.22725813270258843
12901,0.4123253968253968,1,3,1,316810,288800,23022,84934,2.6751639556856497,0.22725788930094667
12902,0.4123333333333333,6,45,6,316855,288755,23028,84928,2.67474711919671,0.22727284891204577
12903,0.4123333333333334,0,1,0,316856,288754,23028,84928,2.674737856163622,0.22727345711059135
12904,0.4123452380952381,0,1,0,316857,288753,23028,84928,2.6747285931305345,0.2272740653123921
12905,0.4123809523809523,0,3,0,316860,288750,23028,84928,2.674700804031272,0.22727588993732573
12906,0.4123809523809524,0,7,0,316867,288743,23028,84928,2.674635962799659,0.22728014750944012
12907,0.4124047619047619,1,0,1,316867,288743,23029,84927,2.674635962799659,0.2272780795889421
12908,0.4124285714285714,0,1,0,316868,288742,23029,84927,2.6746266997665717,0.22727868782264518
12909,0.4124285714285715,0,1,0,316869,288741,23029,84927,2.674617436733484,0.2272792960596037
12910,0.4124444444444444,1,1,1,316870,288740,23030,84926,2.6746081737003964,0.22727783635653231
12911,0.4124523809523808,0,1,0,316871,288739,23030,84926,2.6745989106673087,0.22727844459609545
12912,0.4124999999999999,0,5,0,316876,288734,23030,84926,2.674552595501871,0.22728148584274474
12913,0.4125,39,385,39,317261,288349,23069,84887,2.670986327763163,0.22743518845984845
12914,0.4125000000000001,1,10,1,317271,288339,23070,84886,2.6708936974322874,0.22743921227141806
12915,0.4125238095238094,0,1,0,317272,288338,23070,84886,2.6708844343991998,0.22743982166205817
12916,0.4125595238095238,0,1,0,317273,288337,23070,84886,2.670875171366112,0.22744043105596387
12917,0.4126190476190476,0,5,0,317278,288332,23070,84886,2.6708288562006746,0.22744347807447657
12918,0.412638888888889,0,1,0,317279,288331,23070,84886,2.670819593167587,0.22744408748797618
12919,0.4126547619047618,0,1,0,317280,288330,23070,84886,2.670810330134499,0.22744469690474148
12920,0.4126666666666665,1,0,1,317280,288330,23071,84885,2.670810330134499,0.22744262690406333
12921,0.4126666666666667,12,57,12,317337,288273,23083,84873,2.6702823372485085,0.2274525252850091
12922,0.4126785714285714,0,1,0,317338,288272,23083,84873,2.6702730742154213,0.22745313484034357
12923,0.4127142857142857,1,0,1,317338,288272,23084,84872,2.6702730742154213,0.227451064468409
12924,0.4127380952380952,0,2,0,317340,288270,23084,84872,2.670254548149246,0.22745228358104957
12925,0.41275,0,2,0,317342,288268,23084,84872,2.670236022083071,0.22745350270675885
12926,0.4127619047619049,0,1,0,317343,288267,23084,84872,2.6702267590499833,0.22745411227451431
12927,0.4127777777777777,1,0,1,317343,288267,23085,84871,2.6702267590499833,0.22745204187190798
12928,0.4127857142857143,0,1,0,317344,288266,23085,84871,2.6702174960168956,0.2274526514390157
12929,0.4128095238095238,0,1,0,317345,288265,23085,84871,2.6702082329838084,0.22745326100939067
12930,0.4128214285714285,0,1,0,317346,288264,23085,84871,2.6701989699507207,0.22745387058303296
12931,0.4128333333333332,1,0,1,317346,288264,23086,84870,2.6701989699507207,0.22745180015758415
12932,0.4128333333333333,2,17,2,317363,288247,23088,84868,2.6700414983882323,0.22745802232555645
12933,0.4128333333333334,0,6,0,317369,288241,23088,84868,2.6699859201897067,0.2274616800988451
12934,0.4128571428571428,2,6,2,317375,288235,23090,84866,2.6699303419911815,0.2274611968341012
12935,0.4128571428571429,0,1,0,317376,288234,23090,84866,2.669921078958094,0.22746180648619674
12936,0.4128690476190477,0,1,0,317377,288233,23090,84866,2.6699118159250066,0.2274624161415603
12937,0.4128809523809524,0,1,0,317378,288232,23090,84866,2.669902552891919,0.2274630258001919
12938,0.4129166666666666,0,2,0,317380,288230,23090,84866,2.669884026825744,0.22746424512725946
12939,0.4129166666666667,0,2,0,317382,288228,23090,84866,2.6698655007595686,0.22746546446739963
12940,0.4129285714285713,1,0,1,317382,288228,23091,84865,2.6698655007595686,0.22746339384550232
12941,0.4129444444444444,0,1,0,317383,288227,23091,84865,2.669856237726481,0.2274640035165589
12942,0.4129523809523809,0,1,0,317384,288226,23091,84865,2.6698469746933937,0.22746461319088374
12943,0.413,10,64,10,317448,288162,23101,84855,2.66925414057579,0.22748292973242507
12944,0.4130000000000001,0,1,0,317449,288161,23101,84855,2.6692448775427025,0.22748353958007164
12945,0.4130555555555555,0,1,0,317450,288160,23101,84855,2.669235614509615,0.22748414943098802
12946,0.4130714285714286,1,0,1,317450,288160,23102,84854,2.669235614509615,0.2274820784206491
12947,0.4130952380952381,0,1,0,317451,288159,23102,84854,2.6692263514765275,0.22748268827091817
12948,0.4131153846153846,0,1,0,317452,288158,23102,84854,2.66921708844344,0.2274832981244571
12949,0.4131666666666666,2,19,2,317471,288139,23104,84852,2.6690410908147766,0.22749074374448713
12950,0.4131666666666667,1,7,1,317478,288132,23105,84851,2.6689762495831637,0.22749294203757275
12951,0.4131904761904762,0,1,0,317479,288131,23105,84851,2.668966986550076,0.22749355196765528
12952,0.4132049062049062,0,3,0,317482,288128,23105,84851,2.6689391974508134,0.22749538177752635
12953,0.4132142857142857,1,6,1,317488,288122,23106,84850,2.668883619252288,0.22749697028195145
12954,0.4132499999999999,0,1,0,317489,288121,23106,84850,2.6688743562192005,0.227497580240823
12955,0.41325,0,1,0,317490,288120,23106,84850,2.668865093186113,0.22749819020296538
12956,0.4132619047619048,1,0,1,317490,288120,23107,84849,2.668865093186113,0.22749611898039784
12957,0.4133095238095238,0,1,0,317491,288119,23107,84849,2.668855830153025,0.22749672894189313
12958,0.4133333333333333,98,799,98,318290,287320,23205,84751,2.6614546667160695,0.2277817943349522
12959,0.4133809523809524,1,0,1,318290,287320,23206,84750,2.6614546667160695,0.2277797188701051
12960,0.4134166666666667,0,1,0,318291,287319,23206,84750,2.6614454036829818,0.22778033106762455
12961,0.4134285714285714,0,1,0,318292,287318,23206,84750,2.6614361406498945,0.22778094326843482
12962,0.4134523809523809,0,1,0,318293,287317,23206,84750,2.661426877616807,0.22778155547253587
12963,0.4134761904761905,0,1,0,318294,287316,23206,84750,2.661417614583719,0.22778216767992776
12964,0.4134999999999999,0,3,0,318297,287313,23206,84750,2.6613898254844566,0.22778400432184873
12965,0.4135,7,35,7,318332,287278,23213,84743,2.661065619326392,0.2277909042769091
12966,0.4135000000000001,0,1,0,318333,287277,23213,84743,2.6610563562933045,0.22779151658512983
12967,0.4135079365079365,0,1,0,318334,287276,23213,84743,2.6610470932602173,0.22779212889664238
12968,0.413531746031746,1,0,1,318334,287276,23214,84742,2.6610470932602173,0.2277900531694703
12969,0.4135404040404041,0,1,0,318335,287275,23214,84742,2.6610378302271296,0.22779066548034096
12970,0.4135595238095238,0,1,0,318336,287274,23214,84742,2.661028567194042,0.22779127779450345
12971,0.4135714285714285,0,2,0,318338,287272,23214,84742,2.661010041127867,0.22779250243270416
12972,0.4135714285714286,0,2,0,318340,287270,23214,84742,2.6609915150616916,0.22779372708407256
12973,0.4135833333333333,0,1,0,318341,287269,23214,84742,2.6609822520286044,0.22779433941469474
12974,0.413595238095238,0,1,0,318342,287268,23214,84742,2.6609729889955167,0.22779495174860892
12975,0.4136111111111111,1,0,1,318342,287268,23215,84741,2.6609729889955167,0.22779287597880696
12976,0.4136190476190476,0,2,0,318344,287266,23215,84741,2.660954462929342,0.22779410064864372
12977,0.4136428571428571,0,2,0,318346,287264,23215,84741,2.6609359368631664,0.22779532533164876
12978,0.4136666666666666,1,5,1,318351,287259,23216,84740,2.660889621697729,0.22779631128040667
12979,0.4136666666666667,4,28,4,318379,287231,23220,84736,2.6606302567712774,0.22780515475835222
12980,0.4136904761904762,0,3,0,318382,287228,23220,84736,2.6606024676720144,0.22780699207450184
12981,0.4137063492063492,0,4,0,318386,287224,23220,84736,2.6605654155396645,0.22780944187547048
12982,0.4137142857142856,1,0,1,318386,287224,23221,84735,2.6605654155396645,0.22780736586559272
12983,0.41375,0,9,0,318395,287215,23221,84735,2.6604820482418763,0.22781287807501008
12984,0.4137619047619047,3,4,3,318399,287211,23224,84732,2.660444996109526,0.2278090997814181
12985,0.4137857142857143,0,5,0,318404,287206,23224,84732,2.6603986809440885,0.2278121622420941
12986,0.4138095238095237,0,1,0,318405,287205,23224,84732,2.660389417911001,0.22781277474410988
12987,0.4138095238095238,1,4,1,318409,287201,23225,84731,2.6603523657786505,0.227813148640074
12988,0.4138333333333333,0,11,0,318420,287190,23225,84731,2.6602504724146874,0.22781988648126889
12989,0.4138333333333334,0,2,0,318422,287188,23225,84731,2.6602319463485125,0.22782111158612495
12990,0.4138809523809524,1,0,1,318422,287188,23226,84730,2.6602319463485125,0.2278190353787663
12991,0.4139166666666666,0,1,0,318423,287187,23226,84730,2.6602226833154248,0.22781964793219991
12992,0.4139285714285715,1,3,1,318426,287184,23227,84729,2.660194894216162,0.2278194093779997
12993,0.4139404761904761,2,2,2,318428,287182,23229,84727,2.660176368149987,0.2278164819888736
12994,0.4139523809523809,1,1,1,318429,287181,23230,84726,2.6601671051168996,0.2278150182706967
12995,0.4139999999999999,0,1,0,318430,287180,23230,84726,2.660157842083812,0.22781563083144665
12996,0.414,12,150,12,318580,287030,23242,84714,2.658768387120679,0.22788262890591374
12997,0.414047619047619,0,5,0,318585,287025,23242,84714,2.658722071955241,0.22788569399498035
12998,0.414107142857143,1,0,1,318585,287025,23243,84713,2.658722071955241,0.22788361695602816
12999,0.4141111111111111,1,0,1,318585,287025,23244,84712,2.658722071955241,0.2278815399059012
13000,0.4141190476190475,0,2,0,318587,287023,23244,84712,2.658703545889066,0.22788276594886142
13001,0.4141190476190476,0,1,0,318588,287022,23244,84712,2.6586942828559783,0.2278833789752888
13002,0.4141269841269841,0,1,0,318589,287021,23244,84712,2.6586850198228906,0.22788399200501436
13003,0.4141666666666666,15,75,15,318664,286946,23259,84697,2.6579902923413243,0.22789881687533467
13004,0.4141666666666667,12,68,12,318732,286878,23271,84685,2.6573604060913705,0.22791558901182302
13005,0.4142142857142857,0,1,0,318733,286877,23271,84685,2.657351143058283,0.2279162024103649
13006,0.414238095238095,0,2,0,318735,286875,23271,84685,2.657332616992108,0.22791742921735386
13007,0.4142420634920636,0,3,0,318738,286872,23271,84685,2.6573048278928453,0.22791926945260083
13008,0.4142777777777778,0,1,0,318739,286871,23271,84685,2.6572955648597576,0.2279198828709535
13009,0.4142857142857142,0,1,0,318740,286870,23271,84685,2.65728630182667,0.2279204962926081
13010,0.4142857142857143,1,11,1,318751,286859,23272,84684,2.657184408462707,0.22792516613151104
13011,0.4143333333333333,2,12,2,318763,286847,23274,84682,2.6570732520656564,0.22792837167488944
13012,0.4143333333333334,4,40,4,318803,286807,23278,84678,2.656702730742154,0.22794460072412076
13013,0.4143650793650794,0,1,0,318804,286806,23278,84678,2.656693467709067,0.2279452143295539
13014,0.4143690476190477,0,1,0,318805,286805,23278,84678,2.656684204675979,0.22794582793829057
13015,0.4143809523809523,0,2,0,318807,286803,23278,84678,2.656665678609804,0.22794705516567468
13016,0.4143809523809524,0,1,0,318808,286802,23278,84678,2.6566564155767165,0.22794766878432218
13017,0.4144047619047619,0,2,0,318810,286800,23278,84678,2.656637889510541,0.22794889603152813
13018,0.4144166666666667,0,1,0,318811,286799,23278,84678,2.656628626477454,0.22794950966008662
13019,0.4144285714285714,0,2,0,318813,286797,23278,84678,2.6566101004112785,0.22795073692711487
13020,0.414436507936508,0,2,0,318815,286795,23278,84678,2.6565915743451036,0.22795196420735828
13021,0.4144444444444443,0,2,0,318817,286793,23278,84678,2.6565730482789283,0.22795319150081703
13022,0.4144444444444444,0,2,0,318819,286791,23278,84678,2.6565545222127533,0.22795441880749134
13023,0.4144444444444445,0,1,0,318820,286790,23278,84678,2.6565452591796657,0.2279550324657844
13024,0.4144523809523809,0,1,0,318821,286789,23278,84678,2.6565359961465784,0.22795564612738142
13025,0.414452380952381,0,1,0,318822,286788,23278,84678,2.6565267331134907,0.22795625979228246
13026,0.4144642857142857,0,1,0,318823,286787,23278,84678,2.656517470080403,0.22795687346048754
13027,0.414468253968254,1,0,1,318823,286787,23279,84677,2.656517470080403,0.22795479508108457
13028,0.4145,2,17,2,318840,286770,23281,84675,2.6563599985179147,0.22796107095263093
13029,0.4145000000000001,0,1,0,318841,286769,23281,84675,2.656350735484827,0.227961684668483
13030,0.4145079365079366,0,2,0,318843,286767,23281,84675,2.656332209418652,0.22796291211010064
13031,0.4145238095238095,1,7,1,318850,286760,23282,84674,2.6562673681870392,0.2279651297404115
13032,0.414531746031746,0,2,0,318852,286758,23282,84674,2.656248842120864,0.22796635723362554
13033,0.4145714285714285,0,1,0,318853,286757,23282,84674,2.6562395790877766,0.2279669709851897
13034,0.4145833333333333,0,1,0,318854,286756,23282,84674,2.656230316054689,0.22796758474005868
13035,0.4145887445887445,0,1,0,318855,286755,23282,84674,2.6562210530216013,0.2279681984982325
13036,0.4146153846153846,0,1,0,318856,286754,23282,84674,2.656211789988514,0.22796881225971116
13037,0.4146190476190476,1,0,1,318856,286754,23283,84673,2.656211789988514,0.22796673370541182
13038,0.4146428571428571,1,1,1,318857,286753,23284,84672,2.6562025269554264,0.22796526889681631
13039,0.4146666666666666,1,12,1,318869,286741,23285,84671,2.6560913705583755,0.2279705556094041
13040,0.4146666666666667,6,35,6,318904,286706,23291,84665,2.655767164400311,0.2279795676022091
13041,0.4146785714285715,0,2,0,318906,286704,23291,84665,2.655748638334136,0.2279807953814131
13042,0.4146904761904761,0,1,0,318907,286703,23291,84665,2.6557393753010485,0.22798140927597424
13043,0.4147142857142857,0,2,0,318909,286701,23291,84665,2.6557208492348736,0.22798263707501495
13044,0.4147142857142858,0,1,0,318910,286700,23291,84665,2.655711586201786,0.22798325097949457
13045,0.41475,1,0,1,318910,286700,23292,84664,2.655711586201786,0.22798117211145938
13046,0.4147619047619047,1,4,1,318914,286696,23293,84663,2.6556745340694357,0.22798154885165028
13047,0.4147619047619048,1,0,1,318914,286696,23294,84662,2.6556745340694357,0.2279794699454435
13048,0.4147922077922078,0,1,0,318915,286695,23294,84662,2.655665271036348,0.22798008385461968
13049,0.4148333333333333,2,17,2,318932,286678,23296,84660,2.6555077994738596,0.22798636282847431
13050,0.4148333333333334,0,1,0,318933,286677,23296,84660,2.6554985364407724,0.22798697678927765
13051,0.4148571428571428,0,1,0,318934,286676,23296,84660,2.6554892734076847,0.22798759075338776
13052,0.4148809523809524,1,4,1,318938,286672,23297,84659,2.6554522212753344,0.22798796760841405
13053,0.4149047619047619,0,1,0,318939,286671,23297,84659,2.6554429582422467,0.22798858158511298
13054,0.4149523809523809,0,2,0,318941,286669,23297,84659,2.655424432176072,0.22798980954843157
13055,0.4149761904761904,0,1,0,318942,286668,23297,84659,2.655415169142984,0.2279904235350513
13056,0.4149769119769119,0,1,0,318943,286667,23297,84659,2.6554059061098965,0.22799103752497804
13057,0.4149999999999999,2,26,2,318969,286641,23299,84657,2.6551650672496203,0.22800284407672544
13058,0.415,155,1448,155,320417,285193,23454,84502,2.641752195338842,0.22857220140926982
13059,0.4150000000000001,2,27,2,320444,285166,23456,84500,2.6415020934454776,0.22858472242510808
13060,0.4150357142857143,0,1,0,320445,285165,23456,84500,2.6414928304123904,0.2285853407815184
13061,0.415047619047619,0,1,0,320446,285164,23456,84500,2.6414835673793027,0.22858595914127425
13062,0.4151111111111111,0,1,0,320447,285163,23456,84500,2.641474304346215,0.2285865775043756
13063,0.4151190476190476,1,0,1,320447,285163,23457,84499,2.641474304346215,0.2285844906969069
13064,0.4151428571428571,1,0,1,320447,285163,23458,84498,2.641474304346215,0.22858240387814782
13065,0.4151428571428572,0,1,0,320448,285162,23458,84498,2.6414650413131278,0.2285830222366499
13066,0.4151666666666667,1,19,1,320467,285143,23459,84497,2.641289043684464,0.22859268477437505
13067,0.4151904761904761,0,1,0,320468,285142,23459,84497,2.6412797806513764,0.22859330319582077
13068,0.4152023809523808,0,1,0,320469,285141,23459,84497,2.641270517618289,0.2285939216206126
13069,0.4152142857142857,0,2,0,320471,285139,23459,84497,2.6412519915521138,0.22859515848023462
13070,0.4152380952380952,0,4,0,320475,285135,23459,84497,2.6412149394197635,0.22859763223963292
13071,0.41525,0,1,0,320476,285134,23459,84497,2.6412056763866762,0.22859825068784814
13072,0.4152777777777778,0,1,0,320477,285133,23459,84497,2.6411964133535886,0.2285988691394097
13073,0.4152857142857143,0,2,0,320479,285131,23459,84497,2.641177887287413,0.22860010605257178
13074,0.4152976190476191,0,1,0,320480,285130,23459,84497,2.641168624254326,0.2286007245141724
13075,0.4153333333333332,0,1,0,320481,285129,23459,84497,2.6411593612212383,0.22860134297911944
13076,0.4153333333333333,3,26,3,320507,285103,23462,84494,2.6409185223609617,0.2286111629693964
13077,0.4153333333333334,1,9,1,320516,285094,23463,84493,2.640835155063174,0.22861464283105196
13078,0.415340909090909,0,1,0,320517,285093,23463,84493,2.640825892030086,0.22861526140059418
13079,0.4153571428571428,0,2,0,320519,285091,23463,84493,2.6408073659639113,0.22861649854972077
13080,0.4153809523809524,0,2,0,320521,285089,23463,84493,2.640788839897736,0.22861773571223706
13081,0.4154166666666666,0,1,0,320522,285088,23463,84493,2.6407795768646487,0.22861835429851643
13082,0.415426406926407,1,0,1,320522,285088,23464,84492,2.6407795768646487,0.22861626711402133
13083,0.4154285714285714,0,1,0,320523,285087,23464,84492,2.640770313831561,0.2286168856996745
13084,0.4154761904761904,0,4,0,320527,285083,23464,84492,2.6407332616992107,0.2286193600757627
13085,0.4154761904761905,1,3,1,320530,285080,23465,84491,2.640705472599948,0.22861912866539852
13086,0.4154999999999999,0,1,0,320531,285079,23465,84491,2.6406962095668605,0.2286197472738588
13087,0.4155,1,24,1,320555,285055,23466,84490,2.6404738967727592,0.22863250754305972
13088,0.4155173160173159,0,1,0,320556,285054,23466,84490,2.6404646337396716,0.22863312623124715
13089,0.4155238095238095,0,1,0,320557,285053,23466,84490,2.6404553707065843,0.22863374492278302
13090,0.4155555555555555,0,2,0,320559,285051,23466,84490,2.640436844640409,0.2286349823159
13091,0.4156111111111111,0,1,0,320560,285050,23466,84490,2.6404275816073217,0.2286356010174812
13092,0.4156190476190476,2,0,2,320560,285050,23468,84488,2.6404275816073217,0.22863142626739333
13093,0.4156428571428571,0,2,0,320562,285048,23468,84488,2.6404090555411464,0.22863266366470383
13094,0.4156666666666666,4,34,4,320596,285014,23472,84484,2.6400941124161696,0.22864535126035865
13095,0.4156666666666667,4,13,4,320609,285001,23476,84480,2.639973692986031,0.2286450453473927
13096,0.4156904761904761,0,4,0,320613,284997,23476,84480,2.6399366408536813,0.22864752068464342
13097,0.4156980519480519,0,1,0,320614,284996,23476,84480,2.6399273778205936,0.2286481395273306
13098,0.4157142857142857,0,23,0,320637,284973,23476,84480,2.6397143280595796,0.22866237383374882
13099,0.4157222222222222,0,2,0,320639,284971,23476,84480,2.6396958019934047,0.22866361168328142
13100,0.4157539682539683,0,1,0,320640,284970,23476,84480,2.639686538960317,0.22866423061307348
13101,0.4157619047619048,0,2,0,320642,284968,23476,84480,2.639668012894142,0.22866546848270933
13102,0.4157918470418471,0,1,0,320643,284967,23476,84480,2.6396587498610544,0.22866608742255318
13103,0.4157954545454544,0,2,0,320645,284965,23476,84480,2.6396402237948795,0.22866732531229275
13104,0.4158333333333333,22,118,22,320763,284847,23498,84458,2.638547185890548,0.22869443955538105
13105,0.4158333333333334,0,1,0,320764,284846,23498,84458,2.6385379228574606,0.22869505881333535
13106,0.4158571428571428,0,2,0,320766,284844,23498,84458,2.638519396791285,0.22869629733930497
13107,0.4158809523809524,0,1,0,320767,284843,23498,84458,2.638510133758198,0.2286969166073203
13108,0.4158928571428572,0,2,0,320769,284841,23498,84458,2.6384916076920226,0.22869815515341227
13109,0.4159523809523809,0,7,0,320776,284834,23498,84458,2.6384267664604097,0.22870249017038008
13110,0.4159761904761905,0,1,0,320777,284833,23498,84458,2.638417503427322,0.22870310947193406
13111,0.4159999999999999,0,12,0,320789,284821,23498,84458,2.6383063470302717,0.22871054135220253
13112,0.416,19,140,19,320929,284681,23517,84439,2.637009522398014,0.22875758560901605
13113,0.4160000000000001,2,4,2,320933,284677,23519,84437,2.636972470265664,0.2287558857155242
13114,0.4160238095238096,0,8,0,320941,284669,23519,84437,2.6368983660009633,0.22876084376845676
13115,0.416047619047619,0,1,0,320942,284668,23519,84437,2.6368891029678756,0.22876146354018503
13116,0.4160606060606061,0,1,0,320943,284667,23519,84437,2.6368798399347884,0.22876208331527156
13117,0.4160649350649351,0,2,0,320945,284665,23519,84437,2.636861313868613,0.2287633228755195
13118,0.4160714285714285,0,1,0,320946,284664,23519,84437,2.6368520508355258,0.22876394266068095
13119,0.4160714285714286,0,1,0,320947,284663,23519,84437,2.636842787802438,0.22876456244920076
13120,0.4160833333333332,0,1,0,320948,284662,23519,84437,2.6368335247693504,0.22876518224107895
13121,0.4160833333333333,0,1,0,320949,284661,23519,84437,2.6368242617362627,0.22876580203631555
13122,0.4160952380952381,0,4,0,320953,284657,23519,84437,2.636787209603913,0.22876828125084667
13123,0.4161111111111111,0,2,0,320955,284655,23519,84437,2.6367686835377375,0.2287695208782634
13124,0.4161212121212121,1,0,1,320955,284655,23520,84436,2.6367686835377375,0.2287674313380711
13125,0.4161428571428571,0,2,0,320957,284653,23520,84436,2.6367501574715626,0.22876867097095824
13126,0.4161666666666666,1,0,1,320957,284653,23521,84435,2.6367501574715626,0.2287665814114791
13127,0.4161666666666667,0,9,0,320966,284644,23521,84435,2.6366667901737744,0.22877215988988808
13128,0.4161904761904761,0,1,0,320967,284643,23521,84435,2.636657527140687,0.22877277973761645
13129,0.4161904761904762,0,11,0,320978,284632,23521,84435,2.636555633776724,0.22877959828432237
13130,0.4161904761904763,0,1,0,320979,284631,23521,84435,2.6365463707436363,0.2287802181723594
13131,0.4162499999999999,0,1,0,320980,284630,23521,84435,2.6365371077105486,0.2287808380637557
13132,0.41625,1,9,1,320989,284621,23522,84434,2.636453740412761,0.22878432753925568
13133,0.4162857142857143,0,1,0,320990,284620,23522,84434,2.636444477379673,0.22878494746026326
13134,0.4163095238095238,1,2,1,320992,284618,23523,84433,2.636425951313498,0.2287840975908479
13135,0.4163333333333333,6,25,6,321017,284593,23529,84427,2.6361943754863093,0.22878705761205353
13136,0.4163333333333334,1,5,1,321022,284588,23530,84426,2.6361480603208713,0.22878806766138954
13137,0.4163571428571428,0,1,0,321023,284587,23530,84426,2.636138797287784,0.2287886876614103
13138,0.4163773448773449,0,3,0,321026,284584,23530,84426,2.636111008188521,0.22879054768163465
13139,0.4163809523809523,0,1,0,321027,284583,23530,84426,2.636101745155434,0.22879116769509686
13140,0.4163809523809524,0,1,0,321028,284582,23530,84426,2.636092482122346,0.22879178771191952
13141,0.4164047619047619,0,1,0,321029,284581,23530,84426,2.6360832190892585,0.22879240773210263
13142,0.4164126984126984,0,2,0,321031,284579,23530,84426,2.6360646930230835,0.22879364778255037
13143,0.4164166666666666,0,1,0,321032,284578,23530,84426,2.636055429989996,0.22879426781281503
13144,0.4164285714285713,0,3,0,321035,284575,23530,84426,2.6360276408907333,0.22879612792377257
13145,0.4164285714285715,0,2,0,321037,284573,23530,84426,2.6360091148245584,0.22879736801454748
13146,0.4164761904761904,0,1,0,321038,284572,23530,84426,2.6359998517914707,0.22879798806497595
13147,0.4165,3,30,3,321068,284542,23533,84423,2.635721960798844,0.2288103207621319
13148,0.416547619047619,2,0,2,321068,284542,23535,84421,2.635721960798844,0.22880614045310776
13149,0.4166190476190475,0,1,0,321069,284541,23535,84421,2.6357126977657566,0.22880676058781121
13150,0.4166190476190476,0,1,0,321070,284540,23535,84421,2.635703434732669,0.22880738072587617
13151,0.4166428571428571,0,1,0,321071,284539,23535,84421,2.635694171699581,0.22880800086730269
13152,0.4166666666666666,53,423,53,321494,284116,23588,84368,2.631775908703546,0.2289597377362382
13153,0.4166666666666667,38,343,38,321837,283773,23626,84330,2.628598688354515,0.22909348742064042
13154,0.4167499999999999,0,1,0,321838,283772,23626,84330,2.6285894253214273,0.22909410978478792
13155,0.41675,1,0,1,321838,283772,23627,84329,2.6285894253214273,0.22909201550661368
13156,0.4167619047619048,0,1,0,321839,283771,23627,84329,2.6285801622883396,0.22909263787014397
13157,0.4167857142857143,1,3,1,321842,283768,23628,84328,2.628552373189077,0.22909241067547595
13158,0.4167936507936507,0,1,0,321843,283767,23628,84328,2.6285431101559893,0.22909303304853368
13159,0.4168095238095238,0,1,0,321844,283766,23628,84328,2.628533847122902,0.22909365542497298
13160,0.4168257575757576,0,1,0,321845,283765,23628,84328,2.6285245840898144,0.2290942778047939
13161,0.4168333333333333,0,6,0,321851,283759,23628,84328,2.628469005891289,0.22909801215473516
13162,0.4168333333333334,1,12,1,321863,283747,23629,84327,2.6283578494942383,0.2291033868189549
13163,0.4168571428571428,0,2,0,321865,283745,23629,84327,2.6283393234280634,0.22910463170249298
13164,0.4169047619047619,0,4,0,321869,283741,23629,84327,2.628302271295713,0.22910712151015572
13165,0.4169444444444444,0,3,0,321872,283738,23629,84327,2.6282744821964505,0.22910898890141687
13166,0.4169523809523809,0,1,0,321873,283737,23629,84327,2.628265219163363,0.2291096113719353
13167,0.4169642857142858,0,3,0,321876,283734,23629,84327,2.6282374300641003,0.22911147880378524
13168,0.4169761904761904,0,1,0,321877,283733,23629,84327,2.6282281670310126,0.2291121012878335
13169,0.417,7,69,7,321946,283664,23636,84320,2.6275890177479715,0.22914039740858297
13170,0.4170238095238094,0,1,0,321947,283663,23636,84320,2.627579754714884,0.22914102010147208
13171,0.4170476190476189,0,1,0,321948,283662,23636,84320,2.627570491681796,0.22914164279774554
13172,0.417047619047619,0,1,0,321949,283661,23636,84320,2.627561228648709,0.2291422654974034
13173,0.4170476190476191,0,1,0,321950,283660,23636,84320,2.627551965615621,0.22914288820044568
13174,0.4170833333333333,0,4,0,321954,283656,23636,84320,2.627514913483271,0.22914537904645954
13175,0.4170880230880231,0,1,0,321955,283655,23636,84320,2.6275056504501832,0.22914600176642436
13176,0.4171111111111111,0,1,0,321956,283654,23636,84320,2.627496387417096,0.22914662448977374
13177,0.4171428571428571,2,13,2,321969,283641,23638,84318,2.6273759679869575,0.22915053035800184
13178,0.4171428571428572,0,1,0,321970,283640,23638,84318,2.6273667049538703,0.2291511531207366
13179,0.4171666666666666,0,4,0,321974,283636,23638,84318,2.62732965282152,0.2291536442055257
13180,0.4171666666666667,1,13,1,321987,283623,23639,84317,2.6272092333913815,0.2291596455943904
13181,0.4172222222222222,0,2,0,321989,283621,23639,84317,2.6271907073252065,0.2291608912371106
13182,0.4172857142857142,1,0,1,321989,283621,23640,84316,2.6271907073252065,0.22915879620695934
13183,0.4173095238095238,0,1,0,321990,283620,23640,84316,2.627181444292119,0.2291594190293964
13184,0.4173333333333333,6,47,6,322037,283573,23646,84310,2.626746081737004,0.22917612393070624
13185,0.4173333333333334,0,2,0,322039,283571,23646,84310,2.6267275556708287,0.22917736985601322
13186,0.4173809523809523,0,4,0,322043,283567,23646,84310,2.6266905035384784,0.2291798617472688
13187,0.4173809523809524,0,4,0,322047,283563,23646,84310,2.6266534514061286,0.2291823536927146
13188,0.4173888888888889,0,2,0,322049,283561,23646,84310,2.6266349253399532,0.2291835996857594
13189,0.4174058441558442,0,1,0,322050,283560,23646,84310,2.6266256623068656,0.22918422268736238
13190,0.4174166666666666,0,1,0,322051,283559,23646,84310,2.6266163992737783,0.22918484569235245
13191,0.4174444444444444,0,1,0,322052,283558,23646,84310,2.6266071362406906,0.22918546870072962
13192,0.417452380952381,0,1,0,322053,283557,23646,84310,2.626597873207603,0.2291860917124939
13193,0.4174999999999999,0,10,0,322063,283547,23646,84310,2.6265052428767275,0.22919232201643575
13194,0.4175,60,397,60,322460,283150,23706,84250,2.6228278187409684,0.22931409907457811
13195,0.4175000000000001,1,5,1,322465,283145,23707,84249,2.622781503575531,0.22931512218490233
13196,0.4175238095238095,0,2,0,322467,283143,23707,84249,2.6227629775093555,0.22931637052521558
13197,0.4175714285714286,1,1,1,322468,283142,23708,84248,2.6227537144762683,0.2293148969759656
13198,0.4175952380952381,0,1,0,322469,283141,23708,84248,2.6227444514431806,0.22931552115060602
13199,0.417611111111111,0,1,0,322470,283140,23708,84248,2.622735188410093,0.2293161453286444
13200,0.4176190476190476,1,4,1,322474,283136,23709,84247,2.6226981362777426,0.22931654431478865
13201,0.4176388888888888,0,2,0,322476,283134,23709,84247,2.6226796102115677,0.2293177927002213
13202,0.4176666666666666,1,33,1,322509,283101,23710,84246,2.6223739301196782,0.22933629511061748
13203,0.4176666666666667,3,8,3,322517,283093,23713,84243,2.622299825854978,0.22933499575320687
13204,0.4177142857142857,0,2,0,322519,283091,23713,84243,2.6222812997888028,0.2293362443988305
13205,0.4177380952380952,0,1,0,322520,283090,23713,84243,2.622272036755715,0.22933686872674114
13206,0.41775,0,1,0,322521,283089,23713,84243,2.622262773722628,0.22933749305805104
13207,0.4177777777777778,0,2,0,322523,283087,23713,84243,2.6222442476564525,0.2293387417308687
13208,0.417797619047619,1,1,1,322524,283086,23714,84242,2.6222349846233652,0.2293372680547086
13209,0.4178149350649351,1,1,1,322525,283085,23715,84241,2.6222257215902776,0.22933579436250087
13210,0.4178333333333332,0,1,0,322526,283084,23715,84241,2.62221645855719,0.22933641870278365
13211,0.4178333333333333,2,14,2,322540,283070,23717,84239,2.622086776093964,0.22934096360285208
13212,0.4178333333333334,0,7,0,322547,283063,23717,84239,2.6220219348623512,0.22934533435701412
13213,0.4178571428571427,0,1,0,322548,283062,23717,84239,2.6220126718292636,0.22934595876406544
13214,0.4178571428571428,2,6,2,322554,283056,23719,84237,2.6219570936307384,0.22934550889889
13215,0.4178586691086692,0,1,0,322555,283055,23719,84237,2.6219478305976507,0.22934613332171677
13216,0.4178809523809523,1,2,1,322557,283053,23720,84236,2.6219293045314758,0.22934528395895332
13217,0.4179047341547341,1,4,1,322561,283049,23721,84235,2.6218922523991255,0.22934568344931988
13218,0.4179166666666666,0,5,0,322566,283044,23721,84235,2.621845937233688,0.2293488056763387
13219,0.4179166666666667,0,1,0,322567,283043,23721,84235,2.6218366742006003,0.22934943013194364
13220,0.4179285714285714,2,3,2,322570,283040,23723,84233,2.6218088851013377,0.22934710692046517
13221,0.4179999999999999,0,1,0,322571,283039,23723,84233,2.62179962206825,0.2293477313816463
13222,0.418,9,102,9,322673,282937,23732,84224,2.6208547926933194,0.22939255530952363
13223,0.4180714285714286,0,2,0,322675,282935,23732,84224,2.6208362666271445,0.22939380486383285
13224,0.4180833333333333,0,2,0,322677,282933,23732,84224,2.620817740560969,0.22939505443175534
13225,0.418095238095238,0,1,0,322678,282932,23732,84224,2.620808477527882,0.22939567922082166
13226,0.4180952380952381,0,1,0,322679,282931,23732,84224,2.6207992144947942,0.2293963040132914
13227,0.4181111111111111,0,1,0,322680,282930,23732,84224,2.6207899514617066,0.22939692880916454
13228,0.4181190476190475,0,1,0,322681,282929,23732,84224,2.620780688428619,0.22939755360844116
13229,0.4181547619047619,0,1,0,322682,282928,23732,84224,2.6207714253955317,0.22939817841112128
13230,0.4181666666666666,2,12,2,322694,282916,23734,84222,2.620660268998481,0.2294014784631392
13231,0.4181666666666667,1,2,1,322696,282914,23735,84221,2.620641742932306,0.22940062919634466
13232,0.4181904761904761,1,1,1,322697,282913,23736,84220,2.620632479899218,0.2293991550745915
13233,0.4182142857142857,2,6,2,322703,282907,23738,84218,2.620576901700693,0.2293987061627511
13234,0.4182142857142858,0,1,0,322704,282906,23738,84218,2.6205676386676053,0.2293993310162234
13235,0.41825,0,2,0,322706,282904,23738,84218,2.6205491126014304,0.22940058073338018
13236,0.4182619047619048,0,2,0,322708,282902,23738,84218,2.620530586535255,0.2294018304641534
13237,0.4182857142857143,0,1,0,322709,282901,23738,84218,2.6205213235021674,0.22940245533464626
13238,0.4183333333333333,55,434,55,323143,282467,23793,84163,2.616501167142169,0.2295584103864932
13239,0.4183333333333334,0,2,0,323145,282465,23793,84163,2.616482641075994,0.22955966265533456
13240,0.4183571428571428,0,1,0,323146,282464,23793,84163,2.6164733780429064,0.22956028879487872
13241,0.4183809523809524,1,0,1,323146,282464,23794,84162,2.6164733780429064,0.2295581873625984
13242,0.4183939393939394,0,1,0,323147,282463,23794,84162,2.6164641150098187,0.22955881350153426
13243,0.4184166666666666,0,2,0,323149,282461,23794,84162,2.6164455889436438,0.22956006578965313
13244,0.4184444444444444,0,2,0,323151,282459,23794,84162,2.6164270628774684,0.229561318091435
13245,0.4184448051948052,0,1,0,323152,282458,23794,84162,2.616417799844381,0.22956194424744966
13246,0.4184523809523809,0,2,0,323154,282456,23794,84162,2.616399273778206,0.22956319656972654
13247,0.418452380952381,0,1,0,323155,282455,23794,84162,2.6163900107451186,0.22956382273598877
13248,0.4184523809523811,0,1,0,323156,282454,23794,84162,2.616380747712031,0.22956444890566696
13249,0.4184761904761905,0,1,0,323157,282453,23794,84162,2.616371484678943,0.2295650750787611
13250,0.4184999999999998,0,1,0,323158,282452,23794,84162,2.6163622216458555,0.2295657012552712
13251,0.4184999999999999,1,3,1,323161,282449,23795,84161,2.616334432546593,0.229565478301192
13252,0.4185,4,26,4,323187,282423,23799,84157,2.6160935936863168,0.22957335370178406
13253,0.4185000000000001,0,1,0,323188,282422,23799,84157,2.616084330653229,0.2295739799606633
13254,0.418547619047619,0,1,0,323189,282421,23799,84157,2.6160750676201414,0.22957460622295936
13255,0.4185555555555555,0,1,0,323190,282420,23799,84157,2.616065804587054,0.22957523248867223
13256,0.4185714285714285,0,1,0,323191,282419,23799,84157,2.6160565415539665,0.22957585875780193
13257,0.4185714285714286,2,10,2,323201,282409,23801,84155,2.615963911223091,0.22957791818072698
13258,0.4185833333333333,0,2,0,323203,282407,23801,84155,2.6159453851569157,0.22957917078147763
13259,0.4185873015873016,0,5,0,323208,282402,23801,84155,2.615899069991478,0.22958230234315535
13260,0.4186111111111111,0,1,0,323209,282401,23801,84155,2.6158898069583905,0.22958292866574276
13261,0.4186428571428571,0,1,0,323210,282400,23801,84155,2.615880543925303,0.22958355499174748
13262,0.4186666666666666,0,4,0,323214,282396,23801,84155,2.6158434917929525,0.22958606032994044
13263,0.4186666666666667,4,33,4,323247,282363,23805,84151,2.6155378117010635,0.2295983236656717
13264,0.4186904761904762,1,2,1,323249,282361,23806,84150,2.615519285634888,0.22959747456420135
13265,0.4187142857142856,0,1,0,323250,282360,23806,84150,2.615510022601801,0.22959810100679381
13266,0.4187222222222222,0,1,0,323251,282359,23806,84150,2.615500759568713,0.2295987274528047
13267,0.4187380952380952,0,1,0,323252,282358,23806,84150,2.6154914965356255,0.22959935390223407
13268,0.4187499999999999,0,2,0,323254,282356,23806,84150,2.6154729704694506,0.22960060681134825
13269,0.41875,0,8,0,323262,282348,23806,84150,2.61539886620475,0.2296056185845489
13270,0.4188095238095237,0,1,0,323263,282347,23806,84150,2.6153896031716624,0.22960624507158311
13271,0.4188095238095238,1,2,1,323265,282345,23807,84149,2.6153710771054874,0.2296053959955688
13272,0.4188333333333333,2,12,2,323277,282333,23809,84147,2.6152599207084366,0.2296087098886706
13273,0.4188333333333334,0,2,0,323279,282331,23809,84147,2.6152413946422617,0.22960996294456967
13274,0.4188571428571429,0,1,0,323280,282330,23809,84147,2.615232131609174,0.22961058947764798
13275,0.4188690476190476,0,1,0,323281,282329,23809,84147,2.6152228685760868,0.22961121601414552
13276,0.4188888888888888,0,1,0,323282,282328,23809,84147,2.615213605542999,0.22961184255406236
13277,0.4188928571428572,0,1,0,323283,282327,23809,84147,2.6152043425099114,0.22961246909739846
13278,0.4189166666666666,1,0,1,323283,282327,23810,84146,2.6152043425099114,0.22961036693016948
13279,0.4189285714285714,1,4,1,323287,282323,23811,84145,2.615167290377561,0.22961077092679305
13280,0.4189523809523809,0,1,0,323288,282322,23811,84145,2.615158027344474,0.22961139747917275
13281,0.4189642857142857,0,1,0,323289,282321,23811,84145,2.615148764311386,0.22961202403497186
13282,0.4189761904761904,0,2,0,323291,282319,23811,84145,2.615130238245211,0.2296132771568285
13283,0.4189999999999999,1,3,1,323294,282316,23812,84144,2.6151024491459482,0.2296130546307919
13284,0.419,11,80,11,323374,282236,23823,84133,2.614361406498944,0.22964006234151907
13285,0.4190238095238094,0,1,0,323375,282235,23823,84133,2.6143521434658563,0.2296406891431566
13286,0.419047619047619,0,3,0,323378,282232,23823,84133,2.6143243543665937,0.22964256956859963
13287,0.4190476190476191,0,1,0,323379,282231,23823,84133,2.614315091333506,0.2296431963839242
13288,0.4190833333333333,1,0,1,323379,282231,23824,84132,2.614315091333506,0.22964109366939348
13289,0.4190952380952379,0,3,0,323382,282228,23824,84132,2.6142873022342434,0.22964297412381265
13290,0.4191071428571429,0,1,0,323383,282227,23824,84132,2.614278039201156,0.22964360094879613
13291,0.4191428571428571,1,0,1,323383,282227,23825,84131,2.614278039201156,0.22964149820667215
13292,0.4191428571428572,0,1,0,323384,282226,23825,84131,2.6142687761680685,0.22964212503104894
13293,0.4191666666666666,16,74,16,323458,282152,23841,84115,2.6135833117195895,0.22965486926204107
13294,0.4191666666666667,9,76,9,323534,282076,23850,84106,2.6128793212049355,0.22968359995849058
13295,0.4191904761904761,0,1,0,323535,282075,23850,84106,2.612870058171848,0.22968422719911738
13296,0.4191904761904762,0,1,0,323536,282074,23850,84106,2.61286079513876,0.22968485444317002
13297,0.4192142857142857,1,1,1,323537,282073,23851,84105,2.612851532105673,0.22968337802926445
13298,0.4192499999999999,0,1,0,323538,282072,23851,84105,2.612842269072585,0.22968400527613694
13299,0.41925,0,1,0,323539,282071,23851,84105,2.6128330060394975,0.22968463252643537
13300,0.4192857142857142,0,1,0,323540,282070,23851,84105,2.61282374300641,0.22968525978015977
13301,0.4192857142857143,0,13,0,323553,282057,23851,84105,2.6127033235762718,0.22969341439035182
13302,0.4192936507936508,0,1,0,323554,282056,23851,84105,2.612694060543184,0.22969404169204258
13303,0.4193095238095237,1,0,1,323554,282056,23852,84104,2.612694060543184,0.22969193795062268
13304,0.4193333333333333,0,10,0,323564,282046,23852,84104,2.6126014302123086,0.229698211115663
13305,0.4193333333333334,10,56,10,323620,281990,23862,84094,2.6120827003594056,0.22971230646518284
13306,0.4193452380952381,0,2,0,323622,281988,23862,84094,2.6120641742932307,0.22971356144251834
13307,0.4193809523809523,0,1,0,323623,281987,23862,84094,2.612054911260143,0.2297141889363283
13308,0.4194166666666667,0,2,0,323625,281985,23862,84094,2.612036385193968,0.22971544393423277
13309,0.4194285714285714,0,1,0,323626,281984,23862,84094,2.6120271221608804,0.22971607143832734
13310,0.4194444444444444,0,2,0,323628,281982,23862,84094,2.612008596094705,0.22971732645680132
13311,0.4194458874458875,0,1,0,323629,281981,23862,84094,2.611999333061618,0.22971795397118078
13312,0.4194523809523809,0,1,0,323630,281980,23862,84094,2.61199007002853,0.22971858148898858
13313,0.4194761904761904,0,1,0,323631,281979,23862,84094,2.6119808069954424,0.22971920901022475
13314,0.4195,5,13,5,323644,281966,23867,84089,2.6118603875653044,0.22971684582917867
13315,0.4195198412698413,0,2,0,323646,281964,23867,84089,2.6118418614991294,0.22971810093073955
13316,0.4195238095238094,0,1,0,323647,281963,23867,84089,2.6118325984660418,0.2297187284866631
13317,0.419547619047619,1,0,1,323647,281963,23868,84088,2.6118325984660418,0.22971662418624728
13318,0.4195555555555554,0,1,0,323648,281962,23868,84088,2.611823335432954,0.22971725174156535
13319,0.4195833333333333,1,2,1,323650,281960,23869,84087,2.611804809366779,0.22971640253847184
13320,0.4196190476190475,0,1,0,323651,281959,23869,84087,2.6117955463336915,0.22971703010004207
13321,0.4196428571428571,0,3,0,323654,281956,23869,84087,2.611767757234429,0.22971891280532614
13322,0.4196428571428572,0,1,0,323655,281955,23869,84087,2.611758494201341,0.22971954038061207
13323,0.4196666666666666,2,15,2,323670,281940,23871,84085,2.6116195487050278,0.22972474557748787
13324,0.4196666666666667,2,22,2,323692,281918,23873,84083,2.611415761977102,0.22973434498812845
13325,0.4196904761904761,0,1,0,323693,281917,23873,84083,2.611406498944014,0.22973497267759563
13326,0.4197023809523809,0,3,0,323696,281914,23873,84083,2.6113787098447516,0.22973685576657732
13327,0.4197142857142857,0,2,0,323698,281912,23873,84083,2.6113601837785763,0.22973811117638218
13328,0.4197619047619047,0,1,0,323699,281911,23873,84083,2.611350920745489,0.22973873888642984
13329,0.4197619047619048,0,1,0,323700,281910,23873,84083,2.6113416577124013,0.22973936659990765
13330,0.4198095238095238,0,1,0,323701,281909,23873,84083,2.6113323946793137,0.22973999431681566
13331,0.4198333333333333,3,16,3,323717,281893,23876,84080,2.611184186149913,0.22974372426381182
13332,0.4198397435897436,0,1,0,323718,281892,23876,84080,2.6111749231168253,0.22974435202693103
13333,0.4198484848484848,1,0,1,323718,281892,23877,84079,2.6111749231168253,0.22974224733653759
13334,0.4198571428571428,0,1,0,323719,281891,23877,84079,2.6111656600837376,0.22974287509905184
13335,0.4198571428571429,0,1,0,323720,281890,23877,84079,2.6111563970506504,0.22974350286499676
13336,0.4198809523809524,0,3,0,323723,281887,23877,84079,2.611128607951388,0.22974538618341594
13337,0.4199166666666667,0,1,0,323724,281886,23877,84079,2.6111193449183,0.2297460139630839
13338,0.4199285714285714,0,3,0,323727,281883,23877,84079,2.6110915558190375,0.22974789732267284
13339,0.4199404761904762,1,0,1,323727,281883,23878,84078,2.6110915558190375,0.2297457925844557
13340,0.4199523809523809,0,3,0,323730,281880,23878,84078,2.611063766719775,0.2297476759628154
13341,0.4199610389610388,0,2,0,323732,281878,23878,84078,2.6110452406535996,0.2297489315655434
13342,0.4199999999999999,2,42,2,323774,281836,23880,84076,2.6106561932639223,0.2297710925031155
13343,0.42,419,3393,419,327167,278443,24299,83657,2.579226721997851,0.23103286384976526
13344,0.4200000000000001,4,23,4,327190,278420,24303,83653,2.579013672236837,0.2310390446125505
13345,0.420047619047619,3,3,3,327193,278417,24306,83650,2.5789858831375745,0.23103458752109415
13346,0.4200541125541125,0,1,0,327194,278416,24306,83650,2.578976620104487,0.23103522562184794
13347,0.4200714285714286,0,3,0,327197,278413,24306,83650,2.578948831005224,0.23103713994525815
13348,0.4200833333333332,1,0,1,327197,278413,24307,83649,2.578948831005224,0.23103501610221452
13349,0.4200833333333333,0,1,0,327198,278412,24307,83649,2.578939567972137,0.23103565421296413
13350,0.4200833333333334,1,1,1,327199,278411,24308,83648,2.5789303049390493,0.2310341684642558
13351,0.4200952380952381,0,2,0,327201,278409,24308,83648,2.578911778872874,0.23103544469517232
13352,0.4201071428571428,0,1,0,327202,278408,24308,83648,2.5789025158397867,0.23103608281591798
13353,0.4201507936507937,0,2,0,327204,278406,24308,83648,2.5788839897736113,0.23103735906798434
13354,0.4201666666666666,4,11,4,327215,278395,24312,83644,2.578782096409648,0.23103588287449695
13355,0.4201666666666667,1,1,1,327216,278394,24313,83643,2.578772833376561,0.23103439703676695
13356,0.4202142857142857,1,0,1,327216,278394,24314,83642,2.578772833376561,0.23103227303362098
13357,0.4202222222222223,0,1,0,327217,278393,24314,83642,2.5787635703434733,0.23103291118262045
13358,0.4202380952380952,1,1,1,327218,278392,24315,83641,2.5787543073103856,0.2310314253120572
13359,0.42025,0,1,0,327219,278391,24315,83641,2.5787450442772983,0.23103206346400318
13360,0.4202777777777777,0,1,0,327220,278390,24315,83641,2.5787357812442107,0.23103270161947456
13361,0.4202857142857144,0,1,0,327221,278389,24315,83641,2.578726518211123,0.2310333397784714
13362,0.4203333333333332,0,1,0,327222,278388,24315,83641,2.5787172551780353,0.23103397794099367
13363,0.4203333333333333,2,22,2,327244,278366,24317,83639,2.5785134684501094,0.23104377011367247
13364,0.4203333333333334,0,8,0,327252,278358,24317,83639,2.578439364185409,0.23104887609565825
13365,0.4203452380952381,0,1,0,327253,278357,24317,83639,2.578430101152321,0.23104951435927468
13366,0.4203571428571429,0,5,0,327258,278352,24317,83639,2.5783837859868837,0.23105270573025297
13367,0.4203809523809523,0,2,0,327260,278350,24317,83639,2.5783652599207083,0.23105398230332966
13368,0.4204126984126983,0,2,0,327262,278348,24317,83639,2.5783467338545334,0.23105525889051265
13369,0.4204166666666666,1,0,1,327262,278348,24318,83638,2.5783467338545334,0.23105313465161637
13370,0.4204166666666667,0,1,0,327263,278347,24318,83638,2.5783374708214457,0.23105377294639282
13371,0.4204523809523809,0,2,0,327265,278345,24318,83638,2.578318944755271,0.23105504954652567
13372,0.4204761904761904,0,1,0,327266,278344,24318,83638,2.578309681722183,0.23105568785188213
13373,0.4204761904761905,2,9,2,327275,278335,24320,83636,2.5782263144243953,0.23105718413906087
13374,0.4204999999999999,0,1,0,327276,278334,24320,83636,2.5782170513913076,0.23105782247147555
13375,0.4205,0,28,0,327304,278306,24320,83636,2.577957686464856,0.23107569721115537
13376,0.4205238095238096,0,1,0,327305,278305,24320,83636,2.5779484234317684,0.23107633564586494
13377,0.4205555555555555,0,1,0,327306,278304,24320,83636,2.5779391603986808,0.23107697408410233
13378,0.4205555555555556,1,0,1,327306,278304,24321,83635,2.5779391603986808,0.23107484962935743
13379,0.4206190476190475,0,2,0,327308,278302,24321,83635,2.577920634332506,0.23107612650820447
13380,0.4206428571428571,0,2,0,327310,278300,24321,83635,2.577902108266331,0.2310774034011632
13381,0.4206666666666666,5,39,5,327349,278261,24326,83630,2.5775408499759163,0.23109168230212965
13382,0.4206666666666667,1,12,1,327361,278249,24327,83629,2.5774296935788654,0.23109722061026092
13383,0.4206818181818181,0,1,0,327362,278248,24327,83629,2.5774204305457777,0.2310978592173584
13384,0.4207142857142856,0,1,0,327363,278247,24327,83629,2.5774111675126905,0.23109849782798528
13385,0.4207142857142857,1,11,1,327374,278236,24328,83628,2.5773092741487273,0.23110339796166515
13386,0.4207222222222222,0,1,0,327375,278235,24328,83628,2.5773000111156397,0.23110403661054046
13387,0.4207499999999999,0,1,0,327376,278234,24328,83628,2.577290748082552,0.23110467526294554
13388,0.42075,0,2,0,327378,278232,24328,83628,2.577272222016377,0.2311059525783452
13389,0.4207619047619048,0,1,0,327379,278231,24328,83628,2.5772629589832894,0.23110659124133986
13390,0.4207777777777777,0,2,0,327381,278229,24328,83628,2.5772444329171145,0.2311078685779189
13391,0.4207857142857142,0,1,0,327382,278228,24328,83628,2.577235169884027,0.23110850725150336
13392,0.4208253968253968,0,1,0,327383,278227,24328,83628,2.577225906850939,0.2311091459286178
13393,0.4208333333333333,21,120,21,327503,278107,24349,83607,2.576114342880433,0.23114117783663335
13394,0.4208333333333334,0,2,0,327505,278105,24349,83607,2.5760958168142576,0.23114245587649843
13395,0.4209393939393939,0,1,0,327506,278104,24349,83607,2.57608655378117,0.23114309490173093
13396,0.4209523809523809,1,7,1,327513,278097,24350,83606,2.576021712549557,0.2311454425315798
13397,0.420952380952381,0,2,0,327515,278095,24350,83606,2.576003186483382,0.23114672063389374
13398,0.4209999999999999,0,11,0,327526,278084,24350,83606,2.575901293119419,0.23115375044927977
13399,0.421,13,65,13,327591,278019,24363,83593,2.575299195968728,0.23116766036525335
13400,0.4210000000000001,0,1,0,327592,278018,24363,83593,2.5752899329356405,0.23116829963690264
13401,0.4210021645021645,0,2,0,327594,278016,24363,83593,2.5752714068694655,0.2311695781908083
13402,0.421030303030303,0,1,0,327595,278015,24363,83593,2.575262143836378,0.23117021747306477
13403,0.421047619047619,0,4,0,327599,278011,24363,83593,2.5752250917040276,0.2311727746374487
13404,0.4210555555555555,0,2,0,327601,278009,24363,83593,2.5752065656378527,0.23117405324085596
13405,0.4210714285714286,0,2,0,327603,278007,24363,83593,2.5751880395716773,0.23117533185840708
13406,0.4211111111111111,0,2,0,327605,278005,24363,83593,2.5751695135055024,0.23117661049010227
13407,0.421142857142857,0,1,0,327606,278004,24363,83593,2.5751602504724147,0.23117724981125395
13408,0.4211428571428571,1,1,1,327607,278003,24364,83592,2.575150987439327,0.23117576293919995
13409,0.4211666666666666,2,3,2,327610,278000,24366,83590,2.5751231983400644,0.23117342846870764
13410,0.4211666666666667,3,10,3,327620,277990,24369,83587,2.575030568009189,0.23117344300107584
13411,0.4211904761904762,0,3,0,327623,277987,24369,83587,2.5750027789099263,0.23117536106025321
13412,0.4212142857142857,0,2,0,327625,277985,24369,83587,2.574984252843751,0.2311766397840541
13413,0.4212499999999999,0,2,0,327627,277983,24369,83587,2.574965726777576,0.23117791852200129
13414,0.42125,2,7,2,327634,277976,24371,83585,2.574900885545963,0.23117814144777782
13415,0.4212539682539683,0,2,0,327636,277974,24371,83585,2.5748823594797883,0.2311794202329357
13416,0.4213095238095238,1,2,1,327638,277972,24372,83584,2.574863833413613,0.23117857261392427
13417,0.4213333333333333,4,39,4,327677,277933,24376,83580,2.5745025751231982,0.23119500543548918
13418,0.4213333333333334,1,3,1,327680,277930,24377,83579,2.5744747860239356,0.2311947973632745
13419,0.4213690476190476,0,1,0,327681,277929,24377,83579,2.574465522990848,0.23119543689212962
13420,0.4213809523809524,0,1,0,327682,277928,24377,83579,2.5744562599577607,0.2311960764245229
13421,0.4213888888888888,0,1,0,327683,277927,24377,83579,2.574446996924673,0.23119671596045432
13422,0.4214047619047618,0,1,0,327684,277926,24377,83579,2.5744377338915854,0.23119735549992393
13423,0.4214166666666666,1,1,1,327685,277925,24378,83578,2.5744284708584977,0.23119586836070516
13424,0.4214166666666667,0,1,0,327686,277924,24378,83578,2.5744192078254104,0.23119650790313748
13425,0.4214285714285714,0,3,0,327689,277921,24378,83578,2.574391418726148,0.23119842655166403
13426,0.4214285714285715,0,1,0,327690,277920,24378,83578,2.57438215569306,0.23119906610824956
13427,0.4214523809523809,0,2,0,327692,277918,24378,83578,2.574363629626885,0.23120034523203575
13428,0.4214722222222222,0,1,0,327693,277917,24378,83578,2.5743543665937976,0.2312009847992365
13429,0.4214761904761905,0,1,0,327694,277916,24378,83578,2.57434510356071,0.2312016243699757
13430,0.4214999999999999,1,2,1,327696,277914,24379,83577,2.574326577494535,0.23120077678282447
13431,0.4215,1,27,1,327723,277887,24380,83576,2.5740764756011707,0.23121591974835598
13432,0.421547619047619,0,2,0,327725,277885,24380,83576,2.574057949534996,0.23121719908925167
13433,0.4215476190476191,0,1,0,327726,277884,24380,83576,2.574048686501908,0.23121783876500857
13434,0.4215714285714285,0,2,0,327728,277882,24380,83576,2.574030160435733,0.23121911812714063
13435,0.4215714285714286,0,1,0,327729,277881,24380,83576,2.5740208974026455,0.23121975781351586
13436,0.4215952380952381,0,2,0,327731,277879,24380,83576,2.5740023713364706,0.2312210371968848
13437,0.4216428571428572,0,1,0,327732,277878,24380,83576,2.573993108303383,0.23122167689387862
13438,0.4216666666666666,30,227,30,327959,277651,24410,83546,2.571890399792508,0.2313031392841026
13439,0.4216666666666667,21,215,21,328174,277436,24431,83525,2.569898847678684,0.2313961896160527
13440,0.4217142857142857,0,1,0,328175,277435,24431,83525,2.5698895846455962,0.23139683067375885
13441,0.42175,0,1,0,328176,277434,24431,83525,2.569880321612509,0.23139747173501699
13442,0.4217619047619048,0,1,0,328177,277433,24431,83525,2.5698710585794213,0.23139811279982714
13443,0.4217777777777777,0,1,0,328178,277432,24431,83525,2.5698617955463336,0.23139875386818928
13444,0.4217857142857143,2,4,2,328182,277428,24433,83523,2.5698247434139834,0.2313970594346601
13445,0.4218095238095238,0,1,0,328183,277427,24433,83523,2.569815480380896,0.23139770051253636
13446,0.4218333333333333,0,10,0,328193,277417,24433,83523,2.56972285005002,0.2314041114866737
13447,0.4218333333333334,1,8,1,328201,277409,24434,83522,2.56964874578532,0.23140711105446748
13448,0.4218571428571428,0,2,0,328203,277407,24434,83522,2.5696302197191447,0.2314083933405185
13449,0.4218571428571429,0,1,0,328204,277406,24434,83522,2.5696209566860575,0.23140903448887312
13450,0.4218809523809523,0,1,0,328205,277405,24434,83522,2.56961169365297,0.23140967564078055
13451,0.4218864468864469,0,1,0,328206,277404,24434,83522,2.569602430619882,0.23141031679624077
13452,0.4218888888888888,0,1,0,328207,277403,24434,83522,2.5695931675867945,0.23141095795525385
13453,0.4218888888888889,0,1,0,328208,277402,24434,83522,2.569583904553707,0.2314115991178198
13454,0.4219047619047618,0,1,0,328209,277401,24434,83522,2.5695746415206195,0.23141224028393867
13455,0.4219047619047619,0,3,0,328212,277398,24434,83522,2.569546852421357,0.231414163803613
13456,0.4219404761904761,1,0,1,328212,277398,24435,83521,2.569546852421357,0.2314120342791596
13457,0.4219444444444444,0,1,0,328213,277397,24435,83521,2.5695375893882693,0.2314126754553666
13458,0.4219523809523809,0,1,0,328214,277396,24435,83521,2.5695283263551816,0.23141331663512663
13459,0.421952380952381,0,1,0,328215,277395,24435,83521,2.5695190633220943,0.23141395781843974
13460,0.4219642857142857,0,2,0,328217,277393,24435,83521,2.569500537255919,0.2314152401957253
13461,0.4219682539682539,0,1,0,328218,277392,24435,83521,2.5694912742228317,0.2314158813896978
13462,0.4219999999999999,1,4,1,328222,277388,24436,83520,2.5694542220904815,0.23141631662362708
13463,0.422,12,65,12,328287,277323,24448,83508,2.56885212493979,0.23143244344305228
13464,0.4220238095238094,1,1,1,328288,277322,24449,83507,2.5688428619067025,0.23143095482901874
13465,0.4220238095238096,0,1,0,328289,277321,24449,83507,2.5688335988736153,0.23143159621758844
13466,0.4220317460317461,0,1,0,328290,277320,24449,83507,2.5688243358405276,0.23143223760971324
13467,0.422047619047619,0,2,0,328292,277318,24449,83507,2.5688058097743527,0.23143352040462828
13468,0.4220476190476191,0,3,0,328295,277315,24449,83507,2.5687780206750896,0.23143544462366486
13469,0.4220555555555556,0,1,0,328296,277314,24449,83507,2.5687687576420024,0.2314360860371209
13470,0.4220833333333333,0,3,0,328299,277311,24449,83507,2.56874096854274,0.23143801029882102
13471,0.4220952380952381,0,1,0,328300,277310,24449,83507,2.568731705509652,0.23143865172649847
13472,0.4221428571428571,1,10,1,328310,277300,24450,83506,2.5686390751787767,0.2314429360930805
13473,0.4221666666666666,1,7,1,328317,277293,24451,83505,2.5685742339471638,0.2314452962599571
13474,0.4221666666666667,2,7,2,328324,277286,24453,83503,2.568509392715551,0.23144552633256557
13475,0.4222142857142857,0,1,0,328325,277285,24453,83503,2.568500129682463,0.23144616783263303
13476,0.4222222222222222,3,2,3,328327,277283,24456,83500,2.5684816036162883,0.2314410601386429
13477,0.4222323232323232,0,1,0,328328,277282,24456,83500,2.5684723405832006,0.23144170163699962
13478,0.4222380952380952,0,1,0,328329,277281,24456,83500,2.568463077550113,0.23144234313891252
13479,0.42225,0,1,0,328330,277280,24456,83500,2.5684538145170253,0.23144298464438162
13480,0.4222857142857142,0,1,0,328331,277279,24456,83500,2.568444551483938,0.23144362615340694
13481,0.4223095238095238,1,2,1,328333,277277,24457,83499,2.5684260254177627,0.2314427788988181
13482,0.4223333333333333,5,46,5,328379,277231,24462,83494,2.567999925895735,0.23146163975327466
13483,0.4223333333333334,0,3,0,328382,277228,24462,83494,2.5679721367964725,0.23146356473960558
13484,0.4223809523809523,1,3,1,328385,277225,24463,83493,2.56794434769721,0.2314633591891727
13485,0.4223809523809524,0,8,0,328393,277217,24463,83493,2.5678702434325094,0.23146849269496272
13486,0.4224001554001554,0,1,0,328394,277216,24463,83493,2.567860980399422,0.23146913439919714
13487,0.4224458874458874,1,0,1,328394,277216,24464,83492,2.567860980399422,0.23146700378145205
13488,0.4224761904761905,0,1,0,328395,277215,24464,83492,2.5678517173663344,0.23146764548511672
13489,0.4224999999999999,0,11,0,328406,277204,24464,83492,2.5677498240023713,0.23147470446026572
13490,0.4225,39,373,39,328779,276831,24503,83453,2.5642947126607134,0.2316311576423044
13491,0.4225000000000001,0,8,0,328787,276823,24503,83453,2.5642206083960133,0.2316363010580777
13492,0.4225238095238094,0,1,0,328788,276822,24503,83453,2.5642113453629256,0.23163694400111026
13493,0.4225714285714285,1,0,1,328788,276822,24504,83452,2.5642113453629256,0.23163481128252386
13494,0.4225833333333332,2,2,2,328790,276820,24506,83450,2.5641928192967507,0.23163183168179421
13495,0.4226190476190476,0,1,0,328791,276819,24506,83450,2.564183556263663,0.23163247462312883
13496,0.4226666666666666,3,65,3,328856,276754,24509,83447,2.5635814591129717,0.2316678743257237
13497,0.4226666666666667,2,11,2,328867,276743,24511,83445,2.563479565749009,0.23167068308772085
13498,0.4227063492063492,0,1,0,328868,276742,24511,83445,2.5634703027159214,0.23167132628329173
13499,0.4227142857142857,0,2,0,328870,276740,24511,83445,2.563451776649746,0.2316726126851479
13500,0.4227380952380952,0,2,0,328872,276738,24511,83445,2.563433250583571,0.2316738991012902
13501,0.4227857142857143,1,0,1,328872,276738,24512,83444,2.563433250583571,0.23167176594055228
13502,0.4228095238095238,0,2,0,328874,276736,24512,83444,2.563414724517396,0.23167305236270755
13503,0.4228174603174602,0,1,0,328875,276735,24512,83444,2.5634054614843085,0.23167369557914258
13504,0.4228225108225107,0,4,0,328879,276731,24512,83444,2.563368409351958,0.23167626848059972
13505,0.4228333333333333,1,12,1,328891,276719,24513,83443,2.5632572529549074,0.2316818542766866
13506,0.4228333333333334,1,3,1,328894,276716,24514,83442,2.5632294638556448,0.23168165083102416
13507,0.4228571428571427,1,2,1,328896,276714,24515,83441,2.56321093778947,0.2316808040982355
13508,0.4228571428571428,0,19,0,328915,276695,24515,83441,2.563034940160806,0.23169302707865919
13509,0.4228571428571429,1,2,1,328917,276693,24516,83440,2.563016414094631,0.23169218038891187
13510,0.4228690476190477,1,0,1,328917,276693,24517,83439,2.563016414094631,0.23169004698277298
13511,0.4229047619047618,0,1,0,328918,276692,24517,83439,2.5630071510615435,0.23169069033212913
13512,0.4229166666666666,0,1,0,328919,276691,24517,83439,2.562997888028456,0.23169133368505818
13513,0.4229444444444444,0,1,0,328920,276690,24517,83439,2.5629886249953686,0.2316919770415601
13514,0.4229523809523809,1,2,1,328922,276688,24518,83438,2.5629700989291933,0.2316911303266079
13515,0.422974025974026,0,2,0,328924,276686,24518,83438,2.5629515728630183,0.23169241705634727
13516,0.4229761904761905,0,1,0,328925,276685,24518,83438,2.5629423098299307,0.23169306042657647
13517,0.423,8,56,8,328981,276629,24526,83430,2.5624235799770276,0.23171202497368487
13518,0.4230238095238095,0,1,0,328982,276628,24526,83430,2.56241431694394,0.2317126685145171
13519,0.423047619047619,0,3,0,328985,276625,24526,83430,2.5623865278446774,0.2317145991584619
13520,0.4230555555555556,0,1,0,328986,276624,24526,83430,2.56237726481159,0.23171524271359295
13521,0.4230714285714285,1,1,1,328987,276623,24527,83429,2.5623680017785024,0.2317137524579783
13522,0.4230833333333333,1,2,1,328989,276621,24528,83428,2.562349475712327,0.23171290574338493
13523,0.4230952380952381,0,1,0,328990,276620,24528,83428,2.56234021267924,0.23171354930453716
13524,0.4230952380952382,0,1,0,328991,276619,24528,83428,2.562330949646152,0.23171419286926428
13525,0.4231190476190475,0,2,0,328993,276617,24528,83428,2.5623124235799772,0.23171548000944325
13526,0.4231190476190477,0,1,0,328994,276616,24528,83428,2.5623031605468896,0.23171612358489518
13527,0.4231428571428571,0,1,0,328995,276615,24528,83428,2.562293897513802,0.2317167671639221
13528,0.4231457431457431,0,1,0,328996,276614,24528,83428,2.562284634480714,0.23171741074652402
13529,0.4231666666666666,1,11,1,329007,276603,24529,83427,2.5621827411167515,0.23172235647029416
13530,0.4231666666666667,0,4,0,329011,276599,24529,83427,2.562145688984401,0.2317249309772072
13531,0.4232142857142857,1,5,1,329016,276594,24530,83426,2.5620993738189632,0.2317260152213766
13532,0.4232222222222221,1,1,1,329017,276593,24531,83425,2.5620901107858756,0.23172452488486686
13533,0.4232467532467532,0,1,0,329018,276592,24531,83425,2.5620808477527883,0.23172516853370814
13534,0.423297619047619,0,1,0,329019,276591,24531,83425,2.5620715847197006,0.23172581218612506
13535,0.4233333333333333,90,679,90,329698,275912,24621,83335,2.5557819852532515,0.23197131778414296
13536,0.4233333333333334,0,1,0,329699,275911,24621,83335,2.555772722220164,0.23197196350133334
13537,0.4233412698412699,0,2,0,329701,275909,24621,83335,2.5557541961539885,0.23197325494649876
13538,0.4234166666666666,0,4,0,329705,275905,24621,83335,2.5557171440216386,0.2319758378799688
13539,0.4234523809523809,0,2,0,329707,275903,24621,83335,2.5556986179554633,0.23197712936827397
13540,0.423452380952381,1,0,1,329707,275903,24622,83334,2.5556986179554633,0.2319749914401913
13541,0.4234761904761905,0,1,0,329708,275902,24622,83334,2.5556893549223756,0.23197563718558273
13542,0.4234905372405373,0,1,0,329709,275901,24622,83334,2.5556800918892884,0.2319762829345693
13543,0.4234999999999999,0,3,0,329712,275898,24622,83334,2.5556523027900258,0.23197822020309994
13544,0.4235,2,29,2,329741,275869,24624,83332,2.5553836748304866,0.2319926726261898
13545,0.4235000000000001,0,2,0,329743,275867,24624,83332,2.555365148764311,0.2319939643484531
13546,0.4235238095238094,0,1,0,329744,275866,24624,83332,2.555355885731224,0.2319946102149789
13547,0.4235238095238095,0,1,0,329745,275865,24624,83332,2.5553466226981363,0.23199525608510094
13548,0.423547619047619,0,2,0,329747,275863,24624,83332,2.5553280966319614,0.23199654783613358
13549,0.4235714285714285,0,4,0,329751,275859,24624,83332,2.555291044499611,0.23199913138135422
13550,0.4235714285714286,0,4,0,329755,275855,24624,83332,2.555253992367261,0.2320017149841169
13551,0.4235833333333332,0,1,0,329756,275854,24624,83332,2.555244729334173,0.23200236089379875
13552,0.4235873015873017,0,1,0,329757,275853,24624,83332,2.5552354663010854,0.23200300680707714
13553,0.4235952380952381,0,2,0,329759,275851,24624,83332,2.5552169402349105,0.2320042986444236
13554,0.4236428571428572,0,1,0,329760,275850,24624,83332,2.555207677201823,0.23200494456849174
13555,0.4236666666666666,0,3,0,329763,275847,24624,83332,2.5551798881025602,0.23200688236227618
13556,0.4236666666666667,5,29,5,329792,275818,24629,83327,2.554911260143021,0.23201492433418258
13557,0.4236904761904761,0,2,0,329794,275816,24629,83327,2.554892734076846,0.2320162163817755
13558,0.4236904761904762,0,1,0,329795,275815,24629,83327,2.5548834710437585,0.23201686241096836
13559,0.4237142857142856,1,3,1,329798,275812,24630,83326,2.554855681944496,0.23201666211873986
13560,0.4237142857142857,0,3,0,329801,275809,24630,83326,2.5548278928452333,0.23201860024781767
13561,0.42375,0,7,0,329808,275802,24630,83326,2.5547630516136204,0.2320231226749237
13562,0.4237777777777777,0,2,0,329810,275800,24630,83326,2.5547445255474455,0.23202441482933567
13563,0.423797619047619,1,1,1,329811,275799,24631,83325,2.554735262514358,0.23202292244461523
13564,0.4237976190476191,0,1,0,329812,275798,24631,83325,2.55472599948127,0.23202356852666078
13565,0.4238095238095238,0,4,0,329816,275794,24631,83325,2.55468894734892,0.23202615289082448
13566,0.4238333333333333,0,10,0,329826,275784,24631,83325,2.5545963170180443,0.2320326140531148
13567,0.4238333333333334,0,4,0,329830,275780,24631,83325,2.554559264885694,0.23203519861878838
13568,0.4238452380952381,0,1,0,329831,275779,24631,83325,2.554550001852607,0.23203584476920336
13569,0.4238571428571427,0,6,0,329837,275773,24631,83325,2.554494423654081,0.23203972174726675
13570,0.4238571428571429,1,0,1,329837,275773,24632,83324,2.554494423654081,0.23203758315998185
13571,0.4238611111111111,0,1,0,329838,275772,24632,83324,2.554485160620994,0.23203822933143226
13572,0.4238690476190476,0,1,0,329839,275771,24632,83324,2.5544758975879063,0.23203887550648158
13573,0.4238809523809523,0,1,0,329840,275770,24632,83324,2.5544666345548186,0.2320395216851298
13574,0.4238888888888888,0,3,0,329843,275767,24632,83324,2.554438845455556,0.23204146024266828
13575,0.4239047619047618,0,1,0,329844,275766,24632,83324,2.5544295824224683,0.2320421064357125
13576,0.423904761904762,0,1,0,329845,275765,24632,83324,2.554420319389381,0.23204275263235577
13577,0.4239166666666666,0,1,0,329846,275764,24632,83324,2.5544110563562934,0.23204339883259814
13578,0.4239166666666667,0,1,0,329847,275763,24632,83324,2.5544017933232057,0.23204404503643963
13579,0.4239285714285713,0,1,0,329848,275762,24632,83324,2.554392530290118,0.2320446912438803
13580,0.423968253968254,0,1,0,329849,275761,24632,83324,2.554383267257031,0.23204533745492015
13581,0.4239761904761905,0,1,0,329850,275760,24632,83324,2.554374004223943,0.23204598366955922
13582,0.4239999999999999,0,9,0,329859,275751,24632,83324,2.554290636926155,0.23205179976328066
13583,0.424,15,133,15,329992,275618,24647,83309,2.55305865352551,0.2321056928010431
13584,0.4240000000000001,0,1,0,329993,275617,24647,83309,2.553049390492423,0.23210633946830267
13585,0.4240238095238094,0,1,0,329994,275616,24647,83309,2.5530401274593353,0.23210698613916556
13586,0.4240357142857142,0,1,0,329995,275615,24647,83309,2.5530308644262476,0.23210763281363186
13587,0.424047619047619,2,2,2,329997,275613,24649,83307,2.5530123383600727,0.2321046472751588
13588,0.4241071428571428,0,2,0,329999,275611,24649,83307,2.5529938122938973,0.23210594063267934
13589,0.4241111111111111,0,2,0,330001,275609,24649,83307,2.5529752862277224,0.2321072340046139
13590,0.424142857142857,0,1,0,330002,275608,24649,83307,2.5529660231946347,0.2321078806959865
13591,0.4241428571428571,0,1,0,330003,275607,24649,83307,2.5529567601615475,0.23210852739096274
13592,0.4241666666666666,9,86,9,330089,275521,24658,83298,2.5521601393160176,0.23214489756673978
13593,0.4241666666666667,9,59,9,330148,275462,24667,83289,2.551613620363852,0.2321638127837971
13594,0.4241904761904762,0,1,0,330149,275461,24667,83289,2.5516043573307643,0.2321644599303136
13595,0.4242142857142857,0,1,0,330150,275460,24667,83289,2.5515950942976766,0.23216510708043786
13596,0.4242499999999999,1,2,1,330152,275458,24668,83288,2.5515765682315017,0.23216426106493174
13597,0.4242619047619048,0,1,0,330153,275457,24668,83288,2.551567305198414,0.23216490822171737
13598,0.4242857142857143,0,24,0,330177,275433,24668,83288,2.551344992404313,0.23218044106701308
13599,0.4242857142857144,0,1,0,330178,275432,24668,83288,2.551335729371225,0.23218108831400536
13600,0.4243095238095238,0,2,0,330180,275430,24668,83288,2.55131720330505,0.2321823828188159
13601,0.4243333333333333,0,12,0,330192,275418,24668,83288,2.5512060469079993,0.2321901501508199
13602,0.4243333333333334,5,30,5,330222,275388,24673,83283,2.550928155915373,0.23219886748580176
13603,0.4243809523809523,0,1,0,330223,275387,24673,83283,2.5509188928822852,0.23219951487439708
13604,0.4243809523809524,0,1,0,330224,275386,24673,83283,2.550909629849198,0.23220016226660237
13605,0.4243888888888889,0,1,0,330225,275385,24673,83283,2.5509003668161103,0.2322008096624176
13606,0.4244285714285714,0,1,0,330226,275384,24673,83283,2.5508911037830226,0.2322014570618429
13607,0.4244285714285715,1,0,1,330226,275384,24674,83282,2.5508911037830226,0.23219931635560662
13608,0.4244404761904762,0,1,0,330227,275383,24674,83282,2.550881840749935,0.2321999637544784
13609,0.4244444444444444,0,2,0,330229,275381,24674,83282,2.55086331468376,0.23220125856305224
13610,0.4244523809523808,0,1,0,330230,275380,24674,83282,2.5508540516506724,0.23220190597275428
13611,0.4244642857142857,0,1,0,330231,275379,24674,83282,2.550844788617585,0.23220255338606652
13612,0.4244761904761904,0,1,0,330232,275378,24674,83282,2.5508355255844974,0.2322032008029889
13613,0.4244999999999999,0,5,0,330237,275373,24674,83282,2.5507892104190595,0.2322064379417546
13614,0.4245,0,17,0,330254,275356,24674,83282,2.550631738856571,0.23221744488871787
13615,0.4245238095238094,1,4,1,330258,275352,24675,83281,2.550594686724221,0.23221789405882895
13616,0.424547619047619,0,2,0,330260,275350,24675,83281,2.550576160658046,0.23221918908292924
13617,0.4245555555555556,1,2,1,330262,275348,24676,83280,2.5505576345918706,0.2322183432414647
13618,0.4245714285714285,0,2,0,330264,275346,24676,83280,2.5505391085256957,0.23221963828612538
13619,0.4245833333333333,0,4,0,330268,275342,24676,83280,2.5505020563933454,0.2322222284187808
13620,0.4246428571428571,0,4,0,330272,275338,24676,83280,2.550465004260995,0.23222481860921648
13621,0.4246666666666666,0,8,0,330280,275330,24676,83280,2.550390899996295,0.2322299991634366
13622,0.4246666666666667,5,26,5,330306,275304,24681,83275,2.5501500611360184,0.23223613206573726
13623,0.4247063492063493,0,1,0,330307,275303,24681,83275,2.5501407981029307,0.23223677972435566
13624,0.4247142857142856,0,1,0,330308,275302,24681,83275,2.5501315350698435,0.23223742738658643
13625,0.4247222222222221,0,1,0,330309,275301,24681,83275,2.550122272036756,0.2322380750524296
13626,0.4247222222222222,0,1,0,330310,275300,24681,83275,2.550113009003668,0.23223872272188523
13627,0.4247619047619047,1,3,1,330313,275297,24682,83274,2.5500852199044055,0.232238524587878
13628,0.4247619047619048,0,1,0,330314,275296,24682,83274,2.550075956871318,0.2322391722676186
13629,0.4248214285714287,0,2,0,330316,275294,24682,83274,2.550057430805143,0.23224046763793757
13630,0.4248333333333333,4,18,4,330334,275276,24686,83270,2.549890696209567,0.2322435614955961
13631,0.4248809523809523,1,2,1,330336,275274,24687,83269,2.549872170143392,0.2322427156575362
13632,0.4248809523809524,0,2,0,330338,275272,24687,83269,2.5498536440772166,0.2322440111451689
13633,0.424892857142857,0,4,0,330342,275268,24687,83269,2.5498165919448663,0.23224660216379342
13634,0.4249285714285715,0,1,0,330343,275267,24687,83269,2.549807328911779,0.23224724992748288
13635,0.4249523809523809,0,3,0,330346,275264,24687,83269,2.549779539812516,0.23224919324023172
13636,0.4249880952380951,0,2,0,330348,275262,24687,83269,2.549761013746341,0.23225048880013166
13637,0.4249999999999999,2,23,2,330371,275239,24689,83267,2.5495479639853276,0.23226110581133927
13638,0.425,180,1345,180,331716,273894,24869,83087,2.537089184482567,0.23274908188390978
13639,0.425047619047619,1,1,1,331717,273893,24870,83086,2.5370799214494792,0.23274758459181072
13640,0.4250833333333333,0,2,0,331719,273891,24870,83086,2.5370613953833043,0.23274888858385834
13641,0.4250952380952381,0,1,0,331720,273890,24870,83086,2.5370521323502166,0.2327495405853615
13642,0.4251190476190476,0,3,0,331723,273887,24870,83086,2.537024343250954,0.23275149661178857
13643,0.4251251803751804,0,3,0,331726,273884,24870,83086,2.5369965541516915,0.23275345267109282
13644,0.4251298701298701,0,1,0,331727,273883,24870,83086,2.5369872911186038,0.23275410469816707
13645,0.4251428571428571,1,0,1,331727,273883,24871,83085,2.5369872911186038,0.23275195535734294
13646,0.4251666666666666,6,12,6,331739,273871,24877,83079,2.5368761347215534,0.23274688331699117
13647,0.4251666666666667,1,2,1,331741,273869,24878,83078,2.536857608655378,0.23274603792719928
13648,0.4252142857142856,0,1,0,331742,273868,24878,83078,2.536848345622291,0.2327466899755145
13649,0.4252142857142857,1,0,1,331742,273868,24879,83077,2.536848345622291,0.2327445404754234
13650,0.4252380952380952,0,5,0,331747,273863,24879,83077,2.536802030456853,0.23274780075082646
13651,0.4252499999999999,0,4,0,331751,273859,24879,83077,2.5367649783245025,0.23275040903691419
13652,0.4252857142857142,0,1,0,331752,273858,24879,83077,2.536755715291415,0.23275106111757043
13653,0.4252857142857143,0,1,0,331753,273857,24879,83077,2.5367464522583276,0.23275171320188046
13654,0.4253333333333332,0,4,0,331757,273853,24879,83077,2.5367094001259773,0.2327543215756591
13655,0.4253333333333333,5,32,5,331789,273821,24884,83072,2.5364129830671756,0.23276444200362573
13656,0.4253333333333334,0,21,0,331810,273800,24884,83072,2.536218459372337,0.23277813894057253
13657,0.4253571428571428,1,6,1,331816,273794,24885,83071,2.5361628811738117,0.23277990276435068
13658,0.4253571428571429,0,2,0,331818,273792,24885,83071,2.5361443551076364,0.23278120735408267
13659,0.4253888888888887,0,1,0,331819,273791,24885,83071,2.5361350920745487,0.23278185965443224
13660,0.4254166666666667,2,2,2,331821,273789,24887,83069,2.5361165660083738,0.2327788644222632
13661,0.4254206349206349,0,1,0,331822,273788,24887,83069,2.536107302975286,0.23277951672518685
13662,0.4254285714285714,1,0,1,331822,273788,24888,83068,2.536107302975286,0.2327773667809985
13663,0.4254523809523809,0,2,0,331824,273786,24888,83068,2.536088776909111,0.23277867138941977
13664,0.425452380952381,1,2,1,331826,273784,24889,83067,2.536070250842936,0.23277782603943942
13665,0.4254761904761904,0,2,0,331828,273782,24889,83067,2.536051724776761,0.23277913066871422
13666,0.4254761904761905,0,4,0,331832,273778,24889,83067,2.5360146726444106,0.23278173997113594
13667,0.4255,3,27,3,331859,273751,24892,83064,2.5357645707510468,0.23279290388576712
13668,0.4255555555555555,1,0,1,331859,273751,24893,83063,2.5357645707510468,0.23279075372603092
13669,0.4255555555555556,0,2,0,331861,273749,24893,83063,2.5357460446848714,0.23279205856305282
13670,0.4255714285714285,0,1,0,331862,273748,24893,83063,2.535736781651784,0.23279271098704918
13671,0.4255833333333333,2,2,2,331864,273746,24895,83061,2.535718255585609,0.23278971544840768
13672,0.4256190476190475,1,0,1,331864,273746,24896,83060,2.535718255585609,0.23278756523152638
13673,0.4256468253968254,0,1,0,331865,273745,24896,83060,2.5357089925525216,0.2327882176539006
13674,0.4256551226551227,0,1,0,331866,273744,24896,83060,2.535699729519434,0.23278887007993185
13675,0.4256666666666666,1,29,1,331895,273715,24897,83059,2.5354311015598947,0.2328056416667134
13676,0.4256666666666667,1,15,1,331910,273700,24898,83058,2.5352921560635813,0.23281327959008627
13677,0.4257142857142857,3,18,3,331928,273682,24901,83055,2.5351254214680057,0.23281857502866257
13678,0.42575,0,1,0,331929,273681,24901,83055,2.535116158434918,0.232819227664155
13679,0.4257619047619048,0,2,0,331931,273679,24901,83055,2.5350976323687426,0.2328205329461167
13680,0.4257857142857142,0,2,0,331933,273677,24901,83055,2.5350791063025677,0.2328218382427144
13681,0.4257857142857144,0,1,0,331934,273676,24901,83055,2.53506984326948,0.23282249089650184
13682,0.4258333333333333,24,157,24,332091,273519,24925,83031,2.533615547074734,0.2328733697938578
13683,0.4258571428571429,0,1,0,332092,273518,24925,83031,2.5336062840416465,0.23287402292532022
13684,0.4258809523809523,1,1,1,332093,273517,24926,83030,2.533597021008559,0.23287252451990903
13685,0.4258809523809524,0,2,0,332095,273515,24926,83030,2.533578494942384,0.23287383079274707
13686,0.4258888888888887,0,1,0,332096,273514,24926,83030,2.533569231909296,0.23287448393466165
13687,0.4259090909090909,1,0,1,332096,273514,24927,83029,2.533569231909296,0.23287233236944774
13688,0.4259166666666666,1,1,1,332097,273513,24928,83028,2.533559968876209,0.23287083392933772
13689,0.4259285714285715,0,1,0,332098,273512,24928,83028,2.5335507058431213,0.23287148707017447
13690,0.4259523809523809,0,5,0,332103,273507,24928,83028,2.5335043906776833,0.2328747528293155
13691,0.425952380952381,0,2,0,332105,273505,24928,83028,2.5334858646115084,0.23287605915861925
13692,0.4259722222222222,0,1,0,332106,273504,24928,83028,2.5334766015784207,0.2328767123287671
13693,0.4259761904761905,0,1,0,332107,273503,24928,83028,2.5334673385453335,0.232877365502579
13694,0.4259999999999999,1,6,1,332113,273497,24929,83027,2.533411760346808,0.23287913296159585
13695,0.426,21,133,21,332246,273364,24950,83006,2.532179776946163,0.23292084069927324
13696,0.4260000000000001,0,2,0,332248,273362,24950,83006,2.5321612508799882,0.23292214789206664
13697,0.4260248917748918,0,2,0,332250,273360,24950,83006,2.532142724813813,0.2329234550995325
13698,0.4260595238095239,0,1,0,332251,273359,24950,83006,2.5321334617807256,0.2329241087087677
13699,0.4260714285714285,0,2,0,332253,273357,24950,83006,2.5321149357145503,0.23292541593824276
13700,0.4260714285714286,0,1,0,332254,273356,24950,83006,2.532105672681463,0.23292606955848266
13701,0.4260833333333334,0,1,0,332255,273355,24950,83006,2.5320964096483753,0.23292672318239088
13702,0.426095238095238,0,1,0,332256,273354,24950,83006,2.5320871466152877,0.23292737680996745
13703,0.4261031746031745,0,2,0,332258,273352,24950,83006,2.5320686205491127,0.23292868407612569
13704,0.426111111111111,1,0,1,332258,273352,24951,83005,2.5320686205491127,0.23292653154000062
13705,0.426142857142857,1,0,1,332258,273352,24952,83004,2.5320686205491127,0.23292437899179472
13706,0.4261428571428571,0,1,0,332259,273351,24952,83004,2.532059357516025,0.23292503262196404
13707,0.4261666666666666,0,1,0,332260,273350,24952,83004,2.5320500944829374,0.23292568625580182
13708,0.4261666666666667,1,9,1,332269,273341,24953,83003,2.5319667271851496,0.23292941651886942
13709,0.4261904761904761,0,1,0,332270,273340,24953,83003,2.531957464152062,0.23293007018518674
13710,0.4261904761904762,0,1,0,332271,273339,24953,83003,2.5319482011189742,0.23293072385517283
13711,0.4262142857142857,0,1,0,332272,273338,24953,83003,2.531938938085887,0.23293137752882773
13712,0.4262489177489177,0,1,0,332273,273337,24953,83003,2.5319296750527993,0.23293203120615144
13713,0.42625,1,8,1,332281,273329,24954,83002,2.5318555707880988,0.23293510808770498
13714,0.4262619047619047,0,1,0,332282,273328,24954,83002,2.5318463077550115,0.2329357617938428
13715,0.4262857142857142,0,1,0,332283,273327,24954,83002,2.531837044721924,0.2329364155036497
13716,0.4263095238095238,0,4,0,332287,273323,24954,83002,2.5317999925895736,0.2329390303795692
13717,0.426330808080808,0,1,0,332288,273322,24954,83002,2.531790729556486,0.23293968410772217
13718,0.4263333333333332,1,1,1,332289,273321,24955,83001,2.5317814665233986,0.23293818512469058
13719,0.4263333333333333,0,17,0,332306,273304,24955,83001,2.53162399496091,0.2329492990555844
13720,0.4263333333333334,0,3,0,332309,273301,24955,83001,2.5315962058616472,0.2329512604475978
13721,0.426345238095238,0,1,0,332310,273300,24955,83001,2.53158694282856,0.23295191425227546
13722,0.4263571428571427,0,2,0,332312,273298,24955,83001,2.5315684167623846,0.23295322187264067
13723,0.4263571428571429,0,1,0,332313,273297,24955,83001,2.531559153729297,0.23295387568832832
13724,0.4263809523809524,0,1,0,332314,273296,24955,83001,2.5315498906962097,0.232954529507686
13725,0.4264166666666666,0,1,0,332315,273295,24955,83001,2.531540627663122,0.2329551833307138
13726,0.4264166666666667,0,1,0,332316,273294,24955,83001,2.5315313646300344,0.2329558371574117
13727,0.4264285714285714,1,7,1,332323,273287,24956,83000,2.5314665233984215,0.23295826117708476
13728,0.4264285714285715,0,1,0,332324,273286,24956,83000,2.531457260365334,0.23295891502893742
13729,0.4264523809523809,0,2,0,332326,273284,24956,83000,2.531438734299159,0.23296022274365394
13730,0.4264761904761905,1,0,1,332326,273284,24957,82999,2.531438734299159,0.23295806984896839
13731,0.4264999999999999,1,0,1,332326,273284,24958,82998,2.531438734299159,0.23295591694219747
13732,0.4265,3,32,3,332358,273252,24961,82995,2.531142317240357,0.23297038290848765
13733,0.4265226995226995,0,1,0,332359,273251,24961,82995,2.5311330542072694,0.23297103686778237
13734,0.426547619047619,0,1,0,332360,273250,24961,82995,2.531123791174182,0.2329716908307485
13735,0.4265833333333333,0,1,0,332361,273249,24961,82995,2.5311145281410945,0.23297234479738607
13736,0.4266071428571428,1,0,1,332361,273249,24962,82994,2.5311145281410945,0.23297019169499472
13737,0.4266190476190477,1,1,1,332362,273248,24963,82993,2.531105265108007,0.2329686925424081
13738,0.4266666666666666,55,413,55,332775,272835,25018,82938,2.527279632442847,0.23312055720923172
13739,0.4266666666666667,53,338,53,333113,272497,25071,82885,2.524148727259254,0.23322790687204192
13740,0.4266789044289044,1,6,1,333119,272491,25072,82884,2.5240931490607283,0.2332296869504045
13741,0.4267142857142857,0,2,0,333121,272489,25072,82884,2.5240746229945534,0.233230999541327
13742,0.4267261904761904,0,1,0,333122,272488,25072,82884,2.5240653599614657,0.2332316558423286
13743,0.4267539682539683,0,3,0,333125,272485,25072,82884,2.524037570862203,0.2332336247674952
13744,0.4267582417582417,0,1,0,333126,272484,25072,82884,2.5240283078291155,0.23323428108327143
13745,0.4267619047619047,0,1,0,333127,272483,25072,82884,2.5240190447960282,0.2332349374027414
13746,0.4267857142857143,1,3,1,333130,272480,25073,82883,2.523991255696765,0.23323474869358937
13747,0.4268030303030303,0,1,0,333131,272479,25073,82883,2.523981992663678,0.23323540502360973
13748,0.4268095238095237,1,0,1,333131,272479,25074,82882,2.523981992663678,0.23323324731751655
13749,0.4268333333333333,1,5,1,333136,272474,25075,82881,2.52393567749824,0.23323437126254026
13750,0.4268333333333334,3,25,3,333161,272449,25078,82878,2.523704101671051,0.23324430735632248
13751,0.4268571428571428,0,2,0,333163,272447,25078,82878,2.523685575604876,0.23324562020685288
13752,0.426861111111111,0,1,0,333164,272446,25078,82878,2.5236763125717885,0.2332462766376603
13753,0.4268650793650794,1,0,1,333164,272446,25079,82877,2.5236763125717885,0.23324411873140777
13754,0.4268809523809523,0,1,0,333165,272445,25079,82877,2.523667049538701,0.23324477516168432
13755,0.4269047619047619,0,1,0,333166,272444,25079,82877,2.5236577865056136,0.23324543159565575
13756,0.426924603174603,0,1,0,333167,272443,25079,82877,2.523648523472526,0.23324608803332209
13757,0.4269444444444444,0,2,0,333169,272441,25079,82877,2.5236299974063505,0.2332474009197395
13758,0.4269523809523809,0,3,0,333172,272438,25079,82877,2.523602208307088,0.2332493702770781
13759,0.4269761904761904,0,1,0,333173,272437,25079,82877,2.5235929452740007,0.2332500267369144
13760,0.4269999999999999,1,4,1,333177,272433,25080,82876,2.5235558931416504,0.23325049463987685
13761,0.427,7,46,7,333223,272387,25087,82869,2.523129793619623,0.23326558875852907
13762,0.4270000000000001,0,1,0,333224,272386,25087,82869,2.523120530586535,0.23326624537304189
13763,0.4270119047619047,0,1,0,333225,272385,25087,82869,2.5231112675534475,0.23326690199125133
13764,0.4270238095238094,1,2,1,333227,272383,25088,82868,2.5230927414872726,0.23326605695691216
13765,0.4270454545454544,0,1,0,333228,272382,25088,82868,2.523083478454185,0.23326671358198453
13766,0.427047619047619,0,2,0,333230,272380,25088,82868,2.52306495238801,0.23326802684321937
13767,0.4270833333333333,0,4,0,333234,272376,25088,82868,2.5230279002556597,0.23327065341005054
13768,0.4270833333333334,0,2,0,333236,272374,25088,82868,2.523009374189485,0.23327196671564737
13769,0.4271060606060606,0,1,0,333237,272373,25088,82868,2.523000111156397,0.23327262337399118
13770,0.4271428571428571,0,12,0,333249,272361,25088,82868,2.5228889547593463,0.23328050356249067
13771,0.4271428571428572,0,1,0,333250,272360,25088,82868,2.522879691726259,0.23328116026889772
13772,0.4271666666666666,0,5,0,333255,272355,25088,82868,2.522833376560821,0.23328444385639444
13773,0.4271666666666667,1,8,1,333263,272347,25089,82867,2.5227592722961205,0.23328753934248087
13774,0.4271825396825396,0,2,0,333265,272345,25089,82867,2.5227407462299456,0.23328885285407025
13775,0.4271904761904761,0,1,0,333266,272344,25089,82867,2.522731483196858,0.23328950961541167
13776,0.4272142857142856,0,1,0,333267,272343,25089,82867,2.5227222201637702,0.233290166380451
13777,0.4272164502164502,0,1,0,333268,272342,25089,82867,2.522712957130683,0.23329082314918823
13778,0.4272222222222222,0,4,0,333272,272338,25089,82867,2.5226759049983327,0.2332934502611168
13779,0.4272380952380952,0,1,0,333273,272337,25089,82867,2.522666641965245,0.23329410704834405
13780,0.4272619047619048,1,1,1,333274,272336,25090,82866,2.5226573789321574,0.23329260533442941
13781,0.4272727272727272,0,1,0,333275,272335,25090,82866,2.52264811589907,0.2332932621248251
13782,0.4272857142857142,1,0,1,333275,272335,25091,82865,2.52264811589907,0.2332911036036036
13783,0.4273095238095238,0,1,0,333276,272334,25091,82865,2.5226388528659824,0.23329176039346958
13784,0.4273333333333333,6,60,6,333336,272274,25097,82859,2.522083070880729,0.23331822162401128
13785,0.4273333333333334,1,0,1,333336,272274,25098,82858,2.522083070880729,0.23331606275976258
13786,0.4273809523809524,0,2,0,333338,272272,25098,82858,2.522064544814554,0.23331737673528005
13787,0.4274047619047618,0,1,0,333339,272271,25098,82858,2.5220552817814665,0.23331803372858875
13788,0.4274285714285715,0,3,0,333342,272268,25098,82858,2.522027492682204,0.2333200047307153
13789,0.4274761904761904,0,1,0,333343,272267,25098,82858,2.5220182296491163,0.23332066173882435
13790,0.4274841269841269,0,1,0,333344,272266,25098,82858,2.5220089666160286,0.23332131875063358
13791,0.4274999999999999,0,10,0,333354,272256,25098,82858,2.521916336285153,0.23332788907224158
13792,0.4275,46,360,46,333714,271896,25144,82812,2.5185816443736337,0.23346527284414223
13793,0.4275238095238095,0,2,0,333716,271894,25144,82812,2.5185631183074584,0.23346658923164537
13794,0.4275833333333334,0,2,0,333718,271892,25144,82812,2.5185445922412835,0.23346790563399342
13795,0.4276031746031746,1,1,1,333719,271891,25145,82811,2.518535329208196,0.23346640278318137
13796,0.4276190476190475,1,5,1,333724,271886,25146,82810,2.5184890140427583,0.23346753276044838
13797,0.4276190476190477,0,2,0,333726,271884,25146,82810,2.518470487976583,0.23346884920523042
13798,0.4276428571428571,0,1,0,333727,271883,25146,82810,2.5184612249434957,0.2334695074331887
13799,0.4276666666666666,6,27,6,333754,271856,25152,82804,2.5182111230501314,0.2334743134269441
13800,0.4276666666666667,1,9,1,333763,271847,25153,82803,2.5181277557523436,0.23347807697730155
13801,0.427702380952381,0,1,0,333764,271846,25153,82803,2.518118492719256,0.23347873531294322
13802,0.4277142857142857,0,1,0,333765,271845,25153,82803,2.5181092296861682,0.2334793936522975
13803,0.4277142857142859,0,4,0,333769,271841,25153,82803,2.5180721775538184,0.23348202704684135
13804,0.4277380952380952,0,1,0,333770,271840,25153,82803,2.5180629145207307,0.23348268540475917
13805,0.4277499999999999,0,1,0,333771,271839,25153,82803,2.518053651487643,0.23348334376638977
13806,0.4277777777777777,0,1,0,333772,271838,25153,82803,2.5180443884545554,0.2334840021317332
13807,0.4277777777777778,0,2,0,333774,271836,25153,82803,2.5180258623883804,0.23348531887355875
13808,0.427788961038961,1,0,1,333774,271836,25154,82802,2.5180258623883804,0.2334831574732544
13809,0.4277936507936508,0,1,0,333775,271835,25154,82802,2.5180165993552928,0.23348381584549835
13810,0.4278095238095238,1,1,1,333776,271834,25155,82801,2.5180073363222055,0.233482312800485
13811,0.4278333333333333,0,9,0,333785,271825,25155,82801,2.5179239690244173,0.23348823831303966
13812,0.4278333333333334,3,4,3,333789,271821,25158,82798,2.517886916892067,0.23348438746936853
13813,0.4278571428571427,0,1,0,333790,271820,25158,82798,2.5178776538589798,0.23348504588035576
13814,0.4278571428571428,0,3,0,333793,271817,25158,82798,2.5178498647597167,0.23348702113559777
13815,0.427904761904762,1,0,1,333793,271817,25159,82797,2.5178498647597167,0.23348485959381185
13816,0.4279166666666667,0,2,0,333795,271815,25159,82797,2.517831338693542,0.23348617644072958
13817,0.4279372294372294,0,1,0,333796,271814,25159,82797,2.517822075660454,0.23348683486975869
13818,0.427952380952381,0,1,0,333797,271813,25159,82797,2.517812812627367,0.23348749330250135
13819,0.4279999999999999,0,1,0,333798,271812,25159,82797,2.517803549594279,0.23348815173895757
13820,0.428,10,95,10,333893,271717,25169,82787,2.5169235614509615,0.23352909981269604
13821,0.4280054112554111,0,1,0,333894,271716,25169,82787,2.516914298417874,0.2335297585633972
13822,0.4280079365079365,0,1,0,333895,271715,25169,82787,2.5169050353847866,0.23353041731781485
13823,0.4280238095238095,0,1,0,333896,271714,25169,82787,2.516895772351699,0.233531076075949
13824,0.4280714285714285,0,1,0,333897,271713,25169,82787,2.5168865093186112,0.2335317348377997
13825,0.4280793650793651,0,2,0,333899,271711,25169,82787,2.5168679832524363,0.2335330523726509
13826,0.4280952380952381,0,3,0,333902,271708,25169,82787,2.5168401941531737,0.23353502870280257
13827,0.4281666666666666,4,19,4,333921,271689,25173,82783,2.51666419652451,0.23353889728948973
13828,0.4281666666666667,0,6,0,333927,271683,25173,82783,2.516608618325985,0.23354285037210903
13829,0.4281964489758608,1,4,1,333931,271679,25174,82782,2.5165715661936345,0.23354332352501403
13830,0.4282142857142856,0,1,0,333932,271678,25174,82782,2.516562303160547,0.23354398239575694
13831,0.4282142857142857,0,5,0,333937,271673,25174,82782,2.5165159879951093,0.2335472768052362
13832,0.4282380952380953,0,1,0,333938,271672,25174,82782,2.5165067249620217,0.23354793569828525
13833,0.42825,0,2,0,333940,271670,25174,82782,2.5164881988958463,0.23354925349553676
13834,0.4282857142857142,0,1,0,333941,271669,25174,82782,2.516478935862759,0.23354991239973932
13835,0.4283333333333333,59,479,59,334420,271190,25233,82723,2.5120419430138203,0.23373823510297728
13836,0.4283333333333334,0,2,0,334422,271188,25233,82723,2.5120234169476454,0.2337395559900653
13837,0.4283690476190476,0,4,0,334426,271184,25233,82723,2.511986364815295,0.2337421978090289
13838,0.4283809523809523,0,1,0,334427,271183,25233,82723,2.5119771017822075,0.23374285827310076
13839,0.4284047619047618,0,1,0,334428,271182,25233,82723,2.51196783874912,0.23374351874090504
13840,0.4284047619047619,0,1,0,334429,271181,25233,82723,2.5119585757160325,0.23374417921244178
13841,0.4284166666666666,0,2,0,334431,271179,25233,82723,2.511940049649857,0.2337455001667128
13842,0.4284285714285715,0,1,0,334432,271178,25233,82723,2.51193078661677,0.23374616064944717
13843,0.428452380952381,0,3,0,334435,271175,25233,82723,2.5119029975175073,0.23374814212004588
13844,0.4284761904761904,0,2,0,334437,271173,25233,82723,2.511884471451332,0.23374946311910844
13845,0.4284999999999999,1,1,1,334438,271172,25234,82722,2.5118752084182443,0.23374795842822993
13846,0.4285,5,19,5,334457,271153,25239,82717,2.511699210789581,0.23374968208664199
13847,0.4285000000000001,0,1,0,334458,271152,25239,82717,2.5116899477564933,0.2337503426409208
13848,0.4285126262626262,0,1,0,334459,271151,25239,82717,2.5116806847234057,0.23375100319893294
13849,0.4285238095238096,0,1,0,334460,271150,25239,82717,2.5116714216903184,0.23375166376067844
13850,0.4285595238095238,0,1,0,334461,271149,25239,82717,2.5116621586572307,0.23375232432615736
13851,0.4285714285714285,0,1,0,334462,271148,25239,82717,2.511652895624143,0.2337529848953697
13852,0.4285714285714286,0,7,0,334469,271141,25239,82717,2.51158805439253,0.23375760898439488
13853,0.4285833333333333,0,2,0,334471,271139,25239,82717,2.5115695283263553,0.23375893018629046
13854,0.4285880647130647,1,3,1,334474,271136,25240,82716,2.5115417392270927,0.23375874659462148
13855,0.4286190476190476,0,1,0,334475,271135,25240,82716,2.511532476194005,0.23375940720811866
13856,0.4286388888888889,0,3,0,334478,271132,25240,82716,2.5115046870947424,0.23376138907101354
13857,0.4286428571428572,0,1,0,334479,271131,25240,82716,2.5114954240616547,0.23376204969944636
13858,0.4286666666666666,4,11,4,334490,271120,25244,82712,2.5113935306976916,0.23376065477401706
13859,0.4286666666666667,3,24,3,334514,271096,25247,82709,2.5111712179035903,0.23377001455604077
13860,0.4286746031746032,0,2,0,334516,271094,25247,82709,2.5111526918374154,0.23377133602598055
13861,0.428702380952381,0,1,0,334517,271093,25247,82709,2.5111434288043277,0.23377199676655305
13862,0.4287142857142857,0,1,0,334518,271092,25247,82709,2.51113416577124,0.23377265751086063
13863,0.42875,0,5,0,334523,271087,25247,82709,2.5110878506058025,0.2337759612884261
13864,0.4287500000000001,0,1,0,334524,271086,25247,82709,2.511078587572715,0.23377662205514493
13865,0.4287777777777777,0,1,0,334525,271085,25247,82709,2.511069324539627,0.23377728282559906
13866,0.4288095238095238,0,4,0,334529,271081,25247,82709,2.511032272407277,0.23377992594476948
13867,0.4288333333333333,0,7,0,334536,271074,25247,82709,2.510967431175664,0.23378455154713482
13868,0.4288333333333334,1,2,1,334538,271072,25248,82708,2.510948905109489,0.2337837073887727
13869,0.4288658008658009,0,1,0,334539,271071,25248,82708,2.5109396420764014,0.23378436820727064
13870,0.4288690476190477,1,3,1,334542,271068,25249,82707,2.510911852977139,0.23378418486326055
13871,0.4288809523809524,0,1,0,334543,271067,25249,82707,2.510902589944051,0.23378484569244773
13872,0.4288888888888889,0,3,0,334546,271064,25249,82707,2.5108748008447885,0.23378682820242475
13873,0.4289007936507936,0,1,0,334547,271063,25249,82707,2.510865537811701,0.23378748904655566
13874,0.4289166666666666,0,1,0,334548,271062,25249,82707,2.5108562747786136,0.23378814989442262
13875,0.4289285714285714,1,5,1,334553,271057,25250,82706,2.5108099596131757,0.23378928830883952
13876,0.428952380952381,0,1,0,334554,271056,25250,82706,2.510800696580088,0.23378994917486898
13877,0.4289999999999999,0,1,0,334555,271055,25250,82706,2.5107914335470007,0.23379061004463467
13878,0.429,14,76,14,334631,270979,25264,82692,2.5100874430323463,0.23381051881550932
13879,0.4290238095238095,0,2,0,334633,270977,25264,82692,2.5100689169661714,0.2338118410151865
13880,0.429047619047619,0,3,0,334636,270974,25264,82692,2.510041127866909,0.23381382434274145
13881,0.4290476190476191,0,1,0,334637,270973,25264,82692,2.510031864833821,0.23381448545940367
13882,0.4290555555555556,0,1,0,334638,270972,25264,82692,2.5100226018007334,0.23381514657980457
13883,0.4290714285714285,0,1,0,334639,270971,25264,82692,2.510013338767646,0.23381580770394414
13884,0.4290714285714286,0,1,0,334640,270970,25264,82692,2.5100040757345585,0.23381646883182247
13885,0.4290833333333333,0,1,0,334641,270969,25264,82692,2.509994812701471,0.23381712996343956
13886,0.4291111111111111,0,1,0,334642,270968,25264,82692,2.5099855496683836,0.23381779109879544
13887,0.4291666666666666,8,90,8,334732,270878,25272,82684,2.5091518766905034,0.2338599736397011
13888,0.4291666666666667,9,85,9,334817,270793,25281,82675,2.5083645188780612,0.233896703520545
13889,0.4291904761904762,0,1,0,334818,270792,25281,82675,2.508355255844974,0.23389736524201693
13890,0.4292261904761905,1,0,1,334818,270792,25282,82674,2.508355255844974,0.23389519784081073
13891,0.4292499999999999,0,1,0,334819,270791,25282,82674,2.5083459928118863,0.2338958595617671
13892,0.4292857142857143,2,14,2,334833,270777,25284,82672,2.5082163103486605,0.23390078908131018
13893,0.4293333333333333,5,47,5,334880,270730,25289,82667,2.5077809477935453,0.23392105762074947
13894,0.4293333333333334,0,1,0,334881,270729,25289,82667,2.507771684760458,0.23392171954408086
13895,0.4293452380952381,0,1,0,334882,270728,25289,82667,2.5077624217273704,0.23392238147115835
13896,0.4293458442898098,0,1,0,334883,270727,25289,82667,2.5077531586942827,0.23392304340198192
13897,0.4293571428571428,0,3,0,334886,270724,25289,82667,2.50772536959502,0.2339250292169297
13898,0.4293650793650794,1,0,1,334886,270724,25290,82666,2.50772536959502,0.2339228614278842
13899,0.4293730158730158,0,1,0,334887,270723,25290,82666,2.5077161065619324,0.23392352336943142
13900,0.4294047619047619,0,1,0,334888,270722,25290,82666,2.507706843528845,0.2339241853147249
13901,0.4294166666666666,0,1,0,334889,270721,25290,82666,2.5076975804957575,0.23392484726376467
13902,0.4294285714285714,0,1,0,334890,270720,25290,82666,2.50768831746267,0.23392550921655075
13903,0.4294285714285715,0,1,0,334891,270719,25290,82666,2.5076790544295826,0.23392617117308317
13904,0.4294444444444444,0,1,0,334892,270718,25290,82666,2.507669791396495,0.23392683313336202
13905,0.4294444444444445,0,1,0,334893,270717,25290,82666,2.5076605283634072,0.23392749509738725
13906,0.4294999999999999,0,5,0,334898,270712,25290,82666,2.5076142131979697,0.23393080497371088
13907,0.4295,5,16,5,334914,270696,25295,82661,2.5074660046685686,0.2339305574815272
13908,0.4295238095238095,0,3,0,334917,270693,25295,82661,2.507438215569306,0.2339325435682064
13909,0.4295238095238096,0,2,0,334919,270691,25295,82661,2.507419689503131,0.2339338676447282
13910,0.429563492063492,0,1,0,334920,270690,25295,82661,2.5074104264700434,0.23393452968860992
13911,0.4295833333333332,0,1,0,334921,270689,25295,82661,2.5074011634369557,0.23393519173623886
13912,0.4295833333333334,0,4,0,334925,270685,25295,82661,2.5073641113046055,0.2339378399642277
13913,0.4296111111111111,0,1,0,334926,270684,25295,82661,2.507354848271518,0.23393850203059333
13914,0.4296153846153846,1,1,1,334927,270683,25296,82660,2.5073455852384305,0.23393699606331525
13915,0.4296190476190476,0,1,0,334928,270682,25296,82660,2.507336322205343,0.23393765813291373
13916,0.4296428571428571,0,3,0,334931,270679,25296,82660,2.5073085331060803,0.23393964436419415
13917,0.4296666666666666,0,11,0,334942,270668,25296,82660,2.507206639742117,0.23394692750079246
13918,0.4296666666666667,0,18,0,334960,270650,25296,82660,2.507039905146541,0.23395884633890918
13919,0.4296785714285714,0,1,0,334961,270649,25296,82660,2.507030642113454,0.23395950853219136
13920,0.4297142857142856,0,1,0,334962,270648,25296,82660,2.507021379080366,0.2339601707292221
13921,0.4297142857142857,0,1,0,334963,270647,25296,82660,2.5070121160472785,0.2339608329300014
13922,0.4297460317460318,0,1,0,334964,270646,25296,82660,2.507002853014191,0.23396149513452927
13923,0.4297619047619047,0,1,0,334965,270645,25296,82660,2.5069935899811036,0.2339621573428058
13924,0.4297619047619048,2,1,2,334966,270644,25298,82658,2.506984326948016,0.23395848311076642
13925,0.4298333333333333,3,19,3,334985,270625,25301,82655,2.506808329319352,0.2339645606884058
13926,0.4298333333333334,0,2,0,334987,270623,25301,82655,2.5067898032531772,0.233965885223535
13927,0.4298484848484848,0,1,0,334988,270622,25301,82655,2.5067805402200896,0.23396654749672352
13928,0.4298571428571429,0,1,0,334989,270621,25301,82655,2.5067712771870023,0.2339672097736614
13929,0.4298809523809523,0,1,0,334990,270620,25301,82655,2.5067620141539146,0.2339678720543486
13930,0.4298809523809524,0,2,0,334992,270618,25301,82655,2.5067434880877393,0.23396919662697122
13931,0.4298849206349208,0,1,0,334993,270617,25301,82655,2.506734225054652,0.23396985891890668
13932,0.4298928571428571,0,1,0,334994,270616,25301,82655,2.5067249620215644,0.23397052121459164
13933,0.4299285714285714,0,2,0,334996,270614,25301,82655,2.5067064359553894,0.23397184581721012
13934,0.4299285714285715,0,3,0,334999,270611,25301,82655,2.5066786468561264,0.23397383274925976
13935,0.4299523809523809,0,1,0,335000,270610,25301,82655,2.506669383823039,0.23397449506744228
13936,0.429952380952381,0,1,0,335001,270609,25301,82655,2.5066601207899515,0.23397515738937452
13937,0.4299761904761904,0,1,0,335002,270608,25301,82655,2.506650857756864,0.2339758197150565
13938,0.4299999999999999,4,27,4,335029,270581,25305,82651,2.5064007558635,0.23398502966888618
13939,0.43,418,3438,418,338467,267143,25723,82233,2.4745544481084885,0.2353710615497344
13940,0.4300106837606837,0,1,0,338468,267142,25723,82233,2.474545185075401,0.23537173524150268
13941,0.4300238095238095,0,1,0,338469,267141,25723,82233,2.4745359220423135,0.23537240893712755
13942,0.430047619047619,1,1,1,338470,267140,25724,82232,2.474526659009226,0.23537089406134434
13943,0.4300555555555555,1,0,1,338470,267140,25725,82231,2.474526659009226,0.23536870547355104
13944,0.4300714285714286,1,1,1,338471,267139,25726,82230,2.4745173959761386,0.23536719056355887
13945,0.4300952380952381,1,0,1,338471,267139,25727,82229,2.4745173959761386,0.23536500194637172
13946,0.430111111111111,0,2,0,338473,267137,25727,82229,2.4744988699099633,0.23536634932992906
13947,0.4301190476190477,0,3,0,338476,267134,25727,82229,2.4744710808107007,0.23536837043419023
13948,0.4301666666666666,1,14,1,338490,267120,25728,82228,2.474341398347475,0.2353756140009389
13949,0.4301666666666667,1,1,1,338491,267119,25729,82227,2.4743321353143872,0.23537409903076034
13950,0.4301785714285713,0,4,0,338495,267115,25729,82227,2.474295083182037,0.2353767940871696
13951,0.4302261904761904,0,1,0,338496,267114,25729,82227,2.4742858201489497,0.23537746786091526
13952,0.4302380952380951,0,1,0,338497,267113,25729,82227,2.474276557115862,0.23537814163851836
13953,0.4302380952380952,0,2,0,338499,267111,25729,82227,2.474258031049687,0.2353794892052969
13954,0.4302499999999999,1,1,1,338500,267110,25730,82226,2.4742487680165994,0.2353779742139373
13955,0.4302857142857143,0,1,0,338501,267109,25730,82226,2.4742395049835118,0.23537864800263358
13956,0.4303015873015874,0,1,0,338502,267108,25730,82226,2.474230241950424,0.23537932179518742
13957,0.4303333333333333,1,20,1,338522,267088,25731,82225,2.474044981288673,0.23539060956792332
13958,0.4303333333333334,1,10,1,338532,267078,25732,82224,2.4739523509577976,0.2353951594894962
13959,0.4303571428571427,0,1,0,338533,267077,25732,82224,2.47394308792471,0.23539583339297626
13960,0.4303571428571428,0,3,0,338536,267074,25732,82224,2.4739152988254474,0.23539785512656813
13961,0.4303571428571429,1,4,1,338540,267070,25733,82223,2.473878246693097,0.23539836183376134
13962,0.4303809523809525,0,1,0,338541,267069,25733,82223,2.47386898366001,0.23539903576377358
13963,0.4304047619047618,0,2,0,338543,267067,25733,82223,2.4738504575938345,0.2354003836353746
13964,0.4304166666666666,1,2,1,338545,267065,25734,82222,2.4738319315276596,0.23539954249657158
13965,0.4304166666666667,0,1,0,338546,267064,25734,82222,2.473822668494572,0.23540021644154074
13966,0.4304444444444444,0,1,0,338547,267063,25734,82222,2.473813405461484,0.2354008903903689
13967,0.4304523809523809,0,2,0,338549,267061,25734,82222,2.4737948793953093,0.23540223829960233
13968,0.430452380952381,1,1,1,338550,267060,25735,82221,2.4737856163622216,0.23540072319994504
13969,0.4304722222222223,0,1,0,338551,267059,25735,82221,2.473776353329134,0.23540139715987174
13970,0.4304761904761905,0,3,0,338554,267056,25735,82221,2.4737485642298713,0.23540341906280687
13971,0.4305,2,19,2,338573,267037,25737,82219,2.473572566601208,0.23541184689740477
13972,0.4305238095238094,0,2,0,338575,267035,25737,82219,2.4735540405350327,0.235413194981303
13973,0.4305238095238095,0,1,0,338576,267034,25737,82219,2.4735447775019455,0.235413869029042
13974,0.4305357142857143,1,0,1,338576,267034,25738,82218,2.4735447775019455,0.2354116798185837
13975,0.4305476190476189,0,1,0,338577,267033,25738,82218,2.4735355144688578,0.23541235386584433
13976,0.430547619047619,0,1,0,338578,267032,25738,82218,2.47352625143577,0.23541302791696492
13977,0.4305476190476191,0,1,0,338579,267031,25738,82218,2.4735169884026824,0.23541370197194553
13978,0.4305555555555556,0,7,0,338586,267024,25738,82218,2.4734521471710695,0.23541842046489253
13979,0.4305833333333333,1,0,1,338586,267024,25739,82217,2.4734521471710695,0.23541623119851335
13980,0.4305833333333334,0,1,0,338587,267023,25739,82217,2.4734428841379823,0.23541690528003664
13981,0.4305862193362192,1,0,1,338587,267023,25740,82216,2.4734428841379823,0.23541471599678157
13982,0.430595238095238,0,2,0,338589,267021,25740,82216,2.473424358071807,0.2354160641627319
13983,0.4305952380952381,0,1,0,338590,267020,25740,82216,2.4734150950387193,0.23541673825149756
13984,0.4306190476190475,0,1,0,338591,267019,25740,82216,2.473405832005632,0.23541741234412358
13985,0.4306515151515151,0,1,0,338592,267018,25740,82216,2.4733965689725443,0.23541808644061002
13986,0.4306637806637806,0,1,0,338593,267017,25740,82216,2.4733873059394567,0.2354187605409569
13987,0.4306666666666666,5,41,5,338634,266976,25745,82211,2.473007521582867,0.2354354543554027
13988,0.4306666666666667,4,11,4,338645,266965,25749,82207,2.472905628218904,0.23543411270090386
13989,0.4307142857142857,1,5,1,338650,266960,25750,82206,2.4728593130534664,0.23543529438719693
13990,0.4307460317460317,0,1,0,338651,266959,25750,82206,2.4728500500203787,0.2354359686681082
13991,0.4307539682539682,0,1,0,338652,266958,25750,82206,2.472840786987291,0.23543664295288175
13992,0.4307777777777777,1,0,1,338652,266958,25751,82205,2.472840786987291,0.2354344532496284
13993,0.4308095238095238,0,1,0,338653,266957,25751,82205,2.4728315239542034,0.2354351275339241
13994,0.4308333333333333,26,147,26,338800,266810,25777,82179,2.471469858090333,0.23547733596187845
13995,0.4308412698412699,0,1,0,338801,266809,25777,82179,2.4714605950572457,0.23547801070523916
13996,0.4308571428571429,0,1,0,338802,266808,25777,82179,2.471451332024158,0.23547868545246672
13997,0.4308809523809522,0,1,0,338803,266807,25777,82179,2.4714420689910703,0.23547936020356117
13998,0.4308809523809525,1,0,1,338803,266807,25778,82178,2.4714420689910703,0.23547716950585268
13999,0.4309444444444444,0,1,0,338804,266806,25778,82178,2.471432805957983,0.2354778442564702
14000,0.430952380952381,0,2,0,338806,266804,25778,82178,2.4714142798918077,0.23547919376930615
14001,0.4309858474858474,1,0,1,338806,266804,25779,82177,2.4714142798918077,0.2354770030460111
14002,0.4309999999999999,0,9,0,338815,266795,25779,82177,2.47133091259402,0.2354830760060979
14003,0.431,11,69,11,338884,266726,25790,82166,2.4706917633109784,0.23550554326267154
14004,0.4310238095238095,1,3,1,338887,266723,25791,82165,2.470663974211716,0.23550537708376326
14005,0.431047619047619,0,1,0,338888,266722,25791,82165,2.470654711178628,0.23550605210282985
14006,0.4310714285714286,0,1,0,338889,266721,25791,82165,2.470645448145541,0.235506727125766
14007,0.4310753968253968,0,2,0,338891,266719,25791,82165,2.4706269220793655,0.23550807718324715
14008,0.431095238095238,0,1,0,338892,266718,25791,82165,2.4706176590462783,0.23550875221779222
14009,0.4310952380952381,0,2,0,338894,266716,25791,82165,2.470599132980103,0.23551010229849145
14010,0.431111111111111,0,1,0,338895,266715,25791,82165,2.4705898699470152,0.23551077734464573
14011,0.4311111111111111,0,2,0,338897,266713,25791,82165,2.4705713438808403,0.23551212744856367
14012,0.4311190476190477,0,1,0,338898,266712,25791,82165,2.4705620808477526,0.23551280250632745
14013,0.4311309523809523,0,2,0,338900,266710,25791,82165,2.4705435547815777,0.2355141526334647
14014,0.4311428571428571,0,2,0,338902,266708,25791,82165,2.4705250287154024,0.23551550277608185
14015,0.4311666666666666,0,1,0,338903,266707,25791,82165,2.470515765682315,0.23551617785319545
14016,0.4311666666666667,2,8,2,338911,266699,25793,82163,2.4704416614176146,0.23551719591127723
14017,0.4311904761904762,0,6,0,338917,266693,25793,82163,2.4703860832190894,0.2355212465888504
14018,0.4311984126984126,1,0,1,338917,266693,25794,82162,2.4703860832190894,0.23551905519485172
14019,0.4312142857142856,0,1,0,338918,266692,25794,82162,2.4703768201860017,0.23551973031698073
14020,0.4312142857142857,0,3,0,338921,266689,25794,82162,2.470349031086739,0.23552175570659106
14021,0.4312380952380952,0,2,0,338923,266687,25794,82162,2.4703305050205637,0.23552310598568435
14022,0.43125,0,7,0,338930,266680,25794,82162,2.470265663788951,0.23552783208443936
14023,0.4312777777777777,0,1,0,338931,266679,25794,82162,2.4702564007558636,0.23552850725688781
14024,0.4313095238095238,1,1,1,338932,266678,25795,82161,2.470247137722776,0.2355269909614464
14025,0.4313333333333332,0,4,0,338936,266674,25795,82161,2.4702100855904257,0.23552969168804735
14026,0.4313333333333333,5,31,5,338967,266643,25800,82156,2.4699229315647115,0.23553966611142807
14027,0.4313333333333334,1,3,1,338970,266640,25801,82155,2.469895142465449,0.23553950027953383
14028,0.4313888888888887,0,1,0,338971,266639,25801,82155,2.4698858794323613,0.23554017557641474
14029,0.4313888888888889,0,2,0,338973,266637,25801,82155,2.4698673533661863,0.23554152618179316
14030,0.4314166666666665,0,1,0,338974,266636,25801,82155,2.4698580903330987,0.23554220149029076
14031,0.4314166666666666,0,1,0,338975,266635,25801,82155,2.469848827300011,0.23554287680266062
14032,0.4314166666666667,0,1,0,338976,266634,25801,82155,2.4698395642669237,0.23554355211890282
14033,0.4314285714285714,0,8,0,338984,266626,25801,82155,2.469765460002223,0.23554895478824822
14034,0.4314523809523809,0,2,0,338986,266624,25801,82155,2.469746933936048,0.23555030549431016
14035,0.4314761904761905,1,0,1,338986,266624,25802,82154,2.469746933936048,0.23554811369983197
14036,0.4315,4,35,4,339021,266589,25806,82150,2.4694227277779834,0.2355629854991842
14037,0.4315238095238096,0,1,0,339022,266588,25806,82150,2.469413464744896,0.23556366097184706
14038,0.4315384615384615,0,1,0,339023,266587,25806,82150,2.4694042017118085,0.23556433644838373
14039,0.4315476190476191,0,2,0,339025,266585,25806,82150,2.4693856756456336,0.2355656874130787
14040,0.4315555555555556,0,1,0,339026,266584,25806,82150,2.469376412612546,0.23556636290123706
14041,0.4315833333333333,0,1,0,339027,266583,25806,82150,2.4693671495794582,0.23556703839326934
14042,0.4316190476190476,0,1,0,339028,266582,25806,82150,2.4693578865463706,0.23556771388917563
14043,0.4316666666666666,35,242,35,339270,266340,25841,82115,2.4671162325391824,0.235654532149058
14044,0.4316666666666667,26,188,26,339458,266152,25867,82089,2.4653747823187224,0.23572468491648024
14045,0.4316904761904762,0,1,0,339459,266151,25867,82089,2.4653655192856347,0.23572536181943488
14046,0.4317103174603175,0,5,0,339464,266146,25867,82089,2.4653192041201972,0.23572874639252228
14047,0.4317142857142857,0,2,0,339466,266144,25867,82089,2.465300678054022,0.23573010024897123
14048,0.4317142857142858,0,1,0,339467,266143,25867,82089,2.4652914150209346,0.2357307771830274
14049,0.4317499999999999,0,2,0,339469,266141,25867,82089,2.4652728889547593,0.23573213106280333
14050,0.4317738095238095,0,1,0,339470,266140,25867,82089,2.4652636259216716,0.23573280800852311
14051,0.4317777777777777,0,1,0,339471,266139,25867,82089,2.4652543628885843,0.23573348495813087
14052,0.4317777777777778,1,3,1,339474,266136,25868,82088,2.4652265737893218,0.2357333210806837
14053,0.4317857142857142,0,5,0,339479,266131,25868,82088,2.465180258623884,0.2357367059235711
14054,0.4317857142857143,0,4,0,339483,266127,25868,82088,2.4651432064915335,0.23573941386786898
14055,0.4318095238095237,0,1,0,339484,266126,25868,82088,2.465133943458446,0.2357400908636643
14056,0.4318333333333333,2,18,2,339502,266108,25870,82086,2.4649672088628702,0.23574788767181515
14057,0.4319047619047619,0,2,0,339504,266106,25870,82086,2.464948682796695,0.2357492417976289
14058,0.4319285714285714,1,0,1,339504,266106,25871,82085,2.464948682796695,0.23574704687944262
14059,0.4319444444444444,0,2,0,339506,266104,25871,82085,2.46493015673052,0.23574840101209402
14060,0.4319523809523808,0,1,0,339507,266103,25871,82085,2.4649208936974323,0.23574907808425333
14061,0.431952380952381,0,1,0,339508,266102,25871,82085,2.4649116306643446,0.2357497551603018
14062,0.4319682539682539,0,1,0,339509,266101,25871,82085,2.4649023676312574,0.23575043224023942
14063,0.4319761904761905,0,1,0,339510,266100,25871,82085,2.4648931045981697,0.23575110932406623
14064,0.4319999999999999,1,4,1,339514,266096,25872,82084,2.4648560524658194,0.23575162272387845
14065,0.432,13,80,13,339594,266016,25885,82071,2.464115009818815,0.2357772625809065
14066,0.4320000000000001,0,2,0,339596,266014,25885,82071,2.46409648375264,0.23577861729175345
14067,0.4320238095238096,0,2,0,339598,266012,25885,82071,2.464077957686465,0.23577997201816808
14068,0.4320699855699856,0,4,0,339602,266008,25885,82071,2.4640409055541146,0.23578268151770143
14069,0.4320833333333332,0,1,0,339603,266007,25885,82071,2.464031642521027,0.235783358902315
14070,0.4320833333333334,0,2,0,339605,266005,25885,82071,2.464013116454852,0.2357847136832186
14071,0.4320952380952381,0,1,0,339606,266004,25885,82071,2.4640038534217643,0.23578539107950872
14072,0.4321111111111111,0,1,0,339607,266003,25885,82071,2.463994590388677,0.2357860684796911
14073,0.4321428571428571,3,13,3,339620,265990,25888,82068,2.4638741709585386,0.23578828815887007
14074,0.4321567599067599,0,1,0,339621,265989,25888,82068,2.4638649079254513,0.235788965600462
14075,0.4321666666666666,1,3,1,339624,265986,25889,82067,2.4638371188261883,0.2357888022801125
14076,0.4321666666666667,0,8,0,339632,265978,25889,82067,2.463763014561488,0.2357942220115215
14077,0.432170634920635,0,1,0,339633,265977,25889,82067,2.4637537515284005,0.2357948994954661
14078,0.4321746031746032,0,1,0,339634,265976,25889,82067,2.463744488495313,0.23579557698330378
14079,0.4321825396825396,0,1,0,339635,265975,25889,82067,2.4637352254622256,0.23579625447503463
14080,0.4321904761904762,0,2,0,339637,265973,25889,82067,2.46371669939605,0.23579760947017583
14081,0.4322222222222222,0,1,0,339638,265972,25889,82067,2.4637074363629625,0.2357982869735863
14082,0.4322222222222223,0,3,0,339641,265969,25889,82067,2.4636796472637,0.23580031950717742
14083,0.43225,0,2,0,339643,265967,25889,82067,2.463661121197525,0.2358016745490383
14084,0.4322619047619048,1,0,1,339643,265967,25890,82066,2.463661121197525,0.23579947878505775
14085,0.4322683982683982,0,1,0,339644,265966,25890,82066,2.4636518581644373,0.23580015630746598
14086,0.4322857142857143,0,1,0,339645,265965,25890,82066,2.4636425951313496,0.23580083383376768
14087,0.432297619047619,0,1,0,339646,265964,25890,82066,2.4636333320982624,0.23580151136396288
14088,0.4323333333333333,2,38,2,339684,265926,25892,82064,2.463281336840935,0.235822868473232
14089,0.4323333333333334,0,1,0,339685,265925,25892,82064,2.4632720738078477,0.2358235461465736
14090,0.4323650793650793,0,1,0,339686,265924,25892,82064,2.46326281077476,0.23582422382381002
14091,0.4323809523809523,0,2,0,339688,265922,25892,82064,2.463244284708585,0.2358255791899674
14092,0.4323809523809524,2,4,2,339692,265918,25894,82062,2.463207232576235,0.2358238979251681
14093,0.4323809523809525,1,0,1,339692,265918,25895,82061,2.463207232576235,0.23582170188430912
14094,0.4324166666666666,0,1,0,339693,265917,25895,82061,2.463197969543147,0.2358223795757203
14095,0.4324285714285714,0,1,0,339694,265916,25895,82061,2.4631887065100595,0.23582305727102654
14096,0.4324999999999999,1,10,1,339704,265906,25896,82060,2.463096076179184,0.23582763833248077
14097,0.4325,53,336,53,340040,265570,25949,82007,2.459983697061766,0.23593908687859094
14098,0.4325952380952381,0,1,0,340041,265569,25949,82007,2.459974434028678,0.23593976569153222
14099,0.4326071428571428,0,2,0,340043,265567,25949,82007,2.4599559079625033,0.23594112332913278
14100,0.4326111111111111,0,1,0,340044,265566,25949,82007,2.4599466449294156,0.23594180215379215
14101,0.4326190476190475,0,5,0,340049,265561,25949,82007,2.459900329763978,0.23594519633568106
14102,0.4326190476190477,1,1,1,340050,265560,25950,82006,2.4598910667308904,0.2359436768843903
14103,0.4326666666666666,8,45,8,340095,265515,25958,81998,2.4594742302419506,0.23595664047100395
14104,0.4326666666666667,4,13,4,340108,265502,25962,81994,2.459353810811812,0.23595667288256555
14105,0.4326904761904761,0,1,0,340109,265501,25962,81994,2.459344547778725,0.23595735190434394
14106,0.4326904761904762,0,1,0,340110,265500,25962,81994,2.459335284745637,0.23595803093003045
14107,0.4327142857142857,0,1,0,340111,265499,25962,81994,2.4593260217125494,0.2359587099596251
14108,0.4327380952380952,0,5,0,340116,265494,25962,81994,2.459279706547112,0.23596210516622157
14109,0.4327499999999999,0,1,0,340117,265493,25962,81994,2.4592704435140242,0.23596278421926575
14110,0.4327510822510823,0,1,0,340118,265492,25962,81994,2.4592611804809366,0.2359634632762183
14111,0.432767316017316,0,1,0,340119,265491,25962,81994,2.4592519174478493,0.2359641423370793
14112,0.4327777777777777,0,3,0,340122,265488,25962,81994,2.4592241283485863,0.23596617954311302
14113,0.4327857142857143,0,3,0,340125,265485,25962,81994,2.4591963392493237,0.23596821678432367
14114,0.4328095238095237,0,1,0,340126,265484,25962,81994,2.4591870762162364,0.23596889587254444
14115,0.4328333333333332,0,1,0,340127,265483,25962,81994,2.4591778131831488,0.2359695749646739
14116,0.4328333333333333,0,7,0,340134,265476,25962,81994,2.459112971951536,0.2359743287190261
14117,0.4328333333333334,0,11,0,340145,265465,25962,81994,2.4590110785875727,0.23598179929142718
14118,0.4328571428571428,0,9,0,340154,265456,25962,81994,2.458927711289785,0.23598791192977406
14119,0.4328888888888888,0,1,0,340155,265455,25962,81994,2.4589184482566973,0.23598859113136028
14120,0.4329047619047619,0,1,0,340156,265454,25962,81994,2.4589091852236096,0.23598927033685616
14121,0.4329166666666666,1,3,1,340159,265451,25963,81993,2.458881396124347,0.23598910903627635
14122,0.4329761904761904,0,3,0,340162,265448,25963,81993,2.4588536070250844,0.23599114669828833
14123,0.4329920634920635,0,1,0,340163,265447,25963,81993,2.4588443439919967,0.23599182592677873
14124,0.433,11,58,11,340221,265389,25974,81982,2.4583070880729188,0.23600703570534098
14125,0.4330238095238095,0,3,0,340224,265386,25974,81982,2.4582792989736557,0.23600907395039267
14126,0.433047619047619,0,1,0,340225,265385,25974,81982,2.4582700359405685,0.2360097533732335
14127,0.4330555555555556,0,2,0,340227,265383,25974,81982,2.458251509874393,0.23601111223065074
14128,0.4330714285714285,0,2,0,340229,265381,25974,81982,2.458232983808218,0.2360124711037157
14129,0.4330833333333332,0,2,0,340231,265379,25974,81982,2.458214457742043,0.23601382999242862
14130,0.4330873015873016,0,1,0,340232,265378,25974,81982,2.4582051947089556,0.23601450944265315
14131,0.4330952380952381,0,1,0,340233,265377,25974,81982,2.458195931675868,0.23601518889678977
14132,0.4331031746031747,1,2,1,340235,265375,25975,81981,2.458177405609693,0.2360143483918516
14133,0.4331071428571427,0,5,0,340240,265370,25975,81981,2.458131090444255,0.23601774573846052
14134,0.4331190476190475,0,1,0,340241,265369,25975,81981,2.4581218274111674,0.2360184252195192
14135,0.4331428571428571,0,4,0,340245,265365,25975,81981,2.458084775278817,0.23602114318287817
14136,0.4331587301587301,0,3,0,340248,265362,25975,81981,2.4580569861795545,0.2360231816964787
14137,0.4331645021645023,0,2,0,340250,265360,25975,81981,2.4580384601133796,0.23602454072510876
14138,0.4331666666666666,2,10,2,340260,265350,25977,81979,2.457945829782504,0.2360269369963349
14139,0.4331666666666667,1,8,1,340268,265342,25978,81978,2.4578717255178035,0.2360301739030289
14140,0.4331904761904762,0,1,0,340269,265341,25978,81978,2.457862462484716,0.23603085348051792
14141,0.4332142857142857,0,3,0,340272,265338,25978,81978,2.4578346733854533,0.2360328922364648
14142,0.4332222222222223,0,2,0,340274,265336,25978,81978,2.4578161473192783,0.2360342514266629
14143,0.4332380952380952,1,1,1,340275,265335,25979,81977,2.4578068842861907,0.23603273137697517
14144,0.43325,1,0,1,340275,265335,25980,81976,2.4578068842861907,0.23603053171365146
14145,0.4332727272727272,0,1,0,340276,265334,25980,81976,2.457797621253103,0.2360312113097809
14146,0.4333282828282828,0,1,0,340277,265333,25980,81976,2.4577883582200157,0.23603189090982382
14147,0.4333333333333333,108,708,108,340985,264625,26088,81868,2.4512301307940274,0.23627605752497163
14148,0.4333333333333334,0,2,0,340987,264623,26088,81868,2.451211604727852,0.23627742134716342
14149,0.4333809523809523,0,2,0,340989,264621,26088,81868,2.451193078661677,0.23627878518509968
14150,0.4334166666666667,0,1,0,340990,264620,26088,81868,2.4511838156285894,0.23627946710997205
14151,0.4334444444444444,2,0,2,340990,264620,26090,81866,2.4511838156285894,0.23627505873253177
14152,0.433452380952381,0,1,0,340991,264619,26090,81866,2.4511745525955018,0.2362757406525535
14153,0.4334999999999999,0,2,0,340993,264617,26090,81866,2.451156026529327,0.2362771045044057
14154,0.4335,4,32,4,341025,264585,26094,81862,2.450859609470525,0.2362901107528713
14155,0.4335000000000001,0,1,0,341026,264584,26094,81862,2.4508503464374374,0.23629079279310483
14156,0.433547619047619,0,2,0,341028,264582,26094,81862,2.4508318203712625,0.23629215688538407
14157,0.4335714285714285,0,1,0,341029,264581,26094,81862,2.450822557338175,0.23629283893742983
14158,0.4335714285714286,0,6,0,341035,264575,26094,81862,2.4507669791396496,0.23629693133239232
14159,0.4335833333333333,0,1,0,341036,264574,26094,81862,2.450757716106562,0.23629761341200106
14160,0.4336111111111111,0,1,0,341037,264573,26094,81862,2.450748453073474,0.2362982954955475
14161,0.4336190476190477,1,1,1,341038,264572,26095,81861,2.450739190040387,0.23629677311341588
14162,0.4336666666666666,3,27,3,341065,264545,26098,81858,2.4504890881470227,0.23630857700424074
14163,0.4336666666666667,0,2,0,341067,264543,26098,81858,2.450470562080848,0.23630994136852954
14164,0.4336904761904762,0,3,0,341070,264540,26098,81858,2.450442772981585,0.23631198794450314
14165,0.4337142857142856,1,1,1,341071,264539,26099,81857,2.4504335099484975,0.23631046547881615
14166,0.4337499999999999,0,1,0,341072,264538,26099,81857,2.45042424691541,0.2363111476782286
14167,0.43375,1,10,1,341082,264528,26100,81856,2.4503316165845344,0.23631576516236316
14168,0.4337619047619048,0,1,0,341083,264527,26100,81856,2.4503223535514467,0.23631644740070962
14169,0.4337857142857143,0,1,0,341084,264526,26100,81856,2.4503130905183594,0.2363171296429953
14170,0.4338095238095238,1,3,1,341087,264523,26101,81855,2.450285301419097,0.23631697163214754
14171,0.4338311688311689,0,1,0,341088,264522,26101,81855,2.450276038386009,0.23631765388579495
14172,0.4338333333333332,0,2,0,341090,264520,26101,81855,2.450257512319834,0.236319018404908
14173,0.4338333333333333,2,10,2,341100,264510,26103,81853,2.4501648819889583,0.23632143156168528
14174,0.4338744588744588,0,1,0,341101,264509,26103,81853,2.450155618955871,0.23632211385775576
14175,0.4338888888888889,0,1,0,341102,264508,26103,81853,2.4501463559227834,0.23632279615776602
14176,0.4339166666666667,0,1,0,341103,264507,26103,81853,2.4501370928896957,0.23632347846171614
14177,0.4339285714285714,0,1,0,341104,264506,26103,81853,2.450127829856608,0.2363241607696061
14178,0.433952380952381,0,1,0,341105,264505,26103,81853,2.450118566823521,0.23632484308143598
14179,0.4339880952380952,1,0,1,341105,264505,26104,81852,2.450118566823521,0.2363226382027792
14180,0.4339999999999999,0,1,0,341106,264504,26104,81852,2.450109303790433,0.23632332051415306
14181,0.434,16,115,16,341221,264389,26120,81836,2.4490440549853645,0.23636652465882013
14182,0.4340238095238095,0,2,0,341223,264387,26120,81836,2.449025528919189,0.23636789005929704
14183,0.4340476190476189,0,1,0,341224,264386,26120,81836,2.449016265886102,0.23636857276545106
14184,0.434047619047619,0,3,0,341227,264383,26120,81836,2.4489884767868393,0.23637062090757585
14185,0.4340616883116884,1,2,1,341229,264381,26121,81835,2.448969950720664,0.2363697807149294
14186,0.4340641996891997,0,1,0,341230,264380,26121,81835,2.4489606876875762,0.23637046344034776
14187,0.4340952380952381,0,1,0,341231,264379,26121,81835,2.448951424654489,0.23637114616971006
14188,0.4341043094332568,0,1,0,341232,264378,26121,81835,2.4489421616214013,0.23637182890301636
14189,0.4341071428571428,1,0,1,341232,264378,26122,81834,2.4489421616214013,0.23636962323662958
14190,0.4341428571428571,0,1,0,341233,264377,26122,81834,2.4489328985883136,0.23637030596948103
14191,0.434154761904762,1,2,1,341235,264375,26123,81833,2.4489143725221387,0.2363694657546908
14192,0.4341666666666666,8,87,8,341322,264288,26131,81825,2.4481084886435216,0.23641122985845664
14193,0.4341666666666667,10,59,10,341381,264229,26141,81815,2.4475619696913555,0.236429471396701
14194,0.4341904761904762,0,1,0,341382,264228,26141,81815,2.4475527066582683,0.23643015463396166
14195,0.4342142857142856,0,1,0,341383,264227,26141,81815,2.4475434436251806,0.23643083787517122
14196,0.4342857142857142,0,2,0,341385,264225,26141,81815,2.4475249175590057,0.23643220436943707
14197,0.4342857142857143,1,16,1,341401,264209,26142,81814,2.4473767090296046,0.23644093022718143
14198,0.434297619047619,0,1,0,341402,264208,26142,81814,2.447367445996517,0.23644161353902354
14199,0.4343333333333332,0,1,0,341403,264207,26142,81814,2.4473581829634297,0.23644229685481516
14200,0.4343333333333333,4,30,4,341433,264177,26146,81810,2.447080291970803,0.23645397081393232
14201,0.4343333333333334,0,1,0,341434,264176,26146,81810,2.4470710289377156,0.2364546542345644
14202,0.434363247863248,0,5,0,341439,264171,26146,81810,2.4470247137722776,0.23645807139698422
14203,0.4343809523809523,0,1,0,341440,264170,26146,81810,2.44701545073919,0.2364587548413203
14204,0.4343939393939394,0,1,0,341441,264169,26146,81810,2.4470061877061027,0.23645943828960717
14205,0.4344047619047619,0,1,0,341442,264168,26146,81810,2.446996924673015,0.23646012174184486
14206,0.4344444444444444,0,3,0,341445,264165,26146,81810,2.4469691355737524,0.23646217212226317
14207,0.4344642857142857,0,1,0,341446,264164,26146,81810,2.4469598725406647,0.23646285559030447
14208,0.4344761904761905,0,1,0,341447,264163,26146,81810,2.446950609507577,0.23646353906229678
14209,0.4344999999999999,1,5,1,341452,264158,26147,81809,2.4469042943421395,0.23646474952813418
14210,0.4345,3,14,3,341466,264144,26150,81806,2.4467746118789138,0.23646769764416822
14211,0.4345238095238095,2,2,2,341468,264142,26152,81804,2.4467560858127384,0.23646465055239835
14212,0.4345714285714285,0,2,0,341470,264140,26152,81804,2.4467375597465635,0.2364660176213491
14213,0.4345833333333332,1,5,1,341475,264135,26153,81803,2.4466912445811255,0.23646722823164845
14214,0.4345833333333334,0,5,0,341480,264130,26153,81803,2.446644929415688,0.23647064604995766
14215,0.4346428571428571,0,1,0,341481,264129,26153,81803,2.4466356663826003,0.23647132962547554
14216,0.4346666666666666,1,10,1,341491,264119,26154,81802,2.446543036051725,0.23647595838356156
14217,0.4346666666666667,1,27,1,341518,264092,26155,81801,2.446292934158361,0.2364922100187052
14218,0.4347222222222222,0,1,0,341519,264091,26155,81801,2.4462836711252733,0.2364928937356169
14219,0.43475,0,1,0,341520,264090,26155,81801,2.4462744080921857,0.23649357745648195
14220,0.4347619047619048,0,1,0,341521,264089,26155,81801,2.446265145059098,0.2364942611813004
14221,0.4348232323232323,0,1,0,341522,264088,26155,81801,2.4462558820260107,0.2364949449100723
14222,0.4348333333333333,2,21,2,341543,264067,26157,81799,2.446061358331172,0.23650488917673318
14223,0.4348333333333334,2,3,2,341546,264064,26159,81797,2.4460335692319095,0.23650252558108603
14224,0.4348571428571428,0,1,0,341547,264063,26159,81797,2.446024306198822,0.2365032093910831
14225,0.4348571428571429,0,2,0,341549,264061,26159,81797,2.4460057801326465,0.23650457702294006
14226,0.4348809523809523,0,1,0,341550,264060,26159,81797,2.4459965170995592,0.23650526084480003
14227,0.4348809523809524,0,4,0,341554,264056,26159,81797,2.445959464967209,0.23650799617178397
14228,0.4349404761904761,0,1,0,341555,264055,26159,81797,2.4459502019341213,0.23650868001341616
14229,0.4349444444444443,0,1,0,341556,264054,26159,81797,2.4459409389010336,0.23650936385900287
14230,0.4349523809523809,1,0,1,341556,264054,26160,81796,2.4459409389010336,0.23650715628162497
14231,0.4349999999999999,1,27,1,341583,264027,26161,81795,2.4456908370076698,0.23652341377934313
14232,0.435,158,1405,158,342988,262622,26319,81637,2.4326762755196563,0.2371383173715139
14233,0.4350000000000001,0,2,0,342990,262620,26319,81637,2.432657749453481,0.23713969505340488
14234,0.4350808080808081,0,1,0,342991,262619,26319,81637,2.4326484864203937,0.23714038390035322
14235,0.4350833333333332,0,1,0,342992,262618,26319,81637,2.432639223387306,0.23714107275130353
14236,0.4350833333333333,0,1,0,342993,262617,26319,81637,2.4326299603542183,0.23714176160625586
14237,0.4351111111111111,1,2,1,342995,262615,26320,81636,2.4326114342880434,0.2371409233379133
14238,0.4351190476190475,0,2,0,342997,262613,26320,81636,2.432592908221868,0.23714230106696024
14239,0.4351428571428571,0,2,0,342999,262611,26320,81636,2.432574382155693,0.23714367881201578
14240,0.4351436896436896,0,1,0,343000,262610,26320,81636,2.4325651191226054,0.23714436769054686
14241,0.4351666666666666,1,12,1,343012,262598,26321,81635,2.432453962725555,0.2371504184665619
14242,0.4351666666666667,0,6,0,343018,262592,26321,81635,2.4323983845270294,0.23715455208336358
14243,0.435186507936508,0,2,0,343020,262590,26321,81635,2.4323798584608545,0.23715592998765342
14244,0.4351904761904762,0,1,0,343021,262589,26321,81635,2.432370595427767,0.23715661894580273
14245,0.4352380952380952,0,4,0,343025,262585,26321,81635,2.4323335432954165,0.23715937481843008
14246,0.4353095238095237,0,1,0,343026,262584,26321,81635,2.4323242802623293,0.2371600637965946
14247,0.4353095238095239,1,1,1,343027,262583,26322,81634,2.4323150172292416,0.23715853662079445
14248,0.4353333333333332,1,1,1,343028,262582,26323,81633,2.432305754196154,0.23715700942724752
14249,0.4353333333333333,4,24,4,343052,262558,26327,81629,2.4320834414020527,0.2371646808275734
14250,0.4353333333333334,4,12,4,343064,262546,26331,81625,2.431972285005002,0.23716408413259688
14251,0.4353571428571428,0,1,0,343065,262545,26331,81625,2.4319630219719146,0.23716477322253537
14252,0.4353613053613053,0,1,0,343066,262544,26331,81625,2.431953758938827,0.23716546231647825
14253,0.4353809523809524,0,1,0,343067,262543,26331,81625,2.4319444959057392,0.2371661514144255
14254,0.4353846153846154,0,1,0,343068,262542,26331,81625,2.431935232872652,0.23716684051637724
14255,0.4353968253968254,0,1,0,343069,262541,26331,81625,2.4319259698395643,0.2371675296223334
14256,0.4354022366522367,0,3,0,343072,262538,26331,81625,2.4318981807403017,0.23716959696422915
14257,0.4354166666666666,0,1,0,343073,262537,26331,81625,2.431888917707214,0.23717028608620358
14258,0.4354166666666667,1,0,1,343073,262537,26332,81624,2.431888917707214,0.23716806959533474
14259,0.4354285714285715,0,1,0,343074,262536,26332,81624,2.4318796546741264,0.23716875871687587
14260,0.4354523809523809,1,0,1,343074,262536,26333,81623,2.4318796546741264,0.23716654220868844
14261,0.4354603174603175,0,1,0,343075,262535,26333,81623,2.431870391641039,0.2371672313297962
14262,0.4354761904761905,1,3,1,343078,262532,26334,81622,2.431842602541776,0.23716708217832713
14263,0.4355,5,17,5,343095,262515,26339,81617,2.4316851309792877,0.23716771471412132
14264,0.4355238095238095,0,1,0,343096,262514,26339,81617,2.4316758679462005,0.23716840389270366
14265,0.435547619047619,0,1,0,343097,262513,26339,81617,2.431666604913113,0.23716909307529133
14266,0.4355555555555556,1,3,1,343100,262510,26340,81616,2.43163881581385,0.23716894393332674
14267,0.4355952380952381,1,0,1,343100,262510,26341,81615,2.43163881581385,0.2371667272066836
14268,0.4356666666666666,6,29,6,343129,262481,26347,81609,2.431370187854311,0.2371734139324014
14269,0.4356666666666667,1,10,1,343139,262471,26348,81608,2.4312775575234356,0.23717808991539735
14270,0.4357121212121212,1,0,1,343139,262471,26349,81607,2.4312775575234356,0.23717587291253728
14271,0.4357142857142857,4,19,4,343158,262452,26353,81603,2.431101559894772,0.23718010201857262
14272,0.43575,0,1,0,343159,262451,26353,81603,2.4310922968616846,0.23718079138739848
14273,0.4357500000000001,0,1,0,343160,262450,26353,81603,2.431083033828597,0.2371814807602317
14274,0.4357575757575758,1,0,1,343160,262450,26354,81602,2.431083033828597,0.2371792635996884
14275,0.4357579365079364,1,0,1,343160,262450,26355,81601,2.431083033828597,0.23717704642625656
14276,0.4358095238095237,0,1,0,343161,262449,26355,81601,2.4310737707955092,0.23717773579421594
14277,0.4358095238095238,0,1,0,343162,262448,26355,81601,2.4310645077624216,0.23717842516618273
14278,0.4358160173160172,0,2,0,343164,262446,26355,81601,2.4310459816962466,0.23717980392213855
14279,0.4358333333333333,22,145,22,343309,262301,26377,81579,2.429702841898551,0.2372310108177271
14280,0.435845238095238,0,2,0,343311,262299,26377,81579,2.429684315832376,0.23723239055711617
14281,0.4358809523809523,0,1,0,343312,262298,26377,81579,2.4296750527992885,0.23723308043282917
14282,0.4358888888888889,0,1,0,343313,262297,26377,81579,2.429665789766201,0.23723377031255452
14283,0.4359015151515152,0,1,0,343314,262296,26377,81579,2.4296565267331136,0.23723446019629227
14284,0.4359523809523808,1,0,1,343314,262296,26378,81578,2.4296565267331136,0.23723224204214335
14285,0.4359523809523809,0,7,0,343321,262289,26378,81578,2.4295916855015007,0.237237071309547
14286,0.435952380952381,0,1,0,343322,262288,26378,81578,2.429582422468413,0.2372377612209407
14287,0.4359999999999999,1,7,1,343329,262281,26379,81577,2.4295175812368,0.2372403724793374
14288,0.436,11,136,11,343465,262145,26390,81566,2.428257808736893,0.2373098329701406
14289,0.4360000000000001,2,3,2,343468,262142,26392,81564,2.4282300196376303,0.2373074662647728
14290,0.4360238095238095,1,0,1,343468,262142,26393,81563,2.4282300196376303,0.23730524723236496
14291,0.436031746031746,1,0,1,343468,262142,26394,81562,2.4282300196376303,0.23730302818704466
14292,0.4360547785547786,1,1,1,343469,262141,26395,81561,2.4282207566045426,0.23730149955484692
14293,0.4360555555555555,0,1,0,343470,262140,26395,81561,2.428211493571455,0.23730218998489966
14294,0.4360714285714285,0,1,0,343471,262139,26395,81561,2.4282022305383677,0.23730288041897002
14295,0.4360714285714286,0,1,0,343472,262138,26395,81561,2.42819296750528,0.23730357085705805
14296,0.4360833333333333,0,1,0,343473,262137,26395,81561,2.4281837044721923,0.2373042612991638
14297,0.4360952380952381,0,3,0,343476,262134,26395,81561,2.4281559153729297,0.23730633264958756
14298,0.4361031746031745,0,3,0,343479,262131,26395,81561,2.428128126273667,0.23730840403617193
14299,0.4361111111111111,0,1,0,343480,262130,26395,81561,2.4281188632405795,0.23730909450640256
14300,0.4361309523809523,0,1,0,343481,262129,26395,81561,2.428109600207492,0.23730978498065117
14301,0.4361428571428571,0,1,0,343482,262128,26395,81561,2.4281003371744045,0.2373104754589178
14302,0.4361507936507936,0,2,0,343484,262126,26395,81561,2.428081811108229,0.23731185642750527
14303,0.4361666666666666,5,13,5,343497,262113,26400,81556,2.427961391678091,0.2373097369852969
14304,0.4361666666666667,0,4,0,343501,262109,26400,81556,2.427924339545741,0.23731249909068425
14305,0.4361904761904761,0,1,0,343502,262108,26400,81556,2.427915076512653,0.23731318962707762
14306,0.4361904761904762,0,2,0,343504,262106,26400,81556,2.4278965504464782,0.23731457071192044
14307,0.4361904761904763,0,2,0,343506,262104,26400,81556,2.427878024380303,0.23731595181283827
14308,0.4362222222222222,0,1,0,343507,262103,26400,81556,2.4278687613472156,0.2373166423693254
14309,0.4362380952380952,0,1,0,343508,262102,26400,81556,2.427859498314128,0.2373173329298314
14310,0.43625,3,6,3,343514,262096,26403,81553,2.4278039201156028,0.2373148183175275
14311,0.4362575757575757,0,2,0,343516,262094,26403,81553,2.4277853940494274,0.23731619947213273
14312,0.4363055555555555,0,1,0,343517,262093,26403,81553,2.42777613101634,0.23731689005546405
14313,0.4363333333333332,1,7,1,343524,262086,26404,81552,2.4277112897847273,0.2373195048277548
14314,0.4363333333333333,0,14,0,343538,262072,26404,81552,2.4275816073215015,0.23732917374805018
14315,0.4363333333333334,0,3,0,343541,262069,26404,81552,2.4275538182222385,0.23733124576204598
14316,0.4363571428571428,0,2,0,343543,262067,26404,81552,2.4275352921560636,0.23733262712480974
14317,0.4363571428571429,0,2,0,343545,262065,26404,81552,2.4275167660898886,0.23733400850365377
14318,0.4363809523809523,0,2,0,343547,262063,26404,81552,2.4274982400237133,0.23733538989857836
14319,0.4364047619047619,0,1,0,343548,262062,26404,81552,2.4274889769906256,0.23733608060207093
14320,0.4364166666666667,0,1,0,343549,262061,26404,81552,2.4274797139575384,0.23733677130958375
14321,0.4364285714285714,1,2,1,343551,262059,26405,81551,2.427461187891363,0.2373359331800588
14322,0.4364444444444444,0,3,0,343554,262056,26405,81551,2.4274333987921004,0.23733800533749314
14323,0.4364999999999999,0,4,0,343558,262052,26405,81551,2.42739634665975,0.23734076827035852
14324,0.4365,2,28,2,343586,262024,26407,81549,2.4271369817332986,0.2373556711383025
14325,0.4365476190476189,1,0,1,343586,262024,26408,81548,2.4271369817332986,0.23735345138719105
14326,0.4365476190476191,2,8,2,343594,262016,26410,81546,2.4270628774685985,0.23735453862767128
14327,0.4365555555555555,0,1,0,343595,262015,26410,81546,2.427053614435511,0.2373552294934524
14328,0.4365714285714285,0,1,0,343596,262014,26410,81546,2.427044351402423,0.2373559203632553
14329,0.4365714285714286,0,1,0,343597,262013,26410,81546,2.4270350883693355,0.2373566112370801
14330,0.4365833333333333,1,2,1,343599,262011,26411,81545,2.4270165623031605,0.2373557731490645
14331,0.4366190476190475,0,1,0,343600,262010,26411,81545,2.427007299270073,0.2373564640305046
14332,0.4366384448884448,0,6,0,343606,262004,26411,81545,2.4269517210715477,0.23736060940360765
14333,0.4366666666666666,60,419,60,344025,261585,26471,81485,2.4230705102078627,0.2375171247850293
14334,0.4366666666666667,50,315,50,344340,261270,26521,81435,2.4201526547852827,0.23762419573685822
14335,0.4367103174603175,0,3,0,344343,261267,26521,81435,2.42012486568602,0.23762627588984014
14336,0.4367142857142857,0,2,0,344345,261265,26521,81435,2.4201063396198452,0.23762766267872776
14337,0.4367499999999999,1,0,1,344345,261265,26522,81434,2.4201063396198452,0.23762543806664158
14338,0.4367857142857143,0,3,0,344348,261262,26522,81434,2.4200785505205826,0.23762751826691877
14339,0.4367857142857144,0,1,0,344349,261261,26522,81434,2.420069287487495,0.23762821167510467
14340,0.4368095238095238,0,1,0,344350,261260,26522,81434,2.4200600244544073,0.2376289050873374
14341,0.4368333333333333,1,29,1,344379,261231,26523,81433,2.419791396494868,0.2376467910256111
14342,0.4368571428571428,0,2,0,344381,261229,26523,81433,2.419772870428693,0.23764817808802843
14343,0.4368611111111111,0,3,0,344384,261226,26523,81433,2.4197450813294306,0.23765025871201398
14344,0.4369047619047619,0,3,0,344387,261223,26523,81433,2.419717292230168,0.23765233937243183
14345,0.4369112554112554,0,1,0,344388,261222,26523,81433,2.4197080291970803,0.23765303293400067
14346,0.4369166666666667,0,5,0,344393,261217,26523,81433,2.4196617140316423,0.23765650080256823
14347,0.4369285714285713,0,1,0,344394,261216,26523,81433,2.419652450998555,0.23765719438842664
14348,0.4369285714285714,0,2,0,344396,261214,26523,81433,2.4196339249323797,0.23765858157228867
14349,0.4369444444444444,0,1,0,344397,261213,26523,81433,2.4196246618992925,0.23765927517029237
14350,0.436952380952381,0,1,0,344398,261212,26523,81433,2.419615398866205,0.23765996877234455
14351,0.436974025974026,0,1,0,344399,261211,26523,81433,2.419606135833117,0.23766066237844527
14352,0.4369761904761905,0,1,0,344400,261210,26523,81433,2.4195968728000294,0.23766135598859453
14353,0.4369999999999999,1,6,1,344406,261204,26524,81432,2.4195412946015042,0.23766329282387139
14354,0.437,5,43,5,344449,261161,26529,81427,2.4191429841787393,0.23768199703433862
14355,0.4370238095238095,0,2,0,344451,261159,26529,81427,2.4191244581125644,0.23768338460999575
14356,0.437047619047619,0,1,0,344452,261158,26529,81427,2.4191151950794767,0.23768407840389977
14357,0.4370476190476191,0,1,0,344453,261157,26529,81427,2.4191059320463895,0.23768477220185413
14358,0.4370555555555555,0,1,0,344454,261156,26529,81427,2.419096669013302,0.23768546600385893
14359,0.4370833333333332,0,2,0,344456,261154,26529,81427,2.4190781429471264,0.2376868536200198
14360,0.4370833333333334,0,2,0,344458,261152,26529,81427,2.4190596168809515,0.23768824125238266
14361,0.4371150793650794,0,1,0,344459,261151,26529,81427,2.419050353847864,0.23768893507463992
14362,0.4371190476190477,1,1,1,344460,261150,26530,81426,2.4190410908147766,0.23768740367101024
14363,0.437142857142857,0,2,0,344462,261148,26530,81426,2.4190225647486012,0.2376887913268374
14364,0.4371428571428571,4,12,4,344474,261136,26534,81422,2.418911408351551,0.2376882163020569
14365,0.4371666666666666,0,2,0,344476,261134,26534,81422,2.4188928822853755,0.23768960403554457
14366,0.4371666666666667,0,9,0,344485,261125,26534,81422,2.4188095149875877,0.23769584903677451
14367,0.4372142857142858,0,1,0,344486,261124,26534,81422,2.4188002519545,0.23769654294605688
14368,0.4372222222222223,0,1,0,344487,261123,26534,81422,2.4187909889214123,0.23769723685939073
14369,0.4373035714285714,1,0,1,344487,261123,26535,81421,2.4187909889214123,0.23769501144378533
14370,0.4373333333333333,6,52,6,344539,261071,26541,81415,2.4183093112008596,0.23771774612684898
14371,0.4373571428571429,0,1,0,344540,261070,26541,81415,2.418300048167772,0.23771844022365943
14372,0.4373636363636363,0,1,0,344541,261069,26541,81415,2.4182907851346847,0.23771913432452318
14373,0.4373809523809523,0,1,0,344542,261068,26541,81415,2.418281522101597,0.23771982842944028
14374,0.4373809523809524,0,4,0,344546,261064,26541,81415,2.4182444699692467,0.23772260488964286
14375,0.4374047619047618,0,2,0,344548,261062,26541,81415,2.4182259439030718,0.23772399314406514
14376,0.4374047619047619,0,1,0,344549,261061,26541,81415,2.418216680869984,0.23772468727735666
14377,0.4374444444444444,1,0,1,344549,261061,26542,81414,2.418216680869984,0.23772246149353968
14378,0.4374642857142857,1,0,1,344549,261061,26543,81413,2.418216680869984,0.23772023569672443
14379,0.4374999999999999,1,14,1,344563,261047,26544,81412,2.4180869984067583,0.23772772799079597
14380,0.4375,50,384,50,344947,260663,26594,81362,2.4145299937011373,0.23788319567283092
14381,0.4375595238095238,0,1,0,344948,260662,26594,81362,2.41452073066805,0.23788389118892242
14382,0.4375714285714285,0,1,0,344949,260661,26594,81362,2.4145114676349624,0.23788458670908097
14383,0.4375833333333334,0,1,0,344950,260660,26594,81362,2.4145022046018747,0.23788528223330663
14384,0.4376190476190476,0,4,0,344954,260656,26594,81362,2.4144651524695244,0.23788806437088106
14385,0.4376190476190477,2,4,2,344958,260652,26596,81360,2.4144281003371746,0.2378863899512298
14386,0.4376666666666666,1,33,1,344991,260619,26597,81359,2.414122420245285,0.2379071168320769
14387,0.4376666666666667,4,9,4,345000,260610,26601,81355,2.4140390529474973,0.237904463907125
14388,0.4376730769230769,1,0,1,345000,260610,26602,81354,2.4140390529474973,0.23790223532301646
14389,0.4376904761904761,0,1,0,345001,260609,26602,81354,2.4140297899144096,0.2379029310188529
14390,0.4377142857142857,1,2,1,345003,260607,26603,81353,2.4140112638482343,0.23790209381214178
14391,0.4377261904761906,0,1,0,345004,260606,26603,81353,2.414002000815147,0.23790278951570218
14392,0.4377380952380952,1,1,1,345005,260605,26604,81352,2.4139927377820594,0.23790125659074093
14393,0.4377698412698412,0,1,0,345006,260604,26604,81352,2.4139834747489717,0.23790195229795646
14394,0.4377777777777777,0,1,0,345007,260603,26604,81352,2.4139742117158844,0.237902648009241
14395,0.4378095238095238,0,2,0,345009,260601,26604,81352,2.413955685649709,0.23790403944401717
14396,0.4378189033189032,0,1,0,345010,260600,26604,81352,2.4139464226166214,0.2379047351675089
14397,0.4378333333333332,0,1,0,345011,260599,26604,81352,2.413937159583534,0.23790543089506977
14398,0.4378333333333333,0,7,0,345018,260592,26604,81352,2.4138723183519213,0.2379103011019348
14399,0.4378333333333334,2,7,2,345025,260585,26606,81350,2.4138074771203084,0.23791071402459532
14400,0.4378571428571428,2,7,2,345032,260578,26608,81348,2.4137426358886955,0.2379111269689933
14401,0.4379047619047619,0,1,0,345033,260577,26608,81348,2.413733372855608,0.2379118227681509
14402,0.4379155844155843,0,1,0,345034,260576,26608,81348,2.41372410982252,0.23791251857137843
14403,0.4379166666666666,0,1,0,345035,260575,26608,81348,2.413714846789433,0.2379132143786759
14404,0.4379166666666667,0,3,0,345038,260572,26608,81348,2.41368705769017,0.2379153018249883
14405,0.4379761904761904,1,2,1,345040,260570,26609,81347,2.413668531623995,0.23791446462153096
14406,0.4379761904761905,0,1,0,345041,260569,26609,81347,2.4136592685909073,0.2379151604487652
14407,0.4379999999999999,14,104,14,345145,260465,26623,81333,2.412695913149802,0.23795633678371436
14408,0.438,1,6,1,345151,260459,26624,81332,2.4126403349512766,0.23795828444868355
14409,0.4380357142857143,0,2,0,345153,260457,26624,81332,2.4126218088851012,0.23795967687666952
14410,0.438047619047619,0,3,0,345156,260454,26624,81332,2.4125940197858387,0.2379617655492033
14411,0.438079365079365,0,2,0,345158,260452,26624,81332,2.4125754937196637,0.23796315801792944
14412,0.4380952380952381,0,5,0,345163,260447,26624,81332,2.4125291785542258,0.23796663926104294
14413,0.4381017316017316,0,1,0,345164,260446,26624,81332,2.412519915521138,0.23796733552188848
14414,0.4381428571428571,0,3,0,345167,260443,26624,81332,2.4124921264218755,0.23796942432887133
14415,0.4381666666666666,3,17,3,345184,260426,26627,81329,2.412334654859387,0.23797457242761627
14416,0.4381666666666667,0,4,0,345188,260422,26627,81329,2.412297602727037,0.2379773577838836
14417,0.4381746031746031,0,1,0,345189,260421,26627,81329,2.412288339693949,0.23797805413313827
14418,0.4381904761904762,0,5,0,345194,260416,26627,81329,2.4122420245285117,0.23798153594054047
14419,0.4382142857142856,0,2,0,345196,260414,26627,81329,2.4122234984623363,0.2379829286920288
14420,0.4382380952380952,0,1,0,345197,260413,26627,81329,2.412214235429249,0.23798362507388615
14421,0.4382499999999998,0,4,0,345201,260409,26627,81329,2.412177183296899,0.23798641064207082
14422,0.43825,0,1,0,345202,260408,26627,81329,2.412167920263811,0.237987107044306
14423,0.4382857142857143,0,1,0,345203,260407,26627,81329,2.4121586572307234,0.23798780345061685
14424,0.4383085248085248,0,1,0,345204,260406,26627,81329,2.412149394197636,0.2379884998610034
14425,0.4383333333333333,65,480,65,345684,259926,26692,81264,2.4077031383156102,0.2381781412116416
14426,0.4383492063492064,2,1,2,345685,259925,26694,81262,2.4076938752825225,0.23817437358398766
14427,0.4383507326007325,0,2,0,345687,259923,26694,81262,2.407675349216347,0.23817576974368745
14428,0.4383809523809523,0,1,0,345688,259922,26694,81262,2.40766608618326,0.23817646782967547
14429,0.4383809523809524,0,1,0,345689,259921,26694,81262,2.4076568231501723,0.23817716591975568
14430,0.4384047619047619,0,1,0,345690,259920,26694,81262,2.4076475601170846,0.23817786401392804
14431,0.4384285714285715,0,1,0,345691,259919,26694,81262,2.4076382970839973,0.23817856211219265
14432,0.4384318181818182,0,1,0,345692,259918,26694,81262,2.4076290340509097,0.2381792602145495
14433,0.4384523809523809,0,1,0,345693,259917,26694,81262,2.407619771017822,0.23817995832099864
14434,0.4384761904761904,0,2,0,345695,259915,26694,81262,2.407601244951647,0.23818135454617398
14435,0.4384999999999999,1,3,1,345698,259912,26695,81261,2.4075734558523845,0.238181215981335
14436,0.4385,7,26,7,345724,259886,26702,81254,2.407332616992108,0.23818373688221844
14437,0.438531746031746,0,1,0,345725,259885,26702,81254,2.40732335395902,0.23818443508364626
14438,0.438547619047619,1,0,1,345725,259885,26703,81253,2.40732335395902,0.238182201924148
14439,0.4385714285714285,0,1,0,345726,259884,26703,81253,2.407314090925933,0.23818290012516966
14440,0.4385714285714286,3,6,3,345732,259878,26706,81250,2.4072585127274073,0.23818038976571845
14441,0.4385833333333333,0,2,0,345734,259876,26706,81250,2.4072399866612324,0.23818178620216576
14442,0.4386428571428572,0,1,0,345735,259875,26706,81250,2.4072307236281447,0.23818248442652987
14443,0.4386515151515152,0,1,0,345736,259874,26706,81250,2.407221460595057,0.23818318265498764
14444,0.4386666666666666,3,32,3,345768,259842,26709,81247,2.4069250435362557,0.2381988278719044
14445,0.4386666666666667,0,5,0,345773,259837,26709,81247,2.4068787283708177,0.23820231966319147
14446,0.4386904761904761,0,2,0,345775,259835,26709,81247,2.406860202304643,0.238203716408371
14447,0.4386904761904762,0,1,0,345776,259834,26709,81247,2.406850939271555,0.23820441478710336
14448,0.4387142857142856,0,2,0,345778,259832,26709,81247,2.4068324132053798,0.2382058115568534
14449,0.4387222222222222,0,2,0,345780,259830,26709,81247,2.406813887139205,0.23820720834298414
14450,0.43875,1,7,1,345787,259823,26710,81246,2.406749045907592,0.23820986369327027
14451,0.4387619047619047,0,1,0,345788,259822,26710,81246,2.4067397828745043,0.23821056211664537
14452,0.4387896825396825,0,4,0,345792,259818,26710,81246,2.406702730742154,0.23821335585110126
14453,0.4388095238095238,0,2,0,345794,259816,26710,81246,2.406684204675979,0.23821475274290305
14454,0.4388333333333332,0,2,0,345796,259814,26710,81246,2.406665678609804,0.23821614965108778
14455,0.4388333333333333,1,11,1,345807,259803,26711,81245,2.406563785245841,0.23822159930566958
14456,0.4388333333333334,1,3,1,345810,259800,26712,81244,2.4065359961465784,0.23822146116043677
14457,0.4388571428571428,0,1,0,345811,259799,26712,81244,2.4065267331134907,0.23822215966901533
14458,0.438904761904762,1,0,1,345811,259799,26713,81243,2.4065267331134907,0.23821992599152012
14459,0.4389285714285714,0,2,0,345813,259797,26713,81243,2.4065082070473154,0.23822132301196342
14460,0.4389393939393939,0,1,0,345814,259796,26713,81243,2.406498944014228,0.2382220215283296
14461,0.4389999999999999,1,2,1,345816,259794,26714,81242,2.406480417948053,0.23822118486024935
14462,0.439,6,86,6,345902,259708,26720,81236,2.4056837971025233,0.2382678680369797
14463,0.4390476190476189,0,1,0,345903,259707,26720,81236,2.4056745340694357,0.23826856688654702
14464,0.4390476190476191,1,4,1,345907,259703,26721,81235,2.4056374819370854,0.2382691281112695
14465,0.4390555555555556,1,0,1,345907,259703,26722,81234,2.4056374819370854,0.23826689388362074
14466,0.4390833333333334,0,1,0,345908,259702,26722,81234,2.405628218903998,0.23826759274467935
14467,0.4391111111111111,0,1,0,345909,259701,26722,81234,2.4056189558709105,0.23826829160983765
14468,0.4391190476190476,0,2,0,345911,259699,26722,81234,2.405600429804735,0.2382696893524534
14469,0.4391428571428571,0,1,0,345912,259698,26722,81234,2.405591166771648,0.23827038822991095
14470,0.4391666666666666,8,84,8,345996,259614,26730,81226,2.4048130719922933,0.23831123107616478
14471,0.4391666666666667,11,69,11,346065,259545,26741,81215,2.404173922709252,0.23833489846226083
14472,0.4391774891774891,0,1,0,346066,259544,26741,81215,2.4041646596761646,0.2383355978858959
14473,0.4391904761904762,1,0,1,346066,259544,26742,81214,2.4041646596761646,0.23833336267967298
14474,0.4391944444444444,0,1,0,346067,259543,26742,81214,2.404155396643077,0.23833406210290617
14475,0.4392619047619046,0,1,0,346068,259542,26742,81214,2.404146133609989,0.23833476153024452
14476,0.4392692307692307,0,1,0,346069,259541,26742,81214,2.4041368705769015,0.238335460961688
14477,0.4392727272727272,1,2,1,346071,259539,26743,81213,2.4041183445107266,0.2383346245950134
14478,0.4392857142857143,1,4,1,346075,259535,26744,81212,2.4040812923783763,0.2383351871036282
14479,0.4392857142857144,0,1,0,346076,259534,26744,81212,2.4040720293452886,0.23833588655479448
14480,0.4393333333333333,11,58,11,346134,259476,26755,81201,2.4035347734262107,0.23835186995306404
14481,0.4393333333333334,0,1,0,346135,259475,26755,81201,2.403525510393123,0.23835256959691906
14482,0.4393571428571428,1,2,1,346137,259473,26756,81200,2.403506984326948,0.2383517331869564
14483,0.4393730158730159,0,1,0,346138,259472,26756,81200,2.4034977212938604,0.23835243283862484
14484,0.4393888888888889,0,1,0,346139,259471,26756,81200,2.4034884582607727,0.23835313249440077
14485,0.4394166666666666,0,2,0,346141,259469,26756,81200,2.403469932194598,0.2383545318182752
14486,0.439452380952381,0,1,0,346142,259468,26756,81200,2.40346066916151,0.23835523148637383
14487,0.4394761904761904,0,1,0,346143,259467,26756,81200,2.403451406128423,0.2383559311585801
14488,0.4394999999999999,1,2,1,346145,259465,26757,81199,2.4034328800622475,0.23835509475612335
14489,0.4395,3,18,3,346163,259447,26760,81196,2.4032661454666715,0.23836098202517006
14490,0.4395238095238095,0,3,0,346166,259444,26760,81196,2.403238356367409,0.23836308125880695
14491,0.4395584415584416,0,1,0,346167,259443,26760,81196,2.403229093334321,0.23836378101156944
14492,0.4395714285714285,0,1,0,346168,259442,26760,81196,2.403219830301234,0.23836448076844038
14493,0.4395833333333332,0,2,0,346170,259440,26760,81196,2.4032013042350586,0.23836588029450792
14494,0.4395833333333334,0,1,0,346171,259439,26760,81196,2.4031920412019714,0.23836658006370456
14495,0.4395952380952381,1,0,1,346171,259439,26761,81195,2.4031920412019714,0.2383643441347605
14496,0.4396428571428571,1,0,1,346171,259439,26762,81194,2.4031920412019714,0.23836210819268833
14497,0.4396666666666666,0,14,0,346185,259425,26762,81194,2.4030623587387456,0.2383719052665882
14498,0.4396666666666667,2,27,2,346212,259398,26764,81192,2.4028122568453814,0.2383863296045098
14499,0.4396904761904762,0,2,0,346214,259396,26764,81192,2.4027937307792064,0.23838772945611708
14500,0.4396969696969697,0,1,0,346215,259395,26764,81192,2.4027844677461188,0.23838842938808585
14501,0.4396984126984127,0,2,0,346217,259393,26764,81192,2.402765941679944,0.23838982926435398
14502,0.4397142857142857,0,1,0,346218,259392,26764,81192,2.402756678646856,0.23839052920865336
14503,0.4397222222222222,0,1,0,346219,259391,26764,81192,2.4027474156137685,0.23839122915706304
14504,0.4397539682539683,0,2,0,346221,259389,26764,81192,2.4027288895475936,0.23839262906621334
14505,0.4397619047619048,0,1,0,346222,259388,26764,81192,2.402719626514506,0.238393329026954
14506,0.4397777777777778,0,1,0,346223,259387,26764,81192,2.402710363481418,0.23839402899180512
14507,0.4397857142857143,0,2,0,346225,259385,26764,81192,2.4026918374152433,0.23839542893383875
14508,0.4398090798090799,1,2,1,346227,259383,26765,81191,2.402673311349068,0.23839459265827692
14509,0.4398333333333333,1,16,1,346243,259367,26766,81190,2.4025251028196672,0.2384035565265139
14510,0.4398571428571429,0,1,0,346244,259366,26766,81190,2.4025158397865796,0.23840425656867006
14511,0.4398787878787877,0,1,0,346245,259365,26766,81190,2.4025065767534923,0.23840495661493738
14512,0.4398809523809523,0,1,0,346246,259364,26766,81190,2.4024973137204046,0.23840565666531593
14513,0.4398809523809524,0,2,0,346248,259362,26766,81190,2.4024787876542293,0.23840705677840682
14514,0.4399126984126983,0,1,0,346249,259361,26766,81190,2.402469524621142,0.23840775684111926
14515,0.4399642857142857,0,1,0,346250,259360,26766,81190,2.4024602615880544,0.23840845690794304
14516,0.4399999999999999,4,28,4,346278,259332,26770,81186,2.402200896661603,0.23841911440804892
14517,0.44,449,3437,449,349715,255895,27219,80737,2.370363851939679,0.23983756743268614
14518,0.4400436507936507,0,2,0,349717,255893,27219,80737,2.370345325873504,0.23983899236550515
14519,0.4400476190476191,0,2,0,349719,255891,27219,80737,2.3703267998073287,0.23984041731525602
14520,0.4400952380952381,1,0,1,349719,255891,27220,80736,2.3703267998073287,0.23983815914944434
14521,0.4401190476190477,0,1,0,349720,255890,27220,80736,2.3703175367742415,0.23983887162607762
14522,0.4401666666666666,5,14,5,349734,255876,27225,80731,2.3701878543110158,0.23983755536872375
14523,0.4401666666666667,0,1,0,349735,255875,27225,80731,2.370178591277928,0.23983826788589627
14524,0.4402142857142857,0,1,0,349736,255874,27225,80731,2.3701693282448404,0.23983898040730234
14525,0.4402380952380952,0,5,0,349741,255869,27225,80731,2.370123013079403,0.2398425430778372
14526,0.44025,1,2,1,349743,255867,27226,80730,2.3701044870132275,0.2398417098191606
14527,0.4402738095238094,0,3,0,349746,255864,27226,80730,2.370076697913965,0.23984384748391238
14528,0.4402777777777777,0,2,0,349748,255862,27226,80730,2.37005817184779,0.2398452726149166
14529,0.4402820512820512,1,0,1,349748,255862,27227,80729,2.37005817184779,0.23984301422200832
14530,0.4402857142857143,0,2,0,349750,255860,27227,80729,2.3700396457816146,0.2398444393607634
14531,0.4403095238095239,0,1,0,349751,255859,27227,80729,2.3700303827485274,0.23984515193649208
14532,0.4403333333333333,3,13,3,349764,255846,27230,80726,2.369909963318389,0.23984764032658687
14533,0.4403333333333334,1,7,1,349771,255839,27231,80725,2.369845122086776,0.2398503702119062
14534,0.4403571428571428,0,1,0,349772,255838,27231,80725,2.3698358590536883,0.23985108285818701
14535,0.4403636363636364,0,1,0,349773,255837,27231,80725,2.369826596020601,0.2398517955087027
14536,0.4403846153846154,0,1,0,349774,255836,27231,80725,2.3698173329875134,0.23985250816345327
14537,0.4403928571428571,0,1,0,349775,255835,27231,80725,2.3698080699544257,0.2398532208224388
14538,0.4404166666666665,0,1,0,349776,255834,27231,80725,2.3697988069213385,0.23985393348565928
14539,0.4404166666666666,1,1,1,349777,255833,27232,80724,2.369789543888251,0.23985238755990812
14540,0.4404166666666667,0,1,0,349778,255832,27232,80724,2.369780280855163,0.23985310022700532
14541,0.4404166666666668,0,1,0,349779,255831,27232,80724,2.3697710178220754,0.23985381289833757
14542,0.4404285714285714,0,1,0,349780,255830,27232,80724,2.369761754788988,0.23985452557390494
14543,0.4404444444444444,0,1,0,349781,255829,27232,80724,2.3697524917559005,0.23985523825370744
14544,0.4404761904761904,0,3,0,349784,255826,27232,80724,2.369724702656638,0.23985737631852622
14545,0.4404761904761905,1,5,1,349789,255821,27233,80723,2.3696783874912,0.2398586811828468
14546,0.4404999999999999,1,18,1,349807,255803,27234,80722,2.369511652895624,0.23986925191293365
14547,0.4405238095238095,0,1,0,349808,255802,27234,80722,2.3695023898625367,0.23986996469791158
14548,0.4405238095238096,0,1,0,349809,255801,27234,80722,2.369493126829449,0.2398706774871257
14549,0.4405476190476189,0,1,0,349810,255800,27234,80722,2.3694838637963613,0.239871390280576
14550,0.440547619047619,0,1,0,349811,255799,27234,80722,2.369474600763274,0.23987210307826257
14551,0.4405714285714285,1,3,1,349814,255796,27235,80721,2.369446811664011,0.23987198269329632
14552,0.4405833333333334,0,1,0,349815,255795,27235,80721,2.369437548630924,0.23987269550333418
14553,0.4406375291375292,0,3,0,349818,255792,27235,80721,2.369409759531661,0.23987483395886638
14554,0.4406428571428571,0,3,0,349821,255789,27235,80721,2.369381970432398,0.23987697245252743
14555,0.4406517094017095,0,1,0,349822,255788,27235,80721,2.369372707399311,0.239877685292221
14556,0.4406666666666666,3,41,3,349863,255747,27238,80718,2.368992923042721,0.239900138201596
14557,0.4406666666666667,1,17,1,349880,255730,27239,80717,2.3688354514802326,0.23991000068361437
14558,0.4406785714285713,0,2,0,349882,255728,27239,80717,2.3688169254140576,0.23991142683053693
14559,0.4406923076923077,0,1,0,349883,255727,27239,80717,2.36880766238097,0.23991213991035656
14560,0.4407023809523809,0,1,0,349884,255726,27239,80717,2.3687983993478823,0.2399128529944151
14561,0.4407142857142856,1,10,1,349894,255716,27240,80716,2.368705769017007,0.2399177248299805
14562,0.4407142857142858,1,1,1,349895,255715,27241,80715,2.3686965059839196,0.23991617869987814
14563,0.4407222222222223,0,4,0,349899,255711,27241,80715,2.3686594538515693,0.23991903122826416
14564,0.4407380952380952,0,1,0,349900,255710,27241,80715,2.3686501908184816,0.23991974437095936
14565,0.4407619047619047,0,1,0,349901,255709,27241,80715,2.368640927785394,0.2399204575178941
14566,0.4408333333333333,23,143,23,350044,255566,27264,80692,2.3673163140538738,0.2399704988431502
14567,0.4408571428571428,0,1,0,350045,255565,27264,80692,2.367307051020786,0.23997121249520456
14568,0.4408571428571429,0,2,0,350047,255563,27264,80692,2.367288524954611,0.23997263981204742
14569,0.4408809523809524,1,1,1,350048,255562,27265,80691,2.3672792619215235,0.23997109319470755
14570,0.4409047619047618,0,1,0,350049,255561,27265,80691,2.367269998888436,0.23997180685914135
14571,0.4409523809523809,0,4,0,350053,255557,27265,80691,2.367232946756086,0.23997466155932526
14572,0.440952380952381,0,3,0,350056,255554,27265,80691,2.367205157656823,0.23997680262903537
14573,0.4409999999999999,2,8,2,350064,255546,27267,80689,2.367131053392123,0.23997799158326766
14574,0.441,7,82,7,350146,255464,27274,80682,2.366371484678943,0.24002070528877334
14575,0.4410238095238095,0,2,0,350148,255462,27274,80682,2.3663529586127683,0.24002213337141226
14576,0.4410277777777778,1,0,1,350148,255462,27275,80681,2.3663529586127683,0.24001987249474183
14577,0.4411111111111111,0,4,0,350152,255458,27275,80681,2.366315906480418,0.24002272869259444
14578,0.4411360028860029,0,1,0,350153,255457,27275,80681,2.3663066434473303,0.24002344275267895
14579,0.4411428571428571,1,3,1,350156,255454,27276,80680,2.3662788543480677,0.24002332403148743
14580,0.4411666666666666,1,14,1,350170,255440,27277,80679,2.366149171884842,0.24003106042800318
14581,0.4411666666666667,0,1,0,350171,255439,27277,80679,2.3661399088517543,0.24003177455536448
14582,0.4411774891774891,0,1,0,350172,255438,27277,80679,2.366130645818667,0.24003248868697508
14583,0.4411904761904762,1,8,1,350180,255430,27278,80678,2.3660565415539665,0.2400359408285432
14584,0.4412380952380952,0,1,0,350181,255429,27278,80678,2.366047278520879,0.24003665499379662
14585,0.44125,0,6,0,350187,255423,27278,80678,2.3659917003223536,0.24004094007456092
14586,0.4412619047619047,0,1,0,350188,255422,27278,80678,2.365982437289266,0.24004165426956264
14587,0.4412698412698412,0,1,0,350189,255421,27278,80678,2.3659731742561783,0.24004236846881424
14588,0.4412857142857143,0,1,0,350190,255420,27278,80678,2.365963911223091,0.2400430826723158
14589,0.441297619047619,0,1,0,350191,255419,27278,80678,2.3659546481900033,0.24004379688006736
14590,0.4413095238095238,1,3,1,350194,255416,27279,80677,2.3659268590907407,0.24004367838663704
14591,0.4413333333333332,1,2,1,350196,255414,27280,80676,2.3659083330245654,0.24004284566633938
14592,0.4413333333333333,5,19,5,350215,255395,27285,80671,2.365732335395902,0.24004511018668953
14593,0.4413333333333334,0,5,0,350220,255390,27285,80671,2.365686020230464,0.240048681638155
14594,0.4413809523809523,0,1,0,350221,255389,27285,80671,2.365676757197377,0.24004939594120098
14595,0.4413809523809524,0,1,0,350222,255388,27285,80671,2.3656674941642892,0.24005011024849804
14596,0.4413888888888888,0,1,0,350223,255387,27285,80671,2.3656582311312015,0.24005082456004617
14597,0.4413888888888889,0,2,0,350225,255385,27285,80671,2.3656397050650266,0.24005225319589593
14598,0.4414285714285714,2,7,2,350232,255378,27287,80669,2.3655748638334138,0.24005273071921487
14599,0.4414285714285715,0,2,0,350234,255376,27287,80669,2.3655563377672384,0.24005415941317382
14600,0.4414880952380952,1,0,1,350234,255376,27288,80668,2.3655563377672384,0.24005189796574258
14601,0.4415,4,34,4,350268,255342,27292,80664,2.3652413946422617,0.24006714165818469
14602,0.4415407647907649,0,3,0,350271,255339,27292,80664,2.365213605542999,0.2400692850956688
14603,0.4415476190476191,0,2,0,350273,255337,27292,80664,2.3651950794768237,0.24007071407525574
14604,0.4415833333333333,0,1,0,350274,255336,27292,80664,2.3651858164437365,0.24007142857142857
14605,0.4415952380952381,0,2,0,350276,255334,27292,80664,2.365167290377561,0.24007285757653318
14606,0.4416111111111111,0,2,0,350278,255332,27292,80664,2.365148764311386,0.24007428659865
14607,0.4416428571428571,0,1,0,350279,255331,27292,80664,2.3651395012782985,0.24007500111608804
14608,0.4416666666666666,39,232,39,350511,255099,27331,80625,2.362990477601986,0.24015262537084034
14609,0.4416666666666667,25,168,25,350679,254931,27356,80600,2.361434288043277,0.2402162542358232
14610,0.4417142857142857,1,0,1,350679,254931,27357,80599,2.361434288043277,0.24021398980717074
14611,0.4417619047619048,0,1,0,350680,254930,27357,80599,2.361425025010189,0.24021470573333453
14612,0.4417857142857143,0,4,0,350684,254926,27357,80599,2.3613879728778393,0.24021756948066464
14613,0.4417976190476191,0,1,0,350685,254925,27357,80599,2.3613787098447516,0.2402182854281661
14614,0.4418095238095237,0,1,0,350686,254924,27357,80599,2.361369446811664,0.2402190013799352
14615,0.4418333333333333,1,22,1,350708,254902,27358,80598,2.3611656600837376,0.24023248882265275
14616,0.4418362193362193,0,1,0,350709,254901,27358,80598,2.3611563970506504,0.24023320486797278
14617,0.4418571428571428,0,1,0,350710,254900,27358,80598,2.3611471340175627,0.24023392091756135
14618,0.4418571428571429,0,1,0,350711,254899,27358,80598,2.361137870984475,0.24023463697141853
14619,0.4418611111111111,0,1,0,350712,254898,27358,80598,2.361128607951388,0.24023535302954432
14620,0.4419047619047619,0,3,0,350715,254895,27358,80598,2.3611008188521247,0.24023750122953386
14621,0.4419166666666666,0,1,0,350716,254894,27358,80598,2.3610915558190375,0.24023821730473455
14622,0.4419772727272727,0,2,0,350718,254892,27358,80598,2.361073029752862,0.2402396494679424
14623,0.4419999999999999,0,5,0,350723,254887,27358,80598,2.3610267145874246,0.24024322995066844
14624,0.442,8,86,8,350809,254801,27366,80590,2.3602300937418947,0.24028671013831618
14625,0.4420238095238095,0,2,0,350811,254799,27366,80590,2.36021156767572,0.24028814302198342
14626,0.4420238095238096,0,1,0,350812,254798,27366,80590,2.360202304642632,0.24028885947022552
14627,0.442063492063492,0,1,0,350813,254797,27366,80590,2.3601930416095445,0.24028957592274
14628,0.4420833333333333,0,3,0,350816,254794,27366,80590,2.360165252510282,0.240291725305918
14629,0.4420833333333334,1,0,1,350816,254794,27367,80589,2.360165252510282,0.24028946010978494
14630,0.4420952380952381,0,1,0,350817,254793,27367,80589,2.3601559894771946,0.24029017657477145
14631,0.4421428571428571,1,6,1,350823,254787,27368,80588,2.360100411278669,0.24029221021244876
14632,0.4421666666666666,1,1,1,350824,254786,27369,80587,2.3600911482455817,0.24029066144263253
14633,0.4421666666666667,0,5,0,350829,254781,27369,80587,2.360044833080144,0.24029424393502063
14634,0.442170634920635,0,4,0,350833,254777,27369,80587,2.3600077809477935,0.2402971100058444
14635,0.4422142857142857,1,0,1,350833,254777,27370,80586,2.3600077809477935,0.24029484469067847
14636,0.4422222222222221,0,1,0,350834,254776,27370,80586,2.359998517914706,0.24029556121444887
14637,0.4422222222222222,0,1,0,350835,254775,27370,80586,2.3599892548816186,0.24029627774249243
14638,0.44225,0,1,0,350836,254774,27370,80586,2.359979991848531,0.24029699427480916
14639,0.4422777777777779,1,0,1,350836,254774,27371,80585,2.359979991848531,0.24029472893227855
14640,0.4423203463203463,0,1,0,350837,254773,27371,80585,2.3599707288154432,0.24029544546425013
14641,0.4423333333333332,2,8,2,350845,254765,27373,80583,2.359896624550743,0.2402966470651383
14642,0.4423333333333333,1,36,1,350881,254729,27374,80582,2.359563155359591,0.24032018036986558
14643,0.4423809523809523,0,4,0,350885,254725,27374,80582,2.3595261032272408,0.2403230472373079
14644,0.4423809523809524,1,3,1,350888,254722,27375,80581,2.359498314127978,0.24032293179601733
14645,0.4423906926406926,0,1,0,350889,254721,27375,80581,2.3594890510948905,0.24032364853177135
14646,0.4424007936507936,0,1,0,350890,254720,27375,80581,2.359479788061803,0.24032436527180057
14647,0.4424047619047618,0,1,0,350891,254719,27375,80581,2.3594705250287156,0.24032508201610497
14648,0.4424047619047619,0,1,0,350892,254718,27375,80581,2.359461261995628,0.24032579876468466
14649,0.4424523809523809,0,2,0,350894,254716,27375,80581,2.3594427359294525,0.24032723227466993
14650,0.442452380952381,0,1,0,350895,254715,27375,80581,2.3594334728963653,0.2403279490360756
14651,0.4424999999999999,1,8,1,350903,254707,27376,80580,2.3593593686316647,0.24033141756167103
14652,0.4425,42,364,42,351267,254343,27418,80538,2.355987624587795,0.24049737070780366
14653,0.4425248917748917,0,1,0,351268,254342,27418,80538,2.3559783615547074,0.2404980888676541
14654,0.4425357142857142,0,2,0,351270,254340,27418,80538,2.3559598354885325,0.24049952520022216
14655,0.4425476190476191,0,1,0,351271,254339,27418,80538,2.355950572455445,0.2405002433729399
14656,0.4425714285714285,0,1,0,351272,254338,27418,80538,2.355941309422357,0.24050096154994685
14657,0.4425833333333333,0,3,0,351275,254335,27418,80538,2.3559135203230945,0.24050311610670314
14658,0.4426071428571429,0,3,0,351278,254332,27418,80538,2.355885731223832,0.24050527070206348
14659,0.4426190476190475,0,2,0,351280,254330,27418,80538,2.355867205157657,0.2405067071204176
14660,0.4426190476190476,0,2,0,351282,254328,27418,80538,2.3558486790914817,0.24050814355592984
14661,0.4426190476190477,0,2,0,351284,254326,27418,80538,2.3558301530253067,0.2405095800086005
14662,0.4426666666666666,8,40,8,351324,254286,27426,80530,2.3554596317018044,0.2405201663002963
14663,0.4426666666666667,2,16,2,351340,254270,27428,80528,2.3553114231724037,0.24052712381794394
14664,0.442695589813237,2,4,2,351344,254266,27430,80526,2.3552743710400534,0.2405254605844823
14665,0.4427142857142857,0,1,0,351345,254265,27430,80526,2.3552651080069658,0.24052617901914927
14666,0.4427380952380952,1,3,1,351348,254262,27431,80525,2.355237318907703,0.24052606582692876
14667,0.44275,0,3,0,351351,254259,27431,80525,2.3552095298084406,0.24052822118141848
14668,0.4427539682539682,0,1,0,351352,254258,27431,80525,2.355200266775353,0.24052893964149913
14669,0.4427738095238095,0,1,0,351353,254257,27431,80525,2.355191003742265,0.24052965810587187
14670,0.4427777777777777,2,2,2,351355,254255,27433,80523,2.3551724776760903,0.24052655789806976
14671,0.4427777777777779,1,1,1,351356,254254,27434,80522,2.3551632146430026,0.24052500776638708
14672,0.4428095238095239,0,1,0,351357,254253,27434,80522,2.3551539516099154,0.24052572623403778
14673,0.4428214285714286,1,0,1,351357,254253,27435,80521,2.3551539516099154,0.24052345761618285
14674,0.4428333333333333,2,2,2,351359,254251,27437,80519,2.35513542554374,0.2405203572602085
14675,0.4428333333333334,0,2,0,351361,254249,27437,80519,2.355116899477565,0.24052179419777278
14676,0.4428571428571428,6,7,6,351368,254242,27443,80513,2.355052058245952,0.24051321115442637
14677,0.4428809523809524,0,1,0,351369,254241,27443,80513,2.3550427952128645,0.24051392963190882
14678,0.4428852813852814,0,1,0,351370,254240,27443,80513,2.355033532179777,0.2405146481136838
14679,0.4429166666666668,0,1,0,351371,254239,27443,80513,2.3550242691466896,0.24051536659975145
14680,0.4429285714285714,0,1,0,351372,254238,27443,80513,2.355015006113602,0.24051608509011174
14681,0.4429761904761905,1,4,1,351376,254234,27444,80512,2.3549779539812516,0.24051669026664993
14682,0.4429848484848485,0,2,0,351378,254232,27444,80512,2.3549594279150767,0.24051812728532848
14683,0.4429999999999999,10,57,10,351435,254175,27454,80502,2.354431435029086,0.2405363977805466
14684,0.443,1,5,1,351440,254170,27455,80501,2.354385119863648,0.24053772212112792
14685,0.4430079365079365,0,1,0,351441,254169,27455,80501,2.3543758568305604,0.24053844085218276
14686,0.4430238095238094,0,1,0,351442,254168,27455,80501,2.354366593797473,0.24053915958753275
14687,0.4430476190476189,0,1,0,351443,254167,27455,80501,2.3543573307643855,0.240539878327178
14688,0.443047619047619,0,2,0,351445,254165,27455,80501,2.3543388046982106,0.24054131581935423
14689,0.4430555555555556,0,1,0,351446,254164,27455,80501,2.354329541665123,0.2405420345718853
14690,0.4430714285714285,0,1,0,351447,254163,27455,80501,2.354320278632035,0.24054275332871178
14691,0.4430833333333334,0,2,0,351449,254161,27455,80501,2.3543017525658603,0.24054419085525097
14692,0.4431428571428571,0,1,0,351450,254160,27455,80501,2.3542924895327726,0.24054490962496378
14693,0.4431666666666666,1,10,1,351460,254150,27456,80500,2.354199859201897,0.24054982817869416
14694,0.4431666666666667,3,5,3,351465,254145,27459,80497,2.354153544036459,0.24054661399346167
14695,0.4431904761904761,1,0,1,351465,254145,27460,80496,2.354153544036459,0.24054434453638376
14696,0.4431944444444444,0,1,0,351466,254144,27460,80496,2.354144281003372,0.24054506335166148
14697,0.4432142857142856,1,11,1,351477,254133,27461,80495,2.3540423876394088,0.24055070107701687
14698,0.4432222222222222,0,1,0,351478,254132,27461,80495,2.354033124606321,0.24055141993921592
14699,0.4432380952380952,1,0,1,351478,254132,27462,80494,2.354033124606321,0.2405491503947691
14700,0.4432380952380953,1,0,1,351478,254132,27463,80493,2.354033124606321,0.24054688083675757
14701,0.4432857142857142,0,1,0,351479,254131,27463,80493,2.3540238615732334,0.2405475996939849
14702,0.4432857142857143,0,1,0,351480,254130,27463,80493,2.354014598540146,0.24054831855550873
14703,0.4433095238095239,0,1,0,351481,254129,27463,80493,2.3540053355070585,0.24054903742132913
14704,0.4433333333333333,102,765,102,352246,253364,27565,80391,2.3469191151950795,0.2408683015984779
14705,0.4433333333333334,0,1,0,352247,253363,27565,80391,2.3469098521619918,0.24086902329260473
14706,0.4433809523809524,0,1,0,352248,253362,27565,80391,2.3469005891289045,0.24086974499105626
14707,0.4434285714285713,0,1,0,352249,253361,27565,80391,2.346891326095817,0.24087046669383255
14708,0.4434365079365079,0,1,0,352250,253360,27565,80391,2.346882063062729,0.24087118840093363
14709,0.4434523809523809,1,4,1,352254,253356,27566,80390,2.346845010930379,0.24087180071072012
14710,0.4434761904761906,0,1,0,352255,253355,27566,80390,2.3468357478972917,0.24087252243479304
14711,0.4434999999999999,1,3,1,352258,253352,27567,80389,2.3468079587980286,0.24087241303885348
14712,0.4435,7,22,7,352280,253330,27574,80382,2.3466041720701027,0.2408723689888287
14713,0.4435238095238096,0,2,0,352282,253328,27574,80382,2.3465856460039274,0.2408738125917713
14714,0.4435714285714285,0,3,0,352285,253325,27574,80382,2.346557856904665,0.2408759780286299
14715,0.4435714285714286,1,6,1,352291,253319,27575,80381,2.3465022787061396,0.24087803416242135
14716,0.4436428571428572,0,1,0,352292,253318,27575,80381,2.346493015673052,0.24087875600466288
14717,0.4436666666666666,2,19,2,352311,253299,27577,80379,2.3463170180443886,0.240887921888767
14718,0.4436666666666667,0,2,0,352313,253297,27577,80379,2.3462984919782133,0.2408893657320275
14719,0.4436904761904762,0,1,0,352314,253296,27577,80379,2.3462892289451256,0.24089008766014836
14720,0.4437142857142856,0,1,0,352315,253295,27577,80379,2.3462799659120384,0.24089080959259637
14721,0.4437142857142857,1,1,1,352316,253294,27578,80378,2.3462707028789507,0.24088925651538037
14722,0.4437261904761904,0,1,0,352317,253293,27578,80378,2.346261439845863,0.2408899784518283
14723,0.4437380952380952,0,1,0,352318,253292,27578,80378,2.3462521768127758,0.24089070039260346
14724,0.4437499999999999,0,1,0,352319,253291,27578,80378,2.346242913779688,0.24089142233770594
14725,0.44375,1,7,1,352326,253284,27579,80377,2.346178072548075,0.24089420100041659
14726,0.4437619047619048,0,1,0,352327,253283,27579,80377,2.3461688095149875,0.24089492297548404
14727,0.4437857142857143,0,3,0,352330,253280,27579,80377,2.346141020415725,0.2408970889266522
14728,0.4438095238095238,0,5,0,352335,253275,27579,80377,2.346094705250287,0.24090069893182117
14729,0.4438095238095239,0,4,0,352339,253271,27579,80377,2.346057653117937,0.24090358701385892
14730,0.4438156565656567,1,3,1,352342,253268,27580,80376,2.346029864018674,0.24090347795854264
14731,0.4438333333333332,3,4,3,352346,253264,27583,80373,2.3459928118863242,0.24089954051858756
14732,0.4438333333333333,1,8,1,352354,253256,27584,80372,2.3459187076216237,0.24090304171112736
14733,0.4438333333333334,1,0,1,352354,253256,27585,80371,2.3459187076216237,0.24090076642477976
14734,0.4438888888888888,0,3,0,352357,253253,27585,80371,2.345890918522361,0.24090293264273555
14735,0.4439166666666667,0,1,0,352358,253252,27585,80371,2.3458816554892734,0.2409036547240448
14736,0.4439404761904761,0,1,0,352359,253251,27585,80371,2.3458723924561857,0.24090437680968282
14737,0.4439523809523809,0,1,0,352360,253250,27585,80371,2.3458631294230985,0.2409050988996496
14738,0.4439761904761904,0,1,0,352361,253249,27585,80371,2.345853866390011,0.2409058209939452
14739,0.4439880952380952,2,0,2,352361,253249,27587,80369,2.345853866390011,0.24090127031515085
14740,0.443998556998557,0,2,0,352363,253247,27587,80369,2.3458353403238354,0.2409027144981056
14741,0.444,15,150,15,352513,253097,27602,80354,2.3444458853607024,0.24097693514189492
14742,0.444047619047619,0,5,0,352518,253092,27602,80354,2.344399570195265,0.2409805485745818
14743,0.4440952380952381,0,1,0,352519,253091,27602,80354,2.3443903071621772,0.24098127127412317
14744,0.444111111111111,0,2,0,352521,253089,27602,80354,2.344371781096002,0.24098271668621024
14745,0.4441666666666666,14,70,14,352591,253019,27616,80340,2.343723368779873,0.24100144288889755
14746,0.4441666666666667,7,63,7,352654,252956,27623,80333,2.343139797695357,0.24103105713059836
14747,0.4442063492063491,0,1,0,352655,252955,27623,80333,2.34313053466227,0.2410317803221238
14748,0.44425,0,1,0,352656,252954,27623,80333,2.3431212716291823,0.241032503517989
14749,0.4442777777777777,0,1,0,352657,252953,27623,80333,2.3431120085960946,0.241033226718194
14750,0.4442857142857143,5,16,5,352673,252937,27628,80328,2.342963800066694,0.24103341184942914
14751,0.4443055555555555,0,1,0,352674,252936,27628,80328,2.3429545370336062,0.24103413510010083
14752,0.4443333333333333,8,31,8,352705,252905,27636,80320,2.342667383007892,0.2410383374596744
14753,0.4443452380952381,0,1,0,352706,252904,27636,80320,2.3426581199748044,0.24103906081194632
14754,0.4443650793650793,0,1,0,352707,252903,27636,80320,2.342648856941717,0.24103978416855978
14755,0.4443809523809524,0,1,0,352708,252902,27636,80320,2.3426395939086295,0.24104050752951486
14756,0.4444047619047619,0,1,0,352709,252901,27636,80320,2.342630330875542,0.24104123089481155
14757,0.4444285714285713,1,0,1,352709,252901,27637,80319,2.342630330875542,0.241038953244103
14758,0.4444444444444444,1,0,1,352709,252901,27638,80318,2.342630330875542,0.24103667557972386
14759,0.4444999999999999,0,6,0,352715,252895,27638,80318,2.3425747526770166,0.24104101580670623
14760,0.4445,2,11,2,352726,252884,27640,80316,2.3424728593130535,0.24104441776710683
14761,0.4445238095238095,1,7,1,352733,252877,27641,80315,2.3424080180814406,0.24104720401450214
14762,0.4445714285714285,1,2,1,352735,252875,27642,80314,2.3423894920152657,0.24104637307954344
14763,0.4445833333333333,1,4,1,352739,252871,27643,80313,2.3423524398829154,0.2410469890510949
14764,0.4446153846153846,0,1,0,352740,252870,27643,80313,2.3423431768498277,0.24104771251834578
14765,0.444642857142857,0,1,0,352741,252869,27643,80313,2.34233391381674,0.24104843598993944
14766,0.4446428571428572,0,3,0,352744,252866,27643,80313,2.3423061247174775,0.24105060643077744
14767,0.4446666666666666,2,8,2,352752,252858,27645,80311,2.342232020452777,0.2410518385564083
14768,0.4446666666666667,4,24,4,352776,252834,27649,80307,2.3420097076586757,0.24106009167289527
14769,0.4446915584415584,0,1,0,352777,252833,27649,80307,2.342000444625588,0.24106081527285825
14770,0.4447420634920636,0,1,0,352778,252832,27649,80307,2.3419911815925007,0.2410615388771654
14771,0.44475,0,4,0,352782,252828,27649,80307,2.3419541294601505,0.241064433337836
14772,0.4447500000000001,0,2,0,352784,252826,27649,80307,2.341935603393975,0.24106588059423714
14773,0.4447619047619047,1,5,1,352789,252821,27650,80306,2.3418892882285376,0.24106722060955732
14774,0.4447619047619048,0,5,0,352794,252816,27650,80306,2.3418429730630996,0.24107083891187012
14775,0.4447824675324676,0,1,0,352795,252815,27650,80306,2.3418337100300124,0.24107156258536688
14776,0.4448333333333332,0,2,0,352797,252813,27650,80306,2.341815183963837,0.24107300994539488
14777,0.4448333333333333,2,11,2,352808,252802,27652,80304,2.341713290599874,0.24107641411442604
14778,0.4448571428571428,0,2,0,352810,252800,27652,80304,2.341694764533699,0.2410778615687593
14779,0.4448809523809524,0,1,0,352811,252799,27652,80304,2.3416855015006113,0.241078585302444
14780,0.4448888888888889,0,1,0,352812,252798,27652,80304,2.3416762384675236,0.2410793090404741
14781,0.4449166666666666,0,4,0,352816,252794,27652,80304,2.3416391863351738,0.24108220403604946
14782,0.4449285714285715,0,2,0,352818,252792,27652,80304,2.3416206602689984,0.24108365155991066
14783,0.4449523809523809,0,1,0,352819,252791,27652,80304,2.3416113972359107,0.24108437532835977
14784,0.4449999999999998,0,1,0,352820,252790,27652,80304,2.3416021342028235,0.24108509910115464
14785,0.4449999999999999,1,20,1,352840,252770,27653,80303,2.341416873541072,0.24109729698894836
14786,0.445,200,1388,200,354228,251382,27853,80103,2.328559783615547,0.24164894339110368
14787,0.445030303030303,1,0,1,354228,251382,27854,80102,2.328559783615547,0.24164665564552135
14788,0.4450830590977649,0,2,0,354230,251380,27854,80102,2.328541257549372,0.2416481136230625
14789,0.4450833333333333,0,2,0,354232,251378,27854,80102,2.3285227314831967,0.24164957161819717
14790,0.4451190476190476,0,2,0,354234,251376,27854,80102,2.3285042054170217,0.24165102963092575
14791,0.4451428571428572,0,2,0,354236,251374,27854,80102,2.328485679350847,0.24165248766124847
14792,0.4451666666666666,1,13,1,354249,251361,27855,80101,2.3283652599207083,0.2416596774290869
14793,0.4451666666666667,0,5,0,354254,251356,27855,80101,2.328318944755271,0.2416633228442905
14794,0.4451904761904762,1,1,1,354255,251355,27856,80100,2.328309681722183,0.24166176404036746
14795,0.4452142857142858,0,1,0,354256,251354,27856,80100,2.3283004186890954,0.24166249313630248
14796,0.4452222222222222,1,0,1,354256,251354,27857,80099,2.3283004186890954,0.24166020521763268
14797,0.4452380952380952,0,1,0,354257,251353,27857,80099,2.328291155656008,0.24166093431326408
14798,0.44525,0,1,0,354258,251352,27857,80099,2.3282818926229205,0.24166166341329487
14799,0.4452619047619048,0,1,0,354259,251351,27857,80099,2.328272629589833,0.24166239251772514
14800,0.4452857142857142,0,1,0,354260,251350,27857,80099,2.328263366556745,0.24166312162655493
14801,0.4452857142857143,0,4,0,354264,251346,27857,80099,2.3282263144243953,0.24166603810586976
14802,0.4452898629148629,0,1,0,354265,251345,27857,80099,2.3282170513913076,0.2416667672366976
14803,0.4453333333333332,0,5,0,354270,251340,27857,80099,2.3281707362258697,0.2416704129568337
14804,0.4453333333333333,4,34,4,354304,251306,27861,80095,2.327855793100893,0.24168605405535892
14805,0.4453571428571428,0,2,0,354306,251304,27861,80095,2.327837267034718,0.2416875126358257
14806,0.4453571428571429,1,1,1,354307,251303,27862,80094,2.3278280040016304,0.24168595370507276
14807,0.445373015873016,0,1,0,354308,251302,27862,80094,2.3278187409685427,0.24168668300160534
14808,0.4453809523809524,1,1,1,354309,251301,27863,80093,2.327809477935455,0.24168512405173298
14809,0.4454047619047618,0,1,0,354310,251300,27863,80093,2.3278002149023678,0.24168585335236412
14810,0.4454047619047619,0,1,0,354311,251299,27863,80093,2.32779095186928,0.24168658265739668
14811,0.4454166666666666,2,4,2,354315,251295,27865,80091,2.32775389973693,0.2416849233220474
14812,0.4454285714285714,0,2,0,354317,251293,27865,80091,2.327735373670755,0.2416863819617121
14813,0.4454325396825396,0,1,0,354318,251292,27865,80091,2.327726110637667,0.24168711128814696
14814,0.4454523809523809,0,1,0,354319,251291,27865,80091,2.3277168476045795,0.24168784061898352
14815,0.4454545454545455,1,0,1,354319,251291,27866,80090,2.3277168476045795,0.2416855522797022
14816,0.4454761904761904,2,1,2,354320,251290,27868,80088,2.3277075845714923,0.24168170488083096
14817,0.4454761904761905,0,4,0,354324,251286,27868,80088,2.327670532439142,0.24168462220934653
14818,0.4454999999999999,3,24,3,354348,251262,27871,80085,2.327448219645041,0.2416952620666552
14819,0.4455,1,7,1,354355,251255,27872,80084,2.327383378413428,0.24169807961030848
14820,0.4455119047619047,0,1,0,354356,251254,27872,80084,2.3273741153803402,0.2416988090710996
14821,0.4455277777777777,0,1,0,354357,251253,27872,80084,2.3273648523472525,0.24169953853629386
14822,0.4455555555555555,0,1,0,354358,251252,27872,80084,2.327355589314165,0.2417002680058913
14823,0.4456190476190476,1,4,1,354362,251248,27873,80083,2.327318537181815,0.24170089729002114
14824,0.4456601731601731,0,1,0,354363,251247,27873,80083,2.3273092741487273,0.24170162677692936
14825,0.4456666666666665,0,1,0,354364,251246,27873,80083,2.3273000111156397,0.24170235626824094
14826,0.4456666666666666,3,35,3,354399,251211,27876,80080,2.3269758049575753,0.24172102471844994
14827,0.4456666666666667,2,10,2,354409,251201,27878,80078,2.3268831746267,0.2417237434307638
14828,0.4456904761904761,0,1,0,354410,251200,27878,80078,2.326873911593612,0.24172447310114165
14829,0.4457142857142857,3,15,3,354425,251185,27881,80075,2.3267349660972987,0.24172855159089537
14830,0.4457142857142859,0,1,0,354426,251184,27881,80075,2.3267257030642114,0.24172928131763968
14831,0.4457380952380954,1,0,1,354426,251184,27882,80074,2.3267257030642114,0.24172699225377198
14832,0.44575,1,0,1,354426,251184,27883,80073,2.3267257030642114,0.24172470317608383
14833,0.4457748917748917,0,1,0,354427,251183,27883,80073,2.3267164400311238,0.2417254328978192
14834,0.4457857142857142,1,1,1,354428,251182,27884,80072,2.326707176998036,0.2417238735230367
14835,0.4458333333333332,1,0,1,354428,251182,27885,80071,2.326707176998036,0.24172158440829214
14836,0.4458333333333333,21,155,21,354583,251027,27906,80050,2.3252714068694655,0.2417866538599782
14837,0.4458571428571429,1,1,1,354584,251026,27907,80049,2.325262143836378,0.24178509401193082
14838,0.4459047619047618,0,1,0,354585,251025,27907,80049,2.32525288080329,0.24178582431722212
14839,0.4459523809523809,0,3,0,354588,251022,27907,80049,2.3252250917040276,0.24178801525956667
14840,0.4459642857142857,0,2,0,354590,251020,27907,80049,2.3252065656378527,0.24178947590985564
14841,0.4459682539682539,0,3,0,354593,251017,27907,80049,2.3251787765385896,0.2417916669183788
14842,0.4459761904761904,0,2,0,354595,251015,27907,80049,2.3251602504724147,0.24179312761278787
14843,0.4459761904761907,1,0,1,354595,251015,27908,80048,2.3251602504724147,0.24179083739348703
14844,0.4459999999999999,2,6,2,354601,251009,27910,80046,2.3251046722738895,0.24179063901768588
14845,0.446,20,143,20,354744,250866,27930,80026,2.323780058542369,0.2418493043047278
14846,0.446047619047619,0,1,0,354745,250865,27930,80026,2.3237707955092817,0.2418500352079688
14847,0.4460476190476191,0,1,0,354746,250864,27930,80026,2.323761532476194,0.24185076611562756
14848,0.446063492063492,0,1,0,354747,250863,27930,80026,2.3237522694431063,0.24185149702770414
14849,0.4460714285714286,0,4,0,354751,250859,27930,80026,2.323715217310756,0.24185442072018978
14850,0.4460952380952381,0,1,0,354752,250858,27930,80026,2.323705954277669,0.2418551516543562
14851,0.446111111111111,0,1,0,354753,250857,27930,80026,2.323696691244581,0.24185588259294072
14852,0.4461111111111111,0,1,0,354754,250856,27930,80026,2.3236874282114934,0.24185661353594332
14853,0.4461666666666666,0,7,0,354761,250849,27930,80026,2.3236225869798806,0.24186173026067245
14854,0.4461666666666667,1,5,1,354766,250844,27931,80025,2.323576271814443,0.24186309385285415
14855,0.4461669653875536,0,1,0,354767,250843,27931,80025,2.3235670087813554,0.2418638248485801
14856,0.4461904761904761,0,2,0,354769,250841,27931,80025,2.3235484827151804,0.24186528685328804
14857,0.4461904761904762,0,2,0,354771,250839,27931,80025,2.323529956649005,0.24186674887567097
14858,0.4462380952380952,0,1,0,354772,250838,27931,80025,2.3235206936159174,0.24186747989349067
14859,0.4462499999999999,0,1,0,354773,250837,27931,80025,2.32351143058283,0.24186821091572921
14860,0.44625,1,5,1,354778,250832,27932,80024,2.323465115417392,0.24186957467901443
14861,0.4462500000000001,0,1,0,354779,250831,27932,80024,2.3234558523843045,0.24187030572305088
14862,0.4462857142857142,0,1,0,354780,250830,27932,80024,2.3234465893512173,0.24187103677150645
14863,0.4462857142857143,0,3,0,354783,250827,27932,80024,2.3234188002519547,0.24187322994338842
14864,0.4462857142857144,0,1,0,354784,250826,27932,80024,2.323409537218867,0.24187396100952094
14865,0.4463095238095239,0,1,0,354785,250825,27932,80024,2.3234002741857793,0.24187469208007278
14866,0.4463333333333332,1,3,1,354788,250822,27933,80023,2.3233724850865167,0.24187459384303828
14867,0.4463333333333333,4,23,4,354811,250799,27937,80019,2.323159435325503,0.24188224340876252
14868,0.4463333333333334,1,6,1,354817,250793,27938,80018,2.3231038571269775,0.24188433879163632
14869,0.4463690476190476,0,1,0,354818,250792,27938,80018,2.3230945940938903,0.24188506997974668
14870,0.4464166666666667,1,1,1,354819,250791,27939,80017,2.3230853310608026,0.2418835094677275
14871,0.4464285714285714,1,9,1,354828,250782,27940,80016,2.3230019637630144,0.2418877985961221
14872,0.4464523809523809,0,1,0,354829,250781,27940,80016,2.322992700729927,0.24188852982342646
14873,0.4464761904761904,0,1,0,354830,250780,27940,80016,2.3229834376968395,0.24188926105515182
14874,0.4464761904761905,0,4,0,354834,250776,27940,80016,2.322946385564489,0.24189218602626425
14875,0.4465,4,40,4,354874,250736,27944,80012,2.3225758642409873,0.2419122715783618
14876,0.4465476190476189,0,2,0,354876,250734,27944,80012,2.322557338174812,0.24191373440646297
14877,0.446547619047619,0,1,0,354877,250733,27944,80012,2.3225480751417242,0.2419144658271478
14878,0.4465952380952381,0,1,0,354878,250732,27944,80012,2.322538812108637,0.24191519725225552
14879,0.4466025641025641,0,3,0,354881,250729,27944,80012,2.3225110230093744,0.24191739155411637
14880,0.4466666666666665,0,1,0,354882,250728,27944,80012,2.3225017599762867,0.241918122996916
14881,0.4466666666666666,65,441,65,355323,250287,28009,79947,2.3184167623846754,0.24209197114773162
14882,0.4466666666666667,38,314,38,355637,249973,28047,79909,2.315508169995183,0.24223510224868286
14883,0.44675,0,2,0,355639,249971,28047,79909,2.3154896439290082,0.24223657087425732
14884,0.4467619047619047,0,1,0,355640,249970,28047,79909,2.3154803808959206,0.24223730519372255
14885,0.4467777777777778,0,2,0,355642,249968,28047,79909,2.3154618548297456,0.24223877384600928
14886,0.4467857142857143,0,4,0,355646,249964,28047,79909,2.3154248026973954,0.2422417112040088
14887,0.4468095238095237,0,1,0,355647,249963,28047,79909,2.3154155396643077,0.24224244555463936
14888,0.4468333333333333,2,21,2,355668,249942,28049,79907,2.315221015969469,0.24225327346755637
14889,0.4468571428571428,0,1,0,355669,249941,28049,79907,2.3152117529363814,0.24225400790667218
14890,0.4468809523809524,0,2,0,355671,249939,28049,79907,2.3151932268702065,0.24225547679826342
14891,0.4469047619047619,0,3,0,355674,249936,28049,79907,2.315165437770944,0.2422576801690501
14892,0.4469444444444444,0,2,0,355676,249934,28049,79907,2.3151469117047685,0.24225914910517493
14893,0.446952380952381,0,1,0,355677,249933,28049,79907,2.3151376486716813,0.24225988357991754
14894,0.4469999999999999,1,6,1,355683,249927,28050,79906,2.3150820704731556,0.24226199319049338
14895,0.447,4,54,4,355737,249873,28054,79902,2.314581866686428,0.24229247214009553
14896,0.4470238095238095,0,3,0,355740,249870,28054,79902,2.3145540775871654,0.24229467632182236
14897,0.4470714285714286,0,1,0,355741,249869,28054,79902,2.3145448145540777,0.24229541105797658
14898,0.4470833333333333,0,7,0,355748,249862,28054,79902,2.314479973322465,0.24230055433582803
14899,0.447142857142857,0,1,0,355749,249861,28054,79902,2.314470710289377,0.24230128910763185
14900,0.4471428571428572,3,16,3,355765,249845,28057,79899,2.3143225017599764,0.2423061526517541
14901,0.4471666666666666,2,8,2,355773,249837,28059,79897,2.314248397495276,0.24230743569058696
14902,0.4471666666666667,0,13,0,355786,249824,28059,79897,2.314127978065138,0.24231698921209144
14903,0.4472222222222222,0,1,0,355787,249823,28059,79897,2.31411871503205,0.24231772412956448
14904,0.4472301587301587,0,1,0,355788,249822,28059,79897,2.3141094519989625,0.24231845905149538
14905,0.4472380952380952,0,1,0,355789,249821,28059,79897,2.3141001889658748,0.24231919397788412
14906,0.44725,2,0,2,355789,249821,28061,79895,2.3141001889658748,0.24231459801768795
14907,0.4472521645021645,1,0,1,355789,249821,28062,79894,2.3141001889658748,0.24231230001668108
14908,0.4472619047619048,0,1,0,355790,249820,28062,79894,2.3140909259327875,0.24231303493330583
14909,0.4472857142857143,0,1,0,355791,249819,28062,79894,2.3140816628997,0.24231376985438852
14910,0.4473095238095238,0,1,0,355792,249818,28062,79894,2.314072399866612,0.24231450477992916
14911,0.4473137973137973,0,1,0,355793,249817,28062,79894,2.314063136833525,0.2423152397099278
14912,0.4473333333333332,1,8,1,355801,249809,28063,79893,2.3139890325688244,0.242318821238573
14913,0.4473333333333333,4,39,4,355840,249770,28067,79889,2.3136277742784097,0.2423382950260724
14914,0.4473333333333334,1,1,1,355841,249769,28068,79888,2.313618511245322,0.24233673181518972
14915,0.4473412698412699,0,1,0,355842,249768,28068,79888,2.313609248212235,0.24233746693522945
14916,0.4473560606060606,0,1,0,355843,249767,28068,79888,2.313599985179147,0.2423382020597291
14917,0.4473809523809523,0,2,0,355845,249765,28068,79888,2.3135814591129717,0.2423396723221084
14918,0.4473809523809524,0,4,0,355849,249761,28068,79888,2.313544406980622,0.242342612900388
14919,0.4474141414141414,0,1,0,355850,249760,28068,79888,2.3135351439475342,0.24234334805610833
14920,0.4474285714285714,0,1,0,355851,249759,28068,79888,2.3135258809144466,0.24234408321628895
14921,0.4474642857142856,0,1,0,355852,249758,28068,79888,2.313516617881359,0.24234481838092983
14922,0.4474722222222222,0,1,0,355853,249757,28068,79888,2.3135073548482716,0.2423455535500311
14923,0.4474761904761904,0,1,0,355854,249756,28068,79888,2.313498091815184,0.24234628872359273
14924,0.4474999999999999,1,13,1,355867,249743,28069,79887,2.313377672385046,0.24235354791736188
14925,0.4475,40,325,40,356192,249418,28109,79847,2.3103671866315905,0.24250072130350933
14926,0.4475238095238094,0,1,0,356193,249417,28109,79847,2.3103579235985032,0.24250145779678312
14927,0.4476190476190476,1,5,1,356198,249412,28110,79846,2.3103116084330653,0.24250283971839712
14928,0.4476428571428571,0,3,0,356201,249409,28110,79846,2.3102838193338027,0.2425050492779153
14929,0.4476428571428572,1,0,1,356201,249409,28111,79845,2.3102838193338027,0.24250274863782975
14930,0.4476666666666666,8,24,8,356225,249385,28119,79837,2.3100615065397014,0.24250201991361453
14931,0.4476666666666667,1,6,1,356231,249379,28120,79836,2.3100059283411762,0.24250413863280834
14932,0.4476734654234654,0,3,0,356234,249376,28120,79836,2.309978139241913,0.24250634849276453
14933,0.4476825396825397,1,1,1,356235,249375,28121,79835,2.309968876208826,0.24250478418031043
14934,0.4477121212121212,0,1,0,356236,249374,28121,79835,2.3099596131757383,0.24250552080896937
14935,0.4477142857142857,0,2,0,356238,249372,28121,79835,2.3099410871095634,0.24250699407971277
14936,0.4477380952380952,0,1,0,356239,249371,28121,79835,2.3099318240764757,0.2425077307217973
14937,0.44775,0,1,0,356240,249370,28121,79835,2.309922561043388,0.2425084673683571
14938,0.4477619047619048,0,1,0,356241,249369,28121,79835,2.3099132980103003,0.24250920401939224
14939,0.4477777777777778,0,3,0,356244,249366,28121,79835,2.3098855089110377,0.24251141399934995
14940,0.4478174603174603,1,1,1,356245,249365,28122,79834,2.3098762458779505,0.24250984966539996
14941,0.4478333333333333,3,17,3,356262,249348,28125,79831,2.3097187743154617,0.24251547030642903
14942,0.4478571428571428,1,9,1,356271,249339,28126,79830,2.309635407017674,0.24251979985964656
14943,0.4478809523809524,0,1,0,356272,249338,28126,79830,2.309626143984586,0.24252053662567444
14944,0.4478926906426907,2,3,2,356275,249335,28128,79828,2.3095983548853236,0.2425181445059135
14945,0.4479047619047619,0,1,0,356276,249334,28128,79828,2.309589091852236,0.2425188812803422
14946,0.4479166666666666,0,1,0,356277,249333,28128,79828,2.3095798288191487,0.2425196180592476
14947,0.4479166666666667,0,3,0,356280,249330,28128,79828,2.309552039719886,0.2425218284228243
14948,0.4479285714285714,0,2,0,356282,249328,28128,79828,2.3095335136537107,0.24252330202092626
14949,0.4479365079365081,0,2,0,356284,249326,28128,79828,2.309514987587536,0.2425247756369359
14950,0.447952380952381,0,5,0,356289,249321,28128,79828,2.309468672422098,0.24252845975530837
14951,0.4479761904761905,0,2,0,356291,249319,28128,79828,2.309450146355923,0.24252993343399756
14952,0.4479999999999999,11,102,11,356393,249217,28139,79817,2.3085053169809924,0.24257979418540332
14953,0.448,1,3,1,356396,249214,28140,79816,2.3084775278817298,0.24257970397836062
14954,0.4480238095238095,0,1,0,356397,249213,28140,79816,2.308468264848642,0.24258044123770245
14955,0.4480238095238096,0,1,0,356398,249212,28140,79816,2.3084590018155544,0.24258117850152572
14956,0.448047619047619,0,1,0,356399,249211,28140,79816,2.3084497387824667,0.24258191576983043
14957,0.4480714285714286,0,1,0,356400,249210,28140,79816,2.3084404757493795,0.2425826530426167
14958,0.4480952380952381,0,3,0,356403,249207,28140,79816,2.308412686650117,0.242584864887865
14959,0.4481071428571428,0,4,0,356407,249203,28140,79816,2.3083756345177666,0.24258781407760646
14960,0.4481190476190476,0,1,0,356408,249202,28140,79816,2.308366371484679,0.24258855138624635
14961,0.4481428571428571,0,1,0,356409,249201,28140,79816,2.3083571084515913,0.2425892886993681
14962,0.4481428571428572,1,0,1,356409,249201,28141,79815,2.3083571084515913,0.24258698665110512
14963,0.4481666666666665,0,1,0,356410,249200,28141,79815,2.308347845418504,0.242587723963953
14964,0.4481666666666666,3,20,3,356430,249180,28144,79812,2.3081625847567526,0.24259556463379048
14965,0.4481666666666667,0,5,0,356435,249175,28144,79812,2.308116269591315,0.24259925164216214
14966,0.4481818181818181,0,2,0,356437,249173,28144,79812,2.3080977435251397,0.24260072647689104
14967,0.4482142857142857,0,3,0,356440,249170,28144,79812,2.308069954425877,0.24260293876260708
14968,0.4482380952380952,0,1,0,356441,249169,28144,79812,2.3080606913927895,0.2426036762001453
14969,0.44825,1,0,1,356441,249169,28145,79811,2.3080606913927895,0.2426013739437048
14970,0.4482857142857142,0,1,0,356442,249168,28145,79811,2.3080514283597022,0.2426021113809696
14971,0.4482857142857143,0,3,0,356445,249165,28145,79811,2.3080236392604396,0.24260432371966345
14972,0.4482936507936508,0,1,0,356446,249164,28145,79811,2.308014376227352,0.2426050611748613
14973,0.4483333333333333,53,432,53,356878,248732,28198,79758,2.3040127459335284,0.24280191177813631
14974,0.4483333333333334,0,2,0,356880,248730,28198,79758,2.3039942198673535,0.24280339007817636
14975,0.4483571428571427,1,0,1,356880,248730,28199,79757,2.3039942198673535,0.24280108497444344
14976,0.4483571428571428,0,1,0,356881,248729,28199,79757,2.303984956834266,0.2428018241264468
14977,0.4483809523809524,0,1,0,356882,248728,28199,79757,2.303975693801178,0.24280256328295052
14978,0.4484047619047618,0,1,0,356883,248727,28199,79757,2.3039664307680905,0.24280330244395465
14979,0.4484444444444445,0,1,0,356884,248726,28199,79757,2.3039571677350033,0.24280404160945923
14980,0.4484523809523809,0,1,0,356885,248725,28199,79757,2.3039479047019156,0.24280478077946432
14981,0.4484722222222222,0,2,0,356887,248723,28199,79757,2.3039293786357407,0.24280625913297613
14982,0.4484761904761904,0,1,0,356888,248722,28199,79757,2.303920115602653,0.24280699831648295
14983,0.4484999999999999,1,7,1,356895,248715,28200,79756,2.30385527437104,0.2428098675377735
14984,0.4485,2,30,2,356925,248685,28202,79754,2.3035773833784132,0.24282743523150419
14985,0.4485238095238095,0,1,0,356926,248684,28202,79754,2.303568120345326,0.24282817457176087
14986,0.4485714285714285,1,3,1,356929,248681,28203,79753,2.3035403312460634,0.24282808722604846
14987,0.4485714285714286,0,6,0,356935,248675,28203,79753,2.3034847530475377,0.2428325234145688
14988,0.4486666666666666,3,31,3,356966,248644,28206,79750,2.3031975990218236,0.24284852951028338
14989,0.4486666666666667,0,4,0,356970,248640,28206,79750,2.3031605468894734,0.24285148756052255
14990,0.4487380952380952,0,3,0,356973,248637,28206,79750,2.3031327577902108,0.24285370614549298
14991,0.44875,0,3,0,356976,248634,28206,79750,2.303104968690948,0.2428559247709998
14992,0.4487777777777778,0,1,0,356977,248633,28206,79750,2.3030957056578605,0.2428566643218437
14993,0.4487878787878787,0,1,0,356978,248632,28206,79750,2.3030864426247732,0.24285740387719182
14994,0.4488095238095237,1,6,1,356984,248626,28207,79749,2.3030308644262476,0.24285953559192996
14995,0.4488095238095239,1,1,1,356985,248625,28208,79748,2.3030216013931604,0.24285796944328553
14996,0.4488333333333332,0,4,0,356989,248621,28208,79748,2.30298454926081,0.242860927797691
14997,0.4488333333333333,1,7,1,356996,248614,28209,79747,2.302919708029197,0.24286379929406965
14998,0.4488333333333334,0,9,0,357005,248605,28209,79747,2.302836340731409,0.24287045609589708
14999,0.4488888888888888,0,1,0,357006,248604,28209,79747,2.3028270776983217,0.24287119576307062
15000,0.4488888888888889,0,1,0,357007,248603,28209,79747,2.302817814665234,0.2428719354347495
15001,0.4489166666666666,0,1,0,357008,248602,28209,79747,2.3028085516321464,0.2428726751109338
15002,0.4489285714285715,0,1,0,357009,248601,28209,79747,2.3027992885990587,0.24287341479162353
15003,0.4489404761904761,0,1,0,357010,248600,28209,79747,2.3027900255659715,0.24287415447681873
15004,0.4489761904761905,0,1,0,357011,248599,28209,79747,2.3027807625328838,0.24287489416651947
15005,0.4489999999999999,0,2,0,357013,248597,28209,79747,2.302762236466709,0.24287637355943767
15006,0.449,13,81,13,357094,248516,28222,79734,2.302011930786617,0.24290632140137092
15007,0.4490238095238095,1,0,1,357094,248516,28223,79733,2.302011930786617,0.24290401493987795
15008,0.449047619047619,0,4,0,357098,248512,28223,79733,2.3019748786542666,0.24290697497296226
15009,0.4490952380952381,1,1,1,357099,248511,28224,79732,2.301965615621179,0.2429054084930981
15010,0.4491071428571428,0,1,0,357100,248510,28224,79732,2.3019563525880913,0.24290614851237807
15011,0.4491190476190476,0,1,0,357101,248509,28224,79732,2.301947089555004,0.24290688853616701
15012,0.4491428571428572,2,2,2,357103,248507,28226,79730,2.3019285634888287,0.2429037555181165
15013,0.4491666666666665,0,5,0,357108,248502,28226,79730,2.301882248323391,0.2429074557020644
15014,0.4491666666666666,11,74,11,357182,248428,28237,79719,2.301196783874912,0.24293685451946842
15015,0.4491666666666667,10,57,10,357239,248371,28247,79709,2.3006687909889214,0.24295598634479396
15016,0.4491746031746031,0,1,0,357240,248370,28247,79709,2.3006595279558337,0.24295672688590247
15017,0.4492142857142856,0,1,0,357241,248369,28247,79709,2.3006502649227465,0.24295746743152544
15018,0.4492142857142857,0,1,0,357242,248368,28247,79709,2.300641001889659,0.24295820798166284
15019,0.4492222222222221,0,4,0,357246,248364,28247,79709,2.3006039497573085,0.24296117022735794
15020,0.4492380952380952,0,2,0,357248,248362,28247,79709,2.3005854236911336,0.24296265137729334
15021,0.44925,0,1,0,357249,248361,28247,79709,2.300576160658046,0.24296339195903313
15022,0.4492857142857142,0,1,0,357250,248360,28247,79709,2.3005668976249583,0.24296413254528773
15023,0.4492857142857143,2,6,2,357256,248354,28249,79707,2.300511319426433,0.24296396097067313
15024,0.4493333333333333,5,58,5,357314,248296,28254,79702,2.2999740635073547,0.24299538411819585
15025,0.4493333333333334,0,1,0,357315,248295,28254,79702,2.2999648004742674,0.2429961249645576
15026,0.4494404761904761,0,1,0,357316,248294,28254,79702,2.2999555374411798,0.24299686581543678
15027,0.4494444444444444,1,0,1,357316,248294,28255,79701,2.2999555374411798,0.24299455784386956
15028,0.4494761904761905,0,1,0,357317,248293,28255,79701,2.299946274408092,0.24299529869448833
15029,0.4494999999999999,0,6,0,357323,248287,28255,79701,2.299890696209567,0.24299974389306925
15030,0.4495,4,23,4,357346,248264,28259,79697,2.2996776464485533,0.24300755272730598
15031,0.4495000000000001,0,1,0,357347,248263,28259,79697,2.2996683834154656,0.24300829369435298
15032,0.4495238095238095,1,8,1,357355,248255,28260,79696,2.299594279150765,0.24301191336510639
15033,0.4495476190476191,0,1,0,357356,248254,28260,79696,2.2995850161176774,0.2430126543680439
15034,0.4495714285714285,0,1,0,357357,248253,28260,79696,2.29957575308459,0.24301339537550046
15035,0.4495793650793651,0,1,0,357358,248252,28260,79696,2.2995664900515025,0.24301413638747607
15036,0.4495833333333333,0,2,0,357360,248250,28260,79696,2.2995479639853276,0.2430156184249846
15037,0.4495873015873015,0,2,0,357362,248248,28260,79696,2.299529437919152,0.24301710048056985
15038,0.4496190476190476,0,3,0,357365,248245,28260,79696,2.2995016488198896,0.24301932359784228
15039,0.4496309523809524,1,0,1,357365,248245,28261,79695,2.2995016488198896,0.24301701530767825
15040,0.4496666666666666,8,24,8,357389,248221,28269,79687,2.2992793360257884,0.24301633384973834
15041,0.4496666666666667,1,1,1,357390,248220,28270,79686,2.2992700729927007,0.24301476642696382
15042,0.4497142857142857,0,4,0,357394,248216,28270,79686,2.2992330208603504,0.24301773090740525
15043,0.4497380952380952,0,1,0,357395,248215,28270,79686,2.2992237578272627,0.2430184720388166
15044,0.44975,0,1,0,357396,248214,28270,79686,2.2992144947941755,0.2430192131747484
15045,0.4497619047619047,1,1,1,357397,248213,28271,79685,2.299205231761088,0.2430176457312945
15046,0.4497619047619048,0,1,0,357398,248212,28271,79685,2.299195968728,0.24301838687148708
15047,0.4498214285714286,0,1,0,357399,248211,28271,79685,2.299186705694913,0.24301912801620026
15048,0.4498225108225109,1,0,1,357399,248211,28272,79684,2.299186705694913,0.24301681940865216
15049,0.4498333333333332,1,3,1,357402,248208,28273,79683,2.29915891659565,0.24301673421960346
15050,0.4498333333333333,3,10,3,357412,248198,28276,79680,2.2990662862647744,0.24301721981956703
15051,0.4498333333333334,0,1,0,357413,248197,28276,79680,2.299057023231687,0.24301796100366907
15052,0.4498412698412698,0,1,0,357414,248196,28276,79680,2.2990477601985995,0.2430187021922922
15053,0.4498571428571429,1,0,1,357414,248196,28277,79679,2.2990477601985995,0.24301639344262296
15054,0.4498636363636363,0,1,0,357415,248195,28277,79679,2.299038497165512,0.2430171346309863
15055,0.4498690476190476,1,0,1,357415,248195,28278,79678,2.299038497165512,0.24301482586245285
15056,0.4498809523809523,0,2,0,357417,248193,28278,79678,2.299019971099337,0.24301630824318102
15057,0.4498888888888889,0,1,0,357418,248192,28278,79678,2.299010708066249,0.24301704944032695
15058,0.4499166666666667,0,1,0,357419,248191,28278,79678,2.2990014450331615,0.24301779064199422
15059,0.4499206349206349,0,1,0,357420,248190,28278,79678,2.2989921820000743,0.2430185318481828
15060,0.4499523809523809,0,1,0,357421,248189,28278,79678,2.2989829189669866,0.2430192730588928
15061,0.4499761904761905,0,1,0,357422,248188,28278,79678,2.298973655933899,0.24302001427412417
15062,0.4499999999999999,6,44,6,357466,248144,28284,79672,2.2985660824780467,0.24303877785098957
15063,0.45,456,3252,456,360718,244892,28740,79216,2.2684426988773203,0.24441235637503547
15064,0.4500476190476191,0,2,0,360720,244890,28740,79216,2.2684241728111454,0.24441386459985315
15065,0.4500497835497835,0,1,0,360721,244889,28740,79216,2.2684149097780577,0.24441461871924222
15066,0.4500833333333333,0,2,0,360723,244887,28740,79216,2.268396383711883,0.24441612697198112
15067,0.4500833333333334,0,1,0,360724,244886,28740,79216,2.268387120678795,0.24441688110533102
15068,0.4501190476190476,0,5,0,360729,244881,28740,79216,2.268340805513357,0.24442065184188685
15069,0.4501309523809524,0,1,0,360730,244880,28740,79216,2.26833154248027,0.24442140600315956
15070,0.4501428571428571,0,2,0,360732,244878,28740,79216,2.2683130164140946,0.2444229143396669
15071,0.4501666666666666,1,12,1,360744,244866,28741,79215,2.268201860017044,0.24442963333240764
15072,0.4501666666666667,0,3,0,360747,244863,28741,79215,2.268174070917781,0.24443189602503101
15073,0.4501904761904762,0,1,0,360748,244862,28741,79215,2.268164807884694,0.24443265026521474
15074,0.4502380952380952,0,3,0,360751,244859,28741,79215,2.2681370187854313,0.2444349130136944
15075,0.4502619047619047,0,1,0,360752,244858,28741,79215,2.2681277557523436,0.24443566727249724
15076,0.4502619047619048,0,1,0,360753,244857,28741,79215,2.268118492719256,0.24443642153595496
15077,0.4502976190476191,1,1,1,360754,244856,28742,79214,2.2681092296861682,0.2444348443237572
15078,0.4503095238095237,1,0,1,360754,244856,28743,79213,2.2681092296861682,0.244432512829058
15079,0.4503333333333333,5,18,5,360772,244838,28748,79208,2.2679424950905926,0.24443443214852212
15080,0.4503571428571428,0,4,0,360776,244834,28748,79208,2.2679054429582424,0.2444374494664272
15081,0.4503809523809524,0,2,0,360778,244832,28748,79208,2.267886916892067,0.2444389581533144
15082,0.450474025974026,0,1,0,360779,244831,28748,79208,2.2678776538589798,0.24443971250374183
15083,0.4504761904761904,1,2,1,360781,244829,28749,79207,2.2678591277928044,0.24443888950610426
15084,0.4504761904761905,0,12,0,360793,244817,28749,79207,2.267747971395754,0.24444794212774362
15085,0.4504999999999999,2,11,2,360804,244806,28751,79205,2.267646078031791,0.24445157726126582
15086,0.4505,3,4,3,360808,244802,28754,79202,2.2676090258994406,0.24444759941235294
15087,0.450515873015873,0,1,0,360809,244801,28754,79202,2.267599762866353,0.2444483538732666
15088,0.4505357142857143,0,1,0,360810,244800,28754,79202,2.267590499833265,0.2444491083388374
15089,0.450547619047619,0,3,0,360813,244797,28754,79202,2.2675627107340026,0.2444513717634931
15090,0.4505530303030303,2,3,2,360816,244794,28756,79200,2.26753492163474,0.24444897127724588
15091,0.4505555555555556,0,5,0,360821,244789,28756,79200,2.2674886064693025,0.24445274376599205
15092,0.4505595238095237,0,3,0,360824,244786,28756,79200,2.2674608173700395,0.2444550073151309
15093,0.4505674603174603,0,1,0,360825,244785,28756,79200,2.2674515543369522,0.24445576184082596
15094,0.450595238095238,0,1,0,360826,244784,28756,79200,2.2674422913038645,0.24445651637117882
15095,0.4505952380952381,0,2,0,360828,244782,28756,79200,2.2674237652376896,0.2444580254458581
15096,0.4506428571428572,2,0,2,360828,244782,28758,79198,2.2674237652376896,0.2444533613185999
15097,0.4506666666666666,4,57,4,360885,244725,28762,79194,2.266895772351699,0.24448704768784787
15098,0.4506666666666667,1,11,1,360896,244714,28763,79193,2.2667938789877358,0.24449301805765236
15099,0.4506904761904761,0,1,0,360897,244713,28763,79193,2.266784615954648,0.24449377288472582
15100,0.450702380952381,0,1,0,360898,244712,28763,79193,2.266775352921561,0.24449452771646007
15101,0.4507142857142857,2,9,2,360907,244703,28765,79191,2.2666919856237726,0.24449665631348527
15102,0.4507142857142858,0,1,0,360908,244702,28765,79191,2.266682722590685,0.2444974111820879
15103,0.4507380952380952,0,1,0,360909,244701,28765,79191,2.2666734595575977,0.2444981660553518
15104,0.45075,0,3,0,360912,244698,28765,79191,2.266645670458335,0.24450043070311125
15105,0.4507619047619047,0,2,0,360914,244696,28765,79191,2.2666271443921597,0.2445019404915912
15106,0.4507738095238094,0,1,0,360915,244695,28765,79191,2.266617881359072,0.2445026953928234
15107,0.4507857142857143,0,3,0,360918,244692,28765,79191,2.2665900922598095,0.2445049601244894
15108,0.4508333333333332,0,1,0,360919,244691,28765,79191,2.266580829226722,0.24450571504436802
15109,0.4508333333333333,21,138,21,361057,244553,28786,79170,2.2653025306606396,0.2445609363560822
15110,0.4508333333333334,0,1,0,361058,244552,28786,79170,2.265293267627552,0.24456169182199541
15111,0.4508571428571429,0,2,0,361060,244550,28786,79170,2.265274741561377,0.24456320276782403
15112,0.450904761904762,1,0,1,361060,244550,28787,79169,2.265274741561377,0.24456086914886058
15113,0.4509166666666667,0,2,0,361062,244548,28787,79169,2.2652562154952016,0.244562380103609
15114,0.4509404761904763,0,3,0,361065,244545,28787,79169,2.265228426395939,0.24456464657073837
15115,0.4509523809523809,0,4,0,361069,244541,28787,79169,2.2651913742635887,0.2445676685922585
15116,0.450952380952381,0,2,0,361071,244539,28787,79169,2.265172848197414,0.24456917963102548
15117,0.4509999999999999,0,5,0,361076,244534,28787,79169,2.265126533031976,0.2445729573096326
15118,0.451,16,77,16,361153,244457,28803,79153,2.264413279484234,0.24459380118043325
15119,0.451047619047619,0,1,0,361154,244456,28803,79153,2.264404016451147,0.2445945570117024
15120,0.4510714285714285,0,3,0,361157,244453,28803,79153,2.264376227351884,0.2445968245335377
15121,0.4510714285714286,0,1,0,361158,244452,28803,79153,2.2643669643187967,0.24459758038349222
15122,0.4510833333333333,0,2,0,361160,244450,28803,79153,2.2643484382526213,0.24459909209741565
15123,0.4510909090909091,0,1,0,361161,244449,28803,79153,2.264339175219534,0.24459984796138468
15124,0.4511111111111111,0,2,0,361163,244447,28803,79153,2.2643206491533587,0.24460135970333746
15125,0.4511190476190477,0,1,0,361164,244446,28803,79153,2.264311386120271,0.24460211558132133
15126,0.4511428571428571,3,0,3,361164,244446,28806,79150,2.264311386120271,0.2445951124241338
15127,0.4511666666666666,1,1,1,361165,244445,28807,79149,2.264302123087184,0.24459353387269234
15128,0.4511666666666667,0,2,0,361167,244443,28807,79149,2.2642835970210085,0.24459504561299414
15129,0.4511904761904762,1,1,1,361168,244442,28808,79148,2.264274333987921,0.24459346704162674
15130,0.4512142857142857,0,1,0,361169,244441,28808,79148,2.2642650709548335,0.24459422291857882
15131,0.4512142857142858,0,4,0,361173,244437,28808,79148,2.2642280188224833,0.244597246473106
15132,0.4512380952380952,1,0,1,361173,244437,28809,79147,2.2642280188224833,0.2445949119857595
15133,0.45125,0,7,0,361180,244430,28809,79147,2.2641631775908704,0.24460020335190696
15134,0.4512857142857143,0,1,0,361181,244429,28809,79147,2.2641539145577827,0.2446009592800455
15135,0.4513015873015873,0,1,0,361182,244428,28809,79147,2.2641446515246955,0.24460171521285637
15136,0.4513095238095237,0,1,0,361183,244427,28809,79147,2.264135388491608,0.24460247115033965
15137,0.4513181818181819,0,4,0,361187,244423,28809,79147,2.2640983363592575,0.24460549494699757
15138,0.4513333333333332,0,7,0,361194,244416,28809,79147,2.2640334951276446,0.24461078677104614
15139,0.4513333333333333,5,26,5,361220,244390,28814,79142,2.263792656267368,0.24461877032256468
15140,0.4513333333333334,1,3,1,361223,244387,28815,79141,2.2637648671681054,0.24461870379070744
15141,0.4513492063492064,0,1,0,361224,244386,28815,79141,2.2637556041350178,0.2446194598905192
15142,0.4513809523809523,0,2,0,361226,244384,28815,79141,2.263737078068843,0.24462097210416506
15143,0.4513809523809524,0,1,0,361227,244383,28815,79141,2.263727815035755,0.2446217282179993
15144,0.4513888888888888,0,2,0,361229,244381,28815,79141,2.2637092889695802,0.24462324045969053
15145,0.4514285714285714,1,5,1,361234,244376,28816,79140,2.2636629738041423,0.2446246862597213
15146,0.4514982517482517,0,1,0,361235,244375,28816,79140,2.263653710771055,0.24462544240607081
15147,0.4514999999999999,1,1,1,361236,244374,28817,79139,2.2636444477379674,0.24462386364690136
15148,0.4515,4,18,4,361254,244356,28821,79135,2.2634777131423913,0.24462813494038474
15149,0.4515039682539684,0,2,0,361256,244354,28821,79135,2.2634591870762164,0.24462964737595405
15150,0.4515238095238095,0,1,0,361257,244353,28821,79135,2.2634499240431287,0.2446304036007518
15151,0.451531746031746,0,1,0,361258,244352,28821,79135,2.263440661010041,0.24463115983022501
15152,0.451547619047619,1,4,1,361262,244348,28822,79134,2.2634036088776908,0.24463184968560847
15153,0.451595238095238,0,1,0,361263,244347,28822,79134,2.2633943458446035,0.2446326059335788
15154,0.4516071428571427,0,1,0,361264,244346,28822,79134,2.263385082811516,0.2446333621862248
15155,0.4516349206349205,0,1,0,361265,244345,28822,79134,2.263375819778428,0.24463411844354657
15156,0.4516428571428571,1,1,1,361266,244344,28823,79133,2.2633665567453405,0.24463253956231817
15157,0.4516666666666665,0,5,0,361271,244339,28823,79133,2.263320241579903,0.24463632091803927
15158,0.4516666666666666,30,271,30,361542,244068,28853,79103,2.2608099596131757,0.24477134396341255
15159,0.4516666666666667,24,201,24,361743,243867,28877,79079,2.2589480899625776,0.2448675629981483
15160,0.4517045454545454,0,1,0,361744,243866,28877,79079,2.25893882692949,0.2448683212311694
15161,0.45175,1,0,1,361744,243866,28878,79078,2.25893882692949,0.24486598295679746
15162,0.4517857142857143,0,4,0,361748,243862,28878,79078,2.2589017747971396,0.24486901591626928
15163,0.4517857142857144,1,1,1,361749,243861,28879,79077,2.258892511764052,0.2448674358545603
15164,0.4518095238095237,1,0,1,361749,243861,28880,79076,2.258892511764052,0.2448650975267622
15165,0.4518333333333333,1,19,1,361768,243842,28881,79075,2.2587165141353887,0.2448771665784087
15166,0.4518371212121211,0,1,0,361769,243841,28881,79075,2.258707251102301,0.24487792490926433
15167,0.4518461538461538,0,1,0,361770,243840,28881,79075,2.2586979880692133,0.24487868324481674
15168,0.4518571428571428,0,3,0,361773,243837,28881,79075,2.2586701989699507,0.24488095827965514
15169,0.4518650793650793,0,1,0,361774,243836,28881,79075,2.258660935936863,0.24488171663399513
15170,0.4518809523809524,1,1,1,361775,243835,28882,79074,2.2586516729037758,0.24488013650904744
15171,0.4519047619047618,0,1,0,361776,243834,28882,79074,2.258642409870688,0.24488089486788805
15172,0.4519047619047619,0,1,0,361777,243833,28882,79074,2.2586331468376004,0.24488165323142577
15173,0.451904761904762,0,1,0,361778,243832,28882,79074,2.2586238838045127,0.2448824115996606
15174,0.4519523809523809,0,1,0,361779,243831,28882,79074,2.2586146207714255,0.24488316997259255
15175,0.4519722222222221,1,3,1,361782,243828,28883,79073,2.258586831672163,0.2448831065868486
15176,0.4519999999999999,0,5,0,361787,243823,28883,79073,2.258540516506725,0.24488689856795995
15177,0.452,10,67,10,361854,243756,28893,79063,2.2579198932898588,0.24491433279949446
15178,0.4520000000000001,0,1,0,361855,243755,28893,79063,2.257910630256771,0.24491509147569218
15179,0.4520357142857143,0,5,0,361860,243750,28893,79063,2.2578643150913336,0.24491888492718694
15180,0.4520833333333333,1,5,1,361865,243745,28894,79062,2.2578179999258956,0.24492033939784452
15181,0.4521190476190476,0,3,0,361868,243742,28894,79062,2.257790210826633,0.24492261558097173
15182,0.4521190476190477,0,1,0,361869,243741,28894,79062,2.2577809477935453,0.24492337431808256
15183,0.452142857142857,1,0,1,361869,243741,28895,79061,2.2577809477935453,0.2449210351856556
15184,0.4521428571428572,2,12,2,361881,243729,28897,79059,2.257669791396495,0.24492546191308226
15185,0.4521666666666666,3,17,3,361898,243712,28900,79056,2.2575123198340066,0.24493134387547713
15186,0.4521904761904761,0,1,0,361899,243711,28900,79056,2.257503056800919,0.2449321027242562
15187,0.4522142857142857,0,1,0,361900,243710,28900,79056,2.257493793767831,0.24493286157773744
15188,0.452219696969697,0,1,0,361901,243709,28900,79056,2.257484530734744,0.24493362043592087
15189,0.4522222222222222,0,1,0,361902,243708,28900,79056,2.2574752677016563,0.24493437929880657
15190,0.4522380952380952,1,0,1,361902,243708,28901,79055,2.2574752677016563,0.24493203991783444
15191,0.4522619047619047,0,1,0,361903,243707,28901,79055,2.2574660046685686,0.2449327987805256
15192,0.4523214285714285,0,1,0,361904,243706,28901,79055,2.257456741635481,0.24493355764791905
15193,0.4523214285714286,0,1,0,361905,243705,28901,79055,2.2574474786023937,0.24493431652001488
15194,0.4523333333333332,2,8,2,361913,243697,28903,79053,2.257373374337693,0.2449357087529047
15195,0.4523333333333333,6,33,6,361946,243664,28909,79047,2.2570676942458037,0.2449467170316475
15196,0.4523333333333334,0,1,0,361947,243663,28909,79047,2.2570584312127164,0.2449474760620991
15197,0.4523571428571429,1,2,1,361949,243661,28910,79046,2.257039905146541,0.2449466543954733
15198,0.4523809523809523,1,5,1,361954,243656,28911,79045,2.2569935899811036,0.24494810986021115
15199,0.4523809523809524,2,1,2,361955,243655,28913,79043,2.256984326948016,0.24494418930393122
15200,0.4523888888888889,0,1,0,361956,243654,28913,79043,2.256975063914928,0.24494494835712757
15201,0.4524603174603174,1,1,1,361957,243653,28914,79042,2.256965800881841,0.24494336757619423
15202,0.4524999999999999,1,11,1,361968,243642,28915,79041,2.256863907517878,0.24494937756249943
15203,0.4525,65,333,65,362301,243309,28980,78976,2.2537793174997223,0.2450501884977582
15204,0.4525277777777778,0,1,0,362302,243308,28980,78976,2.2537700544666346,0.24505094885256481
15205,0.4525476190476191,0,5,0,362307,243303,28980,78976,2.2537237393011966,0.24505475069737712
15206,0.4525833333333333,0,1,0,362308,243302,28980,78976,2.2537144762681094,0.24505551108049572
15207,0.4525972222222222,0,1,0,362309,243301,28980,78976,2.2537052132350217,0.24505627146833314
15208,0.4526190476190476,1,2,1,362311,243299,28981,78975,2.2536866871688463,0.24505544971049478
15209,0.4526666666666666,7,40,7,362351,243259,28988,78968,2.2533161658453444,0.2450694696595878
15210,0.4526666666666667,6,6,6,362357,243253,28994,78962,2.2532605876468192,0.2450599754822091
15211,0.4527142857142856,0,2,0,362359,243251,28994,78962,2.253242061580644,0.24506149658766097
15212,0.4527222222222222,0,3,0,362362,243248,28994,78962,2.2532142724813813,0.24506377828124515
15213,0.4527261904761904,1,0,1,362362,243248,28995,78961,2.2532142724813813,0.2450614352795856
15214,0.4527272727272727,0,1,0,362363,243247,28995,78961,2.2532050094482936,0.24506219584864436
15215,0.4527380952380953,0,3,0,362366,243244,28995,78961,2.253177220349031,0.24506447758414673
15216,0.45275,0,3,0,362369,243241,28995,78961,2.2531494312497684,0.24506675936213929
15217,0.4527619047619048,1,0,1,362369,243241,28996,78960,2.2531494312497684,0.24506441631155707
15218,0.4527777777777778,0,1,0,362370,243240,28996,78960,2.2531401682166807,0.24506517690875232
15219,0.4528073593073592,0,1,0,362371,243239,28996,78960,2.2531309051835935,0.24506593751066888
15220,0.4528333333333332,0,1,0,362372,243238,28996,78960,2.253121642150506,0.24506669811730675
15221,0.4528333333333333,1,9,1,362381,243229,28997,78959,2.2530382748527176,0.24507120066545
15222,0.4528571428571428,3,8,3,362389,243221,29000,78956,2.2529641705880175,0.24507025641184815
15223,0.4528888888888889,0,1,0,362390,243220,29000,78956,2.2529549075549298,0.24507101708382995
15224,0.4528924963924964,0,2,0,362392,243218,29000,78956,2.252936381488755,0.24507253844195995
15225,0.4528928571428572,0,1,0,362393,243217,29000,78956,2.252927118455667,0.24507329912810819
15226,0.452904761904762,0,1,0,362394,243216,29000,78956,2.2529178554225795,0.24507405981897867
15227,0.4529166666666666,0,3,0,362397,243213,29000,78956,2.252890066323317,0.245076341919924
15228,0.4529166666666667,0,2,0,362399,243211,29000,78956,2.252871540257142,0.24507786334416623
15229,0.4529761904761904,0,1,0,362400,243210,29000,78956,2.2528622772240543,0.24507862406337105
15230,0.4529761904761905,1,0,1,362400,243210,29001,78955,2.2528622772240543,0.2450762807877951
15231,0.4529880952380952,0,1,0,362401,243209,29001,78955,2.2528530141909666,0.2450770415068102
15232,0.4529999999999999,8,47,8,362448,243162,29009,78947,2.252417651635852,0.24509405201344886
15233,0.453,4,8,4,362456,243154,29013,78943,2.2523435473711513,0.2450907645833398
15234,0.4530238095238095,0,2,0,362458,243152,29013,78943,2.252325021304976,0.24509228643723124
15235,0.4530357142857142,0,2,0,362460,243150,29013,78943,2.252306495238801,0.24509380831002225
15236,0.453047619047619,1,1,1,362461,243149,29014,78942,2.2522972322057133,0.24509222548906986
15237,0.4530476190476192,0,1,0,362462,243148,29014,78942,2.252287969172626,0.24509298643236363
15238,0.4530555555555555,1,2,1,362464,243146,29015,78941,2.2522694431064507,0.24509216453939464
15239,0.4530714285714285,0,2,0,362466,243144,29015,78941,2.252250917040276,0.24509368644922924
15240,0.4530833333333334,0,2,0,362468,243142,29015,78941,2.2522323909741004,0.2450952083779647
15241,0.4530952380952381,2,8,2,362476,243134,29017,78939,2.2521582867094003,0.24509660853284815
15242,0.4531666666666666,3,15,3,362491,243119,29020,78936,2.252019341213087,0.2451009920665725
15243,0.4531666666666667,0,6,0,362497,243113,29020,78936,2.2519637630145617,0.24510555847091592
15244,0.4531904761904761,0,3,0,362500,243110,29020,78936,2.2519359739152986,0.24510784173689473
15245,0.4532142857142857,0,6,0,362506,243104,29020,78936,2.2518803957167735,0.2451124083964725
15246,0.4532142857142858,1,0,1,362506,243104,29021,78935,2.2518803957167735,0.24511006430898122
15247,0.4532792207792207,0,2,0,362508,243102,29021,78935,2.2518618696505985,0.24511158655682422
15248,0.4533333333333332,1,0,1,362508,243102,29022,78934,2.2518618696505985,0.24510924244494403
15249,0.4533333333333333,113,744,113,363252,242358,29135,78821,2.244970173033458,0.24541143723593387
15250,0.4533571428571428,0,2,0,363254,242356,29135,78821,2.2449516469672828,0.24541296543650387
15251,0.4533809523809523,0,1,0,363255,242355,29135,78821,2.2449423839341955,0.24541372954392607
15252,0.4533888888888889,0,1,0,363256,242354,29135,78821,2.244933120901108,0.24541449365610649
15253,0.4534166666666666,0,1,0,363257,242353,29135,78821,2.24492385786802,0.24541525777304515
15254,0.4534285714285714,2,2,2,363259,242351,29137,78819,2.2449053318018453,0.24541208705669895
15255,0.4534444444444444,0,1,0,363260,242350,29137,78819,2.2448960687687576,0.2454128511780402
15256,0.4534523809523809,0,2,0,363262,242348,29137,78819,2.2448775427025827,0.245414379434998
15257,0.453452380952381,1,0,1,363262,242348,29138,78818,2.2448775427025827,0.2454120299159936
15258,0.4534722222222223,1,0,1,363262,242348,29139,78817,2.2448775427025827,0.24540968038235797
15259,0.4534999999999999,0,1,0,363263,242347,29139,78817,2.244868279669495,0.2454104445081018
15260,0.4535,7,17,7,363280,242330,29146,78810,2.2447108081070066,0.2454069876066513
15261,0.4535476190476189,0,1,0,363281,242329,29146,78810,2.244701545073919,0.2454077517834956
15262,0.453547619047619,0,3,0,363284,242326,29146,78810,2.2446737559746563,0.24541004434258382
15263,0.4535714285714285,0,1,0,363285,242325,29146,78810,2.2446644929415687,0.24541080853846514
15264,0.4535714285714286,1,1,1,363286,242324,29147,78809,2.2446552299084814,0.24540922296992213
15265,0.4535833333333334,0,1,0,363287,242323,29147,78809,2.2446459668753937,0.24540998717038476
15266,0.4536111111111111,0,1,0,363288,242322,29147,78809,2.244636703842306,0.24541075137560683
15267,0.4536666666666666,3,25,3,363313,242297,29150,78806,2.244405128015117,0.24542280825778645
15268,0.4536666666666667,0,2,0,363315,242295,29150,78806,2.2443866019489422,0.2454243368908848
15269,0.4536904761904762,0,6,0,363321,242289,29150,78806,2.244331023750417,0.24542892290443638
15270,0.4537121212121212,0,1,0,363322,242288,29150,78806,2.2443217607173294,0.24542968725669118
15271,0.45375,1,7,1,363329,242281,29151,78805,2.2442569194857165,0.2454326878157254
15272,0.4537500000000001,0,1,0,363330,242280,29151,78805,2.244247656452629,0.24543345220113055
15273,0.4537619047619047,1,1,1,363331,242279,29152,78804,2.244238393419541,0.2454318665267236
15274,0.4537619047619048,1,0,1,363331,242279,29153,78803,2.244238393419541,0.24542951644751185
15275,0.4538076923076923,1,0,1,363331,242279,29154,78802,2.244238393419541,0.24542716635366155
15276,0.4538095238095238,0,7,0,363338,242272,29154,78802,2.2441735521879282,0.24543251711443467
15277,0.4538095238095239,0,4,0,363342,242268,29154,78802,2.2441365000555784,0.24543557479677328
15278,0.4538145743145743,0,1,0,363343,242267,29154,78802,2.2441272370224907,0.24543633922926225
15279,0.4538333333333332,0,3,0,363346,242264,29154,78802,2.244099447923228,0.24543863255530016
15280,0.4538333333333333,3,6,3,363352,242258,29157,78799,2.2440438697247025,0.2454361686554101
15281,0.4538333333333334,0,1,0,363353,242257,29157,78799,2.2440346066916153,0.2454369331207017
15282,0.4538571428571428,1,0,1,363353,242257,29158,78798,2.2440346066916153,0.24543458285963465
15283,0.4538888888888888,0,1,0,363354,242256,29158,78798,2.2440253436585276,0.24543534732474911
15284,0.4538888888888889,0,1,0,363355,242255,29158,78798,2.24401608062544,0.24543611179462582
15285,0.4539166666666666,0,4,0,363359,242251,29158,78798,2.2439790284930896,0.24543916972175586
15286,0.4539166666666667,0,1,0,363360,242250,29158,78798,2.2439697654600024,0.2454399342154444
15287,0.4539404761904761,0,1,0,363361,242249,29158,78798,2.2439605024269147,0.24544069871389548
15288,0.4539722222222221,0,1,0,363362,242248,29158,78798,2.243951239393827,0.24544146321710908
15289,0.4539761904761905,0,2,0,363364,242246,29158,78798,2.243932713327652,0.2454429922378241
15290,0.4539999999999999,20,123,20,363487,242123,29178,78778,2.242793360257883,0.24549004210021158
15291,0.454,0,7,0,363494,242116,29178,78778,2.24272851902627,0.24549539723397756
15292,0.4540238095238095,0,1,0,363495,242115,29178,78778,2.2427192559931823,0.24549616227215926
15293,0.454047619047619,0,4,0,363499,242111,29178,78778,2.242682203860832,0.2454992224725684
15294,0.4540555555555556,1,1,1,363500,242110,29179,78777,2.242672940827745,0.2454976362395485
15295,0.4540714285714285,0,1,0,363501,242109,29179,78777,2.242663677794657,0.24549840130139675
15296,0.4541666666666665,0,1,0,363502,242108,29179,78777,2.2426544147615695,0.24549916636801347
15297,0.4541666666666666,11,77,11,363579,242031,29190,78766,2.241941161213828,0.24553222131129654
15298,0.4541666666666667,10,54,10,363633,241977,29200,78756,2.2414409574271,0.24555003694661914
15299,0.45425,0,2,0,363635,241975,29200,78756,2.241422431360925,0.24555156813653808
15300,0.4542857142857143,2,14,2,363649,241961,29202,78754,2.241292748897699,0.24555758227709962
15301,0.4542857142857144,1,0,1,363649,241961,29203,78753,2.241292748897699,0.2455552298933006
15302,0.4543333333333332,0,1,0,363650,241960,29203,78753,2.2412834858646113,0.2455559955474209
15303,0.4543333333333333,4,43,4,363693,241917,29207,78749,2.240885175441847,0.2455795126393194
15304,0.4543452380952382,1,1,1,363694,241916,29208,78748,2.240875912408759,0.2455779258039568
15305,0.4543571428571427,0,1,0,363695,241915,29208,78748,2.2408666493756715,0.2455786916482413
15306,0.4543571428571428,0,1,0,363696,241914,29208,78748,2.240857386342584,0.24557945749730245
15307,0.4543589743589744,0,1,0,363697,241913,29208,78748,2.2408481233094966,0.2455802233511403
15308,0.4543809523809524,1,1,1,363698,241912,29209,78747,2.240838860276409,0.24557863649546716
15309,0.4544047619047618,0,1,0,363699,241911,29209,78747,2.240829597243321,0.24557940235390976
15310,0.454404761904762,0,1,0,363700,241910,29209,78747,2.240820334210234,0.24558016821712922
15311,0.4544285714285713,1,2,1,363702,241908,29210,78746,2.2408018081440586,0.24557934720914132
15312,0.4544285714285714,0,1,0,363703,241907,29210,78746,2.240792545110971,0.24558011308174257
15313,0.4544444444444444,0,3,0,363706,241904,29210,78746,2.2407647560117083,0.24558241072820833
15314,0.4544999999999999,0,1,0,363707,241903,29210,78746,2.240755492978621,0.24558317661991774
15315,0.4545,4,15,4,363722,241888,29214,78742,2.2406165474823077,0.24558525403112622
15316,0.4545238095238094,0,1,0,363723,241887,29214,78742,2.24060728444922,0.24558601997947785
15317,0.4545238095238095,2,2,2,363725,241885,29216,78740,2.240588758383045,0.24558284600389862
15318,0.4545833333333333,0,2,0,363727,241883,29216,78740,2.2405702323168697,0.2455843779142482
15319,0.4546190476190475,0,1,0,363728,241882,29216,78740,2.2405609692837825,0.2455851438765899
15320,0.4546349206349206,0,1,0,363729,241881,29216,78740,2.2405517062506948,0.24558590984370954
15321,0.4546428571428571,0,1,0,363730,241880,29216,78740,2.240542443217607,0.24558667581560725
15322,0.4546666666666666,6,41,6,363771,241839,29222,78734,2.2401626588610175,0.2456039653994566
15323,0.4546666666666668,0,4,0,363775,241835,29222,78734,2.2401256067286672,0.24560702999978165
15324,0.4547121212121212,0,1,0,363776,241834,29222,78734,2.2401163436955795,0.24560779616181277
15325,0.4547380952380952,0,4,0,363780,241830,29222,78734,2.2400792915632293,0.24561086085773823
15326,0.45475,0,3,0,363783,241827,29222,78734,2.2400515024639667,0.2456131594298745
15327,0.4547619047619047,0,6,0,363789,241821,29222,78734,2.2399959242654415,0.24561775670321787
15328,0.4547777777777777,0,1,0,363790,241820,29222,78734,2.239986661232354,0.24561852293217368
15329,0.4548030303030302,0,1,0,363791,241819,29222,78734,2.2399773981992666,0.24561928916591017
15330,0.4548095238095238,0,3,0,363794,241816,29222,78734,2.2399496091000035,0.2456215878958041
15331,0.4548333333333332,1,2,1,363796,241814,29223,78733,2.2399310830338286,0.24562076700140698
15332,0.4548333333333333,3,17,3,363813,241797,29226,78730,2.2397736114713402,0.24562673347331115
15333,0.4549761904761905,0,1,0,363814,241796,29226,78730,2.2397643484382526,0.24562749979720833
15334,0.4549880952380952,0,1,0,363815,241795,29226,78730,2.239755085405165,0.24562826612588723
15335,0.4549999999999999,8,12,8,363827,241783,29234,78722,2.2396439290081145,0.24561863309464751
15336,0.455,185,1233,185,365060,240550,29419,78537,2.22822260921116,0.24613036569963678
15337,0.455047619047619,0,1,0,365061,240549,29419,78537,2.2282133461780727,0.24613113706022827
15338,0.4550476190476191,0,1,0,365062,240548,29419,78537,2.228204083144985,0.2461319084256546
15339,0.4550714285714285,1,0,1,365062,240548,29420,78536,2.228204083144985,0.24612954582492386
15340,0.4550833333333333,0,1,0,365063,240547,29420,78536,2.2281948201118973,0.24613031719019815
15341,0.4551111111111111,0,1,0,365064,240546,29420,78536,2.22818555707881,0.24613108856030738
15342,0.4551190476190476,0,4,0,365068,240542,29420,78536,2.2281485049464598,0.24613417408909422
15343,0.4551666666666666,4,15,4,365083,240527,29424,78532,2.2280095594501463,0.24613629454113503
15344,0.4551666666666667,0,6,0,365089,240521,29424,78532,2.227953981251621,0.24614092329487577
15345,0.4551785714285714,0,1,0,365090,240520,29424,78532,2.2279447182185335,0.24614169477075837
15346,0.4552023809523809,1,1,1,365091,240519,29425,78531,2.227935455185446,0.24614010343206394
15347,0.4552142857142857,0,1,0,365092,240518,29425,78531,2.2279261921523585,0.24614087491263098
15348,0.4552380952380953,1,1,1,365093,240517,29426,78530,2.227916929119271,0.24613928355383377
15349,0.45525,0,1,0,365094,240516,29426,78530,2.227907666086183,0.24614005503908526
15350,0.4552857142857143,0,1,0,365095,240515,29426,78530,2.2278984030530955,0.246140826529173
15351,0.4553095238095238,1,0,1,365095,240515,29427,78529,2.2278984030530955,0.2461384636601848
15352,0.4553333333333332,0,1,0,365096,240514,29427,78529,2.2278891400200083,0.24613923515012082
15353,0.4553333333333333,6,31,6,365127,240483,29433,78523,2.227601985994294,0.24614897525438392
15354,0.4553571428571428,0,6,0,365133,240477,29433,78523,2.2275464077957685,0.246153605015674
15355,0.4553809523809524,0,1,0,365134,240476,29433,78523,2.2275371447626813,0.24615437665948797
15356,0.4553928571428571,0,1,0,365135,240475,29433,78523,2.2275278817295936,0.24615514830813987
15357,0.4554047619047618,0,1,0,365136,240474,29433,78523,2.227518618696506,0.24615591996162972
15358,0.4554166666666666,0,5,0,365141,240469,29433,78523,2.2274723035310684,0.2461597783016502
15359,0.4554166666666667,0,3,0,365144,240466,29433,78523,2.2274445144318054,0.246162093363721
15360,0.4554404761904762,0,1,0,365145,240465,29433,78523,2.227435251398718,0.24616286506075463
15361,0.455452380952381,0,1,0,365146,240464,29433,78523,2.2274259883656304,0.2461636367626267
15362,0.4554761904761905,0,2,0,365148,240462,29433,78523,2.2274074622994555,0.24616518018088626
15363,0.4554999999999999,3,17,3,365165,240445,29436,78520,2.2272499907369667,0.24617121000736758
15364,0.4555,0,6,0,365171,240439,29436,78520,2.2271944125384415,0.24617584078204408
15365,0.4555238095238095,0,3,0,365174,240436,29436,78520,2.227166623439179,0.24617815623471576
15366,0.455547619047619,0,1,0,365175,240435,29436,78520,2.2271573604060912,0.24617892806195232
15367,0.4555476190476191,0,1,0,365176,240434,29436,78520,2.227148097373004,0.2461796998940286
15368,0.4555555555555555,1,7,1,365183,240427,29437,78519,2.227083256141391,0.24618273939789181
15369,0.4555555555555556,1,0,1,365183,240427,29438,78518,2.227083256141391,0.24618037592688394
15370,0.4555952380952381,0,1,0,365184,240426,29438,78518,2.2270739931083035,0.2461811477876994
15371,0.4556111111111112,0,1,0,365185,240425,29438,78518,2.2270647300752158,0.24618191965335498
15372,0.4556190476190476,0,2,0,365187,240423,29438,78518,2.227046204009041,0.24618346339918667
15373,0.4556428571428572,0,2,0,365189,240421,29438,78518,2.2270276779428655,0.24618500716437938
15374,0.4556666666666665,1,1,1,365190,240420,29439,78517,2.2270184149097783,0.24618341553347525
15375,0.4556666666666666,3,25,3,365215,240395,29442,78514,2.2267868390825893,0.24619562320285723
15376,0.4556666666666667,1,11,1,365226,240384,29443,78513,2.226684945718626,0.2462017516627626
15377,0.4556904761904762,0,1,0,365227,240383,29443,78513,2.2266756826855385,0.2462025237067884
15378,0.4557023809523811,0,5,0,365232,240378,29443,78513,2.226629367520101,0.24620638399954844
15379,0.4557142857142857,2,23,2,365255,240355,29445,78511,2.226416317759087,0.24621941505209086
15380,0.4557611832611835,0,7,0,365262,240348,29445,78511,2.226351476527474,0.24622482037515014
15381,0.4557619047619047,0,3,0,365265,240345,29445,78511,2.2263236874282115,0.246227137014828
15382,0.4557777777777778,0,1,0,365266,240344,29445,78511,2.226314424395124,0.2462279092377413
15383,0.4557857142857142,1,0,1,365266,240344,29446,78510,2.226314424395124,0.2462255452338688
15384,0.4558095238095238,1,1,1,365267,240343,29447,78509,2.2263051613620366,0.24622395343294068
15385,0.4558333333333333,19,116,19,365383,240227,29466,78490,2.2252306495238803,0.24626863330164378
15386,0.4558452380952381,0,1,0,365384,240226,29466,78490,2.2252213864907926,0.24626940599154107
15387,0.4558809523809523,0,1,0,365385,240225,29466,78490,2.225212123457705,0.24627017868628712
15388,0.4558888888888889,0,1,0,365386,240224,29466,78490,2.2252028604246172,0.246270951385882
15389,0.4559047619047618,1,1,1,365387,240223,29467,78489,2.22519359739153,0.24626935917066192
15390,0.455904761904762,1,1,1,365388,240222,29468,78488,2.2251843343584423,0.24626776693545857
15391,0.4559166666666667,0,1,0,365389,240221,29468,78488,2.2251750713253546,0.24626853963960854
15392,0.4559285714285714,0,2,0,365391,240219,29468,78488,2.2251565452591797,0.24627008506245548
15393,0.4559523809523809,1,11,1,365402,240208,29469,78487,2.2250546518952166,0.24627622021054613
15394,0.455952380952381,1,5,1,365407,240203,29470,78486,2.2250083367297786,0.24627771903015166
15395,0.4559761904761905,0,1,0,365408,240202,29470,78486,2.2249990736966914,0.24627849181644743
15396,0.4559999999999999,2,11,2,365419,240191,29472,78484,2.224897180332728,0.24628226249313565
15397,0.456,21,124,21,365543,240067,29493,78463,2.2237485642298713,0.24632844630019152
15398,0.4560128205128205,0,1,0,365544,240066,29493,78463,2.223739301196784,0.2463292196314935
15399,0.4560714285714284,0,1,0,365545,240065,29493,78463,2.2237300381636964,0.2463299929676512
15400,0.4560714285714285,0,1,0,365546,240064,29493,78463,2.2237207751306087,0.24633076630866457
15401,0.4560833333333333,0,1,0,365547,240063,29493,78463,2.223711512097521,0.2463315396545337
15402,0.4560952380952381,0,1,0,365548,240062,29493,78463,2.223702249064434,0.24633231300525862
15403,0.4561190476190476,0,1,0,365549,240061,29493,78463,2.223692986031346,0.24633308636083937
15404,0.4561666666666666,3,15,3,365564,240046,29496,78460,2.2235540405350327,0.24633758861685495
15405,0.4561666666666667,0,2,0,365566,240044,29496,78460,2.2235355144688578,0.2463391354582674
15406,0.4561904761904761,0,1,0,365567,240043,29496,78460,2.22352625143577,0.24633990888625854
15407,0.4561904761904762,1,4,1,365571,240039,29497,78459,2.22348919930342,0.24634063636192377
15408,0.4562380952380952,0,3,0,365574,240036,29497,78459,2.223461410204157,0.24634295671831583
15409,0.45625,4,9,4,365583,240027,29501,78455,2.2233780429063694,0.24634045252164957
15410,0.4562619047619047,1,2,1,365585,240025,29502,78454,2.223359516840194,0.24633963306842838
15411,0.4562619047619048,0,1,0,365586,240024,29502,78454,2.2233502538071064,0.2463404065586948
15412,0.4562857142857142,1,1,1,365587,240023,29503,78453,2.223340990774019,0.2463388135997689
15413,0.4562857142857143,0,1,0,365588,240022,29503,78453,2.2233317277409315,0.2463395870947484
15414,0.4563095238095238,1,3,1,365591,240019,29504,78452,2.223303938641669,0.24633954111991357
15415,0.4563095238095239,0,2,0,365593,240017,29504,78452,2.2232854125754935,0.24634108814358696
15416,0.4563333333333332,1,1,1,365594,240016,29505,78451,2.2232761495424063,0.24633949514392386
15417,0.4563333333333333,2,23,2,365617,239993,29507,78449,2.2230630997813923,0.24635255399727424
15418,0.4563564213564213,0,1,0,365618,239992,29507,78449,2.223053836748305,0.2463533276179889
15419,0.4563690476190476,2,1,2,365619,239991,29509,78447,2.2230445737152174,0.24634936785182673
15420,0.4563809523809523,0,1,0,365620,239990,29509,78447,2.2230353106821297,0.24635014147225354
15421,0.4563888888888888,1,0,1,365620,239990,29510,78446,2.2230353106821297,0.24634777474908615
15422,0.4563888888888889,1,0,1,365620,239990,29511,78445,2.2230353106821297,0.24634540801105406
15423,0.4564047619047619,0,1,0,365621,239989,29511,78445,2.223026047649042,0.24634618162633387
15424,0.4564285714285714,1,5,1,365626,239984,29512,78444,2.2229797324836045,0.24634768299270166
15425,0.4564444444444444,0,2,0,365628,239982,29512,78444,2.222961206417429,0.24634923027642217
15426,0.4564523809523809,0,1,0,365629,239981,29512,78444,2.222951943384342,0.24635000392557116
15427,0.456452380952381,1,2,1,365631,239979,29513,78443,2.2229334173181665,0.24634918441564968
15428,0.4564999999999999,4,28,4,365659,239951,29517,78439,2.222674052391715,0.2463613806966299
15429,0.4565000000000001,0,1,0,365660,239950,29517,78439,2.2226647893586278,0.24636215447141704
15430,0.4565187969924812,0,2,0,365662,239948,29517,78439,2.2226462632924524,0.24636370203557306
15431,0.4565238095238095,1,1,1,365663,239947,29518,78438,2.2226370002593647,0.2463621087676869
15432,0.4565476190476191,0,1,0,365664,239946,29518,78438,2.2226277372262775,0.2463628825569124
15433,0.4566190476190476,0,2,0,365666,239944,29518,78438,2.222609211160102,0.24636443014994566
15434,0.4566428571428571,0,2,0,365668,239942,29518,78438,2.222590685093927,0.24636597776242225
15435,0.4566666666666665,0,4,0,365672,239938,29518,78438,2.222553632961577,0.24636907304570696
15436,0.4566666666666666,61,417,61,366089,239521,29579,78377,2.218690948164067,0.24654763477593442
15437,0.4566666666666667,38,279,38,366368,239242,29617,78339,2.2161065619326394,0.2466740768496856
15438,0.4566904761904762,3,1,3,366369,239241,29620,78336,2.2160972988995518,0.24666773727316524
15439,0.4567023809523809,1,0,1,366369,239241,29621,78335,2.2160972988995518,0.24666536514094264
15440,0.4567142857142857,0,1,0,366370,239240,29621,78335,2.216088035866464,0.24666614185625443
15441,0.45675,0,1,0,366371,239239,29621,78335,2.2160787728333764,0.24666691857645778
15442,0.4567619047619047,0,3,0,366374,239236,29621,78335,2.216050983734114,0.24666924876641758
15443,0.4567857142857142,0,1,0,366375,239235,29621,78335,2.2160417207010266,0.2466700255061876
15444,0.4567857142857143,1,4,1,366379,239231,29622,78334,2.2160046685686763,0.24667076031678553
15445,0.4568217893217893,0,1,0,366380,239230,29622,78334,2.2159954055355886,0.246671537075991
15446,0.4568333333333333,1,5,1,366385,239225,29623,78333,2.2159490903701506,0.24667304870291412
15447,0.4568571428571428,1,0,1,366385,239225,29624,78332,2.2159490903701506,0.24667067644548854
15448,0.4569047619047619,0,1,0,366386,239224,29624,78332,2.2159398273370634,0.24667145322399828
15449,0.4569230769230769,0,1,0,366387,239223,29624,78332,2.2159305643039757,0.2466722300074003
15450,0.4569285714285714,1,0,1,366387,239223,29625,78331,2.2159305643039757,0.24666985772498537
15451,0.4569444444444444,1,0,1,366387,239223,29626,78330,2.2159305643039757,0.2466674854276294
15452,0.4569523809523809,1,1,1,366388,239222,29627,78329,2.215921301270888,0.24666588988855334
15453,0.4569999999999999,1,7,1,366395,239215,29628,78328,2.215856460039275,0.24666895507065184
15454,0.457,4,41,4,366436,239174,29632,78324,2.2154766756826856,0.2466913177405842
15455,0.4570000000000001,0,2,0,366438,239172,29632,78324,2.21545814961651,0.24669287172121854
15456,0.4570238095238095,1,5,1,366443,239167,29633,78323,2.2154118344510727,0.24669438407508898
15457,0.4570555555555555,0,1,0,366444,239166,29633,78323,2.215402571417985,0.24669516109219533
15458,0.4570833333333333,0,2,0,366446,239164,29633,78323,2.21538404535181,0.2466967151410924
15459,0.457095238095238,0,1,0,366447,239163,29633,78323,2.2153747823187224,0.24669749217288323
15460,0.4570952380952381,0,1,0,366448,239162,29633,78323,2.2153655192856347,0.24669826920956894
15461,0.4571190476190475,0,1,0,366449,239161,29633,78323,2.2153562562525475,0.24669904625114966
15462,0.4571428571428571,1,9,1,366458,239152,29634,78322,2.2152728889547593,0.2467036670719492
15463,0.4571666666666666,5,16,5,366474,239136,29639,78317,2.2151246804253586,0.24670423653265208
15464,0.4571904761904761,0,1,0,366475,239135,29639,78317,2.215115417392271,0.2467050136713582
15465,0.4571904761904762,0,1,0,366476,239134,29639,78317,2.2151061543591832,0.2467057908149604
15466,0.4572142857142857,1,0,1,366476,239134,29640,78316,2.2151061543591832,0.2467034178610805
15467,0.4572222222222223,0,1,0,366477,239133,29640,78316,2.215096891326096,0.2467041950045519
15468,0.45725,0,2,0,366479,239131,29640,78316,2.2150783652599206,0.2467057493061834
15469,0.4572619047619047,0,1,0,366480,239130,29640,78316,2.215069102226833,0.24670652646434355
15470,0.4572727272727273,0,1,0,366481,239129,29640,78316,2.2150598391937457,0.2467073036274
15471,0.4573160173160173,0,1,0,366482,239128,29640,78316,2.215050576160658,0.2467080807953529
15472,0.4573214285714285,0,1,0,366483,239127,29640,78316,2.2150413131275704,0.24670885796820216
15473,0.4573333333333332,2,11,2,366494,239116,29642,78314,2.214939419763607,0.24671266105913114
15474,0.4573333333333333,6,32,6,366526,239084,29648,78308,2.214643002704806,0.2467232948530524
15475,0.4573333333333334,0,1,0,366527,239083,29648,78308,2.214633739671718,0.24672407220116513
15476,0.4573571428571428,0,1,0,366528,239082,29648,78308,2.2146244766386305,0.24672484955417626
15477,0.4573809523809523,1,3,1,366531,239079,29649,78307,2.214596687539368,0.24672480827761778
15478,0.4573809523809524,1,1,1,366532,239078,29650,78306,2.21458742450628,0.24672321226022736
15479,0.4574166666666667,0,3,0,366535,239075,29650,78306,2.2145596354070176,0.24672554437726266
15480,0.457452380952381,0,1,0,366536,239074,29650,78306,2.21455037237393,0.24672632175940512
15481,0.4574999999999998,1,0,1,366536,239074,29651,78305,2.21455037237393,0.24672394833936712
15482,0.4574999999999999,3,7,3,366543,239067,29654,78302,2.214485531142317,0.24672226966086794
15483,0.4575,33,336,33,366879,238731,29687,78269,2.211373152024899,0.24690536277602523
15484,0.4575000000000001,0,14,0,366893,238717,29687,78269,2.211243469561673,0.2469162675954143
15485,0.4575595238095238,0,1,0,366894,238716,29687,78269,2.211234206528586,0.2469170465479439
15486,0.4575714285714287,0,1,0,366895,238715,29687,78269,2.2112249434954983,0.2469178255053883
15487,0.4575833333333334,0,2,0,366897,238713,29687,78269,2.211206417429323,0.24691938343502154
15488,0.4576111111111111,0,1,0,366898,238712,29687,78269,2.2111971543962357,0.24692016240721051
15489,0.4576190476190476,0,4,0,366902,238708,29687,78269,2.2111601022638854,0.24692327834511651
15490,0.4576428571428571,0,2,0,366904,238706,29687,78269,2.21114157619771,0.24692483634356022
15491,0.4576666666666666,3,29,3,366933,238677,29690,78266,2.2108729482381713,0.2469403015684208
15492,0.4576666666666667,2,11,2,366944,238666,29692,78264,2.210771054874208,0.2469441201527151
15493,0.4577142857142858,0,1,0,366945,238665,29692,78264,2.2107617918411204,0.24694489933076494
15494,0.4577380952380951,0,1,0,366946,238664,29692,78264,2.2107525288080327,0.24694567851373184
15495,0.4577380952380953,0,1,0,366947,238663,29692,78264,2.2107432657749455,0.24694645770161583
15496,0.45775,0,1,0,366948,238662,29692,78264,2.210734002741858,0.246947236894417
15497,0.4577619047619047,0,1,0,366949,238661,29692,78264,2.21072473970877,0.24694801609213538
15498,0.4577777777777778,0,5,0,366954,238656,29692,78264,2.2106784245433326,0.24695191215448695
15499,0.4578095238095238,0,1,0,366955,238655,29692,78264,2.210669161510245,0.24695269138170953
15500,0.4578214285714285,0,1,0,366956,238654,29692,78264,2.2106598984771573,0.24695347061384965
15501,0.4578333333333333,1,18,1,366974,238636,29693,78263,2.2104931638815812,0.24696512137936694
15502,0.4578571428571428,1,8,1,366982,238628,29694,78262,2.210419059616881,0.24696897977216067
15503,0.4578888888888889,0,1,0,366983,238627,29694,78262,2.2104097965837934,0.24696975912701294
15504,0.4579047619047618,0,1,0,366984,238626,29694,78262,2.2104005335507058,0.24697053848678396
15505,0.4579166666666666,1,5,1,366989,238621,29695,78261,2.2103542183852682,0.2469720589998801
15506,0.4579166666666667,0,2,0,366991,238619,29695,78261,2.210335692319093,0.24697361777328958
15507,0.4579761904761904,0,1,0,366992,238618,29695,78261,2.210326429286005,0.24697439716737304
15508,0.4579761904761905,0,2,0,366994,238616,29695,78261,2.2103079032198303,0.24697595597029762
15509,0.4579999999999999,15,100,15,367094,238516,29710,78246,2.209381599911075,0.24701826607989594
15510,0.458,1,7,1,367101,238509,29711,78245,2.209316758679462,0.24702134779671292
15511,0.4580000000000001,0,3,0,367104,238506,29711,78245,2.209288969580199,0.2470236873758883
15512,0.4580238095238095,1,2,1,367106,238504,29712,78244,2.2092704435140242,0.24702286991551645
15513,0.4580833333333333,0,2,0,367108,238502,29712,78244,2.2092519174478493,0.24702442966919866
15514,0.4580833333333334,0,1,0,367109,238501,29712,78244,2.2092426544147616,0.24702520955342624
15515,0.4580952380952381,1,4,1,367113,238497,29713,78243,2.2092056022824114,0.24702595188482668
15516,0.4581071428571428,0,1,0,367114,238496,29713,78243,2.2091963392493237,0.24702673178863355
15517,0.4581190476190475,0,3,0,367117,238493,29713,78243,2.209168550150061,0.24702907152960193
15518,0.4581428571428572,1,1,1,367118,238492,29714,78242,2.2091592871169734,0.24702747415812637
15519,0.4581666666666666,2,14,2,367132,238478,29716,78240,2.2090296046537476,0.24703363875750667
15520,0.4581666666666667,0,5,0,367137,238473,29716,78240,2.20898328948831,0.24703753871801915
15521,0.4581904761904761,1,0,1,367137,238473,29717,78239,2.20898328948831,0.24703516128217434
15522,0.4582142857142857,1,2,1,367139,238471,29718,78238,2.2089647634221348,0.24703434382982487
15523,0.4582499999999999,0,1,0,367140,238470,29718,78238,2.2089555003890475,0.24703512383646767
15524,0.45825,0,2,0,367142,238468,29718,78238,2.208936974322872,0.2470366838645305
15525,0.4583076923076923,0,2,0,367144,238466,29718,78238,2.2089184482566973,0.24703824391229665
15526,0.4583181818181818,0,1,0,367145,238465,29718,78238,2.2089091852236096,0.24703902394356858
15527,0.4583333333333332,36,196,36,367341,238269,29754,78202,2.207093630738449,0.2471063699359499
15528,0.4583333333333333,26,207,26,367548,238062,29780,78176,2.2051761828893253,0.24720621810155644
15529,0.4583333333333334,1,6,1,367554,238056,29781,78175,2.2051206046908,0.24720852794318077
15530,0.4583809523809524,0,5,0,367559,238051,29781,78175,2.205074289525362,0.2472124366750362
15531,0.458404761904762,0,1,0,367560,238050,29781,78175,2.2050650264922744,0.24721321843624003
15532,0.4584166666666666,0,1,0,367561,238049,29781,78175,2.205055763459187,0.24721400020238818
15533,0.4584285714285713,1,0,1,367561,238049,29782,78174,2.205055763459187,0.2472116196481597
15534,0.4584444444444444,0,2,0,367563,238047,29782,78174,2.205037237393012,0.24721318318517746
15535,0.458452380952381,0,1,0,367564,238046,29782,78174,2.2050279743599246,0.24721396496110304
15536,0.4584642857142856,0,1,0,367565,238045,29782,78174,2.205018711326837,0.24721474674197313
15537,0.4584999999999999,2,2,2,367567,238043,29784,78172,2.2050001852606615,0.2472115491042487
15538,0.4585,5,35,5,367602,238008,29789,78167,2.204675979102597,0.2472270103581877
15539,0.4585238095238095,0,2,0,367604,238006,29789,78167,2.2046574530364222,0.24722857422993108
15540,0.4585454545454544,1,1,1,367605,238005,29790,78166,2.2046481900033346,0.24722697527603735
15541,0.458563492063492,0,1,0,367606,238004,29790,78166,2.2046389269702473,0.2472277572192175
15542,0.4585714285714285,0,2,0,367608,238002,29790,78166,2.204620400904072,0.24722932112041698
15543,0.4585714285714286,0,3,0,367611,237999,29790,78166,2.2045926118048094,0.24723166700931476
15544,0.4585833333333333,0,1,0,367612,237998,29790,78166,2.2045833487717217,0.2472324489821738
15545,0.4586111111111112,1,2,1,367614,237996,29791,78165,2.2045648227055468,0.2472316319849697
15546,0.4586190476190477,0,1,0,367615,237995,29791,78165,2.204555559672459,0.24723241396761134
15547,0.4586666666666666,7,42,7,367657,237953,29798,78158,2.204166512282782,0.24724859305750196
15548,0.4586666666666667,0,3,0,367660,237950,29798,78158,2.204138723183519,0.2472509395523049
15549,0.4586904761904761,0,1,0,367661,237949,29798,78158,2.2041294601504315,0.2472517217271367
15550,0.4587142857142857,0,1,0,367662,237948,29798,78158,2.2041201971173443,0.2472525039069173
15551,0.4587499999999999,1,1,1,367663,237947,29799,78157,2.2041109340842566,0.2472509047655202
15552,0.45875,2,2,2,367665,237945,29801,78155,2.2040924080180813,0.24724770642201835
15553,0.4587857142857144,0,1,0,367666,237944,29801,78155,2.204083144984994,0.2472484886064176
15554,0.4588095238095238,0,3,0,367669,237941,29801,78155,2.2040553558857314,0.24725083518930957
15555,0.458829365079365,0,1,0,367670,237940,29801,78155,2.2040460928526437,0.24725161739350512
15556,0.4588333333333333,3,11,3,367681,237929,29804,78152,2.2039441994886806,0.24725307753392325
15557,0.4588333333333334,1,3,1,367684,237926,29805,78151,2.203916410389418,0.24725304277122348
15558,0.4588571428571428,0,1,0,367685,237925,29805,78151,2.2039071473563303,0.2472538250294233
15559,0.4588690476190475,0,2,0,367687,237923,29805,78151,2.2038886212901554,0.2472553895606725
15560,0.4588809523809524,0,1,0,367688,237922,29805,78151,2.2038793582570677,0.24725617183372195
15561,0.4588888888888889,0,1,0,367689,237921,29805,78151,2.20387009522398,0.24725695411172138
15562,0.4589047619047619,0,1,0,367690,237920,29805,78151,2.203860832190893,0.24725773639467083
15563,0.4589126984126984,1,0,1,367690,237920,29806,78150,2.203860832190893,0.2472553548264625
15564,0.4589285714285714,0,1,0,367691,237919,29806,78150,2.203851569157805,0.24725613710930208
15565,0.4589523809523808,0,1,0,367692,237918,29806,78150,2.2038423061247174,0.24725691939709177
15566,0.4589523809523809,0,1,0,367693,237917,29806,78150,2.2038330430916298,0.24725770168983158
15567,0.458952380952381,1,0,1,367693,237917,29807,78149,2.2038330430916298,0.24725532009137333
15568,0.4589642857142857,0,1,0,367694,237916,29807,78149,2.2038237800585425,0.24725610238400328
15569,0.4589999999999999,5,71,5,367765,237845,29812,78144,2.203166104709326,0.24729974777603017
15570,0.4590000000000001,2,9,2,367774,237836,29814,78142,2.203082737411538,0.24730202735633494
15571,0.459047619047619,0,8,0,367782,237828,29814,78142,2.2030086331468377,0.24730828876159128
15572,0.4591071428571428,0,1,0,367783,237827,29814,78142,2.20299937011375,0.24730907145954192
15573,0.4591190476190476,0,1,0,367784,237826,29814,78142,2.2029901070806623,0.24730985416244683
15574,0.4591666666666666,11,60,11,367844,237766,29825,78131,2.202434325095409,0.24733061725815694
15575,0.4591666666666667,8,52,8,367896,237714,29833,78123,2.2019526473748563,0.24735227348284083
15576,0.4592301587301587,0,1,0,367897,237713,29833,78123,2.201943384341769,0.24735305664965362
15577,0.4592380952380951,0,1,0,367898,237712,29833,78123,2.2019341213086814,0.24735383982142575
15578,0.4592857142857142,0,1,0,367899,237711,29833,78123,2.2019248582755937,0.24735462299815725
15579,0.4592857142857143,1,4,1,367903,237707,29834,78122,2.2018878061432434,0.24735537268585214
15580,0.4593333333333333,6,60,6,367963,237647,29840,78116,2.20133202415799,0.2473880727000947
15581,0.4593571428571428,0,1,0,367964,237646,29840,78116,2.201322761124903,0.2473888561638196
15582,0.4594047619047618,0,1,0,367965,237645,29840,78116,2.201313498091815,0.24738963963250687
15583,0.459404761904762,0,2,0,367967,237643,29840,78116,2.2012949720256403,0.24739120658476876
15584,0.4594090909090908,0,1,0,367968,237642,29840,78116,2.2012857089925526,0.24739199006834348
15585,0.4594285714285713,0,1,0,367969,237641,29840,78116,2.201276445959465,0.24739277355688077
15586,0.4594404761904762,0,2,0,367971,237639,29840,78116,2.20125791989329,0.24739434054884324
15587,0.4594444444444444,0,2,0,367973,237637,29840,78116,2.2012393938271146,0.2473959075606566
15588,0.4594642857142858,0,2,0,367975,237635,29840,78116,2.2012208677609397,0.24739747459232117
15589,0.4594761904761905,1,0,1,367975,237635,29841,78115,2.2012208677609397,0.2473950910530483
15590,0.4594999999999999,0,4,0,367979,237631,29841,78115,2.2011838156285894,0.2473982251556631
15591,0.4595,3,16,3,367995,237615,29844,78112,2.2010356070991888,0.2474036113477783
15592,0.4595238095238095,0,5,0,368000,237610,29844,78112,2.200989291933751,0.2474075294087837
15593,0.459534188034188,0,1,0,368001,237609,29844,78112,2.200980028900663,0.24740831303587663
15594,0.459547619047619,0,1,0,368002,237608,29844,78112,2.200970765867576,0.24740909666793362
15595,0.4595833333333333,0,6,0,368008,237602,29844,78112,2.2009151876690503,0.24741379856452358
15596,0.4596190476190476,0,1,0,368009,237601,29844,78112,2.200905924635963,0.24741458223133037
15597,0.4596212121212122,0,2,0,368011,237599,29844,78112,2.2008873985697877,0.24741614957983726
15598,0.4596309523809523,0,1,0,368012,237598,29844,78112,2.2008781355367,0.2474169332615375
15599,0.4596309523809525,0,2,0,368014,237596,29844,78112,2.200859609470525,0.24741850063983176
15600,0.4596428571428571,0,5,0,368019,237591,29844,78112,2.200813294305087,0.24742241917245006
15601,0.4596666666666666,2,26,2,368045,237565,29846,78110,2.200572455444811,0.24743802961907024
15602,0.4596998001998004,1,1,1,368046,237564,29847,78109,2.2005631924117233,0.2474364294697361
15603,0.459702380952381,2,1,2,368047,237563,29849,78107,2.2005539293786356,0.2474324452751291
15604,0.4597142857142857,0,1,0,368048,237562,29849,78107,2.2005446663455484,0.24743322911023888
15605,0.4597222222222221,0,1,0,368049,237561,29849,78107,2.2005354033124607,0.2474340129503149
15606,0.4597261904761904,0,1,0,368050,237560,29849,78107,2.200526140279373,0.24743479679535713
15607,0.4597499999999999,0,1,0,368051,237559,29849,78107,2.2005168772462853,0.24743558064536567
15608,0.45975,0,1,0,368052,237558,29849,78107,2.200507614213198,0.24743636450034054
15609,0.4597500000000001,0,2,0,368054,237556,29849,78107,2.2004890881470227,0.24743793222518953
15610,0.4597857142857143,0,5,0,368059,237551,29849,78107,2.200442772981585,0.24744185162422622
15611,0.4598095238095239,0,1,0,368060,237550,29849,78107,2.2004335099484975,0.24744263551893353
15612,0.4598333333333332,3,9,3,368069,237541,29852,78104,2.2003501426507097,0.2474425382946031
15613,0.4598333333333333,2,21,2,368090,237520,29854,78102,2.200155618955871,0.24745423322835544
15614,0.4598333333333334,0,1,0,368091,237519,29854,78102,2.2001463559227834,0.2474550172517038
15615,0.4598484848484848,0,1,0,368092,237518,29854,78102,2.2001370928896957,0.2474558012800203
15616,0.4598571428571428,0,1,0,368093,237517,29854,78102,2.200127829856608,0.24745658531330497
15617,0.4598809523809523,0,4,0,368097,237513,29854,78102,2.200090777724258,0.2474597214961266
15618,0.4599047619047619,1,0,1,368097,237513,29855,78101,2.200090777724258,0.2474573371269969
15619,0.4599285714285714,0,3,0,368100,237510,29855,78101,2.200062988624995,0.24745968930106998
15620,0.4599285714285715,1,0,1,368100,237510,29856,78100,2.200062988624995,0.24745730490161907
15621,0.4599523809523809,0,1,0,368101,237509,29856,78100,2.200053725591908,0.24745808896450988
15622,0.4599761904761905,0,1,0,368102,237508,29856,78100,2.2000444625588202,0.24745887303236927
15623,0.4599999999999999,5,25,5,368127,237483,29861,78095,2.1998128867316313,0.24746655343528381
15624,0.46,457,3225,457,371352,234258,30318,77638,2.169939605024269,0.24892271782901992
15625,0.4600000000000001,7,22,7,371374,234236,30325,77631,2.169735818296343,0.2489234192780897
15626,0.4600238095238095,0,1,0,371375,234235,30325,77631,2.169726555263255,0.24892421745236737
15627,0.4600833333333333,1,0,1,371375,234235,30326,77630,2.169726555263255,0.24892180911612397
15628,0.4600876068376067,0,1,0,371376,234234,30326,77630,2.169717292230168,0.24892260729035734
15629,0.4601190476190476,2,4,2,371380,234230,30328,77628,2.1696802400978177,0.24892098326802584
15630,0.4601666666666666,1,22,1,371402,234208,30329,77627,2.1694764533698914,0.24893613609761572
15631,0.4601666666666667,0,6,0,371408,234202,30329,77627,2.169420875171366,0.24894092595621317
15632,0.4601785714285714,0,2,0,371410,234200,30329,77627,2.169402349105191,0.24894252261670735
15633,0.4601904761904762,0,3,0,371413,234197,30329,77627,2.169374560005928,0.2489449176458515
15634,0.4602445054945054,0,2,0,371415,234195,30329,77627,2.1693560339397533,0.24894651435755014
15635,0.46025,0,4,0,371419,234191,30329,77627,2.169318981807403,0.24894970784239526
15636,0.4603055555555556,1,0,1,371419,234191,30330,77626,2.169318981807403,0.24894729921716904
15637,0.4603333333333332,0,3,0,371422,234188,30330,77626,2.1692911927081404,0.248949694369079
15638,0.4603333333333333,1,19,1,371441,234169,30331,77625,2.1691151950794767,0.24896245598055125
15639,0.4603809523809523,1,0,1,371441,234169,30332,77624,2.1691151950794767,0.24896004721080975
15640,0.4604166666666666,1,0,1,371441,234169,30333,77623,2.1691151950794767,0.24895763842561708
15641,0.4604166666666667,0,2,0,371443,234167,30333,77623,2.169096669013302,0.2489592353827897
15642,0.4604761904761904,1,2,1,371445,234165,30334,77622,2.1690781429471264,0.2489584235391469
15643,0.4604761904761905,0,4,0,371449,234161,30334,77622,2.1690410908147766,0.24896161753527293
15644,0.4604999999999999,2,29,2,371478,234132,30336,77620,2.1687724628552374,0.24897995842849444
15645,0.4605238095238095,1,0,1,371478,234132,30337,77619,2.1687724628552374,0.24897754939037886
15646,0.460547619047619,0,1,0,371479,234131,30337,77619,2.1687631998221497,0.24897834803528468
15647,0.4605555555555555,1,4,1,371483,234127,30338,77618,2.1687261476897994,0.2489791335867456
15648,0.4605714285714286,0,1,0,371484,234126,30338,77618,2.168716884656712,0.2489799322521043
15649,0.4605833333333333,0,2,0,371486,234124,30338,77618,2.168698358590537,0.2489815295981934
15650,0.4605912698412697,0,1,0,371487,234123,30338,77618,2.168689095557449,0.24898232827892386
15651,0.4605952380952381,1,0,1,371487,234123,30339,77617,2.168689095557449,0.2489799191634054
15652,0.4606190476190476,0,1,0,371488,234122,30339,77617,2.168679832524362,0.24898071784409392
15653,0.4606388888888888,0,1,0,371489,234121,30339,77617,2.1686705694912742,0.24898151652990652
15654,0.4606666666666666,4,35,4,371524,234086,30343,77613,2.16834636333321,0.2489998363806108
15655,0.4606666666666667,2,13,2,371537,234073,30345,77611,2.1682259439030718,0.24900540290807358
15656,0.4606904761904761,0,1,0,371538,234072,30345,77611,2.168216680869984,0.24900620181402258
15657,0.4606904761904762,0,1,0,371539,234071,30345,77611,2.1682074178368964,0.24900700072509802
15658,0.4607142857142857,2,11,2,371550,234060,30347,77609,2.1681055244729333,0.2490109699713478
15659,0.4607222222222222,0,1,0,371551,234059,30347,77609,2.168096261439846,0.24901176893360885
15660,0.46075,0,2,0,371553,234057,30347,77609,2.1680777353736707,0.24901336687351203
15661,0.4607619047619047,0,1,0,371554,234056,30347,77609,2.1680684723405834,0.2490141658511543
15662,0.4607857142857143,0,2,0,371556,234054,30347,77609,2.168049946274408,0.24901576382182036
15663,0.4608095238095238,0,2,0,371558,234052,30347,77609,2.168031420208233,0.24901736181299552
15664,0.4608333333333332,8,65,8,371623,233987,30355,77601,2.167429323057542,0.24905002760054945
15665,0.4608333333333334,11,79,11,371702,233908,30366,77590,2.1666975434436253,0.24908667150350886
15666,0.4608571428571429,0,1,0,371703,233907,30366,77590,2.1666882804105376,0.24908747114739468
15667,0.4608809523809523,0,4,0,371707,233903,30366,77590,2.1666512282781873,0.24909066977428065
15668,0.4609415584415585,0,2,0,371709,233901,30366,77590,2.1666327022120124,0.2490922691185299
15669,0.4609523809523809,2,4,2,371713,233897,30368,77588,2.166595650079662,0.24909064641957077
15670,0.460952380952381,0,4,0,371717,233893,30368,77588,2.166558597947312,0.24909384521046227
15671,0.4609618437118437,0,1,0,371718,233892,30368,77588,2.166549334914224,0.2490946449210222
15672,0.4609761904761905,1,1,1,371719,233891,30369,77587,2.166540071881137,0.24909303385792897
15673,0.4609999999999999,0,3,0,371722,233888,30369,77587,2.166512282781874,0.2490954330203066
15674,0.461,8,63,8,371785,233825,30377,77579,2.165928711697358,0.24912653658912537
15675,0.4610000000000001,0,4,0,371789,233821,30377,77579,2.165891659565008,0.24912973667308927
15676,0.4610515873015873,0,1,0,371790,233820,30377,77579,2.1658823965319205,0.24913053670692584
15677,0.4610555555555555,0,4,0,371794,233816,30377,77579,2.16584534439957,0.24913373689365598
15678,0.4610714285714285,0,2,0,371796,233814,30377,77579,2.1658268183333953,0.24913533701785204
15679,0.4611111111111111,0,4,0,371800,233810,30377,77579,2.165789766201045,0.24913853732790817
15680,0.4611547619047618,0,1,0,371801,233809,30377,77579,2.1657805031679573,0.24913933741826916
15681,0.4611666666666666,0,16,0,371817,233793,30377,77579,2.1656322946385567,0.24915213956296647
15682,0.4611666666666667,0,3,0,371820,233790,30377,77579,2.1656045055392936,0.2491545401115718
15683,0.4611904761904761,0,1,0,371821,233789,30377,77579,2.1655952425062064,0.2491553403047198
15684,0.4611904761904762,2,3,2,371824,233786,30379,77577,2.165567453406944,0.24915291797676667
15685,0.4612142857142857,0,2,0,371826,233784,30379,77577,2.1655489273407684,0.24915451838862285
15686,0.4612380952380951,0,1,0,371827,233783,30379,77577,2.1655396643076807,0.24915531860226106
15687,0.4612499999999999,0,1,0,371828,233782,30379,77577,2.1655304012745935,0.24915611882103939
15688,0.46125,3,10,3,371838,233772,30382,77574,2.165437770943718,0.24915688655065427
15689,0.4612539682539683,0,1,0,371839,233771,30382,77574,2.1654285079106304,0.24915768681045142
15690,0.4613095238095238,0,1,0,371840,233770,30382,77574,2.1654192448775427,0.2491584870753893
15691,0.4613209013209012,1,0,1,371840,233770,30383,77573,2.1654192448775427,0.24915607545376
15692,0.4613333333333332,2,8,2,371848,233762,30385,77571,2.165345140612842,0.24915765434438367
15693,0.4613333333333333,2,27,2,371875,233735,30387,77569,2.1650950387194783,0.24917444041836917
15694,0.4613333333333334,0,5,0,371880,233730,30387,77569,2.1650487235540403,0.24917844259056404
15695,0.4613636363636364,0,1,0,371881,233729,30387,77569,2.165039460520953,0.2491792430404307
15696,0.4613809523809524,0,2,0,371883,233727,30387,77569,2.1650209344547777,0.24918084395559212
15697,0.4614047619047619,0,1,0,371884,233726,30387,77569,2.1650116714216905,0.24918164442088694
15698,0.4614166666666666,0,3,0,371887,233723,30387,77569,2.1649838823224274,0.2491840458476286
15699,0.4614285714285714,2,11,2,371898,233712,30389,77567,2.1648819889584647,0.24918802746089522
15700,0.4614444444444444,1,0,1,371898,233712,30390,77566,2.1648819889584647,0.24918561543057974
15701,0.4614523809523809,0,1,0,371899,233711,30390,77566,2.164872725925377,0.24918641595749125
15702,0.4614761904761905,0,2,0,371901,233709,30390,77566,2.1648541998592017,0.24918801702674484
15703,0.4614999999999999,7,24,7,371925,233685,30397,77559,2.1646318870651005,0.24919034583799204
15704,0.4615000000000001,0,2,0,371927,233683,30397,77559,2.1646133609989255,0.24919194710225484
15705,0.4615079365079364,0,3,0,371930,233680,30397,77559,2.164585571899663,0.24919434903723506
15706,0.4615238095238095,0,1,0,371931,233679,30397,77559,2.1645763088665753,0.24919514969251827
15707,0.461547619047619,1,2,1,371933,233677,30398,77558,2.1645577828004003,0.24919433868298874
15708,0.4615555555555555,0,1,0,371934,233676,30398,77558,2.1645485197673127,0.24919513934852877
15709,0.461563492063492,1,1,1,371935,233675,30399,77557,2.164539256734225,0.24919352765782438
15710,0.4615714285714286,0,1,0,371936,233674,30399,77557,2.1645299937011373,0.24919432832847627
15711,0.4615833333333334,0,1,0,371937,233673,30399,77557,2.16452073066805,0.24919512900427337
15712,0.4615952380952381,0,1,0,371938,233672,30399,77557,2.1645114676349624,0.2491959296852157
15713,0.4616190476190476,0,1,0,371939,233671,30399,77557,2.1645022046018747,0.24919673037130335
15714,0.4616666666666665,3,1,3,371940,233670,30402,77554,2.1644929415687875,0.2491902938076755
15715,0.4616666666666666,51,272,51,372212,233398,30453,77503,2.1619733965689725,0.24928514221568923
15716,0.4616666666666667,29,164,29,372376,233234,30482,77474,2.1604542591426137,0.24934665344954104
15717,0.4616666666666668,0,1,0,372377,233233,30482,77474,2.160444996109526,0.24934745596333524
15718,0.4616904761904762,0,1,0,372378,233232,30482,77474,2.1604357330764388,0.24934825848229517
15719,0.4617142857142858,1,0,1,372378,233232,30483,77473,2.1604357330764388,0.24934584251943162
15720,0.4617261904761905,0,1,0,372379,233231,30483,77473,2.160426470043351,0.24934664503836448
15721,0.46175,0,2,0,372381,233229,30483,77473,2.1604079439771757,0.24934825009172776
15722,0.4617857142857142,0,1,0,372382,233228,30483,77473,2.1603986809440885,0.24934905262615828
15723,0.4617857142857143,0,2,0,372384,233226,30483,77473,2.160380154877913,0.24935065771051726
15724,0.4618333333333333,0,5,0,372389,233221,30483,77473,2.1603338397124756,0.24935467051182192
15725,0.4618333333333334,1,14,1,372403,233207,30484,77472,2.16020415724925,0.24936349093437277
15726,0.461845238095238,0,4,0,372407,233203,30484,77472,2.1601671051168996,0.24936670153697593
15727,0.4618571428571428,2,3,2,372410,233200,30486,77470,2.160139316017637,0.2493642772073261
15728,0.4618690476190476,0,1,0,372411,233199,30486,77470,2.1601300529845493,0.2493650798760095
15729,0.4619047619047619,1,2,1,372413,233197,30487,77469,2.160111526918374,0.24936426902203654
15730,0.4619285714285714,0,1,0,372414,233196,30487,77469,2.1601022638852867,0.24936507170102845
15731,0.4619393939393939,1,1,1,372415,233195,30488,77468,2.160093000852199,0.24936345815240307
15732,0.4619523809523809,1,2,1,372417,233193,30489,77467,2.160074474786024,0.24936264726710874
15733,0.461952380952381,0,1,0,372418,233192,30489,77467,2.1600652117529364,0.24936344995638304
15734,0.4619621848739496,0,2,0,372420,233190,30489,77467,2.160046685686761,0.2493650553504347
15735,0.4619761904761904,0,1,0,372421,233189,30489,77467,2.160037422653674,0.2493658580552122
15736,0.4619999999999999,1,13,1,372434,233176,30490,77466,2.1599170032235353,0.24937387732502367
15737,0.462,8,83,8,372517,233093,30498,77458,2.1591481714772685,0.24942119007828023
15738,0.4620000000000001,0,1,0,372518,233092,30498,77458,2.1591389084441808,0.2494219932378039
15739,0.4620079365079364,0,1,0,372519,233091,30498,77458,2.1591296454110935,0.2494227964025001
15740,0.4620238095238095,0,1,0,372520,233090,30498,77458,2.159120382378006,0.24942359957236884
15741,0.4620555555555555,0,3,0,372523,233087,30498,77458,2.1590925932787433,0.249426009113011
15742,0.4620833333333333,1,1,1,372524,233086,30499,77457,2.1590833302456556,0.2494243953333355
15743,0.4621111111111111,0,1,0,372525,233085,30499,77457,2.159074067212568,0.24942519852387116
15744,0.4621428571428571,3,7,3,372532,233078,30502,77454,2.159009225980955,0.2494235698736362
15745,0.4621666666666666,2,6,2,372538,233072,30504,77452,2.15895364778243,0.24942355502312222
15746,0.4621666666666668,0,1,0,372539,233071,30504,77452,2.158944384749342,0.24942435826009668
15747,0.4621904761904762,0,1,0,372540,233070,30504,77452,2.158935121716255,0.2494251615022446
15748,0.4621944444444444,0,1,0,372541,233069,30504,77452,2.158925858683167,0.24942596474956605
15749,0.4622121212121212,0,1,0,372542,233068,30504,77452,2.1589165956500795,0.24942676800206107
15750,0.4622380952380952,0,1,0,372543,233067,30504,77452,2.1589073326169923,0.24942757125972967
15751,0.46225,1,2,1,372545,233065,30505,77451,2.158888806550817,0.24942676061781036
15752,0.4622500000000001,0,2,0,372547,233063,30505,77451,2.158870280484642,0.24942836715896868
15753,0.4622619047619048,0,1,0,372548,233062,30505,77451,2.1588610174515543,0.24942917043730858
15754,0.4622857142857142,1,0,1,372548,233062,30506,77450,2.1588610174515543,0.2494267532333694
15755,0.4622857142857143,0,1,0,372549,233061,30506,77450,2.1588517544184667,0.24942755651168558
15756,0.4622905982905982,0,4,0,372553,233057,30506,77450,2.1588147022861164,0.24943076967669006
15757,0.4623095238095238,0,1,0,372554,233056,30506,77450,2.158805439253029,0.24943157298087637
15758,0.4623214285714286,0,1,0,372555,233055,30506,77450,2.1587961762199415,0.24943237629023687
15759,0.4623333333333332,1,5,1,372560,233050,30507,77449,2.1587498610545035,0.24943397563277175
15760,0.4623333333333333,3,32,3,372592,233018,30510,77446,2.158453443995702,0.24945243248814677
15761,0.4623333333333334,1,1,1,372593,233017,30511,77445,2.1584441809626145,0.24945081845765343
15762,0.4623809523809523,1,1,1,372594,233016,30512,77444,2.158434917929527,0.24944920440636476
15763,0.4623809523809524,3,2,3,372596,233014,30515,77441,2.158416391863352,0.24944355864779114
15764,0.4624285714285714,0,2,0,372598,233012,30515,77441,2.1583978657971765,0.24944516561283028
15765,0.4624523809523809,0,1,0,372599,233011,30515,77441,2.1583886027640893,0.24944596910311417
15766,0.4624761904761905,1,0,1,372599,233011,30516,77440,2.1583886027640893,0.24944355147833314
15767,0.4624999999999999,1,7,1,372606,233004,30517,77439,2.1583237615324764,0.2494467583421111
15768,0.4625,61,338,61,372944,232666,30578,77378,2.155192856348883,0.24957102862819472
15769,0.4625000000000001,1,12,1,372956,232654,30579,77377,2.155081699951832,0.24957826797965366
15770,0.4625674603174602,0,2,0,372958,232652,30579,77377,2.155063173885657,0.24957987801141185
15771,0.4625714285714285,0,1,0,372959,232651,30579,77377,2.1550539108525695,0.2495806830350807
15772,0.4625833333333333,0,1,0,372960,232650,30579,77377,2.155044647819482,0.2495814880639428
15773,0.4626190476190476,0,5,0,372965,232645,30579,77377,2.1549983326540443,0.2495855132861539
15774,0.4626428571428571,0,2,0,372967,232643,30579,77377,2.154979806587869,0.2495871234113928
15775,0.4626428571428572,0,1,0,372968,232642,30579,77377,2.1549705435547817,0.24958792848180272
15776,0.4626515151515151,0,1,0,372969,232641,30579,77377,2.154961280521694,0.24958873355740635
15777,0.4626666666666665,0,4,0,372973,232637,30579,77377,2.1549242283893437,0.2495919539117588
15778,0.4626666666666666,9,46,9,373019,232591,30588,77368,2.154498128867316,0.24960720611435705
15779,0.4626666666666667,1,8,1,373027,232583,30589,77367,2.154424024602616,0.24961122761735763
15780,0.4627142857142857,0,1,0,373028,232582,30589,77367,2.1544147615695284,0.24961203294735584
15781,0.4627499999999999,0,1,0,373029,232581,30589,77367,2.1544054985364407,0.24961283828255063
15782,0.46275,0,3,0,373032,232578,30589,77367,2.154377709437178,0.24961525431931472
15783,0.4627619047619047,0,3,0,373035,232575,30589,77367,2.1543499203379155,0.24961767040284957
15784,0.4627698412698413,1,0,1,373035,232575,30590,77366,2.1543499203379155,0.2496152493539093
15785,0.4627777777777778,0,1,0,373036,232574,30590,77366,2.154340657304828,0.24961605472026843
15786,0.4628015873015872,1,0,1,373036,232574,30591,77365,2.154340657304828,0.24961363365049252
15787,0.4628095238095238,0,1,0,373037,232573,30591,77365,2.15433139427174,0.24961443901683564
15788,0.4628333333333333,3,4,3,373041,232569,30594,77362,2.1542943421393903,0.2496103971529147
15789,0.4628333333333334,1,4,1,373045,232565,30595,77361,2.15425729000704,0.24961119751166408
15790,0.4628571428571428,1,9,1,373054,232556,30596,77360,2.154173922709252,0.24961602498741595
15791,0.4628571428571429,0,1,0,373055,232555,30596,77360,2.1541646596761646,0.24961683042124452
15792,0.4629166666666666,0,1,0,373056,232554,30596,77360,2.154155396643077,0.24961763586027091
15793,0.4629166666666667,0,1,0,373057,232553,30596,77360,2.154146133609989,0.24961844130449512
15794,0.4629206349206349,1,0,1,373057,232553,30597,77359,2.154146133609989,0.2496160200314928
15795,0.4629444444444446,0,1,0,373058,232552,30597,77359,2.1541368705769015,0.24961682547570108
15796,0.4629761904761904,0,2,0,373060,232550,30597,77359,2.1541183445107266,0.24961843637971146
15797,0.4629761904761905,0,4,0,373064,232546,30597,77359,2.1540812923783763,0.2496216582501089
15798,0.4629999999999999,5,57,5,373121,232489,30602,77354,2.1535532994923856,0.2496554706738574
15799,0.463,3,7,3,373128,232482,30605,77351,2.1534884582607727,0.2496538457814371
15800,0.463047619047619,1,2,1,373130,232480,30606,77350,2.153469932194598,0.2496530355356163
15801,0.4630555555555555,0,2,0,373132,232478,30606,77350,2.153451406128423,0.24965464709451696
15802,0.4630952380952381,0,3,0,373135,232475,30606,77350,2.15342361702916,0.2496570644718793
15803,0.4631111111111111,1,0,1,373135,232475,30607,77349,2.15342361702916,0.24965464263581905
15804,0.4631111111111112,0,1,0,373136,232474,30607,77349,2.1534143539960726,0.2496554484334604
15805,0.4631190476190476,0,1,0,373137,232473,30607,77349,2.153405090962985,0.24965625423630342
15806,0.4631190476190477,0,3,0,373140,232470,30607,77349,2.1533773018637223,0.2496586716760431
15807,0.4631666666666666,1,11,1,373151,232459,30608,77348,2.153275408499759,0.2496651140871575
15808,0.4631666666666667,1,6,1,373157,232453,30609,77347,2.153219830301234,0.24966752743705617
15809,0.4631904761904761,0,2,0,373159,232451,30609,77347,2.1532013042350586,0.24966913924557294
15810,0.4632142857142857,0,5,0,373164,232446,30609,77347,2.153154989069621,0.2496731688579148
15811,0.4632222222222222,0,2,0,373166,232444,30609,77347,2.1531364630034457,0.2496747807392726
15812,0.4632222222222223,1,0,1,373166,232444,30610,77346,2.1531364630034457,0.24967235869459956
15813,0.46325,0,1,0,373167,232443,30610,77346,2.1531271999703585,0.24967316463786643
15814,0.4632943722943722,0,1,0,373168,232442,30610,77346,2.153117936937271,0.24967397058633647
15815,0.4633333333333332,40,348,40,373516,232094,30650,77306,2.149894401422802,0.249857789269554
15816,0.4633333333333334,58,357,58,373873,231737,30708,77248,2.146587498610545,0.2500056637053579
15817,0.4633531746031746,1,0,1,373873,231737,30709,77247,2.146587498610545,0.250003236413536
15818,0.4633571428571429,0,3,0,373876,231734,30709,77247,2.1465597095112825,0.25000566377867894
15819,0.4633690476190476,1,0,1,373876,231734,30710,77246,2.1465597095112825,0.250003236455434
15820,0.4633809523809523,0,1,0,373877,231733,30710,77246,2.146550446478195,0.25000404558238587
15821,0.4633964646464645,0,4,0,373881,231729,30710,77246,2.1465133943458445,0.2500072821425682
15822,0.4634047619047619,0,1,0,373882,231728,30710,77246,2.146504131312757,0.2500080912957077
15823,0.4634126984126985,0,1,0,373883,231727,30710,77246,2.1464948682796696,0.25000890045408497
15824,0.4634285714285714,0,1,0,373884,231726,30710,77246,2.146485605246582,0.25000970961769997
15825,0.4634372294372295,0,5,0,373889,231721,30710,77246,2.146439290081144,0.25001375551434296
15826,0.4634444444444445,1,0,1,373889,231721,30711,77245,2.146439290081144,0.2500113281072998
15827,0.4634523809523809,0,2,0,373891,231719,30711,77245,2.146420764014969,0.25001294649214795
15828,0.4634999999999999,1,4,1,373895,231715,30712,77244,2.146383711882619,0.25001375587052005
15829,0.4635,3,38,3,373933,231677,30715,77241,2.146031716625292,0.250037226707411
15830,0.4635119047619047,0,1,0,373934,231676,30715,77241,2.146022453592204,0.250038036106786
15831,0.4635238095238094,0,1,0,373935,231675,30715,77241,2.146013190559117,0.25003884551140115
15832,0.4635555555555555,0,1,0,373936,231674,30715,77241,2.146003927526029,0.2500396549212567
15833,0.4635714285714284,0,1,0,373937,231673,30715,77241,2.1459946644929415,0.2500404643363525
15834,0.4635714285714285,0,2,0,373939,231671,30715,77241,2.1459761384267666,0.2500420831822655
15835,0.4635714285714286,0,1,0,373940,231670,30715,77241,2.145966875393679,0.2500428926130827
15836,0.4635773809523809,0,1,0,373941,231669,30715,77241,2.1459576123605912,0.2500437020491405
15837,0.4635833333333333,0,3,0,373944,231666,30715,77241,2.1459298232613286,0.2500461303887578
15838,0.4635833333333334,1,0,1,373944,231666,30716,77240,2.1459298232613286,0.250043702615035
15839,0.4635952380952381,0,3,0,373947,231663,30716,77240,2.145902034162066,0.25004613098610246
15840,0.4636111111111111,0,1,0,373948,231662,30716,77240,2.1458927711289784,0.25004694045360665
15841,0.4636190476190476,0,2,0,373950,231660,30716,77240,2.1458742450628034,0.25004855940433796
15842,0.4636309523809523,0,4,0,373954,231656,30716,77240,2.145837192930453,0.25005179736869365
15843,0.4636428571428571,0,1,0,373955,231655,30716,77240,2.1458279298973655,0.2500526068728856
15844,0.4636439393939394,0,1,0,373956,231654,30716,77240,2.1458186668642782,0.25005341638231887
15845,0.4636666666666666,3,32,3,373988,231622,30719,77237,2.1455222498054765,0.2500720393448143
15846,0.4636666666666667,0,1,0,373989,231621,30719,77237,2.1455129867723888,0.2500728490115199
15847,0.4637142857142857,0,2,0,373991,231619,30719,77237,2.145494460706214,0.25007446836066
15848,0.46375,0,4,0,373995,231615,30719,77237,2.1454574085738636,0.25007770712185773
15849,0.4638095238095238,0,5,0,374000,231610,30719,77237,2.1454110934084256,0.25008175569132934
15850,0.4638095238095239,0,1,0,374001,231609,30719,77237,2.145401830375338,0.25008256542095414
15851,0.4638333333333332,1,0,1,374001,231609,30720,77236,2.145401830375338,0.25008013728569345
15852,0.4638333333333333,3,13,3,374014,231596,30723,77233,2.1452814109452,0.2500833794753731
15853,0.4638333333333334,0,4,0,374018,231592,30723,77233,2.1452443588128496,0.25008661863514936
15854,0.4638571428571429,0,1,0,374019,231591,30723,77233,2.1452350957797623,0.2500874284382043
15855,0.463862567987568,1,0,1,374019,231591,30724,77232,2.1452350957797623,0.25008500014571455
15856,0.4638809523809524,0,5,0,374024,231586,30724,77232,2.1451887806143244,0.2500890492134526
15857,0.4638888888888889,0,2,0,374026,231584,30724,77232,2.145170254548149,0.2500906688772602
15858,0.4638917748917748,0,3,0,374029,231581,30724,77232,2.1451424654488864,0.25009309841230776
15859,0.4638928571428573,1,3,1,374032,231578,30725,77231,2.145114676349624,0.25009309961821063
15860,0.4639285714285714,0,2,0,374034,231576,30725,77231,2.145096150283449,0.250094719355455
15861,0.4639999999999999,26,111,26,374145,231465,30751,77205,2.14406795361073,0.25012148896880165
15862,0.4640000000000001,4,5,4,374150,231460,30755,77201,2.1440216384452926,0.25011582286067885
15863,0.464047619047619,0,1,0,374151,231459,30755,77201,2.144012375412205,0.25011663318862176
15864,0.4640476190476191,0,1,0,374152,231458,30755,77201,2.1440031123791172,0.25011744352181536
15865,0.4640833333333333,0,2,0,374154,231456,30755,77201,2.1439845863129423,0.2501190642039546
15866,0.4640833333333334,0,1,0,374155,231455,30755,77201,2.1439753232798546,0.2501198745529003
15867,0.464095238095238,0,1,0,374156,231454,30755,77201,2.1439660602467674,0.25012068490709694
15868,0.4641666666666666,6,64,6,374220,231390,30761,77195,2.143373226129164,0.25015797916295346
15869,0.4641666666666667,10,72,10,374292,231318,30771,77185,2.1427062877468597,0.25019205647919146
15870,0.4641746031746031,0,1,0,374293,231317,30771,77185,2.1426970247137724,0.2501928674692547
15871,0.4641904761904762,0,2,0,374295,231315,30771,77185,2.142678498647597,0.250194489465154
15872,0.4642142857142856,0,2,0,374297,231313,30771,77185,2.142659972581422,0.25019611148208415
15873,0.4642179487179486,0,1,0,374298,231312,30771,77185,2.1426507095483345,0.25019692249843595
15874,0.4642301587301587,0,1,0,374299,231311,30771,77185,2.142641446515247,0.25019773352004565
15875,0.4642380952380952,1,0,1,374299,231311,30772,77184,2.142641446515247,0.2501953030032902
15876,0.46425,0,1,0,374300,231310,30772,77184,2.1426321834821596,0.2501961140249081
15877,0.4642619047619047,0,1,0,374301,231309,30772,77184,2.142622920449072,0.250196925051784
15878,0.4642857142857143,5,11,5,374312,231298,30777,77179,2.1425210270851087,0.2501936935330673
15879,0.4643095238095238,1,2,1,374314,231296,30778,77178,2.142502501018934,0.2501928849757192
15880,0.4643333333333333,3,8,3,374322,231288,30781,77175,2.1424283967542332,0.25019208138415305
15881,0.4643333333333334,2,27,2,374349,231261,30783,77173,2.1421782948608694,0.2502091209140367
15882,0.4643650793650794,1,1,1,374350,231260,30784,77172,2.1421690318277817,0.2502075011671941
15883,0.4643809523809523,0,2,0,374352,231258,30784,77172,2.1421505057616064,0.2502091236261064
15884,0.4643809523809524,0,1,0,374353,231257,30784,77172,2.142141242728519,0.25020993486345317
15885,0.4644166666666666,0,1,0,374354,231256,30784,77172,2.1421319796954315,0.2502107461060604
15886,0.4644444444444444,1,1,1,374355,231255,30785,77171,2.1421227166623438,0.25020912633824643
15887,0.4644523809523809,0,1,0,374356,231254,30785,77171,2.1421134536292565,0.25020993758612303
15888,0.4644920634920635,1,0,1,374356,231254,30786,77170,2.1421134536292565,0.2502075065494255
15889,0.4644999999999999,1,7,1,374363,231247,30787,77169,2.1420486123976437,0.2502107543058726
15890,0.4645,0,13,0,374376,231234,30787,77169,2.141928192967505,0.25022130134920867
15891,0.4645000000000001,0,1,0,374377,231233,30787,77169,2.141918929934418,0.25022211269706424
15892,0.4645238095238095,0,5,0,374382,231228,30787,77169,2.14187261476898,0.25022616951526766
15893,0.4645714285714286,0,1,0,374383,231227,30787,77169,2.1418633517358923,0.25022698089469386
15894,0.4645833333333333,1,3,1,374386,231224,30788,77168,2.1418355626366297,0.2502269838387507
15895,0.4645952380952381,1,3,1,374389,231221,30789,77167,2.141807773537367,0.2502269867828839
15896,0.4646111111111111,0,2,0,374391,231219,30789,77167,2.141789247471192,0.2502286095996576
15897,0.4646150793650793,0,2,0,374393,231217,30789,77167,2.141770721405017,0.25023023243748055
15898,0.4646168831168832,0,1,0,374394,231216,30789,77167,2.141761458371929,0.25023104386428563
15899,0.4646428571428571,0,1,0,374395,231215,30789,77167,2.141752195338842,0.2502318552963532
15900,0.4646666666666666,2,14,2,374409,231201,30791,77165,2.141622512875616,0.250238353125831
15901,0.4646666666666667,0,16,0,374425,231185,30791,77165,2.141474304346215,0.25025133776552616
15902,0.4646666666666668,0,1,0,374426,231184,30791,77165,2.1414650413131278,0.25025214935024925
15903,0.4646904761904762,1,1,1,374427,231183,30792,77164,2.14145577828004,0.2502505294359926
15904,0.4647481684981684,1,0,1,374427,231183,30793,77163,2.14145577828004,0.2502480979159775
15905,0.4647619047619047,0,4,0,374431,231179,30793,77163,2.14141872614769,0.25025134428653895
15906,0.4648180153180155,0,3,0,374434,231176,30793,77163,2.141390937048427,0.2502537791197351
15907,0.4648214285714285,0,2,0,374436,231174,30793,77163,2.141372410982252,0.25025540236818805
15908,0.4648333333333332,0,7,0,374443,231167,30793,77163,2.141307569750639,0.2502610839036098
15909,0.4648333333333333,1,13,1,374456,231154,30794,77162,2.141187150320501,0.2502692043228376
15910,0.4648333333333334,0,1,0,374457,231153,30794,77162,2.141177887287413,0.2502700160550087
15911,0.4648571428571428,0,2,0,374459,231151,30794,77162,2.1411593612212383,0.25027163953514775
15912,0.4648809523809524,0,3,0,374462,231148,30794,77162,2.1411315721219757,0.25027407479484937
15913,0.4648809523809525,0,2,0,374464,231146,30794,77162,2.1411130460558003,0.2502756983276464
15914,0.4649166666666666,0,2,0,374466,231144,30794,77162,2.1410945199896254,0.2502773218815073
15915,0.4649999999999999,2,17,2,374483,231127,30796,77160,2.140937048427137,0.25028625923246844
15916,0.465,175,1216,175,375699,229911,30971,76985,2.1296732001926713,0.25085045096710284
15917,0.4650000000000001,1,23,1,375722,229888,30972,76984,2.1294601504316573,0.25086681091790713
15918,0.4650238095238094,0,1,0,375723,229887,30972,76984,2.1294508873985696,0.2508676284171525
15919,0.4650238095238095,1,0,1,375723,229887,30973,76983,2.1294508873985696,0.2508651872128263
15920,0.465047619047619,0,3,0,375726,229884,30973,76983,2.129423098299307,0.2508676397266568
15921,0.4650555555555555,0,1,0,375727,229883,30973,76983,2.1294138352662197,0.2508684572419232
15922,0.465079365079365,0,1,0,375728,229882,30973,76983,2.129404572233132,0.25086927476251775
15923,0.4650952380952381,0,1,0,375729,229881,30973,76983,2.1293953092000444,0.2508700922884405
15924,0.4651190476190476,0,2,0,375731,229879,30973,76983,2.1293767831338695,0.2508717273562709
15925,0.4651428571428571,0,4,0,375735,229875,30973,76983,2.129339731001519,0.2508749975558727
15926,0.4651601731601731,0,1,0,375736,229874,30973,76983,2.1293304679684315,0.25087581511909457
15927,0.4651666666666665,0,2,0,375738,229872,30973,76983,2.1293119419022566,0.2508774502615242
15928,0.4651666666666667,3,13,3,375751,229859,30976,76980,2.129191522472118,0.25088075505395335
15929,0.4652023809523807,0,3,0,375754,229856,30976,76980,2.1291637333728555,0.2508832079677743
15930,0.4652222222222222,1,0,1,375754,229856,30977,76979,2.1291637333728555,0.25088076653576025
15931,0.4652380952380952,2,3,2,375757,229853,30979,76977,2.129135944273593,0.2508783365381482
15932,0.4652777777777778,0,2,0,375759,229851,30979,76977,2.129117418207418,0.2508799718409011
15933,0.465280303030303,1,1,1,375760,229850,30980,76976,2.1291081551743303,0.25087834798876235
15934,0.4653333333333333,4,18,4,375778,229832,30984,76972,2.1289414205787542,0.2508833000873522
15935,0.4653333333333334,1,9,1,375787,229823,30985,76971,2.1288580532809664,0.25088821815289736
15936,0.4653571428571428,0,1,0,375788,229822,30985,76971,2.1288487902478788,0.2508890359297637
15937,0.4653888888888888,0,1,0,375789,229821,30985,76971,2.128839527214791,0.2508898537119612
15938,0.465409090909091,0,5,0,375794,229816,30985,76971,2.1287932120493536,0.25089394270291765
15939,0.4654166666666666,1,3,1,375797,229813,30986,76970,2.128765422950091,0.25089395435861833
15940,0.4654166666666667,0,1,0,375798,229812,30986,76970,2.1287561599170033,0.2508947721835049
15941,0.4654242424242424,0,1,0,375799,229811,30986,76970,2.1287468968839156,0.25089559001372314
15942,0.4654285714285713,0,1,0,375800,229810,30986,76970,2.128737633850828,0.2508964078492731
15943,0.4654285714285714,0,1,0,375801,229809,30986,76970,2.1287283708177407,0.2508972256901548
15944,0.4654761904761905,0,1,0,375802,229808,30986,76970,2.128719107784653,0.2508980435363683
15945,0.4654999999999999,3,21,3,375823,229787,30989,76967,2.1285245840898144,0.25090789362159904
15946,0.4655,0,3,0,375826,229784,30989,76967,2.1284967949905518,0.2509103474805298
15947,0.4655238095238095,0,1,0,375827,229783,30989,76967,2.128487531957464,0.2509111654441728
15948,0.4655555555555555,0,3,0,375830,229780,30989,76967,2.1284597428582015,0.25091361936710055
15949,0.4655714285714286,0,2,0,375832,229778,30989,76967,2.1284412167920266,0.25091525534238535
15950,0.4655714285714287,0,1,0,375833,229777,30989,76967,2.128431953758939,0.2509160733380278
15951,0.4655833333333333,0,2,0,375835,229775,30989,76967,2.1284134276927635,0.250917709345313
15952,0.4655873015873015,0,2,0,375837,229773,30989,76967,2.1283949016265886,0.25091934537393235
15953,0.4655952380952382,0,1,0,375838,229772,30989,76967,2.128385638593501,0.2509201633962424
15954,0.4656111111111111,0,1,0,375839,229771,30989,76967,2.1283763755604137,0.2509209814238862
15955,0.4656507936507936,0,2,0,375841,229769,30989,76967,2.1283578494942383,0.250922617495175
15956,0.4656666666666666,7,28,7,375869,229741,30996,76960,2.128098484567787,0.2509284286650516
15957,0.4656666666666667,3,4,3,375873,229737,30999,76957,2.1280614324354366,0.25092437413187085
15958,0.4657142857142856,0,1,0,375874,229736,30999,76957,2.1280521694023493,0.2509251922932705
15959,0.4657142857142857,3,14,3,375888,229722,31002,76954,2.1279224869391236,0.2509293195424487
15960,0.46575,0,1,0,375889,229721,31002,76954,2.127913223906036,0.25093013776799544
15961,0.4657857142857143,0,1,0,375890,229720,31002,76954,2.127903960872948,0.25093095599887827
15962,0.4658333333333332,9,63,9,375953,229657,31011,76945,2.1273203897884323,0.2509605286332118
15963,0.4658333333333334,11,69,11,376022,229588,31022,76934,2.126681240505391,0.25099014100129846
15964,0.4658730158730159,1,3,1,376025,229585,31023,76933,2.1266534514061286,0.250990153922445
15965,0.4658888888888889,1,0,1,376025,229585,31024,76932,2.1266534514061286,0.250987710306443
15966,0.4659166666666666,0,1,0,376026,229584,31024,76932,2.126644188373041,0.2509885291469287
15967,0.4659285714285714,0,1,0,376027,229583,31024,76932,2.1266349253399532,0.2509893479927573
15968,0.4659523809523809,1,5,1,376032,229578,31025,76931,2.1265886101745157,0.25099099863299285
15969,0.465952380952381,1,2,1,376034,229576,31026,76930,2.1265700841083404,0.25099019268790823
15970,0.4659999999999999,0,8,0,376042,229568,31026,76930,2.12649597984364,0.2509967438612976
15971,0.466,14,117,14,376159,229451,31040,76916,2.1254122049723962,0.25105837116921864
15972,0.4660000000000001,0,1,0,376160,229450,31040,76916,2.1254029419393086,0.25105919064125914
15973,0.466025641025641,0,1,0,376161,229449,31040,76916,2.125393678906221,0.2510600101186493
15974,0.466047619047619,0,1,0,376162,229448,31040,76916,2.1253844158731336,0.2510608296013892
15975,0.4660555555555555,0,1,0,376163,229447,31040,76916,2.125375152840046,0.2510616490894788
15976,0.4660714285714284,0,1,0,376164,229446,31040,76916,2.1253658898069583,0.25106246858291825
15977,0.4660714285714285,0,2,0,376166,229444,31040,76916,2.1253473637407834,0.25106410758584674
15978,0.4660714285714286,0,2,0,376168,229442,31040,76916,2.125328837674608,0.251065746610175
15979,0.466095238095238,0,1,0,376169,229441,31040,76916,2.1253195746415208,0.25106656613036427
15980,0.4661031746031745,0,1,0,376170,229440,31040,76916,2.125310311608433,0.2510673856559036
15981,0.4661111111111111,0,1,0,376171,229439,31040,76916,2.1253010485753454,0.2510682051867931
15982,0.4661190476190476,1,1,1,376172,229438,31041,76915,2.125291785542258,0.25106658005634025
15983,0.4661547619047619,0,1,0,376173,229437,31041,76915,2.1252825225091705,0.2510673995926255
15984,0.4661666666666666,0,4,0,376177,229433,31041,76915,2.12524547037682,0.25107067779127007
15985,0.4661666666666667,3,7,3,376184,229426,31044,76912,2.1251806291452073,0.25106908055807636
15986,0.4661904761904761,0,1,0,376185,229425,31044,76912,2.1251713661121197,0.25106990014265335
15987,0.4661904761904762,0,7,0,376192,229418,31044,76912,2.1251065248805068,0.25107563738452
15988,0.4662142857142857,0,1,0,376193,229417,31044,76912,2.1250972618474195,0.2510764570119055
15989,0.4662380952380953,0,1,0,376194,229416,31044,76912,2.125087998814332,0.25107727664464236
15990,0.46625,2,12,2,376206,229404,31046,76910,2.124976842417281,0.25108222281710924
15991,0.4662619047619047,0,1,0,376207,229403,31046,76910,2.1249675793841933,0.25108304250880636
15992,0.4662857142857142,0,4,0,376211,229399,31046,76910,2.1249305272518435,0.25108632132911535
15993,0.4663095238095238,0,6,0,376217,229393,31046,76910,2.124874949053318,0.2510912397201464
15994,0.4663333333333332,0,3,0,376220,229390,31046,76910,2.1248471599540553,0.25109369898792033
15995,0.4663333333333333,4,25,4,376245,229365,31050,76906,2.1246155841268664,0.2511044140646682
15996,0.4663333333333334,1,3,1,376248,229362,31051,76905,2.1245877950276038,0.25110442848886755
15997,0.4663585858585859,1,0,1,376248,229362,31052,76904,2.1245877950276038,0.25110198324332444
15998,0.4663809523809524,1,3,1,376251,229359,31053,76903,2.124560005928341,0.251101997636011
15999,0.4663835608835608,0,1,0,376252,229358,31053,76903,2.1245507428952535,0.2511028175314519
16000,0.4663888888888888,1,1,1,376253,229357,31054,76902,2.1245414798621662,0.25110119212823134
16001,0.4664166666666667,0,1,0,376254,229356,31054,76902,2.1245322168290786,0.2511020120290735
16002,0.4664285714285714,2,5,2,376259,229351,31056,76900,2.1244859016636406,0.2511012208939726
16003,0.4664404761904762,0,2,0,376261,229349,31056,76900,2.1244673755974657,0.2511028607440351
16004,0.4664622877122877,0,5,0,376266,229344,31056,76900,2.1244210604320277,0.2511069604628989
16005,0.4664642857142857,0,3,0,376269,229341,31056,76900,2.124393271332765,0.25110942035847583
16006,0.4664761904761904,1,0,1,376269,229341,31057,76899,2.124393271332765,0.2511069749216301
16007,0.4664999999999999,5,30,5,376299,229311,31062,76894,2.1241153803401387,0.2511193481491158
16008,0.4665000000000001,0,4,0,376303,229307,31062,76894,2.1240783282077884,0.2511226286001679
16009,0.4665238095238095,0,2,0,376305,229305,31062,76894,2.124059802141613,0.2511242688578343
16010,0.466547619047619,1,2,1,376307,229303,31063,76893,2.124041276075438,0.2511234634025265
16011,0.4665476190476191,0,2,0,376309,229301,31063,76893,2.124022750009263,0.2511251036924303
16012,0.4665714285714286,0,1,0,376310,229300,31063,76893,2.1240134869761755,0.25112592384541776
16013,0.466595238095238,0,1,0,376311,229299,31063,76893,2.124004223943088,0.25112674400376234
16014,0.4666190476190475,0,1,0,376312,229298,31063,76893,2.12399496091,0.2511275641674641
16015,0.4666363636363636,0,1,0,376313,229297,31063,76893,2.123985697876913,0.25112838433652307
16016,0.4666666666666665,0,9,0,376322,229288,31063,76893,2.1239023305791247,0.25113576609913746
16017,0.4666666666666666,64,424,64,376746,228864,31127,76829,2.1199748045500018,0.25132731204181974
16018,0.4666666666666667,49,312,49,377058,228552,31176,76780,2.117084738226685,0.25146398019205324
16019,0.4666904761904761,0,1,0,377059,228551,31176,76780,2.117075475193597,0.2514648037703345
16020,0.4667142857142857,1,0,1,377059,228551,31177,76779,2.117075475193597,0.25146235220908525
16021,0.4667380952380953,0,2,0,377061,228549,31177,76779,2.1170569491274223,0.25146399937116803
16022,0.46675,0,1,0,377062,228548,31177,76779,2.1170476860943346,0.2514648229603016
16023,0.4667857142857143,1,5,1,377067,228543,31178,76778,2.117001370928897,0.25146648936692856
16024,0.4668333333333333,0,6,0,377073,228537,31178,76778,2.1169457927303714,0.25147143114488313
16025,0.4668333333333334,3,11,3,377084,228526,31181,76775,2.1168438993664087,0.251473136347408
16026,0.4668571428571428,1,0,1,377084,228526,31182,76774,2.1168438993664087,0.25147068457255156
16027,0.4668809523809524,0,1,0,377085,228525,31182,76774,2.116834636333321,0.25147150825911646
16028,0.4668888888888889,0,1,0,377086,228524,31182,76774,2.1168253733002333,0.2514723319510773
16029,0.4669047619047618,0,1,0,377087,228523,31182,76774,2.1168161102671457,0.25147315564843414
16030,0.4669444444444444,0,3,0,377090,228520,31182,76774,2.116788321167883,0.2514756267728812
16031,0.466969696969697,1,0,1,377090,228520,31183,76773,2.116788321167883,0.25147317494996607
16032,0.4669761904761905,1,1,1,377091,228519,31184,76772,2.116779058134796,0.25147154681926426
16033,0.4669960317460317,0,2,0,377093,228517,31184,76772,2.1167605320686205,0.2514731942520038
16034,0.4669999999999999,0,4,0,377097,228513,31184,76772,2.11672347993627,0.2514764891822395
16035,0.467,12,39,12,377136,228474,31196,76760,2.1163622216458555,0.251479193012574
16036,0.4670238095238094,0,1,0,377137,228473,31196,76760,2.1163529586127683,0.2514800169051184
16037,0.4670238095238095,0,1,0,377138,228472,31196,76760,2.1163436955796806,0.25148084080306127
16038,0.4670833333333333,1,6,1,377144,228466,31197,76759,2.1162881173811554,0.25148333196822015
16039,0.4671190476190476,0,1,0,377145,228465,31197,76759,2.1162788543480677,0.2514841558986187
16040,0.4671428571428571,5,22,5,377167,228443,31202,76754,2.1160750676201414,0.251490021199422
16041,0.4671428571428572,0,1,0,377168,228442,31202,76754,2.116065804587054,0.25149084522732934
16042,0.4671666666666666,0,8,0,377176,228434,31202,76754,2.1159917003223536,0.2514974376449926
16043,0.4671666666666667,2,9,2,377185,228425,31204,76752,2.1159083330245654,0.25149994920980284
16044,0.4671904761904762,0,1,0,377186,228424,31204,76752,2.115899069991478,0.2515007733242457
16045,0.4672023809523809,0,1,0,377187,228423,31204,76752,2.1158898069583905,0.25150159744408945
16046,0.4672222222222222,0,2,0,377189,228421,31204,76752,2.1158712808922155,0.25150324569998
16047,0.46725,0,1,0,377190,228420,31204,76752,2.115862017859128,0.2515040698360269
16048,0.4672857142857143,0,2,0,377192,228418,31204,76752,2.1158434917929525,0.25150571812432415
16049,0.4673095238095238,0,1,0,377193,228417,31204,76752,2.1158342287598653,0.2515065422765746
16050,0.4673333333333332,1,7,1,377200,228410,31205,76751,2.1157693875282524,0.25150985873030957
16051,0.4673333333333333,6,41,6,377241,228369,31211,76745,2.1153896031716624,0.2515289367252896
16052,0.4673333333333334,0,1,0,377242,228368,31211,76745,2.115380340138575,0.2515297611049021
16053,0.4673412698412699,0,2,0,377244,228366,31211,76745,2.1153618140723998,0.2515314098803386
16054,0.4673571428571428,0,1,0,377245,228365,31211,76745,2.1153525510393125,0.25153223427616267
16055,0.4673571428571429,0,1,0,377246,228364,31211,76745,2.115343288006225,0.25153305867739073
16056,0.4673809523809523,0,2,0,377248,228362,31211,76745,2.1153247619400495,0.2515347074960588
16057,0.4673809523809524,1,6,1,377254,228356,31212,76744,2.1152691837415243,0.2515372009177319
16058,0.4674166666666667,0,1,0,377255,228355,31212,76744,2.1152599207084366,0.25153802536225944
16059,0.4674285714285714,1,4,1,377259,228351,31213,76743,2.1152228685760868,0.2515388699876104
16060,0.4674761904761905,0,3,0,377262,228348,31213,76743,2.1151950794768237,0.25154134340246026
16061,0.4674761904761906,0,1,0,377263,228347,31213,76743,2.1151858164437365,0.2515421678848864
16062,0.4674999999999999,0,11,0,377274,228336,31213,76743,2.1150839230797733,0.25155123754830716
16063,0.4675,58,331,58,377605,228005,31271,76685,2.1120178591277927,0.2516820374807181
16064,0.4675000000000001,0,8,0,377613,227997,31271,76685,2.111943754863092,0.2516886458668382
16065,0.4675793650793651,1,1,1,377614,227996,31272,76684,2.111934491830005,0.2516870158855192
16066,0.4675833333333332,0,1,0,377615,227995,31272,76684,2.1119252287969172,0.2516878419582577
16067,0.4675833333333333,0,2,0,377617,227993,31272,76684,2.1119067027307423,0.2516894941200025
16068,0.467611111111111,0,1,0,377618,227992,31272,76684,2.1118974396976546,0.2516903202090089
16069,0.4676190476190475,0,2,0,377620,227990,31272,76684,2.1118789136314793,0.25169197240329005
16070,0.4676190476190476,0,4,0,377624,227986,31272,76684,2.1118418614991294,0.25169527685692716
16071,0.4676388888888889,0,1,0,377625,227985,31272,76684,2.1118325984660418,0.251696102983894
16072,0.4676666666666665,0,5,0,377630,227980,31272,76684,2.111786283300604,0.25170023370007616
16073,0.4676666666666667,5,36,5,377666,227944,31277,76679,2.111452814109452,0.251717696956566
16074,0.4676796536796537,0,2,0,377668,227942,31277,76679,2.111434288043277,0.25171934961805
16075,0.4676904761904762,2,0,2,377668,227942,31279,76677,2.111434288043277,0.25171443672259447
16076,0.4677142857142857,0,2,0,377670,227940,31279,76677,2.111415761977102,0.25171608938437445
16077,0.4677222222222222,0,2,0,377672,227938,31279,76677,2.1113972359109265,0.25171774206785613
16078,0.4677272727272727,1,0,1,377672,227938,31280,76676,2.1113972359109265,0.2517152855745304
16079,0.4677380952380952,0,2,0,377674,227936,31280,76676,2.1113787098447516,0.2517169382690111
16080,0.4677460317460317,0,2,0,377676,227934,31280,76676,2.1113601837785763,0.25171859098519417
16081,0.4677777777777777,0,1,0,377677,227933,31280,76676,2.111350920745489,0.2517194173514243
16082,0.4677777777777778,0,5,0,377682,227928,31280,76676,2.111304605580051,0.2517235492639624
16083,0.4677857142857142,0,1,0,377683,227927,31280,76676,2.1112953425469634,0.2517243756627479
16084,0.4677857142857143,0,2,0,377685,227925,31280,76676,2.1112768164807885,0.25172602847659725
16085,0.4678095238095238,0,2,0,377687,227923,31280,76676,2.1112582904146135,0.2517276813121514
16086,0.4678333333333333,2,6,2,377693,227917,31282,76674,2.111202712216088,0.25172772668923243
16087,0.4678333333333334,1,4,1,377697,227913,31283,76673,2.1111656600837376,0.25172857583736613
16088,0.4678571428571428,0,1,0,377698,227912,31283,76673,2.1111563970506504,0.2517294023014922
16089,0.4679047619047619,0,2,0,377700,227910,31283,76673,2.111137870984475,0.2517310552460249
16090,0.4679166666666666,1,0,1,377700,227910,31284,76672,2.111137870984475,0.25172859853832463
16091,0.4679166666666667,0,4,0,377704,227906,31284,76672,2.1111008188521247,0.2517319044711043
16092,0.4679285714285713,0,1,0,377705,227905,31284,76672,2.1110915558190375,0.2517327309678669
16093,0.4679390331890332,0,1,0,377706,227904,31284,76672,2.11108229278595,0.2517335574700567
16094,0.4679444444444444,0,6,0,377712,227898,31284,76672,2.1110267145874246,0.2517385165971698
16095,0.4679444444444445,1,0,1,377712,227898,31285,76671,2.1110267145874246,0.2517360598091073
16096,0.4679642857142857,1,0,1,377712,227898,31286,76670,2.1110267145874246,0.2517336030049119
16097,0.4679761904761904,0,2,0,377714,227896,31286,76670,2.1110081885212493,0.25173525606929203
16098,0.4679761904761905,1,1,1,377715,227895,31287,76669,2.110998925488162,0.2517336257732365
16099,0.4679761904761906,0,1,0,377716,227894,31287,76669,2.1109896624550744,0.25173445231364283
16100,0.4679999999999999,5,100,5,377816,227794,31292,76664,2.1100633591463187,0.25180484664551434
16101,0.468,2,7,2,377823,227787,31294,76662,2.109998517914706,0.2518057211552674
16102,0.4680000000000002,0,2,0,377825,227785,31294,76662,2.109979991848531,0.25180737533955005
16103,0.4680555555555555,0,1,0,377826,227784,31294,76662,2.1099707288154432,0.25180820243984153
16104,0.4680833333333333,0,2,0,377828,227782,31294,76662,2.1099522027492683,0.25180985665672506
16105,0.4681428571428572,1,0,1,377828,227782,31295,76661,2.1099522027492683,0.25180739908620003
16106,0.4681666666666666,2,13,2,377841,227769,31297,76659,2.10983178331913,0.25181323662737987
16107,0.4681666666666667,2,5,2,377846,227764,31299,76657,2.1097854681536923,0.2518124570906738
16108,0.4681666666666668,0,1,0,377847,227763,31299,76657,2.1097762051206046,0.25181328427829974
16109,0.4682142857142855,1,0,1,377847,227763,31300,76656,2.1097762051206046,0.2518108265252826
16110,0.4682142857142857,1,5,1,377852,227758,31301,76655,2.109729889955167,0.25181250472220307
16111,0.4682510822510822,0,1,0,377853,227757,31301,76655,2.1097206269220794,0.2518133319317241
16112,0.4682619047619047,0,1,0,377854,227756,31301,76655,2.1097113638889917,0.25181415914668
16113,0.4682857142857143,0,2,0,377856,227754,31301,76655,2.109692837822817,0.2518158135928964
16114,0.4683333333333332,25,190,25,378046,227564,31326,76630,2.1079328615361814,0.25191160903896853
16115,0.4683333333333334,34,221,34,378267,227343,31360,76596,2.105885731223832,0.2520110943314283
16116,0.4683809523809524,0,1,0,378268,227342,31360,76596,2.1058764681907443,0.25201192348439483
16117,0.4683888888888889,0,1,0,378269,227341,31360,76596,2.105867205157657,0.2520127526428174
16118,0.4684126984126984,1,0,1,378269,227341,31361,76595,2.105867205157657,0.25201029164034533
16119,0.4684166666666667,0,1,0,378270,227340,31361,76595,2.1058579421245693,0.252011120798855
16120,0.4684285714285714,1,0,1,378270,227340,31362,76594,2.1058579421245693,0.2520086597748195
16121,0.4684523809523809,0,1,0,378271,227339,31362,76594,2.1058486790914817,0.25200948893341624
16122,0.4684999999999999,1,1,1,378272,227338,31363,76593,2.105839416058394,0.2520078570465007
16123,0.4685,1,22,1,378294,227316,31364,76592,2.105635629330468,0.2520236387327744
16124,0.4685000000000001,0,1,0,378295,227315,31364,76592,2.1056263662973804,0.25202446801159567
16125,0.468547619047619,0,1,0,378296,227314,31364,76592,2.1056171032642927,0.25202529729587436
16126,0.4685555555555555,0,1,0,378297,227313,31364,76592,2.1056078402312055,0.25202612658561063
16127,0.4685555555555556,0,1,0,378298,227312,31364,76592,2.105598577198118,0.2520269558808045
16128,0.4685714285714285,0,2,0,378300,227310,31364,76592,2.1055800511319425,0.2520286144875651
16129,0.4685714285714286,1,5,1,378305,227305,31365,76591,2.105533735966505,0.25203029983941877
16130,0.468595238095238,0,1,0,378306,227304,31365,76591,2.1055244729334173,0.2520311291729051
16131,0.4685952380952381,0,1,0,378307,227303,31365,76591,2.1055152099003296,0.2520319585118495
16132,0.4686666666666666,0,2,0,378309,227301,31365,76591,2.1054966838341547,0.2520336172061127
16133,0.4686666666666667,2,31,2,378340,227270,31367,76589,2.1052095298084406,0.2520544068136866
16134,0.4686818181818182,0,2,0,378342,227268,31367,76589,2.105191003742265,0.25205606584676343
16135,0.4686904761904761,0,1,0,378343,227267,31367,76589,2.105181740709178,0.2520568953714918
16136,0.4686904761904762,0,1,0,378344,227266,31367,76589,2.1051724776760903,0.2520577249016801
16137,0.4687142857142856,0,3,0,378347,227263,31367,76589,2.1051446885768277,0.25206021352500557
16138,0.4687142857142857,0,1,0,378348,227262,31367,76589,2.10513542554374,0.2520610430770345
16139,0.4687301587301587,0,1,0,378349,227261,31367,76589,2.1051261625106523,0.2520618726345236
16140,0.4687348484848484,1,2,1,378351,227259,31368,76588,2.1051076364444774,0.2520610702096779
16141,0.46875,0,6,0,378357,227253,31368,76588,2.105052058245952,0.2520660477025813
16142,0.4687619047619046,0,3,0,378360,227250,31368,76588,2.1050242691466896,0.25206853652275224
16143,0.4687698412698413,0,1,0,378361,227249,31368,76588,2.105015006113602,0.25206936614039765
16144,0.4687857142857142,1,0,1,378361,227249,31369,76587,2.105015006113602,0.25206690451427743
16145,0.4687857142857143,0,1,0,378362,227248,31369,76587,2.1050057430805142,0.25206773413201244
16146,0.4688015873015873,1,1,1,378363,227247,31370,76586,2.1049964800474266,0.25206610210214164
16147,0.4688095238095238,0,1,0,378364,227246,31370,76586,2.1049872170143393,0.2520669317254272
16148,0.4688333333333332,0,1,0,378365,227245,31370,76586,2.1049779539812516,0.25206776135417386
16149,0.4688333333333333,1,10,1,378375,227235,31371,76585,2.104885323650376,0.25207359620828124
16150,0.4688333333333334,0,3,0,378378,227232,31371,76585,2.1048575345511136,0.2520760852750175
16151,0.4688452380952381,0,1,0,378379,227231,31371,76585,2.104848271518026,0.2520769149748532
16152,0.4688571428571428,0,1,0,378380,227230,31371,76585,2.104839008484938,0.25207774468015076
16153,0.4688888888888888,0,1,0,378381,227229,31371,76585,2.104829745451851,0.25207857439091025
16154,0.4688888888888889,0,1,0,378382,227228,31371,76585,2.1048204824187633,0.2520794041071317
16155,0.4689047619047619,0,3,0,378385,227225,31371,76585,2.1047926933195007,0.2520818932885685
16156,0.4689285714285713,0,1,0,378386,227224,31371,76585,2.104783430286413,0.2520827230266384
16157,0.4689285714285715,0,2,0,378388,227222,31371,76585,2.1047649042202377,0.25208438251916515
16158,0.4689404761904762,0,3,0,378391,227219,31371,76585,2.104737115120975,0.252086871798923
16159,0.4689523809523809,0,1,0,378392,227218,31371,76585,2.104727852087888,0.25208770156976723
16160,0.468952380952381,0,1,0,378393,227217,31371,76585,2.1047185890548,0.25208853134607406
16161,0.4689722222222222,0,1,0,378394,227216,31371,76585,2.1047093260217125,0.2520893611278436
16162,0.4689963924963925,0,2,0,378396,227214,31371,76585,2.1046907999555375,0.2520910207077706
16163,0.4689999999999999,0,1,0,378397,227213,31371,76585,2.10468153692245,0.2520918505059283
16164,0.469,5,48,5,378445,227165,31376,76580,2.1042369113342474,0.25211937645064114
16165,0.4690000000000001,0,5,0,378450,227160,31376,76580,2.1041905961688094,0.2521235267004675
16166,0.469047619047619,4,4,4,378454,227156,31380,76576,2.104153544036459,0.25211699787970976
16167,0.4690476190476191,0,3,0,378457,227153,31380,76576,2.1041257549371966,0.25211948809629636
16168,0.4691111111111111,0,1,0,378458,227152,31380,76576,2.104116491904109,0.2521203181794237
16169,0.4691428571428571,0,1,0,378459,227151,31380,76576,2.1041072288710216,0.252121148268017
16170,0.4691428571428572,0,1,0,378460,227150,31380,76576,2.104097965837934,0.25212197836207634
16171,0.4691666666666665,1,2,1,378462,227148,31381,76575,2.104079439771759,0.25212117620331687
16172,0.4691666666666666,13,77,13,378539,227071,31394,76562,2.1033661862240174,0.2521530927139013
16173,0.4691666666666667,11,57,11,378596,227014,31405,76551,2.1028381933380267,0.25217334014132065
16174,0.4692023809523809,0,1,0,378597,227013,31405,76551,2.102828930304939,0.2521741708502985
16175,0.4692142857142858,0,1,0,378598,227012,31405,76551,2.1028196672718513,0.2521750015647493
16176,0.4692857142857142,0,4,0,378602,227008,31405,76551,2.1027826151395015,0.2521783244772845
16177,0.4692857142857143,2,10,2,378612,226998,31407,76549,2.1026899848086256,0.2521817049748474
16178,0.4693095238095238,0,3,0,378615,226995,31407,76549,2.102662195709363,0.25218419734865455
16179,0.4693333333333332,0,1,0,378616,226994,31407,76549,2.1026529326762757,0.2521850281508715
16180,0.4693333333333333,1,13,1,378629,226981,31408,76548,2.102532513246137,0.25219336537859643
16181,0.4693333333333334,9,25,9,378654,226956,31417,76539,2.1023009374189483,0.25219196362378293
16182,0.4693769841269841,1,0,1,378654,226956,31418,76538,2.1023009374189483,0.25218949962766973
16183,0.4693809523809523,0,1,0,378655,226955,31418,76538,2.102291674385861,0.25219033058423096
16184,0.4693888888888889,0,1,0,378656,226954,31418,76538,2.1022824113527734,0.2521911615462681
16185,0.4694047619047618,0,1,0,378657,226953,31418,76538,2.1022731483196857,0.25219199251378127
16186,0.4694047619047619,0,2,0,378659,226951,31418,76538,2.102254622253511,0.25219365446523595
16187,0.4694155844155843,0,1,0,378660,226950,31418,76538,2.102245359220423,0.25219448544917755
16188,0.4694166666666665,0,1,0,378661,226949,31418,76538,2.1022360961873354,0.2521953164385954
16189,0.4694166666666667,0,1,0,378662,226948,31418,76538,2.102226833154248,0.2521961474334895
16190,0.4694285714285714,0,4,0,378666,226944,31418,76538,2.102189781021898,0.25219947146783006
16191,0.4694444444444445,0,1,0,378667,226943,31418,76538,2.1021805179888102,0.25220030249010644
16192,0.4694523809523809,1,1,1,378668,226942,31419,76537,2.1021712549557225,0.2521986694301747
16193,0.4694761904761904,1,0,1,378668,226942,31420,76536,2.1021712549557225,0.252196205326251
16194,0.4695,3,20,3,378688,226922,31423,76533,2.1019859942939716,0.2522054340841311
16195,0.4695238095238095,1,7,1,378695,226915,31424,76532,2.1019211530623587,0.25220878769603916
16196,0.4695476190476191,0,1,0,378696,226914,31424,76532,2.101911890029271,0.2522096188448686
16197,0.4695555555555555,0,1,0,378697,226913,31424,76532,2.101902626996184,0.25221044999917613
16198,0.4695555555555556,0,2,0,378699,226911,31424,76532,2.1018841009300084,0.25221211232422563
16199,0.4695714285714285,0,1,0,378700,226910,31424,76532,2.1018748378969208,0.25221294349496776
16200,0.4695730233818467,0,1,0,378701,226909,31424,76532,2.1018655748638335,0.25221377467118816
16201,0.4695833333333333,1,2,1,378703,226907,31425,76531,2.101847048797658,0.2522129726665744
16202,0.469595238095238,0,1,0,378704,226906,31425,76531,2.101837785764571,0.25221380385384773
16203,0.4696428571428571,0,4,0,378708,226902,31425,76531,2.1018007336322206,0.2522171286577268
16204,0.4696666666666666,2,9,2,378717,226893,31427,76529,2.1017173663344324,0.2522196808405455
16205,0.4696666666666667,5,17,5,378734,226876,31432,76524,2.101559894771944,0.2522214897824654
16206,0.4696904761904761,0,1,0,378735,226875,31432,76524,2.1015506317388564,0.2522223211019153
16207,0.4697023809523809,0,2,0,378737,226873,31432,76524,2.1015321056726814,0.25222398375725535
16208,0.4697142857142857,0,1,0,378738,226872,31432,76524,2.1015228426395938,0.2522248150931456
16209,0.4697222222222222,0,1,0,378739,226871,31432,76524,2.1015135796065065,0.25222564643451606
16210,0.4697307692307692,1,0,1,378739,226871,31433,76523,2.1015135796065065,0.2522231817372789
16211,0.46975,0,1,0,378740,226870,31433,76523,2.101504316573419,0.25222401307874603
16212,0.4697619047619047,0,1,0,378741,226869,31433,76523,2.101495053540331,0.2522248444256935
16213,0.4697619047619048,0,1,0,378742,226868,31433,76523,2.1014857905072435,0.2522256757781213
16214,0.4697619047619049,0,4,0,378746,226864,31433,76523,2.1014487383748937,0.2522290012426373
16215,0.4697857142857142,0,1,0,378747,226863,31433,76523,2.101439475341806,0.25222983262246773
16216,0.4698095238095237,1,0,1,378747,226863,31434,76522,2.101439475341806,0.25222736786591293
16217,0.4698333333333332,1,7,1,378754,226856,31435,76521,2.101374634110193,0.2522307228300102
16218,0.4698333333333333,3,19,3,378773,226837,31438,76518,2.1011986364815294,0.25223912577673024
16219,0.4698333333333334,1,0,1,378773,226837,31439,76517,2.1011986364815294,0.2522366607989346
16220,0.4698535353535354,1,2,1,378775,226835,31440,76516,2.1011801104153545,0.25223585879064186
16221,0.4698650793650793,0,1,0,378776,226834,31440,76516,2.101170847382267,0.2522366902917422
16222,0.4698809523809524,0,2,0,378778,226832,31440,76516,2.101152321316092,0.2522383533103894
16223,0.469881313131313,0,1,0,378779,226831,31440,76516,2.101143058283004,0.25223918482793634
16224,0.4698888888888888,0,1,0,378780,226830,31440,76516,2.1011337952499165,0.25224001635096555
16225,0.4699285714285714,0,1,0,378781,226829,31440,76516,2.1011245322168293,0.25224084787947715
16226,0.4699285714285715,0,2,0,378783,226827,31440,76516,2.101106006150654,0.25224251095294764
16227,0.4699523809523808,0,1,0,378784,226826,31440,76516,2.1010967431175662,0.25224334249790664
16228,0.469952380952381,1,2,1,378786,226824,31441,76515,2.1010782170513913,0.2522425405239682
16229,0.4699999999999999,6,25,6,378811,226799,31447,76509,2.1008466412242024,0.2522485394384586
16230,0.47,503,3160,503,381971,223639,31950,76006,2.071575456667531,0.25365348996312304
16231,0.4700000000000001,5,32,5,382003,223607,31955,76001,2.0712790396087293,0.25366812635176633
16232,0.4700714285714286,0,1,0,382004,223606,31955,76001,2.071269776575642,0.25366897302132463
16233,0.4701190476190476,1,0,1,382004,223606,31956,76000,2.071269776575642,0.2536664819796666
16234,0.4701428571428571,1,0,1,382004,223606,31957,75999,2.071269776575642,0.2536639909213798
16235,0.4701666666666665,0,1,0,382005,223605,31957,75999,2.0712605135425544,0.25366483758561303
16236,0.4701666666666667,4,9,4,382014,223596,31961,75995,2.0711771462447666,0.25366249319906137
16237,0.4701904761904761,0,2,0,382016,223594,31961,75995,2.071158620178591,0.2536641866023118
16238,0.4701904761904762,0,1,0,382017,223593,31961,75995,2.0711493571455035,0.25366503331241574
16239,0.4702142857142858,0,3,0,382020,223590,31961,75995,2.071121568046241,0.2536675734766427
16240,0.4702380952380952,1,4,1,382024,223586,31962,75994,2.0710845159138906,0.2536684691901996
16241,0.4702738095238095,0,1,0,382025,223585,31962,75994,2.0710752528808034,0.25366931594003583
16242,0.4702777777777777,0,2,0,382027,223583,31962,75994,2.071056726814628,0.2536710094566672
16243,0.4702777777777778,0,1,0,382028,223582,31962,75994,2.071047463781541,0.2536718562234625
16244,0.4702896825396825,1,2,1,382030,223580,31963,75993,2.0710289377153654,0.2536710584732269
16245,0.4703055555555555,0,1,0,382031,223579,31963,75993,2.0710196746822778,0.25367190525149214
16246,0.4703095238095238,0,1,0,382032,223578,31963,75993,2.0710104116491905,0.2536727520354106
16247,0.4703333333333332,1,5,1,382037,223573,31964,75992,2.0709640964837526,0.2536744946839584
16248,0.4703333333333333,1,22,1,382059,223551,31965,75991,2.0707603097558263,0.25369063436846917
16249,0.4703333333333334,1,7,1,382066,223544,31966,75990,2.0706954685242134,0.25369407145766426
16250,0.4703463203463203,0,1,0,382067,223543,31966,75990,2.070686205491126,0.25369491842301184
16251,0.4703571428571428,2,3,2,382070,223540,31968,75988,2.0706584163918635,0.2536924761624957
16252,0.4704166666666667,0,2,0,382072,223538,31968,75988,2.070639890325688,0.2536941701221263
16253,0.4704761904761904,1,0,1,382072,223538,31969,75987,2.070639890325688,0.253691678490944
16254,0.4704761904761905,1,5,1,382077,223533,31970,75986,2.0705935751602507,0.253693421786264
16255,0.4705,6,21,6,382098,223512,31976,75980,2.070399051465412,0.2536962589985709
16256,0.4705000000000001,0,1,0,382099,223511,31976,75980,2.0703897884323244,0.25369710608999935
16257,0.4705039682539683,0,1,0,382100,223510,31976,75980,2.0703805253992367,0.2536979531870847
16258,0.4705238095238095,0,3,0,382103,223507,31976,75980,2.070352736299974,0.25370049451228266
16259,0.470547619047619,0,1,0,382104,223506,31976,75980,2.0703434732668864,0.25370134163199615
16260,0.4705555555555555,0,3,0,382107,223503,31976,75980,2.070315684167624,0.2537038830250799
16261,0.470563492063492,1,0,1,382107,223503,31977,75979,2.070315684167624,0.2537013910685784
16262,0.470595238095238,0,1,0,382108,223502,31977,75979,2.070306421134536,0.2537022382054287
16263,0.4705952380952381,0,2,0,382110,223500,31977,75979,2.070287895068361,0.25370393249610157
16264,0.4706031746031747,0,3,0,382113,223497,31977,75979,2.0702601059690986,0.2537064739745422
16265,0.4706111111111111,1,0,1,382113,223497,31978,75978,2.0702601059690986,0.2537039819684448
16266,0.4706190476190475,1,0,1,382113,223497,31979,75977,2.0702601059690986,0.2537014899457048
16267,0.4706666666666666,4,40,4,382153,223457,31983,75973,2.0698895846455962,0.2537254116154026
16268,0.4706666666666667,3,18,3,382171,223439,31986,75970,2.06972285005002,0.2537331877131282
16269,0.4706666666666668,0,1,0,382172,223438,31986,75970,2.069713587016933,0.2537340351627211
16270,0.4707051282051281,0,1,0,382173,223437,31986,75970,2.0697043239838453,0.2537348826179749
16271,0.4707142857142856,0,1,0,382174,223436,31986,75970,2.0696950609507576,0.25373573007888955
16272,0.4707142857142857,1,8,1,382182,223428,31987,75969,2.0696209566860575,0.25374001743504443
16273,0.4707380952380952,0,1,0,382183,223427,31987,75969,2.06961169365297,0.2537408649414154
16274,0.4707619047619047,0,1,0,382184,223426,31987,75969,2.069602430619882,0.2537417124534478
16275,0.4707619047619048,0,1,0,382185,223425,31987,75969,2.0695931675867945,0.2537425599711417
16276,0.4708095238095238,0,1,0,382186,223424,31987,75969,2.069583904553707,0.2537434074944972
16277,0.4708333333333332,12,58,12,382244,223366,31999,75957,2.069046648634629,0.2537626577309462
16278,0.4708333333333334,15,82,15,382326,223284,32014,75942,2.0682870799214497,0.2537947905596439
16279,0.4709047619047619,0,1,0,382327,223283,32014,75942,2.068277816888362,0.2537956387333946
16280,0.4709166666666667,0,1,0,382328,223282,32014,75942,2.0682685538552743,0.2537964869128145
16281,0.4709523809523809,1,6,1,382334,223276,32015,75941,2.068212975656749,0.253799082271395
16282,0.470952380952381,0,6,0,382340,223270,32015,75941,2.068157397458224,0.2538041716380748
16283,0.4709999999999999,0,3,0,382343,223267,32015,75941,2.068129608358961,0.25380671639795727
16284,0.471,11,77,11,382420,223190,32026,75930,2.067416354811219,0.25384461085851834
16285,0.4710396825396826,0,4,0,382424,223186,32026,75930,2.0673793026788694,0.2538480054560772
16286,0.471047619047619,0,2,0,382426,223184,32026,75930,2.067360776612694,0.25384970278890323
16287,0.471060606060606,0,1,0,382427,223183,32026,75930,2.0673515135796063,0.25385055146382807
16288,0.4710714285714285,0,2,0,382429,223181,32026,75930,2.0673329875134314,0.2538522488307016
16289,0.4710714285714286,0,2,0,382431,223179,32026,75930,2.0673144614472565,0.25385394622027424
16290,0.4710753968253967,1,1,1,382432,223178,32027,75929,2.067305198414169,0.25385230034736733
16291,0.471153846153846,0,1,0,382433,223177,32027,75929,2.067295935381081,0.25385314905083817
16292,0.4711666666666666,0,3,0,382436,223174,32027,75929,2.0672681462818185,0.2538556951953006
16293,0.4711666666666667,1,9,1,382445,223165,32028,75928,2.0671847789840307,0.2538608392707285
16294,0.4711746031746031,0,3,0,382448,223162,32028,75928,2.0671569898847677,0.25386338560299576
16295,0.4711753246753247,0,4,0,382452,223158,32028,75928,2.067119937752418,0.25386678079214675
16296,0.4711904761904761,0,2,0,382454,223156,32028,75928,2.0671014116862425,0.2538684784207781
16297,0.4711904761904762,0,2,0,382456,223154,32028,75928,2.0670828856200676,0.253870176072114
16298,0.4712121212121212,0,1,0,382457,223153,32028,75928,2.06707362258698,0.25387102490629626
16299,0.4712301587301587,0,1,0,382458,223152,32028,75928,2.0670643595538922,0.2538718737461549
16300,0.4712380952380953,0,1,0,382459,223151,32028,75928,2.067055096520805,0.2538727225916898
16301,0.47125,0,8,0,382467,223143,32028,75928,2.0669809922561044,0.2538795135603251
16302,0.4712857142857143,0,1,0,382468,223142,32028,75928,2.0669717292230168,0.2538803624569499
16303,0.4713333333333332,0,7,0,382475,223135,32028,75928,2.066906887991404,0.2538863048922802
16304,0.4713333333333333,5,22,5,382497,223113,32033,75923,2.0667031012634776,0.2538925079254672
16305,0.4713333333333334,0,1,0,382498,223112,32033,75923,2.0666938382303903,0.2538933569649038
16306,0.471345238095238,0,1,0,382499,223111,32033,75923,2.0666845751973026,0.25389420601001894
16307,0.4713636363636364,0,1,0,382500,223110,32033,75923,2.066675312164215,0.25389505506081267
16308,0.4713809523809524,0,3,0,382503,223107,32033,75923,2.0666475230649524,0.25389760224726615
16309,0.4714047619047619,1,2,1,382505,223105,32034,75922,2.0666289969987774,0.25389680530520653
16310,0.4714166666666666,0,2,0,382507,223103,32034,75922,2.066610470932602,0.25389850346960957
16311,0.4714166666666667,0,1,0,382508,223102,32034,75922,2.0666012078995144,0.2538993525603296
16312,0.4714285714285713,0,2,0,382510,223100,32034,75922,2.0665826818333395,0.25390105075880703
16313,0.4714285714285715,1,4,1,382514,223096,32035,75921,2.066545629700989,0.2539019520629262
16314,0.4714761904761905,0,1,0,382515,223095,32035,75921,2.0665363666679015,0.2539028011878963
16315,0.4714920634920635,1,0,1,382515,223095,32036,75920,2.0665363666679015,0.25390030600471547
16316,0.4714999999999999,0,1,0,382516,223094,32036,75920,2.0665271036348143,0.25390115512986017
16317,0.4715,4,37,4,382553,223057,32040,75916,2.0661843714105745,0.2539225950169413
16318,0.4715238095238095,0,1,0,382554,223056,32040,75916,2.0661751083774873,0.25392344433592445
16319,0.471547619047619,0,3,0,382557,223053,32040,75916,2.0661473192782243,0.25392599232696367
16320,0.4715476190476191,0,1,0,382558,223052,32040,75916,2.066138056245137,0.2539268416686736
16321,0.4715714285714286,0,5,0,382563,223047,32040,75916,2.066091741079699,0.2539310884624519
16322,0.4715833333333333,0,1,0,382564,223046,32040,75916,2.0660824780466114,0.2539319378382537
16323,0.4715833333333334,0,1,0,382565,223045,32040,75916,2.066073215013524,0.25393278721973767
16324,0.4715903540903541,0,1,0,382566,223044,32040,75916,2.0660639519804365,0.25393363660690393
16325,0.471595238095238,0,2,0,382568,223042,32040,75916,2.0660454259142615,0.2539353353982834
16326,0.4716666666666665,1,2,1,382570,223040,32041,75915,2.066026899848086,0.2539345386429396
16327,0.4716666666666666,32,221,32,382791,222819,32073,75883,2.0639797695357367,0.25404249050893535
16328,0.4716666666666667,37,169,37,382960,222650,32110,75846,2.06241431694394,0.25409385720411665
16329,0.4717023809523809,1,0,1,382960,222650,32111,75845,2.06241431694394,0.2540913583142096
16330,0.4717142857142856,0,2,0,382962,222648,32111,75845,2.062395790877765,0.2540930608087962
16331,0.4717301587301587,0,1,0,382963,222647,32111,75845,2.0623865278446774,0.25409391206464493
16332,0.4717619047619047,1,2,1,382965,222645,32112,75844,2.0623680017785024,0.2540931156592035
16333,0.4717619047619048,0,1,0,382966,222644,32112,75844,2.0623587387454148,0.2540939669266436
16334,0.4717777777777778,0,1,0,382967,222643,32112,75844,2.062349475712327,0.2540948181997876
16335,0.4717857142857143,1,6,1,382973,222637,32113,75843,2.062293897513802,0.25409742696328064
16336,0.4718333333333333,0,10,0,382983,222627,32113,75843,2.0622012671829264,0.2541059402955071
16337,0.4718333333333334,2,13,2,382996,222614,32115,75841,2.0620808477527883,0.25411201018579016
16338,0.4718571428571428,0,2,0,382998,222612,32115,75841,2.062062321686613,0.2541137130469454
16339,0.4718809523809523,0,1,0,382999,222611,32115,75841,2.0620530586535257,0.2541145644860815
16340,0.4718809523809524,0,1,0,383000,222610,32115,75841,2.062043795620438,0.25411541593092335
16341,0.4718939393939393,0,1,0,383001,222609,32115,75841,2.0620345325873504,0.2541162673814709
16342,0.4719047619047619,1,2,1,383003,222607,32116,75840,2.0620160065211754,0.254115471088669
16343,0.471904761904762,0,3,0,383006,222604,32116,75840,2.061988217421913,0.2541180254922196
16344,0.4719166666666666,0,2,0,383008,222602,32116,75840,2.0619696913557375,0.2541197284564505
16345,0.4719404761904762,0,1,0,383009,222601,32116,75840,2.06196042832265,0.2541205799471252
16346,0.4719444444444444,0,2,0,383011,222599,32116,75840,2.061941902256475,0.2541222829455936
16347,0.4719523809523809,1,0,1,383011,222599,32117,75839,2.061941902256475,0.25411978367366084
16348,0.4719642857142856,0,4,0,383015,222595,32117,75839,2.0619048501241246,0.25412318971698933
16349,0.4719761904761905,1,0,1,383015,222595,32118,75838,2.0619048501241246,0.2541206904062218
16350,0.472,16,89,16,383104,222506,32134,75822,2.061080440179332,0.25415649888713093
16351,0.4720143467643469,0,3,0,383107,222503,32134,75822,2.0610526510800695,0.25415905472219896
16352,0.4720238095238095,0,1,0,383108,222502,32134,75822,2.0610433880469823,0.2541599066786447
16353,0.4720476190476191,0,2,0,383110,222500,32134,75822,2.061024861980807,0.25416161060867115
16354,0.4720833333333333,3,4,3,383114,222496,32137,75819,2.0609878098484566,0.25415751805976905
16355,0.4720833333333334,0,2,0,383116,222494,32137,75819,2.0609692837822817,0.2541592220251883
16356,0.472095238095238,0,2,0,383118,222492,32137,75819,2.0609507577161064,0.25416092601345575
16357,0.4721428571428571,1,7,1,383125,222485,32138,75818,2.0608859164844935,0.2541643898988612
16358,0.4721428571428572,1,0,1,383125,222485,32139,75817,2.0608859164844935,0.2541618896286314
16359,0.4721437173937173,1,5,1,383130,222480,32140,75816,2.060839601319056,0.2541636495293266
16360,0.4721666666666666,0,4,0,383134,222476,32140,75816,2.0608025491867057,0.25416705778230725
16361,0.4721666666666667,3,10,3,383144,222466,32143,75813,2.06070991885583,0.2541680775381438
16362,0.4721904761904762,0,1,0,383145,222465,32143,75813,2.0607006558227425,0.2541689296562267
16363,0.4722023809523809,0,1,0,383146,222464,32143,75813,2.060691392789655,0.25416978178002325
16364,0.4722222222222222,1,1,1,383147,222463,32144,75812,2.0606821297565676,0.25416813343391165
16365,0.4722499999999999,0,1,0,383148,222462,32144,75812,2.06067286672348,0.2541689855636093
16366,0.47225,0,2,0,383150,222460,32144,75812,2.060654340657305,0.2541706898401459
16367,0.4722857142857142,0,1,0,383151,222459,32144,75812,2.0606450776242173,0.254171541986985
16368,0.4723095238095238,0,1,0,383152,222458,32144,75812,2.0606358145911297,0.254172394139538
16369,0.4723333333333332,0,6,0,383158,222452,32144,75812,2.0605802363926045,0.2541775071748518
16370,0.4723333333333333,4,31,4,383189,222421,32148,75808,2.0602930823668903,0.25419392480275227
16371,0.4723809523809523,1,1,1,383190,222420,32149,75807,2.0602838193338027,0.2541922763532477
16372,0.4723809523809524,1,3,1,383193,222417,32150,75806,2.06025603023454,0.2541923325833353
16373,0.4723888888888889,0,2,0,383195,222415,32150,75806,2.0602375041683647,0.2541940373079025
16374,0.4724166666666666,0,3,0,383198,222412,32150,75806,2.060209715069102,0.25419659443762616
16375,0.4724285714285715,0,2,0,383200,222410,32150,75806,2.060191189002927,0.25419829921935777
16376,0.4724761904761905,0,1,0,383201,222409,32150,75806,2.0601819259698395,0.2541991516187985
16377,0.4724999999999999,2,11,2,383212,222398,32152,75804,2.0600800326058764,0.25420352646863537
16378,0.4725,62,321,62,383533,222077,32214,75742,2.0571065989847717,0.25432225613543796
16379,0.4725000000000001,0,8,0,383541,222069,32214,75742,2.057032494720071,0.25432908791146064
16380,0.4725238095238096,0,1,0,383542,222068,32214,75742,2.0570232316869834,0.254329941909271
16381,0.4725952380952381,0,1,0,383543,222067,32214,75742,2.057013968653896,0.2543307959128166
16382,0.4726190476190476,1,2,1,383545,222065,32215,75741,2.056995442587721,0.25433000006715784
16383,0.4726515151515151,0,1,0,383546,222064,32215,75741,2.0569861795546336,0.25433085408236933
16384,0.4726666666666665,1,3,1,383549,222061,32216,75740,2.0569583904553705,0.2543309122534847
16385,0.4726666666666667,5,54,5,383603,222007,32221,75735,2.056458186668643,0.25436451693076556
16386,0.4726746031746031,1,0,1,383603,222007,32222,75734,2.056458186668643,0.25436201262170816
16387,0.4727142857142856,0,2,0,383605,222005,32222,75734,2.0564396606024675,0.2543637212457891
16388,0.47275,0,1,0,383606,222004,32222,75734,2.0564303975693803,0.2543645755664376
16389,0.4727777777777777,0,1,0,383607,222003,32222,75734,2.0564211345362926,0.2543654298928249
16390,0.4727777777777778,0,2,0,383609,222001,32222,75734,2.0564026084701172,0.25436713856281595
16391,0.4728095238095238,0,3,0,383612,221998,32222,75734,2.0563748193708546,0.25436970161084466
16392,0.4728333333333332,0,2,0,383614,221996,32222,75734,2.0563562933046797,0.2543714103382259
16393,0.4728333333333333,0,6,0,383620,221990,32222,75734,2.0563007151061545,0.2543765366581129
16394,0.4728333333333334,1,6,1,383626,221984,32223,75733,2.056245136907629,0.25437915873127837
16395,0.4728571428571428,0,7,0,383633,221977,32223,75733,2.056180295676016,0.25438513990124617
16396,0.4728571428571429,0,1,0,383634,221976,32223,75733,2.0561710326429288,0.2543859943770595
16397,0.4728730158730159,1,4,1,383638,221972,32224,75732,2.0561339805105785,0.2543869078010373
16398,0.472904761904762,0,1,0,383639,221971,32224,75732,2.056124717477491,0.2543877623000104
16399,0.4729166666666666,0,2,0,383641,221969,32224,75732,2.056106191411316,0.25438947131517864
16400,0.4729166666666667,0,3,0,383644,221966,32224,75732,2.056078402312053,0.2543920348809868
16401,0.4729761904761904,0,1,0,383645,221965,32224,75732,2.0560691392789656,0.2543928894144046
16402,0.4729999999999999,0,1,0,383646,221964,32224,75732,2.056059876245878,0.25439374395356334
16403,0.473,12,69,12,383715,221895,32236,75720,2.055420726962837,0.254422660148178
16404,0.4730119047619048,0,3,0,383718,221892,32236,75720,2.0553929378635742,0.254425224789323
16405,0.473021978021978,0,1,0,383719,221891,32236,75720,2.0553836748304866,0.2544260796811946
16406,0.4730714285714286,0,1,0,383720,221890,32236,75720,2.055374411797399,0.2544269345788112
16407,0.4730952380952381,0,1,0,383721,221889,32236,75720,2.055365148764311,0.25442778948217293
16408,0.4731111111111111,0,1,0,383722,221888,32236,75720,2.055355885731224,0.2544286443912798
16409,0.4731428571428571,0,1,0,383723,221887,32236,75720,2.0553466226981363,0.2544294993061319
16410,0.4731666666666666,1,10,1,383733,221877,32237,75719,2.055253992367261,0.25443554348848774
16411,0.4731666666666667,0,3,0,383736,221874,32237,75719,2.055226203267998,0.2544381084232492
16412,0.4731904761904761,0,1,0,383737,221873,32237,75719,2.0552169402349105,0.254438963412995
16413,0.4732142857142857,1,5,1,383742,221868,32238,75718,2.0551706250694726,0.25444073309900334
16414,0.4732499999999999,0,2,0,383744,221866,32238,75718,2.0551520990032976,0.2544424431421044
16415,0.4732619047619046,0,1,0,383745,221865,32238,75718,2.05514283597021,0.2544432981722746
16416,0.4733095238095237,1,0,1,383745,221865,32239,75717,2.05514283597021,0.25444079278988646
16417,0.4733095238095238,0,1,0,383746,221864,32239,75717,2.0551335729371227,0.25444164782025736
16418,0.4733333333333332,0,1,0,383747,221863,32239,75717,2.055124309904035,0.25444250285637476
16419,0.4733333333333333,51,321,51,384068,221542,32290,75666,2.05215087628293,0.25458937848240965
16420,0.4733333333333334,53,350,53,384418,221192,32343,75613,2.048908814702286,0.25475648995131484
16421,0.4733585858585858,1,0,1,384418,221192,32344,75612,2.048908814702286,0.254753979056886
16422,0.4733809523809523,0,1,0,384419,221191,32344,75612,2.0488995516691983,0.2547548373837192
16423,0.4733888888888889,0,1,0,384420,221190,32344,75612,2.048890288636111,0.25475569571633616
16424,0.4734285714285714,0,1,0,384421,221189,32344,75612,2.0488810256030234,0.254756554054737
16425,0.4734285714285715,0,1,0,384422,221188,32344,75612,2.0488717625699358,0.25475741239892186
16426,0.473452380952381,0,1,0,384423,221187,32344,75612,2.0488624995368485,0.2547582707488907
16427,0.4734761904761904,0,1,0,384424,221186,32344,75612,2.048853236503761,0.25475912910464354
16428,0.4734999999999999,0,5,0,384429,221181,32344,75612,2.048806921338323,0.25476342097017113
16429,0.4735,4,32,4,384461,221149,32348,75608,2.048510504279521,0.254780847629542
16430,0.4735000000000001,0,1,0,384462,221148,32348,75608,2.048501241246434,0.2547817061828573
16431,0.4735476190476191,0,2,0,384464,221146,32348,75608,2.0484827151802585,0.2547834233068467
16432,0.4735555555555555,2,1,2,384465,221145,32350,75606,2.0484734521471712,0.25477925937907536
16433,0.4735714285714285,0,1,0,384466,221144,32350,75606,2.0484641891140836,0.25478011794439764
16434,0.4735714285714286,0,5,0,384471,221139,32350,75606,2.0484178739486456,0.25478441085780723
16435,0.4736111111111111,0,2,0,384473,221137,32350,75606,2.0483993478824707,0.254786128063678
16436,0.4736190476190476,1,2,1,384475,221135,32351,75605,2.0483808218162953,0.25478533396239134
16437,0.4736666666666666,0,1,0,384476,221134,32351,75605,2.048371558783208,0.2547861925800114
16438,0.4736666666666667,4,22,4,384498,221112,32355,75601,2.0481677720552818,0.25479503762895456
16439,0.4736746031746032,0,1,0,384499,221111,32355,75601,2.048158509022194,0.25479589635741057
16440,0.4736904761904762,1,2,1,384501,221109,32356,75600,2.048139982956019,0.254795102271923
16441,0.4737063492063492,0,1,0,384502,221108,32356,75600,2.0481307199229315,0.2547959610121736
16442,0.4737222222222222,0,1,0,384503,221107,32356,75600,2.048121456889844,0.25479681975821267
16443,0.4737380952380953,0,1,0,384504,221106,32356,75600,2.0481121938567566,0.25479767851004026
16444,0.47375,0,5,0,384509,221101,32356,75600,2.0480658786913186,0.2548019723560082
16445,0.4737619047619048,0,1,0,384510,221100,32356,75600,2.048056615658231,0.25480283114256824
16446,0.4738095238095238,1,4,1,384514,221096,32357,75599,2.048019563525881,0.25480375469758504
16447,0.4738333333333333,3,14,3,384528,221082,32360,75596,2.0478898810626553,0.25480824328059376
16448,0.4738412698412698,0,1,0,384529,221081,32360,75596,2.0478806180295677,0.25480910215486874
16449,0.4738809523809524,1,1,1,384530,221080,32361,75595,2.04787135499648,0.25480744922895426
16450,0.4738888888888888,0,1,0,384531,221079,32361,75595,2.0478620919633923,0.25480830810923777
16451,0.4738888888888889,0,1,0,384532,221078,32361,75595,2.047852828930305,0.2548091669953113
16452,0.4739166666666666,0,2,0,384534,221076,32361,75595,2.0478343028641297,0.254810884784829
16453,0.4739285714285715,0,1,0,384535,221075,32361,75595,2.0478250398310425,0.25481174368827314
16454,0.473952380952381,0,1,0,384536,221074,32361,75595,2.047815776797955,0.25481260259750765
16455,0.4739761904761905,0,2,0,384538,221072,32361,75595,2.0477972507317794,0.25481432043334784
16456,0.474,27,123,27,384661,220949,32388,75568,2.0466578976620102,0.2548521669921118
16457,0.4740238095238095,0,1,0,384662,220948,32388,75568,2.046648634628923,0.25485302648086444
16458,0.474047619047619,1,4,1,384666,220944,32389,75567,2.0466115824965727,0.2548539514554266
16459,0.4740555555555557,0,1,0,384667,220943,32389,75567,2.046602319463485,0.2548548109675896
16460,0.4740833333333333,0,1,0,384668,220942,32389,75567,2.0465930564303974,0.2548556704855502
16461,0.4741111111111112,0,1,0,384669,220941,32389,75567,2.04658379339731,0.25485653000930836
16462,0.4741190476190475,0,2,0,384671,220939,32389,75567,2.0465652673311348,0.2548582490742177
16463,0.4741349206349207,0,1,0,384672,220938,32389,75567,2.0465560042980475,0.25485910861536903
16464,0.4741428571428571,0,1,0,384673,220937,32389,75567,2.04654674126496,0.2548599681623182
16465,0.4741428571428572,0,1,0,384674,220936,32389,75567,2.046537478231872,0.2548608277150653
16466,0.4741666666666665,0,2,0,384676,220934,32389,75567,2.0465189521656972,0.25486254683795334
16467,0.4741666666666666,7,67,7,384743,220867,32396,75560,2.045898328948831,0.254902556109936
16468,0.4741666666666667,4,71,4,384814,220796,32400,75556,2.0452406535996146,0.2549535687290789
16469,0.4741666666666668,0,1,0,384815,220795,32400,75556,2.045231390566527,0.25495442903853877
16470,0.4741702186702184,0,5,0,384820,220790,32400,75556,2.0451850754010894,0.2549587306729296
16471,0.4742380952380954,0,3,0,384823,220787,32400,75556,2.045157286301827,0.2549613117232396
16472,0.4742619047619048,0,2,0,384825,220785,32400,75556,2.0451387602356514,0.25496303245247876
16473,0.4742738095238094,0,1,0,384826,220784,32400,75556,2.045129497202564,0.25496389282580817
16474,0.4742857142857143,1,17,1,384843,220767,32401,75555,2.0449720256400754,0.2549760058314941
16475,0.4743055555555556,0,1,0,384844,220766,32401,75555,2.044962762606988,0.2549768663037719
16476,0.4743253968253969,0,1,0,384845,220765,32401,75555,2.0449534995739005,0.25497772678185743
16477,0.4743333333333333,1,14,1,384859,220751,32402,75554,2.0448238171106747,0.25498725974924485
16478,0.4743333333333334,7,24,7,384883,220727,32409,75547,2.0446015043165735,0.25499031302105485
16479,0.4743571428571428,1,1,1,384884,220726,32410,75546,2.044592241283486,0.25498865907004375
16480,0.4743809523809524,0,2,0,384886,220724,32410,75546,2.044573715217311,0.25499038039626015
16481,0.4743888888888888,0,1,0,384887,220723,32410,75546,2.0445644521842232,0.2549912410680834
16482,0.4744047619047619,1,1,1,384888,220722,32411,75545,2.0445551891511355,0.2549895870954241
16483,0.4744285714285715,0,1,0,384889,220721,32411,75545,2.0445459261180483,0.25499044777328483
16484,0.4744444444444444,0,4,0,384893,220717,32411,75545,2.044508873985698,0.25499389054283034
16485,0.4744444444444445,0,1,0,384894,220716,32411,75545,2.0444996109526103,0.25499475124974263
16486,0.4744603174603174,1,0,1,384894,220716,32412,75544,2.0444996109526103,0.25499223654897724
16487,0.4744920634920635,0,1,0,384895,220715,32412,75544,2.0444903479195227,0.25499309725611713
16488,0.4745,2,19,2,384914,220696,32414,75542,2.0443143502908594,0.25500442212005214
16489,0.4745119047619047,0,1,0,384915,220695,32414,75542,2.0443050872577717,0.25500528293224684
16490,0.4745238095238095,0,8,0,384923,220687,32414,75542,2.044230982993071,0.2550121696390293
16491,0.474547619047619,1,0,1,384923,220687,32415,75541,2.044230982993071,0.2550096547254142
16492,0.4745555555555555,0,1,0,384924,220686,32415,75541,2.044221719959984,0.2550105155843323
16493,0.4745833333333333,1,2,1,384926,220684,32416,75540,2.0442031938938086,0.25500972237225883
16494,0.474595238095238,0,2,0,384928,220682,32416,75540,2.0441846678276336,0.255011444119613
16495,0.4745952380952382,1,0,1,384928,220682,32417,75539,2.0441846678276336,0.25500892914411877
16496,0.4746190476190476,0,2,0,384930,220680,32417,75539,2.0441661417614583,0.25501065090355446
16497,0.4746428571428571,2,6,2,384936,220674,32419,75537,2.044110563562933,0.255010786230086
16498,0.4746666666666666,0,14,0,384950,220660,32419,75537,2.0439808810997073,0.2550228395290972
16499,0.4746666666666667,2,26,2,384976,220634,32421,75535,2.0437400422394307,0.2550401966444834
16500,0.4746904761904761,0,1,0,384977,220633,32421,75535,2.0437307792063435,0.2550410577780179
16501,0.4746904761904762,0,1,0,384978,220632,32421,75535,2.043721516173256,0.25504191891736755
16502,0.4746904761904763,0,1,0,384979,220631,32421,75535,2.043712253140168,0.2550427800625325
16503,0.4747023809523809,1,0,1,384979,220631,32422,75534,2.043712253140168,0.25504026471730284
16504,0.4747142857142857,0,2,0,384981,220629,32422,75534,2.043693727073993,0.2550419870139079
16505,0.4747222222222222,0,1,0,384982,220628,32422,75534,2.0436844640409055,0.2550428481709335
16506,0.4747619047619047,0,1,0,384983,220627,32422,75534,2.043675201007818,0.2550437093337745
16507,0.4747857142857142,0,1,0,384984,220626,32422,75534,2.0436659379747306,0.2550445705024311
16508,0.4748333333333333,0,19,0,385003,220607,32422,75534,2.043489940346067,0.2550609338119342
16509,0.4748333333333334,0,1,0,385004,220606,32422,75534,2.043480677312979,0.2550617950969136
16510,0.4748333333333335,1,2,1,385006,220604,32423,75533,2.0434621512468043,0.25506100217129235
16511,0.4748809523809524,0,1,0,385007,220603,32423,75533,2.0434528882137166,0.25506186346813625
16512,0.4749242424242424,0,1,0,385008,220602,32423,75533,2.043443625180629,0.2550627247707971
16513,0.4749285714285715,0,6,0,385014,220596,32423,75533,2.0433880469821037,0.2550678927089208
16514,0.4749444444444444,0,1,0,385015,220595,32423,75533,2.043378783949016,0.2550687540523017
16515,0.47498556998557,0,1,0,385016,220594,32423,75533,2.043369520915929,0.2550696154015
16516,0.4749999999999999,4,14,4,385030,220580,32427,75529,2.043239838452703,0.2550716121428258
16517,0.475,202,1281,202,386311,219299,32629,75327,2.031373893067546,0.25566990014459007
16518,0.4750000000000001,4,16,4,386327,219283,32633,75323,2.0312256845381453,0.2556736794226866
16519,0.4750555555555555,1,1,1,386328,219282,32634,75322,2.0312164215050577,0.2556720207464936
16520,0.4750833333333333,0,1,0,386329,219281,32634,75322,2.03120715847197,0.25567288859923354
16521,0.4751190476190476,0,5,0,386334,219276,32634,75322,2.0311608433065325,0.2556772279513099
16522,0.4751388888888889,3,6,3,386340,219270,32637,75319,2.031105265108007,0.25567485547661317
16523,0.4751428571428572,0,1,0,386341,219269,32637,75319,2.0310960020749196,0.25567572338316563
16524,0.4751666666666667,2,12,2,386353,219257,32639,75317,2.0309848456778687,0.25568108522815997
16525,0.4751666666666668,0,1,0,386354,219256,32639,75317,2.030975582644781,0.25568195320005566
16526,0.4751904761904761,0,1,0,386355,219255,32639,75317,2.030966319611694,0.25568282117784447
16527,0.4752380952380952,2,7,2,386362,219248,32641,75315,2.030901478380081,0.25568384352413576
16528,0.47525,0,1,0,386363,219247,32641,75315,2.0308922153469933,0.2556847115378087
16529,0.4752777777777778,0,1,0,386364,219246,32641,75315,2.0308829523139056,0.2556855795573752
16530,0.4753333333333333,3,16,3,386380,219230,32644,75312,2.030734743784505,0.2556918877443624
16531,0.4753333333333334,0,7,0,386387,219223,32644,75312,2.030669902552892,0.2556979645882493
16532,0.4753409090909091,0,1,0,386388,219222,32644,75312,2.0306606395198044,0.25569883273238403
16533,0.4753571428571428,0,4,0,386392,219218,32644,75312,2.030623587387454,0.25570230536787425
16534,0.4753888888888888,0,1,0,386393,219217,32644,75312,2.0306143243543664,0.25570317354148486
16535,0.4754047619047618,0,1,0,386394,219216,32644,75312,2.030605061321279,0.25570404172099087
16536,0.4754166666666666,0,4,0,386398,219212,32644,75312,2.030568009188929,0.2557075144979696
16537,0.4754166666666667,1,4,1,386402,219208,32645,75311,2.0305309570565786,0.2557084602351631
16538,0.4754444444444444,0,2,0,386404,219206,32645,75311,2.0305124309904037,0.2557101966949276
16539,0.4754761904761904,0,3,0,386407,219203,32645,75311,2.0304846418911406,0.25571280142879455
16540,0.4754761904761905,2,2,2,386409,219201,32647,75309,2.0304661158249657,0.2557094835489457
16541,0.4754999999999999,0,1,0,386410,219200,32647,75309,2.030456852791878,0.2557103518058871
16542,0.4755,3,14,3,386424,219186,32650,75306,2.0303271703286523,0.2557149260421336
16543,0.4755238095238094,0,1,0,386425,219185,32650,75306,2.030317907295565,0.2557157943706259
16544,0.4755555555555555,0,2,0,386427,219183,32650,75306,2.0302993812293897,0.2557175310453022
16545,0.4755833333333333,0,4,0,386431,219179,32650,75306,2.0302623290970394,0.2557210044654227
16546,0.475595238095238,0,1,0,386432,219178,32650,75306,2.030253066063952,0.2557218728351965
16547,0.4755952380952381,0,1,0,386433,219177,32650,75306,2.0302438030308645,0.25572274121086785
16548,0.4756190476190475,0,1,0,386434,219176,32650,75306,2.030234539997777,0.2557236095924369
16549,0.4756428571428571,1,1,1,386435,219175,32651,75305,2.030225276964689,0.2557219505569139
16550,0.4756666666666666,7,24,7,386459,219151,32658,75298,2.030002964170588,0.2557251001022248
16551,0.4756666666666667,0,8,0,386467,219143,32658,75298,2.029928859905888,0.2557320481862241
16552,0.4756904761904762,0,1,0,386468,219142,32658,75298,2.0299195968728,0.2557329167232713
16553,0.4757142857142857,4,13,4,386481,219129,32662,75294,2.029799177442662,0.2557340968606393
16554,0.4757575757575757,1,0,1,386481,219129,32663,75293,2.029799177442662,0.2557315689724273
16555,0.4757619047619048,1,0,1,386481,219129,32664,75292,2.029799177442662,0.25572904106704347
16556,0.4757628743805215,0,2,0,386483,219127,32664,75292,2.0297806513764867,0.25573077824461055
16557,0.4757857142857142,0,1,0,386484,219126,32664,75292,2.029771388343399,0.2557316468422447
16558,0.4757857142857143,0,1,0,386485,219125,32664,75292,2.0297621253103117,0.2557325154457793
16559,0.4758333333333333,24,139,24,386624,218986,32688,75268,2.0284745637111414,0.25579261454389746
16560,0.4758333333333334,0,2,0,386626,218984,32688,75268,2.0284560376449665,0.2557943531394859
16561,0.4758571428571428,0,2,0,386628,218982,32688,75268,2.028437511578791,0.2557960917587086
16562,0.4758809523809523,1,2,1,386630,218980,32689,75267,2.0284189855126162,0.25579530122652056
16563,0.4759047619047619,0,1,0,386631,218979,32689,75267,2.0284097224795286,0.2557961705511715
16564,0.4759285714285714,0,1,0,386632,218978,32689,75267,2.0284004594464413,0.2557970398817312
16565,0.4759523809523809,0,5,0,386637,218973,32689,75267,2.0283541442810034,0.25580138662316476
16566,0.475952380952381,0,5,0,386642,218968,32689,75267,2.0283078291155654,0.2558057335123286
16567,0.4759761904761905,0,1,0,386643,218967,32689,75267,2.028298566082478,0.25580660290788965
16568,0.4759999999999999,1,7,1,386650,218960,32690,75266,2.0282337248508653,0.25581015953722647
16569,0.476,18,130,18,386780,218830,32708,75248,2.027029530549483,0.2558776923129238
16570,0.4760000000000001,0,1,0,386781,218829,32708,75248,2.0270202675163955,0.2558785624173261
16571,0.476047619047619,1,2,1,386783,218827,32709,75247,2.0270017414502206,0.25587777226140357
16572,0.4760714285714286,1,0,1,386783,218827,32710,75246,2.0270017414502206,0.2558752418617146
16573,0.4761190476190476,0,1,0,386784,218826,32710,75246,2.026992478417133,0.25587611197257815
16574,0.4761666666666666,2,0,2,386784,218826,32712,75244,2.026992478417133,0.25587105111027986
16575,0.4761666666666667,0,17,0,386801,218809,32712,75244,2.0268350068546446,0.25588584370844714
16576,0.4761746031746031,0,1,0,386802,218808,32712,75244,2.026825743821557,0.2558867139145457
16577,0.4761904761904761,0,3,0,386805,218805,32712,75244,2.0267979547222943,0.2558893245683542
16578,0.4761904761904762,0,1,0,386806,218804,32712,75244,2.0267886916892066,0.2558901947981282
16579,0.47625,1,10,1,386816,218794,32713,75243,2.026696061358331,0.2558963667837721
16580,0.4762619047619047,0,1,0,386817,218793,32713,75243,2.0266867983252435,0.2558972370730115
16581,0.4762619047619048,0,1,0,386818,218792,32713,75243,2.026677535292156,0.2558981073681705
16582,0.4763095238095238,0,1,0,386819,218791,32713,75243,2.0266682722590685,0.25589897766924913
16583,0.4763333333333333,5,20,5,386839,218771,32718,75238,2.0264830115973176,0.25590373083817164
16584,0.4763333333333334,0,1,0,386840,218770,32718,75238,2.02647374856423,0.25590460123534053
16585,0.4763888888888888,0,1,0,386841,218769,32718,75238,2.0264644855311422,0.25590547163843036
16586,0.4763928571428571,0,1,0,386842,218768,32718,75238,2.0264552224980545,0.2559063420474412
16587,0.4764285714285713,0,3,0,386845,218765,32718,75238,2.026427433398792,0.25590895331000024
16588,0.4764285714285715,1,0,1,386845,218765,32719,75237,2.026427433398792,0.25590642240528977
16589,0.4764859943977591,0,1,0,386846,218764,32719,75237,2.0264181703657047,0.2559072928323373
16590,0.4764999999999999,0,3,0,386849,218761,32719,75237,2.0263903812664417,0.2559099041490078
16591,0.4765,2,27,2,386876,218734,32721,75235,2.026140279373078,0.2559283461861625
16592,0.4765089477515946,0,4,0,386880,218730,32721,75235,2.0261032272407276,0.2559318286190533
16593,0.4765128205128205,0,1,0,386881,218729,32721,75235,2.0260939642076403,0.25593269924208406
16594,0.4765190691661279,0,2,0,386883,218727,32721,75235,2.026075438141465,0.25593444050591574
16595,0.4765277777777777,0,1,0,386884,218726,32721,75235,2.0260661751083773,0.25593531114671675
16596,0.476547619047619,1,1,1,386885,218725,32722,75234,2.02605691207529,0.25593365061113965
16597,0.4765714285714286,0,1,0,386886,218724,32722,75234,2.0260476490422024,0.2559345212581389
16598,0.4766111111111111,0,1,0,386887,218723,32722,75234,2.0260383860091147,0.25593539191106185
16599,0.4766190476190475,1,0,1,386887,218723,32723,75233,2.0260383860091147,0.25593286070024085
16600,0.4766309523809524,0,1,0,386888,218722,32723,75233,2.0260291229760274,0.25593373135343844
16601,0.4766666666666665,0,3,0,386891,218719,32723,75233,2.0260013338767644,0.2559363433485739
16602,0.4766666666666666,69,398,69,387289,218321,32792,75164,2.022314646707918,0.2561084893606147
16603,0.4766666666666667,60,276,60,387565,218045,32852,75104,2.0197580495757532,0.25619736038669755
16604,0.4766904761904761,0,1,0,387566,218044,32852,75104,2.0197487865426655,0.2561982343389687
16605,0.476702380952381,0,2,0,387568,218042,32852,75104,2.0197302604764906,0.2561999822613988
16606,0.4767142857142857,0,1,0,387569,218041,32852,75104,2.019720997443403,0.25620085623155775
16607,0.4767619047619048,0,1,0,387570,218040,32852,75104,2.0197117344103153,0.2562017302076795
16608,0.4767738095238095,0,1,0,387571,218039,32852,75104,2.0197024713772276,0.25620260418976404
16609,0.4767857142857143,0,1,0,387572,218038,32852,75104,2.0196932083441403,0.2562034781778114
16610,0.4768095238095238,0,3,0,387575,218035,32852,75104,2.0196654192448777,0.2562061001777314
16611,0.4768333333333333,3,6,3,387581,218029,32855,75101,2.019609841046352,0.2562037321325009
16612,0.4768333333333334,4,12,4,387593,218017,32859,75097,2.0194986846493017,0.2562040707710993
16613,0.4768452380952381,0,4,0,387597,218013,32859,75097,2.0194616325169514,0.25620756712497017
16614,0.4768571428571428,1,3,1,387600,218010,32860,75096,2.019433843417689,0.25620765183926636
16615,0.4768809523809524,0,1,0,387601,218009,32860,75096,2.019424580384601,0.2562085259548626
16616,0.4769047619047618,0,1,0,387602,218008,32860,75096,2.0194153173515135,0.2562094000764234
16617,0.4769166666666666,0,2,0,387604,218006,32860,75096,2.0193967912853386,0.25621114833743885
16618,0.4769487179487178,0,1,0,387605,218005,32860,75096,2.019387528252251,0.2562120224768936
16619,0.4769523809523809,0,1,0,387606,218004,32860,75096,2.019378265219163,0.2562128966223132
16620,0.4769761904761905,1,1,1,387607,218003,32861,75095,2.019369002186076,0.2562112331029212
16621,0.4769999999999998,1,0,1,387607,218003,32862,75094,2.019369002186076,0.25620869541482855
16622,0.477,5,38,5,387645,217965,32867,75089,2.019017006928749,0.2562292273778894
16623,0.4770000000000001,0,1,0,387646,217964,32867,75089,2.0190077438956613,0.25623010172221405
16624,0.4770714285714285,0,1,0,387647,217963,32867,75089,2.0189984808625736,0.2562309760725059
16625,0.4770833333333333,0,1,0,387648,217962,32867,75089,2.018989217829486,0.25623185042876495
16626,0.477090909090909,0,2,0,387650,217960,32867,75089,2.018970691763311,0.256233599159185
16627,0.477095238095238,0,1,0,387651,217959,32867,75089,2.0189614287302233,0.25623447353334605
16628,0.4770952380952381,0,1,0,387652,217958,32867,75089,2.018952165697136,0.25623534791347463
16629,0.4771190476190476,0,1,0,387653,217957,32867,75089,2.0189429026640484,0.2562362222995707
16630,0.4771428571428571,5,15,5,387668,217942,32872,75084,2.018803957167735,0.2562366479425034
16631,0.4771666666666666,0,8,0,387676,217934,32872,75084,2.0187298529030344,0.25624364373519715
16632,0.4771666666666667,0,6,0,387682,217928,32872,75084,2.018674274704509,0.2562488908304097
16633,0.4772222222222222,2,2,2,387684,217926,32874,75082,2.0186557486383343,0.2562455632610714
16634,0.4772380952380952,0,1,0,387685,217925,32874,75082,2.0186464856052466,0.2562464377984144
16635,0.47725,0,2,0,387687,217923,32874,75082,2.0186279595390713,0.2562481868910087
16636,0.4772619047619047,0,1,0,387688,217922,32874,75082,2.018618696505984,0.25624906144626014
16637,0.4772619047619048,0,1,0,387689,217921,32874,75082,2.0186094334728963,0.25624993600748114
16638,0.4772727272727273,0,1,0,387690,217920,32874,75082,2.0186001704398087,0.25625081057467186
16639,0.4773095238095239,1,0,1,387690,217920,32875,75081,2.0186001704398087,0.2562482721901973
16640,0.4773116883116883,0,1,0,387691,217919,32875,75081,2.0185909074067214,0.2562491467576792
16641,0.4773333333333333,11,50,11,387741,217869,32886,75070,2.0181277557523436,0.25626495618541745
16642,0.4773333333333334,0,2,0,387743,217867,32886,75070,2.0181092296861682,0.25626670581046435
16643,0.4773484848484849,0,1,0,387744,217866,32886,75070,2.018099966653081,0.25626758063194693
16644,0.4773571428571428,0,1,0,387745,217865,32886,75070,2.0180907036199933,0.25626845545940224
16645,0.4773809523809523,0,2,0,387747,217863,32886,75070,2.0180721775538184,0.2562702051322316
16646,0.4773809523809524,0,4,0,387751,217859,32886,75070,2.018035125421468,0.2562737045495666
16647,0.4774166666666667,0,1,0,387752,217858,32886,75070,2.0180258623883804,0.2562745794188333
16648,0.4774285714285715,0,1,0,387753,217857,32886,75070,2.0180165993552928,0.2562754542940733
16649,0.4774999999999999,3,5,3,387758,217852,32889,75067,2.0179702841898552,0.256272211771855
16650,0.4775,55,333,55,388091,217519,32944,75012,2.0148856941716997,0.2564241054794193
16651,0.4775000000000001,0,11,0,388102,217508,32944,75012,2.0147838008077366,0.2564337481197867
16652,0.477547619047619,0,1,0,388103,217507,32944,75012,2.014774537774649,0.25643462475941736
16653,0.4775555555555555,0,1,0,388104,217506,32944,75012,2.014765274741561,0.25643550140504173
16654,0.4775833333333333,0,1,0,388105,217505,32944,75012,2.014756011708474,0.25643637805666
16655,0.4775952380952382,0,1,0,388106,217504,32944,75012,2.0147467486753863,0.25643725471427203
16656,0.4776190476190476,2,9,2,388115,217495,32946,75010,2.0146633813775985,0.2564400608536606
16657,0.4776587301587301,0,1,0,388116,217494,32946,75010,2.014654118344511,0.2564409375598282
16658,0.4776666666666667,5,33,5,388149,217461,32951,75005,2.0143484382526213,0.25645716083237025
16659,0.4776785714285714,0,3,0,388152,217458,32951,75005,2.0143206491533587,0.25645979149499254
16660,0.477702380952381,0,1,0,388153,217457,32951,75005,2.014311386120271,0.25646066839452647
16661,0.4777142857142857,0,2,0,388155,217455,32951,75005,2.014292860054096,0.2564624222115845
16662,0.4777261904761903,0,1,0,388156,217454,32951,75005,2.0142835970210085,0.2564632991291087
16663,0.4777380952380952,0,4,0,388160,217450,32951,75005,2.014246544888658,0.2564668068591749
16664,0.4777499999999999,0,1,0,388161,217449,32951,75005,2.014237281855571,0.2564676838066841
16665,0.4777539682539682,0,1,0,388162,217448,32951,75005,2.0142280188224833,0.25646856076019053
16666,0.4777777777777778,2,4,2,388166,217444,32953,75003,2.014190966690133,0.2564669837611601
16667,0.4778205128205128,0,1,0,388167,217443,32953,75003,2.0141817036570453,0.25646786073326355
16668,0.4778333333333332,0,2,0,388169,217441,32953,75003,2.0141631775908704,0.2564696146954631
16669,0.4778333333333333,3,9,3,388178,217432,32956,75000,2.0140798102930826,0.25646988017727196
16670,0.4778333333333334,1,4,1,388182,217428,32957,74999,2.0140427581607323,0.2564708457153409
16671,0.4778571428571428,0,8,0,388190,217420,32957,74999,2.0139686538960317,0.2564778622456133
16672,0.4778809523809524,0,1,0,388191,217419,32957,74999,2.013959390862944,0.2564787393388916
16673,0.4779047619047619,0,1,0,388192,217418,32957,74999,2.013950127829857,0.2564796164381688
16674,0.4779166666666667,1,0,1,388192,217418,32958,74998,2.013950127829857,0.2564770737579339
16675,0.4779393939393939,0,1,0,388193,217417,32958,74998,2.013940864796769,0.2564779508575141
16676,0.4779633699633701,0,1,0,388194,217416,32958,74998,2.0139316017636815,0.2564788279630934
16677,0.4779999999999999,0,2,0,388196,217414,32958,74998,2.0139130756975065,0.2564805821922493
16678,0.478,12,90,12,388286,217324,32970,74986,2.0130794027196264,0.25652902740241523
16679,0.4780238095238095,0,2,0,388288,217322,32970,74986,2.0130608766534515,0.2565307825991762
16680,0.4780238095238096,0,1,0,388289,217321,32970,74986,2.0130516136203638,0.25653166020656365
16681,0.4780357142857143,0,2,0,388291,217319,32970,74986,2.013033087554189,0.2565334154393527
16682,0.4780555555555555,0,3,0,388294,217316,32970,74986,2.0130052984549263,0.2565360483335728
16683,0.4780714285714286,0,2,0,388296,217314,32970,74986,2.012986772388751,0.2565378036264112
16684,0.4780833333333333,0,2,0,388298,217312,32970,74986,2.012968246322576,0.25653955894327024
16685,0.478095238095238,0,1,0,388299,217311,32970,74986,2.0129589832894883,0.2565404366107076
16686,0.4781111111111111,1,0,1,388299,217311,32971,74985,2.0129589832894883,0.2565378930946712
16687,0.4781190476190475,0,1,0,388300,217310,32971,74985,2.0129497202564006,0.25653877076241466
16688,0.4781428571428571,2,0,2,388300,217310,32973,74983,2.0129497202564006,0.2565336836667317
16689,0.4781666666666666,3,18,3,388318,217292,32976,74980,2.0127829856608246,0.2565418514260689
16690,0.4781666666666667,0,4,0,388322,217288,32976,74980,2.0127459335284748,0.25654536247553617
16691,0.4782142857142857,0,1,0,388323,217287,32976,74980,2.012736670495387,0.25654624025291944
16692,0.4782222222222222,0,1,0,388324,217286,32976,74980,2.0127274074622994,0.25654711803630936
16693,0.4782857142857143,0,1,0,388325,217285,32976,74980,2.0127181444292117,0.25654799582570614
16694,0.4783333333333332,0,1,0,388326,217284,32976,74980,2.0127088813961245,0.2565488736211097
16695,0.4783333333333333,56,402,56,388728,216882,33032,74924,2.0089851420949274,0.2567596279720088
16696,0.4783333333333334,0,4,0,388732,216878,33032,74924,2.0089480899625776,0.25676314761379293
16697,0.4783571428571428,0,2,0,388734,216876,33032,74924,2.008929563896402,0.25676490747087044
16698,0.4783809523809523,0,1,0,388735,216875,33032,74924,2.0089203008633145,0.25676578740845585
16699,0.4784285714285713,0,1,0,388736,216874,33032,74924,2.0089110378302273,0.2567666673520723
16700,0.4784285714285715,0,2,0,388738,216872,33032,74924,2.008892511764052,0.256768427257399
16701,0.478452380952381,0,2,0,388740,216870,33032,74924,2.008873985697877,0.256770187186851
16702,0.4784848484848484,0,1,0,388741,216869,33032,74924,2.0088647226647893,0.25677106716062414
16703,0.4784880952380954,0,2,0,388743,216867,33032,74924,2.0088461965986144,0.25677282712626504
16704,0.4785,3,27,3,388770,216840,33035,74921,2.00859609470525,0.2567889471176751
16705,0.478547619047619,1,0,1,388770,216840,33036,74920,2.00859609470525,0.2567863997806416
16706,0.4785714285714285,2,4,2,388774,216836,33038,74918,2.0085590425729,0.25678482557222865
16707,0.4785714285714286,1,3,1,388777,216833,33039,74917,2.0085312534736373,0.2567849185946872
16708,0.4785833333333333,0,1,0,388778,216832,33039,74917,2.00852199044055,0.2567857987516667
16709,0.4786074481074482,0,2,0,388780,216830,33039,74917,2.0085034643743747,0.25678755908372664
16710,0.4786082251082251,0,1,0,388781,216829,33039,74917,2.008494201341287,0.25678843925880734
16711,0.4786190476190476,0,2,0,388783,216827,33039,74917,2.008475675275112,0.2567901996270703
16712,0.4786666666666666,2,2,2,388785,216825,33041,74915,2.008457149208937,0.25678686501679576
16713,0.4786666666666667,7,23,7,388808,216802,33048,74908,2.008244099447923,0.2567892770216996
16714,0.4786785714285714,1,0,1,388808,216802,33049,74907,2.008244099447923,0.25678672924044166
16715,0.4786904761904761,0,1,0,388809,216801,33049,74907,2.0082348364148355,0.25678760952733554
16716,0.4786904761904762,0,4,0,388813,216797,33049,74907,2.0081977842824856,0.2567911307352659
16717,0.4787142857142856,0,1,0,388814,216796,33049,74907,2.008188521249398,0.25679201105233745
16718,0.4787380952380952,0,1,0,388815,216795,33049,74907,2.0081792582163103,0.2567928913754448
16719,0.4787499999999999,0,2,0,388817,216793,33049,74907,2.0081607321501354,0.25679465203976687
16720,0.47875,1,4,1,388821,216789,33050,74906,2.008123680017785,0.256795625567802
16721,0.4787619047619048,0,1,0,388822,216788,33050,74906,2.0081144169846974,0.2567965059274445
16722,0.4787777777777778,0,1,0,388823,216787,33050,74906,2.0081051539516097,0.25679738629312326
16723,0.4787857142857142,1,1,1,388824,216786,33051,74905,2.0080958909185225,0.256795718757178
16724,0.4787857142857143,0,1,0,388825,216785,33051,74905,2.008086627885435,0.25679659912921254
16725,0.4788095238095238,0,3,0,388828,216782,33051,74905,2.008058838786172,0.25679924028153467
16726,0.4788333333333333,3,15,3,388843,216767,33054,74902,2.0079198932898588,0.2568048027044355
16727,0.4788333333333334,0,4,0,388847,216763,33054,74902,2.0078828411575085,0.25680832461899783
16728,0.4788809523809524,0,1,0,388848,216762,33054,74902,2.0078735781244212,0.2568092051127325
16729,0.4788888888888888,0,3,0,388851,216759,33054,74902,2.007845789025158,0.2568118466301631
16730,0.4789047619047619,0,1,0,388852,216758,33054,74902,2.007836525992071,0.2568127271480491
16731,0.4789166666666666,0,2,0,388854,216756,33054,74902,2.0078179999258956,0.25681448820193514
16732,0.4789285714285713,0,2,0,388856,216754,33054,74902,2.0077994738597207,0.25681624927997365
16733,0.4789285714285715,0,1,0,388857,216753,33054,74902,2.007790210826633,0.2568171298280503
16734,0.4789999999999999,0,2,0,388859,216751,33054,74902,2.007771684760458,0.25681889094231847
16735,0.479,12,83,12,388942,216668,33066,74890,2.007002853014191,0.2568614135094904
16736,0.4790133477633477,0,1,0,388943,216667,33066,74890,2.0069935899811036,0.25686229450844944
16737,0.4790454545454545,0,1,0,388944,216666,33066,74890,2.006984326948016,0.25686317551345195
16738,0.479047619047619,3,4,3,388948,216662,33069,74887,2.0069472748156656,0.25685905285217925
16739,0.4790934343434344,1,0,1,388948,216662,33070,74886,2.0069472748156656,0.2568565039033024
16740,0.4791071428571428,0,2,0,388950,216660,33070,74886,2.0069287487494907,0.2568582659340207
16741,0.4791111111111111,0,1,0,388951,216659,33070,74886,2.006919485716403,0.25685914695844553
16742,0.4791190476190475,0,1,0,388952,216658,33070,74886,2.0069102226833153,0.2568600279889142
16743,0.4791388888888888,1,1,1,388953,216657,33071,74885,2.006900959650228,0.25685836003045875
16744,0.4791666666666666,19,85,19,389038,216572,33090,74866,2.006113601837786,0.25688482627522835
16745,0.4791666666666667,8,51,8,389089,216521,33098,74858,2.0056411871503204,0.25690938605733427
16746,0.4792142857142857,0,1,0,389090,216520,33098,74858,2.005631924117233,0.25691026776215087
16747,0.4792857142857143,1,7,1,389097,216513,33099,74857,2.0055670828856202,0.25691388955623434
16748,0.4793095238095237,0,1,0,389098,216512,33099,74857,2.0055578198525326,0.256914771303742
16749,0.4793181818181818,0,1,0,389099,216511,33099,74857,2.005548556819445,0.25691565305730213
16750,0.4793333333333333,2,17,2,389116,216494,33101,74855,2.0053910852569565,0.25692554290558745
16751,0.4793333333333334,11,36,11,389152,216458,33112,74844,2.0050576160658045,0.2569292349520429
16752,0.4793452380952381,1,1,1,389153,216457,33113,74843,2.0050483530327172,0.2569275660830759
16753,0.4793809523809523,0,1,0,389154,216456,33113,74843,2.0050390899996295,0.25692844808942017
16754,0.4794047619047619,0,1,0,389155,216455,33113,74843,2.005029826966542,0.2569293301018201
16755,0.4794166666666666,0,1,0,389156,216454,33113,74843,2.005020563933454,0.2569302121202759
16756,0.4794166666666667,0,3,0,389159,216451,33113,74843,2.0049927748341916,0.25693285821197825
16757,0.4794285714285713,0,1,0,389160,216450,33113,74843,2.0049835118011043,0.2569337402546577
16758,0.4794444444444444,0,4,0,389164,216446,33113,74843,2.004946459668754,0.2569372684859366
16759,0.4794444444444445,0,1,0,389165,216445,33113,74843,2.0049371966356664,0.256938150558897
16760,0.4794642857142857,0,1,0,389166,216444,33113,74843,2.0049279336025787,0.2569390326379138
16761,0.4795,4,18,4,389184,216426,33117,74839,2.0047611990070027,0.256944706710384
16762,0.4795000000000001,0,1,0,389185,216425,33117,74839,2.0047519359739154,0.2569455888815645
16763,0.4795238095238094,1,5,1,389190,216420,33118,74838,2.0047056208084775,0.2569474486537709
16764,0.479547619047619,0,1,0,389191,216419,33118,74838,2.00469635777539,0.2569483308555674
16765,0.4795714285714285,0,1,0,389192,216418,33118,74838,2.0046870947423026,0.2569492130634219
16766,0.4795833333333333,0,1,0,389193,216417,33118,74838,2.004677831709215,0.2569500952773343
16767,0.4796190476190476,0,1,0,389194,216416,33118,74838,2.004668568676127,0.2569509774973048
16768,0.4796428571428571,1,1,1,389195,216415,33119,74837,2.00465930564304,0.25694930850260256
16769,0.4796666666666666,1,7,1,389202,216408,33120,74836,2.004594464411427,0.2569529329359575
16770,0.4796666666666667,5,9,5,389211,216399,33125,74831,2.004511097113639,0.25694811660886585
16771,0.4797142857142857,0,2,0,389213,216397,33125,74831,2.004492571047464,0.2569498811927425
16772,0.47975,0,1,0,389214,216396,33125,74831,2.0044833080143762,0.25695076349376944
16773,0.4797777777777778,2,0,2,389214,216396,33127,74829,2.0044833080143762,0.2569456605717229
16774,0.4797857142857142,0,1,0,389215,216395,33127,74829,2.0044740449812886,0.2569465428673461
16775,0.4797857142857144,2,1,2,389216,216394,33129,74827,2.0044647819482013,0.25694232215396556
16776,0.4798181818181818,0,1,0,389217,216393,33129,74827,2.0044555189151136,0.2569432044502438
16777,0.4798333333333333,1,26,1,389243,216367,33130,74826,2.004214680054837,0.256963594591903
16778,0.4798333333333334,0,1,0,389244,216366,33130,74826,2.00420541702175,0.25696447704607267
16779,0.479845238095238,0,1,0,389245,216365,33130,74826,2.004196153988662,0.25696535950630345
16780,0.4798571428571428,0,1,0,389246,216364,33130,74826,2.0041868909555745,0.2569662419725952
16781,0.4798809523809523,0,1,0,389247,216363,33130,74826,2.0041776279224868,0.2569671244449481
16782,0.4798809523809524,0,3,0,389250,216360,33130,74826,2.004149838823224,0.2569697718983742
16783,0.479892857142857,0,1,0,389251,216359,33130,74826,2.004140575790137,0.25697065439497224
16784,0.4799047619047619,0,2,0,389253,216357,33130,74826,2.0041220497239616,0.2569724194063527
16785,0.4799166666666666,0,1,0,389254,216356,33130,74826,2.004112786690874,0.2569733019211352
16786,0.4799502164502165,0,1,0,389255,216355,33130,74826,2.0041035236577867,0.2569741844419794
16787,0.4799523809523808,1,2,1,389257,216353,33131,74825,2.0040849975916113,0.2569733977154868
16788,0.4799523809523809,0,1,0,389258,216352,33131,74825,2.004075734558524,0.2569742802487834
16789,0.479965367965368,0,1,0,389259,216351,33131,74825,2.0040664715254364,0.25697516278814186
16790,0.4799880952380951,0,1,0,389260,216350,33131,74825,2.0040572084923487,0.2569760453335623
16791,0.4799999999999999,6,32,6,389292,216318,33137,74819,2.003760791433547,0.2569889776977849
16792,0.48,466,3002,466,392294,213316,33603,74353,1.9759531661047094,0.2584671966739551
16793,0.4800000000000001,7,34,7,392328,213282,33610,74346,1.9756382229797325,0.2584797029496433
16794,0.480047619047619,1,0,1,392328,213282,33611,74345,1.9756382229797325,0.258477124887441
16795,0.4801190476190475,1,0,1,392328,213282,33612,74344,1.9756382229797325,0.2584745468073123
16796,0.4801190476190476,1,4,1,392332,213278,33613,74343,1.9756011708473822,0.2584755633281297
16797,0.4801666666666666,1,14,1,392346,213264,33614,74342,1.9754714883841564,0.25848556706049247
16798,0.4801666666666667,1,3,1,392349,213261,33615,74341,1.9754436992848938,0.25848568507868513
16799,0.4801794871794872,0,1,0,392350,213260,33615,74341,1.9754344362518064,0.25848658384358886
16800,0.4802142857142857,0,1,0,392351,213259,33615,74341,1.9754251732187187,0.2584874826147427
16801,0.4802272727272727,0,1,0,392352,213258,33615,74341,1.9754159101856312,0.2584883813921467
16802,0.4802380952380952,0,3,0,392355,213255,33615,74341,1.9753881210863686,0.25849107776186037
16803,0.4802380952380953,1,0,1,392355,213255,33616,74340,1.9753881210863686,0.25848849945235486
16804,0.48025,0,1,0,392356,213254,33616,74340,1.975378858053281,0.25848939824892037
16805,0.4802698412698412,0,1,0,392357,213253,33616,74340,1.9753695950201935,0.2584902970517363
16806,0.4802857142857142,0,2,0,392359,213251,33616,74340,1.9753510689540184,0.2584920946761199
16807,0.4802857142857143,0,1,0,392360,213250,33616,74340,1.9753418059209307,0.2584929934976877
16808,0.4803333333333333,2,11,2,392371,213239,33618,74338,1.9752399125569677,0.2584977240878095
16809,0.4803333333333334,0,12,0,392383,213227,33618,74338,1.975128756159917,0.25850851111922524
16810,0.4803571428571428,1,2,1,392385,213225,33619,74337,1.975110230093742,0.2585077305068124
16811,0.4803650793650794,0,1,0,392386,213224,33619,74337,1.9751009670606543,0.2585086294733987
16812,0.4803809523809523,1,2,1,392388,213222,33620,74336,1.9750824409944792,0.2585078488513622
16813,0.4803888888888889,0,1,0,392389,213221,33620,74336,1.9750731779613917,0.25850874783086486
16814,0.4804166666666666,0,1,0,392390,213220,33620,74336,1.975063914928304,0.2585096468166201
16815,0.4804166666666667,0,1,0,392391,213219,33620,74336,1.9750546518952166,0.2585105458086279
16816,0.4804285714285714,0,1,0,392392,213218,33620,74336,1.975045388862129,0.2585114448068884
16817,0.4804365079365079,0,2,0,392394,213216,33620,74336,1.975026862795954,0.2585132428221678
16818,0.4804404761904763,1,2,1,392396,213214,33621,74335,1.9750083367297788,0.2585124622238297
16819,0.4804761904761904,0,5,0,392401,213209,33621,74335,1.974962021564341,0.2585169574047798
16820,0.4804761904761905,0,6,0,392407,213203,33621,74335,1.9749064433658157,0.2585223518282801
16821,0.4805,6,17,6,392424,213186,33627,74329,1.9747489718033273,0.25852216406100553
16822,0.4805555555555555,0,3,0,392427,213183,33627,74329,1.9747211827040647,0.2585248615709953
16823,0.4805833333333333,0,4,0,392431,213179,33627,74329,1.9746841305717144,0.2585284583385506
16824,0.4805909090909091,0,1,0,392432,213178,33627,74329,1.9746748675386268,0.25852935754607714
16825,0.4806190476190476,0,3,0,392435,213175,33627,74329,1.9746470784393642,0.25853205520618844
16826,0.4806309523809524,0,1,0,392436,213174,33627,74329,1.9746378154062767,0.2585329544387363
16827,0.4806428571428571,0,1,0,392437,213173,33627,74329,1.974628552373189,0.2585338536775396
16828,0.4806666666666666,7,45,7,392482,213128,33634,74322,1.9742117158842492,0.2585562706557662
16829,0.4806666666666667,2,6,2,392488,213122,33636,74320,1.9741561376857237,0.2585565087913388
16830,0.4806666666666668,1,1,1,392489,213121,33637,74319,1.9741468746526363,0.25855482883384356
16831,0.4807142857142857,2,10,2,392499,213111,33639,74317,1.9740542443217608,0.25855866512657083
16832,0.4807380952380952,0,1,0,392500,213110,33639,74317,1.9740449812886731,0.258559564689469
16833,0.48075,0,2,0,392502,213108,33639,74317,1.974026455222498,0.25856136383404366
16834,0.4807510822510822,0,1,0,392503,213107,33639,74317,1.9740171921894105,0.2585622634157203
16835,0.4807738095238095,1,2,1,392505,213105,33640,74316,1.9739986661232354,0.2585614829814105
16836,0.4808095238095238,0,2,0,392507,213103,33640,74316,1.9739801400570602,0.25856328217689156
16837,0.4808333333333333,22,141,22,392648,212962,33662,74294,1.9726740523917152,0.2586334140975297
16838,0.4808333333333334,1,7,1,392655,212955,33663,74293,1.9726092111601023,0.2586371358547318
16839,0.4808571428571428,0,1,0,392656,212954,33663,74293,1.9725999481270147,0.25863803625451265
16840,0.4809285714285714,0,1,0,392657,212953,33663,74293,1.9725906850939272,0.2586389366605627
16841,0.4809285714285715,0,1,0,392658,212952,33663,74293,1.9725814220608395,0.258639837072882
16842,0.4809523809523808,0,1,0,392659,212951,33663,74293,1.972572159027752,0.25864073749147065
16843,0.4809523809523809,0,6,0,392665,212945,33663,74293,1.9725165808292267,0.25864614013466186
16844,0.4809682539682539,0,3,0,392668,212942,33663,74293,1.972488791729964,0.25864884154089857
16845,0.4809761904761904,0,1,0,392669,212941,33663,74293,1.9724795286968766,0.258649742022184
16846,0.4809999999999999,2,5,2,392674,212936,33665,74291,1.9724332135314386,0.2586490824330582
16847,0.481,7,54,7,392728,212882,33672,74284,1.9719330097447108,0.25867964870493027
16848,0.4810000000000001,0,3,0,392731,212879,33672,74284,1.9719052206454482,0.258682351138552
16849,0.4810238095238094,0,1,0,392732,212878,33672,74284,1.9718959576123607,0.258683251962307
16850,0.4810714285714285,0,1,0,392733,212877,33672,74284,1.971886694579273,0.25868415279233603
16851,0.4810952380952381,0,3,0,392736,212874,33672,74284,1.9718589054800104,0.2586868553200677
16852,0.481111111111111,0,1,0,392737,212873,33672,74284,1.9718496424469227,0.25868775617519335
16853,0.4811111111111111,1,1,1,392738,212872,33673,74283,1.9718403794138353,0.2586860754644704
16854,0.4811190476190476,0,5,0,392743,212867,33673,74283,1.9717940642483975,0.2586905798363225
16855,0.4811428571428571,0,2,0,392745,212865,33673,74283,1.9717755381822224,0.2586923816289857
16856,0.4811666666666666,0,5,0,392750,212860,33673,74283,1.9717292230167847,0.2586968862204546
16857,0.4811666666666667,5,10,5,392760,212850,33678,74278,1.9716365926859092,0.25869298709983
16858,0.4811825396825396,0,2,0,392762,212848,33678,74278,1.971618066619734,0.2586947890473172
16859,0.4811904761904761,0,2,0,392764,212846,33678,74278,1.971599540553559,0.2586965910199078
16860,0.4811904761904762,0,1,0,392765,212845,33678,74278,1.9715902775204712,0.258697492015617
16861,0.4811904761904763,2,2,2,392767,212843,33680,74276,1.971571751454296,0.25869413030833904
16862,0.4812142857142856,2,0,2,392767,212843,33682,74274,1.971571751454296,0.2586889665188756
16863,0.4812142857142857,0,3,0,392770,212840,33682,74274,1.9715439623550335,0.2586916695110653
16864,0.48125,0,3,0,392773,212837,33682,74274,1.9715161732557709,0.2586943725597417
16865,0.4812777777777777,0,1,0,392774,212836,33682,74274,1.9715069102226832,0.25869527358852007
16866,0.4812857142857142,0,2,0,392776,212834,33682,74274,1.9714883841565083,0.2586970756649066
16867,0.481297619047619,0,1,0,392777,212833,33682,74274,1.9714791211234206,0.2586979767125148
16868,0.4813095238095238,0,1,0,392778,212832,33682,74274,1.9714698580903331,0.2586988777663999
16869,0.4813333333333333,1,34,1,392812,212798,33683,74273,1.9711549149653562,0.2587269351484476
16870,0.4813333333333334,1,2,1,392814,212796,33684,74272,1.971136388899181,0.25872615547535777
16871,0.4813809523809523,1,2,1,392816,212794,33685,74271,1.971117862833006,0.2587253757859718
16872,0.4813888888888888,0,2,0,392818,212792,33685,74271,1.971099336766831,0.2587271783545772
16873,0.4814047619047619,0,1,0,392819,212791,33685,74271,1.9710900737337433,0.25872807964829897
16874,0.4814166666666666,0,1,0,392820,212790,33685,74271,1.9710808107006559,0.2587289809483002
16875,0.4814166666666667,0,4,0,392824,212786,33685,74271,1.9710437585683056,0.25873258621110096
16876,0.4814285714285714,1,7,1,392831,212779,33686,74270,1.9709789173366927,0.2587363133123613
16877,0.4814285714285715,0,3,0,392834,212776,33686,74270,1.9709511282374301,0.2587390174397135
16878,0.4814523809523808,0,1,0,392835,212775,33686,74270,1.9709418652043424,0.2587399188280583
16879,0.4814523809523809,0,1,0,392836,212774,33686,74270,1.970932602171255,0.25874082022268363
16880,0.48145670995671,1,0,1,392836,212774,33687,74269,1.970932602171255,0.2587382378249949
16881,0.4814761904761904,0,1,0,392837,212773,33687,74269,1.9709233391381673,0.25873913922004443
16882,0.4814761904761905,0,1,0,392838,212772,33687,74269,1.9709140761050798,0.2587400406213746
16883,0.4814999999999999,0,2,0,392840,212770,33687,74269,1.9708955500389047,0.2587418434428771
16884,0.4815,2,24,2,392864,212746,33689,74267,1.9706732372448035,0.2587583140833342
16885,0.4815238095238095,0,2,0,392866,212744,33689,74267,1.9706547111786283,0.25876011720805125
16886,0.481547619047619,0,3,0,392869,212741,33689,74267,1.9706269220793657,0.25876282194224554
16887,0.4815476190476191,1,0,1,392869,212741,33690,74266,1.9706269220793657,0.25876023929729935
16888,0.4815714285714286,0,1,0,392870,212740,33690,74266,1.970617659046278,0.25876114088207214
16889,0.4816190476190475,0,1,0,392871,212739,33690,74266,1.9706083960131906,0.2587620424731277
16890,0.4816190476190476,0,2,0,392873,212737,33690,74266,1.9705898699470155,0.25876384567408706
16891,0.4816666666666666,56,231,56,393104,212506,33746,74210,1.9684501093037905,0.25882755060756985
16892,0.4816666666666667,23,170,23,393274,212336,33769,74187,1.9668753936789063,0.25892162234794414
16893,0.4816904761904761,0,1,0,393275,212335,33769,74187,1.9668661306458186,0.25892252601894444
16894,0.4817142857142857,0,2,0,393277,212333,33769,74187,1.9668476045796435,0.25892433337986875
16895,0.4817619047619048,0,3,0,393280,212330,33769,74187,1.9668198154803809,0.25892704446856557
16896,0.4817857142857143,0,2,0,393282,212328,33769,74187,1.9668012894142057,0.2589288518925711
16897,0.4818095238095237,0,1,0,393283,212327,33769,74187,1.9667920263811183,0.2589297556140363
16898,0.4818095238095238,0,1,0,393284,212326,33769,74187,1.9667827633480306,0.25893065934181
16899,0.4818159618159618,0,2,0,393286,212324,33769,74187,1.9667642372818557,0.2589324668162828
16900,0.4818333333333332,0,2,0,393288,212322,33769,74187,1.9667457112156805,0.2589342743159901
16901,0.4818333333333333,3,7,3,393295,212315,33772,74184,1.9666808699840677,0.25893284095232444
16902,0.4818333333333334,1,8,1,393303,212307,33773,74183,1.966606765719367,0.2589374847289609
16903,0.4818571428571428,0,1,0,393304,212306,33773,74183,1.9665975026862796,0.25893838855942114
16904,0.4818809523809524,1,0,1,393304,212306,33774,74182,1.9665975026862796,0.258935801848594
16905,0.4819047619047619,1,2,1,393306,212304,33775,74181,1.9665789766201045,0.25893502277606156
16906,0.4819166666666667,0,1,0,393307,212303,33775,74181,1.966569713587017,0.2589359266137027
16907,0.4819444444444445,1,0,1,393307,212303,33776,74180,1.966569713587017,0.2589333398491359
16908,0.4819523809523809,1,0,1,393307,212303,33777,74179,1.966569713587017,0.2589307530665103
16909,0.4819642857142858,1,0,1,393307,212303,33778,74178,1.966569713587017,0.25892816626582565
16910,0.482,14,73,14,393380,212230,33792,74164,1.9658935121716254,0.2589579390629692
16911,0.4820238095238094,0,2,0,393382,212228,33792,74164,1.9658749861054503,0.2589597474789799
16912,0.4820367965367964,1,0,1,393382,212228,33793,74163,1.9658749861054503,0.25895715996661905
16913,0.4820476190476191,0,1,0,393383,212227,33793,74163,1.9658657230723628,0.25895806417821854
16914,0.4820714285714285,0,3,0,393386,212224,33793,74163,1.9658379339731002,0.2589607768509046
16915,0.4820833333333334,0,2,0,393388,212222,33793,74163,1.965819407906925,0.25896258533093564
16916,0.4821190476190476,0,6,0,393394,212216,33793,74163,1.9657638297083997,0.2589680109225886
16917,0.4821428571428571,2,9,2,393403,212207,33795,74161,1.9656804624106117,0.25897097441054867
16918,0.4821428571428572,0,1,0,393404,212206,33795,74161,1.9656711993775242,0.2589718787430116
16919,0.4821666666666666,2,4,2,393408,212202,33797,74159,1.965634147245174,0.2589703206791428
16920,0.4821666666666667,2,7,2,393415,212195,33799,74157,1.965569306013561,0.2589714756663128
16921,0.4821904761904762,0,1,0,393416,212194,33799,74157,1.9655600429804736,0.2589723800510562
16922,0.4822222222222222,1,2,1,393418,212192,33800,74156,1.9655415169142985,0.2589716009890064
16923,0.4822222222222223,2,1,2,393419,212191,33802,74154,1.9655322538812108,0.25896732961986413
16924,0.4822380952380952,0,3,0,393422,212188,33802,74154,1.9655044647819482,0.2589700428159334
16925,0.4822380952380953,0,1,0,393423,212187,33802,74154,1.9654952017488607,0.258970947227257
16926,0.4822619047619047,0,1,0,393424,212186,33802,74154,1.965485938715773,0.25897185164489767
16927,0.4822727272727272,1,0,1,393424,212186,33803,74153,1.965485938715773,0.2589692637049092
16928,0.4822857142857142,0,1,0,393425,212185,33803,74153,1.9654766756826856,0.2589701681229875
16929,0.4822857142857145,0,1,0,393426,212184,33803,74153,1.965467412649598,0.258971072547383
16930,0.4823333333333333,6,35,6,393461,212149,33809,74147,1.9651432064915335,0.25898720205661274
16931,0.4823333333333334,0,2,0,393463,212147,33809,74147,1.9651246804253584,0.25898901129608026
16932,0.4823809523809523,0,2,0,393465,212145,33809,74147,1.9651061543591835,0.258990820560826
16933,0.4823809523809524,0,4,0,393469,212141,33809,74147,1.9650691022268332,0.2589944391661544
16934,0.4824166666666666,0,1,0,393470,212140,33809,74147,1.9650598391937455,0.25899534383328615
16935,0.4824523809523809,0,1,0,393471,212139,33809,74147,1.965050576160658,0.258996248506738
16936,0.4824848484848483,0,1,0,393472,212138,33809,74147,1.9650413131275706,0.25899715318650995
16937,0.4824848484848484,0,1,0,393473,212137,33809,74147,1.965032050094483,0.25899805787260205
16938,0.4824999999999999,2,9,2,393482,212128,33811,74145,1.9649486827966949,0.2590010234985486
16939,0.4825,50,310,50,393792,211818,33861,74095,1.9620771425395531,0.2591522596034458
16940,0.4825000000000001,1,8,1,393800,211810,33862,74094,1.9620030382748528,0.2591569198052493
16941,0.4825457875457875,0,1,0,393801,211809,33862,74094,1.961993775241765,0.25915782625575806
16942,0.4825555555555556,0,4,0,393805,211805,33862,74094,1.961956723109415,0.2591614521212036
16943,0.4825714285714285,1,0,1,393805,211805,33863,74093,1.961956723109415,0.25915886085247186
16944,0.4825714285714286,0,1,0,393806,211804,33863,74093,1.9619474600763274,0.25915976732879326
16945,0.4825833333333333,0,1,0,393807,211803,33863,74093,1.96193819704324,0.2591606738114559
16946,0.4825912698412697,1,2,1,393809,211801,33864,74092,1.9619196709770648,0.2591598954853739
16947,0.4825952380952381,0,1,0,393810,211800,33864,74092,1.961910407943977,0.2591608019811677
16948,0.4825961538461538,0,1,0,393811,211799,33864,74092,1.9619011449108896,0.25916170848330305
16949,0.4826190476190476,0,4,0,393815,211795,33864,74092,1.9618640927785393,0.25916533455526136
16950,0.4826428571428571,1,0,1,393815,211795,33865,74091,1.9618640927785393,0.259162743191342
16951,0.4826666666666666,8,26,8,393841,211769,33873,74083,1.961623253918263,0.25916558218938474
16952,0.4826666666666667,2,8,2,393849,211761,33875,74081,1.9615491496535626,0.2591676520595294
16953,0.4826785714285714,0,1,0,393850,211760,33875,74081,1.961539886620475,0.259168558744197
16954,0.4826904761904761,0,2,0,393852,211758,33875,74081,1.9615213605542998,0.2591703721325641
16955,0.4827142857142858,0,1,0,393853,211757,33875,74081,1.9615120975212124,0.2591712788362639
16956,0.4827272727272727,1,0,1,393853,211757,33876,74080,1.9615120975212124,0.2591686870489125
16957,0.4827380952380952,1,1,1,393854,211756,33877,74079,1.961502834488125,0.25916700194167963
16958,0.48275,0,2,0,393856,211754,33877,74079,1.9614843084219498,0.2591688153572191
16959,0.4827777777777778,0,3,0,393859,211751,33877,74079,1.961456519322687,0.2591715355281111
16960,0.4827835497835499,0,2,0,393861,211749,33877,74079,1.9614379932565118,0.25917334900709516
16961,0.4828095238095238,0,2,0,393863,211747,33877,74079,1.9614194671903369,0.259175162511458
16962,0.4828333333333333,0,8,0,393871,211739,33877,74079,1.9613453629256363,0.25918241678270787
16963,0.4828333333333334,0,2,0,393873,211737,33877,74079,1.9613268368594612,0.25918423041397265
16964,0.4828571428571429,0,9,0,393882,211728,33877,74079,1.9612434695616732,0.2591923920687737
16965,0.4829166666666666,0,1,0,393883,211727,33877,74079,1.9612342065285857,0.2591932989510367
16966,0.4829166666666667,0,2,0,393885,211725,33877,74079,1.9612156804624106,0.25919511273460133
16967,0.4829761904761904,0,1,0,393886,211724,33877,74079,1.9612064174293231,0.25919601963590305
16968,0.4829761904761905,1,0,1,393886,211724,33878,74078,1.9612064174293231,0.25919342761772135
16969,0.482996753246753,0,4,0,393890,211720,33878,74078,1.9611693652969728,0.259197055262808
16970,0.4829999999999999,0,1,0,393891,211719,33878,74078,1.9611601022638854,0.259197962189946
16971,0.483,11,47,11,393938,211672,33889,74067,1.9607247397087701,0.25921207815523956
16972,0.4830000000000001,0,1,0,393939,211671,33889,74067,1.9607154766756827,0.25921298532221826
16973,0.4830357142857142,0,2,0,393941,211669,33889,74067,1.9606969506095075,0.2592147996752247
16974,0.4830357142857143,1,1,1,393942,211668,33890,74066,1.96068768757642,0.2592131142951136
16975,0.4830476190476191,1,1,1,393943,211667,33891,74065,1.9606784245433324,0.25921142889140875
16976,0.4830833333333333,0,1,0,393944,211666,33891,74065,1.960669161510245,0.25921233607833943
16977,0.4830941558441559,0,1,0,393945,211665,33891,74065,1.9606598984771573,0.25921324327162004
16978,0.483095238095238,0,1,0,393946,211664,33891,74065,1.9606506354440698,0.25921415047125074
16979,0.4830952380952381,0,1,0,393947,211663,33891,74065,1.9606413724109824,0.2592150576772315
16980,0.4830952380952382,1,5,1,393952,211658,33892,74064,1.9605950572455444,0.2592170011409692
16981,0.4831190476190476,0,1,0,393953,211657,33892,74064,1.960585794212457,0.2592179083791531
16982,0.4831349206349206,0,2,0,393955,211655,33892,74064,1.9605672681462818,0.25921972287457257
16983,0.4831666666666666,1,11,1,393966,211644,33893,74063,1.9604653747823186,0.2592271102913124
16984,0.4831666666666667,1,9,1,393975,211635,33894,74062,1.9603820074845308,0.2592326835773564
16985,0.4831904761904761,0,1,0,393976,211634,33894,74062,1.9603727444514432,0.2592335909498208
16986,0.4832142857142857,0,4,0,393980,211630,33894,74062,1.9603356923190929,0.25923722050319925
16987,0.4832261904761904,1,2,1,393982,211628,33895,74061,1.960317166252918,0.25923644242515465
16988,0.48325,0,2,0,393984,211626,33895,74061,1.9602986401867428,0.2592382572535677
16989,0.4832738095238095,1,3,1,393987,211623,33896,74060,1.96027085108748,0.25923838660333304
16990,0.4832857142857143,0,1,0,393988,211622,33896,74060,1.9602615880543925,0.25923929404022655
16991,0.4833095238095238,0,1,0,393989,211621,33896,74060,1.960252325021305,0.2592402014834728
16992,0.4833095238095239,0,1,0,393990,211620,33896,74060,1.9602430619882174,0.25924110893307195
16993,0.4833253968253967,0,1,0,393991,211619,33896,74060,1.96023379895513,0.25924201638902405
16994,0.4833333333333333,78,650,78,394641,210969,33974,73982,1.9542128274482196,0.25963060315633213
16995,0.4833333333333334,0,2,0,394643,210967,33974,73982,1.9541943013820446,0.25963242545157206
16996,0.4833571428571428,1,0,1,394643,210967,33975,73981,1.9541943013820446,0.2596298271965411
16997,0.4834166666666665,0,1,0,394644,210966,33975,73981,1.954185038348957,0.2596307383478331
16998,0.4834166666666666,1,0,1,394644,210966,33976,73980,1.954185038348957,0.2596281400686446
16999,0.4834523809523809,0,2,0,394646,210964,33976,73980,1.9541665122827818,0.2596299623785726
17000,0.4834999999999999,0,3,0,394649,210961,33976,73980,1.9541387231835192,0.2596326958914302
17001,0.4835,4,34,4,394683,210927,33980,73976,1.9538237800585423,0.25965328550418915
17002,0.4835000000000001,1,0,1,394683,210927,33981,73975,1.9538237800585423,0.25965068690286486
17003,0.4835238095238095,0,1,0,394684,210926,33981,73975,1.9538145170254548,0.2596515982744883
17004,0.4835303030303031,0,1,0,394685,210925,33981,73975,1.9538052539923672,0.25965250965250963
17005,0.483547619047619,1,1,1,394686,210924,33982,73974,1.9537959909592797,0.25965082239959564
17006,0.4835714285714285,2,0,2,394686,210924,33984,73972,1.9537959909592797,0.25964562507020106
17007,0.4835714285714286,0,2,0,394688,210922,33984,73972,1.9537774648931046,0.259647447822699
17008,0.4836060606060606,0,1,0,394689,210921,33984,73972,1.953768201860017,0.25964835920854495
17009,0.4836190476190476,1,4,1,394693,210917,33985,73971,1.9537311497276668,0.2596494060823903
17010,0.4836666666666666,0,6,0,394699,210911,33985,73971,1.9536755715291414,0.25965487464985504
17011,0.4836666666666667,2,21,2,394720,210890,33987,73969,1.9534810478343028,0.25966881860850455
17012,0.4836666666666668,0,1,0,394721,210889,33987,73969,1.9534717848012153,0.25966973018135353
17013,0.4836785714285714,0,1,0,394722,210888,33987,73969,1.9534625217681278,0.25967064176060267
17014,0.4837142857142856,0,1,0,394723,210887,33987,73969,1.9534532587350402,0.25967155334625214
17015,0.4837380952380952,0,1,0,394724,210886,33987,73969,1.9534439957019527,0.25967246493830193
17016,0.4837499999999999,0,1,0,394725,210885,33987,73969,1.953434732668865,0.25967337653675215
17017,0.48375,0,6,0,394731,210879,33987,73969,1.9533791544703398,0.259678846261866
17018,0.4837619047619046,0,2,0,394733,210877,33987,73969,1.9533606284041647,0.259680669554777
17019,0.4837619047619049,0,2,0,394735,210875,33987,73969,1.9533421023379895,0.25968249287329204
17020,0.4837738095238094,1,0,1,394735,210875,33988,73968,1.9533421023379895,0.2596798938362537
17021,0.4838095238095238,0,5,0,394740,210870,33988,73968,1.9532957871725518,0.25968445221494324
17022,0.4838333333333333,0,7,0,394747,210863,33988,73968,1.953230945940939,0.2596908342139725
17023,0.4838333333333334,0,5,0,394752,210858,33988,73968,1.9531846307755012,0.25969539297676475
17024,0.4838888888888888,0,1,0,394753,210857,33988,73968,1.9531753677424135,0.2596963047485298
17025,0.4839047619047618,0,1,0,394754,210856,33988,73968,1.953166104709326,0.2596972165266972
17026,0.4839047619047619,1,0,1,394754,210856,33989,73967,1.953166104709326,0.2596946173588509
17027,0.4839166666666666,0,1,0,394755,210855,33989,73967,1.9531568416762384,0.2596955291374964
17028,0.4839285714285715,0,4,0,394759,210851,33989,73967,1.9531197895438883,0.2596991763161036
17029,0.4839761904761905,0,1,0,394760,210850,33989,73967,1.9531105265108006,0.2597000881267621
17030,0.484,16,123,16,394883,210727,34005,73951,1.9519711734410314,0.2597706882864148
17031,0.4840000000000001,0,2,0,394885,210725,34005,73951,1.9519526473748565,0.2597725133133808
17032,0.4840238095238096,0,1,0,394886,210724,34005,73951,1.9519433843417688,0.2597734258364802
17033,0.484047619047619,0,3,0,394889,210721,34005,73951,1.9519155952425062,0.2597761634442446
17034,0.4840476190476191,1,0,1,394889,210721,34006,73950,1.9519155952425062,0.2597735631659003
17035,0.4840833333333333,0,1,0,394890,210720,34006,73950,1.9519063322094186,0.25977447570871537
17036,0.4841082251082251,0,1,0,394891,210719,34006,73950,1.951897069176331,0.25977538825794166
17037,0.4841111111111111,0,1,0,394892,210718,34006,73950,1.9518878061432436,0.25977630081357933
17038,0.4841190476190476,0,1,0,394893,210717,34006,73950,1.951878543110156,0.25977721337562837
17039,0.4841666666666666,15,87,15,394980,210630,34021,73935,1.9510726592315388,0.2598176163618154
17040,0.4841666666666667,7,62,7,395042,210568,34028,73928,1.9504983511801104,0.25985602609527025
17041,0.4841904761904761,0,1,0,395043,210567,34028,73928,1.950489088147023,0.25985693948927047
17042,0.484202380952381,0,1,0,395044,210566,34028,73928,1.9504798251139353,0.2598578528896919
17043,0.4842142857142856,0,1,0,395045,210565,34028,73928,1.9504705620808478,0.25985876629653454
17044,0.4842142857142857,0,2,0,395047,210563,34028,73928,1.9504520360146727,0.2598605931294839
17045,0.4842619047619047,1,1,1,395048,210562,34029,73927,1.9504427729815852,0.2598589049137225
17046,0.4842857142857143,4,8,4,395056,210554,34033,73923,1.9503686687168846,0.2598558055660036
17047,0.4842857142857144,0,1,0,395057,210553,34033,73923,1.9503594056837972,0.2598567190202337
17048,0.4843055555555555,0,1,0,395058,210552,34033,73923,1.9503501426507095,0.25985763248088584
17049,0.4843333333333332,1,2,1,395060,210550,34034,73922,1.9503316165845344,0.25985685761691835
17050,0.4843333333333333,2,10,2,395070,210540,34036,73920,1.9502389862536589,0.25986078886310904
17051,0.4843333333333334,1,26,1,395096,210514,34037,73919,1.9499981473933825,0.25988194056245234
17052,0.4844117647058823,0,1,0,395097,210513,34037,73919,1.9499888843602948,0.25988285424987345
17053,0.4844166666666667,1,4,1,395101,210509,34038,73918,1.9499518322279448,0.25988390694273045
17054,0.4844523809523809,0,1,0,395102,210508,34038,73918,1.949942569194857,0.25988482065633944
17055,0.4844761904761905,0,1,0,395103,210507,34038,73918,1.9499333061617696,0.2598857343763734
17056,0.4844999999999999,0,3,0,395106,210504,34038,73918,1.949905517062507,0.25988847557502587
17057,0.4845,0,18,0,395124,210486,34038,73918,1.949738782466931,0.2599049239813786
17058,0.4845238095238094,0,2,0,395126,210484,34038,73918,1.9497202564007559,0.25990675171060684
17059,0.4845238095238096,0,3,0,395129,210481,34038,73918,1.9496924673014933,0.2599094933526489
17060,0.4845833333333333,1,2,1,395131,210479,34039,73917,1.9496739412353181,0.2599087188286755
17061,0.4845873015873016,0,2,0,395133,210477,34039,73917,1.949655415169143,0.259910546636005
17062,0.4846190476190475,0,1,0,395134,210476,34039,73917,1.9496461521360555,0.2599114605493103
17063,0.484642094017094,0,1,0,395135,210475,34039,73917,1.9496368891029678,0.25991237446904275
17064,0.4846428571428571,0,4,0,395139,210471,34039,73917,1.9495998369706176,0.25991603021224524
17065,0.4846666666666666,5,16,5,395155,210455,34044,73912,1.9494516284412169,0.25991764163914943
17066,0.4846666666666667,4,18,4,395173,210437,34048,73908,1.9492848938456409,0.25992368425680074
17067,0.4847005494505496,3,4,3,395177,210433,34051,73905,1.9492478417132906,0.25991953238751064
17068,0.4847142857142856,1,2,1,395179,210431,34052,73904,1.9492293156471154,0.25991875780329543
17069,0.48475,0,1,0,395180,210430,34052,73904,1.949220052614028,0.25991967193511856
17070,0.4847619047619047,1,6,1,395186,210424,34053,73903,1.9491644744155026,0.2599225539607565
17071,0.4847777777777778,0,1,0,395187,210423,34053,73903,1.949155211382415,0.2599234681316517
17072,0.4847857142857142,0,1,0,395188,210422,34053,73903,1.9491459483493274,0.2599243823089774
17073,0.4848333333333333,7,17,7,395205,210405,34060,73896,1.948988476786839,0.2599217027024175
17074,0.4848333333333335,0,1,0,395206,210404,34060,73896,1.9489792137537516,0.25992261695392194
17075,0.4848571428571428,0,2,0,395208,210402,34060,73896,1.9489606876875765,0.2599244454762257
17076,0.4848809523809524,0,2,0,395210,210400,34060,73896,1.9489421616214013,0.2599262740242564
17077,0.4849047619047619,0,1,0,395211,210399,34060,73896,1.9489328985883139,0.2599271883079196
17078,0.4849523809523809,0,3,0,395214,210396,34060,73896,1.948905109489051,0.2599299311975012
17079,0.4849761904761904,0,2,0,395216,210394,34060,73896,1.948886583422876,0.2599317598227162
17080,0.4849999999999999,4,33,4,395249,210361,34064,73892,1.9485809033309867,0.25995152205957367
17081,0.485,190,1161,190,396410,209200,34254,73702,1.9378265219163362,0.2605213112667991
17082,0.4850000000000001,6,20,6,396430,209180,34260,73696,1.9376412612545852,0.26052404587168937
17083,0.4850238095238095,0,1,0,396431,209179,34260,73696,1.9376319982214976,0.2605249668581529
17084,0.4850357142857143,0,1,0,396432,209178,34260,73696,1.93762273518841,0.26052588785112807
17085,0.4850555555555555,1,0,1,396432,209178,34261,73695,1.93762273518841,0.2605232736952625
17086,0.4850833333333332,0,1,0,396433,209177,34261,73695,1.9376134721553226,0.2605241946887638
17087,0.4850886613386614,0,1,0,396434,209176,34261,73695,1.937604209122235,0.26052511568877684
17088,0.4851190476190475,0,1,0,396435,209175,34261,73695,1.9375949460891475,0.2605260366953017
17089,0.4851190476190476,0,2,0,396437,209173,34261,73695,1.9375764200229724,0.2605278787278872
17090,0.4851428571428571,0,4,0,396441,209169,34261,73695,1.937539367890622,0.2605315628712031
17091,0.4851428571428572,0,1,0,396442,209168,34261,73695,1.9375301048575346,0.2605324839233127
17092,0.4851666666666666,4,9,4,396451,209159,34265,73691,1.9374467375597466,0.26053031642213187
17093,0.4851666666666667,1,3,1,396454,209156,34266,73690,1.9374189484604838,0.260530465341564
17094,0.4852380952380952,0,1,0,396455,209155,34266,73690,1.9374096854273963,0.2605313864484081
17095,0.4852499999999999,0,1,0,396456,209154,34266,73690,1.9374004223943089,0.2605323075617655
17096,0.4852857142857143,1,2,1,396458,209152,34267,73689,1.9373818963281337,0.26053153538560536
17097,0.4853333333333332,0,2,0,396460,209150,34267,73689,1.9373633702619586,0.2605333776459399
17098,0.4853333333333333,3,21,3,396481,209129,34270,73686,1.93716884656712,0.26054487916128916
17099,0.4853333333333334,1,9,1,396490,209120,34271,73685,1.937085479269332,0.2605505560368452
17100,0.4853571428571428,0,1,0,396491,209119,34271,73685,1.9370762162362445,0.2605514773482695
17101,0.4854166666666666,0,1,0,396492,209118,34271,73685,1.9370669532031568,0.26055239866620933
17102,0.4854166666666667,0,3,0,396495,209115,34271,73685,1.9370391641038942,0.26055516265912304
17103,0.4854642857142855,0,2,0,396497,209113,34271,73685,1.937020638037719,0.2605570053536447
17104,0.4854761904761904,1,3,1,396500,209110,34272,73684,1.9369928489384565,0.2605571546779635
17105,0.4854761904761905,0,1,0,396501,209109,34272,73684,1.9369835859053688,0.26055807604855846
17106,0.4854999999999999,0,2,0,396503,209107,34272,73684,1.9369650598391936,0.26055991880929735
17107,0.4855,0,14,0,396517,209093,34272,73684,1.936835377375968,0.2605728188643348
17108,0.485515873015873,1,0,1,396517,209093,34273,73683,1.936835377375968,0.26057020397770675
17109,0.485547619047619,0,1,0,396518,209092,34273,73683,1.9368261143428804,0.26057112545309874
17110,0.4855555555555556,0,2,0,396520,209090,34273,73683,1.9368075882767053,0.260572968423435
17111,0.4855714285714286,0,1,0,396521,209089,34273,73683,1.9367983252436178,0.2605738899183795
17112,0.4855833333333333,0,1,0,396522,209088,34273,73683,1.9367890622105302,0.2605748114198415
17113,0.4855873015873015,1,1,1,396523,209087,34274,73682,1.9367797991774427,0.2605731179867666
17114,0.4856111111111111,1,2,1,396525,209085,34275,73681,1.9367612731112676,0.2605723460387741
17115,0.4856190476190476,0,1,0,396526,209084,34275,73681,1.93675201007818,0.2605732675543296
17116,0.4856388888888889,0,6,0,396532,209078,34275,73681,1.9366964318796547,0.2605787967845409
17117,0.4856666666666666,7,26,7,396558,209052,34282,73674,1.9364555930193783,0.2605844527917489
17118,0.4856666666666667,3,11,3,396569,209041,34285,73671,1.9363536996554152,0.2605867455219446
17119,0.4857142857142857,1,9,1,396578,209032,34286,73670,1.9362703323576271,0.26059242594675663
17120,0.4857261904761905,0,1,0,396579,209031,34286,73670,1.9362610693245397,0.2605933477419606
17121,0.4857439080527315,1,1,1,396580,209030,34287,73669,1.936251806291452,0.26059165402070755
17122,0.4857976190476191,0,2,0,396582,209028,34287,73669,1.9362332802252769,0.26059349763174
17123,0.4858333333333332,0,1,0,396583,209027,34287,73669,1.9362240171921894,0.26059441944703854
17124,0.4858333333333333,22,121,22,396704,208906,34309,73647,1.9351031901885953,0.26064844471656645
17125,0.4858333333333334,0,3,0,396707,208903,34309,73647,1.9350754010893327,0.26065121217483633
17126,0.4858571428571428,0,1,0,396708,208902,34309,73647,1.935066138056245,0.26065213467398574
17127,0.4858809523809523,0,1,0,396709,208901,34309,73647,1.9350568750231576,0.260653057179665
17128,0.4859285714285713,0,1,0,396710,208900,34309,73647,1.9350476119900701,0.26065397969187426
17129,0.4859444444444444,1,0,1,396710,208900,34310,73646,1.9350476119900701,0.2606513629639068
17130,0.4859523809523809,0,1,0,396711,208899,34310,73646,1.9350383489569825,0.26065228547664976
17131,0.4859981684981685,0,1,0,396712,208898,34310,73646,1.935029085923895,0.2606532079959228
17132,0.4859999999999999,3,9,3,396721,208889,34313,73643,1.934945718626107,0.2606536604703184
17133,0.486,20,103,20,396824,208786,34333,73623,1.933991626218089,0.26069636590901846
17134,0.4860000000000001,0,2,0,396826,208784,34333,73623,1.9339731001519138,0.2606982121547979
17135,0.4860036630036629,0,2,0,396828,208782,34333,73623,1.9339545740857387,0.26070005842672755
17136,0.4860317460317459,0,3,0,396831,208779,34333,73623,1.933926784986476,0.26070282788365523
17137,0.4860357142857143,0,1,0,396832,208778,34333,73623,1.9339175219533884,0.2607037510490402
17138,0.4860714285714286,0,2,0,396834,208776,34333,73623,1.9338989958872133,0.2607055973994242
17139,0.4860833333333333,0,5,0,396839,208771,34333,73623,1.9338526807217755,0.2607102133898029
17140,0.4861230158730157,1,5,1,396844,208766,34334,73622,1.9338063655563378,0.26071221156706376
17141,0.4861428571428571,0,1,0,396845,208765,34334,73622,1.9337971025232503,0.2607131348114467
17142,0.4861547619047619,0,1,0,396846,208764,34334,73622,1.9337878394901626,0.2607140580623685
17143,0.4861666666666666,0,2,0,396848,208762,34334,73622,1.9337693134239875,0.2607159045838291
17144,0.4861666666666667,0,20,0,396868,208742,34334,73622,1.9335840527622365,0.26073437123712656
17145,0.4861904761904761,0,1,0,396869,208741,34334,73622,1.9335747897291489,0.26073529463846185
17146,0.4861904761904762,0,5,0,396874,208736,34334,73622,1.9335284745637111,0.26073991174324795
17147,0.4861948051948052,0,2,0,396876,208734,34334,73622,1.933509948497536,0.2607417586309482
17148,0.4862142857142856,0,2,0,396878,208732,34334,73622,1.9334914224313609,0.2607436055448125
17149,0.4862380952380952,0,1,0,396879,208731,34334,73622,1.9334821593982734,0.2607445290115565
17150,0.48625,1,9,1,396888,208722,34335,73621,1.9333987921004854,0.2607502222474083
17151,0.4862857142857143,0,1,0,396889,208721,34335,73621,1.933389529067398,0.2607511457735654
17152,0.4863095238095238,1,1,1,396890,208720,34336,73620,1.9333802660343102,0.26074945101650493
17153,0.4863333333333333,6,20,6,396910,208700,34342,73614,1.9331950053725593,0.2607522120759155
17154,0.4863333333333334,0,4,0,396914,208696,34342,73614,1.933157953240209,0.2607559066274663
17155,0.4863888888888888,0,1,0,396915,208695,34342,73614,1.9331486902071213,0.2607568302817126
17156,0.4864047619047619,0,1,0,396916,208694,34342,73614,1.9331394271740339,0.2607577539425025
17157,0.4864166666666666,0,1,0,396917,208693,34342,73614,1.9331301641409464,0.2607586776098361
17158,0.4864166666666667,0,3,0,396920,208690,34342,73614,1.9331023750416836,0.2607614486510995
17159,0.4864206349206349,0,3,0,396923,208687,34342,73614,1.933074585942421,0.2607642197512584
17160,0.4864285714285714,1,5,1,396928,208682,34343,73613,1.9330282707769832,0.26076621973467473
17161,0.4864523809523809,1,1,1,396929,208681,34344,73612,1.9330190077438956,0.2607645248022445
17162,0.4864973359973358,1,4,1,396933,208677,34345,73611,1.9329819556115455,0.2607656010882503
17163,0.4864999999999999,1,1,1,396934,208676,34346,73610,1.9329726925784578,0.26076390610940675
17164,0.4865,6,12,6,396946,208664,34352,73604,1.9328615361814072,0.2607592784162569
17165,0.486547619047619,0,2,0,396948,208662,34352,73604,1.932843010115232,0.26076112603005674
17166,0.4865555555555556,0,1,0,396949,208661,34352,73604,1.9328337470821446,0.2607620498467752
17167,0.4865833333333333,0,4,0,396953,208657,34352,73604,1.9327966949497943,0.2607657451791073
17168,0.4865952380952382,1,0,1,396953,208657,34353,73603,1.9327966949497943,0.2607631261957061
17169,0.4866071428571428,1,0,1,396953,208657,34354,73602,1.9327966949497943,0.2607605071937476
17170,0.4866190476190477,0,1,0,396954,208656,34354,73602,1.9327874319167069,0.2607614310311842
17171,0.4866666666666666,67,404,67,397358,208252,34421,73535,1.9290451665493349,0.260959519069368
17172,0.4866666666666667,43,269,43,397627,207983,34464,73492,1.926553410648783,0.2610960120792255
17173,0.4866666666666668,0,1,0,397628,207982,34464,73492,1.9265441476156953,0.26109693968181785
17174,0.4866904761904762,0,2,0,397630,207980,34464,73492,1.9265256215495201,0.2610987949067758
17175,0.4867619047619048,0,1,0,397631,207979,34464,73492,1.9265163585164327,0.26109972252914154
17176,0.4867738095238094,0,1,0,397632,207978,34464,73492,1.926507095483345,0.2611006501580986
17177,0.4867857142857143,0,3,0,397635,207975,34464,73492,1.9264793063840824,0.2611034330845179
17178,0.4868095238095237,0,1,0,397636,207974,34464,73492,1.926470043350995,0.26110436073984067
17179,0.4868333333333332,1,3,1,397639,207971,34465,73491,1.926442254251732,0.2611045185495733
17180,0.4868333333333333,3,3,3,397642,207968,34468,73488,1.9264144651524695,0.2610994258427605
17181,0.4868333333333334,1,16,1,397658,207952,34469,73487,1.9262662566230686,0.2611116440862851
17182,0.4868571428571428,0,2,0,397660,207950,34469,73487,1.9262477305568935,0.2611134996464573
17183,0.4868809523809523,0,1,0,397661,207949,34469,73487,1.926238467523806,0.26111442743643315
17184,0.4869047619047619,0,4,0,397665,207945,34469,73487,1.9262014153914557,0.2611181386622701
17185,0.4869206071706072,1,0,1,397665,207945,34470,73486,1.9262014153914557,0.26111551321638343
17186,0.486958041958042,1,5,1,397670,207940,34471,73485,1.926155100226018,0.26111752687216844
17187,0.4869832112332112,0,1,0,397671,207939,34471,73485,1.9261458371929305,0.2611184547160157
17188,0.4869999999999999,1,7,1,397678,207932,34472,73484,1.9260809959613177,0.26112232424595616
17189,0.487,9,36,9,397714,207896,34481,73475,1.9257475267701656,0.2611320996122557
17190,0.4870000000000001,1,0,1,397714,207896,34482,73474,1.9257475267701656,0.2611294736467996
17191,0.4870079365079364,0,1,0,397715,207895,34482,73474,1.9257382637370781,0.2611304017144746
17192,0.4870238095238094,0,5,0,397720,207890,34482,73474,1.9256919485716404,0.26113504215180333
17193,0.4870238095238096,0,1,0,397721,207889,34482,73474,1.9256826855385527,0.2611359702590604
17194,0.4870497835497835,0,1,0,397722,207888,34482,73474,1.9256734225054652,0.2611368983729146
17195,0.4870833333333333,0,5,0,397727,207883,34482,73474,1.9256271073400275,0.261141539041147
17196,0.4871111111111111,0,1,0,397728,207882,34482,73474,1.9256178443069398,0.2611424671945862
17197,0.4871428571428571,2,16,2,397744,207866,34484,73472,1.925469635777539,0.26115206619795406
17198,0.4871428571428572,0,1,0,397745,207865,34484,73472,1.9254603727444515,0.2611529944514941
17199,0.4871587301587302,0,3,0,397748,207862,34484,73472,1.9254325836451889,0.2611557792517079
17200,0.4871666666666666,1,7,1,397755,207855,34485,73471,1.925367742413576,0.26115965108095235
17201,0.4871666666666667,0,11,0,397766,207844,34485,73471,1.9252658490496128,0.26116986296500366
17202,0.4871904761904762,0,4,0,397770,207840,34485,73471,1.9252287969172626,0.26117357657539164
17203,0.4872045454545454,0,1,0,397771,207839,34485,73471,1.925219533884175,0.2611745049944901
17204,0.4872142857142857,0,1,0,397772,207838,34485,73471,1.9252102708510874,0.2611754334201892
17205,0.4872222222222223,0,1,0,397773,207837,34485,73471,1.925201007818,0.2611763618524891
17206,0.4872261904761905,1,0,1,397773,207837,34486,73470,1.925201007818,0.26117373545628086
17207,0.48725,0,1,0,397774,207836,34486,73470,1.9251917447849123,0.2611746638891456
17208,0.4872777777777777,0,3,0,397777,207833,34486,73470,1.9251639556856497,0.2611774492273456
17209,0.4872936507936507,0,1,0,397778,207832,34486,73470,1.9251546926525622,0.2611783776866144
17210,0.4873333333333333,5,37,5,397815,207795,34491,73465,1.9248119604283227,0.2611996017919363
17211,0.4873571428571429,0,3,0,397818,207792,34491,73465,1.9247841713290599,0.26120238785168015
17212,0.4873809523809523,0,4,0,397822,207788,34491,73465,1.9247471191967098,0.2612061026904602
17213,0.4873809523809524,1,2,1,397824,207786,34492,73464,1.9247285931305347,0.26120533333333334
17214,0.4873898046398045,0,1,0,397825,207785,34492,73464,1.924719330097447,0.26120626206670955
17215,0.4874080459770114,0,1,0,397826,207784,34492,73464,1.9247100670643595,0.2612071908066902
17216,0.4874444444444444,0,2,0,397828,207782,34492,73464,1.9246915409981844,0.2612090483064648
17217,0.4874682539682539,1,0,1,397828,207782,34493,73463,1.9246915409981844,0.2612064214474924
17218,0.4874761904761904,1,2,1,397830,207780,34494,73462,1.9246730149320093,0.2612056520718812
17219,0.4874999999999999,1,11,1,397841,207769,34495,73461,1.9245711215680463,0.2612132418305302
17220,0.4875,54,351,54,398192,207418,34549,73407,1.9213197969543148,0.2613976675865753
17221,0.4875238095238094,0,2,0,398194,207416,34549,73407,1.9213012708881396,0.26139952924083854
17222,0.4875238095238096,0,1,0,398195,207415,34549,73407,1.9212920078550522,0.2614004600779141
17223,0.4875396825396825,0,1,0,398196,207414,34549,73407,1.9212827448219645,0.2614013909216191
17224,0.4875396825396826,0,2,0,398198,207412,34549,73407,1.9212642187557893,0.26140325262891756
17225,0.4875833333333334,0,5,0,398203,207407,34549,73407,1.9212179035903516,0.2614079070131831
17226,0.4876190476190475,1,0,1,398203,207407,34550,73406,1.9212179035903516,0.26140527682122977
17227,0.4876190476190476,0,4,0,398207,207403,34550,73406,1.9211808514580013,0.2614090004237756
17228,0.4876190476190477,0,3,0,398210,207400,34550,73406,1.9211530623587387,0.2614117931953021
17229,0.4876495726495726,0,1,0,398211,207399,34550,73406,1.9211437993256513,0.26141272413240507
17230,0.4876666666666666,10,28,10,398239,207371,34560,73396,1.9208844343991998,0.2614124879348356
17231,0.4876666666666667,3,9,3,398248,207362,34563,73393,1.9208010671014117,0.26141297572616695
17232,0.4876785714285715,2,4,2,398252,207358,34565,73391,1.9207640149690615,0.26141143868722594
17233,0.4876825396825396,0,1,0,398253,207357,34565,73391,1.920754751935974,0.26141236981207344
17234,0.4877380952380952,1,1,1,398254,207356,34566,73390,1.9207454889028863,0.2614106701431187
17235,0.4877499999999999,1,2,1,398256,207354,34567,73389,1.9207269628367112,0.2614099015825862
17236,0.4877619047619048,0,1,0,398257,207353,34567,73389,1.9207176998036237,0.2614108327218585
17237,0.4877777777777778,1,1,1,398258,207352,34568,73388,1.920708436770536,0.26140913300562796
17238,0.4877857142857142,0,1,0,398259,207351,34568,73388,1.9206991737374486,0.2614100641521128
17239,0.4877857142857144,0,1,0,398260,207350,34568,73388,1.9206899107043611,0.2614109953052312
17240,0.4878333333333332,0,4,0,398264,207346,34568,73388,1.9206528585720108,0.2614147199840418
17241,0.4878333333333333,1,5,1,398269,207341,34569,73387,1.920606543406573,0.2614167450343393
17242,0.4878333333333334,0,4,0,398273,207337,34569,73387,1.9205694912742228,0.26142046992775825
17243,0.4878571428571427,0,1,0,398274,207336,34569,73387,1.9205602282411354,0.26142140116769913
17244,0.4878571428571428,0,5,0,398279,207331,34569,73387,1.9205139130756974,0.2614260574669241
17245,0.4878849206349205,1,0,1,398279,207331,34570,73386,1.9205139130756974,0.2614234264401515
17246,0.4879029304029305,0,2,0,398281,207329,34570,73386,1.9204953870095225,0.2614252889941756
17247,0.4879166666666666,0,1,0,398282,207328,34570,73386,1.9204861239764348,0.2614262202811402
17248,0.4879166666666667,0,5,0,398287,207323,34570,73386,1.920439808810997,0.2614308768154922
17249,0.4879999999999999,0,2,0,398289,207321,34570,73386,1.920421282744822,0.2614327394756811
17250,0.488,16,84,16,398373,207237,34586,73370,1.9196431879654674,0.2614688870911987
17251,0.4880396825396824,0,1,0,398374,207236,34586,73370,1.91963392493238,0.2614698188919695
17252,0.488047619047619,0,1,0,398375,207235,34586,73370,1.9196246618992923,0.2614707506993817
17253,0.4880555555555556,0,3,0,398378,207232,34586,73370,1.9195968728000297,0.2614735461614671
17254,0.4880714285714285,0,1,0,398379,207231,34586,73370,1.919587609766942,0.2614744779954455
17255,0.4880753968253968,1,0,1,398379,207231,34587,73369,1.919587609766942,0.261471846044191
17256,0.4880833333333333,0,1,0,398380,207230,34587,73369,1.9195783467338545,0.2614727778787522
17257,0.4880952380952381,0,2,0,398382,207228,34587,73369,1.9195598206676794,0.2614746415678001
17258,0.4881428571428571,0,1,0,398383,207227,34587,73369,1.919550557634592,0.26147557342228683
17259,0.4881666666666666,1,7,1,398390,207220,34588,73368,1.919485716402979,0.26147946455301013
17260,0.4881666666666667,1,4,1,398394,207216,34589,73367,1.9194486642706288,0.2614805601194655
17261,0.4881785714285714,0,1,0,398395,207215,34589,73367,1.9194394012375413,0.2614814920415422
17262,0.4881818181818182,0,1,0,398396,207214,34589,73367,1.9194301382044536,0.2614824239702617
17263,0.4881966089466089,0,1,0,398397,207213,34589,73367,1.9194208751713662,0.26148335590562405
17264,0.4882023809523809,0,2,0,398399,207211,34589,73367,1.919402349105191,0.2614852197962777
17265,0.4882142857142857,0,4,0,398403,207207,34589,73367,1.9193652969728408,0.2614889476573025
17266,0.4882619047619048,0,1,0,398404,207206,34589,73367,1.9193560339397533,0.261489879639167
17267,0.4882738095238095,0,3,0,398407,207203,34589,73367,1.9193282448404905,0.2614926756246213
17268,0.4883333333333333,62,404,62,398811,206799,34651,73305,1.9155859794731187,0.26170636620683746
17269,0.4883333333333334,0,2,0,398813,206797,34651,73305,1.9155674534069436,0.261708234857302
17270,0.4883809523809523,0,1,0,398814,206796,34651,73305,1.915558190373856,0.2617091691925413
17271,0.4883809523809524,1,0,1,398814,206796,34652,73304,1.915558190373856,0.26170653338093536
17272,0.4883968253968254,0,1,0,398815,206795,34652,73304,1.9155489273407684,0.26170746771677156
17273,0.4884047619047619,0,1,0,398816,206794,34652,73304,1.915539664307681,0.26170840205927925
17274,0.4884285714285715,0,1,0,398817,206793,34652,73304,1.9155304012745933,0.2617093364084585
17275,0.4884523809523809,0,1,0,398818,206792,34652,73304,1.9155211382415058,0.26171027076430936
17276,0.488452380952381,0,1,0,398819,206791,34652,73304,1.9155118752084181,0.261711205126832
17277,0.4884761904761904,0,1,0,398820,206790,34652,73304,1.9155026121753307,0.26171213949602634
17278,0.4884999999999999,0,1,0,398821,206789,34652,73304,1.9154933491422432,0.2617130738718926
17279,0.4885,4,22,4,398843,206767,34656,73300,1.915289562414317,0.2617230876897314
17280,0.4885000000000001,0,2,0,398845,206765,34656,73300,1.9152710363481418,0.26172495670647883
17281,0.4885238095238095,0,1,0,398846,206764,34656,73300,1.9152617733150543,0.2617258912248629
17282,0.488547619047619,0,2,0,398848,206762,34656,73300,1.9152432472488792,0.2617277602816519
17283,0.4885714285714285,1,4,1,398852,206758,34657,73299,1.915206195116529,0.2617288623387382
17284,0.4885714285714286,3,9,3,398861,206749,34660,73296,1.9151228278187409,0.2617293649234944
17285,0.4885952380952381,0,1,0,398862,206748,34660,73296,1.9151135647856534,0.26173029952436044
17286,0.488611111111111,0,2,0,398864,206746,34660,73296,1.9150950387194783,0.26173216874611666
17287,0.488642857142857,0,2,0,398866,206744,34660,73296,1.9150765126533031,0.2617340379945722
17288,0.4886666666666666,0,4,0,398870,206740,34660,73296,1.915039460520953,0.26173777657158365
17289,0.4886666666666667,5,37,5,398907,206703,34665,73291,1.9146967282967136,0.261759180553869
17290,0.4886904761904762,0,1,0,398908,206702,34665,73291,1.9146874652636259,0.2617601154314572
17291,0.4887063492063492,0,1,0,398909,206701,34665,73291,1.9146782022305384,0.26176105031572333
17292,0.4887142857142857,0,1,0,398910,206700,34665,73291,1.9146689391974507,0.2617619852066674
17293,0.48875,2,8,2,398918,206692,34667,73289,1.9145948349327504,0.26176419114154176
17294,0.4887500000000001,0,1,0,398919,206691,34667,73289,1.9145855718996627,0.26176512608043434
17295,0.4887777777777778,0,1,0,398920,206690,34667,73289,1.9145763088665753,0.2617660610260055
17296,0.4888095238095237,0,1,0,398921,206689,34667,73289,1.9145670458334878,0.2617669959782554
17297,0.4888095238095238,3,2,3,398923,206687,34670,73286,1.9145485197673127,0.26176095552071094
17298,0.4888333333333332,1,4,1,398927,206683,34671,73285,1.9145114676349624,0.26176205852097384
17299,0.4888333333333333,1,3,1,398930,206680,34672,73284,1.9144836785356998,0.26176222657198783
17300,0.4888333333333334,0,2,0,398932,206678,34672,73284,1.9144651524695246,0.26176409655596117
17301,0.4888809523809523,0,1,0,398933,206677,34672,73284,1.914455889436437,0.261765031557967
17302,0.4888809523809524,0,1,0,398934,206676,34672,73284,1.9144466264033495,0.26176596656665235
17303,0.4888888888888889,2,2,2,398936,206674,34674,73282,1.9144281003371744,0.26176256268842246
17304,0.4889007936507936,0,1,0,398937,206673,34674,73282,1.914418837304087,0.2617634977049883
17305,0.4889047619047619,0,1,0,398938,206672,34674,73282,1.9144095742709992,0.2617644327282339
17306,0.4889166666666667,0,2,0,398940,206670,34674,73282,1.914391048204824,0.2617663027947648
17307,0.4889285714285714,1,0,1,398940,206670,34675,73281,1.914391048204824,0.2617636657843694
17308,0.488939393939394,1,0,1,398940,206670,34676,73280,1.914391048204824,0.26176102875513485
17309,0.4889761904761904,1,1,1,398941,206669,34677,73279,1.9143817851717366,0.2617593267321074
17310,0.4889772727272727,0,1,0,398942,206668,34677,73279,1.9143725221386492,0.2617602617638339
17311,0.4889999999999999,0,2,0,398944,206666,34677,73279,1.914353996072474,0.26176213184732716
17312,0.489,13,73,13,399017,206593,34690,73266,1.9136777946570824,0.261796118759804
17313,0.4890039682539682,0,1,0,399018,206592,34690,73266,1.913668531623995,0.2617970542203546
17314,0.4890357142857142,0,5,0,399023,206587,34690,73266,1.9136222164585572,0.261801731623388
17315,0.4890476190476189,0,2,0,399025,206585,34690,73266,1.913603690392382,0.2618036026314003
17316,0.489047619047619,0,5,0,399030,206580,34690,73266,1.9135573752269444,0.26180828026843334
17317,0.4890476190476191,0,1,0,399031,206579,34690,73266,1.9135481121938567,0.2618092158158981
17318,0.4890930735930736,0,1,0,399032,206578,34690,73266,1.9135388491607692,0.26181015137004904
17319,0.4891060606060605,0,1,0,399033,206577,34690,73266,1.9135295861276818,0.2618110869308862
17320,0.4891666666666666,24,82,24,399115,206495,34714,73242,1.9127700174145021,0.2618244994405459
17321,0.4891666666666667,11,53,11,399168,206442,34725,73231,1.912279076660862,0.2618450833652158
17322,0.4892142857142856,0,1,0,399169,206441,34725,73231,1.9122698136277743,0.2618460196229869
17323,0.4892142857142857,1,0,1,399169,206441,34726,73230,1.9122698136277743,0.26184338025751686
17324,0.4892857142857143,2,14,2,399183,206427,34728,73228,1.9121401311645485,0.26185120952602314
17325,0.4893333333333332,1,2,1,399185,206425,34729,73227,1.9121216050983734,0.2618504426930614
17326,0.4893333333333333,2,15,2,399200,206410,34731,73225,1.9119826596020602,0.2618592093264434
17327,0.4893333333333334,9,34,9,399234,206376,34740,73216,1.9116677164770832,0.26186729234026723
17328,0.4893571428571427,0,1,0,399235,206375,34740,73216,1.9116584534439958,0.26186822894871437
17329,0.4893571428571428,0,1,0,399236,206374,34740,73216,1.911649190410908,0.26186916556386136
17330,0.4893571428571429,0,1,0,399237,206373,34740,73216,1.9116399273778206,0.26187010218570833
17331,0.4893809523809523,1,1,1,399238,206372,34741,73215,1.911630664344733,0.26186839874529216
17332,0.4894047619047619,0,1,0,399239,206371,34741,73215,1.9116214013116455,0.2618693353744465
17333,0.4894166666666666,0,1,0,399240,206370,34741,73215,1.911612138278558,0.261870272010301
17334,0.4894444444444444,0,2,0,399242,206368,34741,73215,1.9115936122123829,0.26187214530211067
17335,0.4894523809523809,0,1,0,399243,206367,34741,73215,1.9115843491792952,0.26187308195806597
17336,0.4894801587301587,1,2,1,399245,206365,34742,73214,1.91156582311312,0.2618723151595792
17337,0.4894999999999999,0,7,0,399252,206358,34742,73214,1.9115009818815072,0.2618788719900419
17338,0.4895,0,13,0,399265,206345,34742,73214,1.9113805624513691,0.2618910498320569
17339,0.4895000000000001,1,1,1,399266,206344,34743,73213,1.9113712994182814,0.26188934635870326
17340,0.4895151515151514,0,1,0,399267,206343,34743,73213,1.911362036385194,0.2618902831633018
17341,0.4895238095238094,1,4,1,399271,206339,34744,73212,1.9113249842528437,0.26189139012201706
17342,0.4895238095238096,1,2,1,399273,206337,34745,73211,1.9113064581866686,0.2618906234349736
17343,0.4895396825396826,0,1,0,399274,206336,34745,73211,1.911297195153581,0.26189156027430094
17344,0.489547619047619,0,1,0,399275,206335,34745,73211,1.9112879321204936,0.2618924971203308
17345,0.4895476190476191,0,2,0,399277,206333,34745,73211,1.9112694060543185,0.2618943708324986
17346,0.4895833333333332,0,3,0,399280,206330,34745,73211,1.9112416169550557,0.2618971814510215
17347,0.4895833333333333,2,1,2,399281,206329,34747,73209,1.9112323539219682,0.2618928374675357
17348,0.4896071428571428,0,1,0,399282,206328,34747,73209,1.9112230908888808,0.26189377434829736
17349,0.4896071428571429,0,1,0,399283,206327,34747,73209,1.911213827855793,0.26189471123576213
17350,0.4896428571428571,0,5,0,399288,206322,34747,73209,1.9111675126903553,0.26189939577363514
17351,0.4896547619047618,0,1,0,399289,206321,34747,73209,1.9111582496572679,0.26190033270132007
17352,0.4896666666666666,2,13,2,399302,206308,34749,73207,1.9110378302271296,0.2619072321700088
17353,0.4896666666666667,5,19,5,399321,206289,34754,73202,1.910861832598466,0.26191183258137113
17354,0.4897142857142857,0,1,0,399322,206288,34754,73202,1.9108525695653784,0.2619127696876454
17355,0.4897619047619047,0,1,0,399323,206287,34754,73202,1.910843306532291,0.2619137068006254
17356,0.4898095238095238,0,1,0,399324,206286,34754,73202,1.9108340434992033,0.26191464392031144
17357,0.4898333333333333,2,17,2,399341,206269,34756,73200,1.910676571936715,0.2619252940397683
17358,0.4898333333333334,1,4,1,399345,206265,34757,73199,1.9106395198043646,0.26192640196948447
17359,0.489845238095238,1,0,1,399345,206265,34758,73198,1.9106395198043646,0.2619237609272068
17360,0.4898571428571428,1,0,1,399345,206265,34759,73197,1.9106395198043646,0.2619211198660283
17361,0.4898571428571429,0,1,0,399346,206264,34759,73197,1.9106302567712772,0.26192205710278
17362,0.4898809523809523,0,2,0,399348,206262,34759,73197,1.910611730705102,0.2619239315964059
17363,0.4898809523809524,0,3,0,399351,206259,34759,73197,1.9105839416058394,0.26192674338715216
17364,0.4898968253968255,0,1,0,399352,206258,34759,73197,1.9105746785727518,0.26192768066414984
17365,0.4899166666666666,1,0,1,399352,206258,34760,73196,1.9105746785727518,0.2619250395413914
17366,0.4899415584415584,0,1,0,399353,206257,34760,73196,1.9105654155396643,0.261925976819
17367,0.4899444444444444,0,1,0,399354,206256,34760,73196,1.9105561525065768,0.2619269141033165
17368,0.4899523809523809,0,2,0,399356,206254,34760,73196,1.9105376264404017,0.2619287886920737
17369,0.489952380952381,0,2,0,399358,206252,34760,73196,1.9105191003742266,0.2619306633076637
17370,0.4899999999999999,5,33,5,399391,206219,34765,73191,1.9102134202823373,0.2619483912529974
17371,0.49,510,2928,510,402319,203291,35275,72681,1.8830912594019786,0.2633636745756816
17372,0.490047619047619,0,1,0,402320,203290,35275,72681,1.883081996368891,0.2633646288921662
17373,0.4900833333333332,1,1,1,402321,203289,35276,72680,1.8830727333358035,0.26336291395047995
17374,0.4900833333333333,0,1,0,402322,203288,35276,72680,1.8830634703027158,0.2633638682745826
17375,0.4900952380952381,0,1,0,402323,203287,35276,72680,1.8830542072696284,0.2633648226056014
17376,0.4901071428571426,1,2,1,402325,203285,35277,72679,1.8830356812034532,0.26336406197909873
17377,0.4901190476190475,1,3,1,402328,203282,35278,72678,1.8830078921041906,0.26336425568923033
17378,0.4901190476190477,0,1,0,402329,203281,35278,72678,1.882998629071103,0.2633652100493189
17379,0.4901428571428571,0,3,0,402332,203278,35278,72678,1.8829708399718403,0.26336807317108524
17380,0.4901666666666666,2,10,2,402342,203268,35280,72676,1.8828782096409649,0.2633722784333053
17381,0.4901666666666667,2,0,2,402342,203268,35282,72674,1.8828782096409649,0.26336693942930034
17382,0.4901904761904761,0,1,0,402343,203267,35282,72674,1.8828689466078772,0.26336789386136894
17383,0.4902142857142857,0,1,0,402344,203266,35282,72674,1.8828596835747897,0.2633688483003552
17384,0.4902460317460317,0,1,0,402345,203265,35282,72674,1.8828504205417023,0.26336980274625915
17385,0.4902619047619047,0,1,0,402346,203264,35282,72674,1.8828411575086146,0.26337075719908093
17386,0.4902738095238094,0,1,0,402347,203263,35282,72674,1.8828318944755271,0.2633717116588207
17387,0.4902857142857143,0,1,0,402348,203262,35282,72674,1.8828226314424394,0.2633726661254784
17388,0.4903095238095238,2,0,2,402348,203262,35284,72672,1.8828226314424394,0.2633673269694927
17389,0.4903333333333332,1,0,1,402348,203262,35285,72671,1.8828226314424394,0.26336465736247566
17390,0.4903333333333333,1,19,1,402367,203243,35286,72670,1.882646633813776,0.263380123444709
17391,0.4903333333333334,0,7,0,402374,203236,35286,72670,1.882581792582163,0.26338680565120004
17392,0.4903571428571428,1,1,1,402375,203235,35287,72669,1.8825725295490756,0.26338509046624914
17393,0.4904047619047618,0,1,0,402376,203234,35287,72669,1.882563266515988,0.26338604509555896
17394,0.4904166666666666,1,0,1,402376,203234,35288,72668,1.882563266515988,0.26338337525643163
17395,0.4904166666666667,0,2,0,402378,203232,35288,72668,1.8825447404498128,0.26338528452337806
17396,0.4904285714285714,0,3,0,402381,203229,35288,72668,1.8825169513505502,0.26338814847569925
17397,0.4904444444444444,0,1,0,402382,203228,35288,72668,1.8825076883174627,0.2633891031403137
17398,0.490456795655325,1,4,1,402386,203224,35289,72667,1.8824706361851125,0.263390251947327
17399,0.4904761904761904,0,2,0,402388,203222,35289,72667,1.8824521101189373,0.2633921613402492
17400,0.4904761904761905,0,10,0,402398,203212,35289,72667,1.8823594797880618,0.2634017087201273
17401,0.4905,4,17,4,402415,203195,35293,72663,1.8822020082255735,0.26340726025708877
17402,0.4905238095238095,0,1,0,402416,203194,35293,72663,1.8821927451924858,0.2634082151259529
17403,0.4905833333333333,0,1,0,402417,203193,35293,72663,1.8821834821593983,0.26340917000174
17404,0.490595238095238,1,0,1,402417,203193,35294,72662,1.8821834821593983,0.26340649979155717
17405,0.4905952380952381,0,1,0,402418,203192,35294,72662,1.8821742191263107,0.26340745466804905
17406,0.4906190476190475,1,0,1,402418,203192,35295,72661,1.8821742191263107,0.2634047844322882
17407,0.4906190476190476,0,1,0,402419,203191,35295,72661,1.8821649560932232,0.2634057393094848
17408,0.4906453823953823,0,1,0,402420,203190,35295,72661,1.8821556930601355,0.2634066941936045
17409,0.4906666666666666,2,39,2,402459,203151,35297,72659,1.881794434769721,0.263438599035568
17410,0.4906666666666667,0,7,0,402466,203144,35297,72659,1.8817295935381082,0.2634452852216981
17411,0.4906746031746031,0,1,0,402467,203143,35297,72659,1.8817203305050205,0.26344624041885123
17412,0.4907142857142857,2,11,2,402478,203132,35299,72657,1.8816184371410574,0.26345140669134737
17413,0.4908333333333332,0,2,0,402480,203130,35299,72657,1.8815999110748824,0.26345331723395227
17414,0.4908333333333333,14,123,14,402603,203007,35313,72643,1.8804605580051132,0.26353346635225827
17415,0.4908333333333334,0,1,0,402604,203006,35313,72643,1.8804512949720256,0.2635344223995008
17416,0.4908571428571428,0,1,0,402605,203005,35313,72643,1.880442031938938,0.2635353784536801
17417,0.4908787878787879,0,1,0,402606,203004,35313,72643,1.8804327689058504,0.2635363345147961
17418,0.4908809523809523,1,0,1,402606,203004,35314,72642,1.8804327689058504,0.26353366274134216
17419,0.4908809523809525,0,1,0,402607,203003,35314,72642,1.880423505872763,0.26353461880317075
17420,0.4909047619047618,0,1,0,402608,203002,35314,72642,1.8804142428396755,0.26353557487193624
17421,0.4909047619047619,1,1,1,402609,203001,35315,72641,1.8804049798065878,0.26353385913612587
17422,0.490952380952381,1,6,1,402615,202995,35316,72640,1.8803494016080626,0.2635369238304279
17423,0.4909642857142858,0,1,0,402616,202994,35316,72640,1.880340138574975,0.26353787994224226
17424,0.4909999999999999,2,7,2,402623,202987,35318,72638,1.880275297343362,0.2635392290249433
17425,0.491,11,59,11,402682,202928,35329,72627,1.8797287783911965,0.2635662571900347
17426,0.4910000000000001,2,2,2,402684,202926,35331,72625,1.8797102523250213,0.2635628250305751
17427,0.4910238095238095,0,1,0,402685,202925,35331,72625,1.8797009892919339,0.26356378152785337
17428,0.491047619047619,0,3,0,402688,202922,35331,72625,1.879673200192671,0.2635666510613434
17429,0.4910714285714285,0,2,0,402690,202920,35331,72625,1.879654674126496,0.2635685641183836
17430,0.4910714285714286,0,1,0,402691,202919,35331,72625,1.8796454110934084,0.26356952065731787
17431,0.4910833333333333,0,2,0,402693,202917,35331,72625,1.8796268850272333,0.26357143375601544
17432,0.4911111111111111,0,4,0,402697,202913,35331,72625,1.879589832894883,0.26357526003672815
17433,0.4911111111111112,0,1,0,402698,202912,35331,72625,1.8795805698617956,0.2635762166242646
17434,0.4911428571428571,0,1,0,402699,202911,35331,72625,1.879571306828708,0.2635771732187446
17435,0.4911666666666666,0,3,0,402702,202908,35331,72625,1.8795435177294453,0.2635800430438459
17436,0.4911666666666667,2,13,2,402715,202895,35333,72623,1.8794230982993072,0.26358713405294754
17437,0.4911904761904763,0,1,0,402716,202894,35333,72623,1.8794138352662195,0.2635880907530207
17438,0.4912023809523809,0,1,0,402717,202893,35333,72623,1.879404572233132,0.26358904746003864
17439,0.4912142857142856,0,1,0,402718,202892,35333,72623,1.8793953092000444,0.2635900041740014
17440,0.4912380952380952,0,1,0,402719,202891,35333,72623,1.879386046166957,0.26359096089490913
17441,0.4912460317460319,0,1,0,402720,202890,35333,72623,1.8793767831338692,0.2635919176227619
17442,0.4912499999999999,0,1,0,402721,202889,35333,72623,1.8793675201007818,0.26359287435755974
17443,0.49125,1,5,1,402726,202884,35334,72622,1.879321204935344,0.263594985227182
17444,0.4912500000000001,0,1,0,402727,202883,35334,72622,1.8793119419022564,0.2635959419974229
17445,0.4912857142857142,0,4,0,402731,202879,35334,72622,1.8792748897699063,0.2635997691478434
17446,0.4912857142857143,0,1,0,402732,202878,35334,72622,1.8792656267368186,0.2636007259528131
17447,0.4913095238095238,0,2,0,402734,202876,35334,72622,1.8792471006706435,0.2636026395835904
17448,0.4913333333333332,0,6,0,402740,202870,35334,72622,1.8791915224721183,0.2636083806426321
17449,0.4913333333333333,2,10,2,402750,202860,35336,72620,1.8790988921412428,0.26361260345578624
17450,0.4913333333333334,0,8,0,402758,202852,35336,72620,1.8790247878765423,0.26362025904629144
17451,0.4913636363636364,0,1,0,402759,202851,35336,72620,1.8790155248434548,0.2636212160263694
17452,0.4913809523809523,0,2,0,402761,202849,35336,72620,1.8789969987772797,0.26362313000736926
17453,0.4914166666666666,0,1,0,402762,202848,35336,72620,1.878987735744192,0.2636240870082913
17454,0.4914285714285714,1,8,1,402770,202840,35337,72619,1.8789136314794916,0.2636290700249402
17455,0.4914285714285715,0,1,0,402771,202839,35337,72619,1.8789043684464042,0.2636300270821686
17456,0.4914393939393939,0,2,0,402773,202837,35337,72619,1.878885842380229,0.26363194121747213
17457,0.4914783272283272,0,1,0,402774,202836,35337,72619,1.8788765793471414,0.26363289829554737
17458,0.4914841269841271,0,1,0,402775,202835,35337,72619,1.878867316314054,0.2636338553805717
17459,0.4914920634920633,0,1,0,402776,202834,35337,72619,1.8788580532809662,0.2636348124725452
17460,0.4914999999999999,1,0,1,402776,202834,35338,72618,1.8788580532809662,0.2636321391748835
17461,0.4915,3,32,3,402808,202802,35341,72615,1.8785616362221647,0.2636547489806366
17462,0.4915238095238095,0,3,0,402811,202799,35341,72615,1.8785338471229018,0.26365762089073175
17463,0.4915277777777776,0,1,0,402812,202798,35341,72615,1.8785245840898144,0.26365857820800037
17464,0.491547619047619,0,3,0,402815,202795,35341,72615,1.8784967949905518,0.2636614502015177
17465,0.4915555555555555,0,1,0,402816,202794,35341,72615,1.878487531957464,0.2636624075465943
17466,0.4915714285714285,0,1,0,402817,202793,35341,72615,1.8784782689243766,0.26366336489862313
17467,0.4915714285714286,0,3,0,402820,202790,35341,72615,1.878450479825114,0.26366623699642344
17468,0.4915833333333333,0,1,0,402821,202789,35341,72615,1.8784412167920264,0.2636671943762618
17469,0.4915952380952382,0,1,0,402822,202788,35341,72615,1.878431953758939,0.2636681517630527
17470,0.4916428571428571,0,2,0,402824,202786,35341,72615,1.8784134276927638,0.26367006655749253
17471,0.4916666666666666,42,236,42,403060,202550,35383,72573,1.8762273518841008,0.26378383486658696
17472,0.4916666666666667,35,161,35,403221,202389,35418,72538,1.8747360035570046,0.2638445841987146
17473,0.4917142857142857,0,4,0,403225,202385,35418,72538,1.8746989514246546,0.2638484230129891
17474,0.4917619047619048,1,3,1,403228,202382,35419,72537,1.8746711623253918,0.2638486245039448
17475,0.4917635697635696,0,3,0,403231,202379,35419,72537,1.8746433732261292,0.2638515037320491
17476,0.4917857142857143,1,1,1,403232,202378,35420,72536,1.8746341101930417,0.26384978575118034
17477,0.4918333333333333,2,19,2,403251,202359,35422,72534,1.874458112564378,0.26386266656480883
17478,0.4919047619047618,0,1,0,403252,202358,35422,72534,1.8744488495312905,0.26386362644238465
17479,0.4919047619047619,1,1,1,403253,202357,35423,72533,1.874439586498203,0.2638619083997235
17480,0.4919404761904762,2,1,2,403254,202356,35425,72531,1.8744303234651154,0.2638575123596241
17481,0.4919761904761905,0,1,0,403255,202355,35425,72531,1.874421060432028,0.26385847223940107
17482,0.4919999999999999,1,8,1,403263,202347,35426,72530,1.8743469561673274,0.263863473480866
17483,0.492,18,65,18,403328,202282,35444,72512,1.8737448590166363,0.26387766836248244
17484,0.4920238095238095,0,1,0,403329,202281,35444,72512,1.8737355959835489,0.26387862864046757
17485,0.4920357142857144,0,2,0,403331,202279,35444,72512,1.8737170699173737,0.2638805492174052
17486,0.492047619047619,1,5,1,403336,202274,35445,72511,1.873670754751936,0.2638826719071274
17487,0.4920555555555554,0,3,0,403339,202271,35445,72511,1.8736429656526734,0.26388555291103494
17488,0.4920714285714285,0,1,0,403340,202270,35445,72511,1.8736337026195857,0.2638865132596504
17489,0.4920714285714286,0,1,0,403341,202269,35445,72511,1.8736244395864983,0.26388747361525583
17490,0.4920833333333332,0,5,0,403346,202264,35445,72511,1.8735781244210605,0.2638922754981348
17491,0.4921388888888889,1,1,1,403347,202263,35446,72510,1.8735688613879729,0.26389055693244967
17492,0.4921428571428571,1,6,1,403353,202257,35447,72509,1.8735132831894477,0.2638936404067461
17493,0.4921666666666666,1,5,1,403358,202252,35448,72508,1.8734669680240097,0.26389576357548405
17494,0.4921666666666667,3,9,3,403367,202243,35451,72505,1.873383600726222,0.26389637049223286
17495,0.4921904761904762,0,1,0,403368,202242,35451,72505,1.8733743376931342,0.2638973309990646
17496,0.4922142857142856,1,1,1,403369,202241,35452,72504,1.8733650746600468,0.2638956122950372
17497,0.4922222222222222,0,1,0,403370,202240,35452,72504,1.873355811626959,0.2638965728095973
17498,0.4922380952380952,0,1,0,403371,202239,35452,72504,1.8733465485938716,0.26389753333114946
17499,0.49225,0,2,0,403373,202237,35452,72504,1.8733280225276965,0.26389945439523044
17500,0.4922619047619047,0,2,0,403375,202235,35452,72504,1.8733094964615213,0.26390137548728065
17501,0.4922857142857143,0,2,0,403377,202233,35452,72504,1.8732909703953462,0.2639032966073008
17502,0.4922878787878788,0,2,0,403379,202231,35452,72504,1.873272444329171,0.26390521775529147
17503,0.4923015873015873,0,1,0,403380,202230,35452,72504,1.8732631812960836,0.2639061783397759
17504,0.4923095238095238,0,1,0,403381,202229,35452,72504,1.8732539182629961,0.2639071389312532
17505,0.4923333333333333,11,27,11,403408,202202,35463,72493,1.873003816369632,0.2639036021769599
17506,0.4923333333333334,0,1,0,403409,202201,35463,72493,1.8729945533365444,0.26390456289544
17507,0.4923809523809523,0,3,0,403412,202198,35463,72493,1.8729667642372818,0.2639074450928498
17508,0.4923809523809524,1,4,1,403416,202194,35464,72492,1.8729297121049315,0.26390860837465324
17509,0.4924087301587302,0,2,0,403418,202192,35464,72492,1.8729111860387566,0.2639105299180149
17510,0.4924126984126984,1,1,1,403419,202191,35465,72491,1.872901923005669,0.26390881091589546
17511,0.4924166666666666,0,4,0,403423,202187,35465,72491,1.8728648708733187,0.2639126540895157
17512,0.4924285714285714,0,1,0,403424,202186,35465,72491,1.8728556078402312,0.2639136149004103
17513,0.4924761904761904,0,2,0,403426,202184,35465,72491,1.872837081774056,0.2639155365431874
17514,0.4924843767343767,0,5,0,403431,202179,35465,72491,1.8727907666086183,0.26392034077256343
17515,0.4924999999999999,4,10,4,403441,202169,35469,72487,1.8726981362777428,0.26391922987300476
17516,0.4925,54,337,54,403778,201832,35523,72433,1.869576494127237,0.2640985907789911
17517,0.4925119047619048,0,4,0,403782,201828,35523,72433,1.8695394419948868,0.2641024425638352
17518,0.4925238095238095,0,1,0,403783,201827,35523,72433,1.8695301789617993,0.26410340552760153
17519,0.492547619047619,0,1,0,403784,201826,35523,72433,1.8695209159287116,0.2641043684983902
17520,0.4925555555555555,1,0,1,403784,201826,35524,72432,1.8695209159287116,0.2641016852744496
17521,0.4925952380952381,0,2,0,403786,201824,35524,72432,1.8695023898625367,0.26410361122454934
17522,0.4926190476190475,1,2,1,403788,201822,35525,72431,1.8694838637963616,0.2641028539341411
17523,0.4926190476190477,2,4,2,403792,201818,35527,72429,1.8694468116640113,0.26410133930362045
17524,0.4926349206349206,0,1,0,403793,201817,35527,72429,1.8694375486309238,0.26410230231252235
17525,0.4926428571428571,1,0,1,403793,201817,35528,72428,1.8694375486309238,0.26409961895385514
17526,0.4926507936507937,0,4,0,403797,201813,35528,72428,1.8694004964985735,0.26410347103460097
17527,0.4926666666666666,7,25,7,403822,201788,35535,72421,1.8691689206713846,0.26410876375319553
17528,0.4926666666666667,2,10,2,403832,201778,35537,72419,1.8690762903405091,0.26411302822423294
17529,0.4926904761904762,1,0,1,403832,201778,35538,72418,1.8690762903405091,0.26411034442515574
17530,0.4927142857142857,0,1,0,403833,201777,35538,72418,1.8690670273074215,0.26411130764601837
17531,0.4927380952380951,0,2,0,403835,201775,35538,72418,1.8690485012412463,0.26411323410882115
17532,0.4927380952380952,0,3,0,403838,201772,35538,72418,1.8690207121419837,0.2641161238557205
17533,0.4927777777777777,0,2,0,403840,201770,35538,72418,1.8690021860758086,0.26411805038878433
17534,0.4927857142857143,0,1,0,403841,201769,35538,72418,1.8689929230427211,0.2641190136658558
17535,0.4928333333333333,0,8,0,403849,201761,35538,72418,1.8689188187780206,0.264126720135386
17536,0.4928333333333334,2,4,2,403853,201757,35540,72416,1.8688817666456705,0.26412520561835046
17537,0.4928424908424908,1,0,1,403853,201757,35541,72415,1.8688817666456705,0.2641225216287586
17538,0.4928571428571428,1,6,1,403859,201751,35542,72414,1.868826188447145,0.26412561778491056
17539,0.4928636363636363,0,1,0,403860,201750,35542,72414,1.8688169254140576,0.26412658117039434
17540,0.4928787878787878,1,0,1,403860,201750,35543,72413,1.8688169254140576,0.26412389709771195
17541,0.4929166666666666,0,3,0,403863,201747,35543,72413,1.8687891363147948,0.26412678727750216
17542,0.4929285714285715,1,0,1,403863,201747,35544,72412,1.8687891363147948,0.2641241031664107
17543,0.4929393939393939,0,2,0,403865,201745,35544,72412,1.86877061024862,0.264126029975525
17544,0.4929761904761904,0,1,0,403866,201744,35544,72412,1.8687613472155322,0.26412699339062434
17545,0.4929761904761905,0,1,0,403867,201743,35544,72412,1.8687520841824448,0.2641279568127519
17546,0.4929999999999999,0,3,0,403870,201740,35544,72412,1.868724295083182,0.26413084712130497
17547,0.493,7,45,7,403915,201695,35551,72405,1.868307458594242,0.2641554177307552
17548,0.493047619047619,1,3,1,403918,201692,35552,72404,1.8682796694949795,0.2641556243068122
17549,0.4930476190476191,0,1,0,403919,201691,35552,72404,1.8682704064618918,0.2641565880442912
17550,0.4930555555555556,2,0,2,403919,201691,35554,72402,1.8682704064618918,0.26415121874692166
17551,0.4930833333333332,0,1,0,403920,201690,35554,72402,1.8682611434288043,0.26415218247887573
17552,0.4930952380952381,1,1,1,403921,201689,35555,72401,1.8682518803957169,0.2641504615272356
17553,0.4931428571428571,0,1,0,403922,201688,35555,72401,1.8682426173626292,0.2641514252669753
17554,0.4931666666666666,1,11,1,403933,201677,35556,72400,1.868140723998666,0.26415934208269937
17555,0.4931666666666667,2,6,2,403939,201671,35558,72398,1.8680851458001408,0.26415975539006603
17556,0.4932142857142856,0,1,0,403940,201670,35558,72398,1.8680758827670532,0.26416071923756146
17557,0.4932142857142857,1,1,1,403941,201669,35559,72397,1.8680666197339657,0.2641589981975145
17558,0.4932380952380952,0,2,0,403943,201667,35559,72397,1.8680480936677906,0.2641609259151147
17559,0.4932857142857142,0,1,0,403944,201666,35559,72397,1.868038830634703,0.26416188978446564
17560,0.4933333333333332,1,0,1,403944,201666,35560,72396,1.868038830634703,0.264159204851457
17561,0.4933333333333333,116,635,116,404579,201031,35676,72280,1.8621568046241062,0.2644606327590181
17562,0.4933333333333334,0,2,0,404581,201029,35676,72280,1.862138278557931,0.2644625680091032
17563,0.4933571428571428,0,1,0,404582,201028,35676,72280,1.8621290155248436,0.2644635356447671
17564,0.4933571428571429,0,1,0,404583,201027,35676,72280,1.8621197524917559,0.26446450328751187
17565,0.4933809523809523,0,1,0,404584,201026,35676,72280,1.8621104894586684,0.26446547093733763
17566,0.4933809523809524,0,2,0,404586,201024,35676,72280,1.8620919633924933,0.2644674062582326
17567,0.4934166666666666,0,1,0,404587,201023,35676,72280,1.8620827003594056,0.2644683739293019
17568,0.4934166666666668,0,2,0,404589,201021,35676,72280,1.8620641742932307,0.2644703092926846
17569,0.4934285714285714,0,1,0,404590,201020,35676,72280,1.862054911260143,0.26447127698499817
17570,0.4934444444444444,0,1,0,404591,201019,35676,72280,1.8620456482270555,0.2644722446843933
17571,0.493452380952381,0,1,0,404592,201018,35676,72280,1.8620363851939679,0.26447321239087
17572,0.4934722222222221,0,1,0,404593,201017,35676,72280,1.8620271221608804,0.2644741801044285
17573,0.4934848484848484,0,1,0,404594,201016,35676,72280,1.8620178591277927,0.2644751478250688
17574,0.4934999999999999,0,3,0,404597,201013,35676,72280,1.8619900700285301,0.2644780510294812
17575,0.4935,6,18,6,404615,200995,35682,72274,1.861823335432954,0.264479322572264
17576,0.4935000000000001,1,2,1,404617,200993,35683,72273,1.8618048093667792,0.26447856667130193
17577,0.4935238095238095,1,0,1,404617,200993,35684,72272,1.8618048093667792,0.2644758750663276
17578,0.4935454545454545,0,1,0,404618,200992,35684,72272,1.8617955463336915,0.26447684290649337
17579,0.4935714285714285,0,4,0,404622,200988,35684,72272,1.8617584942013412,0.26448071433799314
17580,0.4935714285714286,0,3,0,404625,200985,35684,72272,1.8617307051020786,0.2644836179859985
17581,0.4935833333333333,0,1,0,404626,200984,35684,72272,1.8617214420689912,0.26448458588283513
17582,0.4935833333333334,0,1,0,404627,200983,35684,72272,1.8617121790359035,0.264485553786756
17583,0.4936071428571429,0,1,0,404628,200982,35684,72272,1.861702916002816,0.26448652169776105
17584,0.4936111111111111,0,1,0,404629,200981,35684,72272,1.8616936529697283,0.2644874896158505
17585,0.4936190476190476,0,1,0,404630,200980,35684,72272,1.8616843899366409,0.2644884575410244
17586,0.4936190476190477,2,0,2,404630,200980,35686,72270,1.8616843899366409,0.26448307410795974
17587,0.4936666666666666,0,1,0,404631,200979,35686,72270,1.8616751269035532,0.2644840420276012
17588,0.4936666666666667,2,18,2,404649,200961,35688,72268,1.8615083923079774,0.2644960820410718
17589,0.4936904761904761,0,1,0,404650,200960,35688,72268,1.8614991292748897,0.2644970500827148
17590,0.4936904761904762,0,1,0,404651,200959,35688,72268,1.8614898662418022,0.2644980181314438
17591,0.4937142857142856,0,1,0,404652,200958,35688,72268,1.8614806032087146,0.2644989861872589
17592,0.4937142857142857,0,2,0,404654,200956,35688,72268,1.8614620771425396,0.26450092232014755
17593,0.49375,1,6,1,404660,200950,35689,72267,1.8614064989440142,0.2645040389141232
17594,0.4937619047619047,0,1,0,404661,200949,35689,72267,1.8613972359109268,0.26450500702740687
17595,0.4938095238095238,0,6,0,404667,200943,35689,72267,1.8613416577124013,0.264510815855935
17596,0.4938333333333332,0,3,0,404670,200940,35689,72267,1.8613138686131387,0.26451372036587645
17597,0.4938333333333333,1,10,1,404680,200930,35690,72266,1.861221238282263,0.26452071040571606
17598,0.4938333333333334,0,6,0,404686,200924,35690,72266,1.8611656600837378,0.26452652000439253
17599,0.4938571428571429,1,0,1,404686,200924,35691,72265,1.8611656600837378,0.26452382782615697
17600,0.4938888888888889,0,2,0,404688,200922,35691,72265,1.8611471340175627,0.2645257644031378
17601,0.493904761904762,0,1,0,404689,200921,35691,72265,1.8611378709844753,0.26452673270226146
17602,0.4939285714285714,0,1,0,404690,200920,35691,72265,1.8611286079513876,0.2645277010084741
17603,0.4939523809523809,0,1,0,404691,200919,35691,72265,1.8611193449183001,0.2645286693217758
17604,0.4939761904761905,0,1,0,404692,200918,35691,72265,1.8611100818852124,0.2645296376421666
17605,0.4939999999999999,1,5,1,404697,200913,35692,72264,1.8610637667197747,0.2645317870831
17606,0.494,22,110,22,404807,200803,35714,72242,1.8600448330801438,0.2645790986833672
17607,0.4940238095238095,0,2,0,404809,200801,35714,72242,1.8600263070139686,0.2645810366865292
17608,0.4940476190476189,0,4,0,404813,200797,35714,72242,1.8599892548816184,0.26458491277802804
17609,0.494047619047619,0,2,0,404815,200795,35714,72242,1.8599707288154432,0.2645868508663661
17610,0.4940555555555556,0,2,0,404817,200793,35714,72242,1.8599522027492683,0.2645887889830974
17611,0.4940952380952381,0,1,0,404818,200792,35714,72242,1.8599429397161806,0.2645897580521107
17612,0.4941190476190476,0,1,0,404819,200791,35714,72242,1.8599336766830932,0.26459072712822257
17613,0.4941428571428571,1,0,1,404819,200791,35715,72241,1.8599336766830932,0.26458803363708283
17614,0.4941547619047618,0,3,0,404822,200788,35715,72241,1.8599058875838304,0.26459094088906304
17615,0.4941666666666666,13,89,13,404911,200699,35728,72228,1.859081477639038,0.2646421937001469
17616,0.4941666666666667,8,55,8,404966,200644,35736,72220,1.8585720108192227,0.26467397677964116
17617,0.4942142857142857,0,1,0,404967,200643,35736,72220,1.858562747786135,0.2646749467681584
17618,0.4942142857142858,0,6,0,404973,200637,35736,72220,1.8585071695876099,0.264680766848569
17619,0.4942380952380951,0,1,0,404974,200636,35736,72220,1.8584979065545222,0.2646817368868561
17620,0.4942857142857142,0,2,0,404976,200634,35736,72220,1.858479380488347,0.2646836769847611
17621,0.4942857142857143,4,9,4,404985,200625,35740,72216,1.858396013190559,0.26468162776122356
17622,0.4943333333333333,1,44,1,405029,200581,35741,72215,1.8579884397347068,0.2647216234842153
17623,0.4943982683982683,1,0,1,405029,200581,35742,72214,1.8579884397347068,0.26471892813284703
17624,0.4944047619047619,1,2,1,405031,200579,35743,72213,1.8579699136685317,0.26471817355347665
17625,0.4944166666666666,0,2,0,405033,200577,35743,72213,1.8579513876023566,0.264720114373694
17626,0.4944444444444444,0,3,0,405036,200574,35743,72213,1.8579235985030937,0.26472302565738104
17627,0.4944444444444445,1,0,1,405036,200574,35744,72212,1.8579235985030937,0.26472033022222546
17628,0.4944523809523808,0,2,0,405038,200572,35744,72212,1.8579050724369188,0.2647222711009443
17629,0.4944999999999999,0,2,0,405040,200570,35744,72212,1.8578865463707437,0.2647242120081237
17630,0.4945,1,11,1,405051,200559,35745,72211,1.8577846530067805,0.2647321919565935
17631,0.4945238095238095,0,3,0,405054,200556,35745,72211,1.857756863907518,0.26473510358657754
17632,0.4945238095238096,1,2,1,405056,200554,35746,72210,1.8577383378413428,0.2647343491076535
17633,0.4945555555555556,0,1,0,405057,200553,35746,72210,1.857729074808255,0.2647353196731228
17634,0.4945714285714285,0,1,0,405058,200552,35746,72210,1.8577198117751677,0.2647362902457087
17635,0.4945833333333332,1,4,1,405062,200548,35747,72209,1.8576827596428174,0.264737476948346
17636,0.4945833333333334,0,2,0,405064,200546,35747,72209,1.8576642335766422,0.2647394181591538
17637,0.4946269841269841,1,1,1,405065,200545,35748,72208,1.8576549705435548,0.2647376930776197
17638,0.4946428571428571,3,4,3,405069,200541,35751,72205,1.8576179184112045,0.26473348830047005
17639,0.4946428571428572,0,8,0,405077,200533,35751,72205,1.8575438141465042,0.2647412535106953
17640,0.4946515151515152,0,1,0,405078,200532,35751,72205,1.8575345511134165,0.26474222419400373
17641,0.4946666666666666,2,14,2,405092,200518,35753,72203,1.8574048686501907,0.264750422593053
17642,0.4946666666666667,5,23,5,405115,200495,35758,72198,1.8571918188891772,0.26475927141510786
17643,0.4946904761904761,0,1,0,405116,200494,35758,72198,1.8571825558560895,0.264760242324674
17644,0.4947142857142858,0,1,0,405117,200493,35758,72198,1.857173292823002,0.2647612132413611
17645,0.4947222222222222,0,4,0,405121,200489,35758,72198,1.8571362406906518,0.2647650969793206
17646,0.4947460317460318,0,1,0,405122,200488,35758,72198,1.8571269776575643,0.26476606793161367
17647,0.4947619047619047,1,3,1,405125,200485,35759,72197,1.8570991885583015,0.2647662845365664
17648,0.4947857142857143,0,1,0,405126,200484,35759,72197,1.857089925525214,0.2647672555110184
17649,0.4948095238095238,0,1,0,405127,200483,35759,72197,1.8570806624921263,0.2647682264925921
17650,0.4948214285714286,0,1,0,405128,200482,35759,72197,1.8570713994590389,0.2647691974812875
17651,0.4948333333333333,0,8,0,405136,200474,35759,72197,1.8569972951943385,0.26477696564724523
17652,0.4948571428571429,0,2,0,405138,200472,35759,72197,1.8569787691281634,0.26477890775995805
17653,0.4948582251082251,3,5,3,405143,200467,35762,72194,1.8569324539627257,0.2647756738220721
17654,0.4948736263736264,0,1,0,405144,200466,35762,72194,1.856923190929638,0.26477664490574343
17655,0.4948809523809523,0,2,0,405146,200464,35762,72194,1.8569046648634628,0.26477858709445534
17656,0.4948809523809524,0,3,0,405149,200461,35762,72194,1.8568768757642002,0.26478150043094756
17657,0.4949166666666666,0,3,0,405152,200458,35762,72194,1.8568490866649376,0.2647844138315508
17658,0.4949242424242424,0,1,0,405153,200457,35762,72194,1.85683982363185,0.26478538497933257
17659,0.4949404761904762,0,1,0,405154,200456,35762,72194,1.8568305605987625,0.264786356134238
17660,0.4949617604617605,1,0,1,405154,200456,35763,72193,1.8568305605987625,0.26478365957696526
17661,0.4949880952380951,0,2,0,405156,200454,35763,72193,1.8568120345325874,0.2647856018954912
17662,0.4949999999999999,2,24,2,405180,200430,35765,72191,1.8565897217384861,0.26480351843768457
17663,0.495,181,1161,181,406341,199269,35946,72010,1.8458353403238357,0.265446274868309
17664,0.495021978021978,0,1,0,406342,199268,35946,72010,1.845826077290748,0.2654472533710806
17665,0.495047619047619,0,4,0,406346,199264,35946,72010,1.845789025158398,0.2654511674543082
17666,0.495051282051282,0,1,0,406347,199263,35946,72010,1.8457797621253103,0.2654521459931508
17667,0.495095238095238,0,1,0,406348,199262,35946,72010,1.8457704990922228,0.2654531245392079
17668,0.4950952380952381,0,1,0,406349,199261,35946,72010,1.8457612360591351,0.26545410309247947
17669,0.4951190476190475,0,2,0,406351,199259,35946,72010,1.8457427099929602,0.2654560602206666
17670,0.4951190476190477,0,1,0,406352,199258,35946,72010,1.8457334469598725,0.26545703879558225
17671,0.4951230158730159,0,1,0,406353,199257,35946,72010,1.845724183926785,0.26545801737771274
17672,0.4951428571428571,1,0,1,406353,199257,35947,72009,1.845724183926785,0.26545530954856117
17673,0.4951666666666666,2,15,2,406368,199242,35949,72007,1.8455852384304716,0.26546457314128347
17674,0.4951666666666667,1,9,1,406377,199233,35950,72006,1.8455018711326836,0.26547067346509906
17675,0.4951904761904762,1,1,1,406378,199232,35951,72005,1.8454926080995961,0.26546894413372807
17676,0.4952261904761905,0,1,0,406379,199231,35951,72005,1.8454833450665087,0.2654699228715952
17677,0.4952380952380952,1,3,1,406382,199228,35952,72004,1.8454555559672459,0.26547015101462956
17678,0.4952499999999999,1,2,1,406384,199226,35953,72003,1.8454370299010707,0.26546940039597533
17679,0.4952619047619047,0,1,0,406385,199225,35953,72003,1.8454277668679833,0.26547037916439303
17680,0.4952777777777777,0,1,0,406386,199224,35953,72003,1.8454185038348958,0.2654713579400281
17681,0.4952857142857143,1,10,1,406396,199214,35954,72002,1.84532587350402,0.2654784378502743
17682,0.4953333333333333,3,17,3,406413,199197,35957,71999,1.8451684019415318,0.2654869540848685
17683,0.4953333333333334,2,9,2,406422,199188,35959,71997,1.8450850346437437,0.26549034791747333
17684,0.4953571428571428,0,1,0,406423,199187,35959,71997,1.8450757716106563,0.26549132692194227
17685,0.4953611111111111,0,1,0,406424,199186,35959,71997,1.8450665085775686,0.26549230593363154
17686,0.4954166666666666,1,2,1,406426,199184,35960,71996,1.8450479825113935,0.2654915554244413
17687,0.4954166666666667,0,2,0,406428,199182,35960,71996,1.8450294564452183,0.26549351348560724
17688,0.4954444444444445,2,0,2,406428,199182,35962,71994,1.8450294564452183,0.2654880962917072
17689,0.4954761904761905,0,4,0,406432,199178,35962,71994,1.8449924043128683,0.2654920124496629
17690,0.4954999999999999,0,1,0,406433,199177,35962,71994,1.8449831412797806,0.26549299150720396
17691,0.4955,4,30,4,406463,199147,35966,71990,1.844705250287154,0.2655115310710084
17692,0.4955238095238095,0,1,0,406464,199146,35966,71990,1.8446959872540665,0.2655125103269208
17693,0.495547619047619,0,1,0,406465,199145,35966,71990,1.844686724220979,0.2655134895900566
17694,0.4955555555555556,0,3,0,406468,199142,35966,71990,1.8446589351217162,0.2655164274228051
17695,0.4955634920634921,0,1,0,406469,199141,35966,71990,1.8446496720886287,0.26551740671483526
17696,0.4955714285714285,0,1,0,406470,199140,35966,71990,1.844640409055541,0.26551838601408917
17697,0.4955952380952381,0,1,0,406471,199139,35966,71990,1.8446311460224536,0.26551936532056697
17698,0.4955952380952382,0,2,0,406473,199137,35966,71990,1.8446126199562785,0.26552132395519445
17699,0.4956190476190476,0,1,0,406474,199136,35966,71990,1.844603356923191,0.26552230328334425
17700,0.4956349206349206,0,1,0,406475,199135,35966,71990,1.8445940938901033,0.2655232826187183
17701,0.4956388888888889,0,4,0,406479,199131,35966,71990,1.8445570417577533,0.26552720003245783
17702,0.4956666666666666,8,31,8,406510,199100,35974,71982,1.844269887732039,0.26553588950944734
17703,0.4956666666666667,2,11,2,406521,199089,35976,71980,1.844167994368076,0.26554124595582673
17704,0.4957063492063492,0,1,0,406522,199088,35976,71980,1.8441587313349883,0.2655422255670164
17705,0.4957142857142857,3,20,3,406542,199068,35979,71977,1.8439734706732371,0.2655536903466214
17706,0.4957142857142858,0,1,0,406543,199067,35979,71977,1.8439642076401497,0.265554670090465
17707,0.4957380952380952,0,1,0,406544,199066,35979,71977,1.8439549446070622,0.26555564984153807
17708,0.4957777777777778,1,0,1,406544,199066,35980,71976,1.8439549446070622,0.2655529401347393
17709,0.4957857142857142,0,1,0,406545,199065,35980,71976,1.8439456815739745,0.2655539198866592
17710,0.4957857142857143,0,1,0,406546,199064,35980,71976,1.843936418540887,0.26555489964580875
17711,0.4958095238095239,0,1,0,406547,199063,35980,71976,1.8439271555077994,0.2655558794121879
17712,0.495813492063492,0,1,0,406548,199062,35980,71976,1.843917892474712,0.2655568591857968
17713,0.4958181818181817,0,1,0,406549,199061,35980,71976,1.8439086294416243,0.26555783896663554
17714,0.4958333333333332,0,1,0,406550,199060,35980,71976,1.8438993664085368,0.26555881875470416
17715,0.4958333333333333,20,146,20,406696,198914,36000,71956,1.8425469635777538,0.26564772769225087
17716,0.4958333333333334,1,1,1,406697,198913,36001,71955,1.8425377005446664,0.265645997312344
17717,0.4958809523809523,1,0,1,406697,198913,36002,71954,1.8425377005446664,0.2656432861884246
17718,0.4958863636363636,0,2,0,406699,198911,36002,71954,1.8425191744784912,0.2656452476325845
17719,0.4959444444444444,0,1,0,406700,198910,36002,71954,1.8425099114454038,0.2656462283655266
17720,0.4959523809523808,0,1,0,406701,198909,36002,71954,1.842500648412316,0.26564720910571027
17721,0.4959523809523809,0,3,0,406704,198906,36002,71954,1.8424728593130535,0.26565015136971126
17722,0.4959999999999999,1,1,1,406705,198905,36003,71953,1.8424635962799658,0.2656484209438156
17723,0.496,23,113,23,406818,198792,36026,71930,1.8414168735410723,0.26569691417764346
17724,0.4960000000000001,0,2,0,406820,198790,36026,71930,1.8413983474748972,0.26569887706855794
17725,0.4960238095238095,0,2,0,406822,198788,36026,71930,1.841379821408722,0.2657008399884751
17726,0.496047619047619,0,1,0,406823,198787,36026,71930,1.8413705583756346,0.26570182145930993
17727,0.4960606060606061,0,3,0,406826,198784,36026,71930,1.8413427692763717,0.2657047659153202
17728,0.4960714285714285,1,2,1,406828,198782,36027,71929,1.8413242432101968,0.2657040164603581
17729,0.4960833333333333,1,1,1,406829,198781,36028,71928,1.8413149801771092,0.26570228547998037
17730,0.4961190476190476,0,1,0,406830,198780,36028,71928,1.8413057171440217,0.26570326698878494
17731,0.4961190476190477,1,0,1,406830,198780,36029,71927,1.8413057171440217,0.2657005544740254
17732,0.4961363636363637,0,1,0,406831,198779,36029,71927,1.841296454110934,0.2657015359836871
17733,0.4961428571428571,0,2,0,406833,198777,36029,71927,1.8412779280447589,0.26570349902476503
17734,0.4961666666666666,4,7,4,406840,198770,36033,71923,1.841213086813146,0.265699519381735
17735,0.4961666666666667,2,6,2,406846,198764,36035,71921,1.8411575086146208,0.26569998337551026
17736,0.4961666666666668,0,1,0,406847,198763,36035,71921,1.8411482455815331,0.2657009649628349
17737,0.4961904761904761,0,1,0,406848,198762,36035,71921,1.8411389825484457,0.2657019465574122
17738,0.4961904761904762,1,3,1,406851,198759,36036,71920,1.841111193449183,0.2657021785953103
17739,0.4961984126984128,0,2,0,406853,198757,36036,71920,1.841092667383008,0.26570414183694957
17740,0.4962261904761905,0,1,0,406854,198756,36036,71920,1.8410834043499202,0.2657051234686489
17741,0.4962380952380952,0,1,0,406855,198755,36036,71920,1.8410741413168328,0.26570610510760134
17742,0.49625,0,8,0,406863,198747,36036,71920,1.8410000370521324,0.2657139584803467
17743,0.4962619047619048,0,3,0,406866,198744,36036,71920,1.8409722479528696,0.2657169036148139
17744,0.4962857142857143,0,2,0,406868,198742,36036,71920,1.8409537218866945,0.26571886707406284
17745,0.4963095238095238,0,4,0,406872,198738,36036,71920,1.8409166697543444,0.2657227940796134
17746,0.4963333333333332,0,3,0,406875,198735,36036,71920,1.8408888806550816,0.2657257394099499
17747,0.4963333333333333,2,12,2,406887,198723,36038,71918,1.840777724258031,0.2657320952848977
17748,0.4963333333333334,0,1,0,406888,198722,36038,71918,1.8407684612249435,0.2657330771504582
17749,0.4963809523809523,1,2,1,406890,198720,36039,71917,1.8407499351587684,0.2657323278044022
17750,0.4964087301587301,2,0,2,406890,198720,36041,71915,1.8407499351587684,0.2657269015463632
17751,0.4964166666666667,0,1,0,406891,198719,36041,71915,1.840740672125681,0.26572788341450077
17752,0.4964285714285714,1,5,1,406896,198714,36042,71914,1.840694356960243,0.2657300796665534
17753,0.4964285714285715,0,1,0,406897,198713,36042,71914,1.8406850939271555,0.26573106157183135
17754,0.4964444444444444,0,1,0,406898,198712,36042,71914,1.840675830894068,0.26573204348436585
17755,0.4964675324675325,0,1,0,406899,198711,36042,71914,1.8406665678609804,0.26573302540415705
17756,0.4965,5,29,5,406928,198682,36047,71909,1.8403979399014414,0.26574793692325316
17757,0.4965476190476189,0,1,0,406929,198681,36047,71909,1.8403886768683537,0.26574891902878894
17758,0.4965714285714285,0,1,0,406930,198680,36047,71909,1.8403794138352663,0.26574990114158376
17759,0.4965714285714286,0,2,0,406932,198678,36047,71909,1.8403608877690911,0.2657518653889507
17760,0.4965833333333333,0,1,0,406933,198677,36047,71909,1.8403516247360037,0.265752847523523
17761,0.4966071428571428,0,1,0,406934,198676,36047,71909,1.840342361702916,0.2657538296653547
17762,0.4966190476190476,0,2,0,406936,198674,36047,71909,1.8403238356367408,0.2657557939707964
17763,0.4966428571428571,0,1,0,406937,198673,36047,71909,1.8403145726036534,0.26575677613440657
17764,0.4966626984126984,0,1,0,406938,198672,36047,71909,1.8403053095705657,0.2657577583052764
17765,0.4966666666666666,64,375,64,407313,198297,36111,71845,1.836831672162733,0.26595272116146323
17766,0.4966666666666667,46,247,46,407560,198050,36157,71799,1.834543702990107,0.2660710249065218
17767,0.4967023809523809,0,1,0,407561,198049,36157,71799,1.8345344399570196,0.26607201090984556
17768,0.4967142857142857,0,1,0,407562,198048,36157,71799,1.834525176923932,0.26607299692047715
17769,0.4967222222222223,1,2,1,407564,198046,36158,71798,1.8345066508577568,0.2660722491513615
17770,0.4967460317460318,1,0,1,407564,198046,36159,71797,1.8345066508577568,0.26606952931890027
17771,0.4967499999999999,0,3,0,407567,198043,36159,71797,1.8344788617584942,0.2660724873999407
17772,0.4967857142857143,0,2,0,407569,198041,36159,71797,1.834460335692319,0.2660744594905091
17773,0.4967976190476191,1,7,1,407576,198034,36160,71796,1.8343954944607062,0.2660786421079939
17774,0.4968037518037518,0,3,0,407579,198031,36160,71796,1.8343677053614436,0.26608160043286994
17775,0.4968095238095237,0,1,0,407580,198030,36160,71796,1.834358442328356,0.2660825865557804
17776,0.4968333333333332,0,1,0,407581,198029,36160,71796,1.8343491792952684,0.2660835726860002
17777,0.4968333333333333,2,20,2,407601,198009,36162,71794,1.8341639186335175,0.2660978565842485
17778,0.4968333333333334,0,1,0,407602,198008,36162,71794,1.8341546556004298,0.2660988428551308
17779,0.4968571428571428,0,1,0,407603,198007,36162,71794,1.8341453925673423,0.2660998291333242
17780,0.4969047619047619,1,4,1,407607,198003,36163,71793,1.834108340434992,0.26610105412978696
17781,0.4969285714285714,0,2,0,407609,198001,36163,71793,1.834089814368817,0.2661030267537455
17782,0.4969365079365079,0,2,0,407611,197999,36163,71793,1.8340712883026418,0.26610499940695054
17783,0.496952380952381,0,1,0,407612,197998,36163,71793,1.8340620252695543,0.26610598574452077
17784,0.4969999999999999,1,2,1,407614,197996,36164,71792,1.8340434992033792,0.2661052381870209
17785,0.497,10,29,10,407643,197967,36174,71782,1.83377487124384,0.2661066398763295
17786,0.4970000000000001,0,2,0,407645,197965,36174,71782,1.833756345177665,0.26610861288540744
17787,0.4970238095238095,0,5,0,407650,197960,36174,71782,1.833710030012227,0.2661135455361049
17788,0.4970277777777777,0,3,0,407653,197957,36174,71782,1.8336822409129645,0.26611650521429975
17789,0.4970476190476189,0,1,0,407654,197956,36174,71782,1.833672977879877,0.26611749178832794
17790,0.4970642135642136,0,1,0,407655,197955,36174,71782,1.8336637148467894,0.2661184783696712
17791,0.4970833333333334,0,6,0,407661,197949,36174,71782,1.8336081366482642,0.26612439801135207
17792,0.4970952380952381,0,2,0,407663,197947,36174,71782,1.833589610582089,0.26612637128377
17793,0.4971190476190477,0,1,0,407664,197946,36174,71782,1.8335803475490013,0.26612735793095266
17794,0.4971212121212121,0,1,0,407665,197945,36174,71782,1.8335710845159139,0.2661283445854512
17795,0.4971428571428571,5,12,5,407677,197933,36179,71777,1.8334599281188633,0.26612658040117165
17796,0.4971428571428572,0,1,0,407678,197932,36179,71777,1.8334506650857756,0.2661275671186353
17797,0.4971666666666666,0,3,0,407681,197929,36179,71777,1.833422875986513,0.2661305273149281
17798,0.4971666666666667,1,4,1,407685,197925,36180,71776,1.8333858238541627,0.26613175331200106
17799,0.4972261904761904,0,1,0,407686,197924,36180,71776,1.8333765608210753,0.2661327400815721
17800,0.4972380952380951,0,1,0,407687,197923,36180,71776,1.8333672977879878,0.2661337268584607
17801,0.4972424242424242,1,0,1,407687,197923,36181,71775,1.8333672977879878,0.26613100579166327
17802,0.49725,0,1,0,407688,197922,36181,71775,1.8333580347549001,0.26613199256943904
17803,0.4972611555111554,0,2,0,407690,197920,36181,71775,1.833339508688725,0.2661339661469438
17804,0.4972619047619047,1,1,1,407691,197919,36182,71774,1.8333302456556375,0.26613223183397416
17805,0.4972857142857143,1,0,1,407691,197919,36183,71773,1.8333302456556375,0.2661295107010961
17806,0.4973333333333333,10,29,10,407720,197890,36193,71763,1.8330616176960983,0.2661309163999659
17807,0.4973333333333334,0,1,0,407721,197889,36193,71763,1.8330523546630109,0.26613190334208536
17808,0.4973484848484847,0,3,0,407724,197886,36193,71763,1.8330245655637483,0.266134864212365
17809,0.4973809523809523,0,1,0,407725,197885,36193,71763,1.8330153025306606,0.2661358511837655
17810,0.4973809523809525,0,1,0,407726,197884,36193,71763,1.8330060394975731,0.2661368381624865
17811,0.4973888888888889,0,1,0,407727,197883,36193,71763,1.8329967764644854,0.2661378251485281
17812,0.4974285714285714,0,2,0,407729,197881,36193,71763,1.8329782503983105,0.2661397991425732
17813,0.4974761904761905,1,0,1,407729,197881,36194,71762,1.8329782503983105,0.26613707754327015
17814,0.4974999999999999,0,11,0,407740,197870,36194,71762,1.8328763570343474,0.2661479349632091
17815,0.4975,42,303,42,408043,197567,36236,71720,1.8300696580088185,0.26633294589044404
17816,0.4975000000000001,0,2,0,408045,197565,36236,71720,1.8300511319426433,0.26633492396531555
17817,0.4975238095238095,0,1,0,408046,197564,36236,71720,1.8300418689095557,0.26633591301376985
17818,0.497540404040404,0,3,0,408049,197561,36236,71720,1.830014079810293,0.2663388802032078
17819,0.4975555555555556,0,1,0,408050,197560,36236,71720,1.8300048167772056,0.26633986928104575
17820,0.4975833333333333,0,1,0,408051,197559,36236,71720,1.829995553744118,0.26634085836622984
17821,0.4976190476190475,1,4,1,408055,197555,36237,71719,1.8299585016117677,0.266342090212943
17822,0.4976190476190477,1,3,1,408058,197552,36238,71718,1.829930712512505,0.266342332974338
17823,0.4976666666666666,5,27,5,408085,197525,36243,71713,1.8296806106191412,0.26635541788306255
17824,0.4976666666666667,0,11,0,408096,197514,36243,71713,1.829578717255178,0.26636630055677923
17825,0.4976904761904762,0,3,0,408099,197511,36243,71713,1.8295509281559155,0.26636926871304195
17826,0.4977380952380952,1,0,1,408099,197511,36244,71712,1.8295509281559155,0.26636654372026164
17827,0.4977777777777777,0,2,0,408101,197509,36244,71712,1.8295324020897403,0.26636852251495985
17828,0.4978174603174602,0,2,0,408103,197507,36244,71712,1.8295138760235652,0.26637050133905854
17829,0.4978333333333333,0,3,0,408106,197504,36244,71712,1.8294860869243026,0.266373469630334
17830,0.4978333333333334,3,7,3,408113,197497,36247,71709,1.8294212456926897,0.26637222053000303
17831,0.4978571428571428,0,5,0,408118,197492,36247,71709,1.8293749305272518,0.2663771679897177
17832,0.4978690476190476,1,0,1,408118,197492,36248,71708,1.8293749305272518,0.2663744427934621
17833,0.4978809523809523,0,1,0,408119,197491,36248,71708,1.8293656674941643,0.2663754323010115
17834,0.4978928571428571,0,1,0,408120,197490,36248,71708,1.8293564044610768,0.2663764218159125
17835,0.4979166666666666,0,2,0,408122,197488,36248,71708,1.8293378783949017,0.2663784008677692
17836,0.4979166666666667,0,2,0,408124,197486,36248,71708,1.8293193523287266,0.266380379949033
17837,0.4979365079365079,0,1,0,408125,197485,36248,71708,1.8293100892956389,0.2663813695006928
17838,0.4979761904761905,0,1,0,408126,197484,36248,71708,1.8293008262625514,0.2663823590597046
17839,0.4979999999999999,0,2,0,408128,197482,36248,71708,1.8292823001963763,0.2663843381997845
17840,0.498,9,75,9,408203,197407,36257,71699,1.8285875727148098,0.2664340445772298
17841,0.4980079365079365,0,1,0,408204,197406,36257,71699,1.828578309681722,0.26643503465190166
17842,0.4980347985347984,3,1,3,408205,197405,36260,71696,1.8285690466486346,0.26642784679358306
17843,0.4980555555555556,0,4,0,408209,197401,36260,71696,1.8285319945162843,0.26643180711787945
17844,0.4980833333333333,0,1,0,408210,197400,36260,71696,1.8285227314831969,0.2664327972173499
17845,0.4980833333333334,0,2,0,408212,197398,36260,71696,1.8285042054170217,0.26643477743836724
17846,0.4980952380952381,0,2,0,408214,197396,36260,71696,1.8284856793508466,0.2664367576888202
17847,0.4981190476190476,0,1,0,408215,197395,36260,71696,1.8284764163177591,0.26643774782508517
17848,0.4981666666666666,3,8,3,408223,197387,36263,71693,1.8284023120530586,0.2664374907090828
17849,0.4981666666666667,2,3,2,408226,197384,36265,71691,1.828374522953796,0.26643500882653537
17850,0.4981904761904762,0,2,0,408228,197382,36265,71691,1.8283559968876208,0.2664369892185392
17851,0.4982142857142857,0,2,0,408230,197380,36265,71691,1.8283374708214457,0.2664389696399835
17852,0.4982857142857143,0,2,0,408232,197378,36265,71691,1.8283189447552706,0.2664409500908689
17853,0.4983095238095237,0,1,0,408233,197377,36265,71691,1.828309681722183,0.2664419403273522
17854,0.4983095238095238,0,2,0,408235,197375,36265,71691,1.828291155656008,0.2664439208224004
17855,0.4983293650793651,0,1,0,408236,197374,36265,71691,1.8282818926229205,0.2664449110809656
17856,0.4983333333333332,0,1,0,408237,197373,36265,71691,1.8282726295898328,0.26644590134689145
17857,0.4983333333333333,58,410,58,408647,196963,36323,71633,1.8244747860239356,0.2666942173375627
17858,0.4983333333333334,1,2,1,408649,196961,36324,71632,1.8244562599577605,0.2666934730242411
17859,0.4983809523809523,0,1,0,408650,196960,36324,71632,1.824446996924673,0.26669446595579915
17860,0.4984047619047619,1,2,1,408652,196958,36325,71631,1.824428470858498,0.26669372163416966
17861,0.498452380952381,0,2,0,408654,196956,36325,71631,1.8244099447923228,0.2666957075361056
17862,0.4984761904761904,0,1,0,408655,196955,36325,71631,1.8244006817592353,0.26669670049816446
17863,0.4984999999999999,0,3,0,408658,196952,36325,71631,1.8243728926599725,0.2666996794287055
17864,0.4985,6,21,6,408679,196931,36331,71625,1.8241783689651339,0.26670415108953066
17865,0.4985000000000001,0,1,0,408680,196930,36331,71625,1.8241691059320464,0.2667051441976504
17866,0.4985238095238095,2,0,2,408680,196930,36333,71623,1.8241691059320464,0.2666996831165543
17867,0.4985714285714286,0,4,0,408684,196926,36333,71623,1.8241320537996961,0.26670365557123654
17868,0.4985833333333333,1,0,1,408684,196926,36334,71622,1.8241320537996961,0.26670092497430625
17869,0.4985952380952381,0,5,0,408689,196921,36334,71622,1.8240857386342584,0.2667058906767259
17870,0.4986190476190475,0,1,0,408690,196920,36334,71622,1.824076475601171,0.26670688383939944
17871,0.4986190476190477,1,0,1,408690,196920,36335,71621,1.824076475601171,0.2667041531833128
17872,0.4986587301587302,0,1,0,408691,196919,36335,71621,1.8240672125680832,0.26670514634691295
17873,0.4986666666666666,5,28,5,408719,196891,36340,71616,1.8238078476416317,0.26671930340735994
17874,0.4986666666666667,1,7,1,408726,196884,36341,71615,1.8237430064100189,0.26672352597216376
17875,0.4986785714285714,1,1,1,408727,196883,36342,71614,1.8237337433769314,0.2667217883253817
17876,0.4986904761904762,0,2,0,408729,196881,36342,71614,1.8237152173107563,0.2667237751168551
17877,0.4986984126984126,0,1,0,408730,196880,36342,71614,1.8237059542776686,0.2667247685236914
17878,0.4987499999999999,0,1,0,408731,196879,36342,71614,1.8236966912445811,0.26672576193792763
17879,0.49875,0,4,0,408735,196875,36342,71614,1.8236596391122308,0.2667297356688728
17880,0.4987500000000001,0,2,0,408737,196873,36342,71614,1.8236411130460557,0.26673172257874683
17881,0.4987738095238096,1,2,1,408739,196871,36343,71613,1.8236225869798808,0.26673097838232446
17882,0.4987857142857143,0,3,0,408742,196868,36343,71613,1.823594797880618,0.2667339588276265
17883,0.4988095238095238,0,5,0,408747,196863,36343,71613,1.8235484827151802,0.26673892638448127
17884,0.4988333333333332,0,7,0,408754,196856,36343,71613,1.8234836414835673,0.26674588127493304
17885,0.4988333333333333,0,12,0,408766,196844,36343,71613,1.8233724850865167,0.26675780478810385
17886,0.4988333333333334,0,1,0,408767,196843,36343,71613,1.8233632220534293,0.26675879846231787
17887,0.4988571428571429,0,1,0,408768,196842,36343,71613,1.8233539590203416,0.26675979214393475
17888,0.4988888888888889,0,1,0,408769,196841,36343,71613,1.8233446959872541,0.2667607858329546
17889,0.498892857142857,0,1,0,408770,196840,36343,71613,1.8233354329541664,0.2667617795293776
17890,0.4988968253968253,0,1,0,408771,196839,36343,71613,1.823326169921079,0.2667627732332037
17891,0.4989285714285714,0,2,0,408773,196837,36343,71613,1.8233076438549038,0.26676476066306576
17892,0.4989523809523809,1,1,1,408774,196836,36344,71612,1.8232983808218164,0.2667630230063178
17893,0.4989999999999999,0,3,0,408777,196833,36344,71612,1.8232705917225536,0.26676600420942836
17894,0.499,11,68,11,408845,196765,36355,71601,1.8226407054726,0.26680354441322673
17895,0.4990476190476189,1,0,1,408845,196765,36356,71600,1.8226407054726,0.2668008123264956
17896,0.4990476190476191,0,6,0,408851,196759,36356,71600,1.8225851272740745,0.26680677748836445
17897,0.4990714285714286,0,1,0,408852,196758,36356,71600,1.822575864240987,0.2668077717079424
17898,0.499079365079365,0,4,0,408856,196754,36356,71600,1.8225388121086368,0.2668117486603516
17899,0.4990873015873016,0,2,0,408858,196752,36356,71600,1.8225202860424616,0.266813737181016
17900,0.4991111111111111,0,1,0,408859,196751,36356,71600,1.8225110230093742,0.26681473145246337
17901,0.4991190476190475,0,1,0,408860,196750,36356,71600,1.8225017599762867,0.26681572573132106
17902,0.4991666666666666,10,68,10,408928,196682,36366,71590,1.8218718737263329,0.2668560267191507
17903,0.4991666666666667,13,40,13,408968,196642,36379,71577,1.8215013524028307,0.26686028953951807
17904,0.4991706349206349,0,1,0,408969,196641,36379,71577,1.8214920893697433,0.26686128447755186
17905,0.4991785714285715,0,1,0,408970,196640,36379,71577,1.8214828263366556,0.2668622794230045
17906,0.4992023809523809,0,1,0,408971,196639,36379,71577,1.8214735633035681,0.26686327437587615
17907,0.4992063492063493,0,1,0,408972,196638,36379,71577,1.8214643002704807,0.26686426933616686
17908,0.4992142857142856,0,1,0,408973,196637,36379,71577,1.821455037237393,0.26686526430387675
17909,0.4992272727272727,0,1,0,408974,196636,36379,71577,1.8214457742043055,0.26686625927900587
17910,0.4992380952380952,0,1,0,408975,196635,36379,71577,1.8214365111712179,0.2668672542615543
17911,0.4992619047619047,0,1,0,408976,196634,36379,71577,1.8214272481381304,0.26686824925152214
17912,0.4992857142857142,0,2,0,408978,196632,36379,71577,1.8214087220719553,0.26687023925371633
17913,0.4992857142857143,1,8,1,408986,196624,36380,71576,1.8213346178072547,0.26687546607009693
17914,0.4993095238095238,1,0,1,408986,196624,36381,71575,1.8213346178072547,0.2668727325605241
17915,0.4993333333333333,4,49,4,409035,196575,36385,71571,1.8208807291859646,0.26691056364816185
17916,0.4993452380952382,0,1,0,409036,196574,36385,71571,1.820871466152877,0.2669115590445468
17917,0.4993625492154904,0,1,0,409037,196573,36385,71571,1.8208622031197896,0.2669125544483561
17918,0.4993650793650793,0,1,0,409038,196572,36385,71571,1.820852940086702,0.26691354985958987
17919,0.4993809523809524,0,2,0,409040,196570,36385,71571,1.8208344140205268,0.26691554070433093
17920,0.4993888888888888,0,1,0,409041,196569,36385,71571,1.8208251509874394,0.26691653613783844
17921,0.4994444444444444,0,1,0,409042,196568,36385,71571,1.8208158879543517,0.26691753157877074
17922,0.4994642857142857,0,1,0,409043,196567,36385,71571,1.8208066249212642,0.2669185270271278
17923,0.4994761904761905,1,1,1,409044,196566,36386,71570,1.8207973618881768,0.2669167884953904
17924,0.4994927572427571,1,3,1,409047,196563,36387,71569,1.820769572788914,0.2669170408604717
17925,0.4995,3,15,3,409062,196548,36390,71566,1.8206306272926007,0.2669237712316403
17926,0.4995238095238095,1,3,1,409065,196545,36391,71565,1.8206028381933381,0.2669240237216068
17927,0.499547619047619,0,2,0,409067,196543,36391,71565,1.820584312127163,0.2669260148895221
17928,0.4995476190476191,0,1,0,409068,196542,36391,71565,1.8205750490940753,0.2669270104846199
17929,0.4995714285714285,1,0,1,409068,196542,36392,71564,1.8205750490940753,0.26692427621910736
17930,0.4995714285714286,0,2,0,409070,196540,36392,71564,1.8205565230279002,0.2669262674186137
17931,0.4995833333333332,0,1,0,409071,196539,36392,71564,1.8205472599948127,0.2669272630295073
17932,0.4995833333333334,0,5,0,409076,196534,36392,71564,1.820500944829375,0.2669322411953838
17933,0.4996190476190476,1,1,1,409077,196533,36393,71563,1.8204916817962873,0.2669305025065648
17934,0.4996190476190477,0,1,0,409078,196532,36393,71563,1.8204824187631998,0.26693149816296463
17935,0.4996428571428571,0,3,0,409081,196529,36393,71563,1.8204546296639372,0.26693448517673035
17936,0.4996666666666666,2,8,2,409089,196521,36395,71561,1.8203805253992367,0.26693698196820376
17937,0.4996666666666667,2,23,2,409112,196498,36397,71559,1.820167475638223,0.26695441641143486
17938,0.4996904761904763,0,2,0,409114,196496,36397,71559,1.820148949572048,0.26695640819980976
17939,0.4997142857142856,0,1,0,409115,196495,36397,71559,1.8201396865389603,0.266957404105143
17940,0.4997142857142858,0,1,0,409116,196494,36397,71559,1.8201304235058728,0.2669584000179069
17941,0.4997261904761904,0,2,0,409118,196492,36397,71559,1.8201118974396977,0.26696039186572706
17942,0.49975,0,2,0,409120,196490,36397,71559,1.8200933713735226,0.2669623837432708
17943,0.4997619047619047,1,1,1,409121,196489,36398,71558,1.820084108340435,0.26696064496151795
17944,0.4997802197802198,0,1,0,409122,196488,36398,71558,1.8200748453073474,0.2669616409123807
17945,0.4997857142857143,0,4,0,409126,196484,36398,71558,1.8200377931749971,0.26696562479014485
17946,0.4998095238095238,0,2,0,409128,196482,36398,71558,1.820019267108822,0.26696761677361586
17947,0.4998214285714285,0,1,0,409129,196481,36398,71558,1.8200100040757345,0.2669686127764989
17948,0.4998333333333333,7,10,7,409139,196471,36405,71551,1.819917373744859,0.2669594287036139
17949,0.4998333333333334,0,2,0,409141,196469,36405,71551,1.819898847678684,0.2669614207894933
17950,0.4998809523809523,1,3,1,409144,196466,36406,71550,1.8198710585794213,0.26696167392991466
17951,0.4998809523809524,0,2,0,409146,196464,36406,71550,1.8198525325132462,0.2669636660771452
17952,0.499904761904762,1,0,1,409146,196464,36407,71549,1.8198525325132462,0.2669609309996157
17953,0.4999195526695527,0,1,0,409147,196463,36407,71549,1.8198432694801585,0.266961927077892
17954,0.4999444444444444,1,0,1,409147,196463,36408,71548,1.8198432694801585,0.2669591919734638
17955,0.499952380952381,0,1,0,409148,196462,36408,71548,1.819834006447071,0.2669601880526846
17956,0.4999761904761905,1,2,1,409150,196460,36409,71547,1.819815480380896,0.2669594450891208
17957,0.4999999999999999,5,32,5,409182,196428,36414,71542,1.8195190633220941,0.26697764675150204
17958,0.5,477,2976,477,412158,193452,36891,71065,1.791952276853533,0.2686594812431715
17959,0.5000000000000001,1,17,1,412175,193435,36892,71064,1.7917948052910444,0.26867398364455064
17960,0.5000238095238095,0,1,0,412176,193434,36892,71064,1.791785542257957,0.268674999432888
17961,0.5000476190476191,0,2,0,412178,193432,36892,71064,1.7917670161917818,0.26867703103260543
17962,0.5000555555555555,0,1,0,412179,193431,36892,71064,1.7917577531586943,0.2686780468439857
17963,0.5001428571428572,1,0,1,412179,193431,36893,71063,1.7917577531586943,0.26867528185894574
17964,0.5001666666666665,0,1,0,412180,193430,36893,71063,1.7917484901256067,0.26867629767139395
17965,0.5001666666666666,3,16,3,412196,193414,36896,71060,1.7916002815962058,0.2686842562974054
17966,0.5001666666666668,1,2,1,412198,193412,36897,71059,1.7915817555300309,0.2686835229571484
17967,0.5002380952380953,0,2,0,412200,193410,36897,71059,1.7915632294638557,0.2686855548287323
17968,0.5002619047619047,0,1,0,412201,193409,36897,71059,1.791553966430768,0.2686865707760485
17969,0.5002777777777777,0,1,0,412202,193408,36897,71059,1.7915447033976806,0.26868758673104776
17970,0.5002857142857142,0,2,0,412204,193406,36897,71059,1.7915261773315054,0.26868961866409546
17971,0.5002857142857143,0,2,0,412206,193404,36897,71059,1.7915076512653303,0.2686916506278761
17972,0.5003095238095238,1,2,1,412208,193402,36898,71058,1.7914891251991552,0.26869091734099676
17973,0.5003333333333333,4,11,4,412219,193391,36902,71054,1.7913872318351922,0.26869103216169715
17974,0.5003333333333334,2,8,2,412227,193383,36904,71052,1.7913131275704917,0.26869362981451017
17975,0.500357142857143,1,0,1,412227,193383,36905,71051,1.7913131275704917,0.26869086426102545
17976,0.5003928571428571,0,1,0,412228,193382,36905,71051,1.7913038645374042,0.26869188036288966
17977,0.5004166666666666,1,3,1,412231,193379,36906,71050,1.7912760754381414,0.26869216311372807
17978,0.5004166666666667,0,2,0,412233,193377,36906,71050,1.7912575493719665,0.2686941953733923
17979,0.5004285714285713,0,1,0,412234,193376,36906,71050,1.7912482863388788,0.26869521151475273
17980,0.5004761904761904,1,1,1,412235,193375,36907,71049,1.7912390233057913,0.2686934620155508
17981,0.5004761904761905,0,5,0,412240,193370,36907,71049,1.7911927081403536,0.26869854284298783
17982,0.5005,3,12,3,412252,193358,36910,71046,1.7910815517433027,0.2687024402051406
17983,0.5005000000000001,0,3,0,412255,193355,36910,71046,1.7910537626440401,0.26870548901100977
17984,0.5005476190476191,0,1,0,412256,193354,36910,71046,1.7910444996109527,0.26870650529500756
17985,0.5005555555555555,0,1,0,412257,193353,36910,71046,1.791035236577865,0.26870752158669287
17986,0.5005714285714286,0,2,0,412259,193351,36910,71046,1.7910167105116899,0.26870955419312625
17987,0.5005833333333334,0,2,0,412261,193349,36910,71046,1.7909981844455147,0.2687115868303107
17988,0.5005873015873017,0,1,0,412262,193348,36910,71046,1.7909889214124273,0.2687126031604348
17989,0.5005952380952381,0,1,0,412263,193347,36910,71046,1.7909796583793398,0.2687136194982469
17990,0.5006071428571429,0,2,0,412265,193345,36910,71046,1.7909611323131647,0.2687156521969356
17991,0.5006428571428572,0,1,0,412266,193344,36910,71046,1.790951869280077,0.26871666855781234
17992,0.5006666666666666,4,41,4,412307,193303,36914,71042,1.7905720849234874,0.2687472810153398
17993,0.5006666666666667,2,11,2,412318,193292,36916,71040,1.7904701915595242,0.2687529319189504
17994,0.500686274509804,0,1,0,412319,193291,36916,71040,1.7904609285264368,0.2687539486477182
17995,0.5007142857142857,3,5,3,412324,193286,36919,71037,1.7904146133609988,0.268750733004695
17996,0.5007142857142858,1,0,1,412324,193286,36920,71036,1.7904146133609988,0.2687479664954109
17997,0.50075,0,1,0,412325,193285,36920,71036,1.7904053503279114,0.2687489832438588
17998,0.500757215007215,0,1,0,412326,193284,36920,71036,1.790396087294824,0.26875
17999,0.5007857142857143,0,2,0,412328,193282,36920,71036,1.7903775612286488,0.2687520335353627
18000,0.5008333333333332,11,47,11,412375,193235,36931,71025,1.7899421986735338,0.26876939377885417
18001,0.5008333333333334,14,63,14,412438,193172,36945,71011,1.7893586275890176,0.26879473698156203
18002,0.5008412698412699,0,1,0,412439,193171,36945,71011,1.7893493645559302,0.2687957544420135
18003,0.5008571428571428,0,2,0,412441,193169,36945,71011,1.789330838489755,0.26879778938602467
18004,0.5008787878787878,0,1,0,412442,193168,36945,71011,1.7893215754566676,0.26879880686958463
18005,0.5009166666666666,0,1,0,412443,193167,36945,71011,1.78931231242358,0.2687998243608476
18006,0.5009285714285715,0,1,0,412444,193166,36945,71011,1.7893030493904925,0.2688008418598137
18007,0.5009523809523809,0,1,0,412445,193165,36945,71011,1.7892937863574048,0.26880185936648293
18008,0.500952380952381,0,1,0,412446,193164,36945,71011,1.7892845233243173,0.26880287688085547
18009,0.5009761904761905,0,2,0,412448,193162,36945,71011,1.7892659972581422,0.2688049119327108
18010,0.5009761904761906,0,1,0,412449,193161,36945,71011,1.7892567342250547,0.26880592947019366
18011,0.5009761904761907,0,2,0,412451,193159,36945,71011,1.7892382081588796,0.26880796456827044
18012,0.5009920634920635,0,1,0,412452,193158,36945,71011,1.789228945125792,0.2688089821288645
18013,0.5009999999999999,2,5,2,412457,193153,36947,71009,1.7891826299603542,0.2688085341570703
18014,0.501,11,73,11,412530,193080,36958,70998,1.7885064285449628,0.2688523845227546
18015,0.5010000000000001,1,4,1,412534,193076,36959,70997,1.7884693764126125,0.2688536881847065
18016,0.5010238095238095,0,1,0,412535,193075,36959,70997,1.788460113379525,0.26885470629222336
18017,0.501030303030303,1,0,1,412535,193075,36960,70996,1.788460113379525,0.2688519375470991
18018,0.5010357142857143,0,1,0,412536,193074,36960,70996,1.7884508503464374,0.26885295565569733
18019,0.5010454545454546,0,1,0,412537,193073,36960,70996,1.78844158731335,0.26885397377200654
18020,0.5010714285714285,1,3,1,412540,193070,36961,70995,1.7884137982140873,0.26885425936795865
18021,0.5010714285714286,0,1,0,412541,193069,36961,70995,1.7884045351809996,0.2688552775084828
18022,0.5010909090909091,0,1,0,412542,193068,36961,70995,1.7883952721479122,0.26885629565671826
18023,0.5011111111111111,1,1,1,412543,193067,36962,70994,1.7883860091148245,0.26885454497256317
18024,0.5011111111111112,0,1,0,412544,193066,36962,70994,1.788376746081737,0.26885556312959175
18025,0.5011190476190476,0,1,0,412545,193065,36962,70994,1.7883674830486493,0.26885658129433193
18026,0.5011190476190477,0,1,0,412546,193064,36962,70994,1.7883582200155619,0.26885759946678384
18027,0.5011428571428572,1,0,1,412546,193064,36963,70993,1.7883582200155619,0.2688548305858205
18028,0.5011666666666666,0,11,0,412557,193053,36963,70993,1.7882563266515987,0.268866030918855
18029,0.5011666666666668,1,0,1,412557,193053,36964,70992,1.7882563266515987,0.2688632619439868
18030,0.5011785714285715,0,1,0,412558,193052,36964,70992,1.7882470636185113,0.26886428019572495
18031,0.5011904761904762,0,5,0,412563,193047,36964,70992,1.7882007484530735,0.268869371570109
18032,0.5012142857142856,0,1,0,412564,193046,36964,70992,1.7881914854199858,0.26887038986812506
18033,0.501218253968254,0,1,0,412565,193045,36964,70992,1.7881822223868984,0.2688714081738544
18034,0.50125,1,5,1,412570,193040,36965,70991,1.7881359072214607,0.26887373073616355
18035,0.5012857142857143,1,0,1,412570,193040,36966,70990,1.7881359072214607,0.2688709616331478
18036,0.5013095238095238,1,1,1,412571,193039,36967,70989,1.788126644188373,0.2688692108412744
18037,0.5013333333333333,6,30,6,412601,193009,36973,70983,1.7878487531957463,0.26888314797418106
18038,0.5013333333333334,1,7,1,412608,193002,36974,70982,1.7877839119641334,0.2688875083338384
18039,0.5013571428571428,1,1,1,412609,193001,36975,70981,1.787774648931046,0.2688857573622444
18040,0.5013809523809524,0,3,0,412612,192998,36975,70981,1.7877468598317834,0.2688888131252865
18041,0.5013888888888889,0,2,0,412614,192996,36975,70981,1.7877283337656082,0.2688908503392341
18042,0.5014285714285713,0,2,0,412616,192994,36975,70981,1.787709807699433,0.2688928875840515
18043,0.5014285714285714,0,2,0,412618,192992,36975,70981,1.787691281633258,0.2688949248597394
18044,0.5014523809523809,0,1,0,412619,192991,36975,70981,1.7876820186001705,0.2688959435091601
18045,0.5014581529581528,0,1,0,412620,192990,36975,70981,1.7876727555670828,0.26889696216629855
18046,0.5014642857142857,1,1,1,412621,192989,36976,70980,1.7876634925339954,0.2688952111801007
18047,0.5014761904761904,0,2,0,412623,192987,36976,70980,1.7876449664678202,0.2688972485197013
18048,0.5015,2,24,2,412647,192963,36978,70978,1.787422653673719,0.26891615929317536
18049,0.5015000000000001,0,1,0,412648,192962,36978,70978,1.7874133906406313,0.2689171781465485
18050,0.5015039682539684,1,2,1,412650,192960,36979,70977,1.7873948645744562,0.26891644597006104
18051,0.5015238095238095,0,1,0,412651,192959,36979,70977,1.7873856015413687,0.2689174648399612
18052,0.5015443722943723,0,2,0,412653,192957,36979,70977,1.7873670754751936,0.26891950260292347
18053,0.5015555555555555,0,1,0,412654,192956,36979,70977,1.7873578124421061,0.2689205214959857
18054,0.5015714285714286,0,1,0,412655,192955,36979,70977,1.7873485494090184,0.26892154039676885
18055,0.5015952380952381,0,1,0,412656,192954,36979,70977,1.787339286375931,0.268922559305273
18056,0.5016111111111111,0,1,0,412657,192953,36979,70977,1.7873300233428433,0.26892357822149815
18057,0.5016190476190476,0,2,0,412659,192951,36979,70977,1.7873114972766684,0.26892561607711196
18058,0.5016428571428572,0,3,0,412662,192948,36979,70977,1.7872837081774056,0.26892867291844275
18059,0.5016547619047619,0,1,0,412663,192947,36979,70977,1.787274445144318,0.268929691880996
18060,0.5016666666666666,31,223,31,412886,192724,37010,70946,1.7852087887657935,0.26907118746918496
18061,0.5016666666666667,22,150,22,413036,192574,37032,70924,1.7838193338026604,0.2691633333080327
18062,0.5016944444444446,0,1,0,413037,192573,37032,70924,1.7838100707695728,0.26916435481238876
18063,0.5017142857142857,0,6,0,413043,192567,37032,70924,1.7837544925710476,0.2691704840013511
18064,0.5017222222222222,0,1,0,413044,192566,37032,70924,1.7837452295379599,0.2691715055599833
18065,0.5017460317460317,0,3,0,413047,192563,37032,70924,1.7837174404386973,0.2691745702824048
18066,0.5017777777777778,0,1,0,413048,192562,37032,70924,1.7837081774056096,0.2691755918720539
18067,0.5017857142857143,1,3,1,413051,192559,37033,70923,1.783680388306347,0.2691758829825187
18068,0.5018333333333334,1,13,1,413064,192546,37034,70922,1.783559968876209,0.2691863907571318
18069,0.5018571428571428,0,2,0,413066,192544,37034,70922,1.7835414428100338,0.2691884341812606
18070,0.5019047619047619,2,4,2,413070,192540,37036,70920,1.7835043906776835,0.2691869733545889
18071,0.5019444444444444,1,0,1,413070,192540,37037,70919,1.7835043906776835,0.2691841994390019
18072,0.5019999999999999,0,1,0,413071,192539,37037,70919,1.783495127644596,0.2691852211737734
18073,0.502,15,66,15,413137,192473,37052,70904,1.7828837674608173,0.2692110548757105
18074,0.5020000000000001,1,6,1,413143,192467,37053,70903,1.7828281892622921,0.2692144131829745
18075,0.502015873015873,0,1,0,413144,192466,37053,70903,1.7828189262292045,0.26921543537773995
18076,0.5020238095238095,1,2,1,413146,192464,37054,70902,1.7828004001630293,0.2692147050112771
18077,0.5020476190476191,1,0,1,413146,192464,37055,70901,1.7828004001630293,0.269211930210924
18078,0.5020555555555556,0,1,0,413147,192463,37055,70901,1.7827911371299419,0.26921295241566806
18079,0.5020833333333333,1,4,1,413151,192459,37056,70900,1.7827540849975916,0.2692142664575731
18080,0.5020873015873015,0,1,0,413152,192458,37056,70900,1.7827448219645041,0.2692152886944767
18081,0.502095238095238,0,2,0,413154,192456,37056,70900,1.782726295898329,0.26921733319157337
18082,0.5021111111111111,0,1,0,413155,192455,37056,70900,1.7827170328652413,0.26921835545176664
18083,0.5021428571428571,1,9,1,413164,192446,37057,70899,1.7826336655674535,0.26922478118058063
18084,0.5021666666666667,2,11,2,413175,192435,37059,70897,1.7825317722034904,0.26923047711633985
18085,0.5021666666666668,0,1,0,413176,192434,37059,70897,1.7825225091704027,0.269231499519616
18086,0.5022222222222222,0,3,0,413179,192431,37059,70897,1.78249472007114,0.26923456677603597
18087,0.50225,0,3,0,413182,192428,37059,70897,1.7824669309718775,0.269237634102345
18088,0.5022619047619048,1,2,1,413184,192426,37060,70896,1.7824484049057023,0.2692369038667487
18089,0.5022817460317459,0,1,0,413185,192425,37060,70896,1.7824391418726149,0.26923792633325866
18090,0.5022857142857142,1,3,1,413188,192422,37061,70895,1.782411352773352,0.26923821857305075
18091,0.5023095238095238,0,2,0,413190,192420,37061,70895,1.782392826707177,0.26924026356265307
18092,0.5023214285714286,0,1,0,413191,192419,37061,70895,1.7823835636740895,0.2692412860691038
18093,0.5023333333333333,2,28,2,413219,192391,37063,70893,1.782124198747638,0.2692643685146078
18094,0.5023333333333334,0,1,0,413220,192390,37063,70893,1.7821149357145503,0.26926539123300786
18095,0.5023571428571428,0,1,0,413221,192389,37063,70893,1.7821056726814628,0.26926641395917683
18096,0.5023809523809524,0,2,0,413223,192387,37063,70893,1.7820871466152877,0.26926845943482225
18097,0.5024047619047619,0,1,0,413224,192386,37063,70893,1.7820778835822002,0.2692694821842988
18098,0.5024285714285714,1,0,1,413224,192386,37064,70892,1.7820778835822002,0.2692667066750735
18099,0.5024761904761905,0,1,0,413225,192385,37064,70892,1.7820686205491125,0.26926772942566196
18100,0.5025,57,309,57,413534,192076,37121,70835,1.7792063433250584,0.2694257752623511
18101,0.5025000000000001,0,10,0,413544,192066,37121,70835,1.7791137129941827,0.2694360234460881
18102,0.5025238095238095,0,2,0,413546,192064,37121,70835,1.7790951869280076,0.26943807317639096
18103,0.502547619047619,0,1,0,413547,192063,37121,70835,1.7790859238949202,0.2694390980532374
18104,0.5025476190476191,0,3,0,413550,192060,37121,70835,1.7790581347956576,0.2694421727305578
18105,0.5025833333333333,0,1,0,413551,192059,37121,70835,1.7790488717625699,0.269443197638592
18106,0.5026190476190476,0,6,0,413557,192053,37121,70835,1.7789932935640447,0.26944934725054015
18107,0.5026313131313132,0,1,0,413558,192052,37121,70835,1.778984030530957,0.2694503722131562
18108,0.5026547619047619,1,0,1,413558,192052,37122,70834,1.778984030530957,0.2694475932533494
18109,0.5026666666666666,0,1,0,413559,192051,37122,70834,1.7789747674978695,0.2694486182170911
18110,0.5026666666666667,9,45,9,413604,192006,37131,70825,1.7785579310089297,0.26946973530519613
18111,0.5027014652014653,0,1,0,413605,192005,37131,70825,1.778548667975842,0.26947076056766733
18112,0.5027063492063493,0,2,0,413607,192003,37131,70825,1.7785301419096669,0.269472811116015
18113,0.5027142857142857,1,2,1,413609,192001,37132,70824,1.7785116158434917,0.26947208218396274
18114,0.5027380952380952,0,1,0,413610,192000,37132,70824,1.7785023528104043,0.26947310747876907
18115,0.5027380952380953,0,2,0,413612,191998,37132,70824,1.7784838267442291,0.26947515809178835
18116,0.50275,0,1,0,413613,191997,37132,70824,1.7784745637111417,0.26947618341000146
18117,0.5027777777777778,0,2,0,413615,191995,37132,70824,1.7784560376449665,0.2694782340698351
18118,0.5027857142857143,0,1,0,413616,191994,37132,70824,1.7784467746118788,0.26947925941145584
18119,0.5027976190476191,0,1,0,413617,191993,37132,70824,1.7784375115787914,0.26948028476087926
18120,0.5028333333333334,2,7,2,413624,191986,37134,70822,1.7783726703471785,0.26948190313841286
18121,0.5028461538461538,0,1,0,413625,191985,37134,70822,1.7783634073140908,0.26948292853691114
18122,0.5028571428571429,2,9,2,413634,191976,37136,70820,1.778280040016303,0.2694865979695277
18123,0.5029047619047619,0,6,0,413640,191970,37136,70820,1.7782244618177776,0.2694927508657103
18124,0.502904761904762,0,1,0,413641,191969,37136,70820,1.7782151987846901,0.26949377637572347
18125,0.5029166666666667,0,2,0,413643,191967,37136,70820,1.778196672718515,0.26949582741916456
18126,0.5029761904761905,0,3,0,413646,191964,37136,70820,1.7781688836192522,0.2694989040428641
18127,0.503,10,45,10,413691,191919,37146,70810,1.7777520471303123,0.2695172592290916
18128,0.5030476190476191,0,1,0,413692,191918,37146,70810,1.7777427840972249,0.26951828507049114
18129,0.5030595238095238,0,1,0,413693,191917,37146,70810,1.7777335210641372,0.26951931091969994
18130,0.503095238095238,0,5,0,413698,191912,37146,70810,1.7776872058986994,0.2695244402828846
18131,0.5030952380952382,1,0,1,413698,191912,37147,70809,1.7776872058986994,0.26952165985969906
18132,0.5031428571428571,0,1,0,413699,191911,37147,70809,1.777677942865612,0.2695226857490865
18133,0.5031666666666665,0,1,0,413700,191910,37147,70809,1.7776686798325243,0.2695237116462837
18134,0.5031666666666667,1,16,1,413716,191894,37148,70808,1.7775204713031234,0.269537346499075
18135,0.5032380952380953,1,1,1,413717,191893,37149,70807,1.777511208270036,0.26953559192995813
18136,0.50325,0,1,0,413718,191892,37149,70807,1.7775019452369485,0.2695366179543889
18137,0.5032857142857143,0,1,0,413719,191891,37149,70807,1.7774926822038608,0.26953764398663105
18138,0.5033095238095238,0,3,0,413722,191888,37149,70807,1.7774648931045982,0.26954072213022706
18139,0.5033214285714286,1,0,1,413722,191888,37150,70806,1.7774648931045982,0.26953794148324667
18140,0.5033333333333333,54,269,54,413991,191619,37204,70752,1.774973137204046,0.26966394914072056
18141,0.5033333333333334,59,348,59,414339,191271,37263,70693,1.7717496016895773,0.2698576903696691
18142,0.5033809523809524,0,1,0,414340,191270,37263,70693,1.7717403386564896,0.26985872050633103
18143,0.5034166666666667,0,1,0,414341,191269,37263,70693,1.7717310756234022,0.26985975065085777
18144,0.5034404761904762,0,2,0,414343,191267,37263,70693,1.771712549557227,0.26986181096350587
18145,0.503452380952381,0,2,0,414345,191265,37263,70693,1.7716940234910519,0.2698638713076142
18146,0.5034523809523811,0,3,0,414348,191262,37263,70693,1.7716662343917893,0.2698669618827661
18147,0.5034761904761905,0,1,0,414349,191261,37263,70693,1.7716569713587016,0.26986799209021434
18148,0.5035,1,5,1,414354,191256,37264,70692,1.7716106561932639,0.2698703559485089
18149,0.5035000000000001,4,20,4,414374,191236,37268,70688,1.771425395531513,0.2698798124646844
18150,0.5035238095238095,1,0,1,414374,191236,37269,70687,1.771425395531513,0.26987702492717325
18151,0.5035238095238096,0,2,0,414376,191234,37269,70687,1.7714068694653378,0.2698790856785061
18152,0.5035714285714286,1,1,1,414377,191233,37270,70686,1.77139760643225,0.2698773284870513
18153,0.5035793650793651,0,2,0,414379,191231,37270,70686,1.7713790803660752,0.26987938927217403
18154,0.5035833333333333,0,1,0,414380,191230,37270,70686,1.7713698173329875,0.26988041967653753
18155,0.5035833333333334,0,1,0,414381,191229,37270,70686,1.7713605542999,0.26988145008876924
18156,0.5036111111111111,0,2,0,414383,191227,37270,70686,1.7713420282337249,0.2698835109368378
18157,0.5036190476190475,0,1,0,414384,191226,37270,70686,1.7713327652006372,0.2698845413726748
18158,0.5036190476190476,0,5,0,414389,191221,37270,70686,1.7712864500351995,0.26988969366989046
18159,0.5036515151515152,0,1,0,414390,191220,37270,70686,1.771277187002112,0.26989072415294035
18160,0.5036666666666666,1,6,1,414396,191214,37271,70685,1.7712216088035866,0.2698941194888106
18161,0.5036666666666667,3,22,3,414418,191192,37274,70682,1.7710178220756605,0.26990842924459857
18162,0.5036666666666668,1,0,1,414418,191192,37275,70681,1.7710178220756605,0.2699056412841339
18163,0.5036785714285715,1,1,1,414419,191191,37276,70680,1.7710085590425728,0.26990388397340676
18164,0.5036825396825396,0,1,0,414420,191190,37276,70680,1.7709992960094854,0.26990491465230837
18165,0.5036904761904761,0,1,0,414421,191189,37276,70680,1.770990032976398,0.26990594533908174
18166,0.5036904761904762,0,2,0,414423,191187,37276,70680,1.7709715069102228,0.269908006736244
18167,0.5037142857142857,0,1,0,414424,191186,37276,70680,1.770962243877135,0.269909037446633
18168,0.5037301587301586,0,1,0,414425,191185,37276,70680,1.7709529808440476,0.2699100681648941
18169,0.5037499999999999,0,1,0,414426,191184,37276,70680,1.77094371781096,0.2699110988910274
18170,0.50375,0,6,0,414432,191178,37276,70680,1.7708881396124347,0.2699172834131476
18171,0.503754329004329,0,2,0,414434,191176,37276,70680,1.7708696135462596,0.2699193449835024
18172,0.5037619047619049,0,1,0,414435,191175,37276,70680,1.7708603505131721,0.2699203757804892
18173,0.5038095238095238,1,3,1,414438,191172,37277,70679,1.7708325614139093,0.26992068008142034
18174,0.5038181818181818,0,1,0,414439,191171,37277,70679,1.7708232983808219,0.26992171090318884
18175,0.5038333333333332,0,1,0,414440,191170,37277,70679,1.7708140353477342,0.26992274173283076
18176,0.5038333333333334,1,4,1,414444,191166,37278,70678,1.7707769832153841,0.2699240769313026
18177,0.5038571428571428,1,1,1,414445,191165,37279,70677,1.7707677201822964,0.26992231956676166
18178,0.5038571428571429,0,2,0,414447,191163,37279,70677,1.7707491941161213,0.2699243813015582
18179,0.5038690476190477,0,1,0,414448,191162,37279,70677,1.7707399310830338,0.26992541218076754
18180,0.5038888888888889,0,2,0,414450,191160,37279,70677,1.7707214050168587,0.2699274739628089
18181,0.5039285714285714,0,1,0,414451,191159,37279,70677,1.7707121419837712,0.2699285048656411
18182,0.503952380952381,0,1,0,414452,191158,37279,70677,1.7707028789506836,0.2699295357763477
18183,0.5039761904761905,0,1,0,414453,191157,37279,70677,1.770693615917596,0.2699305666949289
18184,0.5039761904761906,0,1,0,414454,191156,37279,70677,1.7706843528845084,0.26993159762138463
18185,0.504,23,113,23,414567,191043,37302,70654,1.769637630145615,0.26998398911718513
18186,0.5040238095238095,0,2,0,414569,191041,37302,70654,1.7696191040794398,0.2699860524656566
18187,0.504047619047619,0,2,0,414571,191039,37302,70654,1.7696005780132646,0.2699881158456665
18188,0.5040476190476191,2,4,2,414575,191035,37304,70652,1.7695635258809144,0.269986663456725
18189,0.5040606060606061,0,1,0,414576,191034,37304,70652,1.769554262847827,0.2699876951766621
18190,0.5040714285714286,1,0,1,414576,191034,37305,70651,1.769554262847827,0.26998490551617405
18191,0.5040833333333333,0,1,0,414577,191033,37305,70651,1.7695449998147392,0.26998593723727854
18192,0.5041428571428572,0,1,0,414578,191032,37305,70651,1.7695357367816518,0.26998696896626834
18193,0.5041666666666665,0,3,0,414581,191029,37305,70651,1.7695079476823892,0.2699900642005503
18194,0.5041666666666667,6,63,6,414644,190966,37311,70645,1.7689243765978733,0.27003833936646393
18195,0.5041666666666668,7,52,7,414696,190914,37318,70638,1.7684426988773203,0.27007249036520464
18196,0.5041746031746032,1,1,1,414697,190913,37319,70637,1.7684334358442328,0.2700707321735806
18197,0.5041904761904761,1,0,1,414697,190913,37320,70636,1.7684334358442328,0.2700679413800091
18198,0.5042142857142857,1,0,1,414697,190913,37321,70635,1.7684334358442328,0.27006515056509706
18199,0.5042380952380952,0,1,0,414698,190912,37321,70635,1.7684241728111454,0.270066183133433
18200,0.5042380952380953,0,1,0,414699,190911,37321,70635,1.7684149097780577,0.27006721570966485
18201,0.50425,0,1,0,414700,190910,37321,70635,1.7684056467449702,0.27006824829379267
18202,0.5042619047619048,0,1,0,414701,190909,37321,70635,1.7683963837118826,0.27006928088581655
18203,0.5042857142857142,0,1,0,414702,190908,37321,70635,1.768387120678795,0.27007031348573657
18204,0.5042857142857143,2,6,2,414708,190902,37323,70633,1.7683315424802697,0.27007092740933336
18205,0.5042976190476192,0,1,0,414709,190901,37323,70633,1.7683222794471822,0.27007196005108325
18206,0.5043095238095238,0,1,0,414710,190900,37323,70633,1.7683130164140946,0.27007299270072993
18207,0.5043333333333332,1,0,1,414710,190900,37324,70632,1.7683130164140946,0.2700702017343958
18208,0.5043333333333333,0,10,0,414720,190890,37324,70632,1.768220386083219,0.2700805285979765
18209,0.5043333333333334,3,21,3,414741,190869,37327,70629,1.7680258623883804,0.2700938439299727
18210,0.5043636363636363,0,1,0,414742,190868,37327,70629,1.768016599355293,0.27009487680547006
18211,0.5043809523809524,0,2,0,414744,190866,37327,70629,1.7679980732891178,0.27009694258016403
18212,0.5043928571428572,1,1,1,414745,190865,37328,70628,1.7679888102560302,0.2700951841923111
18213,0.5043968253968254,0,1,0,414746,190864,37328,70628,1.7679795472229427,0.2700962170926835
18214,0.504404761904762,1,0,1,414746,190864,37329,70627,1.7679795472229427,0.27009342577756024
18215,0.5044166666666666,0,1,0,414747,190863,37329,70627,1.767970284189855,0.2700944586791082
18216,0.5044444444444445,2,2,2,414749,190861,37331,70625,1.76795175812368,0.2700909417712612
18217,0.5044761904761904,1,1,1,414750,190860,37332,70624,1.7679424950905924,0.2700891832769883
18218,0.5044761904761905,0,1,0,414751,190859,37332,70624,1.767933232057505,0.27009021618996265
18219,0.5044880952380951,0,1,0,414752,190858,37332,70624,1.7679239690244173,0.2700912491108375
18220,0.5045,2,3,2,414755,190855,37334,70622,1.7678961799251547,0.27008876497741674
18221,0.5045000000000001,6,13,6,414768,190842,37340,70616,1.7677757604950164,0.2700854439336337
18222,0.5045238095238095,0,1,0,414769,190841,37340,70616,1.767766497461929,0.2700864769350218
18223,0.5045238095238096,0,2,0,414771,190839,37340,70616,1.7677479713957538,0.2700885429615039
18224,0.5045277777777779,0,2,0,414773,190837,37340,70616,1.7677294453295787,0.27009060901959436
18225,0.5045555555555555,0,1,0,414774,190836,37340,70616,1.7677201822964912,0.27009164206049296
18226,0.5045714285714286,0,1,0,414775,190835,37340,70616,1.7677109192634035,0.2700926751092939
18227,0.5045833333333333,0,1,0,414776,190834,37340,70616,1.767701656230316,0.2700937081659973
18228,0.5046190476190475,0,2,0,414778,190832,37340,70616,1.767683130164141,0.2700957743031119
18229,0.5046666666666666,2,9,2,414787,190823,37342,70614,1.767599762866353,0.27009948859572286
18230,0.5046666666666667,1,26,1,414813,190797,37343,70613,1.7673589240060765,0.2701235606901037
18231,0.5046904761904762,0,1,0,414814,190796,37343,70613,1.767349660972989,0.2701245940269845
18232,0.5047142857142858,0,2,0,414816,190794,37343,70613,1.767331134906814,0.2701266607244642
18233,0.5047619047619047,0,1,0,414817,190793,37343,70613,1.7673218718737262,0.2701276940850631
18234,0.5048015873015873,0,1,0,414818,190792,37343,70613,1.7673126088406388,0.2701287274535682
18235,0.5048095238095238,0,1,0,414819,190791,37343,70613,1.7673033458075513,0.27012976082997964
18236,0.5048216783216783,0,1,0,414820,190790,37343,70613,1.7672940827744636,0.2701307942142975
18237,0.5048333333333332,0,1,0,414821,190789,37343,70613,1.7672848197413762,0.27013182760652177
18238,0.5048333333333334,1,12,1,414833,190777,37344,70612,1.7671736633443256,0.2701414367092724
18239,0.5048333333333335,0,1,0,414834,190776,37344,70612,1.767164400311238,0.2701424701975607
18240,0.5048690476190476,0,1,0,414835,190775,37344,70612,1.7671551372781504,0.2701435036937568
18241,0.5048809523809523,1,1,1,414836,190774,37345,70611,1.7671458742450628,0.27014174493563137
18242,0.5048809523809524,0,1,0,414837,190773,37345,70611,1.7671366112119753,0.2701427784409145
18243,0.5048852813852815,0,1,0,414838,190772,37345,70611,1.7671273481788876,0.27014381195410564
18244,0.504904761904762,0,2,0,414840,190770,37345,70611,1.7671088221127127,0.2701458790042122
18245,0.5049166666666668,0,1,0,414841,190769,37345,70611,1.767099559079625,0.2701469125411279
18246,0.5049285714285715,0,1,0,414842,190768,37345,70611,1.7670902960465376,0.27014794608595183
18247,0.5049999999999999,4,26,4,414868,190742,37349,70607,1.766849457186261,0.270163650903581
18248,0.505,185,1141,185,416009,189601,37534,70422,1.7562803364333617,0.27082988812528125
18249,0.5050000000000001,3,26,3,416035,189575,37537,70419,1.7560394975730853,0.27084855804364716
18250,0.5050238095238094,0,1,0,416036,189574,37537,70419,1.7560302345399978,0.2708495997969176
18251,0.5050238095238095,0,2,0,416038,189572,37537,70419,1.7560117084738227,0.2708516833274998
18252,0.5050238095238097,1,2,1,416040,189570,37538,70418,1.7559931824076476,0.27085096235210854
18253,0.5050317460317459,0,1,0,416041,189569,37538,70418,1.75598391937456,0.27085200413866845
18254,0.5050476190476191,1,0,1,416041,189569,37539,70417,1.75598391937456,0.27084919957228465
18255,0.5050555555555555,0,1,0,416042,189568,37539,70417,1.7559746563414724,0.27085024136007846
18256,0.5050555555555556,0,3,0,416045,189565,37539,70417,1.7559468672422098,0.2708533667715457
18257,0.5050595238095238,0,1,0,416046,189564,37539,70417,1.7559376042091221,0.2708544085913971
18258,0.5050952380952382,0,1,0,416047,189563,37539,70417,1.7559283411760347,0.270855450419263
18259,0.5051190476190476,0,3,0,416050,189560,37539,70417,1.755900552076772,0.27085857595094953
18260,0.5051428571428571,0,1,0,416051,189559,37539,70417,1.7558912890436844,0.27085961781087486
18261,0.5051666666666665,1,4,1,416055,189555,37540,70416,1.7558542369113344,0.2708609806478415
18262,0.5051666666666667,2,11,2,416066,189544,37542,70414,1.7557523435473712,0.270866832334454
18263,0.5051666666666668,1,5,1,416071,189539,37543,70413,1.7557060283819335,0.27086923739767343
18264,0.5051760461760462,1,0,1,416071,189539,37544,70412,1.7557060283819335,0.27086643251997494
18265,0.5052142857142857,0,1,0,416072,189538,37544,70412,1.7556967653488458,0.2708674745143297
18266,0.5052222222222222,0,1,0,416073,189537,37544,70412,1.7556875023157583,0.27086851651670135
18267,0.5052380952380953,0,5,0,416078,189532,37544,70412,1.7556411871503206,0.27087372664881665
18268,0.50525,1,3,1,416081,189529,37545,70411,1.7556133980510578,0.2708740478571978
18269,0.5052615440115441,0,2,0,416083,189527,37545,70411,1.7555948719848826,0.27087613200070787
18270,0.5052678571428572,1,0,1,416083,189527,37546,70410,1.7555948719848826,0.270873326998465
18271,0.5052860750360749,0,3,0,416086,189524,37546,70410,1.75556708288562,0.2708764532535182
18272,0.5053333333333332,0,1,0,416087,189523,37546,70410,1.7555578198525326,0.2708774953545721
18273,0.5053333333333333,5,16,5,416103,189507,37551,70405,1.7554096113231317,0.270880144048755
18274,0.5053333333333334,3,9,3,416112,189498,37554,70402,1.7553262440253437,0.27088110811850713
18275,0.5053455433455435,1,0,1,416112,189498,37555,70401,1.7553262440253437,0.27087830272528945
18276,0.5053571428571428,1,0,1,416112,189498,37556,70400,1.7553262440253437,0.2708754973104833
18277,0.505404761904762,0,2,0,416114,189496,37556,70400,1.7553077179591685,0.27087758180195154
18278,0.5054126984126984,1,1,1,416115,189495,37557,70399,1.755298454926081,0.2708758186029689
18279,0.5054166666666666,0,4,0,416119,189491,37557,70399,1.7552614027937308,0.27087998768709837
18280,0.5054166666666667,0,3,0,416122,189488,37557,70399,1.7552336136944682,0.27088311458441555
18281,0.5054285714285713,0,1,0,416123,189487,37557,70399,1.7552243506613805,0.27088415689956363
18282,0.5054285714285716,0,1,0,416124,189486,37557,70399,1.755215087628293,0.27088519922273313
18283,0.5054761904761904,0,2,0,416126,189484,37557,70399,1.755196561562118,0.27088728389313654
18284,0.5054761904761905,0,3,0,416129,189481,37557,70399,1.7551687724628553,0.2708904109589041
18285,0.5055,4,16,4,416145,189465,37561,70395,1.7550205639334544,0.27089586700531054
18286,0.5055000000000001,1,1,1,416146,189464,37562,70394,1.7550113009003667,0.27089410370279154
18287,0.5055021645021646,0,2,0,416148,189462,37562,70394,1.7549927748341918,0.27089618865833387
18288,0.5055238095238095,0,1,0,416149,189461,37562,70394,1.7549835118011041,0.2708972311481403
18289,0.5055454545454545,0,1,0,416150,189460,37562,70394,1.7549742487680167,0.2708982736459704
18290,0.5055476190476191,1,0,1,416150,189460,37563,70393,1.7549742487680167,0.27089546782219176
18291,0.5055555555555555,0,1,0,416151,189459,37563,70393,1.754964985734929,0.2708965103212598
18292,0.5055714285714286,0,1,0,416152,189458,37563,70393,1.7549557227018415,0.27089755282835165
18293,0.5055833333333334,0,1,0,416153,189457,37563,70393,1.7549464596687538,0.2708985953434674
18294,0.5055952380952381,1,1,1,416154,189456,37564,70392,1.7549371966356664,0.27089683199408887
18295,0.5055952380952382,0,1,0,416155,189455,37564,70392,1.754927933602579,0.27089787451846664
18296,0.5056111111111111,0,1,0,416156,189454,37564,70392,1.7549186705694912,0.2708989170508686
18297,0.5056666666666666,7,18,7,416174,189436,37571,70385,1.7547519359739152,0.27089804134384826
18298,0.5056666666666667,1,16,1,416190,189420,37572,70384,1.7546037274445145,0.27091191821527
18299,0.5056904761904762,0,2,0,416192,189418,37572,70384,1.7545852013783394,0.2709140037413107
18300,0.5057142857142857,1,20,1,416212,189398,37573,70383,1.7543999407165882,0.2709320543072819
18301,0.5057142857142858,0,1,0,416213,189397,37573,70383,1.7543906776835008,0.27093309723612286
18302,0.5057240259740259,0,1,0,416214,189396,37573,70383,1.754381414650413,0.2709341401729932
18303,0.5057380952380952,0,1,0,416215,189395,37573,70383,1.7543721516173256,0.270935183117893
18304,0.5057499999999999,0,1,0,416216,189394,37573,70383,1.754362888584238,0.2709362260708223
18305,0.5058333333333332,9,39,9,416255,189355,37582,70374,1.7540016302938235,0.27095164575384345
18306,0.5058333333333334,15,64,15,416319,189291,37597,70359,1.75340879617622,0.27097631426920854
18307,0.5058333333333335,0,2,0,416321,189289,37597,70359,1.7533902701100448,0.27097840152822283
18308,0.505857142857143,0,1,0,416322,189288,37597,70359,1.7533810070769573,0.2709794451697882
18309,0.5058809523809524,0,2,0,416324,189286,37597,70359,1.7533624810107822,0.27098153247703594
18310,0.5059047619047619,0,1,0,416325,189285,37597,70359,1.7533532179776947,0.2709825761427185
18311,0.5059285714285714,0,1,0,416326,189284,37597,70359,1.753343954944607,0.27098361981644026
18312,0.5059285714285715,0,3,0,416329,189281,37597,70359,1.7533161658453444,0.27098675088584195
18313,0.5059523809523809,2,4,2,416333,189277,37599,70357,1.7532791137129942,0.270985310090358
18314,0.505952380952381,1,2,1,416335,189275,37600,70356,1.753260587646819,0.2709845896676437
18315,0.5059761904761905,0,1,0,416336,189274,37600,70356,1.7532513246137316,0.2709856334013789
18316,0.5059999999999999,1,7,1,416343,189267,37601,70355,1.7531864833821187,0.27099013180701176
18317,0.506,11,118,11,416461,189149,37612,70344,1.7520934454777872,0.2710824569448887
18318,0.5060119047619048,1,0,1,416461,189149,37613,70343,1.7520934454777872,0.2710796479274891
18319,0.5060238095238097,0,1,0,416462,189148,37613,70343,1.7520841824446998,0.27108069258664075
18320,0.506031746031746,0,2,0,416464,189146,37613,70343,1.7520656563785246,0.2710827819290991
18321,0.5060714285714285,0,1,0,416465,189145,37613,70343,1.752056393345437,0.271083826612406
18322,0.5060714285714286,0,2,0,416467,189143,37613,70343,1.752037867279262,0.2710859160031755
18323,0.5060714285714287,0,1,0,416468,189142,37613,70343,1.7520286042461743,0.27108696071063837
18324,0.506079365079365,0,1,0,416469,189141,37613,70343,1.752019341213087,0.27108800542615347
18325,0.506095238095238,0,1,0,416470,189140,37613,70343,1.7520100781799992,0.2710890501497208
18326,0.5061111111111112,0,1,0,416471,189139,37613,70343,1.7520008151469117,0.2710900948813405
18327,0.5061428571428571,0,1,0,416472,189138,37613,70343,1.751991552113824,0.2710911396210127
18328,0.5061666666666667,2,4,2,416476,189134,37615,70341,1.751954499981474,0.27108970035648905
18329,0.5061904761904761,0,1,0,416477,189133,37615,70341,1.7519452369483863,0.2710907451228254
18330,0.5061904761904762,0,3,0,416480,189130,37615,70341,1.7519174478491237,0.27109387947015273
18331,0.50625,1,11,1,416491,189119,37616,70340,1.7518155544851606,0.27110256341078937
18332,0.5062619047619049,0,1,0,416492,189118,37616,70340,1.7518062914520731,0.27110360829112995
18333,0.5062857142857142,0,1,0,416493,189117,37616,70340,1.7517970284189854,0.2711046531795249
18334,0.5062857142857143,1,0,1,416493,189117,37617,70339,1.7517970284189854,0.2711018438579181
18335,0.5063095238095238,0,2,0,416495,189115,37617,70339,1.7517785023528103,0.27110393364527047
18336,0.5063333333333333,9,26,9,416521,189089,37626,70330,1.751537663492534,0.27110581723004096
18337,0.5063333333333334,0,7,0,416528,189082,37626,70330,1.751472822260921,0.27111313277720384
18338,0.506357142857143,0,1,0,416529,189081,37626,70330,1.7514635592278336,0.27111417788759923
18339,0.5063809523809524,0,1,0,416530,189080,37626,70330,1.751454296194746,0.2711152230060522
18340,0.5064047619047618,0,1,0,416531,189079,37626,70330,1.7514450331616584,0.27111626813256284
18341,0.5064166666666666,1,0,1,416531,189079,37627,70329,1.7514450331616584,0.2711134583359033
18342,0.5064207181707182,0,1,0,416532,189078,37627,70329,1.751435770128571,0.27111450346366905
18343,0.5064285714285713,0,2,0,416534,189076,37627,70329,1.7514172440623959,0.27111659374337427
18344,0.5064285714285715,0,1,0,416535,189075,37627,70329,1.7514079810293082,0.2711176388953139
18345,0.5064642857142857,1,3,1,416538,189072,37628,70328,1.7513801919300456,0.2711179645335389
18346,0.5064880952380952,0,2,0,416540,189070,37628,70328,1.7513616658638704,0.2711200548963369
18347,0.5064920634920635,0,1,0,416541,189069,37628,70328,1.751352402830783,0.2711211000898237
18348,0.5065,4,15,4,416556,189054,37632,70324,1.7512134573344695,0.27112553878894896
18349,0.5065000000000001,1,3,1,416559,189051,37633,70323,1.751185668235207,0.27112586458164656
18350,0.5065079365079365,0,1,0,416560,189050,37633,70323,1.7511764052021195,0.271126909894245
18351,0.5065277777777778,0,3,0,416563,189047,37633,70323,1.7511486161028567,0.2711300458804025
18352,0.506547619047619,0,5,0,416568,189042,37633,70323,1.751102300937419,0.271135272685212
18353,0.5065714285714286,0,2,0,416570,189040,37633,70323,1.7510837748712438,0.27113736346356265
18354,0.5065714285714287,0,1,0,416571,189039,37633,70323,1.7510745118381563,0.27113840886482987
18355,0.5065952380952382,0,1,0,416572,189038,37633,70323,1.7510652488050686,0.2711394542741584
18356,0.5066111111111112,0,1,0,416573,189037,37633,70323,1.7510559857719812,0.2711404996915484
18357,0.5066190476190475,0,1,0,416574,189036,37633,70323,1.7510467227388937,0.271141545117
18358,0.5066190476190477,0,1,0,416575,189035,37633,70323,1.751037459705806,0.2711425905505132
18359,0.5066428571428572,0,1,0,416576,189034,37633,70323,1.7510281966727186,0.27114363599208813
18360,0.5066666666666666,85,414,85,416990,188620,37718,70238,1.7471933009744711,0.2713379536270851
18361,0.5066666666666667,40,261,40,417251,188359,37758,70198,1.7447756493386195,0.2714991278518857
18362,0.5067142857142857,1,0,1,417251,188359,37759,70197,1.7447756493386195,0.2714963102770773
18363,0.5067182539682541,0,3,0,417254,188356,37759,70197,1.7447478602393567,0.2714994604587841
18364,0.5067619047619047,0,1,0,417255,188355,37759,70197,1.7447385972062692,0.27150051053559826
18365,0.5067857142857143,1,5,1,417260,188350,37760,70196,1.7446922820408315,0.27150294338338243
18366,0.5068333333333332,0,3,0,417263,188347,37760,70196,1.744664492941569,0.2715060937639
18367,0.5068333333333334,1,17,1,417280,188330,37761,70195,1.7445070213790803,0.27152112948457596
18368,0.5068571428571428,0,1,0,417281,188329,37761,70195,1.7444977583459929,0.2715221797589392
18369,0.5069047619047619,0,1,0,417282,188328,37761,70195,1.7444884953129052,0.27152323004142764
18370,0.5069523809523809,0,1,0,417283,188327,37761,70195,1.7444792322798177,0.2715242803320414
18371,0.5069999999999999,0,1,0,417284,188326,37761,70195,1.7444699692467303,0.2715253306307805
18372,0.507,10,29,10,417313,188297,37771,70185,1.744201341287191,0.27152761120696994
18373,0.5070649350649351,0,2,0,417315,188295,37771,70185,1.744182815221016,0.2715297121634169
18374,0.5070833333333333,0,6,0,417321,188289,37771,70185,1.7441272370224907,0.2715360152278372
18375,0.5071190476190476,0,1,0,417322,188288,37771,70185,1.744117973989403,0.271537065767024
18376,0.5071428571428571,3,9,3,417331,188279,37774,70182,1.744034606691615,0.27153806570430356
18377,0.5071428571428572,0,1,0,417332,188278,37774,70182,1.7440253436585276,0.2715391163042637
18378,0.5071666666666667,2,12,2,417344,188266,37776,70180,1.743914187261477,0.27154608699689686
18379,0.5071666666666668,0,1,0,417345,188265,37776,70180,1.7439049242283893,0.27154713768886996
18380,0.5071944444444445,0,2,0,417347,188263,37776,70180,1.7438863981622141,0.27154923909720907
18381,0.5072023809523809,0,2,0,417349,188261,37776,70180,1.7438678720960392,0.2715513405380725
18382,0.5072142857142857,1,1,1,417350,188260,37777,70179,1.7438586090629515,0.2715495726264225
18383,0.5072380952380953,0,1,0,417351,188259,37777,70179,1.743849346029864,0.27155062336034175
18384,0.50725,0,1,0,417352,188258,37777,70179,1.7438400829967764,0.27155167410239245
18385,0.5072619047619047,0,2,0,417354,188256,37777,70179,1.7438215569306013,0.2715537756108886
18386,0.5072727272727273,0,1,0,417355,188255,37777,70179,1.7438122938975138,0.27155482637733425
18387,0.5072738095238095,0,1,0,417356,188254,37777,70179,1.7438030308644263,0.2715558771519117
18388,0.5072857142857142,0,1,0,417357,188253,37777,70179,1.7437937678313387,0.2715569279346211
18389,0.5073015873015874,0,3,0,417360,188250,37777,70179,1.743765978732076,0.2715600803315417
18390,0.5073095238095238,0,1,0,417361,188249,37777,70179,1.7437567156989884,0.27156113114677977
18391,0.5073253968253968,0,1,0,417362,188248,37777,70179,1.743747452665901,0.2715621819701502
18392,0.5073333333333333,10,49,10,417411,188199,37787,70169,1.7432935640446108,0.2715854904632153
18393,0.5073333333333334,0,2,0,417413,188197,37787,70169,1.7432750379784356,0.27158759279471756
18394,0.5073809523809524,1,2,1,417415,188195,37788,70168,1.7432565119122605,0.27158687582974345
18395,0.5074722222222222,0,1,0,417416,188194,37788,70168,1.743247248879173,0.271587927017131
18396,0.5075,44,317,44,417733,187877,37832,70124,1.7403108673904184,0.2717973961341235
18397,0.5075000000000001,0,12,0,417745,187865,37832,70124,1.7401997109933676,0.27181003841249046
18398,0.5075079365079366,0,1,0,417746,187864,37832,70124,1.74019044796028,0.2718110919887747
18399,0.5075396825396825,0,1,0,417747,187863,37832,70124,1.7401811849271926,0.2718121455732266
18400,0.507547619047619,0,2,0,417749,187861,37832,70124,1.7401626588610175,0.27181425276663373
18401,0.5075595238095238,0,1,0,417750,187860,37832,70124,1.7401533958279298,0.2718153063755892
18402,0.5075714285714286,1,0,1,417750,187860,37833,70123,1.7401533958279298,0.2718124837683103
18403,0.5075833333333334,0,1,0,417751,187859,37833,70123,1.7401441327948424,0.2718135373785768
18404,0.5076190476190476,0,7,0,417758,187852,37833,70123,1.7400792915632295,0.27182091287915494
18405,0.5076428571428572,0,1,0,417759,187851,37833,70123,1.7400700285301418,0.2718219665547691
18406,0.5076666666666666,0,3,0,417762,187848,37833,70123,1.7400422394308792,0.27182512763062516
18407,0.5076666666666667,5,38,5,417800,187810,37838,70118,1.7396902441735522,0.27185105921032227
18408,0.5077142857142857,0,1,0,417801,187809,37838,70118,1.7396809811404645,0.27185211319481867
18409,0.5077142857142858,1,0,1,417801,187809,37839,70117,1.7396809811404645,0.27184929010646464
18410,0.5077380952380952,0,1,0,417802,187808,37839,70117,1.739671718107377,0.2718503440922749
18411,0.5077777777777778,1,1,1,417803,187807,37840,70116,1.7396624550742896,0.271848574962295
18412,0.5077820512820513,0,1,0,417804,187806,37840,70116,1.739653192041202,0.27184962895759185
18413,0.5077857142857143,0,1,0,417805,187805,37840,70116,1.7396439290081145,0.27185068296106174
18414,0.5078333333333332,0,1,0,417806,187804,37840,70116,1.7396346659750268,0.2718517369727047
18415,0.5078333333333334,5,10,5,417816,187794,37845,70111,1.7395420356441513,0.2718481611446075
18416,0.5078571428571428,0,2,0,417818,187792,37845,70111,1.7395235095779762,0.27185026928729017
18417,0.5078571428571429,0,6,0,417824,187786,37845,70111,1.739467931379451,0.27185659391152284
18418,0.5079242424242425,0,1,0,417825,187785,37845,70111,1.7394586683463633,0.27185764804417284
18419,0.5079285714285714,0,1,0,417826,187784,37845,70111,1.7394494053132759,0.27185870218499775
18420,0.5079545454545454,0,1,0,417827,187783,37845,70111,1.7394401422801882,0.27185975633399767
18421,0.5079761904761905,0,1,0,417828,187782,37845,70111,1.7394308792471007,0.2718608104911727
18422,0.5079999999999999,0,2,0,417830,187780,37845,70111,1.7394123531809256,0.2718629188300484
18423,0.508,22,67,22,417897,187713,37867,70089,1.7387917299640594,0.27187143621849325
18424,0.5080000000000001,0,2,0,417899,187711,37867,70089,1.7387732038978843,0.27187354538401864
18425,0.5080238095238095,0,3,0,417902,187708,37867,70089,1.7387454147986217,0.2718767091936679
18426,0.5080376845376844,0,1,0,417903,187707,37867,70089,1.7387361517655342,0.2718777638132477
18427,0.5080476190476191,1,2,1,417905,187705,37868,70088,1.738717625699359,0.27187704863980017
18428,0.5080555555555556,0,1,0,417906,187704,37868,70088,1.7387083626662714,0.2718781032770606
18429,0.5080833333333333,0,1,0,417907,187703,37868,70088,1.738699099633184,0.2718791579225031
18430,0.508095238095238,1,0,1,417907,187703,37869,70087,1.738699099633184,0.27187633344970713
18431,0.5080952380952382,2,1,2,417908,187702,37871,70085,1.7386898366000962,0.2718717390714039
18432,0.5081666666666667,0,20,0,417928,187682,37871,70085,1.7385045759383453,0.2718928334503641
18433,0.5081818181818182,0,1,0,417929,187681,37871,70085,1.7384953129052576,0.27189388825523925
18434,0.5081904761904762,0,2,0,417931,187679,37871,70085,1.7384767868390827,0.2718959978895424
18435,0.50825,0,1,0,417932,187678,37871,70085,1.738467523805995,0.2718970527189705
18436,0.5082619047619048,0,1,0,417933,187677,37871,70085,1.7384582607729075,0.2718981075565832
18437,0.5082857142857145,0,1,0,417934,187676,37871,70085,1.7384489977398199,0.2718991624023805
18438,0.5083333333333332,0,1,0,417935,187675,37871,70085,1.7384397347067324,0.2719002172563625
18439,0.5083333333333333,69,373,69,418308,187302,37940,70016,1.7349846233650748,0.2720991147140892
18440,0.5083333333333334,1,4,1,418312,187298,37941,70015,1.7349475712327245,0.2721005157143246
18441,0.5083571428571428,1,1,1,418313,187297,37942,70014,1.7349383081996368,0.2720987443210745
18442,0.508375,1,0,1,418313,187297,37943,70013,1.7349383081996368,0.27209591543274647
18443,0.5083809523809524,1,1,1,418314,187296,37944,70012,1.7349290451665493,0.2720941439830864
18444,0.508420634920635,1,1,1,418315,187295,37945,70011,1.7349197821334619,0.2720923725058879
18445,0.508452380952381,0,2,0,418317,187293,37945,70011,1.7349012560672867,0.2720944874545285
18446,0.5084761904761905,1,0,1,418317,187293,37946,70010,1.7349012560672867,0.2720916584726956
18447,0.5085,1,1,1,418318,187292,37947,70009,1.734891993034199,0.27208988694175307
18448,0.5085000000000001,7,21,7,418339,187271,37954,70002,1.7346974693393604,0.2720922910682427
18449,0.5085317460317461,0,1,0,418340,187270,37954,70002,1.734688206306273,0.27209334867377716
18450,0.5085357142857143,0,1,0,418341,187269,37954,70002,1.7346789432731853,0.2720944062875334
18451,0.508547619047619,0,1,0,418342,187268,37954,70002,1.7346696802400978,0.2720954639095114
18452,0.5085555555555556,0,1,0,418343,187267,37954,70002,1.7346604172070104,0.27209652153971137
18453,0.5085714285714286,1,9,1,418352,187258,37955,70001,1.7345770499092223,0.2721032111607368
18454,0.5085833333333333,0,1,0,418353,187257,37955,70001,1.7345677868761347,0.2721042688662743
18455,0.5085833333333334,0,2,0,418355,187255,37955,70001,1.7345492608099595,0.2721063843020182
18456,0.5085952380952381,0,1,0,418356,187254,37955,70001,1.734539997776872,0.2721074420322248
18457,0.5086111111111111,1,2,1,418358,187252,37956,70000,1.734521471710697,0.27210672803321256
18458,0.5086190476190475,0,3,0,418361,187249,37956,70000,1.7344936826114343,0.27210990130185153
18459,0.5086309523809525,0,1,0,418362,187248,37956,70000,1.7344844195783466,0.27211095907451177
18460,0.5086428571428572,0,1,0,418363,187247,37956,70000,1.7344751565452592,0.27211201685539577
18461,0.5086547619047619,0,1,0,418364,187246,37956,70000,1.7344658935121717,0.2721130746445037
18462,0.5086666666666666,1,7,1,418371,187239,37957,69999,1.7344010522805589,0.27211764980290626
18463,0.5086666666666667,4,23,4,418394,187216,37961,69995,1.734188002519545,0.2721306631520425
18464,0.5086904761904761,0,1,0,418395,187215,37961,69995,1.7341787394864574,0.27213172116169665
18465,0.5086904761904762,0,1,0,418396,187214,37961,69995,1.73416947645337,0.2721327791795777
18466,0.5087142857142858,0,2,0,418398,187212,37961,69995,1.7341509503871948,0.27213489524002066
18467,0.5087499999999999,0,1,0,418399,187211,37961,69995,1.7341416873541071,0.27213595328258283
18468,0.50875,2,3,2,418402,187208,37963,69993,1.7341138982548445,0.2721334675992706
18469,0.5088015873015873,0,1,0,418403,187207,37963,69993,1.734104635221757,0.27213452566096424
18470,0.5088095238095237,0,1,0,418404,187206,37963,69993,1.7340953721886694,0.2721355837308854
18471,0.5088095238095238,2,1,2,418405,187205,37965,69991,1.734086109155582,0.2721309818193129
18472,0.5088333333333334,2,9,2,418414,187196,37967,69989,1.734002741857794,0.2721348445671404
18473,0.5088571428571429,0,2,0,418416,187194,37967,69989,1.7339842157916188,0.27213696084111316
18474,0.5088888888888888,1,0,1,418416,187194,37968,69988,1.7339842157916188,0.2721341306934389
18475,0.5089285714285714,0,2,0,418418,187192,37968,69988,1.7339656897254436,0.27213624698654637
18476,0.5089285714285715,0,1,0,418419,187191,37968,69988,1.7339564266923562,0.27213730514544343
18477,0.5089404761904762,0,3,0,418422,187188,37968,69988,1.7339286375930936,0.272140479671509
18478,0.5089999999999999,0,4,0,418426,187184,37968,69988,1.7338915854607433,0.2721447124881402
18479,0.509,16,61,16,418487,187123,37984,69972,1.7333265404424025,0.2721639860751862
18480,0.5090000000000001,1,0,1,418487,187123,37985,69971,1.7333265404424025,0.2721611550639066
18481,0.5090476190476191,0,6,0,418493,187117,37985,69971,1.7332709622438771,0.2721675068459049
18482,0.5090555555555555,0,1,0,418494,187116,37985,69971,1.7332616992107897,0.27216856550506247
18483,0.5090833333333333,0,2,0,418496,187114,37985,69971,1.7332431731446145,0.27217068284808527
18484,0.509095238095238,0,2,0,418498,187112,37985,69971,1.7332246470784394,0.27217280022405216
18485,0.5090952380952382,0,1,0,418499,187111,37985,69971,1.733215384045352,0.2721738589243899
18486,0.5091190476190476,0,1,0,418500,187110,37985,69971,1.7332061210122642,0.2721749176329639
18487,0.5091190476190477,0,1,0,418501,187109,37985,69971,1.7331968579791768,0.27217597634977436
18488,0.5091428571428572,0,3,0,418504,187106,37985,69971,1.733169068879914,0.2721791525496252
18489,0.5091507936507937,0,1,0,418505,187105,37985,69971,1.7331598058468265,0.2721802112993823
18490,0.5091666666666665,1,2,1,418507,187103,37986,69970,1.7331412797806514,0.2721794976524178
18491,0.5091666666666667,24,93,24,418600,187010,38010,69946,1.7322798177035088,0.2722100281760301
18492,0.5091666666666668,7,52,7,418652,186958,38017,69939,1.731798139982956,0.27224529675317344
18493,0.5092261904761906,1,0,1,418652,186958,38018,69938,1.731798139982956,0.2722424638764325
18494,0.5092380952380953,0,2,0,418654,186956,38018,69938,1.731779613916781,0.272244583369016
18495,0.50925,0,1,0,418655,186955,38018,69938,1.7317703508836935,0.2722456431276835
18496,0.5092857142857143,2,5,2,418660,186950,38020,69936,1.7317240357182555,0.2722452761146968
18497,0.5093095238095239,0,1,0,418661,186949,38020,69936,1.731714772685168,0.2722463359090644
18498,0.5093333333333333,4,16,4,418677,186933,38024,69932,1.7315665641557672,0.272251961146906
18499,0.5093333333333334,5,34,5,418711,186899,38029,69927,1.7312516210307902,0.2722738352036009
18500,0.5094285714285713,1,4,1,418715,186895,38030,69926,1.7312145688984402,0.27227524228937666
18501,0.5094285714285715,1,0,1,418715,186895,38031,69925,1.7312145688984402,0.2722724086909119
18502,0.509452380952381,1,0,1,418715,186895,38032,69924,1.7312145688984402,0.2722695750703803
18503,0.5095,1,2,1,418717,186893,38033,69923,1.731196042832265,0.2722688617531618
18504,0.5095000000000001,4,17,4,418734,186876,38037,69919,1.7310385712697767,0.2722755505364201
18505,0.5095238095238095,0,6,0,418740,186870,38037,69919,1.7309829930712513,0.27228191238721283
18506,0.5095238095238096,0,1,0,418741,186869,38037,69919,1.7309737300381638,0.27228297272458213
18507,0.509579365079365,0,1,0,418742,186868,38037,69919,1.7309644670050761,0.27228403307020993
18508,0.5095833333333333,0,1,0,418743,186867,38037,69919,1.7309552039719887,0.27228509342409635
18509,0.509595238095238,1,0,1,418743,186867,38038,69918,1.7309552039719887,0.27228225947777324
18510,0.5096071428571428,0,1,0,418744,186866,38038,69918,1.730945940938901,0.2722833198330114
18511,0.5096212121212121,0,1,0,418745,186865,38038,69918,1.7309366779058135,0.27228438019650836
18512,0.5096428571428571,0,1,0,418746,186864,38038,69918,1.7309274148727258,0.27228544056826415
18513,0.5096428571428572,1,4,1,418750,186860,38039,69917,1.7308903627403758,0.27228684812113235
18514,0.5096666666666666,1,12,1,418762,186848,38040,69916,1.7307792063433252,0.2722967394182985
18515,0.5096666666666667,3,16,3,418778,186832,38043,69913,1.7306309978139243,0.27230520555414905
18516,0.5096904761904761,0,1,0,418779,186831,38043,69913,1.7306217347808366,0.272306266163961
18517,0.5097142857142857,0,3,0,418782,186828,38043,69913,1.730593945681574,0.27230944804296936
18518,0.5097142857142858,0,4,0,418786,186824,38043,69913,1.7305568935492237,0.27231369066398686
18519,0.5097272727272726,0,1,0,418787,186823,38043,69913,1.7305476305161362,0.2723147513398978
18520,0.50975,1,1,1,418788,186822,38044,69912,1.7305383674830486,0.27231297763443874
18521,0.5097619047619047,1,0,1,418788,186822,38045,69911,1.7305383674830486,0.27231014322272556
18522,0.5097619047619049,0,1,0,418789,186821,38045,69911,1.730529104449961,0.2723112039013446
18523,0.5097857142857143,0,1,0,418790,186820,38045,69911,1.7305198414168736,0.2723122645882266
18524,0.5098095238095238,0,1,0,418791,186819,38045,69911,1.730510578383786,0.27231332528337165
18525,0.5098333333333332,0,7,0,418798,186812,38045,69911,1.730445737152173,0.2723207503807606
18526,0.5098333333333334,2,10,2,418808,186802,38047,69909,1.7303531068212976,0.27232568919913835
18527,0.5098809523809524,0,2,0,418810,186800,38047,69909,1.7303345807551225,0.2723278108675582
18528,0.5099047619047619,0,2,0,418812,186798,38047,69909,1.7303160546889473,0.27232993256903787
18529,0.509904761904762,0,1,0,418813,186797,38047,69909,1.7303067916558599,0.2723309934321753
18530,0.5099166666666667,0,1,0,418814,186796,38047,69909,1.7302975286227722,0.27233205430357804
18531,0.5099999999999999,7,32,7,418846,186764,38054,69902,1.7300011115639704,0.272346161938083
18532,0.51,516,2819,516,421665,183945,38570,69386,1.7038886212901552,0.2738946279768366
18533,0.5100000000000001,12,38,12,421703,183907,38582,69374,1.7035366260328282,0.27390131908828536
18534,0.5100238095238094,0,3,0,421706,183904,38582,69374,1.7035088369335656,0.27390456336515606
18535,0.5100317460317462,3,1,3,421707,183903,38585,69371,1.703499573900478,0.27389704430774575
18536,0.5100357142857143,0,1,0,421708,183902,38585,69371,1.7034903108673904,0.27389812573784017
18537,0.5100454545454545,1,1,1,421709,183901,38586,69370,1.7034810478343028,0.2738963402837277
18538,0.510047619047619,0,1,0,421710,183900,38586,69370,1.7034717848012153,0.273897421723852
18539,0.5100476190476191,1,1,1,421711,183899,38587,69369,1.7034625217681278,0.2738956362430311
18540,0.51010101010101,0,1,0,421712,183898,38587,69369,1.7034532587350402,0.27389671769318547
18541,0.5101190476190475,0,1,0,421713,183897,38587,69369,1.7034439957019527,0.27389779915187984
18542,0.5101190476190476,0,1,0,421714,183896,38587,69369,1.703434732668865,0.2738988806191144
18543,0.5101428571428572,0,1,0,421715,183895,38587,69369,1.7034254696357776,0.27389996209488915
18544,0.5101666666666667,0,12,0,421727,183883,38587,69369,1.703314313238727,0.2739129404703615
18545,0.5101666666666668,0,4,0,421731,183879,38587,69369,1.7032772611063767,0.27391726686884005
18546,0.5102222222222222,0,1,0,421732,183878,38587,69369,1.7032679980732892,0.2739183484898143
18547,0.5102380952380952,0,1,0,421733,183877,38587,69369,1.7032587350402015,0.2739194301193306
18548,0.5102380952380953,1,2,1,421735,183875,38588,69368,1.7032402089740264,0.27391872628266134
18549,0.5102420634920635,1,1,1,421736,183874,38589,69367,1.703230945940939,0.27391694077973155
18550,0.5102500000000001,0,1,0,421737,183873,38589,69367,1.7032216829078513,0.27391802242931607
18551,0.510297619047619,0,2,0,421739,183871,38589,69367,1.7032031568416763,0.27392018575411275
18552,0.5103102453102454,1,3,1,421742,183868,38590,69366,1.7031753677424135,0.2739205635894074
18553,0.5103174603174604,0,1,0,421743,183867,38590,69366,1.703166104709326,0.2739216452831977
18554,0.5103333333333333,3,16,3,421759,183851,38593,69363,1.7030178961799252,0.2739303514023711
18555,0.5103333333333334,0,6,0,421765,183845,38593,69363,1.7029623179813997,0.27393684243783767
18556,0.510345238095238,0,2,0,421767,183843,38593,69363,1.7029437919152248,0.2739390061846876
18557,0.5103571428571428,1,1,1,421768,183842,38594,69362,1.7029345288821371,0.2739372205810335
18558,0.510357142857143,0,1,0,421769,183841,38594,69362,1.7029252658490497,0.2739383024687701
18559,0.5104166666666666,2,0,2,421769,183841,38596,69360,1.7029252658490497,0.2739325674069218
18560,0.5104285714285715,0,1,0,421770,183840,38596,69360,1.702916002815962,0.2739336492890995
18561,0.510452380952381,0,1,0,421771,183839,38596,69360,1.7029067397828745,0.273934731179823
18562,0.5104761904761904,0,1,0,421772,183838,38596,69360,1.7028974767497869,0.27393581307909226
18563,0.5104761904761905,2,3,2,421775,183835,38598,69358,1.7028696876505243,0.2739333235910945
18564,0.5105,4,14,4,421789,183821,38602,69354,1.7027400051872985,0.27393700009874594
18565,0.5105000000000001,0,3,0,421792,183818,38602,69354,1.702712216088036,0.273940246156763
18566,0.5105000000000002,0,2,0,421794,183816,38602,69354,1.7026936900218608,0.2739424102381799
18567,0.5105238095238095,0,1,0,421795,183815,38602,69354,1.7026844269887733,0.2739434922917103
18568,0.5105238095238096,0,1,0,421796,183814,38602,69354,1.7026751639556856,0.2739445743537888
18569,0.5105555555555555,0,1,0,421797,183813,38602,69354,1.7026659009225982,0.2739456564244155
18570,0.5105952380952381,0,2,0,421799,183811,38602,69354,1.702647374856423,0.27394782059131395
18571,0.5105952380952382,0,2,0,421801,183809,38602,69354,1.702628848790248,0.27394998479240645
18572,0.5106666666666666,4,32,4,421833,183777,38606,69350,1.702332431731446,0.27397314391589994
18573,0.5106666666666667,3,20,3,421853,183757,38609,69347,1.7021471710696952,0.273986187496049
18574,0.5106794871794872,0,1,0,421854,183756,38609,69347,1.7021379080366075,0.27398727000470163
18575,0.510686507936508,0,2,0,421856,183754,38609,69347,1.7021193819704323,0.2739894350476687
18576,0.5106904761904761,0,1,0,421857,183753,38609,69347,1.7021101189373449,0.2739905175819834
18577,0.5107023809523811,0,3,0,421860,183750,38609,69347,1.7020823298380823,0.2739937652362533
18578,0.5107142857142857,1,11,1,421871,183739,38610,69346,1.7019804364741191,0.27400280538159116
18579,0.5107142857142858,0,1,0,421872,183738,38610,69346,1.7019711734410314,0.2740038880371734
18580,0.5107499999999999,0,2,0,421874,183736,38610,69346,1.7019526473748565,0.27400605337400524
18581,0.5107619047619048,1,0,1,421874,183736,38611,69345,1.7019526473748565,0.2740031847511271
18582,0.5107857142857143,1,2,1,421876,183734,38612,69344,1.7019341213086814,0.2740024814484072
18583,0.5108095238095238,0,2,0,421878,183732,38612,69344,1.7019155952425062,0.27400464682545955
18584,0.5108333333333333,8,48,8,421926,183684,38620,69336,1.7014709696543036,0.27403367322741284
18585,0.5108333333333334,10,76,10,422002,183608,38630,69326,1.7007669791396496,0.27408731131441405
18586,0.5108333333333335,1,1,1,422003,183607,38631,69325,1.700757716106562,0.27408552496323124
18587,0.5108571428571429,0,2,0,422005,183605,38631,69325,1.7007391900403868,0.27408769224686674
18588,0.5108888888888888,0,4,0,422009,183601,38631,69325,1.7007021379080367,0.2740920269169639
18589,0.5108928571428571,0,1,0,422010,183600,38631,69325,1.700692874874949,0.27409311060591085
18590,0.5109047619047619,0,1,0,422011,183599,38631,69325,1.7006836118418616,0.27409419430342713
18591,0.5109126984126985,0,1,0,422012,183598,38631,69325,1.7006743488087739,0.2740952780095128
18592,0.5109285714285714,0,1,0,422013,183597,38631,69325,1.7006650857756864,0.2740963617241679
18593,0.5109523809523808,0,1,0,422014,183596,38631,69325,1.7006558227425987,0.2740974454473927
18594,0.5109523809523809,0,1,0,422015,183595,38631,69325,1.7006465597095113,0.2740985291791871
18595,0.510952380952381,0,1,0,422016,183594,38631,69325,1.7006372966764238,0.2740996129195513
18596,0.5109642857142856,0,3,0,422019,183591,38631,69325,1.700609507577161,0.27410286419206376
18597,0.5109999999999999,0,4,0,422023,183587,38631,69325,1.700572455444811,0.2741071993420636
18598,0.511,8,78,8,422101,183509,38639,69317,1.6998499388639816,0.27416879593079824
18599,0.5110000000000001,1,3,1,422104,183506,38640,69316,1.699822149764719,0.2741691783151783
18600,0.5110006660006658,0,1,0,422105,183505,38640,69316,1.6998128867316313,0.2741702627550718
18601,0.5110317460317461,0,1,0,422106,183504,38640,69316,1.6998036236985439,0.274171347203544
18602,0.511047619047619,0,2,0,422108,183502,38640,69316,1.6997850976323687,0.2741735161262252
18603,0.5110714285714286,1,0,1,422108,183502,38641,69315,1.6997850976323687,0.27417064517022194
18604,0.5110833333333333,1,1,1,422109,183501,38642,69314,1.6997758345992813,0.2741688586515832
18605,0.5110916583416584,0,1,0,422110,183500,38642,69314,1.6997665715661936,0.27416994312023857
18606,0.5111038961038962,0,1,0,422111,183499,38642,69314,1.6997573085331061,0.27417102759747325
18607,0.511107142857143,0,1,0,422112,183498,38642,69314,1.6997480455000185,0.2741721120832872
18608,0.5111507936507936,1,0,1,422112,183498,38643,69313,1.6997480455000185,0.2741692410535934
18609,0.5111666666666665,0,1,0,422113,183497,38643,69313,1.699738782466931,0.2741703255409201
18610,0.5111666666666667,0,8,0,422121,183489,38643,69313,1.6996646782022304,0.27417900174840387
18611,0.5111666666666668,0,4,0,422125,183485,38643,69313,1.6996276260698804,0.2741833400580701
18612,0.5111904761904762,1,1,1,422126,183484,38644,69312,1.6996183630367927,0.2741815535055934
18613,0.511192612942613,1,3,1,422129,183481,38645,69311,1.69959057393753,0.27418193613721953
18614,0.51125,1,4,1,422133,183477,38646,69310,1.6995535218051798,0.27418340341868846
18615,0.511281746031746,2,2,2,422135,183475,38648,69308,1.6995349957390047,0.2741798301309819
18616,0.5113095238095238,1,3,1,422138,183472,38649,69307,1.699507206639742,0.27418021275501525
18617,0.5113095238095239,0,2,0,422140,183470,38649,69307,1.699488680573567,0.27418238209963725
18618,0.5113214285714285,1,3,1,422143,183467,38650,69306,1.6994608914743043,0.27418276477313636
18619,0.5113333333333333,5,24,5,422167,183443,38655,69301,1.6992385786802031,0.27419444180672936
18620,0.5113333333333334,0,3,0,422170,183440,38655,69301,1.6992107895809403,0.2741976964560558
18621,0.5113611111111109,1,3,1,422173,183437,38656,69300,1.6991830004816777,0.27419807942643937
18622,0.5114285714285713,1,6,1,422179,183431,38657,69299,1.6991274222831525,0.2742017172476556
18623,0.5114285714285715,0,4,0,422183,183427,38657,69299,1.6990903701508022,0.2742060571528058
18624,0.5114523809523809,0,3,0,422186,183424,38657,69299,1.6990625810515396,0.2742093121718245
18625,0.5115,6,21,6,422207,183403,38663,69293,1.698868057356701,0.27421486687561336
18626,0.5115000000000001,0,1,0,422208,183402,38663,69293,1.6988587943236133,0.2742159520370407
18627,0.5115238095238095,0,1,0,422209,183401,38663,69293,1.6988495312905258,0.27421703720705676
18628,0.511547619047619,0,2,0,422211,183399,38663,69293,1.6988310052243507,0.2742192075728555
18629,0.5115714285714286,0,2,0,422213,183397,38663,69293,1.6988124791581756,0.2742213779730104
18630,0.5115873015873017,2,2,2,422215,183395,38665,69291,1.6987939530920004,0.27421780391474004
18631,0.5116190476190476,0,2,0,422217,183393,38665,69291,1.6987754270258253,0.27421997435532125
18632,0.5116666666666666,37,224,37,422441,183169,38702,69254,1.6967005076142132,0.2743569326091521
18633,0.5116666666666667,29,139,29,422580,183030,38731,69225,1.695412946015043,0.27442468930249153
18634,0.5116785714285715,0,1,0,422581,183029,38731,69225,1.6954036829819557,0.27442577719282946
18635,0.5116865079365079,0,1,0,422582,183028,38731,69225,1.695394419948868,0.27442686509179276
18636,0.5116904761904761,0,2,0,422584,183026,38731,69225,1.695375893882693,0.274429040915596
18637,0.5117045454545455,0,1,0,422585,183025,38731,69225,1.6953666308496054,0.27443012884043605
18638,0.5117142857142857,0,1,0,422586,183024,38731,69225,1.695357367816518,0.274431216773902
18639,0.5117499999999999,0,1,0,422587,183023,38731,69225,1.6953481047834302,0.2744323047159938
18640,0.5117857142857143,1,3,1,422590,183020,38732,69224,1.6953203156841676,0.2744326921552148
18641,0.5118095238095238,1,1,1,422591,183019,38733,69223,1.6953110526510802,0.27443090365601286
18642,0.5118095238095239,1,1,1,422592,183018,38734,69222,1.6953017896179925,0.2744291151284491
18643,0.5118181818181818,0,1,0,422593,183017,38734,69222,1.695292526584905,0.2744302031010272
18644,0.5118333333333333,0,3,0,422596,183014,38734,69222,1.6952647374856422,0.27443346707052124
18645,0.5118333333333334,4,13,4,422609,183001,38738,69218,1.6951443180555041,0.2744361051308585
18646,0.5118484848484848,0,1,0,422610,183000,38738,69218,1.6951350550224165,0.27443719322173676
18647,0.5118571428571428,0,1,0,422611,182999,38738,69218,1.695125791989329,0.2744382813212432
18648,0.5119047619047619,1,6,1,422617,182993,38739,69217,1.6950702137908036,0.27444193330954364
18649,0.5119285714285714,0,1,0,422618,182992,38739,69217,1.6950609507577161,0.2744430214623586
18650,0.5119404761904762,0,2,0,422620,182990,38739,69217,1.695042424691541,0.27444519779387566
18651,0.5119444444444444,1,0,1,422620,182990,38740,69216,1.695042424691541,0.27444232095985027
18652,0.5119523809523809,0,2,0,422622,182988,38740,69216,1.6950238986253658,0.27444449731170006
18653,0.511952380952381,0,1,0,422623,182987,38740,69216,1.6950146355922784,0.27444558550056897
18654,0.5119682539682539,0,1,0,422624,182986,38740,69216,1.6950053725591907,0.2744466736980674
18655,0.5119761904761905,0,1,0,422625,182985,38740,69216,1.6949961095261032,0.27444776190419545
18656,0.512,17,65,17,422690,182920,38757,69199,1.6943940123754122,0.27446959570678925
18657,0.5120000000000001,0,6,0,422696,182914,38757,69199,1.6943384341768868,0.274476127768104
18658,0.5120238095238094,0,2,0,422698,182912,38757,69199,1.6943199081107119,0.2744783051909675
18659,0.5120238095238095,0,1,0,422699,182911,38757,69199,1.6943106450776242,0.2744793939153544
18660,0.512047619047619,0,3,0,422702,182908,38757,69199,1.6942828559783616,0.27448266014033723
18661,0.5120833333333333,1,9,1,422711,182899,38758,69198,1.6941994886805736,0.27448958139128987
18662,0.512095238095238,1,0,1,422711,182899,38759,69197,1.6941994886805736,0.2744867034780401
18663,0.5121158008658009,0,1,0,422712,182898,38759,69197,1.6941902256474861,0.2744877923005216
18664,0.5121212121212122,0,1,0,422713,182897,38759,69197,1.6941809626143984,0.2744888811316414
18665,0.5121428571428571,0,7,0,422720,182890,38759,69197,1.6941161213827856,0.27449650319135854
18666,0.5121666666666667,4,10,4,422730,182880,38763,69193,1.69402349105191,0.2744958801616992
18667,0.512167748917749,1,0,1,422730,182880,38764,69192,1.69402349105191,0.2744930019994287
18668,0.5121904761904762,0,1,0,422731,182879,38764,69192,1.6940142280188224,0.27449409095056554
18669,0.5122023809523809,0,1,0,422732,182878,38764,69192,1.694004964985735,0.2744951799103424
18670,0.5122380952380953,0,1,0,422733,182877,38764,69192,1.6939957019526475,0.2744962688787594
18671,0.5122619047619048,1,0,1,422733,182877,38765,69191,1.6939957019526475,0.27449339067235823
18672,0.5122673992673993,1,0,1,422733,182877,38766,69190,1.6939957019526475,0.2744905124431203
18673,0.5123333333333333,2,33,2,422766,182844,38768,69188,1.693690021860758,0.27452069578466226
18674,0.5123809523809523,0,1,0,422767,182843,38768,69188,1.6936807588276706,0.2745217850185096
18675,0.5123809523809524,0,2,0,422769,182841,38768,69188,1.6936622327614954,0.2745239635121355
18676,0.5123928571428571,1,3,1,422772,182838,38769,69187,1.6936344436622328,0.2745243527427835
18677,0.5124285714285715,1,1,1,422773,182837,38770,69186,1.6936251806291451,0.274522563416831
18678,0.5124404761904762,0,1,0,422774,182836,38770,69186,1.6936159175960577,0.27452365269698675
18679,0.5124718614718614,0,1,0,422775,182835,38770,69186,1.69360665456297,0.2745247419857869
18680,0.5124761904761904,0,1,0,422776,182834,38770,69186,1.6935973915298825,0.2745258312832315
18681,0.5125,62,297,62,423073,182537,38832,69124,1.6908462707028789,0.27467108530920564
18682,0.5125555555555557,0,1,0,423074,182536,38832,69124,1.6908370076697914,0.2746721767464039
18683,0.5126666666666666,7,40,7,423114,182496,38839,69117,1.6904664863462893,0.27469566357859093
18684,0.5126666666666667,3,14,3,423128,182482,38842,69114,1.6903368038830635,0.2747023005135217
18685,0.5126904761904763,1,1,1,423129,182481,38843,69113,1.6903275408499758,0.27470050955110215
18686,0.5127222222222223,0,1,0,423130,182480,38843,69113,1.6903182778168884,0.27470160139590527
18687,0.5127272727272727,0,1,0,423131,182479,38843,69113,1.690309014783801,0.2747026932493879
18688,0.5127380952380952,0,2,0,423133,182477,38843,69113,1.6902904887176258,0.274704876982392
18689,0.5127777777777777,0,1,0,423134,182476,38843,69113,1.690281225684538,0.2747059688619137
18690,0.5127777777777778,0,1,0,423135,182475,38843,69113,1.6902719626514506,0.27470706075011525
18691,0.5128333333333334,2,10,2,423145,182465,38845,69111,1.6901793323205752,0.27471221420167263
18692,0.5128571428571429,1,5,1,423150,182460,38846,69110,1.6901330171551372,0.2747147911118178
18693,0.5128704906204906,0,1,0,423151,182459,38846,69110,1.6901237541220497,0.27471588311755424
18694,0.5128787878787879,0,1,0,423152,182458,38846,69110,1.6901144910889623,0.2747169751319723
18695,0.5128809523809523,1,0,1,423152,182458,38847,69109,1.6901144910889623,0.2747140920708996
18696,0.5129166666666667,1,7,1,423159,182451,38848,69108,1.6900496498573494,0.27471885323124995
18697,0.5129285714285714,0,1,0,423160,182450,38848,69108,1.6900403868242617,0.2747199453008849
18698,0.5129761904761905,1,4,1,423164,182446,38849,69107,1.6900033346919114,0.27472143047389613
18699,0.5129999999999999,0,1,0,423165,182445,38849,69107,1.689994071658824,0.27472252257982444
18700,0.513,9,33,9,423198,182412,38858,69098,1.6896883915669347,0.27473261500536755
18701,0.5130238095238095,1,3,1,423201,182409,38859,69097,1.689660602467672,0.2747330083576535
18702,0.5130357142857143,0,1,0,423202,182408,38859,69097,1.6896513394345845,0.2747341007137035
18703,0.513047619047619,0,1,0,423203,182407,38859,69097,1.689642076401497,0.27473519307844013
18704,0.5130476190476191,0,4,0,423207,182403,38859,69097,1.6896050242691467,0.2747395626242545
18705,0.513095238095238,0,1,0,423208,182402,38859,69097,1.689595761236059,0.27474065503242556
18706,0.5131111111111112,0,1,0,423209,182401,38859,69097,1.6895864982029716,0.27474174744928387
18707,0.5131168831168832,1,1,1,423210,182400,38860,69096,1.6895772351698841,0.27473995610268154
18708,0.5131428571428571,0,1,0,423211,182399,38860,69096,1.6895679721367964,0.27474104852979186
18709,0.5131666666666667,5,20,5,423231,182379,38865,69091,1.6893827114750455,0.2747484789438104
18710,0.5131818181818182,1,0,1,423231,182379,38866,69090,1.6893827114750455,0.27474559488445893
18711,0.5132142857142856,0,1,0,423232,182378,38866,69090,1.6893734484419578,0.27474668745128605
18712,0.5132142857142857,0,3,0,423235,182375,38866,69090,1.6893456593426952,0.2747499652039051
18713,0.5132301587301586,0,1,0,423236,182374,38866,69090,1.6893363963096075,0.27475105780549103
18714,0.5132857142857142,0,1,0,423237,182373,38866,69090,1.68932713327652,0.27475215041576695
18715,0.5132857142857143,1,1,1,423238,182372,38867,69089,1.6893178702434326,0.2747503589025734
18716,0.5133095238095238,0,1,0,423239,182371,38867,69089,1.689308607210345,0.27475145152310504
18717,0.5133333333333333,99,606,99,423845,181765,38966,68990,1.6836952091592872,0.27512911008753566
18718,0.5133333333333334,0,3,0,423848,181762,38966,68990,1.6836674200600243,0.2751324017355794
18719,0.5133452380952381,0,1,0,423849,181761,38966,68990,1.6836581570269369,0.27513349896909683
18720,0.5134242424242424,0,1,0,423850,181760,38966,68990,1.6836488939938494,0.2751345962113659
18721,0.5134523809523809,0,1,0,423851,181759,38966,68990,1.6836396309607617,0.2751356934623867
18722,0.5134761904761905,2,1,2,423852,181758,38968,68988,1.6836303679276743,0.2751310090689383
18723,0.5134826839826839,0,1,0,423853,181757,38968,68988,1.6836211048945866,0.275132106323157
18724,0.5135,1,2,1,423855,181755,38969,68987,1.6836025788284115,0.27513140997519364
18725,0.5135000000000001,8,16,8,423871,181739,38977,68979,1.6834543702990108,0.27512583859156503
18726,0.5135238095238095,0,3,0,423874,181736,38977,68979,1.683426581199748,0.27512913068623734
18727,0.5135476190476191,0,1,0,423875,181735,38977,68979,1.6834173181666605,0.27513022806863596
18728,0.5135555555555555,0,1,0,423876,181734,38977,68979,1.6834080551335728,0.2751313254597887
18729,0.5135642135642137,0,1,0,423877,181733,38977,68979,1.6833987921004854,0.2751324228596956
18730,0.5135714285714286,1,2,1,423879,181731,38978,68978,1.6833802660343102,0.2751317264238619
18731,0.5135952380952381,0,3,0,423882,181728,38978,68978,1.6833524769350476,0.27513501870717094
18732,0.513611111111111,0,2,0,423884,181726,38978,68978,1.6833339508688725,0.27513721360648413
18733,0.5136111111111111,0,1,0,423885,181725,38978,68978,1.683324687835785,0.2751383110692732
18734,0.5136190476190476,0,1,0,423886,181724,38978,68978,1.6833154248026974,0.27513940854081737
18735,0.5136363636363637,0,1,0,423887,181723,38978,68978,1.68330616176961,0.2751405060211168
18736,0.5136428571428572,0,2,0,423889,181721,38978,68978,1.6832876357034348,0.27514270100798166
18737,0.5136666666666666,1,1,1,423890,181720,38979,68977,1.683278372670347,0.27514090715086337
18738,0.5136666666666667,2,14,2,423904,181706,38981,68975,1.6831486902071213,0.27515049006506276
18739,0.5137023809523809,0,1,0,423905,181705,38981,68975,1.6831394271740339,0.2751515876815063
18740,0.5137380952380952,0,1,0,423906,181704,38981,68975,1.6831301641409464,0.275152685306707
18741,0.5137499999999999,0,1,0,423907,181703,38981,68975,1.6831209011078587,0.2751537829406649
18742,0.51375,0,3,0,423910,181700,38981,68975,1.6830931120085961,0.27515707589508326
18743,0.5137619047619046,1,0,1,423910,181700,38982,68974,1.6830931120085961,0.2751541843190758
18744,0.5137619047619048,1,3,1,423913,181697,38983,68973,1.6830653229093335,0.2751545857102964
18745,0.5138095238095237,0,1,0,423914,181696,38983,68973,1.6830560598762458,0.275155683391245
18746,0.5138095238095238,0,5,0,423919,181691,38983,68973,1.683009744710808,0.27516117192736095
18747,0.5138333333333333,0,3,0,423922,181688,38983,68973,1.6829819556115455,0.27516446515413245
18748,0.5138333333333334,0,11,0,423933,181677,38983,68973,1.6828800622475824,0.2751765409934171
18749,0.5138571428571428,0,1,0,423934,181676,38983,68973,1.682870799214495,0.2751776388495466
18750,0.5138754440004442,1,13,1,423947,181663,38984,68972,1.6827503797843566,0.27518901988948075
18751,0.5138787878787879,0,1,0,423948,181662,38984,68972,1.6827411167512691,0.27519011786110426
18752,0.5138866411366411,0,2,0,423950,181660,38984,68972,1.682722590685094,0.27519231383063614
18753,0.5138874458874458,2,1,2,423951,181659,38986,68970,1.6827133276520063,0.27518762792813284
18754,0.5138888888888888,0,1,0,423952,181658,38986,68970,1.6827040646189189,0.2751887259204877
18755,0.513888888888889,1,4,1,423956,181654,38987,68969,1.6826670124865686,0.2751902259569154
18756,0.5139523809523809,0,2,0,423958,181652,38987,68969,1.6826484864203934,0.27519242202369315
18757,0.5139761904761904,0,1,0,423959,181651,38987,68969,1.682639223387306,0.27519352007022585
18758,0.5139999999999999,0,2,0,423961,181649,38987,68969,1.6826206973211308,0.2751957161895794
18759,0.514,20,118,20,424079,181531,39007,68949,1.6815276594167994,0.27526748642606197
18760,0.5140119047619048,0,1,0,424080,181530,39007,68949,1.681518396383712,0.275268585390392
18761,0.514047619047619,1,3,1,424083,181527,39008,68948,1.6814906072844493,0.27526898892105
18762,0.5140476190476191,3,3,3,424086,181524,39011,68945,1.6814628181851865,0.27526360547612677
18763,0.5140714285714286,1,1,1,424087,181523,39012,68944,1.681453555152099,0.2752618109371694
18764,0.5140833333333333,1,0,1,424087,181523,39013,68943,1.681453555152099,0.2752589173780074
18765,0.5140869408369407,1,3,1,424090,181520,39014,68942,1.6814257660528364,0.27525932077520743
18766,0.5140952380952382,0,1,0,424091,181519,39014,68942,1.6814165030197488,0.27526041978591476
18767,0.5141428571428571,0,1,0,424092,181518,39014,68942,1.6814072399866613,0.27526151880539806
18768,0.5141428571428572,0,2,0,424094,181516,39014,68942,1.6813887139204862,0.2752637168706929
18769,0.5141666666666665,0,2,0,424096,181514,39014,68942,1.681370187854311,0.2752659149710927
18770,0.5141666666666667,25,124,25,424220,181390,39039,68917,1.6802215717514544,0.2753298948890762
18771,0.5141904761904762,0,1,0,424221,181389,39039,68917,1.6802123087183667,0.27533099486228857
18772,0.5142301587301588,0,4,0,424225,181385,39039,68917,1.6801752565860166,0.2753353948430296
18773,0.5142619047619047,0,1,0,424226,181384,39039,68917,1.680165993552929,0.27533649486018835
18774,0.5142777777777777,0,2,0,424228,181382,39039,68917,1.6801474674867538,0.27533869492087465
18775,0.5142857142857143,3,14,3,424242,181368,39042,68914,1.680017785023528,0.27534541037709465
18776,0.5143095238095238,0,3,0,424245,181365,39042,68914,1.6799899959242655,0.275348710838704
18777,0.5143095238095239,1,4,1,424249,181361,39043,68913,1.6799529437919152,0.27535021616308525
18778,0.5143158263305323,0,1,0,424250,181360,39043,68913,1.6799436807588277,0.27535131636253213
18779,0.5143333333333333,4,8,4,424258,181352,39047,68909,1.6798695764941272,0.2753485361282821
18780,0.5143333333333334,7,20,7,424278,181332,39054,68902,1.6796843158323762,0.275350272145272
18781,0.5143571428571428,0,1,0,424279,181331,39054,68902,1.6796750527992885,0.2753513725208106
18782,0.514357142857143,0,1,0,424280,181330,39054,68902,1.679665789766201,0.27535247290514403
18783,0.5144047619047619,0,1,0,424281,181329,39054,68902,1.6796565267331134,0.27535357329827237
18784,0.5144444444444445,0,5,0,424286,181324,39054,68902,1.6796102115676756,0.27535907539584215
18785,0.514452380952381,0,2,0,424288,181322,39054,68902,1.6795916855015005,0.2753612762964384
18786,0.5144761904761904,0,1,0,424289,181321,39054,68902,1.679582422468413,0.27536237675993014
18787,0.5144999999999998,1,2,1,424291,181319,39055,68901,1.679563896402238,0.27536168172008635
18788,0.5145,1,4,1,424295,181315,39056,68900,1.6795268442698876,0.2753631876586136
18789,0.5145000000000001,2,15,2,424310,181300,39058,68898,1.6793878987735744,0.2753739038681364
18790,0.5145238095238094,0,2,0,424312,181298,39058,68898,1.6793693727073993,0.2753761051335753
18791,0.5145238095238095,1,1,1,424313,181297,39059,68897,1.6793601096743118,0.2753743095358002
18792,0.5145238095238096,0,4,0,424317,181293,39059,68897,1.6793230575419615,0.27537871217874416
18793,0.5145714285714286,1,0,1,424317,181293,39060,68896,1.6793230575419615,0.2753758158831923
18794,0.5145833333333333,0,1,0,424318,181292,39060,68896,1.679313794508874,0.2753769165587478
18795,0.5145833333333334,1,0,1,424318,181292,39061,68895,1.679313794508874,0.27537402023286583
18796,0.5145952380952381,0,1,0,424319,181291,39061,68895,1.6793045314757864,0.2753751209100429
18797,0.5146071428571427,1,0,1,424319,181291,39062,68894,1.6793045314757864,0.27537222455383015
18798,0.5146349206349208,0,1,0,424320,181290,39062,68894,1.679295268442699,0.2753733252326288
18799,0.5146363636363637,0,1,0,424321,181289,39062,68894,1.6792860054096113,0.2753744259202264
18800,0.5146431623931624,0,2,0,424323,181287,39062,68894,1.6792674793434361,0.275376627321819
18801,0.5146666666666666,2,12,2,424335,181275,39064,68892,1.6791563229463855,0.2753840434589694
18802,0.5146666666666667,2,19,2,424354,181256,39066,68890,1.678980325317722,0.27539916688653826
18803,0.5146904761904763,1,1,1,424355,181255,39067,68889,1.6789710622846346,0.2753973711142382
18804,0.5147142857142857,0,2,0,424357,181253,39067,68889,1.6789525362184594,0.27539957304251184
18805,0.5147222222222222,0,1,0,424358,181252,39067,68889,1.6789432731853717,0.2754006740198528
18806,0.5147222222222223,0,1,0,424359,181251,39067,68889,1.6789340101522843,0.27540177500599666
18807,0.5147499999999999,0,1,0,424360,181250,39067,68889,1.6789247471191968,0.2754028760009435
18808,0.5147619047619048,0,2,0,424362,181248,39067,68889,1.6789062210530217,0.27540507801724656
18809,0.514797619047619,0,2,0,424364,181246,39067,68889,1.6788876949868465,0.27540728006876286
18810,0.5148095238095238,0,2,0,424366,181244,39067,68889,1.6788691689206714,0.27540948215549327
18811,0.5148333333333333,1,7,1,424373,181237,39068,68888,1.6788043276890585,0.2754142928535732
18812,0.5148333333333334,3,11,3,424384,181226,39071,68885,1.6787024343250954,0.27541771453474656
18813,0.5148519536019536,0,3,0,424387,181223,39071,68885,1.6786746452258328,0.2754210181201721
18814,0.5148571428571429,0,5,0,424392,181218,39071,68885,1.678628330060395,0.27542652427199993
18815,0.5149047619047619,0,1,0,424393,181217,39071,68885,1.6786190670273073,0.27542762552878425
18816,0.514904761904762,1,1,1,424394,181216,39072,68884,1.6786098039942199,0.2754258296681327
18817,0.5149523809523809,0,1,0,424395,181215,39072,68884,1.6786005409611322,0.2754269309353496
18818,0.5149920634920635,1,6,1,424401,181209,39073,68883,1.678544962762607,0.2754306415239192
18819,0.5149999999999999,4,21,4,424422,181188,39077,68879,1.6783504390677684,0.27544218149535926
18820,0.515,208,1050,208,425472,180138,39285,68671,1.6686242543258365,0.27599885856219025
18821,0.5150000000000001,4,19,4,425491,180119,39289,68667,1.668448256697173,0.27600829628676854
18822,0.5150422077922078,0,1,0,425492,180118,39289,68667,1.6684389936640853,0.27600940571175914
18823,0.5150476190476191,0,3,0,425495,180115,39289,68667,1.6684112045648227,0.27601273404024407
18824,0.515064935064935,0,1,0,425496,180114,39289,68667,1.668401941531735,0.27601384350091046
18825,0.5150714285714286,0,1,0,425497,180113,39289,68667,1.6683926784986476,0.276014952970496
18826,0.515079365079365,0,1,0,425498,180112,39289,68667,1.6683834154655601,0.2760160624490009
18827,0.5151190476190475,0,2,0,425500,180110,39289,68667,1.668364889399385,0.27601828143276913
18828,0.5151190476190476,1,0,1,425500,180110,39290,68666,1.668364889399385,0.2760153712576776
18829,0.515142857142857,0,1,0,425501,180109,39290,68666,1.6683556263662973,0.27601648075570295
18830,0.5151428571428571,0,1,0,425502,180108,39290,68666,1.6683463633332098,0.27601759026264805
18831,0.5151428571428572,2,3,2,425505,180105,39292,68664,1.6683185742339472,0.2760150983442471
18832,0.5151666666666666,0,1,0,425506,180104,39292,68664,1.6683093112008596,0.27601620787239517
18833,0.5151666666666667,2,4,2,425510,180100,39294,68662,1.6682722590685093,0.27601482541545735
18834,0.5151666666666668,0,5,0,425515,180095,39294,68662,1.6682259439030716,0.27602037329602785
18835,0.5151984126984126,0,1,0,425516,180094,39294,68662,1.668216680869984,0.27602148289890494
18836,0.5152380952380952,0,1,0,425517,180093,39294,68662,1.6682074178368964,0.2760225925107033
18837,0.5152380952380953,2,2,2,425519,180091,39296,68660,1.6681888917707215,0.2760189908784286
18838,0.51525,2,0,2,425519,180091,39298,68658,1.6681888917707215,0.27601316990219055
18839,0.5152500000000001,0,1,0,425520,180090,39298,68658,1.6681796287376338,0.2760142795117951
18840,0.5152619047619048,0,1,0,425521,180089,39298,68658,1.6681703657045464,0.27601538913032114
18841,0.5152857142857143,0,2,0,425523,180087,39298,68658,1.6681518396383712,0.2760176083941386
18842,0.5153030303030304,0,1,0,425524,180086,39298,68658,1.6681425766052835,0.2760187180394301
18843,0.5153095238095238,0,1,0,425525,180085,39298,68658,1.668133313572196,0.27601982769364364
18844,0.5153333333333332,0,1,0,425526,180084,39298,68658,1.6681240505391086,0.2760209373567793
18845,0.5153333333333333,4,11,4,425537,180073,39302,68654,1.6680221571751455,0.2760215014855645
18846,0.5153333333333334,1,5,1,425542,180068,39303,68653,1.6679758420097077,0.2760241394976701
18847,0.5153571428571428,0,1,0,425543,180067,39303,68653,1.66796657897662,0.2760252492762946
18848,0.5154047619047619,0,1,0,425544,180066,39303,68653,1.6679573159435326,0.27602635906384315
18849,0.5154166666666666,0,3,0,425547,180063,39303,68653,1.66792952684427,0.27602968848003345
18850,0.5154285714285715,1,2,1,425549,180061,39304,68652,1.6679110007780948,0.2760289972779871
18851,0.515452380952381,0,1,0,425550,180060,39304,68652,1.6679017377450072,0.27603010711184023
18852,0.5154761904761904,0,1,0,425551,180059,39304,68652,1.6678924747119197,0.276031216954618
18853,0.5154761904761905,1,1,1,425552,180058,39305,68651,1.667883211678832,0.27602941590372687
18854,0.515488095238095,0,1,0,425553,180057,39305,68651,1.6678739486457446,0.27603052575711273
18855,0.5154949217449216,1,4,1,425557,180053,39306,68650,1.6678368965133943,0.27603205429769645
18856,0.5155,1,28,1,425585,180025,39307,68649,1.6675775315869428,0.27606022342504644
18857,0.5155000000000001,1,1,1,425586,180024,39308,68648,1.6675682685538553,0.27605842233946726
18858,0.5155317460317462,0,2,0,425588,180022,39308,68648,1.6675497424876802,0.27606064261873164
18859,0.5155476190476189,0,1,0,425589,180021,39308,68648,1.6675404794545927,0.2760617527717568
18860,0.5155555555555555,1,1,1,425590,180020,39309,68647,1.667531216421505,0.2760599516622632
18861,0.5155833333333334,0,1,0,425591,180019,39309,68647,1.6675219533884176,0.276061061825903
18862,0.515595238095238,0,1,0,425592,180018,39309,68647,1.66751269035533,0.27606217199847183
18863,0.5155952380952381,1,3,1,425595,180015,39310,68646,1.6674849012560673,0.2760625912386743
18864,0.5156190476190475,1,1,1,425596,180014,39311,68645,1.6674756382229798,0.2760607900779783
18865,0.5156212121212121,0,1,0,425597,180013,39311,68645,1.6674663751898922,0.2760619002807068
18866,0.5156363636363637,0,1,0,425598,180012,39311,68645,1.6674571121568047,0.276063010492365
18867,0.5156398046398045,0,3,0,425601,180009,39311,68645,1.6674293230575419,0.27606634118091805
18868,0.5156666666666666,5,23,5,425624,179986,39316,68640,1.667216273296528,0.27607732095597404
18869,0.5156666666666667,1,3,1,425627,179983,39317,68639,1.6671884841972655,0.27607774050566725
18870,0.5156904761904763,1,1,1,425628,179982,39318,68638,1.667179221164178,0.27607593918429735
18871,0.5157142857142857,2,9,2,425637,179973,39320,68636,1.66709585386639,0.2760801097305407
18872,0.5157142857142858,0,5,0,425642,179968,39320,68636,1.6670495387009523,0.2760856623384982
18873,0.5157380952380952,0,1,0,425643,179967,39320,68636,1.6670402756678646,0.27608677288689193
18874,0.5157738095238096,2,0,2,425643,179967,39322,68634,1.6670402756678646,0.27608094899055113
18875,0.5157777777777777,0,1,0,425644,179966,39322,68634,1.6670310126347772,0.276082059533387
18876,0.5158333333333333,10,64,10,425708,179902,39332,68624,1.6664381785171736,0.276124027264753
18877,0.5158333333333334,12,76,12,425784,179826,39344,68612,1.6657341880025196,0.2761735322293691
18878,0.5158333333333335,0,2,0,425786,179824,39344,68612,1.6657156619363445,0.27617575552657425
18879,0.5158571428571428,1,0,1,425786,179824,39345,68611,1.6657156619363445,0.2761728419908628
18880,0.5158806046894281,1,10,1,425796,179814,39346,68610,1.665623031605469,0.27618104530963195
18881,0.5158809523809523,0,5,0,425801,179809,39346,68610,1.665576716440031,0.2761866040842287
18882,0.5158809523809524,0,1,0,425802,179808,39346,68610,1.6655674534069436,0.27618771586600005
18883,0.5159047619047619,0,3,0,425805,179805,39346,68610,1.665539664307681,0.27619105126502025
18884,0.515904761904762,1,0,1,425805,179805,39347,68609,1.665539664307681,0.2761881375445828
18885,0.5159166666666667,0,1,0,425806,179804,39347,68609,1.6655304012745933,0.2761892493549049
18886,0.5159285714285714,0,1,0,425807,179803,39347,68609,1.6655211382415058,0.2761903611741784
18887,0.5159523809523809,2,2,2,425809,179801,39349,68607,1.6655026121753307,0.27618675727029723
18888,0.515952380952381,0,2,0,425811,179799,39349,68607,1.6654840861091555,0.27618898094248934
18889,0.5159642857142858,0,1,0,425812,179798,39349,68607,1.665474823076068,0.27619009279201306
18890,0.5159999999999999,0,3,0,425815,179795,39349,68607,1.6654470339768053,0.27619342839429634
18891,0.516,18,90,18,425905,179705,39367,68589,1.6646133609989255,0.27624106905523294
18892,0.5160000000000001,1,2,1,425907,179703,39368,68588,1.6645948349327504,0.2762403792324329
18893,0.5160198412698412,0,1,0,425908,179702,39368,68588,1.6645855718996627,0.2762414918039389
18894,0.5160714285714285,0,2,0,425910,179700,39368,68588,1.6645670458334878,0.2762437169738368
18895,0.5160714285714286,1,3,1,425913,179697,39369,68587,1.664539256734225,0.27624413977541845
18896,0.5160833333333333,0,2,0,425915,179695,39369,68587,1.6645207306680498,0.2762463650204203
18897,0.5160952380952382,0,2,0,425917,179693,39369,68587,1.664502204601875,0.27624859030127275
18898,0.5161111111111111,0,1,0,425918,179692,39369,68587,1.6644929415687872,0.27624970295514323
18899,0.5161111111111112,1,4,1,425922,179688,39370,68586,1.664455889436437,0.2762512385509558
18900,0.5161190476190476,0,2,0,425924,179686,39370,68586,1.664437363370262,0.27625346394277245
18901,0.5161428571428571,0,1,0,425925,179685,39370,68586,1.6644281003371744,0.2762545766521261
18902,0.5161666666666666,0,1,0,425926,179684,39370,68586,1.664418837304087,0.2762556893704435
18903,0.5161666666666667,2,12,2,425938,179672,39372,68584,1.6643076809070363,0.2762632121680846
18904,0.5161666666666668,0,4,0,425942,179668,39372,68584,1.664270628774686,0.27626766350321447
18905,0.5161818181818182,0,1,0,425943,179667,39372,68584,1.6642613657415983,0.27626877635941044
18906,0.5161904761904761,0,1,0,425944,179666,39372,68584,1.6642521027085109,0.276269889224572
18907,0.5161904761904762,0,1,0,425945,179665,39372,68584,1.6642428396754234,0.2762710020986993
18908,0.5161944444444443,1,0,1,425945,179665,39373,68583,1.6642428396754234,0.27626808675195774
18909,0.51625,1,3,1,425948,179662,39374,68582,1.6642150505761606,0.2762685100143407
18910,0.5162738095238094,0,1,0,425949,179661,39374,68582,1.6642057875430731,0.27626962290981016
18911,0.5163095238095238,0,3,0,425952,179658,39374,68582,1.6641779984438105,0.27627296165001614
18912,0.5163333333333333,3,22,3,425974,179636,39377,68579,1.6639742117158842,0.2762887013274782
18913,0.5163333333333334,2,3,2,425977,179633,39379,68577,1.6639464226166216,0.27628620925828934
18914,0.5163571428571428,1,2,1,425979,179631,39380,68576,1.6639278965504465,0.27628551974763
18915,0.5163888888888889,0,1,0,425980,179630,39380,68576,1.663918633517359,0.27628663287752914
18916,0.5164047619047619,0,3,0,425983,179627,39380,68576,1.6638908444180962,0.2762899723210437
18917,0.5164285714285713,1,5,1,425988,179622,39381,68575,1.6638445292526585,0.27629262239269614
18918,0.5164285714285715,1,1,1,425989,179621,39382,68574,1.663835266219571,0.2762908197183666
18919,0.5164444444444445,0,1,0,425990,179620,39382,68574,1.6638260031864833,0.2762919329234389
18920,0.516452380952381,0,1,0,425991,179619,39382,68574,1.6638167401533959,0.27629304613748173
18921,0.5164761904761905,0,1,0,425992,179618,39382,68574,1.6638074771203082,0.2762941593604951
18922,0.5165,3,25,3,426017,179593,39385,68571,1.6635759012931195,0.2763132444673684
18923,0.5165000000000001,0,4,0,426021,179589,39385,68571,1.6635388491607692,0.2763176982591876
18924,0.5165433455433456,0,2,0,426023,179587,39385,68571,1.663520323094594,0.27631992520893944
18925,0.516547619047619,1,3,1,426026,179584,39386,68570,1.6634925339953315,0.2763203494604157
18926,0.5165714285714286,1,0,1,426026,179584,39387,68569,1.6634925339953315,0.2763174331964554
18927,0.5166190476190476,1,0,1,426026,179584,39388,68568,1.6634925339953315,0.2763145169089913
18928,0.5166428571428572,0,2,0,426028,179582,39388,68568,1.6634740079291563,0.27631674390489624
18929,0.5166666666666666,85,329,85,426357,179253,39473,68483,1.660426470043351,0.2764353989731004
18930,0.5166666666666667,42,235,42,426592,179018,39515,68441,1.6582496572677758,0.2765751094120642
18931,0.5167142857142857,0,6,0,426598,179012,39515,68441,1.6581940790692504,0.27658181553668776
18932,0.5167222222222222,0,1,0,426599,179011,39515,68441,1.658184816036163,0.2765829332557425
18933,0.5167499999999999,0,1,0,426600,179010,39515,68441,1.6581755530030753,0.27658405098383115
18934,0.51675,0,1,0,426601,179009,39515,68441,1.6581662899699878,0.27658516872095373
18935,0.5167619047619048,1,2,1,426603,179007,39516,68440,1.6581477639038127,0.27658448071708286
18936,0.5167619047619049,0,1,0,426604,179006,39516,68440,1.658138500870725,0.2765855984740105
18937,0.5167857142857143,2,6,2,426610,179000,39518,68438,1.6580829226721998,0.2765864580218075
18938,0.5168095238095238,0,1,0,426611,178999,39518,68438,1.6580736596391121,0.2765875758273823
18939,0.5168259269969796,0,1,0,426612,178998,39518,68438,1.6580643966060247,0.2765886936419923
18940,0.5168333333333333,1,4,1,426616,178994,39519,68437,1.6580273444736744,0.2765902413198023
18941,0.5168333333333334,1,13,1,426629,178981,39520,68436,1.6579069250435363,0.2766018503174802
18942,0.5168333333333335,0,1,0,426630,178980,39520,68436,1.6578976620104486,0.2766029682801436
18943,0.5168571428571428,0,2,0,426632,178978,39520,68436,1.6578791359442735,0.27660520423258184
18944,0.5168968253968255,1,0,1,426632,178978,39521,68435,1.6578791359442735,0.2766022803975539
18945,0.5169047619047619,1,3,1,426635,178975,39522,68434,1.657851346845011,0.2766027104915343
18946,0.5169166666666666,0,1,0,426636,178974,39522,68434,1.6578420838119234,0.276603828493824
18947,0.5169444444444445,0,1,0,426637,178973,39522,68434,1.6578328207788358,0.27660494650515144
18948,0.5169999999999999,1,5,1,426642,178968,39523,68433,1.657786505613398,0.2766076127420665
18949,0.517,5,36,5,426678,178932,39528,68428,1.6574530364222462,0.2766332470892626
18950,0.5170238095238096,0,1,0,426679,178931,39528,68428,1.6574437733891585,0.27663436543647085
18951,0.517047619047619,0,2,0,426681,178929,39528,68428,1.6574252473229834,0.27663660215801456
18952,0.5170555555555554,1,1,1,426682,178928,39529,68427,1.657415984289896,0.276634796143195
18953,0.5170714285714286,0,1,0,426683,178927,39529,68427,1.6574067212568084,0.276635914519272
18954,0.5170833333333333,3,4,3,426687,178923,39532,68424,1.6573696691244582,0.27663161469514486
18955,0.5171071428571428,0,1,0,426688,178922,39532,68424,1.6573604060913705,0.27663273309453157
18956,0.5171190476190476,0,1,0,426689,178921,39532,68424,1.657351143058283,0.27663385150296144
18957,0.5171428571428571,1,11,1,426700,178910,39533,68423,1.6572492496943199,0.2766432299773989
18958,0.5171428571428572,0,1,0,426701,178909,39533,68423,1.6572399866612324,0.2766443484870538
18959,0.5171602564102564,0,1,0,426702,178908,39533,68423,1.6572307236281447,0.27664546700575343
18960,0.5171666666666667,2,10,2,426712,178898,39535,68421,1.6571380932972692,0.2766508032136633
18961,0.5172142857142856,0,1,0,426713,178897,39535,68421,1.6571288302641818,0.2766519218172555
18962,0.5172222222222222,1,1,1,426714,178896,39536,68420,1.657119567231094,0.2766501156415274
18963,0.5172380952380952,0,1,0,426715,178895,39536,68420,1.6571103041980066,0.27665123425590843
18964,0.5172619047619048,0,1,0,426716,178894,39536,68420,1.657101041164919,0.2766523528793356
18965,0.5172857142857143,1,1,1,426717,178893,39537,68419,1.6570917781318315,0.2766505466778806
18966,0.5173095238095239,1,0,1,426717,178893,39538,68418,1.6570917781318315,0.2766476218202991
18967,0.5173333333333333,5,41,5,426758,178852,39543,68413,1.6567119937752417,0.2766788668028229
18968,0.5173333333333334,1,0,1,426758,178852,39544,68412,1.6567119937752417,0.2766759415038178
18969,0.5173690476190477,0,2,0,426760,178850,39544,68412,1.6566934677090666,0.276678179421019
18970,0.5173809523809524,0,5,0,426765,178845,39544,68412,1.6566471525436288,0.27668377437241415
18971,0.5173809523809525,0,1,0,426766,178844,39544,68412,1.6566378895105414,0.276684893389847
18972,0.5173888888888889,0,1,0,426767,178843,39544,68412,1.6566286264774537,0.27668601241633134
18973,0.5173928571428573,0,1,0,426768,178842,39544,68412,1.6566193634443662,0.2766871314518673
18974,0.5174285714285715,0,1,0,426769,178841,39544,68412,1.6566101004112788,0.27668825049645507
18975,0.5174444444444444,0,1,0,426770,178840,39544,68412,1.656600837378191,0.27668936955009465
18976,0.5174458874458874,1,0,1,426770,178840,39545,68411,1.656600837378191,0.2766864441397608
18977,0.5174841269841269,0,1,0,426771,178839,39545,68411,1.6565915743451036,0.2766875631951466
18978,0.5175,62,307,62,427078,178532,39607,68349,1.6537478231872245,0.2768499803549078
18979,0.5175000000000001,2,12,2,427090,178520,39609,68347,1.6536366667901738,0.27685757918231274
18980,0.5175238095238095,0,2,0,427092,178518,39609,68347,1.6536181407239987,0.2768598221700119
18981,0.5175555555555555,0,1,0,427093,178517,39609,68347,1.653608877690911,0.2768609436774904
18982,0.5175714285714286,0,2,0,427095,178515,39609,68347,1.653590351624736,0.2768631867197057
18983,0.5175833333333333,1,0,1,427095,178515,39610,68346,1.653590351624736,0.2768602573918116
18984,0.5176071428571429,0,1,0,427096,178514,39610,68346,1.6535810885916484,0.27686137891922546
18985,0.5176098901098901,1,0,1,427096,178514,39611,68345,1.6535810885916484,0.2768584495602753
18986,0.5176190476190476,0,6,0,427102,178508,39611,68345,1.6535255103931232,0.27686517887163614
18987,0.517626984126984,0,1,0,427103,178507,39611,68345,1.6535162473600356,0.27686630045533356
18988,0.5176309523809524,0,1,0,427104,178506,39611,68345,1.653506984326948,0.2768674220481181
18989,0.5176515151515151,0,1,0,427105,178505,39611,68345,1.6534977212938604,0.27686854364998986
18990,0.5176666666666666,3,14,3,427119,178491,39614,68342,1.6533680388306347,0.2768754583058181
18991,0.5176666666666667,1,6,1,427125,178485,39615,68341,1.6533124606321095,0.2768792590731933
18992,0.5177380952380952,0,5,0,427130,178480,39615,68341,1.6532661454666715,0.27688486798124956
18993,0.51775,1,1,1,427131,178479,39616,68340,1.653256882433584,0.2768830600561545
18994,0.5177777777777777,0,1,0,427132,178478,39616,68340,1.6532476194004966,0.27688418186680064
18995,0.5177777777777778,0,4,0,427136,178474,39616,68340,1.6532105672681463,0.2768886692002885
18996,0.5177777777777779,0,1,0,427137,178473,39616,68340,1.6532013042350586,0.27688979105638684
18997,0.5177857142857143,0,1,0,427138,178472,39616,68340,1.6531920412019712,0.2768909129215759
18998,0.5178333333333333,0,1,0,427139,178471,39616,68340,1.6531827781688837,0.27689203479585595
18999,0.5178333333333334,3,8,3,427147,178463,39619,68337,1.6531086739041831,0.27689222042139383
19000,0.5178571428571428,1,12,1,427159,178451,39620,68336,1.6529975175071325,0.27690275419693905
19001,0.5179047619047619,0,3,0,427162,178448,39620,68336,1.65296972840787,0.2769061203319502
19002,0.5179166666666667,0,2,0,427164,178446,39620,68336,1.6529512023416948,0.2769083644674247
19003,0.5179444444444444,1,1,1,427165,178445,39621,68335,1.6529419393086071,0.2769065564470378
19004,0.5179999999999999,0,2,0,427167,178443,39621,68335,1.6529234132424322,0.2769088006224218
19005,0.518,15,57,15,427224,178386,39636,68320,1.6523954203564415,0.2769288140539752
19006,0.5180238095238096,0,1,0,427225,178385,39636,68320,1.652386157323354,0.27692993656391235
19007,0.5180357142857143,0,1,0,427226,178384,39636,68320,1.6523768942902664,0.2769310590829496
19008,0.5180361860361861,0,4,0,427230,178380,39636,68320,1.6523398421579163,0.27693554925010133
19009,0.5180833333333333,1,1,1,427231,178379,39637,68319,1.6523305791248286,0.27693374084913536
19010,0.5181190476190476,1,4,1,427235,178375,39638,68318,1.6522935269924783,0.27693530015038936
19011,0.5181428571428571,1,5,1,427240,178370,39639,68317,1.6522472118270406,0.27693798213931015
19012,0.5181666666666666,0,1,0,427241,178369,39639,68317,1.6522379487939531,0.27693910477286915
19013,0.5181666666666667,5,24,5,427265,178345,39644,68312,1.6520156359998517,0.27695139404111785
19014,0.5181666666666668,0,2,0,427267,178343,39644,68312,1.6519971099336768,0.27695363969917497
19015,0.5181818181818182,1,0,1,427267,178343,39645,68311,1.6519971099336768,0.2769507082796144
19016,0.5181904761904762,0,1,0,427268,178342,39645,68311,1.651987846900589,0.2769518311149672
19017,0.5182142857142857,1,4,1,427272,178338,39646,68310,1.6519507947682388,0.2769533910674321
19018,0.5182857142857142,0,2,0,427274,178336,39646,68310,1.6519322687020639,0.2769556368236258
19019,0.5183095238095238,1,0,1,427274,178336,39647,68309,1.6519322687020639,0.2769527053051957
19020,0.5183214285714286,1,0,1,427274,178336,39648,68308,1.6519322687020639,0.27694977376299446
19021,0.5183333333333333,79,360,79,427634,177976,39727,68229,1.6485975767905443,0.27712272293414025
19022,0.5183333333333334,1,2,1,427636,177974,39728,68228,1.6485790507243692,0.277122038001316
19023,0.5183412698412698,0,1,0,427637,177973,39728,68228,1.6485697876912817,0.27712316359397404
19024,0.5183452380952381,0,2,0,427639,177971,39728,68228,1.6485512616251066,0.27712541480672137
19025,0.5183636363636362,0,1,0,427640,177970,39728,68228,1.6485419985920189,0.27712654042681095
19026,0.5183809523809524,0,3,0,427643,177967,39728,68228,1.6485142094927563,0.2771299173419444
19027,0.5184047619047619,1,0,1,427643,177967,39729,68227,1.6485142094927563,0.2771269811611981
19028,0.518452380952381,0,1,0,427644,177966,39729,68227,1.6485049464596688,0.2771281068105105
19029,0.5184761904761905,0,1,0,427645,177965,39729,68227,1.6484956834265811,0.2771292324689673
19030,0.5185,5,20,5,427665,177945,39734,68222,1.6483104227648302,0.277137065488063
19031,0.5185000000000001,0,2,0,427667,177943,39734,68222,1.648291896698655,0.2771393171246928
19032,0.5185238095238095,0,1,0,427668,177942,39734,68222,1.6482826336655674,0.277140442956728
19033,0.5185476190476191,0,1,0,427669,177941,39734,68222,1.64827337063248,0.27714156879791035
19034,0.5185714285714286,0,8,0,427677,177933,39734,68222,1.6481992663677794,0.2771505758566757
19035,0.5185866910866911,0,1,0,427678,177932,39734,68222,1.648190003334692,0.2771517017801864
19036,0.5185909090909092,0,3,0,427681,177929,39734,68222,1.6481622142354293,0.2771550796056079
19037,0.5186111111111111,0,2,0,427683,177927,39734,68222,1.6481436881692542,0.2771573315349646
19038,0.5186190476190476,1,3,1,427686,177924,39735,68221,1.6481158990699916,0.27715777285746207
19039,0.5186666666666666,1,5,1,427691,177919,39736,68220,1.6480695839045536,0.27716046624062013
19040,0.5186666666666667,4,21,4,427712,177898,39740,68216,1.647875060209715,0.27717236727695294
19041,0.5186904761904761,0,2,0,427714,177896,39740,68216,1.64785653414354,0.2771746196853465
19042,0.5186904761904763,0,1,0,427715,177895,39740,68216,1.6478472711104524,0.27717574590327126
19043,0.5187142857142857,1,3,1,427718,177892,39741,68215,1.6478194820111898,0.27717618759320134
19044,0.51875,1,10,1,427728,177882,39742,68214,1.6477268516803143,0.27718451336063976
19045,0.5187539682539682,0,1,0,427729,177881,39742,68214,1.6477175886472266,0.27718563969198884
19046,0.5187619047619049,1,0,1,427729,177881,39743,68213,1.6477175886472266,0.2771827025445561
19047,0.5187777777777778,0,1,0,427730,177880,39743,68213,1.6477083256141392,0.2771838288777007
19048,0.5187857142857143,1,2,1,427732,177878,39744,68212,1.647689799547964,0.27718314437807307
19049,0.5188095238095238,1,3,1,427735,177875,39745,68211,1.6476620104487014,0.2771835862259535
19050,0.5188253968253969,0,2,0,427737,177873,39745,68211,1.6476434843825263,0.2771858389818111
19051,0.5188333333333334,1,11,1,427748,177862,39746,68210,1.6475415910185631,0.27719529243473456
19052,0.5188484848484848,0,1,0,427749,177861,39746,68210,1.6475323279854757,0.27719641891974267
19053,0.5188571428571429,0,1,0,427750,177860,39746,68210,1.647523064952388,0.2771975454139066
19054,0.5188809523809524,1,0,1,427750,177860,39747,68209,1.647523064952388,0.2771946080164507
19055,0.5189166666666667,0,1,0,427751,177859,39747,68209,1.6475138019193005,0.2771957345124112
19056,0.5189242424242424,0,1,0,427752,177858,39747,68209,1.6475045388862128,0.2771968610175278
19057,0.5189999999999999,0,1,0,427753,177857,39747,68209,1.6474952758531254,0.2771979875318004
19058,0.519,7,66,7,427819,177791,39754,68202,1.6468839156693467,0.2772517917176505
19059,0.5190238095238096,0,3,0,427822,177788,39754,68202,1.646856126570084,0.27725517297451113
19060,0.519047619047619,0,2,0,427824,177786,39754,68202,1.646837600503909,0.2772574271915703
19061,0.5190476190476191,0,8,0,427832,177778,39754,68202,1.6467634962392086,0.2772664444263761
19062,0.5190714285714285,0,1,0,427833,177777,39754,68202,1.646754233206121,0.27726757162196775
19063,0.5190833333333333,0,3,0,427836,177774,39754,68202,1.6467264441068583,0.277270953263733
19064,0.519095238095238,0,1,0,427837,177773,39754,68202,1.6467171810737709,0.27727208049598534
19065,0.5191190476190476,0,1,0,427838,177772,39754,68202,1.6467079180406832,0.27727320773740316
19066,0.5191428571428571,0,4,0,427842,177768,39754,68202,1.6466708659083331,0.27727771679473107
19067,0.5191666666666667,19,103,19,427945,177665,39773,68183,1.6457167735003149,0.27733803000227786
19068,0.5191666666666668,0,1,0,427946,177664,39773,68183,1.6457075104672274,0.27733915809426185
19069,0.5191717171717172,0,1,0,427947,177663,39773,68183,1.6456982474341397,0.27734028619542317
19070,0.5191904761904762,0,2,0,427949,177661,39773,68183,1.6456797213679648,0.27734254242527784
19071,0.5192142857142857,0,1,0,427950,177660,39773,68183,1.6456704583348771,0.2773436705539714
19072,0.5192261904761906,0,2,0,427952,177658,39773,68183,1.645651932268702,0.2773459268388918
19073,0.5192272727272728,0,2,0,427954,177656,39773,68183,1.6456334062025268,0.27734818316052373
19074,0.5192777777777777,0,1,0,427955,177655,39773,68183,1.6456241431694394,0.2773493113351069
19075,0.5192857142857142,0,1,0,427956,177654,39773,68183,1.645614880136352,0.2773504395188682
19076,0.5192857142857144,0,5,0,427961,177649,39773,68183,1.645568564970914,0.27735608057535227
19077,0.5193095238095239,0,1,0,427962,177648,39773,68183,1.6455593019378265,0.27735720881418535
19078,0.5193333333333333,1,17,1,427979,177631,39774,68182,1.6454018303753382,0.27737345054980816
19079,0.5193333333333334,8,32,8,428011,177599,39782,68174,1.6451054133165364,0.2773860432187425
19080,0.5193809523809524,0,3,0,428014,177596,39782,68174,1.6450776242172738,0.27738942914106685
19081,0.5193928571428572,0,1,0,428015,177595,39782,68174,1.645068361184186,0.27739055780021077
19082,0.5193968253968254,0,1,0,428016,177594,39782,68174,1.6450590981510986,0.27739168646853946
19083,0.5194047619047619,1,3,1,428019,177591,39783,68173,1.645031309051836,0.27739213228951354
19084,0.5194166666666667,0,3,0,428022,177588,39783,68173,1.6450035199525732,0.27739551841016274
19085,0.5194444444444444,0,2,0,428024,177586,39783,68173,1.644984993886398,0.27739777586985626
19086,0.5194761904761905,0,1,0,428025,177585,39783,68173,1.6449757308533106,0.27739890461348155
19087,0.519484126984127,1,1,1,428026,177584,39784,68172,1.6449664678202232,0.2773970930516447
19088,0.5194999999999999,0,1,0,428027,177583,39784,68172,1.6449572047871355,0.2773982218062705
19089,0.5195,1,5,1,428032,177578,39785,68171,1.6449108896216977,0.2774009253343859
19090,0.5195000000000001,5,13,5,428045,177565,39790,68166,1.6447904701915594,0.27740089772963117
19091,0.5195238095238095,1,2,1,428047,177563,39791,68165,1.6447719441253845,0.2774002148717281
19092,0.5195238095238096,0,2,0,428049,177561,39791,68165,1.6447534180592094,0.2774024726728144
19093,0.5195833333333333,1,1,1,428050,177560,39792,68164,1.6447441550261217,0.2774006609041038
19094,0.5195833333333334,0,2,0,428052,177558,39792,68164,1.6447256289599466,0.27740291874557427
19095,0.5196190476190476,0,1,0,428053,177557,39792,68164,1.644716365926859,0.27740404768009247
19096,0.5196428571428572,0,3,0,428056,177554,39792,68164,1.6446885768275965,0.27740743453878025
19097,0.5196666666666666,5,8,5,428064,177546,39797,68159,1.644614472562896,0.27740176227589997
19098,0.5196666666666667,1,11,1,428075,177535,39798,68158,1.6445125791989328,0.2774112408574929
19099,0.5196746031746031,0,1,0,428076,177534,39798,68158,1.6445033161658453,0.2774123699591358
19100,0.5196904761904761,0,1,0,428077,177533,39798,68158,1.6444940531327579,0.27741349906997
19101,0.5197499999999999,0,2,0,428079,177531,39798,68158,1.6444755270665827,0.2774157573192125
19102,0.5197619047619046,0,5,0,428084,177526,39798,68158,1.644429211901145,0.2774214031031732
19103,0.5197619047619049,0,2,0,428086,177524,39798,68158,1.6444106858349699,0.2774236614811016
19104,0.5197857142857143,1,0,1,428086,177524,39799,68157,1.6444106858349699,0.2774207203650262
19105,0.5197915417915419,0,1,0,428087,177523,39799,68157,1.6444014228018822,0.2774218495604038
19106,0.5198095238095238,0,2,0,428089,177521,39799,68157,1.644382896735707,0.2774241079787364
19107,0.5198333333333333,1,6,1,428095,177515,39800,68156,1.6443273185371818,0.2774279422479658
19108,0.5198333333333334,2,10,2,428105,177505,39802,68154,1.6442346882063064,0.27743335273692393
19109,0.5198809523809524,0,1,0,428106,177504,39802,68154,1.6442254251732187,0.27743448208484967
19110,0.5198888888888888,1,0,1,428106,177504,39803,68153,1.6442254251732187,0.2774315407254831
19111,0.5199047619047619,0,2,0,428108,177502,39803,68153,1.6442068991070435,0.2774337994341658
19112,0.5199166666666667,0,1,0,428109,177501,39803,68153,1.644197636073956,0.27743492880229914
19113,0.5199246031746031,0,1,0,428110,177500,39803,68153,1.6441883730408684,0.27743605817962735
19114,0.5199523809523809,0,2,0,428112,177498,39803,68153,1.6441698469746935,0.27743831696186866
19115,0.519952380952381,0,2,0,428114,177496,39803,68153,1.6441513209085183,0.2774405757808906
19116,0.5199761904761906,1,1,1,428115,177495,39804,68152,1.6441420578754307,0.2774387637544932
19117,0.5199999999999999,7,28,7,428143,177467,39811,68145,1.6438826929489792,0.27744979886976207
19118,0.52,506,2733,506,430876,174734,40317,67639,1.6185668235206936,0.27906986339237455
19119,0.5200238095238096,0,2,0,430878,174732,40317,67639,1.6185482974545184,0.27907216622450703
19120,0.5200357142857143,0,1,0,430879,174731,40317,67639,1.618539034421431,0.2790733176548253
19121,0.52003663003663,2,0,2,430879,174731,40319,67637,1.618539034421431,0.27906736862952203
19122,0.5200952380952382,0,1,0,430880,174730,40319,67637,1.6185297713883433,0.27906852005429783
19123,0.5201190476190476,1,0,1,430880,174730,40320,67636,1.6185297713883433,0.2790655454973057
19124,0.5201190476190477,0,1,0,430881,174729,40320,67636,1.6185205083552558,0.27906669692406083
19125,0.5201428571428572,0,2,0,430883,174727,40320,67636,1.6185019822890807,0.279068999806076
19126,0.5201515151515151,0,1,0,430884,174726,40320,67636,1.6184927192559933,0.27907015126133633
19127,0.5201666666666667,4,8,4,430892,174718,40324,67632,1.6184186149912927,0.27906746441097585
19128,0.5201666666666668,0,2,0,430894,174716,40324,67632,1.6184000889251176,0.27906976744186046
19129,0.5201904761904762,0,1,0,430895,174715,40324,67632,1.61839082589203,0.27907091897155734
19130,0.5202380952380952,0,1,0,430896,174714,40324,67632,1.6183815628589426,0.27907207051075733
19131,0.5202380952380953,0,3,0,430899,174711,40324,67632,1.6183537737596798,0.27907552518537776
19132,0.52025,0,2,0,430901,174709,40324,67632,1.6183352476935047,0.27907782834930944
19133,0.5202777777777777,0,1,0,430902,174708,40324,67632,1.6183259846604172,0.27907897994553105
19134,0.5202777777777778,0,1,0,430903,174707,40324,67632,1.6183167216273298,0.2790801315512567
19135,0.5203095238095239,0,1,0,430904,174706,40324,67632,1.618307458594242,0.2790812831664865
19136,0.5203333333333332,0,1,0,430905,174705,40324,67632,1.6182981955611546,0.27908243479122047
19137,0.5203333333333333,5,12,5,430917,174693,40329,67627,1.618187039164104,0.27908137999339716
19138,0.5203333333333334,3,7,3,430924,174686,40332,67624,1.6181221979324911,0.2790805166934918
19139,0.5203571428571429,0,2,0,430926,174684,40332,67624,1.618103671866316,0.2790828202122918
19140,0.520357142857143,0,1,0,430927,174683,40332,67624,1.6180944088332283,0.2790839719859517
19141,0.5203809523809524,0,1,0,430928,174682,40332,67624,1.6180851458001408,0.27908512376911837
19142,0.5204047619047618,0,1,0,430929,174681,40332,67624,1.6180758827670532,0.27908627556179194
19143,0.5204047619047619,0,1,0,430930,174680,40332,67624,1.6180666197339657,0.2790874273639725
19144,0.5204166666666666,0,2,0,430932,174678,40332,67624,1.6180480936677906,0.2790897309968552
19145,0.5204166666666667,0,4,0,430936,174674,40332,67624,1.6180110415354403,0.27909433837670966
19146,0.5204285714285715,0,1,0,430937,174673,40332,67624,1.6180017785023528,0.27909549024544256
19147,0.5204404761904761,1,0,1,430937,174673,40333,67623,1.6180017785023528,0.2790925149404035
19148,0.520452380952381,1,0,1,430937,174673,40334,67622,1.6180017785023528,0.279089539610805
19149,0.5204761904761905,1,1,1,430938,174672,40335,67621,1.6179925154692651,0.2790877161123103
19150,0.5205,3,16,3,430954,174656,40338,67618,1.6178443069398645,0.2790972205024064
19151,0.5205000000000001,0,7,0,430961,174649,40338,67618,1.6177794657082516,0.279105284665266
19152,0.5205238095238096,0,2,0,430963,174647,40338,67618,1.6177609396420765,0.2791075887973913
19153,0.5205454545454545,0,1,0,430964,174646,40338,67618,1.6177516766089888,0.2791087408777202
19154,0.5205555555555555,1,0,1,430964,174646,40339,67617,1.6177516766089888,0.27910576522209335
19155,0.5205833333333334,0,1,0,430965,174645,40339,67617,1.6177424135759013,0.27910691730440595
19156,0.5205952380952381,1,0,1,430965,174645,40340,67616,1.6177424135759013,0.2791039416166861
19157,0.5206111111111111,2,0,2,430965,174645,40342,67614,1.6177424135759013,0.27909799016754794
19158,0.5206428571428572,0,1,0,430966,174644,40342,67614,1.6177331505428136,0.2790991422367889
19159,0.5206666666666666,6,30,6,430996,174614,40348,67608,1.6174552595501872,0.2791158523998646
19160,0.5206666666666667,2,13,2,431009,174601,40350,67606,1.617334840120049,0.2791248807837924
19161,0.5207142857142857,2,5,2,431014,174596,40352,67604,1.6172885249546112,0.2791246903385632
19162,0.5207142857142858,0,4,0,431018,174592,40352,67604,1.617251472822261,0.27912930023617233
19163,0.5207380952380952,0,1,0,431019,174591,40352,67604,1.6172422097891734,0.27913045273436693
19164,0.5207402597402598,1,0,1,431019,174591,40353,67603,1.6172422097891734,0.2791274763206355
19165,0.5207619047619049,1,0,1,431019,174591,40354,67602,1.6172422097891734,0.27912449988232524
19166,0.5207857142857142,0,1,0,431020,174590,40354,67602,1.6172329467560858,0.2791256523749752
19167,0.5207857142857143,0,2,0,431022,174588,40354,67602,1.6172144206899106,0.27912795738882695
19168,0.5208333333333333,8,42,8,431064,174546,40362,67594,1.6168253733002333,0.2791525563723466
19169,0.5208333333333334,16,59,16,431123,174487,40378,67578,1.6162788543480677,0.2791729494144135
19170,0.5208333333333335,0,1,0,431124,174486,40378,67578,1.6162695913149803,0.2791741027166369
19171,0.5208452380952382,0,1,0,431125,174485,40378,67578,1.6162603282818926,0.27917525602838933
19172,0.5208571428571428,0,2,0,431127,174483,40378,67578,1.6162418022157174,0.2791775626804814
19173,0.5208571428571429,0,4,0,431131,174479,40378,67578,1.6162047500833674,0.279182176099018
19174,0.5208809523809524,0,1,0,431132,174478,40378,67578,1.6161954870502797,0.27918332947747626
19175,0.520952380952381,0,2,0,431134,174476,40378,67578,1.6161769609841046,0.27918563626298265
19176,0.5209523809523811,0,2,0,431136,174474,40378,67578,1.6161584349179294,0.2791879430866095
19177,0.5209642857142857,0,1,0,431137,174473,40378,67578,1.616149171884842,0.2791890965127184
19178,0.5209999999999999,1,5,1,431142,174468,40379,67577,1.6161028567194042,0.27919188580635834
19179,0.521,14,66,14,431208,174402,40393,67563,1.6154914965356255,0.2792263343872048
19180,0.5210000000000001,0,1,0,431209,174401,40393,67563,1.615482233502538,0.27922748838670214
19181,0.5210238095238096,0,1,0,431210,174400,40393,67563,1.6154729704694506,0.2792286423957382
19182,0.5210246464062254,0,4,0,431214,174396,40393,67563,1.6154359183371003,0.27923325852727116
19183,0.521047619047619,0,2,0,431216,174394,40393,67563,1.6154173922709252,0.27923556665027255
19184,0.5210649350649351,0,2,0,431218,174392,40393,67563,1.61539886620475,0.27923787481143186
19185,0.5210714285714285,0,3,0,431221,174389,40393,67563,1.6153710771054874,0.27924133712471894
19186,0.5210714285714286,0,2,0,431223,174387,40393,67563,1.6153525510393123,0.2792436453812771
19187,0.5211190476190477,0,1,0,431224,174386,40393,67563,1.6153432880062248,0.2792447995238666
19188,0.5211309523809523,0,1,0,431225,174385,40393,67563,1.6153340249731372,0.27924595367599647
19189,0.521142857142857,0,1,0,431226,174384,40393,67563,1.6153247619400497,0.27924710783766693
19190,0.5211428571428571,0,1,0,431227,174383,40393,67563,1.615315498906962,0.27924826200887803
19191,0.5211428571428572,1,0,1,431227,174383,40394,67562,1.615315498906962,0.2792452830188679
19192,0.5211666666666666,1,3,1,431230,174380,40395,67561,1.6152877098076994,0.27924576652985644
19193,0.5211666666666667,2,7,2,431237,174373,40397,67559,1.6152228685760865,0.2792478878362515
19194,0.5211666666666668,0,2,0,431239,174371,40397,67559,1.6152043425099114,0.27925019633778364
19195,0.5211904761904761,2,1,2,431240,174370,40399,67557,1.615195079476824,0.27924539220508665
19196,0.5211904761904762,0,6,0,431246,174364,40399,67557,1.6151395012782985,0.2792523179054319
19197,0.5212142857142856,0,2,0,431248,174362,40399,67557,1.6151209752121234,0.2792546265485555
19198,0.52125,0,2,0,431250,174360,40399,67557,1.6151024491459482,0.27925693522985157
19199,0.5212619047619047,1,1,1,431251,174359,40400,67556,1.6150931861128608,0.2792551102660025
19200,0.5212720057720057,0,1,0,431252,174358,40400,67556,1.6150839230797733,0.2792562646229652
19201,0.5212857142857142,1,0,1,431252,174358,40401,67555,1.6150839230797733,0.27925328527197796
19202,0.5213095238095238,0,1,0,431253,174357,40401,67555,1.6150746600466857,0.27925443963094015
19203,0.5213333333333332,3,5,3,431258,174352,40404,67552,1.615028344881248,0.27925127323235666
19204,0.5213333333333333,5,19,5,431277,174333,40409,67547,1.6148523472525844,0.27925830990573836
19205,0.5213333333333334,0,1,0,431278,174332,40409,67547,1.6148430842194967,0.2792594644429653
19206,0.5213571428571427,0,2,0,431280,174330,40409,67547,1.6148245581533218,0.2792617735460585
19207,0.5213611111111112,0,4,0,431284,174326,40409,67547,1.6147875060209715,0.27926639186680613
19208,0.5214166666666666,0,1,0,431285,174325,40409,67547,1.6147782429878839,0.2792675464708606
19209,0.5214246031746032,0,1,0,431286,174324,40409,67547,1.6147689799547964,0.2792687010844624
19210,0.5214285714285714,2,0,2,431286,174324,40411,67545,1.6147689799547964,0.2792627414013371
19211,0.5214285714285715,0,6,0,431292,174318,40411,67545,1.614713401756271,0.2792696691928902
19212,0.5214523809523809,0,1,0,431293,174317,40411,67545,1.6147041387231835,0.2792708238582332
19213,0.5214697802197801,0,1,0,431294,174316,40411,67545,1.614694875690096,0.2792719785331244
19214,0.5215,2,15,2,431309,174301,40413,67543,1.6145559301937826,0.27928333967350855
19215,0.5215000000000001,1,3,1,431312,174298,40414,67542,1.61452814109452,0.27928382401587826
19216,0.521530303030303,0,1,0,431313,174297,40414,67542,1.6145188780614323,0.2792849788495652
19217,0.5215384615384615,0,1,0,431314,174296,40414,67542,1.614509615028345,0.27928613369280264
19218,0.5215476190476189,1,0,1,431314,174296,40415,67541,1.614509615028345,0.2792831535290299
19219,0.521547619047619,0,1,0,431315,174295,40415,67541,1.6145003519952574,0.27928430837427015
19220,0.5215476190476191,1,2,1,431317,174293,40416,67540,1.6144818259290823,0.2792836378823403
19221,0.5215833333333333,0,1,0,431318,174292,40416,67540,1.6144725628959946,0.27928479274868506
19222,0.5215909090909091,0,3,0,431321,174289,40416,67540,1.614444773796732,0.2792882574050259
19223,0.5215952380952382,0,3,0,431324,174286,40416,67540,1.6144169846974694,0.27929172214732906
19224,0.5216666666666666,35,225,35,431549,174061,40451,67505,1.6123328022527696,0.2794474387951947
19225,0.5216666666666667,24,129,24,431678,173932,40475,67481,1.6111378709844753,0.2795251291355478
19226,0.5216904761904763,0,1,0,431679,173931,40475,67481,1.6111286079513876,0.2795262870114162
19227,0.5217023809523809,1,0,1,431679,173931,40476,67480,1.6111286079513876,0.27952330258356084
19228,0.5217142857142857,1,0,1,431679,173931,40477,67479,1.6111286079513876,0.2795203181309805
19229,0.5217222222222222,0,1,0,431680,173930,40477,67479,1.6111193449183001,0.279521476001309
19230,0.5217500000000002,0,1,0,431681,173929,40477,67479,1.6111100818852124,0.2795226338812301
19231,0.5217777777777779,0,1,0,431682,173928,40477,67479,1.611100818852125,0.279523791770744
19232,0.5217857142857142,0,1,0,431683,173927,40477,67479,1.6110915558190373,0.2795249496698508
19233,0.5217857142857143,0,2,0,431685,173925,40477,67479,1.6110730297528624,0.2795272654968435
19234,0.5218333333333333,2,1,2,431686,173924,40479,67477,1.6110637667197747,0.27952245433946005
19235,0.5218333333333334,3,11,3,431697,173913,40482,67474,1.6109618733558115,0.27952623794984816
19236,0.5218571428571428,0,1,0,431698,173912,40482,67474,1.610952610322724,0.2795273959550264
19237,0.5218809523809523,1,1,1,431699,173911,40483,67473,1.6109433472896366,0.27952556921751237
19238,0.5218888888888888,1,0,1,431699,173911,40484,67472,1.6109433472896366,0.279522584440495
19239,0.5219047619047619,0,1,0,431700,173910,40484,67472,1.610934084256549,0.279523742449727
19240,0.5219166666666666,0,1,0,431701,173909,40484,67472,1.6109248212234615,0.2795249004685539
19241,0.5219166666666667,0,1,0,431702,173908,40484,67472,1.6109155581903738,0.2795260584969757
19242,0.5219191919191918,0,1,0,431703,173907,40484,67472,1.6109062951572863,0.2795272165349927
19243,0.5219206349206349,0,1,0,431704,173906,40484,67472,1.6108970321241987,0.2795283745826049
19244,0.521952380952381,1,0,1,431704,173906,40485,67471,1.6108970321241987,0.2795253897430161
19245,0.5219999999999999,1,7,1,431711,173899,40486,67470,1.6108321908925858,0.27953051137470014
19246,0.522,11,56,11,431767,173843,40497,67459,1.6103134610396828,0.27956253988777546
19247,0.5220000000000001,0,1,0,431768,173842,40497,67459,1.6103041980065953,0.27956369845131185
19248,0.5220238095238094,1,1,1,431769,173841,40498,67458,1.6102949349735076,0.27956187137120336
19249,0.5220238095238096,0,1,0,431770,173840,40498,67458,1.6102856719404202,0.2795630299463734
19250,0.522047619047619,1,0,1,431770,173840,40499,67457,1.6102856719404202,0.2795600442608072
19251,0.5220512820512819,1,0,1,431770,173840,40500,67456,1.6102856719404202,0.279557058550494
19252,0.522082251082251,0,1,0,431771,173839,40500,67456,1.6102764089073327,0.2795582171201227
19253,0.5220833333333332,1,1,1,431772,173838,40501,67455,1.610267145874245,0.27955638994914894
19254,0.5220833333333333,0,1,0,431773,173837,40501,67455,1.6102578828411576,0.27955754853041126
19255,0.5220952380952382,0,2,0,431775,173835,40501,67455,1.6102393567749824,0.2795598657217456
19256,0.5221428571428571,1,12,1,431787,173823,40502,67454,1.6101282003779318,0.2795707837879284
19257,0.5221666666666667,3,8,3,431795,173815,40505,67451,1.6100540961132312,0.2795710958029727
19258,0.5221666666666668,0,1,0,431796,173814,40505,67451,1.6100448330801438,0.2795722545748451
19259,0.5221904761904761,0,1,0,431797,173813,40505,67451,1.610035570047056,0.27957341335632335
19260,0.5222142857142857,0,1,0,431798,173812,40505,67451,1.6100263070139686,0.2795745721474076
19261,0.5222222222222223,1,3,1,431801,173809,40506,67450,1.609998517914706,0.2795750624847156
19262,0.5222619047619049,0,1,0,431802,173808,40506,67450,1.6099892548816184,0.279576221306651
19263,0.5222698412698413,1,1,1,431803,173807,40507,67449,1.609979991848531,0.2795743940047087
19264,0.5222857142857142,0,1,0,431804,173806,40507,67449,1.6099707288154432,0.27957555283828317
19265,0.5222857142857144,1,2,1,431806,173804,40508,67448,1.6099522027492683,0.2795748843532903
19266,0.5222976190476188,0,2,0,431808,173802,40508,67448,1.6099336766830932,0.27957720207253883
19267,0.5223333333333333,10,34,10,431842,173768,40518,67438,1.6096187335581162,0.27958674328167626
19268,0.5223571428571429,1,1,1,431843,173767,40519,67437,1.6096094705250288,0.2795849156730402
19269,0.5223809523809524,1,3,1,431846,173764,40520,67436,1.609581681425766,0.2795854063018242
19270,0.5224047619047619,0,1,0,431847,173763,40520,67436,1.6095724183926785,0.2795865654501055
19271,0.5224166666666666,0,1,0,431848,173762,40520,67436,1.609563155359591,0.2795877246079984
19272,0.522452380952381,0,1,0,431849,173761,40520,67436,1.6095538923265034,0.279588883775503
19273,0.5224761904761905,0,2,0,431851,173759,40520,67436,1.6095353662603282,0.27959120213934785
19274,0.5224880952380953,0,1,0,431852,173758,40520,67436,1.6095261032272408,0.27959236133568827
19275,0.5224935064935066,0,1,0,431853,173757,40520,67436,1.609516840194153,0.27959352054164094
19276,0.5225,50,328,50,432181,173429,40570,67386,1.6064785653414353,0.27982476174656895
19277,0.5225000000000001,3,16,3,432197,173413,40573,67383,1.6063303568120346,0.27983438263094074
19278,0.5225357142857142,0,1,0,432198,173412,40573,67383,1.606321093778947,0.27983554475798916
19279,0.522547619047619,0,4,0,432202,173408,40573,67383,1.6062840416465967,0.27984019336270877
19280,0.5225476190476191,0,1,0,432203,173407,40573,67383,1.6062747786135092,0.2798413555380207
19281,0.5225714285714286,0,1,0,432204,173406,40573,67383,1.6062655155804217,0.2798425177229857
19282,0.5225833333333334,0,2,0,432206,173404,40573,67383,1.6062469895142466,0.2798448421218753
19283,0.5226190476190475,0,2,0,432208,173402,40573,67383,1.6062284634480715,0.2798471665593787
19284,0.5226190476190476,0,2,0,432210,173400,40573,67383,1.6062099373818963,0.27984949103549667
19285,0.5226666666666666,12,34,12,432244,173366,40585,67371,1.6058949942569194,0.2798531177176753
19286,0.5226666666666667,0,9,0,432253,173357,40585,67371,1.6058116269591316,0.27986358047256654
19287,0.5227222222222222,0,2,0,432255,173355,40585,67371,1.6057931008929565,0.27986590563545277
19288,0.5227272727272727,0,1,0,432256,173354,40585,67371,1.6057838378598688,0.27986706823138435
19289,0.5227380952380952,0,1,0,432257,173353,40585,67371,1.6057745748267813,0.27986823083697515
19290,0.5227499999999999,0,1,0,432258,173352,40585,67371,1.6057653117936936,0.27986939345222517
19291,0.5227619047619048,0,1,0,432259,173351,40585,67371,1.6057560487606062,0.2798705560771346
19292,0.5227777777777779,0,4,0,432263,173347,40585,67371,1.605718996628256,0.27987520667336885
19293,0.5228095238095238,0,3,0,432266,173344,40585,67371,1.6056912075289933,0.27987869472197413
19294,0.5228333333333333,0,9,0,432275,173335,40585,67371,1.6056078402312053,0.2798891593894627
19295,0.5228333333333334,1,6,1,432281,173329,40586,67370,1.60555226203268,0.27989314454983194
19296,0.5228571428571428,0,8,0,432289,173321,40586,67370,1.6054781577679795,0.2799024475364679
19297,0.5228787878787879,0,1,0,432290,173320,40586,67370,1.605468894734892,0.27990361045328016
19298,0.5228961038961039,0,1,0,432291,173319,40586,67370,1.6054596317018044,0.2799047733797556
19299,0.5229047619047619,0,1,0,432292,173318,40586,67370,1.605450368668717,0.27990593631589444
19300,0.5229166666666667,0,2,0,432294,173316,40586,67370,1.6054318426025418,0.2799082622171626
19301,0.5229523809523811,1,0,1,432294,173316,40587,67369,1.6054318426025418,0.2799052703741405
19302,0.5229761904761905,1,0,1,432294,173316,40588,67368,1.6054318426025418,0.27990227850625715
19303,0.5229999999999999,0,1,0,432295,173315,40588,67368,1.6054225795694541,0.2799034414561893
19304,0.523,8,55,8,432350,173260,40596,67360,1.6049131127496388,0.27994347934502534
19305,0.5230198412698414,1,0,1,432350,173260,40597,67359,1.6049131127496388,0.2799404868277235
19306,0.5230238095238096,0,3,0,432353,173257,40597,67359,1.6048853236503762,0.2799439771253782
19307,0.5230555555555556,0,1,0,432354,173256,40597,67359,1.6048760606172885,0.27994514057727077
19308,0.5230952380952381,0,3,0,432357,173253,40597,67359,1.604848271518026,0.279948630990973
19309,0.5231111111111111,0,1,0,432358,173252,40597,67359,1.6048390084849382,0.27994979448154905
19310,0.5231194083694082,0,1,0,432359,173251,40597,67359,1.6048297454518508,0.27995095798179626
19311,0.5231428571428571,1,0,1,432359,173251,40598,67358,1.6048297454518508,0.2799479653712039
19312,0.5231428571428572,0,1,0,432360,173250,40598,67358,1.6048204824187633,0.2799491288735204
19313,0.5231666666666666,0,1,0,432361,173249,40598,67358,1.6048112193856756,0.27995029238550834
19314,0.5231666666666667,2,8,2,432369,173241,40600,67356,1.6047371151209753,0.2799536153817379
19315,0.5232142857142857,2,2,2,432371,173239,40602,67354,1.6047185890548001,0.27994995698129205
19316,0.52325,1,5,1,432376,173234,40603,67353,1.6046722738893624,0.2799527821536492
19317,0.5232619047619048,0,2,0,432378,173232,40603,67353,1.6046537478231873,0.27995510942078683
19318,0.5232777777777778,0,1,0,432379,173231,40603,67353,1.6046444847900996,0.2799562730688658
19319,0.5232857142857142,0,2,0,432381,173229,40603,67353,1.6046259587239247,0.27995860039404447
19320,0.5232857142857144,0,1,0,432382,173228,40603,67353,1.604616695690837,0.2799597640711444
19321,0.5232871572871572,0,2,0,432384,173226,40603,67353,1.6045981696246618,0.27996209145436635
19322,0.5233095238095238,0,3,0,432387,173223,40603,67353,1.6045703805253992,0.2799655826017558
19323,0.5233333333333333,96,604,96,432991,172619,40699,67257,1.5989755085405164,0.28038236422151447
19324,0.5233333333333334,0,2,0,432993,172617,40699,67257,1.5989569824743415,0.2803847019685335
19325,0.5233571428571429,0,1,0,432994,172616,40699,67257,1.5989477194412538,0.28038587085666167
19326,0.5234166666666666,1,0,1,432994,172616,40700,67256,1.5989477194412538,0.28038287086446106
19327,0.5234206349206348,0,1,0,432995,172615,40700,67256,1.5989384564081663,0.2803840397547015
19328,0.5234285714285715,2,1,2,432996,172614,40702,67254,1.5989291933750787,0.2803792085647106
19329,0.5234523809523809,0,3,0,432999,172611,40702,67254,1.598901404275816,0.2803827152773435
19330,0.523452380952381,0,1,0,433000,172610,40702,67254,1.5988921412427286,0.28038388420104726
19331,0.5234761904761905,0,1,0,433001,172609,40702,67254,1.598882878209641,0.28038505313449763
19332,0.5235,4,30,4,433031,172579,40706,67250,1.5986049872170143,0.2804081241217701
19333,0.5235000000000001,1,2,1,433033,172577,40707,67249,1.5985864611508391,0.2804074620766723
19334,0.5235454545454545,0,1,0,433034,172576,40707,67249,1.5985771981177517,0.2804086312936516
19335,0.523547619047619,0,1,0,433035,172575,40707,67249,1.5985679350846642,0.2804098005203816
19336,0.5235555555555554,0,1,0,433036,172574,40707,67249,1.5985586720515765,0.28041096975686236
19337,0.5235555555555556,1,0,1,433036,172574,40708,67248,1.5985586720515765,0.28040796924385586
19338,0.5235606060606061,0,1,0,433037,172573,40708,67248,1.598549409018489,0.28040913848245147
19339,0.5235714285714286,1,8,1,433045,172565,40709,67247,1.5984753047537885,0.28041549213550615
19340,0.5235833333333333,0,1,0,433046,172564,40709,67247,1.598466041720701,0.28041666145422856
19341,0.5236190476190477,0,1,0,433047,172563,40709,67247,1.5984567786876134,0.280417830782703
19342,0.5236428571428572,0,1,0,433048,172562,40709,67247,1.598447515654526,0.2804190001209296
19343,0.5236666666666666,0,8,0,433056,172554,40709,67247,1.5983734113898256,0.28042835517783493
19344,0.5236666666666667,2,16,2,433072,172538,40711,67245,1.5982252028604247,0.28044106546335645
19345,0.5236904761904762,1,3,1,433075,172535,40712,67244,1.5981974137611619,0.2804415732820639
19346,0.5237063492063492,0,1,0,433076,172534,40712,67244,1.5981881507280744,0.28044274287048854
19347,0.5237142857142857,0,3,0,433079,172531,40712,67244,1.5981603616288118,0.2804462516942967
19348,0.52375,3,10,3,433089,172521,40715,67241,1.5980677312979361,0.28044894520399394
19349,0.5237619047619048,0,1,0,433090,172520,40715,67241,1.5980584682648487,0.280450114906094
19350,0.5237777777777778,0,1,0,433091,172519,40715,67241,1.5980492052317612,0.28045128461795127
19351,0.5237857142857143,0,1,0,433092,172518,40715,67241,1.5980399421986735,0.280452454339566
19352,0.5238095238095238,0,20,0,433112,172498,40715,67241,1.5978546815369226,0.28047585082110127
19353,0.5238333333333333,1,1,1,433113,172497,40716,67240,1.5978454185038349,0.2804740194463099
19354,0.5238333333333334,0,13,0,433126,172484,40716,67240,1.5977249990736966,0.28048922928033904
19355,0.5238571428571429,0,1,0,433127,172483,40716,67240,1.5977157360406091,0.2804903993359002
19356,0.5238690476190476,1,1,1,433128,172482,40717,67239,1.5977064730075217,0.2804885679602538
19357,0.5239166666666667,0,1,0,433129,172481,40717,67239,1.597697209974434,0.280489738027699
19358,0.5239285714285714,0,3,0,433132,172478,40717,67239,1.5976694208751714,0.280493248288607
19359,0.5239393939393939,1,0,1,433132,172478,40718,67238,1.5976694208751714,0.28049024679203727
19360,0.523952380952381,1,3,1,433135,172475,40719,67237,1.5976416317759088,0.2804907555733547
19361,0.5239545454545455,0,1,0,433136,172474,40719,67237,1.597632368742821,0.28049192569385634
19362,0.5239761904761905,0,2,0,433138,172472,40719,67237,1.597613842676646,0.28049426596414817
19363,0.524,17,91,17,433229,172381,40736,67220,1.5967709066656786,0.2805497472882
19364,0.5240000000000002,0,2,0,433231,172379,40736,67220,1.5967523805995034,0.2805520891155639
19365,0.5240238095238094,0,1,0,433232,172378,40736,67220,1.596743117566416,0.2805532600439069
19366,0.5240238095238096,0,1,0,433233,172377,40736,67220,1.5967338545333285,0.280554430982024
19367,0.5240476190476191,2,6,2,433239,172371,40738,67218,1.596678276334803,0.2805554512101975
19368,0.5240595238095239,0,4,0,433243,172367,40738,67218,1.5966412242024528,0.2805601352338419
19369,0.5240833333333333,1,0,1,433243,172367,40739,67217,1.5966412242024528,0.28055713236276214
19370,0.5240952380952382,0,1,0,433244,172366,40739,67217,1.5966319611693653,0.28055830338546556
19371,0.5241428571428571,1,0,1,433244,172366,40740,67216,1.5966319611693653,0.28055530048167227
19372,0.5241666666666664,0,2,0,433246,172364,40740,67216,1.5966134351031902,0.2805576425411136
19373,0.5241666666666666,2,3,2,433249,172361,40742,67214,1.5965856460039276,0.2805551497443389
19374,0.5241666666666667,24,127,24,433376,172234,40766,67190,1.5954092408018081,0.28063184977278804
19375,0.5241666666666668,1,0,1,433376,172234,40767,67189,1.5954092408018081,0.2806288451819583
19376,0.5241904761904762,0,1,0,433377,172233,40767,67189,1.5953999777687207,0.28063001729164405
19377,0.5241904761904763,0,1,0,433378,172232,40767,67189,1.595390714735633,0.280631189411121
19378,0.5242142857142857,1,0,1,433378,172232,40768,67188,1.595390714735633,0.2806281847798847
19379,0.5242420634920635,0,2,0,433380,172230,40768,67188,1.5953721886694578,0.2806305290329048
19380,0.5242857142857144,4,15,4,433395,172215,40772,67184,1.5952332431731446,0.2806360928825935
19381,0.5243333333333332,1,1,1,433396,172214,40773,67183,1.595223980140057,0.28063426024553356
19382,0.5243333333333333,3,29,3,433425,172185,40776,67180,1.594955352180518,0.28065924425041255
19383,0.5243333333333334,0,4,0,433429,172181,40776,67180,1.5949183000481677,0.28066393439198534
19384,0.5243809523809523,0,2,0,433431,172179,40776,67180,1.5948997739819926,0.2806662795215555
19385,0.5243809523809524,1,2,1,433433,172177,40777,67179,1.5948812479158176,0.2806656194120891
19386,0.5243888888888889,0,1,0,433434,172176,40777,67179,1.59487198488273,0.2806667920035094
19387,0.5244047619047618,0,2,0,433436,172174,40777,67179,1.5948534588165548,0.2806691372157441
19388,0.5244047619047619,0,2,0,433438,172172,40777,67179,1.5948349327503797,0.28067148246717166
19389,0.5244444444444445,0,1,0,433439,172171,40777,67179,1.5948256697172922,0.28067265510758305
19390,0.5245000000000001,4,19,4,433458,172152,40781,67175,1.5946496720886287,0.2806829150075002
19391,0.5245079365079366,0,3,0,433461,172149,40781,67175,1.5946218829893661,0.2806864334542294
19392,0.5245238095238096,1,0,1,433461,172149,40782,67174,1.5946218829893661,0.2806834278360208
19393,0.5245555555555556,1,0,1,433461,172149,40783,67173,1.5946218829893661,0.28068042219269435
19394,0.5245714285714286,0,2,0,433463,172147,40783,67173,1.594603356923191,0.2806827678422196
19395,0.5245833333333333,0,1,0,433464,172146,40783,67173,1.5945940938901033,0.2806839406816843
19396,0.5245833333333334,1,1,1,433465,172145,40784,67172,1.5945848308570159,0.28068210783187153
19397,0.524595238095238,0,1,0,433466,172144,40784,67172,1.5945755678239282,0.2806832806832807
19398,0.5246428571428571,0,1,0,433467,172143,40784,67172,1.5945663047908407,0.28068445354449156
19399,0.5246428571428572,0,2,0,433469,172141,40784,67172,1.5945477787246656,0.28068679929631907
19400,0.5246666666666666,0,14,0,433483,172127,40784,67172,1.5944180962614398,0.2807032206570023
19401,0.5246666666666667,4,10,4,433493,172117,40788,67168,1.5943254659305643,0.2807029274714253
19402,0.5247142857142858,0,1,0,433494,172116,40788,67168,1.5943162028974767,0.28070410056669065
19403,0.5247222222222222,1,3,1,433497,172113,40789,67167,1.594288413798214,0.28070461384152456
19404,0.5247380952380953,0,1,0,433498,172112,40789,67167,1.5942791507651266,0.28070578696835075
19405,0.5247499999999998,0,1,0,433499,172111,40789,67167,1.594269887732039,0.2807069601049825
19406,0.5247626262626263,0,1,0,433500,172110,40789,67167,1.5942606246989515,0.2807081332514199
19407,0.5247936507936508,0,1,0,433501,172109,40789,67167,1.5942513616658638,0.2807093064076631
19408,0.5247976190476191,1,0,1,433501,172109,40790,67166,1.5942513616658638,0.2807063002821022
19409,0.5248095238095238,0,1,0,433502,172108,40790,67166,1.5942420986327763,0.2807074734404908
19410,0.5248333333333333,0,5,0,433507,172103,40790,67166,1.5941957834673386,0.2807133393795268
19411,0.5248333333333334,4,17,4,433524,172086,40794,67162,1.59403831190485,0.28072125994783653
19412,0.5248571428571428,0,1,0,433525,172085,40794,67162,1.5940290488717626,0.28072243330114904
19413,0.5248809523809523,0,2,0,433527,172083,40794,67162,1.5940105228055874,0.28072478003720036
19414,0.5248809523809524,1,3,1,433530,172080,40795,67161,1.5939827337063248,0.2807252937414574
19415,0.5249047619047619,0,1,0,433531,172079,40795,67161,1.5939734706732371,0.2807264671459622
19416,0.5249166666666667,0,1,0,433532,172078,40795,67161,1.5939642076401497,0.28072764056027655
19417,0.5249484126984126,0,1,0,433533,172077,40795,67161,1.5939549446070622,0.28072881398440047
19418,0.5249523809523808,0,1,0,433534,172076,40795,67161,1.5939456815739745,0.2807299874183341
19419,0.5249523809523811,0,1,0,433535,172075,40795,67161,1.593936418540887,0.2807311608620776
19420,0.5249981684981685,0,3,0,433538,172072,40795,67161,1.5939086294416243,0.2807346812521684
19421,0.5249999999999999,4,21,4,433559,172051,40799,67157,1.5937141057467856,0.280747299421424
19422,0.525,225,1078,225,434637,170973,41024,66932,1.5837285560784022,0.28133919001282026
19423,0.5250555555555556,1,0,1,434637,170973,41025,66931,1.5837285560784022,0.2813361692111104
19424,0.5250595238095238,1,0,1,434637,170973,41026,66930,1.5837285560784022,0.28133314838400525
19425,0.5250873015873015,0,1,0,434638,170972,41026,66930,1.5837192930453148,0.2813343309429933
19426,0.5251031746031746,0,2,0,434640,170970,41026,66930,1.5837007669791396,0.2813366960907944
19427,0.5251190476190476,0,2,0,434642,170968,41026,66930,1.5836822409129645,0.281339061278363
19428,0.525121212121212,0,1,0,434643,170967,41026,66930,1.583672977879877,0.28134024388706036
19429,0.5251428571428571,0,1,0,434644,170966,41026,66930,1.5836637148467894,0.2813414265057
19430,0.5251666666666666,1,0,1,434644,170966,41027,66929,1.5836637148467894,0.28133840559910883
19431,0.5251666666666667,1,9,1,434653,170957,41028,66928,1.5835803475490013,0.2813460285432037
19432,0.5251666666666668,2,1,2,434654,170956,41030,66926,1.5835710845159139,0.2813411691510917
19433,0.5251904761904761,0,1,0,434655,170955,41030,66926,1.5835618214828264,0.281342351848193
19434,0.5252063492063492,0,1,0,434656,170954,41030,66926,1.5835525584497387,0.2813435345552379
19435,0.5252380952380952,0,1,0,434657,170953,41030,66926,1.5835432954166513,0.28134471727222665
19436,0.5252380952380953,0,1,0,434658,170952,41030,66926,1.5835340323835636,0.2813458999991592
19437,0.5252857142857144,0,2,0,434660,170950,41030,66926,1.5835155063173885,0.28134826548285663
19438,0.5253055555555555,0,2,0,434662,170948,41030,66926,1.5834969802512135,0.28135063100633106
19439,0.5253333333333332,0,1,0,434663,170947,41030,66926,1.5834877172181259,0.281351813782985
19440,0.5253333333333333,3,10,3,434673,170937,41033,66923,1.5833950868872504,0.2813545783233835
19441,0.5253333333333334,0,13,0,434686,170924,41033,66923,1.583274667457112,0.28136995631645556
19442,0.5253571428571429,0,1,0,434687,170923,41033,66923,1.5832654044240246,0.2813711393086283
19443,0.5253809523809524,0,1,0,434688,170922,41033,66923,1.583256141390937,0.2813723223107486
19444,0.5254007936507938,0,1,0,434689,170921,41033,66923,1.5832468783578495,0.28137350532281663
19445,0.5254166666666666,1,7,1,434696,170914,41034,66922,1.5831820371262366,0.2813787651995493
19446,0.5254285714285714,1,0,1,434696,170914,41035,66921,1.5831820371262366,0.28137574368785084
19447,0.5254523809523809,1,1,1,434697,170913,41036,66920,1.5831727740931492,0.2813739052192084
19448,0.525452380952381,0,2,0,434699,170911,41036,66920,1.583154248026974,0.28137627138598414
19449,0.5254761904761905,1,0,1,434699,170911,41037,66919,1.583154248026974,0.2813732498002775
19450,0.5254999999999999,0,1,0,434700,170910,41037,66919,1.5831449849938863,0.28137443289085856
19451,0.5255,1,12,1,434712,170898,41038,66918,1.5830338285968357,0.28138560904228477
19452,0.5255000000000001,1,4,1,434716,170894,41039,66917,1.5829967764644854,0.28138732018283424
19453,0.5255555555555556,0,2,0,434718,170892,41039,66917,1.5829782503983105,0.2813896866813283
19454,0.5255595238095238,0,1,0,434719,170891,41039,66917,1.5829689873652228,0.2813908699455023
19455,0.5255833333333333,0,1,0,434720,170890,41039,66917,1.5829597243321354,0.2813920532196277
19456,0.525595238095238,0,1,0,434721,170889,41039,66917,1.5829504612990477,0.2813932365037047
19457,0.5256190476190475,0,3,0,434724,170886,41039,66917,1.582922672199785,0.2813967864156466
19458,0.5256190476190477,0,2,0,434726,170884,41039,66917,1.58290414613361,0.28139915307336805
19459,0.5256428571428572,0,2,0,434728,170882,41039,66917,1.5828856200674348,0.28140151977089894
19460,0.5256666666666665,0,1,0,434729,170881,41039,66917,1.5828763570343474,0.2814027031345932
19461,0.5256666666666666,4,24,4,434753,170857,41043,66913,1.582654044240246,0.2814190183791059
19462,0.5256666666666667,3,9,3,434762,170848,41046,66910,1.5825706769424581,0.2814206041437092
19463,0.5256904761904763,1,3,1,434765,170845,41047,66909,1.5825428878431953,0.2814211327674824
19464,0.5256944444444445,0,1,0,434766,170844,41047,66909,1.5825336248101078,0.2814223164376475
19465,0.5257142857142857,3,15,3,434781,170829,41050,66906,1.5823946793137944,0.28143100511073255
19466,0.5257142857142858,0,1,0,434782,170828,41050,66906,1.582385416280707,0.28143218891702493
19467,0.5257619047619048,0,1,0,434783,170827,41050,66906,1.5823761532476195,0.2814333727332764
19468,0.5258333333333333,8,62,8,434845,170765,41058,66898,1.581801845196191,0.28148260351842735
19469,0.5258333333333334,13,47,13,434892,170718,41071,66885,1.581366482641076,0.28149897097258875
19470,0.5259166666666666,0,2,0,434894,170716,41071,66885,1.581347956574901,0.28150134048257375
19471,0.5259166666666667,1,0,1,434894,170716,41072,66884,1.581347956574901,0.2814983164983165
19472,0.5259285714285715,0,1,0,434895,170715,41072,66884,1.5813386935418132,0.2814995012605272
19473,0.5259444444444444,0,1,0,434896,170714,41072,66884,1.5813294305087258,0.2815006860327107
19474,0.525952380952381,0,3,0,434899,170711,41072,66884,1.5813016414094632,0.2815042404090995
19475,0.5259642857142858,0,1,0,434900,170710,41072,66884,1.5812923783763755,0.2815054252211756
19476,0.5259761904761904,0,1,0,434901,170709,41072,66884,1.581283115343288,0.2815066100432252
19477,0.5259999999999999,1,3,1,434904,170706,41073,66883,1.5812553262440254,0.281507140482093
19478,0.526,14,114,14,435018,170592,41087,66869,1.5801993404720442,0.281599925882566
19479,0.5260000000000001,0,3,0,435021,170589,41087,66869,1.5801715513727814,0.2816034835634091
19480,0.5260119047619047,0,2,0,435023,170587,41087,66869,1.5801530253066063,0.2816058554005795
19481,0.5260238095238094,0,2,0,435025,170585,41087,66869,1.5801344992404314,0.2816082272777043
19482,0.5260634920634921,0,1,0,435026,170584,41087,66869,1.5801252362073437,0.28160941323125
19483,0.5260714285714285,1,1,1,435027,170583,41088,66868,1.5801159731742562,0.2816075737731153
19484,0.5260714285714286,0,2,0,435029,170581,41088,66868,1.580097447108081,0.28160994571465875
19485,0.5260833333333332,0,1,0,435030,170580,41088,66868,1.5800881840749934,0.2816111317004144
19486,0.5260952380952381,0,1,0,435031,170579,41088,66868,1.580078921041906,0.2816123176961596
19487,0.5261111111111111,0,1,0,435032,170578,41088,66868,1.5800696580088185,0.2816135037018943
19488,0.5261111111111112,0,2,0,435034,170576,41088,66868,1.5800511319426433,0.2816158757433332
19489,0.5261587301587302,0,1,0,435035,170575,41088,66868,1.5800418689095557,0.2816170617790375
19490,0.5261666666666666,0,1,0,435036,170574,41088,66868,1.5800326058764682,0.28161824782473194
19491,0.5261666666666667,4,12,4,435048,170562,41092,66864,1.5799214494794176,0.2816203785600566
19492,0.5261666666666668,0,5,0,435053,170557,41092,66864,1.5798751343139799,0.2816263093829105
19493,0.5261818181818182,0,1,0,435054,170556,41092,66864,1.5798658712808922,0.28162749557745764
19494,0.5261904761904761,1,1,1,435055,170555,41093,66863,1.5798566082478047,0.28162565601597184
19495,0.5261904761904762,1,2,1,435057,170553,41094,66862,1.5798380821816296,0.2816250026325211
19496,0.5261904761904763,0,1,0,435058,170552,41094,66862,1.579828819148542,0.28162618885154206
19497,0.52625,3,4,3,435062,170548,41097,66859,1.5797917670161918,0.28162185613735063
19498,0.5262500000000001,0,3,0,435065,170545,41097,66859,1.579763977916929,0.2816254149045509
19499,0.5262777777777778,2,0,2,435065,170545,41099,66857,1.579763977916929,0.28161936293712775
19500,0.5263095238095238,0,3,0,435068,170542,41099,66857,1.5797361888176664,0.28162292174777487
19501,0.5263095238095239,0,1,0,435069,170541,41099,66857,1.579726925784579,0.28162410803797844
19502,0.5263333333333332,0,3,0,435072,170538,41099,66857,1.5796991366853161,0.2816276669685545
19503,0.5263333333333333,1,9,1,435081,170529,41100,66856,1.5796157693875283,0.2816353181540535
19504,0.5263571428571429,0,1,0,435082,170528,41100,66856,1.5796065063544407,0.28163650456644085
19505,0.5263809523809525,0,1,0,435083,170527,41100,66856,1.5795972433213532,0.28163769098882396
19506,0.5263888888888889,0,1,0,435084,170526,41100,66856,1.5795879802882655,0.28163887742120297
19507,0.5264166666666666,0,2,0,435086,170524,41100,66856,1.5795694542220904,0.2816412503159491
19508,0.5264285714285714,0,1,0,435087,170523,41100,66856,1.579560191189003,0.2816424367783165
19509,0.5264285714285715,1,3,1,435090,170520,41101,66855,1.5795324020897403,0.2816429699842022
19510,0.5264920634920633,0,1,0,435091,170519,41101,66855,1.5795231390566526,0.2816441564788056
19511,0.5265,2,22,2,435113,170497,41103,66853,1.5793193523287266,0.2816642089740889
19512,0.5265000000000001,0,1,0,435114,170496,41103,66853,1.5793100892956389,0.28166539568315013
19513,0.5265158730158731,0,1,0,435115,170495,41103,66853,1.5793008262625514,0.2816665824022111
19514,0.5265277777777779,1,0,1,435115,170495,41104,66852,1.5793008262625514,0.28166355589074227
19515,0.5265476190476189,0,1,0,435116,170494,41104,66852,1.579291563229464,0.2816647426120516
19516,0.526547619047619,0,2,0,435118,170492,41104,66852,1.5792730371632888,0.2816671160846704
19517,0.5265595238095238,0,1,0,435119,170491,41104,66852,1.5792637741302011,0.28166830283598
19518,0.5265714285714285,0,1,0,435120,170490,41104,66852,1.5792545110971137,0.28166948959729
19519,0.526611111111111,1,0,1,435120,170490,41105,66851,1.5792545110971137,0.2816664630215597
19520,0.5266111111111111,0,1,0,435121,170489,41105,66851,1.579245248064026,0.2816676497851184
19521,0.5266190476190477,1,2,1,435123,170487,41106,66850,1.579226721997851,0.28166699671774736
19522,0.5266428571428572,0,2,0,435125,170485,41106,66850,1.579208195931676,0.2816693702993659
19523,0.5266546786546786,0,1,0,435126,170484,41106,66850,1.5791989328985883,0.2816705571051767
19524,0.5266666666666666,78,335,78,435461,170149,41184,66772,1.5760958168142576,0.2818323407380519
19525,0.5266666666666667,42,192,42,435653,169957,41226,66730,1.5743173144614473,0.28193352402117566
19526,0.5266666666666668,0,3,0,435656,169954,41226,66730,1.5742895253621847,0.2819370975646854
19527,0.5266904761904762,0,1,0,435657,169953,41226,66730,1.574280262329097,0.2819382887659866
19528,0.5267380952380952,0,1,0,435658,169952,41226,66730,1.5742709992960096,0.2819394799773536
19529,0.5267499999999999,0,1,0,435659,169951,41226,66730,1.5742617362629219,0.2819406711987866
19530,0.5267857142857143,0,2,0,435661,169949,41226,66730,1.5742432101967467,0.2819430536718509
19531,0.5267857142857144,0,1,0,435662,169948,41226,66730,1.5742339471636593,0.2819442449234825
19532,0.526797619047619,0,2,0,435664,169946,41226,66730,1.5742154210974841,0.2819466274569454
19533,0.5268214285714286,0,1,0,435665,169945,41226,66730,1.5742061580643967,0.2819478187387768
19534,0.5268214285714287,0,1,0,435666,169944,41226,66730,1.574196895031309,0.28194901003067513
19535,0.5268333333333333,0,6,0,435672,169938,41226,66730,1.5741413168327838,0.2819561579934761
19536,0.5268333333333334,2,12,2,435684,169926,41228,66728,1.5740301604357332,0.2819643868263372
19537,0.5268333333333335,0,1,0,435685,169925,41228,66728,1.5740208974026455,0.2819655782939578
19538,0.5268571428571429,0,2,0,435687,169923,41228,66728,1.5740023713364704,0.2819679612594073
19539,0.5268849206349207,0,1,0,435688,169922,41228,66728,1.573993108303383,0.28196915275723644
19540,0.5268968253968255,0,1,0,435689,169921,41228,66728,1.5739838452702952,0.2819703442651353
19541,0.5269166666666667,1,0,1,435689,169921,41229,66727,1.5739838452702952,0.2819673100976978
19542,0.5269206349206349,0,2,0,435691,169919,41229,66727,1.5739653192041203,0.2819696931281323
19543,0.5269285714285715,0,2,0,435693,169917,41229,66727,1.5739467931379452,0.28197207619884723
19544,0.526952380952381,1,0,1,435693,169917,41230,66726,1.5739467931379452,0.28196904197461997
19545,0.5269761904761905,0,1,0,435694,169916,41230,66726,1.5739375301048575,0.28197023351729616
19546,0.5269999999999999,6,10,6,435704,169906,41236,66720,1.573844899773982,0.281963943100082
19547,0.527,7,33,7,435737,169873,41243,66713,1.5735392196820928,0.2819820276770392
19548,0.5270000000000001,1,2,1,435739,169871,41244,66712,1.5735206936159176,0.2819813765147961
19549,0.5270238095238095,0,3,0,435742,169868,41244,66712,1.573492904516655,0.2819849522360301
19550,0.527047619047619,0,1,0,435743,169867,41244,66712,1.5734836414835673,0.28198614416326045
19551,0.5270555555555556,0,2,0,435745,169865,41244,66712,1.5734651154173922,0.28198852804795055
19552,0.5270833333333335,1,1,1,435746,169864,41245,66711,1.5734558523843047,0.2819866849836204
19553,0.5270854978354977,0,1,0,435747,169863,41245,66711,1.573446589351217,0.2819878769433666
19554,0.5271111111111111,0,1,0,435748,169862,41245,66711,1.5734373263181296,0.2819890689131896
19555,0.5271190476190476,0,2,0,435750,169860,41245,66711,1.5734188002519545,0.2819914528830668
19556,0.5271414141414141,1,0,1,435750,169860,41246,66710,1.5734188002519545,0.2819884178044553
19557,0.5271428571428571,5,12,5,435762,169848,41251,66705,1.5733076438549038,0.28198754613131094
19558,0.5271666666666666,2,8,2,435770,169840,41253,66703,1.5732335395902035,0.2819910122049691
19559,0.5271666666666667,0,9,0,435779,169831,41253,66703,1.5731501722924155,0.28200174182147175
19560,0.5271666666666668,0,1,0,435780,169830,41253,66703,1.5731409092593278,0.2820029340514854
19561,0.5272222222222223,1,1,1,435781,169829,41254,66702,1.5731316462262404,0.28200109076611524
19562,0.5272261904761905,0,1,0,435782,169828,41254,66702,1.5731223831931527,0.2820022830084979
19563,0.5272857142857142,1,1,1,435783,169827,41255,66701,1.5731131201600652,0.2820004396942434
19564,0.5273333333333333,8,33,8,435816,169794,41263,66693,1.572807440068176,0.28201550190919583
19565,0.5273333333333334,0,1,0,435817,169793,41263,66693,1.5727981770350883,0.28201669443434285
19566,0.5273571428571429,0,2,0,435819,169791,41263,66693,1.5727796509689134,0.2820190795148932
19567,0.5273650793650794,0,1,0,435820,169790,41263,66693,1.5727703879358257,0.2820202720702968
19568,0.5273809523809523,1,3,1,435823,169787,41264,66692,1.572742598836563,0.2820208136874733
19569,0.5273809523809524,0,3,0,435826,169784,41264,66692,1.5727148097373005,0.282024391481588
19570,0.5274285714285714,0,1,0,435827,169783,41264,66692,1.5727055467042128,0.2820255840997991
19571,0.5274761904761905,0,1,0,435828,169782,41264,66692,1.5726962836711254,0.28202677672809695
19572,0.5274772727272726,0,1,0,435829,169781,41264,66692,1.5726870206380377,0.2820279693664816
19573,0.5275,70,280,70,436109,169501,41334,66622,1.5700933713735226,0.28214955764580324
19574,0.5275000000000001,2,12,2,436121,169489,41336,66620,1.569982214976472,0.28215781694048087
19575,0.5275396825396825,0,3,0,436124,169486,41336,66620,1.5699544258772091,0.28216140208211565
19576,0.5275714285714286,0,2,0,436126,169484,41336,66620,1.5699358998110342,0.28216379222715415
19577,0.5275833333333334,0,1,0,436127,169483,41336,66620,1.5699266367779465,0.28216498731485834
19578,0.5276190476190475,1,0,1,436127,169483,41337,66619,1.5699266367779465,0.2821619469551296
19579,0.5276190476190477,2,2,2,436129,169481,41339,66617,1.5699081107117714,0.28215825631729197
19580,0.5276309523809524,0,1,0,436130,169480,41339,66617,1.569898847678684,0.28215945141191967
19581,0.5276428571428573,0,1,0,436131,169479,41339,66617,1.5698895846455962,0.28216064651667117
19582,0.5276666666666666,6,25,6,436156,169454,41345,66611,1.5696580088184076,0.2821722830576324
19583,0.5276666666666667,0,7,0,436163,169447,41345,66611,1.5695931675867947,0.282180650518093
19584,0.5276904761904762,0,1,0,436164,169446,41345,66611,1.569583904553707,0.282181845910098
19585,0.5277023809523809,0,1,0,436165,169445,41345,66611,1.5695746415206195,0.282183041312231
19586,0.5277380952380952,0,2,0,436167,169443,41345,66611,1.5695561154544444,0.28218543214688163
19587,0.5277499999999999,0,1,0,436168,169442,41345,66611,1.569546852421357,0.28218662757939955
19588,0.5277539682539681,0,1,0,436169,169441,41345,66611,1.5695375893882693,0.282187823022046
19589,0.5277626262626263,1,0,1,436169,169441,41346,66610,1.5695375893882693,0.28218478210217285
19590,0.5277777777777778,0,1,0,436170,169440,41346,66610,1.5695283263551818,0.2821859775471298
19591,0.5277857142857143,1,1,1,436171,169439,41347,66609,1.5695190633220941,0.28218413204094084
19592,0.527797619047619,1,0,1,436171,169439,41348,66608,1.5695190633220941,0.28218109105390027
19593,0.5278333333333333,2,9,2,436180,169430,41350,66606,1.569435696024306,0.28218576827263636
19594,0.5278333333333334,0,3,0,436183,169427,41350,66606,1.5694079069250435,0.2821893548783433
19595,0.5278571428571428,1,3,1,436186,169424,41351,66605,1.569380117825781,0.2821899003935957
19596,0.5278690476190476,1,0,1,436186,169424,41352,66604,1.569380117825781,0.28218685918619824
19597,0.5278809523809523,1,0,1,436186,169424,41353,66603,1.569380117825781,0.2821838179530308
19598,0.5279047619047619,0,1,0,436187,169423,41353,66603,1.5693708547926932,0.28218501351546016
19599,0.5279166666666667,0,1,0,436188,169422,41353,66603,1.5693615917596058,0.28218620908802033
19600,0.527952380952381,0,1,0,436189,169421,41353,66603,1.5693523287265183,0.28218740467071146
19601,0.5279761904761905,0,1,0,436190,169420,41353,66603,1.5693430656934306,0.28218860026353365
19602,0.5279999999999999,1,0,1,436190,169420,41354,66602,1.5693430656934306,0.28218555897331604
19603,0.528,17,58,17,436248,169362,41371,66585,1.5688058097743525,0.28220320665234144
19604,0.5280357142857143,0,2,0,436250,169360,41371,66585,1.5687872837081773,0.28220559876242346
19605,0.5280555555555556,0,1,0,436251,169359,41371,66585,1.5687780206750899,0.28220679483267214
19606,0.5280714285714285,0,1,0,436252,169358,41371,66585,1.5687687576420022,0.28220799091305954
19607,0.5280833333333333,0,1,0,436253,169357,41371,66585,1.5687594946089147,0.2822091870035856
19608,0.5280952380952381,0,1,0,436254,169356,41371,66585,1.5687502315758273,0.2822103831042506
19609,0.5281428571428571,1,2,1,436256,169354,41372,66584,1.5687317055096521,0.2822097330654664
19610,0.5281666666666667,7,22,7,436278,169332,41379,66577,1.5685279187817258,0.2822147522985558
19611,0.5281666666666668,0,1,0,436279,169331,41379,66577,1.5685186557486384,0.28221594859012833
19612,0.5281818181818182,0,1,0,436280,169330,41379,66577,1.5685093927155507,0.28221714489184296
19613,0.5281904761904762,1,1,1,436281,169329,41380,66576,1.5685001296824632,0.2822152985311884
19614,0.5282063492063491,0,2,0,436283,169327,41380,66576,1.568481603616288,0.28221769116967566
19615,0.5282142857142857,0,4,0,436287,169323,41380,66576,1.5684445514839378,0.28222247656836186
19616,0.5282380952380952,0,1,0,436288,169322,41380,66576,1.5684352884508503,0.2822236729433908
19617,0.5282539682539683,0,1,0,436289,169321,41380,66576,1.5684260254177629,0.2822248693285629
19618,0.5282619047619047,0,1,0,436290,169320,41380,66576,1.5684167623846752,0.2822260657238783
19619,0.5282857142857142,0,2,0,436292,169318,41380,66576,1.5683982363185,0.28222845854493966
19620,0.5283182095682096,2,0,2,436292,169318,41382,66574,1.5683982363185,0.2822223729503332
19621,0.5283333333333333,69,299,69,436591,169019,41451,66505,1.5656285894253215,0.28237037414446087
19622,0.5283333333333334,2,0,2,436591,169019,41453,66503,1.5656285894253215,0.2823642801946315
19623,0.5283809523809524,1,0,1,436591,169019,41454,66502,1.5656285894253215,0.28236123318090534
19624,0.5284166666666666,0,1,0,436592,169018,41454,66502,1.5656193263922338,0.2823624320652174
19625,0.5284444444444444,0,2,0,436594,169016,41454,66502,1.5656008003260589,0.28236482986438405
19626,0.5284523809523809,1,1,1,436595,169015,41455,66501,1.5655915372929712,0.28236298170824914
19627,0.5284761904761904,0,1,0,436596,169014,41455,66501,1.5655822742598837,0.2823641806254379
19628,0.5285,4,24,4,436620,168990,41459,66497,1.5653599614657823,0.2823807683651327
19629,0.5285000000000001,1,2,1,436622,168988,41460,66496,1.5653414353996074,0.28238011924377027
19630,0.5285079365079364,0,1,0,436623,168987,41460,66496,1.5653321723665197,0.2823813183966571
19631,0.528547619047619,0,1,0,436624,168986,41460,66496,1.5653229093334322,0.28238251755972854
19632,0.5285714285714286,1,4,1,436628,168982,41461,66495,1.565285857201082,0.28238426682860746
19633,0.5286190476190477,0,1,0,436629,168981,41461,66495,1.5652765941679945,0.2823854660347551
19634,0.5286666666666666,1,29,1,436658,168952,41462,66494,1.5650079662084553,0.2824171996975952
19635,0.5286666666666667,2,2,2,436660,168950,41464,66492,1.5649894401422801,0.2824135031132933
19636,0.5286904761904762,1,2,1,436662,168948,41465,66491,1.564970914076105,0.28241285428497404
19637,0.5286904761904763,0,1,0,436663,168947,41465,66491,1.5649616510430175,0.2824140538060976
19638,0.5287142857142857,1,1,1,436664,168946,41466,66490,1.5649523880099299,0.28241220544011963
19639,0.5287222222222222,0,1,0,436665,168945,41466,66490,1.5649431249768424,0.28241340497377193
19640,0.5287272727272727,0,1,0,436666,168944,41466,66490,1.564933861943755,0.2824146045176143
19641,0.5287420634920634,0,1,0,436667,168943,41466,66490,1.5649245989106673,0.28241580407164674
19642,0.52875,1,3,1,436670,168940,41467,66489,1.5648968098114047,0.2824163548245968
19643,0.5287857142857143,1,0,1,436670,168940,41468,66488,1.5648968098114047,0.28241330682841465
19644,0.5287878787878788,0,1,0,436671,168939,41468,66488,1.564887546778317,0.28241450640750637
19645,0.5288095238095238,0,2,0,436673,168937,41468,66488,1.564869020712142,0.2824169055962621
19646,0.5288333333333333,2,1,2,436674,168936,41470,66486,1.5648597576790544,0.2824120090730688
19647,0.5288333333333334,4,12,4,436686,168924,41474,66482,1.5647486012820038,0.28241421204217393
19648,0.5288571428571429,0,6,0,436692,168918,41474,66482,1.5646930230834784,0.2824214103653356
19649,0.5288888888888889,0,1,0,436693,168917,41474,66482,1.564683760050391,0.2824226101215383
19650,0.5289019175269176,1,9,1,436702,168908,41475,66481,1.5646003927526029,0.2824303599573472
19651,0.5289166666666667,0,1,0,436703,168907,41475,66481,1.5645911297195154,0.28243155980763673
19652,0.5289285714285714,0,3,0,436706,168904,41475,66481,1.5645633406202526,0.2824351594196742
19653,0.5289285714285715,2,1,2,436707,168903,41477,66479,1.5645540775871651,0.28243026229703205
19654,0.5289365079365078,0,1,0,436708,168902,41477,66479,1.5645448145540777,0.2824314621825891
19655,0.5289509379509378,0,1,0,436709,168901,41477,66479,1.56453555152099,0.2824326620783414
19656,0.5289682539682539,0,2,0,436711,168899,41477,66479,1.5645170254548149,0.2824350619004325
19657,0.5289761904761905,0,1,0,436712,168898,41477,66479,1.5645077624217274,0.2824362618267715
19658,0.528987012987013,1,0,1,436712,168898,41478,66478,1.5645077624217274,0.2824332132417919
19659,0.5289999999999999,0,4,0,436716,168894,41478,66478,1.5644707102893771,0.28243801301769117
19660,0.529,12,62,12,436778,168832,41490,66466,1.563896402237949,0.28247583914865404
19661,0.5290238095238096,0,1,0,436779,168831,41490,66466,1.5638871392048612,0.2824770396562642
19662,0.5290396825396826,0,2,0,436781,168829,41490,66466,1.563868613138686,0.28247944070209735
19663,0.529047619047619,0,2,0,436783,168827,41490,66466,1.563850087072511,0.2824818417887485
19664,0.5290476190476191,1,5,1,436788,168822,41491,66465,1.5638037719070732,0.28248479516505376
19665,0.5290476190476192,0,4,0,436792,168818,41491,66465,1.5637667197747231,0.2824895976334882
19666,0.5290833333333333,0,3,0,436795,168815,41491,66465,1.5637389306754603,0.2824931995919755
19667,0.5290952380952381,0,1,0,436796,168814,41491,66465,1.5637296676423729,0.28249440026521705
19668,0.5291190476190476,0,1,0,436797,168813,41491,66465,1.5637204046092852,0.282495600948665
19669,0.5291388888888889,0,3,0,436800,168810,41491,66465,1.5636926155100226,0.28249920306024867
19670,0.5291428571428571,2,0,2,436800,168810,41493,66463,1.5636926155100226,0.2824931037560621
19671,0.5291507936507938,0,1,0,436801,168809,41493,66463,1.5636833524769351,0.28249430446461965
19672,0.5291666666666666,0,3,0,436804,168806,41493,66463,1.5636555633776723,0.28249790665153507
19673,0.5291666666666667,26,117,26,436921,168689,41519,66437,1.5625717885064285,0.28255913850446146
19674,0.5291666666666668,0,2,0,436923,168687,41519,66437,1.5625532624402534,0.2825615419948623
19675,0.5292424242424242,0,4,0,436927,168683,41519,66437,1.5625162103079033,0.2825663490983328
19676,0.52925,1,2,1,436929,168681,41520,66436,1.5624976842417282,0.2825657013316774
19677,0.5292619047619047,0,1,0,436930,168680,41520,66436,1.5624884212086405,0.2825669031456813
19678,0.5292857142857144,2,8,2,436938,168672,41522,66434,1.5624143169439402,0.28257041504682995
19679,0.5293333333333333,9,40,9,436978,168632,41531,66425,1.562043795620438,0.2825910311116027
19680,0.5293333333333334,0,2,0,436980,168630,41531,66425,1.562025269554263,0.28259343557890704
19681,0.5293650793650794,0,1,0,436981,168629,41531,66425,1.5620160065211752,0.2825946378279034
19682,0.5293809523809524,0,1,0,436982,168628,41531,66425,1.5620067434880878,0.2825958400871293
19683,0.5294047619047618,0,1,0,436983,168627,41531,66425,1.561997480455,0.28259704235658495
19684,0.5294047619047619,1,0,1,436983,168627,41532,66424,1.561997480455,0.2825939902404159
19685,0.529452380952381,0,2,0,436985,168625,41532,66424,1.5619789543888252,0.28259639479427695
19686,0.5294761904761905,1,1,1,436986,168624,41533,66423,1.5619696913557375,0.28259454492080305
19687,0.5294999999999999,0,1,0,436987,168623,41533,66423,1.56196042832265,0.2825957472154387
19688,0.5295,1,3,1,436990,168620,41534,66422,1.5619326392233872,0.28259630193752605
19689,0.5295000000000001,2,17,2,437007,168603,41536,66420,1.5617751676608989,0.28261063810775966
19690,0.5295238095238095,1,1,1,437008,168602,41537,66419,1.5617659046278114,0.2826087881508461
19691,0.5295714285714286,0,7,0,437015,168595,41537,66419,1.5617010633961985,0.28261720578348526
19692,0.5295833333333333,0,2,0,437017,168593,41537,66419,1.5616825373300234,0.28261961091348525
19693,0.5295833333333334,1,0,1,437017,168593,41538,66418,1.5616825373300234,0.28261655837386335
19694,0.529595238095238,0,2,0,437019,168591,41538,66418,1.5616640112638482,0.28261896352905636
19695,0.5296153846153846,0,1,0,437020,168590,41538,66418,1.5616547482307608,0.28262016612200436
19696,0.5296190476190477,1,1,1,437021,168589,41539,66417,1.561645485197673,0.28261831612809885
19697,0.5296190476190478,0,1,0,437022,168588,41539,66417,1.5616362221645856,0.28261951873364394
19698,0.5296428571428572,0,2,0,437024,168586,41539,66417,1.5616176960984105,0.2826219239754386
19699,0.5296666666666666,0,10,0,437034,168576,41539,66417,1.561525065767535,0.28263395079853443
19700,0.5296666666666667,0,15,0,437049,168561,41539,66417,1.5613861202712216,0.28265199295253174
19701,0.5296984126984126,0,1,0,437050,168560,41539,66417,1.5613768572381341,0.28265319584469967
19702,0.5297380952380952,0,2,0,437052,168558,41539,66417,1.561358331171959,0.282655601659751
19703,0.5297738095238096,0,1,0,437053,168557,41539,66417,1.5613490681388713,0.2826568045826347
19704,0.5298095238095238,1,1,1,437054,168556,41540,66416,1.5613398051057839,0.2826549546328924
19705,0.5298333333333333,0,4,0,437058,168552,41540,66416,1.5613027529734336,0.2826597664362807
19706,0.5298333333333334,4,9,4,437067,168543,41544,66412,1.5612193856756456,0.28265838139218147
19707,0.5298809523809523,0,2,0,437069,168541,41544,66412,1.5612008596094704,0.28266078747664425
19708,0.5298809523809526,1,0,1,437069,168541,41545,66411,1.5612008596094704,0.2826577343457387
19709,0.529904761904762,0,1,0,437070,168540,41545,66411,1.561191596576383,0.28265893739545694
19710,0.5299166666666667,0,3,0,437073,168537,41545,66411,1.5611638074771204,0.2826625466060575
19711,0.5299242424242424,0,1,0,437074,168536,41545,66411,1.5611545444440327,0.28266374969674013
19712,0.5299285714285715,0,1,0,437075,168535,41545,66411,1.5611452814109452,0.2826649527976641
19713,0.5299523809523808,0,2,0,437077,168533,41545,66411,1.56112675534477,0.282667359030237
19714,0.5299642857142858,0,3,0,437080,168530,41545,66411,1.5610989662455075,0.2826709684559102
19715,0.5299999999999999,11,39,11,437119,168491,41556,66400,1.5607377079550928,0.2826843088922096
19716,0.53,497,2655,497,439774,165836,42053,65903,1.5361443551076364,0.2843845878337267
19717,0.5300054112554113,0,2,0,439776,165834,42053,65903,1.5361258290414614,0.28438704220732985
19718,0.5300238095238096,0,2,0,439778,165832,42053,65903,1.5361073029752863,0.28438949662329815
19719,0.5300476190476191,1,2,1,439780,165830,42054,65902,1.5360887769091112,0.28438886299691024
19720,0.5300833333333334,0,1,0,439781,165829,42054,65902,1.5360795138760235,0.284390090233935
19721,0.5301111111111111,0,1,0,439782,165828,42054,65902,1.536070250842936,0.28439131748155183
19722,0.5301666666666667,1,22,1,439804,165806,42055,65901,1.5358664641150097,0.28441523130505336
19723,0.5301785714285715,0,2,0,439806,165804,42055,65901,1.5358479380488348,0.284417686282126
19724,0.5302380952380953,0,2,0,439808,165802,42055,65901,1.5358294119826597,0.28442014130158005
19725,0.53025,0,1,0,439809,165801,42055,65901,1.535820148949572,0.2844213688272005
19726,0.5302619047619048,0,2,0,439811,165799,42055,65901,1.5358016228833968,0.28442382391022875
19727,0.5302662337662337,0,3,0,439814,165796,42055,65901,1.5357738337841342,0.2844275066142419
19728,0.5302777777777777,1,3,1,439817,165793,42056,65900,1.5357460446848716,0.28442810097844995
19729,0.5302857142857141,1,2,1,439819,165791,42057,65899,1.5357275186186965,0.28442746773706246
19730,0.5302857142857144,0,3,0,439822,165788,42057,65899,1.535699729519434,0.28443115064720936
19731,0.5303333333333333,1,20,1,439842,165768,42058,65898,1.5355144688576827,0.28445261712983344
19732,0.5303333333333334,5,5,5,439847,165763,42063,65893,1.535468153692245,0.2844433124978416
19733,0.5303690476190475,1,2,1,439849,165761,42064,65892,1.5354496276260698,0.2844426793523071
19734,0.5303690476190476,0,1,0,439850,165760,42064,65892,1.5354403645929824,0.2844439072401706
19735,0.5303809523809524,0,2,0,439852,165758,42064,65892,1.5354218385268072,0.28444636304770127
19736,0.5304047619047618,0,1,0,439853,165757,42064,65892,1.5354125754937196,0.2844475909673687
19737,0.5304047619047619,1,0,1,439853,165757,42065,65891,1.5354125754937196,0.2844445020030391
19738,0.5304166666666666,0,1,0,439854,165756,42065,65891,1.535403312460632,0.2844457299252742
19739,0.5304166666666668,0,1,0,439855,165755,42065,65891,1.5353940494275446,0.2844469578581111
19740,0.5304761904761905,1,5,1,439860,165750,42066,65890,1.5353477342621067,0.28445000863408737
19741,0.5305,5,11,5,439871,165739,42071,65885,1.5352458408981438,0.28444807101163955
19742,0.5305000000000001,0,1,0,439872,165738,42071,65885,1.535236577865056,0.28444929907651656
19743,0.5305238095238095,1,0,1,439872,165738,42072,65884,1.535236577865056,0.2844462097728195
19744,0.5305238095238096,0,3,0,439875,165735,42072,65884,1.5352087887657935,0.28444989400696835
19745,0.530547619047619,0,2,0,439877,165733,42072,65884,1.5351902626996183,0.2844523502160895
19746,0.5305555555555556,0,1,0,439878,165732,42072,65884,1.5351809996665309,0.28445357833655704
19747,0.5305833333333334,0,1,0,439879,165731,42072,65884,1.5351717366334432,0.2844548064676295
19748,0.5306071428571428,0,1,0,439880,165730,42072,65884,1.5351624736003557,0.28445603460930685
19749,0.5306666666666665,1,0,1,439880,165730,42073,65883,1.5351624736003557,0.28445294521464687
19750,0.5306666666666666,10,24,10,439904,165706,42083,65873,1.5349401608062545,0.2844515262610168
19751,0.5306666666666667,1,14,1,439918,165692,42084,65872,1.5348104783430288,0.2844656336909019
19752,0.5306904761904763,0,1,0,439919,165691,42084,65872,1.534801215309941,0.2844668621498253
19753,0.530702380952381,1,1,1,439920,165690,42085,65871,1.5347919522768536,0.2844650005829997
19754,0.5307045454545455,0,1,0,439921,165689,42085,65871,1.534782689243766,0.2844662290551045
19755,0.5307142857142857,1,7,1,439928,165682,42086,65870,1.534717848012153,0.28447173852957436
19756,0.53075,0,1,0,439929,165681,42086,65870,1.5347085849790656,0.284472967078527
19757,0.5307777777777778,0,1,0,439930,165680,42086,65870,1.534699321945978,0.2844741956380911
19758,0.5307857142857143,0,4,0,439934,165676,42086,65870,1.5346622698136279,0.28447910998246567
19759,0.5307936507936508,0,1,0,439935,165675,42086,65870,1.5346530067805402,0.28448033859508953
19760,0.5307997835497836,1,2,1,439937,165673,42087,65869,1.534634480714365,0.2844797056257612
19761,0.5308333333333333,16,54,16,439991,165619,42103,65853,1.5341342769276372,0.2844966129812677
19762,0.5308333333333334,14,68,14,440059,165551,42117,65839,1.5335043906776835,0.2845369289943386
19763,0.5308412698412698,0,1,0,440060,165550,42117,65839,1.533495127644596,0.2845381586851579
19764,0.5308571428571428,0,1,0,440061,165549,42117,65839,1.5334858646115084,0.28453938838660603
19765,0.5308809523809525,0,1,0,440062,165548,42117,65839,1.533476601578421,0.28454061809868314
19766,0.5308928571428572,0,2,0,440064,165546,42117,65839,1.5334580755122458,0.2845430775547248
19767,0.5309047619047619,0,2,0,440066,165544,42117,65839,1.5334395494460706,0.28454553705328395
19768,0.530904761904762,0,1,0,440067,165543,42117,65839,1.533430286412983,0.28454676681850793
19769,0.5309166666666666,0,1,0,440068,165542,42117,65839,1.5334210233798955,0.2845479965943617
19770,0.5309166666666667,0,1,0,440069,165541,42117,65839,1.533411760346808,0.28454922638084534
19771,0.5309285714285715,0,2,0,440071,165539,42117,65839,1.533393234280633,0.2845516859857031
19772,0.5309523809523808,0,1,0,440072,165538,42117,65839,1.5333839712475452,0.2845529158040773
19773,0.530952380952381,1,3,1,440075,165535,42118,65838,1.5333561821482826,0.28455351315840655
19774,0.5309523809523811,0,1,0,440076,165534,42118,65838,1.5333469191151952,0.2845547430112546
19775,0.5309999999999999,1,7,1,440083,165527,42119,65837,1.5332820778835823,0.284560260023167
19776,0.531,9,48,9,440131,165479,42128,65828,1.5328374522953796,0.2845914736691929
19777,0.5310000000000001,0,2,0,440133,165477,42128,65828,1.5328189262292045,0.28459393441559844
19778,0.531025641025641,0,1,0,440134,165476,42128,65828,1.532809663196117,0.2845951648047591
19779,0.5310476190476191,1,1,1,440135,165475,42129,65827,1.5328004001630293,0.2845933022628425
19780,0.5310714285714285,0,1,0,440136,165474,42129,65827,1.5327911371299419,0.28459453266522844
19781,0.5310909090909091,0,1,0,440137,165473,42129,65827,1.5327818740968542,0.28459576307825335
19782,0.5310952380952382,0,1,0,440138,165472,42129,65827,1.5327726110637667,0.2845969935019174
19783,0.5310984848484849,0,1,0,440139,165471,42129,65827,1.5327633480306793,0.2845982239362208
19784,0.5311111111111111,2,4,2,440143,165467,42131,65825,1.532726295898329,0.2845969596873216
19785,0.531142857142857,1,0,1,440143,165467,42132,65824,1.532726295898329,0.2845938666009486
19786,0.5311428571428571,0,1,0,440144,165466,42132,65824,1.5327170328652413,0.2845950970642916
19787,0.5311666666666666,0,3,0,440147,165463,42132,65824,1.5326892437659787,0.2845987885181614
19788,0.5311666666666667,2,5,2,440152,165458,42134,65822,1.532642928600541,0.28459875475613977
19789,0.5311904761904761,1,1,1,440153,165457,42135,65821,1.5326336655674535,0.2845968920519894
19790,0.5311904761904762,0,6,0,440159,165451,42135,65821,1.532578087368928,0.28460427548514305
19791,0.5311959706959708,0,1,0,440160,165450,42135,65821,1.5325688243358406,0.2846055060945817
19792,0.5312103174603174,0,1,0,440161,165449,42135,65821,1.532559561302753,0.2846067367146625
19793,0.5312222222222222,1,0,1,440161,165449,42136,65820,1.532559561302753,0.284603643376328
19794,0.53125,0,4,0,440165,165445,42136,65820,1.5325225091704027,0.28460856593085854
19795,0.5312500000000001,0,3,0,440168,165442,42136,65820,1.53249472007114,0.2846122579585059
19796,0.5312857142857143,0,2,0,440170,165440,42136,65820,1.532476194004965,0.284614719363487
19797,0.5313095238095238,0,3,0,440173,165437,42136,65820,1.5324484049057023,0.2846184115507855
19798,0.5313333333333332,3,5,3,440178,165432,42139,65817,1.5324020897402646,0.2846152848228533
19799,0.5313333333333333,6,31,6,440209,165401,42145,65811,1.5321149357145503,0.2846348805425324
19800,0.5313333333333334,0,3,0,440212,165398,42145,65811,1.5320871466152877,0.28463857375794194
19801,0.5313665223665225,1,5,1,440217,165393,42146,65810,1.53204083144985,0.2846416352728987
19802,0.5313888888888889,0,1,0,440218,165392,42146,65810,1.5320315684167625,0.2846428664111902
19803,0.5313928571428572,0,1,0,440219,165391,42146,65810,1.5320223053836748,0.28464409756013165
19804,0.5314166666666666,0,1,0,440220,165390,42146,65810,1.5320130423505873,0.2846453287197232
19805,0.5314285714285714,0,2,0,440222,165388,42146,65810,1.5319945162844122,0.284647791070857
19806,0.5314285714285715,0,3,0,440225,165385,42146,65810,1.5319667271851496,0.2846514846774368
19807,0.5314285714285716,1,1,1,440226,165384,42147,65809,1.531957464152062,0.284649621744603
19808,0.5314423558897243,0,1,0,440227,165383,42147,65809,1.5319482011189745,0.28465085297069104
19809,0.5314761904761904,1,1,1,440228,165382,42148,65808,1.5319389380858868,0.28464899000821836
19810,0.5314999999999999,1,3,1,440231,165379,42149,65807,1.5319111489866242,0.28464958950801517
19811,0.5315,2,26,2,440257,165353,42151,65805,1.5316703101263478,0.2846754168144732
19812,0.5315000000000001,0,2,0,440259,165351,42151,65805,1.5316517840601727,0.2846778798733323
19813,0.5315119047619049,0,1,0,440260,165350,42151,65805,1.5316425210270852,0.284679111418745
19814,0.5315151515151516,0,1,0,440261,165349,42151,65805,1.5316332579939975,0.2846803429748133
19815,0.5315238095238095,0,2,0,440263,165347,42151,65805,1.5316147319278224,0.28468280611891744
19816,0.531547619047619,0,3,0,440266,165344,42151,65805,1.5315869428285598,0.2846865009149942
19817,0.5315714285714286,0,1,0,440267,165343,42151,65805,1.5315776797954723,0.28468773253499924
19818,0.5315869963369962,0,2,0,440269,165341,42151,65805,1.5315591537292972,0.28469019580697913
19819,0.5316190476190475,1,0,1,440269,165341,42152,65804,1.5315591537292972,0.2846871011702611
19820,0.5316428571428571,0,1,0,440270,165340,42152,65804,1.5315498906962095,0.28468833281417644
19821,0.5316666666666666,46,232,46,440502,165108,42198,65758,1.529400867019897,0.28483189382585566
19822,0.5316666666666667,20,126,20,440628,164982,42218,65738,1.528233724850865,0.2849254507628294
19823,0.5316904761904762,0,1,0,440629,164981,42218,65738,1.5282244618177776,0.28492668570858926
19824,0.5317269119769121,1,2,1,440631,164979,42219,65737,1.5282059357516025,0.2849260562769812
19825,0.53175,0,1,0,440632,164978,42219,65737,1.528196672718515,0.28492729124677635
19826,0.5317500000000001,1,2,1,440634,164976,42220,65736,1.5281781466523399,0.2849266618121294
19827,0.5317539682539684,0,1,0,440635,164975,42220,65736,1.5281688836192522,0.2849278968059607
19828,0.5317619047619048,1,2,1,440637,164973,42221,65735,1.5281503575530773,0.28492726736827506
19829,0.5317857142857143,1,4,1,440641,164969,42222,65734,1.528113305420727,0.2849291079873257
19830,0.5318095238095238,1,0,1,440641,164969,42223,65733,1.528113305420727,0.2849260084437933
19831,0.5318107725607727,0,1,0,440642,164968,42223,65733,1.5281040423876393,0.2849272434883247
19832,0.5318333333333333,1,5,1,440647,164963,42224,65732,1.5280577272222016,0.28493031925269297
19833,0.5318333333333334,1,15,1,440662,164948,42225,65731,1.5279187817258884,0.28494574712045745
19834,0.5318571428571428,0,1,0,440663,164947,42225,65731,1.5279095186928007,0.2849469823736984
19835,0.5319047619047619,1,5,1,440668,164942,42226,65730,1.527863203527363,0.2849500589581744
19836,0.531904761904762,0,1,0,440669,164941,42226,65730,1.5278539404942755,0.28495129426759325
19837,0.5319166666666666,0,2,0,440671,164939,42226,65730,1.5278354144281003,0.28495376491856295
19838,0.5319523809523808,0,1,0,440672,164938,42226,65730,1.5278261513950129,0.2849550002601141
19839,0.5319523809523811,0,1,0,440673,164937,42226,65730,1.5278168883619252,0.28495623561237626
19840,0.5319545454545455,0,1,0,440674,164936,42226,65730,1.5278076253288377,0.2849574709753496
19841,0.5319999999999999,1,9,1,440683,164927,42227,65729,1.5277242580310497,0.2849654897336293
19842,0.532,10,52,10,440735,164875,42237,65719,1.527242580310497,0.2849987423783793
19843,0.5320000000000001,0,2,0,440737,164873,42237,65719,1.5272240542443218,0.28500121426588954
19844,0.5320238095238095,1,2,1,440739,164871,42238,65718,1.5272055281781467,0.2850005854572421
19845,0.5320555555555555,0,1,0,440740,164870,42238,65718,1.527196265145059,0.28500182143043
19846,0.5320555555555557,0,2,0,440742,164868,42238,65718,1.527177739078884,0.2850042934089667
19847,0.5320833333333332,1,0,1,440742,164868,42239,65717,1.527177739078884,0.285001192618774
19848,0.5321111111111112,0,1,0,440743,164867,42239,65717,1.5271684760457964,0.2850024286160358
19849,0.5321309523809523,1,0,1,440743,164867,42240,65716,1.5271684760457964,0.28499932779086057
19850,0.532142857142857,0,1,0,440744,164866,42240,65716,1.527159213012709,0.28500056379075556
19851,0.5321428571428571,1,7,1,440751,164859,42241,65715,1.527094371781096,0.2850061151734367
19852,0.5321428571428573,0,1,0,440752,164858,42241,65715,1.5270851087480084,0.2850073512510138
19853,0.5321468253968255,1,0,1,440752,164858,42242,65714,1.5270851087480084,0.28500425029925575
19854,0.5321666666666666,1,9,1,440761,164849,42243,65713,1.5270017414502204,0.28501227435570475
19855,0.5321666666666667,0,8,0,440769,164841,42243,65713,1.52692763718552,0.28502216400496194
19856,0.5322142857142858,0,1,0,440770,164840,42243,65713,1.5269183741524324,0.2850234002593764
19857,0.5322142857142859,0,1,0,440771,164839,42243,65713,1.526909111119345,0.2850246365245151
19858,0.5322222222222223,0,3,0,440774,164836,42243,65713,1.5268813220200823,0.2850283453842784
19859,0.5322380952380952,0,1,0,440775,164835,42243,65713,1.5268720589869946,0.2850295816923157
19860,0.53225,1,0,1,440775,164835,42244,65712,1.5268720589869946,0.2850264805007222
19861,0.5322500000000001,0,1,0,440776,164834,42244,65712,1.5268627959539072,0.28502771681139555
19862,0.5322738095238094,0,1,0,440777,164833,42244,65712,1.5268535329208195,0.285028953132794
19863,0.5322738095238095,0,1,0,440778,164832,42244,65712,1.526844269887732,0.28503018946491776
19864,0.5322777777777777,0,1,0,440779,164831,42244,65712,1.5268350068546446,0.28503142580776686
19865,0.5322857142857143,0,4,0,440783,164827,42244,65712,1.5267979547222943,0.28503637128642006
19866,0.5323333333333333,6,21,6,440804,164806,42250,65706,1.5266034310274557,0.2850437287429722
19867,0.5323809523809523,0,2,0,440806,164804,42250,65706,1.5265849049612805,0.28504620190013447
19868,0.5323809523809524,0,1,0,440807,164803,42250,65706,1.526575641928193,0.2850474384948093
19869,0.5324166666666666,1,1,1,440808,164802,42251,65705,1.5265663788951054,0.2850455734533008
19870,0.5324444444444444,0,1,0,440809,164801,42251,65705,1.526557115862018,0.2850468100613433
19871,0.5325,58,249,58,441058,164552,42309,65647,1.524250620623217,0.2851750007602118
19872,0.5325000000000001,2,15,2,441073,164537,42311,65645,1.5241116751269035,0.2851873734696892
19873,0.532547619047619,0,3,0,441076,164534,42311,65645,1.5240838860276409,0.2851910904122444
19874,0.5325685425685425,2,4,2,441080,164530,42313,65643,1.5240468338952906,0.28518983547158006
19875,0.5325714285714287,0,1,0,441081,164529,42313,65643,1.5240375708622032,0.2851910745008081
19876,0.5325833333333333,0,1,0,441082,164528,42313,65643,1.5240283078291155,0.28519231354080227
19877,0.5326190476190475,1,0,1,441082,164528,42314,65642,1.5240283078291155,0.2851892079767129
19878,0.5326190476190477,0,4,0,441086,164524,42314,65642,1.5239912556967654,0.2851941642119166
19879,0.5326666666666666,8,38,8,441124,164486,42322,65634,1.5236392604394382,0.28521640883017557
19880,0.5326666666666667,2,10,2,441134,164476,42324,65632,1.5235466301085627,0.28522259113112103
19881,0.5326785714285714,0,3,0,441137,164473,42324,65632,1.5235188410093001,0.2852263097281676
19882,0.5326904761904762,1,0,1,441137,164473,42325,65631,1.5235188410093001,0.2852232034210618
19883,0.5327380952380952,0,2,0,441139,164471,42325,65631,1.523500314943125,0.2852256825234027
19884,0.53275,0,1,0,441140,164470,42325,65631,1.5234910519100375,0.2852269220907341
19885,0.5327619047619047,0,2,0,441142,164468,42325,65631,1.5234725258438624,0.2852294012577195
19886,0.5327777777777777,1,0,1,441142,164468,42326,65630,1.5234725258438624,0.28522629488304985
19887,0.5327777777777778,0,1,0,441143,164467,42326,65630,1.5234632628107747,0.28522753447459115
19888,0.5327777777777779,1,0,1,441143,164467,42327,65629,1.5234632628107747,0.28522442806480774
19889,0.5327857142857142,0,1,0,441144,164466,42327,65629,1.5234539997776873,0.2852256676590104
19890,0.5327857142857143,1,0,1,441144,164466,42328,65628,1.5234539997776873,0.2852225612141125
19891,0.5328333333333333,1,7,1,441151,164459,42329,65627,1.5233891585460744,0.28522813208974035
19892,0.5328333333333334,0,4,0,441155,164455,42329,65627,1.523352106413724,0.28523309081110215
19893,0.5328567821067822,1,10,1,441165,164445,42330,65626,1.5232594760828486,0.2852423816995623
19894,0.5328571428571428,1,3,1,441168,164442,42331,65625,1.5232316869835858,0.28524299443205675
19895,0.5328809523809523,0,2,0,441170,164440,42331,65625,1.5232131609174109,0.2852454741051442
19896,0.5329166666666666,1,3,1,441173,164437,42332,65624,1.523185371818148,0.28524608690738545
19897,0.5329285714285714,0,1,0,441174,164436,42332,65624,1.5231761087850606,0.28524732678431713
19898,0.5329761904761905,0,2,0,441176,164434,42332,65624,1.5231575827188855,0.285249806570517
19899,0.5329999999999999,6,41,6,441217,164393,42338,65618,1.5227777983622957,0.28528200825177924
19900,0.533,0,4,0,441221,164389,42338,65618,1.5227407462299456,0.2852869695270144
19901,0.5330238095238095,0,2,0,441223,164387,42338,65618,1.5227222201637705,0.2852894502293428
19902,0.5330476190476189,0,1,0,441224,164386,42338,65618,1.5227129571306828,0.28529069059668527
19903,0.533047619047619,0,2,0,441226,164384,42338,65618,1.5226944310645079,0.2852931713637273
19904,0.5330476190476191,0,1,0,441227,164383,42338,65618,1.5226851680314202,0.2852944117634271
19905,0.5330952380952381,0,1,0,441228,164382,42338,65618,1.5226759049983327,0.28529565217391306
19906,0.5331666666666667,1,15,1,441243,164367,42339,65617,1.5225369595020193,0.2853111520801447
19907,0.5332142857142856,0,3,0,441246,164364,42339,65617,1.5225091704027567,0.28531487383740395
19908,0.5332619047619047,0,1,0,441247,164363,42339,65617,1.5224999073696692,0.2853161144447343
19909,0.5332619047619048,0,1,0,441248,164362,42339,65617,1.5224906443365815,0.28531735506285355
19910,0.5332738095238095,0,2,0,441250,164360,42339,65617,1.5224721182704064,0.28531983633145924
19911,0.5332857142857143,0,1,0,441251,164359,42339,65617,1.522462855237319,0.2853210769819459
19912,0.5333095238095238,0,1,0,441252,164358,42339,65617,1.5224535922042313,0.2853223176432221
19913,0.5333333333333332,0,1,0,441253,164357,42339,65617,1.5224443291711438,0.28532355831528783
19914,0.5333333333333333,116,543,116,441796,163814,42455,65501,1.517414502204602,0.28563765998735363
19915,0.5333333333333334,0,1,0,441797,163813,42455,65501,1.5174052391715143,0.2856389056054144
19916,0.5333690476190477,0,2,0,441799,163811,42455,65501,1.5173867131053391,0.2856413968741278
19917,0.5333809523809524,2,1,2,441800,163810,42457,65499,1.5173774500722517,0.28563641200301776
19918,0.5333888888888889,1,0,1,441800,163810,42458,65498,1.5173774500722517,0.2856332967013798
19919,0.5334523809523809,0,2,0,441802,163808,42458,65498,1.5173589240060765,0.28563578798635886
19920,0.5334761904761904,0,2,0,441804,163806,42458,65498,1.5173403979399014,0.2856382793147961
19921,0.5335,4,24,4,441828,163782,42462,65494,1.5171180851458002,0.28565571625464503
19922,0.5335714285714286,3,2,3,441830,163780,42465,65491,1.517099559079625,0.2856488609549398
19923,0.5335952380952381,1,0,1,441830,163780,42466,65490,1.517099559079625,0.28564574519125924
19924,0.533611111111111,0,1,0,441831,163779,42466,65490,1.5170902960465376,0.28564699108907005
19925,0.5336428571428571,0,1,0,441832,163778,42466,65490,1.5170810330134499,0.2856482369977494
19926,0.5336666666666666,0,27,0,441859,163751,42466,65490,1.516830931120086,0.28568188064089756
19927,0.5336666666666667,0,7,0,441866,163744,42466,65490,1.5167660898884732,0.28569060436060967
19928,0.5336904761904762,0,1,0,441867,163743,42466,65490,1.5167568268553855,0.28569185064977554
19929,0.5337222222222223,0,2,0,441869,163741,42466,65490,1.5167383007892103,0.28569434326072823
19930,0.53375,1,7,1,441876,163734,42467,65489,1.5166734595575975,0.28569995157553996
19931,0.5337857142857143,1,0,1,441876,163734,42468,65488,1.5166734595575975,0.2856968353822931
19932,0.5338095238095238,0,5,0,441881,163729,42468,65488,1.5166271443921597,0.2857030673990149
19933,0.5338333333333333,0,1,0,441882,163728,42468,65488,1.5166178813590723,0.28570431383498535
19934,0.5338333333333334,2,10,2,441892,163718,42470,65486,1.5165252510281966,0.2857105460637685
19935,0.5338571428571428,0,3,0,441895,163715,42470,65486,1.516497461928934,0.2857142857142857
19936,0.5338636363636363,0,1,0,441896,163714,42470,65486,1.5164881988958465,0.28571553228621294
19937,0.5339404761904762,1,0,1,441896,163714,42471,65485,1.5164881988958465,0.2857124158482367
19938,0.533952380952381,0,1,0,441897,163713,42471,65485,1.5164789358627588,0.28571366242288326
19939,0.5339761904761905,2,0,2,441897,163713,42473,65483,1.5164789358627588,0.28570742944903055
19940,0.5339999999999999,0,3,0,441900,163710,42473,65483,1.5164511467634962,0.2857111691892859
19941,0.534,21,95,21,441995,163615,42494,65462,1.5155711586201785,0.2857641753646154
19942,0.5340238095238095,0,1,0,441996,163614,42494,65462,1.515561895587091,0.2857654228291048
19943,0.534047619047619,0,1,0,441997,163613,42494,65462,1.5155526325540034,0.28576667030448544
19944,0.5340476190476191,1,2,1,441999,163611,42495,65461,1.5155341064878283,0.28576604735628974
19945,0.5340555555555556,0,2,0,442001,163609,42495,65461,1.5155155804216534,0.2857685423669621
19946,0.5340833333333332,0,1,0,442002,163608,42495,65461,1.5155063173885657,0.28576978988863616
19947,0.5340833333333334,0,1,0,442003,163607,42495,65461,1.5154970543554782,0.2857710374212024
19948,0.5341190476190476,0,2,0,442005,163605,42495,65461,1.515478528289303,0.285773532519012
19949,0.5341428571428571,1,2,1,442007,163603,42496,65460,1.515460002223128,0.2857729096362136
19950,0.5341666666666667,17,110,17,442117,163493,42513,65443,1.514441068583497,0.28585718279344446
19951,0.5342142857142858,0,2,0,442119,163491,42513,65443,1.514422542517322,0.2858596800824692
19952,0.53425,1,1,1,442120,163490,42514,65442,1.5144132794842342,0.28585780930582005
19953,0.5342857142857143,1,12,1,442132,163478,42515,65441,1.5143021230871836,0.2858696744263255
19954,0.5342857142857144,0,1,0,442133,163477,42515,65441,1.5142928600540961,0.28587092321267876
19955,0.5342976190476191,0,1,0,442134,163476,42515,65441,1.5142835970210085,0.28587217200994247
19956,0.5343095238095238,0,1,0,442135,163475,42515,65441,1.514274333987921,0.2858734208181167
19957,0.5343333333333332,0,2,0,442137,163473,42515,65441,1.5142558079217459,0.2858759184671973
19958,0.5343333333333333,3,31,3,442168,163442,42518,65438,1.5139686538960317,0.2859052778748689
19959,0.5343362193362192,1,0,1,442168,163442,42519,65437,1.5139686538960317,0.285902157908764
19960,0.5343571428571429,0,1,0,442169,163441,42519,65437,1.513959390862944,0.2859034070552871
19961,0.5344047619047619,1,0,1,442169,163441,42520,65436,1.513959390862944,0.28590028705374504
19962,0.5344285714285715,0,1,0,442170,163440,42520,65436,1.5139501278298566,0.2859015362030095
19963,0.5344444444444444,1,3,1,442173,163437,42521,65435,1.513922338730594,0.28590216365479393
19964,0.534452380952381,1,0,1,442173,163437,42522,65434,1.513922338730594,0.2858990435660263
19965,0.5344761904761904,0,1,0,442174,163436,42522,65434,1.5139130756975063,0.285900292742605
19966,0.5344761904761905,0,1,0,442175,163435,42522,65434,1.5139038126644189,0.28590154193009976
19967,0.5345,6,20,6,442195,163415,42528,65428,1.5137185520026677,0.2859078057882478
19968,0.5345238095238095,2,4,2,442199,163411,42530,65426,1.5136814998703176,0.28590656231291267
19969,0.5345714285714286,1,3,1,442202,163408,42531,65425,1.5136537107710548,0.2859071899594901
19970,0.5345833333333333,0,2,0,442204,163406,42531,65425,1.5136351847048797,0.28590968880964557
19971,0.5345833333333334,0,4,0,442208,163402,42531,65425,1.5135981325725296,0.2859146866409995
19972,0.534607142857143,0,1,0,442209,163401,42531,65425,1.513588869539442,0.2859159361261395
19973,0.5346428571428572,1,1,1,442210,163400,42532,65424,1.5135796065063545,0.2859140649582212
19974,0.534653846153846,0,1,0,442211,163399,42532,65424,1.5135703434732668,0.2859153144570257
19975,0.5346666666666666,2,8,2,442219,163391,42534,65422,1.5134962392085665,0.28591906928365085
19976,0.5346666666666667,2,17,2,442236,163374,42536,65420,1.513338767646078,0.28593407169768437
19977,0.5346785714285714,0,1,0,442237,163373,42536,65420,1.5133295046129904,0.28593532144777156
19978,0.5347142857142857,0,1,0,442238,163372,42536,65420,1.513320241579903,0.2859365712087835
19979,0.5347500000000001,1,0,1,442238,163372,42537,65419,1.513320241579903,0.2859334501794214
19980,0.5347619047619048,0,1,0,442239,163371,42537,65419,1.5133109785468153,0.2859346999431793
19981,0.5347857142857143,0,1,0,442240,163370,42537,65419,1.5133017155137278,0.2859359497178623
19982,0.5348095238095238,0,1,0,442241,163369,42537,65419,1.5132924524806404,0.28593719950347046
19983,0.5348333333333333,1,5,1,442246,163364,42538,65418,1.5132461373152024,0.2859403274733152
19984,0.5348333333333334,2,15,2,442261,163349,42540,65416,1.5131071918188892,0.2859528336939654
19985,0.5348373015873017,1,0,1,442261,163349,42541,65415,1.5131071918188892,0.2859497123673305
19986,0.5348809523809523,0,4,0,442265,163345,42541,65415,1.513070139686539,0.2859547123623011
19987,0.5348809523809525,0,1,0,442266,163344,42541,65415,1.5130608766534515,0.28595596238836507
19988,0.5348928571428572,0,2,0,442268,163342,42541,65415,1.5130423505872763,0.2859584624732795
19989,0.5349404761904761,0,1,0,442269,163341,42541,65415,1.5130330875541886,0.2859597125321303
19990,0.5349999999999999,8,16,8,442285,163325,42549,65407,1.512884879024788,0.2859547417938898
19991,0.535,211,1046,211,443331,162279,42760,65196,1.5031957464152061,0.28660731948565776
19992,0.535047619047619,1,1,1,443332,162278,42761,65195,1.5031864833821187,0.28660544328337867
19993,0.5350833333333334,0,1,0,443333,162277,42761,65195,1.503177220349031,0.2866067032425969
19994,0.5350952380952382,0,2,0,443335,162275,42761,65195,1.503158694282856,0.28660922319426735
19995,0.5351111111111111,0,1,0,443336,162274,42761,65195,1.5031494312497684,0.28661048318671994
19996,0.5351190476190476,0,3,0,443339,162271,42761,65195,1.5031216421505058,0.2866142632305487
19997,0.535138888888889,0,1,0,443340,162270,42761,65195,1.5031123791174181,0.2866155232673159
19998,0.5351428571428571,0,1,0,443341,162269,42761,65195,1.5031031160843307,0.28661678331516194
19999,0.5351666666666667,1,11,1,443352,162258,42762,65194,1.5030012227203675,0.2866275082215149
20000,0.5351904761904762,0,3,0,443355,162255,42762,65194,1.502973433621105,0.2866312887724281
20001,0.5352380952380952,0,2,0,443357,162253,42762,65194,1.5029549075549298,0.28663380919510917
20002,0.53525,2,1,2,443358,162252,42764,65192,1.5029456445218423,0.28662879653892825
20003,0.5352619047619047,0,1,0,443359,162251,42764,65192,1.5029363814887546,0.2866300567614743
20004,0.5352738095238095,0,3,0,443362,162248,42764,65192,1.502908592389492,0.2866338374956032
20005,0.5352777777777777,0,1,0,443363,162247,42764,65192,1.5028993293564044,0.286635097762477
20006,0.5353333333333332,0,1,0,443364,162246,42764,65192,1.502890066323317,0.28663635804043297
20007,0.5353333333333333,3,17,3,443381,162229,42767,65189,1.5027325947608285,0.28664837435910967
20008,0.5353333333333334,1,14,1,443395,162215,42768,65188,1.5026029122976028,0.28666288483441293
20009,0.5353571428571429,1,2,1,443397,162213,42769,65187,1.5025843862314276,0.2866622691292876
20010,0.5353809523809524,1,0,1,443397,162213,42770,65186,1.5025843862314276,0.28665913218615735
20011,0.5354166666666667,0,1,0,443398,162212,42770,65186,1.50257512319834,0.2866603927914933
20012,0.5354166666666668,0,2,0,443400,162210,42770,65186,1.502556597132165,0.2866629140354272
20013,0.5354404761904763,0,3,0,443403,162207,42770,65186,1.5025288080329022,0.286666695984485
20014,0.535452380952381,1,3,1,443406,162204,42771,65185,1.5025010189336396,0.28666734098835034
20015,0.5354761904761904,0,1,0,443407,162203,42771,65185,1.5024917559005522,0.28666860168522523
20016,0.5354761904761905,2,2,2,443409,162201,42773,65183,1.502473229834377,0.28666484888998345
20017,0.5355,5,13,5,443422,162188,42778,65178,1.5023528104042387,0.28666555245727154
20018,0.5355000000000001,0,6,0,443428,162182,42778,65178,1.5022972322057135,0.2866731175228712
20019,0.535547619047619,0,1,0,443429,162181,42778,65178,1.5022879691726259,0.2866743784059571
20020,0.5355555555555556,1,1,1,443430,162180,42779,65177,1.5022787061395384,0.2866725018363191
20021,0.5355595238095239,0,1,0,443431,162179,42779,65177,1.5022694431064507,0.2866737627333345
20022,0.5355833333333333,1,0,1,443431,162179,42780,65176,1.5022694431064507,0.28667062523366543
20023,0.5355952380952381,0,1,0,443432,162178,42780,65176,1.5022601800733633,0.2866718861335186
20024,0.5356111111111111,0,1,0,443433,162177,42780,65176,1.5022509170402756,0.2866731470444639
20025,0.5356190476190476,0,1,0,443434,162176,42780,65176,1.5022416540071881,0.2866744079665013
20026,0.5356428571428572,0,1,0,443435,162175,42780,65176,1.5022323909741007,0.286675668899631
20027,0.5356666666666666,9,20,9,443455,162155,42789,65167,1.5020471303123495,0.28667264936961667
20028,0.5356666666666667,1,11,1,443466,162144,42790,65166,1.5019452369483863,0.2866833839250363
20029,0.5357142857142856,0,1,0,443467,162143,42790,65166,1.5019359739152989,0.28668464513063713
20030,0.5357142857142857,4,11,4,443478,162132,42794,65162,1.5018340805513357,0.2866859661935643
20031,0.5357142857142858,0,1,0,443479,162131,42794,65162,1.5018248175182483,0.2866872274993071
20032,0.5357500000000001,1,1,1,443480,162130,42795,65161,1.5018155544851606,0.28668535049781996
20033,0.5357619047619048,0,1,0,443481,162129,42795,65161,1.5018062914520731,0.2866866118175019
20034,0.5357857142857142,0,3,0,443484,162126,42795,65161,1.5017785023528103,0.28669039584314104
20035,0.5358208020050125,0,1,0,443485,162125,42795,65161,1.5017692393197228,0.2866916572072191
20036,0.5358333333333333,7,49,7,443534,162076,42802,65154,1.5013153506984327,0.28673150552303833
20037,0.5358333333333334,10,61,10,443595,162015,42812,65144,1.500750305680092,0.2867771032624725
20038,0.5358571428571428,0,1,0,443596,162014,42812,65144,1.5007410426470043,0.28677836571901494
20039,0.5358888888888889,0,1,0,443597,162013,42812,65144,1.5007317796139168,0.28677962818667263
20040,0.5358928571428573,0,1,0,443598,162012,42812,65144,1.5007225165808293,0.28678089066544576
20041,0.5359166666666666,0,3,0,443601,162009,42812,65144,1.5006947274815665,0.28678467816845915
20042,0.5359404761904761,1,2,1,443603,162007,42813,65143,1.5006762014153914,0.2867840633942329
20043,0.535952380952381,0,1,0,443604,162006,42813,65143,1.500666938382304,0.2867853259314371
20044,0.5359523809523811,0,1,0,443605,162005,42813,65143,1.5006576753492165,0.2867865884797577
20045,0.5359999999999999,0,10,0,443615,161995,42813,65143,1.5005650450183408,0.2867992145743997
20046,0.536,20,111,20,443726,161884,42833,65123,1.4995368483456224,0.2868766161395904
20047,0.5360595238095239,1,0,1,443726,161884,42834,65122,1.4995368483456224,0.2868734747099196
20048,0.5360681818181818,0,3,0,443729,161881,42834,65122,1.4995090592463596,0.28687726593921664
20049,0.5360714285714285,1,0,1,443729,161881,42835,65121,1.4995090592463596,0.28687412445705324
20050,0.5360714285714286,0,3,0,443732,161878,42835,65121,1.499481270147097,0.28687791576174343
20051,0.5360833333333332,0,1,0,443733,161877,42835,65121,1.4994720071140095,0.28687917955224274
20052,0.5361056998556998,0,1,0,443734,161876,42835,65121,1.4994627440809218,0.2868804433538769
20053,0.5361111111111111,2,2,2,443736,161874,42837,65119,1.4994442180147467,0.28687668782737796
20054,0.5361190476190476,0,1,0,443737,161873,42837,65119,1.4994349549816592,0.286877951645873
20055,0.536142857142857,0,1,0,443738,161872,42837,65119,1.4994256919485716,0.28687921547550344
20056,0.5361666666666666,0,3,0,443741,161869,42837,65119,1.499397902849309,0.2868830070312087
20057,0.5361666666666667,5,8,5,443749,161861,42842,65114,1.4993237985846086,0.2868774094063223
20058,0.5361666666666668,0,1,0,443750,161860,42842,65114,1.499314535551521,0.2868786733282226
20059,0.5361904761904762,1,3,1,443753,161857,42843,65113,1.4992867464522583,0.28687932325858045
20060,0.5362142857142858,0,1,0,443754,161856,42843,65113,1.4992774834191707,0.28688058721675647
20061,0.5362380952380952,0,2,0,443756,161854,42843,65113,1.4992589573529957,0.286883115166522
20062,0.5362499999999999,0,2,0,443758,161852,42843,65113,1.4992404312868206,0.28688564316083975
20063,0.53625,3,6,3,443764,161846,42846,65110,1.4991848530882952,0.2868838012654435
20064,0.5362777777777779,0,1,0,443765,161845,42846,65110,1.4991755900552077,0.2868850653213192
20065,0.5362857142857143,0,1,0,443766,161844,42846,65110,1.49916632702212,0.2868863293883342
20066,0.5362857142857144,1,5,1,443771,161839,42847,65109,1.4991200118566823,0.2868895077286427
20067,0.5363095238095238,0,1,0,443772,161838,42847,65109,1.4991107488235949,0.28689077185422146
20068,0.5363333333333332,0,3,0,443775,161835,42847,65109,1.499082959724332,0.28689456429780036
20069,0.5363333333333333,1,13,1,443788,161822,42848,65108,1.498962540294194,0.286907857048429
20070,0.5363333333333334,0,2,0,443790,161820,42848,65108,1.4989440142280188,0.28691038567298877
20071,0.536345238095238,1,2,1,443792,161818,42849,65107,1.4989254881618437,0.28690977195108514
20072,0.5363968253968254,0,1,0,443793,161817,42849,65107,1.4989162251287562,0.28691103629408965
20073,0.5364166666666667,1,0,1,443793,161817,42850,65106,1.4989162251287562,0.28690789386708265
20074,0.5364285714285714,1,1,1,443794,161816,42851,65105,1.4989069620956685,0.28690601574997465
20075,0.5364285714285715,0,1,0,443795,161815,42851,65105,1.498897699062581,0.2869072800987132
20076,0.5364761904761906,0,1,0,443796,161814,42851,65105,1.4988884360294934,0.28690854445859537
20077,0.5364999999999999,0,5,0,443801,161809,42851,65105,1.4988421208640557,0.2869148664251655
20078,0.5365,4,16,4,443817,161793,42855,65101,1.4986939123346548,0.2869225277001595
20079,0.5365000000000001,0,2,0,443819,161791,42855,65101,1.4986753862684798,0.2869250568552439
20080,0.5365238095238095,0,1,0,443820,161790,42855,65101,1.4986661232353922,0.2869263214495066
20081,0.5365357142857143,0,1,0,443821,161789,42855,65101,1.4986568602023047,0.2869275860549165
20082,0.536547619047619,0,2,0,443823,161787,42855,65101,1.4986383341361296,0.28693011529917845
20083,0.5365595238095238,1,0,1,443823,161787,42856,65100,1.4986383341361296,0.28692697245765514
20084,0.5365714285714286,0,2,0,443825,161785,42856,65100,1.4986198080699544,0.2869295017299513
20085,0.5366060606060605,0,2,0,443827,161783,42856,65100,1.4986012820037793,0.2869320310468391
20086,0.5366623376623376,0,1,0,443828,161782,42856,65100,1.4985920189706918,0.28693329572200527
20087,0.5366666666666666,88,370,88,444198,161412,42944,65012,1.4951646967282968,0.28712503974843656
20088,0.5366666666666667,55,212,55,444410,161200,42999,64957,1.4932009337137353,0.28722082447149544
20089,0.5366818181818183,0,1,0,444411,161199,42999,64957,1.4931916706806476,0.28722209448345387
20090,0.5366908483673188,1,0,1,444411,161199,43000,64956,1.4931916706806476,0.28721894276049614
20091,0.5367142857142856,1,3,1,444414,161196,43001,64955,1.493163881581385,0.2872196010630066
20092,0.5367142857142857,0,4,0,444418,161192,43001,64955,1.4931268294490347,0.2872246812913724
20093,0.5367222222222222,0,2,0,444420,161190,43001,64955,1.4931083033828596,0.28722722147294877
20094,0.5367619047619047,0,2,0,444422,161188,43001,64955,1.4930897773166847,0.28722976169945563
20095,0.5367619047619048,1,1,1,444423,161187,43002,64954,1.493080514283597,0.287227879951004
20096,0.5367857142857143,1,0,1,444423,161187,43003,64953,1.493080514283597,0.28722472804457416
20097,0.5368333333333333,0,6,0,444429,161181,43003,64953,1.4930249360850716,0.2872323489612354
20098,0.5368333333333334,1,4,1,444433,161177,43004,64952,1.4929878839527215,0.28723427777949756
20099,0.5368888888888887,0,1,0,444434,161176,43004,64952,1.4929786209196338,0.2872355480082077
20100,0.5368888888888889,0,1,0,444435,161175,43004,64952,1.4929693578865464,0.2872368182481526
20101,0.5369047619047619,0,1,0,444436,161174,43004,64952,1.4929600948534587,0.28723808849933224
20102,0.5369458874458874,0,1,0,444437,161173,43004,64952,1.4929508318203712,0.28723935876174683
20103,0.5369761904761904,0,1,0,444438,161172,43004,64952,1.4929415687872838,0.2872406290353965
20104,0.5369761904761905,1,1,1,444439,161171,43005,64951,1.492932305754196,0.28723874722494935
20105,0.5369999999999999,0,11,0,444450,161160,43005,64951,1.492830412390233,0.28725272100870813
20106,0.537,6,45,6,444495,161115,43011,64945,1.492413575901293,0.28729098469432895
20107,0.5370238095238095,0,1,0,444496,161114,43011,64945,1.4924043128682056,0.28729225556160115
20108,0.5370357142857143,1,0,1,444496,161114,43012,64944,1.4924043128682056,0.2872891027966274
20109,0.537047619047619,0,2,0,444498,161112,43012,64944,1.4923857868020305,0.2872916445482535
20110,0.5370477643271758,0,1,0,444499,161111,43012,64944,1.4923765237689428,0.2872929154409325
20111,0.5370833333333332,1,0,1,444499,161111,43013,64943,1.4923765237689428,0.2872897626230901
20112,0.5370833333333334,0,2,0,444501,161109,43013,64943,1.492357997702768,0.2872923044255304
20113,0.5371309523809524,0,1,0,444502,161108,43013,64943,1.4923487346696802,0.28729357534361716
20114,0.5371428571428571,2,14,2,444516,161094,43015,64941,1.4922190522064545,0.287305063375141
20115,0.5371666666666666,1,8,1,444524,161086,43016,64940,1.4921449479417541,0.2873120791413377
20116,0.5371666666666667,0,7,0,444531,161079,43016,64940,1.4920801067101412,0.2873209774399497
20117,0.5371785714285714,0,1,0,444532,161078,43016,64940,1.4920708436770536,0.28732224867045986
20118,0.5372142857142858,1,0,1,444532,161078,43017,64939,1.4920708436770536,0.2873190954662702
20119,0.5372619047619047,0,1,0,444533,161077,43017,64939,1.492061580643966,0.2873203666997027
20120,0.5372619047619048,0,3,0,444536,161074,43017,64939,1.4920337915447035,0.28732418046749525
20121,0.5373134920634921,0,3,0,444539,161071,43017,64939,1.4920060024454407,0.2873279943365338
20122,0.5373333333333332,1,9,1,444548,161062,43018,64938,1.4919226351476527,0.2873362831858407
20123,0.5373333333333333,10,27,10,444575,161035,43028,64928,1.4916725332542888,0.2873390776366042
20124,0.5373333333333334,0,4,0,444579,161031,43028,64928,1.4916354811219386,0.2873441642067809
20125,0.5373809523809523,1,0,1,444579,161031,43029,64927,1.4916354811219386,0.28734101027624603
20126,0.5373809523809524,1,5,1,444584,161026,43030,64926,1.4915891659565008,0.28734421470046734
20127,0.5373928571428572,0,2,0,444586,161024,43030,64926,1.4915706398903257,0.2873467581323302
20128,0.5375,49,282,49,444868,160742,43079,64877,1.4889584645596354,0.2875511370939504
20129,0.5375000000000001,0,9,0,444877,160733,43079,64877,1.4888750972618474,0.2875626080404237
20130,0.5375714285714285,0,1,0,444878,160732,43079,64877,1.48886583422876,0.2875638826465256
20131,0.5375833333333333,1,1,1,444879,160731,43080,64876,1.4888565711956723,0.2875619994060468
20132,0.5376309523809524,0,1,0,444880,160730,43080,64876,1.4888473081625848,0.28756327402640003
20133,0.5376666666666666,3,29,3,444909,160701,43083,64873,1.4885786802030456,0.2875907684396251
20134,0.5376666666666667,2,12,2,444921,160689,43085,64871,1.488467523805995,0.28759975172902996
20135,0.5376904761904763,0,1,0,444922,160688,43085,64871,1.4884582607729075,0.2876010267823496
20136,0.5377142857142857,0,4,0,444926,160684,43085,64871,1.4884212086405573,0.28760612710868744
20137,0.5377380952380952,0,1,0,444927,160683,43085,64871,1.4884119456074698,0.2876074022185375
20138,0.53775,1,0,1,444927,160683,43086,64870,1.4884119456074698,0.28760424379192473
20139,0.5377619047619048,0,2,0,444929,160681,43086,64870,1.4883934195412947,0.2876067940288449
20140,0.5377619047619049,0,1,0,444930,160680,43086,64870,1.488384156508207,0.2876080691642651
20141,0.5377777777777778,1,0,1,444930,160680,43087,64869,1.488384156508207,0.28760491068459626
20142,0.5377857142857142,0,1,0,444931,160679,43087,64869,1.4883748934751195,0.28760618582297337
20143,0.5377857142857143,0,1,0,444932,160678,43087,64869,1.4883656304420319,0.2876074609726576
20144,0.5377857142857144,1,0,1,444932,160678,43088,64868,1.4883656304420319,0.28760430244828106
20145,0.5378015873015873,0,1,0,444933,160677,43088,64868,1.4883563674089444,0.2876055776009222
20146,0.5378095238095238,0,1,0,444934,160676,43088,64868,1.488347104375857,0.2876068527648707
20147,0.5378333333333333,1,4,1,444938,160672,43089,64867,1.4883100522435067,0.2876087949312536
20148,0.5378333333333334,1,5,1,444943,160667,43090,64866,1.488263737078069,0.28761201243277035
20149,0.5378571428571428,0,2,0,444945,160665,43090,64866,1.4882452110118938,0.28761456296473653
20150,0.5378809523809523,1,0,1,444945,160665,43091,64865,1.4882452110118938,0.28761140424777193
20151,0.5379047619047619,1,1,1,444946,160664,43092,64864,1.488235947978806,0.2876095207690398
20152,0.5379166666666666,0,3,0,444949,160661,43092,64864,1.4882081588795435,0.287613346635628
20153,0.537936507936508,0,1,0,444950,160660,43092,64864,1.488198895846456,0.28761462194710985
20154,0.5379523809523808,0,2,0,444952,160658,43092,64864,1.488180369780281,0.28761717260400316
20155,0.537952380952381,0,1,0,444953,160657,43092,64864,1.4881711067471932,0.28761844794941493
20156,0.5379999999999999,21,76,21,445029,160581,43113,64843,1.4874671162325392,0.28764905245226774
20157,0.538,0,4,0,445033,160577,43113,64843,1.487430064100189,0.28765415668529853
20158,0.5380324675324676,0,2,0,445035,160575,43113,64843,1.4874115380340138,0.2876567088697442
20159,0.5380555555555555,0,1,0,445036,160574,43113,64843,1.4874022750009264,0.2876579849789501
20160,0.5380952380952381,0,4,0,445040,160570,43113,64843,1.487365222868576,0.2876630895289979
20161,0.5381428571428571,0,1,0,445041,160569,43113,64843,1.4873559598354886,0.2876643656948166
20162,0.5381666666666666,0,1,0,445042,160568,43113,64843,1.487346696802401,0.2876656418719583
20163,0.5381666666666667,4,15,4,445057,160553,43117,64839,1.4872077513060877,0.2876721445304181
20164,0.5381904761904761,1,1,1,445058,160552,43118,64838,1.487198488273,0.28767026043746396
20165,0.538202380952381,1,0,1,445058,160552,43119,64837,1.487198488273,0.28766709999157014
20166,0.5382142857142856,2,4,2,445062,160548,43121,64835,1.48716143614065,0.28766588429473383
20167,0.5382380952380952,0,1,0,445063,160547,43121,64835,1.4871521731075623,0.2876671606428197
20168,0.5382619047619047,0,1,0,445064,160546,43121,64835,1.4871429100744749,0.28766843700223177
20169,0.5382857142857143,0,1,0,445065,160545,43121,64835,1.4871336470413872,0.2876697133729701
20170,0.5382905982905983,1,0,1,445065,160545,43122,64834,1.4871336470413872,0.2876665527844209
20171,0.5383055555555556,1,0,1,445065,160545,43123,64833,1.4871336470413872,0.2876633921678247
20172,0.5383095238095239,0,2,0,445067,160543,43123,64833,1.487115120975212,0.28766594490983954
20173,0.5383333333333333,82,313,82,445380,160230,43205,64751,1.4842157916188077,0.287806525884408
20174,0.5383333333333334,0,3,0,445383,160227,43205,64751,1.484188002519545,0.2878103636800043
20175,0.5383809523809524,0,4,0,445387,160223,43205,64751,1.4841509503871948,0.28781548090001513
20176,0.5384166666666667,0,1,0,445388,160222,43205,64751,1.4841416873541071,0.28781676023345026
20177,0.538452380952381,0,1,0,445389,160221,43205,64751,1.4841324243210197,0.28781803957825863
20178,0.5384642857142857,0,2,0,445391,160219,43205,64751,1.4841138982548445,0.2878205983019958
20179,0.5385,5,14,5,445405,160205,43210,64746,1.4839842157916188,0.28782268138394584
20180,0.5385000000000001,1,0,1,445405,160205,43211,64745,1.4839842157916188,0.2878195154478773
20181,0.5385238095238095,0,2,0,445407,160203,43211,64745,1.4839656897254436,0.28782207443498053
20182,0.538531746031746,0,2,0,445409,160201,43211,64745,1.4839471636592685,0.2878246334675878
20183,0.538547619047619,1,0,1,445409,160201,43212,64744,1.4839471636592685,0.28782146746982595
20184,0.5385555555555556,0,1,0,445410,160200,43212,64744,1.483937900626181,0.2878227469948076
20185,0.538563492063492,0,1,0,445411,160199,43212,64744,1.4839286375930936,0.2878240265311657
20186,0.5385714285714286,3,8,3,445419,160191,43215,64741,1.483854533328393,0.2878247648178116
20187,0.5386111111111112,1,0,1,445419,160191,43216,64740,1.483854533328393,0.2878215986235779
20188,0.5386190476190477,0,1,0,445420,160190,43216,64740,1.4838452702953056,0.2878228782287823
20189,0.5386388888888889,1,0,1,445420,160190,43217,64739,1.4838452702953056,0.28781971199800827
20190,0.5386428571428571,1,0,1,445420,160190,43218,64738,1.4838452702953056,0.28781654573908094
20191,0.5386666666666665,0,1,0,445421,160189,43218,64738,1.4838360072622179,0.2878178253388877
20192,0.5386666666666666,2,19,2,445440,160170,43220,64736,1.4836600096335544,0.2878358069593519
20193,0.5386666666666667,2,5,2,445445,160165,43222,64734,1.4836136944681166,0.28783587299187635
20194,0.5386746031746031,1,0,1,445445,160165,43223,64733,1.4836136944681166,0.28783270638244896
20195,0.5386904761904762,0,2,0,445447,160163,43223,64733,1.4835951684019415,0.287835266078543
20196,0.5387142857142857,1,1,1,445448,160162,43224,64732,1.483585905368854,0.2878333792809057
20197,0.53875,1,5,1,445453,160157,43225,64731,1.4835395902034163,0.287836612002419
20198,0.5387619047619048,0,3,0,445456,160154,43225,64731,1.4835118011041535,0.28784045178646867
20199,0.5387857142857143,1,0,1,445456,160154,43226,64730,1.4835118011041535,0.2878372850002668
20200,0.5388095238095238,0,2,0,445458,160152,43226,64730,1.4834932750379783,0.28783984489643455
20201,0.5388333333333333,0,10,0,445468,160142,43226,64730,1.4834006447071029,0.28785264506030095
20202,0.5388333333333334,0,1,0,445469,160141,43226,64730,1.4833913816740154,0.2878539251393021
20203,0.5388333333333335,1,6,1,445475,160135,43227,64729,1.48333580347549,0.28785843887861107
20204,0.5388492063492063,0,1,0,445476,160134,43227,64729,1.4833265404424025,0.2878597190289198
20205,0.5388690476190476,0,1,0,445477,160133,43227,64729,1.4833172774093148,0.2878609991906147
20206,0.5388888888888889,0,2,0,445479,160131,43227,64729,1.4832987513431397,0.2878635595481633
20207,0.5388939393939394,0,1,0,445480,160130,43227,64729,1.4832894883100523,0.2878648397440174
20208,0.5389722222222223,0,1,0,445481,160129,43227,64729,1.4832802252769648,0.2878661199512581
20209,0.5389761904761905,0,1,0,445482,160128,43227,64729,1.4832709622438771,0.28786740016988577
20210,0.5389999999999999,0,1,0,445483,160127,43227,64729,1.4832616992107897,0.2878686803999004
20211,0.539,20,50,20,445533,160077,43247,64709,1.4827985475564118,0.2878693512941197
20212,0.539047619047619,1,8,1,445541,160069,43248,64708,1.4827244432917115,0.2878764286381614
20213,0.5390833333333334,0,1,0,445542,160068,43248,64708,1.4827151802586238,0.28787770936398904
20214,0.5391190476190476,3,5,3,445547,160063,43251,64705,1.482668865093186,0.28787460848519364
20215,0.5391428571428571,0,1,0,445548,160062,43251,64705,1.4826596020600986,0.2878758892542055
20216,0.5391547619047619,0,1,0,445549,160061,43251,64705,1.482650339027011,0.28787717003461377
20217,0.5391666666666666,2,3,2,445552,160058,43253,64703,1.4826225499277483,0.2878746757667033
20218,0.5391666666666667,27,115,27,445667,159943,43280,64676,1.4815573011226797,0.2879364612966846
20219,0.5391666666666668,0,2,0,445669,159941,43280,64676,1.4815387750565046,0.2879390250960524
20220,0.5392045454545457,0,1,0,445670,159940,43280,64676,1.4815295120234169,0.2879403070128575
20221,0.53925,1,0,1,445670,159940,43281,64675,1.4815295120234169,0.287937136878659
20222,0.5392777777777777,1,1,1,445671,159939,43282,64674,1.4815202489903294,0.28793524862763953
20223,0.5392857142857143,3,5,3,445676,159934,43285,64671,1.4814739338248917,0.28793214754791746
20224,0.5392857142857144,0,1,0,445677,159933,43285,64671,1.481464670791804,0.2879334295025912
20225,0.5393333333333332,0,1,0,445678,159932,43285,64671,1.4814554077587165,0.28793471146868027
20226,0.5393333333333333,12,40,12,445718,159892,43297,64659,1.4810848864352144,0.28794794946359625
20227,0.5393333333333334,1,0,1,445718,159892,43298,64658,1.4810848864352144,0.2879447784457804
20228,0.5393571428571429,0,1,0,445719,159891,43298,64658,1.4810756234021267,0.2879460607707004
20229,0.5394047619047619,0,2,0,445721,159889,43298,64658,1.4810570973359516,0.28794862545480454
20230,0.5394234376734378,1,3,1,445724,159886,43299,64657,1.481029308236689,0.28794930147009706
20231,0.539439393939394,0,1,0,445725,159885,43299,64657,1.4810200452036015,0.2879505838551362
20232,0.5394444444444444,0,1,0,445726,159884,43299,64657,1.4810107821705139,0.2879518662515977
20233,0.5394444444444445,0,3,0,445729,159881,43299,64657,1.4809829930712513,0.2879557135095173
20234,0.5394523809523809,1,1,1,445730,159880,43300,64656,1.4809737300381638,0.28795382477642784
20235,0.5395,3,18,3,445748,159862,43303,64653,1.4808069954425878,0.2879673963877692
20236,0.539547619047619,0,1,0,445749,159861,43303,64653,1.4807977324095,0.28796867901333545
20237,0.5395833333333333,1,5,1,445754,159856,43304,64652,1.4807514172440623,0.28797192082242057
20238,0.5396190476190477,1,0,1,445754,159856,43305,64651,1.4807514172440623,0.2879687493040306
20239,0.5396287878787879,0,1,0,445755,159855,43305,64651,1.4807421542109749,0.28797003198132787
20240,0.5396428571428572,0,3,0,445758,159852,43305,64651,1.4807143651117123,0.28797388008178065
20241,0.5396666666666666,3,6,3,445764,159846,43308,64648,1.4806587869131869,0.28797206161411887
20242,0.5396666666666667,2,13,2,445777,159833,43310,64646,1.4805383674830486,0.28798239478971305
20243,0.5396904761904762,0,1,0,445778,159832,43310,64646,1.480529104449961,0.2879836776877912
20244,0.5397142857142857,0,1,0,445779,159831,43310,64646,1.4805198414168736,0.2879849605972995
20245,0.5397222222222221,0,1,0,445780,159830,43310,64646,1.480510578383786,0.28798624351823804
20246,0.5397222222222222,0,2,0,445782,159828,43310,64646,1.4804920523176108,0.28798880939440646
20247,0.5397380952380952,1,0,1,445782,159828,43311,64645,1.4804920523176108,0.28798563747087624
20248,0.5397777777777778,0,1,0,445783,159827,43311,64645,1.4804827892845234,0.2879869204176913
20249,0.5398095238095239,2,0,2,445783,159827,43313,64643,1.4804827892845234,0.2879805764690159
20250,0.5398333333333333,0,7,0,445790,159820,43313,64643,1.4804179480529105,0.2879895572989758
20251,0.5398333333333334,0,16,0,445806,159804,43313,64643,1.4802697395235096,0.2880100870138607
20252,0.5398571428571429,0,1,0,445807,159803,43313,64643,1.480260476490422,0.2880113702182262
20253,0.5398874458874459,0,1,0,445808,159802,43313,64643,1.4802512134573345,0.28801265343402616
20254,0.5399047619047619,0,1,0,445809,159801,43313,64643,1.480241950424247,0.28801393666126074
20255,0.5399166666666667,0,3,0,445812,159798,43313,64643,1.4802141613249842,0.28801778641157366
20256,0.5399523809523809,0,1,0,445813,159797,43313,64643,1.4802048982918967,0.2880190696845482
20257,0.539952380952381,0,1,0,445814,159796,43313,64643,1.480195635258809,0.28802035296895817
20258,0.5399642857142858,0,1,0,445815,159795,43313,64643,1.4801863722257216,0.28802163626480365
20259,0.5399999999999999,6,21,6,445836,159774,43319,64637,1.479991848530883,0.28802955291852894
20260,0.54,500,2552,500,448388,157222,43819,64137,1.4563525880914447,0.28974200280991513
20261,0.5400357142857142,0,2,0,448390,157220,43819,64137,1.4563340620252696,0.28974462068062
20262,0.5400833333333334,0,1,0,448391,157219,43819,64137,1.456324798992182,0.2897459296337122
20263,0.5400952380952382,0,1,0,448392,157218,43819,64137,1.4563155359590945,0.28974723859863116
20264,0.5401190476190476,1,1,1,448393,157217,43820,64136,1.4563062729260068,0.2897453388930803
20265,0.5401309523809523,1,0,1,448393,157217,43821,64135,1.4563062729260068,0.2897421301817919
20266,0.5401428571428571,0,1,0,448394,157216,43821,64135,1.4562970098929193,0.2897434391532001
20267,0.5401468253968253,0,1,0,448395,157215,43821,64135,1.4562877468598319,0.2897447481364355
20268,0.5401666666666666,0,2,0,448397,157213,43821,64135,1.4562692207936567,0.2897473661383884
20269,0.5401666666666667,1,17,1,448414,157196,43822,64134,1.4561117492311682,0.28976641214476123
20270,0.5401818181818182,0,1,0,448415,157195,43822,64134,1.4561024861980807,0.2897677213559904
20271,0.5402301587301587,0,1,0,448416,157194,43822,64134,1.4560932231649932,0.2897690305790501
20272,0.5402380952380952,0,1,0,448417,157193,43822,64134,1.4560839601319056,0.28977033981394046
20273,0.5402380952380953,0,3,0,448420,157190,43822,64134,1.456056171032643,0.2897742675895972
20274,0.5402499999999999,1,3,1,448423,157187,43823,64133,1.4560283819333804,0.2897749864449666
20275,0.54025,0,2,0,448425,157185,43823,64133,1.4560098558672052,0.2897776050750504
20276,0.5402619047619046,0,1,0,448426,157184,43823,64133,1.4560005928341175,0.2897789144078403
20277,0.5402619047619048,0,1,0,448427,157183,43823,64133,1.45599132980103,0.28978022375246254
20278,0.5402777777777777,1,3,1,448430,157180,43824,64132,1.4559635407017675,0.28978094274146904
20279,0.5402857142857143,0,1,0,448431,157179,43824,64132,1.4559542776686798,0.2897822521248379
20280,0.5403333333333332,0,2,0,448433,157177,43824,64132,1.4559357516025047,0.28978487092707483
20281,0.5403333333333333,3,22,3,448455,157155,43827,64129,1.4557319648745786,0.28980405271054394
20282,0.5403419913419915,0,1,0,448456,157154,43827,64129,1.4557227018414909,0.2898053623640316
20283,0.5403571428571429,0,2,0,448458,157152,43827,64129,1.455704175775316,0.28980798170651795
20284,0.5403809523809524,0,2,0,448460,157150,43827,64129,1.4556856497091408,0.2898106010963535
20285,0.5404166666666667,0,2,0,448462,157148,43827,64129,1.4556671236429657,0.2898132205335394
20286,0.5404166666666668,0,1,0,448463,157147,43827,64129,1.455657860609878,0.2898145302698892
20287,0.5404444444444444,0,1,0,448464,157146,43827,64129,1.4556485975767905,0.28981584001807703
20288,0.5404761904761904,0,1,0,448465,157145,43827,64129,1.455639334543703,0.2898171497781032
20289,0.5404761904761906,1,3,1,448468,157142,43828,64128,1.4556115454444403,0.2898178695711122
20290,0.540479797979798,0,1,0,448469,157141,43828,64128,1.4556022824113528,0.2898191793699072
20291,0.5405,2,13,2,448482,157128,43830,64126,1.4554818629812145,0.28982978838800655
20292,0.5405000000000001,0,2,0,448484,157126,43830,64126,1.4554633369150394,0.28983240829461426
20293,0.5405079365079365,0,1,0,448485,157125,43830,64126,1.455454073881952,0.28983371826568016
20294,0.5405238095238096,0,2,0,448487,157123,43830,64126,1.4554355478157768,0.2898363382433367
20295,0.5405357142857143,0,2,0,448489,157121,43830,64126,1.4554170217496016,0.2898389582683607
20296,0.5405555555555556,0,4,0,448493,157117,43830,64126,1.4553799696172516,0.2898441984605163
20297,0.5405714285714286,0,3,0,448496,157114,43830,64126,1.4553521805179888,0.2898481287289821
20298,0.5405952380952381,0,3,0,448499,157111,43830,64126,1.4553243914187262,0.2898520591040378
20299,0.5406190476190477,0,2,0,448501,157109,43830,64126,1.455305865352551,0.28985467941329357
20300,0.5406666666666666,3,20,3,448521,157089,43833,64123,1.4551206046907998,0.2898712547239752
20301,0.5406666666666667,1,7,1,448528,157082,43834,64122,1.455055763459187,0.2898772174101734
20302,0.5407142857142857,4,11,4,448539,157071,43838,64118,1.454953870095224,0.28987879144080403
20303,0.5407222222222222,0,1,0,448540,157070,43838,64118,1.4549446070621364,0.2898801019946833
20304,0.5407619047619048,0,1,0,448541,157069,43838,64118,1.454935344029049,0.28988141256041267
20305,0.5407857142857142,1,0,1,448541,157069,43839,64117,1.454935344029049,0.28987820205618803
20306,0.5407857142857143,1,1,1,448542,157068,43840,64116,1.4549260809959612,0.2898763020833333
20307,0.5408095238095239,0,1,0,448543,157067,43840,64116,1.4549168179628738,0.2898776126555838
20308,0.5408333333333333,8,55,8,448598,157012,43848,64108,1.4544073511430582,0.28992402315484805
20309,0.5408333333333334,7,60,7,448658,156952,43855,64101,1.4538515691578051,0.2899802309853293
20310,0.5408982683982684,2,1,2,448659,156951,43857,64099,1.4538423061247174,0.2899751187514137
20311,0.5409166666666666,1,0,1,448659,156951,43858,64098,1.4538423061247174,0.28997190668132405
20312,0.540952380952381,0,1,0,448660,156950,43858,64098,1.45383304309163,0.28997321848648255
20313,0.5409523809523811,0,1,0,448661,156949,43858,64098,1.4538237800585423,0.2899745303035101
20314,0.5409642857142856,0,3,0,448664,156946,43858,64098,1.4537959909592797,0.28997846582580844
20315,0.5409642857142858,0,4,0,448668,156942,43858,64098,1.4537589388269294,0.28998371335504886
20316,0.5409999999999999,1,5,1,448673,156937,43859,64097,1.4537126236614917,0.28998706081417336
20317,0.541,3,60,3,448733,156877,43862,64094,1.4531568416762384,0.29005616121572514
20318,0.541017316017316,1,2,1,448735,156875,43863,64093,1.4531383156100635,0.2900555736577242
20319,0.5410238095238096,0,2,0,448737,156873,43863,64093,1.4531197895438883,0.29005819899894103
20320,0.541031746031746,0,1,0,448738,156872,43863,64093,1.4531105265108006,0.2900595116873713
20321,0.5410714285714286,0,2,0,448740,156870,43863,64093,1.4530920004446255,0.29006213709987644
20322,0.5411111111111111,1,3,1,448743,156867,43864,64092,1.453064211345363,0.2900628623409773
20323,0.5411190476190476,0,2,0,448745,156865,43864,64092,1.4530456852791878,0.29006548785510305
20324,0.5411428571428571,0,4,0,448749,156861,43864,64092,1.4530086331468377,0.2900707390259467
20325,0.5411435786435788,0,2,0,448751,156859,43864,64092,1.4529901070806626,0.2900733646826672
20326,0.5411666666666667,0,4,0,448755,156855,43864,64092,1.4529530549483123,0.290078616138712
20327,0.5411666666666668,1,0,1,448755,156855,43865,64091,1.4529530549483123,0.29007540303965673
20328,0.5411785714285714,0,1,0,448756,156854,43865,64091,1.4529437919152248,0.2900767159247777
20329,0.5411904761904761,0,1,0,448757,156853,43865,64091,1.4529345288821371,0.2900780288217829
20330,0.5411904761904762,1,3,1,448760,156850,43866,64090,1.4529067397828745,0.29007875441296277
20331,0.5412380952380953,0,1,0,448761,156849,43866,64090,1.4528974767497869,0.29008006734890623
20332,0.54125,2,4,2,448765,156845,43868,64088,1.4528604246174368,0.2900788926959757
20333,0.5412857142857141,0,2,0,448767,156843,43868,64088,1.4528418985512617,0.29008151866419835
20334,0.5413095238095238,0,4,0,448771,156839,43868,64088,1.4528048464189114,0.2900867707432772
20335,0.5413095238095239,1,2,1,448773,156837,43869,64087,1.4527863203527362,0.290086183483913
20336,0.5413333333333332,1,5,1,448778,156832,43870,64086,1.4527400051872985,0.29008953548375416
20337,0.5413333333333333,4,14,4,448792,156818,43874,64082,1.4526103227240728,0.29009506564056137
20338,0.5413333333333334,0,1,0,448793,156817,43874,64082,1.4526010596909853,0.29009637888808915
20339,0.5413888888888889,0,1,0,448794,156816,43874,64082,1.4525917966578976,0.29009769214750697
20340,0.5413928571428571,0,1,0,448795,156815,43874,64082,1.4525825336248102,0.2900990054188151
20341,0.5413989898989899,0,4,0,448799,156811,43874,64082,1.4525454814924599,0.2901042586229532
20342,0.5414047619047618,1,0,1,448799,156811,43875,64081,1.4525454814924599,0.29010104485449906
20343,0.5414047619047619,0,1,0,448800,156810,43875,64081,1.4525362184593724,0.29010235817665725
20344,0.5414166666666667,0,2,0,448802,156808,43875,64081,1.4525176923931973,0.29010498485664743
20345,0.5414285714285714,4,7,4,448809,156801,43879,64077,1.4524528511615844,0.2901013229022356
20346,0.5414285714285715,0,4,0,448813,156797,43879,64077,1.4524157990292341,0.2901065766002336
20347,0.5414999999999999,0,2,0,448815,156795,43879,64077,1.452397272963059,0.2901092035205911
20348,0.5415,3,18,3,448833,156777,43882,64074,1.452230538367483,0.29012320523792057
20349,0.5415000000000001,0,9,0,448842,156768,43882,64074,1.4521471710696952,0.29013502866302604
20350,0.5415238095238095,0,1,0,448843,156767,43882,64074,1.4521379080366075,0.2901363424364135
20351,0.5415476190476189,1,1,1,448844,156766,43883,64073,1.45212864500352,0.2901344418331907
20352,0.541547619047619,1,2,1,448846,156764,43884,64072,1.4521101189373449,0.29013385498741145
20353,0.5415595238095238,0,3,0,448849,156761,43884,64072,1.4520823298380823,0.29013779643440973
20354,0.5415833333333333,0,4,0,448853,156757,43884,64072,1.452045277705732,0.2901430518636592
20355,0.5415833333333334,0,1,0,448854,156756,43884,64072,1.4520360146726443,0.29014436575072
20356,0.5415952380952381,0,1,0,448855,156755,43884,64072,1.4520267516395569,0.2901456796496805
20357,0.5416666666666665,1,0,1,448855,156755,43885,64071,1.4520267516395569,0.2901424651082753
20358,0.5416666666666666,42,171,42,449026,156584,43927,64029,1.4504427729815852,0.29023221659648346
20359,0.5416666666666667,29,123,29,449149,156461,43956,64000,1.449303419911816,0.29030077882255817
20360,0.5416904761904762,0,1,0,449150,156460,43956,64000,1.4492941568787283,0.29030209561825276
20361,0.541702380952381,0,1,0,449151,156459,43956,64000,1.4492848938456409,0.29030341242589325
20362,0.5417142857142857,0,2,0,449153,156457,43956,64000,1.4492663677794657,0.29030604607701277
20363,0.5417857142857143,0,5,0,449158,156452,43956,64000,1.449220052614028,0.29031263041387695
20364,0.541797619047619,0,2,0,449160,156450,43956,64000,1.4492015265478528,0.29031526423225223
20365,0.5418095238095237,1,0,1,449160,156450,43957,63999,1.4492015265478528,0.2903120449627805
20366,0.5418095238095239,0,2,0,449162,156448,43957,63999,1.4491830004816777,0.29031467881168715
20367,0.5418181818181818,0,1,0,449163,156447,43957,63999,1.4491737374485902,0.2903159957540622
20368,0.5418333333333333,0,4,0,449167,156443,43957,63999,1.44913668531624,0.29032126364304445
20369,0.5418333333333334,1,6,1,449173,156437,43958,63998,1.4490811071177145,0.29032594642411597
20370,0.5418571428571428,0,2,0,449175,156435,43958,63998,1.4490625810515396,0.2903285805664306
20371,0.5418571428571429,0,2,0,449177,156433,43958,63998,1.4490440549853645,0.2903312147565451
20372,0.5418690476190475,0,1,0,449178,156432,43958,63998,1.4490347919522768,0.29033253186952773
20373,0.5419047619047618,0,2,0,449180,156430,43958,63998,1.4490162658861017,0.29033516613134447
20374,0.5419047619047619,0,2,0,449182,156428,43958,63998,1.4489977398199267,0.2903378004409643
20375,0.541904761904762,1,0,1,449182,156428,43959,63997,1.4489977398199267,0.2903345809232165
20376,0.5419166666666667,0,2,0,449184,156426,43959,63997,1.4489792137537516,0.29033721526337997
20377,0.5419444444444445,0,2,0,449186,156424,43959,63997,1.4489606876875765,0.290339849651349
20378,0.541952380952381,0,1,0,449187,156423,43959,63997,1.4489514246544888,0.29034116686326106
20379,0.541969696969697,0,1,0,449188,156422,43959,63997,1.4489421616214013,0.290342484087125
20380,0.5419761904761905,0,1,0,449189,156421,43959,63997,1.4489328985883139,0.29034380132294096
20381,0.5419999999999999,1,7,1,449196,156414,43960,63996,1.448868057356701,0.29034980264053356
20382,0.542,6,62,6,449258,156352,43966,63990,1.4482937493052725,0.29041217743326286
20383,0.5420000000000001,0,2,0,449260,156350,43966,63990,1.4482752232390974,0.2904148134700917
20384,0.5420238095238095,0,2,0,449262,156348,43966,63990,1.4482566971729223,0.29041744955477494
20385,0.5420476190476191,0,1,0,449263,156347,43966,63990,1.4482474341398348,0.29041876761506236
20386,0.5420595238095238,0,1,0,449264,156346,43966,63990,1.4482381711067471,0.2904200856873139
20387,0.5420833333333334,1,1,1,449265,156345,43967,63989,1.4482289080736597,0.2904181833035301
20388,0.5420952380952381,0,1,0,449266,156344,43967,63989,1.448219645040572,0.29041950139107625
20389,0.5421428571428571,2,4,2,449270,156340,43969,63987,1.448182592908222,0.29041833275086576
20390,0.5421450216450217,0,1,0,449271,156339,43969,63987,1.4481733298751343,0.2904196508809673
20391,0.5421666666666666,0,1,0,449272,156338,43969,63987,1.4481640668420468,0.29042096902303416
20392,0.5421666666666667,1,6,1,449278,156332,43970,63986,1.4481084886435214,0.29042565745876414
20393,0.5421666666666668,0,1,0,449279,156331,43970,63986,1.448099225610434,0.2904269756759578
20394,0.5421904761904761,0,1,0,449280,156330,43970,63986,1.4480899625773462,0.2904282939051181
20395,0.542218253968254,0,1,0,449281,156329,43970,63986,1.4480806995442588,0.29042961214624513
20396,0.5422222222222222,1,3,1,449284,156326,43971,63985,1.4480529104449962,0.29043034619242797
20397,0.5422499999999999,0,1,0,449285,156325,43971,63985,1.4480436474119085,0.29043166447278834
20398,0.5422619047619048,0,2,0,449287,156323,43971,63985,1.4480251213457334,0.2904343010694119
20399,0.5422727272727272,0,1,0,449288,156322,43971,63985,1.448015858312646,0.29043561938567547
20400,0.5422738095238095,0,1,0,449289,156321,43971,63985,1.4480065952795584,0.290436937713907
20401,0.5423095238095238,0,1,0,449290,156320,43971,63985,1.4479973322464708,0.2904382560541068
20402,0.5423333333333332,3,11,3,449301,156309,43974,63982,1.4478954388825076,0.29044309572338406
20403,0.5423333333333333,1,25,1,449326,156284,43975,63981,1.447663863055319,0.29047283953419745
20404,0.5423333333333334,0,1,0,449327,156283,43975,63981,1.4476546000222312,0.29047415828278794
20405,0.5423571428571429,0,1,0,449328,156282,43975,63981,1.4476453369891438,0.2904754770433527
20406,0.5423611111111111,0,1,0,449329,156281,43975,63981,1.447636073956056,0.290476795815892
20407,0.5423809523809523,2,1,2,449330,156280,43977,63979,1.4476268109229686,0.29047167198616175
20408,0.5423809523809524,1,6,1,449336,156274,43978,63978,1.4475712327244432,0.29047636343824346
20409,0.5424047619047617,0,1,0,449337,156273,43978,63978,1.4475619696913558,0.29047768228067067
20410,0.5424166666666667,0,2,0,449339,156271,43978,63978,1.4475434436251806,0.2904803200014529
20411,0.5424285714285714,1,0,1,449339,156271,43979,63977,1.4475434436251806,0.2904770985434601
20412,0.5425,57,295,57,449634,155976,44036,63920,1.444810848864352,0.290682868264998
20413,0.5425000000000001,0,6,0,449640,155970,44036,63920,1.4447552706658269,0.29069079994542724
20414,0.5425238095238095,2,1,2,449641,155969,44038,63918,1.4447460076327392,0.2906856703670522
20415,0.5425714285714285,0,1,0,449642,155968,44038,63918,1.4447367445996517,0.29068699235058165
20416,0.5425833333333333,0,1,0,449643,155967,44038,63918,1.444727481566564,0.29068831434613546
20417,0.5426190476190476,1,2,1,449645,155965,44039,63917,1.4447089555003891,0.2906877325110741
20418,0.5426190476190477,0,2,0,449647,155963,44039,63917,1.444690429434214,0.2906903765690377
20419,0.5426190476190478,0,2,0,449649,155961,44039,63917,1.4446719033680389,0.29069302067510167
20420,0.5426666666666666,9,27,9,449676,155934,44048,63908,1.4444218014746748,0.290699684318738
20421,0.5426666666666667,2,10,2,449686,155924,44050,63906,1.4443291711437993,0.29070645498794523
20422,0.5426785714285713,0,1,0,449687,155923,44050,63906,1.4443199081107119,0.2907077774088041
20423,0.5426904761904762,0,1,0,449688,155922,44050,63906,1.4443106450776242,0.2907090998416944
20424,0.5427142857142857,0,2,0,449690,155920,44050,63906,1.444292119011449,0.2907117447435699
20425,0.5427261904761904,0,1,0,449691,155919,44050,63906,1.4442828559783616,0.29071306721255546
20426,0.5427380952380952,1,0,1,449691,155919,44051,63905,1.4442828559783616,0.2907098405997525
20427,0.5427445887445888,0,1,0,449692,155918,44051,63905,1.444273592945274,0.29071116307210804
20428,0.54275,0,1,0,449693,155917,44051,63905,1.4442643299121865,0.2907124855564957
20429,0.5427619047619048,0,1,0,449694,155916,44051,63905,1.444255066879099,0.2907138080529158
20430,0.5427777777777778,1,4,1,449698,155912,44052,63904,1.4442180147467487,0.29071587145612693
20431,0.5428095238095237,0,1,0,449699,155911,44052,63904,1.444208751713661,0.2907171940040489
20432,0.5428333333333333,0,5,0,449704,155906,44052,63904,1.4441624365482233,0.2907238069241618
20433,0.5428333333333334,1,6,1,449710,155900,44053,63903,1.444106858349698,0.2907285159893177
20434,0.5428333333333335,0,1,0,449711,155899,44053,63903,1.4440975953166104,0.2907298386729875
20435,0.5428571428571428,1,11,1,449722,155888,44054,63902,1.4439957019526475,0.2907411620182902
20436,0.5428787878787878,1,0,1,449722,155888,44055,63901,1.4439957019526475,0.29073793501949596
20437,0.5429087301587301,0,2,0,449724,155886,44055,63901,1.4439771758864723,0.29074058065308683
20438,0.5429166666666667,0,1,0,449725,155885,44055,63901,1.4439679128533847,0.29074190348793827
20439,0.5429285714285714,0,2,0,449727,155883,44055,63901,1.4439493867872095,0.29074454919375387
20440,0.5429999999999999,10,47,10,449774,155836,44065,63891,1.4435140242320945,0.2907744610357398
20441,0.543,1,1,1,449775,155835,44066,63890,1.443504761199007,0.29077255660484697
20442,0.5430238095238095,0,1,0,449776,155834,44066,63890,1.4434954981659194,0.2907738799584934
20443,0.5430476190476191,0,1,0,449777,155833,44066,63890,1.443486235132832,0.29077520332418544
20444,0.5430833333333333,0,1,0,449778,155832,44066,63890,1.4434769720997442,0.29077652670192333
20445,0.5430952380952381,0,2,0,449780,155830,44066,63890,1.4434584460335693,0.2907791734935372
20446,0.5431111111111112,0,1,0,449781,155829,44066,63890,1.4434491830004816,0.29078049690741353
20447,0.5431190476190476,0,3,0,449784,155826,44066,63890,1.443421393901219,0.29078446722132206
20448,0.5431190476190477,0,1,0,449785,155825,44066,63890,1.4434121308681314,0.2907857906833853
20449,0.5431349206349206,1,0,1,449785,155825,44067,63889,1.4434121308681314,0.2907825627861675
20450,0.5431666666666666,0,2,0,449787,155823,44067,63889,1.4433936048019564,0.29078520972909994
20451,0.5431666666666667,0,4,0,449791,155819,44067,63889,1.4433565526696062,0.29079050375953536
20452,0.5431904761904761,0,1,0,449792,155818,44067,63889,1.4433472896365185,0.2907918272972641
20453,0.5431904761904762,0,1,0,449793,155817,44067,63889,1.443338026603431,0.29079315084704105
20454,0.5432142857142856,1,1,1,449794,155816,44068,63888,1.4433287635703436,0.29079124640425297
20455,0.5432380952380952,0,1,0,449795,155815,44068,63888,1.4433195005372559,0.2907925699694588
20456,0.5432435064935065,0,1,0,449796,155814,44068,63888,1.4433102375041684,0.29079389354671326
20457,0.54325,0,2,0,449798,155812,44068,63888,1.4432917114379933,0.29079654073736916
20458,0.5433095238095238,0,1,0,449799,155811,44068,63888,1.4432824484049056,0.2907978643507708
20459,0.5433109668109669,0,1,0,449800,155810,44068,63888,1.4432731853718181,0.2907991879762219
20460,0.5433333333333333,124,509,124,450309,155301,44192,63764,1.438558301530253,0.2910734256955698
20461,0.5433333333333334,1,4,1,450313,155297,44193,63763,1.438521249397903,0.2910755044280106
20462,0.5433412698412698,0,1,0,450314,155296,44193,63763,1.4385119863648153,0.2910768331819282
20463,0.5433809523809524,0,1,0,450315,155295,44193,63763,1.4385027233317278,0.29107816194797725
20464,0.5434242424242425,0,1,0,450316,155294,44193,63763,1.4384934602986401,0.291079490726158
20465,0.5434404761904762,1,2,1,450318,155292,44194,63762,1.438474934232465,0.29107891204908376
20466,0.5434523809523809,0,1,0,450319,155291,44194,63762,1.4384656711993775,0.29108024085495293
20467,0.543452380952381,0,1,0,450320,155290,44194,63762,1.43845640816629,0.29108156967295434
20468,0.5434999999999999,0,1,0,450321,155289,44194,63762,1.4384471451332024,0.2910828985030883
20469,0.5435,4,17,4,450338,155272,44198,63758,1.438289673570714,0.29109254440031046
20470,0.5435000000000001,0,2,0,450340,155270,44198,63758,1.4382711475045389,0.2910952024398707
20471,0.5435714285714286,0,3,0,450343,155267,44198,63758,1.4382433584052763,0.2910991895902294
20472,0.5435793650793651,0,1,0,450344,155266,44198,63758,1.4382340953721886,0.2911005186646212
20473,0.5435833333333333,0,2,0,450346,155264,44198,63758,1.4382155693060135,0.2911031768498142
20474,0.5435866910866913,0,1,0,450347,155263,44198,63758,1.438206306272926,0.29110450596061566
20475,0.543616883116883,0,4,0,450351,155259,44198,63758,1.4381692541405757,0.29110982252519213
20476,0.5436190476190476,1,3,1,450354,155256,44199,63757,1.4381414650413131,0.29111057334496127
20477,0.5436666666666666,6,25,6,450379,155231,44205,63751,1.4379098892141242,0.29112438465261986
20478,0.5436666666666667,2,1,2,450380,155230,44207,63749,1.4379006261810368,0.29111923974445036
20479,0.5436904761904762,0,1,0,450381,155229,44207,63749,1.437891363147949,0.29112056918959894
20480,0.5437142857142857,0,2,0,450383,155227,44207,63749,1.4378728370817742,0.29112322811632324
20481,0.54375,2,6,2,450389,155221,44209,63747,1.4378172588832487,0.2911247305542362
20482,0.5437500000000001,0,1,0,450390,155220,44209,63747,1.4378079958501613,0.29112606009124664
20483,0.5438095238095237,0,2,0,450392,155218,44209,63747,1.4377894697839861,0.2911287192016989
20484,0.5438095238095239,0,1,0,450393,155217,44209,63747,1.4377802067508985,0.2911300487751411
20485,0.5438333333333333,1,11,1,450404,155206,44210,63746,1.4376783133869355,0.29114143739267057
20486,0.5438333333333334,0,4,0,450408,155202,44210,63746,1.4376412612545852,0.29114675630743375
20487,0.5438888888888889,0,4,0,450412,155198,44210,63746,1.437604209122235,0.29115207541654486
20488,0.5439047619047619,0,1,0,450413,155197,44210,63746,1.4375949460891475,0.29115340522419075
20489,0.5439166666666666,0,1,0,450414,155196,44210,63746,1.4375856830560598,0.29115473504398426
20490,0.543952380952381,1,2,1,450416,155194,44211,63745,1.4375671569898847,0.29115415709398507
20491,0.5439761904761905,1,1,1,450417,155193,44212,63744,1.4375578939567972,0.2911522492771893
20492,0.5439999999999998,0,2,0,450419,155191,44212,63744,1.437539367890622,0.2911549089912531
20493,0.5439999999999999,0,1,0,450420,155190,44212,63744,1.4375301048575346,0.2911562388665077
20494,0.544,10,92,10,450512,155098,44222,63734,1.4366779058134795,0.29124625283322364
20495,0.544047619047619,0,6,0,450518,155092,44222,63734,1.4366223276149543,0.2912542385274145
20496,0.5440595238095238,0,1,0,450519,155091,44222,63734,1.4366130645818667,0.29125556951902204
20497,0.544079365079365,1,0,1,450519,155091,44223,63733,1.4366130645818667,0.29125233064014916
20498,0.5440833333333334,0,1,0,450520,155090,44223,63733,1.4366038015487792,0.2912536616352029
20499,0.5440952380952381,0,1,0,450521,155089,44223,63733,1.4365945385156915,0.2912549926424217
20500,0.5441111111111112,0,1,0,450522,155088,44223,63733,1.436585275482604,0.29125632366180576
20501,0.5441666666666666,0,3,0,450525,155085,44223,63733,1.4365574863833415,0.2912603167929512
20502,0.5441666666666667,18,83,18,450608,155002,44241,63715,1.4357886546370744,0.29131251800271585
20503,0.5441904761904762,0,1,0,450609,155001,44241,63715,1.4357793916039867,0.2913138499241025
20504,0.5442142857142858,0,2,0,450611,154999,44241,63715,1.4357608655378118,0.2913165138034145
20505,0.5442380952380953,0,1,0,450612,154998,44241,63715,1.4357516025047241,0.2913178457613402
20506,0.54425,1,0,1,450612,154998,44242,63714,1.4357516025047241,0.29131460550861404
20507,0.5442539682539682,1,0,1,450612,154998,44243,63713,1.4357516025047241,0.2913113652262575
20508,0.5442857142857143,2,7,2,450619,154991,44245,63711,1.4356867612731112,0.29131420837486627
20509,0.5443333333333333,7,35,7,450654,154956,44252,63704,1.4353625551150468,0.29133815055337053
20510,0.5443492063492062,0,1,0,450655,154955,44252,63704,1.4353532920819594,0.29133948293918843
20511,0.5443492063492064,0,1,0,450656,154954,44252,63704,1.4353440290488717,0.29134081533719325
20512,0.5443571428571429,0,2,0,450658,154952,44252,63704,1.4353255029826966,0.29134348016976436
20513,0.5443809523809524,0,1,0,450659,154951,44252,63704,1.435316239949609,0.29134481260433104
20514,0.544404761904762,1,1,1,450660,154950,44253,63703,1.4353069769165216,0.2913429040534546
20515,0.5444166666666667,0,2,0,450662,154948,44253,63703,1.4352884508503465,0.2913455689660692
20516,0.5444444444444444,1,3,1,450665,154945,44254,63702,1.4352606617510837,0.29134632535548166
20517,0.5444444444444445,0,2,0,450667,154943,44254,63702,1.4352421356849088,0.29134899037252165
20518,0.5444761904761904,0,1,0,450668,154942,44254,63702,1.435232872651821,0.29135032289932494
20519,0.5444880952380952,1,2,1,450670,154940,44255,63701,1.435214346585646,0.2913497468452852
20520,0.5445,4,7,4,450677,154933,44259,63697,1.435149505354033,0.29134610986598364
20521,0.5445238095238095,1,1,1,450678,154932,44260,63696,1.4351402423209456,0.29134420110873266
20522,0.5445238095238096,1,0,1,450678,154932,44261,63695,1.4351402423209456,0.29134095971677787
20523,0.544547619047619,0,2,0,450680,154930,44261,63695,1.4351217162547705,0.2913436249285306
20524,0.5445714285714286,0,1,0,450681,154929,44261,63695,1.435112453221683,0.2913449575526932
20525,0.5445833333333333,0,3,0,450684,154926,44261,63695,1.4350846641224202,0.2913489554983282
20526,0.5446190476190477,0,1,0,450685,154925,44261,63695,1.4350754010893327,0.2913502881712561
20527,0.5446309523809524,0,1,0,450686,154924,44261,63695,1.435066138056245,0.2913516208563757
20528,0.5446428571428572,1,4,1,450690,154920,44262,63694,1.435029085923895,0.2913537101923939
20529,0.5446666666666666,3,27,3,450717,154893,44265,63691,1.434778984030531,0.2913799729165904
20530,0.5446904761904762,0,1,0,450718,154892,44265,63691,1.4347697209974435,0.2913813059570049
20531,0.5447222222222221,1,0,1,450718,154892,44266,63690,1.4347697209974435,0.29137806406748956
20532,0.5447222222222222,0,1,0,450719,154891,44266,63690,1.4347604579643558,0.29137939711136834
20533,0.5447619047619048,2,3,2,450722,154888,44268,63688,1.4347326688650932,0.2913769123783032
20534,0.5447777777777778,0,1,0,450723,154887,44268,63688,1.4347234058320055,0.29137824545350566
20535,0.5448095238095239,1,1,1,450724,154886,44269,63687,1.434714142798918,0.29137633650999895
20536,0.5448333333333333,2,3,2,450727,154883,44271,63685,1.4346863536996555,0.29137385161597307
20537,0.5448333333333334,3,11,3,450738,154872,44274,63682,1.4345844603356923,0.2913787896812687
20538,0.54484126984127,0,1,0,450739,154871,44274,63682,1.4345751973026049,0.29138012289925097
20539,0.5448571428571428,0,1,0,450740,154870,44274,63682,1.4345659342695172,0.2913814561294337
20540,0.5448809523809522,0,2,0,450742,154868,44274,63682,1.434547408203342,0.2913841226264013
20541,0.5449047619047619,0,1,0,450743,154867,44274,63682,1.4345381451702546,0.29138545589318643
20542,0.5449166666666667,0,1,0,450744,154866,44274,63682,1.434528882137167,0.2913867891721727
20543,0.544926406926407,1,0,1,450744,154866,44275,63681,1.434528882137167,0.29138354678856265
20544,0.5449285714285714,0,1,0,450745,154865,44275,63681,1.4345196191040794,0.2913848800710148
20545,0.5449285714285715,0,1,0,450746,154864,44275,63681,1.434510356070992,0.2913862133656684
20546,0.5449433621933621,0,3,0,450749,154861,44275,63681,1.4344825669717292,0.29139021332283954
20547,0.5449999999999999,6,15,6,450764,154846,44281,63675,1.434343621475416,0.2913907587829087
20548,0.545,207,947,207,451711,153899,44488,63468,1.425571529141502,0.29198544397263615
20549,0.5450046620046621,0,4,0,451715,153895,44488,63468,1.4255344770091518,0.2919908172044
20550,0.5450119047619048,0,1,0,451716,153894,44488,63468,1.4255252139760644,0.29199216054324123
20551,0.5450714285714287,0,1,0,451717,153893,44488,63468,1.4255159509429767,0.2919935038944429
20552,0.5450833333333333,1,0,1,451717,153893,44489,63467,1.4255159509429767,0.29199024659550976
20553,0.5450833333333334,0,1,0,451718,153892,44489,63467,1.4255066879098892,0.2919915899502666
20554,0.5450909090909091,1,0,1,451718,153892,44490,63466,1.4255066879098892,0.29198833261255625
20555,0.5450952380952381,0,1,0,451719,153891,44490,63466,1.4254974248768018,0.2919896759708682
20556,0.5451078504828505,0,1,0,451720,153890,44490,63466,1.425488161843714,0.2919910193415411
20557,0.5451111111111111,0,1,0,451721,153889,44490,63466,1.4254788988106266,0.291992362724575
20558,0.5451190476190476,2,0,2,451721,153889,44492,63464,1.4254788988106266,0.2919858479064011
20559,0.5451230158730158,0,1,0,451722,153888,44492,63464,1.425469635777539,0.29198719128418416
20560,0.545142857142857,0,1,0,451723,153887,44492,63464,1.4254603727444515,0.2919885346743286
20561,0.5451666666666666,0,2,0,451725,153885,44492,63464,1.4254418466782763,0.2919912214917023
20562,0.5451666666666667,2,12,2,451737,153873,44494,63462,1.4253306902812257,0.29200082821450757
20563,0.5452121212121211,0,1,0,451738,153872,44494,63462,1.425321427248138,0.2920021717724792
20564,0.545214285714286,0,1,0,451739,153871,44494,63462,1.4253121642150506,0.29200351534281493
20565,0.5452380952380952,0,3,0,451742,153868,44494,63462,1.425284375115788,0.2920075461280081
20566,0.5452380952380953,0,1,0,451743,153867,44494,63462,1.4252751120827003,0.2920088897478017
20567,0.5452727272727272,0,1,0,451744,153866,44494,63462,1.4252658490496128,0.29201023337996024
20568,0.5452777777777778,1,0,1,451744,153866,44495,63461,1.4252658490496128,0.2920069756634012
20569,0.5452857142857143,0,2,0,451746,153864,44495,63461,1.4252473229834377,0.2920096629471989
20570,0.5452857142857144,1,0,1,451746,153864,44496,63460,1.4252473229834377,0.29200640518304466
20571,0.545297619047619,0,2,0,451748,153862,44496,63460,1.4252287969172626,0.29200909249868856
20572,0.5453095238095238,0,1,0,451749,153861,44496,63460,1.425219533884175,0.292010436175059
20573,0.5453333333333332,0,1,0,451750,153860,44496,63460,1.4252102708510874,0.29201177986379534
20574,0.5453333333333333,4,23,4,451773,153837,44500,63456,1.4249972210900737,0.29202965581035745
20575,0.5453452380952382,0,1,0,451774,153836,44500,63456,1.4249879580569862,0.2920309997606907
20576,0.5453571428571429,0,2,0,451776,153834,44500,63456,1.424969431990811,0.2920336876984675
20577,0.5453690476190477,0,1,0,451777,153833,44500,63456,1.4249601689577236,0.2920350316859114
20578,0.5454126984126983,0,1,0,451778,153832,44500,63456,1.424950905924636,0.2920363756857259
20579,0.5454166666666667,1,6,1,451784,153826,44501,63455,1.4248953277261107,0.29204118169559234
20580,0.5454761904761904,0,1,0,451785,153825,44501,63455,1.424886064693023,0.2920425257731959
20581,0.5454761904761906,0,1,0,451786,153824,44501,63455,1.4248768016599356,0.2920438698631713
20582,0.5454999999999999,0,1,0,451787,153823,44501,63455,1.424867538626848,0.2920452139655188
20583,0.5455,1,19,1,451806,153804,44502,63454,1.4246915409981844,0.29206749578841745
20584,0.5455000000000001,2,5,2,451811,153799,44504,63452,1.4246452258327467,0.29206770049389874
20585,0.5455238095238095,1,1,1,451812,153798,44505,63451,1.4246359627996592,0.29206578626368823
20586,0.5455530303030303,0,1,0,451813,153797,44505,63451,1.4246266997665715,0.29206713065252615
20587,0.5455555555555556,0,3,0,451816,153794,44505,63451,1.424598910667309,0.2920711638933002
20588,0.5455833333333333,0,4,0,451820,153790,44505,63451,1.4245618585349586,0.2920765417209459
20589,0.5455833333333334,0,1,0,451821,153789,44505,63451,1.4245525955018712,0.2920778862088013
20590,0.5455952380952381,1,0,1,451821,153789,44506,63450,1.4245525955018712,0.2920746274840153
20591,0.5456097236097237,0,1,0,451822,153788,44506,63450,1.4245433324687835,0.29207597197543705
20592,0.5456428571428571,0,1,0,451823,153787,44506,63450,1.424534069435696,0.29207731647923696
20593,0.5456666666666665,0,1,0,451824,153786,44506,63450,1.4245248064026084,0.29207866099541513
20594,0.5456666666666666,6,23,6,451847,153763,44512,63444,1.4243117566415948,0.2920900339307665
20595,0.5456666666666667,1,12,1,451859,153751,44513,63443,1.424200600244544,0.2921029126034789
20596,0.5457023809523808,0,2,0,451861,153749,44513,63443,1.424182074178369,0.29210560241629524
20597,0.5457142857142857,4,18,4,451879,153731,44517,63439,1.424015339582793,0.2921167748768246
20598,0.5457222222222222,0,2,0,451881,153729,44517,63439,1.4239968135166179,0.29211946511456566
20599,0.5457380952380952,0,2,0,451883,153727,44517,63439,1.4239782874504427,0.2921221554018585
20600,0.5457619047619048,0,1,0,451884,153726,44517,63439,1.4239690244173553,0.2921235005640872
20601,0.5457698412698413,0,2,0,451886,153724,44517,63439,1.4239504983511801,0.2921261909257102
20602,0.5457857142857143,0,1,0,451887,153723,44517,63439,1.4239412353180925,0.2921275361251048
20603,0.5458333333333333,10,35,10,451922,153688,44527,63429,1.423617029160028,0.2921420248069013
20604,0.5458333333333334,13,66,13,451988,153622,44540,63416,1.4230056689762496,0.2921884646928188
20605,0.5458484848484848,0,1,0,451989,153621,44540,63416,1.4229964059431621,0.2921898109538927
20606,0.5458571428571429,0,2,0,451991,153619,44540,63416,1.422977879876987,0.2921925035132582
20607,0.5459047619047619,1,0,1,451991,153619,44541,63415,1.422977879876987,0.29218924223854326
20608,0.5459166666666667,2,0,2,451991,153619,44543,63413,1.422977879876987,0.29218271959895314
20609,0.545952380952381,1,3,1,451994,153616,44544,63412,1.4229500907777242,0.2921834970602872
20610,0.5459761904761905,4,1,4,451995,153615,44548,63408,1.4229408277446367,0.2921717974592555
20611,0.5459999999999998,2,0,2,451995,153615,44550,63406,1.4229408277446367,0.2921652743282908
20612,0.5459999999999999,0,4,0,451999,153611,44550,63406,1.4229037756122864,0.29217065944142623
20613,0.546,25,103,25,452102,153508,44575,63381,1.4219496832042684,0.2922278216045996
20614,0.5460238095238096,1,1,1,452103,153507,44576,63380,1.421940420171181,0.29222590565594064
20615,0.546047619047619,0,1,0,452104,153506,44576,63380,1.4219311571380933,0.2922272530269358
20616,0.5460714285714285,1,1,1,452105,153505,44577,63379,1.4219218941050058,0.2922253370465318
20617,0.5460714285714287,1,0,1,452105,153505,44578,63378,1.4219218941050058,0.29222207365261454
20618,0.5460833333333334,0,1,0,452106,153504,44578,63378,1.4219126310719181,0.29222342103079096
20619,0.5461111111111111,2,0,2,452106,153504,44580,63376,1.4219126310719181,0.2922168941350055
20620,0.5461190476190476,0,1,0,452107,153503,44580,63376,1.4219033680388307,0.2922182415079376
20621,0.5461190476190477,1,1,1,452108,153502,44581,63375,1.421894105005743,0.2922163253825901
20622,0.5461428571428573,0,1,0,452109,153501,44581,63375,1.4218848419726555,0.29221767277153765
20623,0.5461507936507937,0,3,0,452112,153498,44581,63375,1.421857052873393,0.2922217150129338
20624,0.5461666666666666,0,4,0,452116,153494,44581,63375,1.4218200007410426,0.29222710484209363
20625,0.5461666666666667,1,7,1,452123,153487,44582,63374,1.4217551595094298,0.29223327384822534
20626,0.5461904761904761,0,1,0,452124,153486,44582,63374,1.4217458964763423,0.2922346214147376
20627,0.5461904761904762,1,4,1,452128,153482,44583,63373,1.421708844343992,0.29223674805745775
20628,0.5461984126984128,0,2,0,452130,153480,44583,63373,1.421690318277817,0.29223944330952306
20629,0.5462142857142857,0,1,0,452131,153479,44583,63373,1.4216810552447294,0.2922407909541992
20630,0.5462142857142858,2,0,2,452131,153479,44585,63371,1.4216810552447294,0.292234263315656
20631,0.5462222222222222,0,1,0,452132,153478,44585,63371,1.4216717922116417,0.29223561095508854
20632,0.5462222222222223,0,3,0,452135,153475,44585,63371,1.4216440031123792,0.2922396539479631
20633,0.54625,1,3,1,452138,153472,44586,63370,1.4216162140131166,0.29224043312642384
20634,0.5462777777777778,1,1,1,452139,153471,44587,63369,1.4216069509800289,0.29223851687880464
20635,0.5462857142857144,0,1,0,452140,153470,44587,63369,1.4215976879469414,0.2922398646000028
20636,0.5463095238095239,1,1,1,452141,153469,44588,63368,1.4215884249138537,0.29223794832062794
20637,0.5463333333333332,1,1,1,452142,153468,44589,63367,1.4215791618807663,0.2922360320059031
20638,0.5463333333333333,4,14,4,452156,153454,44593,63363,1.4214494794175405,0.29224184450481283
20639,0.5463333333333334,2,4,2,452160,153450,44595,63361,1.4214124272851902,0.29224070734418456
20640,0.5463690476190476,0,2,0,452162,153448,44595,63361,1.421393901219015,0.2922434031797573
20641,0.5463809523809524,0,3,0,452165,153445,44595,63361,1.4213661121197525,0.2922474470263738
20642,0.5463886113886114,2,5,2,452170,153440,44597,63359,1.4213197969543148,0.29224765796890206
20643,0.5464285714285714,3,0,3,452170,153440,44600,63356,1.4213197969543148,0.2922378641672356
20644,0.5464285714285715,1,2,1,452172,153438,44601,63355,1.4213012708881396,0.2922372954846328
20645,0.546452380952381,0,2,0,452174,153436,44601,63355,1.4212827448219645,0.2922399915125628
20646,0.5464682539682539,0,1,0,452175,153435,44601,63355,1.421273481788877,0.292241339545182
20647,0.5464999999999999,0,1,0,452176,153434,44601,63355,1.4212642187557893,0.2922426875902375
20648,0.5465,3,15,3,452191,153419,44604,63352,1.4211252732594761,0.2922531150384507
20649,0.5465000000000001,1,2,1,452193,153417,44605,63351,1.421106747193301,0.2922525465013286
20650,0.546547619047619,0,1,0,452194,153416,44605,63351,1.4210974841602135,0.2922538947348997
20651,0.5465555555555555,0,1,0,452195,153415,44605,63351,1.4210882211271259,0.29225524298091027
20652,0.5465555555555556,0,1,0,452196,153414,44605,63351,1.4210789580940384,0.2922565912393606
20653,0.5465952380952381,0,3,0,452199,153411,44605,63351,1.4210511689947756,0.29226063608935143
20654,0.5466320346320347,0,1,0,452200,153410,44605,63351,1.4210419059616881,0.2922619843975623
20655,0.5466666666666665,1,3,1,452203,153407,44606,63350,1.4210141168624255,0.29226276429365605
20656,0.5466666666666666,80,335,80,452538,153072,44686,63270,1.4179110007780948,0.2924536151094101
20657,0.5466666666666667,47,200,47,452738,152872,44733,63223,1.416058394160584,0.29257039727897455
20658,0.5466785714285715,1,0,1,452738,152872,44734,63222,1.416058394160584,0.29256712356659603
20659,0.54675,0,1,0,452739,152871,44734,63222,1.4160491311274963,0.29256847746109316
20660,0.5467857142857142,0,1,0,452740,152870,44734,63222,1.4160398680944088,0.292569831368121
20661,0.5467857142857143,1,0,1,452740,152870,44735,63221,1.4160398680944088,0.2925665576076745
20662,0.5468095238095237,3,2,3,452742,152868,44738,63218,1.4160213420282337,0.2925594439251039
20663,0.5468333333333333,0,4,0,452746,152864,44738,63218,1.4159842898958834,0.29256485963661943
20664,0.5468333333333334,1,11,1,452757,152853,44739,63217,1.4158823965319205,0.29257647984449486
20665,0.5468571428571428,0,4,0,452761,152849,44739,63217,1.4158453443995702,0.29258189627243525
20666,0.5468809523809525,0,2,0,452763,152847,44739,63217,1.415826818333395,0.2925846045616114
20667,0.5468888888888889,0,1,0,452764,152846,44739,63217,1.4158175553003076,0.2925859587250015
20668,0.5469047619047618,0,1,0,452765,152845,44739,63217,1.41580829226722,0.2925873129009266
20669,0.5469047619047619,0,2,0,452767,152843,44739,63217,1.4157897662010448,0.2925900212903823
20670,0.5469444444444445,1,0,1,452767,152843,44740,63216,1.4157897662010448,0.29258674713851307
20671,0.5469545454545455,0,1,0,452768,152842,44740,63216,1.4157805031679573,0.2925881013431579
20672,0.5469999999999999,2,4,2,452772,152838,44742,63214,1.415743451035607,0.2925869698035658
20673,0.547,5,28,5,452800,152810,44747,63209,1.4154840861091555,0.29260852054680375
20674,0.5470000000000002,1,2,1,452802,152808,44748,63208,1.4154655600429804,0.29260795496629877
20675,0.5470238095238095,0,1,0,452803,152807,44748,63208,1.415456297009893,0.29260930953868947
20676,0.5470833333333333,0,2,0,452805,152805,44748,63208,1.4154377709437178,0.2926120187210955
20677,0.5470833333333334,0,2,0,452807,152803,44748,63208,1.4154192448775427,0.29261472795366905
20678,0.5470952380952381,0,3,0,452810,152800,44748,63208,1.41539145577828,0.2926187918965964
20679,0.5470952380952382,0,1,0,452811,152799,44748,63208,1.4153821927451924,0.29262014656932417
20680,0.5471031746031747,1,0,1,452811,152799,44749,63207,1.4153821927451924,0.2926168717535624
20681,0.5471349206349206,0,2,0,452813,152797,44749,63207,1.4153636666790175,0.29261958111886816
20682,0.5471428571428572,1,9,1,452822,152788,44750,63206,1.4152802993812295,0.2926284989397854
20683,0.5471666666666666,0,7,0,452829,152781,44750,63206,1.4152154581496166,0.2926379828415599
20684,0.5471666666666667,2,4,2,452833,152777,44752,63204,1.4151784060172663,0.29263685231571296
20685,0.5471904761904763,0,2,0,452835,152775,44752,63204,1.4151598799510912,0.29263956217965637
20686,0.5472142857142857,0,1,0,452836,152774,44752,63204,1.4151506169180037,0.2926409171304485
20687,0.5472222222222222,0,1,0,452837,152773,44752,63204,1.415141353884916,0.2926422720937878
20688,0.5472499999999999,1,0,1,452837,152773,44753,63203,1.415141353884916,0.2926389969255843
20689,0.54725,0,1,0,452838,152772,44753,63203,1.4151320908518286,0.29264035189258014
20690,0.5472619047619047,0,1,0,452839,152771,44753,63203,1.4151228278187409,0.2926417068721235
20691,0.5473015873015874,1,0,1,452839,152771,44754,63202,1.4151228278187409,0.29263843165580883
20692,0.5473095238095239,1,1,1,452840,152770,44755,63201,1.4151135647856534,0.2926365113834728
20693,0.5473333333333332,2,5,2,452845,152765,44757,63199,1.4150672496202157,0.292636735752255
20694,0.5473333333333333,6,33,6,452878,152732,44763,63193,1.4147615695283264,0.29266180386708346
20695,0.5473809523809523,2,1,2,452879,152731,44765,63191,1.4147523064952388,0.29265660747862654
20696,0.5473809523809524,0,2,0,452881,152729,44765,63191,1.4147337804290636,0.2926593182660244
20697,0.5474126984126984,0,1,0,452882,152728,44765,63191,1.4147245173959762,0.29266067367855536
20698,0.547452380952381,0,1,0,452883,152727,44765,63191,1.4147152543628885,0.2926620291036412
20699,0.5474999999999999,1,8,1,452891,152719,44766,63190,1.4146411500981881,0.29266959691351446
20700,0.5475,44,258,44,453149,152461,44810,63146,1.4122512875615991,0.2928754632270752
20701,0.5475000000000001,1,11,1,453160,152450,44811,63145,1.412149394197636,0.292887126324822
20702,0.5475595238095239,0,3,0,453163,152447,44811,63145,1.4121216050983734,0.292891201899885
20703,0.5475833333333334,0,1,0,453164,152446,44811,63145,1.412112342065286,0.2928925604501115
20704,0.5475952380952381,0,1,0,453165,152445,44811,63145,1.4121030790321982,0.2928939190129412
20705,0.5475974025974026,0,1,0,453166,152444,44811,63145,1.4120938159991108,0.2928952775883742
20706,0.5476093073593072,1,0,1,453166,152444,44812,63144,1.4120938159991108,0.29289199769931534
20707,0.5476111111111112,0,1,0,453167,152443,44812,63144,1.412084552966023,0.2928933562784398
20708,0.5476190476190476,1,1,1,453168,152442,44813,63143,1.4120752899329356,0.29289143493285713
20709,0.5476190476190477,0,3,0,453171,152439,44813,63143,1.412047500833673,0.29289551075692777
20710,0.5476666666666666,4,31,4,453202,152408,44817,63139,1.4117603468079587,0.2929245129832473
20711,0.5476666666666667,1,7,1,453209,152401,44818,63138,1.4116955055763458,0.2929307457119129
20712,0.5476746031746031,0,1,0,453210,152400,44818,63138,1.4116862425432584,0.29293210477966763
20713,0.547701076701077,0,2,0,453212,152398,44818,63138,1.4116677164770832,0.29293482295301015
20714,0.547702380952381,0,4,0,453216,152394,44818,63138,1.411630664344733,0.2929402594510328
20715,0.5477142857142858,0,1,0,453217,152393,44818,63138,1.4116214013116455,0.29294161860706813
20716,0.5477777777777778,1,1,1,453218,152392,44819,63137,1.411612138278558,0.2929396972101202
20717,0.5478095238095237,1,0,1,453218,152392,44820,63136,1.411612138278558,0.29293641661408265
20718,0.5478333333333333,2,9,2,453227,152383,44822,63134,1.41152877098077,0.29294208809513866
20719,0.5478333333333334,2,6,2,453233,152377,44824,63132,1.4114731927822446,0.29294368216640604
20720,0.5478571428571428,1,3,1,453236,152374,44825,63131,1.411445403682982,0.2929444792464212
20721,0.5478571428571429,0,2,0,453238,152372,44825,63131,1.4114268776168069,0.29294719795084057
20722,0.5478809523809524,1,0,1,453238,152372,44826,63130,1.4114268776168069,0.2929439169938098
20723,0.5479166666666666,1,1,1,453239,152371,44827,63129,1.4114176145837194,0.2929419953596288
20724,0.5479285714285715,0,1,0,453240,152370,44827,63129,1.4114083515506317,0.29294335472554395
20725,0.5479404761904761,1,1,1,453241,152369,44828,63128,1.4113990885175443,0.29294143305939296
20726,0.5479642857142857,0,2,0,453243,152367,44828,63128,1.4113805624513691,0.29294415183646955
20727,0.5479761904761905,1,2,1,453245,152365,44829,63127,1.411362036385194,0.2929435895532085
20728,0.5479999999999999,6,75,6,453320,152290,44835,63121,1.4106673089036275,0.2930258900427555
20729,0.548,1,7,1,453327,152283,44836,63120,1.4106024676720146,0.29303213047172044
20730,0.548047619047619,1,0,1,453327,152283,44837,63119,1.4106024676720146,0.29302884838580884
20731,0.5480555555555555,0,1,0,453328,152282,44837,63119,1.410593204638927,0.293030208773404
20732,0.5480800865800866,0,2,0,453330,152280,44837,63119,1.4105746785727518,0.29303292958648836
20733,0.5480833333333334,0,1,0,453331,152279,44837,63119,1.4105654155396643,0.29303429001197784
20734,0.5480952380952381,0,2,0,453333,152277,44837,63119,1.4105468894734892,0.2930370109008524
20735,0.5480952380952382,0,1,0,453334,152276,44837,63119,1.4105376264404017,0.29303837136423777
20736,0.5481190476190476,0,1,0,453335,152275,44837,63119,1.410528363407314,0.29303973184025556
20737,0.548142857142857,0,3,0,453338,152272,44837,63119,1.4105005743080514,0.29304381334410445
20738,0.5481428571428572,0,1,0,453339,152271,44837,63119,1.410491311274964,0.2930451738706532
20739,0.5481666666666666,0,3,0,453342,152268,44837,63119,1.4104635221757011,0.2930492555260995
20740,0.5481666666666667,1,10,1,453352,152258,44838,63118,1.4103708918448257,0.29305957952603817
20741,0.5481666666666668,0,2,0,453354,152256,44838,63118,1.4103523657786505,0.2930623009276886
20742,0.5482142857142857,0,2,0,453356,152254,44838,63118,1.4103338397124754,0.29306502237988225
20743,0.5482261904761905,0,1,0,453357,152253,44838,63118,1.410324576679388,0.29306638312493327
20744,0.54825,0,1,0,453358,152252,44838,63118,1.4103153136463003,0.2930677438826206
20745,0.5482500000000001,1,1,1,453359,152251,44839,63117,1.4103060506132128,0.2930658222205713
20746,0.5482857142857143,1,0,1,453359,152251,44840,63116,1.4103060506132128,0.2930625397577159
20747,0.5483333333333333,59,335,59,453694,151916,44899,63057,1.4072029345288821,0.2933252082819703
20748,0.5483333333333335,2,5,2,453699,151911,44901,63055,1.4071566193634444,0.293325456118642
20749,0.5483809523809523,0,1,0,453700,151910,44901,63055,1.4071473563303567,0.2933268206452213
20750,0.5483888888888888,0,1,0,453701,151909,44901,63055,1.4071380932972692,0.293328185184496
20751,0.5484166666666667,1,0,1,453701,151909,44902,63054,1.4071380932972692,0.29332489777310516
20752,0.5484444444444445,0,1,0,453702,151908,44902,63054,1.4071288302641818,0.2933262623161303
20753,0.5484515272309392,0,4,0,453706,151904,44902,63054,1.4070917781318315,0.2933317206151899
20754,0.5484523809523809,1,4,1,453710,151900,44903,63053,1.4070547259994812,0.2933338915949068
20755,0.5484761904761905,0,2,0,453712,151898,44903,63053,1.407036199933306,0.29333662090429913
20756,0.5484761904761906,1,1,1,453713,151897,44904,63052,1.4070269369002186,0.2933346979981298
20757,0.5485,3,20,3,453733,151877,44907,63049,1.4068416762384675,0.2933521305007305
20758,0.5485000000000001,1,1,1,453734,151876,44908,63048,1.40683241320538,0.2933502075152147
20759,0.548519841269841,0,2,0,453736,151874,44908,63048,1.4068138871392049,0.29335293734471113
20760,0.5485476190476191,0,1,0,453737,151873,44908,63048,1.4068046241061174,0.2933543022785116
20761,0.5485714285714285,2,1,2,453738,151872,44910,63046,1.4067953610730297,0.2933490912813259
20762,0.5485714285714286,4,5,4,453743,151867,44914,63042,1.406749045907592,0.29334276368137213
20763,0.5486111111111112,1,3,1,453746,151864,44915,63041,1.4067212568083294,0.29334357041483444
20764,0.5486309523809524,0,1,0,453747,151863,44915,63041,1.4067119937752417,0.29334493541302165
20765,0.5486666666666666,3,19,3,453766,151844,44918,63038,1.4065359961465782,0.2933610074366396
20766,0.5486666666666667,1,8,1,453774,151836,44919,63037,1.4064618918818779,0.29336864101120197
20767,0.5486785714285715,0,1,0,453775,151835,44919,63037,1.4064526288487902,0.29337000632934956
20768,0.5486904761904762,0,1,0,453776,151834,44919,63037,1.4064433658157027,0.29337137166020544
20769,0.5487142857142858,1,0,1,453776,151834,44920,63036,1.4064433658157027,0.2933680830269465
20770,0.5487380952380954,0,1,0,453777,151833,44920,63036,1.406434102782615,0.2933694483615598
20771,0.54875,2,8,2,453785,151825,44922,63034,1.4063599985179147,0.2933737939765148
20772,0.5487662337662337,0,1,0,453786,151824,44922,63034,1.4063507354848273,0.2933751594076087
20773,0.548797619047619,0,1,0,453787,151823,44922,63034,1.4063414724517396,0.2933765248514128
20774,0.5488095238095237,1,1,1,453788,151822,44923,63033,1.4063322094186521,0.29337460147541367
20775,0.5488333333333333,2,10,2,453798,151812,44925,63031,1.4062395790877764,0.2933816787142239
20776,0.5488333333333334,1,4,1,453802,151808,44926,63030,1.4062025269554264,0.2933838520187304
20777,0.5488888888888889,0,2,0,453804,151806,44926,63030,1.4061840008892512,0.2933865832542032
20778,0.5489166666666666,0,1,0,453805,151805,44926,63030,1.4061747378561635,0.2933879488910094
20779,0.5489285714285714,0,1,0,453806,151804,44926,63030,1.406165474823076,0.29338931454052897
20780,0.5489285714285715,0,1,0,453807,151803,44926,63030,1.4061562117899886,0.29339068020276216
20781,0.5489519924519924,0,3,0,453810,151800,44926,63030,1.4061284226907258,0.29339477726574503
20782,0.548952380952381,0,1,0,453811,151799,44926,63030,1.4061191596576383,0.2933961429788343
20783,0.5489722222222222,0,1,0,453812,151798,44926,63030,1.4061098966245507,0.29339750870463815
20784,0.5489999999999999,12,63,12,453875,151735,44938,63018,1.4055263255400348,0.2934440962407976
20785,0.549,0,5,0,453880,151730,44938,63018,1.405480010374597,0.29345092853018423
20786,0.549047619047619,1,3,1,453883,151727,44939,63017,1.4054522212753344,0.293451737883247
20787,0.5490476190476191,0,2,0,453885,151725,44939,63017,1.4054336952091593,0.2934544709465312
20788,0.5490833333333334,0,3,0,453888,151722,44939,63017,1.4054059061098967,0.2934585706369127
20789,0.5490909090909091,0,1,0,453889,151721,44939,63017,1.405396643076809,0.2934599372258287
20790,0.5491428571428572,1,1,1,453890,151720,44940,63016,1.4053873800437215,0.2934580135608375
20791,0.5491666666666666,3,3,3,453893,151717,44943,63013,1.405359590944459,0.2934522423508592
20792,0.5491666666666667,28,86,28,453979,151631,44971,62985,1.4045629700989293,0.2934776531106721
20793,0.5491666666666668,0,1,0,453980,151630,44971,62985,1.4045537070658416,0.2934790205717214
20794,0.5492023809523809,0,2,0,453982,151628,44971,62985,1.4045351809996665,0.2934817555320507
20795,0.5492142857142857,0,1,0,453983,151627,44971,62985,1.404525917966579,0.29348312303133095
20796,0.5492261904761905,1,0,1,453983,151627,44972,62984,1.404525917966579,0.2934798309499513
20797,0.5492857142857143,3,7,3,453990,151620,44975,62981,1.4044610767349661,0.2934795271224272
20798,0.5492976190476191,0,1,0,453991,151619,44975,62981,1.4044518137018784,0.29348089468779126
20799,0.5493095238095238,0,1,0,453992,151618,44975,62981,1.404442550668791,0.2934822622659006
20800,0.5493333333333333,6,34,6,454026,151584,44981,62975,1.404127607543814,0.29350901150732434
20801,0.5493333333333335,0,1,0,454027,151583,44981,62975,1.4041183445107266,0.29351037947781017
20802,0.5493452380952382,0,1,0,454028,151582,44981,62975,1.4041090814776391,0.29351174746104763
20803,0.5493650793650794,0,1,0,454029,151581,44981,62975,1.4040998184445515,0.29351311545703684
20804,0.5493809523809524,0,1,0,454030,151580,44981,62975,1.404090555411464,0.293514483465778
20805,0.5493928571428571,0,1,0,454031,151579,44981,62975,1.4040812923783763,0.2935158514872713
20806,0.5494047619047618,0,1,0,454032,151578,44981,62975,1.4040720293452889,0.2935172195215168
20807,0.549404761904762,0,2,0,454034,151576,44981,62975,1.4040535032791137,0.29351995562826555
20808,0.5494761904761905,0,1,0,454035,151575,44981,62975,1.4040442402460263,0.29352132370076905
20809,0.5495,5,23,5,454058,151552,44986,62970,1.4038311904850125,0.2935363272764565
20810,0.5495238095238095,2,2,2,454060,151550,44988,62968,1.4038126644188373,0.29353247746109884
20811,0.5495476190476192,1,0,1,454060,151550,44989,62967,1.4038126644188373,0.2935291841672222
20812,0.5495634920634921,0,2,0,454062,151548,44989,62967,1.4037941383526622,0.29353192084469615
20813,0.5495833333333333,0,1,0,454063,151547,44989,62967,1.4037848753195747,0.29353328920256955
20814,0.5496082251082253,0,1,0,454064,151546,44989,62967,1.403775612286487,0.2935346575732007
20815,0.5496190476190477,0,1,0,454065,151545,44989,62967,1.4037663492533996,0.29353602595658984
20816,0.5496190476190478,0,1,0,454066,151544,44989,62967,1.403757086220312,0.2935373943527372
20817,0.5496428571428571,0,4,0,454070,151540,44989,62967,1.4037200340879619,0.29354286806491164
20818,0.5496666666666666,3,8,3,454078,151532,44992,62964,1.4036459298232613,0.2935439355512457
20819,0.549702380952381,0,1,0,454079,151531,44992,62964,1.4036366667901738,0.29354530408634233
20820,0.5497142857142857,0,1,0,454080,151530,44992,62964,1.4036274037570862,0.29354667263419953
20821,0.5497261904761905,0,1,0,454081,151529,44992,62964,1.4036181407239987,0.29354804119481753
20822,0.5497380952380951,0,1,0,454082,151528,44992,62964,1.403608877690911,0.2935494097681965
20823,0.5497483904983906,0,2,0,454084,151526,44992,62964,1.403590351624736,0.2935521469532379
20824,0.54975,0,2,0,454086,151524,44992,62964,1.403571825558561,0.2935548841893253
20825,0.5497619047619048,1,2,1,454088,151522,44993,62963,1.4035532994923858,0.29355432780847146
20826,0.5497857142857143,0,1,0,454089,151521,44993,62963,1.4035440364592981,0.29355569646220697
20827,0.5498333333333333,1,1,1,454090,151520,44994,62962,1.4035347734262107,0.29355377141205324
20828,0.5498333333333334,3,5,3,454095,151515,44997,62959,1.403488458260773,0.293550733422233
20829,0.5498333333333335,0,1,0,454096,151514,44997,62959,1.4034791952276853,0.2935521021294056
20830,0.5498419913419913,0,3,0,454099,151511,44997,62959,1.4034514061284227,0.293556208327505
20831,0.5498571428571428,0,1,0,454100,151510,44997,62959,1.4034421430953352,0.29355757708573266
20832,0.5498809523809524,1,1,1,454101,151509,44998,62958,1.4034328800622475,0.293555651918477
20833,0.5498809523809525,0,1,0,454102,151508,44998,62958,1.40342361702916,0.29355702069325673
20834,0.5499166666666667,0,3,0,454105,151505,44998,62958,1.4033958279298973,0.2935611270941841
20835,0.54992828005328,2,5,2,454110,151500,45000,62956,1.4033495127644595,0.29356138322080055
20836,0.5499285714285715,0,1,0,454111,151499,45000,62956,1.403340249731372,0.2935627520925136
20837,0.549940476190476,1,1,1,454112,151498,45001,62955,1.4033309866982844,0.2935608268478408
20838,0.5499444444444443,0,2,0,454114,151496,45001,62955,1.4033124606321095,0.2935635646371432
20839,0.5499761904761904,0,3,0,454117,151493,45001,62955,1.4032846715328466,0.293567671416847
20840,0.5499999999999999,5,26,5,454143,151467,45006,62950,1.4030438326725703,0.2935867958230924
20841,0.55,540,2451,540,456594,149016,45546,62410,1.380340138574975,0.2951860225327065
20842,0.5500357142857143,0,1,0,456595,149015,45546,62410,1.3803308755418875,0.2951874187063971
20843,0.550047619047619,0,1,0,456596,149014,45546,62410,1.3803216125087998,0.295188814893295
20844,0.5500714285714284,0,1,0,456597,149013,45546,62410,1.3803123494757124,0.29519021109340043
20845,0.5500714285714285,0,2,0,456599,149011,45546,62410,1.3802938234095372,0.29519300353323463
20846,0.5500833333333333,0,1,0,456600,149010,45546,62410,1.3802845603764498,0.29519439977296374
20847,0.5501071428571429,0,2,0,456602,149008,45546,62410,1.3802660343102746,0.29519719229204705
20848,0.5501190476190475,1,1,1,456603,149007,45547,62409,1.380256771277187,0.29519525485299125
20849,0.5501190476190476,1,3,1,456606,149004,45548,62408,1.3802289821779243,0.29519610996537565
20850,0.5501666666666666,0,3,0,456609,149001,45548,62408,1.3802011930786617,0.29520029894659167
20851,0.5501666666666667,4,10,4,456619,148991,45552,62404,1.380108562747786,0.2952009271742473
20852,0.5502142857142858,0,3,0,456622,148988,45552,62404,1.3800807736485234,0.2952051165607024
20853,0.5502200577200577,0,1,0,456623,148987,45552,62404,1.380071510615436,0.29520651304927836
20854,0.5502380952380952,2,3,2,456626,148984,45554,62402,1.3800437215161732,0.2952040343258305
20855,0.5502380952380953,1,0,1,456626,148984,45555,62401,1.3800437215161732,0.2952007001442865
20856,0.5502499999999999,0,2,0,456628,148982,45555,62401,1.3800251954499982,0.2952034931853555
20857,0.55025,0,1,0,456629,148981,45555,62401,1.3800159324169106,0.29520488972570985
20858,0.5502738095238096,0,1,0,456630,148980,45555,62401,1.380006669383823,0.2952062862792777
20859,0.5502857142857143,0,1,0,456631,148979,45555,62401,1.3799974063507354,0.29520768284605925
20860,0.5503095238095238,0,1,0,456632,148978,45555,62401,1.379988143317648,0.2952090794260546
20861,0.5503333333333332,0,3,0,456635,148975,45555,62401,1.3799603542183854,0.29521326924532587
20862,0.5503333333333333,6,22,6,456657,148953,45561,62395,1.379756567490459,0.2952239907640479
20863,0.5503571428571428,0,1,0,456658,148952,45561,62395,1.3797473044573716,0.295225387632661
20864,0.5503571428571429,1,2,1,456660,148950,45562,62394,1.3797287783911965,0.2952248466954349
20865,0.5503809523809523,0,1,0,456661,148949,45562,62394,1.3797195153581088,0.2952262435945359
20866,0.5503888888888889,0,1,0,456662,148948,45562,62394,1.3797102523250213,0.2952276405068562
20867,0.550404761904762,0,1,0,456663,148947,45562,62394,1.3797009892919339,0.295229037432396
20868,0.5504166666666667,1,2,1,456665,148945,45563,62393,1.3796824632257587,0.2952284965316223
20869,0.5504285714285715,1,0,1,456665,148945,45564,62392,1.3796824632257587,0.2952251617085508
20870,0.5504523809523809,0,1,0,456666,148944,45564,62392,1.379673200192671,0.2952265586554113
20871,0.5504761904761905,1,2,1,456668,148942,45565,62391,1.379654674126496,0.2952260177066525
20872,0.5504761904761906,0,1,0,456669,148941,45565,62391,1.3796454110934084,0.2952274146840043
20873,0.5505,7,19,7,456688,148922,45572,62384,1.379469413464745,0.29523061342318724
20874,0.5505238095238096,0,2,0,456690,148920,45572,62384,1.3794508873985698,0.2952334077916178
20875,0.5505555555555556,0,1,0,456691,148919,45572,62384,1.3794416243654823,0.29523480499566973
20876,0.5505833333333334,0,1,0,456692,148918,45572,62384,1.3794323613323947,0.2952362022129464
20877,0.5505952380952381,0,1,0,456693,148917,45572,62384,1.3794230982993072,0.29523759944344796
20878,0.5506428571428572,0,2,0,456695,148915,45572,62384,1.379404572233132,0.29524039394412654
20879,0.5506666666666665,1,0,1,456695,148915,45573,62383,1.379404572233132,0.29523705856184157
20880,0.5506666666666666,5,26,5,456721,148889,45578,62378,1.3791637333728557,0.2952567130692441
20881,0.5506666666666667,2,7,2,456728,148882,45580,62376,1.3790988921412428,0.2952598244800197
20882,0.5506818181818183,0,1,0,456729,148881,45580,62376,1.3790896291081551,0.2952612221133501
20883,0.5507142857142857,1,5,1,456734,148876,45581,62375,1.3790433139427174,0.29526487448580124
20884,0.5507619047619048,0,1,0,456735,148875,45581,62375,1.37903405090963,0.2952662721893491
20885,0.5508095238095239,0,1,0,456736,148874,45581,62375,1.3790247878765423,0.29526766990612974
20886,0.5508333333333333,6,52,6,456788,148822,45587,62369,1.3785431101559895,0.2953203498255134
20887,0.5508333333333334,7,72,7,456860,148750,45594,62362,1.3778761717736856,0.29539770358861644
20888,0.5508690476190475,0,4,0,456864,148746,45594,62362,1.3778391196413353,0.2954033006802205
20889,0.5508690476190476,0,3,0,456867,148743,45594,62362,1.3778113305420727,0.2954074986381185
20890,0.5509523809523809,0,1,0,456868,148742,45594,62362,1.377802067508985,0.2954088979839321
20891,0.550952380952381,0,5,0,456873,148737,45594,62362,1.3777557523435473,0.295415894911866
20892,0.5509642857142858,0,2,0,456875,148735,45594,62362,1.3777372262773722,0.2954186937758471
20893,0.5509761904761905,0,1,0,456876,148734,45594,62362,1.3777279632442847,0.2954200932277258
20894,0.551,7,66,7,456942,148668,45601,62355,1.3771166030605062,0.29548911730000993
20895,0.5510714285714287,0,1,0,456943,148667,45601,62355,1.3771073400274185,0.29549051757636646
20896,0.5510952380952381,0,1,0,456944,148666,45601,62355,1.377098076994331,0.2954919178659944
20897,0.5511190476190477,0,1,0,456945,148665,45601,62355,1.3770888139612434,0.29549331816889396
20898,0.5511428571428572,0,1,0,456946,148664,45601,62355,1.377079550928156,0.2954947184850653
20899,0.5511666666666666,0,1,0,456947,148663,45601,62355,1.3770702878950685,0.2954961188145087
20900,0.5511666666666667,3,2,3,456949,148661,45604,62352,1.3770517618288933,0.2954889035272708
20901,0.5511886446886447,2,3,2,456952,148658,45606,62350,1.3770239727296305,0.2954864270548984
20902,0.5512142857142858,0,2,0,456954,148656,45606,62350,1.3770054466634556,0.2954892277944703
20903,0.5512380952380953,1,0,1,456954,148656,45607,62349,1.3770054466634556,0.29548588895997724
20904,0.5512420634920635,0,2,0,456956,148654,45607,62349,1.3769869205972805,0.29548868973426917
20905,0.5512499999999999,0,1,0,456957,148653,45607,62349,1.3769776575641928,0.29549009014132566
20906,0.55125,2,6,2,456963,148647,45609,62347,1.3769220793656676,0.29549181493312604
20907,0.5512698412698412,0,1,0,456964,148646,45609,62347,1.37691281633258,0.2954932154147294
20908,0.5512857142857144,0,1,0,456965,148645,45609,62347,1.3769035532994924,0.29549461590960796
20909,0.5513095238095238,0,5,0,456970,148640,45609,62347,1.3768572381340547,0.29550161858313545
20910,0.5513311688311688,0,1,0,456971,148639,45609,62347,1.376847975100967,0.29550301915766924
20911,0.5513333333333332,1,1,1,456972,148638,45610,62346,1.3768387120678796,0.29550108065066544
20912,0.5513333333333333,3,14,3,456986,148624,45613,62343,1.3767090296046538,0.2955106722852389
20913,0.5513333333333335,1,4,1,456990,148620,45614,62342,1.3766719774723035,0.2955129359789915
20914,0.5513809523809523,0,1,0,456991,148619,45614,62342,1.376662714439216,0.29551433677314765
20915,0.5514285714285714,0,1,0,456992,148618,45614,62342,1.3766534514061284,0.29551573758058397
20916,0.5514285714285715,0,4,0,456996,148614,45614,62342,1.376616399273778,0.29552134094313504
20917,0.5514404761904762,0,1,0,456997,148613,45614,62342,1.3766071362406906,0.2955227418169752
20918,0.551452380952381,1,2,1,456999,148611,45615,62341,1.3765886101745155,0.2955222041033031
20919,0.5514999999999999,0,1,0,457000,148610,45615,62341,1.376579347141428,0.295523605007798
20920,0.5515,3,17,3,457017,148593,45618,62338,1.3764218755789395,0.29553740322664757
20921,0.5515000000000001,0,3,0,457020,148590,45618,62338,1.3763940864796769,0.2955416066145794
20922,0.5515238095238095,0,1,0,457021,148589,45618,62338,1.3763848234465894,0.2955430077704609
20923,0.5515476190476191,0,1,0,457022,148588,45618,62338,1.3763755604135017,0.29554440893962813
20924,0.5515555555555555,1,0,1,457022,148588,45619,62337,1.3763755604135017,0.29554106910039113
20925,0.5516190476190477,0,1,0,457023,148587,45619,62337,1.3763662973804143,0.29554247027365305
20926,0.5516309523809524,0,1,0,457024,148586,45619,62337,1.3763570343473266,0.2955438714602011
20927,0.5516666666666665,1,3,1,457027,148583,45620,62336,1.376329245248064,0.29554473518270047
20928,0.5516666666666666,50,184,50,457211,148399,45670,62286,1.374624847159954,0.29563566461779434
20929,0.5516666666666667,18,122,18,457333,148277,45688,62268,1.3734947571232725,0.2957467524757178
20930,0.5517142857142856,1,0,1,457333,148277,45689,62267,1.3734947571232725,0.2957434075537655
20931,0.5517142857142857,1,1,1,457334,148276,45690,62266,1.3734854940901848,0.29574146726068906
20932,0.5517142857142858,0,3,0,457337,148273,45690,62266,1.3734577049909222,0.2957456813227003
20933,0.551738455988456,0,1,0,457338,148272,45690,62266,1.3734484419578348,0.29574708603672495
20934,0.5517460317460317,0,1,0,457339,148271,45690,62266,1.373439178924747,0.2957484907640937
20935,0.55175,0,1,0,457340,148270,45690,62266,1.3734299158916596,0.2957498955048068
20936,0.5517619047619048,0,2,0,457342,148268,45690,62266,1.3734113898254845,0.29575270502626655
20937,0.5517619047619049,0,1,0,457343,148267,45690,62266,1.3734021267923968,0.2957541098070136
20938,0.5517777777777777,0,1,0,457344,148266,45690,62266,1.3733928637593094,0.2957555146011058
20939,0.5517857142857143,0,4,0,457348,148262,45690,62266,1.373355811626959,0.29576113391092873
20940,0.5518095238095239,0,5,0,457353,148257,45690,62266,1.3733094964615213,0.295768158348494
20941,0.5518333333333333,1,3,1,457356,148254,45691,62265,1.3732817073622587,0.29576902797372207
20942,0.5518333333333334,1,17,1,457373,148237,45692,62264,1.3731242357997704,0.29578956869563566
20943,0.5518412698412699,0,1,0,457374,148236,45692,62264,1.3731149727666827,0.295790973871734
20944,0.5518571428571428,0,2,0,457376,148234,45692,62264,1.3730964467005076,0.2957937842639835
20945,0.5518571428571429,0,1,0,457377,148233,45692,62264,1.37308718366742,0.2957951894801351
20946,0.551904761904762,0,1,0,457378,148232,45692,62264,1.3730779206343324,0.2957965947096382
20947,0.5519166666666666,1,1,1,457379,148231,45693,62263,1.373068657601245,0.29579465447946257
20948,0.5519285714285714,0,1,0,457380,148230,45693,62263,1.3730593945681573,0.29579605972645173
20949,0.5519423076923077,1,0,1,457380,148230,45694,62262,1.3730593945681573,0.2957927142124166
20950,0.5519444444444445,0,1,0,457381,148229,45694,62262,1.3730501315350698,0.29579411946354
20951,0.5519581252081251,0,1,0,457382,148228,45694,62262,1.3730408685019824,0.29579552472801557
20952,0.5519999999999999,1,4,1,457386,148224,45695,62261,1.373003816369632,0.2957978003183125
20953,0.552,8,53,8,457439,148171,45703,62253,1.3725128756159917,0.295845530928031
20954,0.5520129870129871,0,1,0,457440,148170,45703,62253,1.3725036125829042,0.29584693688427594
20955,0.5520238095238095,1,1,1,457441,148169,45704,62252,1.3724943495498165,0.29584499645947887
20956,0.552047619047619,0,1,0,457442,148168,45704,62252,1.372485086516729,0.2958464024332288
20957,0.5520555555555555,0,1,0,457443,148167,45704,62252,1.3724758234836414,0.29584780842034225
20958,0.5520833333333333,1,1,1,457444,148166,45705,62251,1.372466560450554,0.29584586796694184
20959,0.5520833333333334,2,3,2,457447,148163,45707,62249,1.3724387713512913,0.29584339296237855
20960,0.552095238095238,0,1,0,457448,148162,45707,62249,1.3724295083182037,0.295844798988646
20961,0.5521190476190476,0,1,0,457449,148161,45707,62249,1.3724202452851162,0.29584620502827813
20962,0.5521428571428572,1,3,1,457452,148158,45708,62248,1.3723924561858536,0.29584707660427934
20963,0.5521666666666666,1,5,1,457457,148153,45709,62247,1.3723461410204156,0.2958507604562738
20964,0.5521666666666667,4,7,4,457464,148146,45713,62243,1.3722812997888028,0.29584721634686223
20965,0.5521666666666668,0,1,0,457465,148145,45713,62243,1.3722720367557153,0.2958486225450121
20966,0.5521904761904762,0,2,0,457467,148143,45713,62243,1.3722535106895402,0.29585143498141514
20967,0.5522142857142857,0,1,0,457468,148142,45713,62243,1.3722442476564527,0.2958528412196687
20968,0.5522619047619047,0,1,0,457469,148141,45713,62243,1.372234984623365,0.2958542474712906
20969,0.5522619047619048,1,0,1,457469,148141,45714,62242,1.372234984623365,0.2958509005005157
20970,0.552309523809524,0,2,0,457471,148139,45714,62242,1.3722164585571899,0.2958537130254158
20971,0.5523333333333332,3,3,3,457474,148136,45717,62239,1.3721886694579273,0.2958478906714201
20972,0.5523333333333333,2,22,2,457496,148114,45719,62237,1.3719848827300012,0.2958721375225219
20973,0.5523333333333335,0,4,0,457500,148110,45719,62237,1.371947830597651,0.2958777638853894
20974,0.5523809523809523,0,1,0,457501,148109,45719,62237,1.3719385675645634,0.29587917050954143
20975,0.5523809523809524,3,5,3,457506,148104,45722,62234,1.3718922523991255,0.29587616122621685
20976,0.5524999999999999,2,5,2,457511,148099,45724,62232,1.3718459372336878,0.29587649942233907
20977,0.5525,49,254,49,457765,147845,45773,62183,1.369493126829449,0.29607004780315005
20978,0.5525000000000001,1,8,1,457773,147837,45774,62182,1.3694190225647487,0.29607797389759977
20979,0.5525476190476191,1,1,1,457774,147836,45775,62181,1.369409759531661,0.2960760319402715
20980,0.5525714285714285,0,1,0,457775,147835,45775,62181,1.3694004964985735,0.2960774417187262
20981,0.5525833333333334,0,1,0,457776,147834,45775,62181,1.3693912334654859,0.29607885151060637
20982,0.5526190476190476,1,2,1,457778,147832,45776,62180,1.369372707399311,0.2960783193341333
20983,0.5526190476190477,1,2,1,457780,147830,45777,62179,1.3693541813331358,0.2960777871424558
20984,0.5526666666666666,6,32,6,457812,147798,45783,62173,1.369057764274334,0.2961027951479014
20985,0.5526666666666668,2,5,2,457817,147793,45785,62171,1.3690114491088963,0.29610314149092226
20986,0.5526904761904762,0,2,0,457819,147791,45785,62171,1.3689929230427211,0.2961059620312247
20987,0.55275,0,1,0,457820,147790,45785,62171,1.3689836600096335,0.2961073723215264
20988,0.5527619047619047,1,0,1,457820,147790,45786,62170,1.3689836600096335,0.29610401981329776
20989,0.5527777777777778,0,1,0,457821,147789,45786,62170,1.368974396976546,0.29610543010778295
20990,0.5528333333333333,2,6,2,457827,147783,45788,62168,1.3689188187780206,0.29610718691504206
20991,0.5528333333333334,1,3,1,457830,147780,45789,62167,1.368891029678758,0.2961080653688788
20992,0.5528333333333335,0,1,0,457831,147779,45789,62167,1.3688817666456705,0.2961094757699599
20993,0.5528571428571428,3,14,3,457845,147765,45792,62164,1.3687520841824448,0.296119164098338
20994,0.5529047619047619,0,1,0,457846,147764,45792,62164,1.368742821149357,0.2961205746732213
20995,0.5529166666666666,0,3,0,457849,147761,45792,62164,1.3687150320500945,0.29612480647850425
20996,0.5529166666666667,0,5,0,457854,147756,45792,62164,1.3686687168846567,0.29613185975609757
20997,0.5529444444444445,0,1,0,457855,147755,45792,62164,1.368659453851569,0.2961332704519362
20998,0.5529523809523809,1,0,1,457855,147755,45793,62163,1.368659453851569,0.29612991739631667
20999,0.552984126984127,0,2,0,457857,147753,45793,62163,1.3686409277853941,0.2961327388098096
21000,0.5529999999999999,8,32,8,457889,147721,45801,62155,1.3683445107265924,0.29615106062627455
21001,0.553,0,6,0,457895,147715,45801,62155,1.368288932528067,0.2961595273264402
21002,0.5530000000000002,0,1,0,457896,147714,45801,62155,1.3682796694949795,0.29616093849020103
21003,0.5530119047619048,1,1,1,457897,147713,45802,62154,1.3682704064618918,0.2961589959355211
21004,0.553047619047619,0,2,0,457899,147711,45802,62154,1.3682518803957169,0.29616181831177185
21005,0.5530952380952382,1,1,1,457900,147710,45803,62153,1.3682426173626292,0.2961598757284514
21006,0.5531496836496835,1,1,1,457901,147709,45804,62152,1.3682333543295417,0.2961579331081049
21007,0.5531666666666666,1,15,1,457916,147694,45805,62151,1.3680944088332283,0.296175748766947
21008,0.5531666666666667,0,6,0,457922,147688,45805,62151,1.368038830634703,0.29618421742383444
21009,0.5531666666666668,0,1,0,457923,147687,45805,62151,1.3680295676016154,0.29618562891373346
21010,0.5532103174603176,0,4,0,457927,147683,45805,62151,1.3679925154692651,0.29619127500786335
21011,0.5532142857142857,1,4,1,457931,147679,45806,62150,1.367955463336915,0.2961935671427686
21012,0.5532222222222223,0,1,0,457932,147678,45806,62150,1.3679462003038274,0.2961949787444955
21013,0.5532619047619048,0,2,0,457934,147676,45806,62150,1.3679276742376523,0.29619780198831414
21014,0.5532857142857143,0,1,0,457935,147675,45806,62150,1.3679184112045648,0.2961992136304063
21015,0.5532857142857144,1,1,1,457936,147674,45807,62149,1.3679091481714774,0.2961972710332042
21016,0.5533333333333332,39,228,39,458164,147446,45846,62110,1.365797176627515,0.29638855484930043
21017,0.5533333333333333,64,307,64,458471,147139,45910,62046,1.3629534254696358,0.2966082654109998
21018,0.5533333333333335,0,11,0,458482,147128,45910,62046,1.3628515321056727,0.29662386338646296
21019,0.5533571428571428,0,3,0,458485,147125,45910,62046,1.36282374300641,0.2966281176644946
21020,0.553404761904762,0,3,0,458488,147122,45910,62046,1.3627959539071473,0.29663237206456056
21021,0.5534285714285714,0,2,0,458490,147120,45910,62046,1.3627774278409723,0.2966352083990706
21022,0.553452380952381,0,1,0,458491,147119,45910,62046,1.3627681648078847,0.296636626586666
21023,0.5534523809523811,0,1,0,458492,147118,45910,62046,1.3627589017747972,0.296638044787822
21024,0.5534722222222223,1,0,1,458492,147118,45911,62045,1.3627589017747972,0.296634682042235
21025,0.5535,2,23,2,458515,147095,45913,62043,1.3625458520137834,0.29666057818282665
21026,0.5535000000000001,1,1,1,458516,147094,45914,62042,1.3625365889806957,0.2966586336164027
21027,0.553515873015873,1,1,1,458517,147093,45915,62041,1.3625273259476083,0.2966566890127861
21028,0.5535238095238094,0,1,0,458518,147092,45915,62041,1.3625180629145208,0.29665810752009486
21029,0.5535238095238095,0,4,0,458522,147088,45915,62041,1.3624810107821705,0.2966637816849887
21030,0.5535331890331892,0,1,0,458523,147087,45915,62041,1.3624717477490829,0.29666520026012777
21031,0.5535714285714285,0,1,0,458524,147086,45915,62041,1.3624624847159954,0.2966666188488335
21032,0.5535714285714286,0,3,0,458527,147083,45915,62041,1.3624346956167328,0.2966708746963524
21033,0.5535833333333333,0,1,0,458528,147082,45915,62041,1.3624254325836451,0.2966722933393266
21034,0.5536071428571429,0,1,0,458529,147081,45915,62041,1.3624161695505577,0.29667371199586845
21035,0.5536190476190476,0,1,0,458530,147080,45915,62041,1.36240690651747,0.29667513066597806
21036,0.5536666666666666,3,23,3,458553,147057,45918,62038,1.3621938567564564,0.29669767330639185
21037,0.5536666666666668,0,7,0,458560,147050,45918,62038,1.3621290155248436,0.2967076063666973
21038,0.5536904761904762,0,1,0,458561,147049,45918,62038,1.3621197524917559,0.29670902542960587
21039,0.5537142857142857,0,1,0,458562,147048,45918,62038,1.3621104894586684,0.2967104445060884
21040,0.5537222222222222,0,1,0,458563,147047,45918,62038,1.3621012264255807,0.2967118635961451
21041,0.55375,0,5,0,458568,147042,45918,62038,1.362054911260143,0.2967189592500478
21042,0.5537857142857142,1,1,1,458569,147041,45919,62037,1.3620456482270555,0.2967170147026469
21043,0.5538015873015874,0,3,0,458572,147038,45919,62037,1.3620178591277927,0.29672127227071626
21044,0.5538095238095238,0,4,0,458576,147034,45919,62037,1.3619808069954427,0.2967269492182082
21045,0.5538095238095239,0,2,0,458578,147032,45919,62037,1.3619622809292675,0.2967297877734145
21046,0.5538333333333333,2,3,2,458581,147029,45921,62035,1.361934491830005,0.29672731795048407
21047,0.5538333333333334,0,3,0,458584,147026,45921,62035,1.361906702730742,0.29673157595151656
21048,0.5538571428571428,2,2,2,458586,147024,45923,62033,1.361888176664567,0.296727686707453
21049,0.5538888888888889,0,2,0,458588,147022,45923,62033,1.361869650598392,0.2967305254598072
21050,0.5539166666666668,0,2,0,458590,147020,45923,62033,1.361851124532217,0.2967333642664779
21051,0.5539999999999999,9,76,9,458666,146944,45932,62024,1.3611471340175627,0.29681099498487806
21052,0.554,6,4,6,458670,146940,45938,62018,1.3611100818852124,0.2967964854181223
21053,0.5540396825396826,0,1,0,458671,146939,45938,62018,1.361100818852125,0.2967979057892294
21054,0.554047619047619,0,3,0,458674,146936,45938,62018,1.3610730297528624,0.29680216698412093
21055,0.5540476190476191,0,1,0,458675,146935,45938,62018,1.3610637667197747,0.2968035874096089
21056,0.5540714285714287,0,1,0,458676,146934,45938,62018,1.3610545036866872,0.2968050078486925
21057,0.5540833333333333,0,2,0,458678,146932,45938,62018,1.361035977620512,0.29680784876764776
21058,0.554111111111111,1,0,1,458678,146932,45939,62017,1.361035977620512,0.2968044833906838
21059,0.554126984126984,0,2,0,458680,146930,45939,62017,1.361017451554337,0.2968073243454082
21060,0.5541666666666666,0,1,0,458681,146929,45939,62017,1.3610081885212495,0.2968087448431652
21061,0.5541666666666667,25,101,25,458782,146828,45964,61992,1.3600726221794064,0.2968681160808352
21062,0.554186507936508,0,1,0,458783,146827,45964,61992,1.360063359146319,0.29686953773363534
21063,0.5541868686868687,1,1,1,458784,146826,45965,61991,1.3600540961132312,0.2968675921979532
21064,0.5541904761904762,0,1,0,458785,146825,45965,61991,1.3600448330801438,0.29686901386866904
21065,0.5542016594516594,1,0,1,458785,146825,45966,61990,1.3600448330801438,0.296865646625003
21066,0.5542857142857143,0,8,0,458793,146817,45966,61990,1.3599707288154432,0.296877020406404
21067,0.5542976190476191,1,0,1,458793,146817,45967,61989,1.3599707288154432,0.29687365305594665
21068,0.5543253968253968,0,1,0,458794,146816,45967,61989,1.3599614657823558,0.29687507483058356
21069,0.5543333333333333,3,31,3,458825,146785,45970,61986,1.3596743117566417,0.2969090534604902
21070,0.5543333333333335,0,1,0,458826,146784,45970,61986,1.359665048723554,0.2969104756430522
21071,0.5543401875901874,1,2,1,458828,146782,45971,61985,1.3596465226573788,0.2969099522434101
21072,0.5543412698412699,0,1,0,458829,146781,45971,61985,1.3596372596242914,0.29691137445752663
21073,0.5544047619047618,0,2,0,458831,146779,45971,61985,1.3596187335581162,0.2969142189266349
21074,0.5544444444444444,1,2,1,458833,146777,45972,61984,1.359600207491941,0.29691369556574265
21075,0.5544642857142857,0,1,0,458834,146776,45972,61984,1.3595909444588536,0.2969151178386664
21076,0.5544761904761906,1,0,1,458834,146776,45973,61983,1.3595909444588536,0.2969117499125786
21077,0.5545,2,16,2,458850,146760,45975,61981,1.3594427359294528,0.2969277717362665
21078,0.5545231157731156,0,1,0,458851,146759,45975,61981,1.3594334728963653,0.29692919421289643
21079,0.5545238095238095,0,3,0,458854,146756,45975,61981,1.3594056837971025,0.2969334617245625
21080,0.5545476190476191,0,1,0,458855,146755,45975,61981,1.359396420764015,0.2969348842557106
21081,0.5545714285714286,0,2,0,458857,146753,45975,61981,1.3593778946978399,0.29693772935889695
21082,0.5545833333333333,0,3,0,458860,146750,45975,61981,1.3593501055985773,0.2969419971159052
21083,0.554595238095238,0,2,0,458862,146748,45975,61981,1.3593315795324021,0.29694484235539864
21084,0.5546428571428571,0,1,0,458863,146747,45975,61981,1.3593223164993145,0.29694626499559235
21085,0.5546666666666666,3,18,3,458881,146729,45978,61978,1.3591555819037386,0.29696176937045715
21086,0.5546666666666668,0,1,0,458882,146728,45978,61978,1.359146318870651,0.296963192241718
21087,0.554702380952381,0,1,0,458883,146727,45978,61978,1.3591370558375635,0.2969646151266141
21088,0.5547142857142857,0,1,0,458884,146726,45978,61978,1.3591277928044758,0.29696603802514565
21089,0.5547222222222221,0,1,0,458885,146725,45978,61978,1.3591185297713884,0.29696746093731285
21090,0.5547222222222222,0,1,0,458886,146724,45978,61978,1.3591092667383007,0.2969688838631158
21091,0.55475,0,3,0,458889,146721,45978,61978,1.359081477639038,0.29697315272234176
21092,0.5547619047619048,1,1,1,458890,146720,45979,61977,1.3590722146059506,0.2969712070609544
21093,0.5547777777777777,0,1,0,458891,146719,45979,61977,1.359062951572863,0.2969726300456166
21094,0.5547857142857143,0,2,0,458893,146717,45979,61977,1.3590444255066878,0.2969754760558521
21095,0.5548095238095239,0,1,0,458894,146716,45979,61977,1.3590351624736003,0.2969768990814258
21096,0.5548333333333333,5,13,5,458907,146703,45984,61972,1.358914743043462,0.296978555169522
21097,0.5548571428571428,0,2,0,458909,146701,45984,61972,1.3588962169772871,0.296981401522957
21098,0.5548809523809524,0,2,0,458911,146699,45984,61972,1.358877690911112,0.2969842479309535
21099,0.5549166666666667,1,1,1,458912,146698,45985,61971,1.3588684278780243,0.29698230211483256
21100,0.5549285714285714,0,1,0,458913,146697,45985,61971,1.3588591648449369,0.296983725343608
21101,0.5549444444444445,0,1,0,458914,146696,45985,61971,1.3588499018118492,0.29698514858602465
21102,0.5549999999999999,5,18,5,458932,146678,45990,61966,1.3586831672162734,0.29699392266252567
21103,0.555,202,971,202,459903,145707,46192,61764,1.3496887620882583,0.29769943751174865
21104,0.555047619047619,1,1,1,459904,145706,46193,61763,1.3496794990551706,0.29769748733545737
21105,0.5550476190476192,0,1,0,459905,145705,46193,61763,1.3496702360220831,0.2976989222434303
21106,0.5550555555555555,0,1,0,459906,145704,46193,61763,1.3496609729889955,0.2977003571652359
21107,0.5550714285714284,0,5,0,459911,145699,46193,61763,1.3496146578235577,0.29770753198176053
21108,0.5550833333333334,0,1,0,459912,145698,46193,61763,1.3496053947904703,0.2977089669865661
21109,0.5551428571428572,1,1,1,459913,145697,46194,61762,1.3495961317573826,0.2977070168081404
21110,0.5551666666666666,0,3,0,459916,145694,46194,61762,1.34956834265812,0.29771132191886474
21111,0.5551666666666667,3,15,3,459931,145679,46197,61759,1.3494293971618068,0.2977226930456329
21112,0.5551904761904761,0,1,0,459932,145678,46197,61759,1.349420134128719,0.29772412828955297
21113,0.5551904761904762,0,2,0,459934,145676,46197,61759,1.349401608062544,0.29772699881890713
21114,0.5551944444444445,0,3,0,459937,145673,46197,61759,1.3493738189632813,0.29773130471672643
21115,0.5552083333333333,0,1,0,459938,145672,46197,61759,1.3493645559301939,0.29773274004367717
21116,0.5552380952380953,0,6,0,459944,145666,46197,61759,1.3493089777316685,0.2977413522960106
21117,0.5552857142857143,0,6,0,459950,145660,46197,61759,1.349253399533143,0.2977499650465965
21118,0.5553333333333332,0,1,0,459951,145659,46197,61759,1.3492441365000556,0.2977514005534717
21119,0.5553333333333333,3,30,3,459981,145629,46200,61756,1.348966245507429,0.29778431419823037
21120,0.5553333333333335,0,1,0,459982,145628,46200,61756,1.3489569824743415,0.2977857501060834
21121,0.5553571428571429,0,3,0,459985,145625,46200,61756,1.3489291933750787,0.29779005791273067
21122,0.5553809523809524,0,2,0,459987,145623,46200,61756,1.3489106673089035,0.29779292985307093
21123,0.555404761904762,0,1,0,459988,145622,46200,61756,1.348901404275816,0.2977943658440143
21124,0.5554166666666667,0,3,0,459991,145619,46200,61756,1.3488736151765535,0.29779867389993975
21125,0.555423742923743,0,1,0,459992,145618,46200,61756,1.3488643521434658,0.29780010994628064
21126,0.5554761904761905,1,1,1,459993,145617,46201,61755,1.3488550891103783,0.2977981598287136
21127,0.5554761904761906,0,2,0,459995,145615,46201,61755,1.3488365630442032,0.29780103197183777
21128,0.5554761904761907,0,1,0,459996,145614,46201,61755,1.3488273000111157,0.29780246806417543
21129,0.5555,2,17,2,460013,145597,46203,61753,1.3486698284486272,0.2978201109235592
21130,0.5555238095238095,0,2,0,460015,145595,46203,61753,1.348651302382452,0.2978229835831549
21131,0.5555555555555556,1,0,1,460015,145595,46204,61752,1.348651302382452,0.29781959710051265
21132,0.5555833333333333,0,1,0,460016,145594,46204,61752,1.3486420393493646,0.29782103344168687
21133,0.5556190476190476,0,1,0,460017,145593,46204,61752,1.348632776316277,0.2978224697967156
21134,0.5556428571428572,0,1,0,460018,145592,46204,61752,1.3486235132831894,0.2978239061655992
21135,0.5556666666666665,0,1,0,460019,145591,46204,61752,1.348614250250102,0.29782534254833776
21136,0.5556666666666666,4,21,4,460040,145570,46208,61748,1.3484197265552633,0.29784196258887313
21137,0.5556666666666668,3,12,3,460052,145558,46211,61745,1.3483085701582127,0.2978490422232192
21138,0.5556818181818182,0,1,0,460053,145557,46211,61745,1.348299307125125,0.2978504790112975
21139,0.5557142857142857,2,8,2,460061,145549,46213,61743,1.3482252028604247,0.29785519942882505
21140,0.5557500000000001,0,1,0,460062,145548,46213,61743,1.348215939827337,0.2978566363228505
21141,0.5557777777777777,0,1,0,460063,145547,46213,61743,1.3482066767942495,0.29785807323073954
21142,0.5557857142857142,1,0,1,460063,145547,46214,61742,1.3482066767942495,0.29785468596982956
21143,0.5558095238095239,1,0,1,460063,145547,46215,61741,1.3482066767942495,0.2978512986762379
21144,0.5558333333333332,0,1,0,460064,145546,46215,61741,1.3481974137611619,0.29785273557917286
21145,0.5558333333333333,6,41,6,460105,145505,46221,61735,1.3478176294045723,0.2978913337193592
21146,0.5558333333333334,12,54,12,460159,145451,46233,61723,1.3473174256178444,0.2979283114676552
21147,0.5558412698412699,0,1,0,460160,145450,46233,61723,1.3473081625847567,0.297929749532999
21148,0.5558452380952382,0,1,0,460161,145449,46233,61723,1.3472988995516693,0.2979311876122256
21149,0.5558571428571428,0,1,0,460162,145448,46233,61723,1.3472896365185816,0.2979326257053352
21150,0.5558571428571429,0,1,0,460163,145447,46233,61723,1.3472803734854941,0.29793406381232806
21151,0.5559047619047619,0,3,0,460166,145444,46233,61723,1.3472525843862315,0.29793837821660785
21152,0.5559166666666667,1,0,1,460166,145444,46234,61722,1.3472525843862315,0.29793498933222634
21153,0.5559285714285714,0,1,0,460167,145443,46234,61722,1.3472433213531438,0.2979364274853378
21154,0.555952380952381,0,4,0,460171,145439,46234,61722,1.3472062692207936,0.29794218023662755
21155,0.5559999999999999,3,8,3,460179,145431,46237,61719,1.3471321649560932,0.2979435191889935
21156,0.556,16,115,16,460294,145316,46253,61703,1.3460669161510246,0.29805476791985275
21157,0.5560555555555556,0,2,0,460296,145314,46253,61703,1.3460483900848494,0.29805764743958224
21158,0.5560772005772006,0,1,0,460297,145313,46253,61703,1.3460391270517618,0.2980590872203115
21159,0.5560833333333333,0,1,0,460298,145312,46253,61703,1.3460298640186743,0.2980605270149506
21160,0.556095238095238,0,4,0,460302,145308,46253,61703,1.345992811886324,0.29806628633261034
21161,0.5560952380952381,0,2,0,460304,145306,46253,61703,1.3459742858201489,0.29806916607490497
21162,0.5561111111111111,3,0,3,460304,145306,46256,61700,1.3459742858201489,0.2980589934591268
21163,0.5561309523809523,0,1,0,460305,145305,46256,61700,1.3459650227870614,0.2980604333228666
21164,0.5561515151515153,0,1,0,460306,145304,46256,61700,1.3459557597539737,0.29806187320051786
21165,0.5561666666666666,1,3,1,460309,145301,46257,61699,1.3459279706547111,0.29806280193236717
21166,0.5561666666666667,2,11,2,460320,145290,46259,61697,1.345826077290748,0.29807185958538457
21167,0.5561785714285713,0,1,0,460321,145289,46259,61697,1.3458168142576605,0.29807329964345414
21168,0.5561904761904761,0,3,0,460324,145286,46259,61697,1.345789025158398,0.2980776199011513
21169,0.5561904761904762,1,2,1,460326,145284,46260,61696,1.3457704990922228,0.2980771088994106
21170,0.5562142857142857,0,1,0,460327,145283,46260,61696,1.3457612360591351,0.29807854903154424
21171,0.5562142857142858,3,2,3,460329,145281,46263,61693,1.3457427099929602,0.298071255326756
21172,0.5562272727272728,0,1,0,460330,145280,46263,61693,1.3457334469598725,0.2980726954723563
21173,0.5562380952380952,1,0,1,460330,145280,46264,61692,1.3457334469598725,0.2980693040604526
21174,0.55625,2,6,2,460336,145274,46266,61690,1.3456778687613473,0.2980711621344775
21175,0.5562857142857144,0,1,0,460337,145273,46266,61690,1.3456686057282596,0.2980726023492122
21176,0.5563095238095237,0,2,0,460339,145271,46266,61690,1.3456500796620845,0.2980754828204348
21177,0.5563095238095238,0,1,0,460340,145270,46266,61690,1.345640816628997,0.2980769230769231
21178,0.5563181818181818,0,1,0,460341,145269,46266,61690,1.3456315535959094,0.2980783633473297
21179,0.5563333333333332,1,6,1,460347,145263,46267,61689,1.3455759753973842,0.29808361359155744
21180,0.5563333333333333,8,13,8,460360,145250,46275,61681,1.3454555559672459,0.29807520381189867
21181,0.5563333333333336,0,1,0,460361,145249,46275,61681,1.3454462929341584,0.2980766442758421
21182,0.5563809523809524,0,1,0,460362,145248,46275,61681,1.3454370299010707,0.2980780847537078
21183,0.5563888888888889,1,0,1,460362,145248,46276,61680,1.3454370299010707,0.2980746926467177
21184,0.5564166666666667,0,1,0,460363,145247,46276,61680,1.3454277668679833,0.2980761331290745
21185,0.5564285714285715,1,4,1,460367,145243,46277,61679,1.345390714735633,0.29807850301079636
21186,0.5564523809523809,0,1,0,460368,145242,46277,61679,1.3453814517025455,0.2980799435533368
21187,0.5564761904761905,0,1,0,460369,145241,46277,61679,1.3453721886694578,0.2980813841098009
21188,0.5564761904761906,0,4,0,460373,145237,46277,61679,1.3453351365371078,0.29808714647489803
21189,0.5564880952380953,0,1,0,460374,145236,46277,61679,1.34532587350402,0.2980885871009835
21190,0.5564999999999999,0,1,0,460375,145235,46277,61679,1.3453166104709327,0.29809002774099386
21191,0.5565,7,17,7,460392,145218,46284,61672,1.345159138908444,0.2980907728744744
21192,0.5565000000000001,0,3,0,460395,145215,46284,61672,1.3451313498091815,0.2980950953902372
21193,0.5565238095238096,0,2,0,460397,145213,46284,61672,1.3451128237430063,0.2980979771370568
21194,0.5565476190476191,0,1,0,460398,145212,46284,61672,1.3451035607099189,0.2980994180313606
21195,0.5565555555555556,0,2,0,460400,145210,46284,61672,1.3450850346437437,0.29810229986175696
21196,0.5565714285714286,0,1,0,460401,145209,46284,61672,1.3450757716106563,0.29810374079784996
21197,0.5565833333333334,2,1,2,460402,145208,46286,61670,1.3450665085775686,0.29809839615618866
21198,0.556595238095238,0,1,0,460403,145207,46286,61670,1.3450572455444811,0.29809983710127275
21199,0.5566190476190477,0,1,0,460404,145206,46286,61670,1.3450479825113935,0.2981012780602873
21200,0.5566309523809525,1,2,1,460406,145204,46287,61669,1.3450294564452183,0.2981007671373258
21201,0.556642857142857,0,1,0,460407,145203,46287,61669,1.3450201934121309,0.2981022081286979
21202,0.5566428571428572,0,1,0,460408,145202,46287,61669,1.3450109303790434,0.2981036491340014
21203,0.5566666666666665,0,2,0,460410,145200,46287,61669,1.3449924043128683,0.298106531186403
21204,0.5566666666666666,73,362,73,460772,144838,46360,61596,1.3416391863351735,0.29838108063594176
21205,0.5566666666666668,41,180,41,460952,144658,46401,61555,1.3399718403794139,0.2985020343043358
21206,0.5567499999999999,1,0,1,460952,144658,46402,61554,1.3399718403794139,0.29849863247531666
21207,0.55675,0,1,0,460953,144657,46402,61554,1.3399625773463262,0.2985000800151301
21208,0.5567593795093795,0,2,0,460955,144655,46402,61554,1.3399440512801513,0.2985029751368757
21209,0.5567857142857143,0,2,0,460957,144653,46402,61554,1.3399255252139761,0.29850587031478076
21210,0.5568015873015874,0,1,0,460958,144652,46402,61554,1.3399162621808884,0.2985073179247937
21211,0.5568095238095238,0,1,0,460959,144651,46402,61554,1.339906999147801,0.29850876554884703
21212,0.5568174603174604,0,1,0,460960,144650,46402,61554,1.3398977361147133,0.2985102131869411
21213,0.5568333333333333,0,5,0,460965,144645,46402,61554,1.3398514209492756,0.29851745158802906
21214,0.5568333333333334,0,12,0,460977,144633,46402,61554,1.339740264552225,0.298534825182965
21215,0.5568571428571428,2,0,2,460977,144633,46404,61552,1.339740264552225,0.2985280209520576
21216,0.5568571428571429,0,2,0,460979,144631,46404,61552,1.3397217384860498,0.29853091670991305
21217,0.5569166666666666,0,1,0,460980,144630,46404,61552,1.3397124754529623,0.29853236460990773
21218,0.556952380952381,0,1,0,460981,144629,46404,61552,1.3397032124198747,0.2985338125239474
21219,0.5569761904761904,0,1,0,460982,144628,46404,61552,1.3396939493867872,0.2985352604520322
21220,0.5569761904761905,0,1,0,460983,144627,46404,61552,1.3396846863536997,0.29853670839416235
21221,0.5569999999999999,4,4,4,460987,144623,46408,61548,1.3396476342213495,0.2985288910661538
21222,0.557,5,32,5,461019,144591,46413,61543,1.3393512171625477,0.2985582194106746
21223,0.5570238095238095,0,1,0,461020,144590,46413,61543,1.3393419541294602,0.29855966778730236
21224,0.557047619047619,1,0,1,461020,144590,46414,61542,1.3393419541294602,0.2985562649176256
21225,0.5570833333333334,0,4,0,461024,144586,46414,61542,1.33930490199711,0.29856205852674067
21226,0.5570952380952381,1,0,1,461024,144586,46415,61541,1.33930490199711,0.2985586555861192
21227,0.5571428571428572,5,18,5,461042,144568,46420,61536,1.339138167401534,0.29856771338741606
21228,0.5571666666666666,2,3,2,461045,144565,46422,61534,1.3391103783022713,0.29856525262131306
21229,0.5571666666666667,1,8,1,461053,144557,46423,61533,1.339036274037571,0.29857343878887865
21230,0.5572222222222222,1,3,1,461056,144554,46424,61532,1.3390084849383082,0.2985743815688596
21231,0.55725,0,1,0,461057,144553,46424,61532,1.3389992219052207,0.29857583036125873
21232,0.5572500000000001,0,1,0,461058,144552,46424,61532,1.338989958872133,0.29857727916771803
21233,0.5572619047619047,0,1,0,461059,144551,46424,61532,1.3389806958390456,0.29857872798823776
21234,0.5572691197691199,0,1,0,461060,144550,46424,61532,1.3389714328059579,0.2985801768228181
21235,0.5572857142857142,0,2,0,461062,144548,46424,61532,1.338952906739783,0.2985830745341615
21236,0.5573333333333332,3,4,3,461066,144544,46427,61529,1.3389158546074327,0.29857865901889136
21237,0.5573333333333333,4,20,4,461086,144524,46431,61525,1.3387305939456815,0.2985940237516319
21238,0.5573333333333335,0,1,0,461087,144523,46431,61525,1.338721330912594,0.29859547289951854
21239,0.5573809523809523,1,0,1,461087,144523,46432,61524,1.338721330912594,0.2985920687998369
21240,0.5573809523809524,0,5,0,461092,144518,46432,61524,1.3386750157471563,0.2985993147028276
21241,0.5574285714285714,1,0,1,461092,144518,46433,61523,1.3386750157471563,0.298595910522663
21242,0.5574329004329005,0,1,0,461093,144517,46433,61523,1.3386657527140686,0.2985973597359736
21243,0.5574372294372294,1,0,1,461093,144517,46434,61522,1.3386657527140686,0.2985939555132766
21244,0.5574523809523809,0,1,0,461094,144516,46434,61522,1.3386564896809812,0.2985954047311661
21245,0.5574761904761905,0,1,0,461095,144515,46434,61522,1.3386472266478935,0.29859685396312313
21246,0.5574761904761906,0,1,0,461096,144514,46434,61522,1.338637963614806,0.29859830320914793
21247,0.5574999999999999,2,13,2,461109,144501,46436,61520,1.3385175441846677,0.2986103358395503
21248,0.5575,74,233,74,461342,144268,46510,61446,1.3363592574752676,0.29869624818923357
21249,0.5575000000000001,0,7,0,461349,144261,46510,61446,1.3362944162436547,0.2987064125187767
21250,0.5575277777777777,1,1,1,461350,144260,46511,61445,1.3362851532105673,0.29870445540944557
21251,0.557547619047619,1,1,1,461351,144259,46512,61444,1.3362758901774796,0.2987024982620574
21252,0.5575674603174603,1,0,1,461351,144259,46513,61443,1.3362758901774796,0.2986990889733692
21253,0.5576190476190476,0,4,0,461355,144255,46513,61443,1.3362388380451296,0.2987048974710498
21254,0.5576269841269841,0,2,0,461357,144253,46513,61443,1.3362203119789544,0.2987078018046049
21255,0.5576388888888889,1,0,1,461357,144253,46514,61442,1.3362203119789544,0.2987043924256788
21256,0.5576547619047618,0,1,0,461358,144252,46514,61442,1.3362110489458667,0.2987058446041207
21257,0.5576666666666665,2,1,2,461359,144251,46516,61440,1.3362017859127793,0.298700477901318
21258,0.5576666666666666,7,35,7,461394,144216,46523,61433,1.3358775797547149,0.2987274433622337
21259,0.5576666666666668,1,8,1,461402,144208,46524,61432,1.3358034754900145,0.2987356545419179
21260,0.5577142857142857,0,1,0,461403,144207,46524,61432,1.3357942124569269,0.29873710726078223
21261,0.5577777777777778,0,1,0,461404,144206,46524,61432,1.3357849494238394,0.29873855999377547
21262,0.5578095238095238,1,3,1,461407,144203,46525,61431,1.3357571603245766,0.298739508058006
21263,0.5578333333333333,3,3,3,461410,144200,46528,61428,1.335729371225314,0.2987336354971113
21264,0.5578333333333334,3,3,3,461413,144197,46531,61425,1.3357015821260514,0.2987277625934968
21265,0.5578571428571428,2,3,2,461416,144194,46533,61423,1.3356737930267888,0.29872529995087954
21266,0.5578939393939394,0,1,0,461417,144193,46533,61423,1.335664529993701,0.29872675278188465
21267,0.5579166666666666,1,0,1,461417,144193,46534,61422,1.335664529993701,0.2987233421686161
21268,0.5579166666666667,0,1,0,461418,144192,46534,61422,1.3356552669606137,0.2987247950042312
21269,0.5579285714285713,0,1,0,461419,144191,46534,61422,1.335646003927526,0.2987262478539781
21270,0.5579761904761904,0,1,0,461420,144190,46534,61422,1.3356367408944385,0.2987277007178569
21271,0.5579999999999999,19,64,19,461484,144126,46553,61403,1.335043906776835,0.29875589332892194
21272,0.558,3,9,3,461493,144117,46556,61400,1.334960539479047,0.29875874015288273
21273,0.558047619047619,0,1,0,461494,144116,46556,61400,1.3349512764459595,0.29876019385351993
21274,0.5580714285714286,0,1,0,461495,144115,46556,61400,1.334942013412872,0.29876164756830403
21275,0.5580833333333333,1,0,1,461495,144115,46557,61399,1.334942013412872,0.2987582354486799
21276,0.5580952380952382,0,1,0,461496,144114,46557,61399,1.3349327503797843,0.2987596891680818
21277,0.5580992063492063,0,1,0,461497,144113,46557,61399,1.3349234873466969,0.298761142901631
21278,0.5581212121212121,0,1,0,461498,144112,46557,61399,1.3349142243136092,0.29876259664932775
21279,0.5581428571428572,0,1,0,461499,144111,46557,61399,1.3349049612805217,0.2987640504111722
21280,0.5581666666666666,0,9,0,461508,144102,46557,61399,1.3348215939827337,0.298777134904453
21281,0.5581666666666667,0,5,0,461513,144097,46557,61399,1.334775278817296,0.29878440456261923
21282,0.5581818181818182,0,2,0,461515,144095,46557,61399,1.3347567527511208,0.2987873125249399
21283,0.5581904761904761,0,2,0,461517,144093,46557,61399,1.3347382266849457,0.29879022054386545
21284,0.5582142857142857,1,4,1,461521,144089,46558,61398,1.3347011745525954,0.2987926243509322
21285,0.5582222222222222,0,1,0,461522,144088,46558,61398,1.334691911519508,0.29879407842870076
21286,0.5582301587301588,0,1,0,461523,144087,46558,61398,1.3346826484864205,0.29879553252062196
21287,0.5582380952380953,0,1,0,461524,144086,46558,61398,1.3346733854533328,0.298796986626696
21288,0.55825,1,0,1,461524,144086,46559,61397,1.3346733854533328,0.2987935741642861
21289,0.5582539682539682,1,0,1,461524,144086,46560,61396,1.3346733854533328,0.29879016166866196
21290,0.5583095238095237,0,1,0,461525,144085,46560,61396,1.3346641224202453,0.2987916157698279
21291,0.5583333333333332,25,121,25,461646,143964,46585,61371,1.3335432954166513,0.2988823142669296
21292,0.5583333333333333,46,172,46,461818,143792,46631,61325,1.331950053725592,0.2989757065479702
21293,0.5583333333333335,1,4,1,461822,143788,46632,61324,1.3319130015932417,0.2989781192714224
21294,0.5584285714285714,0,1,0,461823,143787,46632,61324,1.3319037385601542,0.2989795769120135
21295,0.5584285714285715,0,2,0,461825,143785,46632,61324,1.331885212493979,0.29898249223583556
21296,0.5584523809523809,0,3,0,461828,143782,46632,61324,1.3318574233947165,0.29898686532817176
21297,0.558452380952381,0,1,0,461829,143781,46632,61324,1.3318481603616288,0.2989883230540455
21298,0.5584595959595959,0,1,0,461830,143780,46632,61324,1.3318388973285413,0.2989897807941337
21299,0.5584761904761905,1,2,1,461832,143778,46633,61323,1.3318203712623662,0.29898927845305484
21300,0.5585,10,27,10,461859,143751,46643,61313,1.3315702693690021,0.2989944602660633
21301,0.5585238095238094,0,1,0,461860,143750,46643,61313,1.3315610063359147,0.29899591832753836
21302,0.5585714285714285,0,5,0,461865,143745,46643,61313,1.331514691170477,0.2990032088482283
21303,0.5585714285714286,1,1,1,461866,143744,46644,61312,1.3315054281373893,0.2990012484394507
21304,0.5586190476190476,0,1,0,461867,143743,46644,61312,1.3314961651043018,0.29900270659091466
21305,0.5586309523809523,0,1,0,461868,143742,46644,61312,1.3314869020712141,0.2990041647566007
21306,0.5586666666666666,4,25,4,461893,143717,46648,61308,1.3312553262440254,0.29902694793317885
21307,0.5586666666666668,1,2,1,461895,143715,46649,61307,1.3312368001778503,0.2990264459423867
21308,0.5586904761904762,0,2,0,461897,143713,46649,61307,1.3312182741116751,0.2990293629889767
21309,0.5587142857142857,0,4,0,461901,143709,46649,61307,1.3311812219793249,0.29903519725289734
21310,0.55875,0,2,0,461903,143707,46649,61307,1.3311626959131497,0.2990381144702313
21311,0.5587857142857142,0,3,0,461906,143704,46649,61307,1.3311349068138871,0.299042490402954
21312,0.5587857142857143,0,1,0,461907,143703,46649,61307,1.3311256437807997,0.29904394907565485
21313,0.5588095238095238,0,2,0,461909,143701,46649,61307,1.3311071177146245,0.29904686646374773
21314,0.5588095238095239,0,1,0,461910,143700,46649,61307,1.3310978546815369,0.2990483251791402
21315,0.5588225108225109,1,0,1,461910,143700,46650,61306,1.3310978546815369,0.29904490600275113
21316,0.5588333333333333,0,7,0,461917,143693,46650,61306,1.331033013449924,0.2990551173420358
21317,0.5588833943833944,1,0,1,461917,143693,46651,61305,1.331033013449924,0.299051698065347
21318,0.5588888888888889,1,4,1,461921,143689,46652,61304,1.330995961317574,0.29905411404291854
21319,0.5589047619047619,0,2,0,461923,143687,46652,61304,1.3309774352513988,0.29905703177212656
21320,0.5589166666666666,1,0,1,461923,143687,46653,61303,1.3309774352513988,0.2990536123713352
21321,0.5589285714285714,1,5,1,461928,143682,46654,61302,1.330931120085961,0.2990574874136518
21322,0.558952380952381,0,2,0,461930,143680,46654,61302,1.330912594019786,0.29906040530388034
21323,0.5589761904761904,1,0,1,461930,143680,46655,61301,1.330912594019786,0.29905698576941275
21324,0.5589999999999999,8,37,8,461967,143643,46663,61293,1.3305698617955464,0.29908361634851854
21325,0.559,1,3,1,461970,143640,46664,61292,1.3305420726962838,0.2990845743954092
21326,0.5590357142857143,0,1,0,461971,143639,46664,61292,1.330532809663196,0.29908603383577886
21327,0.559047619047619,1,5,1,461976,143634,46665,61291,1.3304864944977584,0.29908991094302795
21328,0.5590476190476191,0,1,0,461977,143633,46665,61291,1.330477231464671,0.29909137045929224
21329,0.5590714285714286,0,3,0,461980,143630,46665,61291,1.330449442365408,0.29909574909355313
21330,0.5590952380952381,0,1,0,461981,143629,46665,61291,1.3304401793323206,0.2990972086667968
21331,0.5590952380952382,0,1,0,461982,143628,46665,61291,1.330430916299233,0.2990986682542858
21332,0.5591190476190476,0,1,0,461983,143627,46665,61291,1.3304216532661455,0.29910012785602047
21333,0.5591428571428572,2,3,2,461986,143624,46667,61289,1.3303938641668829,0.299097665838673
21334,0.5591666666666666,22,65,22,462051,143559,46689,61267,1.3297917670161918,0.2991172995615791
21335,0.5591666666666667,8,46,8,462097,143513,46697,61259,1.3293656674941643,0.2991571113238138
21336,0.5591666666666668,0,1,0,462098,143512,46697,61259,1.3293564044610768,0.29915857225876713
21337,0.5592619047619048,0,2,0,462100,143510,46697,61259,1.3293378783949017,0.299161494171481
21338,0.5592857142857143,6,5,6,462105,143505,46703,61253,1.329291563229464,0.29914826282733764
21339,0.559297619047619,0,2,0,462107,143503,46703,61253,1.3292730371632888,0.2991511848248647
21340,0.5593333333333333,9,41,9,462148,143462,46712,61244,1.328893252806699,0.2991802878274208
21341,0.5593549783549784,0,1,0,462149,143461,46712,61244,1.3288839897736116,0.29918174934662073
21342,0.559404761904762,0,1,0,462150,143460,46712,61244,1.3288747267405239,0.2991832108801
21343,0.5594126984126985,1,0,1,462150,143460,46713,61243,1.3288747267405239,0.29917978730160283
21344,0.5594166666666667,1,2,1,462152,143458,46714,61242,1.3288562006743487,0.2991792867611138
21345,0.5594444444444444,1,1,1,462153,143457,46715,61241,1.3288469376412613,0.29917732464410984
21346,0.5594444444444445,0,1,0,462154,143456,46715,61241,1.3288376746081736,0.2991787862059532
21347,0.5594523809523809,0,1,0,462155,143455,46715,61241,1.3288284115750861,0.29918024778207686
21348,0.5594761904761905,3,1,3,462156,143454,46718,61238,1.3288191485419987,0.2991714380630411
21349,0.5595,4,17,4,462173,143437,46722,61234,1.32866167697951,0.299182590596616
21350,0.5595000000000001,1,5,1,462178,143432,46723,61233,1.3286153618140724,0.2991864754598979
21351,0.5595238095238095,0,1,0,462179,143431,46723,61233,1.328606098780985,0.2991879373021147
21352,0.5595476190476191,0,1,0,462180,143430,46723,61233,1.3285968357478972,0.29918939915861686
21353,0.5595555555555555,0,1,0,462181,143429,46723,61233,1.3285875727148098,0.29919086102940456
21354,0.5595714285714287,0,1,0,462182,143428,46723,61233,1.328578309681722,0.2991923229144781
21355,0.5595833333333333,0,2,0,462184,143426,46723,61233,1.3285597836155472,0.29919524672748327
21356,0.5595952380952381,0,1,0,462185,143425,46723,61233,1.3285505205824595,0.29919670865541537
21357,0.5596277056277055,0,1,0,462186,143424,46723,61233,1.328541257549372,0.2991981705976341
21358,0.5596428571428571,0,3,0,462189,143421,46723,61233,1.3285134684501092,0.29920255651001204
21359,0.5596666666666666,2,19,2,462208,143402,46725,61231,1.3283374708214457,0.2992234879027332
21360,0.5596666666666668,0,2,0,462210,143400,46725,61231,1.3283189447552706,0.2992264124204055
21361,0.5596666666666669,0,1,0,462211,143399,46725,61231,1.328309681722183,0.2992278747006793
21362,0.5597023809523811,1,0,1,462211,143399,46726,61230,1.328309681722183,0.2992244501023804
21363,0.5597142857142857,0,1,0,462212,143398,46726,61230,1.3283004186890957,0.2992259123873566
21364,0.5597380952380953,0,2,0,462214,143396,46726,61230,1.3282818926229205,0.2992288370001857
21365,0.55975,0,2,0,462216,143394,46726,61230,1.3282633665567454,0.29923176167018534
21366,0.5597619047619048,1,3,1,462219,143391,46727,61229,1.3282355774574828,0.29923272407389306
21367,0.5597777777777778,0,1,0,462220,143390,46727,61229,1.328226314424395,0.29923418646362265
21368,0.5597857142857143,0,1,0,462221,143389,46727,61229,1.3282170513913076,0.29923564886764603
21369,0.5598333333333333,3,8,3,462229,143381,46730,61226,1.328142947126607,0.2992370740004008
21370,0.5598333333333334,0,1,0,462230,143380,46730,61226,1.3281336840935196,0.2992385365043058
21371,0.5598571428571428,0,1,0,462231,143379,46730,61226,1.328124421060432,0.2992399990225068
21372,0.559861111111111,0,1,0,462232,143378,46730,61226,1.3281151580273445,0.2992414615550038
21373,0.5598809523809524,2,1,2,462233,143377,46732,61224,1.328105894994257,0.29923607411498476
21374,0.5598867243867243,0,2,0,462235,143375,46732,61224,1.3280873689280819,0.2992389992130949
21375,0.5599166666666666,0,1,0,462236,143374,46732,61224,1.3280781058949942,0.29924046178359515
21376,0.5599285714285714,0,2,0,462238,143372,46732,61224,1.328059579828819,0.29924338696748715
21377,0.559952380952381,0,4,0,462242,143368,46732,61224,1.328022527696469,0.2992492375068429
21378,0.5599761904761905,0,1,0,462243,143367,46732,61224,1.3280132646633813,0.29925070017742716
21379,0.5599999999999999,5,24,5,462267,143343,46737,61219,1.32779095186928,0.299268681377773
21380,0.56,542,2445,542,464712,140898,47279,60677,1.3051428359702102,0.3010145107280169
21381,0.5600119047619048,0,4,0,464716,140894,47279,60677,1.30510578383786,0.30102048409741483
21382,0.5600476190476191,1,1,1,464717,140893,47280,60676,1.3050965208047722,0.301018509790692
21383,0.5601111111111111,0,1,0,464718,140892,47280,60676,1.3050872577716848,0.3010200031751072
21384,0.5601515151515152,0,1,0,464719,140891,47280,60676,1.3050779947385973,0.30102149657434
21385,0.5601666666666667,1,7,1,464726,140884,47281,60675,1.3050131535069844,0.30102848297520823
21386,0.5601904761904761,0,3,0,464729,140881,47281,60675,1.3049853644077216,0.30103296354363057
21387,0.5601904761904762,0,3,0,464732,140878,47281,60675,1.304957575308459,0.3010374442454342
21388,0.5602142857142858,1,0,1,464732,140878,47282,60674,1.304957575308459,0.3010339763435739
21389,0.5602222222222223,0,1,0,464733,140877,47282,60674,1.3049483122753716,0.3010354699306875
21390,0.5602380952380953,0,1,0,464734,140876,47282,60674,1.3049390492422839,0.30103696353262216
21391,0.560297619047619,1,0,1,464734,140876,47283,60673,1.3049390492422839,0.301033495576758
21392,0.5603095238095238,1,0,1,464734,140876,47284,60672,1.3049390492422839,0.3010300275864806
21393,0.5603333333333332,1,4,1,464738,140872,47285,60671,1.3049019971099336,0.30103253400018853
21394,0.5603333333333333,4,24,4,464762,140848,47289,60667,1.3046796843158324,0.3010545120710617
21395,0.5603333333333335,1,0,1,464762,140848,47290,60666,1.3046796843158324,0.3010510435999484
21396,0.5603571428571428,0,1,0,464763,140847,47290,60666,1.304670421282745,0.30105253755340844
21397,0.5603571428571429,1,1,1,464764,140846,47291,60665,1.3046611582496572,0.30105056299656097
21398,0.5603787878787878,0,1,0,464765,140845,47291,60665,1.3046518952165698,0.3010520569698774
21399,0.5604166666666667,1,2,1,464767,140843,47292,60664,1.3046333691503946,0.3010515763720367
21400,0.5604285714285714,0,1,0,464768,140842,47292,60664,1.304624106117307,0.3010530703800383
21401,0.560436507936508,0,1,0,464769,140841,47292,60664,1.3046148430842195,0.30105456440286843
21402,0.5604761904761905,1,5,1,464774,140836,47293,60663,1.3045685279187818,0.30105856604747416
21403,0.5605,8,25,8,464799,140811,47301,60655,1.3043369520915928,0.30106817031161587
21404,0.5605079365079365,1,2,1,464801,140809,47302,60654,1.3043184260254177,0.30106768984875637
21405,0.5605555555555556,0,1,0,464802,140808,47302,60654,1.3043091629923302,0.3010691842630372
21406,0.5605714285714286,0,1,0,464803,140807,47302,60654,1.3042998999592426,0.3010706786921538
21407,0.5605952380952381,2,3,2,464806,140804,47304,60652,1.30427211085998,0.3010682233341275
21408,0.5606060606060607,1,0,1,464806,140804,47305,60651,1.30427211085998,0.30106475391526644
21409,0.5606190476190476,0,1,0,464807,140803,47305,60651,1.3042628478268925,0.3010662483743187
21410,0.5606190476190477,1,0,1,464807,140803,47306,60650,1.3042628478268925,0.3010627789112101
21411,0.5606428571428572,0,1,0,464808,140802,47306,60650,1.3042535847938048,0.30106427337529534
21412,0.5606666666666666,8,34,8,464842,140768,47314,60642,1.3039386416688281,0.3010873342932327
21413,0.5606904761904762,0,1,0,464843,140767,47314,60642,1.3039293786357404,0.301088829198298
21414,0.560702380952381,0,1,0,464844,140766,47314,60642,1.303920115602653,0.3010903241182078
21415,0.5607142857142857,2,14,2,464858,140752,47316,60640,1.3037904331394272,0.30110431397473586
21416,0.5607499999999999,0,2,0,464860,140750,47316,60640,1.303771907073252,0.3011073042355628
21417,0.5607500000000001,0,3,0,464863,140747,47316,60640,1.3037441179739895,0.3011117897381658
21418,0.5607857142857143,0,1,0,464864,140746,47316,60640,1.3037348549409018,0.3011132849353977
21419,0.5608333333333333,8,46,8,464910,140700,47324,60632,1.3033087554188743,0.3011543122802138
21420,0.5608333333333334,15,57,15,464967,140643,47339,60617,1.3027807625328838,0.3011875186326145
21421,0.5608531746031744,0,1,0,464968,140642,47339,60617,1.3027714994997963,0.30118901514963303
21422,0.5608571428571427,0,2,0,464970,140640,47339,60617,1.3027529734336212,0.30119200822828524
21423,0.5608571428571428,1,1,1,464971,140639,47340,60616,1.3027437104005335,0.30119003254577525
21424,0.5609047619047619,1,3,1,464974,140636,47341,60615,1.302715921301271,0.30119104998236035
21425,0.560923076923077,0,1,0,464975,140635,47341,60615,1.3027066582681834,0.3011925465838509
21426,0.560952380952381,1,8,1,464983,140627,47342,60614,1.3026325540034829,0.3012010475002609
21427,0.5609999999999999,0,5,0,464988,140622,47342,60614,1.3025862388380451,0.30120853127670993
21428,0.561,13,45,13,465033,140577,47355,60601,1.3021694023491053,0.30123075087733253
21429,0.5610003378973967,0,1,0,465034,140576,47355,60601,1.3021601393160176,0.30123224821922984
21430,0.5610238095238096,1,3,1,465037,140573,47356,60600,1.302132350216755,0.30123326688969193
21431,0.5610476190476189,0,1,0,465038,140572,47356,60600,1.3021230871836673,0.3012347642813115
21432,0.5610476190476191,0,1,0,465039,140571,47356,60600,1.3021138241505799,0.3012362616878178
21433,0.5610714285714286,1,0,1,465039,140571,47357,60599,1.3021138241505799,0.3012327881890938
21434,0.5610833333333333,0,1,0,465040,140570,47357,60599,1.3021045611174924,0.3012342856006641
21435,0.5610833333333334,0,1,0,465041,140569,47357,60599,1.3020952980844047,0.3012357830271216
21436,0.5610952380952381,0,3,0,465044,140566,47357,60599,1.3020675089851421,0.3012402753958194
21437,0.5611111111111111,0,1,0,465045,140565,47357,60599,1.3020582459520544,0.30124177288182774
21438,0.561142857142857,0,1,0,465046,140564,47357,60599,1.302048982918967,0.30124327038272447
21439,0.5611428571428572,1,0,1,465046,140564,47358,60598,1.302048982918967,0.3012397967807041
21440,0.5611666666666666,0,1,0,465047,140563,47358,60598,1.3020397198858795,0.3012412942866659
21441,0.5611666666666667,1,8,1,465055,140555,47359,60597,1.301965615621179,0.3012498011454025
21442,0.5611785714285714,0,1,0,465056,140554,47359,60597,1.3019563525880915,0.30125129877554674
21443,0.5611904761904762,1,3,1,465059,140551,47360,60596,1.3019285634888287,0.30125231795651936
21444,0.5612380952380953,1,1,1,465060,140550,47361,60595,1.3019193004557412,0.30125034179323373
21445,0.56125,0,4,0,465064,140546,47361,60595,1.301882248323391,0.30125633262238927
21446,0.5612658730158728,1,0,1,465064,140546,47362,60594,1.301882248323391,0.3012528587053793
21447,0.5613095238095238,1,1,1,465065,140545,47363,60593,1.3018729852903035,0.3012508824786962
21448,0.5613214285714285,0,1,0,465066,140544,47363,60593,1.3018637222572158,0.30125238021845807
21449,0.5613333333333332,0,3,0,465069,140541,47363,60593,1.3018359331579532,0.30125687352710134
21450,0.5613333333333334,2,31,2,465100,140510,47365,60591,1.301548779132239,0.3012963635188288
21451,0.5613333333333335,0,1,0,465101,140509,47365,60591,1.3015395160991514,0.30129786176031825
21452,0.5613452380952382,1,0,1,465101,140509,47366,60590,1.3015395160991514,0.3012943873415581
21453,0.5613492063492064,0,1,0,465102,140508,47366,60590,1.301530253066064,0.3012958855881212
21454,0.5613571428571429,0,1,0,465103,140507,47366,60590,1.3015209900329765,0.30129738384958504
21455,0.5613636363636364,0,1,0,465104,140506,47366,60590,1.3015117269998888,0.3012988821259498
21456,0.5614047619047617,0,2,0,465106,140504,47366,60590,1.3014932009337137,0.3013018787233831
21457,0.5614166666666667,2,4,2,465110,140500,47368,60588,1.3014561488013636,0.30130092297899425
21458,0.5614285714285714,0,3,0,465113,140497,47368,60588,1.3014283597021008,0.30130541810677075
21459,0.5614285714285715,0,3,0,465116,140494,47368,60588,1.3014005706028382,0.30130991336867546
21460,0.5615,11,15,11,465131,140479,47379,60577,1.301261625106525,0.3012941667992997
21461,0.5615000000000001,1,2,1,465133,140477,47380,60576,1.3012430990403498,0.30129368872884266
21462,0.5615079365079364,0,2,0,465135,140475,47380,60576,1.3012245729741747,0.30129668591551395
21463,0.5615476190476191,0,2,0,465137,140473,47380,60576,1.3012060469079996,0.30129968316181627
21464,0.5615833333333333,1,0,1,465137,140473,47381,60575,1.3012060469079996,0.3012962078707572
21465,0.5615952380952381,0,2,0,465139,140471,47381,60575,1.3011875208418244,0.30129920515702874
21466,0.5616071428571429,0,2,0,465141,140469,47381,60575,1.3011689947756493,0.30130220250293466
21467,0.5616190476190477,0,1,0,465142,140468,47381,60575,1.3011597317425618,0.3013037011982511
21468,0.5616666666666665,1,1,1,465143,140467,47382,60574,1.3011504687094742,0.30130172452385334
21469,0.5616666666666666,39,197,39,465340,140270,47421,60535,1.2993256511912261,0.3014616169916088
21470,0.5616666666666668,23,109,23,465449,140161,47444,60512,1.2983159805846827,0.30154530006528035
21471,0.5616904761904762,0,2,0,465451,140159,47444,60512,1.2982974545185075,0.3015483054352647
21472,0.5617619047619048,0,2,0,465453,140157,47444,60512,1.2982789284523324,0.3015513108651561
21473,0.5617738095238096,0,1,0,465454,140156,47444,60512,1.298269665419245,0.3015528136025674
21474,0.5617777777777778,0,2,0,465456,140154,47444,60512,1.2982511393530698,0.30155581912232265
21475,0.5617857142857143,0,4,0,465460,140150,47444,60512,1.2982140872207195,0.3015618303415694
21476,0.5618333333333333,3,5,3,465465,140145,47447,60509,1.2981677720552818,0.30155890238918737
21477,0.5618333333333334,2,9,2,465474,140136,47449,60507,1.2980844047574938,0.3015654670235194
21478,0.5618571428571428,1,0,1,465474,140136,47450,60506,1.2980844047574938,0.3015619860248602
21479,0.5618730158730159,0,3,0,465477,140133,47450,60506,1.2980566156582312,0.3015664950483206
21480,0.5618809523809524,1,0,1,465477,140133,47451,60505,1.2980566156582312,0.3015630139853866
21481,0.5619047619047619,0,2,0,465479,140131,47451,60505,1.298038089592056,0.30156602005622124
21482,0.5619285714285714,0,1,0,465480,140130,47451,60505,1.2980288265589686,0.30156752311411267
21483,0.5619285714285716,0,1,0,465481,140129,47451,60505,1.2980195635258809,0.3015690261869873
21484,0.5619444444444444,1,3,1,465484,140126,47452,60504,1.2979917744266183,0.3015700543288641
21485,0.5619444444444445,1,1,1,465485,140125,47453,60503,1.2979825113935306,0.3015680762406045
21486,0.561952380952381,0,1,0,465486,140124,47453,60503,1.2979732483604431,0.3015695793686792
21487,0.5619999999999998,1,2,1,465488,140122,47454,60502,1.297954722294268,0.3015691043942898
21488,0.5619999999999999,1,5,1,465493,140117,47455,60501,1.2979084071288303,0.3015731390004885
21489,0.562,15,55,15,465548,140062,47470,60486,1.2973989403090147,0.3016036061192333
21490,0.5620238095238095,0,1,0,465549,140061,47470,60486,1.2973896772759272,0.30160511002408413
21491,0.5620515873015873,0,1,0,465550,140060,47470,60486,1.2973804142428398,0.30160661394393307
21492,0.5620595238095238,0,2,0,465552,140058,47470,60486,1.2973618881766646,0.30160962182862616
21493,0.5620714285714286,0,1,0,465553,140057,47470,60486,1.297352625143577,0.3016111257934707
21494,0.5620833333333333,1,0,1,465553,140057,47471,60485,1.297352625143577,0.30160764328669304
21495,0.5620833333333334,0,2,0,465555,140055,47471,60485,1.2973340990774018,0.30161065124164754
21496,0.5621111111111111,0,1,0,465556,140054,47471,60485,1.2973248360443144,0.3016121552416238
21497,0.5621153846153846,0,1,0,465557,140053,47471,60485,1.2973155730112267,0.3016136592565997
21498,0.5621190476190477,1,2,1,465559,140051,47472,60484,1.2972970469450518,0.301613184730845
21499,0.5621428571428572,1,4,1,465563,140047,47473,60483,1.2972599948127015,0.30161571834638207
21500,0.5621666666666666,1,7,1,465570,140040,47474,60482,1.2971951535810886,0.3016227645844346
21501,0.5621666666666667,2,15,2,465585,140025,47476,60480,1.2970562080847752,0.30163836313308895
21502,0.5621904761904762,0,1,0,465586,140024,47476,60480,1.2970469450516877,0.3016398675338148
21503,0.5622142857142858,0,1,0,465587,140023,47476,60480,1.2970376820186003,0.3016413719495469
21504,0.5622222222222222,1,2,1,465589,140021,47477,60479,1.2970191559524251,0.301640897755611
21505,0.56225,0,1,0,465590,140020,47477,60479,1.2970098929193374,0.3016424022064948
21506,0.5622539682539681,1,0,1,465590,140020,47478,60478,1.2970098929193374,0.30163891909146223
21507,0.5622619047619046,1,1,1,465591,140019,47479,60477,1.29700062988625,0.30163694038783817
21508,0.5622857142857143,2,1,2,465592,140018,47481,60475,1.2969913668531623,0.3016314784057299
21509,0.5623095238095238,0,1,0,465593,140017,47481,60475,1.2969821038200748,0.3016329828621591
21510,0.5623333333333332,1,11,1,465604,140006,47482,60474,1.2968802104561117,0.301646049481245
21511,0.5623333333333334,3,10,3,465614,139996,47485,60471,1.2967875801252362,0.30165064574219197
21512,0.5623333333333335,1,3,1,465617,139993,47486,60470,1.2967597910259736,0.3016516763692053
21513,0.5623611111111111,0,1,0,465618,139992,47486,60470,1.296750527992886,0.30165318115153994
21514,0.5623809523809523,0,2,0,465620,139990,47486,60470,1.2967320019267108,0.3016561907612491
21515,0.5623809523809524,0,2,0,465622,139988,47486,60470,1.2967134758605359,0.30165920043101296
21516,0.5624444444444444,1,0,1,465622,139988,47487,60469,1.2967134758605359,0.30165571668736935
21517,0.5624761904761906,2,2,2,465624,139986,47489,60467,1.2966949497943607,0.3016517587663941
21518,0.5624880952380953,0,1,0,465625,139985,47489,60467,1.296685686761273,0.3016532636242093
21519,0.5624999999999999,1,8,1,465633,139977,47490,60466,1.2966115824965727,0.3016618190707583
21520,0.5625,71,221,71,465854,139756,47561,60395,1.2945644521842232,0.30174718087843677
21521,0.5625000000000001,0,6,0,465860,139750,47561,60395,1.2945088739856978,0.3017562267356167
21522,0.5625238095238094,1,0,1,465860,139750,47562,60394,1.2945088739856978,0.3017527380286194
21523,0.5625238095238095,0,1,0,465861,139749,47562,60394,1.2944996109526103,0.30175424571431425
21524,0.5625476190476192,0,1,0,465862,139748,47562,60394,1.2944903479195227,0.3017557534150753
21525,0.562579365079365,0,2,0,465864,139746,47562,60394,1.2944718218533477,0.30175876886179676
21526,0.5625952380952381,0,1,0,465865,139745,47562,60394,1.29446255882026,0.3017602766077576
21527,0.5626190476190476,0,3,0,465868,139742,47562,60394,1.2944347697209975,0.3017647999360435
21528,0.5626190476190477,1,2,1,465870,139740,47563,60393,1.2944162436548223,0.3017643267227294
21529,0.5626666666666665,3,0,3,465870,139740,47566,60390,1.2944162436548223,0.30175385999100585
21530,0.5626666666666666,9,25,9,465895,139715,47575,60381,1.2941846678276334,0.3017601551255397
21531,0.5626666666666668,3,14,3,465909,139701,47578,60378,1.2940549853644077,0.30177080053378913
21532,0.5626904761904761,0,3,0,465912,139698,47578,60378,1.294027196265145,0.301775325376357
21533,0.5626984126984127,0,1,0,465913,139697,47578,60378,1.2940179332320576,0.30177683368736724
21534,0.5627142857142857,0,1,0,465914,139696,47578,60378,1.29400867019897,0.30177834201345505
21535,0.5627272727272727,1,0,1,465914,139696,47579,60377,1.29400867019897,0.30177485217895467
21536,0.5627380952380951,0,1,0,465915,139695,47579,60377,1.2939994071658825,0.30177636051021633
21537,0.5627500000000001,1,0,1,465915,139695,47580,60376,1.2939994071658825,0.301772870630926
21538,0.5627777777777777,0,1,0,465916,139694,47580,60376,1.2939901441327948,0.3017743789673614
21539,0.5627777777777778,1,0,1,465916,139694,47581,60375,1.2939901441327948,0.3017708890432801
21540,0.5627850877192982,2,0,2,465916,139694,47583,60373,1.2939901441327948,0.3017639090904547
21541,0.5627857142857143,0,1,0,465917,139693,47583,60373,1.2939808810997073,0.30176541741225393
21542,0.5628333333333333,0,11,0,465928,139682,47583,60373,1.2938789877357442,0.3017820099472645
21543,0.5628333333333334,2,1,2,465929,139681,47585,60371,1.2938697247026567,0.30177653810009397
21544,0.5628571428571427,0,1,0,465930,139680,47585,60371,1.293860461669569,0.30177804659811747
21545,0.5628571428571428,2,13,2,465943,139667,47587,60369,1.293740042239431,0.301790677678018
21546,0.5628888888888889,0,2,0,465945,139665,47587,60369,1.2937215161732558,0.3017936950718378
21547,0.562888888888889,0,1,0,465946,139664,47587,60369,1.2937122531401681,0.3017952037913744
21548,0.5629166666666666,1,1,1,465947,139663,47588,60368,1.2937029901070807,0.3017932220505822
21549,0.5629545454545455,0,1,0,465948,139662,47588,60368,1.2936937270739932,0.30179473079038144
21550,0.5629642857142857,0,2,0,465950,139660,47588,60368,1.293675201007818,0.30179774831523587
21551,0.5629740259740259,1,2,1,465952,139658,47589,60367,1.293656674941643,0.3017972753405824
21552,0.563,5,35,5,465987,139623,47594,60362,1.2933324687835785,0.3018326374478086
21553,0.5630000000000001,3,4,3,465991,139619,47597,60359,1.2932954166512283,0.3018282011021212
21554,0.5630000000000002,0,1,0,465992,139618,47597,60359,1.2932861536181408,0.3018297104166979
21555,0.5630238095238095,0,1,0,465993,139617,47597,60359,1.2932768905850531,0.30183121974636956
21556,0.5630238095238096,0,2,0,465995,139615,47597,60359,1.293258364518878,0.3018342384509986
21557,0.5630357142857143,0,1,0,465996,139614,47597,60359,1.2932491014857905,0.3018357478259565
21558,0.563047619047619,1,0,1,465996,139614,47598,60358,1.2932491014857905,0.3018322565159122
21559,0.5630952380952381,0,6,0,466002,139608,47598,60358,1.2931935232872651,0.30184131302321393
21560,0.5631111111111111,0,1,0,466003,139607,47598,60358,1.2931842602541777,0.30184282249393646
21561,0.5631428571428572,0,1,0,466004,139606,47598,60358,1.29317499722109,0.30184433197975635
21562,0.5631666666666666,3,9,3,466013,139597,47601,60355,1.2930916299233022,0.30184744338641273
21563,0.5631666666666667,1,5,1,466018,139592,47602,60354,1.2930453147578642,0.30185149990497434
21564,0.5631818181818182,0,2,0,466020,139590,47602,60354,1.2930267886916893,0.3018545192653943
21565,0.5631904761904761,0,1,0,466021,139589,47602,60354,1.2930175256586016,0.301856028968256
21566,0.5632023809523811,0,1,0,466022,139588,47602,60354,1.2930082626255142,0.301857538686219
21567,0.5632142857142857,1,4,1,466026,139584,47603,60353,1.2929712104931639,0.30186008592706703
21568,0.5632142857142858,1,0,1,466026,139584,47604,60352,1.2929712104931639,0.30185659411011523
21569,0.5632601010101009,0,1,0,466027,139583,47604,60352,1.2929619474600764,0.3018581038837622
21570,0.5632619047619049,1,0,1,466027,139583,47605,60351,1.2929619474600764,0.30185461202196723
21571,0.5632738095238096,0,1,0,466028,139582,47605,60351,1.2929526844269887,0.3018561218008033
21572,0.5633333333333332,35,197,35,466225,139385,47640,60316,1.2911278669087407,0.3020315371480363
21573,0.5633333333333334,61,284,61,466509,139101,47701,60255,1.288497165511875,0.30224823933064465
21574,0.5633333333333335,1,4,1,466513,139097,47702,60254,1.288460113379525,0.3022508038585209
21575,0.5633571428571429,0,1,0,466514,139096,47702,60254,1.2884508503464374,0.3022523200401304
21576,0.5633690476190476,0,3,0,466517,139093,47702,60254,1.2884230612471748,0.30225686867622786
21577,0.5633809523809524,1,1,1,466518,139092,47703,60253,1.2884137982140873,0.30225488474754825
21578,0.5634206349206349,0,2,0,466520,139090,47703,60253,1.2883952721479122,0.3022579172581932
21579,0.5634285714285714,0,1,0,466521,139089,47703,60253,1.2883860091148245,0.30225943353633455
21580,0.563452380952381,1,0,1,466521,139089,47704,60252,1.2883860091148245,0.30225593330022427
21581,0.5634761904761905,0,1,0,466522,139088,47704,60252,1.288376746081737,0.302257449583626
21582,0.5634999999999999,0,2,0,466524,139086,47704,60252,1.2883582200155619,0.302260482196069
21583,0.5635,5,17,5,466541,139069,47709,60247,1.2882007484530735,0.30226875915631457
21584,0.5635000000000001,0,1,0,466542,139068,47709,60247,1.2881914854199858,0.3022702756942528
21585,0.5635238095238095,0,5,0,466547,139063,47709,60247,1.288145170254548,0.3022778586122121
21586,0.5635714285714285,0,2,0,466549,139061,47709,60247,1.288126644188373,0.30228089188592533
21587,0.5635714285714286,1,1,1,466550,139060,47710,60246,1.2881173811552855,0.302278907810101
21588,0.5635833333333333,0,3,0,466553,139057,47710,60246,1.288089592056023,0.3022834578506094
21589,0.5635873015873016,0,1,0,466554,139056,47710,60246,1.2880803290229352,0.30228497456121867
21590,0.5636071428571429,0,1,0,466555,139055,47710,60246,1.2880710659898478,0.3022864912870482
21591,0.563611111111111,1,1,1,466556,139054,47711,60245,1.28806180295676,0.30228450719772804
21592,0.5636666666666666,0,10,0,466566,139044,47711,60245,1.2879691726258846,0.3022996753458545
21593,0.5636666666666668,1,0,1,466566,139044,47712,60244,1.2879691726258846,0.30229617438079565
21594,0.5637388167388169,0,1,0,466567,139043,47712,60244,1.2879599095927972,0.30229769126937533
21595,0.5637460317460317,0,1,0,466568,139042,47712,60244,1.2879506465597095,0.30229920817317824
21596,0.56375,2,4,2,466572,139038,47714,60242,1.2879135944273592,0.30229827378562824
21597,0.5637500000000001,0,1,0,466573,139037,47714,60242,1.2879043313942717,0.302299790745638
21598,0.5637698412698413,0,1,0,466574,139036,47714,60242,1.2878950683611843,0.3023013077208723
21599,0.5638095238095238,1,5,1,466579,139031,47715,60241,1.2878487531957463,0.3023053916255169
21600,0.5638095238095239,0,1,0,466580,139030,47715,60241,1.2878394901626589,0.30230690868214644
21601,0.5638333333333333,1,12,1,466592,139018,47716,60240,1.2877283337656082,0.302321613184916
21602,0.5638333333333334,0,3,0,466595,139015,47716,60240,1.2877005446663456,0.3023261649644927
21603,0.5638571428571428,1,3,1,466598,139012,47717,60239,1.2876727555670828,0.30232721542175445
21604,0.5638888888888889,0,3,0,466601,139009,47717,60239,1.2876449664678202,0.3023317674455954
21605,0.5639285714285714,1,1,1,466602,139008,47718,60238,1.2876357034347328,0.3023297832829768
21606,0.5639444444444444,1,0,1,466602,139008,47719,60237,1.2876357034347328,0.30232628171346837
21607,0.563952380952381,0,2,0,466604,139006,47719,60237,1.2876171773685576,0.30232931646281175
21608,0.5639761904761905,1,1,1,466605,139005,47720,60236,1.28760791433547,0.3023273322257969
21609,0.564,21,88,21,466693,138917,47741,60215,1.2867927674237651,0.30238736114737963
21610,0.5640000000000001,2,4,2,466697,138913,47743,60213,1.286755715291415,0.3023864286933901
21611,0.564047619047619,2,6,2,466703,138907,47745,60211,1.2867001370928897,0.30238853343243705
21612,0.5640952380952381,0,1,0,466704,138906,47745,60211,1.2866908740598022,0.3023900520799329
21613,0.5640952380952382,0,1,0,466705,138905,47745,60211,1.2866816110267145,0.30239157074268264
21614,0.5641349206349207,0,1,0,466706,138904,47745,60211,1.286672347993627,0.30239308942068654
21615,0.5641666666666666,16,59,16,466765,138845,47761,60195,1.2861258290414614,0.30242664790996787
21616,0.5641666666666667,6,45,6,466810,138800,47767,60189,1.2857089925525214,0.30247400610083974
21617,0.5641904761904762,0,1,0,466811,138799,47767,60189,1.285699729519434,0.30247552616238166
21618,0.5642023809523811,1,4,1,466815,138795,47768,60188,1.2856626773870836,0.30247810114431883
21619,0.5642085137085137,0,3,0,466818,138792,47768,60188,1.285634888287821,0.30248266157402753
21620,0.564218253968254,0,1,0,466819,138791,47768,60188,1.2856256252547333,0.30248418174782266
21621,0.5642380952380952,0,2,0,466821,138789,47768,60188,1.2856070991885582,0.3024872221412525
21622,0.5642499999999999,0,1,0,466822,138788,47768,60188,1.2855978361554707,0.30248874236088774
21623,0.5642857142857143,3,17,3,466839,138771,47771,60185,1.2854403645929824,0.3025040712519351
21624,0.5643095238095238,0,2,0,466841,138769,47771,60185,1.2854218385268072,0.3025071121967892
21625,0.5643333333333334,7,25,7,466866,138744,47778,60178,1.2851902626996183,0.3025205859583153
21626,0.5643333333333335,0,3,0,466869,138741,47778,60178,1.2851624736003557,0.30252514842724926
21627,0.5643730158730159,1,0,1,466869,138741,47779,60177,1.2851624736003557,0.30252164208367266
21628,0.5643809523809523,0,2,0,466871,138739,47779,60177,1.2851439475341806,0.3025246837861208
21629,0.564404761904762,0,2,0,466873,138737,47779,60177,1.2851254214680055,0.30252772554973506
21630,0.5644166666666667,2,0,2,466873,138737,47781,60175,1.2851254214680055,0.3025207126769627
21631,0.5644404761904762,0,1,0,466874,138736,47781,60175,1.285116158434918,0.3025222335617437
21632,0.5644523809523809,0,1,0,466875,138735,47781,60175,1.2851068954018303,0.3025237544618169
21633,0.5644722222222222,0,1,0,466876,138734,47781,60175,1.2850976323687429,0.30252527537718255
21634,0.5644761904761904,0,1,0,466877,138733,47781,60175,1.2850883693356552,0.3025267963078408
21635,0.5644999999999999,0,1,0,466878,138732,47781,60175,1.2850791063025677,0.302528317253792
21636,0.5645,3,14,3,466892,138718,47784,60172,1.284949423839342,0.3025390919603801
21637,0.5645000000000001,0,2,0,466894,138716,47784,60172,1.2849308977731668,0.3025421342665219
21638,0.5645238095238094,0,1,0,466895,138715,47784,60172,1.2849216347400794,0.3025436554425377
21639,0.5645238095238095,0,1,0,466896,138714,47784,60172,1.2849123717069917,0.30254517663385055
21640,0.564563492063492,1,0,1,466896,138714,47785,60171,1.2849123717069917,0.30254166980918623
21641,0.5645714285714285,0,1,0,466897,138713,47785,60171,1.2849031086739042,0.30254319100581245
21642,0.5645793650793651,1,2,1,466899,138711,47786,60170,1.284884582607729,0.30254272655507564
21643,0.5645833333333333,0,1,0,466900,138710,47786,60170,1.2848753195746416,0.30254424778761063
21644,0.5646125541125541,0,1,0,466901,138709,47786,60170,1.284866056541554,0.30254576903544367
21645,0.5646190476190476,0,2,0,466903,138707,47786,60170,1.2848475304753788,0.30254881157700486
21646,0.5646428571428571,0,3,0,466906,138704,47786,60170,1.2848197413761162,0.302553375504088
21647,0.5646666666666665,0,1,0,466907,138703,47786,60170,1.2848104783430288,0.30255489684371434
21648,0.5646666666666667,1,14,1,466921,138689,47787,60169,1.2846807958798028,0.302572690060244
21649,0.5646666666666668,0,2,0,466923,138687,47787,60169,1.2846622698136279,0.30257573319386893
21650,0.5646904761904762,0,2,0,466925,138685,47787,60169,1.2846437437474527,0.3025787763887073
21651,0.5647142857142857,0,1,0,466926,138684,47787,60169,1.284634480714365,0.3025802980090821
21652,0.5647222222222222,0,2,0,466928,138682,47787,60169,1.28461595464819,0.30258334129574405
21653,0.5647619047619048,0,3,0,466931,138679,47787,60169,1.2845881655489273,0.3025879063405214
21654,0.5647777777777777,0,1,0,466932,138678,47787,60169,1.2845789025158398,0.30258942805272393
21655,0.5647857142857142,0,1,0,466933,138677,47787,60169,1.2845696394827522,0.30259094978023193
21656,0.5648095238095238,0,1,0,466934,138676,47787,60169,1.2845603764496647,0.3025924715230456
21657,0.5648174603174604,0,4,0,466938,138672,47787,60169,1.2845233243173144,0.30259855864736146
21658,0.5648333333333333,3,10,3,466948,138662,47790,60166,1.284430693986439,0.30260325507473795
21659,0.5648333333333334,0,1,0,466949,138661,47790,60166,1.2844214309533513,0.3026047770172059
21660,0.5648333333333335,0,1,0,466950,138660,47790,60166,1.2844121679202638,0.30260629897498315
21661,0.5648571428571428,1,1,1,466951,138659,47791,60165,1.2844029048871763,0.30260431336257193
21662,0.564860028860029,0,1,0,466952,138658,47791,60165,1.2843936418540887,0.3026058353409817
21663,0.5648809523809524,0,5,0,466957,138653,47791,60165,1.284347326688651,0.3026134454626845
21664,0.5648939393939394,0,1,0,466958,138652,47791,60165,1.2843380636555635,0.30261496753295747
21665,0.5649047619047619,0,2,0,466960,138650,47791,60165,1.2843195375893883,0.30261801171943764
21666,0.5649761904761905,0,1,0,466961,138649,47791,60165,1.2843102745563006,0.3026195338356454
21667,0.565,186,888,186,467849,137761,47977,59979,1.2760847011745526,0.3033225447557399
21668,0.5650000000000001,7,17,7,467866,137744,47984,59972,1.2759272296120643,0.3033239596188472
21669,0.5650238095238095,0,1,0,467867,137743,47984,59972,1.2759179665789766,0.30332549376627976
21670,0.5650476190476189,0,1,0,467868,137742,47984,59972,1.2759087035458891,0.3033270279292311
21671,0.565047619047619,0,1,0,467869,137741,47984,59972,1.2758994405128015,0.3033285621077016
21672,0.5650833333333333,1,2,1,467871,137739,47985,59971,1.2758809144466263,0.3033281068231248
21673,0.5650833333333334,1,1,1,467872,137738,47986,59970,1.2758716514135389,0.30332611730430736
21674,0.5650873015873017,0,1,0,467873,137737,47986,59970,1.2758623883804512,0.30332765152473107
21675,0.565111111111111,0,1,0,467874,137736,47986,59970,1.2758531253473637,0.30332918576067497
21676,0.5651190476190476,0,2,0,467876,137734,47986,59970,1.2758345992811886,0.30333225427912436
21677,0.565142857142857,0,4,0,467880,137730,47986,59970,1.2757975471488383,0.30333839150227615
21678,0.5651666666666666,0,1,0,467881,137729,47986,59970,1.2757882841157508,0.3033399258468682
21679,0.5651666666666667,3,13,3,467894,137716,47989,59967,1.2756678646856126,0.30334930165972795
21680,0.5651904761904762,0,1,0,467895,137715,47989,59967,1.275658601652525,0.30335083619145903
21681,0.5652380952380952,2,6,2,467901,137709,47991,59965,1.2756030234539997,0.3033529953357548
21682,0.56525,0,2,0,467903,137707,47991,59965,1.2755844973878248,0.3033560645918491
21683,0.5652575757575758,0,1,0,467904,137706,47991,59965,1.275575234354737,0.3033575992431869
21684,0.5652619047619047,0,2,0,467906,137704,47991,59965,1.275556708288562,0.3033606685924449
21685,0.5652857142857142,0,4,0,467910,137700,47991,59965,1.2755196561562119,0.30336680747729744
21686,0.5652857142857143,0,1,0,467911,137699,47991,59965,1.2755103931231242,0.30336834223733206
21687,0.5653333333333331,0,4,0,467915,137695,47991,59965,1.275473340990774,0.30337448143276335
21688,0.5653333333333332,0,1,0,467916,137694,47991,59965,1.2754640779576865,0.3033760162704456
21689,0.5653333333333334,5,23,5,467939,137671,47996,59960,1.2752510281966727,0.3033936983570391
21690,0.5653571428571429,0,4,0,467943,137667,47996,59960,1.2752139760643224,0.3033998390908125
21691,0.5653809523809524,0,1,0,467944,137666,47996,59960,1.275204713031235,0.30340137431309644
21692,0.5654047619047619,0,2,0,467946,137664,47996,59960,1.2751861869650598,0.3034044448042748
21693,0.5654166666666667,0,3,0,467949,137661,47996,59960,1.2751583978657972,0.30340905065757184
21694,0.5654444444444444,1,0,1,467949,137661,47997,59959,1.2751583978657972,0.30340552575650237
21695,0.5654523809523809,2,1,2,467950,137660,47999,59957,1.2751491348327095,0.3034000111326455
21696,0.5654545454545454,0,1,0,467951,137659,47999,59957,1.275139871799622,0.30340154643348716
21697,0.5654761904761905,1,4,1,467955,137655,48000,59956,1.2751028196672718,0.303404162723735
21698,0.5655,1,15,1,467970,137640,48001,59955,1.2749638741709586,0.3034236696272679
21699,0.5655000000000001,0,1,0,467971,137639,48001,59955,1.274954611137871,0.30342520521878197
21700,0.5655079365079365,0,1,0,467972,137638,48001,59955,1.2749453481047834,0.303426740825839
21701,0.5655238095238095,0,2,0,467974,137636,48001,59955,1.2749268220386083,0.3034298120865829
21702,0.5655555555555555,0,1,0,467975,137635,48001,59955,1.2749175590055208,0.30343134774027025
21703,0.5655555555555556,0,1,0,467976,137634,48001,59955,1.2749082959724332,0.30343288340950153
21704,0.5655714285714286,1,0,1,467976,137634,48002,59954,1.2749082959724332,0.30342935805818166
21705,0.5655833333333333,0,2,0,467978,137632,48002,59954,1.274889769906258,0.30343242942313725
21706,0.5655952380952382,0,1,0,467979,137631,48002,59954,1.2748805068731706,0.30343396512893184
21707,0.5656666666666667,1,21,1,468000,137610,48003,59953,1.274685983178332,0.3034626929131467
21708,0.5657142857142857,3,8,3,468008,137602,48006,59950,1.2746118789136314,0.30346440430873894
21709,0.5657380952380953,0,2,0,468010,137600,48006,59950,1.2745933528474565,0.3034674765882055
21710,0.5657619047619048,0,1,0,468011,137599,48006,59950,1.2745840898143688,0.30346901275126675
21711,0.5657857142857143,0,2,0,468013,137597,48006,59950,1.2745655637481936,0.30347208512404644
21712,0.5658333333333333,8,41,8,468054,137556,48014,59942,1.274185779391604,0.30350687095565526
21713,0.5658333333333334,10,58,10,468112,137498,48024,59932,1.2736485234725259,0.30356075571088487
21714,0.5658452380952379,1,1,1,468113,137497,48025,59931,1.2736392604394382,0.3035587657272525
21715,0.5658571428571428,0,2,0,468115,137495,48025,59931,1.2736207343732633,0.3035618408922837
21716,0.5658809523809524,0,4,0,468119,137491,48025,59931,1.273583682240913,0.30356799140926544
21717,0.5659166666666667,0,2,0,468121,137489,48025,59931,1.2735651561747379,0.30357106676121975
21718,0.5659285714285714,0,1,0,468122,137488,48025,59931,1.2735558931416504,0.30357260446056356
21719,0.565952380952381,0,3,0,468125,137485,48025,59931,1.2735281040423876,0.3035772176520647
21720,0.5659999999999998,0,1,0,468126,137484,48025,59931,1.2735188410093001,0.30357875541372237
21721,0.566,0,7,0,468133,137477,48025,59931,1.2734539997776873,0.30358952018155294
21722,0.5660000000000001,14,98,14,468231,137379,48039,59917,1.272546222535107,0.3036909009812667
21723,0.5660238095238095,0,1,0,468232,137378,48039,59917,1.2725369595020193,0.3036924402544413
21724,0.566041847041847,0,1,0,468233,137377,48039,59917,1.2725276964689318,0.30369397954321975
21725,0.5660555555555556,0,1,0,468234,137376,48039,59917,1.2725184334358441,0.3036955188476023
21726,0.5660714285714286,0,3,0,468237,137373,48039,59917,1.2724906443365815,0.3037001368543768
21727,0.5660833333333333,0,1,0,468238,137372,48039,59917,1.272481381303494,0.30370167622117805
21728,0.5661111111111111,0,1,0,468239,137371,48039,59917,1.2724721182704064,0.3037032156035846
21729,0.5661428571428572,0,1,0,468240,137370,48039,59917,1.272462855237319,0.30370475500159666
21730,0.5661666666666666,0,1,0,468241,137369,48039,59917,1.2724535922042313,0.30370629441521446
21731,0.5661666666666667,1,9,1,468250,137360,48040,59916,1.2723702249064435,0.30371662036943164
21732,0.5661904761904761,0,1,0,468251,137359,48040,59916,1.2723609618733558,0.30371815992903306
21733,0.5661904761904762,0,2,0,468253,137357,48040,59916,1.2723424358071806,0.30372123909506116
21734,0.5662499999999999,0,2,0,468255,137355,48040,59916,1.2723239097410055,0.3037243183235245
21735,0.56625,0,3,0,468258,137352,48040,59916,1.272296120641743,0.30372893728328976
21736,0.5662619047619047,0,1,0,468259,137351,48040,59916,1.2722868576086555,0.3037304769677645
21737,0.5662619047619049,1,2,1,468261,137349,48041,59915,1.2722683315424803,0.30373002676616107
21738,0.5662698412698413,0,1,0,468262,137348,48041,59915,1.2722590685093926,0.3037315664873798
21739,0.5662850482850483,1,0,1,468262,137348,48042,59914,1.2722590685093926,0.30372803682412225
21740,0.5663095238095238,0,2,0,468264,137346,48042,59914,1.2722405424432177,0.3037311162932171
21741,0.5663333333333332,1,2,1,468266,137344,48043,59913,1.2722220163770426,0.3037306660853607
21742,0.5663333333333334,5,11,5,468277,137333,48048,59908,1.2721201230130794,0.3037299547254374
21743,0.5663571428571428,1,0,1,468277,137333,48049,59907,1.2721201230130794,0.3037264246603123
21744,0.5663809523809524,0,1,0,468278,137332,48049,59907,1.272110859979992,0.30372796455062134
21745,0.5664166666666667,1,0,1,468278,137332,48050,59906,1.272110859979992,0.303724434439611
21746,0.5664285714285713,0,1,0,468279,137331,48050,59906,1.2721015969469043,0.3037259743354442
21747,0.5664285714285714,0,2,0,468281,137329,48050,59906,1.2720830708807291,0.3037290541739549
21748,0.5664920634920635,1,1,1,468282,137328,48051,59905,1.2720738078476417,0.30372706392946414
21749,0.5664999999999999,0,3,0,468285,137325,48051,59905,1.2720460187483789,0.30373168382091975
21750,0.5665,3,22,3,468307,137303,48054,59902,1.2718422320204528,0.303754975786618
21751,0.5665367965367966,0,1,0,468308,137302,48054,59902,1.2718329689873653,0.3037565160950082
21752,0.5665396825396826,0,1,0,468309,137301,48054,59902,1.2718237059542776,0.30375805641902
21753,0.5665476190476191,0,3,0,468312,137298,48054,59902,1.271795916855015,0.303762677484787
21754,0.5665714285714286,0,1,0,468313,137297,48054,59902,1.2717866538219273,0.3037642178712874
21755,0.5666190476190476,0,1,0,468314,137296,48054,59902,1.27177739078884,0.30376575827341046
21756,0.5666428571428572,0,2,0,468316,137294,48054,59902,1.2717588647226648,0.30376883912452585
21757,0.5666666666666665,1,7,1,468323,137287,48055,59901,1.2716940234910519,0.3037760918514311
21758,0.5666666666666667,71,330,71,468653,136957,48126,59830,1.268637222572159,0.3040343112095819
21759,0.5666666666666668,40,169,40,468822,136788,48166,59790,1.2670717699803624,0.30415407624454416
21760,0.5666785714285714,0,1,0,468823,136787,48166,59790,1.2670625069472747,0.3041556234961364
21761,0.5666880994822169,1,0,1,468823,136787,48167,59789,1.2670625069472747,0.3041520836724727
21762,0.5666904761904762,0,1,0,468824,136786,48167,59789,1.2670532439141873,0.3041536309296706
21763,0.5667142857142857,0,2,0,468826,136784,48167,59789,1.2670347178480121,0.3041567254912933
21764,0.5667500000000001,0,1,0,468827,136783,48167,59789,1.2670254548149247,0.3041582727957186
21765,0.5667738095238095,0,1,0,468828,136782,48167,59789,1.267016191781837,0.3041598201158869
21766,0.5667857142857142,0,1,0,468829,136781,48167,59789,1.2670069287487495,0.30416136745179834
21767,0.5667857142857143,1,7,1,468836,136774,48168,59788,1.2669420875171367,0.3041686592525514
21768,0.5667976190476189,1,0,1,468836,136774,48169,59787,1.2669420875171367,0.30416511922507516
21769,0.5668095238095238,0,2,0,468838,136772,48169,59787,1.2669235614509615,0.30416821412400347
21770,0.5668095238095239,1,0,1,468838,136772,48170,59786,1.2669235614509615,0.3041646740402324
21771,0.5668333333333332,0,1,0,468839,136771,48170,59786,1.2669142984178738,0.3041662215031772
21772,0.5668333333333333,3,2,3,468841,136769,48173,59783,1.266895772351699,0.3041586959176198
21773,0.5668333333333334,1,4,1,468845,136765,48174,59782,1.2668587202193486,0.3041613456323424
21774,0.566857142857143,0,1,0,468846,136764,48174,59782,1.266849457186261,0.3041628931649588
21775,0.5668888888888888,0,1,0,468847,136763,48174,59782,1.2668401941531735,0.30416444071332266
21776,0.5669047619047619,1,0,1,468847,136763,48175,59781,1.2668401941531735,0.3041609003581895
21777,0.5669166666666667,0,3,0,468850,136760,48175,59781,1.266812405053911,0.30416554306734983
21778,0.5669523809523809,0,2,0,468852,136758,48175,59781,1.2667938789877358,0.3041686382855311
21779,0.5669761904761905,0,1,0,468853,136757,48175,59781,1.266784615954648,0.3041701859182448
21780,0.567,0,7,0,468860,136750,48175,59781,1.2667197747230352,0.3041810197882268
21781,0.5670000000000001,9,21,9,468881,136729,48184,59772,1.2665252510281966,0.30418165810861014
21782,0.5670238095238095,0,2,0,468883,136727,48184,59772,1.2665067249620217,0.30418475412088614
21783,0.5670436507936507,1,0,1,468883,136727,48185,59771,1.2665067249620217,0.3041812130403363
21784,0.5670476190476191,1,0,1,468883,136727,48186,59770,1.2665067249620217,0.3041776719237444
21785,0.5670952380952381,0,2,0,468885,136725,48186,59770,1.2664881988958465,0.3041807679584722
21786,0.5671428571428572,2,15,2,468900,136710,48188,59768,1.266349253399533,0.3041969075418113
21787,0.5671666666666666,0,2,0,468902,136708,48188,59768,1.266330727333358,0.30420000407174413
21788,0.5671666666666667,2,6,2,468908,136702,48190,59766,1.2662751491348327,0.30420221104709166
21789,0.5671904761904761,0,2,0,468910,136700,48190,59766,1.2662566230686576,0.304205307788625
21790,0.5671904761904762,1,0,1,468910,136700,48191,59765,1.2662566230686576,0.3042017662179014
21791,0.5672222222222222,0,1,0,468911,136699,48191,59765,1.2662473600355701,0.3042033146021663
21792,0.5672449494949494,0,1,0,468912,136698,48191,59765,1.2662380970024825,0.3042048630021938
21793,0.56725,1,1,1,468913,136697,48192,59764,1.266228833969395,0.3042028697807707
21794,0.5672619047619046,0,1,0,468914,136696,48192,59764,1.2662195709363073,0.3042044182021786
21795,0.5672857142857144,0,1,0,468915,136695,48192,59764,1.2662103079032199,0.3042059666393497
21796,0.5673069985569986,0,1,0,468916,136694,48192,59764,1.2662010448701322,0.30420751509228433
21797,0.5673333333333332,0,7,0,468923,136687,48192,59764,1.2661362036385193,0.3042183547042265
21798,0.5673333333333334,3,24,3,468947,136663,48195,59761,1.265913890844418,0.30424489879037186
21799,0.5673333333333335,1,1,1,468948,136662,48196,59760,1.2659046278113306,0.30424290558084127
21800,0.5673571428571429,0,3,0,468951,136659,48196,59760,1.2658768387120678,0.30424755242619095
21801,0.5673809523809523,1,1,1,468952,136658,48197,59759,1.2658675756789803,0.30424555919294155
21802,0.5673809523809524,0,3,0,468955,136655,48197,59759,1.2658397865797177,0.30425020619711424
21803,0.5673888888888888,0,2,0,468957,136653,48197,59759,1.2658212605135426,0.30425330427876096
21804,0.5674166666666667,1,1,1,468958,136652,48198,59758,1.265811997480455,0.30425131103304315
21805,0.5674444444444444,1,1,1,468959,136651,48199,59757,1.2658027344473675,0.3042493177467313
21806,0.5674523809523809,0,1,0,468960,136650,48199,59757,1.26579347141428,0.3042508668224656
21807,0.5674999999999999,2,10,2,468970,136640,48201,59755,1.2657008410834043,0.3042592734030907
21808,0.5675,45,256,45,469226,136384,48246,59710,1.2633295046129904,0.3044968229522576
21809,0.5675000000000001,0,9,0,469235,136375,48246,59710,1.2632461373152024,0.30451079888823723
21810,0.5675238095238094,1,1,1,469236,136374,48247,59709,1.263236874282115,0.3045088049448448
21811,0.5675357142857141,0,1,0,469237,136373,48247,59709,1.2632276112490273,0.304510357911486
21812,0.5675595238095238,0,1,0,469238,136372,48247,59709,1.2632183482159398,0.3045119108939673
21813,0.5675714285714286,0,1,0,469239,136371,48247,59709,1.2632090851828524,0.30451346389228884
21814,0.5675833333333332,0,1,0,469240,136370,48247,59709,1.2631998221497647,0.304515016906451
21815,0.5676111111111112,1,0,1,469240,136370,48248,59708,1.2631998221497647,0.3045114699252338
21816,0.5676179653679653,1,4,1,469244,136366,48249,59707,1.2631627700174144,0.3045141350415406
21817,0.5676190476190476,0,3,0,469247,136363,48249,59707,1.2631349809181518,0.30451879430815526
21818,0.5676190476190477,0,1,0,469248,136362,48249,59707,1.2631257178850643,0.3045203474287113
21819,0.5676666666666667,7,24,7,469272,136338,48256,59700,1.2629034050909629,0.30453279466225935
21820,0.5676666666666668,1,5,1,469277,136333,48257,59699,1.2628570899255251,0.30453701436500163
21821,0.5676904761904762,0,1,0,469278,136332,48257,59699,1.2628478268924377,0.30453856787957007
21822,0.5677142857142857,0,1,0,469279,136331,48257,59699,1.26283856385935,0.30454012140998826
21823,0.5677222222222222,0,2,0,469281,136329,48257,59699,1.262820037793175,0.30454322851837495
21824,0.5677380952380952,0,1,0,469282,136328,48257,59699,1.2628107747600874,0.3045447820963439
21825,0.5677380952380953,1,2,1,469284,136326,48258,59698,1.2627922486939123,0.30454434150920295
21826,0.56775,0,1,0,469285,136325,48258,59698,1.2627829856608248,0.3045458951245517
21827,0.5677777777777777,0,1,0,469286,136324,48258,59698,1.2627737226277371,0.3045474487557519
21828,0.5677777777777778,0,1,0,469287,136323,48258,59698,1.2627644595946497,0.3045490024028038
21829,0.5677857142857142,0,1,0,469288,136322,48258,59698,1.2627551965615622,0.3045505560657076
21830,0.5678333333333332,2,1,2,469289,136321,48260,59696,1.2627459335284745,0.3045450139528714
21831,0.5678333333333333,1,3,1,469292,136318,48261,59695,1.262718144429212,0.3045461270425941
21832,0.5678333333333334,0,3,0,469295,136315,48261,59695,1.2626903553299493,0.3045507882250906
21833,0.5678571428571428,1,11,1,469306,136304,48262,59694,1.2625884619659862,0.304564332289105
21834,0.5678809523809524,0,1,0,469307,136303,48262,59694,1.2625791989328985,0.30456588621254405
21835,0.5678888888888891,0,3,0,469310,136300,48262,59694,1.262551409833636,0.3045705480780024
21836,0.5678928571428572,0,1,0,469311,136299,48262,59694,1.2625421468005484,0.3045721020648697
21837,0.5679047619047619,0,3,0,469314,136296,48262,59694,1.2625143577012856,0.3045767641206184
21838,0.5679166666666666,0,1,0,469315,136295,48262,59694,1.2625050946681982,0.30457831817091774
21839,0.5679285714285716,1,0,1,469315,136295,48263,59693,1.2625050946681982,0.30457476988387044
21840,0.5679523809523811,0,3,0,469318,136292,48263,59693,1.2624773055689356,0.30457943209939536
21841,0.5679642857142857,0,1,0,469319,136291,48263,59693,1.2624680425358479,0.3045809862029553
21842,0.568,15,69,15,469388,136222,48278,59678,1.2618288932528068,0.3046350178662583
21843,0.5680000000000001,0,7,0,469395,136215,48278,59678,1.261764052021194,0.3046459036310639
21844,0.5680079365079367,1,2,1,469397,136213,48279,59677,1.2617455259550188,0.30464546429118383
21845,0.5680357142857142,0,1,0,469398,136212,48279,59677,1.261736262921931,0.304647019485525
21846,0.568047619047619,0,1,0,469399,136211,48279,59677,1.2617269998888436,0.3046485746957445
21847,0.5680800865800867,0,2,0,469401,136209,48279,59677,1.2617084738226685,0.3046516851638198
21848,0.568095238095238,0,1,0,469402,136208,48279,59677,1.261699210789581,0.30465324042167596
21849,0.5680952380952381,1,3,1,469405,136205,48280,59676,1.2616714216903182,0.30465435647153116
21850,0.5680952380952382,0,3,0,469408,136202,48280,59676,1.2616436325910556,0.3046590224527512
21851,0.5681428571428572,0,1,0,469409,136201,48280,59676,1.2616343695579681,0.30466057781158584
21852,0.5681666666666666,1,7,1,469416,136194,48281,59675,1.2615695283263553,0.3046679158008669
21853,0.5681666666666667,1,4,1,469420,136190,48282,59674,1.261532476194005,0.30467058775476863
21854,0.5681904761904762,0,1,0,469421,136189,48282,59674,1.2615232131609173,0.3046721432838259
21855,0.5682142857142857,0,1,0,469422,136188,48282,59674,1.2615139501278299,0.3046736988287672
21856,0.5682142857142858,0,1,0,469423,136187,48282,59674,1.2615046870947424,0.30467525438959264
21857,0.5682222222222222,0,3,0,469426,136184,48282,59674,1.2614768979954796,0.30467992116737636
21858,0.5682380952380953,0,1,0,469427,136183,48282,59674,1.2614676349623921,0.3046814767917409
21859,0.56825,0,1,0,469428,136182,48282,59674,1.2614583719293044,0.30468303243199085
21860,0.5682738095238096,0,1,0,469429,136181,48282,59674,1.261449108896217,0.30468458808812643
21861,0.5682857142857143,0,1,0,469430,136180,48282,59674,1.2614398458631295,0.30468614376014785
21862,0.5682857142857144,1,0,1,469430,136180,48283,59673,1.2614398458631295,0.30468259357783645
21863,0.5682976190476191,0,2,0,469432,136178,48283,59673,1.2614213197969544,0.3046857049491705
21864,0.5683333333333332,28,117,28,469549,136061,48311,59645,1.2603375449257104,0.304768377055379
21865,0.5683333333333334,32,145,32,469694,135916,48343,59613,1.258994405128015,0.3048806059459211
21866,0.5683333333333335,1,6,1,469700,135910,48344,59612,1.2589388269294899,0.30488640664477656
21867,0.568357142857143,1,2,1,469702,135908,48345,59611,1.2589203008633147,0.3048859701614677
21868,0.5683809523809523,2,0,2,469702,135908,48347,59609,1.2589203008633147,0.3048788596388038
21869,0.5684166666666667,0,1,0,469703,135907,48347,59609,1.258911037830227,0.30488041899384194
21870,0.5684285714285714,0,1,0,469704,135906,48347,59609,1.2589017747971396,0.30488197836483133
21871,0.5684523809523809,0,1,0,469705,135905,48347,59609,1.258892511764052,0.30488353775177224
21872,0.5684999999999999,0,5,0,469710,135900,48347,59609,1.2588461965986142,0.3048913349257579
21873,0.5685,3,23,3,469733,135877,48350,59606,1.2586331468376004,0.30491654005719165
21874,0.5685000000000001,1,2,1,469735,135875,48351,59605,1.2586146207714255,0.3049161039492531
21875,0.5685714285714285,0,5,0,469740,135870,48351,59605,1.2585683056059875,0.30492390331244407
21876,0.5685714285714286,0,2,0,469742,135868,48351,59605,1.2585497795398126,0.30492702316944026
21877,0.5686428571428571,0,1,0,469743,135867,48351,59605,1.258540516506725,0.30492858312187937
21878,0.5686666666666667,8,19,8,469762,135848,48359,59597,1.2583645188780614,0.3049297756402057
21879,0.5686666666666668,0,2,0,469764,135846,48359,59597,1.2583459928118863,0.30493289603618445
21880,0.5686904761904761,0,1,0,469765,135845,48359,59597,1.2583367297787988,0.3049344562581226
21881,0.5686904761904762,0,1,0,469766,135844,48359,59597,1.2583274667457112,0.3049360164960269
21882,0.5687222222222222,0,1,0,469767,135843,48359,59597,1.2583182037126237,0.3049375767498977
21883,0.5687492784992785,0,2,0,469769,135841,48359,59597,1.2582996776464486,0.30494069730553935
21884,0.56875,0,7,0,469776,135834,48359,59597,1.2582348364148357,0.3049516197532633
21885,0.5687619047619047,0,1,0,469777,135833,48359,59597,1.2582255733817482,0.30495318016681167
21886,0.5687619047619048,0,2,0,469779,135831,48359,59597,1.258207047315573,0.3049563010418159
21887,0.5687950937950937,0,1,0,469780,135830,48359,59597,1.2581977842824854,0.3049578615032723
21888,0.5688095238095238,0,3,0,469783,135827,48359,59597,1.2581699951832228,0.3049625429834616
21889,0.5688095238095239,0,1,0,469784,135826,48359,59597,1.2581607321501351,0.3049641035087989
21890,0.5688333333333333,1,8,1,469792,135818,48360,59596,1.2580866278854348,0.30497303161493033
21891,0.5688492063492063,0,1,0,469793,135817,48360,59596,1.2580773648523473,0.3049745922737996
21892,0.5688571428571428,1,3,1,469796,135814,48361,59595,1.2580495757530845,0.30497571759744946
21893,0.5688888888888889,0,1,0,469797,135813,48361,59595,1.258040312719997,0.30497727830999755
21894,0.5689047619047619,0,1,0,469798,135812,48361,59595,1.2580310496869094,0.3049788390385196
21895,0.5689285714285715,1,0,1,469798,135812,48362,59594,1.2580310496869094,0.30497528223288944
21896,0.5689707792207793,0,1,0,469799,135811,48362,59594,1.258021786653822,0.30497684296717076
21897,0.5689999999999998,0,2,0,469801,135809,48362,59594,1.2580032605876468,0.30497996448365683
21898,0.569,8,58,8,469859,135751,48370,59586,1.2574660046685686,0.305042055524555
21899,0.5690000000000001,3,2,3,469861,135749,48373,59583,1.2574474786023935,0.3050345053549854
21900,0.5690079365079366,1,2,1,469863,135747,48374,59582,1.2574289525362186,0.3050340707217054
21901,0.569047619047619,0,4,0,469867,135743,48374,59582,1.2573919004038683,0.3050403174196851
21902,0.5690952380952381,1,2,1,469869,135741,48375,59581,1.2573733743376931,0.3050398828600977
21903,0.5691071428571428,0,1,0,469870,135740,48375,59581,1.2573641113046057,0.30504144459633115
21904,0.5691111111111111,2,0,2,469870,135740,48377,59579,1.2573641113046057,0.3050343284575489
21905,0.5691601731601731,0,1,0,469871,135739,48377,59579,1.257354848271518,0.30503589018933225
21906,0.5691666666666666,22,70,22,469941,135669,48399,59557,1.2567064359553892,0.3050669480499524
21907,0.5691666666666667,5,27,5,469968,135642,48404,59552,1.2564563340620252,0.30509134502085106
21908,0.5692142857142857,0,1,0,469969,135641,48404,59552,1.2564470710289377,0.30509290804485817
21909,0.5692499999999999,0,1,0,469970,135640,48404,59552,1.2564378079958503,0.3050944710848805
21910,0.5692698412698411,0,2,0,469972,135638,48404,59552,1.2564192819296751,0.30509759721297197
21911,0.5692857142857143,0,5,0,469977,135633,48404,59552,1.2563729667642374,0.30510541281348463
21912,0.5693095238095238,0,1,0,469978,135632,48404,59552,1.2563637037311497,0.30510697598163783
21913,0.5693333333333332,3,6,3,469984,135626,48407,59549,1.2563081255326245,0.30510567439477393
21914,0.5693333333333334,7,23,7,470007,135603,48414,59542,1.2560950757716107,0.305116708088857
21915,0.5693481028775146,1,3,1,470010,135600,48415,59541,1.256067286672348,0.3051178378710778
21916,0.5693690476190478,0,1,0,470011,135599,48415,59541,1.2560580236392604,0.30511940145536537
21917,0.5693809523809523,0,1,0,470012,135598,48415,59541,1.256048760606173,0.30512096505567826
21918,0.5693809523809524,1,0,1,470012,135598,48416,59540,1.256048760606173,0.3051174040935133
21919,0.5694126984126985,0,1,0,470013,135597,48416,59540,1.2560394975730853,0.30511896769961616
21920,0.5694166666666667,1,1,1,470014,135596,48417,59539,1.2560302345399978,0.30511697030261103
21921,0.5694444444444445,0,1,0,470015,135595,48417,59539,1.2560209715069102,0.3051185339305298
21922,0.5694523809523809,0,2,0,470017,135593,48417,59539,1.256002445440735,0.30512166123444645
21923,0.5694761904761906,0,1,0,470018,135592,48417,59539,1.2559931824076476,0.3051232249104448
21924,0.5695,4,16,4,470034,135576,48421,59535,1.2558449738782467,0.3051340006457862
21925,0.5695238095238095,1,4,1,470038,135572,48422,59534,1.2558079217458964,0.3051366949248101
21926,0.5695833333333333,1,0,1,470038,135572,48423,59533,1.2558079217458964,0.3051331334409677
21927,0.5695833333333334,0,1,0,470039,135571,48423,59533,1.255798658712809,0.3051346973921601
21928,0.5696428571428571,1,3,1,470042,135568,48424,59532,1.2557708696135463,0.3051358277806253
21929,0.5696587301587301,0,1,0,470043,135567,48424,59532,1.2557616065804587,0.3051373917857088
21930,0.5696666666666667,6,13,6,470056,135554,48430,59526,1.2556411871503206,0.30513635431617797
21931,0.5696666666666668,0,1,0,470057,135553,48430,59526,1.255631924117233,0.3051379184843064
21932,0.5696904761904762,1,0,1,470057,135553,48431,59525,1.255631924117233,0.3051343565138047
21933,0.5697142857142857,3,0,3,470057,135553,48434,59522,1.255631924117233,0.30512367038318594
21934,0.5697222222222222,0,2,0,470059,135551,48434,59522,1.2556133980510578,0.30512679868562026
21935,0.5697236652236651,2,3,2,470062,135548,48436,59520,1.2555856089517952,0.3051243668874444
21936,0.56975,1,2,1,470064,135546,48437,59519,1.25556708288562,0.3051239330479584
21937,0.5697500000000001,0,1,0,470065,135545,48437,59519,1.2555578198525326,0.30512549727269
21938,0.5697619047619048,0,1,0,470066,135544,48437,59519,1.2555485568194449,0.30512706151345975
21939,0.5698095238095238,0,3,0,470069,135541,48437,59519,1.2555207677201823,0.3051317543320004
21940,0.5698214285714286,2,1,2,470070,135540,48439,59517,1.2555115046870948,0.3051261938817884
21941,0.5698333333333333,2,12,2,470082,135528,48441,59515,1.255400348290044,0.3051378413990761
21942,0.5698452380952381,0,2,0,470084,135526,48441,59515,1.255381822223869,0.30514097036007815
21943,0.5698484848484848,1,0,1,470084,135526,48442,59514,1.255381822223869,0.3051374077112387
21944,0.5698571428571428,2,0,2,470084,135526,48444,59512,1.255381822223869,0.3051302823039613
21945,0.5698580031080032,0,1,0,470085,135525,48444,59512,1.2553725591907814,0.30513184677779087
21946,0.5698809523809524,1,1,1,470086,135524,48445,59511,1.255363296157694,0.3051298484887328
21947,0.5698809523809525,0,1,0,470087,135523,48445,59511,1.2553540331246063,0.3051314129844027
21948,0.5698888888888889,1,0,1,470087,135523,48446,59510,1.2553540331246063,0.3051278501586911
21949,0.5699155844155844,0,1,0,470088,135522,48446,59510,1.2553447700915188,0.30512941466015836
21950,0.5699166666666667,0,1,0,470089,135521,48446,59510,1.255335507058431,0.3051309791776692
21951,0.5699444444444445,0,1,0,470090,135520,48446,59510,1.2553262440253437,0.3051325437112239
21952,0.569968253968254,0,1,0,470091,135519,48446,59510,1.2553169809922562,0.30513410826082277
21953,0.57,501,2345,501,472436,133174,48947,59009,1.2335951684019415,0.3070458885541385
21954,0.5700000000000001,2,18,2,472454,133156,48949,59007,1.2334284338063655,0.3070674375400051
21955,0.5700238095238096,0,1,0,472455,133155,48949,59007,1.233419170773278,0.3070690355012958
21956,0.5700952380952381,0,1,0,472456,133154,48949,59007,1.2334099077401905,0.3070706334792179
21957,0.5701190476190475,0,1,0,472457,133153,48949,59007,1.2334006447071029,0.3070722314737719
21958,0.5701190476190476,0,2,0,472459,133151,48949,59007,1.2333821186409277,0.30707542751277594
21959,0.5701190476190477,1,0,1,472459,133151,48950,59006,1.2333821186409277,0.30707182147931117
21960,0.5701428571428572,1,1,1,472460,133150,48951,59005,1.2333728556078403,0.3070698134318649
21961,0.5701666666666667,1,8,1,472468,133142,48952,59004,1.2332987513431397,0.3070789920164875
21962,0.570202380952381,1,1,1,472469,133141,48953,59003,1.2332894883100523,0.3070769839287201
21963,0.5702222222222223,0,1,0,472470,133140,48953,59003,1.2332802252769648,0.3070785820977085
21964,0.5702380952380952,0,5,0,472475,133135,48953,59003,1.2332339101115268,0.3070865731921848
21965,0.5702380952380953,0,1,0,472476,133134,48953,59003,1.2332246470784394,0.30708817146098877
21966,0.5702500000000001,0,1,0,472477,133133,48953,59003,1.233215384045352,0.3070897697464296
21967,0.5702619047619047,0,1,0,472478,133132,48953,59003,1.2332061210122642,0.30709136804850756
21968,0.5702857142857143,0,1,0,472479,133131,48953,59003,1.2331968579791768,0.3070929663672229
21969,0.5703333333333332,1,1,1,472480,133130,48954,59002,1.233187594946089,0.30709095829950245
21970,0.5703333333333334,5,10,5,472490,133120,48959,58997,1.2330949646152136,0.30708890936252387
21971,0.5703571428571429,0,4,0,472494,133116,48959,58997,1.2330579124828633,0.3070953032850458
21972,0.5703690476190476,0,1,0,472495,133115,48959,58997,1.2330486494497759,0.3070969018072791
21973,0.570404761904762,0,1,0,472496,133114,48959,58997,1.2330393864166882,0.30709850034615405
21974,0.5704166666666667,1,1,1,472497,133113,48960,58996,1.2330301233836007,0.3070964920956332
21975,0.5704761904761904,0,1,0,472498,133112,48960,58996,1.2330208603505133,0.30709809065733856
21976,0.5704761904761905,2,1,2,472499,133111,48962,58994,1.2330115973174256,0.3070924754691445
21977,0.5704999999999999,0,5,0,472504,133106,48962,58994,1.2329652821519879,0.3071004685059865
21978,0.5705,2,14,2,472518,133092,48964,58992,1.232835599688762,0.30711563690885235
21979,0.5705238095238095,0,1,0,472519,133091,48964,58992,1.2328263366556744,0.30711723577828337
21980,0.5705476190476191,0,1,0,472520,133090,48964,58992,1.232817073622587,0.3071188346643621
21981,0.5705555555555555,0,1,0,472521,133089,48964,58992,1.2328078105894995,0.3071204335670889
21982,0.5705833333333333,0,1,0,472522,133088,48964,58992,1.2327985475564118,0.30712203248646397
21983,0.5706133196868491,0,5,0,472527,133083,48964,58992,1.232752232390974,0.30713002733307304
21984,0.5706190476190476,0,4,0,472531,133079,48964,58992,1.2327151802586238,0.30713642351005616
21985,0.5706666666666665,0,1,0,472532,133078,48964,58992,1.2327059172255364,0.3071380225959286
21986,0.5706666666666667,3,28,3,472560,133050,48967,58989,1.2324465522990848,0.30717198069142204
21987,0.5706684981684982,0,1,0,472561,133049,48967,58989,1.2324372892659972,0.307173580228913
21988,0.570672077922078,0,1,0,472562,133048,48967,58989,1.2324280262329097,0.30717517978306264
21989,0.5706904761904762,0,1,0,472563,133047,48967,58989,1.2324187631998222,0.30717677935387117
21990,0.5707142857142857,1,3,1,472566,133044,48968,58988,1.2323909741005594,0.30717797033827693
21991,0.5707301587301586,0,1,0,472567,133043,48968,58988,1.232381711067472,0.307179569965266
21992,0.5707380952380953,0,1,0,472568,133042,48968,58988,1.2323724480343843,0.3071811696089153
21993,0.5707619047619048,0,1,0,472569,133041,48968,58988,1.2323631850012968,0.30718276926922494
21994,0.5707857142857143,0,1,0,472570,133040,48968,58988,1.2323539219682094,0.30718436894619533
21995,0.5708333333333332,0,2,0,472572,133038,48968,58988,1.2323353959020342,0.30718756835011923
21996,0.5708333333333333,22,91,22,472663,132947,48990,58966,1.2314924598910668,0.3072538077149542
21997,0.5708421855921856,0,1,0,472664,132946,48990,58966,1.2314831968579791,0.3072554087290008
21998,0.5708571428571428,1,0,1,472664,132946,48991,58965,1.2314831968579791,0.3072517990109999
21999,0.5708888888888889,0,1,0,472665,132945,48991,58965,1.2314739338248917,0.30725340003126467
22000,0.5709166666666666,0,1,0,472666,132944,48991,58965,1.231464670791804,0.30725500106821463
22001,0.5709166666666667,1,0,1,472666,132944,48992,58964,1.231464670791804,0.30725139129166057
22002,0.5709285714285715,0,2,0,472668,132942,48992,58964,1.2314461447256289,0.3072545933946828
22003,0.5709523809523809,0,2,0,472670,132940,48992,58964,1.231427618659454,0.3072577955644489
22004,0.570952380952381,1,2,1,472672,132938,48993,58963,1.2314090925932788,0.30725738792398166
22005,0.5709642857142856,0,1,0,472673,132937,48993,58963,1.2313998295601911,0.30725898905680044
22006,0.5709761904761905,0,1,0,472674,132936,48993,58963,1.2313905665271037,0.3072605902063064
22007,0.5710000000000001,15,65,15,472739,132871,49008,58948,1.2307884693764126,0.30731053753799153
22008,0.5710714285714286,0,2,0,472741,132869,49008,58948,1.2307699433102375,0.30731374174343257
22009,0.5710873015873016,1,1,1,472742,132868,49009,58947,1.23076068027715,0.3073117326590725
22010,0.5711111111111111,1,1,1,472743,132867,49010,58946,1.2307514172440623,0.3073097235328158
22011,0.5711666666666666,0,1,0,472744,132866,49010,58946,1.2307421542109749,0.30731132567305486
22012,0.5711666666666667,3,9,3,472753,132857,49013,58943,1.2306587869131869,0.30731491136600625
22013,0.5711666666666668,0,1,0,472754,132856,49013,58943,1.2306495238800994,0.3073165136418855
22014,0.5711904761904761,0,1,0,472755,132855,49013,58943,1.2306402608470117,0.3073181159344727
22015,0.5711904761904762,0,2,0,472757,132853,49013,58943,1.2306217347808366,0.30732132056977207
22016,0.5712222222222222,1,0,1,472757,132853,49014,58942,1.2306217347808366,0.3073177090122266
22017,0.57125,2,1,2,472758,132852,49016,58940,1.2306124717477491,0.3073120880954367
22018,0.5712820512820512,0,2,0,472760,132850,49016,58940,1.230593945681574,0.3073152927681318
22019,0.5712857142857143,0,2,0,472762,132848,49016,58940,1.2305754196153988,0.3073184975076647
22020,0.5712934287934288,0,1,0,472763,132847,49016,58940,1.2305661565823114,0.307320099902496
22021,0.5713095238095238,1,1,1,472764,132846,49017,58939,1.2305568935492237,0.30731809057016973
22022,0.5713160173160173,0,2,0,472766,132844,49017,58939,1.2305383674830486,0.3073212954224306
22023,0.5713333333333332,0,4,0,472770,132840,49017,58939,1.2305013153506985,0.3073277053274863
22024,0.5713333333333334,3,16,3,472786,132824,49020,58936,1.2303531068212976,0.30734251147267416
22025,0.57134126984127,1,1,1,472787,132823,49021,58935,1.23034384378821,0.3073405020911774
22026,0.5713571428571429,1,1,1,472788,132822,49022,58934,1.2303345807551225,0.3073384926677653
22027,0.5713730158730158,0,1,0,472789,132821,49022,58934,1.2303253177220348,0.3073400954342781
22028,0.5713809523809524,0,1,0,472790,132820,49022,58934,1.2303160546889473,0.30734169821750784
22029,0.5713928571428571,0,1,0,472791,132819,49022,58934,1.2303067916558599,0.3073433010174548
22030,0.5714166666666666,1,0,1,472791,132819,49023,58933,1.2303067916558599,0.30733968876465434
22031,0.5714166666666667,0,3,0,472794,132816,49023,58933,1.230279002556597,0.3073444972333624
22032,0.5714285714285714,2,1,2,472795,132815,49025,58931,1.2302697395235096,0.30733887538723104
22033,0.5714285714285715,0,2,0,472797,132813,49025,58931,1.2302512134573345,0.3073420811081442
22034,0.5714365079365078,0,1,0,472798,132812,49025,58931,1.230241950424247,0.30734368399367906
22035,0.5714523809523808,0,1,0,472799,132811,49025,58931,1.2302326873911593,0.3073452868959331
22036,0.5714920634920635,0,1,0,472800,132810,49025,58931,1.2302234243580719,0.30734688981490654
22037,0.5715,2,18,2,472818,132792,49027,58929,1.2300566897624958,0.3073685198804513
22038,0.5715079365079366,0,1,0,472819,132791,49027,58929,1.2300474267294084,0.30737012309618195
22039,0.5715238095238094,1,0,1,472819,132791,49028,58928,1.2300474267294084,0.3073665103615187
22040,0.5715238095238095,0,1,0,472820,132790,49028,58928,1.2300381636963207,0.3073681135834924
22041,0.5715357142857143,0,1,0,472821,132789,49028,58928,1.2300289006632332,0.30736971682219105
22042,0.5715714285714285,0,1,0,472822,132788,49028,58928,1.2300196376301455,0.3073713200776148
22043,0.5715833333333333,0,1,0,472823,132787,49028,58928,1.230010374597058,0.30737292334976396
22044,0.5715952380952382,1,2,1,472825,132785,49029,58927,1.229991848530883,0.3073725171089968
22045,0.5716190476190477,1,0,1,472825,132785,49030,58926,1.229991848530883,0.30736890423606367
22046,0.5716363636363636,0,1,0,472826,132784,49030,58926,1.2299825854977955,0.30737050753742634
22047,0.5716666666666665,1,1,1,472827,132783,49031,58925,1.2299733224647078,0.30736849792392595
22048,0.5716666666666667,47,151,47,472978,132632,49078,58878,1.228574604468487,0.3074408647068038
22049,0.5716666666666668,23,101,23,473079,132531,49101,58855,1.2276390381266442,0.3075198812870325
22050,0.5716904761904762,0,1,0,473080,132530,49101,58855,1.2276297750935565,0.3075214880999033
22051,0.5717063492063492,0,1,0,473081,132529,49101,58855,1.227620512060469,0.3075230949295657
22052,0.5717619047619048,0,2,0,473083,132527,49101,58855,1.227601985994294,0.30752630863926594
22053,0.5717857142857143,1,2,1,473085,132525,49102,58854,1.2275834599281188,0.3075259040960607
22054,0.5718333333333332,0,3,0,473088,132522,49102,58854,1.2275556708288562,0.3075307248557813
22055,0.5718333333333333,1,4,1,473092,132518,49103,58853,1.227518618696506,0.30753353433905867
22056,0.5718333333333334,1,10,1,473102,132508,49104,58852,1.2274259883656304,0.30754598662207355
22057,0.5718571428571428,1,0,1,473102,132508,49105,58851,1.2274259883656304,0.3075423680098663
22058,0.5719047619047619,1,5,1,473107,132503,49106,58850,1.2273796732001927,0.30754678526074847
22059,0.5719166666666665,0,1,0,473108,132502,49106,58850,1.227370410167105,0.3075483924913249
22060,0.5719444444444445,0,2,0,473110,132500,49106,58850,1.22735188410093,0.3075516070028743
22061,0.571952380952381,0,1,0,473111,132499,49106,58850,1.2273426210678424,0.30755321428384785
22062,0.571968253968254,0,1,0,473112,132498,49106,58850,1.227333358034755,0.3075548215816209
22063,0.572,2,8,2,473120,132490,49108,58848,1.2272592537700544,0.307560442776657
22064,0.5720000000000001,9,50,9,473170,132440,49117,58839,1.2267961021156768,0.3076082580941975
22065,0.5720238095238095,1,0,1,473170,132440,49118,58838,1.2267961021156768,0.30760463827518064
22066,0.5720357142857143,0,1,0,473171,132439,49118,58838,1.2267868390825891,0.30760624643841133
22067,0.5720606060606059,0,2,0,473173,132437,49118,58838,1.2267683130164142,0.30760946281531826
22068,0.5720692640692642,0,1,0,473174,132436,49118,58838,1.2267590499833265,0.30761107102899504
22069,0.5720714285714287,1,2,1,473176,132434,49119,58837,1.2267405239171514,0.3076106675868271
22070,0.5720793650793651,0,1,0,473177,132433,49119,58837,1.226731260884064,0.307612275840435
22071,0.5720833333333333,1,1,1,473178,132432,49120,58836,1.2267219978509762,0.30761026413200326
22072,0.5720833333333334,1,2,1,473180,132430,49121,58835,1.2267034717848013,0.30760986066452306
22073,0.572095238095238,0,1,0,473181,132429,49121,58835,1.2266942087517136,0.30761146896436337
22074,0.5720952380952381,0,1,0,473182,132428,49121,58835,1.2266849457186262,0.30761307728102144
22075,0.5721428571428572,1,7,1,473189,132421,49122,58834,1.2266201044870133,0.30762071579827976
22076,0.572159090909091,1,0,1,473189,132421,49123,58833,1.2266201044870133,0.3076170955901576
22077,0.5721666666666666,0,4,0,473193,132417,49123,58833,1.226583052354663,0.3076235294117647
22078,0.5721666666666667,1,10,1,473203,132407,49124,58832,1.2264904220237876,0.30763599475002484
22079,0.5721945831945832,0,1,0,473204,132406,49124,58832,1.2264811589906999,0.307637603405181
22080,0.5722222222222223,0,1,0,473205,132405,49124,58832,1.2264718959576124,0.3076392120771608
22081,0.5722380952380951,0,1,0,473206,132404,49124,58832,1.2264626329245247,0.30764082076596455
22082,0.5722619047619047,0,1,0,473207,132403,49124,58832,1.2264533698914373,0.30764242947159254
22083,0.5722619047619049,2,2,2,473209,132401,49126,58830,1.2264348438252621,0.30763840590699204
22084,0.5722727272727272,0,1,0,473210,132400,49126,58830,1.2264255807921747,0.3076400146420541
22085,0.5722738095238096,0,1,0,473211,132399,49126,58830,1.226416317759087,0.3076416233939413
22086,0.5723095238095239,1,0,1,473211,132399,49127,58829,1.226416317759087,0.3076380028029368
22087,0.5723214285714285,1,0,1,473211,132399,49128,58828,1.226416317759087,0.30763438217406536
22088,0.5723333333333332,2,7,2,473218,132392,49130,58826,1.2263514765274741,0.3076384022424667
22089,0.5723333333333334,4,18,4,473236,132374,49134,58822,1.226184741931898,0.30765287976735917
22090,0.5723809523809523,1,4,1,473240,132370,49135,58821,1.226147689799548,0.30765569509025004
22091,0.5723809523809524,1,2,1,473242,132368,49136,58820,1.2261291637333729,0.30765529217314896
22092,0.5723860722610724,2,0,2,473242,132368,49138,58818,1.2261291637333729,0.3076480495433766
22093,0.5724285714285715,0,3,0,473245,132365,49138,58818,1.2261013746341103,0.3076528770863518
22094,0.572452380952381,0,1,0,473246,132364,49138,58818,1.2260921116010226,0.3076544863010116
22095,0.5724761904761905,0,4,0,473250,132360,49138,58818,1.2260550594686723,0.307660923327998
22096,0.5724999999999999,3,3,3,473253,132357,49141,58815,1.2260272703694097,0.30765488669888896
22097,0.5725,49,225,49,473478,132132,49190,58766,1.22394308792471,0.30783978878772955
22098,0.5725000000000001,2,5,2,473483,132127,49192,58764,1.2238967727592722,0.30784060013306025
22099,0.572547619047619,0,1,0,473484,132126,49192,58764,1.2238875097261848,0.30784221279270785
22100,0.5725714285714286,0,1,0,473485,132125,49192,58764,1.223878246693097,0.30784382546925176
22101,0.5725833333333332,0,1,0,473486,132124,49192,58764,1.2238689836600096,0.3078454381626923
22102,0.5725833333333333,0,1,0,473487,132123,49192,58764,1.2238597206269222,0.3078470508730296
22103,0.5725833333333336,0,2,0,473489,132121,49192,58764,1.223841194560747,0.3078502763443958
22104,0.5725952380952382,1,0,1,473489,132121,49193,58763,1.223841194560747,0.3078466503216613
22105,0.5726190476190476,0,1,0,473490,132120,49193,58763,1.2238319315276593,0.3078482630721437
22106,0.5726190476190477,1,1,1,473491,132119,49194,58762,1.2238226684945719,0.3078462497577024
22107,0.5726580086580086,0,1,0,473492,132118,49194,58762,1.2238134054614842,0.30784786253143337
22108,0.5726666666666665,1,2,1,473494,132116,49195,58761,1.2237948793953093,0.3078474619781325
22109,0.5726666666666667,6,26,6,473520,132090,49201,58755,1.2235540405350327,0.30786764127957245
22110,0.5726666666666668,3,4,3,473524,132086,49204,58752,1.2235169884026826,0.30786321382533877
22111,0.5727023809523809,1,6,1,473530,132080,49205,58751,1.2234614102041572,0.3078692665237828
22112,0.5727142857142857,0,4,0,473534,132076,49205,58751,1.223424358071807,0.30787571989288726
22113,0.572734126984127,0,1,0,473535,132075,49205,58751,1.2234150950387195,0.307877333277436
22114,0.5727380952380953,1,1,1,473536,132074,49206,58750,1.223405832005632,0.30787531966628934
22115,0.5727619047619048,0,1,0,473537,132073,49206,58750,1.2233965689725443,0.3078769330741053
22116,0.5727683982683982,0,1,0,473538,132072,49206,58750,1.2233873059394569,0.3078785464988314
22117,0.5727777777777778,1,0,1,473538,132072,49207,58749,1.2233873059394569,0.3078749194271071
22118,0.5728333333333333,0,3,0,473541,132069,49207,58749,1.223359516840194,0.3078797597710908
22119,0.5728333333333334,1,5,1,473546,132064,49208,58748,1.2233132016747563,0.3078842001551265
22120,0.5728571428571428,0,6,0,473552,132058,49208,58748,1.2232576234762311,0.3078938817437607
22121,0.5728636363636364,0,1,0,473553,132057,49208,58748,1.2232483604431434,0.3078954954010639
22122,0.5728888888888889,0,1,0,473554,132056,49208,58748,1.223239097410056,0.30789710907528145
22123,0.5729166666666666,2,1,2,473555,132055,49210,58746,1.2232298343769683,0.3078914680740667
22124,0.5729166666666667,0,1,0,473556,132054,49210,58746,1.2232205713438808,0.30789308176100627
22125,0.5729523809523809,0,1,0,473557,132053,49210,58746,1.2232113083107934,0.3078946954648609
22126,0.5729761904761904,0,1,0,473558,132052,49210,58746,1.2232020452777057,0.3078963091856309
22127,0.5729761904761905,0,1,0,473559,132051,49210,58746,1.2231927822446182,0.3078979229233164
22128,0.573,11,25,11,473584,132026,49221,58735,1.2229612064174293,0.30789836496977896
22129,0.5730000000000001,1,5,1,473589,132021,49222,58734,1.2229148912519916,0.3079028072658646
22130,0.5730476190476191,0,1,0,473590,132020,49222,58734,1.222905628218904,0.3079044214013861
22131,0.5730555555555555,0,1,0,473591,132019,49222,58734,1.2228963651858165,0.3079060355538314
22132,0.5730774503274503,1,2,1,473593,132017,49223,58733,1.2228778391196413,0.3079056356487549
22133,0.5730833333333334,0,6,0,473599,132011,49223,58733,1.222822260921116,0.3079153210585916
22134,0.5730952380952381,1,4,1,473603,132007,49224,58732,1.2227852087887658,0.30791814993263045
22135,0.5730952380952382,0,2,0,473605,132005,49224,58732,1.2227666827225907,0.30792137865228036
22136,0.5731428571428572,0,2,0,473607,132003,49224,58732,1.2227481566564156,0.3079246074396414
22137,0.5731666666666666,1,10,1,473617,131993,49225,58731,1.22265552632554,0.30793712380193367
22138,0.5731666666666667,0,7,0,473624,131986,49225,58731,1.2225906850939272,0.3079484262021739
22139,0.5731666666666668,0,1,0,473625,131985,49225,58731,1.2225814220608395,0.3079500408985088
22140,0.5732023809523811,0,2,0,473627,131983,49225,58731,1.2225628959946644,0.30795327034197806
22141,0.5732142857142857,0,4,0,473631,131979,49225,58731,1.2225258438623143,0.3079597294321221
22142,0.5732142857142858,0,1,0,473632,131978,49225,58731,1.2225165808292267,0.3079613442469941
22143,0.5732857142857143,1,0,1,473632,131978,49226,58730,1.2225165808292267,0.30795771546028483
22144,0.5733095238095238,0,1,0,473633,131977,49226,58730,1.2225073177961392,0.30795933028153133
22145,0.5733333333333333,40,170,40,473803,131807,49266,58690,1.220932602171255,0.30808884129408864
22146,0.5733333333333334,71,259,71,474062,131548,49337,58619,1.2185334766015785,0.30825011700242416
22147,0.5733333333333335,0,3,0,474065,131545,49337,58619,1.2185056875023157,0.3082549799120759
22148,0.5733809523809523,0,1,0,474066,131544,49337,58619,1.2184964244692282,0.3082566009160562
22149,0.5733939393939393,0,1,0,474067,131543,49337,58619,1.2184871614361406,0.30825822193708524
22150,0.5734126984126984,0,1,0,474068,131542,49337,58619,1.218477898403053,0.3082598429751632
22151,0.5734404761904762,1,0,1,474068,131542,49338,58618,1.218477898403053,0.30825620530079934
22152,0.5734444444444445,0,1,0,474069,131541,49338,58618,1.2184686353699656,0.30825782634532156
22153,0.5734523809523809,0,2,0,474071,131539,49338,58618,1.2184501093037905,0.3082610684855146
22154,0.5734999999999999,0,4,0,474075,131535,49338,58618,1.2184130571714402,0.3082675529705027
22155,0.5735,4,21,4,474096,131514,49342,58614,1.2182185334766016,0.3082870487250694
22156,0.5735000000000001,0,1,0,474097,131513,49342,58614,1.2182092704435141,0.30828867020465267
22157,0.5735238095238094,0,1,0,474098,131512,49342,58614,1.2182000074104264,0.30829029170129285
22158,0.5735714285714285,0,1,0,474099,131511,49342,58614,1.218190744377339,0.30829191321499017
22159,0.5735714285714286,0,1,0,474100,131510,49342,58614,1.2181814813442513,0.3082935347457449
22160,0.5735833333333333,0,1,0,474101,131509,49342,58614,1.2181722183111638,0.3082951562935573
22161,0.5736190476190476,1,2,1,474103,131507,49343,58613,1.2181536922449887,0.30829476120345045
22162,0.5736428571428571,1,1,1,474104,131506,49344,58612,1.2181444292119012,0.3082927445060436
22163,0.5736666666666665,1,5,1,474109,131501,49345,58611,1.2180981140464633,0.3082972142736913
22164,0.5736666666666667,2,8,2,474117,131493,49347,58609,1.218024009781763,0.30830291106879465
22165,0.5736666666666668,2,4,2,474121,131489,49349,58607,1.2179869576494127,0.308302121033583
22166,0.5736785714285715,0,2,0,474123,131487,49349,58607,1.2179684315832375,0.30830536471429926
22167,0.5736904761904761,0,2,0,474125,131485,49349,58607,1.2179499055170626,0.3083086084632704
22168,0.5736904761904762,0,1,0,474126,131484,49349,58607,1.217940642483975,0.3083102303633523
22169,0.5736904761904763,0,4,0,474130,131480,49349,58607,1.2179035903516247,0.308316718134328
22170,0.5737142857142856,0,1,0,474131,131479,49349,58607,1.2178943273185372,0.3083183401197353
22171,0.5737142857142857,0,1,0,474132,131478,49349,58607,1.2178850642854497,0.30831996212220847
22172,0.5737380952380952,0,1,0,474133,131477,49349,58607,1.217875801252362,0.3083215841417479
22173,0.57375,0,5,0,474138,131472,49349,58607,1.2178294860869243,0.3083296944954466
22174,0.5737619047619047,0,1,0,474139,131471,49349,58607,1.2178202230538369,0.30833131661738866
22175,0.5737777777777777,1,1,1,474140,131470,49350,58606,1.2178109600207492,0.30832929985900376
22176,0.5737857142857142,0,2,0,474142,131468,49350,58606,1.217792433954574,0.3083325441670086
22177,0.5737857142857143,1,2,1,474144,131466,49351,58605,1.217773907888399,0.30833214956516247
22178,0.5737987012987013,1,0,1,474144,131466,49352,58604,1.217773907888399,0.3083285105487452
22179,0.5738095238095238,1,3,1,474147,131463,49353,58603,1.2177461187891363,0.3083297380909789
22180,0.5738333333333333,0,11,0,474158,131452,49353,58603,1.2176442254251731,0.3083475835942227
22181,0.5738333333333334,0,3,0,474161,131449,49353,58603,1.2176164363259105,0.3083524509081725
22182,0.5738571428571428,0,2,0,474163,131447,49353,58603,1.2175979102597354,0.308355695869508
22183,0.5738809523809523,0,1,0,474164,131446,49353,58603,1.217588647226648,0.3083573183757873
22184,0.5738888888888889,0,2,0,474166,131444,49353,58603,1.2175701211604728,0.3083605634395702
22185,0.5738928571428572,0,1,0,474167,131443,49353,58603,1.2175608581273851,0.3083621859970744
22186,0.5739047619047618,0,1,0,474168,131442,49353,58603,1.2175515950942977,0.3083638085716541
22187,0.5739047619047619,0,2,0,474170,131440,49353,58603,1.2175330690281225,0.30836705377204104
22188,0.5739166666666666,0,3,0,474173,131437,49353,58603,1.21750527992886,0.3083719217006946
22189,0.5739166666666667,0,3,0,474176,131434,49353,58603,1.2174774908295973,0.3083767897830422
22190,0.5739285714285715,1,0,1,474176,131434,49354,58602,1.2174774908295973,0.3083731503504599
22191,0.5739523809523809,0,1,0,474177,131433,49354,58602,1.2174682277965096,0.30837477306811906
22192,0.573952380952381,1,0,1,474177,131433,49355,58601,1.2174682277965096,0.3083711335866213
22193,0.5739880952380951,1,0,1,474177,131433,49356,58600,1.2174682277965096,0.30836749406681996
22194,0.574,24,80,24,474257,131353,49380,58576,1.2167271851495054,0.3084099847837876
22195,0.5740000000000001,0,6,0,474263,131347,49380,58576,1.21667160695098,0.3084197279950296
22196,0.5740054945054944,0,1,0,474264,131346,49380,58576,1.2166623439178925,0.3084213519234212
22197,0.5740238095238096,0,1,0,474265,131345,49380,58576,1.2166530808848048,0.30842297586891393
22198,0.574047619047619,0,3,0,474268,131342,49380,58576,1.2166252917855422,0.30842784780800137
22199,0.5740476190476191,0,1,0,474269,131341,49380,58576,1.2166160287524548,0.30842947182190117
22200,0.5741190476190476,0,1,0,474270,131340,49380,58576,1.216606765719367,0.3084310958529034
22201,0.5741666666666666,12,74,12,474344,131266,49392,58564,1.215921301270888,0.30850761207396094
22202,0.5741666666666667,6,29,6,474373,131237,49398,58558,1.215652673311349,0.30853289075054663
22203,0.5741666666666668,0,6,0,474379,131231,49398,58558,1.2155970951128237,0.30854264472651205
22204,0.5742023809523811,0,1,0,474380,131230,49398,58558,1.2155878320797362,0.30854427044913274
22205,0.5742301587301587,0,4,0,474384,131226,49398,58558,1.215550779947386,0.30855077351093874
22206,0.5742777777777779,0,1,0,474385,131225,49398,58558,1.2155415169142985,0.30855239931922246
22207,0.5742857142857143,3,9,3,474394,131216,49401,58555,1.2154581496165104,0.3085561018279927
22208,0.5743055555555556,0,1,0,474395,131215,49401,58555,1.215448886583423,0.30855772777572854
22209,0.5743333333333333,3,11,3,474406,131204,49404,58552,1.2153469932194598,0.3085646830666751
22210,0.5743333333333334,3,25,3,474431,131179,49407,58549,1.215115417392271,0.30859440883791533
22211,0.5743333333333335,0,1,0,474432,131178,49407,58549,1.2151061543591835,0.3085960353560642
22212,0.5743571428571429,0,1,0,474433,131177,49407,58549,1.2150968913260958,0.3085976618913591
22213,0.5743809523809523,0,1,0,474434,131176,49407,58549,1.2150876282930083,0.30859928844380025
22214,0.5744047619047619,1,1,1,474435,131175,49408,58548,1.2150783652599206,0.3085972707578944
22215,0.5744444444444444,0,1,0,474436,131174,49408,58548,1.2150691022268332,0.3085988973339939
22216,0.5744444444444445,1,0,1,474436,131174,49409,58547,1.2150691022268332,0.3085952530294485
22217,0.5745,5,14,5,474450,131160,49414,58542,1.2149394197636074,0.3085998039029636
22218,0.5745000000000001,0,1,0,474451,131159,49414,58542,1.2149301567305197,0.3086014306724793
22219,0.5745238095238094,0,2,0,474453,131157,49414,58542,1.2149116306643448,0.30860468426296395
22220,0.5745238095238095,0,2,0,474455,131155,49414,58542,1.2148931045981697,0.30860793792205465
22221,0.5745476190476192,1,0,1,474455,131155,49415,58541,1.2148931045981697,0.3086042931848853
22222,0.5746190476190476,0,1,0,474456,131154,49415,58541,1.214883841565082,0.3086059200295211
22223,0.5746190476190477,0,1,0,474457,131153,49415,58541,1.2148745785319945,0.30860754689130915
22224,0.5746341436341436,0,4,0,474461,131149,49415,58541,1.2148375263996443,0.30861405450998997
22225,0.5746428571428571,2,3,2,474464,131146,49417,58539,1.2148097373003817,0.3086116456230066
22226,0.5746666666666667,5,20,5,474484,131126,49422,58534,1.2146244766386305,0.3086259622482337
22227,0.5746666666666668,0,1,0,474485,131125,49422,58534,1.214615213605543,0.3086275895159207
22228,0.5747023809523809,0,1,0,474486,131124,49422,58534,1.2146059505724554,0.3086292168007677
22229,0.5747142857142857,1,1,1,474487,131123,49423,58533,1.214596687539368,0.3086271987176783
22230,0.57475,0,1,0,474488,131122,49423,58533,1.2145874245062804,0.3086288260262055
22231,0.5747777777777777,0,1,0,474489,131121,49423,58533,1.2145781614731928,0.30863045335189343
22232,0.5747976190476191,0,1,0,474490,131120,49423,58533,1.2145688984401053,0.3086320806947425
22233,0.5748095238095238,0,1,0,474491,131119,49423,58533,1.2145596354070176,0.30863370805475293
22234,0.5748333333333333,2,10,2,474501,131109,49425,58531,1.2144670050761421,0.30864269141531325
22235,0.5748333333333334,0,2,0,474503,131107,49425,58531,1.214448479009967,0.3086459464875183
22236,0.5748571428571428,1,0,1,474503,131107,49426,58530,1.214448479009967,0.3086423008168237
22237,0.5748593073593073,1,0,1,474503,131107,49427,58529,1.214448479009967,0.30863865510767996
22238,0.5748809523809524,1,2,1,474505,131105,49428,58528,1.2144299529437919,0.3086382644370969
22239,0.5748809523809525,0,1,0,474506,131104,49428,58528,1.2144206899107044,0.30863989200135
22240,0.5749545454545455,1,1,1,474507,131103,49429,58527,1.2144114268776167,0.3086378737541528
22241,0.574984126984127,0,1,0,474508,131102,49429,58527,1.2144021638445293,0.3086395013420943
22242,0.575,231,807,231,475315,130295,49660,58296,1.206926896142873,0.309113372324236
22243,0.5750000000000001,5,17,5,475332,130278,49665,58291,1.2067694245803846,0.30912292052246126
22244,0.5750119047619048,0,1,0,475333,130277,49665,58291,1.2067601615472971,0.3091245598404819
22245,0.5750714285714286,0,1,0,475334,130276,49665,58291,1.2067508985142095,0.30912619917588974
22246,0.5750833333333333,0,1,0,475335,130275,49665,58291,1.206741635481122,0.3091278385286849
22247,0.5751060606060606,0,1,0,475336,130274,49665,58291,1.2067323724480343,0.30912947789886774
22248,0.5751309523809524,0,1,0,475337,130273,49665,58291,1.2067231094149469,0.30913111728643855
22249,0.5751428571428572,1,1,1,475338,130272,49666,58290,1.2067138463818592,0.3091290928182773
22250,0.5751666666666666,4,9,4,475347,130263,49670,58286,1.2066304790840714,0.30912919188115556
22251,0.5751666666666667,0,6,0,475353,130257,49670,58286,1.206574900885546,0.30913902929305254
22252,0.5751666666666668,0,1,0,475354,130256,49670,58286,1.2065656378524585,0.3091406689225743
22253,0.5752142857142857,1,0,1,475354,130256,49671,58285,1.2065656378524585,0.3091370046833315
22254,0.5752380952380952,1,4,1,475358,130252,49672,58284,1.2065285857201082,0.3091398990113294
22255,0.5752698412698413,0,1,0,475359,130251,49672,58284,1.2065193226870206,0.309141538706341
22256,0.575297619047619,0,1,0,475360,130250,49672,58284,1.206510059653933,0.3091431784187468
22257,0.5753333333333333,0,9,0,475369,130241,49672,58284,1.206426692356145,0.30915793661318125
22258,0.5753333333333334,7,25,7,475394,130216,49679,58277,1.2061951165289562,0.30917328494957375
22259,0.5753571428571429,2,1,2,475395,130215,49681,58275,1.2061858534958687,0.30916759509788316
22260,0.5753809523809523,1,1,1,475396,130214,49682,58274,1.206176590462781,0.309165570221977
22261,0.5754047619047619,0,2,0,475398,130212,49682,58274,1.2061580643966061,0.30916885073692474
22262,0.5754166666666667,0,3,0,475401,130209,49682,58274,1.2061302752973433,0.30917377163988263
22263,0.5754285714285714,1,0,1,475401,130209,49683,58273,1.2061302752973433,0.3091701064292611
22264,0.575465367965368,1,0,1,475401,130209,49684,58272,1.2061302752973433,0.30916644117974756
22265,0.5754761904761905,0,5,0,475406,130204,49684,58272,1.2060839601319056,0.3091746429253592
22266,0.5754999999999999,0,4,0,475410,130200,49684,58272,1.2060469079995553,0.3091812046351713
22267,0.5755,3,20,3,475430,130180,49687,58269,1.2058616473378043,0.3092030204458501
22268,0.5755238095238095,0,2,0,475432,130178,49687,58269,1.2058431212716292,0.3092063020371776
22269,0.575547619047619,0,1,0,475433,130177,49687,58269,1.2058338582385417,0.30920794285896225
22270,0.5755555555555556,0,2,0,475435,130175,49687,58269,1.2058153321723666,0.3092112245547749
22271,0.575595238095238,1,0,1,475435,130175,49688,58268,1.2058153321723666,0.3092075587843539
22272,0.5755952380952382,0,1,0,475436,130174,49688,58268,1.205806069139279,0.30920919964763693
22273,0.5756190476190476,1,1,1,475437,130173,49689,58267,1.2057968061061914,0.30920717469751646
22274,0.5756428571428572,0,1,0,475438,130172,49689,58267,1.2057875430731038,0.3092088155848842
22275,0.5756666666666667,4,24,4,475462,130148,49693,58263,1.2055652302790025,0.30923353732000786
22276,0.5756666666666669,1,0,1,475462,130148,49694,58262,1.2055652302790025,0.30922987102595406
22277,0.5756785714285714,0,1,0,475463,130147,49694,58262,1.205555967245915,0.30923151229506024
22278,0.5757142857142857,7,19,7,475482,130128,49701,58255,1.2053799696172516,0.30923703306561634
22279,0.5757142857142858,0,1,0,475483,130127,49701,58255,1.205370706584164,0.3092386746079774
22280,0.57575,0,1,0,475484,130126,49701,58255,1.2053614435510764,0.30924031616776637
22281,0.5757857142857143,0,2,0,475486,130124,49701,58255,1.2053429174849013,0.30924359933962914
22282,0.5758055555555557,1,0,1,475486,130124,49702,58254,1.2053429174849013,0.30923993247619147
22283,0.5758095238095238,0,1,0,475487,130123,49702,58254,1.2053336544518136,0.3092415740775148
22284,0.5758333333333332,0,1,0,475488,130122,49702,58254,1.2053243914187262,0.30924321569626706
22285,0.5758333333333333,21,83,21,475571,130039,49723,58233,1.204555559672459,0.30930249851279
22286,0.5758333333333334,1,3,1,475574,130036,49724,58232,1.2045277705731965,0.3093037584719655
22287,0.5758809523809524,0,1,0,475575,130035,49724,58232,1.204518507540109,0.3093054013714565
22288,0.5759047619047619,0,1,0,475576,130034,49724,58232,1.2045092445070213,0.30930704428840045
22289,0.5759166666666666,0,1,0,475577,130033,49724,58232,1.204499981473934,0.30930868722279764
22290,0.5759285714285715,1,0,1,475577,130033,49725,58231,1.204499981473934,0.30930501848468106
22291,0.5759404761904762,0,4,0,475581,130029,49725,58231,1.2044629293415836,0.30931159035376604
22292,0.575952380952381,1,5,1,475586,130024,49726,58230,1.2044166141761459,0.30931613670891456
22293,0.5759682539682539,0,1,0,475587,130023,49726,58230,1.2044073511430582,0.3093177797963379
22294,0.5759761904761904,0,1,0,475588,130022,49726,58230,1.2043980881099707,0.3093194229012175
22295,0.5759761904761905,0,1,0,475589,130021,49726,58230,1.2043888250768833,0.30932106602355364
22296,0.5759999999999998,0,1,0,475590,130020,49726,58230,1.2043795620437956,0.3093227091633466
22297,0.576,0,3,0,475593,130017,49726,58230,1.204351772944533,0.3093276386874691
22298,0.5760000000000001,16,99,16,475692,129918,49742,58214,1.203434732668865,0.3094316756320031
22299,0.576047619047619,0,1,0,475693,129917,49742,58214,1.2034254696357776,0.3094333203990836
22300,0.5760714285714286,1,1,1,475694,129916,49743,58213,1.2034162066026899,0.309431294484104
22301,0.5760952380952381,0,1,0,475695,129915,49743,58213,1.2034069435696024,0.30943293927538695
22302,0.5761190476190476,1,0,1,475695,129915,49744,58212,1.2034069435696024,0.3094292685260489
22303,0.5761190476190478,1,0,1,475695,129915,49745,58211,1.2034069435696024,0.30942559773768646
22304,0.5761309523809524,1,2,1,475697,129913,49746,58210,1.2033884175034273,0.30942521648070676
22305,0.5761666666666666,1,1,1,475698,129912,49747,58209,1.2033791544703398,0.309423190393417
22306,0.5761666666666667,3,8,3,475706,129904,49750,58206,1.2033050502056393,0.30942533623943436
22307,0.5761680672268907,0,1,0,475707,129903,49750,58206,1.2032957871725518,0.30942698116517553
22308,0.5762222222222222,0,1,0,475708,129902,49750,58206,1.2032865241394641,0.3094286261084058
22309,0.5762499999999999,1,0,1,475708,129902,49751,58205,1.2032865241394641,0.30942495494585526
22310,0.57625,1,6,1,475714,129896,49752,58204,1.203230945940939,0.30943115364167995
22311,0.5762777777777778,1,2,1,475716,129894,49753,58203,1.2032124198747638,0.3094307724206128
22312,0.5762857142857143,1,4,1,475720,129890,49754,58202,1.2031753677424135,0.3094336813899581
22313,0.5763333333333333,0,6,0,475726,129884,49754,58202,1.2031197895438883,0.30944355241751115
22314,0.5763333333333334,3,10,3,475736,129874,49757,58199,1.2030271592130126,0.3094489905515412
22315,0.5763571428571429,0,1,0,475737,129873,49757,58199,1.2030178961799252,0.3094506359266664
22316,0.5763787878787879,0,1,0,475738,129872,49757,58199,1.2030086331468377,0.309452281319289
22317,0.5763809523809524,1,1,1,475739,129871,49758,58198,1.20299937011375,0.30945025495961587
22318,0.5764090909090909,0,2,0,475741,129869,49758,58198,1.2029808440475749,0.3094535458108015
22319,0.5764285714285714,0,2,0,475743,129867,49758,58198,1.2029623179813997,0.309456836731981
22320,0.5764761904761905,0,1,0,475744,129866,49758,58198,1.2029530549483123,0.3094584822188191
22321,0.5764920634920635,0,1,0,475745,129865,49758,58198,1.2029437919152248,0.3094601277231566
22322,0.5764999999999999,0,1,0,475746,129864,49758,58198,1.2029345288821371,0.3094617732449937
22323,0.5765,6,12,6,475758,129852,49764,58192,1.2028233724850865,0.3094594882048882
22324,0.576547619047619,1,0,1,475758,129852,49765,58191,1.2028233724850865,0.30945581595698857
22325,0.5765555555555556,1,0,1,475758,129852,49766,58190,1.2028233724850865,0.30945214367003115
22326,0.5765753968253968,0,1,0,475759,129851,49766,58190,1.202814109451999,0.30945378933317735
22327,0.5765833333333333,0,1,0,475760,129850,49766,58190,1.2028048464189114,0.30945543501382683
22328,0.5766547619047618,0,1,0,475761,129849,49766,58190,1.202795583385824,0.30945708071197997
22329,0.5766666666666665,0,4,0,475765,129845,49766,58190,1.2027585312534737,0.3094636636796341
22330,0.5766666666666667,110,462,110,476227,129383,49876,58080,1.1984790099670235,0.3098211380379062
22331,0.5766666666666668,0,2,0,476229,129381,49876,58080,1.1984604839008486,0.3098244434842447
22332,0.5766904761904762,1,0,1,476229,129381,49877,58079,1.1984604839008486,0.30982076176250933
22333,0.5767380952380952,0,1,0,476230,129380,49877,58079,1.198451220867761,0.30982241450130427
22334,0.5767500000000001,0,1,0,476231,129379,49877,58079,1.1984419578346734,0.30982406725773237
22335,0.5767857142857142,0,1,0,476232,129378,49877,58079,1.1984326948015858,0.309825720031794
22336,0.5767857142857143,1,4,1,476236,129374,49878,58078,1.1983956426692357,0.30982864946759703
22337,0.5768095238095238,0,1,0,476237,129373,49878,58078,1.198386379636148,0.30983030231900605
22338,0.5768333333333333,0,4,0,476241,129369,49878,58078,1.1983493275037977,0.309836913900996
22339,0.5768333333333334,2,14,2,476255,129355,49880,58076,1.198219645040572,0.30985269245749103
22340,0.5768571428571428,0,1,0,476256,129354,49880,58076,1.1982103820074845,0.3098543456223657
22341,0.5768888888888888,1,0,1,476256,129354,49881,58075,1.1982103820074845,0.30985066345122686
22342,0.5769166666666666,1,2,1,476258,129352,49882,58074,1.1981918559413094,0.309850287580165
22343,0.576952380952381,1,1,1,476259,129351,49883,58073,1.198182592908222,0.30984825849410963
22344,0.5769642857142857,0,3,0,476262,129348,49883,58073,1.1981548038089591,0.3098532181559164
22345,0.5769999999999998,0,1,0,476263,129347,49883,58073,1.1981455407758717,0.30985487141180235
22346,0.577,2,2,2,476265,129345,49885,58071,1.1981270147096965,0.3098508131642976
22347,0.5770000000000001,4,30,4,476295,129315,49889,58067,1.1978491237170699,0.3098856880596856
22348,0.5770238095238095,0,1,0,476296,129314,49889,58067,1.1978398606839824,0.30988734183294997
22349,0.5770238095238096,0,2,0,476298,129312,49889,58067,1.1978213346178073,0.3098906494324337
22350,0.577060606060606,2,4,2,476302,129308,49891,58065,1.197784282485457,0.30988989875809214
22351,0.5770833333333334,0,1,0,476303,129307,49891,58065,1.1977750194523695,0.3098915526332643
22352,0.577095238095238,0,3,0,476306,129304,49891,58065,1.197747230353107,0.3098965143647028
22353,0.5771111111111111,0,1,0,476307,129303,49891,58065,1.1977379673200192,0.3098981683104906
22354,0.5771190476190475,0,2,0,476309,129301,49891,58065,1.197719441253844,0.3099014762550303
22355,0.5771428571428572,2,7,2,476316,129294,49893,58063,1.1976546000222312,0.3099056880714358
22356,0.5771666666666666,2,2,2,476318,129292,49895,58061,1.197636073956056,0.30990162954422934
22357,0.5771666666666667,2,5,2,476323,129287,49897,58059,1.1975897587906184,0.30990253328066786
22358,0.5771904761904763,1,0,1,476323,129287,49898,58058,1.1975897587906184,0.30989884971576503
22359,0.5772142857142857,0,1,0,476324,129286,49898,58058,1.197580495757531,0.30990050388589974
22360,0.57725,0,2,0,476326,129284,49898,58058,1.1975619696913558,0.3099038122791472
22361,0.5772619047619048,1,2,1,476328,129282,49899,58057,1.1975434436251806,0.30990343708464335
22362,0.5772619047619049,0,2,0,476330,129280,49899,58057,1.1975249175590055,0.3099067455975061
22363,0.5773174603174605,0,1,0,476331,129279,49899,58057,1.197515654525918,0.30990839988042873
22364,0.5773333333333331,0,1,0,476332,129278,49899,58057,1.1975063914928303,0.30991005418101264
22365,0.5773333333333333,0,7,0,476339,129271,49899,58057,1.1974415502612175,0.30992163477963786
22366,0.5773333333333334,3,17,3,476356,129254,49902,58054,1.197284078698729,0.30993871057296
22367,0.5773611111111111,0,1,0,476357,129253,49902,58054,1.1972748156656416,0.3099403652826643
22368,0.5773769841269839,0,1,0,476358,129252,49902,58054,1.197265552632554,0.30994202001003707
22369,0.5773809523809523,0,4,0,476362,129248,49902,58054,1.1972285005002037,0.30994863909621895
22370,0.5773809523809524,0,4,0,476366,129244,49902,58054,1.1971914483678536,0.30995525846511973
22371,0.5774285714285715,0,3,0,476369,129241,49902,58054,1.1971636592685908,0.30996022317734057
22372,0.5774891774891775,1,0,1,476369,129241,49903,58053,1.1971636592685908,0.3099565389174239
22373,0.5774999999999999,1,10,1,476379,129231,49904,58052,1.1970710289377153,0.3099694045909132
22374,0.5775,54,278,54,476657,128953,49958,57998,1.1944959057393754,0.3102310231023102
22375,0.5775000000000001,0,6,0,476663,128947,49958,57998,1.19444032754085,0.3102409799673701
22376,0.577547619047619,0,3,0,476666,128944,49958,57998,1.1944125384415873,0.31024595863957805
22377,0.5775952380952382,0,1,0,476667,128943,49958,57998,1.1944032754084997,0.3102476182324905
22378,0.5776071428571428,1,1,1,476668,128942,49959,57997,1.1943940123754122,0.31024558813302733
22379,0.5776190476190476,1,0,1,476668,128942,49960,57996,1.1943940123754122,0.31024189838342126
22380,0.5776190476190477,0,3,0,476671,128939,49960,57996,1.1943662232761496,0.3102468772568005
22381,0.5776428571428571,0,1,0,476672,128938,49960,57996,1.194356960243062,0.3102485369167728
22382,0.5776666666666667,2,19,2,476691,128919,49962,57994,1.1941809626143984,0.3102726937131179
22383,0.5776666666666668,0,6,0,476697,128913,49962,57994,1.1941253844158732,0.31028265394019483
22384,0.5776923076923076,0,1,0,476698,128912,49962,57994,1.1941161213827856,0.3102843140402127
22385,0.5777142857142857,0,2,0,476700,128910,49962,57994,1.1940975953166104,0.31028763429354106
22386,0.5777142857142858,0,1,0,476701,128909,49962,57994,1.194088332283523,0.3102892944468521
22387,0.5777380952380952,0,1,0,476702,128908,49962,57994,1.1940790692504353,0.3102909546179281
22388,0.5777380952380953,1,0,1,476702,128908,49963,57993,1.1940790692504353,0.31028726438060794
22389,0.57775,0,1,0,476703,128907,49963,57993,1.1940698062173478,0.3102889245585875
22390,0.5777619047619048,1,2,1,476705,128905,49964,57992,1.1940512801511727,0.31028855465844823
22391,0.5777777777777778,0,1,0,476706,128904,49964,57992,1.1940420171180852,0.3102902148788631
22392,0.5778095238095238,0,2,0,476708,128902,49964,57992,1.19402349105191,0.3102935353729922
22393,0.5778333333333332,1,0,1,476708,128902,49965,57991,1.19402349105191,0.31028984499151924
22394,0.5778333333333333,3,4,3,476712,128898,49968,57988,1.1939864389195598,0.31028541463780057
22395,0.5778333333333334,4,5,4,476717,128893,49972,57984,1.193940123754122,0.3102789535362832
22396,0.5778571428571427,0,1,0,476718,128892,49972,57984,1.1939308607210346,0.31028061388300265
22397,0.5778571428571428,0,4,0,476722,128888,49972,57984,1.1938938085886843,0.31028725544757907
22398,0.5778888888888889,0,1,0,476723,128887,49972,57984,1.1938845455555966,0.31028891588314933
22399,0.5779166666666666,1,2,1,476725,128885,49973,57983,1.1938660194894217,0.3102885459254661
22400,0.5779166666666667,1,1,1,476726,128884,49974,57982,1.193856756456334,0.3102865154709792
22401,0.5779393939393939,0,2,0,476728,128882,49974,57982,1.193838230390159,0.3102898364586009
22402,0.5779761904761904,0,1,0,476729,128881,49974,57982,1.1938289673570714,0.3102914969790702
22403,0.5779761904761905,0,1,0,476730,128880,49974,57982,1.1938197043239838,0.31029315751731223
22404,0.5779999999999998,1,0,1,476730,128880,49975,57981,1.1938197043239838,0.31028946650183825
22405,0.578,15,72,15,476802,128808,49990,57966,1.1931527659416798,0.3103536894856886
22406,0.5780000000000001,1,6,1,476808,128802,49991,57965,1.1930971877431547,0.31035996723189857
22407,0.5780108225108225,1,1,1,476809,128801,49992,57964,1.193087924710067,0.31035793644419457
22408,0.5780714285714286,0,1,0,476810,128800,49992,57964,1.1930786616769795,0.31035959820950504
22409,0.5780768675768675,0,1,0,476811,128799,49992,57964,1.193069398643892,0.31036125999261094
22410,0.5780952380952381,0,1,0,476812,128798,49992,57964,1.1930601356108044,0.3103629217935126
22411,0.5781190476190476,1,0,1,476812,128798,49993,57963,1.1930601356108044,0.3103592291752561
22412,0.5781428571428571,0,1,0,476813,128797,49993,57963,1.193050872577717,0.3103608909830799
22413,0.5781666666666666,1,10,1,476823,128787,49994,57962,1.1929582422468412,0.31037381726274305
22414,0.5781666666666667,1,3,1,476826,128784,49995,57961,1.1929304531475786,0.3103751104447241
22415,0.5781904761904761,0,1,0,476827,128783,49995,57961,1.1929211901144912,0.3103767724799726
22416,0.5782738095238095,0,2,0,476829,128781,49995,57961,1.192902664048316,0.31038009660387056
22417,0.5782857142857143,0,1,0,476830,128780,49995,57961,1.1928934010152283,0.31038175869252066
22418,0.5783333333333333,19,108,19,476938,128672,50014,57942,1.1918929934417726,0.31049117429560485
22419,0.5783333333333334,35,167,35,477105,128505,50049,57907,1.190346066916151,0.3106398729695513
22420,0.5783333333333335,0,3,0,477108,128502,50049,57907,1.1903182778168884,0.31064487229693843
22421,0.57834126984127,0,1,0,477109,128501,50049,57907,1.190309014783801,0.31064653877515985
22422,0.5783809523809523,0,1,0,477110,128500,50049,57907,1.1902997517507132,0.31064820527126125
22423,0.5784285714285715,0,1,0,477111,128499,50049,57907,1.1902904887176258,0.31064987178524295
22424,0.5784999999999999,0,3,0,477114,128496,50049,57907,1.190262699618363,0.3106548714344726
22425,0.5785,2,17,2,477131,128479,50051,57905,1.1901052280558746,0.31067580908232467
22426,0.5785119047619047,0,2,0,477133,128477,50051,57905,1.1900867019896995,0.31067914283568154
22427,0.5785476190476192,0,1,0,477134,128476,50051,57905,1.190077438956612,0.31068080973919016
22428,0.5785634920634921,1,0,1,477134,128476,50052,57904,1.190077438956612,0.3106771112780341
22429,0.5785714285714285,1,1,1,477135,128475,50053,57903,1.1900681759235243,0.31067507967678587
22430,0.5785714285714286,1,2,1,477137,128473,50054,57902,1.1900496498573494,0.3106747149564051
22431,0.5786190476190477,0,1,0,477138,128472,50054,57902,1.1900403868242617,0.3106763818987627
22432,0.5786309523809524,1,2,1,477140,128470,50055,57901,1.1900218607580866,0.31067601719151583
22433,0.5786428571428571,2,0,2,477140,128470,50057,57899,1.1900218607580866,0.31066861978118676
22434,0.5786623376623377,0,1,0,477141,128469,50057,57899,1.1900125977249991,0.3106702867445055
22435,0.5786666666666666,2,2,2,477143,128467,50059,57897,1.189994071658824,0.3106662230902964
22436,0.5786666666666667,7,21,7,477164,128446,50066,57890,1.1897995479639853,0.310675339172248
22437,0.5786666666666668,2,3,2,477167,128443,50068,57888,1.1897717588647228,0.31067294223720154
22438,0.5786904761904762,1,0,1,477167,128443,50069,57887,1.1897717588647228,0.3106692427413728
22439,0.5787301587301585,0,1,0,477168,128442,50069,57887,1.189762495831635,0.3106709100569423
22440,0.5787380952380952,0,3,0,477171,128439,50069,57887,1.1897347067323725,0.3106759121110312
22441,0.57875,3,8,3,477179,128431,50072,57884,1.189660602467672,0.31067815259104203
22442,0.5787820512820513,1,0,1,477179,128431,50073,57883,1.189660602467672,0.3106744528054789
22443,0.5787857142857142,0,2,0,477181,128429,50073,57883,1.189642076401497,0.31067778779681393
22444,0.5788076923076924,0,1,0,477182,128428,50073,57883,1.1896328133684093,0.31067945531933167
22445,0.5788095238095238,0,4,0,477186,128424,50073,57883,1.189595761236059,0.3106861255884105
22446,0.5788095238095239,0,1,0,477187,128423,50073,57883,1.1895864982029716,0.3106877932004337
22447,0.5788174603174603,0,1,0,477188,128422,50073,57883,1.1895772351698841,0.3106894608303588
22448,0.5788237318237319,0,2,0,477190,128420,50073,57883,1.189558709103709,0.3106927961439161
22449,0.5788333333333333,3,15,3,477205,128405,50076,57880,1.1894197636073955,0.31070671283248785
22450,0.5788333333333334,0,5,0,477210,128400,50076,57880,1.1893734484419578,0.31071505260897575
22451,0.5788809523809523,0,1,0,477211,128399,50076,57880,1.1893641854088703,0.3107167206179977
22452,0.5788888888888889,0,2,0,477213,128397,50076,57880,1.1893456593426952,0.3107200566897685
22453,0.5789285714285713,1,0,1,477213,128397,50077,57879,1.1893456593426952,0.31071635637441214
22454,0.5789285714285715,0,3,0,477216,128394,50077,57879,1.1893178702434326,0.31072136058365946
22455,0.5789523809523809,0,1,0,477217,128393,50077,57879,1.189308607210345,0.31072302868922863
22456,0.5789761904761904,0,4,0,477221,128389,50077,57879,1.1892715550779946,0.3107297012906135
22457,0.5789960317460318,0,2,0,477223,128387,50077,57879,1.1892530290118197,0.31073303769877486
22458,0.579,11,48,11,477271,128339,50088,57868,1.188808403423617,0.31077241994124816
22459,0.5790000000000001,0,3,0,477274,128336,50088,57868,1.1887806143243544,0.31077742690812227
22460,0.579047619047619,2,7,2,477281,128329,50090,57866,1.1887157730927416,0.3107817073498214
22461,0.579060606060606,0,1,0,477282,128328,50090,57866,1.1887065100596539,0.31078337647829685
22462,0.5790714285714287,0,1,0,477283,128327,50090,57866,1.1886972470265664,0.3107850456247013
22463,0.5791666666666666,15,64,15,477347,128263,50105,57851,1.1881044129089628,0.3108363691071064
22464,0.5791666666666667,7,47,7,477394,128216,50112,57844,1.1876690503538478,0.3108889605503601
22465,0.5792499999999999,0,2,0,477396,128214,50112,57844,1.1876505242876727,0.3108923024003268
22466,0.5792619047619048,0,1,0,477397,128213,50112,57844,1.1876412612545852,0.3108939733522523
22467,0.5792857142857143,2,7,2,477404,128206,50114,57842,1.1875764200229724,0.3108982628138975
22468,0.5792915417915419,0,1,0,477405,128205,50114,57842,1.1875671569898847,0.31089993388767356
22469,0.5793095238095238,1,0,1,477405,128205,50115,57841,1.1875671569898847,0.3108962299646324
22470,0.5793174603174603,0,4,0,477409,128201,50115,57841,1.1875301048575346,0.3109029143956741
22471,0.5793333333333333,1,6,1,477415,128195,50116,57840,1.1874745266590092,0.3109092375090709
22472,0.5793333333333334,6,24,6,477439,128171,50122,57834,1.187252213864908,0.3109271256149028
22473,0.5793333333333335,0,2,0,477441,128169,50122,57834,1.1872336877987328,0.3109304688634054
22474,0.5793809523809523,0,2,0,477443,128167,50122,57834,1.1872151617325577,0.31093381218380545
22475,0.5794047619047619,0,2,0,477445,128165,50122,57834,1.1871966356663826,0.31093715557610524
22476,0.5794444444444444,1,1,1,477446,128164,50123,57833,1.187187372633295,0.31093512260950446
22477,0.5794444444444445,0,1,0,477447,128163,50123,57833,1.1871781096002074,0.3109367943396632
22478,0.5794523809523809,0,2,0,477449,128161,50123,57833,1.1871595835340323,0.3109401378539093
22479,0.5794761904761905,0,1,0,477450,128160,50123,57833,1.1871503205009448,0.3109418096379971
22480,0.5794999999999999,0,2,0,477452,128158,50123,57833,1.1871317944347697,0.31094515326010397
22481,0.5795,6,10,6,477462,128148,50129,57827,1.1870391641038942,0.3109396424250571
22482,0.5795000000000001,0,1,0,477463,128147,50129,57827,1.1870299010708065,0.31094131437727857
22483,0.5795238095238094,2,3,2,477466,128144,50131,57825,1.187002111971544,0.3109389199275148
22484,0.5795238095238096,0,1,0,477467,128143,50131,57825,1.1869928489384565,0.3109405919297944
22485,0.579547619047619,0,1,0,477468,128142,50131,57825,1.1869835859053688,0.31094226395005564
22486,0.5795476190476191,0,1,0,477469,128141,50131,57825,1.1869743228722813,0.31094393598829895
22487,0.5795714285714285,1,0,1,477469,128141,50132,57824,1.1869743228722813,0.3109402306885704
22488,0.5795714285714287,2,0,2,477469,128141,50134,57822,1.1869743228722813,0.31093281996956385
22489,0.5795793650793651,0,2,0,477471,128139,50134,57822,1.1869557968061062,0.31093616403439434
22490,0.5795833333333333,0,3,0,477474,128136,50134,57822,1.1869280077068436,0.3109411802665118
22491,0.5796095848595848,1,0,1,477474,128136,50135,57821,1.1869280077068436,0.31093747479255957
22492,0.5796190476190476,1,1,1,477475,128135,50136,57820,1.186918744673756,0.310935441370224
22493,0.5796190476190478,0,1,0,477476,128134,50136,57820,1.1869094816406685,0.3109371134796778
22494,0.5796428571428571,0,4,0,477480,128130,50136,57820,1.1868724295083182,0.310943802097338
22495,0.5796666666666666,0,2,0,477482,128128,50136,57820,1.186853903442143,0.31094714651407923
22496,0.5796666666666667,4,33,4,477515,128095,50140,57816,1.1865482233502538,0.31098751553162535
22497,0.5796666666666668,0,2,0,477517,128093,50140,57816,1.1865296972840786,0.3109908611202255
22498,0.5796904761904762,0,1,0,477518,128092,50140,57816,1.1865204342509912,0.3109925339415195
22499,0.5797222222222222,0,2,0,477520,128090,50140,57816,1.186501908184816,0.31099587963809666
22500,0.5797380952380954,0,4,0,477524,128086,50140,57816,1.1864648560524658,0.31100257124721625
22501,0.57975,0,1,0,477525,128085,50140,57816,1.1864555930193783,0.31100424419449063
22502,0.5797500000000001,0,1,0,477526,128084,50140,57816,1.1864463299862906,0.31100591715976333
22503,0.5797777777777778,0,1,0,477527,128083,50140,57816,1.1864370669532032,0.31100759014303464
22504,0.5798333333333333,6,13,6,477540,128070,50146,57810,1.1863166475230649,0.31100710135571336
22505,0.5798333333333334,0,3,0,477543,128067,50146,57810,1.1862888584238023,0.31101212091867203
22506,0.5798484848484847,0,1,0,477544,128066,50146,57810,1.1862795953907148,0.31101379414233143
22507,0.579848484848485,0,1,0,477545,128065,50146,57810,1.1862703323576271,0.3110154673839946
22508,0.5798498168498167,0,1,0,477546,128064,50146,57810,1.1862610693245397,0.3110171406436618
22509,0.5798809523809524,1,1,1,477547,128063,50147,57809,1.186251806291452,0.31101510717052594
22510,0.5799047619047619,0,3,0,477550,128060,50147,57809,1.1862240171921894,0.311020127078749
22511,0.5799203296703295,0,1,0,477551,128059,50147,57809,1.186214754159102,0.3110218004175006
22512,0.5799523809523809,0,1,0,477552,128058,50147,57809,1.1862054911260143,0.31102347377425793
22513,0.5799577922077921,0,3,0,477555,128055,50147,57809,1.1861777020267517,0.3110284939525675
22514,0.5799999999999998,1,0,1,477555,128055,50148,57808,1.1861777020267517,0.31102478707435044
22515,0.58,539,2157,539,479712,125898,50687,57269,1.1661973396568972,0.31266003155590255
22516,0.5800000000000001,2,15,2,479727,125883,50689,57267,1.166058394160584,0.31267813267813266
22517,0.5800079365079365,0,1,0,479728,125882,50689,57267,1.1660491311274963,0.31267983991176584
22518,0.5800833333333333,0,1,0,479729,125881,50689,57267,1.1660398680944088,0.3126815471640422
22519,0.5800952380952381,0,1,0,479730,125880,50689,57267,1.1660306050613212,0.3126832544349621
22520,0.5800952380952382,0,2,0,479732,125878,50689,57267,1.1660120789951463,0.3126866690327336
22521,0.5801111111111111,0,2,0,479734,125876,50689,57267,1.165993552928971,0.3126900837050829
22522,0.5801190476190476,2,2,2,479736,125874,50691,57265,1.165975026862796,0.31268599260670854
22523,0.5801428571428571,0,1,0,479737,125873,50691,57265,1.1659657638297083,0.31268769998580304
22524,0.5801428571428572,0,1,0,479738,125872,50691,57265,1.1659565007966208,0.31268940738354345
22525,0.5801666666666666,0,9,0,479747,125863,50691,57265,1.1658731334988328,0.31270477480232406
22526,0.5801666666666667,1,0,1,479747,125863,50692,57264,1.1658731334988328,0.3127010216953262
22527,0.580190476190476,0,2,0,479749,125861,50692,57264,1.1658546074326577,0.31270443686006827
22528,0.5801904761904761,1,0,1,479749,125861,50693,57263,1.1658546074326577,0.3127006836897403
22529,0.5802380952380952,1,5,1,479754,125856,50694,57262,1.16580829226722,0.31270546860494325
22530,0.5802499999999999,0,1,0,479755,125855,50694,57262,1.1657990292341325,0.31270717628619954
22531,0.5802619047619048,0,1,0,479756,125854,50694,57262,1.1657897662010448,0.3127088839861072
22532,0.5802777777777777,0,1,0,479757,125853,50694,57262,1.1657805031679573,0.3127105917046665
22533,0.5802857142857144,0,1,0,479758,125852,50694,57262,1.1657712401348697,0.31271229944187773
22534,0.5803095238095239,0,1,0,479759,125851,50694,57262,1.1657619771017822,0.3127140071977413
22535,0.5803160173160173,0,1,0,479760,125850,50694,57262,1.1657527140686947,0.3127157149722574
22536,0.5803333333333333,0,2,0,479762,125848,50694,57262,1.1657341880025196,0.31271913057724865
22537,0.5803333333333334,3,11,3,479773,125837,50697,57259,1.1656322946385564,0.3127266570542229
22538,0.5803333333333335,0,3,0,479776,125834,50697,57259,1.1656045055392938,0.31273178111670025
22539,0.5803571428571428,1,3,1,479779,125831,50698,57258,1.165576716440031,0.31273315163663573
22540,0.5803809523809523,0,4,0,479783,125827,50698,57258,1.165539664307681,0.3127399841603627
22541,0.5804047619047619,0,1,0,479784,125826,50698,57258,1.1655304012745933,0.31274169233794324
22542,0.5804166666666667,3,2,3,479786,125824,50701,57255,1.1655118752084181,0.3127338471370283
22543,0.5804603174603175,0,1,0,479787,125823,50701,57255,1.1655026121753307,0.3127355553370694
22544,0.5804761904761905,1,2,1,479789,125821,50702,57254,1.1654840861091555,0.3127352178069097
22545,0.5805,3,19,3,479808,125802,50705,57251,1.165308088480492,0.3127564148088259
22546,0.5805000000000001,1,2,1,479810,125800,50706,57250,1.165289562414317,0.3127560775744332
22547,0.5805238095238096,0,1,0,479811,125799,50706,57250,1.1652802993812295,0.3127577861665456
22548,0.5805555555555556,0,1,0,479812,125798,50706,57250,1.1652710363481418,0.3127594947773262
22549,0.5805714285714285,0,1,0,479813,125797,50706,57250,1.1652617733150543,0.3127612034067753
22550,0.5805833333333333,1,2,1,479815,125795,50707,57249,1.1652432472488792,0.3127608662398112
22551,0.580595238095238,0,2,0,479817,125793,50707,57249,1.165224721182704,0.312764283607041
22552,0.5806666666666667,7,30,7,479847,125763,50714,57242,1.1649468301900774,0.31278926805278545
22553,0.5806746031746031,0,1,0,479848,125762,50714,57242,1.16493756715699,0.312790977246399
22554,0.5806904761904762,1,0,1,479848,125762,50715,57241,1.16493756715699,0.3127872220673978
22555,0.5806904761904763,0,1,0,479849,125761,50715,57241,1.1649283041239022,0.3127889312685107
22556,0.5807142857142857,1,7,1,479856,125754,50716,57240,1.1648634628922894,0.31279714088986527
22557,0.5807564102564103,1,3,1,479859,125751,50717,57239,1.1648356737930268,0.31279851357997707
22558,0.5807857142857142,0,3,0,479862,125748,50717,57239,1.1648078846937642,0.31280364178876097
22559,0.5807857142857143,0,1,0,479863,125747,50717,57239,1.1647986216606765,0.3128053512290558
22560,0.5808333333333333,22,86,22,479949,125661,50739,57217,1.1640020008151468,0.312869782040486
22561,0.5808333333333334,0,2,0,479951,125659,50739,57217,1.163983474748972,0.31287320370086835
22562,0.5808809523809524,0,1,0,479952,125658,50739,57217,1.1639742117158842,0.3128749145591251
22563,0.5809047619047619,0,1,0,479953,125657,50739,57217,1.1639649486827968,0.3128766254360926
22564,0.5809166666666666,0,1,0,479954,125656,50739,57217,1.163955685649709,0.31287833633177126
22565,0.580952380952381,3,2,3,479956,125654,50742,57214,1.163937159583534,0.31287048581490473
22566,0.5809761904761903,0,2,0,479958,125652,50742,57214,1.163918633517359,0.3128739076700972
22567,0.581,11,43,11,480001,125609,50753,57203,1.163520323094594,0.312906154957005
22568,0.5810000000000001,1,1,1,480002,125608,50754,57202,1.1635110600615066,0.31290410809036706
22569,0.5810238095238094,0,1,0,480003,125607,50754,57202,1.163501797028419,0.3129058197353522
22570,0.5810238095238095,1,0,1,480003,125607,50755,57201,1.163501797028419,0.3129020611789418
22571,0.5810357142857143,0,1,0,480004,125606,50755,57201,1.1634925339953315,0.31290377283145615
22572,0.5810714285714286,0,3,0,480007,125603,50755,57201,1.1634647448960687,0.31290890790135883
22573,0.5810833333333334,0,1,0,480008,125602,50755,57201,1.1634554818629812,0.3129106196287807
22574,0.5811129148629148,0,1,0,480009,125601,50755,57201,1.1634462188298937,0.31291233137493024
22575,0.5811190476190476,0,1,0,480010,125600,50755,57201,1.163436955796806,0.31291404313980775
22576,0.5811428571428572,0,1,0,480011,125599,50755,57201,1.1634276927637186,0.31291575492341356
22577,0.5811666666666667,1,8,1,480019,125591,50756,57200,1.163353588499018,0.3129256910898239
22578,0.5811706349206349,0,2,0,480021,125589,50756,57200,1.163335062432843,0.3129291149905082
22579,0.581190476190476,0,1,0,480022,125588,50756,57200,1.1633257993997554,0.31293082696894764
22580,0.5811904761904761,0,1,0,480023,125587,50756,57200,1.163316536366668,0.31293253896611906
22581,0.5811904761904763,0,1,0,480024,125586,50756,57200,1.1633072733335803,0.3129342509820227
22582,0.5812142857142857,0,2,0,480026,125584,50756,57200,1.1632887472674052,0.312937675070028
22583,0.5812142857142858,0,1,0,480027,125583,50756,57200,1.1632794842343177,0.31293938714213027
22584,0.58125,1,2,1,480029,125581,50757,57199,1.1632609581681426,0.3129390524127366
22585,0.5813095238095238,1,1,1,480030,125580,50758,57198,1.163251695135055,0.31293700554771364
22586,0.581325036075036,0,2,0,480032,125578,50758,57198,1.16323316906888,0.3129404298157307
22587,0.5813333333333333,0,4,0,480036,125574,50758,57198,1.1631961169365297,0.3129472785765872
22588,0.5813333333333334,5,18,5,480054,125556,50763,57193,1.1630293823409537,0.31295930483887735
22589,0.5813571428571429,0,1,0,480055,125555,50763,57193,1.1630201193078662,0.3129610173572351
22590,0.5813809523809523,0,1,0,480056,125554,50763,57193,1.1630108562747785,0.31296272989433477
22591,0.5813809523809524,0,1,0,480057,125553,50763,57193,1.163001593241691,0.31296444245017674
22592,0.581404761904762,1,3,1,480060,125550,50764,57192,1.1629738041424285,0.3129658206652001
22593,0.5814166666666666,1,0,1,480060,125550,50765,57191,1.1629738041424285,0.3129620610590946
22594,0.5814166666666667,1,0,1,480060,125550,50766,57190,1.1629738041424285,0.31295830141184194
22595,0.5814206349206349,0,1,0,480061,125549,50766,57190,1.1629645411093408,0.31296001400905116
22596,0.5814285714285714,2,2,2,480063,125547,50768,57188,1.1629460150431656,0.3129559197745369
22597,0.5814285714285715,0,1,0,480064,125546,50768,57188,1.1629367520100782,0.3129576324055731
22598,0.5814761904761905,0,1,0,480065,125545,50768,57188,1.1629274889769907,0.312959345055354
22599,0.5814999999999999,0,3,0,480068,125542,50768,57188,1.162899699877728,0.3129644831171674
22600,0.5815,4,21,4,480089,125521,50772,57184,1.1627051761828893,0.31298541364494675
22601,0.5815476190476191,0,1,0,480090,125520,50772,57184,1.1626959131498018,0.31298712671862683
22602,0.5815833333333333,0,2,0,480092,125518,50772,57184,1.1626773870836267,0.312990552922245
22603,0.5816190476190477,0,1,0,480093,125517,50772,57184,1.1626681240505392,0.3129922660521836
22604,0.5816515151515151,0,1,0,480094,125516,50772,57184,1.1626588610174515,0.31299397920087574
22605,0.5816666666666666,0,1,0,480095,125515,50772,57184,1.162649597984364,0.31299569236832164
22606,0.5816666666666667,73,264,73,480359,125251,50845,57111,1.1602041572492496,0.3131737971726566
22607,0.5816666666666668,0,3,0,480362,125248,50845,57111,1.160176368149987,0.31317894921555833
22608,0.5816904761904762,2,2,2,480364,125246,50847,57109,1.160157842083812,0.31317485125167943
22609,0.5817142857142857,0,2,0,480366,125244,50847,57109,1.1601393160176368,0.3131782860715206
22610,0.58175,0,1,0,480367,125243,50847,57109,1.1601300529845493,0.31318000350969555
22611,0.581762987012987,1,2,1,480369,125241,50848,57108,1.1601115269183742,0.31317967194774854
22612,0.5817857142857142,0,3,0,480372,125238,50848,57108,1.1600837378191116,0.31318482445460827
22613,0.5817857142857144,0,2,0,480374,125236,50848,57108,1.1600652117529364,0.31318825955337165
22614,0.5818095238095238,0,1,0,480375,125235,50848,57108,1.1600559487198487,0.3131899771310113
22615,0.5818181818181819,0,1,0,480376,125234,50848,57108,1.1600466856867613,0.3131916947274901
22616,0.5818333333333332,0,1,0,480377,125233,50848,57108,1.1600374226536738,0.31319341234280823
22617,0.5818333333333333,1,11,1,480388,125222,50849,57107,1.1599355292897107,0.3132085406051698
22618,0.5818333333333334,2,2,2,480390,125220,50851,57105,1.1599170032235355,0.31320444261620733
22619,0.5818571428571429,0,8,0,480398,125212,50851,57105,1.1598428989588352,0.31321818590696426
22620,0.5819047619047618,0,1,0,480399,125211,50851,57105,1.1598336359257475,0.3132199039031133
22621,0.5819047619047619,0,1,0,480400,125210,50851,57105,1.15982437289266,0.31322162191810876
22622,0.5819166666666666,0,2,0,480402,125208,50851,57105,1.159805846826485,0.31322505800464034
22623,0.5819404761904762,0,1,0,480403,125207,50851,57105,1.1597965837933972,0.3132267760761771
22624,0.5819523809523809,0,1,0,480404,125206,50851,57105,1.1597873207603098,0.3132284941665615
22625,0.5819841269841269,1,0,1,480404,125206,50852,57104,1.1597873207603098,0.3132247271131589
22626,0.582,1,8,1,480412,125198,50853,57103,1.1597132164956092,0.31323470524023456
22627,0.5820000000000001,9,36,9,480448,125162,50862,57094,1.1593797473044574,0.3132626635062769
22628,0.5820238095238096,0,5,0,480453,125157,50862,57094,1.1593334321390196,0.31327125777087644
22629,0.5820714285714286,0,1,0,480454,125156,50862,57094,1.159324169105932,0.31327297668038406
22630,0.5820833333333333,0,1,0,480455,125155,50862,57094,1.1593149060728445,0.31327469560875504
22631,0.5820833333333334,0,1,0,480456,125154,50862,57094,1.159305643039757,0.31327641455598965
22632,0.5821150793650792,0,1,0,480457,125153,50862,57094,1.1592963800066693,0.31327813352208816
22633,0.5821428571428572,2,1,2,480458,125152,50864,57092,1.1592871169735819,0.31327231623537677
22634,0.5821626984126984,0,4,0,480462,125148,50864,57092,1.1592500648412316,0.3132791922739245
22635,0.5821666666666666,0,8,0,480470,125140,50864,57092,1.1591759605765313,0.313292945256596
22636,0.5821666666666667,0,8,0,480478,125132,50864,57092,1.1591018563118307,0.31330669944683465
22637,0.5821904761904763,0,2,0,480480,125130,50864,57092,1.1590833302456556,0.31331013818309533
22638,0.5822142857142858,0,1,0,480481,125129,50864,57092,1.1590740672125681,0.31331185757953256
22639,0.5822222222222222,0,1,0,480482,125128,50864,57092,1.1590648041794804,0.3133135769948414
22640,0.5822301587301587,0,1,0,480483,125127,50864,57092,1.159055541146393,0.3133152964290222
22641,0.58225,1,4,1,480487,125123,50865,57091,1.1590184890140427,0.31331840583050696
22642,0.5822500000000002,0,1,0,480488,125122,50865,57091,1.1590092259809552,0.31332012534780723
22643,0.582265406162465,0,1,0,480489,125121,50865,57091,1.1589999629478676,0.3133218448839813
22644,0.5823055555555555,0,1,0,480490,125120,50865,57091,1.15899069991478,0.3133235644390295
22645,0.5823333333333333,1,9,1,480499,125111,50866,57090,1.158907332616992,0.3133352725835753
22646,0.5823333333333334,5,20,5,480519,125091,50871,57085,1.1587220719552411,0.3133508255752679
22647,0.5823809523809523,0,3,0,480522,125088,50871,57085,1.1586942828559783,0.31335598579372353
22648,0.5823809523809524,1,5,1,480527,125083,50872,57084,1.1586479676905406,0.31336081727206355
22649,0.5824047619047619,1,0,1,480527,125083,50873,57083,1.1586479676905406,0.3133570479672387
22650,0.5824166666666667,1,0,1,480527,125083,50874,57082,1.1586479676905406,0.3133532786210304
22651,0.5824999999999999,1,5,1,480532,125078,50875,57081,1.1586016525251028,0.31335811022238813
22652,0.5825,61,234,61,480766,124844,50936,57020,1.156434102782615,0.313530990190472
22653,0.5825238095238096,0,1,0,480767,124843,50936,57020,1.1564248397495276,0.3135327141859532
22654,0.5825714285714285,0,1,0,480768,124842,50936,57020,1.1564155767164401,0.31353443820039373
22655,0.5825833333333335,0,1,0,480769,124841,50936,57020,1.1564063136833524,0.31353616223379394
22656,0.5825952380952379,0,1,0,480770,124840,50936,57020,1.156397050650265,0.3135378862861542
22657,0.5825952380952382,0,4,0,480774,124836,50936,57020,1.1563599985179147,0.3135447826852015
22658,0.5826190476190477,1,0,1,480774,124836,50937,57019,1.1563599985179147,0.31354100794589096
22659,0.5826557609057609,3,2,3,480776,124834,50940,57016,1.1563414724517396,0.3135331317019522
22660,0.5826666666666666,0,1,0,480777,124833,50940,57016,1.1563322094186521,0.3135348558419348
22661,0.5826666666666667,5,30,5,480807,124803,50945,57011,1.1560543184260255,0.3135677120573773
22662,0.5826666666666668,0,10,0,480817,124793,50945,57011,1.15596168809515,0.3135849596268509
22663,0.5827002164502164,0,1,0,480818,124792,50945,57011,1.1559524250620623,0.31358668448815474
22664,0.5827380952380952,0,1,0,480819,124791,50945,57011,1.1559431620289748,0.3135884093684338
22665,0.5827380952380953,1,0,1,480819,124791,50946,57010,1.1559431620289748,0.3135846337478892
22666,0.5827575757575758,0,1,0,480820,124790,50946,57010,1.1559338989958872,0.3135863586358636
22667,0.5827619047619047,0,1,0,480821,124789,50946,57010,1.1559246359627997,0.31358808354281376
22668,0.5827857142857144,0,2,0,480823,124787,50946,57010,1.1559061098966246,0.3135915334136427
22669,0.5828095238095238,0,1,0,480824,124786,50946,57010,1.1558968468635369,0.31359325837752206
22670,0.5828333333333332,0,1,0,480825,124785,50946,57010,1.1558875838304494,0.31359498336037844
22671,0.5828333333333333,0,4,0,480829,124781,50946,57010,1.1558505316980991,0.3136018834815805
22672,0.5828333333333334,1,2,1,480831,124779,50947,57009,1.155832005631924,0.31360155785860455
22673,0.5828571428571427,2,2,2,480833,124777,50949,57007,1.155813479565749,0.3135974563217885
22674,0.5828571428571429,4,7,4,480840,124770,50953,57003,1.1557486383341362,0.3135944282154115
22675,0.582857142857143,0,1,0,480841,124769,50953,57003,1.1557393753010485,0.3135961534229694
22676,0.5828809523809523,0,1,0,480842,124768,50953,57003,1.155730112267961,0.31359787864950955
22677,0.5828928571428571,0,1,0,480843,124767,50953,57003,1.1557208492348734,0.31359960389503216
22678,0.582904761904762,0,1,0,480844,124766,50953,57003,1.155711586201786,0.31360132915953765
22679,0.5829166666666666,0,1,0,480845,124765,50953,57003,1.1557023231686983,0.3136030544430263
22680,0.5829166666666667,0,1,0,480846,124764,50953,57003,1.1556930601356108,0.3136047797454984
22681,0.5829484126984128,0,4,0,480850,124760,50953,57003,1.1556560080032605,0.3136116811452276
22682,0.582952380952381,1,2,1,480852,124758,50954,57002,1.1556374819370854,0.3136113556338028
22683,0.5829545454545454,0,1,0,480853,124757,50954,57002,1.155628218903998,0.3136130810578843
22684,0.5829999999999999,0,2,0,480855,124755,50954,57002,1.1556096928378228,0.31361653196300554
22685,0.583,8,33,8,480888,124722,50962,56994,1.1553040127459335,0.3136432675163442
22686,0.5830000000000001,2,1,2,480889,124721,50964,56992,1.155294749712846,0.3136374392586111
22687,0.5830007215007216,0,2,0,480891,124719,50964,56992,1.155276223646671,0.31364089130542455
22688,0.5830238095238095,0,1,0,480892,124718,50964,56992,1.1552669606135832,0.3136426173573276
22689,0.5830238095238096,0,2,0,480894,124716,50964,56992,1.155248434547408,0.313646069518128
22690,0.583095238095238,0,1,0,480895,124715,50964,56992,1.1552391715143207,0.31364779562702594
22691,0.5830952380952382,1,1,1,480896,124714,50965,56991,1.1552299084812332,0.3136457444759363
22692,0.5831125541125541,0,1,0,480897,124713,50965,56991,1.1552206454481455,0.3136474706115441
22693,0.5831190476190476,1,1,1,480898,124712,50966,56990,1.155211382415058,0.31364541942301133
22694,0.5831428571428572,0,2,0,480900,124710,50966,56990,1.155192856348883,0.3136488717666483
22695,0.5831666666666666,1,5,1,480905,124705,50967,56989,1.1551465411834452,0.31365372549451276
22696,0.5831666666666667,0,3,0,480908,124702,50967,56989,1.1551187520841824,0.3136589044036303
22697,0.5832142857142857,0,1,0,480909,124701,50967,56989,1.155109489051095,0.313660630744675
22698,0.5832214277810254,0,1,0,480910,124700,50967,56989,1.1551002260180074,0.3136623571047229
22699,0.5832380952380953,0,1,0,480911,124699,50967,56989,1.1550909629849198,0.3136640834837744
22700,0.58325,0,1,0,480912,124698,50967,56989,1.1550816999518323,0.31366580988182974
22701,0.5832777777777778,0,1,0,480913,124697,50967,56989,1.1550724369187446,0.31366753629888927
22702,0.5833079975579976,0,1,0,480914,124696,50967,56989,1.1550631738856572,0.3136692627349534
22703,0.5833333333333333,51,181,51,481095,124515,51018,56938,1.1533865648968098,0.31378924569998845
22704,0.5833333333333334,59,274,59,481369,124241,51077,56879,1.1508484938308199,0.3140404151943463
22705,0.5833333333333335,0,3,0,481372,124238,51077,56879,1.1508207047315573,0.3140456169216584
22706,0.5833809523809523,0,2,0,481374,124236,51077,56879,1.1508021786653821,0.3140490848356017
22707,0.5833809523809524,0,1,0,481375,124235,51077,56879,1.1507929156322947,0.3140508188212949
22708,0.5834166666666667,1,1,1,481376,124234,51078,56878,1.150783652599207,0.31404876540483234
22709,0.5834285714285715,1,0,1,481376,124234,51079,56877,1.150783652599207,0.3140449779417043
22710,0.583452380952381,0,2,0,481378,124232,51079,56877,1.1507651265330319,0.3140484459634806
22711,0.5834999999999999,1,0,1,481378,124232,51080,56876,1.1507651265330319,0.31404465843585044
22712,0.5835,3,17,3,481395,124215,51083,56873,1.1506076549705435,0.31406277610885314
22713,0.5835000000000001,0,2,0,481397,124213,51083,56873,1.1505891289043684,0.31406624476767947
22714,0.5835108225108224,0,1,0,481398,124212,51083,56873,1.150579865871281,0.3140679791258249
22715,0.5835238095238094,0,1,0,481399,124211,51083,56873,1.1505706028381932,0.3140697135031256
22716,0.5835714285714285,2,1,2,481400,124210,51085,56871,1.1505613398051058,0.3140638719688979
22717,0.5835833333333332,0,1,0,481401,124209,51085,56871,1.1505520767720183,0.314065606361829
22718,0.5835952380952381,0,1,0,481402,124208,51085,56871,1.1505428137389306,0.31406734077391635
22719,0.5836190476190476,0,2,0,481404,124206,51085,56871,1.1505242876727555,0.3140708096555609
22720,0.5836190476190477,0,1,0,481405,124205,51085,56871,1.150515024639668,0.31407254412511876
22721,0.5836666666666666,0,4,0,481409,124201,51085,56871,1.1504779725073178,0.314079482194928
22722,0.5836666666666667,1,13,1,481422,124188,51086,56870,1.1503575530771797,0.3140982447613472
22723,0.5836666666666668,1,7,1,481429,124181,51087,56869,1.1502927118455668,0.3141066003866335
22724,0.5836904761904761,0,1,0,481430,124180,51087,56869,1.1502834488124791,0.3141083353125397
22725,0.5836904761904762,0,1,0,481431,124179,51087,56869,1.1502741857793917,0.31411007025761123
22726,0.5836944444444445,0,1,0,481432,124178,51087,56869,1.150264922746304,0.31411180522184845
22727,0.5836984126984127,0,2,0,481434,124176,51087,56869,1.1502463966801288,0.3141152752078213
22728,0.5837272727272727,0,1,0,481435,124175,51087,56869,1.1502371336470414,0.31411701022955746
22729,0.5837301587301588,0,1,0,481436,124174,51087,56869,1.150227870613954,0.31411874527046063
22730,0.5837380952380954,1,2,1,481438,124172,51088,56868,1.1502093445477788,0.3141184268669907
22731,0.5837499999999999,0,1,0,481439,124171,51088,56868,1.150200081514691,0.3141201619540541
22732,0.58375,0,8,0,481447,124163,51088,56868,1.1501259772499908,0.3141340433406433
22733,0.5837777777777778,0,1,0,481448,124162,51088,56868,1.150116714216903,0.314135778600232
22734,0.5837857142857144,0,3,0,481451,124159,51088,56868,1.1500889251176405,0.3141409844940258
22735,0.5838095238095238,0,4,0,481455,124155,51088,56868,1.1500518729852902,0.3141479259541605
22736,0.5838333333333332,1,2,1,481457,124153,51089,56867,1.1500333469191153,0.3141476079991161
22737,0.5838333333333333,2,5,2,481462,124148,51091,56865,1.1499870317536773,0.31414870755139135
22738,0.5838571428571429,1,1,1,481463,124147,51092,56864,1.1499777687205899,0.3141466540707471
22739,0.5838809523809523,0,1,0,481464,124146,51092,56864,1.1499685056875024,0.31414838959173524
22740,0.5838888888888889,0,1,0,481465,124145,51092,56864,1.1499592426544147,0.3141501251318995
22741,0.5839047619047618,0,1,0,481466,124144,51092,56864,1.1499499796213273,0.3141518606912402
22742,0.5839166666666666,0,1,0,481467,124143,51092,56864,1.1499407165882396,0.31415359626975753
22743,0.5839285714285714,0,2,0,481469,124141,51092,56864,1.1499221905220645,0.31415706748432365
22744,0.5839285714285715,1,0,1,481469,124141,51093,56863,1.1499221905220645,0.31415327838058826
22745,0.5839285714285716,0,1,0,481470,124140,51093,56863,1.149912927488977,0.3141550140052927
22746,0.5839444444444444,0,1,0,481471,124139,51093,56863,1.1499036644558895,0.31415674964917517
22747,0.5839444444444445,0,1,0,481472,124138,51093,56863,1.1498944014228019,0.31415848531223584
22748,0.583952380952381,0,1,0,481473,124137,51093,56863,1.1498851383897144,0.31416022099447516
22749,0.584,21,75,21,481548,124062,51114,56842,1.1491904109081477,0.31421085216468403
22750,0.5840000000000001,3,9,3,481557,124053,51117,56839,1.1491070436103599,0.3142151117794043
22751,0.5840116272616271,0,1,0,481558,124052,51117,56839,1.1490977805772722,0.31421684882056045
22752,0.5840238095238094,0,2,0,481560,124050,51117,56839,1.149079254511097,0.3142203229604896
22753,0.5840476190476189,1,3,1,481563,124047,51118,56838,1.1490514654118344,0.3142217430964425
22754,0.584047619047619,0,3,0,481566,124044,51118,56838,1.1490236763125719,0.3142269545891797
22755,0.5840476190476191,1,0,1,481566,124044,51119,56837,1.1490236763125719,0.3142231632952051
22756,0.5840714285714285,0,1,0,481567,124043,51119,56837,1.1490144132794842,0.3142249004865104
22757,0.5841071428571429,0,1,0,481568,124042,51119,56837,1.1490051502463967,0.31422663769702397
22758,0.5841111111111111,0,2,0,481570,124040,51119,56837,1.1489866241802216,0.31423011217567737
22759,0.5841190476190476,1,0,1,481570,124040,51120,56836,1.1489866241802216,0.31422632079435636
22760,0.5841349206349206,0,1,0,481571,124039,51120,56836,1.1489773611471341,0.3142280580511403
22761,0.5841428571428572,0,2,0,481573,124037,51120,56836,1.148958835080959,0.3142315326223372
22762,0.5841666666666666,10,67,10,481640,123970,51130,56826,1.1483382118640928,0.3143100511073254
22763,0.5841666666666667,5,36,5,481676,123934,51135,56821,1.1480047426729407,0.3143536831622915
22764,0.5841753524253525,1,8,1,481684,123926,51136,56820,1.1479306384082404,0.3143638033483452
22765,0.5842142857142858,0,1,0,481685,123925,51136,56820,1.147921375375153,0.3143655426152867
22766,0.5842380952380952,1,0,1,481685,123925,51137,56819,1.147921375375153,0.31436174921435844
22767,0.5842499999999999,0,1,0,481686,123924,51137,56819,1.1479121123420652,0.3143634884891808
22768,0.5842777777777778,0,1,0,481687,123923,51137,56819,1.1479028493089778,0.31436522778324905
22769,0.5842835497835497,1,1,1,481688,123922,51138,56818,1.14789358627589,0.314363173619564
22770,0.5842857142857142,1,0,1,481688,123922,51139,56817,1.14789358627589,0.31435938010058706
22771,0.5842857142857143,4,7,4,481695,123915,51143,56813,1.1478287450442772,0.31435638085963435
22772,0.584297619047619,0,1,0,481696,123914,51143,56813,1.1478194820111898,0.3143581202587328
22773,0.5843015873015873,0,1,0,481697,123913,51143,56813,1.147810218978102,0.31435985967708024
22774,0.5843174603174603,1,0,1,481697,123913,51144,56812,1.147810218978102,0.3143560658458985
22775,0.5843333333333333,1,12,1,481709,123901,51145,56811,1.1476990625810515,0.3143731462216123
22776,0.5843333333333334,5,11,5,481720,123890,51150,56806,1.1475971692170885,0.3143733120821712
22777,0.5843589743589743,1,0,1,481720,123890,51151,56805,1.1475971692170885,0.31436951769556437
22778,0.5843809523809523,1,1,1,481721,123889,51152,56804,1.1475879061840009,0.3143674630450543
22779,0.5844047619047619,0,1,0,481722,123888,51152,56804,1.1475786431509134,0.3143692028424059
22780,0.5844166666666666,0,1,0,481723,123887,51152,56804,1.1475693801178257,0.31437094265901455
22781,0.5844166666666667,0,3,0,481726,123884,51152,56804,1.1475415910185631,0.3143761622243868
22782,0.584436507936508,1,0,1,481726,123884,51153,56803,1.1475415910185631,0.3143723676855557
22783,0.5844444444444444,2,4,2,481730,123880,51155,56801,1.1475045388862128,0.3143717380355433
22784,0.5844444444444445,1,0,1,481730,123880,51156,56800,1.1475045388862128,0.31436794332521584
22785,0.5844999999999999,0,4,0,481734,123876,51156,56800,1.1474674867538628,0.3143749031415351
22786,0.5845,3,7,3,481741,123869,51159,56797,1.14740264552225,0.3143756988033166
22787,0.5845000000000001,0,1,0,481742,123868,51159,56797,1.1473933824891622,0.31437743890626296
22788,0.5845238095238094,0,3,0,481745,123865,51159,56797,1.1473655933898996,0.3143826593306838
22789,0.5845238095238096,0,2,0,481747,123863,51159,56797,1.1473470673237245,0.3143861397099524
22790,0.5845714285714285,0,1,0,481748,123862,51159,56797,1.147337804290637,0.31438787992848405
22791,0.5845833333333332,0,1,0,481749,123861,51159,56797,1.1473285412575494,0.314389620166281
22792,0.5845833333333333,0,1,0,481750,123860,51159,56797,1.147319278224462,0.3143913604233437
22793,0.5846190476190477,0,1,0,481751,123859,51159,56797,1.1473100151913742,0.3143931006996723
22794,0.5846666666666667,2,23,2,481774,123836,51161,56795,1.1470969654303604,0.3144255415737055
22795,0.5846666666666668,0,1,0,481775,123835,51161,56795,1.147087702397273,0.31442728228976363
22796,0.5846904761904762,0,2,0,481777,123833,51161,56795,1.1470691763310978,0.3144307637797019
22797,0.5847142857142856,0,1,0,481778,123832,51161,56795,1.1470599132980104,0.3144325045535828
22798,0.5847142857142857,0,1,0,481779,123831,51161,56795,1.1470506502649227,0.3144342453467386
22799,0.5847222222222223,0,1,0,481780,123830,51161,56795,1.1470413872318352,0.31443598615916957
22800,0.58475,0,1,0,481781,123829,51161,56795,1.1470321241987476,0.3144377269908761
22801,0.5847500000000001,0,1,0,481782,123828,51161,56795,1.14702286116566,0.31443946784185844
22802,0.5847619047619048,0,1,0,481783,123827,51161,56795,1.1470135981325724,0.314441208712117
22803,0.5847857142857144,0,1,0,481784,123826,51161,56795,1.147004335099485,0.3144429496016521
22804,0.5848095238095238,1,0,1,481784,123826,51162,56794,1.147004335099485,0.3144391540250249
22805,0.5848333333333333,3,15,3,481799,123811,51165,56791,1.1468653896031717,0.31445388201681046
22806,0.5848333333333334,0,3,0,481802,123808,51165,56791,1.146837600503909,0.3144591055321458
22807,0.5848571428571429,0,2,0,481804,123806,51165,56791,1.1468190744377338,0.3144625879721147
22808,0.5849523809523809,0,2,0,481806,123804,51165,56791,1.1468005483715589,0.3144660704892162
22809,0.584952380952381,0,1,0,481807,123803,51165,56791,1.1467912853384712,0.3144678117766925
22810,0.585,208,825,208,482632,122978,51373,56583,1.139149283041239,0.3151185391037029
22811,0.5850000000000001,4,20,4,482652,122958,51377,56579,1.138964022379488,0.3151383837314871
22812,0.585047619047619,0,1,0,482653,122957,51377,56579,1.1389547593464004,0.31514013902504234
22813,0.5850476190476191,0,1,0,482654,122956,51377,56579,1.1389454963133128,0.3151418943381513
22814,0.5850714285714286,1,1,1,482655,122955,51378,56578,1.1389362332802253,0.3151398350164037
22815,0.5850833333333334,0,2,0,482657,122953,51378,56578,1.1389177072140502,0.31514334571745267
22816,0.5851428571428572,0,2,0,482659,122951,51378,56578,1.138899181147875,0.31514685649672197
22817,0.5851666666666666,0,13,0,482672,122938,51378,56578,1.138778761717737,0.3151696784687716
22818,0.5851666666666667,1,5,1,482677,122933,51379,56577,1.138732446552299,0.3151746420812211
22819,0.5852142857142857,0,1,0,482678,122932,51379,56577,1.1387231835192115,0.3151763978407768
22820,0.5852380952380952,1,3,1,482681,122929,51380,56576,1.138695394419949,0.3151778501991588
22821,0.5852499999999999,0,1,0,482682,122928,51380,56576,1.1386861313868613,0.31517960602549244
22822,0.5852777777777778,0,1,0,482683,122927,51380,56576,1.1386768683537738,0.31518136187138934
22823,0.5852857142857143,0,3,0,482686,122924,51380,56576,1.1386490792545112,0.31518662952646237
22824,0.5853333333333333,2,14,2,482700,122910,51382,56574,1.1385193967912854,0.31520358360633816
22825,0.5853333333333334,7,14,7,482714,122896,51389,56567,1.1383897143280597,0.31520146213982825
22826,0.5853571428571428,0,3,0,482717,122893,51389,56567,1.1383619252287969,0.3152067313050262
22827,0.5853690476190476,0,1,0,482718,122892,51389,56567,1.1383526621957094,0.31520848773257404
22828,0.5853809523809523,0,1,0,482719,122891,51389,56567,1.1383433991626217,0.3152102441796966
22829,0.5853846153846154,1,0,1,482719,122891,51390,56566,1.1383433991626217,0.31520642828086953
22830,0.5854047619047618,1,1,1,482720,122890,51391,56565,1.1383341361295343,0.3152043687832604
22831,0.5854166666666666,0,2,0,482722,122888,51391,56565,1.1383156100633591,0.3152078817294779
22832,0.5854166666666667,0,2,0,482724,122886,51391,56565,1.138297083997184,0.3152113947539997
22833,0.5854285714285714,1,1,1,482725,122885,51392,56564,1.1382878209640965,0.31520933524288236
22834,0.585452380952381,0,1,0,482726,122884,51392,56564,1.1382785579310088,0.3152110917926084
22835,0.5854545454545454,1,0,1,482726,122884,51393,56563,1.1382785579310088,0.3152072756858571
22836,0.5854761904761905,2,3,2,482729,122881,51395,56561,1.1382507688317463,0.3152049130081029
22837,0.5854999999999999,1,3,1,482732,122878,51396,56560,1.1382229797324837,0.3152063665444332
22838,0.5855,3,14,3,482746,122864,51399,56557,1.138093297269258,0.31521951165136747
22839,0.5855000000000001,1,0,1,482746,122864,51400,56556,1.138093297269258,0.3152156950172779
22840,0.585547619047619,1,0,1,482746,122864,51401,56555,1.138093297269258,0.31521187834064396
22841,0.5855555555555556,0,4,0,482750,122860,51401,56555,1.1380562451369076,0.3152189058885823
22842,0.5855714285714285,0,1,0,482751,122859,51401,56555,1.1380469821038202,0.31522066282452876
22843,0.5855833333333333,0,2,0,482753,122857,51401,56555,1.138028456037645,0.315224176755178
22844,0.5855952380952382,0,1,0,482754,122856,51401,56555,1.1380191930045573,0.31522593374988156
22845,0.5856666666666666,0,3,0,482757,122853,51401,56555,1.1379914039052947,0.3152312048515116
22846,0.5856666666666667,5,22,5,482779,122831,51406,56550,1.1377876171773686,0.31525077906801724
22847,0.5857142857142857,3,11,3,482790,122820,51409,56547,1.1376857238134055,0.3152586596196625
22848,0.5857619047619048,1,0,1,482790,122820,51410,56546,1.1376857238134055,0.315254842054793
22849,0.5857619047619049,0,1,0,482791,122819,51410,56546,1.1376764607803178,0.3152565996710618
22850,0.5857857142857142,0,2,0,482793,122817,51410,56546,1.137657934714143,0.3152601149623947
22851,0.5858333333333333,24,88,24,482881,122729,51434,56522,1.136842787802438,0.3153232060072189
22852,0.5858333333333334,0,2,0,482883,122727,51434,56522,1.136824261736263,0.3153267242774018
22853,0.5858809523809524,0,1,0,482884,122726,51434,56522,1.1368149987031753,0.3153284834419352
22854,0.585952380952381,1,4,1,482888,122722,51435,56521,1.1367779465708252,0.3153317005406069
22855,0.5859523809523811,0,1,0,482889,122721,51435,56521,1.1367686835377375,0.3153334597917899
22856,0.5859632034632035,0,1,0,482890,122720,51435,56521,1.13675942050465,0.31533521906260287
22857,0.5859960317460318,0,1,0,482891,122719,51435,56521,1.1367501574715624,0.3153369783530462
22858,0.586,28,94,28,482985,122625,51463,56493,1.1358794323613324,0.3153954376444578
22859,0.5860000000000001,0,1,0,482986,122624,51463,56493,1.135870169328245,0.31539719847920633
22860,0.5860238095238095,0,1,0,482987,122623,51463,56493,1.1358609062951572,0.3153989593336162
22861,0.586047619047619,0,2,0,482989,122621,51463,56493,1.135842380228982,0.31540248110142144
22862,0.5860714285714286,0,4,0,482993,122617,51463,56493,1.135805328096632,0.31540952487298307
22863,0.5860768398268399,0,2,0,482995,122615,51463,56493,1.135786802030457,0.31541304687674476
22864,0.5860833333333333,1,1,1,482996,122614,51464,56492,1.1357775389973692,0.31541098567328846
22865,0.5861428571428572,0,1,0,482997,122613,51464,56492,1.1357682759642818,0.3154127467128221
22866,0.5861666666666666,0,4,0,483001,122609,51464,56492,1.1357312238319315,0.3154197910676099
22867,0.5861666666666667,0,13,0,483014,122596,51464,56492,1.1356108044017934,0.3154426873939069
22868,0.5861904761904762,0,5,0,483019,122591,51464,56492,1.1355644892363554,0.3154514945583891
22869,0.5861944444444444,0,1,0,483020,122590,51464,56492,1.135555226203268,0.315453256050301
22870,0.5861969696969697,1,0,1,483020,122590,51465,56491,1.135555226203268,0.31544943349657417
22871,0.586202380952381,0,1,0,483021,122589,51465,56491,1.1355459631701805,0.31545119499664953
22872,0.5862142857142857,0,3,0,483024,122586,51465,56491,1.1355181740709177,0.31545647961491424
22873,0.5862380952380952,1,1,1,483025,122585,51466,56490,1.1355089110378302,0.315454418539718
22874,0.58625,0,4,0,483029,122581,51466,56490,1.13547185890548,0.3154614650055006
22875,0.5862619047619048,1,0,1,483029,122581,51467,56489,1.13547185890548,0.31545764226280226
22876,0.5862857142857143,0,1,0,483030,122580,51467,56489,1.1354625958723925,0.3154594039169259
22877,0.5863095238095238,2,1,2,483031,122579,51469,56487,1.1354533328393048,0.3154535199311986
22878,0.5863214285714285,0,1,0,483032,122578,51469,56487,1.1354440698062174,0.31545528160165304
22879,0.5863333333333333,2,6,2,483038,122572,51471,56485,1.135388491607692,0.3154582060461194
22880,0.5863333333333334,3,19,3,483057,122553,51474,56482,1.1352124939790285,0.3154802133661016
22881,0.5863333333333335,0,1,0,483058,122552,51474,56482,1.135203230945941,0.3154819754906889
22882,0.5863636363636363,0,1,0,483059,122551,51474,56482,1.1351939679128533,0.3154837376349611
22883,0.5863809523809524,0,1,0,483060,122550,51474,56482,1.1351847048797659,0.31548549979891866
22884,0.5863888888888888,1,2,1,483062,122548,51475,56481,1.1351661788135907,0.3154852007216708
22885,0.586388888888889,0,2,0,483064,122546,51475,56481,1.1351476527474156,0.31548872516436066
22886,0.5864285714285714,0,2,0,483066,122544,51475,56481,1.1351291266812404,0.3154922496857981
22887,0.5864296536796538,0,5,0,483071,122539,51475,56481,1.1350828115158027,0.3155010613339292
22888,0.5864999999999999,0,3,0,483074,122536,51475,56481,1.13505502241654,0.3155063485590754
22889,0.5865,4,21,4,483095,122515,51479,56477,1.1348604987217015,0.315528068293555
22890,0.586547619047619,0,1,0,483096,122514,51479,56477,1.1348512356886138,0.3155298311088267
22891,0.5865476190476191,0,3,0,483099,122511,51479,56477,1.1348234465893512,0.3155351196728272
22892,0.586563492063492,0,1,0,483100,122510,51479,56477,1.1348141835562637,0.31553688256689033
22893,0.5865714285714285,0,1,0,483101,122509,51479,56477,1.134804920523176,0.31553864548065214
22894,0.5866428571428571,0,1,0,483102,122508,51479,56477,1.1347956574900886,0.3155404084141129
22895,0.5866666666666666,1,3,1,483105,122505,51480,56476,1.134767868390826,0.3155418731597209
22896,0.5866666666666667,126,410,126,483515,122095,51606,56350,1.1309700248249286,0.3157835747709378
22897,0.5866825396825397,1,0,1,483515,122095,51607,56349,1.1309700248249286,0.3157797404227657
22898,0.5867142857142857,1,0,1,483515,122095,51608,56348,1.1309700248249286,0.3157759060316179
22899,0.5867222222222223,0,1,0,483516,122094,51608,56348,1.1309607617918411,0.31577767565931786
22900,0.58675,1,0,1,483516,122094,51609,56347,1.1309607617918411,0.31577384121362245
22901,0.5867857142857144,0,2,0,483518,122092,51609,56347,1.130942235725666,0.3157773805053828
22902,0.5868214285714286,0,1,0,483519,122091,51609,56347,1.1309329726925785,0.31577915018101527
22903,0.5868333333333333,3,15,3,483534,122076,51612,56344,1.130794027196265,0.3157941934760677
22904,0.5868333333333335,1,0,1,483534,122076,51613,56343,1.130794027196265,0.31579035865014377
22905,0.5868452380952381,1,0,1,483534,122076,51614,56342,1.130794027196265,0.31578652378123284
22906,0.586857142857143,0,1,0,483535,122075,51614,56342,1.1307847641631776,0.31578829371640593
22907,0.5868809523809524,1,1,1,483536,122074,51615,56341,1.13077550113009,0.3157862287363731
22908,0.5869047619047619,0,2,0,483538,122072,51615,56341,1.130756975063915,0.31578976868277536
22909,0.5869166666666666,1,3,1,483541,122069,51616,56340,1.1307291859646522,0.31579124371528344
22910,0.5869166666666668,1,1,1,483542,122068,51617,56339,1.1307199229315648,0.3157891786757246
22911,0.5869920634920635,2,1,2,483543,122067,51619,56337,1.130710659898477,0.31578327840182957
22912,0.5869999999999999,1,1,1,483544,122066,51620,56336,1.1307013968653896,0.3157812132150985
22913,0.587,1,5,1,483549,122061,51621,56335,1.1306550816999519,0.3157862283907711
22914,0.5870000000000001,5,29,5,483578,122032,51626,56330,1.1303864537404127,0.31581839180991467
22915,0.5870238095238095,2,1,2,483579,122031,51628,56328,1.1303771907073252,0.3158124905387449
22916,0.5870714285714286,1,1,1,483580,122030,51629,56327,1.1303679276742375,0.31581042515853036
22917,0.5870833333333333,0,2,0,483582,122028,51629,56327,1.1303494016080626,0.31581396652743127
22918,0.5870952380952381,1,1,1,483583,122027,51630,56326,1.130340138574975,0.31581190111744684
22919,0.5871071428571428,0,2,0,483585,122025,51630,56326,1.1303216125087998,0.31581544258232364
22920,0.5871309523809524,0,1,0,483586,122024,51630,56326,1.1303123494757124,0.31581721334454727
22921,0.587138888888889,0,1,0,483587,122023,51630,56326,1.1303030864426247,0.3158189841266281
22922,0.5871428571428572,2,5,2,483592,122018,51632,56324,1.130256771277187,0.3158201657489543
22923,0.5871468253968254,0,2,0,483594,122016,51632,56324,1.1302382452110118,0.3158237075249523
22924,0.5871666666666666,1,7,1,483601,122009,51633,56323,1.130173403979399,0.3158322679048068
22925,0.5871666666666667,1,8,1,483609,122001,51634,56322,1.1300992997146986,0.31584260022543365
22926,0.5871666666666668,0,1,0,483610,122000,51634,56322,1.1300900366816111,0.31584437141799665
22927,0.5871904761904762,0,2,0,483612,121998,51634,56322,1.130071510615436,0.3158479138627187
22928,0.5872142857142857,0,1,0,483613,121997,51634,56322,1.1300622475823483,0.3158496851148784
22929,0.5872222222222222,1,0,1,483613,121997,51635,56321,1.1300622475823483,0.31584584842808916
22930,0.5872272727272727,0,1,0,483614,121996,51635,56321,1.1300529845492608,0.3158476196885322
22931,0.5872380952380953,0,1,0,483615,121995,51635,56321,1.1300437215161732,0.31584939096884185
22932,0.58725,0,1,0,483616,121994,51635,56321,1.1300344584830857,0.3158511622690183
22933,0.5873095238095238,1,1,1,483617,121993,51636,56320,1.1300251954499982,0.3158490968129076
22934,0.5873333333333333,0,14,0,483631,121979,51636,56320,1.1298955129867725,0.3158738972175952
22935,0.5873333333333334,8,22,8,483653,121957,51644,56312,1.1296917262588462,0.31588217805675695
22936,0.5873351648351649,0,1,0,483654,121956,51644,56312,1.1296824632257587,0.31588395000785335
22937,0.5873809523809523,0,2,0,483656,121954,51644,56312,1.1296639371595836,0.31588749396968574
22938,0.5873809523809524,0,1,0,483657,121953,51644,56312,1.129654674126496,0.3158892659804224
22939,0.5874166666666667,0,1,0,483658,121952,51644,56312,1.1296454110934084,0.3158910380110398
22940,0.5874285714285715,0,1,0,483659,121951,51644,56312,1.129636148060321,0.3158928100615383
22941,0.5874481074481075,0,1,0,483660,121950,51644,56312,1.1296268850272333,0.3158945821319182
22942,0.5874999999999999,2,11,2,483671,121939,51646,56310,1.1295249916632701,0.31590640059691777
22943,0.5875,52,251,52,483922,121688,51698,56258,1.1271999703582942,0.3161520910838119
22944,0.5875238095238094,0,2,0,483924,121686,51698,56258,1.127181444292119,0.3161556444724183
22945,0.5875277777777778,1,0,1,483924,121686,51699,56257,1.127181444292119,0.3161518014195557
22946,0.5875476190476191,0,1,0,483925,121685,51699,56257,1.1271721812590314,0.31615357813220035
22947,0.5875833333333333,0,3,0,483928,121682,51699,56257,1.1271443921597688,0.31615890838995386
22948,0.5875873015873017,0,1,0,483929,121681,51699,56257,1.1271351291266813,0.3161606851824793
22949,0.5875894383394384,0,1,0,483930,121680,51699,56257,1.1271258660935937,0.3161624619949758
22950,0.587605263157895,0,1,0,483931,121679,51699,56257,1.1271166030605062,0.3161642388274436
22951,0.5876190476190476,1,0,1,483931,121679,51700,56256,1.1271166030605062,0.31616039565009696
22952,0.5876190476190477,0,2,0,483933,121677,51700,56256,1.127098076994331,0.31616394935172226
22953,0.5876428571428571,1,2,1,483935,121675,51701,56255,1.127079550928156,0.3161636598662395
22954,0.5876666666666666,0,3,0,483938,121672,51701,56255,1.1270517618288933,0.31616899065347026
22955,0.5876666666666667,2,26,2,483964,121646,51703,56253,1.1268109229686167,0.3162075110034345
22956,0.5876666666666668,0,7,0,483971,121639,51703,56253,1.1267460817370039,0.31621995367976075
22957,0.5876926406926406,1,0,1,483971,121639,51704,56252,1.1267460817370039,0.3162161098650297
22958,0.587702380952381,3,2,3,483973,121637,51707,56249,1.126727555670829,0.31620813329885433
22959,0.58775,1,1,1,483974,121636,51708,56248,1.1267182926377413,0.31620606687504216
22960,0.5877500000000001,0,1,0,483975,121635,51708,56248,1.1267090296046538,0.3162078444820472
22961,0.5877777777777777,1,1,1,483976,121634,51709,56247,1.1266997665715661,0.31620577802013705
22962,0.5877857142857144,1,0,1,483976,121634,51710,56246,1.1266997665715661,0.3162019338880144
22963,0.5877976190476191,1,0,1,483976,121634,51711,56245,1.1266997665715661,0.3161980897126698
22964,0.5878015873015873,0,2,0,483978,121632,51711,56245,1.126681240505391,0.31620164495690845
22965,0.5878095238095238,2,1,2,483979,121631,51713,56243,1.1266719774723035,0.3161957340589406
22966,0.5878333333333333,3,9,3,483988,121622,51716,56240,1.1265886101745155,0.31620020015517647
22967,0.5878333333333334,4,5,4,483993,121617,51720,56236,1.1265422950090778,0.31619371053622936
22968,0.5878571428571429,1,5,1,483998,121612,51721,56235,1.12649597984364,0.31619875510972917
22969,0.587857142857143,0,1,0,483999,121611,51721,56235,1.1264867168105523,0.3162005330454438
22970,0.5878809523809524,0,1,0,484000,121610,51721,56235,1.1264774537774649,0.3162023110011527
22971,0.5878888888888888,0,1,0,484001,121609,51721,56235,1.1264681907443774,0.31620408897685615
22972,0.5879166666666665,0,1,0,484002,121608,51721,56235,1.1264589277112897,0.31620586697255443
22973,0.5879166666666666,0,3,0,484005,121605,51721,56235,1.1264311386120271,0.31621120107962214
22974,0.5879166666666668,0,1,0,484006,121604,51721,56235,1.1264218755789395,0.3162129791553034
22975,0.5879285714285715,0,1,0,484007,121603,51721,56235,1.126412612545852,0.31621475725098125
22976,0.5879523809523809,0,1,0,484008,121602,51721,56235,1.1264033495127646,0.316216535366656
22977,0.5879761904761904,1,4,1,484012,121598,51722,56234,1.1263662973804143,0.31621980296009716
22978,0.5879761904761905,1,2,1,484014,121596,51723,56233,1.1263477713142391,0.31621951425245604
22979,0.5879999999999999,0,1,0,484015,121595,51723,56233,1.1263385082811517,0.316221292484873
22980,0.588,14,43,14,484058,121552,51737,56219,1.1259401978583867,0.31624393179989985
22981,0.5880000000000001,0,12,0,484070,121540,51737,56219,1.125829041461336,0.31626528052025493
22982,0.5880277777777778,0,1,0,484071,121539,51737,56219,1.1258197784282487,0.31626705971039276
22983,0.5880476190476192,0,1,0,484072,121538,51737,56219,1.125810515395161,0.31626883892054886
22984,0.5880555555555556,0,1,0,484073,121537,51737,56219,1.1258012523620735,0.31627061815072344
22985,0.588095238095238,0,1,0,484074,121536,51737,56219,1.1257919893289858,0.316272397400917
22986,0.5880952380952381,0,2,0,484076,121534,51737,56219,1.1257734632628107,0.3162759559613621
22987,0.5880952380952382,0,1,0,484077,121533,51737,56219,1.1257642002297232,0.3162777352716144
22988,0.5881071428571427,0,1,0,484078,121532,51737,56219,1.1257549371966358,0.3162795146018869
22989,0.5881111111111111,0,1,0,484079,121531,51737,56219,1.125745674163548,0.31628129395218
22990,0.5881428571428572,0,4,0,484083,121527,51737,56219,1.1257086220311978,0.3162884115535652
22991,0.5881666666666666,1,4,1,484087,121523,51738,56218,1.1256715698988478,0.3162916828418879
22992,0.5881666666666667,0,2,0,484089,121521,51738,56218,1.1256530438326726,0.31629524189963937
22993,0.5881818181818183,0,1,0,484090,121520,51738,56218,1.125643780799585,0.3162970214585514
22994,0.5882142857142856,0,1,0,484091,121519,51738,56218,1.1256345177664975,0.316298801037488
22995,0.5882142857142857,1,3,1,484094,121516,51739,56217,1.1256067286672349,0.31630029313633373
22996,0.5882380952380953,1,0,1,484094,121516,51740,56216,1.1256067286672349,0.31629644633493126
22997,0.5882619047619047,0,1,0,484095,121515,51740,56216,1.1255974656341472,0.31629822597070856
22998,0.5882857142857143,0,2,0,484097,121513,51740,56216,1.125578939567972,0.3163017853023423
22999,0.5883095238095238,0,1,0,484098,121512,51740,56216,1.1255696765348846,0.3163035649981995
23000,0.5883333333333333,30,97,30,484195,121415,51770,56186,1.1246711623253918,0.31636083130162557
23001,0.5883333333333334,31,125,31,484320,121290,51801,56155,1.1235132831894477,0.31646425653019244
23002,0.5883571428571428,0,1,0,484321,121289,51801,56155,1.12350402015636,0.3164660399900814
23003,0.5884126984126984,0,1,0,484322,121288,51801,56155,1.1234947571232725,0.3164678234700721
23004,0.5884166666666667,0,1,0,484323,121287,51801,56155,1.1234854940901848,0.3164696069701649
23005,0.5884285714285713,0,1,0,484324,121286,51801,56155,1.1234762310570974,0.31647139049036016
23006,0.5884523809523811,1,0,1,484324,121286,51802,56154,1.1234762310570974,0.3164675383228133
23007,0.5884761904761904,0,1,0,484325,121285,51802,56154,1.1234669680240097,0.31646932185145316
23008,0.5884761904761905,0,1,0,484326,121284,51802,56154,1.1234577049909222,0.31647110540019613
23009,0.5884999999999999,0,3,0,484329,121281,51802,56154,1.1234299158916596,0.31647645616704706
23010,0.5885,3,17,3,484346,121264,51805,56151,1.123272444329171,0.3164952230645661
23011,0.5885000000000001,0,3,0,484349,121261,51805,56151,1.1232446552299085,0.3165005749329245
23012,0.5885476190476191,0,2,0,484351,121259,51805,56151,1.1232261291637333,0.31650414294571894
23013,0.5885627705627706,1,0,1,484351,121259,51806,56150,1.1232261291637333,0.31650029028966964
23014,0.5885714285714285,1,4,1,484355,121255,51807,56149,1.1231890770313833,0.3165035737638385
23015,0.5885714285714286,0,5,0,484360,121250,51807,56149,1.1231427618659453,0.31651249443345225
23016,0.5885833333333332,0,1,0,484361,121249,51807,56149,1.1231334988328578,0.31651427862771847
23017,0.5885992063492064,0,1,0,484362,121248,51807,56149,1.1231242357997704,0.31651606284209993
23018,0.5886190476190477,0,1,0,484363,121247,51807,56149,1.1231149727666827,0.31651784707659697
23019,0.5886269841269841,0,3,0,484366,121244,51807,56149,1.12308718366742,0.31652319990078526
23020,0.5886547619047618,0,1,0,484367,121243,51807,56149,1.1230779206343324,0.31652498421574815
23021,0.5886666666666666,4,5,4,484372,121238,51811,56145,1.1230316054688947,0.3165184938804733
23022,0.5886666666666667,3,13,3,484385,121225,51814,56142,1.1229111860387566,0.31653013243726286
23023,0.5886666666666668,1,3,1,484388,121222,51815,56141,1.1228833969394938,0.31653163286593033
23024,0.5886904761904761,2,2,2,484390,121220,51817,56139,1.1228648708733187,0.31652749508059924
23025,0.5886904761904763,1,2,1,484392,121218,51818,56138,1.1228463448071437,0.3165272108076411
23026,0.5887142857142856,0,1,0,484393,121217,51818,56138,1.122837081774056,0.316528995517465
23027,0.5887260517260516,2,1,2,484394,121216,51820,56136,1.1228278187409686,0.31652307275925845
23028,0.5887261904761906,0,1,0,484395,121215,51820,56136,1.122818555707881,0.31652485748600234
23029,0.5887380952380953,0,1,0,484396,121214,51820,56136,1.1228092926747935,0.31652664223287286
23030,0.58875,1,7,1,484403,121207,51821,56135,1.1227444514431806,0.3165352821102728
23031,0.5887619047619047,2,3,2,484406,121204,51823,56133,1.122716662343918,0.31653292883041895
23032,0.5887738095238094,0,1,0,484407,121203,51823,56133,1.1227073993108303,0.3165347137637028
23033,0.5888095238095238,2,2,2,484409,121201,51825,56131,1.1226888732446552,0.3165305754178603
23034,0.5888095238095239,0,1,0,484410,121200,51825,56131,1.1226796102115677,0.3165323603882006
23035,0.5888333333333333,2,7,2,484417,121193,51827,56129,1.1226147689799548,0.3165371471109056
23036,0.5888690476190477,0,2,0,484419,121191,51827,56129,1.1225962429137797,0.316540717347169
23037,0.5888755411255411,1,0,1,484419,121191,51828,56128,1.1225962429137797,0.3165368629419295
23038,0.5889047619047618,0,1,0,484420,121190,51828,56128,1.1225869798806922,0.3165386480785933
23039,0.5889166666666665,0,1,0,484421,121189,51828,56128,1.1225777168476045,0.316540433235392
23040,0.5889166666666668,1,0,1,484421,121189,51829,56127,1.1225777168476045,0.3165365787633378
23041,0.5889285714285715,1,1,1,484422,121188,51830,56126,1.122568453814517,0.31653450940140093
23042,0.5889523809523809,0,1,0,484423,121187,51830,56126,1.1225591907814294,0.31653629457512983
23043,0.5889545454545454,1,0,1,484423,121187,51831,56125,1.1225591907814294,0.3165324399927811
23044,0.588958485958486,0,1,0,484424,121186,51831,56125,1.122549927748342,0.31653422517497504
23045,0.588969696969697,0,1,0,484425,121185,51831,56125,1.1225406647152543,0.3165360103773053
23046,0.589,6,56,6,484481,121129,51837,56119,1.1220219348623512,0.3166128813865319
23047,0.5890000000000001,0,1,0,484482,121128,51837,56119,1.1220126718292638,0.31661466766715374
23048,0.5890238095238095,0,1,0,484483,121127,51837,56119,1.1220034087961763,0.3166164539679316
23049,0.5890476190476189,1,0,1,484483,121127,51838,56118,1.1220034087961763,0.3166125983807724
23050,0.5891428571428573,1,0,1,484483,121127,51839,56117,1.1220034087961763,0.3166087427501072
23051,0.5891666666666666,10,57,10,484540,121070,51849,56107,1.1214754159101856,0.31667202853643533
23052,0.5891666666666667,3,34,3,484574,121036,51852,56104,1.1211604727852087,0.3167212374393135
23053,0.5892499999999999,0,2,0,484576,121034,51852,56104,1.1211419467190338,0.3167248134223035
23054,0.5892857142857143,1,7,1,484583,121027,51853,56103,1.121077105487421,0.3167334725907526
23055,0.5892857142857144,0,1,0,484584,121026,51853,56103,1.1210678424543332,0.31673526074217095
23056,0.5893333333333333,3,9,3,484593,121017,51856,56100,1.1209844751565452,0.3167397821778824
23057,0.5893333333333334,5,17,5,484610,121000,51861,56095,1.1208270035940568,0.31675089641153054
23058,0.5893452380952382,0,1,0,484611,120999,51861,56095,1.1208177405609694,0.3167526850147379
23059,0.5893571428571429,0,1,0,484612,120998,51861,56095,1.1208084775278817,0.3167544736381449
23060,0.5893809523809523,0,1,0,484613,120997,51861,56095,1.1207992144947942,0.31675626228175185
23061,0.5893888888888889,1,0,1,484613,120997,51862,56094,1.1207992144947942,0.31675240413120936
23062,0.5894047619047619,1,0,1,484613,120997,51863,56093,1.1207992144947942,0.3167485459370941
23063,0.5894206349206349,0,2,0,484615,120995,51863,56093,1.120780688428619,0.3167521232381641
23064,0.5894444444444444,0,1,0,484616,120994,51863,56093,1.1207714253955314,0.31675391191900026
23065,0.5894642857142857,0,1,0,484617,120993,51863,56093,1.120762162362444,0.3167557006200377
23066,0.589480685980686,0,2,0,484619,120991,51863,56093,1.1207436362962688,0.3167592780827178
23067,0.5894999999999999,1,3,1,484622,120988,51864,56092,1.1207158471970062,0.31676078608538516
23068,0.5895,1,13,1,484635,120975,51865,56091,1.120595427766868,0.31678018366033006
23069,0.5895238095238095,1,0,1,484635,120975,51866,56090,1.120595427766868,0.31677632507836107
23070,0.5895238095238096,0,1,0,484636,120974,51866,56090,1.1205861647337805,0.3167781141282248
23071,0.5895357142857143,0,1,0,484637,120973,51866,56090,1.1205769017006928,0.31677990319829663
23072,0.5895833333333333,0,1,0,484638,120972,51866,56090,1.1205676386676053,0.3167816922885769
23073,0.5896080447330446,1,1,1,484639,120971,51867,56089,1.1205583756345177,0.3167796227267593
23074,0.5896388888888888,1,0,1,484639,120971,51868,56088,1.1205583756345177,0.31677576401086643
23075,0.5896428571428571,2,2,2,484641,120969,51870,56086,1.1205398495683427,0.3167716246364124
23076,0.5896666666666666,1,8,1,484649,120961,51871,56085,1.1204657453036422,0.3167820792336455
23077,0.5896666666666667,2,9,2,484658,120952,51873,56083,1.1203823780058542,0.31679046516225606
23078,0.5896666666666668,0,1,0,484659,120951,51873,56083,1.1203731149727667,0.3167922545951625
23079,0.5896904761904762,0,1,0,484660,120950,51873,56083,1.120363851939679,0.31679404404828476
23080,0.5897142857142856,0,1,0,484661,120949,51873,56083,1.1203545889065916,0.3167958335216232
23081,0.58975,0,1,0,484662,120948,51873,56083,1.120345325873504,0.3167976230151781
23082,0.5898095238095238,0,1,0,484663,120947,51873,56083,1.1203360628404164,0.3167994125289499
23083,0.5898181818181818,0,1,0,484664,120946,51873,56083,1.120326799807329,0.3168012020629388
23084,0.5898333333333333,4,4,4,484668,120942,51877,56079,1.1202897476749787,0.31679292287355737
23085,0.5898333333333334,0,1,0,484669,120941,51877,56079,1.1202804846418912,0.3167947124618687
23086,0.5898809523809524,0,1,0,484670,120940,51877,56079,1.1202712216088035,0.3167965020703992
23087,0.5899047619047619,0,1,0,484671,120939,51877,56079,1.120261958575716,0.31679829169914925
23088,0.5899404761904762,0,1,0,484672,120938,51877,56079,1.1202526955426284,0.3168000813481191
23089,0.5899484126984126,0,1,0,484673,120937,51877,56079,1.120243432509541,0.31680187101730917
23090,0.5899523809523809,0,1,0,484674,120936,51877,56079,1.1202341694764533,0.3168036607067198
23091,0.5899679487179488,1,0,1,484674,120936,51878,56078,1.1202341694764533,0.3167998011456721
23092,0.59,549,2153,549,486827,118783,52427,55529,1.100290859238949,0.3185609711322227
23093,0.5900000000000001,5,19,5,486846,118764,52432,55524,1.1001148616102856,0.318576149820986
23094,0.5900000000000002,0,1,0,486847,118763,52432,55524,1.1001055985771981,0.31857797770344315
23095,0.5900238095238097,0,1,0,486848,118762,52432,55524,1.1000963355441105,0.31857980560687604
23096,0.5901190476190477,0,1,0,486849,118761,52432,55524,1.100087072511023,0.318581633531285
23097,0.5901349206349206,0,2,0,486851,118759,52432,55524,1.1000685464448479,0.3185852894430323
23098,0.5901515151515152,0,1,0,486852,118758,52432,55524,1.1000592834117604,0.3185871174303715
23099,0.5901666666666666,0,14,0,486866,118744,52432,55524,1.0999296009485346,0.31861271145591846
23100,0.5901666666666667,2,5,2,486871,118739,52434,55522,1.099883285783097,0.3186140329735282
23101,0.590172077922078,0,2,0,486873,118737,52434,55522,1.0998647597169218,0.31861768976064364
23102,0.590202380952381,1,0,1,486873,118737,52435,55521,1.0998647597169218,0.3186137795682264
23103,0.5902261904761904,0,2,0,486875,118735,52435,55521,1.0998462336507466,0.31861743641538887
23104,0.5902380952380951,0,1,0,486876,118734,52435,55521,1.099836970617659,0.3186192648704485
23105,0.5902380952380952,0,1,0,486877,118733,52435,55521,1.0998277075845715,0.3186210933464942
23106,0.5902438672438671,0,2,0,486879,118731,52435,55521,1.0998091815183964,0.31862475036154536
23107,0.5902499999999999,0,1,0,486880,118730,52435,55521,1.099799918485309,0.3186265789005515
23108,0.5902857142857143,0,2,0,486882,118728,52435,55521,1.0997813924191338,0.3186302360415268
23109,0.5903214285714288,0,3,0,486885,118725,52435,55521,1.0997536033198712,0.3186357219104025
23110,0.5903333333333333,1,11,1,486896,118714,52436,55520,1.099651709955908,0.3186519278671212
23111,0.5903333333333334,0,8,0,486904,118706,52436,55520,1.0995776056912074,0.3186665595261327
23112,0.5903571428571428,0,1,0,486905,118705,52436,55520,1.09956834265812,0.31866838857798824
23113,0.5904166666666666,0,1,0,486906,118704,52436,55520,1.0995590796250325,0.3186702176508403
23114,0.5904166666666667,2,2,2,486908,118702,52438,55518,1.0995405535588574,0.31866605441395934
23115,0.590452380952381,1,0,1,486908,118702,52439,55517,1.0995405535588574,0.3186621436238298
23116,0.5904705882352942,0,1,0,486909,118701,52439,55517,1.0995312905257697,0.3186639727238288
23117,0.5904761904761905,2,7,2,486916,118694,52441,55515,1.0994664492941568,0.31866895510564897
23118,0.5904999999999999,0,1,0,486917,118693,52441,55515,1.0994571862610694,0.31867078434974283
23119,0.5905,3,20,3,486937,118673,52444,55512,1.0992719255993182,0.3186956396934294
23120,0.5905555555555556,1,1,1,486938,118672,52445,55511,1.0992626625662307,0.3186935579247114
23121,0.5905714285714285,1,0,1,486938,118672,52446,55510,1.0992626625662307,0.3186896464617469
23122,0.5905952380952381,0,3,0,486941,118669,52446,55510,1.0992348734669681,0.31869513546409156
23123,0.5906507936507936,0,1,0,486942,118668,52446,55510,1.0992256104338805,0.3186969651735581
23124,0.5906666666666667,12,30,12,486972,118638,52458,55498,1.0989477194412538,0.31870492029218545
23125,0.5906818181818181,0,1,0,486973,118637,52458,55498,1.0989384564081663,0.318706750509662
23126,0.5907142857142857,3,15,3,486988,118622,52461,55495,1.098799510911853,0.3187224682253887
23127,0.5907359307359308,0,1,0,486989,118621,52461,55495,1.0987902478787654,0.3187242987433665
23128,0.5907619047619047,2,2,2,486991,118619,52463,55493,1.0987717218125903,0.3187201341665135
23129,0.5907640692640692,0,1,0,486992,118618,52463,55493,1.0987624587795028,0.31872196472365333
23130,0.5907777777777777,0,2,0,486994,118616,52463,55493,1.0987439327133277,0.31872562590101605
23131,0.5908333333333332,0,3,0,486997,118613,52463,55493,1.0987161436140649,0.3187311178247734
23132,0.5908333333333333,16,81,16,487078,118532,52479,55477,1.0979658379339732,0.31881684280698125
23133,0.5908333333333334,0,3,0,487081,118529,52479,55477,1.0979380488347104,0.31882233945955885
23134,0.5908517316017315,0,1,0,487082,118528,52479,55477,1.097928785801623,0.31882417171920346
23135,0.5909166666666666,0,1,0,487083,118527,52479,55477,1.0979195227685354,0.31882600399990807
23136,0.5909444444444444,0,1,0,487084,118526,52479,55477,1.0979102597354478,0.31882783630167294
23137,0.5909523809523809,0,3,0,487087,118523,52479,55477,1.0978824706361852,0.31883333333333336
23138,0.590952380952381,1,3,1,487090,118520,52480,55476,1.0978546815369226,0.3188349157451895
23139,0.5909761904761904,1,2,1,487092,118518,52481,55475,1.0978361554707474,0.3188346657624157
23140,0.591,10,60,10,487152,118458,52491,55465,1.0972803734854941,0.3189054926605452
23141,0.5910000000000001,1,1,1,487153,118457,52492,55464,1.0972711104524064,0.31890341016898477
23142,0.5910303030303031,0,1,0,487154,118456,52492,55464,1.097261847419319,0.31890524379024837
23143,0.5910628538128538,0,1,0,487155,118455,52492,55464,1.0972525843862315,0.31890707743259794
23144,0.5910714285714286,2,3,2,487158,118452,52494,55462,1.0972247952869687,0.31890474602389685
23145,0.5911111111111111,0,2,0,487160,118450,52494,55462,1.0972062692207936,0.3189084134504807
23146,0.5911190476190477,0,1,0,487161,118449,52494,55462,1.097197006187706,0.31891024719540456
23147,0.5911428571428572,2,1,2,487162,118448,52496,55460,1.0971877431546186,0.31890424822319846
23148,0.5911666666666665,0,1,0,487163,118447,52496,55460,1.097178480121531,0.318906081986349
23149,0.5911666666666666,0,5,0,487168,118442,52496,55460,1.0971321649560932,0.31891525111844604
23150,0.5911666666666667,1,1,1,487169,118441,52497,55459,1.0971229019230058,0.31891316848763657
23151,0.5911904761904762,0,2,0,487171,118439,52497,55459,1.0971043758568306,0.3189168363063405
23152,0.59125,1,0,1,487171,118439,52498,55458,1.0971043758568306,0.3189129197168439
23153,0.5912857142857143,0,1,0,487172,118438,52498,55458,1.097095112823743,0.3189147536458573
23154,0.5913095238095238,0,4,0,487176,118434,52498,55458,1.0970580606913929,0.3189220895728383
23155,0.5913333333333333,2,6,2,487182,118428,52500,55456,1.0970024824928675,0.3189252605185066
23156,0.5913333333333334,4,21,4,487203,118407,52504,55452,1.0968079587980288,0.31894811312615395
23157,0.5914047619047619,0,1,0,487204,118406,52504,55452,1.0967986957649414,0.3189499476584339
23158,0.5914166666666667,1,1,1,487205,118405,52505,55451,1.0967894327318537,0.3189478648996871
23159,0.5914285714285714,1,4,1,487209,118401,52506,55450,1.0967523805995034,0.31895128587123456
23160,0.5914999999999999,0,1,0,487210,118400,52506,55450,1.096743117566416,0.3189531205061835
23161,0.5915,1,18,1,487228,118382,52507,55449,1.09657638297084,0.31898222986693975
23162,0.5915238095238096,0,2,0,487230,118380,52507,55449,1.0965578569046648,0.3189858999361441
23163,0.591547619047619,1,2,1,487232,118378,52508,55448,1.0965393308384896,0.3189856523189857
23164,0.5916111111111111,0,1,0,487233,118377,52508,55448,1.0965300678054022,0.3189874874155041
23165,0.5916190476190475,0,2,0,487235,118375,52508,55448,1.096511541739227,0.31899115767188463
23166,0.5916190476190476,0,3,0,487238,118372,52508,55448,1.0964837526399644,0.31899666321481995
23167,0.5916666666666666,0,5,0,487243,118367,52508,55448,1.0964374374745267,0.3190058395420418
23168,0.5916666666666667,51,273,51,487516,118094,52559,55397,1.0939086294416243,0.31930762979059435
23169,0.5917142857142857,0,3,0,487519,118091,52559,55397,1.0938808403423617,0.31931315134187954
23170,0.5917160894660896,0,1,0,487520,118090,52559,55397,1.0938715773092742,0.3193149919014105
23171,0.5917261904761905,0,2,0,487522,118088,52559,55397,1.093853051243099,0.3193186730841283
23172,0.5917424242424243,0,1,0,487523,118087,52559,55397,1.0938437882100114,0.31932051370731596
23173,0.5917499999999999,1,1,1,487524,118086,52560,55396,1.093834525176924,0.3193184307305657
23174,0.5917777777777778,0,1,0,487525,118085,52560,55396,1.0938252621438365,0.31932027138418617
23175,0.5917857142857144,1,4,1,487529,118081,52561,55395,1.0937882100114862,0.3193237104844474
23176,0.5918333333333332,0,1,0,487530,118080,52561,55395,1.0937789469783985,0.319325551232166
23177,0.5918333333333333,7,14,7,487544,118066,52568,55388,1.0936492645151727,0.31932385531610685
23178,0.59184126984127,0,2,0,487546,118064,52568,55388,1.0936307384489978,0.31932753730138597
23179,0.5918549783549782,0,1,0,487547,118063,52568,55388,1.0936214754159101,0.3193293783258673
23180,0.5918571428571429,0,2,0,487549,118061,52568,55388,1.093602949349735,0.31933306043851506
23181,0.5918809523809524,0,4,0,487553,118057,52568,55388,1.093565897217385,0.31934042491856207
23182,0.5919047619047618,0,3,0,487556,118054,52568,55388,1.0935381081181221,0.3193459485015164
23183,0.5919047619047619,0,2,0,487558,118052,52568,55388,1.093519582051947,0.31934963099631
23184,0.5919166666666666,1,0,1,487558,118052,52569,55387,1.093519582051947,0.319345706559655
23185,0.591926406926407,0,1,0,487559,118051,52569,55387,1.0935103190188595,0.3193475478268891
23186,0.591952380952381,0,3,0,487562,118048,52569,55387,1.093482529919597,0.31935307175598926
23187,0.5919628427128426,0,1,0,487563,118047,52569,55387,1.0934732668865093,0.3193549131081564
23188,0.591969696969697,1,0,1,487563,118047,52570,55386,1.0934732668865093,0.3193509885661898
23189,0.5919761904761905,0,1,0,487564,118046,52570,55386,1.0934640038534218,0.3193528299275797
23190,0.592,1,5,1,487569,118041,52571,55385,1.093417688687984,0.3193581123937587
23191,0.5920000000000001,10,47,10,487616,117994,52581,55375,1.092982326132869,0.31940543003651173
23192,0.5920238095238094,0,1,0,487617,117993,52581,55375,1.0929730630997814,0.3194072723916755
23193,0.5920515873015872,0,1,0,487618,117992,52581,55375,1.092963800066694,0.31940911476809314
23194,0.5920555555555554,0,1,0,487619,117991,52581,55375,1.0929545370336062,0.3194109571657649
23195,0.5920714285714286,1,1,1,487620,117990,52582,55374,1.0929452740005188,0.3194088738146328
23196,0.5920833333333333,0,1,0,487621,117989,52582,55374,1.092936010967431,0.31941071624279693
23197,0.5920833333333334,1,0,1,487621,117989,52583,55373,1.092936010967431,0.3194067904154313
23198,0.5920952380952381,0,1,0,487622,117988,52583,55373,1.0929267479343436,0.3194086328528331
23199,0.5921428571428572,2,6,2,487628,117982,52585,55371,1.0928711697358182,0.3194118359647655
23200,0.5921666666666666,1,8,1,487636,117974,52586,55370,1.0927970654711179,0.3194226509137899
23201,0.5921666666666667,1,9,1,487645,117965,52587,55369,1.0927136981733299,0.31943530986419283
23202,0.5922142857142857,0,1,0,487646,117964,52587,55369,1.0927044351402424,0.31943715276375534
23203,0.5922222222222222,0,1,0,487647,117963,52587,55369,1.0926951721071547,0.31943899568458217
23204,0.5922380952380952,1,0,1,487647,117963,52588,55368,1.0926951721071547,0.31943506931824084
23205,0.59225,0,1,0,487648,117962,52588,55368,1.0926859090740673,0.31943691224831244
23206,0.5922619047619049,0,1,0,487649,117961,52588,55368,1.0926766460409796,0.3194387551996492
23207,0.5922727272727273,0,1,0,487650,117960,52588,55368,1.0926673830078921,0.31944059817225146
23208,0.5923333333333332,1,1,1,487651,117959,52589,55367,1.0926581199748044,0.3194385147063914
23209,0.5923333333333333,3,6,3,487657,117953,52592,55364,1.0926025417762792,0.3194377931766647
23210,0.5923333333333334,2,16,2,487673,117937,52594,55362,1.0924543332468784,0.319459431387371
23211,0.5923571428571429,1,1,1,487674,117936,52595,55361,1.092445070213791,0.31945734779020984
23212,0.5923809523809523,1,3,1,487677,117933,52596,55360,1.092417281114528,0.3194589510251424
23213,0.5923809523809525,0,1,0,487678,117932,52596,55360,1.0924080180814406,0.3194607944971493
23214,0.5923910533910534,0,1,0,487679,117931,52596,55360,1.092398755048353,0.3194626379904323
23215,0.5924166666666667,0,2,0,487681,117929,52596,55360,1.092380228982178,0.3194663250408277
23216,0.5924285714285715,0,1,0,487682,117928,52596,55360,1.0923709659490903,0.319468168597941
23217,0.5924523809523808,0,4,0,487686,117924,52596,55360,1.09233391381674,0.3194755430391727
23218,0.592452380952381,1,3,1,487689,117921,52597,55359,1.0923061247174775,0.3194771468144044
23219,0.5924761904761905,0,1,0,487690,117920,52597,55359,1.09229686168439,0.3194789905297237
23220,0.5924999999999999,2,13,2,487703,117907,52599,55357,1.0921764422542517,0.31949510573460155
23221,0.5925,47,201,47,487904,117706,52646,55310,1.0903145726036534,0.31968141674758405
23222,0.5925000000000001,0,2,0,487906,117704,52646,55310,1.0902960465374782,0.31968511218745305
23223,0.5926190476190476,0,1,0,487907,117703,52646,55310,1.0902867835043908,0.31968695993942653
23224,0.5926190476190477,1,1,1,487908,117702,52647,55309,1.090277520471303,0.3196848755281456
23225,0.5926666666666667,7,46,7,487954,117656,52654,55302,1.0898514209492756,0.3197423651984875
23226,0.5926904761904763,0,1,0,487955,117655,52654,55302,1.089842157916188,0.31974421387975044
23227,0.5927142857142857,0,1,0,487956,117654,52654,55302,1.0898328948831004,0.3197460625823909
23228,0.5927222222222223,0,2,0,487958,117652,52654,55302,1.0898143688169255,0.31974976005180566
23229,0.5927380952380953,0,2,0,487960,117650,52654,55302,1.0897958427507504,0.3197534576067348
23230,0.5927619047619048,0,1,0,487961,117649,52654,55302,1.0897865797176627,0.3197553064162682
23231,0.5927777777777777,1,0,1,487961,117649,52655,55301,1.0897865797176627,0.319751373229257
23232,0.5928333333333332,0,2,0,487963,117647,52655,55301,1.0897680536514875,0.3197550708883595
23233,0.5928333333333333,0,3,0,487966,117644,52655,55301,1.089740264552225,0.3197606175373674
23234,0.5928333333333334,0,5,0,487971,117639,52655,55301,1.0896939493867872,0.3197698623800162
23235,0.5928477633477636,0,1,0,487972,117638,52655,55301,1.0896846863536997,0.31977171141269467
23236,0.5928571428571429,1,3,1,487975,117635,52656,55300,1.089656897254437,0.3197733252378061
23237,0.5929166666666666,0,1,0,487976,117634,52656,55300,1.0896476342213495,0.31977517434396935
23238,0.5929166666666668,1,0,1,487976,117634,52657,55299,1.0896476342213495,0.3197712408851983
23239,0.5929523809523809,0,1,0,487977,117633,52657,55299,1.0896383711882618,0.3197730900006939
23240,0.5929642857142857,0,1,0,487978,117632,52657,55299,1.0896291081551743,0.3197749391375751
23241,0.5929761904761904,0,2,0,487980,117630,52657,55299,1.0896105820889992,0.31977863747549573
23242,0.5929999999999999,0,1,0,487981,117629,52657,55299,1.0896013190559117,0.3197804866765359
23243,0.593,8,29,8,488010,117600,52665,55291,1.0893326910963725,0.31980265022470805
23244,0.5930000000000001,1,8,1,488018,117592,52666,55290,1.0892585868316722,0.3198135144202404
23245,0.5930238095238096,0,1,0,488019,117591,52666,55290,1.0892493237985845,0.3198153643257501
23246,0.5931190476190475,0,1,0,488020,117590,52666,55290,1.089240060765497,0.3198172142526608
23247,0.5931428571428571,0,9,0,488029,117581,52666,55290,1.089156693467709,0.3198338645579652
23248,0.5931428571428572,0,1,0,488030,117580,52666,55290,1.0891474304346216,0.3198357146989067
23249,0.5931666666666666,1,11,1,488041,117569,52667,55289,1.0890455370706584,0.31985213296462994
23250,0.5931666666666667,0,5,0,488046,117564,52667,55289,1.0889992219052207,0.31986138510757695
23251,0.5932142857142857,1,4,1,488050,117560,52668,55288,1.0889621697728704,0.31986485235582707
23252,0.5932142857142858,1,0,1,488050,117560,52669,55287,1.0889621697728704,0.319860917458793
23253,0.59325,0,1,0,488051,117559,52669,55287,1.088952906739783,0.31986276801314467
23254,0.5932619047619049,0,1,0,488052,117558,52669,55287,1.0889436437066953,0.31986461858890913
23255,0.5932857142857143,1,0,1,488052,117558,52670,55286,1.0889436437066953,0.3198606836222258
23256,0.5932925685425685,1,2,1,488054,117556,52671,55285,1.0889251176405201,0.3198604497775412
23257,0.5933333333333333,56,157,56,488211,117399,52727,55229,1.0874708214457742,0.31993071807586254
23258,0.5933333333333334,61,253,61,488464,117146,52788,55168,1.085127274074623,0.32015970843924463
23259,0.5933730158730159,0,1,0,488465,117145,52788,55168,1.0851180110415355,0.3201615664517477
23260,0.5933939393939395,0,1,0,488466,117144,52788,55168,1.0851087480084478,0.3201634244858164
23261,0.5934155844155844,0,1,0,488467,117143,52788,55168,1.0850994849753604,0.3201652825414512
23262,0.5934285714285714,1,0,1,488467,117143,52789,55167,1.0850994849753604,0.3201613371249492
23263,0.5934404761904762,1,2,1,488469,117141,52790,55166,1.0850809589091852,0.3201611077901652
23264,0.593452380952381,0,1,0,488470,117140,52790,55166,1.0850716958760978,0.3201629658862721
23265,0.5934999999999999,0,2,0,488472,117138,52790,55166,1.0850531698099226,0.3201666821431888
23266,0.5935,2,21,2,488493,117117,52792,55164,1.084858646115084,0.320197816358159
23267,0.5935000000000001,0,2,0,488495,117115,52792,55164,1.0848401200489088,0.3202015335589364
23268,0.5935081079051667,2,5,2,488500,117110,52794,55162,1.084793804883471,0.32020293489365653
23269,0.593547619047619,1,0,1,488500,117110,52795,55161,1.084793804883471,0.32019898880252623
23270,0.5935476190476191,0,1,0,488501,117109,52795,55161,1.0847845418503834,0.3202008475068207
23271,0.5935714285714285,0,1,0,488502,117108,52795,55161,1.084775278817296,0.3202027062326942
23272,0.5935714285714286,1,1,1,488503,117107,52796,55160,1.0847660157842083,0.32020061880685213
23273,0.5935833333333334,0,1,0,488504,117106,52796,55160,1.0847567527511208,0.3202024775637677
23274,0.593595238095238,0,1,0,488505,117105,52796,55160,1.0847474897180334,0.32020433634226336
23275,0.5935974025974027,0,1,0,488506,117104,52796,55160,1.0847382266849457,0.32020619514233967
23276,0.5935992063492064,0,2,0,488508,117102,52796,55160,1.0847197006187705,0.3202099128072355
23277,0.5936111111111111,0,3,0,488511,117099,52796,55160,1.084691911519508,0.32021548946644296
23278,0.5936666666666666,0,1,0,488512,117098,52796,55160,1.0846826484864205,0.3202173483960106
23279,0.5936666666666667,0,8,0,488520,117090,52796,55160,1.08460854422172,0.3202322206095791
23280,0.5936666666666668,0,4,0,488524,117086,52796,55160,1.0845714920893696,0.32023965723442055
23281,0.5936904761904762,0,2,0,488526,117084,52796,55160,1.0845529660231947,0.32024337567636607
23282,0.5937142857142856,0,1,0,488527,117083,52796,55160,1.084543702990107,0.3202452349297214
23283,0.5937499999999999,0,1,0,488528,117082,52796,55160,1.0845344399570196,0.3202470942046655
23284,0.59375,0,6,0,488534,117076,52796,55160,1.0844788617584942,0.3202582503077173
23285,0.5937748917748918,1,1,1,488535,117075,52797,55159,1.0844695987254067,0.32025616312690874
23286,0.5937857142857144,0,3,0,488538,117072,52797,55159,1.084441809626144,0.3202617414983365
23287,0.5938095238095238,0,1,0,488539,117071,52797,55159,1.0844325465930564,0.3202636009986646
23288,0.5938095238095239,0,1,0,488540,117070,52797,55159,1.084423283559969,0.32026546052058597
23289,0.5938333333333332,0,2,0,488542,117068,52797,55159,1.0844047574937938,0.3202691796292103
23290,0.5938333333333333,0,6,0,488548,117062,52797,55159,1.0843491792952684,0.3202803374733627
23291,0.5938333333333334,0,3,0,488551,117059,52797,55159,1.0843213901960058,0.32028591668698975
23292,0.5938743756243756,0,2,0,488553,117057,52797,55159,1.0843028641298307,0.32028963627072976
23293,0.5938809523809525,1,0,1,488553,117057,52798,55158,1.0843028641298307,0.32028568939987806
23294,0.5938888888888889,0,2,0,488555,117055,52798,55158,1.0842843380636555,0.3202894090457747
23295,0.5939166666666668,1,1,1,488556,117054,52799,55157,1.084275075030568,0.3202873219480753
23296,0.5939285714285715,0,1,0,488557,117053,52799,55157,1.0842658119974804,0.32028918181290283
23297,0.5939285714285716,0,1,0,488558,117052,52799,55157,1.084256548964393,0.3202910416993305
23298,0.593952380952381,1,0,1,488558,117052,52800,55156,1.084256548964393,0.32028709467620553
23299,0.5939761904761905,0,1,0,488559,117051,52800,55156,1.0842472859313053,0.3202889545721138
23300,0.5939999999999999,0,1,0,488560,117050,52800,55156,1.0842380228982178,0.3202908144896229
23301,0.594,25,63,25,488623,116987,52825,55131,1.083654451813702,0.3203093226739795
23302,0.5940000000000001,2,2,2,488625,116985,52827,55129,1.0836359257475268,0.32030514658888876
23303,0.5940454545454547,1,0,1,488625,116985,52828,55128,1.0836359257475268,0.3203011974691046
23304,0.5940476190476189,0,2,0,488627,116983,52828,55128,1.0836173996813516,0.32030491949962525
23305,0.594047619047619,1,2,1,488629,116981,52829,55127,1.0835988736151765,0.32030469240244497
23306,0.5940555555555557,1,2,1,488631,116979,52830,55126,1.0835803475490013,0.3203044652973476
23307,0.5940595238095239,0,1,0,488632,116978,52830,55126,1.0835710845159139,0.3203063264072886
23308,0.5941428571428571,0,1,0,488633,116977,52830,55126,1.0835618214828264,0.32030818753885754
23309,0.5941428571428572,1,0,1,488633,116977,52831,55125,1.0835618214828264,0.32030423818433257
23310,0.5941666666666666,19,53,19,488686,116924,52850,55106,1.083070880729186,0.32032784979364065
23311,0.5941666666666667,7,31,7,488717,116893,52857,55099,1.082783726703472,0.3203579236243546
23312,0.59425,0,1,0,488718,116892,52857,55099,1.0827744636703842,0.32035978626788614
23313,0.5942500000000001,0,1,0,488719,116891,52857,55099,1.0827652006372968,0.3203616489330775
23314,0.5942777777777778,0,1,0,488720,116890,52857,55099,1.082755937604209,0.3203635116199292
23315,0.5942857142857142,0,1,0,488721,116889,52857,55099,1.0827466745711216,0.32036537432844153
23316,0.5942857142857143,0,8,0,488729,116881,52857,55099,1.082672570306421,0.3203802767763693
23317,0.5943333333333332,0,1,0,488730,116880,52857,55099,1.0826633072733336,0.32038213967984464
23318,0.5943333333333333,1,9,1,488739,116871,52858,55098,1.0825799399755456,0.3203949549046631
23319,0.5943333333333334,5,23,5,488762,116848,52863,55093,1.0823668902145318,0.32041805037774584
23320,0.5943809523809525,0,1,0,488763,116847,52863,55093,1.0823576271814443,0.3204199139234617
23321,0.5944166666666667,1,0,1,488763,116847,52864,55092,1.0823576271814443,0.3204159614747091
23322,0.5944166666666668,0,1,0,488764,116846,52864,55092,1.0823483641483567,0.32041782502995264
23323,0.5944213564213564,0,1,0,488765,116845,52864,55092,1.0823391011152692,0.3204196886068734
23324,0.5944285714285713,1,2,1,488767,116843,52865,55091,1.082320575049094,0.3204194632824223
23325,0.5944444444444444,0,1,0,488768,116842,52865,55091,1.0823113120160066,0.3204213269122274
23326,0.5944761904761904,0,2,0,488770,116840,52865,55091,1.0822927859498315,0.3204250542368741
23327,0.5944999999999999,5,6,5,488776,116834,52870,55086,1.082237207751306,0.3204164727780363
23328,0.5945,0,5,0,488781,116829,52870,55086,1.0821908925858683,0.3204257918157229
23329,0.5945000000000001,1,1,1,488782,116828,52871,55085,1.0821816295527809,0.32042370268682413
23330,0.5945238095238095,0,3,0,488785,116825,52871,55085,1.082153840453518,0.32042929439823165
23331,0.5945238095238096,1,2,1,488787,116823,52872,55084,1.082135314387343,0.3204290692060242
23332,0.5945423465423465,0,1,0,488788,116822,52872,55084,1.0821260513542554,0.32043093318441473
23333,0.5945714285714286,0,1,0,488789,116821,52872,55084,1.082116788321168,0.3204327971844914
23334,0.5945833333333332,1,3,1,488792,116818,52873,55083,1.0820889992219052,0.3204344360998482
23335,0.5945833333333334,1,1,1,488793,116817,52874,55082,1.0820797361888177,0.3204323469013781
23336,0.594642857142857,1,0,1,488793,116817,52875,55081,1.0820797361888177,0.3204283935822406
23337,0.5946623376623377,0,1,0,488794,116816,52875,55081,1.08207047315573,0.320430257654293
23338,0.5946666666666666,1,6,1,488800,116810,52876,55080,1.0820148949572048,0.3204374890918611
23339,0.5946666666666667,1,13,1,488813,116797,52877,55079,1.0818944755270665,0.3204577718820545
23340,0.5946904761904761,1,0,1,488813,116797,52878,55078,1.0818944755270665,0.3204538181818182
23341,0.5946904761904762,0,1,0,488814,116796,52878,55078,1.081885212493979,0.3204556826512445
23342,0.5947142857142856,0,1,0,488815,116795,52878,55078,1.0818759494608914,0.32045754714236674
23343,0.5947222222222223,0,1,0,488816,116794,52878,55078,1.081866686427804,0.32045941165518527
23344,0.5947460317460318,0,1,0,488817,116793,52878,55078,1.0818574233947165,0.32046127618970044
23345,0.59475,0,1,0,488818,116792,52878,55078,1.0818481603616288,0.3204631407459126
23346,0.5947619047619048,1,0,1,488818,116792,52879,55077,1.0818481603616288,0.32045918693888953
23347,0.5947698412698412,1,0,1,488818,116792,52880,55076,1.0818481603616288,0.3204552330858566
23348,0.5948095238095238,0,3,0,488821,116789,52880,55076,1.0818203712623662,0.32046082681174176
23349,0.5948333333333332,0,1,0,488822,116788,52880,55076,1.0818111082292785,0.3204626914304334
23350,0.5948333333333333,6,11,6,488833,116777,52886,55070,1.0817092148653156,0.32045947848958667
23351,0.5948571428571429,0,1,0,488834,116776,52886,55070,1.081699951832228,0.32046134329574155
23352,0.5948809523809523,0,1,0,488835,116775,52886,55070,1.0816906887991404,0.32046320812359974
23353,0.5948809523809524,0,2,0,488837,116773,52886,55070,1.0816721627329653,0.32046693784442776
23354,0.5949166666666666,0,1,0,488838,116772,52886,55070,1.0816628996998778,0.3204688027373983
23355,0.5949523809523809,0,1,0,488839,116771,52886,55070,1.0816536366667902,0.3204706676520737
23356,0.594952380952381,0,1,0,488840,116770,52886,55070,1.0816443736337027,0.3204725325884544
23357,0.595,194,773,194,489613,115997,53080,54876,1.0744840490570233,0.3211507962053689
23358,0.5950000000000001,3,12,3,489625,115985,53083,54873,1.0743728926599725,0.32116143230050687
23359,0.595031746031746,0,3,0,489628,115982,53083,54873,1.07434510356071,0.3211670714933716
23360,0.595047619047619,2,3,2,489631,115979,53085,54871,1.0743173144614473,0.321164764413228
23361,0.5950606060606061,0,1,0,489632,115978,53085,54871,1.0743080514283596,0.3211666442296999
23362,0.5950714285714285,0,1,0,489633,115977,53085,54871,1.0742987883952722,0.3211685240681776
23363,0.5951428571428571,0,1,0,489634,115976,53085,54871,1.0742895253621847,0.3211704039286613
23364,0.5951666666666666,1,7,1,489641,115969,53086,54870,1.0742246841305718,0.32117959014042463
23365,0.5951666666666667,1,1,1,489642,115968,53087,54869,1.0742154210974841,0.32117749667812007
23366,0.5952023809523809,3,2,3,489644,115966,53090,54866,1.074196895031309,0.32116933595579283
23367,0.5952857142857142,0,2,0,489646,115964,53090,54866,1.0741783689651339,0.32117309606041095
23368,0.5953095238095237,0,1,0,489647,115963,53090,54866,1.0741691059320464,0.32117497614573637
23369,0.5953095238095238,0,1,0,489648,115962,53090,54866,1.074159842898959,0.32117685625307324
23370,0.5953333333333333,5,7,5,489655,115955,53095,54861,1.074095001667346,0.3211701479955039
23371,0.5953333333333334,3,5,3,489660,115950,53098,54858,1.074048686501908,0.32116762680904876
23372,0.5953571428571428,0,1,0,489661,115949,53098,54858,1.0740394234688206,0.32116950710450975
23373,0.5953888888888887,0,3,0,489664,115946,53098,54858,1.074011634369558,0.3211751481229948
23374,0.5954166666666666,0,1,0,489665,115945,53098,54858,1.0740023713364704,0.3211770285065251
23375,0.5954166666666667,0,1,0,489666,115944,53098,54858,1.073993108303383,0.3211789089120736
23376,0.5954246031746032,0,2,0,489668,115942,53098,54858,1.0739745822372078,0.32118266978922716
23377,0.5954761904761905,0,6,0,489674,115936,53098,54858,1.0739190040386823,0.3211939529491668
23378,0.5954999999999999,1,10,1,489684,115926,53099,54857,1.0738263737078069,0.32120878541775233
23379,0.5955,0,6,0,489690,115920,53099,54857,1.0737707955092815,0.3212200706184088
23380,0.5955000000000001,0,1,0,489691,115919,53099,54857,1.073761532476194,0.3212219515622804
23381,0.5955238095238095,0,3,0,489694,115916,53099,54857,1.0737337433769314,0.32122759452606675
23382,0.595547619047619,0,1,0,489695,115915,53099,54857,1.0737244803438437,0.32122947555805403
23383,0.5955873015873016,0,1,0,489696,115914,53099,54857,1.0737152173107563,0.32123135661207114
23384,0.5955952380952381,0,2,0,489698,115912,53099,54857,1.0736966912445811,0.32123511878619654
23385,0.5956190476190476,0,1,0,489699,115911,53099,54857,1.0736874282114937,0.3212369999063056
23386,0.5956428571428571,1,2,1,489701,115909,53100,54856,1.0736689021453185,0.32123678739788597
23387,0.5956569264069265,0,1,0,489702,115908,53100,54856,1.0736596391122308,0.32123866857183014
23388,0.5956666666666666,0,2,0,489704,115906,53100,54856,1.0736411130460557,0.3212424309858165
23389,0.5956666666666667,8,21,8,489725,115885,53108,54848,1.073446589351217,0.3212501391060896
23390,0.5956666666666668,0,2,0,489727,115883,53108,54848,1.0734280632850421,0.3212539023375954
23391,0.5957142857142856,4,8,4,489735,115875,53112,54844,1.0733539590203416,0.32125305326296427
23392,0.5957142857142858,0,3,0,489738,115872,53112,54844,1.073326169921079,0.32125869865741935
23393,0.5957380952380952,0,1,0,489739,115871,53112,54844,1.0733169068879913,0.32126058049966316
23394,0.59575,1,2,1,489741,115869,53113,54843,1.0732983808218164,0.32126036833965976
23395,0.5957857142857143,0,1,0,489742,115868,53113,54843,1.0732891177887287,0.3212622502357786
23396,0.5958333333333332,0,1,0,489743,115867,53113,54843,1.0732798547556412,0.3212641321539453
23397,0.5958333333333333,12,81,12,489824,115786,53125,54831,1.0725295490755493,0.3213689140003634
23398,0.5958333333333334,0,2,0,489826,115784,53125,54831,1.0725110230093742,0.32137268118277995
23399,0.5958809523809523,0,1,0,489827,115783,53125,54831,1.0725017599762867,0.32137456480710846
23400,0.5958809523809524,0,1,0,489828,115782,53125,54831,1.072492496943199,0.3213764484535176
23401,0.5959285714285715,0,2,0,489830,115780,53125,54831,1.072473970877024,0.3213802158125795
23402,0.5959404761904761,0,1,0,489831,115779,53125,54831,1.0724647078439364,0.321382099525233
23403,0.5959523809523809,1,1,1,489832,115778,53126,54830,1.0724554448108488,0.32138000562693425
23404,0.5959761904761904,1,2,1,489834,115776,53127,54829,1.0724369187446738,0.321379795433897
23405,0.596,24,88,24,489922,115688,53151,54805,1.071621771832969,0.32145014751338763
23406,0.5960000000000001,0,2,0,489924,115686,53151,54805,1.0716032457667939,0.32145391838865395
23407,0.596047619047619,0,1,0,489925,115685,53151,54805,1.0715939827337064,0.3214558038594639
23408,0.5960714285714286,0,1,0,489926,115684,53151,54805,1.0715847197006187,0.3214576893523922
23409,0.5961190476190477,1,0,1,489926,115684,53152,54804,1.0715847197006187,0.32145370935197787
23410,0.5961309523809524,0,2,0,489928,115682,53152,54804,1.0715661936344436,0.32145748037962063
23411,0.5961394161394162,0,2,0,489930,115680,53152,54804,1.0715476675682685,0.32146125149574156
23412,0.5961428571428571,0,1,0,489931,115679,53152,54804,1.071538404535181,0.32146313708698226
23413,0.5961666666666666,0,8,0,489939,115671,53152,54804,1.0714643002704807,0.3214782226132864
23414,0.5961904761904762,1,1,1,489940,115670,53153,54803,1.071455037237393,0.32147612818452187
23415,0.5962380952380952,0,1,0,489941,115669,53153,54803,1.0714457742043055,0.3214780139847013
23416,0.59625,2,4,2,489945,115665,53155,54801,1.0714087220719553,0.3214775967055014
23417,0.5962896825396826,0,1,0,489946,115664,53155,54801,1.0713994590388678,0.32147948259173437
23418,0.5963095238095238,0,1,0,489947,115663,53155,54801,1.0713901960057801,0.32148136850009384
23419,0.5963333333333333,0,5,0,489952,115658,53155,54801,1.0713438808403424,0.3214907983738025
23420,0.5963333333333334,5,15,5,489967,115643,53160,54796,1.071204935344029,0.3214991873925569
23421,0.5963571428571428,0,1,0,489968,115642,53160,54796,1.0711956723109415,0.3215010737042209
23422,0.5963571428571429,1,1,1,489969,115641,53161,54795,1.071186409277854,0.3214989790889249
23423,0.5963809523809523,0,1,0,489970,115640,53161,54795,1.0711771462447663,0.3215008654325696
23424,0.596388888888889,0,1,0,489971,115639,53161,54795,1.0711678832116789,0.3215027517983501
23425,0.5964166666666667,0,2,0,489973,115637,53161,54795,1.0711493571455037,0.32150652459631995
23426,0.5964285714285714,1,3,1,489976,115634,53162,54794,1.0711215680462411,0.32150820287746146
23427,0.5964761904761905,0,3,0,489979,115631,53162,54794,1.0710937789469783,0.3215138624028165
23428,0.5964999999999999,1,0,1,489979,115631,53163,54793,1.0710937789469783,0.3215098812373844
23429,0.5965,2,15,2,489994,115616,53165,54791,1.0709548334506651,0.3215302188290387
23430,0.596530303030303,0,1,0,489995,115615,53165,54791,1.0709455704175774,0.32153210567703017
23431,0.5965714285714285,0,1,0,489996,115614,53165,54791,1.07093630738449,0.321533992547167
23432,0.5965984848484848,0,1,0,489997,115613,53165,54791,1.0709270443514025,0.3215358794394498
23433,0.5966584387834387,0,1,0,489998,115612,53165,54791,1.0709177813183148,0.32153776635387876
23434,0.5966666666666666,0,2,0,490000,115610,53165,54791,1.0708992552521397,0.3215415402491769
23435,0.5966666666666667,111,454,111,490454,115156,53276,54680,1.06669383823039,0.3219576532655032
23436,0.5966785714285714,0,1,0,490455,115155,53276,54680,1.0666845751973026,0.3219595489740042
23437,0.5966904761904762,0,1,0,490456,115154,53276,54680,1.066675312164215,0.3219614447048294
23438,0.5967142857142858,0,1,0,490457,115153,53276,54680,1.0666660491311275,0.3219633404579793
23439,0.5967380952380953,0,4,0,490461,115149,53276,54680,1.0666289969987772,0.32197092369383323
23440,0.59675,0,4,0,490465,115145,53276,54680,1.0665919448664272,0.321978507286913
23441,0.5967619047619048,1,1,1,490466,115144,53277,54679,1.0665826818333395,0.32197641073352845
23442,0.5967777777777777,1,3,1,490469,115141,53278,54678,1.0665548927340769,0.32197810610120187
23443,0.5967857142857143,1,1,1,490470,115140,53279,54677,1.0665456297009892,0.32197600946901667
23444,0.5967896825396826,1,1,1,490471,115139,53280,54676,1.0665363666679017,0.32197391278744514
23445,0.5968095238095238,0,2,0,490473,115137,53280,54676,1.0665178406017266,0.32197770488714056
23446,0.5968181818181819,0,1,0,490474,115136,53280,54676,1.0665085775686391,0.321979600970485
23447,0.5968333333333331,1,0,1,490474,115136,53281,54675,1.0665085775686391,0.3219756081761488
23448,0.5968333333333332,0,1,0,490475,115135,53281,54675,1.0664993145355515,0.32197750426947763
23449,0.5968333333333333,2,8,2,490483,115127,53283,54673,1.0664252102708511,0.3219846878680801
23450,0.5968333333333334,0,1,0,490484,115126,53283,54673,1.0664159472377635,0.32198658413771575
23451,0.5968571428571428,0,1,0,490485,115125,53283,54673,1.066406684204676,0.32198848042968703
23452,0.5968589743589744,0,1,0,490486,115124,53283,54673,1.0663974211715885,0.3219903767439943
23453,0.596892857142857,0,1,0,490487,115123,53283,54673,1.0663881581385009,0.32199227308063794
23454,0.5969047619047619,0,1,0,490488,115122,53283,54673,1.0663788951054134,0.32199416943961834
23455,0.5969101731601731,0,2,0,490490,115120,53283,54673,1.0663603690392383,0.3219979622245911
23456,0.5969444444444444,0,1,0,490491,115119,53283,54673,1.0663511060061506,0.3219998586505842
23457,0.5969841269841268,1,0,1,490491,115119,53284,54672,1.0663511060061506,0.3219958655052388
23458,0.597,6,37,6,490528,115082,53290,54666,1.066008373781911,0.3220420859155925
23459,0.5970000000000001,0,2,0,490530,115080,53290,54666,1.0659898477157361,0.32204588031529463
23460,0.5970357142857143,0,1,0,490531,115079,53290,54666,1.0659805846826484,0.322047777548676
23461,0.5970476190476189,0,1,0,490532,115078,53290,54666,1.065971321649561,0.3220496748044113
23462,0.5970833333333333,0,1,0,490533,115077,53290,54666,1.0659620586164733,0.3220515720825012
23463,0.5970833333333334,0,4,0,490537,115073,53290,54666,1.0659250064841232,0.32205916141841295
23464,0.5970952380952381,0,2,0,490539,115071,53290,54666,1.065906480417948,0.32206295622050585
23465,0.5971190476190478,0,1,0,490540,115070,53290,54666,1.0658972173848604,0.3220648536550879
23466,0.5971428571428571,0,1,0,490541,115069,53290,54666,1.065887954351773,0.3220667511120276
23467,0.5971428571428572,1,7,1,490548,115062,53291,54665,1.06582311312016,0.3220760397579643
23468,0.5971666666666666,2,3,2,490551,115059,53293,54663,1.0657953240208975,0.3220737441227419
23469,0.5971666666666667,0,8,0,490559,115051,53293,54663,1.065721219756197,0.3220889260756331
23470,0.5971904761904763,1,2,1,490561,115049,53294,54662,1.0657026936900218,0.32208872730701016
23471,0.5972222222222222,1,2,1,490563,115047,53295,54661,1.0656841676238467,0.3220885285313598
23472,0.5972500000000001,0,1,0,490564,115046,53295,54661,1.0656749045907592,0.3220904264408657
23473,0.5972619047619049,1,0,1,490564,115046,53296,54660,1.0656749045907592,0.32208643182916336
23474,0.5972727272727272,0,1,0,490565,115045,53296,54660,1.0656656415576717,0.3220883297486815
23475,0.5972857142857143,1,2,1,490567,115043,53297,54659,1.0656471154914966,0.32208813095897515
23476,0.5973095238095238,0,1,0,490568,115042,53297,54659,1.065637852458409,0.3220900289332414
23477,0.5973333333333332,0,2,0,490570,115040,53297,54659,1.0656193263922338,0.32209382494888006
23478,0.5973333333333333,3,5,3,490575,115035,53300,54656,1.065573011226796,0.322091330712884
23479,0.5973333333333334,3,19,3,490594,115016,53303,54653,1.0653970135981325,0.3221154129510989
23480,0.5973809523809525,0,1,0,490595,115015,53303,54653,1.065387750565045,0.32211731145531275
23481,0.597452380952381,0,1,0,490596,115014,53303,54653,1.0653784875319574,0.32211920998190574
23482,0.5974523809523811,0,2,0,490598,115012,53303,54653,1.0653599614657823,0.32212300710223085
23483,0.5974545454545455,0,1,0,490599,115011,53303,54653,1.0653506984326948,0.3221249056959638
23484,0.5974722222222222,0,1,0,490600,115010,53303,54653,1.0653414353996074,0.32212680431207746
23485,0.5974999999999999,0,9,0,490609,115001,53303,54653,1.0652580681018193,0.3221438928643003
23486,0.5975,58,221,58,490830,114780,53361,54595,1.0632109377894698,0.32233210332103324
23487,0.5975238095238095,0,1,0,490831,114779,53361,54595,1.0632016747563822,0.3223340064000378
23488,0.5975238095238096,1,0,1,490831,114779,53362,54594,1.0632016747563822,0.3223300053727572
23489,0.5975476190476191,0,1,0,490832,114778,53362,54594,1.0631924117232947,0.3223319084618473
23490,0.5976190476190476,0,1,0,490833,114777,53362,54594,1.063183148690207,0.32233381157340985
23491,0.5976190476190477,0,1,0,490834,114776,53362,54594,1.0631738856571196,0.32233571470744526
23492,0.5976309523809524,0,1,0,490835,114775,53362,54594,1.063164622624032,0.3223376178639539
23493,0.597654761904762,0,1,0,490836,114774,53362,54594,1.0631553595909444,0.3223395210429361
23494,0.5976666666666667,7,26,7,490862,114748,53369,54587,1.062914520730668,0.3223610003838545
23495,0.5976904761904762,0,1,0,490863,114747,53369,54587,1.0629052576975806,0.3223629040830548
23496,0.5977380952380953,0,1,0,490864,114746,53369,54587,1.062895994664493,0.32236480780473975
23497,0.5977435064935065,0,1,0,490865,114745,53369,54587,1.0628867316314055,0.32236671154890983
23498,0.59775,0,3,0,490868,114742,53369,54587,1.0628589425321426,0.3223724229163345
23499,0.5977619047619047,0,1,0,490869,114741,53369,54587,1.0628496794990552,0.32237432675044886
23500,0.5977777777777777,1,1,1,490870,114740,53370,54586,1.0628404164659677,0.3223722287185666
23501,0.5977857142857141,0,1,0,490871,114739,53370,54586,1.06283115343288,0.32237413258526504
23502,0.5978205128205129,0,1,0,490872,114738,53370,54586,1.0628218903997926,0.32237603647445134
23503,0.5978333333333332,1,1,1,490873,114737,53371,54585,1.062812627366705,0.3223739384132009
23504,0.5978333333333333,0,6,0,490879,114731,53371,54585,1.0627570491681797,0.32238536228117837
23505,0.5978333333333334,2,13,2,490892,114718,53373,54583,1.0626366297380414,0.3224021122143401
23506,0.5978571428571429,1,2,1,490894,114716,53374,54582,1.0626181036718663,0.32240191851055533
23507,0.5978809523809524,1,1,1,490895,114715,53375,54581,1.0626088406387788,0.3223998204328513
23508,0.5979166666666667,0,2,0,490897,114713,53375,54581,1.0625903145726037,0.3224036291894574
23509,0.5979166666666668,0,1,0,490898,114712,53375,54581,1.0625810515395162,0.3224055336015074
23510,0.5979761904761905,0,4,0,490902,114708,53375,54581,1.062543999407166,0.3224131514746971
23511,0.5979999999999999,0,1,0,490903,114707,53375,54581,1.0625347363740782,0.3224150559992439
23512,0.598,13,45,13,490948,114662,53388,54568,1.0621178998851384,0.32244873840335636
23513,0.5980000000000001,0,4,0,490952,114658,53388,54568,1.062080847752788,0.3224563601337856
23514,0.5980476190476189,0,1,0,490953,114657,53388,54568,1.0620715847197006,0.3224582656226917
23515,0.5980952380952381,0,1,0,490954,114656,53388,54568,1.062062321686613,0.32246017113411807
23516,0.5980952380952382,1,1,1,490955,114655,53389,54567,1.0620530586535255,0.3224580728274101
23517,0.5981190476190476,0,1,0,490956,114654,53389,54567,1.062043795620438,0.3224599783714787
23518,0.5981230158730159,0,1,0,490957,114653,53389,54567,1.0620345325873504,0.3224618839380688
23519,0.5981388888888889,0,1,0,490958,114652,53389,54567,1.062025269554263,0.32246378952718074
23520,0.5981428571428572,0,1,0,490959,114651,53389,54567,1.0620160065211752,0.322465695138815
23521,0.598154761904762,0,1,0,490960,114650,53389,54567,1.0620067434880878,0.322467600772972
23522,0.5981666666666666,2,3,2,490963,114647,53391,54565,1.0619789543888252,0.32246530978890386
23523,0.5981666666666667,0,6,0,490969,114641,53391,54565,1.0619233761902998,0.32247674432348733
23524,0.5981785714285714,2,0,2,490969,114641,53393,54563,1.0619233761902998,0.3224687359636888
23525,0.5981904761904762,1,0,1,490969,114641,53394,54562,1.0619233761902998,0.3224647317127947
23526,0.5981944444444445,2,0,2,490969,114641,53396,54560,1.0619233761902998,0.3224567230690126
23527,0.5982142857142857,0,3,0,490972,114638,53396,54560,1.0618955870910372,0.3224624404543789
23528,0.5982380952380951,1,0,1,490972,114638,53397,54559,1.0618955870910372,0.32245843602427937
23529,0.5982380952380952,0,1,0,490973,114637,53397,54559,1.0618863240579495,0.32246034185205324
23530,0.5982499999999998,0,1,0,490974,114636,53397,54559,1.061877061024862,0.32246224770235526
23531,0.5982619047619048,2,0,2,490974,114636,53399,54557,1.061877061024862,0.3224542386505352
23532,0.5982857142857143,0,1,0,490975,114635,53399,54557,1.0618677979917743,0.32245614449855786
23533,0.5983333333333333,30,94,30,491069,114541,53429,54527,1.0609970728815443,0.3225152009842194
23534,0.5983333333333334,31,144,31,491213,114397,53460,54496,1.0596631961169365,0.3226658298449314
23535,0.5983571428571428,1,0,1,491213,114397,53461,54495,1.0596631961169365,0.3226618193875376
23536,0.5984404761904761,0,1,0,491214,114396,53461,54495,1.059653933083849,0.32266372986127145
23537,0.598452380952381,0,1,0,491215,114395,53461,54495,1.0596446700507614,0.32266564035762924
23538,0.5984523809523811,0,1,0,491216,114394,53461,54495,1.059635407017674,0.32266755087661125
23539,0.5984761904761904,0,1,0,491217,114393,53461,54495,1.0596261439845862,0.322669461418218
23540,0.5984999999999999,2,5,2,491222,114388,53463,54493,1.0595798288191485,0.32267099318455006
23541,0.5985,4,20,4,491242,114368,53467,54489,1.0593945681573975,0.3226931664070782
23542,0.5985595238095238,0,2,0,491244,114366,53467,54489,1.0593760420912224,0.3226969885404637
23543,0.5985714285714285,0,5,0,491249,114361,53467,54489,1.0593297269257846,0.3227065442700622
23544,0.5985714285714286,2,5,2,491254,114356,53469,54487,1.059283411760347,0.3227080779185397
23545,0.5985952380952381,0,1,0,491255,114355,53469,54487,1.0592741487272592,0.32270998922069155
23546,0.5985952380952382,0,1,0,491256,114354,53469,54487,1.0592648856941718,0.3227119005454836
23547,0.5986190476190475,1,1,1,491257,114353,53470,54486,1.059255622661084,0.322709800460794
23548,0.5986190476190476,0,1,0,491258,114352,53470,54486,1.0592463596279966,0.3227117118184295
23549,0.5986666666666666,0,1,0,491259,114351,53470,54486,1.059237096594909,0.32271362319870645
23550,0.5986666666666667,7,7,7,491266,114344,53477,54479,1.059172255363296,0.3226989213555025
23551,0.5986666666666668,3,4,3,491270,114340,53480,54476,1.059135203230946,0.32269453132404513
23552,0.5986785714285714,0,1,0,491271,114339,53480,54476,1.0591259401978583,0.32269644285164234
23553,0.5987063492063492,0,1,0,491272,114338,53480,54476,1.0591166771647709,0.3226983544018861
23554,0.5987222222222224,0,2,0,491274,114336,53480,54476,1.0590981510985957,0.3227021775703149
23555,0.5987261904761902,0,1,0,491275,114335,53480,54476,1.0590888880655083,0.32270408918850074
23556,0.5987380952380952,0,1,0,491276,114334,53480,54476,1.0590796250324206,0.32270600082933476
23557,0.5987499999999999,0,1,0,491277,114333,53480,54476,1.0590703619993331,0.32270791249281733
23558,0.59875,0,5,0,491282,114328,53480,54476,1.0590240468338954,0.32271747114997273
23559,0.5987500000000001,0,1,0,491283,114327,53480,54476,1.0590147838008077,0.32271938294935515
23560,0.5987976190476191,0,4,0,491287,114323,53480,54476,1.0589777316684574,0.32272703037340267
23561,0.5988095238095238,0,2,0,491289,114321,53480,54476,1.0589592056022825,0.3227308542213428
23562,0.5988174603174603,0,1,0,491290,114320,53480,54476,1.0589499425691948,0.32273276617929336
23563,0.5988333333333332,0,2,0,491292,114318,53480,54476,1.0589314165030197,0.3227365901631575
23564,0.5988333333333333,2,2,2,491294,114316,53482,54474,1.0589128904368446,0.3227323893595592
23565,0.5988690476190477,0,1,0,491295,114315,53482,54474,1.058903627403757,0.3227343014058973
23566,0.5989166666666668,0,1,0,491296,114314,53482,54474,1.0588943643706696,0.32273621347489156
23567,0.5989469696969697,1,1,1,491297,114313,53483,54473,1.058885101337582,0.3227341130188523
23568,0.5989642857142857,0,1,0,491298,114312,53483,54473,1.0588758383044945,0.3227360251207157
23569,0.5989761904761904,0,1,0,491299,114311,53483,54473,1.0588665752714068,0.32273793724523653
23570,0.5989761904761906,0,3,0,491302,114308,53483,54473,1.0588387861721442,0.3227436737547473
23571,0.5989855144855144,2,0,2,491302,114308,53485,54471,1.0588387861721442,0.3227356483922763
23572,0.599,12,36,12,491338,114272,53497,54459,1.0585053169809922,0.3227563399730933
23573,0.5990000000000001,2,7,2,491345,114265,53499,54457,1.0584404757493793,0.3227617026825192
23574,0.599047619047619,1,1,1,491346,114264,53500,54456,1.0584312127162918,0.3227596017069701
23575,0.5990833333333333,0,1,0,491347,114263,53500,54456,1.0584219496832044,0.32276151470788705
23576,0.599093795093795,0,2,0,491349,114261,53500,54456,1.0584034236170292,0.3227653407777521
23577,0.5991071428571428,0,1,0,491350,114260,53500,54456,1.0583941605839415,0.32276725384670096
23578,0.5991190476190477,0,1,0,491351,114259,53500,54456,1.058384897550854,0.32276916693832797
23579,0.5991269841269841,0,1,0,491352,114258,53500,54456,1.0583756345177664,0.32277108005263344
23580,0.5991428571428571,0,1,0,491353,114257,53500,54456,1.058366371484679,0.3227729931896179
23581,0.5991428571428572,0,1,0,491354,114256,53500,54456,1.0583571084515915,0.32277490634928163
23582,0.5991666666666666,10,57,10,491411,114199,53510,54446,1.0578291155656008,0.32284384357674406
23583,0.5991666666666667,9,26,9,491437,114173,53519,54437,1.0575882767053244,0.3228574817626475
23584,0.599190476190476,0,1,0,491438,114172,53519,54437,1.057579013672237,0.3228593965921155
23585,0.5991904761904762,0,2,0,491440,114170,53519,54437,1.0575604876060618,0.32286322631919195
23586,0.5992023809523809,0,1,0,491441,114169,53519,54437,1.0575512245729741,0.3228651412168013
23587,0.5992103174603175,0,1,0,491442,114168,53519,54437,1.0575419615398867,0.32286705613712524
23588,0.5992261904761905,1,0,1,491442,114168,53520,54436,1.0575419615398867,0.32286304002277527
23589,0.5992500000000001,1,7,1,491449,114161,53521,54435,1.0574771203082738,0.32287242876462074
23590,0.5992510822510823,0,1,0,491450,114160,53521,54435,1.057467857275186,0.32287434384175095
23591,0.5992857142857143,3,1,3,491451,114159,53524,54432,1.0574585942420986,0.32286420983326514
23592,0.5993063186813187,0,1,0,491452,114158,53524,54432,1.057449331209011,0.3228661249184412
23593,0.5993333333333333,5,15,5,491467,114143,53529,54427,1.0573103857126978,0.3228747701251706
23594,0.5993333333333334,5,18,5,491485,114125,53534,54422,1.0571436511171217,0.3228891644467122
23595,0.5993333333333335,0,2,0,491487,114123,53534,54422,1.0571251250509466,0.3228929959358035
23596,0.5993571428571428,0,1,0,491488,114122,53534,54422,1.0571158620178591,0.32289491171444845
23597,0.5994166666666666,0,1,0,491489,114121,53534,54422,1.0571065989847717,0.3228968275158268
23598,0.5994444444444444,0,1,0,491490,114120,53534,54422,1.057097335951684,0.322898743339939
23599,0.5994523809523808,0,1,0,491491,114119,53534,54422,1.0570880729185965,0.3229006591867854
23600,0.599452380952381,0,1,0,491492,114118,53534,54422,1.0570788098855088,0.32290257505636644
23601,0.5994761904761904,0,1,0,491493,114117,53534,54422,1.0570695468524214,0.3229044909486825
23602,0.5994761904761905,0,2,0,491495,114115,53534,54422,1.0570510207862462,0.3229083228015213
23603,0.5994999999999999,1,2,1,491497,114113,53535,54421,1.057032494720071,0.3229081372304698
23604,0.5995,2,7,2,491504,114106,53537,54419,1.0569676534884582,0.32291351431538345
23605,0.5995238095238095,2,1,2,491505,114105,53539,54417,1.0569583904553708,0.3229073948801937
23606,0.5995476190476191,0,1,0,491506,114104,53539,54417,1.056949127422283,0.32290931100575004
23607,0.5995584415584416,0,1,0,491507,114103,53539,54417,1.0569398643891956,0.322911227154047
23608,0.5995714285714285,0,1,0,491508,114102,53539,54417,1.056930601356108,0.32291314332508503
23609,0.5995833333333332,0,1,0,491509,114101,53539,54417,1.0569213383230205,0.32291505951886446
23610,0.5996111111111111,0,1,0,491510,114100,53539,54417,1.056912075289933,0.32291697573538575
23611,0.5996190476190475,0,2,0,491512,114098,53539,54417,1.0568935492237579,0.3229208082366555
23612,0.5996190476190476,1,2,1,491514,114096,53540,54416,1.0568750231575827,0.32292062286365364
23613,0.5996428571428571,0,1,0,491515,114095,53540,54416,1.056865760124495,0.32292253918141844
23614,0.5996666666666666,1,9,1,491524,114086,53541,54415,1.0567823928267073,0.3229357689271874
23615,0.5996666666666667,2,19,2,491543,114067,53543,54413,1.0566063951980436,0.32296415004748336
23616,0.5996666666666668,0,1,0,491544,114066,53543,54413,1.056597132164956,0.32296606698757707
23617,0.5997222222222222,0,1,0,491545,114065,53543,54413,1.0565878691318686,0.32296798395042675
23618,0.5997261904761905,0,1,0,491546,114064,53543,54413,1.056578606098781,0.32296990093603284
23619,0.5997619047619047,2,2,2,491548,114062,53545,54411,1.0565600800326058,0.3229656977675948
23620,0.5998095238095239,0,1,0,491549,114061,53545,54411,1.0565508169995184,0.322967614796524
23621,0.5998333333333332,1,4,1,491553,114057,53546,54410,1.056513764867168,0.32297126440193036
23622,0.5998333333333333,4,4,4,491557,114053,53550,54406,1.0564767127348178,0.322962857431185
23623,0.5998333333333334,0,1,0,491558,114052,53550,54406,1.0564674497017303,0.32296477460257156
23624,0.5998373015873015,0,1,0,491559,114051,53550,54406,1.0564581866686429,0.32296669179671966
23625,0.5998571428571429,0,1,0,491560,114050,53550,54406,1.0564489236355552,0.32296860901362967
23626,0.5998809523809524,0,2,0,491562,114048,53550,54406,1.05643039756938,0.32297244351573723
23627,0.5998888888888889,0,1,0,491563,114047,53550,54406,1.0564211345362926,0.32297436080093556
23628,0.5999047619047618,0,1,0,491564,114046,53550,54406,1.056411871503205,0.3229762781088975
23629,0.5999285714285714,0,1,0,491565,114045,53550,54406,1.0564026084701175,0.3229781954396234
23630,0.5999523809523809,0,2,0,491567,114043,53550,54406,1.0563840824039423,0.3229820301693688
23631,0.6,554,2133,554,493700,111910,54104,53852,1.0366260328281893,0.32487542380038853
23632,0.6000000000000001,2,20,2,493720,111890,54106,53850,1.0364407721664382,0.324906480028961
23633,0.6000238095238096,0,1,0,493721,111889,54106,53850,1.0364315091333507,0.32490844037915034
23634,0.6000714285714286,0,1,0,493722,111888,54106,53850,1.036422246100263,0.3249104007529957
23635,0.6001190476190476,1,1,1,493723,111887,54107,53849,1.0364129830671756,0.32490828787951925
23636,0.6001190476190477,0,1,0,493724,111886,54107,53849,1.0364037200340879,0.3249102482879295
23637,0.6001666666666666,6,7,6,493731,111879,54113,53843,1.036338878802475,0.3248995305390956
23638,0.6001666666666667,3,4,3,493735,111875,54116,53840,1.036301826670125,0.324895151314003
23639,0.6001666666666668,0,1,0,493736,111874,54116,53840,1.0362925636370373,0.3248971118915722
23640,0.6001904761904762,0,2,0,493738,111872,54116,53840,1.0362740375708621,0.3249010331176982
23641,0.600202380952381,0,1,0,493739,111871,54116,53840,1.0362647745377747,0.3249029937662557
23642,0.6002380952380952,0,2,0,493741,111869,54116,53840,1.0362462484715995,0.32490691513436204
23643,0.60025,1,1,1,493742,111868,54117,53839,1.036236985438512,0.3249048018490468
23644,0.6002857142857142,0,2,0,493744,111866,54117,53839,1.036218459372337,0.3249087233336351
23645,0.6003214285714286,0,4,0,493748,111862,54117,53839,1.0361814072399866,0.32491656658680396
23646,0.6003333333333333,1,5,1,493753,111857,54118,53838,1.036135092074549,0.3249222969914602
23647,0.6003333333333334,1,6,1,493759,111851,54119,53837,1.0360795138760235,0.3249299888947902
23648,0.6003333333333335,0,1,0,493760,111850,54119,53837,1.036070250842936,0.3249319500021124
23649,0.6003571428571428,0,3,0,493763,111847,54119,53837,1.0360424617436734,0.3249378334661162
23650,0.6003809523809525,0,1,0,493764,111846,54119,53837,1.0360331987105857,0.32493979466813133
23651,0.6004047619047619,0,1,0,493765,111845,54119,53837,1.0360239356774983,0.3249417558938207
23652,0.6004166666666666,0,3,0,493768,111842,54119,53837,1.0359961465782357,0.3249476397129389
23653,0.6004166666666667,0,4,0,493772,111838,54119,53837,1.0359590944458854,0.3249554851365625
23654,0.6004285714285714,0,1,0,493773,111837,54119,53837,1.0359498314127977,0.3249574465516617
23655,0.600452380952381,0,1,0,493774,111836,54119,53837,1.0359405683797103,0.324959407990439
23656,0.6004761904761904,0,1,0,493775,111835,54119,53837,1.0359313053466226,0.3249613694528949
23657,0.6004761904761905,0,1,0,493776,111834,54119,53837,1.0359220423135351,0.32496333093902974
23658,0.6004999999999999,4,13,4,493789,111821,54123,53833,1.0358016228833968,0.32497253311118357
23659,0.6005,0,3,0,493792,111818,54123,53833,1.0357738337841342,0.3249784184822307
23660,0.6005000000000001,0,1,0,493793,111817,54123,53833,1.0357645707510468,0.3249803803199517
23661,0.6005128205128206,0,1,0,493794,111816,54123,53833,1.035755307717959,0.3249823421813594
23662,0.6005238095238095,0,1,0,493795,111815,54123,53833,1.0357460446848716,0.3249843040664542
23663,0.6005238095238096,0,1,0,493796,111814,54123,53833,1.035736781651784,0.3249862659752365
23664,0.6005476190476191,0,1,0,493797,111813,54123,53833,1.0357275186186965,0.3249882279077068
23665,0.600611111111111,0,1,0,493798,111812,54123,53833,1.035718255585609,0.3249901898638655
23666,0.6006190476190476,0,3,0,493801,111809,54123,53833,1.0356904664863462,0.32499607587447626
23667,0.6006507936507937,1,2,1,493803,111807,54124,53832,1.035671940420171,0.32499592487276546
23668,0.6006666666666667,10,33,10,493836,111774,54134,53822,1.0353662603282818,0.32501992801758495
23669,0.6006912531912529,1,1,1,493837,111773,54135,53821,1.0353569972951944,0.32501781465512036
23670,0.6007023809523809,2,4,2,493841,111769,54137,53819,1.035319945162844,0.32501751334637774
23671,0.6007142857142856,3,10,3,493851,111759,54140,53816,1.0352273148319686,0.32502491318133775
23672,0.6007142857142858,0,1,0,493852,111758,54140,53816,1.035218051798881,0.32502687620036963
23673,0.6007222222222223,0,1,0,493853,111757,54140,53816,1.0352087887657935,0.3250288392431133
23674,0.60075,0,1,0,493854,111756,54140,53816,1.035199525732706,0.32503080230956927
23675,0.6007500000000001,1,2,1,493856,111754,54141,53815,1.0351809996665309,0.32503065187323715
23676,0.6008095238095239,0,1,0,493857,111753,54141,53815,1.0351717366334432,0.32503261499806724
23677,0.600813492063492,1,1,1,493858,111752,54142,53814,1.0351624736003557,0.32503050143145334
23678,0.6008333333333333,13,74,13,493932,111678,54155,53801,1.0344770091518767,0.3251228252527511
23679,0.6008333333333334,0,1,0,493933,111677,54155,53801,1.0344677461187892,0.3251247900022964
23680,0.6008412698412698,0,1,0,493934,111676,54155,53801,1.0344584830857015,0.32512675477558817
23681,0.6008809523809524,0,1,0,493935,111675,54155,53801,1.034449220052614,0.32512871957262685
23682,0.6008888888888889,0,2,0,493937,111673,54155,53801,1.034430693986439,0.32513264923794677
23683,0.6009047619047618,0,1,0,493938,111672,54155,53801,1.0344214309533513,0.3251346141062288
23684,0.6009166666666668,0,1,0,493939,111671,54155,53801,1.0344121679202638,0.32513657899825954
23685,0.6009444444444444,0,1,0,493940,111670,54155,53801,1.0344029048871763,0.3251385439140393
23686,0.6009523809523809,0,2,0,493942,111668,54155,53801,1.0343843788210012,0.32514247381684785
23687,0.600952380952381,1,0,1,493942,111668,54156,53800,1.0343843788210012,0.32513839533928013
23688,0.601,19,59,19,494001,111609,54175,53781,1.0338378598688354,0.32517685470705604
23689,0.6010000000000001,0,2,0,494003,111607,54175,53781,1.0338193338026604,0.32518078699784747
23690,0.6010238095238095,0,1,0,494004,111606,54175,53781,1.0338100707695728,0.32518275317890766
23691,0.6010555555555556,1,1,1,494005,111605,54176,53780,1.0338008077364853,0.3251806391147928
23692,0.6010609668109669,1,1,1,494006,111604,54177,53779,1.0337915447033976,0.3251785249995465
23693,0.6010714285714286,0,1,0,494007,111603,54177,53779,1.0337822816703102,0.3251804912263729
23694,0.6010833333333333,0,2,0,494009,111601,54177,53779,1.033763755604135,0.32518442375136053
23695,0.6011111111111112,1,4,1,494013,111597,54178,53778,1.0337267034717847,0.32518820861678005
23696,0.6011190476190476,0,1,0,494014,111596,54178,53778,1.0337174404386973,0.32519017499727887
23697,0.6011428571428571,0,1,0,494015,111595,54178,53778,1.0337081774056096,0.3251921414015589
23698,0.6011666666666666,3,8,3,494023,111587,54181,53775,1.0336340731409093,0.3251956314026197
23699,0.6011666666666667,1,2,1,494025,111585,54182,53774,1.0336155470747341,0.32519548376562507
23700,0.6011904761904762,1,5,1,494030,111580,54183,53773,1.0335692319092964,0.32520123614328134
23701,0.6012222222222222,1,0,1,494030,111580,54184,53772,1.0335692319092964,0.3251971551599013
23702,0.60125,0,3,0,494033,111577,54184,53772,1.0335414428100338,0.3252030553556417
23703,0.6012619047619048,0,1,0,494034,111576,54184,53772,1.0335321797769461,0.3252050221351332
23704,0.6012857142857143,0,1,0,494035,111575,54184,53772,1.0335229167438587,0.3252069889384144
23705,0.6013095238095238,1,2,1,494037,111573,54185,53771,1.0335043906776835,0.3252068414940972
23706,0.6013333333333333,0,19,0,494056,111554,54185,53771,1.03332839304902,0.3252442159383033
23707,0.6013333333333334,0,3,0,494059,111551,54185,53771,1.0333006039497572,0.3252501179516338
23708,0.6013333333333335,0,1,0,494060,111550,54185,53771,1.0332913409166697,0.32525208533701105
23709,0.6014047619047619,0,1,0,494061,111549,54185,53771,1.0332820778835823,0.3252540527461892
23710,0.6014166666666667,3,1,3,494062,111548,54188,53768,1.0332728148504946,0.32524377555711487
23711,0.6014285714285714,1,6,1,494068,111542,54189,53767,1.0332172366519694,0.32525149870847925
23712,0.6014632034632034,1,0,1,494068,111542,54190,53766,1.0332172366519694,0.3252474169429187
23713,0.6014761904761905,0,1,0,494069,111541,54190,53766,1.0332079736188817,0.3252493844785762
23714,0.6014999999999999,1,0,1,494069,111541,54191,53765,1.0332079736188817,0.32524530265084145
23715,0.6015,9,17,9,494086,111524,54200,53756,1.0330505020563934,0.32524201355275895
23716,0.6015079365079365,0,1,0,494087,111523,54200,53756,1.0330412390233057,0.3252439813890452
23717,0.6015238095238096,1,1,1,494088,111522,54201,53755,1.0330319759902182,0.3252418666844146
23718,0.601547619047619,0,3,0,494091,111519,54201,53755,1.0330041868909556,0.3252477703692051
23719,0.6015595238095238,0,1,0,494092,111518,54201,53755,1.032994923857868,0.32524973831176296
23720,0.6015833333333334,0,1,0,494093,111517,54201,53755,1.0329856608247805,0.32525170627813543
23721,0.6015952380952382,0,1,0,494094,111516,54201,53755,1.0329763977916928,0.3252536742683229
23722,0.6016547619047619,1,0,1,494094,111516,54202,53754,1.0329763977916928,0.3252495915774188
23723,0.6016666666666666,0,5,0,494099,111511,54202,53754,1.032930082626255,0.3252594318216198
23724,0.6016666666666667,54,231,54,494330,111280,54256,53700,1.0307903219830301,0.3254939992726391
23725,0.6016666666666668,0,1,0,494331,111279,54256,53700,1.0307810589499427,0.3254959722146455
23726,0.6016904761904762,0,5,0,494336,111274,54256,53700,1.0307347437845047,0.3255058372834507
23727,0.6017142857142858,0,1,0,494337,111273,54256,53700,1.0307254807514172,0.3255078103689695
23728,0.6017380952380953,0,1,0,494338,111272,54256,53700,1.0307162177183298,0.3255097834784085
23729,0.6017460317460316,0,1,0,494339,111271,54256,53700,1.030706954685242,0.3255117566117681
23730,0.6017619047619048,0,1,0,494340,111270,54256,53700,1.0306976916521546,0.3255137297690489
23731,0.6017857142857143,3,5,3,494345,111265,54259,53697,1.030651376486717,0.32551132988203346
23732,0.6018095238095238,1,0,1,494345,111265,54260,53696,1.030651376486717,0.3255072411054734
23733,0.6018253968253967,0,1,0,494346,111264,54260,53696,1.0306421134536292,0.32550921435499514
23734,0.6018333333333333,2,22,2,494368,111242,54262,53694,1.0304383267257031,0.3255444536062473
23735,0.6018571428571428,1,0,1,494368,111242,54263,53693,1.0304383267257031,0.3255403643859702
23736,0.6018571428571429,1,2,1,494370,111240,54264,53692,1.030419800659528,0.32554022263720805
23737,0.6019047619047618,0,2,0,494372,111238,54264,53692,1.0304012745933528,0.3255441702540472
23738,0.6019047619047619,1,1,1,494373,111237,54265,53691,1.0303920115602654,0.32554205471478465
23739,0.6019285714285715,0,1,0,494374,111236,54265,53691,1.0303827485271777,0.3255440285702159
23740,0.6019415584415584,1,2,1,494376,111234,54266,53690,1.0303642224610026,0.32554388688123015
23741,0.601952380952381,1,3,1,494379,111231,54267,53689,1.03033643336174,0.32554571913655106
23742,0.6019999999999999,0,1,0,494380,111230,54267,53689,1.0303271703286525,0.32554769310995096
23743,0.602,13,45,13,494425,111185,54280,53676,1.0299103338397124,0.32558337023310546
23744,0.6020000000000001,0,2,0,494427,111183,54280,53676,1.0298918077735373,0.3255873200735174
23745,0.6020238095238095,0,1,0,494428,111182,54280,53676,1.0298825447404498,0.3255892950296619
23746,0.6020476190476189,0,2,0,494430,111180,54280,53676,1.0298640186742747,0.32559324501383025
23747,0.6020555555555557,0,1,0,494431,111179,54280,53676,1.0298547556411872,0.325595220041855
23748,0.6020833333333333,1,1,1,494432,111178,54281,53675,1.0298454926080995,0.3255931041594633
23749,0.6021190476190477,1,1,1,494433,111177,54282,53674,1.029836229575012,0.3255909882257311
23750,0.6021428571428571,1,0,1,494433,111177,54283,53673,1.029836229575012,0.3255868971792539
23751,0.6021428571428572,1,1,1,494434,111176,54284,53672,1.0298269665419244,0.3255847811317092
23752,0.6021536796536797,1,0,1,494434,111176,54285,53671,1.0298269665419244,0.3255806899731266
23753,0.6021666666666666,1,5,1,494439,111171,54286,53670,1.0297806513764867,0.32558647423881193
23754,0.6021666666666667,0,3,0,494442,111168,54286,53670,1.029752862277224,0.32559239981072324
23755,0.6021825396825397,0,2,0,494444,111166,54286,53670,1.029734336211049,0.3255963503118251
23756,0.6022500000000001,1,0,1,494444,111166,54287,53669,1.029734336211049,0.32559225892559224
23757,0.6022857142857142,1,4,1,494448,111162,54288,53668,1.0296972840786986,0.32559606867681856
23758,0.6022857142857143,0,1,0,494449,111161,54288,53668,1.0296880210456112,0.3255980440335135
23759,0.6023333333333333,1,9,1,494458,111152,54289,53667,1.0296046537478232,0.3256117316571512
23760,0.6023333333333334,4,16,4,494474,111136,54293,53663,1.0294564452184223,0.32562697589184403
23761,0.602345238095238,2,1,2,494475,111135,54295,53661,1.0294471821853348,0.32562076749435664
23762,0.6023571428571429,0,1,0,494476,111134,54295,53661,1.0294379191522471,0.3256227434084772
23763,0.6023809523809524,1,1,1,494477,111133,54296,53660,1.0294286561191597,0.3256206270897429
23764,0.6023809523809525,1,2,1,494479,111131,54297,53659,1.0294101300529845,0.325620486680017
23765,0.602452380952381,0,3,0,494482,111128,54297,53659,1.029382340953722,0.3256264147050435
23766,0.6024761904761905,0,2,0,494484,111126,54297,53659,1.0293638148875468,0.32563036684164215
23767,0.6024999999999999,1,4,1,494488,111122,54298,53658,1.0293267627551965,0.32563417890520696
23768,0.6025,49,195,49,494683,110927,54347,53609,1.0275204713031234,0.32581927359362084
23769,0.6025000000000001,0,4,0,494687,110923,54347,53609,1.0274834191707733,0.32582719470984367
23770,0.6025238095238096,0,1,0,494688,110922,54347,53609,1.0274741561376857,0.3258291750490789
23771,0.6025595238095238,0,1,0,494689,110921,54347,53609,1.0274648931045982,0.3258311554123868
23772,0.6025714285714285,0,1,0,494690,110920,54347,53609,1.0274556300715105,0.3258331357997678
23773,0.6026190476190476,0,2,0,494692,110918,54347,53609,1.0274371040053356,0.325837096646751
23774,0.6026666666666666,0,2,0,494694,110916,54347,53609,1.0274185779391605,0.3258410575900319
23775,0.6026666666666667,9,34,9,494728,110882,54356,53600,1.0271036348141835,0.3258715239357498
23776,0.6026785714285715,1,0,1,494728,110882,54357,53599,1.0271036348141835,0.32586742541691743
23777,0.6026904761904762,0,1,0,494729,110881,54357,53599,1.027094371781096,0.325869406614786
23778,0.6027142857142858,0,1,0,494730,110880,54357,53599,1.0270851087480084,0.32587138783674513
23779,0.6027380952380952,0,1,0,494731,110879,54357,53599,1.027075845714921,0.3258733690827953
23780,0.6027619047619048,0,2,0,494733,110877,54357,53599,1.0270573196487458,0.3258773316471704
23781,0.6027817460317462,1,4,1,494737,110873,54358,53598,1.0270202675163955,0.32588115838050474
23782,0.6027857142857144,0,1,0,494738,110872,54358,53598,1.027011004483308,0.32588313978233113
23783,0.6028095238095238,1,0,1,494738,110872,54359,53597,1.027011004483308,0.3258790410350887
23784,0.6028095238095239,0,1,0,494739,110871,54359,53597,1.0270017414502204,0.3258810224481358
23785,0.6028333333333332,1,0,1,494739,110871,54360,53596,1.0270017414502204,0.32587692363817666
23786,0.6028333333333333,2,10,2,494749,110861,54362,53594,1.026909111119345,0.3258885409382506
23787,0.6028571428571429,4,6,4,494755,110855,54366,53590,1.0268535329208195,0.3258840341755602
23788,0.6028888888888888,1,3,1,494758,110852,54367,53589,1.026825743821557,0.32588588004208197
23789,0.6029047619047619,1,0,1,494758,110852,54368,53588,1.026825743821557,0.32588178058866457
23790,0.6029166666666667,0,2,0,494760,110850,54368,53588,1.0268072177553818,0.32588574417105537
23791,0.6029166666666668,1,1,1,494761,110849,54369,53587,1.0267979547222943,0.3258836264564937
23792,0.602952380952381,1,1,1,494762,110848,54370,53586,1.0267886916892066,0.3258815086904168
23793,0.6029999999999999,0,3,0,494765,110845,54370,53586,1.026760902589944,0.3258874543121431
23794,0.603,7,28,7,494793,110817,54377,53579,1.0265015376634925,0.3259142558213095
23795,0.6030000000000001,0,7,0,494800,110810,54377,53579,1.0264366964318796,0.32592813387757086
23796,0.603047619047619,0,1,0,494801,110809,54377,53579,1.0264274333987922,0.3259301165535197
23797,0.6030595238095238,0,1,0,494802,110808,54377,53579,1.0264181703657045,0.3259320992535906
23798,0.6031120268620269,0,3,0,494805,110805,54377,53579,1.0263903812664419,0.32593804749854
23799,0.6031428571428572,0,2,0,494807,110803,54377,53579,1.0263718552002667,0.32594201311579124
23800,0.6031547619047619,0,1,0,494808,110802,54377,53579,1.0263625921671793,0.3259439959606037
23801,0.6031666666666665,0,2,0,494810,110800,54377,53579,1.0263440661010041,0.3259479617226045
23802,0.6031666666666666,2,9,2,494819,110791,54379,53577,1.0262606988032161,0.32595760732015966
23803,0.6031666666666667,0,5,0,494824,110786,54379,53577,1.0262143836377784,0.3259675231043483
23804,0.6031818181818182,0,1,0,494825,110785,54379,53577,1.0262051206046907,0.32596950633358074
23805,0.603190170940171,0,1,0,494826,110784,54379,53577,1.0261958575716033,0.32597148958694583
23806,0.6031904761904763,0,2,0,494828,110782,54379,53577,1.0261773315054281,0.3259754561660755
23807,0.6031984126984127,0,1,0,494829,110781,54379,53577,1.0261680684723407,0.325977439491841
23808,0.6032006327006326,0,1,0,494830,110780,54379,53577,1.026158805439253,0.32597942284174086
23809,0.6032142857142857,0,2,0,494832,110778,54379,53577,1.0261402793730778,0.3259833896139454
23810,0.6032142857142858,0,2,0,494834,110776,54379,53577,1.026121753306903,0.3259873564826927
23811,0.6032500000000001,0,1,0,494835,110775,54379,53577,1.0261124902738152,0.325989339953271
23812,0.6032575757575757,0,1,0,494836,110774,54379,53577,1.0261032272407278,0.3259913234479863
23813,0.6032619047619047,0,2,0,494838,110772,54379,53577,1.0260847011745526,0.32599529050982967
23814,0.6032619047619048,0,1,0,494839,110771,54379,53577,1.026075438141465,0.32599727407695867
23815,0.6032777777777778,1,0,1,494839,110771,54380,53576,1.026075438141465,0.32599317298155733
23816,0.6032857142857143,0,1,0,494840,110770,54380,53576,1.0260661751083775,0.3259951565599406
23817,0.6033095238095239,0,2,0,494842,110768,54380,53576,1.0260476490422024,0.32599912378912527
23818,0.6033333333333333,43,144,43,494986,110624,54423,53533,1.0247137722775945,0.32610854243194015
23819,0.6033333333333334,69,240,69,495226,110384,54492,53464,1.0224906443365815,0.32630242663932424
23820,0.6034365079365078,1,2,1,495228,110382,54493,53463,1.0224721182704064,0.32630229790350634
23821,0.603436507936508,1,0,1,495228,110382,54494,53462,1.0224721182704064,0.32629818607944144
23822,0.6034523809523809,0,1,0,495229,110381,54494,53462,1.022462855237319,0.32630017760905256
23823,0.603452380952381,0,1,0,495230,110380,54494,53462,1.0224535922042313,0.3263021691629741
23824,0.6034523809523811,1,0,1,495230,110380,54495,53461,1.0224535922042313,0.32629805726283406
23825,0.6034617604617605,0,1,0,495231,110379,54495,53461,1.0224443291711438,0.326300048828125
23826,0.6034999999999999,0,3,0,495234,110376,54495,53461,1.0224165400718812,0.326306023669867
23827,0.6035,4,17,4,495251,110359,54499,53457,1.0222590685093926,0.32632343605020264
23828,0.6035238095238095,0,2,0,495253,110357,54499,53457,1.0222405424432177,0.32632742012282223
23829,0.6035476190476191,1,1,1,495254,110356,54500,53456,1.02223127941013,0.3263252997338412
23830,0.6035555555555555,1,0,1,495254,110356,54501,53455,1.02223127941013,0.3263211872218593
23831,0.6035595238095239,0,1,0,495255,110355,54501,53455,1.0222220163770426,0.32632317929308347
23832,0.6035714285714285,0,1,0,495256,110354,54501,53455,1.022212753343955,0.32632517138862943
23833,0.6035714285714286,1,3,1,495259,110351,54502,53454,1.0221849642446923,0.3263270351942859
23834,0.6035833333333332,0,2,0,495261,110349,54502,53454,1.0221664381785172,0.326331019578396
23835,0.6035952380952381,0,1,0,495262,110348,54502,53454,1.0221571751454297,0.32633301180693763
23836,0.6036111111111111,0,1,0,495263,110347,54502,53454,1.022147912112342,0.32633500405980426
23837,0.6036190476190475,0,1,0,495264,110346,54502,53454,1.0221386490792546,0.3263369963369963
23838,0.6036536796536796,0,1,0,495265,110345,54502,53454,1.0221293860461669,0.3263389886385143
23839,0.6036666666666666,1,3,1,495268,110342,54503,53453,1.0221015969469043,0.3263408528953875
23840,0.6036666666666667,3,13,3,495281,110329,54506,53450,1.021981177516766,0.3263544166223997
23841,0.6036666666666668,0,5,0,495286,110324,54506,53450,1.0219348623513282,0.32636438018244657
23842,0.6037142857142858,0,1,0,495287,110323,54506,53450,1.0219255993182408,0.32636637296746107
23843,0.6037222222222222,0,1,0,495288,110322,54506,53450,1.021916336285153,0.32636836577681166
23844,0.60375,0,1,0,495289,110321,54506,53450,1.0219070732520656,0.3263703586104988
23845,0.6037619047619048,0,1,0,495290,110320,54506,53450,1.0218978102189782,0.32637235146852295
23846,0.6037777777777777,1,1,1,495291,110319,54507,53449,1.0218885471858905,0.32637023105857066
23847,0.6038095238095237,0,1,0,495292,110318,54507,53449,1.021879284152803,0.3263722239523225
23848,0.6038095238095238,1,7,1,495299,110311,54508,53448,1.0218144429211902,0.32638206144395115
23849,0.6038095238095239,0,1,0,495300,110310,54508,53448,1.0218051798881025,0.32638405451947383
23850,0.6038214285714286,0,5,0,495305,110305,54508,53448,1.0217588647226648,0.3263940202622242
23851,0.6038333333333332,1,4,1,495309,110301,54509,53447,1.0217218125903145,0.3263978796687593
23852,0.6038333333333333,1,7,1,495316,110294,54510,53446,1.0216569713587016,0.3264077195553927
23853,0.6038333333333334,0,1,0,495317,110293,54510,53446,1.0216477083256141,0.3264097130188898
23854,0.6038571428571428,1,1,1,495318,110292,54511,53445,1.0216384452925267,0.32640759266384506
23855,0.6038888888888888,2,0,2,495318,110292,54513,53443,1.0216384452925267,0.3263993648273124
23856,0.6039166666666665,0,1,0,495319,110291,54513,53443,1.021629182259439,0.32640135830065836
23857,0.6039166666666668,0,2,0,495321,110289,54513,53443,1.0216106561932639,0.3264053453204016
23858,0.6039285714285714,1,0,1,495321,110289,54514,53442,1.0216106561932639,0.32640123128790516
23859,0.6039285714285715,0,2,0,495323,110287,54514,53442,1.0215921301270887,0.32640521837915093
23860,0.603941391941392,0,2,0,495325,110285,54514,53442,1.0215736040609138,0.32640920556780495
23861,0.6039523809523809,0,4,0,495329,110281,54514,53442,1.0215365519285635,0.3264171802373521
23862,0.6039999999999999,1,3,1,495332,110278,54515,53441,1.021508762829301,0.3264190472700175
23863,0.604,19,54,19,495386,110224,54534,53422,1.0210085590425728,0.32644855358517777
23864,0.6040000000000001,0,4,0,495390,110220,54534,53422,1.0209715069102228,0.3264565331638577
23865,0.6040357142857143,0,2,0,495392,110218,54534,53422,1.0209529808440476,0.3264605230994867
23866,0.6040476190476189,1,2,1,495394,110216,54535,53421,1.0209344547778725,0.3264603970984557
23867,0.604047619047619,0,1,0,495395,110215,54535,53421,1.020925191744785,0.3264623921386492
23868,0.6040714285714286,0,1,0,495396,110214,54535,53421,1.0209159287116973,0.3264643872032267
23869,0.604095238095238,0,3,0,495399,110211,54535,53421,1.0208881396124347,0.32647037254326783
23870,0.6041190476190476,0,1,0,495400,110210,54535,53421,1.020878876579347,0.3264723677053859
23871,0.6041666666666665,1,2,1,495402,110208,54536,53420,1.0208603505131721,0.32647224191458674
23872,0.6041666666666666,15,63,15,495465,110145,54551,53405,1.020276779428656,0.3265362274533782
23873,0.6041666666666667,7,34,7,495499,110111,54558,53398,1.0199618363036793,0.32657529554948045
23874,0.6041904761904763,0,1,0,495500,110110,54558,53398,1.0199525732705916,0.32657729285417225
23875,0.6042380952380952,0,3,0,495503,110107,54558,53398,1.019924784171329,0.3265832849148344
23876,0.60425,0,1,0,495504,110106,54558,53398,1.0199155211382416,0.3265852823172522
23877,0.6042698412698413,1,1,1,495505,110105,54559,53397,1.019906258105154,0.32658316106225
23878,0.6042777777777777,0,2,0,495507,110103,54559,53397,1.0198877320389788,0.32658715596330273
23879,0.6042857142857143,1,6,1,495513,110097,54560,53396,1.0198321538404536,0.3265950224168619
23880,0.6043333333333333,2,7,2,495520,110090,54562,53394,1.0197673126088407,0.3266007682709011
23881,0.6043333333333334,4,16,4,495536,110074,54566,53390,1.0196191040794398,0.32661625801399696
23882,0.6043809523809524,0,1,0,495537,110073,54566,53390,1.0196098410463523,0.32661825611912176
23883,0.6043809523809525,0,1,0,495538,110072,54566,53390,1.0196005780132646,0.3266202542486939
23884,0.6044047619047619,1,1,1,495539,110071,54567,53389,1.0195913149801772,0.32661813287654473
23885,0.6044444444444445,0,2,0,495541,110069,54567,53389,1.019572788914002,0.326622129231974
23886,0.6044523809523811,1,0,1,495541,110069,54568,53388,1.019572788914002,0.3266180096294438
23887,0.6044999999999999,1,5,1,495546,110064,54569,53387,1.0195264737485643,0.32662388116316204
23888,0.6045,2,11,2,495557,110053,54571,53385,1.0194245803846012,0.32663762405315777
23889,0.6045238095238095,0,2,0,495559,110051,54571,53385,1.019406054318426,0.326641621185051
23890,0.6045454545454545,0,1,0,495560,110050,54571,53385,1.0193967912853386,0.3266436197876832
23891,0.604547619047619,1,0,1,495560,110050,54572,53384,1.0193967912853386,0.3266394997368969
23892,0.6045833333333333,0,1,0,495561,110049,54572,53384,1.0193875282522509,0.3266414983510062
23893,0.6045833333333334,1,1,1,495562,110048,54573,53383,1.0193782652191634,0.32663937686240674
23894,0.6046190476190476,0,4,0,495566,110044,54573,53383,1.0193412130868131,0.3266473716093424
23895,0.604642857142857,0,1,0,495567,110043,54573,53383,1.0193319500537257,0.3266493703572259
23896,0.6046428571428571,0,1,0,495568,110042,54573,53383,1.019322687020638,0.32665136912957016
23897,0.6046493506493507,0,1,0,495569,110041,54573,53383,1.0193134239875505,0.32665336792637556
23898,0.6046666666666666,3,7,3,495576,110034,54576,53380,1.0192485827559377,0.32665499895969746
23899,0.6046666666666667,6,5,6,495581,110029,54582,53374,1.0192022675905,0.32664026976248905
23900,0.6046666666666668,0,2,0,495583,110027,54582,53374,1.0191837415243248,0.3266442677829389
23901,0.6046942224442227,0,3,0,495586,110024,54582,53374,1.019155952425062,0.3266502649971236
23902,0.6047142857142856,0,1,0,495587,110023,54582,53374,1.0191466893919745,0.32665226411745624
23903,0.6047142857142858,2,0,2,495587,110023,54584,53372,1.0191466893919745,0.3266440221549007
23904,0.6047294372294373,0,1,0,495588,110022,54584,53372,1.019137426358887,0.326646021273731
23905,0.6047619047619047,0,2,0,495590,110020,54584,53372,1.019118900292712,0.3266500195848022
23906,0.6047972582972584,0,1,0,495591,110019,54584,53372,1.0191096372596242,0.32665201877704403
23907,0.6048333333333332,0,4,0,495595,110015,54584,53372,1.0190725851272742,0.32666001579073
23908,0.6048333333333333,1,10,1,495605,110005,54585,53371,1.0189799547963985,0.32667588874742925
23909,0.6048809523809523,0,2,0,495607,110003,54585,53371,1.0189614287302233,0.32667988786465413
23910,0.6048809523809524,0,1,0,495608,110002,54585,53371,1.0189521656971359,0.3266818874599842
23911,0.604904761904762,0,2,0,495610,110000,54585,53371,1.0189336396309607,0.326685886724082
23912,0.6049834054834055,3,2,3,495612,109998,54588,53368,1.0189151135647856,0.3266775216385294
23913,0.6049880952380953,0,1,0,495613,109997,54588,53368,1.0189058505316981,0.3266795213172956
23914,0.6049999999999999,0,1,0,495614,109996,54588,53368,1.0188965874986105,0.3266815210205431
23915,0.605,205,745,205,496359,109251,54793,53163,1.0119956278483826,0.3273301562673169
23916,0.6050000000000001,6,15,6,496374,109236,54799,53157,1.0118566823520694,0.32733553786185365
23917,0.605111111111111,0,1,0,496375,109235,54799,53157,1.0118474193189817,0.3273375535740677
23918,0.6051111111111112,0,1,0,496376,109234,54799,53157,1.0118381562858942,0.32733956931110714
23919,0.6051190476190476,0,1,0,496377,109233,54799,53157,1.0118288932528068,0.32734158507297245
23920,0.6051190476190477,0,1,0,496378,109232,54799,53157,1.011819630219719,0.32734360085966413
23921,0.6051428571428571,1,0,1,496378,109232,54800,53156,1.011819630219719,0.3273394585806833
23922,0.6051666666666666,2,9,2,496387,109223,54802,53154,1.011736262921931,0.327349316713574
23923,0.6051666666666667,1,4,1,496391,109219,54803,53153,1.011699210789581,0.32735323824304685
23924,0.6051904761904762,0,2,0,496393,109217,54803,53153,1.0116806847234059,0.32735727043173
23925,0.6052619047619048,0,2,0,496395,109215,54803,53153,1.0116621586572307,0.3273613027197477
23926,0.6052857142857143,0,1,0,496396,109214,54803,53153,1.011652895624143,0.3273633189010082
23927,0.6053333333333333,5,11,5,496407,109203,54808,53148,1.0115510022601801,0.32736478370937044
23928,0.6053333333333334,1,10,1,496417,109193,54809,53147,1.0114583719293044,0.32738080571639766
23929,0.6053333333333335,0,1,0,496418,109192,54809,53147,1.011449108896217,0.3273828223655437
23930,0.6053968253968254,0,3,0,496421,109189,54809,53147,1.0114213197969544,0.327388872462054
23931,0.605404761904762,1,0,1,496421,109189,54810,53146,1.0114213197969544,0.3273847291095574
23932,0.6054166666666666,0,2,0,496423,109187,54810,53146,1.0114027937307792,0.327388762605262
23933,0.6054761904761904,2,3,2,496426,109184,54812,53144,1.0113750046315166,0.32738652604603025
23934,0.6054761904761905,0,1,0,496427,109183,54812,53144,1.011365741598429,0.3273885428794963
23935,0.6054999999999999,1,18,1,496445,109165,54813,53143,1.011199007002853,0.32742070631145725
23936,0.6055,0,1,0,496446,109164,54813,53143,1.0111897439697655,0.32742272360403435
23937,0.6055000000000001,0,1,0,496447,109163,54813,53143,1.011180480936678,0.32742474092146934
23938,0.6055119047619048,0,1,0,496448,109162,54813,53143,1.0111712179035903,0.32742675826376266
23939,0.6055476190476191,1,3,1,496451,109159,54814,53142,1.0111434288043277,0.3274286664900401
23940,0.6055555555555555,0,1,0,496452,109158,54814,53142,1.01113416577124,0.32743068391866914
23941,0.6055555555555556,0,2,0,496454,109156,54814,53142,1.0111156397050651,0.32743471885050957
23942,0.6056190476190477,0,2,0,496456,109154,54814,53142,1.01109711363889,0.3274387538817962
23943,0.605654761904762,0,2,0,496458,109152,54814,53142,1.0110785875727148,0.3274427890125328
23944,0.6056666666666666,6,21,6,496479,109131,54820,53136,1.0108840638778762,0.32746029691804246
23945,0.6056666666666667,4,9,4,496488,109122,54824,53132,1.0108006965800882,0.3274618807548658
23946,0.6056904761904762,2,0,2,496488,109122,54826,53130,1.0108006965800882,0.32745359071074626
23947,0.6057142857142856,4,4,4,496492,109118,54830,53126,1.010763644447738,0.3274450827149232
23948,0.6057301587301587,0,3,0,496495,109115,54830,53126,1.0107358553484753,0.3274511375053162
23949,0.6057380952380952,0,1,0,496496,109114,54830,53126,1.0107265923153876,0.32745315581854045
23950,0.60575,0,2,0,496498,109112,54830,53126,1.0107080662492127,0.3274571925196317
23951,0.6057738095238097,0,1,0,496499,109111,54830,53126,1.010698803216125,0.3274592109074995
23952,0.6057857142857143,0,2,0,496501,109109,54830,53126,1.01068027714995,0.3274632477578821
23953,0.6057857142857144,0,1,0,496502,109108,54830,53126,1.0106710141168624,0.3274652662203977
23954,0.605797619047619,0,1,0,496503,109107,54830,53126,1.0106617510837748,0.3274672847077968
23955,0.6058333333333333,23,90,23,496593,109017,54853,53103,1.009828078105895,0.3275536639526277
23956,0.6058333333333334,0,3,0,496596,109014,54853,53103,1.0098002890066324,0.3275597253835193
23957,0.6058412698412698,0,1,0,496597,109013,54853,53103,1.0097910259735448,0.3275617459103358
23958,0.6058571428571428,0,1,0,496598,109012,54853,53103,1.0097817629404573,0.3275637664620794
23959,0.6058571428571429,0,1,0,496599,109011,54853,53103,1.0097724999073696,0.3275657870387505
23960,0.6058888888888888,1,0,1,496599,109011,54854,53102,1.0097724999073696,0.32756163910358826
23961,0.6059047619047618,0,1,0,496600,109010,54854,53102,1.0097632368742822,0.32756365969206475
23962,0.6059523809523809,0,2,0,496602,109008,54854,53102,1.009744710808107,0.3275677009438036
23963,0.605952380952381,1,1,1,496603,109007,54855,53101,1.0097354477750196,0.32756557356823846
23964,0.606,19,91,19,496694,108916,54874,53082,1.008892511764052,0.3276707119840986
23965,0.6060000000000001,0,4,0,496698,108912,54874,53082,1.0088554596317019,0.3276788029186266
23966,0.6060238095238095,0,1,0,496699,108911,54874,53082,1.0088461965986142,0.32768082571469137
23967,0.606047619047619,0,1,0,496700,108910,54874,53082,1.0088369335655267,0.32768284853573015
23968,0.6060555555555556,0,1,0,496701,108909,54874,53082,1.008827670532439,0.3276848713817434
23969,0.6060714285714285,0,1,0,496702,108908,54874,53082,1.0088184074993516,0.3276868942527317
23970,0.6060714285714286,0,2,0,496704,108906,54874,53082,1.0087998814331764,0.3276909400696348
23971,0.6060714285714287,1,2,1,496706,108904,54875,53081,1.0087813553670013,0.3276908355711949
23972,0.6060833333333333,0,1,0,496707,108903,54875,53081,1.0087720923339139,0.32769285855393127
23973,0.6061111111111112,1,0,1,496707,108903,54876,53080,1.0087720923339139,0.3276887080743041
23974,0.6061428571428571,1,1,1,496708,108902,54877,53079,1.0087628293008262,0.32768658052487637
23975,0.6061507936507937,1,2,1,496710,108900,54878,53078,1.0087443032346513,0.3276864759411772
23976,0.6061666666666666,1,11,1,496721,108889,54879,53077,1.008642409870688,0.3277045799735747
23977,0.6061666666666667,0,2,0,496723,108887,54879,53077,1.008623883804513,0.3277086266083821
23978,0.6061666666666669,1,1,1,496724,108886,54880,53076,1.0086146207714255,0.32770649905533394
23979,0.6061785714285715,0,2,0,496726,108884,54880,53076,1.0085960947052504,0.3277105458137812
23980,0.6061904761904762,1,1,1,496727,108883,54881,53075,1.0085868316721627,0.3277084182318873
23981,0.6062142857142857,0,2,0,496729,108881,54881,53075,1.0085683056059875,0.32771246511398155
23982,0.6062142857142858,0,2,0,496731,108879,54881,53075,1.0085497795398126,0.32771651209602726
23983,0.6062380952380952,0,1,0,496732,108878,54881,53075,1.008540516506725,0.32771853562453307
23984,0.60625,1,4,1,496736,108874,54882,53074,1.0085034643743747,0.3277224788203621
23985,0.6062619047619048,0,1,0,496737,108873,54882,53074,1.0084942013412872,0.3277245024606816
23986,0.6062777777777777,0,1,0,496738,108872,54882,53074,1.0084849383081997,0.3277265261259926
23987,0.6062857142857143,1,2,1,496740,108870,54883,53073,1.0084664122420246,0.32772642225968396
23988,0.6063095238095237,0,1,0,496741,108869,54883,53073,1.008457149208937,0.3277284459868348
23989,0.6063095238095239,0,1,0,496742,108868,54883,53073,1.0084478861758495,0.327730469738979
23990,0.6063333333333333,6,15,6,496757,108853,54889,53067,1.008308940679536,0.327735918972332
23991,0.6064285714285714,1,4,1,496761,108849,54890,53066,1.008271888547186,0.32773986350863105
23992,0.606452380952381,0,1,0,496762,108848,54890,53066,1.0082626255140983,0.32774188766876244
23993,0.6064761904761905,0,1,0,496763,108847,54890,53066,1.0082533624810108,0.32774391185389684
23994,0.6064999999999999,1,2,1,496765,108845,54891,53065,1.0082348364148357,0.32774380828855537
23995,0.6065,6,10,6,496775,108835,54897,53059,1.0081422060839602,0.327739137954464
23996,0.606547619047619,1,1,1,496776,108834,54898,53058,1.0081329430508725,0.32773700985842413
23997,0.6065714285714285,0,1,0,496777,108833,54898,53058,1.008123680017785,0.32773903428850276
23998,0.6065901043401044,0,1,0,496778,108832,54898,53058,1.0081144169846974,0.32774105874359133
23999,0.6065952380952381,1,1,1,496779,108831,54899,53057,1.00810515395161,0.32773893061869935
24000,0.6066190476190476,0,1,0,496780,108830,54899,53057,1.0080958909185223,0.3277409551106636
24001,0.606642857142857,0,1,0,496781,108829,54899,53057,1.0080866278854348,0.3277429796276392
24002,0.6066666666666666,1,1,1,496782,108828,54900,53056,1.0080773648523473,0.32774085147389487
24003,0.6066666666666667,92,389,92,497171,108439,54992,52964,1.0044740449812888,0.32814755611729646
24004,0.6066904761904762,0,1,0,497172,108438,54992,52964,1.004464781948201,0.328149589224421
24005,0.606702380952381,1,2,1,497174,108436,54993,52963,1.004446255882026,0.32814949287170303
24006,0.6067222222222222,0,1,0,497175,108435,54993,52963,1.0044369928489385,0.3281515260412149
24007,0.6067380952380952,1,0,1,497175,108435,54994,52962,1.0044369928489385,0.32814736333389094
24008,0.6067619047619048,0,1,0,497176,108434,54994,52962,1.0044277298158508,0.3281493965154031
24009,0.6067857142857143,2,4,2,497180,108430,54996,52960,1.0043906776835008,0.32814920379205653
24010,0.6068333333333332,0,1,0,497181,108429,54996,52960,1.004381414650413,0.32815123707315863
24011,0.6068333333333333,2,14,2,497195,108415,54998,52958,1.0042517321871873,0.3281713793509447
24012,0.6068373015873016,1,1,1,497196,108414,54999,52957,1.0042424691540999,0.3281692497412794
24013,0.6068571428571429,1,1,1,497197,108413,55000,52956,1.0042332061210122,0.32816712007882554
24014,0.606857142857143,0,1,0,497198,108412,55000,52956,1.0042239430879247,0.32816915373556094
24015,0.6068690476190476,0,1,0,497199,108411,55000,52956,1.004214680054837,0.32817118741750173
24016,0.6068809523809524,0,2,0,497201,108409,55000,52956,1.0041961539886621,0.3281752548570012
24017,0.606904761904762,0,2,0,497203,108407,55000,52956,1.004177627922487,0.3281793223973278
24018,0.6069166666666667,0,1,0,497204,108406,55000,52956,1.0041683648893993,0.32818135620530237
24019,0.6069343434343435,1,1,1,497205,108405,55001,52955,1.0041591018563119,0.32817922657411996
24020,0.6069761904761904,1,0,1,497205,108405,55002,52954,1.0041591018563119,0.32817506305814986
24021,0.6069880952380953,1,0,1,497205,108405,55003,52953,1.0041591018563119,0.32817089949057376
24022,0.6069999999999999,0,1,0,497206,108404,55003,52953,1.0041498388232242,0.3281729333093699
24023,0.607,4,29,4,497235,108375,55007,52949,1.0038812108636852,0.3282152686519055
24024,0.6070000000000001,0,1,0,497236,108374,55007,52949,1.0038719478305977,0.32821730317437686
24025,0.6070238095238095,0,6,0,497242,108368,55007,52949,1.0038163696320723,0.3282295108389072
24026,0.6070476190476191,0,3,0,497245,108365,55007,52949,1.0037885805328097,0.3282356150117163
24027,0.6070584415584416,0,1,0,497246,108364,55007,52949,1.003779317499722,0.32823764978644004
24028,0.6070833333333333,0,1,0,497247,108363,55007,52949,1.0037700544666346,0.3282396845863916
24029,0.6071428571428571,0,1,0,497248,108362,55007,52949,1.003760791433547,0.32824171941157143
24030,0.6071428571428572,1,10,1,497258,108352,55008,52948,1.0036681611026714,0.32825790452572845
24031,0.6071666666666666,2,11,2,497269,108341,55010,52946,1.0035662677387083,0.3282719624024255
24032,0.6071666666666667,1,4,1,497273,108337,55011,52945,1.0035292156063582,0.32827593903845437
24033,0.6071785714285715,1,0,1,497273,108337,55012,52944,1.0035292156063582,0.32827177410854347
24034,0.6072142857142857,0,1,0,497274,108336,55012,52944,1.0035199525732705,0.3282738095238095
24035,0.6072222222222222,1,0,1,497274,108336,55013,52943,1.0035199525732705,0.32826964452904595
24036,0.6072380952380952,0,1,0,497275,108335,55013,52943,1.003510689540183,0.32827167995634865
24037,0.6072619047619046,1,3,1,497278,108332,55014,52942,1.0034829004409205,0.3282736212904746
24038,0.6072619047619048,1,4,1,497282,108328,55015,52941,1.0034458483085702,0.32827759829849507
24039,0.6073333333333333,2,5,2,497287,108323,55017,52939,1.0033995331431325,0.3282794458706949
24040,0.6073333333333334,5,24,5,497311,108299,55022,52934,1.003177220349031,0.32830748047856206
24041,0.6073333333333335,1,0,1,497311,108299,55023,52933,1.003177220349031,0.3283033144785154
24042,0.6073452380952381,0,2,0,497313,108297,55023,52933,1.003158694282856,0.32830738696272405
24043,0.6073492063492064,1,1,1,497314,108296,55024,52932,1.0031494312497684,0.3283052571513633
24044,0.6073809523809524,1,4,1,497318,108292,55025,52931,1.0031123791174181,0.3283092362752213
24045,0.6074155844155844,1,0,1,497318,108292,55026,52930,1.0031123791174181,0.32830507002766374
24046,0.6074166666666667,0,1,0,497319,108291,55026,52930,1.0031031160843307,0.3283071063943283
24047,0.6074242424242424,0,1,0,497320,108290,55026,52930,1.003093853051243,0.3283091427862548
24048,0.6074880952380951,1,0,1,497320,108290,55027,52929,1.003093853051243,0.32830497646059087
24049,0.6074999999999999,2,7,2,497327,108283,55029,52927,1.0030290118196301,0.32831089882761616
24050,0.6075,66,205,66,497532,108078,55095,52861,1.0011300900366815,0.3284536377136679
24051,0.6075000000000002,1,0,1,497532,108078,55096,52860,1.0011300900366815,0.32844946501137084
24052,0.6075833333333336,0,1,0,497533,108077,55096,52860,1.001120827003594,0.3284515058687561
24053,0.6076071428571429,1,1,1,497534,108076,55097,52859,1.0011115639705066,0.3284493739708578
24054,0.6076190476190476,1,2,1,497536,108074,55098,52858,1.0010930379043315,0.3284492829269505
24055,0.6076666666666666,0,3,0,497539,108071,55098,52858,1.0010652488050686,0.3284554058000733
24056,0.6076666666666667,8,22,8,497561,108049,55106,52850,1.0008614620771425,0.3284669264569699
24057,0.6077380952380952,0,2,0,497563,108047,55106,52850,1.0008429360109674,0.32847100940353147
24058,0.6077499999999999,0,1,0,497564,108046,55106,52850,1.00083367297788,0.32847305091487666
24059,0.607754884004884,0,1,0,497565,108045,55106,52850,1.0008244099447923,0.3284750924515989
24060,0.6077777777777778,0,3,0,497568,108042,55106,52850,1.0007966208455297,0.3284812172140318
24061,0.6078174603174603,0,1,0,497569,108041,55106,52850,1.0007873578124422,0.3284832588522664
24062,0.6078333333333332,1,2,1,497571,108039,55107,52849,1.000768831746267,0.3284831684152951
24063,0.6078333333333333,1,13,1,497584,108026,55108,52848,1.0006484123161288,0.3285055384959658
24064,0.6078506771006772,0,1,0,497585,108025,55108,52848,1.0006391492830413,0.32850758051382145
24065,0.6078571428571429,0,3,0,497588,108022,55108,52848,1.0006113601837785,0.3285137067197116
24066,0.6078809523809523,0,1,0,497589,108021,55108,52848,1.000602097150691,0.32851574883911755
24067,0.6079166666666667,1,6,1,497595,108015,55109,52847,1.0005465189521656,0.328523827877311
24068,0.6079523809523809,1,1,1,497596,108014,55110,52846,1.0005372559190782,0.32852169588462016
24069,0.607952380952381,1,0,1,497596,108014,55111,52845,1.0005372559190782,0.32851752155614544
24070,0.6079761904761903,1,0,1,497596,108014,55112,52844,1.0005372559190782,0.3285133471757699
24071,0.6079761904761904,1,2,1,497598,108012,55113,52843,1.000518729852903,0.3285132572814025
24072,0.6079999999999999,1,1,1,497599,108011,55114,52842,1.0005094668198156,0.32851112506449986
24073,0.608,16,43,16,497642,107968,55130,52826,1.0001111563970506,0.32853215916016765
24074,0.6080000000000001,1,8,1,497650,107960,55131,52825,1.0000370521323503,0.32854432938395994
24075,0.6080000000000002,0,4,0,497654,107956,55131,52825,1.0,0.3285525030942711
24076,0.6080238095238095,0,1,0,497655,107955,55131,52825,0.9999907369669124,0.3285545465853962
24077,0.6080476190476192,0,1,0,497656,107954,55131,52825,0.9999814739338249,0.32855659010194116
24078,0.608079365079365,0,1,0,497657,107953,55131,52825,0.9999722109007373,0.32855863364390653
24079,0.6080833333333333,0,1,0,497658,107952,55131,52825,0.9999629478676498,0.3285606772112927
24080,0.6081190476190477,1,0,1,497658,107952,55132,52824,0.9999629478676498,0.3285565009702941
24081,0.6081388888888888,0,1,0,497659,107951,55132,52824,0.9999536848345623,0.32855854454983674
24082,0.6081428571428572,0,1,0,497660,107950,55132,52824,0.9999444218014747,0.32856058815480116
24083,0.6081666666666666,2,6,2,497666,107944,55134,52822,0.9998888436029494,0.3285644974683702
24084,0.6081666666666667,0,8,0,497674,107936,55134,52822,0.9998147393382489,0.32858084823150324
24085,0.6081904761904762,0,2,0,497676,107934,55134,52822,0.9997962132720738,0.3285849361765657
24086,0.6082142857142857,1,2,1,497678,107932,55135,52821,0.9997776872058987,0.32858484756116524
24087,0.6082380952380951,1,0,1,497678,107932,55136,52820,0.9997776872058987,0.32858067084701903
24088,0.6082857142857143,0,1,0,497679,107931,55136,52820,0.9997684241728112,0.3285827148820225
24089,0.6083333333333333,13,98,13,497777,107833,55149,52807,0.9988606469302308,0.3287288346613546
24090,0.6083333333333334,29,128,29,497905,107705,55178,52778,0.9976749786950239,0.32886972451910795
24091,0.6083809523809524,0,2,0,497907,107703,55178,52778,0.9976564526288488,0.3288738230693976
24092,0.6083888888888889,1,0,1,497907,107703,55179,52777,0.9976564526288488,0.3288696410767697
24093,0.6084166666666666,0,1,0,497908,107702,55179,52777,0.9976471895957613,0.32887169037693403
24094,0.6084365079365079,0,4,0,497912,107698,55179,52777,0.997610137463411,0.3288798878329958
24095,0.6084444444444443,1,0,1,497912,107698,55180,52776,0.997610137463411,0.3288757057217992
24096,0.6084999999999999,0,1,0,497913,107697,55180,52776,0.9976008744303234,0.32887775513637807
24097,0.6085,3,26,3,497939,107671,55183,52773,0.997360035570047,0.328918501159283
24098,0.6085238095238096,0,1,0,497940,107670,55183,52773,0.9973507725369595,0.3289205512237991
24099,0.6085714285714285,0,2,0,497942,107668,55183,52773,0.9973322464707844,0.32892465142949745
24100,0.6085714285714287,1,2,1,497944,107666,55184,52772,0.9973137204046093,0.32892456899238337
24101,0.6085952380952381,1,1,1,497945,107665,55185,52771,0.9973044573715217,0.3289224363609165
24102,0.6086464646464647,0,1,0,497946,107664,55185,52771,0.9972951943384342,0.32892448655218626
24103,0.6086666666666666,0,5,0,497951,107659,55185,52771,0.9972488791729964,0.32893473789191546
24104,0.6086666666666667,3,19,3,497970,107640,55188,52768,0.9970728815443328,0.32896114906987184
24105,0.6087272727272728,0,1,0,497971,107639,55188,52768,0.9970636185112454,0.3289631998603552
24106,0.60875,1,5,1,497976,107634,55189,52767,0.9970173033458075,0.32896927076514487
24107,0.6087500000000001,0,5,0,497981,107629,55189,52767,0.9969709881803698,0.32897952567395694
24108,0.6088095238095238,0,1,0,497982,107628,55189,52767,0.9969617251472822,0.32898157673244177
24109,0.6088095238095239,0,1,0,497983,107627,55189,52767,0.9969524621141946,0.32898362781650187
24110,0.6088145743145743,0,3,0,497986,107624,55189,52767,0.996924673014932,0.3289897812221384
24111,0.6088333333333333,1,9,1,497995,107615,55190,52766,0.996841305717144,0.3290040590843055
24112,0.6088333333333334,1,3,1,497998,107612,55191,52765,0.9968135166178813,0.32900602954288954
24113,0.608857142857143,2,1,2,497999,107611,55193,52763,0.9968042535847939,0.32899971317046406
24114,0.6088809523809523,0,2,0,498001,107609,55193,52763,0.9967857275186187,0.32900381612750357
24115,0.6088888888888888,1,1,1,498002,107608,55194,52762,0.9967764644855311,0.3290016836066596
24116,0.6088888888888889,1,0,1,498002,107608,55195,52761,0.9967764644855311,0.3289974995167395
24117,0.608904761904762,0,2,0,498004,107606,55195,52761,0.996757938419356,0.32900160257409566
24118,0.6089166666666667,0,1,0,498005,107605,55195,52761,0.9967486753862684,0.3290036541411521
24119,0.6089285714285714,0,1,0,498006,107604,55195,52761,0.996739412353181,0.3290057057337948
24120,0.6089285714285715,0,2,0,498008,107602,55195,52761,0.9967208862870058,0.3290098089958407
24121,0.6089393939393939,0,1,0,498009,107601,55195,52761,0.9967116232539183,0.3290118606652449
24122,0.6089444444444446,0,1,0,498010,107600,55195,52761,0.9967023602208307,0.3290139123602372
24123,0.608952380952381,0,4,0,498014,107596,55195,52761,0.9966653080884805,0.32902211939609743
24124,0.6089682539682539,0,1,0,498015,107595,55195,52761,0.996656045055393,0.32902417121903765
24125,0.6089920634920635,1,0,1,498015,107595,55196,52760,0.996656045055393,0.32901998690405665
24126,0.6089999999999999,3,4,3,498019,107591,55199,52757,0.9966189929230427,0.3290156409808666
24127,0.609,7,37,7,498056,107554,55206,52750,0.9962762606988033,0.3290622816648368
24128,0.6090000000000001,1,3,1,498059,107551,55207,52749,0.9962484715995406,0.32906425452276983
24129,0.609031746031746,0,1,0,498060,107550,55207,52749,0.996239208566453,0.32906630733816183
24130,0.6090476190476191,1,1,1,498061,107549,55208,52748,0.9962299455333654,0.32906417462585075
24131,0.6090714285714285,1,0,1,498061,107549,55209,52747,0.9962299455333654,0.3290599890203124
24132,0.6090714285714286,0,2,0,498063,107547,55209,52747,0.9962114194671904,0.32906409472594106
24133,0.6091111111111109,0,1,0,498064,107546,55209,52747,0.9962021564341028,0.32906614761717606
24134,0.609111111111111,0,1,0,498065,107545,55209,52747,0.9961928934010152,0.3290682005340254
24135,0.6091190476190476,0,1,0,498066,107544,55209,52747,0.9961836303679277,0.32907025347648966
24136,0.6091666666666665,0,2,0,498068,107542,55209,52747,0.9961651043017525,0.32907435943826463
24137,0.6091666666666666,10,62,10,498130,107480,55219,52737,0.9955907962503242,0.32915982698465207
24138,0.6091666666666667,6,20,6,498150,107460,55225,52731,0.9954055355885731,0.3291757963930558
24139,0.6091904761904764,0,2,0,498152,107458,55225,52731,0.995387009522398,0.329179906235759
24140,0.6091944444444445,0,2,0,498154,107456,55225,52731,0.9953684834562229,0.32918401618108833
24141,0.6092857142857142,0,3,0,498157,107453,55225,52731,0.9953406943569603,0.3291901812915148
24142,0.6092857142857143,2,2,2,498159,107451,55227,52729,0.9953221682907851,0.3291859158446747
24143,0.6093095238095239,0,3,0,498162,107448,55227,52729,0.9952943791915225,0.329192081260106
24144,0.6093333333333333,2,19,2,498181,107429,55229,52727,0.9951183815628589,0.32922275781113414
24145,0.6093333333333334,3,18,3,498199,107411,55232,52724,0.994951646967283,0.3292471976769601
24146,0.6093474025974025,0,1,0,498200,107410,55232,52724,0.9949423839341954,0.32924925374998437
24147,0.6093571428571427,0,1,0,498201,107409,55232,52724,0.9949331209011079,0.3292513098486883
24148,0.6093571428571428,0,1,0,498202,107408,55232,52724,0.9949238578680203,0.3292533659730722
24149,0.6093809523809525,0,1,0,498203,107407,55232,52724,0.9949145948349327,0.3292554221231367
24150,0.6094007936507936,0,2,0,498205,107405,55232,52724,0.9948960687687577,0.32925953450030915
24151,0.609404761904762,1,0,1,498205,107405,55233,52723,0.9948960687687577,0.32925534572342124
24152,0.6094166666666666,0,1,0,498206,107404,55233,52723,0.9948868057356701,0.3292574019372123
24153,0.6094444444444445,2,0,2,498206,107404,55235,52721,0.9948868057356701,0.32924902419984386
24154,0.6094523809523809,0,1,0,498207,107403,55235,52721,0.9948775427025826,0.3292510804126802
24155,0.6094999999999999,0,1,0,498208,107402,55235,52721,0.994868279669495,0.3292531366511994
24156,0.6095,2,10,2,498218,107392,55237,52719,0.9947756493386194,0.32926532218273574
24157,0.6095000000000002,0,2,0,498220,107390,55237,52719,0.9947571232724444,0.32926943519727186
24158,0.6095238095238095,2,0,2,498220,107390,55239,52717,0.9947571232724444,0.32926105666835304
24159,0.6095454545454546,0,1,0,498221,107389,55239,52717,0.9947478602393568,0.3292631131875133
24160,0.609570512820513,2,1,2,498222,107388,55241,52715,0.9947385972062692,0.3292567909408318
24161,0.6095746753246754,0,1,0,498223,107387,55241,52715,0.9947293341731817,0.3292588474847285
24162,0.6095833333333333,1,2,1,498225,107385,55242,52714,0.9947108081070065,0.32925877113536
24163,0.6096309523809524,0,1,0,498226,107384,55242,52714,0.9947015450739191,0.3292608277430074
24164,0.6096428571428572,0,2,0,498228,107382,55242,52714,0.9946830190077439,0.3292649410353788
24165,0.6096590909090909,1,0,1,498228,107382,55243,52713,0.9946830190077439,0.32926075142883915
24166,0.6096666666666666,3,6,3,498234,107376,55246,52710,0.9946274408092186,0.3292605224691728
24167,0.6096666666666667,4,6,4,498240,107370,55250,52706,0.9945718626106932,0.3292561033509083
24168,0.6096666666666668,1,0,1,498240,107370,55251,52705,0.9945718626106932,0.32925191316570357
24169,0.6096825396825397,0,1,0,498241,107369,55251,52705,0.9945625995776057,0.32925397003885704
24170,0.6096904761904761,0,1,0,498242,107368,55251,52705,0.9945533365445182,0.32925602693770967
24171,0.6097460317460318,0,2,0,498244,107366,55251,52705,0.994534810478343,0.3292601408125144
24172,0.6097619047619048,0,1,0,498245,107365,55251,52705,0.9945255474452555,0.32926219778846755
24173,0.6097777777777778,0,1,0,498246,107364,55251,52705,0.9945162844121679,0.3292642547901218
24174,0.6097857142857142,0,1,0,498247,107363,55251,52705,0.9945070213790803,0.32926631181747756
24175,0.6098214285714285,0,2,0,498249,107361,55251,52705,0.9944884953129053,0.3292704259492959
24176,0.6098333333333333,2,7,2,498256,107354,55253,52703,0.9944236540812924,0.32927644526637384
24177,0.6098333333333334,1,0,1,498256,107354,55254,52702,0.9944236540812924,0.3292722547108512
24178,0.6098571428571428,0,1,0,498257,107353,55254,52702,0.9944143910482048,0.32927431195526535
24179,0.6098593073593073,0,1,0,498258,107352,55254,52702,0.9944051280151173,0.32927636922538644
24180,0.6098809523809523,0,1,0,498259,107351,55254,52702,0.9943958649820297,0.32927842652121486
24181,0.6098809523809524,0,1,0,498260,107350,55254,52702,0.9943866019489421,0.3292804838427511
24182,0.6098888888888889,0,1,0,498261,107349,55254,52702,0.9943773389158546,0.32928254118999567
24183,0.609892857142857,1,0,1,498261,107349,55255,52701,0.9943773389158546,0.3292783505154639
24184,0.6099047619047618,0,1,0,498262,107348,55255,52701,0.9943680758827671,0.3292804078750883
24185,0.6099523809523809,0,2,0,498264,107346,55255,52701,0.994349549816592,0.32928452267146524
24186,0.6099722222222222,0,1,0,498265,107345,55255,52701,0.9943402867835044,0.3292865801082189
24187,0.6099999999999999,8,31,8,498296,107314,55263,52693,0.9940531327577902,0.3293168423881455
24188,0.61,589,2019,589,500315,105295,55852,52104,0.9753510689540184,0.33103132802622637
24189,0.6100000000000001,5,15,5,500330,105280,55857,52099,0.975212123457705,0.33104162562984896
24190,0.6100238095238094,0,1,0,500331,105279,55857,52099,0.9752028604246175,0.33104372911080326
24191,0.610047619047619,0,1,0,500332,105278,55857,52099,0.9751935973915299,0.33104583261848936
24192,0.6100714285714285,0,1,0,500333,105277,55857,52099,0.9751843343584423,0.3310479361529077
24193,0.610095238095238,1,0,1,500333,105277,55858,52098,0.9751843343584423,0.3310436854646545
24194,0.6100952380952381,0,1,0,500334,105276,55858,52098,0.9751750713253547,0.3310457890121621
24195,0.6101190476190476,0,1,0,500335,105275,55858,52098,0.9751658082922672,0.331047892586403
24196,0.6101190476190477,0,1,0,500336,105274,55858,52098,0.9751565452591797,0.3310499961873777
24197,0.6101190476190478,0,1,0,500337,105273,55858,52098,0.9751472822260921,0.33105209981508665
24198,0.6101547619047618,2,1,2,500338,105272,55860,52096,0.9751380191930046,0.33104570179451986
24199,0.6101666666666666,2,11,2,500349,105261,55862,52094,0.9750361258290414,0.33106034126656286
24200,0.6101666666666667,1,1,1,500350,105260,55863,52093,0.9750268627959539,0.3310581939969368
24201,0.6102380952380954,0,1,0,500351,105259,55863,52093,0.9750175997628664,0.331060297930754
24202,0.61025,0,3,0,500354,105256,55863,52093,0.9749898106636037,0.331066609892659
24203,0.6102619047619047,0,1,0,500355,105255,55863,52093,0.9749805476305161,0.3310687139334469
24204,0.6102857142857143,1,0,1,500355,105255,55864,52092,0.9749805476305161,0.33106446262083167
24205,0.6103333333333333,4,12,4,500367,105243,55868,52088,0.9748693912334655,0.33107270658675025
24206,0.6103333333333334,3,6,3,500373,105237,55871,52085,0.9748138130349402,0.3310725772619214
24207,0.6103333333333335,0,1,0,500374,105236,55871,52085,0.9748045500018526,0.3310746817017436
24208,0.6103809523809524,0,1,0,500375,105235,55871,52085,0.974795286968765,0.33107678616831937
24209,0.6103870851370853,0,2,0,500377,105233,55871,52085,0.9747767609025899,0.33108099518173384
24210,0.6104166666666666,0,1,0,500378,105232,55871,52085,0.9747674978695023,0.3310830997285735
24211,0.6104166666666667,0,1,0,500379,105231,55871,52085,0.9747582348364149,0.33108520430216887
24212,0.6104285714285714,0,1,0,500380,105230,55871,52085,0.9747489718033273,0.3310873089025204
24213,0.6104761904761905,1,2,1,500382,105228,55872,52084,0.9747304457371522,0.33108726606997557
24214,0.6104772727272727,0,1,0,500383,105227,55872,52084,0.9747211827040646,0.33108937073694783
24215,0.6104999999999999,3,11,3,500394,105216,55875,52081,0.9746192893401016,0.33109976668340785
24216,0.6105,1,1,1,500395,105215,55876,52080,0.974610026307014,0.3310976191233033
24217,0.6105000000000003,1,0,1,500395,105215,55877,52079,0.974610026307014,0.33109336656197946
24218,0.6105555555555555,1,0,1,500395,105215,55878,52078,0.974610026307014,0.33108911394658375
24219,0.6105833333333333,1,1,1,500396,105214,55879,52077,0.9746007632739264,0.33108696619641304
24220,0.6106071428571429,0,1,0,500397,105213,55879,52077,0.9745915002408388,0.33108907114247565
24221,0.6106190476190476,0,2,0,500399,105211,55879,52077,0.9745729741746637,0.3310932811148975
24222,0.6106428571428572,0,1,0,500400,105210,55879,52077,0.9745637111415762,0.3310953861412577
24223,0.6106428571428573,0,1,0,500401,105209,55879,52077,0.9745544481084887,0.33109749119438475
24224,0.6106666666666666,5,22,5,500423,105187,55884,52072,0.9743506613805625,0.33112254306589767
24225,0.6106666666666667,0,8,0,500431,105179,55884,52072,0.974276557115862,0.3311393886207401
24226,0.6106666666666668,0,1,0,500432,105178,55884,52072,0.9742672940827745,0.3311414944356121
24227,0.6106904761904761,1,0,1,500432,105178,55885,52071,0.9742672940827745,0.33113724093634933
24228,0.6107142857142857,1,5,1,500437,105173,55886,52070,0.9742209789173367,0.331143516722525
24229,0.6107142857142858,0,1,0,500438,105172,55886,52070,0.9742117158842492,0.3311456226707877
24230,0.6107499999999999,0,1,0,500439,105171,55886,52070,0.9742024528511616,0.33114772864583664
24231,0.6107619047619047,0,1,0,500440,105170,55886,52070,0.974193189818074,0.33114983464767234
24232,0.6108095238095238,0,1,0,500441,105169,55886,52070,0.9741839267849864,0.33115194067629533
24233,0.6108333333333332,0,2,0,500443,105167,55886,52070,0.9741654007188114,0.33115615281390515
24234,0.6108333333333333,23,83,23,500526,105084,55909,52047,0.9733965689725443,0.33123317486683085
24235,0.6108333333333335,0,1,0,500527,105083,55909,52047,0.9733873059394568,0.33123528288678167
24236,0.6108571428571428,0,3,0,500530,105080,55909,52047,0.9733595168401942,0.3312416071076263
24237,0.6109444444444444,1,0,1,500530,105080,55910,52046,0.9733595168401942,0.3312373509158255
24238,0.6109523809523809,0,3,0,500533,105077,55910,52046,0.9733317277409315,0.33124367533715626
24239,0.610952380952381,0,1,0,500534,105076,55910,52046,0.9733224647078439,0.3312457835312687
24240,0.6109826839826841,0,1,0,500535,105075,55910,52046,0.9733132016747564,0.3312478917522165
24241,0.611,8,36,8,500571,105039,55918,52038,0.9729797324836045,0.33128974961324703
24242,0.6110000000000001,0,2,0,500573,105037,55918,52038,0.9729612064174293,0.3312939678497533
24243,0.6110714285714286,0,2,0,500575,105035,55918,52038,0.9729426803512542,0.3312981861936806
24244,0.6110833333333333,0,2,0,500577,105033,55918,52038,0.9729241542850791,0.33130240464503313
24245,0.6111055333555332,0,2,0,500579,105031,55918,52038,0.972905628218904,0.3313066232038149
24246,0.6111111111111112,1,0,1,500579,105031,55919,52037,0.972905628218904,0.3313023658542797
24247,0.6111190476190476,0,2,0,500581,105029,55919,52037,0.9728871021527289,0.331306584493143
24248,0.6111428571428571,0,2,0,500583,105027,55919,52037,0.9728685760865537,0.3313108032394438
24249,0.6111666666666666,3,8,3,500591,105019,55922,52034,0.9727944718218533,0.33131490643286027
24250,0.6111666666666667,1,2,1,500593,105017,55923,52033,0.9727759457556783,0.33131486787647246
24251,0.6111904761904762,1,1,1,500594,105016,55924,52032,0.9727666827225907,0.3313127196780602
24252,0.6112142857142857,0,1,0,500595,105015,55924,52032,0.9727574196895031,0.3313148293186116
24253,0.6112380952380954,0,2,0,500597,105013,55924,52032,0.972738893623328,0.33131904868031453
24254,0.61125,3,8,3,500605,105005,55927,52029,0.9726647893586275,0.33132315294776926
24255,0.6112500000000001,1,1,1,500606,105004,55928,52028,0.9726555263255401,0.3313210046359978
24256,0.6112857142857142,0,1,0,500607,105003,55928,52028,0.9726462632924525,0.33132311454426194
24257,0.611297619047619,0,2,0,500609,105001,55928,52028,0.9726277372262774,0.33132733444140894
24258,0.6113333333333333,3,19,3,500628,104982,55931,52025,0.9724517395976139,0.3313546529772558
24259,0.6113333333333334,1,4,1,500632,104978,55932,52024,0.9724146874652636,0.3313588361931695
24260,0.6113809523809524,0,1,0,500633,104977,55932,52024,0.972405424432176,0.33136094674556216
24261,0.6114047619047619,0,1,0,500634,104976,55932,52024,0.9723961613990885,0.3313630573248408
24262,0.6114285714285714,0,4,0,500638,104972,55932,52024,0.9723591092667383,0.33137149991082576
24263,0.6114700577200576,2,2,2,500640,104970,55934,52022,0.9723405832005632,0.3313672034243783
24264,0.6114999999999999,7,17,7,500657,104953,55941,52015,0.9721831116380748,0.331373273533459
24265,0.6115,2,1,2,500658,104952,55943,52013,0.9721738486049872,0.33136686522473163
24266,0.6115238095238095,0,1,0,500659,104951,55943,52013,0.9721645855718997,0.3313689763257817
24267,0.6115454545454546,0,1,0,500660,104950,55943,52013,0.9721553225388121,0.3313710874537311
24268,0.611547619047619,0,1,0,500661,104949,55943,52013,0.9721460595057245,0.33137319860858044
24269,0.6115670995670995,0,1,0,500662,104948,55943,52013,0.972136796472637,0.3313753097903301
24270,0.6115714285714285,0,1,0,500663,104947,55943,52013,0.9721275334395495,0.33137742099898065
24271,0.6115952380952381,0,1,0,500664,104946,55943,52013,0.9721182704064619,0.3313795322345326
24272,0.6116071428571428,0,1,0,500665,104945,55943,52013,0.9721090073733744,0.33138164349698646
24273,0.6116190476190475,1,0,1,500665,104945,55944,52012,0.9721090073733744,0.33137738361462055
24274,0.6116190476190476,0,1,0,500666,104944,55944,52012,0.9720997443402868,0.33137949489028773
24275,0.6116666666666666,2,5,2,500671,104939,55946,52010,0.972053429174849,0.3313815315803223
24276,0.6116666666666667,54,198,54,500869,104741,56000,51956,0.9702193486235133,0.3315698449874599
24277,0.6116904761904762,0,3,0,500872,104738,56000,51956,0.9701915595242506,0.33157619308971625
24278,0.6117142857142857,0,3,0,500875,104735,56000,51956,0.9701637704249879,0.3315825414350537
24279,0.6117222222222223,0,2,0,500877,104733,56000,51956,0.9701452443588129,0.3315867738003306
24280,0.6117301587301587,0,1,0,500878,104732,56000,51956,0.9701359813257253,0.3315888900234862
24281,0.61175,1,0,1,500878,104732,56001,51955,0.9701359813257253,0.33158462412325207
24282,0.6117857142857143,0,2,0,500880,104730,56001,51955,0.9701174552595502,0.3315888566231611
24283,0.6118333333333332,0,1,0,500881,104729,56001,51955,0.9701081922264626,0.3315909729136351
24284,0.6118333333333333,0,10,0,500891,104719,56001,51955,0.9700155618955871,0.3316121373042113
24285,0.6118571428571429,1,2,1,500893,104717,56002,51954,0.969997035829412,0.33161210434605
24286,0.611904761904762,0,1,0,500894,104716,56002,51954,0.9699877727963244,0.3316142209740218
24287,0.6119166666666667,1,5,1,500899,104711,56003,51953,0.9699414576308867,0.33162053822192716
24288,0.6119285714285714,0,1,0,500900,104710,56003,51953,0.9699321945977991,0.33162265499830845
24289,0.6119523809523809,0,6,0,500906,104704,56003,51953,0.9698766163992738,0.33163535622410745
24290,0.6119761904761905,0,1,0,500907,104703,56003,51953,0.9698673533661862,0.33163747318966397
24291,0.612,9,51,9,500958,104652,56012,51944,0.969394938678721,0.3317070678689111
24292,0.6120238095238094,1,1,1,500959,104651,56013,51943,0.9693856756456334,0.3317049184515371
24293,0.6120238095238095,0,2,0,500961,104649,56013,51943,0.9693671495794582,0.33170915500153264
24294,0.6120714285714285,0,1,0,500962,104648,56013,51943,0.9693578865463708,0.33171127331711275
24295,0.6120833333333333,0,1,0,500963,104647,56013,51943,0.9693486235132832,0.3317133916597484
24296,0.6121071428571428,1,0,1,500963,104647,56014,51942,0.9693486235132832,0.3317091238848195
24297,0.6121190476190477,0,1,0,500964,104646,56014,51942,0.9693393604801956,0.33171124224078474
24298,0.6121428571428571,1,6,1,500970,104640,56015,51941,0.9692837822816703,0.3317196850192552
24299,0.6121428571428572,0,1,0,500971,104639,56015,51941,0.9692745192485828,0.3317218035509005
24300,0.6121666666666666,0,4,0,500975,104635,56015,51941,0.9692374671162325,0.3317302779480891
24301,0.6121904761904762,1,0,1,500975,104635,56016,51940,0.9692374671162325,0.3317260098994092
24302,0.6122142857142857,2,1,2,500976,104634,56018,51938,0.969228204083145,0.3317195922642618
24303,0.6122142857142858,0,1,0,500977,104633,56018,51938,0.9692189410500575,0.3317217109170919
24304,0.6122222222222221,1,1,1,500978,104632,56019,51937,0.9692096780169699,0.331719561343561
24305,0.6122222222222222,0,1,0,500979,104631,56019,51937,0.9692004149838823,0.33172168003678915
24306,0.6122413793103448,0,1,0,500980,104630,56019,51937,0.9691911519507947,0.33172379875708163
24307,0.6122500000000001,0,1,0,500981,104629,56019,51937,0.9691818889177072,0.331725917504439
24308,0.6122539682539682,0,1,0,500982,104628,56019,51937,0.9691726258846196,0.3317280362788618
24309,0.6122857142857142,1,0,1,500982,104628,56020,51936,0.9691726258846196,0.331723767915996
24310,0.6122857142857143,0,3,0,500985,104625,56020,51936,0.969144836785357,0.3317301243604729
24311,0.6123095238095239,0,1,0,500986,104624,56020,51936,0.9691355737522694,0.3317322432294328
24312,0.612310966810967,0,1,0,500987,104623,56020,51936,0.9691263107191819,0.3317343621254607
24313,0.6123333333333333,0,4,0,500991,104619,56020,51936,0.9690892585868317,0.33174283798026255
24314,0.6123333333333334,5,14,5,501005,104605,56025,51931,0.968959576123606,0.33175116267184546
24315,0.6123730158730158,0,1,0,501006,104604,56025,51931,0.9689503130905184,0.33175328201360715
24316,0.6123809523809524,1,5,1,501011,104599,56026,51930,0.9689039979250806,0.331759610040312
24317,0.6124166666666666,0,1,0,501012,104598,56026,51930,0.9688947348919931,0.3317617295308188
24318,0.6124999999999999,1,5,1,501017,104593,56027,51929,0.9688484197265552,0.3317680581643475
24319,0.6125,31,208,31,501225,104385,56058,51898,0.966921708844344,0.3320770653238036
24320,0.6125476190476191,0,1,0,501226,104384,56058,51898,0.9669124458112565,0.3320791901818508
24321,0.6125952380952381,0,1,0,501227,104383,56058,51898,0.9669031827781689,0.3320813150670907
24322,0.6125952380952383,0,2,0,501229,104381,56058,51898,0.9668846567119938,0.33208556491915103
24323,0.6126190476190476,0,1,0,501230,104380,56058,51898,0.9668753936789062,0.3320876898859724
24324,0.6126666666666666,1,2,1,501232,104378,56059,51897,0.9668568676127312,0.33208766597344425
24325,0.6126666666666667,7,29,7,501261,104349,56066,51890,0.9665882396531921,0.3321193812044368
24326,0.6126785714285713,1,0,1,501261,104349,56067,51889,0.9665882396531921,0.3321151064401746
24327,0.6127142857142857,0,1,0,501262,104348,56067,51889,0.9665789766201045,0.3321172321537152
24328,0.61275,0,1,0,501263,104347,56067,51889,0.9665697135870169,0.33211935789446734
24329,0.6127619047619047,0,1,0,501264,104346,56067,51889,0.9665604505539294,0.3321214836624316
24330,0.6127777777777776,0,1,0,501265,104345,56067,51889,0.9665511875208418,0.33212360945760844
24331,0.6128333333333333,2,5,2,501270,104340,56069,51887,0.966504872355404,0.3321256889014063
24332,0.6128571428571429,3,9,3,501279,104331,56072,51884,0.966421505057616,0.3321319975674551
24333,0.612857142857143,0,1,0,501280,104330,56072,51884,0.9664122420245285,0.332134123702101
24334,0.6128809523809524,1,0,1,501280,104330,56073,51883,0.9664122420245285,0.33212984834808884
24335,0.612904761904762,0,1,0,501281,104329,56073,51883,0.966402978991441,0.33213197449619747
24336,0.6129166666666667,1,1,1,501282,104328,56074,51882,0.9663937159583534,0.33212982523526025
24337,0.6129444444444446,1,0,1,501282,104328,56075,51881,0.9663937159583534,0.3321255497442529
24338,0.612968253968254,0,1,0,501283,104327,56075,51881,0.9663844529252659,0.3321276759192871
24339,0.6129999999999999,1,2,1,501285,104325,56076,51880,0.9663659268590907,0.33212765276399603
24340,0.613,6,25,6,501310,104300,56082,51874,0.9661343510319019,0.3321551602699553
24341,0.6130320512820512,1,2,1,501312,104298,56083,51873,0.9661158249657268,0.3321551376375896
24342,0.6130476190476191,0,3,0,501315,104295,56083,51873,0.9660880358664641,0.33216151836483787
24343,0.6130606060606061,0,2,0,501317,104293,56083,51873,0.966069509800289,0.3321657723191988
24344,0.6130714285714286,1,0,1,501317,104293,56084,51872,0.966069509800289,0.33216149585374444
24345,0.6130952380952381,1,0,1,501317,104293,56085,51871,0.966069509800289,0.33215721933352116
24346,0.6131666666666665,0,1,0,501318,104292,56085,51871,0.9660602467672015,0.3321593463240332
24347,0.6131666666666666,0,5,0,501323,104287,56085,51871,0.9660139316017636,0.3321699816852163
24348,0.6131666666666667,1,13,1,501336,104274,56086,51870,0.9658935121716254,0.33219335997540733
24349,0.6132142857142857,1,2,1,501338,104272,56087,51869,0.9658749861054504,0.33219333807263945
24350,0.6132857142857143,1,2,1,501340,104270,56088,51868,0.9658564600392753,0.33219331616903
24351,0.6133095238095239,0,1,0,501341,104269,56088,51868,0.9658471970061877,0.33219544374491633
24352,0.6133333333333332,1,1,1,501342,104268,56089,51867,0.9658379339731001,0.3321932942645787
24353,0.6133333333333333,36,163,36,501505,104105,56125,51831,0.9643280595798288,0.33238636363636365
24354,0.6133333333333334,57,261,57,501766,103844,56182,51774,0.9619104079439772,0.3326993021372849
24355,0.6133412698412699,1,5,1,501771,103839,56183,51773,0.9618640927785395,0.33270570393028814
24356,0.6133571428571429,0,1,0,501772,103838,56183,51773,0.9618548297454519,0.33270784199060477
24357,0.6133928571428572,0,1,0,501773,103837,56183,51773,0.9618455667123643,0.33270998007840114
24358,0.6134722222222222,0,1,0,501774,103836,56183,51773,0.9618363036792767,0.33271211819367774
24359,0.6134999999999999,0,2,0,501776,103834,56183,51773,0.9618177776131016,0.33271639450667384
24360,0.6135,3,23,3,501799,103811,56186,51770,0.9616047278520878,0.3327527140203495
24361,0.6135714285714285,0,2,0,501801,103809,56186,51770,0.9615862017859128,0.3327569916248337
24362,0.6135714285714287,1,0,1,501801,103809,56187,51769,0.9615862017859128,0.3327527028243068
24363,0.6135833333333334,0,2,0,501803,103807,56187,51769,0.9615676757197377,0.33275698051113284
24364,0.6136046176046175,0,2,0,501805,103805,56187,51769,0.9615491496535625,0.3327612583079435
24365,0.6136190476190476,0,1,0,501806,103804,56187,51769,0.961539886620475,0.33276339724759435
24366,0.6136190476190477,1,2,1,501808,103802,56188,51768,0.9615213605542999,0.3327633862569904
24367,0.6136309523809523,0,1,0,501809,103801,56188,51768,0.9615120975212124,0.33276552526531633
24368,0.6136666666666666,0,5,0,501814,103796,56188,51768,0.9614657823557746,0.3327762207194467
24369,0.6136666666666667,3,16,3,501830,103780,56191,51765,0.9613175738263737,0.3327975826931113
24370,0.6136904761904761,0,1,0,501831,103779,56191,51765,0.9613083107932862,0.33279972226508253
24371,0.6136904761904762,0,1,0,501832,103778,56191,51765,0.9612990477601986,0.3328018618645648
24372,0.6137142857142858,1,2,1,501834,103776,56192,51764,0.9612805216940234,0.3328018516137328
24373,0.6137499999999999,0,1,0,501835,103775,56192,51764,0.961271258660936,0.3328039912819293
24374,0.61375,0,2,0,501837,103773,56192,51764,0.9612527325947609,0.33280827070086216
24375,0.6137619047619046,0,2,0,501839,103771,56192,51764,0.9612342065285857,0.3328125502298518
24376,0.6137619047619047,0,3,0,501842,103768,56192,51764,0.9612064174293231,0.33281896972970193
24377,0.613781746031746,0,1,0,501843,103767,56192,51764,0.9611971543962355,0.33282110961801825
24378,0.6138095238095238,1,1,1,501844,103766,56193,51763,0.961187891363148,0.3328189598081387
24379,0.6138333333333333,1,4,1,501848,103762,56194,51762,0.9611508392307977,0.3328232298551992
24380,0.6138571428571429,1,1,1,501849,103761,56195,51761,0.9611415761977101,0.33282107997582333
24381,0.6138888888888888,0,1,0,501850,103760,56195,51761,0.9611323131646227,0.3328232200153034
24382,0.6138888888888889,0,1,0,501851,103759,56195,51761,0.9611230501315351,0.3328253600823045
24383,0.613904761904762,1,0,1,501851,103759,56196,51760,0.9611230501315351,0.3328210700943293
24384,0.6139365079365079,1,0,1,501851,103759,56197,51759,0.9611230501315351,0.33281678005118376
24385,0.6139444444444444,0,2,0,501853,103757,56197,51759,0.96110452406536,0.332821060212454
24386,0.613952380952381,0,1,0,501854,103756,56197,51759,0.9610952610322724,0.3328232003343729
24387,0.6139999999999999,1,3,1,501857,103753,56198,51758,0.9610674719330098,0.33282533068400305
24388,0.614,15,63,15,501920,103690,56213,51743,0.9604839008484938,0.3328958457985113
24389,0.6140000000000001,2,7,2,501927,103683,56215,51741,0.9604190596168809,0.33290225447807287
24390,0.6140370511841099,0,2,0,501929,103681,56215,51741,0.9604005335507059,0.33290653832790723
24391,0.6141428571428572,1,1,1,501930,103680,56216,51740,0.9603912705176183,0.3329043881096384
24392,0.6141666666666665,0,3,0,501933,103677,56216,51740,0.9603634814183556,0.3329108141323021
24393,0.6141666666666666,12,28,12,501961,103649,56228,51728,0.9601041164919041,0.33291928663830556
24394,0.6141666666666667,5,19,5,501980,103630,56233,51723,0.9599281188632406,0.332938533533308
24395,0.6142156862745098,0,1,0,501981,103629,56233,51723,0.959918855830153,0.33294067665688243
24396,0.6142380952380952,0,1,0,501982,103628,56233,51723,0.9599095927970654,0.3329428198080476
24397,0.61425,0,4,0,501986,103624,56233,51723,0.9598725406647153,0.3329513926886261
24398,0.6142532467532468,0,1,0,501987,103623,56233,51723,0.9598632776316277,0.3329535359777529
24399,0.614256645315469,0,1,0,501988,103622,56233,51723,0.9598540145985401,0.3329556792944736
24400,0.6142857142857143,3,8,3,501996,103614,56236,51720,0.9597799103338397,0.33295994437792115
24401,0.6143333333333332,0,3,0,501999,103611,56236,51720,0.9597521212345771,0.3329663750313846
24402,0.6143333333333333,3,15,3,502014,103596,56239,51717,0.9596131757382638,0.33298564833594096
24403,0.6143333333333334,3,13,3,502027,103583,56242,51714,0.9594927563081256,0.3330006374881678
24404,0.6143650793650793,0,1,0,502028,103582,56242,51714,0.959483493275038,0.33300278178446324
24405,0.6143809523809522,0,1,0,502029,103581,56242,51714,0.9594742302419504,0.3330049261083744
24406,0.6143809523809524,0,1,0,502030,103580,56242,51714,0.9594649672088629,0.33300707045990185
24407,0.6143809523809525,0,1,0,502031,103579,56242,51714,0.9594557041757753,0.33300921483904616
24408,0.6144206349206348,1,1,1,502032,103578,56243,51713,0.9594464411426877,0.33300706415696985
24409,0.6144444444444445,0,3,0,502035,103575,56243,51713,0.9594186520434251,0.33301349750141673
24410,0.614452380952381,0,1,0,502036,103574,56243,51713,0.9594093890103376,0.333015642004804
24411,0.6144999999999999,1,1,1,502037,103573,56244,51712,0.95940012597725,0.3330134913224072
24412,0.6145,4,8,4,502045,103565,56248,51708,0.9593260217125495,0.3330134666039814
24413,0.6145238095238095,0,2,0,502047,103563,56248,51708,0.9593074956463744,0.3330177560523214
24414,0.614528083028083,1,1,1,502048,103562,56249,51707,0.959298232613287,0.3330156051755341
24415,0.6145454545454545,1,0,1,502048,103562,56250,51706,0.959298232613287,0.3330113094778061
24416,0.6145833333333333,0,1,0,502049,103561,56250,51706,0.9592889695801994,0.33301345424333567
24417,0.6145833333333334,0,3,0,502052,103558,56250,51706,0.9592611804809367,0.3330198887056884
24418,0.6146212121212121,0,1,0,502053,103557,56250,51706,0.9592519174478491,0.33302203358172905
24419,0.6146428571428572,0,3,0,502056,103554,56250,51706,0.9592241283485865,0.333028468375628
24420,0.6146666666666666,2,13,2,502069,103541,56252,51704,0.9591037089184482,0.3330477632129859
24421,0.6146666666666667,0,10,0,502079,103531,56252,51704,0.9590110785875727,0.333069217637775
24422,0.6146666666666668,2,3,2,502082,103528,56254,51702,0.95898328948831,0.33306706177929524
24423,0.6146904761904761,1,1,1,502083,103527,56255,51701,0.9589740264552225,0.33306491096967045
24424,0.6146904761904762,1,0,1,502083,103527,56256,51700,0.9589740264552225,0.3330606144549595
24425,0.6147023809523811,0,1,0,502084,103526,56256,51700,0.958964763422135,0.33306276010462166
24426,0.6147500000000001,0,1,0,502085,103525,56256,51700,0.9589555003890474,0.33306490578192943
24427,0.6148095238095237,1,0,1,502085,103525,56257,51699,0.9589555003890474,0.33306060918414676
24428,0.6148333333333332,0,1,0,502086,103524,56257,51699,0.9589462373559599,0.333062754875244
24429,0.6148333333333333,0,5,0,502091,103519,56257,51699,0.9588999221905221,0.3330734837454419
24430,0.6148333333333335,0,1,0,502092,103518,56257,51699,0.9588906591574345,0.3330756296024276
24431,0.6148571428571429,0,2,0,502094,103516,56257,51699,0.9588721330912594,0.3330799213993493
24432,0.6148730158730159,1,0,1,502094,103516,56258,51698,0.9588721330912594,0.3330756246214903
24433,0.6148809523809523,1,1,1,502095,103515,56259,51697,0.9588628700581718,0.33307347370048707
24434,0.6149166666666667,0,1,0,502096,103514,56259,51697,0.9588536070250843,0.33307561964036053
24435,0.6149285714285714,0,1,0,502097,103513,56259,51697,0.9588443439919967,0.3330777656078861
24436,0.6149523809523809,0,1,0,502098,103512,56259,51697,0.9588350809589092,0.33307991160306427
24437,0.614952380952381,0,1,0,502099,103511,56259,51697,0.9588258179258217,0.3330820576258956
24438,0.6149999999999999,2,12,2,502111,103499,56261,51695,0.9587146615287709,0.3330992177532637
24439,0.615,204,681,204,502792,102818,56465,51491,0.9524065359961466,0.3336876008528342
24440,0.6150000000000001,2,17,2,502809,102801,56467,51489,0.9522490644336582,0.33371573011860783
24441,0.6150119047619048,0,1,0,502810,102800,56467,51489,0.9522398014005706,0.3337178930448703
24442,0.6150238095238095,0,3,0,502813,102797,56467,51489,0.9522120123013079,0.3337243819918852
24443,0.6150416666666667,0,1,0,502814,102796,56467,51489,0.9522027492682203,0.3337265450303011
24444,0.6150595238095238,0,1,0,502815,102795,56467,51489,0.9521934862351328,0.33372870809675664
24445,0.6151666666666666,3,7,3,502822,102788,56470,51486,0.9521286450035199,0.33373089438272163
24446,0.6151666666666668,0,6,0,502828,102782,56470,51486,0.9520730668049946,0.3337438742966785
24447,0.6152261904761905,0,1,0,502829,102781,56470,51486,0.952063803771907,0.3337460377138338
24448,0.6152380952380951,0,4,0,502833,102777,56470,51486,0.9520267516395569,0.33375469166293925
24449,0.6152380952380953,0,1,0,502834,102776,56470,51486,0.9520174886064693,0.33375685522033943
24450,0.6152380952380954,0,1,0,502835,102775,56470,51486,0.9520082255733817,0.3337590188057902
24451,0.6152619047619047,1,0,1,502835,102775,56471,51485,0.9520082255733817,0.33375469985738365
24452,0.6152619047619048,0,1,0,502836,102774,56471,51485,0.9519989625402941,0.33375686345691336
24453,0.6152777777777777,0,1,0,502837,102773,56471,51485,0.9519896995072067,0.3337590270844948
24454,0.6152777777777778,0,1,0,502838,102772,56471,51485,0.9519804364741191,0.3337611907401285
24455,0.6152857142857143,1,0,1,502838,102772,56472,51484,0.9519804364741191,0.3337568716938077
24456,0.6153095238095238,0,1,0,502839,102771,56472,51484,0.9519711734410315,0.3337590353635214
24457,0.6153333333333333,6,6,6,502845,102765,56478,51478,0.9519155952425062,0.33374610193007137
24458,0.6153333333333334,2,7,2,502852,102758,56480,51476,0.9518507540108934,0.3337526096710194
24459,0.6153333333333335,0,1,0,502853,102757,56480,51476,0.9518414909778058,0.3337547736217282
24460,0.6153571428571428,0,1,0,502854,102756,56480,51476,0.9518322279447182,0.33375693760049796
24461,0.6153864468864471,2,0,2,502854,102756,56482,51474,0.9518322279447182,0.33374829799649874
24462,0.6154166666666665,0,1,0,502855,102755,56482,51474,0.9518229649116307,0.3337504619753743
24463,0.6154166666666666,0,1,0,502856,102754,56482,51474,0.9518137018785431,0.3337526259823119
24464,0.6154166666666667,0,2,0,502858,102752,56482,51474,0.951795175812368,0.33375695408037553
24465,0.6154761904761904,0,1,0,502859,102751,56482,51474,0.9517859127792805,0.33375911817150267
24466,0.6154761904761905,1,0,1,502859,102751,56483,51473,0.9517859127792805,0.3337547982155825
24467,0.6154999999999999,4,15,4,502874,102736,56487,51469,0.9516469672829672,0.333769981518109
24468,0.6155,0,1,0,502875,102735,56487,51469,0.9516377042498796,0.3337721459884309
24469,0.6155000000000002,0,2,0,502877,102733,56487,51469,0.9516191781837045,0.33377647501329427
24470,0.6155238095238096,0,2,0,502879,102731,56487,51469,0.9516006521175293,0.33378080415045397
24471,0.6155454545454545,1,0,1,502879,102731,56488,51468,0.9516006521175293,0.3337764836347836
24472,0.615547619047619,0,1,0,502880,102730,56488,51468,0.9515913890844419,0.33377864823149456
24473,0.6155555555555555,4,1,4,502881,102729,56492,51464,0.9515821260513543,0.3337635301213414
24474,0.6155833333333334,0,2,0,502883,102727,56492,51464,0.9515635999851791,0.333767859343282
24475,0.6156190476190476,0,3,0,502886,102724,56492,51464,0.9515358108859164,0.3337743533867746
24476,0.6156666666666666,3,21,3,502907,102703,56495,51461,0.9513412871910778,0.3338068550374925
24477,0.6156666666666667,2,5,2,502912,102698,56497,51459,0.9512949720256401,0.3338090388370298
24478,0.6156666666666668,0,1,0,502913,102697,56497,51459,0.9512857089925525,0.33381120423467137
24479,0.6156785714285714,0,1,0,502914,102696,56497,51459,0.9512764459594649,0.33381336966040676
24480,0.6157142857142857,5,6,5,502920,102690,56502,51454,0.9512208677609396,0.33380475399626325
24481,0.6157142857142858,0,2,0,502922,102688,56502,51454,0.9512023416947646,0.33380908512929636
24482,0.6157380952380952,0,1,0,502923,102687,56502,51454,0.951193078661677,0.3338112507379607
24483,0.6157499999999999,0,1,0,502924,102686,56502,51454,0.9511838156285894,0.3338134163747243
24484,0.6157936507936508,0,1,0,502925,102685,56502,51454,0.9511745525955019,0.33381558203958767
24485,0.6158015873015873,0,1,0,502926,102684,56502,51454,0.9511652895624143,0.33381774773255135
24486,0.6158095238095238,0,1,0,502927,102683,56502,51454,0.9511560265293267,0.33381991345361595
24487,0.6158333333333332,9,29,9,502956,102654,56511,51445,0.9508873985697877,0.3338438276692256
24488,0.6158333333333333,8,45,8,503001,102609,56519,51437,0.9504705620808478,0.3339067551250925
24489,0.6158333333333335,0,1,0,503002,102608,56519,51437,0.9504612990477602,0.33390892271738776
24490,0.6158447108447106,0,1,0,503003,102607,56519,51437,0.9504520360146727,0.33391109033782557
24491,0.6158809523809523,0,1,0,503004,102606,56519,51437,0.9504427729815851,0.3339132579864064
24492,0.6158809523809525,0,1,0,503005,102605,56519,51437,0.9504335099484975,0.3339154256631308
24493,0.6159166666666667,2,0,2,503005,102605,56521,51435,0.9504335099484975,0.3339067774603999
24494,0.615952380952381,0,1,0,503006,102604,56521,51435,0.9504242469154099,0.33390894513727043
24495,0.6159761904761905,1,0,1,503006,102604,56522,51434,0.9504242469154099,0.3339046209376907
24496,0.616,21,75,21,503081,102529,56543,51413,0.9497295194338434,0.3339764326824388
24497,0.6160238095238095,1,0,1,503081,102529,56544,51412,0.9497295194338434,0.33397210619652984
24498,0.6160476190476191,0,2,0,503083,102527,56544,51412,0.9497109933676683,0.33397644521531256
24499,0.6160714285714287,1,0,1,503083,102527,56545,51411,0.9497109933676683,0.33397211864516885
24500,0.6160833333333333,0,1,0,503084,102526,56545,51411,0.9497017303345807,0.33397428818282804
24501,0.6160952380952381,0,1,0,503085,102525,56545,51411,0.9496924673014931,0.3339764577486748
24502,0.6160952380952383,0,1,0,503086,102524,56545,51411,0.9496832042684057,0.3339786273427096
24503,0.616111111111111,0,1,0,503087,102523,56545,51411,0.9496739412353181,0.33398079696493305
24504,0.6161428571428571,1,0,1,503087,102523,56546,51410,0.9496739412353181,0.33397647028252553
24505,0.6161666666666666,4,8,4,503095,102515,56550,51406,0.9495998369706177,0.3339765204228143
24506,0.6161666666666668,1,2,1,503097,102513,56551,51405,0.9495813109044425,0.3339765329591081
24507,0.6161904761904762,0,2,0,503099,102511,56551,51405,0.9495627848382674,0.33398087268380156
24508,0.6162142857142857,0,1,0,503100,102510,56551,51405,0.9495535218051799,0.3339830425884417
24509,0.61625,0,4,0,503104,102506,56551,51405,0.9495164696728297,0.3339917224889709
24510,0.6162500000000001,0,2,0,503106,102504,56551,51405,0.9494979436066545,0.33399606260842446
24511,0.6162619047619048,0,3,0,503109,102501,56551,51405,0.9494701545073919,0.33400257299910335
24512,0.6163095238095238,0,1,0,503110,102500,56551,51405,0.9494608914743043,0.3340047431857315
24513,0.6163095238095239,0,2,0,503112,102498,56551,51405,0.9494423654081292,0.3340090836435937
24514,0.6163333333333333,2,14,2,503126,102484,56553,51403,0.9493126829449035,0.33403081481866564
24515,0.6163333333333334,0,2,0,503128,102482,56553,51403,0.9492941568787284,0.33403515612307894
24516,0.6163333333333335,0,1,0,503129,102481,56553,51403,0.9492848938456409,0.33403732681760284
24517,0.6163636363636364,1,1,1,503130,102480,56554,51402,0.9492756308125533,0.33403516980543535
24518,0.6163928571428571,1,4,1,503134,102476,56555,51401,0.949238578680203,0.33403952507522244
24519,0.6164166666666667,0,1,0,503135,102475,56555,51401,0.9492293156471155,0.33404169591099325
24520,0.6164285714285714,1,2,1,503137,102473,56556,51400,0.9492107895809404,0.3340417097216536
24521,0.6164999999999999,8,10,8,503147,102463,56564,51392,0.9491181592500648,0.3340287933443827
24522,0.6165,0,2,0,503149,102461,56564,51392,0.9490996331838897,0.3340331355254691
24523,0.6165238095238095,0,3,0,503152,102458,56564,51392,0.9490718440846271,0.3340396490087748
24524,0.6165317460317461,1,2,1,503154,102456,56565,51391,0.9490533180184519,0.3340396627818547
24525,0.616547619047619,2,1,2,503155,102455,56567,51389,0.9490440549853644,0.3340331764644705
24526,0.6165833333333333,0,2,0,503157,102453,56567,51389,0.9490255289191893,0.3340375190130134
24527,0.6166428571428572,0,1,0,503158,102452,56567,51389,0.9490162658861018,0.33403969032962605
24528,0.6166428571428573,0,1,0,503159,102451,56567,51389,0.9490070028530142,0.334041861674467
24529,0.6166666666666666,1,3,1,503162,102448,56568,51388,0.9489792137537515,0.3340440469070959
24530,0.6166666666666667,105,378,105,503540,102070,56673,51283,0.9454777872466561,0.3344114559219578
24531,0.6167142857142858,0,1,0,503541,102069,56673,51283,0.9454685242135685,0.3344136366007616
24532,0.61675,0,2,0,503543,102067,56673,51283,0.9454499981473934,0.3344179980436909
24533,0.6167857142857143,0,3,0,503546,102064,56673,51283,0.9454222090481307,0.33442454042139724
24534,0.6167976190476191,0,1,0,503547,102063,56673,51283,0.9454129460150432,0.33442672127085155
24535,0.6168333333333333,0,12,0,503559,102051,56673,51283,0.9453017896179925,0.33445289368307096
24536,0.6168333333333335,0,2,0,503561,102049,56673,51283,0.9452832635518174,0.3344572561500535
24537,0.6168571428571429,0,3,0,503564,102046,56673,51283,0.9452554744525548,0.33446380006391485
24538,0.6168888888888889,0,1,0,503565,102045,56673,51283,0.9452462114194672,0.3344659814254409
24539,0.6169047619047618,0,2,0,503567,102043,56673,51283,0.945227685353292,0.3344703442338547
24540,0.6169062049062048,1,4,1,503571,102039,56674,51282,0.9451906332209419,0.33447472948911106
24541,0.6169444444444444,0,1,0,503572,102038,56674,51282,0.9451813701878543,0.33447691103574223
24542,0.6169642857142856,0,1,0,503573,102037,56674,51282,0.9451721071547667,0.33447909261083103
24543,0.617,8,30,8,503603,102007,56682,51274,0.9448942161621401,0.3345098218304943
24544,0.6170833333333333,0,1,0,503604,102006,56682,51274,0.9448849531290526,0.33451200417536536
24545,0.6170952380952381,0,1,0,503605,102005,56682,51274,0.9448756900959651,0.33451418654871184
24546,0.6170952380952383,0,1,0,503606,102004,56682,51274,0.9448664270628775,0.3345163689505343
24547,0.6171071428571429,0,1,0,503607,102003,56682,51274,0.9448571640297899,0.3345185513808334
24548,0.6171428571428571,1,11,1,503618,101992,56683,51273,0.9447552706658268,0.3345382181189443
24549,0.6171666666666666,8,12,8,503630,101980,56691,51265,0.9446441142687761,0.3345296747039055
24550,0.6171666666666668,0,1,0,503631,101979,56691,51265,0.9446348512356886,0.3345318576910026
24551,0.6172121212121211,1,0,1,503631,101979,56692,51264,0.9446348512356886,0.33452751512303985
24552,0.6172135642135643,0,3,0,503634,101976,56692,51264,0.944607062136426,0.3345340642129992
24553,0.6172222222222222,0,1,0,503635,101975,56692,51264,0.9445977991033384,0.33453624729996934
24554,0.61725,6,1,6,503636,101974,56698,51258,0.9445885360702508,0.3345123733945912
24555,0.6172619047619049,0,1,0,503637,101973,56698,51258,0.9445792730371633,0.33451455645398126
24556,0.6173333333333333,3,28,3,503665,101945,56701,51255,0.9443199081107118,0.3345626631853786
24557,0.6173333333333334,1,4,1,503669,101941,56702,51254,0.9442828559783616,0.33456705506054374
24558,0.6173333333333335,0,1,0,503670,101940,56702,51254,0.944273592945274,0.33456923900413854
24559,0.6173452380952381,0,1,0,503671,101939,56702,51254,0.9442643299121865,0.33457142297624565
24560,0.6173571428571428,0,1,0,503672,101938,56702,51254,0.9442550668790989,0.3345736069768656
24561,0.6173809523809524,1,0,1,503672,101938,56703,51253,0.9442550668790989,0.3345692632073686
24562,0.6173809523809525,0,1,0,503673,101937,56703,51253,0.9442458038460113,0.33457144722240356
24563,0.6174285714285714,0,1,0,503674,101936,56703,51253,0.9442365408129237,0.3345736312659525
24564,0.6174642857142857,0,2,0,503676,101934,56703,51253,0.9442180147467487,0.3345779994385947
24565,0.6174855144855145,2,9,2,503685,101925,56705,51251,0.9441346474489607,0.33458896955136574
24566,0.6174999999999999,3,10,3,503695,101915,56708,51248,0.9440420171180851,0.33459778144852215
24567,0.6175,52,198,52,503893,101717,56760,51196,0.9422079365667494,0.3348047582612335
24568,0.6175238095238096,0,1,0,503894,101716,56760,51196,0.9421986735336618,0.33480694778696246
24569,0.6175714285714285,1,1,1,503895,101715,56761,51195,0.9421894105005743,0.33480478712968414
24570,0.6176111111111111,1,0,1,503895,101715,56762,51194,0.9421894105005743,0.33480043686113964
24571,0.6176190476190476,0,3,0,503898,101712,56762,51194,0.9421616214013117,0.3348070056112906
24572,0.6176666666666666,1,1,1,503899,101711,56763,51193,0.9421523583682241,0.3348048448699838
24573,0.6176666666666667,3,23,3,503922,101688,56766,51190,0.9419393086072103,0.33484216172372744
24574,0.6177142857142858,0,1,0,503923,101687,56766,51190,0.9419300455741227,0.334844351995395
24575,0.61775,0,2,0,503925,101685,56766,51190,0.9419115195079477,0.3348487326246934
24576,0.6177777777777778,0,1,0,503926,101684,56766,51190,0.9419022564748601,0.3348509229823253
24577,0.6177857142857143,1,0,1,503926,101684,56767,51189,0.9419022564748601,0.3348465719911299
24578,0.617797619047619,0,1,0,503927,101683,56767,51189,0.9418929934417726,0.3348487623632843
24579,0.6178023088023086,1,2,1,503929,101681,56768,51188,0.9418744673755974,0.33484879210304247
24580,0.6178214285714285,0,1,0,503930,101680,56768,51188,0.9418652043425099,0.33485098254703405
24581,0.6178333333333333,1,4,1,503934,101676,56769,51187,0.9418281522101597,0.3348553933914682
24582,0.6178571428571429,0,3,0,503937,101673,56769,51187,0.941800363110897,0.3348619651969122
24583,0.6178611111111111,2,1,2,503938,101672,56771,51185,0.9417911000778095,0.3348554531359375
24584,0.6178809523809522,1,0,1,503938,101672,56772,51184,0.9417911000778095,0.33485110169047994
24585,0.617904761904762,1,2,1,503940,101670,56773,51183,0.9417725740116344,0.3348511314792644
24586,0.6179166666666667,2,4,2,503944,101666,56775,51181,0.9417355218792841,0.3348511910603414
24587,0.6179285714285715,0,1,0,503945,101665,56775,51181,0.9417262588461967,0.3348533818353114
24588,0.6179761904761905,0,1,0,503946,101664,56775,51181,0.9417169958131091,0.33485557263894794
24589,0.6179999999999999,0,4,0,503950,101660,56775,51181,0.9416799436807588,0.3348643361401718
24590,0.618,11,49,11,503999,101611,56786,51170,0.9412260550594687,0.3349238452425367
24591,0.6180952380952381,0,1,0,504000,101610,56786,51170,0.9412167920263811,0.3349260374394554
24592,0.6181428571428571,0,5,0,504005,101605,56786,51170,0.9411704768609434,0.3349369988545246
24593,0.6181428571428572,0,2,0,504007,101603,56786,51170,0.9411519507947682,0.3349413836214514
24594,0.6181547619047619,0,1,0,504008,101602,56786,51170,0.9411426877616806,0.33494357604796693
24595,0.6181666666666666,0,8,0,504016,101594,56786,51170,0.9410685834969803,0.3349611164934147
24596,0.6181666666666668,1,7,1,504023,101587,56787,51169,0.9410037422653674,0.3349721123883841
24597,0.6182142857142856,0,1,0,504024,101586,56787,51169,0.9409944792322799,0.33497430526005695
24598,0.6182142857142857,1,2,1,504026,101584,56788,51168,0.9409759531661047,0.3349743374882162
24599,0.618227453102453,0,2,0,504028,101582,56788,51168,0.9409574270999296,0.33497872340425533
24600,0.61825,0,2,0,504030,101580,56788,51168,0.9409389010337544,0.3349831094351481
24601,0.6182619047619047,1,0,1,504030,101580,56789,51167,0.9409389010337544,0.33497875572024327
24602,0.6182619047619048,0,2,0,504032,101578,56789,51167,0.9409203749675794,0.33498314183770334
24603,0.6182857142857143,0,1,0,504033,101577,56789,51167,0.9409111119344918,0.3349853349395066
24604,0.6183333333333332,0,3,0,504036,101574,56789,51167,0.9408833228352291,0.3349919144172161
24605,0.6183333333333333,24,78,24,504114,101496,56813,51143,0.9401608062543999,0.3350585368090724
24606,0.6183333333333334,52,129,52,504243,101367,56865,51091,0.9389658749861054,0.33511524485432054
24607,0.6183809523809525,0,1,0,504244,101366,56865,51091,0.9389566119530179,0.3351174429511272
24608,0.6184126984126984,0,1,0,504245,101365,56865,51091,0.9389473489199304,0.33511964107676967
24609,0.618452380952381,0,8,0,504253,101357,56865,51091,0.9388732446552299,0.33513722712006716
24610,0.6184999999999999,0,1,0,504254,101356,56865,51091,0.9388639816221424,0.33513942550525755
24611,0.6185,6,14,6,504268,101342,56871,51085,0.9387342991589166,0.3351440361615724
24612,0.6185714285714284,0,1,0,504269,101341,56871,51085,0.938725036125829,0.3351462348943094
24613,0.6185714285714285,0,1,0,504270,101340,56871,51085,0.9387157730927415,0.33514843365589636
24614,0.6185714285714287,2,0,2,504270,101340,56873,51083,0.9387157730927415,0.33513970988630326
24615,0.618595238095238,0,1,0,504271,101339,56873,51083,0.9387065100596539,0.33514190864835786
24616,0.6186111111111111,1,0,1,504271,101339,56874,51082,0.9387065100596539,0.33513754666351747
24617,0.6186666666666666,1,3,1,504274,101336,56875,51081,0.9386787209603913,0.33513978099555825
24618,0.6186666666666667,6,23,6,504297,101313,56881,51075,0.9384656711993775,0.33516418615639026
24619,0.6187499999999999,0,1,0,504298,101312,56881,51075,0.93845640816629,0.33516638558407214
24620,0.61875,3,4,3,504302,101308,56884,51072,0.9384193560339398,0.3351620947630923
24621,0.6188095238095238,0,3,0,504305,101305,56884,51072,0.9383915669346771,0.33516869343798605
24622,0.6188333333333332,1,2,1,504307,101303,56885,51071,0.9383730408685019,0.3351687295732868
24623,0.6188333333333333,2,7,2,504314,101296,56887,51069,0.938308199636889,0.3351754011748105
24624,0.6188461538461538,0,1,0,504315,101295,56887,51069,0.9382989366038016,0.33517760100811217
24625,0.6189166666666667,1,0,1,504315,101295,56888,51068,0.9382989366038016,0.3351732375970544
24626,0.6189999999999999,2,1,2,504316,101294,56890,51066,0.938289673570714,0.33516671042268315
24627,0.619,15,44,15,504360,101250,56905,51051,0.9378821001148616,0.33519806173301553
24628,0.6190000000000001,1,2,1,504362,101248,56906,51050,0.9378635740486865,0.3351980984648518
24629,0.619047619047619,0,1,0,504363,101247,56906,51050,0.9378543110155989,0.33520029941495894
24630,0.6190476190476191,1,0,1,504363,101247,56907,51049,0.9378543110155989,0.3351959342333351
24631,0.6190714285714287,0,1,0,504364,101246,56907,51049,0.9378450479825114,0.3351981351981352
24632,0.6191111111111112,1,0,1,504364,101246,56908,51048,0.9378450479825114,0.33519376994497485
24633,0.6191190476190475,0,1,0,504365,101245,56908,51048,0.9378357849494239,0.33519597092446796
24634,0.6191428571428572,0,1,0,504366,101244,56908,51048,0.9378265219163363,0.33519817193286583
24635,0.6191666666666665,0,2,0,504368,101242,56908,51048,0.9378079958501612,0.335202574036378
24636,0.6191666666666666,10,51,10,504419,101191,56918,51038,0.9373355811626959,0.33527120325299387
24637,0.6191666666666668,11,27,11,504446,101164,56929,51027,0.937085479269332,0.33528263826376065
24638,0.6191911976911977,0,1,0,504447,101163,56929,51027,0.9370762162362444,0.3352848413167751
24639,0.6192142857142857,0,1,0,504448,101162,56929,51027,0.9370669532031568,0.335287044398741
24640,0.6192261904761903,0,1,0,504449,101161,56929,51027,0.9370576901700692,0.3352892475096591
24641,0.6192738095238094,0,2,0,504451,101159,56929,51027,0.9370391641038942,0.33529365381835385
24642,0.6192857142857143,1,2,1,504453,101157,56930,51026,0.9370206380377191,0.3352936924623644
24643,0.6193333333333332,0,1,0,504454,101156,56930,51026,0.9370113750046315,0.3352958957038283
24644,0.6193333333333333,4,12,4,504466,101144,56934,51022,0.9369002186075809,0.3353048644243786
24645,0.6193333333333334,4,16,4,504482,101128,56938,51018,0.93675201007818,0.33532265061191224
24646,0.6194047619047618,0,2,0,504484,101126,56938,51018,0.9367334840120048,0.3353270585760858
24647,0.619404761904762,0,1,0,504485,101125,56938,51018,0.9367242209789174,0.3353292626016314
24648,0.6194444444444445,1,0,1,504485,101125,56939,51017,0.9367242209789174,0.33532489384916725
24649,0.619452380952381,0,1,0,504486,101124,56939,51017,0.9367149579458298,0.3353270978894578
24650,0.6194523809523811,1,2,1,504488,101122,56940,51016,0.9366964318796547,0.33532713720438023
24651,0.6194761904761905,0,1,0,504489,101121,56940,51016,0.9366871688465671,0.33532934131736525
24652,0.6194999999999999,2,5,2,504494,101116,56942,51014,0.9366408536811294,0.33533162426871754
24653,0.6195,2,14,2,504508,101102,56944,51012,0.9365111712179036,0.3353537478470095
24654,0.6195238095238095,0,1,0,504509,101101,56944,51012,0.936501908184816,0.3353559524826938
24655,0.6195238095238096,0,1,0,504510,101100,56944,51012,0.9364926451517285,0.3353581571473651
24656,0.6195476190476191,0,1,0,504511,101099,56944,51012,0.9364833821186409,0.33536036184102397
24657,0.6195703463203462,0,2,0,504513,101097,56944,51012,0.9364648560524658,0.3353647713153068
24658,0.6195714285714287,0,1,0,504514,101096,56944,51012,0.9364555930193783,0.33536697609593186
24659,0.6195833333333333,2,3,2,504517,101093,56946,51010,0.9364278039201156,0.3353648514493468
24660,0.6195833333333334,0,1,0,504518,101092,56946,51010,0.936418540887028,0.33536705631747116
24661,0.619595238095238,0,2,0,504520,101090,56946,51010,0.9364000148208529,0.3353714661406969
24662,0.6196190476190476,0,1,0,504521,101089,56946,51010,0.9363907517877654,0.33537367109579946
24663,0.619642857142857,0,3,0,504524,101086,56946,51010,0.9363629626885027,0.3353802861350726
24664,0.6196428571428572,1,1,1,504525,101085,56947,51009,0.9363536996554152,0.3353781214249083
24665,0.6196666666666666,4,7,4,504532,101078,56951,51005,0.9362888584238023,0.3353760775366083
24666,0.6196666666666667,0,6,0,504538,101072,56951,51005,0.936233280225277,0.33538930936302
24667,0.6196666666666668,0,3,0,504541,101069,56951,51005,0.9362054911260143,0.335395925667767
24668,0.6197380952380953,0,1,0,504542,101068,56951,51005,0.9361962280929268,0.33539813116069256
24669,0.6197857142857143,0,1,0,504543,101067,56951,51005,0.9361869650598392,0.33540033668262403
24670,0.6197857142857144,0,2,0,504545,101065,56951,51005,0.9361684389936641,0.33540474781350693
24671,0.6197871572871573,1,0,1,504545,101065,56952,51004,0.9361684389936641,0.3354003774602319
24672,0.6197878787878788,0,1,0,504546,101064,56952,51004,0.9361591759605765,0.3354025830549491
24673,0.6198095238095238,0,1,0,504547,101063,56952,51004,0.936149912927489,0.3354047886786745
24674,0.6198333333333332,1,3,1,504550,101060,56953,51003,0.9361221238282263,0.3354070352419721
24675,0.6198333333333333,1,3,1,504553,101057,56954,51002,0.9360943347289636,0.3354092819234639
24676,0.6198333333333335,0,1,0,504554,101056,56954,51002,0.9360850716958761,0.33541148772179036
24677,0.6198809523809523,1,0,1,504554,101056,56955,51001,0.9360850716958761,0.33540711706794163
24678,0.6199166666666667,0,3,0,504557,101053,56955,51001,0.9360572825966135,0.33541373459428886
24679,0.6199285714285715,1,0,1,504557,101053,56956,51000,0.9360572825966135,0.3354093638402399
24680,0.619952380952381,0,1,0,504558,101052,56956,51000,0.9360480195635259,0.33541156972614633
24681,0.6199999999999999,7,18,7,504576,101034,56963,50993,0.9358812849679499,0.3354206818525657
24682,0.62,580,1895,580,506471,99139,57543,50413,0.9183278372670347,0.3370934524446346
24683,0.6200000000000001,6,11,6,506482,99128,57549,50407,0.9182259439030717,0.33709165078409736
24684,0.6200238095238095,0,1,0,506483,99127,57549,50407,0.9182166808699841,0.3370939050650688
24685,0.6200238095238096,0,3,0,506486,99124,57549,50407,0.9181888917707214,0.3371006680888913
24686,0.6200555555555556,0,1,0,506487,99123,57549,50407,0.9181796287376338,0.33710292249047014
24687,0.6200595238095239,0,1,0,506488,99122,57549,50407,0.9181703657045462,0.3371051769222024
24688,0.6201190476190476,1,1,1,506489,99121,57550,50406,0.9181611026714588,0.33710299812074074
24689,0.6201190476190477,0,2,0,506491,99119,57550,50406,0.9181425766052836,0.33710750710583515
24690,0.6201666666666666,3,7,3,506498,99112,57553,50403,0.9180777353736708,0.337109988964318
24691,0.6201666666666668,0,2,0,506500,99110,57553,50403,0.9180592093074956,0.337114498404821
24692,0.6201904761904761,1,1,1,506501,99109,57554,50402,0.9180499462744081,0.3371123194948867
24693,0.6202380952380951,0,1,0,506502,99108,57554,50402,0.9180406832413205,0.33711457427596814
24694,0.6202380952380953,1,1,1,506503,99107,57555,50401,0.918031420208233,0.3371123953233272
24695,0.62025,0,1,0,506504,99106,57555,50401,0.9180221571751455,0.3371146501501602
24696,0.6202857142857143,0,1,0,506505,99105,57555,50401,0.9180128941420579,0.3371169050071569
24697,0.6202936507936507,0,1,0,506506,99104,57555,50401,0.9180036311089703,0.3371191598943179
24698,0.6203015873015872,0,1,0,506507,99103,57555,50401,0.9179943680758827,0.3371214148116438
24699,0.6203333333333333,3,11,3,506518,99092,57558,50398,0.9178924747119197,0.3371329185898722
24700,0.6203333333333334,4,11,4,506529,99081,57562,50394,0.9177905813479565,0.3371399899648771
24701,0.6203809523809524,0,1,0,506530,99080,57562,50394,0.917781318314869,0.3371422454741293
24702,0.6204047619047619,1,1,1,506531,99079,57563,50393,0.9177720552817815,0.337140066366945
24703,0.620436507936508,0,1,0,506532,99078,57563,50393,0.917762792248694,0.3371423219219782
24704,0.6204565434565434,0,1,0,506533,99077,57563,50393,0.9177535292156064,0.33714457750719207
24705,0.6204761904761904,0,2,0,506535,99075,57563,50393,0.9177350031494312,0.3371490887681644
24706,0.6204761904761905,1,0,1,506535,99075,57564,50392,0.9177350031494312,0.3371446540038938
24707,0.6204761904761906,0,1,0,506536,99074,57564,50392,0.9177257401163437,0.3371469096650743
24708,0.6204999999999999,3,10,3,506546,99064,57567,50389,0.9176331097854682,0.3371561628070363
24709,0.6205,0,3,0,506549,99061,57567,50389,0.9176053206862055,0.3371629307460689
24710,0.6205000000000002,0,1,0,506550,99060,57567,50389,0.9175960576531179,0.3371651867861277
24711,0.6205277777777778,0,1,0,506551,99059,57567,50389,0.9175867946200303,0.3371674428563781
24712,0.620547619047619,0,1,0,506552,99058,57567,50389,0.9175775315869428,0.3371696989568208
24713,0.6205555555555555,0,1,0,506553,99057,57567,50389,0.9175682685538553,0.33717195508745634
24714,0.6206190476190476,0,1,0,506554,99056,57567,50389,0.9175590055207677,0.33717421124828534
24715,0.6206428571428572,0,1,0,506555,99055,57567,50389,0.9175497424876802,0.33717646743930835
24716,0.6206666666666666,7,20,7,506575,99035,57574,50382,0.9173644818259291,0.3371905472603519
24717,0.6206666666666667,5,8,5,506583,99027,57579,50377,0.9172903775612287,0.3371864207116275
24718,0.6207142857142857,1,2,1,506585,99025,57580,50376,0.9172718514950535,0.33718649808234213
24719,0.6207380952380952,0,1,0,506586,99024,57580,50376,0.917262588461966,0.33718875502008033
24720,0.6207536428999276,1,4,1,506590,99020,57581,50375,0.9172255363296158,0.33719334649754007
24721,0.6207857142857143,0,1,0,506591,99019,57581,50375,0.9172162732965282,0.33719560357176326
24722,0.6208095238095237,0,1,0,506592,99018,57581,50375,0.9172070102634406,0.33719786067620305
24723,0.6208333333333332,6,27,6,506619,98991,57587,50369,0.9169569083700767,0.3372321906802357
24724,0.6208333333333333,11,41,11,506660,98950,57598,50358,0.916577124013487,0.33727596645859564
24725,0.6208412698412699,0,1,0,506661,98949,57598,50358,0.9165678609803994,0.33727822540135427
24726,0.6208571428571428,0,2,0,506663,98947,57598,50358,0.9165493349142243,0.3372827433776498
24727,0.6208809523809524,0,1,0,506664,98946,57598,50358,0.9165400718811367,0.3372850024111879
24728,0.6209166666666666,1,1,1,506665,98945,57599,50357,0.9165308088480492,0.33728282273512744
24729,0.6209404761904762,0,1,0,506666,98944,57599,50357,0.9165215458149617,0.3372850818145893
24730,0.6209523809523809,1,3,1,506669,98941,57600,50356,0.916493756715699,0.33728742037683274
24731,0.6209761904761905,0,1,0,506670,98940,57600,50356,0.9164844936826114,0.33728967956274786
24732,0.6209999999999998,0,1,0,506671,98939,57600,50356,0.9164752306495239,0.3372919387789276
24733,0.621,11,31,11,506702,98908,57611,50345,0.9161880766238097,0.3373131528344489
24734,0.6210000000000001,1,0,1,506702,98908,57612,50344,0.9161880766238097,0.3373087127810683
24735,0.6210714285714285,0,2,0,506704,98906,57612,50344,0.9161695505576346,0.33731323283082076
24736,0.6210714285714286,1,0,1,506704,98906,57613,50343,0.9161695505576346,0.3373087926887282
24737,0.6210833333333333,0,1,0,506705,98905,57613,50343,0.916160287524547,0.3373110527444254
24738,0.6211111111111111,0,1,0,506706,98904,57613,50343,0.9161510244914595,0.33731331283040866
24739,0.6211190476190476,1,2,1,506708,98902,57614,50342,0.9161324984252843,0.3373133928332127
24740,0.6211190476190477,0,1,0,506709,98901,57614,50342,0.9161232353921969,0.33731565299545035
24741,0.6211428571428571,0,1,0,506710,98900,57614,50342,0.9161139723591093,0.33731791318797655
24742,0.6211666666666666,0,4,0,506714,98896,57614,50342,0.916076920226759,0.3373269542609791
24743,0.6211666666666668,1,1,1,506715,98895,57615,50341,0.9160676571936714,0.33732477418317297
24744,0.6211785714285714,1,2,1,506717,98893,57616,50340,0.9160491311274964,0.3373248544222793
24745,0.6211904761904762,0,1,0,506718,98892,57616,50340,0.9160398680944088,0.33732711482791894
24746,0.6212063492063493,1,1,1,506719,98891,57617,50339,0.9160306050613213,0.33732493466461166
24747,0.62125,0,1,0,506720,98890,57617,50339,0.9160213420282337,0.33732719511623077
24748,0.6213095238095238,0,1,0,506721,98889,57617,50339,0.9160120789951461,0.33732945559814514
24749,0.6213095238095239,0,3,0,506724,98886,57617,50339,0.9159842898958835,0.3373362372256659
24750,0.6213160173160172,2,0,2,506724,98886,57619,50337,0.9159842898958835,0.33732735570253913
24751,0.6213333333333333,9,22,9,506746,98864,57628,50328,0.9157805031679573,0.3373371226339214
24752,0.6213333333333334,0,1,0,506747,98863,57628,50328,0.9157712401348698,0.33733938374298716
24753,0.621394660894661,0,1,0,506748,98862,57628,50328,0.9157619771017822,0.3373416448823648
24754,0.6214285714285714,0,2,0,506750,98860,57628,50328,0.9157434510356071,0.3373461672520578
24755,0.6214999999999999,4,12,4,506762,98848,57632,50324,0.9156322946385564,0.3373555358914542
24756,0.6215,0,3,0,506765,98845,57632,50324,0.9156045055392937,0.3373623205893986
24757,0.6215238095238095,0,1,0,506766,98844,57632,50324,0.9155952425062063,0.3373645822160249
24758,0.621547619047619,0,3,0,506769,98841,57632,50324,0.9155674534069436,0.33737136727784667
24759,0.6215846914523384,1,5,1,506774,98836,57633,50323,0.9155211382415058,0.33737823396509764
24760,0.6216060606060606,0,2,0,506776,98834,57633,50323,0.9155026121753307,0.3373827577653077
24761,0.6216287878787878,0,1,0,506777,98833,57633,50323,0.9154933491422431,0.3373850197109067
24762,0.6216428571428572,0,1,0,506778,98832,57633,50323,0.9154840861091555,0.33738728168683585
24763,0.6216666666666666,42,141,42,506919,98691,57675,50281,0.9141779984438104,0.33751980237897056
24764,0.6216666666666667,16,75,16,506994,98616,57691,50265,0.9134832709622439,0.33761863501722855
24765,0.6216904761904761,0,1,0,506995,98615,57691,50265,0.9134740079291563,0.33762090274046214
24766,0.6216904761904763,0,2,0,506997,98613,57691,50265,0.9134554818629812,0.33762543827832187
24767,0.6217103174603175,0,3,0,507000,98610,57691,50265,0.9134276927637186,0.337632241813602
24768,0.6217142857142857,0,1,0,507001,98609,57691,50265,0.913418429730631,0.33763450971962866
24769,0.6217698412698413,1,0,1,507001,98609,57692,50264,0.913418429730631,0.337630060521384
24770,0.6217857142857143,1,2,1,507003,98607,57693,50263,0.9133999036644559,0.3376301471082152
24771,0.6218055555555555,0,1,0,507004,98606,57693,50263,0.9133906406313683,0.3376324150763423
24772,0.6218095238095239,0,1,0,507005,98605,57693,50263,0.9133813775982808,0.3376346830749389
24773,0.6218333333333332,0,1,0,507006,98604,57693,50263,0.9133721145651932,0.3376369511040056
24774,0.6218333333333333,3,9,3,507015,98595,57696,50260,0.9132887472674053,0.33764401598871385
24775,0.6218333333333335,0,1,0,507016,98594,57696,50260,0.9132794842343177,0.3376462842785548
24776,0.6218571428571429,1,3,1,507019,98591,57697,50259,0.913251695135055,0.33764863957003693
24777,0.6219047619047618,0,1,0,507020,98590,57697,50259,0.9132424321019674,0.3376509079671345
24778,0.621904761904762,2,1,2,507021,98589,57699,50257,0.91323316906888,0.33764427663491126
24779,0.6219642857142857,0,1,0,507022,98588,57699,50257,0.9132239060357924,0.3376465450636568
24780,0.6219798534798534,0,1,0,507023,98587,57699,50257,0.9132146430027048,0.337648813522883
24781,0.6219999999999999,0,1,0,507024,98586,57699,50257,0.9132053799696173,0.3376510820125904
24782,0.622,17,52,17,507076,98534,57716,50240,0.9127237022490644,0.3376934141718311
24783,0.6220000000000001,0,2,0,507078,98532,57716,50240,0.9127051761828894,0.3376979539160595
24784,0.6220238095238095,1,5,1,507083,98527,57717,50239,0.9126588610174515,0.33770485191508814
24785,0.6220714285714286,0,1,0,507084,98526,57717,50239,0.912649597984364,0.3377071219708937
24786,0.6220833333333333,0,1,0,507085,98525,57717,50239,0.9126403349512765,0.33770939205721817
24787,0.6220919913419914,0,2,0,507087,98523,57717,50239,0.9126218088851014,0.33771393232142616
24788,0.6221428571428571,2,4,2,507091,98519,57719,50237,0.9125847567527511,0.33771410901072896
24789,0.6221428571428572,1,0,1,507091,98519,57720,50236,0.9125847567527511,0.3377096568182582
24790,0.6221666666666666,3,9,3,507100,98510,57723,50233,0.9125013894549632,0.33771673288827037
24791,0.6221666666666668,0,1,0,507101,98509,57723,50233,0.9124921264218756,0.3377190033749714
24792,0.6222222222222222,1,2,1,507103,98507,57724,50232,0.9124736003557005,0.337719091832001
24793,0.6222380952380953,1,0,1,507103,98507,57725,50231,0.9124736003557005,0.3377146391641679
24794,0.62225,0,1,0,507104,98506,57725,50231,0.9124643373226129,0.3377169097131178
24795,0.6222500000000001,0,1,0,507105,98505,57725,50231,0.9124550742895253,0.33771918029259895
24796,0.622297619047619,0,1,0,507106,98504,57725,50231,0.9124458112564378,0.337721450902612
24797,0.6223095238095238,0,1,0,507107,98503,57725,50231,0.9124365482233503,0.3377237215431576
24798,0.6223333333333333,7,15,7,507122,98488,57732,50224,0.912297602727037,0.33772661251277636
24799,0.6223333333333334,0,2,0,507124,98486,57732,50224,0.9122790766608618,0.33773115459619396
24800,0.6223809523809523,0,1,0,507125,98485,57732,50224,0.9122698136277743,0.3377334256837179
24801,0.6223809523809524,0,2,0,507127,98483,57732,50224,0.9122512875615991,0.3377379679503991
24802,0.6224999999999999,0,11,0,507138,98472,57732,50224,0.9121493941976361,0.3377629526012805
24803,0.6225,64,188,64,507326,98284,57796,50160,0.9104079439771758,0.33790520330899193
24804,0.6225384615384616,0,1,0,507327,98283,57796,50160,0.9103986809440884,0.3379074796386492
24805,0.6226190476190476,0,3,0,507330,98280,57796,50160,0.9103708918448257,0.3379143088116411
24806,0.6226190476190477,0,3,0,507333,98277,57796,50160,0.910343102745563,0.33792113826067627
24807,0.6226666666666666,0,1,0,507334,98276,57796,50160,0.9103338397124755,0.3379234148050338
24808,0.6226666666666667,8,35,8,507369,98241,57804,50152,0.910009633554411,0.337967424339423
24809,0.6226666666666668,0,1,0,507370,98240,57804,50152,0.9100003705213235,0.3379697018707208
24810,0.6226733544233543,0,3,0,507373,98237,57804,50152,0.9099725814220608,0.33797653464879474
24811,0.6227142857142858,0,1,0,507374,98236,57804,50152,0.9099633183889733,0.3379788123028816
24812,0.6227222222222223,0,1,0,507375,98235,57804,50152,0.9099540553558857,0.3379810899876674
24813,0.6228333333333333,2,5,2,507380,98230,57806,50150,0.909907740190448,0.3379835557352743
24814,0.6228333333333335,0,1,0,507381,98229,57806,50150,0.9098984771573604,0.33798583357483203
24815,0.6228571428571429,0,3,0,507384,98226,57806,50150,0.9098706880580978,0.33799266727772687
24816,0.6228809523809523,0,1,0,507385,98225,57806,50150,0.9098614250250102,0.3379949452401011
24817,0.622904761904762,0,1,0,507386,98224,57806,50150,0.9098521619919226,0.337997223233181
24818,0.6229166666666667,0,2,0,507388,98222,57806,50150,0.9098336359257475,0.33800177931146036
24819,0.6229523809523808,1,0,1,507388,98222,57807,50149,0.9098336359257475,0.3379973175350978
24820,0.6229761904761905,0,2,0,507390,98220,57807,50149,0.9098151098595724,0.33800187370677165
24821,0.6229999999999999,0,2,0,507392,98218,57807,50149,0.9097965837933973,0.3380064300012806
24822,0.623,6,10,6,507402,98208,57813,50143,0.9097039534625218,0.33800244015881253
24823,0.6230238095238095,0,3,0,507405,98205,57813,50143,0.9096761643632592,0.33800927548736753
24824,0.6230476190476191,0,1,0,507406,98204,57813,50143,0.9096669013301716,0.3380115539916547
24825,0.6230833333333333,0,2,0,507408,98202,57813,50143,0.9096483752639964,0.338016111092386
24826,0.6230952380952381,0,3,0,507411,98199,57813,50143,0.9096205861647337,0.3380229469738847
24827,0.6231190476190476,0,1,0,507412,98198,57813,50143,0.9096113231316463,0.3380252256624938
24828,0.6231428571428572,0,1,0,507413,98197,57813,50143,0.9096020600985587,0.33802750438182555
24829,0.6231666666666666,3,12,3,507425,98185,57816,50140,0.909490903701508,0.33804146300353954
24830,0.6231666666666668,0,1,0,507426,98184,57816,50140,0.9094816406684205,0.33804374207815324
24831,0.6231818181818182,0,1,0,507427,98183,57816,50140,0.909472377635333,0.3380460211834982
24832,0.6231904761904762,0,1,0,507428,98182,57816,50140,0.9094631146022454,0.338048300319575
24833,0.6232063492063492,0,1,0,507429,98181,57816,50140,0.9094538515691578,0.3380505794863843
24834,0.6232142857142857,0,4,0,507433,98177,57816,50140,0.9094167994368076,0.3380596964609586
24835,0.6232380952380951,0,2,0,507435,98175,57816,50140,0.9093982733706325,0.33806425513265687
24836,0.6232619047619048,0,1,0,507436,98174,57816,50140,0.9093890103375449,0.3380665345146109
24837,0.6232738095238095,0,2,0,507438,98172,57816,50140,0.9093704842713698,0.338071093370732
24838,0.6233095238095238,0,1,0,507439,98171,57816,50140,0.9093612212382822,0.33807337284490024
24839,0.6233333333333332,0,2,0,507441,98169,57816,50140,0.9093426951721072,0.3380779318854554
24840,0.6233333333333333,49,137,49,507578,98032,57865,50091,0.9080736596391122,0.33817165463837484
24841,0.6233333333333334,69,209,69,507787,97823,57934,50022,0.9061376857238134,0.3383408299232304
24842,0.6234166666666667,1,0,1,507787,97823,57935,50021,0.9061376857238134,0.33833635453586214
24843,0.6234285714285714,0,1,0,507788,97822,57935,50021,0.9061284226907258,0.33833864301996036
24844,0.6234444444444445,0,1,0,507789,97821,57935,50021,0.9061191596576383,0.3383409315350171
24845,0.6234999999999999,0,2,0,507791,97819,57935,50021,0.9061006335914632,0.33834550865800866
24846,0.6235,3,19,3,507810,97800,57938,50018,0.9059246359627997,0.3383755699576506
24847,0.6235555555555555,1,2,1,507812,97798,57939,50017,0.9059061098966246,0.33837567229306903
24848,0.6235714285714286,0,2,0,507814,97796,57939,50017,0.9058875838304494,0.3383802507221963
24849,0.6235714285714287,0,4,0,507818,97792,57939,50017,0.9058505316980993,0.3383894079521545
24850,0.6235964912280701,1,0,1,507818,97792,57940,50016,0.9058505316980993,0.33838493180342066
24851,0.623654761904762,0,1,0,507819,97791,57940,50016,0.9058412686650117,0.3383872211735574
24852,0.6236666666666666,1,3,1,507822,97788,57941,50015,0.905813479565749,0.33838961320135585
24853,0.6236666666666667,1,11,1,507833,97777,57942,50014,0.9057115862017859,0.3384103226854139
24854,0.6236666666666668,0,1,0,507834,97776,57942,50014,0.9057023231686984,0.33841261249069626
24855,0.6236904761904762,0,1,0,507835,97775,57942,50014,0.9056930601356108,0.33841490232696614
24856,0.6237142857142857,0,1,0,507836,97774,57942,50014,0.9056837971025232,0.33841719219422417
24857,0.6237272727272728,0,1,0,507837,97773,57942,50014,0.9056745340694357,0.3384194820924709
24858,0.6237424242424243,0,1,0,507838,97772,57942,50014,0.9056652710363482,0.3384217720217071
24859,0.62375,1,4,1,507842,97768,57943,50013,0.9056282189039979,0.33842645536300336
24860,0.6238095238095237,0,1,0,507843,97767,57943,50013,0.9056189558709103,0.33842874543239954
24861,0.6238095238095238,0,2,0,507845,97765,57943,50013,0.9056004298047352,0.33843332566417195
24862,0.6238333333333332,1,2,1,507847,97763,57944,50012,0.9055819037385602,0.33843342919979696
24863,0.6238333333333334,0,15,0,507862,97748,57944,50012,0.9054429582422469,0.33846778559826746
24864,0.6238571428571429,0,1,0,507863,97747,57944,50012,0.9054336952091593,0.3384700762728497
24865,0.6239166666666667,0,1,0,507864,97746,57944,50012,0.9054244321760717,0.3384723669784377
24866,0.6239285714285714,1,0,1,507864,97746,57945,50011,0.9054244321760717,0.3384678898461663
24867,0.623952380952381,0,1,0,507865,97745,57945,50011,0.9054151691429841,0.3384701805679634
24868,0.6239774114774115,1,0,1,507865,97745,57946,50010,0.9054151691429841,0.33846570336029236
24869,0.6239999999999999,0,3,0,507868,97742,57946,50010,0.9053873800437215,0.33847257566733446
24870,0.624,17,47,17,507915,97695,57963,49993,0.9049520174886064,0.3385041438708629
24871,0.6240000000000001,1,1,1,507916,97694,57964,49992,0.9049427544555189,0.3385019568544073
24872,0.6240238095238095,1,0,1,507916,97694,57965,49991,0.9049427544555189,0.338497477739784
24873,0.6240476190476191,0,1,0,507917,97693,57965,49991,0.9049334914224314,0.3384997697787167
24874,0.6240714285714285,0,1,0,507918,97692,57965,49991,0.9049242283893438,0.3385020618486894
24875,0.6240714285714286,1,2,1,507920,97690,57966,49990,0.9049057023231687,0.3385021668472373
24876,0.6240952380952381,0,1,0,507921,97689,57966,49990,0.9048964392900811,0.33850445899552406
24877,0.6241666666666665,1,1,1,507922,97688,57967,49989,0.9048871762569936,0.3385022718500511
24878,0.6241666666666666,17,64,17,507986,97624,57984,49972,0.9042943421393901,0.33857286105314505
24879,0.6241666666666668,6,32,6,508018,97592,57990,49966,0.9039979250805884,0.3386193903414251
24880,0.6241676656676657,0,1,0,508019,97591,57990,49966,0.9039886620475008,0.33862168517928665
24881,0.6241904761904762,1,1,1,508020,97590,57991,49965,0.9039793990144133,0.3386194978143743
24882,0.6241904761904763,0,2,0,508022,97588,57991,49965,0.9039608729482381,0.3386240876159753
24883,0.6241991341991341,0,1,0,508023,97587,57991,49965,0.9039516099151507,0.33862638256343525
24884,0.6242857142857143,2,8,2,508031,97579,57993,49963,0.9038775056504502,0.3386357782868607
24885,0.6242878787878787,1,1,1,508032,97578,57994,49962,0.9038682426173626,0.33863359089060596
24886,0.6243055555555557,0,1,0,508033,97577,57994,49962,0.9038589795842751,0.338635886104691
24887,0.6243333333333333,2,13,2,508046,97564,57996,49960,0.9037385601541369,0.33865676093381414
24888,0.6243333333333334,5,8,5,508054,97556,58001,49955,0.9036644558894364,0.33865271064530783
24889,0.6243571428571429,0,2,0,508056,97554,58001,49955,0.9036459298232613,0.3386573022663024
24890,0.6244642857142857,0,1,0,508057,97553,58001,49955,0.9036366667901737,0.3386595981234916
24891,0.6244642857142858,0,1,0,508058,97552,58001,49955,0.9036274037570862,0.3386618940118096
24892,0.6244999999999999,0,1,0,508059,97551,58001,49955,0.9036181407239987,0.338664189931257
24893,0.6245,3,11,3,508070,97540,58004,49952,0.9035162473600356,0.338675995986223
24894,0.6245039682539683,0,2,0,508072,97538,58004,49952,0.9034977212938604,0.3386805885144756
24895,0.6245119047619049,2,1,2,508073,97537,58006,49950,0.903488458260773,0.33867391702319527
24896,0.6245238095238094,0,1,0,508074,97536,58006,49950,0.9034791952276854,0.338676213335503
24897,0.6245238095238095,1,0,1,508074,97536,58007,49949,0.9034791952276854,0.3386717293284063
24898,0.6245833333333334,1,2,1,508076,97534,58008,49948,0.9034606691615102,0.3386718379192037
24899,0.6246428571428572,1,1,1,508077,97533,58009,49947,0.9034514061284227,0.33866965012205047
24900,0.6246666666666666,2,12,2,508089,97521,58011,49945,0.9033402497313721,0.338688240001085
24901,0.6246666666666667,2,10,2,508099,97511,58013,49943,0.9032476194004965,0.338702239342439
24902,0.6246904761904762,0,2,0,508101,97509,58013,49943,0.9032290933343214,0.33870683341019453
24903,0.6247142857142857,1,2,1,508103,97507,58014,49942,0.9032105672681463,0.3387069427395235
24904,0.6247222222222222,0,1,0,508104,97506,58014,49942,0.9032013042350587,0.33870923986761436
24905,0.6247301587301587,1,0,1,508104,97506,58015,49941,0.9032013042350587,0.3387047549288897
24906,0.6247619047619047,0,1,0,508105,97505,58015,49941,0.9031920412019712,0.33870705207330143
24907,0.6248095238095237,0,1,0,508106,97504,58015,49941,0.9031827781688836,0.33870934924887247
24908,0.6248333333333332,0,2,0,508108,97502,58015,49941,0.9031642521027086,0.3387139436934951
24909,0.6248333333333334,2,10,2,508118,97492,58017,49939,0.903071621771833,0.33872794731094547
24910,0.6248412698412698,0,1,0,508119,97491,58017,49939,0.9030623587387454,0.3387302448619684
24911,0.6248809523809524,0,1,0,508120,97490,58017,49939,0.9030530957056578,0.33873254244415957
24912,0.6248888888888889,1,0,1,508120,97490,58018,49938,0.9030530957056578,0.3387280570854926
24913,0.6249285714285714,1,0,1,508120,97490,58019,49937,0.9030530957056578,0.33872357166597705
24914,0.6249444444444444,0,1,0,508121,97489,58019,49937,0.9030438326725703,0.3387258692496575
24915,0.6249523809523809,0,1,0,508122,97488,58019,49937,0.9030345696394827,0.33872816686450735
24916,0.624952380952381,1,0,1,508122,97488,58020,49936,0.9030345696394827,0.3387236813544606
24917,0.6249761904761905,0,1,0,508123,97487,58020,49936,0.9030253066063952,0.33872597898563994
24918,0.6249920634920634,1,0,1,508123,97487,58021,49935,0.9030253066063952,0.3387214933998996
24919,0.6249999999999999,3,17,3,508140,97470,58024,49932,0.9028678350439068,0.33874709976798145
24920,0.625,183,663,183,508803,96807,58207,49749,0.8967264441068583,0.3394538606403013
24921,0.6250000000000001,6,10,6,508813,96797,58213,49743,0.8966338137759828,0.339449979527774
24922,0.6250238095238094,0,1,0,508814,96796,58213,49743,0.8966245507428953,0.33945229597581533
24923,0.625047619047619,0,2,0,508816,96794,58213,49743,0.8966060246767201,0.3394569289667456
24924,0.6251190476190476,1,2,1,508818,96792,58214,49742,0.896587498610545,0.3394570543355126
24925,0.6251428571428571,0,1,0,508819,96791,58214,49742,0.8965782355774575,0.33945937092668543
24926,0.6251428571428572,0,1,0,508820,96790,58214,49742,0.89656897254437,0.33946168754947725
24927,0.6251666666666665,0,1,0,508821,96789,58214,49742,0.8965597095112824,0.3394640042038886
24928,0.6251666666666666,1,2,1,508823,96787,58215,49741,0.8965411834451072,0.3394641297226469
24929,0.6251666666666668,0,7,0,508830,96780,58215,49741,0.8964763422134944,0.33948034752697565
24930,0.6252222222222222,0,1,0,508831,96779,58215,49741,0.8964670791804068,0.3394826644826645
24931,0.6252380952380953,1,4,1,508835,96775,58216,49740,0.8964300270480566,0.3394874244957854
24932,0.6252543290043291,1,2,1,508837,96773,58217,49739,0.8964115009818815,0.3394875505078082
24933,0.6252777777777777,0,3,0,508840,96770,58217,49739,0.8963837118826189,0.33949450204424303
24934,0.6252777777777778,0,2,0,508842,96768,58217,49739,0.8963651858164438,0.33949913656002784
24935,0.625297619047619,0,1,0,508843,96767,58217,49739,0.8963559227833562,0.33950145386537073
24936,0.6253333333333333,3,14,3,508857,96753,58220,49736,0.8962262403201304,0.339520373543406
24937,0.6253333333333334,1,7,1,508864,96746,58221,49735,0.8961613990885176,0.33953208948600844
24938,0.6253373015873016,0,1,0,508865,96745,58221,49735,0.89615213605543,0.3395344074276352
24939,0.6253809523809524,0,1,0,508866,96744,58221,49735,0.8961428730223424,0.33953672540091073
24940,0.6254166666666666,0,1,0,508867,96743,58221,49735,0.8961336099892548,0.3395390434058357
24941,0.6254166666666667,0,1,0,508868,96742,58221,49735,0.8961243469561673,0.33954136144241076
24942,0.6254285714285713,1,2,1,508870,96740,58222,49734,0.8961058208899922,0.339541488591832
24943,0.625452380952381,1,0,1,508870,96740,58223,49733,0.8961058208899922,0.33953697951158235
24944,0.6254523809523811,0,1,0,508871,96739,58223,49733,0.8960965578569047,0.3395392976131957
24945,0.6254545454545455,0,1,0,508872,96738,58223,49733,0.8960872948238171,0.33954161574646174
24946,0.6254761904761904,0,1,0,508873,96737,58223,49733,0.8960780317907295,0.33954393391138116
24947,0.6254761904761905,0,2,0,508875,96735,58223,49733,0.8960595057245544,0.33954857033618263
24948,0.6255,3,7,3,508882,96728,58226,49730,0.8959946644929415,0.3395512706714553
24949,0.6255000000000001,1,2,1,508884,96726,58227,49729,0.8959761384267665,0.33955139804035367
24950,0.6255238095238096,0,1,0,508885,96725,58227,49729,0.8959668753936789,0.33955371652532534
24951,0.625531746031746,0,1,0,508886,96724,58227,49729,0.8959576123605913,0.33955603504195886
24952,0.6255357142857143,1,0,1,508886,96724,58228,49728,0.8959576123605913,0.33955152541447026
24953,0.625547619047619,2,2,2,508888,96722,58230,49726,0.8959390862944162,0.3395471430132197
24954,0.6255476190476191,0,1,0,508889,96721,58230,49726,0.8959298232613286,0.33954946157995725
24955,0.6255555555555555,0,3,0,508892,96718,58230,49726,0.895902034162066,0.33955641747015924
24956,0.6255833333333333,1,0,1,508892,96718,58231,49725,0.895902034162066,0.3395519075681323
24957,0.625595238095238,1,1,1,508893,96717,58232,49724,0.8958927711289785,0.3395497162679851
24958,0.6256309523809523,1,0,1,508893,96717,58233,49723,0.8958927711289785,0.3395452062278066
24959,0.6256349206349208,0,1,0,508894,96716,58233,49723,0.8958835080958909,0.3395475249079822
24960,0.6256666666666666,5,20,5,508914,96696,58238,49718,0.8956982474341398,0.3395713524662942
24961,0.6256666666666667,1,2,1,508916,96694,58239,49717,0.8956797213679647,0.33957148028495127
24962,0.6256666666666668,0,1,0,508917,96693,58239,49717,0.8956704583348771,0.3395737996038522
24963,0.6257142857142857,2,6,2,508923,96687,58241,49715,0.8956148801363518,0.33957869428013276
24964,0.6257777777777778,0,1,0,508924,96686,58241,49715,0.8956056171032643,0.3395810137908894
24965,0.6258095238095239,0,1,0,508925,96685,58241,49715,0.8955963540701768,0.33958333333333335
24966,0.6258333333333332,7,26,7,508951,96659,58248,49708,0.8953555152099003,0.33961207102693913
24967,0.6258333333333334,7,43,7,508994,96616,58255,49701,0.8949572047871355,0.3396802832206784
24968,0.6258333333333335,2,1,2,508995,96615,58257,49699,0.8949479417540479,0.3396735787416105
24969,0.6258571428571428,0,1,0,508996,96614,58257,49699,0.8949386787209604,0.3396759002959409
24970,0.6258571428571429,0,1,0,508997,96613,58257,49699,0.8949294156878729,0.3396782218820056
24971,0.6258809523809523,0,3,0,509000,96610,58257,49699,0.8949016265886102,0.33968518683061194
24972,0.6258888888888889,0,1,0,509001,96609,58257,49699,0.8948923635555226,0.3396875085436203
24973,0.6259166666666667,0,1,0,509002,96608,58257,49699,0.894883100522435,0.33968983028836625
24974,0.625952380952381,1,3,1,509005,96605,58258,49698,0.8948553114231724,0.33969228245490524
24975,0.6259722222222223,1,0,1,509005,96605,58259,49697,0.8948553114231724,0.33968776913507676
24976,0.6259999999999999,1,6,1,509011,96599,58260,49696,0.8947997332246471,0.33969718719026626
24977,0.626,20,61,20,509072,96538,58280,49676,0.8942346882063062,0.33974858768654165
24978,0.6260000000000001,0,3,0,509075,96535,58280,49676,0.8942068991070437,0.33975555874728985
24979,0.6260238095238094,0,1,0,509076,96534,58280,49676,0.8941976360739561,0.33975788249777716
24980,0.626047619047619,0,1,0,509077,96533,58280,49676,0.8941883730408685,0.33976020628005116
24981,0.6260952380952381,0,2,0,509079,96531,58280,49676,0.8941698469746934,0.3397648539399618
24982,0.6261111111111111,0,1,0,509080,96530,58280,49676,0.8941605839416058,0.33976717781759985
24983,0.6261111111111112,0,2,0,509082,96528,58280,49676,0.8941420578754308,0.3397718256682444
24984,0.6261190476190476,0,1,0,509083,96527,58280,49676,0.8941327948423432,0.33977414964125224
24985,0.6261428571428572,0,1,0,509084,96526,58280,49676,0.8941235318092556,0.33977647364605135
24986,0.6261666666666666,1,7,1,509091,96519,58281,49675,0.8940586905776428,0.33978822660300695
24987,0.6261904761904762,0,1,0,509092,96518,58281,49675,0.8940494275445552,0.3397905508471678
24988,0.6262023809523809,0,1,0,509093,96517,58281,49675,0.8940401645114676,0.3397928751231257
24989,0.62625,1,5,1,509098,96512,58282,49674,0.8939938493460299,0.33979998084631907
24990,0.6263095238095238,0,1,0,509099,96511,58282,49674,0.8939845863129423,0.3398023052980812
24991,0.626309523809524,1,1,1,509100,96510,58283,49673,0.8939753232798547,0.33980011355629586
24992,0.6263333333333333,1,18,1,509118,96492,58284,49672,0.8938085886842788,0.3398374428723899
24993,0.6263333333333334,0,2,0,509120,96490,58284,49672,0.8937900626181037,0.3398420930200736
24994,0.6263571428571428,0,1,0,509121,96489,58284,49672,0.8937807995850161,0.33984441814163835
24995,0.626357142857143,0,1,0,509122,96488,58284,49672,0.8937715365519285,0.3398467432950192
24996,0.6263809523809524,0,1,0,509123,96487,58284,49672,0.893762273518841,0.33984906848021673
24997,0.6263928571428571,0,1,0,509124,96486,58284,49672,0.8937530104857535,0.3398513936972318
24998,0.6264166666666667,0,1,0,509125,96485,58284,49672,0.8937437474526659,0.33985371894606486
24999,0.6264285714285713,0,1,0,509126,96484,58284,49672,0.8937344844195784,0.33985604422671667
25000,0.6264523809523809,1,0,1,509126,96484,58285,49671,0.8937344844195784,0.3398515274879409
25001,0.626452380952381,0,1,0,509127,96483,58285,49671,0.8937252213864908,0.33985385278541813
25002,0.6264761904761905,0,1,0,509128,96482,58285,49671,0.8937159583534032,0.3398561781147154
25003,0.6264880952380952,0,1,0,509129,96481,58285,49671,0.8937066953203157,0.3398585034758334
25004,0.6265,2,11,2,509140,96470,58287,49669,0.8936048019563526,0.3398750504656526
25005,0.6265000000000001,1,6,1,509146,96464,58288,49668,0.8935492237578273,0.33988448799715326
25006,0.6265238095238095,0,1,0,509147,96463,58288,49668,0.8935399607247397,0.33988681388617065
25007,0.626547619047619,0,2,0,509149,96461,58288,49668,0.8935214346585646,0.33989146575970547
25008,0.6265555555555555,0,1,0,509150,96460,58288,49668,0.893512171625477,0.33989379174422424
25009,0.626611111111111,0,1,0,509151,96459,58288,49668,0.8935029085923895,0.33989611776057815
25010,0.6266547619047619,1,0,1,509151,96459,58289,49667,0.8935029085923895,0.3398916003996551
25011,0.6266570374070374,0,4,0,509155,96455,58289,49667,0.8934658564600393,0.33990090472345025
25012,0.6266666666666666,86,225,86,509380,96230,58375,49581,0.8913816740153396,0.3400360740959187
25013,0.6266666666666667,31,117,31,509497,96113,58406,49550,0.8902978991440957,0.3401687456663669
25014,0.6266666666666668,0,1,0,509498,96112,58406,49550,0.8902886361110082,0.34017108099572985
25015,0.6266904761904761,0,4,0,509502,96108,58406,49550,0.890251583978658,0.3401804226338409
25016,0.6266944444444444,0,1,0,509503,96107,58406,49550,0.8902423209455704,0.3401827581235368
25017,0.6267142857142858,0,1,0,509504,96106,58406,49550,0.8902330579124829,0.34018509364530125
25018,0.6267460317460317,0,1,0,509505,96105,58406,49550,0.8902237948793953,0.3401874291991349
25019,0.6267499999999999,1,1,1,509506,96104,58407,49549,0.8902145318463077,0.34018523477031026
25020,0.62675,0,1,0,509507,96103,58407,49549,0.8902052688132202,0.34018757037321834
25021,0.6267857142857143,0,1,0,509508,96102,58407,49549,0.8901960057801327,0.34018990600819765
25022,0.6268095238095238,0,2,0,509510,96100,58407,49549,0.8901774797139576,0.34019457737437264
25023,0.6268333333333332,0,1,0,509511,96099,58407,49549,0.89016821668087,0.3401969131055696
25024,0.6268333333333334,6,16,6,509527,96083,58413,49543,0.8900200081514691,0.3402071058739511
25025,0.6268690476190476,0,3,0,509530,96080,58413,49543,0.8899922190522065,0.34021411452861156
25026,0.6268809523809523,0,2,0,509532,96078,58413,49543,0.8899736929860314,0.34021878712548326
25027,0.6269025974025972,0,3,0,509535,96075,58413,49543,0.8899459038867686,0.3402257962614512
25028,0.6269047619047619,0,2,0,509537,96073,58413,49543,0.8899273778205936,0.34023046917921107
25029,0.6269285714285714,0,2,0,509539,96071,58413,49543,0.8899088517544185,0.34023514222533546
25030,0.6269444444444444,0,1,0,509540,96070,58413,49543,0.8898995887213309,0.34023747879653604
25031,0.626968253968254,1,2,1,509542,96068,58414,49542,0.8898810626551558,0.3402376210425108
25032,0.627,11,26,11,509568,96042,58425,49531,0.8896402237948794,0.3402485350992286
25033,0.6270000000000001,1,3,1,509571,96039,58426,49530,0.8896124346956167,0.3402510149825856
25034,0.6270238095238095,1,0,1,509571,96039,58427,49529,0.8896124346956167,0.3402464827434601
25035,0.6270357142857143,1,1,1,509572,96038,58428,49528,0.8896031716625292,0.34024428781446214
25036,0.6270595238095239,0,1,0,509573,96037,58428,49528,0.8895939086294417,0.34024662521897436
25037,0.6270833333333333,0,1,0,509574,96036,58428,49528,0.8895846455963541,0.34024896265560167
25038,0.6270910587950062,0,3,0,509577,96033,58428,49528,0.8895568564970914,0.3402559751581811
25039,0.6271428571428571,0,7,0,509584,96026,58428,49528,0.8894920152654785,0.34027233878835345
25040,0.6271666666666667,6,13,6,509597,96013,58434,49522,0.8893715958353403,0.34027553509465075
25041,0.6271666666666668,0,1,0,509598,96012,58434,49522,0.8893623328022527,0.34027787321175806
25042,0.6271904761904762,1,0,1,509598,96012,58435,49521,0.8893623328022527,0.3402733400672013
25043,0.6272142857142857,0,2,0,509600,96010,58435,49521,0.8893438067360777,0.34027801636764676
25044,0.6272500000000001,0,1,0,509601,96009,58435,49521,0.8893345437029901,0.34028035456606887
25045,0.6272727272727272,0,1,0,509602,96008,58435,49521,0.8893252806699026,0.3402826927966247
25046,0.6272727272727273,0,1,0,509603,96007,58435,49521,0.889316017636815,0.34028503105931507
25047,0.6272857142857143,0,1,0,509604,96006,58435,49521,0.8893067546037274,0.34028736935414045
25048,0.6273095238095238,0,2,0,509606,96004,58435,49521,0.8892882285375523,0.3402920460401993
25049,0.6273333333333333,5,19,5,509625,95985,58440,49516,0.8891122309088888,0.3403138122762043
25050,0.6273333333333334,0,4,0,509629,95981,58440,49516,0.8890751787765386,0.34032316817528885
25051,0.6273571428571428,2,0,2,509629,95981,58442,49514,0.8890751787765386,0.3403141001408983
25052,0.6273809523809524,0,2,0,509631,95979,58442,49514,0.8890566527103635,0.34031877822300727
25053,0.6274047619047619,0,1,0,509632,95978,58442,49514,0.8890473896772759,0.3403211173122921
25054,0.627437950937951,0,1,0,509633,95977,58442,49514,0.8890381266441884,0.3403234564337313
25055,0.6274444444444444,0,1,0,509634,95976,58442,49514,0.8890288636111008,0.34032579558732556
25056,0.6275,60,204,60,509838,95772,58502,49454,0.8871392048612398,0.34053130982055557
25057,0.6275000000000001,3,7,3,509845,95765,58505,49451,0.8870743636296269,0.34053410092551784
25058,0.6275119047619048,0,2,0,509847,95763,58505,49451,0.8870558375634517,0.3405387910256587
25059,0.6275238095238095,2,3,2,509850,95760,58507,49449,0.8870280484641891,0.3405367435902733
25060,0.6275952380952383,1,0,1,509850,95760,58508,49448,0.8870280484641891,0.3405322020825299
25061,0.6276120448179272,0,1,0,509851,95759,58508,49448,0.8870187854311016,0.3405345472325714
25062,0.6276190476190476,0,4,0,509855,95755,58508,49448,0.8869817332987513,0.34054392815575435
25063,0.6276489898989901,0,2,0,509857,95753,58508,49448,0.8869632072325763,0.3405486188111652
25064,0.6276666666666666,0,1,0,509858,95752,58508,49448,0.8869539441994887,0.34055096418732783
25065,0.6276666666666667,2,14,2,509872,95738,58510,49446,0.8868242617362629,0.3405747189772978
25066,0.6277142857142857,0,1,0,509873,95737,58510,49446,0.8868149987031754,0.3405770648078632
25067,0.6277222222222223,0,1,0,509874,95736,58510,49446,0.8868057356700878,0.3405794106707443
25068,0.62775,1,1,1,509875,95735,58511,49445,0.8867964726370002,0.34057721449235434
25069,0.6277857142857143,0,1,0,509876,95734,58511,49445,0.8867872096039127,0.34057956040474174
25070,0.6278095238095238,0,1,0,509877,95733,58511,49445,0.8867779465708252,0.3405819063494469
25071,0.6278333333333334,3,9,3,509886,95724,58514,49442,0.8866945792730372,0.3405893942107656
25072,0.6278333333333335,0,1,0,509887,95723,58514,49442,0.8866853162399496,0.34059174043330004
25073,0.6278571428571429,0,3,0,509890,95720,58514,49442,0.8866575271406869,0.34059877929485677
25074,0.6278809523809524,0,2,0,509892,95718,58514,49442,0.8866390010745119,0.3406034720308625
25075,0.6279166666666667,1,0,1,509892,95718,58515,49441,0.8866390010745119,0.34059892944977577
25076,0.6279444444444444,1,3,1,509895,95715,58516,49440,0.8866112119752492,0.340601426061796
25077,0.6279761904761905,0,3,0,509898,95712,58516,49440,0.8865834228759865,0.3406084656084656
25078,0.6279761904761906,0,1,0,509899,95711,58516,49440,0.886574159842899,0.3406108121886863
25079,0.628,16,46,16,509945,95665,58532,49424,0.8861480603208715,0.34064608619536973
25080,0.6280158730158729,0,1,0,509946,95664,58532,49424,0.8861387972877839,0.3406484340538156
25081,0.6280238095238095,1,0,1,509946,95664,58533,49423,0.8861387972877839,0.34064388952835195
25082,0.6280476190476191,1,0,1,509946,95664,58534,49422,0.8861387972877839,0.34063934494024234
25083,0.6280555555555556,0,1,0,509947,95663,58534,49422,0.8861295342546963,0.34064169280077194
25084,0.6280833333333333,0,1,0,509948,95662,58534,49422,0.8861202712216089,0.3406440406936671
25085,0.628095238095238,1,0,1,509948,95662,58535,49421,0.8861202712216089,0.3406394960126273
25086,0.6280952380952382,0,2,0,509950,95660,58535,49421,0.8861017451554337,0.3406441918652339
25087,0.6281190476190477,0,1,0,509951,95659,58535,49421,0.8860924821223461,0.34064653984008825
25088,0.6281356421356421,0,1,0,509952,95658,58535,49421,0.8860832190892586,0.3406488878473108
25089,0.6281666666666665,0,1,0,509953,95657,58535,49421,0.886073956056171,0.3406512358869022
25090,0.6281666666666667,3,13,3,509966,95644,58538,49418,0.8859535366260328,0.3406681281107389
25091,0.6281984126984126,0,1,0,509967,95643,58538,49418,0.8859442735929453,0.3406704765581376
25092,0.6282142857142857,0,2,0,509969,95641,58538,49418,0.8859257475267701,0.3406751735500727
25093,0.6282857142857143,1,1,1,509970,95640,58539,49417,0.8859164844936827,0.34067297682979797
25094,0.6283333333333332,0,1,0,509971,95639,58539,49417,0.8859072214605951,0.3406753253915729
25095,0.6283333333333333,27,62,27,510033,95577,58566,49390,0.8853329134091666,0.34069822787255033
25096,0.6283333333333334,47,134,47,510167,95443,58613,49343,0.8840916669754344,0.34079952481593523
25097,0.6283571428571428,1,0,1,510167,95443,58614,49342,0.8840916669754344,0.3407949718548192
25098,0.6283809523809524,0,2,0,510169,95441,58614,49342,0.8840731409092594,0.3407996795203857
25099,0.6284047619047618,1,0,1,510169,95441,58615,49341,0.8840731409092594,0.34079512646599713
25100,0.6284166666666666,0,1,0,510170,95440,58615,49341,0.8840638778761718,0.34079748033236407
25101,0.6284285714285714,0,2,0,510172,95438,58615,49341,0.8840453518099967,0.3408021881626479
25102,0.6284444444444445,0,1,0,510173,95437,58615,49341,0.8840360887769091,0.3408045421265662
25103,0.628452380952381,0,2,0,510175,95435,58615,49341,0.884017562710734,0.3408092501519589
25104,0.6284780497280498,1,5,1,510180,95430,58616,49340,0.8839712475452962,0.3408164675001727
25105,0.6285,0,1,0,510181,95429,58616,49340,0.8839619845122086,0.3408188217090676
25106,0.6285000000000001,5,18,5,510199,95411,58621,49335,0.8837952499166327,0.3408384342227074
25107,0.6285238095238096,0,5,0,510204,95406,58621,49335,0.883748934751195,0.3408502083031069
25108,0.6285714285714286,0,4,0,510208,95402,58621,49335,0.8837118826188447,0.3408596281531329
25109,0.6285952380952381,0,1,0,510209,95401,58621,49335,0.8837026195857571,0.3408619831969931
25110,0.6286190476190476,0,1,0,510210,95400,58621,49335,0.8836933565526696,0.3408643382733962
25111,0.6286666666666666,4,3,4,510213,95397,58625,49331,0.883665567453407,0.34085318666740366
25112,0.6286666666666667,4,15,4,510228,95382,58629,49327,0.8835266219570936,0.340870298322841
25113,0.6286904761904761,0,1,0,510229,95381,58629,49327,0.8835173589240061,0.34087265389612187
25114,0.62875,0,1,0,510230,95380,58629,49327,0.8835080958909185,0.34087500950195915
25115,0.6287727272727274,0,1,0,510231,95379,58629,49327,0.8834988328578309,0.34087736514035355
25116,0.6287777777777778,0,1,0,510232,95378,58629,49327,0.8834895698247434,0.34087972081130574
25117,0.6287857142857143,0,2,0,510234,95376,58629,49327,0.8834710437585683,0.34088443225088627
25118,0.6288015873015873,0,3,0,510237,95373,58629,49327,0.8834432546593056,0.3408914996544575
25119,0.6288095238095238,0,2,0,510239,95371,58629,49327,0.8834247285931305,0.34089621141964643
25120,0.6288333333333332,3,2,3,510241,95369,58632,49324,0.8834062025269555,0.3408872578493776
25121,0.6288333333333334,4,10,4,510251,95359,58636,49320,0.8833135721960799,0.34089259671410505
25122,0.6288571428571429,0,3,0,510254,95356,58636,49320,0.8832857830968173,0.3408996654593713
25123,0.6288809523809523,1,0,1,510254,95356,58637,49319,0.8832857830968173,0.34089510972870224
25124,0.6288888888888888,1,1,1,510255,95355,58638,49318,0.8832765200637297,0.34089291021821627
25125,0.6289165001665001,0,1,0,510256,95354,58638,49318,0.8832672570306421,0.3408952665339527
25126,0.6289523809523808,0,1,0,510257,95353,58638,49318,0.8832579939975546,0.3408976228822639
25127,0.6289999999999999,0,2,0,510259,95351,58638,49318,0.8832394679313794,0.3409023356766135
25128,0.629,11,38,11,510297,95313,58649,49307,0.8828874726740524,0.34094177845387913
25129,0.6290238095238095,0,5,0,510302,95308,58649,49307,0.8828411575086146,0.340953566365868
25130,0.629047619047619,0,1,0,510303,95307,58649,49307,0.882831894475527,0.34095592404608127
25131,0.6290476190476191,0,3,0,510306,95304,58649,49307,0.8828041053762644,0.3409629972823644
25132,0.6290669330669331,0,3,0,510309,95301,58649,49307,0.8827763162770017,0.3409700708121266
25133,0.6290714285714286,0,1,0,510310,95300,58649,49307,0.8827670532439141,0.34097242872060135
25134,0.6291666666666665,0,3,0,510313,95297,58649,49307,0.8827392641446515,0.34097950264169735
25135,0.6291666666666667,10,45,10,510358,95252,58659,49297,0.8823224276557116,0.34104006253934654
25136,0.6291666666666668,4,24,4,510382,95228,58663,49293,0.8821001148616103,0.34107845918586227
25137,0.6291904761904762,0,2,0,510384,95226,58663,49293,0.8820815887954352,0.3410831793743383
25138,0.6292619047619047,0,1,0,510385,95225,58663,49293,0.8820723257623476,0.34108553951756876
25139,0.6292619047619048,0,2,0,510387,95223,58663,49293,0.8820537996961725,0.34109025990201775
25140,0.6292857142857143,1,7,1,510394,95216,58664,49292,0.8819889584645596,0.3411022227143134
25141,0.6292976190476189,1,2,1,510396,95214,58665,49291,0.8819704323983846,0.3411023840005536
25142,0.6293095238095239,0,1,0,510397,95213,58665,49291,0.881961169365297,0.3411047445053424
25143,0.6293333333333333,4,14,4,510411,95199,58669,49287,0.8818314869020712,0.3411195548357626
25144,0.6293333333333334,5,31,5,510442,95168,58674,49282,0.881544332876357,0.3411699550017307
25145,0.6293412698412699,0,1,0,510443,95167,58674,49282,0.8815350698432695,0.34117231687308325
25146,0.6293809523809525,0,1,0,510444,95166,58674,49282,0.8815258068101819,0.3411746787771378
25147,0.629388888888889,0,2,0,510446,95164,58674,49282,0.8815072807440069,0.3411794026833557
25148,0.6294047619047619,0,1,0,510447,95163,58674,49282,0.8814980177109193,0.3411817646855204
25149,0.6295,0,1,0,510448,95162,58674,49282,0.8814887546778317,0.3411841267203899
25150,0.6295000000000001,3,11,3,510459,95151,58677,49279,0.8813868613138686,0.3411964273350412
25151,0.6295238095238095,1,0,1,510459,95151,58678,49278,0.8813868613138686,0.34119186589950773
25152,0.6295238095238096,0,1,0,510460,95150,58678,49278,0.8813775982807811,0.3411942282659872
25153,0.6295714285714286,0,1,0,510461,95149,58678,49278,0.8813683352476935,0.3411965906651803
25154,0.6295833333333333,1,2,1,510463,95147,58679,49277,0.8813498091815184,0.3411967540021049
25155,0.629634199134199,0,1,0,510464,95146,58679,49277,0.8813405461484308,0.3411991164842165
25156,0.6296428571428572,0,2,0,510466,95144,58679,49277,0.8813220200822557,0.3412038415465895
25157,0.6296666666666666,3,8,3,510474,95136,58682,49274,0.8812479158175553,0.3412090575444914
25158,0.6296666666666667,1,8,1,510482,95128,58683,49273,0.8811738115528549,0.3412233987299257
25159,0.6297142857142857,0,1,0,510483,95127,58683,49273,0.8811645485197673,0.3412257617728532
25160,0.6297222222222222,0,1,0,510484,95126,58683,49273,0.8811552854866798,0.34122812484851
25161,0.6297499999999999,1,1,1,510485,95125,58684,49272,0.8811460224535922,0.3412259257463798
25162,0.6297539682539682,0,3,0,510488,95122,58684,49272,0.8811182333543296,0.34123301522223914
25163,0.6297619047619047,0,3,0,510491,95119,58684,49272,0.8810904442550669,0.34124010499269347
25164,0.6297619047619049,0,3,0,510494,95116,58684,49272,0.8810626551558042,0.341247195057761
25165,0.6297738095238096,0,2,0,510496,95114,58684,49272,0.8810441290896291,0.3412519219314892
25166,0.6297857142857142,0,2,0,510498,95112,58684,49272,0.881025603023454,0.3412566489361702
25167,0.6297857142857145,1,0,1,510498,95112,58685,49271,0.881025603023454,0.34125208646447297
25168,0.6298333333333332,2,2,2,510500,95110,58687,49269,0.8810070769572789,0.3412476883757333
25169,0.6298333333333334,5,5,5,510505,95105,58692,49264,0.8809607617918411,0.3412366920876365
25170,0.6298333333333335,0,1,0,510506,95104,58692,49264,0.8809514987587536,0.3412390557464258
25171,0.6298571428571428,2,1,2,510507,95103,58694,49262,0.880942235725666,0.3412322931458456
25172,0.6298571428571429,0,1,0,510508,95102,58694,49262,0.8809329726925784,0.3412346568396553
25173,0.6298809523809524,1,1,1,510509,95101,58695,49261,0.8809237096594909,0.34123245729485596
25174,0.6299166666666666,0,4,0,510513,95097,58695,49261,0.8808866575271407,0.34124191246761526
25175,0.6299285714285715,0,2,0,510515,95095,58695,49261,0.8808681314609655,0.34124664025049184
25176,0.6299404761904762,0,2,0,510517,95093,58695,49261,0.8808496053947905,0.3412513681643737
25177,0.6299523809523808,0,1,0,510518,95092,58695,49261,0.8808403423617029,0.3412537321704433
25178,0.6299880952380952,0,1,0,510519,95091,58695,49261,0.8808310793286154,0.3412560962092662
25179,0.6299999999999999,5,23,5,510542,95068,58700,49256,0.8806180295676016,0.34128765832432584
25180,0.63,578,1874,578,512416,93194,59278,48678,0.8632591055615251,0.3431121010488328
25181,0.6300000000000001,2,19,2,512435,93175,59280,48676,0.8630831079328616,0.34314879697710976
25182,0.6300595238095238,0,1,0,512436,93174,59280,48676,0.863073844899774,0.3431512160733169
25183,0.6300595238095239,0,1,0,512437,93173,59280,48676,0.8630645818666864,0.343153635203632
25184,0.630095238095238,0,1,0,512438,93172,59280,48676,0.8630553188335989,0.34315605436805596
25185,0.6301125541125541,0,3,0,512441,93169,59280,48676,0.8630275297343362,0.34316331206598755
25186,0.6301190476190476,0,1,0,512442,93168,59280,48676,0.8630182667012487,0.34316573136685374
25187,0.6301190476190477,0,1,0,512443,93167,59280,48676,0.8630090036681611,0.3431681507018323
25188,0.6301666666666667,2,2,2,512445,93165,59282,48674,0.862990477601986,0.3431637278886625
25189,0.6301666666666668,0,2,0,512447,93163,59282,48674,0.8629719515358109,0.343168566735055
25190,0.6301904761904762,0,2,0,512449,93161,59282,48674,0.8629534254696358,0.34317340571791166
25191,0.6301944444444445,1,0,1,512449,93161,59283,48673,0.8629534254696358,0.34316877476486596
25192,0.6302103174603174,0,1,0,512450,93160,59283,48673,0.8629441624365483,0.3431711942918785
25193,0.6302222222222222,0,1,0,512451,93159,59283,48673,0.8629348994034607,0.3431736138530092
25194,0.6302261904761904,0,1,0,512452,93158,59283,48673,0.8629256363703731,0.34317603344825887
25195,0.6302380952380952,1,3,1,512455,93155,59284,48672,0.8628978472711104,0.3431786613268277
25196,0.6302380952380953,2,1,2,512456,93154,59286,48670,0.862888584238023,0.34317181859205775
25197,0.6302380952380954,0,1,0,512457,93153,59286,48670,0.8628793212049354,0.3431742383111343
25198,0.63025,0,1,0,512458,93152,59286,48670,0.8628700581718478,0.3431766580643342
25199,0.6302777777777778,0,1,0,512459,93151,59286,48670,0.8628607951387602,0.3431790778516581
25200,0.6302857142857143,1,0,1,512459,93151,59287,48669,0.8628607951387602,0.34317444648145534
25201,0.6303333333333333,3,6,3,512465,93145,59290,48666,0.8628052169402349,0.34317507104526446
25202,0.6303333333333334,1,5,1,512470,93140,59291,48665,0.8627589017747972,0.3431825394027009
25203,0.6303809523809524,0,1,0,512471,93139,59291,48665,0.8627496387417096,0.34318495952159317
25204,0.6304047619047618,0,1,0,512472,93138,59291,48665,0.862740375708622,0.343187379674619
25205,0.6304166666666667,0,1,0,512473,93137,59291,48665,0.8627311126755345,0.3431897998617791
25206,0.6304444444444445,0,1,0,512474,93136,59291,48665,0.8627218496424469,0.34319222008307415
25207,0.6304523809523809,0,5,0,512479,93131,59291,48665,0.8626755344770092,0.3432043217015995
25208,0.6304761904761905,2,4,2,512483,93127,59293,48663,0.8626384823446589,0.34320473940334295
25209,0.6305,2,12,2,512495,93115,59295,48661,0.8625273259476083,0.34322452319151336
25210,0.6305000000000001,0,1,0,512496,93114,59295,48661,0.8625180629145207,0.3432269441015694
25211,0.6305238095238095,0,1,0,512497,93113,59295,48661,0.8625087998814331,0.34322936504577706
25212,0.6305238095238096,1,0,1,512497,93113,59296,48660,0.8625087998814331,0.3432247324949038
25213,0.630548330754213,1,1,1,512498,93112,59297,48659,0.8624995368483456,0.3432225208258389
25214,0.6305833333333334,0,1,0,512499,93111,59297,48659,0.8624902738152581,0.3432249418071524
25215,0.6306190476190477,0,1,0,512500,93110,59297,48659,0.8624810107821705,0.3432273628226199
25216,0.6306428571428572,0,1,0,512501,93109,59297,48659,0.862471747749083,0.34322978387224196
25217,0.6306583971583971,0,1,0,512502,93108,59297,48659,0.8624624847159954,0.34323220495601936
25218,0.6306666666666666,1,17,1,512519,93091,59298,48658,0.8623050131535069,0.34326873558190885
25219,0.6306666666666667,4,7,4,512526,93084,59302,48654,0.8622401719218941,0.3432671548914194
25220,0.6306666666666668,1,0,1,512526,93084,59303,48653,0.8622401719218941,0.3432625214305368
25221,0.630702380952381,0,2,0,512528,93082,59303,48653,0.862221645855719,0.343267365153279
25222,0.6307142857142857,0,4,0,512532,93078,59303,48653,0.8621845937233688,0.3432770530088689
25223,0.6307142857142858,3,0,3,512532,93078,59306,48650,0.8621845937233688,0.3432631519530368
25224,0.6307272727272727,0,1,0,512533,93077,59306,48650,0.8621753306902812,0.34326557395556245
25225,0.63075,0,1,0,512534,93076,59306,48650,0.8621660676571937,0.34326799599226676
25226,0.6308333333333332,7,23,7,512557,93053,59313,48643,0.86195301789618,0.3432912714543812
25227,0.6308333333333334,16,36,16,512593,93017,59329,48627,0.861619548705028,0.34330434045917935
25228,0.6308333333333335,1,3,1,512596,93014,59330,48626,0.8615917596057653,0.3433069754306693
25229,0.6309166666666666,0,2,0,512598,93012,59330,48626,0.8615732335395903,0.3433118230983211
25230,0.6309523809523809,0,2,0,512600,93010,59330,48626,0.8615547074734151,0.3433166709028778
25231,0.630952380952381,0,1,0,512601,93009,59330,48626,0.8615454444403275,0.3433190948564973
25232,0.6309848484848485,0,1,0,512602,93008,59330,48626,0.86153618140724,0.3433215188443453
25233,0.6309999999999999,0,4,0,512606,93004,59330,48626,0.8614991292748898,0.3433312151380357
25234,0.631,8,39,8,512645,92965,59338,48618,0.8611378709844751,0.3433886836696496
25235,0.6310000000000001,1,0,1,512645,92965,59339,48617,0.8611378709844751,0.3433840459945473
25236,0.6310238095238095,0,1,0,512646,92964,59339,48617,0.8611286079513876,0.34338647134855665
25237,0.6310555555555556,0,1,0,512647,92963,59339,48617,0.8611193449183,0.3433888967368272
25238,0.6310833333333332,0,3,0,512650,92960,59339,48617,0.8610915558190374,0.34339617310721376
25239,0.631095238095238,0,1,0,512651,92959,59339,48617,0.8610822927859498,0.3433985986325366
25240,0.6311111111111111,0,1,0,512652,92958,59339,48617,0.8610730297528623,0.3434010241921243
25241,0.6311428571428571,0,3,0,512655,92955,59339,48617,0.8610452406535997,0.34340830107648407
25242,0.6311666666666665,0,1,0,512656,92954,59339,48617,0.8610359776205121,0.34341072677313855
25243,0.6311666666666667,3,10,3,512666,92944,59342,48614,0.8609433472896365,0.34342107122169
25244,0.6311666666666668,0,1,0,512667,92943,59342,48614,0.8609340842565489,0.3434234972484582
25245,0.6311785714285715,0,2,0,512669,92941,59342,48614,0.8609155581903739,0.343428349404825
25246,0.6311904761904761,1,0,1,512669,92941,59343,48613,0.8609155581903739,0.34342371109258657
25247,0.6311904761904762,0,1,0,512670,92940,59343,48613,0.8609062951572863,0.3434261372065587
25248,0.6312142857142857,1,0,1,512670,92940,59344,48612,0.8609062951572863,0.343421498813157
25249,0.6312301587301588,0,1,0,512671,92939,59344,48612,0.8608970321241988,0.3434239249457793
25250,0.63125,1,2,1,512673,92937,59345,48611,0.8608785060580236,0.34342413880803685
25251,0.6312609890109888,1,2,1,512675,92935,59346,48610,0.8608599799918485,0.34342435267935995
25252,0.6312857142857143,0,1,0,512676,92934,59346,48610,0.860850716958761,0.343426778952128
25253,0.6313095238095239,0,1,0,512677,92933,59346,48610,0.8608414539256735,0.3434292052591792
25254,0.6313333333333333,4,20,4,512697,92913,59350,48606,0.8606561932639223,0.34345918215928606
25255,0.6313333333333334,0,1,0,512698,92912,59350,48606,0.8606469302308348,0.3434616091239277
25256,0.631345238095238,0,1,0,512699,92911,59350,48606,0.8606376671977473,0.34346403612286863
25257,0.6313571428571428,0,1,0,512700,92910,59350,48606,0.8606284041646597,0.34346646315610957
25258,0.6313809523809524,0,2,0,512702,92908,59350,48606,0.8606098780984845,0.3434713173254943
25259,0.6313888888888889,0,1,0,512703,92907,59350,48606,0.860600615065397,0.3434737444616396
25260,0.6314047619047619,0,1,0,512704,92906,59350,48606,0.8605913520323094,0.3434761716320877
25261,0.6314285714285715,0,4,0,512708,92902,59350,48606,0.8605542998999592,0.343485880656924
25262,0.631452380952381,0,1,0,512709,92901,59350,48606,0.8605450368668717,0.34348830799889757
25263,0.6314999999999998,1,0,1,512709,92901,59351,48605,0.8605450368668717,0.34348366853702317
25264,0.6315,6,9,6,512718,92892,59357,48599,0.8604616695690837,0.34347767702539383
25265,0.6315000000000001,0,1,0,512719,92891,59357,48599,0.8604524065359962,0.3434801046010319
25266,0.6316666666666666,48,125,48,512844,92766,59405,48551,0.8592945274000519,0.3435609303905404
25267,0.6316666666666667,19,55,19,512899,92711,59424,48532,0.8587850605802364,0.3436064088131801
25268,0.6316785714285714,0,1,0,512900,92710,59424,48532,0.8587757975471488,0.343608841562708
25269,0.6316886446886447,1,1,1,512901,92709,59425,48531,0.8587665345140613,0.34360662701784195
25270,0.6316944444444446,0,1,0,512902,92708,59425,48531,0.8587572714809737,0.3436090598205878
25271,0.6317449494949494,0,1,0,512903,92707,59425,48531,0.8587480084478861,0.3436114926577833
25272,0.6317857142857143,2,4,2,512907,92703,59427,48529,0.858710956315536,0.3436119293078056
25273,0.6318095238095239,0,1,0,512908,92702,59427,48529,0.8587016932824484,0.3436143622859004
25274,0.6318333333333332,2,6,2,512914,92696,59429,48527,0.8586461150839231,0.3436196653519611
25275,0.6318333333333334,0,3,0,512917,92693,59429,48527,0.8586183259846604,0.3436269650191191
25276,0.6319047619047619,1,2,1,512919,92691,59430,48526,0.8585997999184853,0.3436271836960139
25277,0.631904761904762,1,1,1,512920,92690,59431,48525,0.8585905368853978,0.3436249690188719
25278,0.6319166666666667,0,1,0,512921,92689,59431,48525,0.8585812738523102,0.3436274023822001
25279,0.6319166666666668,0,1,0,512922,92688,59431,48525,0.8585720108192226,0.34362983577999195
25280,0.6319563492063491,0,1,0,512923,92687,59431,48525,0.8585627477861351,0.34363226921224826
25281,0.632,17,47,17,512970,92640,59448,48508,0.8581273852310201,0.3436676396406609
25282,0.6320000000000001,0,2,0,512972,92638,59448,48508,0.8581088591648449,0.34367250931659415
25283,0.6320238095238095,0,2,0,512974,92636,59448,48508,0.8580903330986698,0.34367737913053337
25284,0.6320714285714284,0,2,0,512976,92634,59448,48508,0.8580718070324947,0.3436822490824843
25285,0.6320714285714285,0,1,0,512977,92633,59448,48508,0.8580625439994072,0.343684684110216
25286,0.6320833333333332,0,1,0,512978,92632,59448,48508,0.8580532809663196,0.34368711917245287
25287,0.6320833333333333,0,2,0,512980,92630,59448,48508,0.8580347549001445,0.34369198940044493
25288,0.6321111111111111,0,1,0,512981,92629,59448,48508,0.8580254918670569,0.34369442456620164
25289,0.6321190476190477,0,1,0,512982,92628,59448,48508,0.8580162288339694,0.3436968597664664
25290,0.6321388888888888,0,1,0,512983,92627,59448,48508,0.8580069658008819,0.34369929500123997
25291,0.6321428571428571,1,5,1,512988,92622,59449,48507,0.857960650635444,0.343706821418702
25292,0.6321666666666665,0,1,0,512989,92621,59449,48507,0.8579513876023566,0.34370925684485004
25293,0.6321666666666667,1,16,1,513005,92605,59450,48506,0.8578031790729557,0.34374357775084863
25294,0.6322142857142857,1,0,1,513005,92605,59451,48505,0.8578031790729557,0.34373892707816595
25295,0.6322222222222222,0,4,0,513009,92601,59451,48505,0.8577661269406054,0.34374867121171315
25296,0.6322619047619047,1,0,1,513009,92601,59452,48504,0.8577661269406054,0.34374402041033275
25297,0.6322619047619048,0,1,0,513010,92600,59452,48504,0.8577568639075179,0.34374645651434405
25298,0.6322692307692308,0,1,0,513011,92599,59452,48504,0.8577476008744304,0.3437488926528848
25299,0.6323333333333333,2,11,2,513022,92588,59454,48502,0.8576457075104672,0.34376639024735983
25300,0.6323333333333334,0,5,0,513027,92583,59454,48502,0.8575993923450295,0.3437785732005529
25301,0.6323809523809524,1,2,1,513029,92581,59455,48501,0.8575808662788543,0.34377879531052863
25302,0.6324285714285715,0,1,0,513030,92580,59455,48501,0.8575716032457668,0.34378123205817934
25303,0.6324444444444445,0,1,0,513031,92579,59455,48501,0.8575623402126792,0.34378366884037426
25304,0.632452380952381,0,1,0,513032,92578,59455,48501,0.8575530771795917,0.3437861056571141
25305,0.6324761904761904,1,0,1,513032,92578,59456,48500,0.8575530771795917,0.34378145423099277
25306,0.6324891774891774,0,1,0,513033,92577,59456,48500,0.8575438141465042,0.34378389106658064
25307,0.6325,46,160,46,513193,92417,59502,48454,0.8560617288524954,0.34396007694983355
25308,0.6325000000000001,1,8,1,513201,92409,59503,48453,0.855987624587795,0.3439749542105039
25309,0.6325061327561329,1,3,1,513204,92406,59504,48452,0.8559598354885324,0.343977622854222
25310,0.6325714285714286,0,1,0,513205,92405,59504,48452,0.8559505724554448,0.34398006488850397
25311,0.6325833333333334,1,2,1,513207,92403,59505,48451,0.8559320463892697,0.34398029164950944
25312,0.6325952380952381,0,4,0,513211,92399,59505,48451,0.8558949942569195,0.3439900603478878
25313,0.6326190476190476,1,2,1,513213,92397,59506,48450,0.8558764681907444,0.3439902873330635
25314,0.6326212121212121,0,1,0,513214,92396,59506,48450,0.8558672051576568,0.34399272964798433
25315,0.6326666666666666,1,1,1,513215,92395,59507,48449,0.8558579421245692,0.3439905143279089
25316,0.6326666666666667,8,26,8,513241,92369,59515,48441,0.8556171032642929,0.34401676017328314
25317,0.6326697012138188,0,1,0,513242,92368,59515,48441,0.8556078402312053,0.34401920331796976
25318,0.6327281884781883,1,3,1,513245,92365,59516,48440,0.8555800511319427,0.3440218742232165
25319,0.6327326007326007,0,1,0,513246,92364,59516,48440,0.8555707880988551,0.3440243174909804
25320,0.6327380952380952,0,1,0,513247,92363,59516,48440,0.8555615250657675,0.344026760793449
25321,0.6327777777777778,0,3,0,513250,92360,59516,48440,0.8555337359665048,0.34403409090909093
25322,0.6327777777777779,0,1,0,513251,92359,59516,48440,0.8555244729334173,0.344036534350386
25323,0.6327857142857144,0,1,0,513252,92358,59516,48440,0.8555152099003298,0.3440389778263896
25324,0.6328095238095237,0,1,0,513253,92357,59516,48440,0.8555059468672422,0.34404142133710236
25325,0.6328095238095238,0,4,0,513257,92353,59516,48440,0.855468894734892,0.3440511957270603
25326,0.6328333333333334,5,6,5,513263,92347,59521,48435,0.8554133165363667,0.34404256225937974
25327,0.6328484848484849,0,1,0,513264,92346,59521,48435,0.8554040535032791,0.3440450060732627
25328,0.6328571428571429,3,6,3,513270,92340,59524,48432,0.8553484753047538,0.3440456909044412
25329,0.6329166666666667,0,1,0,513271,92339,59524,48432,0.8553392122716662,0.34404813491415137
25330,0.6329285714285714,0,1,0,513272,92338,59524,48432,0.8553299492385786,0.34405057895858493
25331,0.6329444444444444,0,1,0,513273,92337,59524,48432,0.8553206862054912,0.3440530230377427
25332,0.6329761904761905,0,3,0,513276,92334,59524,48432,0.8552928971062285,0.3440603554835685
25333,0.6329761904761906,0,1,0,513277,92333,59524,48432,0.8552836340731409,0.3440627997016304
25334,0.633,12,25,12,513302,92308,59536,48420,0.8550520582459521,0.3440679893127167
25335,0.6330238095238095,0,1,0,513303,92307,59536,48420,0.8550427952128645,0.3440704342450276
25336,0.6330277777777777,1,0,1,513303,92307,59537,48419,0.8550427952128645,0.34406577320466725
25337,0.6330714285714285,0,1,0,513304,92306,59537,48419,0.855033532179777,0.344068218155978
25338,0.6330833333333333,0,1,0,513305,92305,59537,48419,0.8550242691466894,0.3440706631420369
25339,0.6330952380952382,0,1,0,513306,92304,59537,48419,0.8550150061136018,0.34407310816284475
25340,0.6331428571428571,0,1,0,513307,92303,59537,48419,0.8550057430805142,0.3440755532184022
25341,0.6331666666666665,0,1,0,513308,92302,59537,48419,0.8549964800474267,0.34407799830871016
25342,0.6331666666666667,4,14,4,513322,92288,59541,48415,0.8548667975842009,0.3440935872014101
25343,0.6331666666666668,0,1,0,513323,92287,59541,48415,0.8548575345511135,0.3440960327500675
25344,0.6331746031746033,0,1,0,513324,92286,59541,48415,0.8548482715180259,0.34409847833348733
25345,0.6331904761904762,0,1,0,513325,92285,59541,48415,0.8548390084849383,0.34410092395167025
25346,0.6332142857142856,0,1,0,513326,92284,59541,48415,0.8548297454518508,0.34410336960461696
25347,0.6332142857142857,0,2,0,513328,92282,59541,48415,0.8548112193856756,0.34410826101480485
25348,0.6332380952380953,0,2,0,513330,92280,59541,48415,0.8547926933195006,0.344113152564057
25349,0.6332619047619048,1,2,1,513332,92278,59542,48414,0.8547741672533254,0.3441133824240184
25350,0.6333333333333333,105,337,105,513669,91941,59647,48309,0.8516525251028196,0.34444919786096256
25351,0.6333333333333334,4,1,4,513670,91940,59651,48305,0.8516432620697321,0.3444329566116439
25352,0.6333809523809524,0,1,0,513671,91939,59651,48305,0.8516339990366446,0.34443541256666954
25353,0.6333928571428572,1,0,1,513671,91939,59652,48304,0.8516339990366446,0.34443073807605373
25354,0.6334166666666666,0,1,0,513672,91938,59652,48304,0.851624736003557,0.3444331940502845
25355,0.6334523809523809,0,1,0,513673,91937,59652,48304,0.8516154729704695,0.34443565005954035
25356,0.633452380952381,0,2,0,513675,91935,59652,48304,0.8515969469042943,0.34444056218313024
25357,0.6334605949605949,0,3,0,513678,91932,59652,48304,0.8515691578050317,0.34444793063122164
25358,0.6334761904761905,0,4,0,513682,91928,59652,48304,0.8515321056726814,0.3444577557190941
25359,0.6334999999999998,0,2,0,513684,91926,59652,48304,0.8515135796065063,0.34446266847322254
25360,0.6335,0,6,0,513690,91920,59652,48304,0.851458001407981,0.3444774075764491
25361,0.6335000000000001,6,22,6,513712,91898,59658,48298,0.8512542146800548,0.34450340951239694
25362,0.6335317460317459,1,1,1,513713,91897,59659,48297,0.8512449516469672,0.34450119120647105
25363,0.633547619047619,0,1,0,513714,91896,59659,48297,0.8512356886138798,0.3445036485416533
25364,0.6335714285714286,1,2,1,513716,91894,59660,48296,0.8512171625477046,0.34450388758113987
25365,0.6335833333333333,0,1,0,513717,91893,59660,48296,0.8512078995146171,0.3445063450056709
25366,0.6336309523809524,0,1,0,513718,91892,59660,48296,0.8511986364815295,0.34450880246526094
25367,0.6336428571428572,0,1,0,513719,91891,59660,48296,0.8511893734484419,0.34451125995991067
25368,0.6336666666666666,1,6,1,513725,91885,59661,48295,0.8511337952499166,0.3445213297189328
25369,0.6336666666666667,6,9,6,513734,91876,59667,48289,0.8510504279521286,0.3445153925730389
25370,0.6336904761904761,2,0,2,513734,91876,59669,48287,0.8510504279521286,0.3445060393969878
25371,0.6337142857142857,0,2,0,513736,91874,59669,48287,0.8510319018859536,0.3445109552585955
25372,0.6337142857142858,0,1,0,513737,91873,59669,48287,0.851022638852866,0.3445134132420091
25373,0.6337499999999999,0,1,0,513738,91872,59669,48287,0.8510133758197784,0.344515871260497
25374,0.63375,0,2,0,513740,91870,59669,48287,0.8509948497536033,0.3445207874026984
25375,0.6337500000000001,1,2,1,513742,91868,59670,48286,0.8509763236874283,0.3445210268704425
25376,0.6337857142857142,1,0,1,513742,91868,59671,48285,0.8509763236874283,0.34451634998894065
25377,0.633797619047619,0,1,0,513743,91867,59671,48285,0.8509670606543407,0.34451880815115016
25378,0.6338095238095238,0,1,0,513744,91866,59671,48285,0.8509577976212531,0.3445212663484385
25379,0.6338214285714286,0,1,0,513745,91865,59671,48285,0.8509485345881656,0.34452372458080627
25380,0.6338333333333332,0,1,0,513746,91864,59671,48285,0.850939271555078,0.34452618284825437
25381,0.6338333333333334,0,7,0,513753,91857,59671,48285,0.8508744303234651,0.34454339170270154
25382,0.6338571428571428,0,1,0,513754,91856,59671,48285,0.8508651672903775,0.3445458502508188
25383,0.6338809523809525,0,3,0,513757,91853,59671,48285,0.8508373781911149,0.34455322610569583
25384,0.6339047619047619,0,1,0,513758,91852,59671,48285,0.8508281151580274,0.3445556847941657
25385,0.6339166666666666,0,1,0,513759,91851,59671,48285,0.8508188521249398,0.3445581435177256
25386,0.6339761904761905,0,1,0,513760,91850,59671,48285,0.8508095890918522,0.34456060227637636
25387,0.6339999999999999,0,3,0,513763,91847,59671,48285,0.8507817999925896,0.3445679787628807
25388,0.634,19,58,19,513821,91789,59690,48266,0.8502445440735115,0.34462175573881687
25389,0.6340000000000001,0,1,0,513822,91788,59690,48266,0.8502352810404239,0.34462421637368446
25390,0.6340238095238095,0,1,0,513823,91787,59690,48266,0.8502260180073363,0.3446266770436906
25391,0.6340476190476191,1,0,1,513823,91787,59691,48265,0.8502260180073363,0.34462199754376943
25392,0.6340494505494506,0,1,0,513824,91786,59691,48265,0.8502167549742488,0.34462445823307225
25393,0.634090909090909,0,1,0,513825,91785,59691,48265,0.8502074919411612,0.3446269189575152
25394,0.6340952380952382,0,1,0,513826,91784,59691,48265,0.8501982289080736,0.344629379717099
25395,0.6341111111111111,0,1,0,513827,91783,59691,48265,0.8501889658749862,0.3446318405118245
25396,0.6341666666666665,2,0,2,513827,91783,59693,48263,0.8501889658749862,0.3446224811847536
25397,0.6341666666666667,18,41,18,513868,91742,59711,48245,0.8498091815183964,0.34463914506347015
25398,0.6341666666666668,3,25,3,513893,91717,59714,48242,0.8495776056912075,0.34468665823562616
25399,0.6341785714285715,0,2,0,513895,91715,59714,48242,0.8495590796250324,0.3446915838436091
25400,0.634202380952381,0,1,0,513896,91714,59714,48242,0.8495498165919448,0.34469404670039155
25401,0.6342142857142857,0,1,0,513897,91713,59714,48242,0.8495405535588573,0.34469650959236897
25402,0.6342222222222221,0,1,0,513898,91712,59714,48242,0.8495312905257698,0.3446989725195421
25403,0.6342222222222224,1,0,1,513898,91712,59715,48241,0.8495312905257698,0.34469429022600445
25404,0.63425,1,0,1,513898,91712,59716,48240,0.8495312905257698,0.3446896078655539
25405,0.6342857142857142,0,1,0,513899,91711,59716,48240,0.8495220274926822,0.34469207079620723
25406,0.6342857142857143,2,8,2,513907,91703,59718,48238,0.8494479232279818,0.3447024103014842
25407,0.6343333333333333,2,9,2,513916,91694,59720,48236,0.8493645559301938,0.34471521475023226
25408,0.6343333333333334,3,16,3,513932,91678,59723,48233,0.8492163474007929,0.3447405850862334
25409,0.6343531746031745,0,2,0,513934,91676,59723,48233,0.8491978213346179,0.3447455131549793
25410,0.6344444444444445,1,1,1,513935,91675,59724,48232,0.8491885583015303,0.3447432937594259
25411,0.6344523809523809,0,2,0,513937,91673,59724,48232,0.8491700322353551,0.344748222007791
25412,0.634452380952381,0,1,0,513938,91672,59724,48232,0.8491607692022676,0.3447506861848124
25413,0.6344602897102898,0,3,0,513941,91669,59724,48232,0.849132980103005,0.3447580789272414
25414,0.6344761904761905,0,1,0,513942,91668,59724,48232,0.8491237170699174,0.34476054324517513
25415,0.6345,1,0,1,513942,91668,59725,48231,0.8491237170699174,0.34475585958441446
25416,0.6345000000000001,4,13,4,513955,91655,59729,48227,0.8490032976397792,0.34476916257988877
25417,0.6345238095238096,0,1,0,513956,91654,59729,48227,0.8489940346066916,0.34477162731178645
25418,0.6345454545454545,0,1,0,513957,91653,59729,48227,0.8489847715736041,0.3447740920789248
25419,0.6345714285714287,0,1,0,513958,91652,59729,48227,0.8489755085405165,0.34477655688130454
25420,0.6345833333333333,0,1,0,513959,91651,59729,48227,0.8489662455074289,0.3447790217189265
25421,0.6345833333333335,0,1,0,513960,91650,59729,48227,0.8489569824743414,0.34478148659179136
25422,0.6346190476190475,0,1,0,513961,91649,59729,48227,0.8489477194412538,0.34478395149989993
25423,0.6346190476190476,0,1,0,513962,91648,59729,48227,0.8489384564081663,0.3447864164432529
25424,0.6346428571428572,0,3,0,513965,91645,59729,48227,0.8489106673089036,0.3447938114847861
25425,0.6346666666666666,2,7,2,513972,91638,59731,48225,0.8488458260772908,0.34480169880525946
25426,0.6346666666666667,3,9,3,513981,91629,59734,48222,0.8487624587795027,0.3448098333226076
25427,0.6347619047619047,0,1,0,513982,91628,59734,48222,0.8487531957464152,0.34481229889166964
25428,0.6347619047619049,0,1,0,513983,91627,59734,48222,0.8487439327133276,0.34481476449599213
25429,0.6348095238095238,0,1,0,513984,91626,59734,48222,0.8487346696802401,0.34481723013557575
25430,0.6348333333333332,1,3,1,513987,91623,59735,48221,0.8487068805809774,0.34481994222133233
25431,0.6348333333333334,2,9,2,513996,91614,59737,48219,0.8486235132831894,0.34483276479800906
25432,0.6348333333333335,0,1,0,513997,91613,59737,48219,0.8486142502501018,0.3448352308484467
25433,0.6348571428571429,1,0,1,513997,91613,59738,48218,0.8486142502501018,0.34483054544414327
25434,0.6348690476190476,0,1,0,513998,91612,59738,48218,0.8486049872170144,0.34483301151398127
25435,0.6348809523809523,0,1,0,513999,91611,59738,48218,0.8485957241839268,0.3448354776190919
25436,0.6348888888888888,0,1,0,514000,91610,59738,48218,0.8485864611508392,0.3448379437594759
25437,0.6349523809523809,1,0,1,514000,91610,59739,48217,0.8485864611508392,0.3448332582405401
25438,0.6349999999999999,1,10,1,514010,91600,59740,48216,0.8484938308199637,0.344853235681181
25439,0.635,189,618,189,514628,90982,59929,48027,0.8427692763718552,0.3454956153918092
25440,0.6350000000000001,6,15,6,514643,90967,59935,48021,0.8426303308755418,0.3455046478832705
25441,0.6350238095238095,0,2,0,514645,90965,59935,48021,0.8426118048093668,0.345509619673924
25442,0.6350641025641025,0,1,0,514646,90964,59935,48021,0.8426025417762792,0.34551210562290896
25443,0.6350714285714285,0,5,0,514651,90959,59935,48021,0.8425562266108415,0.3455245359044467
25444,0.6351190476190475,0,2,0,514653,90957,59935,48021,0.8425377005446664,0.34552950826749557
25445,0.6351190476190476,0,1,0,514654,90956,59935,48021,0.8425284375115788,0.3455319945026875
25446,0.6351190476190477,1,1,1,514655,90955,59936,48020,0.8425191744784912,0.34552977154164416
25447,0.635142857142857,0,2,0,514657,90953,59936,48020,0.8425006484123161,0.34553474415893737
25448,0.6351666666666665,1,1,1,514658,90952,59937,48019,0.8424913853792286,0.3455325211734822
25449,0.6351666666666667,0,9,0,514667,90943,59937,48019,0.8424080180814406,0.34555489990069227
25450,0.6351666666666668,0,2,0,514669,90941,59937,48019,0.8423894920152655,0.34555987334484745
25451,0.6352380952380952,0,1,0,514670,90940,59937,48019,0.8423802289821779,0.3455623601206111
25452,0.6352380952380953,0,1,0,514671,90939,59937,48019,0.8423709659490903,0.34556484693216655
25453,0.6352619047619048,0,2,0,514673,90937,59937,48019,0.8423524398829153,0.3455698206626558
25454,0.6352777777777778,0,1,0,514674,90936,59937,48019,0.8423431768498277,0.3455723075815912
25455,0.635294733044733,0,2,0,514676,90934,59937,48019,0.8423246507836526,0.3455772815268472
25456,0.6353095238095238,1,1,1,514677,90933,59938,48018,0.842315387750565,0.34557505883368955
25457,0.6353333333333333,2,7,2,514684,90926,59940,48016,0.8422505465189521,0.34558304904204634
25458,0.6353333333333334,2,10,2,514694,90916,59942,48014,0.8421579161880767,0.3455985028431584
25459,0.6353365800865801,0,1,0,514695,90915,59942,48014,0.8421486531549891,0.3456009904339627
25460,0.6353571428571428,3,2,3,514697,90913,59945,48011,0.842130127088814,0.34559183438426766
25461,0.6353809523809525,0,1,0,514698,90912,59945,48011,0.8421208640557264,0.34559432203450835
25462,0.6353888888888889,0,1,0,514699,90911,59945,48011,0.8421116010226388,0.3455968097205626
25463,0.6354166666666667,0,2,0,514701,90909,59945,48011,0.8420930749564638,0.3456017852001152
25464,0.635452380952381,1,2,1,514703,90907,59946,48010,0.8420745488902887,0.34560205014505063
25465,0.6354761904761904,1,0,1,514703,90907,59947,48009,0.8420745488902887,0.3455973393993492
25466,0.6355,2,13,2,514716,90894,59949,48007,0.8419541294601505,0.3456202619131612
25467,0.6355000000000001,1,2,1,514718,90892,59950,48006,0.8419356033939753,0.34562052729340953
25468,0.635547619047619,0,2,0,514720,90890,59950,48006,0.8419170773278002,0.3456255039741965
25469,0.6355555555555555,1,1,1,514721,90889,59951,48005,0.8419078142947126,0.34562328106325685
25470,0.6355833333333334,0,1,0,514722,90888,59951,48005,0.8418985512616252,0.34562576947722345
25471,0.635595238095238,0,2,0,514724,90886,59951,48005,0.84188002519545,0.3456307464126545
25472,0.6355952380952381,0,1,0,514725,90885,59951,48005,0.8418707621623625,0.3456332349341205
25473,0.6356349206349208,0,1,0,514726,90884,59951,48005,0.8418614991292749,0.3456357234914212
25474,0.6356428571428572,0,1,0,514727,90883,59951,48005,0.8418522360961873,0.34563821208455736
25475,0.6356666666666666,1,6,1,514733,90877,59952,48004,0.841796657897662,0.3456484328309848
25476,0.6356666666666667,0,8,0,514741,90869,59952,48004,0.8417225536329616,0.34566834445860606
25477,0.6356666666666668,1,1,1,514742,90868,59953,48003,0.841713290599874,0.34566612179648737
25478,0.6356904761904761,0,1,0,514743,90867,59953,48003,0.8417040275667864,0.34566861093108664
25479,0.6357142857142857,0,10,0,514753,90857,59953,48003,0.8416113972359109,0.3456935042488838
25480,0.6357142857142858,0,1,0,514754,90856,59953,48003,0.8416021342028234,0.345695993777861
25481,0.63575,0,3,0,514757,90853,59953,48003,0.8415743451035607,0.34570346257993895
25482,0.6358333333333333,6,37,6,514794,90816,59959,47997,0.8412316128793212,0.34576732726761905
25483,0.6358333333333334,10,38,10,514832,90778,59969,47987,0.8408796176219941,0.34581486686124024
25484,0.6358333333333335,3,1,3,514833,90777,59972,47984,0.8408703545889066,0.3458032156009253
25485,0.6358567821067821,1,1,1,514834,90776,59973,47983,0.840861091555819,0.3458009930887366
25486,0.6358928571428571,0,1,0,514835,90775,59973,47983,0.8408518285227314,0.3458034852044567
25487,0.6359356199356199,0,1,0,514836,90774,59973,47983,0.840842565489644,0.34580597735609736
25488,0.6359523809523809,0,1,0,514837,90773,59973,47983,0.8408333024565564,0.34580846954365935
25489,0.635952380952381,0,2,0,514839,90771,59973,47983,0.8408147763903813,0.34581345402655056
25490,0.6359999999999999,2,1,2,514840,90770,59975,47981,0.8408055133572937,0.34580651670978946
25491,0.636,25,72,25,514912,90698,60000,47956,0.8401385749749898,0.34586813218515156
25492,0.6360000000000001,1,2,1,514914,90696,60001,47955,0.8401200489088148,0.34586840340134584
25493,0.6360432900432899,0,1,0,514915,90695,60001,47955,0.8401107858757272,0.34587089794446446
25494,0.636047619047619,0,1,0,514916,90694,60001,47955,0.8401015228426396,0.3458733925235667
25495,0.6360714285714285,0,2,0,514918,90692,60001,47955,0.8400829967764645,0.34587838178972496
25496,0.6361111111111111,0,1,0,514919,90691,60001,47955,0.8400737337433769,0.3458808764767826
25497,0.6361190476190476,0,1,0,514920,90690,60001,47955,0.8400644707102893,0.3458833711998269
25498,0.6361666666666665,1,0,1,514920,90690,60002,47954,0.8400644707102893,0.3458786532413952
25499,0.6361666666666667,1,6,1,514926,90684,60003,47953,0.840008892511764,0.3458889041165057
25500,0.6361666666666668,1,0,1,514926,90684,60004,47952,0.840008892511764,0.34588418592573356
25501,0.6361904761904762,0,5,0,514931,90679,60004,47952,0.8399625773463263,0.34589666091999627
25502,0.63625,1,6,1,514937,90673,60005,47951,0.839906999147801,0.34590691366574333
25503,0.6362619047619048,1,2,1,514939,90671,60006,47950,0.8398884730816258,0.34590718577993235
25504,0.6362857142857142,1,1,1,514940,90670,60007,47949,0.8398792100485383,0.34590496252317504
25505,0.6362857142857143,0,1,0,514941,90669,60007,47949,0.8398699470154507,0.34590745790589966
25506,0.6362878787878788,1,0,1,514941,90669,60008,47948,0.8398699470154507,0.34590273920226233
25507,0.6363095238095238,0,2,0,514943,90667,60008,47948,0.8398514209492757,0.34590773004364606
25508,0.6363095238095239,0,3,0,514946,90664,60008,47948,0.839823631850013,0.34591521657576546
25509,0.6363333333333333,3,17,3,514963,90647,60011,47945,0.8396661602875245,0.3459434888016624
25510,0.6363333333333334,1,4,1,514967,90643,60012,47944,0.8396291081551743,0.34594875421215554
25511,0.6363888888888889,0,1,0,514968,90642,60012,47944,0.8396198451220868,0.3459512504870622
25512,0.6364166666666667,0,2,0,514970,90640,60012,47944,0.8396013190559116,0.3459562431449518
25513,0.6364285714285715,1,1,1,514971,90639,60013,47943,0.8395920560228242,0.34595402000259773
25514,0.6364761904761904,0,2,0,514973,90637,60013,47943,0.839573529956649,0.3459590128445663
25515,0.6365,8,6,8,514979,90631,60021,47935,0.8395179517581237,0.34593623255344025
25516,0.6365000000000001,0,3,0,514982,90628,60021,47935,0.839490162658861,0.34594372235012233
25517,0.636547619047619,0,1,0,514983,90627,60021,47935,0.8394808996257734,0.345946219021088
25518,0.6365476190476191,1,0,1,514983,90627,60022,47934,0.8394808996257734,0.3459414986901076
25519,0.6365714285714286,0,1,0,514984,90626,60022,47934,0.8394716365926859,0.34594399538106235
25520,0.6366190476190476,0,1,0,514985,90625,60022,47934,0.8394623735595984,0.34594649210805506
25521,0.6366587301587302,0,1,0,514986,90624,60022,47934,0.8394531105265108,0.3459489888710865
25522,0.6366666666666665,0,1,0,514987,90623,60022,47934,0.8394438474934233,0.34595148567015743
25523,0.6366666666666666,57,221,57,515208,90402,60079,47877,0.8373967171810738,0.3462347861931313
25524,0.6366666666666667,42,111,42,515319,90291,60121,47835,0.8363685205083553,0.3463142348290691
25525,0.6367142857142858,0,1,0,515320,90290,60121,47835,0.8363592574752677,0.34631674208144797
25526,0.6367380952380953,0,1,0,515321,90289,60121,47835,0.8363499944421802,0.3463192493701312
25527,0.6367857142857144,0,2,0,515323,90287,60121,47835,0.836331468376005,0.3463242640564139
25528,0.636797619047619,1,0,1,515323,90287,60122,47834,0.836331468376005,0.34631953142534444
25529,0.6368134920634921,0,1,0,515324,90286,60122,47834,0.8363222053429175,0.34632203880683465
25530,0.6368333333333333,0,4,0,515328,90282,60122,47834,0.8362851532105673,0.34633206869587885
25531,0.6368333333333334,3,6,3,515334,90276,60125,47831,0.836229575012042,0.3463329157826902
25532,0.6368405483405484,1,0,1,515334,90276,60126,47830,0.836229575012042,0.34632818270024474
25533,0.6368809523809524,0,1,0,515335,90275,60126,47830,0.8362203119789544,0.34633069041671194
25534,0.6369047619047619,0,1,0,515336,90274,60126,47830,0.8362110489458668,0.3463331981694954
25535,0.6369166666666668,0,1,0,515337,90273,60126,47830,0.8362017859127793,0.34633570595859614
25536,0.6369444444444444,0,1,0,515338,90272,60126,47830,0.8361925228796917,0.3463382137840147
25537,0.6369523809523809,0,1,0,515339,90271,60126,47830,0.8361832598466041,0.346340721645752
25538,0.6369761904761905,1,0,1,515339,90271,60127,47829,0.8361832598466041,0.3463359884141926
25539,0.6369761904761906,1,1,1,515340,90270,60128,47828,0.8361739968135166,0.3463337629799128
25540,0.637,12,35,12,515375,90235,60140,47816,0.8358497906554522,0.3463647492593317
25541,0.6370000000000001,0,3,0,515378,90232,60140,47816,0.8358220015561896,0.34637227630968936
25542,0.6370238095238095,0,1,0,515379,90231,60140,47816,0.835812738523102,0.34637478539917566
25543,0.6371190476190476,0,3,0,515382,90228,60140,47816,0.8357849494238393,0.34638231288574656
25544,0.6371309523809523,0,1,0,515383,90227,60140,47816,0.8357756863907518,0.3463848221206436
25545,0.6371428571428571,1,6,1,515389,90221,60141,47815,0.8357201081922264,0.3463951432959518
25546,0.6371428571428572,0,1,0,515390,90220,60141,47815,0.835710845159139,0.3463976527692252
25547,0.6371507936507936,0,1,0,515391,90219,60141,47815,0.8357015821260514,0.34640016227885884
25548,0.6371666666666667,0,18,0,515409,90201,60141,47815,0.8355348475304754,0.3464453396707628
25549,0.6372023809523809,0,1,0,515410,90200,60141,47815,0.8355255844973878,0.34644784987139077
25550,0.6372142857142857,2,0,2,515410,90200,60143,47813,0.8355255844973878,0.3464383789932832
25551,0.6372619047619047,1,1,1,515411,90199,60144,47812,0.8355163214643002,0.34643615363992725
25552,0.6372619047619048,1,0,1,515411,90199,60145,47811,0.8355163214643002,0.34643141801318744
25553,0.6372857142857142,0,1,0,515412,90198,60145,47811,0.8355070584312128,0.3464339282220725
25554,0.6372857142857143,1,0,1,515412,90198,60146,47810,0.8355070584312128,0.3464291925105791
25555,0.6373095238095238,1,2,1,515414,90196,60147,47809,0.8354885323650376,0.34642947719285533
25556,0.6373333333333333,6,24,6,515438,90172,60153,47803,0.8352662195709363,0.34646131545569847
25557,0.6373333333333334,0,5,0,515443,90167,60153,47803,0.8352199044054985,0.3464738711314054
25558,0.6373571428571428,2,0,2,515443,90167,60155,47801,0.8352199044054985,0.3464643975414589
25559,0.6373809523809524,1,1,1,515444,90166,60156,47800,0.835210641372411,0.3464621718394387
25560,0.6374126984126984,1,0,1,515444,90166,60157,47799,0.835210641372411,0.3464574348566665
25561,0.6374256854256853,1,3,1,515447,90163,60158,47798,0.8351828522731484,0.34646023151470345
25562,0.6374285714285715,0,1,0,515448,90162,60158,47798,0.8351735892400608,0.34646274282400696
25563,0.6374761904761905,0,1,0,515449,90161,60158,47798,0.8351643262069732,0.3464652541697171
25564,0.6375,67,194,67,515643,89967,60225,47731,0.8333672977879877,0.34663539049223663
25565,0.6375000000000001,1,7,1,515650,89960,60226,47730,0.8333024565563748,0.3466482678480645
25566,0.637547619047619,1,0,1,515650,89960,60227,47729,0.8333024565563748,0.34664352272149557
25567,0.6376190476190476,1,4,1,515654,89956,60228,47728,0.8332654044240246,0.3466488480869237
25568,0.6376428571428572,0,3,0,515657,89953,60228,47728,0.8332376153247619,0.3466564013916227
25569,0.6376666666666666,4,16,4,515673,89937,60232,47724,0.833089406795361,0.3466777082833918
25570,0.6376666666666667,0,5,0,515678,89932,60232,47724,0.8330430916299233,0.3466903004591155
25571,0.6376785714285713,0,1,0,515679,89931,60232,47724,0.8330338285968357,0.3466928190040318
25572,0.6377380952380952,2,0,2,515679,89931,60234,47722,0.8330338285968357,0.3466833269162314
25573,0.6377579365079364,1,3,1,515682,89928,60235,47721,0.8330060394975731,0.3466861364775625
25574,0.6377857142857143,0,1,0,515683,89927,60235,47721,0.8329967764644856,0.3466886551203069
25575,0.6378095238095238,0,1,0,515684,89926,60235,47721,0.832987513431398,0.3466911737996469
25576,0.6378333333333333,0,2,0,515686,89924,60235,47721,0.8329689873652228,0.3466962112681173
25577,0.6378333333333334,2,12,2,515698,89912,60237,47719,0.8328578309681722,0.3467169460368667
25578,0.6378333333333335,0,1,0,515699,89911,60237,47719,0.8328485679350847,0.3467194652328707
25579,0.6378571428571429,3,6,3,515705,89905,60240,47716,0.8327929897365594,0.34672034064568635
25580,0.6378968253968254,0,1,0,515706,89904,60240,47716,0.8327837267034718,0.34672286004941144
25581,0.6379166666666667,0,2,0,515708,89902,60240,47716,0.8327652006372966,0.3467278989667049
25582,0.6379218836718836,1,2,1,515710,89900,60241,47715,0.8327466745711216,0.3467281909675544
25583,0.6379444444444444,0,2,0,515712,89898,60241,47715,0.8327281485049465,0.3467332301454078
25584,0.637952380952381,0,1,0,515713,89897,60241,47715,0.8327188854718589,0.3467357497892626
25585,0.6379678948502477,0,1,0,515714,89896,60241,47715,0.8327096224387713,0.3467382694697372
25586,0.6379999999999999,1,5,1,515719,89891,60242,47714,0.8326633072733336,0.3467461211438538
25587,0.638,15,47,15,515766,89844,60257,47699,0.8322279447182185,0.3467933664381321
25588,0.6380357142857144,0,1,0,515767,89843,60257,47699,0.832218681685131,0.34679588780154424
25589,0.6380476190476191,0,1,0,515768,89842,60257,47699,0.8322094186520435,0.34679840920161986
25590,0.638095238095238,1,1,1,515769,89841,60258,47698,0.8322001556189559,0.3467961814467169
25591,0.6381060606060607,0,1,0,515770,89840,60258,47698,0.8321908925858683,0.3467987029039247
25592,0.6381190476190476,0,1,0,515771,89839,60258,47698,0.8321816295527807,0.3468012243977984
25593,0.6381428571428572,0,1,0,515772,89838,60258,47698,0.8321723665196932,0.34680374592833874
25594,0.6381666666666667,4,5,4,515777,89833,60262,47694,0.8321260513542554,0.34679735615551854
25595,0.6381666666666668,0,3,0,515780,89830,60262,47694,0.8320982622549927,0.34680492132282364
25596,0.6381904761904762,0,1,0,515781,89829,60262,47694,0.8320889992219053,0.3468074431186056
25597,0.6382142857142857,0,5,0,515786,89824,60262,47694,0.8320426840564674,0.3468200526476534
25598,0.6382142857142858,0,1,0,515787,89823,60262,47694,0.8320334210233798,0.34682257466349614
25599,0.6382857142857143,0,1,0,515788,89822,60262,47694,0.8320241579902924,0.3468250967160185
25600,0.6383095238095238,1,1,1,515789,89821,60263,47693,0.8320148949572048,0.34682286894425296
25601,0.6383095238095239,0,2,0,515791,89819,60263,47693,0.8319963688910297,0.34682791320030254
25602,0.6383333333333332,0,2,0,515793,89817,60263,47693,0.8319778428248545,0.3468329576030834
25603,0.6383333333333333,63,155,63,515948,89662,60326,47630,0.8305420726962837,0.3469248026104944
25604,0.6383333333333334,1,2,1,515950,89660,60327,47629,0.8305235466301085,0.34692509960739754
25605,0.6383333333333335,0,1,0,515951,89659,60327,47629,0.8305142835970211,0.3469276265951868
25606,0.6383571428571428,1,0,1,515951,89659,60328,47628,0.8305142835970211,0.34692286960892144
25607,0.638424603174603,0,2,0,515953,89657,60328,47628,0.8304957575308459,0.346927923662454
25608,0.6384485448126752,1,0,1,515953,89657,60329,47627,0.8304957575308459,0.34692316657440053
25609,0.638452380952381,0,1,0,515954,89656,60329,47627,0.8304864944977584,0.3469256936401448
25610,0.6384523809523811,1,0,1,515954,89656,60330,47626,0.8304864944977584,0.3469209364665433
25611,0.6384761904761904,0,2,0,515956,89654,60330,47626,0.8304679684315832,0.34692599067599067
25612,0.6385,1,1,1,515957,89653,60331,47625,0.8304587053984956,0.34692376054429697
25613,0.6385000000000001,5,18,5,515975,89635,60336,47620,0.8302919708029197,0.34694546646752394
25614,0.6385238095238095,0,2,0,515977,89633,60336,47620,0.8302734447367446,0.3469505220286624
25615,0.6385714285714286,3,4,3,515981,89629,60339,47617,0.8302363926043944,0.34694635909243254
25616,0.6386111111111111,0,1,0,515982,89628,60339,47617,0.8302271295713068,0.3469488870268498
25617,0.6386190476190476,1,1,1,515983,89627,60340,47616,0.8302178665382193,0.3469466566600847
25618,0.6386428571428572,0,1,0,515984,89626,60340,47616,0.8302086035051317,0.3469491846519287
25619,0.6386666666666666,1,3,1,515987,89623,60341,47615,0.8301808144058691,0.3469520103761349
25620,0.6386666666666667,2,20,2,516007,89603,60343,47613,0.8299955537441179,0.3469930620335821
25621,0.6386904761904763,0,1,0,516008,89602,60343,47613,0.8299862907110305,0.34699559086105747
25622,0.6387142857142857,0,1,0,516009,89601,60343,47613,0.8299770276779429,0.34699811972539246
25623,0.63875,1,0,1,516009,89601,60344,47612,0.8299770276779429,0.34699336068739844
25624,0.6387619047619046,0,3,0,516012,89598,60344,47612,0.8299492385786802,0.34700094745280957
25625,0.6388015873015873,0,1,0,516013,89597,60344,47612,0.8299399755455926,0.34700347644833796
25626,0.6388095238095238,0,1,0,516014,89596,60344,47612,0.829930712512505,0.34700600548072996
25627,0.6388333333333333,0,3,0,516017,89593,60344,47612,0.8299029234132425,0.3470135927990962
25628,0.6388333333333334,3,7,3,516024,89586,60347,47609,0.8298380821816296,0.34701701957068404
25629,0.6388650793650794,1,0,1,516024,89586,60348,47608,0.8298380821816296,0.34701226001137075
25630,0.6388809523809524,1,0,1,516024,89586,60349,47607,0.8298380821816296,0.3470075003826726
25631,0.6388888888888888,1,0,1,516024,89586,60350,47606,0.8298380821816296,0.34700274068458803
25632,0.638936507936508,0,2,0,516026,89584,60350,47606,0.8298195561154544,0.3470077994022888
25633,0.6389523809523809,0,1,0,516027,89583,60350,47606,0.8298102930823669,0.3470103288164503
25634,0.639,17,38,17,516065,89545,60367,47589,0.8294582978250399,0.34702553706593553
25635,0.6390476190476191,0,2,0,516067,89543,60367,47589,0.8294397717588647,0.34703059825569527
25636,0.6390555555555556,0,1,0,516068,89542,60367,47589,0.8294305087257772,0.3470331289059367
25637,0.6390833333333333,0,1,0,516069,89541,60367,47589,0.8294212456926896,0.34703565959308685
25638,0.639095238095238,0,2,0,516071,89539,60367,47589,0.8294027196265145,0.3470407210781168
25639,0.6391071428571429,3,1,3,516072,89538,60370,47586,0.829393456593427,0.3470289664828914
25640,0.6391428571428572,0,1,0,516073,89537,60370,47586,0.8293841935603394,0.3470314972688754
25641,0.6391666666666665,1,0,1,516073,89537,60371,47585,0.8293841935603394,0.347026735315996
25642,0.6391666666666667,26,77,26,516150,89460,60397,47559,0.8286709400125978,0.3470978477437436
25643,0.6391904761904762,0,1,0,516151,89459,60397,47559,0.8286616769795102,0.3471003809718431
25644,0.6391944444444444,0,1,0,516152,89458,60397,47559,0.8286524139464226,0.3471029142369195
25645,0.6391984126984127,0,1,0,516153,89457,60397,47559,0.8286431509133351,0.34710544753897354
25646,0.6392142857142857,0,1,0,516154,89456,60397,47559,0.8286338878802475,0.34710798087800604
25647,0.6392619047619048,0,1,0,516155,89455,60397,47559,0.8286246248471599,0.34711051425401784
25648,0.6392694805194804,1,1,1,516156,89454,60398,47558,0.8286153618140724,0.34710828248620557
25649,0.6392857142857141,0,1,0,516157,89453,60398,47558,0.8286060987809849,0.3471108159198896
25650,0.6392857142857142,0,1,0,516158,89452,60398,47558,0.8285968357478973,0.34711334939055544
25651,0.6392857142857143,2,3,2,516161,89449,60400,47556,0.8285690466486346,0.34711141929126677
25652,0.6393333333333332,0,1,0,516162,89448,60400,47556,0.828559783615547,0.34711395287728825
25653,0.6393333333333333,4,13,4,516175,89435,60404,47552,0.8284393641854089,0.3471278296480688
25654,0.6393333333333334,4,10,4,516185,89425,60408,47548,0.8283467338545333,0.3471341067217627
25655,0.6393412698412699,0,1,0,516186,89424,60408,47548,0.8283374708214458,0.3471366410653272
25656,0.6394166666666666,0,2,0,516188,89422,60408,47548,0.8283189447552707,0.34714170986347376
25657,0.6394444444444444,1,1,1,516189,89421,60409,47547,0.8283096817221831,0.34713947783423865
25658,0.6394761904761905,0,1,0,516190,89420,60409,47547,0.8283004186890955,0.3471420123095344
25659,0.6394852369852371,0,5,0,516195,89415,60409,47547,0.8282541035236578,0.3471546852411618
25660,0.6395,0,2,0,516197,89413,60409,47547,0.8282355774574827,0.34715975467289717
25661,0.6395000000000001,4,11,4,516208,89402,60413,47543,0.8281336840935196,0.34716857132425427
25662,0.6395079365079365,0,2,0,516210,89400,60413,47543,0.8281151580273445,0.347173641588106
25663,0.6395238095238095,2,4,2,516214,89396,60415,47541,0.8280781058949943,0.3471742480118595
25664,0.6395252802752802,0,1,0,516215,89395,60415,47541,0.8280688428619067,0.3471767833148332
25665,0.6395476190476189,0,1,0,516216,89394,60415,47541,0.8280595798288192,0.34717931865483626
25666,0.639547619047619,1,0,1,516216,89394,60416,47540,0.8280595798288192,0.3471745512436648
25667,0.6395555555555555,1,0,1,516216,89394,60417,47539,0.8280595798288192,0.3471697837628621
25668,0.6395714285714286,1,0,1,516216,89394,60418,47538,0.8280595798288192,0.3471650162124266
25669,0.6395833333333333,1,0,1,516216,89394,60419,47537,0.8280595798288192,0.3471602485923567
25670,0.6395833333333334,0,1,0,516217,89393,60419,47537,0.8280503167957316,0.34716278390418465
25671,0.6396428571428572,0,1,0,516218,89392,60419,47537,0.828041053762644,0.34716531925304356
25672,0.6396666666666666,4,5,4,516223,89387,60423,47533,0.8279947385972063,0.3471589249196611
25673,0.6396666666666667,0,11,0,516234,89376,60423,47533,0.8278928452332431,0.3471868175211272
25674,0.6396904761904763,0,1,0,516235,89375,60423,47533,0.8278835822001556,0.34718935343442314
25675,0.6397142857142857,0,1,0,516236,89374,60423,47533,0.8278743191670681,0.34719188938476486
25676,0.6397619047619048,2,1,2,516237,89373,60425,47531,0.8278650561339805,0.34718488868111963
25677,0.639797619047619,0,2,0,516239,89371,60425,47531,0.8278465300678054,0.3471899607018159
25678,0.6398333333333333,0,4,0,516243,89367,60425,47531,0.8278094779354552,0.34720010518780403
25679,0.6398333333333334,4,13,4,516256,89354,60429,47527,0.8276890585053169,0.347214003404417
25680,0.6398809523809523,1,1,1,516257,89353,60430,47526,0.8276797954722295,0.3472117709802088
25681,0.6399087301587304,0,2,0,516259,89351,60430,47526,0.8276612694060543,0.347216844320083
25682,0.6399603174603176,0,1,0,516260,89350,60430,47526,0.8276520063729668,0.34721938104561795
25683,0.6399761904761905,1,3,1,516263,89347,60431,47525,0.827624217273704,0.3472222222222222
25684,0.6399761904761906,0,1,0,516264,89346,60431,47525,0.8276149542406166,0.3472247590797174
25685,0.6399999999999999,2,16,2,516280,89330,60433,47523,0.8274667457112157,0.3472558146332196
25686,0.64,582,1792,582,518072,87538,61015,46941,0.8108673904183186,0.34905821726812364
25687,0.6400952380952382,0,1,0,518073,87537,61015,46941,0.810858127385231,0.3490608129210726
25688,0.6401190476190476,0,2,0,518075,87535,61015,46941,0.8108396013190559,0.34906600434278234
25689,0.640142857142857,0,1,0,518076,87534,61015,46941,0.8108303382859684,0.3490686001115449
25690,0.6401509949458863,0,4,0,518080,87530,61015,46941,0.8107932861536181,0.3490789835726662
25691,0.6401666666666667,2,10,2,518090,87520,61017,46939,0.8107006558227426,0.3490952632400955
25692,0.6401904761904761,0,1,0,518091,87519,61017,46939,0.8106913927896551,0.3490978595546565
25693,0.6402499999999999,0,1,0,518092,87518,61017,46939,0.8106821297565675,0.3491004559078367
25694,0.6402857142857142,0,2,0,518094,87516,61017,46939,0.8106636036903924,0.3491056487300584
25695,0.6402857142857143,0,1,0,518095,87515,61017,46939,0.8106543406573048,0.34910824519910155
25696,0.6403333333333333,3,13,3,518108,87502,61020,46936,0.8105339212271666,0.3491274788378286
25697,0.6403333333333334,0,1,0,518109,87501,61020,46936,0.810524658194079,0.3491300757975855
25698,0.6403571428571427,1,1,1,518110,87500,61021,46935,0.8105153951609915,0.3491278312939339
25699,0.6403809523809523,0,1,0,518111,87499,61021,46935,0.810506132127904,0.3491304283142657
25700,0.640404761904762,1,0,1,518111,87499,61022,46934,0.810506132127904,0.34912558672349797
25701,0.6404166666666665,0,1,0,518112,87498,61022,46934,0.8104968690948164,0.34912818376577004
25702,0.6404404761904761,0,1,0,518113,87497,61022,46934,0.8104876060617289,0.3491307808466797
25703,0.6404523809523809,1,0,1,518113,87497,61023,46933,0.8104876060617289,0.34912593915048723
25704,0.6404880952380952,0,1,0,518114,87496,61023,46933,0.8104783430286413,0.3491285362533382
25705,0.6404999999999998,1,0,1,518114,87496,61024,46932,0.8104783430286413,0.3491236944684143
25706,0.6405,3,12,3,518126,87484,61027,46929,0.8103671866315907,0.3491403361282019
25707,0.6405000000000001,0,10,0,518136,87474,61027,46929,0.8102745563007151,0.34916631325193637
25708,0.6405238095238096,0,1,0,518137,87473,61027,46929,0.8102652932676275,0.349168911176917
25709,0.6405328282828282,0,1,0,518138,87472,61027,46929,0.81025603023454,0.349171509140557
25710,0.640547619047619,0,2,0,518140,87470,61027,46929,0.8102375041683649,0.3491767051838183
25711,0.6405555555555555,0,1,0,518141,87469,61027,46929,0.8102282411352774,0.34917930326344143
25712,0.6405595238095239,0,1,0,518142,87468,61027,46929,0.8102189781021898,0.3491819013817273
25713,0.6405833333333334,0,1,0,518143,87467,61027,46929,0.8102097150691022,0.34918449953867675
25714,0.6405952380952381,1,0,1,518143,87467,61028,46928,0.8102097150691022,0.3491796569812865
25715,0.640616883116883,0,1,0,518144,87466,61028,46928,0.8102004520360147,0.3491822551602006
25716,0.6406190476190478,0,1,0,518145,87465,61028,46928,0.8101911890029271,0.3491848533777801
25717,0.6406428571428571,0,1,0,518146,87464,61028,46928,0.8101819259698395,0.3491874516340258
25718,0.6406666666666666,8,24,8,518170,87440,61036,46920,0.8099596131757383,0.34921107472462043
25719,0.6406666666666667,0,3,0,518173,87437,61036,46920,0.8099318240764756,0.34921887210938024
25720,0.6406904761904761,0,2,0,518175,87435,61036,46920,0.8099132980103005,0.3492240705593391
25721,0.6407142857142857,1,1,1,518176,87434,61037,46919,0.809904034977213,0.34922182608501484
25722,0.6407261904761907,0,1,0,518177,87433,61037,46919,0.8098947719441254,0.34922442539002024
25723,0.6407380952380951,0,1,0,518178,87432,61037,46919,0.8098855089110378,0.34922702473371986
25724,0.6407380952380953,0,1,0,518179,87431,61037,46919,0.8098762458779503,0.34922962411611463
25725,0.6407857142857142,1,2,1,518181,87429,61038,46918,0.8098577198117751,0.34922997908401376
25726,0.6408333333333333,8,41,8,518222,87388,61046,46910,0.8094779354551854,0.34929783019851374
25727,0.6408333333333335,10,45,10,518267,87343,61056,46900,0.8090610989662456,0.34936644741252804
25728,0.6408571428571429,0,1,0,518268,87342,61056,46900,0.809051835933158,0.34936904992476275
25729,0.6408809523809523,0,1,0,518269,87341,61056,46900,0.8090425729000704,0.3493716524757712
25730,0.6409112554112554,0,1,0,518270,87340,61056,46900,0.8090333098669829,0.34937425506555425
25731,0.6409166666666667,0,1,0,518271,87339,61056,46900,0.8090240468338953,0.34937685769411275
25732,0.640930735930736,0,1,0,518272,87338,61056,46900,0.8090147838008077,0.34937946036144757
25733,0.6409523809523808,0,1,0,518273,87337,61056,46900,0.8090055207677201,0.3493820630675596
25734,0.640952380952381,0,2,0,518275,87335,61056,46900,0.8089869947015451,0.34938726859611874
25735,0.6409999999999999,13,38,13,518313,87297,61069,46887,0.808634999444218,0.3494231801108925
25736,0.6410000000000001,0,1,0,518314,87296,61069,46887,0.8086257364111304,0.34942578419024767
25737,0.641047619047619,0,2,0,518316,87294,61069,46887,0.8086072103449553,0.3494309924654012
25738,0.6410515873015871,0,2,0,518318,87292,61069,46887,0.8085886842787803,0.3494362008958183
25739,0.6410714285714286,0,1,0,518319,87291,61069,46887,0.8085794212456927,0.3494388051692528
25740,0.641095238095238,0,2,0,518321,87289,61069,46887,0.8085608951795176,0.3494440138325781
25741,0.6411406926406926,0,1,0,518322,87288,61069,46887,0.80855163214643,0.34944661822247064
25742,0.6411428571428571,1,0,1,518322,87288,61070,46886,0.80855163214643,0.34944176964240464
25743,0.6411666666666666,2,2,2,518324,87286,61072,46884,0.808533106080255,0.3494372810613401
25744,0.6411666666666668,1,5,1,518329,87281,61073,46883,0.8084867909148171,0.34944545481649325
25745,0.6411904761904762,0,2,0,518331,87279,61073,46883,0.8084682648486421,0.34945066412247877
25746,0.6412142857142856,1,0,1,518331,87279,61074,46882,0.8084682648486421,0.3494458151027497
25747,0.6412222222222222,0,1,0,518332,87278,61074,46882,0.8084590018155545,0.349448419797257
25748,0.6412380952380953,0,1,0,518333,87277,61074,46882,0.808449738782467,0.3494510245305943
25749,0.64125,0,5,0,518338,87272,61074,46882,0.8084034236170292,0.34946404877976056
25750,0.6412857142857142,0,1,0,518339,87271,61074,46882,0.8083941605839416,0.34946665374609587
25751,0.6412857142857143,0,1,0,518340,87270,61074,46882,0.8083848975508541,0.3494692587512672
25752,0.6413095238095238,1,2,1,518342,87268,61075,46881,0.8083663714846789,0.3494696196020842
25753,0.6413333333333333,4,21,4,518363,87247,61079,46877,0.8081718477898403,0.34950493573111446
25754,0.6413333333333334,1,2,1,518365,87245,61080,46876,0.8081533217236652,0.3495052974552829
25755,0.6413809523809523,1,0,1,518365,87245,61081,46875,0.8081533217236652,0.3495004473605726
25756,0.6414166666666666,0,5,0,518370,87240,61081,46875,0.8081070065582274,0.34951347723968235
25757,0.6414285714285713,0,2,0,518372,87238,61081,46875,0.8080884804920523,0.349518689463363
25758,0.6414285714285716,0,2,0,518374,87236,61081,46875,0.8080699544258773,0.3495239018425036
25759,0.6414761904761903,0,1,0,518375,87235,61081,46875,0.8080606913927897,0.34952650809037356
25760,0.6414761904761904,0,2,0,518377,87233,61081,46875,0.8080421653266145,0.3495317207027172
25761,0.6415000000000001,4,16,4,518393,87217,61085,46871,0.8078939567972137,0.3495540242228984
25762,0.6415489347254052,1,0,1,518393,87217,61086,46870,0.8078939567972137,0.34954917329793345
25763,0.6415714285714285,0,1,0,518394,87216,61086,46870,0.8078846937641261,0.34955178020076666
25764,0.6415714285714286,0,1,0,518395,87215,61086,46870,0.8078754307310386,0.34955438714248427
25765,0.6416666666666666,34,125,34,518520,87090,61120,46836,0.8067175515950943,0.34971551453787914
25766,0.6416666666666667,16,64,16,518584,87026,61136,46820,0.8061247174774908,0.3498049997758618
25767,0.6416666666666668,1,0,1,518584,87026,61137,46819,0.8061247174774908,0.3498001419552467
25768,0.641690476190476,0,1,0,518585,87025,61137,46819,0.8061154544444032,0.34980275544663936
25769,0.6417142857142857,0,2,0,518587,87023,61137,46819,0.8060969283782282,0.3498079825465848
25770,0.6417142857142858,1,2,1,518589,87021,61138,46818,0.8060784023120531,0.349808351825701
25771,0.6417380952380952,0,1,0,518590,87020,61138,46818,0.8060691392789655,0.34981096549559915
25772,0.6417738095238096,1,1,1,518591,87019,61139,46817,0.8060598762458779,0.3498087211213724
25773,0.6417857142857143,1,2,1,518593,87017,61140,46816,0.8060413501797028,0.3498090904336001
25774,0.6417857142857144,0,1,0,518594,87016,61140,46816,0.8060320871466153,0.349811704226194
25775,0.6418095238095237,1,0,1,518594,87016,61141,46815,0.8060320871466153,0.34980684594750094
25776,0.6418333333333334,1,19,1,518613,86997,61142,46814,0.8058560895179517,0.34985165644080085
25777,0.641868215118215,0,2,0,518615,86995,61142,46814,0.8058375634517766,0.349856885560762
25778,0.6419047619047619,1,3,1,518618,86992,61143,46813,0.805809774352514,0.3498598707073727
25779,0.6419047619047621,1,0,1,518618,86992,61144,46812,0.805809774352514,0.34985501180831663
25780,0.6419166666666666,0,1,0,518619,86991,61144,46812,0.8058005113194264,0.34985762651061636
25781,0.6419285714285715,1,1,1,518620,86990,61145,46811,0.8057912482863389,0.34985538224676943
25782,0.6419642857142857,0,1,0,518621,86989,61145,46811,0.8057819852532513,0.3498579970104634
25783,0.6419761904761905,0,1,0,518622,86988,61145,46811,0.8057727222201637,0.34986061181324224
25784,0.6419924242424241,0,1,0,518623,86987,61145,46811,0.8057634591870763,0.34986322665510694
25785,0.6419999999999999,0,4,0,518627,86983,61145,46811,0.805726407054726,0.3498736864134416
25786,0.642,8,36,8,518663,86947,61153,46803,0.805392937863574,0.3499289719626168
25787,0.6420238095238097,0,2,0,518665,86945,61153,46803,0.805374411797399,0.3499342046236205
25788,0.6420833333333333,1,0,1,518665,86945,61154,46802,0.805374411797399,0.34992934420958977
25789,0.6420833333333335,0,1,0,518666,86944,61154,46802,0.8053651487643114,0.3499319605819987
25790,0.6421038961038963,1,1,1,518667,86943,61155,46801,0.8053558857312239,0.3499297164732624
25791,0.6421363636363637,1,1,1,518668,86942,61156,46800,0.8053466226981363,0.34992747229740845
25792,0.6421388888888889,0,1,0,518669,86941,61156,46800,0.8053373596650487,0.34993008875363574
25793,0.6421428571428572,0,1,0,518670,86940,61156,46800,0.8053280966319611,0.34993270524899056
25794,0.6421666666666666,0,1,0,518671,86939,61156,46800,0.8053188335988736,0.3499353217834738
25795,0.6421666666666667,1,7,1,518678,86932,61157,46799,0.8052539923672607,0.3499487777703001
25796,0.6421904761904762,0,1,0,518679,86931,61157,46799,0.8052447293341732,0.34995139460106184
25797,0.6422222222222222,0,1,0,518680,86930,61157,46799,0.8052354663010857,0.34995401147095995
25798,0.64225,0,1,0,518681,86929,61157,46799,0.8052262032679981,0.3499566283799952
25799,0.6422619047619047,0,1,0,518682,86928,61157,46799,0.8052169402349105,0.3499592453281686
25800,0.6422857142857142,0,5,0,518687,86923,61157,46799,0.8051706250694728,0.34997233065613736
25801,0.6423318070818069,0,1,0,518688,86922,61157,46799,0.8051613620363852,0.34997494783915767
25802,0.6423333333333332,1,5,1,518693,86917,61158,46798,0.8051150468709474,0.34998317316681
25803,0.6423333333333333,5,11,5,518704,86906,61163,46793,0.8050131535069843,0.3499876588456159
25804,0.642357142857143,1,1,1,518705,86905,61164,46792,0.8050038904738968,0.34998541478118433
25805,0.6423809523809524,0,6,0,518711,86899,61164,46792,0.8049483122753714,0.3500011219902611
25806,0.642404761904762,0,1,0,518712,86898,61164,46792,0.8049390492422839,0.350003739995512
25807,0.6424523809523809,0,1,0,518713,86897,61164,46792,0.8049297862091963,0.35000635803992847
25808,0.6424761904761905,0,1,0,518714,86896,61164,46792,0.8049205231761087,0.35000897612351145
25809,0.6424880952380951,1,0,1,518714,86896,61165,46791,0.8049205231761087,0.3500041140873832
25810,0.6425,45,170,45,518884,86726,61210,46746,0.8033458075512245,0.35023076000959
25811,0.6425400432900432,1,0,1,518884,86726,61211,46745,0.8033458075512245,0.35022589176675084
25812,0.642547619047619,1,0,1,518884,86726,61212,46744,0.8033458075512245,0.3502210234509628
25813,0.6426190476190476,0,1,0,518885,86725,61212,46744,0.803336544518137,0.3502236474387311
25814,0.6426309523809524,0,2,0,518887,86723,61212,46744,0.8033180184519619,0.35022889553222897
25815,0.6426666666666665,1,3,1,518890,86720,61213,46743,0.8032902293526992,0.3502318994777579
25816,0.6426666666666666,3,25,3,518915,86695,61216,46740,0.8030586535255104,0.3502829092816727
25817,0.6426666666666668,0,5,0,518920,86690,61216,46740,0.8030123383600726,0.3502960353743536
25818,0.6427023809523809,1,0,1,518920,86690,61217,46739,0.8030123383600726,0.3502911660883316
25819,0.6427142857142857,0,3,0,518923,86687,61217,46739,0.80298454926081,0.35029904216569485
25820,0.6427499999999999,0,1,0,518924,86686,61217,46739,0.8029752862277224,0.3503016676035226
25821,0.6428095238095238,0,1,0,518925,86685,61217,46739,0.8029660231946348,0.3503042930807051
25822,0.6428239538239537,1,0,1,518925,86685,61218,46738,0.8029660231946348,0.3502994236376037
25823,0.6428333333333334,2,4,2,518929,86681,61220,46736,0.8029289710622847,0.35030018663288787
25824,0.6428571428571428,3,2,3,518931,86679,61223,46733,0.8029104449961095,0.3502908284112374
25825,0.6428809523809523,0,1,0,518932,86678,61223,46733,0.802901181963022,0.3502934540630083
25826,0.6429166666666667,0,3,0,518935,86675,61223,46733,0.8028733928637594,0.35030133125449747
25827,0.6429285714285714,1,1,1,518936,86674,61224,46732,0.8028641298306718,0.35029908699758633
25828,0.6429523809523812,0,1,0,518937,86673,61224,46732,0.8028548667975842,0.35030171282935424
25829,0.6429761904761905,0,1,0,518938,86672,61224,46732,0.8028456037644967,0.3503043387004887
25830,0.643,11,22,11,518960,86650,61235,46721,0.8026418170365704,0.35030853783806076
25831,0.6430000000000001,1,6,1,518966,86644,61236,46720,0.8025862388380451,0.3503194265318977
25832,0.6430079365079365,0,1,0,518967,86643,61236,46720,0.8025769758049576,0.35032205334313116
25833,0.6430357142857143,1,0,1,518967,86643,61237,46719,0.8025769758049576,0.3503171818059117
25834,0.6430476190476191,0,2,0,518969,86641,61237,46719,0.8025584497387824,0.35032243551289743
25835,0.6430714285714285,0,1,0,518970,86640,61237,46719,0.8025491867056949,0.3503250624254831
25836,0.6431190476190477,0,2,0,518972,86638,61237,46719,0.8025306606395198,0.35033031636884454
25837,0.643120243136577,1,0,1,518972,86638,61238,46718,0.8025306606395198,0.35032544467440535
25838,0.6431363424157541,1,2,1,518974,86636,61239,46717,0.8025121345733447,0.3503258269405263
25839,0.6431428571428571,1,1,1,518975,86635,61240,46716,0.8025028715402571,0.3503235821253684
25840,0.6431666666666667,1,7,1,518982,86628,61241,46715,0.8024380303086442,0.3503371005602094
25841,0.6432359307359308,1,5,1,518987,86623,61242,46714,0.8023917151432065,0.35034536550244866
25842,0.6432857142857142,0,1,0,518988,86622,61242,46714,0.8023824521101189,0.3503479930401392
25843,0.6433095238095238,0,1,0,518989,86621,61242,46714,0.8023731890770314,0.35035062061724226
25844,0.6433333333333331,0,1,0,518990,86620,61242,46714,0.8023639260439438,0.35035324823375885
25845,0.6433333333333333,46,108,46,519098,86512,61288,46668,0.8013635184704879,0.35041297492115936
25846,0.6433333333333334,70,211,70,519309,86301,61358,46598,0.799409018489014,0.35062716799975924
25847,0.643345238095238,0,1,0,519310,86300,61358,46598,0.7993997554559265,0.3506298063176271
25848,0.6433571428571428,0,2,0,519312,86298,61358,46598,0.7993812293897514,0.3506350830724777
25849,0.6434047619047618,0,1,0,519313,86297,61358,46598,0.7993719663566639,0.3506377215094624
25850,0.6434285714285712,0,1,0,519314,86296,61358,46598,0.7993627033235763,0.3506403599861544
25851,0.6434880952380952,0,3,0,519317,86293,61358,46598,0.7993349142243136,0.35064827565448375
25852,0.6435,9,23,9,519340,86270,61367,46589,0.7991218644632999,0.350664990704431
25853,0.6435000000000001,0,4,0,519344,86266,61367,46589,0.7990848123309496,0.35067554853035265
25854,0.6435238095238094,0,1,0,519345,86265,61367,46589,0.7990755492978621,0.3506781880861698
25855,0.6435714285714285,0,1,0,519346,86264,61367,46589,0.7990662862647745,0.35068082768172343
25856,0.6435714285714286,1,1,1,519347,86263,61368,46588,0.799057023231687,0.3506785797622901
25857,0.6435952380952381,1,0,1,519347,86263,61369,46587,0.799057023231687,0.3506736921339857
25858,0.6436190476190476,0,2,0,519349,86261,61369,46587,0.7990384971655119,0.3506789714561002
25859,0.6436428571428572,1,1,1,519350,86260,61370,46586,0.7990292341324243,0.35067672342411516
25860,0.6436547619047619,0,1,0,519351,86259,61370,46586,0.7990199710993368,0.35067936316760134
25861,0.6436666666666666,0,3,0,519354,86256,61370,46586,0.7989921820000742,0.35068728263651555
25862,0.6436666666666667,4,11,4,519365,86245,61374,46582,0.798890288636111,0.35069677098782626
25863,0.6436904761904763,0,2,0,519367,86243,61374,46582,0.7988717625699359,0.35070205157161677
25864,0.6437142857142857,0,1,0,519368,86242,61374,46582,0.7988624995368483,0.3507046919231464
25865,0.64375,3,4,3,519372,86238,61377,46579,0.7988254474044981,0.3507005880271351
25866,0.6437738095238095,0,2,0,519374,86236,61377,46579,0.798806921338323,0.35070586906599405
25867,0.6437777777777777,0,1,0,519375,86235,61377,46579,0.7987976583052354,0.35070850964506756
25868,0.6437857142857143,0,2,0,519377,86233,61377,46579,0.7987791322390604,0.350713790922507
25869,0.6438095238095238,1,7,1,519384,86226,61378,46578,0.7987142910074475,0.35072738772928524
25870,0.6438333333333331,1,2,1,519386,86224,61379,46577,0.7986957649412724,0.3507277806643022
25871,0.6438333333333333,2,9,2,519395,86215,61381,46575,0.7986123976434844,0.3507417727238497
25872,0.6438333333333334,0,5,0,519400,86210,61381,46575,0.7985660824780466,0.35075497985465226
25873,0.6438419913419913,0,1,0,519401,86209,61381,46575,0.798556819444959,0.3507576214001687
25874,0.6438484848484849,1,0,1,519401,86209,61382,46574,0.798556819444959,0.35075273190092104
25875,0.6438571428571429,0,2,0,519403,86207,61382,46574,0.7985382933787839,0.35075801507745835
25876,0.643857142857143,1,1,1,519404,86206,61383,46573,0.7985290303456964,0.3507557671017254
25877,0.6438809523809523,0,1,0,519405,86205,61383,46573,0.7985197673126089,0.3507584087725376
25878,0.6438888888888888,0,2,0,519407,86203,61383,46573,0.7985012412464337,0.3507636922335362
25879,0.6439166666666667,0,1,0,519408,86202,61383,46573,0.7984919782133462,0.35076633402372437
25880,0.6439285714285714,0,2,0,519410,86200,61383,46573,0.798473452147171,0.3507716177234829
25881,0.6439444444444444,1,5,1,519415,86195,61384,46572,0.7984271369817333,0.35077993778574496
25882,0.6439523809523809,0,1,0,519416,86194,61384,46572,0.7984178739486457,0.35078257987737826
25883,0.6439722222222222,0,1,0,519417,86193,61384,46572,0.7984086109155581,0.35078522200881257
25884,0.6439920634920635,0,1,0,519418,86192,61384,46572,0.7983993478824707,0.3507878641800488
25885,0.6439978354978355,0,2,0,519420,86190,61384,46572,0.7983808218162955,0.3507931486419307
25886,0.6439999999999999,1,2,1,519422,86188,61385,46571,0.7983622957501204,0.3507935431872792
25887,0.644,19,65,19,519487,86123,61404,46552,0.7977601985994294,0.35087243263614093
25888,0.6440205627705626,0,1,0,519488,86122,61404,46552,0.7977509355663418,0.35087507725703604
25889,0.6440238095238097,0,1,0,519489,86121,61404,46552,0.7977416725332543,0.35087772191779787
25890,0.6440277777777778,1,0,1,519489,86121,61405,46551,0.7977416725332543,0.3508728292329957
25891,0.6440317460317457,0,1,0,519490,86120,61405,46551,0.7977324095001668,0.3508754739166811
25892,0.644047619047619,1,7,1,519497,86113,61406,46550,0.7976675682685539,0.3508890949247341
25893,0.6440952380952382,1,0,1,519497,86113,61407,46549,0.7976675682685539,0.35088420195685277
25894,0.6441666666666666,13,40,13,519537,86073,61420,46536,0.7972970469450517,0.3509264077098839
25895,0.6441666666666667,10,31,10,519568,86042,61430,46526,0.7970098929193375,0.3509595075734717
25896,0.6441666666666669,1,0,1,519568,86042,61431,46525,0.7970098929193375,0.3509546116303454
25897,0.6442380952380953,0,2,0,519570,86040,61431,46525,0.7969913668531624,0.3509599064609814
25898,0.6442857142857144,3,6,3,519576,86034,61434,46522,0.7969357886546371,0.35096110323184165
25899,0.6443095238095238,0,1,0,519577,86033,61434,46522,0.7969265256215495,0.3509637508958546
25900,0.6443095238095239,1,0,1,519577,86033,61435,46521,0.7969265256215495,0.35095885450457925
25901,0.6443333333333332,0,4,0,519581,86029,61435,46521,0.7968894734891993,0.35096944549226705
25902,0.6443333333333334,3,20,3,519601,86009,61438,46518,0.7967042128274482,0.35100771918175167
25903,0.6443571428571429,0,1,0,519602,86008,61438,46518,0.7966949497943606,0.35101036777688904
25904,0.6443795093795093,0,1,0,519603,86007,61438,46518,0.7966856867612732,0.3510130164119977
25905,0.6443809523809524,0,1,0,519604,86006,61438,46518,0.7966764237281856,0.35101566508707854
25906,0.6444047619047619,0,1,0,519605,86005,61438,46518,0.796667160695098,0.35101831380213244
25907,0.6444444444444444,0,1,0,519606,86004,61438,46518,0.7966578976620105,0.3510209625571603
25908,0.644452380952381,0,4,0,519610,86000,61438,46518,0.7966208455296603,0.35103155797702956
25909,0.6444999999999999,0,1,0,519611,85999,61438,46518,0.7966115824965727,0.3510342069319408
25910,0.6445000000000001,2,7,2,519618,85992,61440,46516,0.7965467412649598,0.35104295589700246
25911,0.6445000000000002,1,0,1,519618,85992,61441,46515,0.7965467412649598,0.3510380583667278
25912,0.6445238095238095,0,1,0,519619,85991,61441,46515,0.7965374782318723,0.3510407075905997
25913,0.6445714285714286,1,1,1,519620,85990,61442,46514,0.7965282151987847,0.35103845921632554
25914,0.6445833333333334,0,2,0,519622,85988,61442,46514,0.7965096891326096,0.35104375783007047
25915,0.6446111111111111,0,1,0,519623,85987,61442,46514,0.796500426099522,0.3510464071969268
25916,0.6446190476190476,0,1,0,519624,85986,61442,46514,0.7964911630664345,0.3510490566037736
25917,0.6446428571428572,1,2,1,519626,85984,61443,46513,0.7964726370002594,0.3510494577235711
25918,0.6446666666666665,1,0,1,519626,85984,61444,46512,0.7964726370002594,0.3510445598357686
25919,0.6446666666666667,6,18,6,519644,85966,61450,46506,0.7963059024046834,0.35106286611510357
25920,0.6447142857142856,0,1,0,519645,85965,61450,46506,0.7962966393715958,0.3510655162261929
25921,0.6447499999999999,0,3,0,519648,85962,61450,46506,0.7962688502723332,0.35107346679952894
25922,0.6447857142857143,0,1,0,519649,85961,61450,46506,0.7962595872392456,0.35107611707066666
25923,0.6448333333333331,0,4,0,519653,85957,61450,46506,0.7962225351068954,0.35108671855537016
25924,0.6448333333333334,3,8,3,519661,85949,61453,46503,0.796148430842195,0.35109322622534955
25925,0.6448333333333335,0,1,0,519662,85948,61453,46503,0.7961391678091074,0.35109587696582134
25926,0.6448809523809524,0,2,0,519664,85946,61453,46503,0.7961206417429323,0.3511011785668446
25927,0.6448888888888888,0,1,0,519665,85945,61453,46503,0.7961113787098447,0.35110382942739793
25928,0.6449058441558441,1,1,1,519666,85944,61454,46502,0.7961021156767571,0.3511015810216994
25929,0.6449415584415584,1,0,1,519666,85944,61455,46501,0.7961021156767571,0.3510966816414361
25930,0.6449999999999999,0,1,0,519667,85943,61455,46501,0.7960928526436697,0.3510993325480958
25931,0.645,189,614,189,520281,85329,61644,46312,0.7904053503279114,0.35180528862588406
25932,0.6450000000000001,0,1,0,520282,85328,61644,46312,0.7903960872948238,0.3518079611060468
25933,0.6450476190476191,0,1,0,520283,85327,61644,46312,0.7903868242617362,0.3518106336268127
25934,0.6450952380952382,0,1,0,520284,85326,61644,46312,0.7903775612286487,0.35181330618818274
25935,0.6451190476190476,1,1,1,520285,85325,61645,46311,0.7903682981955612,0.3518110547266705
25936,0.645142857142857,0,1,0,520286,85324,61645,46311,0.7903590351624736,0.351813727352148
25937,0.6451666666666666,0,3,0,520289,85321,61645,46311,0.7903312460632109,0.3518217454722256
25938,0.6451666666666667,1,2,1,520291,85319,61646,46310,0.7903127199970358,0.3518221668477311
25939,0.6451666666666668,0,2,0,520293,85317,61646,46310,0.7902941939308608,0.35182751259240125
25940,0.6451904761904761,0,1,0,520294,85316,61646,46310,0.7902849308977732,0.35183018552565604
25941,0.6452142857142857,0,1,0,520295,85315,61646,46310,0.7902756678646856,0.35183285849952517
25942,0.6452272727272726,0,1,0,520296,85314,61646,46310,0.790266404831598,0.3518355315140096
25943,0.6452380952380952,1,1,1,520297,85313,61647,46309,0.7902571417985105,0.3518332801507347
25944,0.6452777777777777,0,3,0,520300,85310,61647,46309,0.7902293526992479,0.35184129950842963
25945,0.6452857142857142,0,2,0,520302,85308,61647,46309,0.7902108266330727,0.35184664594999127
25946,0.6452857142857144,1,2,1,520304,85306,61648,46308,0.7901923005668976,0.3518470679411005
25947,0.6453333333333333,4,18,4,520322,85288,61652,46304,0.7900255659713217,0.35187549395100004
25948,0.6453571428571427,0,1,0,520323,85287,61652,46304,0.7900163029382341,0.35187816795981486
25949,0.6453809523809524,0,3,0,520326,85284,61652,46304,0.7899885138389714,0.3518861902301122
25950,0.6453986568986569,0,2,0,520328,85282,61652,46304,0.7899699877727964,0.35189153861353034
25951,0.6454166666666665,1,0,1,520328,85282,61653,46303,0.7899699877727964,0.35188661321579207
25952,0.6454166666666667,0,1,0,520329,85281,61653,46303,0.7899607247397088,0.3518892874513619
25953,0.6454285714285715,0,2,0,520331,85279,61653,46303,0.7899421986735337,0.35189463604444376
25954,0.6454444444444444,0,1,0,520332,85278,61653,46303,0.7899329356404461,0.3518973104019577
25955,0.6454523809523809,0,1,0,520333,85277,61653,46303,0.7899236726073585,0.3518999848001216
25956,0.6454761904761903,0,2,0,520335,85275,61653,46303,0.7899051465411835,0.35190533371840277
25957,0.6454761904761905,0,2,0,520337,85273,61653,46303,0.7898866204750083,0.3519106827992947
25958,0.6454999999999999,0,2,0,520339,85271,61653,46303,0.7898680944088332,0.3519160320428048
25959,0.6455,2,5,2,520344,85266,61655,46301,0.7898217792433955,0.35191955429553
25960,0.6455000000000001,2,5,2,520349,85261,61657,46299,0.7897754640779577,0.35192307692307695
25961,0.6455476190476189,0,6,0,520355,85255,61657,46299,0.7897198858794323,0.3519391276586041
25962,0.6456031746031745,0,1,0,520356,85254,61657,46299,0.7897106228463449,0.3519418029235365
25963,0.6456046176046177,0,1,0,520357,85253,61657,46299,0.7897013598132573,0.3519444782291413
25964,0.6456190476190475,0,1,0,520358,85252,61657,46299,0.7896920967801697,0.3519471535754194
25965,0.6456666666666666,4,19,4,520377,85233,61661,46295,0.7895160991515062,0.3519782859923362
25966,0.6456904761904763,0,3,0,520380,85230,61661,46295,0.7894883100522435,0.35198631438889944
25967,0.645702380952381,1,1,1,520381,85229,61662,46294,0.7894790470191559,0.35198406362385287
25968,0.6457142857142857,5,8,5,520389,85221,61667,46289,0.7894049427544555,0.3519808379590906
25969,0.6457380952380951,0,1,0,520390,85220,61667,46289,0.7893956797213679,0.35198351443627435
25970,0.6457857142857142,0,1,0,520391,85219,61667,46289,0.7893864166882804,0.3519861909541625
25971,0.6458095238095238,0,1,0,520392,85218,61667,46289,0.7893771536551929,0.351988867512756
25972,0.6458333333333333,4,22,4,520414,85196,61671,46285,0.7891733669272667,0.3520280496801819
25973,0.6458333333333335,11,53,11,520467,85143,61682,46274,0.7886824261736263,0.352115784107079
25974,0.6459523809523811,0,1,0,520468,85142,61682,46274,0.7886731631405387,0.35211846350520487
25975,0.6459999999999999,13,70,13,520538,85072,61695,46261,0.7880247508244099,0.3522420107665248
25976,0.6460000000000001,2,1,2,520539,85071,61697,46259,0.7880154877913224,0.3522348282951344
25977,0.6460357142857143,0,1,0,520540,85070,61697,46259,0.7880062247582348,0.3522375103747078
25978,0.6460555555555555,0,2,0,520542,85068,61697,46259,0.7879876986920598,0.35224287465639204
25979,0.6461111111111112,1,1,1,520543,85067,61698,46258,0.7879784356589722,0.35224062440510184
25980,0.6461190476190475,0,3,0,520546,85064,61698,46258,0.7879506465597095,0.35224867120512937
25981,0.6461428571428571,1,1,1,520547,85063,61699,46257,0.7879413835266219,0.35224642095644226
25982,0.6461666666666666,0,3,0,520550,85060,61699,46257,0.7879135944273593,0.35225446819528317
25983,0.6461666666666668,3,9,3,520559,85051,61702,46254,0.7878302271295713,0.3522638132592057
25984,0.6461904761904762,2,4,2,520563,85047,61704,46252,0.7877931749972211,0.3522646783296141
25985,0.6462142857142856,0,1,0,520564,85046,61704,46252,0.7877839119641336,0.35226736126978325
25986,0.64625,1,4,1,520568,85042,61705,46251,0.7877468598317833,0.3522731600313802
25987,0.6462857142857144,0,1,0,520569,85041,61705,46251,0.7877375967986958,0.35227584315876065
25988,0.6463095238095238,1,3,1,520572,85038,61706,46250,0.7877098076994331,0.3522789592346597
25989,0.6463333333333332,4,19,4,520591,85019,61710,46246,0.7875338100707696,0.3523102121662286
25990,0.6463333333333334,0,3,0,520594,85016,61710,46246,0.7875060209715069,0.352318264234889
25991,0.6464285714285714,0,3,0,520597,85013,61710,46246,0.7874782318722442,0.35232631667161873
25992,0.6464469696969697,1,3,1,520600,85010,61711,46245,0.7874504427729816,0.3523294350691402
25993,0.6464523809523809,2,2,2,520602,85008,61713,46243,0.7874319167068065,0.3523249346671644
25994,0.6464642857142857,0,1,0,520603,85007,61713,46243,0.7874226536737189,0.35232761904761906
25995,0.6465,0,3,0,520606,85004,61713,46243,0.7873948645744563,0.35233567243441755
25996,0.6465000000000001,7,12,7,520618,84992,61720,46236,0.7872837081774056,0.35233334349376655
25997,0.6465238095238095,0,1,0,520619,84991,61720,46236,0.7872744451443181,0.3523360284087878
25998,0.6465375180375179,0,1,0,520620,84990,61720,46236,0.7872651821112305,0.35233871336472955
25999,0.6465476190476189,0,1,0,520621,84989,61720,46236,0.787255919078143,0.3523413983615927
26000,0.6465555555555557,0,1,0,520622,84988,61720,46236,0.7872466560450554,0.35234408339937817
26001,0.6465833333333333,2,2,2,520624,84986,61722,46234,0.7872281299788803,0.35233958238073465
26002,0.6466111111111111,0,1,0,520625,84985,61722,46234,0.7872188669457927,0.3523422675069921
26003,0.6466666666666666,75,205,75,520830,84780,61797,46159,0.7853199451628441,0.3525229305249009
26004,0.6466666666666667,31,112,31,520942,84668,61828,46128,0.784282485457038,0.35267133551484753
26005,0.6467619047619046,0,2,0,520944,84666,61828,46128,0.7842639593908629,0.35267672829028857
26006,0.6467857142857142,0,1,0,520945,84665,61828,46128,0.7842546963577753,0.3526794247398561
26007,0.6467857142857143,3,3,3,520948,84662,61831,46125,0.7842269072585127,0.3526726662435869
26008,0.6468077200577201,1,0,1,520948,84662,61832,46124,0.7842269072585127,0.35266771672809016
26009,0.646809523809524,0,2,0,520950,84660,61832,46124,0.7842083811923376,0.3526731098605334
26010,0.6468333333333333,0,2,0,520952,84658,61832,46124,0.7841898551261625,0.3526785031579269
26011,0.6468333333333334,6,12,6,520964,84646,61838,46118,0.7840786987291118,0.3526811660701722
26012,0.6468571428571428,0,1,0,520965,84645,61838,46118,0.7840694356960243,0.3526838631723041
26013,0.6469047619047619,1,0,1,520965,84645,61839,46117,0.7840694356960243,0.35267891283400377
26014,0.6469047619047621,0,1,0,520966,84644,61839,46117,0.7840601726629367,0.3526816099601563
26015,0.6469166666666666,0,2,0,520968,84642,61839,46117,0.7840416465967617,0.3526870043362216
26016,0.6469285714285715,0,4,0,520972,84638,61839,46117,0.7840045944644114,0.35269779358341935
26017,0.646952380952381,0,1,0,520973,84637,61839,46117,0.7839953314313238,0.3527004909983633
26018,0.6469999999999999,1,3,1,520976,84634,61840,46116,0.7839675423320612,0.3527036328871893
26019,0.647,6,19,6,520995,84615,61846,46110,0.7837915447033977,0.35272518646012624
26020,0.6470476190476191,0,1,0,520996,84614,61846,46110,0.7837822816703102,0.35272788470365046
26021,0.6470833333333332,0,1,0,520997,84613,61846,46110,0.7837730186372226,0.3527305829884565
26022,0.6470833333333335,0,1,0,520998,84612,61846,46110,0.783763755604135,0.35273328131454534
26023,0.647138888888889,1,0,1,520998,84612,61847,46109,0.783763755604135,0.3527283298016386
26024,0.6471428571428572,0,5,0,521003,84607,61847,46109,0.7837174404386973,0.3527418219651764
26025,0.6471666666666667,0,11,0,521014,84596,61847,46109,0.7836155470747341,0.3527715083585173
26026,0.6471944444444445,1,1,1,521015,84595,61848,46108,0.7836062840416466,0.35276925548763227
26027,0.647202380952381,2,0,2,521015,84595,61850,46106,0.7836062840416466,0.3527593514969281
26028,0.6472222222222223,0,1,0,521016,84594,61850,46106,0.783597021008559,0.3527620504973221
26029,0.6472380952380951,1,0,1,521016,84594,61851,46105,0.783597021008559,0.35275709837106634
26030,0.64725,0,1,0,521017,84593,61851,46105,0.7835877579754715,0.3527597973955225
26031,0.6473095238095238,1,0,1,521017,84593,61852,46104,0.7835877579754715,0.35275484517624733
26032,0.6473333333333332,1,4,1,521021,84589,61853,46103,0.7835507058431213,0.3527606892541242
26033,0.6473333333333333,5,16,5,521037,84573,61858,46098,0.7834024973137204,0.35277911701907844
26034,0.6473809523809524,0,2,0,521039,84571,61858,46098,0.7833839712475453,0.35278451660301985
26035,0.6473888888888888,0,2,0,521041,84569,61858,46098,0.7833654451813702,0.3527899163522542
26036,0.6474166666666668,1,0,1,521041,84569,61859,46097,0.7833654451813702,0.3527849631885877
26037,0.6474523809523809,0,1,0,521042,84568,61859,46097,0.7833561821482826,0.3527876631079478
26038,0.6474523809523811,0,1,0,521043,84567,61859,46097,0.783346919115195,0.35279036306863404
26039,0.6474761904761905,1,0,1,521043,84567,61860,46096,0.783346919115195,0.3527854097946626
26040,0.6474999999999999,0,1,0,521044,84566,61860,46096,0.7833376560821075,0.3527881097794309
26041,0.6475,55,153,55,521197,84413,61915,46041,0.7819204120197117,0.3529290017937357
26042,0.6475000000000002,0,2,0,521199,84411,61915,46041,0.7819018859535366,0.35293441265752923
26043,0.6476071428571428,0,1,0,521200,84410,61915,46041,0.781892622920449,0.35293711815164314
26044,0.6476190476190475,1,3,1,521203,84407,61916,46040,0.7818648338211864,0.3529402745942797
26045,0.6476428571428571,0,1,0,521204,84406,61916,46040,0.7818555707880989,0.35294298023703297
26046,0.6476666666666666,8,17,8,521221,84389,61924,46032,0.7816980992256104,0.3529492949755024
26047,0.6476666666666668,0,3,0,521224,84386,61924,46032,0.7816703101263478,0.3529574138539159
26048,0.6476796536796534,0,2,0,521226,84384,61924,46032,0.7816517840601727,0.35296282664703715
26049,0.64775,0,2,0,521228,84382,61924,46032,0.7816332579939975,0.35296823960617724
26050,0.6477777777777777,0,1,0,521229,84381,61924,46032,0.78162399496091,0.3529709461480067
26051,0.6477857142857144,0,1,0,521230,84380,61924,46032,0.7816147319278225,0.35297365273134373
26052,0.6478055555555556,1,1,1,521231,84379,61925,46031,0.7816054688947349,0.3529713978989341
26053,0.6478095238095238,0,3,0,521234,84376,61925,46031,0.7815776797954722,0.35297951797066107
26054,0.6478333333333333,2,8,2,521242,84368,61927,46029,0.7815035755307718,0.3529912497986917
26055,0.6478333333333335,0,1,0,521243,84367,61927,46029,0.7814943124976842,0.35299395686984264
26056,0.6478412698412699,0,1,0,521244,84366,61927,46029,0.7814850494645967,0.35299666398251467
26057,0.6478571428571428,1,1,1,521245,84365,61928,46028,0.7814757864315092,0.3529944092090833
26058,0.6478809523809522,0,1,0,521246,84364,61928,46028,0.7814665233984216,0.3529971163875084
26059,0.6478809523809526,0,1,0,521247,84363,61928,46028,0.781457260365334,0.3529998236074576
26060,0.6479166666666666,0,1,0,521248,84362,61928,46028,0.7814479973322465,0.3530025308689317
26061,0.6479761904761904,0,1,0,521249,84361,61928,46028,0.7814387342991589,0.3530052381719317
26062,0.6479761904761905,1,0,1,521249,84361,61929,46027,0.7814387342991589,0.3530002760990275
26063,0.6479823232323231,0,1,0,521250,84360,61929,46027,0.7814294712660713,0.3530029834262618
26064,0.6479999999999998,0,1,0,521251,84359,61929,46027,0.7814202082329839,0.35300569079502403
26065,0.648,12,28,12,521279,84331,61941,46015,0.7811608433065322,0.3530219569453608
26066,0.6480000000000001,1,3,1,521282,84328,61942,46014,0.7811330542072696,0.3530251185343174
26067,0.6480238095238096,0,1,0,521283,84327,61942,46014,0.7811237911741821,0.3530278270076185
26068,0.6480303030303031,0,1,0,521284,84326,61942,46014,0.7811145281410945,0.35303053552247965
26069,0.648047619047619,0,1,0,521285,84325,61942,46014,0.7811052651080069,0.35303324407890196
26070,0.6480833333333333,1,1,1,521286,84324,61943,46013,0.7810960020749194,0.35303098889801054
26071,0.6480952380952381,0,1,0,521287,84323,61943,46013,0.7810867390418319,0.3530336975202553
26072,0.6481666666666667,2,14,2,521301,84309,61945,46011,0.7809570565786061,0.35306169429097606
26073,0.6481666666666668,1,0,1,521301,84309,61946,46010,0.7809570565786061,0.353056730024018
26074,0.6481904761904762,0,2,0,521303,84307,61946,46010,0.780938530512431,0.35306214845338674
26075,0.6483333333333333,13,68,13,521371,84239,61959,45997,0.7803086442624773,0.35318191590650816
26076,0.6483333333333334,34,96,34,521467,84143,61993,45963,0.7794193930860721,0.35327348469709313
26077,0.6483571428571427,0,1,0,521468,84142,61993,45963,0.7794101300529845,0.3532761999923139
26078,0.6483809523809524,0,2,0,521470,84140,61993,45963,0.7793916039868094,0.3532816307079775
26079,0.648452380952381,1,1,1,521471,84139,61994,45962,0.7793823409537219,0.3532793752546099
26080,0.6484761904761904,0,1,0,521472,84138,61994,45962,0.7793730779206344,0.3532820906994619
26081,0.6485,3,24,3,521496,84114,61997,45959,0.779150765126533,0.35333235952119196
26082,0.6485000000000001,0,1,0,521497,84113,61997,45959,0.7791415020934455,0.353335075957931
26083,0.6485238095238094,0,1,0,521498,84112,61997,45959,0.7791322390603579,0.35333779243643854
26084,0.6485476190476192,0,1,0,521499,84111,61997,45959,0.7791229760272703,0.3533405089567156
26085,0.6485555555555556,1,0,1,521499,84111,61998,45958,0.7791229760272703,0.35333553729174516
26086,0.6485714285714286,0,8,0,521507,84103,61998,45958,0.77904887176257,0.3533572708190772
26087,0.6486190476190477,0,1,0,521508,84102,61998,45958,0.7790396087294824,0.35335998769798554
26088,0.6486259018759017,0,1,0,521509,84101,61998,45958,0.7790303456963948,0.3533627046186731
26089,0.6486428571428572,0,2,0,521511,84099,61998,45958,0.7790118196302197,0.35336813858538946
26090,0.6486666666666665,0,1,0,521512,84098,61998,45958,0.7790025565971321,0.3533708556314203
26091,0.6486666666666666,0,4,0,521516,84094,61998,45958,0.778965504464782,0.35338172423338354
26092,0.6486666666666667,5,7,5,521523,84087,62003,45953,0.7789006632331691,0.353375884343279
26093,0.6486904761904762,0,1,0,521524,84086,62003,45953,0.7788914002000815,0.35337860180407416
26094,0.6487222222222221,0,1,0,521525,84085,62003,45953,0.778882137166994,0.3533813193066642
26095,0.6487380952380951,0,1,0,521526,84084,62003,45953,0.7788728741339064,0.3533840368510501
26096,0.6488095238095238,0,2,0,521528,84082,62003,45953,0.7788543480677314,0.3533894720652132
26097,0.648809523809524,0,1,0,521529,84081,62003,45953,0.7788450850346438,0.35339218973499237
26098,0.6488333333333333,3,6,3,521535,84075,62006,45950,0.7787895068361185,0.3533935781580465
26099,0.6488333333333334,0,2,0,521537,84073,62006,45950,0.7787709807699433,0.35339901402059637
26100,0.6488333333333336,0,1,0,521538,84072,62006,45950,0.7787617177368558,0.35340173201458214
26101,0.6488571428571427,1,1,1,521539,84071,62007,45949,0.7787524547037682,0.3533994770035379
26102,0.6488571428571429,0,2,0,521541,84069,62007,45949,0.778733928637593,0.35340491316586936
26103,0.6488690476190476,0,2,0,521543,84067,62007,45949,0.778715402571418,0.3534103494954467
26104,0.6488888888888888,0,1,0,521544,84066,62007,45949,0.7787061395383305,0.35341306772295505
26105,0.6489047619047621,0,1,0,521545,84065,62007,45949,0.7786968765052429,0.35341578599227774
26106,0.6489999999999999,0,1,0,521546,84064,62007,45949,0.7786876134721553,0.3534185043034158
26107,0.649,6,31,6,521577,84033,62013,45943,0.7784004594464411,0.3534729488520958
26108,0.6490119047619046,0,4,0,521581,84029,62013,45943,0.7783634073140909,0.35348382728587696
26109,0.6490119047619047,1,0,1,521581,84029,62014,45942,0.7783634073140909,0.3534788529748944
26110,0.649047619047619,3,3,3,521584,84026,62017,45939,0.7783356182148282,0.353472088639249
26111,0.6490476190476191,1,0,1,521584,84026,62018,45938,0.7783356182148282,0.35346711397002245
26112,0.6490714285714286,1,0,1,521584,84026,62019,45937,0.7783356182148282,0.35346213922424075
26113,0.6490952380952381,0,2,0,521586,84024,62019,45937,0.7783170921486532,0.353467578735159
26114,0.6490952380952382,0,1,0,521587,84023,62019,45937,0.7783078291155656,0.35347029855340106
26115,0.6491190476190476,0,2,0,521589,84021,62019,45937,0.7782893030493905,0.35347573831545576
26116,0.6491428571428571,0,1,0,521590,84020,62019,45937,0.7782800400163029,0.3534784582592704
26117,0.6491666666666666,10,36,10,521626,83984,62029,45927,0.777946570825151,0.3535266451647667
26118,0.6491666666666667,4,22,4,521648,83962,62033,45923,0.7777427840972247,0.35356661662239675
26119,0.6491666666666669,1,2,1,521650,83960,62034,45922,0.7777242580310497,0.35356708396852526
26120,0.649190476190476,0,1,0,521651,83959,62034,45922,0.7777149949979622,0.35356980620722045
26121,0.6491984126984127,0,1,0,521652,83958,62034,45922,0.7777057319648746,0.35357252848783494
26122,0.6492142857142857,0,1,0,521653,83957,62034,45922,0.777696468931787,0.35357525081036967
26123,0.6492380952380953,0,2,0,521655,83955,62034,45922,0.7776779428656119,0.35358069558120375
26124,0.6492857142857144,0,5,0,521660,83950,62034,45922,0.7776316277001741,0.3535943082419613
26125,0.6493214285714285,0,1,0,521661,83949,62034,45922,0.7776223646670866,0.353597030899893
26126,0.6493333333333332,1,1,1,521662,83948,62035,45921,0.777613101633999,0.3535947762745536
26127,0.6493333333333333,6,34,6,521696,83914,62041,45915,0.7772981585090222,0.353657503331305
26128,0.6493809523809524,0,1,0,521697,83913,62041,45915,0.7772888954759346,0.35366022737776137
26129,0.6493888888888888,0,1,0,521698,83912,62041,45915,0.777279632442847,0.35366295146618193
26130,0.6494047619047619,0,1,0,521699,83911,62041,45915,0.7772703694097596,0.3536656755965677
26131,0.6494365079365079,0,1,0,521700,83910,62041,45915,0.777261106376672,0.3536683997689197
26132,0.6494444444444444,0,1,0,521701,83909,62041,45915,0.7772518433435844,0.35367112398323886
26133,0.649452380952381,2,0,2,521701,83909,62043,45913,0.7772518433435844,0.35366116682842663
26134,0.649456349206349,0,1,0,521702,83908,62043,45913,0.7772425803104969,0.3536638910499842
26135,0.6494761904761904,0,1,0,521703,83907,62043,45913,0.7772333172774093,0.353666615313511
26136,0.6494999999999999,0,3,0,521706,83904,62043,45913,0.7772055281781467,0.3536747883559164
26137,0.6495000000000001,2,9,2,521715,83895,62045,45911,0.7771221608803587,0.3536893518019198
26138,0.6495000000000002,0,2,0,521717,83893,62045,45911,0.7771036348141835,0.35369480139286924
26139,0.6495101010101009,1,3,1,521720,83890,62046,45910,0.7770758457149209,0.3536979969183359
26140,0.6495119047619048,0,1,0,521721,83889,62046,45910,0.7770665826818334,0.3537007218853766
26141,0.6495238095238095,1,2,1,521723,83887,62047,45909,0.7770480566156582,0.35370119264075933
26142,0.6495873015873016,0,1,0,521724,83886,62047,45909,0.7770387935825707,0.3537039177163989
26143,0.649595238095238,0,2,0,521726,83884,62047,45909,0.7770202675163955,0.35370936799365144
26144,0.6496190476190474,0,1,0,521727,83883,62047,45909,0.7770110044833081,0.35371209319526625
26145,0.6496309523809523,0,1,0,521728,83882,62047,45909,0.7770017414502205,0.3537148184388748
26146,0.6496428571428572,2,1,2,521729,83881,62049,45907,0.7769924784171329,0.35370758467654945
26147,0.6496520146520147,0,1,0,521730,83880,62049,45907,0.7769832153840454,0.35371030996941144
26148,0.6496666666666665,0,1,0,521731,83879,62049,45907,0.7769739523509578,0.3537130353042701
26149,0.6496666666666667,6,11,6,521742,83868,62055,45901,0.7768720589869947,0.3537131364193297
26150,0.6497142857142856,1,0,1,521742,83868,62056,45900,0.7768720589869947,0.3537081560939523
26151,0.6497142857142858,0,1,0,521743,83867,62056,45900,0.7768627959539072,0.3537108818112463
26152,0.6497499999999999,0,2,0,521745,83865,62056,45900,0.776844269887732,0.35371633337186453
26153,0.6497501403824931,1,1,1,521746,83864,62057,45899,0.7768350068546445,0.35371407874355554
26154,0.6497619047619048,0,2,0,521748,83862,62057,45899,0.7768164807884693,0.35371953052149724
26155,0.6498290043290044,0,1,0,521749,83861,62057,45899,0.7768072177553819,0.35372225647348954
26156,0.6498333333333332,0,4,0,521753,83857,62057,45899,0.7767701656230316,0.3537331607016246
26157,0.6498333333333334,1,8,1,521761,83849,62058,45898,0.7766960613583311,0.35374999036586585
26158,0.6498333333333335,1,1,1,521762,83848,62059,45897,0.7766867983252436,0.35374773594358166
26159,0.6498571428571428,0,1,0,521763,83847,62059,45897,0.7766775352921561,0.3537504624491306
26160,0.6498571428571429,0,4,0,521767,83843,62059,45897,0.7766404831598058,0.3537613688916294
26161,0.6499047619047619,0,1,0,521768,83842,62059,45897,0.7766312201267183,0.35376409560733474
26162,0.6499523809523808,1,1,1,521769,83841,62060,45896,0.7766219570936307,0.3537618412634792
26163,0.6499999999999999,0,1,0,521770,83840,62060,45896,0.7766126940605432,0.3537645680458778
26164,0.65,594,1726,594,523496,82114,62654,45302,0.7606246989514247,0.35554404470396184
26165,0.6500000000000001,0,2,0,523498,82112,62654,45302,0.7606061728852496,0.3555496256298366
26166,0.6500476190476191,0,1,0,523499,82111,62654,45302,0.760596909852162,0.35555241615847677
26167,0.6500714285714286,0,1,0,523500,82110,62654,45302,0.7605876468190744,0.35555520673092017
26168,0.6500833333333332,1,1,1,523501,82109,62655,45301,0.7605783837859869,0.35555293932972293
26169,0.650142857142857,0,1,0,523502,82108,62655,45301,0.7605691207528993,0.35555572997198
26170,0.6501666666666666,0,1,0,523503,82107,62655,45301,0.7605598577198118,0.35555852065804344
26171,0.6501666666666667,0,14,0,523517,82093,62655,45301,0.7604301752565861,0.3555975948631804
26172,0.6501666666666668,2,3,2,523520,82090,62657,45299,0.7604023861573234,0.35559585207513994
26173,0.6501785714285714,1,0,1,523520,82090,62658,45298,0.7604023861573234,0.3555907934813326
26174,0.6501904761904762,0,1,0,523521,82089,62658,45298,0.7603931231242358,0.3555935849026981
26175,0.6502142857142857,0,1,0,523522,82088,62658,45298,0.7603838600911482,0.3555963763678897
26176,0.6502380952380952,1,0,1,523522,82088,62659,45297,0.7603838600911482,0.35559131765906504
26177,0.6502500000000001,0,1,0,523523,82087,62659,45297,0.7603745970580607,0.3555941091502858
26178,0.6502738095238095,0,2,0,523525,82085,62659,45297,0.7603560709918856,0.3555996922642132
26179,0.6502857142857144,1,0,1,523525,82085,62660,45296,0.7603560709918856,0.3555946334225669
26180,0.6503030303030303,0,1,0,523526,82084,62660,45296,0.760346807958798,0.3555974250274768
26181,0.6503058608058607,0,1,0,523527,82083,62660,45296,0.7603375449257105,0.3556002166762182
26182,0.6503095238095239,0,2,0,523529,82081,62660,45296,0.7603190188595353,0.35560580010519954
26183,0.6503333333333333,0,13,0,523542,82068,62660,45296,0.7601985994293972,0.3556420966678182
26184,0.6503333333333334,0,3,0,523545,82065,62660,45296,0.7601708103301344,0.35565047384992265
26185,0.6503571428571427,0,3,0,523548,82062,62660,45296,0.7601430212308719,0.35565885142668696
26186,0.6504047619047618,0,1,0,523549,82061,62660,45296,0.7601337581977843,0.35566164403998207
26187,0.6504166666666665,0,4,0,523553,82057,62660,45296,0.7600967060654341,0.3556728149317252
26188,0.6504166666666668,0,1,0,523554,82056,62660,45296,0.7600874430323465,0.3556756077643068
26189,0.6504404761904761,0,2,0,523556,82054,62660,45296,0.7600689169661714,0.3556811935610522
26190,0.6504444444444445,0,1,0,523557,82053,62660,45296,0.7600596539330838,0.3556839865252181
26191,0.6504761904761905,0,3,0,523560,82050,62660,45296,0.7600318648338212,0.35569236568090085
26192,0.6504880952380953,0,1,0,523561,82049,62660,45296,0.7600226018007337,0.35569515882052694
26193,0.6504999999999999,0,1,0,523562,82048,62660,45296,0.7600133387676461,0.3556979520040206
26194,0.6505,0,10,0,523572,82038,62660,45296,0.7599207084367705,0.35572588625190443
26195,0.6505000000000001,0,4,0,523576,82034,62660,45296,0.7598836563044203,0.355737061179612
26196,0.650547619047619,1,0,1,523576,82034,62661,45295,0.7598836563044203,0.35573200135083133
26197,0.6505833333333334,0,1,0,523577,82033,62661,45295,0.7598743932713328,0.355734795174667
26198,0.6505833333333335,0,1,0,523578,82032,62661,45295,0.7598651302382452,0.35573758904238695
26199,0.6505952380952382,1,1,1,523579,82031,62662,45294,0.7598558672051576,0.35573532299234245
26200,0.6506666666666666,2,25,2,523604,82006,62664,45292,0.7596242913779688,0.3557950635516662
26201,0.6506785714285713,1,0,1,523604,82006,62665,45291,0.7596242913779688,0.3557900029065885
26202,0.650690476190476,0,1,0,523605,82005,62665,45291,0.7596150283448813,0.35579279788838614
26203,0.6507142857142857,2,4,2,523609,82001,62667,45289,0.759577976212531,0.3557938565480399
26204,0.65075,0,1,0,523610,82000,62667,45289,0.7595687131794435,0.3557966517138166
26205,0.650809523809524,0,1,0,523611,81999,62667,45289,0.759559450146356,0.355799446923512
26206,0.6508333333333332,0,4,0,523615,81995,62667,45289,0.7595223980140057,0.35581062820150217
26207,0.6508333333333333,5,20,5,523635,81975,62672,45284,0.7593371373522546,0.35584123716200816
26208,0.6508333333333334,10,38,10,523673,81937,62682,45274,0.7589851420949275,0.3558968957087044
26209,0.6508412698412697,0,1,0,523674,81936,62682,45274,0.75897587906184,0.35589969342032857
26210,0.6508571428571428,1,0,1,523674,81936,62683,45273,0.75897587906184,0.3558946300969271
26211,0.6509047619047618,0,1,0,523675,81935,62683,45273,0.7589666160287525,0.3558974278347274
26212,0.6509166666666666,0,1,0,523676,81934,62683,45273,0.7589573529956649,0.3559002256165148
26213,0.6509166666666667,1,0,1,523676,81934,62684,45272,0.7589573529956649,0.3558951621778847
26214,0.6509523809523808,1,0,1,523676,81934,62685,45271,0.7589573529956649,0.3558900986596439
26215,0.6509523809523811,2,4,2,523680,81930,62687,45269,0.7589203008633146,0.35589116266637316
26216,0.6509761904761905,0,2,0,523682,81928,62687,45269,0.7589017747971396,0.35589675857134995
26217,0.6509999999999999,8,39,8,523721,81889,62695,45261,0.7585405165067249,0.3559653952025167
26218,0.6510000000000001,1,1,1,523722,81888,62696,45260,0.7585312534736374,0.35596312958127535
26219,0.6510238095238096,0,1,0,523723,81887,62696,45260,0.7585219904405498,0.35596592920005976
26220,0.6510476190476189,0,1,0,523724,81886,62696,45260,0.7585127274074623,0.35596872886288206
26221,0.6510714285714286,0,2,0,523726,81884,62696,45260,0.7584942013412872,0.3559743283206443
26222,0.6511071428571428,0,2,0,523728,81882,62696,45260,0.7584756752751121,0.3559799279545705
26223,0.6511428571428571,0,2,0,523730,81880,62696,45260,0.7584571492089369,0.35598552776466885
26224,0.6511666666666666,0,3,0,523733,81877,62696,45260,0.7584293601096743,0.35599392781015754
26225,0.6511666666666668,3,7,3,523740,81870,62699,45257,0.7583645188780614,0.35599833237628514
26226,0.6511904761904762,0,3,0,523743,81867,62699,45257,0.7583367297787987,0.35600673358295837
26227,0.6512142857142856,0,2,0,523745,81865,62699,45257,0.7583182037126237,0.3560123346076997
26228,0.6512380952380953,0,1,0,523746,81864,62699,45257,0.7583089406795361,0.35601513518616124
26229,0.65125,0,2,0,523748,81862,62699,45257,0.758290414613361,0.3560207364752712
26230,0.6512619047619047,0,2,0,523750,81860,62699,45257,0.7582718885471859,0.35602633794063737
26231,0.6513095238095238,0,1,0,523751,81859,62699,45257,0.7582626255140983,0.3560291387394191
26232,0.6513333333333332,2,15,2,523766,81844,62701,45255,0.7581236800177851,0.3560610232968001
26233,0.6513333333333334,1,2,1,523768,81842,62702,45254,0.7581051539516099,0.3560615597658463
26234,0.6513452380952381,1,1,1,523769,81841,62703,45253,0.7580958909185224,0.3560592946952649
26235,0.6514285714285714,0,4,0,523773,81837,62703,45253,0.7580588387861722,0.35607050121960815
26236,0.651452380952381,0,1,0,523774,81836,62703,45253,0.7580495757530846,0.35607330296091716
26237,0.6514615384615385,0,1,0,523775,81835,62703,45253,0.7580403127199971,0.3560761047463175
26238,0.6514761904761904,1,1,1,523776,81834,62704,45252,0.7580310496869095,0.35607383976205087
26239,0.6514880952380951,0,2,0,523778,81832,62704,45252,0.7580125236207343,0.35607944351767334
26240,0.6515,0,1,0,523779,81831,62704,45252,0.7580032605876468,0.3560822454616274
26241,0.6515000000000001,3,11,3,523790,81820,62707,45249,0.7579013672236837,0.35609786808741706
26242,0.6515151515151516,0,1,0,523791,81819,62707,45249,0.7578921041905962,0.35610067050713007
26243,0.6515476190476189,0,4,0,523795,81815,62707,45249,0.757855052058246,0.35611188062708554
26244,0.6515714285714286,1,0,1,523795,81815,62708,45248,0.757855052058246,0.35610681315567866
26245,0.6516190476190477,0,1,0,523796,81814,62708,45248,0.7578457890251584,0.35610961577812406
26246,0.6516666666666666,30,100,30,523896,81714,62738,45218,0.756919485716403,0.35623798569312703
26247,0.6516666666666667,20,71,20,523967,81643,62758,45198,0.7562618103671866,0.35633588508447583
26248,0.6516785714285714,0,1,0,523968,81642,62758,45198,0.7562525473340991,0.3563386944181646
26249,0.6517023809523808,0,3,0,523971,81639,62758,45198,0.7562247582348364,0.35634712268502095
26250,0.6517142857142858,0,3,0,523974,81636,62758,45198,0.7561969691355738,0.3563555513505842
26251,0.6517539682539684,0,1,0,523975,81635,62758,45198,0.7561877061024862,0.35635836099437845
26252,0.6517857142857143,1,2,1,523977,81633,62759,45197,0.7561691800363111,0.35635890562169836
26253,0.6518021978021977,1,1,1,523978,81632,62760,45196,0.7561599170032235,0.3563566404894818
26254,0.6518095238095236,0,1,0,523979,81631,62760,45196,0.756150653970136,0.3563594502747838
26255,0.6518333333333334,5,11,5,523990,81620,62765,45191,0.7560487606061729,0.3563649841102113
26256,0.6518787878787881,0,1,0,523991,81619,62765,45191,0.7560394975730853,0.356367794337986
26257,0.6518809523809523,0,1,0,523992,81618,62765,45191,0.7560302345399977,0.35637060461008285
26258,0.651896103896104,0,1,0,523993,81617,62765,45191,0.7560209715069103,0.35637341492650304
26259,0.6519047619047618,0,1,0,523994,81616,62765,45191,0.7560117084738227,0.35637622528724755
26260,0.6519285714285715,0,1,0,523995,81615,62765,45191,0.7560024454407351,0.3563790356923174
26261,0.6519444444444444,0,2,0,523997,81613,62765,45191,0.75598391937456,0.3563846566354374
26262,0.6519484126984127,1,0,1,523997,81613,62766,45190,0.75598391937456,0.35637958092474153
26263,0.6519761904761904,0,1,0,523998,81612,62766,45190,0.7559746563414724,0.3563823914449299
26264,0.6519999999999999,1,4,1,524002,81608,62767,45189,0.7559376042091223,0.3563885580889138
26265,0.652,12,27,12,524029,81581,62779,45177,0.7556875023157583,0.35640354060493223
26266,0.6520000000000001,0,1,0,524030,81580,62779,45177,0.7556782392826707,0.3564063523119039
26267,0.6520238095238097,0,1,0,524031,81579,62779,45177,0.7556689762495832,0.35640916406323964
26268,0.6520515873015872,0,1,0,524032,81578,62779,45177,0.7556597132164956,0.35641197585894047
26269,0.6520833333333332,2,3,2,524035,81575,62781,45175,0.7556319241172329,0.3564102564102564
26270,0.6520833333333335,0,1,0,524036,81574,62781,45175,0.7556226610841454,0.3564130683476793
26271,0.6521190476190476,0,1,0,524037,81573,62781,45175,0.7556133980510579,0.35641588032947263
26272,0.6521428571428572,2,1,2,524038,81572,62783,45173,0.7556041350179703,0.3564085368259103
26273,0.6521666666666666,0,1,0,524039,81571,62783,45173,0.7555948719848827,0.3564113488606956
26274,0.6521666666666667,4,14,4,524053,81557,62787,45169,0.755465189521657,0.35643040891371935
26275,0.6522142857142856,0,3,0,524056,81554,62787,45169,0.7554374004223943,0.35643884693386363
26276,0.6522222222222221,0,1,0,524057,81553,62787,45169,0.7554281373893068,0.35644165969602754
26277,0.6522481962481962,0,1,0,524058,81552,62787,45169,0.7554188743562192,0.35644447250258443
26278,0.65225,0,1,0,524059,81551,62787,45169,0.7554096113231317,0.35644728535353537
26279,0.6523333333333332,2,4,2,524063,81547,62789,45167,0.7553725591907814,0.3564483798159635
26280,0.6523333333333333,4,16,4,524079,81531,62793,45163,0.7552243506613806,0.3564730768623613
26281,0.6523333333333334,0,2,0,524081,81529,62793,45163,0.7552058245952055,0.3564787042591482
26282,0.6523412698412698,0,2,0,524083,81527,62793,45163,0.7551872985290303,0.3564843318336096
26283,0.652357142857143,0,1,0,524084,81526,62793,45163,0.7551780354959428,0.3564871456874709
26284,0.6523809523809524,1,0,1,524084,81526,62794,45162,0.7551780354959428,0.35648206617832784
26285,0.6523888888888889,0,3,0,524087,81523,62794,45162,0.7551502463966802,0.3564905079527963
26286,0.6524166666666668,1,1,1,524088,81522,62795,45161,0.7551409833635926,0.35648824230559745
26287,0.6524285714285715,2,1,2,524089,81521,62797,45159,0.755131720330505,0.3564808967477108
26288,0.6524999999999999,0,2,0,524091,81519,62797,45159,0.7551131942643299,0.35648652488987825
26289,0.6525,49,140,49,524231,81379,62846,45110,0.7538163696320723,0.35663180197487526
26290,0.6525238095238095,0,2,0,524233,81377,62846,45110,0.7537978435658972,0.3566374410018421
26291,0.6525476190476192,0,1,0,524234,81376,62846,45110,0.7537885805328096,0.35664026058219883
26292,0.6525525030525031,0,1,0,524235,81375,62846,45110,0.7537793174997222,0.3566430802071392
26293,0.6525555555555553,0,1,0,524236,81374,62846,45110,0.7537700544666346,0.35664589987666423
26294,0.6525555555555556,1,0,1,524236,81374,62847,45109,0.7537700544666346,0.35664081338994175
26295,0.6525714285714286,0,2,0,524238,81372,62847,45109,0.7537515284004594,0.3566464528269068
26296,0.6525714285714287,1,0,1,524238,81372,62848,45108,0.7537515284004594,0.3566413662239089
26297,0.6525793650793651,0,1,0,524239,81371,62848,45108,0.7537422653673719,0.35664418599135034
26298,0.6525873015873016,0,1,0,524240,81370,62848,45108,0.7537330023342843,0.3566470058033808
26299,0.6525912698412699,2,4,2,524244,81366,62850,45106,0.7536959502019341,0.3566481118350307
26300,0.6526190476190475,0,3,0,524247,81363,62850,45106,0.7536681611026714,0.3566565719662526
26301,0.6526666666666665,1,2,1,524249,81361,62851,45105,0.7536496350364964,0.35665712523524107
26302,0.6526666666666666,8,23,8,524272,81338,62859,45097,0.7534365852754826,0.356681298691027
26303,0.6526666666666668,1,5,1,524277,81333,62860,45096,0.7533902701100448,0.35669031630401254
26304,0.6527142857142857,0,4,0,524281,81329,62860,45096,0.7533532179776946,0.35670160174016213
26305,0.6527380952380952,0,3,0,524284,81326,62860,45096,0.7533254288784319,0.35671006628593127
26306,0.65275,0,1,0,524285,81325,62860,45096,0.7533161658453444,0.35671288789046124
26307,0.6528095238095238,1,0,1,524285,81325,62861,45095,0.7533161658453444,0.3567077993988293
26308,0.6528333333333333,0,7,0,524292,81318,62861,45095,0.7532513246137316,0.3567275517549619
26309,0.6528373015873017,0,1,0,524293,81317,62861,45095,0.753242061580644,0.3567303736986995
26310,0.6528452380952382,0,3,0,524296,81314,62861,45095,0.7532142724813813,0.3567388397977992
26311,0.6528571428571428,0,5,0,524301,81309,62861,45095,0.7531679573159435,0.3567529508559856
26312,0.6528809523809522,1,0,1,524301,81309,62862,45094,0.7531679573159435,0.3567478619969463
26313,0.6528809523809523,0,1,0,524302,81308,62862,45094,0.753158694282856,0.3567506843246151
26314,0.6528846153846153,0,2,0,524304,81306,62862,45094,0.7531401682166808,0.3567563291139241
26315,0.6529285714285714,1,0,1,524304,81306,62863,45093,0.7531401682166808,0.3567512401205706
26316,0.6529652292152293,0,3,0,524307,81303,62863,45093,0.7531123791174182,0.3567597075856831
26317,0.6529761904761904,0,1,0,524308,81302,62863,45093,0.7531031160843307,0.3567625301633767
26318,0.6529761904761905,2,1,2,524309,81301,62865,45091,0.7530938530512431,0.3567551743781252
26319,0.6529761904761906,1,0,1,524309,81301,62866,45090,0.7530938530512431,0.3567500850535244
26320,0.6529999999999998,0,1,0,524310,81300,62866,45090,0.7530845900181555,0.3567529076667458
26321,0.653,8,26,8,524336,81274,62874,45082,0.7528437511578792,0.35678558992054193
26322,0.6530000000000001,0,7,0,524343,81267,62874,45082,0.7527789099262663,0.3568053565916628
26323,0.6530009157509157,0,1,0,524344,81266,62874,45082,0.7527696468931787,0.3568081805806186
26324,0.6530158730158732,0,1,0,524345,81265,62874,45082,0.7527603838600911,0.35681100461427656
26325,0.6530714285714285,0,2,0,524347,81263,62874,45082,0.752741857793916,0.356816652815703
26326,0.6531111111111112,1,0,1,524347,81263,62875,45081,0.752741857793916,0.3568115620844678
26327,0.6531190476190476,0,1,0,524348,81262,62875,45081,0.7527325947608284,0.3568143862342987
26328,0.6531547619047618,0,1,0,524349,81261,62875,45081,0.752723331727741,0.356817210428836
26329,0.6531666666666665,1,0,1,524349,81261,62876,45080,0.752723331727741,0.3568121195811336
26330,0.6531666666666667,1,12,1,524361,81249,62877,45079,0.7526121753306902,0.35684092204420237
26331,0.6531684704184706,0,6,0,524367,81243,62877,45079,0.7525565971321649,0.3568578711546682
26332,0.6531904761904762,0,1,0,524368,81242,62877,45079,0.7525473340990774,0.35686069616294996
26333,0.6532142857142855,0,1,0,524369,81241,62877,45079,0.7525380710659898,0.3568635212159595
26334,0.6532142857142857,1,3,1,524372,81238,62878,45078,0.7525102819667272,0.3568669052218246
26335,0.65325,0,1,0,524373,81237,62878,45078,0.7525010189336396,0.3568697304358152
26336,0.6532857142857142,0,1,0,524374,81236,62878,45078,0.7524917559005521,0.356872555694539
26337,0.6533095238095238,0,1,0,524375,81235,62878,45078,0.7524824928674645,0.35687538099799704
26338,0.6533333333333333,35,138,35,524513,81097,62913,45043,0.7512041943013821,0.35708736324718565
26339,0.6533333333333334,63,204,63,524717,80893,62976,44980,0.7493145355515209,0.3573443073574158
26340,0.6533571428571427,1,0,1,524717,80893,62977,44979,0.7493145355515209,0.3573392017287403
26341,0.6533571428571429,1,0,1,524717,80893,62978,44978,0.7493145355515209,0.35733409601894
26342,0.6533809523809524,0,2,0,524719,80891,62978,44978,0.7492960094853459,0.35733977389190347
26343,0.6533888888888889,0,1,0,524720,80890,62978,44978,0.7492867464522583,0.35734261289604985
26344,0.6534047619047618,0,1,0,524721,80889,62978,44978,0.7492774834191708,0.35734545194530737
26345,0.6534285714285715,1,0,1,524721,80889,62979,44977,0.7492774834191708,0.35734034608234155
26346,0.653452380952381,1,0,1,524721,80889,62980,44976,0.7492774834191708,0.35733524013824336
26347,0.6534682539682539,0,1,0,524722,80888,62980,44976,0.7492682203860832,0.35733807919659316
26348,0.6534722222222222,0,1,0,524723,80887,62980,44976,0.7492589573529956,0.35734091830005643
26349,0.6534761904761904,0,1,0,524724,80886,62980,44976,0.7492496943199081,0.3573437574486342
26350,0.6534960317460317,0,1,0,524725,80885,62980,44976,0.7492404312868206,0.35734659664232765
26351,0.6535,8,20,8,524745,80865,62988,44968,0.7490551706250694,0.35736253605969814
26352,0.6535000000000001,5,4,5,524749,80861,62993,44963,0.7490181184927193,0.35734835961342826
26353,0.6535714285714286,0,6,0,524755,80855,62993,44963,0.748962540294194,0.3573654008170532
26354,0.653607142857143,2,3,2,524758,80852,62995,44961,0.7489347511949312,0.3573637064532282
26355,0.6536190476190475,0,2,0,524760,80850,62995,44961,0.7489162251287561,0.357369387414455
26356,0.6536428571428573,1,0,1,524760,80850,62996,44960,0.7489162251287561,0.3573642794690406
26357,0.6536666666666665,0,1,0,524761,80849,62996,44960,0.7489069620956686,0.3573671199993641
26358,0.6536666666666666,2,3,2,524764,80846,62998,44958,0.7488791729964059,0.3573654255826524
26359,0.6536666666666667,0,17,0,524781,80829,62998,44958,0.7487217014339175,0.3574137231987407
26360,0.6536904761904762,0,3,0,524784,80826,62998,44958,0.7486939123346549,0.3574222476626598
26361,0.6537142857142857,0,1,0,524785,80825,62998,44958,0.7486846493015673,0.3574250892409944
26362,0.6537380952380951,0,1,0,524786,80824,62998,44958,0.7486753862684797,0.35742793086451163
26363,0.65375,0,4,0,524790,80820,62998,44958,0.7486383341361296,0.3574392978104279
26364,0.6537857142857143,0,1,0,524791,80819,62998,44958,0.748629071103042,0.3574421396598742
26365,0.6538095238095238,0,1,0,524792,80818,62998,44958,0.7486198080699544,0.3574449815545096
26366,0.6538333333333333,3,7,3,524799,80811,63001,44955,0.7485549668383416,0.3574495491627308
26367,0.6538333333333334,0,1,0,524800,80810,63001,44955,0.748545703805254,0.35745239136484713
26368,0.6538571428571429,0,1,0,524801,80809,63001,44955,0.7485364407721664,0.35745523361216247
26369,0.6539682539682539,0,4,0,524805,80805,63001,44955,0.7484993886398162,0.35746660305343514
26370,0.654,21,63,21,524868,80742,63022,44934,0.7479158175553003,0.35753843215888476
26371,0.6540238095238097,0,1,0,524869,80741,63022,44934,0.7479065545222128,0.35754127710364036
26372,0.654047619047619,0,3,0,524872,80738,63022,44934,0.7478787654229501,0.3575498122095614
26373,0.6540833333333333,0,1,0,524873,80737,63022,44934,0.7478695023898625,0.35755265733542346
26374,0.6540952380952382,0,1,0,524874,80736,63022,44934,0.747860239356775,0.3575555025065648
26375,0.6541190476190476,0,1,0,524875,80735,63022,44934,0.7478509763236875,0.35755834772298656
26376,0.6541428571428571,0,2,0,524877,80733,63022,44934,0.7478324502575123,0.3575640382916756
26377,0.6541666666666666,8,38,8,524915,80695,63030,44926,0.7474804550001852,0.3576312877623964
26378,0.6541666666666667,15,33,15,524948,80662,63045,44911,0.747174774908296,0.35764853909678035
26379,0.654190476190476,0,1,0,524949,80661,63045,44911,0.7471655118752084,0.3576513872519351
26380,0.6542142857142856,0,1,0,524950,80660,63045,44911,0.7471562488421208,0.3576542354524532
26381,0.6542142857142857,0,2,0,524952,80658,63045,44911,0.7471377227759457,0.3576599319895834
26382,0.6542207792207794,0,1,0,524953,80657,63045,44911,0.7471284597428582,0.35766278032619775
26383,0.6542380952380953,0,1,0,524954,80656,63045,44911,0.7471191967097707,0.3576656287081797
26384,0.6542857142857144,2,8,2,524962,80648,63047,44909,0.7470450924450702,0.35767818600316986
26385,0.6543095238095239,1,0,1,524962,80648,63048,44908,0.7470450924450702,0.3576730701838224
26386,0.6543203463203463,0,1,0,524963,80647,63048,44908,0.7470358294119827,0.35767591891999523
26387,0.6543333333333333,4,17,4,524980,80630,63052,44904,0.7468783578494942,0.3577038889862507
26388,0.6543571428571429,1,4,1,524984,80626,63053,44903,0.746841305717144,0.3577101705581977
26389,0.6543809523809523,0,1,0,524985,80625,63053,44903,0.7468320426840565,0.35771302020266393
26390,0.6544444444444444,2,2,2,524987,80623,63055,44901,0.7468135166178813,0.35770848602657657
26391,0.6544999999999999,1,0,1,524987,80623,63056,44900,0.7468135166178813,0.35770336910367023
26392,0.6545000000000001,5,12,5,524999,80611,63061,44895,0.7467023602208307,0.3577119818972798
26393,0.6545064935064935,0,1,0,525000,80610,63061,44895,0.7466930971877431,0.35771483207840327
26394,0.6545238095238095,2,2,2,525002,80608,63063,44893,0.7466745711215681,0.3577102971291065
26395,0.6545238095238096,0,1,0,525003,80607,63063,44893,0.7466653080884805,0.3577131474103586
26396,0.6545833333333333,1,2,1,525005,80605,63064,44892,0.7466467820223054,0.35771373020869024
26397,0.6545833333333334,0,1,0,525006,80604,63064,44892,0.7466375189892178,0.3577165806081469
26398,0.6546190476190477,0,1,0,525007,80603,63064,44892,0.7466282559561302,0.35771943105303
26399,0.6546428571428572,0,1,0,525008,80602,63064,44892,0.7466189929230427,0.35772228154334074
26400,0.6546666666666667,3,21,3,525029,80581,63067,44889,0.746424469228204,0.3577667968438671
26401,0.6546904761904763,0,1,0,525030,80580,63067,44889,0.7464152061951165,0.35776964827965474
26402,0.6547380952380952,0,1,0,525031,80579,63067,44889,0.746405943162029,0.3577724997608952
26403,0.6547499999999999,0,1,0,525032,80578,63067,44889,0.7463966801289414,0.3577753512875896
26404,0.65475,0,1,0,525033,80577,63067,44889,0.7463874170958539,0.3577782028597389
26405,0.6547698412698412,0,1,0,525034,80576,63067,44889,0.7463781540627663,0.35778105447734426
26406,0.6548095238095238,0,1,0,525035,80575,63067,44889,0.7463688910296787,0.3577839061404068
26407,0.6548333333333332,0,3,0,525038,80572,63067,44889,0.7463411019304161,0.35779246140234816
26408,0.6548333333333334,0,10,0,525048,80562,63067,44889,0.7462484715995406,0.3578209818973145
26409,0.6548333333333335,0,2,0,525050,80560,63067,44889,0.7462299455333654,0.35782668654194133
26410,0.6548611111111109,0,1,0,525051,80559,63067,44889,0.7462206825002778,0.35782953893246605
26411,0.6549166666666666,0,1,0,525052,80558,63067,44889,0.7462114194671904,0.35783239136846634
26412,0.6549999999999998,0,2,0,525054,80556,63067,44889,0.7461928934010152,0.35783809637689823
26413,0.655,182,589,182,525643,79967,63249,44707,0.7407369669124458,0.3585912058648956
26414,0.6550000000000001,0,1,0,525644,79966,63249,44707,0.7407277038793583,0.3585940821188228
26415,0.6550238095238095,2,0,2,525644,79966,63251,44705,0.7407277038793583,0.3585837925419705
26416,0.6550476190476189,0,1,0,525645,79965,63251,44705,0.7407184408462707,0.35858666880564694
26417,0.6550512820512822,0,1,0,525646,79964,63251,44705,0.7407091778131831,0.35858954511546576
26418,0.6550833333333332,1,1,1,525647,79963,63252,44704,0.7406999147800956,0.35858727650460825
26419,0.6551190476190476,1,0,1,525647,79963,63253,44703,0.7406999147800956,0.3585821314552484
26420,0.6551190476190477,1,0,1,525647,79963,63254,44702,0.7406999147800956,0.35857698632334656
26421,0.655142857142857,0,3,0,525650,79960,63254,44702,0.740672125680833,0.3585856155043237
26422,0.6551666666666666,0,1,0,525651,79959,63254,44702,0.7406628626477454,0.35858849199027765
26423,0.6551666666666667,0,5,0,525656,79954,63254,44702,0.7406165474823077,0.3586028751123091
26424,0.6551666666666668,1,1,1,525657,79953,63255,44701,0.7406072844492201,0.35860060647873315
26425,0.6552075147075146,1,0,1,525657,79953,63256,44700,0.7406072844492201,0.35859546099973527
26426,0.6552380952380952,2,2,2,525659,79951,63258,44698,0.7405887583830449,0.35859092331266196
26427,0.6552380952380953,1,0,1,525659,79951,63259,44697,0.7405887583830449,0.3585857775495796
26428,0.6552500000000001,0,2,0,525661,79949,63259,44697,0.7405702323168698,0.35859153121640486
26429,0.6552619047619046,0,1,0,525662,79948,63259,44697,0.7405609692837822,0.35859440811905813
26430,0.655262987012987,0,2,0,525664,79946,63259,44697,0.7405424432176072,0.3586001620628515
26431,0.6552777777777777,0,1,0,525665,79945,63259,44697,0.7405331801845196,0.3586030391039938
26432,0.6553174603174603,0,5,0,525670,79940,63259,44697,0.7404868650190819,0.3586174250022064
26433,0.6553333333333332,1,2,1,525672,79938,63260,44696,0.7404683389529068,0.3586180336023878
26434,0.6553333333333333,4,12,4,525684,79926,63264,44692,0.7403571825558561,0.3586319793288289
26435,0.6553333333333334,0,1,0,525685,79925,63264,44692,0.7403479195227686,0.35863485720246835
26436,0.6553571428571427,0,1,0,525686,79924,63264,44692,0.740338656489681,0.3586377351222957
26437,0.6553809523809524,0,2,0,525688,79922,63264,44692,0.7403201304235059,0.3586434911005184
26438,0.6553838383838385,0,1,0,525689,79921,63264,44692,0.7403108673904183,0.358646369158916
26439,0.6553928571428571,2,4,2,525693,79917,63266,44690,0.7402738152580681,0.3586475880167246
26440,0.6554166666666668,1,1,1,525694,79916,63267,44689,0.7402645522249806,0.35864531920869946
26441,0.6554761904761905,0,2,0,525696,79914,63267,44689,0.7402460261588054,0.3586510758167941
26442,0.6554999999999999,0,1,0,525697,79913,63267,44689,0.7402367631257178,0.3586539541901414
26443,0.6555,2,11,2,525708,79902,63269,44687,0.7401348697617548,0.35867532446684697
26444,0.6555000000000001,2,3,2,525711,79899,63271,44685,0.7401070806624921,0.3586736659603159
26445,0.6555238095238096,1,0,1,525711,79899,63272,44684,0.7401070806624921,0.35866851817663725
26446,0.655547619047619,0,3,0,525714,79896,63272,44684,0.7400792915632295,0.3586771552416118
26447,0.6555555555555556,0,1,0,525715,79895,63272,44684,0.7400700285301419,0.35868003435571005
26448,0.6555952380952381,0,1,0,525716,79894,63272,44684,0.7400607654970544,0.3586829135160301
26449,0.6556147186147185,0,1,0,525717,79893,63272,44684,0.7400515024639668,0.35868579272257317
26450,0.6556666666666666,2,10,2,525727,79883,63274,44682,0.7399588721330913,0.35870429093244494
26451,0.6556666666666667,0,2,0,525729,79881,63274,44682,0.7399403460669162,0.3587100503359746
26452,0.6557142857142856,0,1,0,525730,79880,63274,44682,0.7399310830338286,0.35871293010709526
26453,0.6557142857142857,7,6,7,525736,79874,63281,44675,0.7398755048353033,0.35869416856016506
26454,0.6557499999999998,0,1,0,525737,79873,63281,44675,0.7398662418022157,0.35869704852747536
26455,0.6557619047619048,1,1,1,525738,79872,63282,44674,0.7398569787691281,0.35869477943892214
26456,0.6557857142857144,2,0,2,525738,79872,63284,44672,0.7398569787691281,0.35868448098663924
26457,0.6558333333333332,0,1,0,525739,79871,63284,44672,0.7398477157360406,0.35868736099178594
26458,0.6558333333333333,8,28,8,525767,79843,63292,44664,0.7395883508095891,0.35872681857244976
26459,0.6558333333333334,10,49,10,525816,79794,63302,44654,0.7391344621882989,0.3588165338133196
26460,0.655866883116883,0,1,0,525817,79793,63302,44654,0.7391251991552114,0.358819417101256
26461,0.6558809523809523,0,2,0,525819,79791,63302,44654,0.7391066730890363,0.3588251838161437
26462,0.6559047619047618,1,0,1,525819,79791,63303,44653,0.7391066730890363,0.3588200315001125
26463,0.6559523809523811,0,2,0,525821,79789,63303,44653,0.7390881470228612,0.35882579836389644
26464,0.6559999999999999,15,85,15,525906,79704,63318,44638,0.7383007892104191,0.3589937430634862
26465,0.6560000000000001,0,5,0,525911,79699,63318,44638,0.7382544740449812,0.3590081793834498
26466,0.6560555555555555,0,1,0,525912,79698,63318,44638,0.7382452110118938,0.3590110667867713
26467,0.6560833333333334,0,1,0,525913,79697,63318,44638,0.7382359479788062,0.35901395423653837
26468,0.6561111111111113,0,1,0,525914,79696,63318,44638,0.7382266849457186,0.3590168417327521
26469,0.6561666666666666,0,4,0,525918,79692,63318,44638,0.7381896328133684,0.35902839218209603
26470,0.6561666666666668,0,3,0,525921,79689,63318,44638,0.7381618437141058,0.3590370555068489
26471,0.6561666666666669,1,1,1,525922,79688,63319,44637,0.7381525806810182,0.35903478785441384
26472,0.6561904761904762,0,1,0,525923,79687,63319,44637,0.7381433176479306,0.3590376757504585
26473,0.6562045454545455,1,0,1,525923,79687,63320,44636,0.7381433176479306,0.35903252012901876
26474,0.6562222222222222,0,1,0,525924,79686,63320,44636,0.738134054614843,0.359035408053281
26475,0.65625,2,4,2,525928,79682,63322,44634,0.7380970024824929,0.35903664854081535
26476,0.6562976190476191,1,2,1,525930,79680,63323,44633,0.7380784764163177,0.35903726882948683
26477,0.6563095238095238,0,5,0,525935,79675,63323,44633,0.73803216125088,0.3590517102680439
26478,0.6563333333333332,3,13,3,525948,79662,63326,44630,0.7379117418207418,0.35907379396904066
26479,0.6563333333333334,1,3,1,525951,79659,63327,44629,0.7378839527214791,0.3590773043254377
26480,0.6564285714285714,1,1,1,525952,79658,63328,44628,0.7378746896883915,0.3590750366091112
26481,0.6564999999999999,0,4,0,525956,79654,63328,44628,0.7378376375560414,0.3590865933924462
26482,0.6565000000000001,3,19,3,525975,79635,63331,44625,0.7376616399273778,0.3591260260743602
26483,0.6565555555555557,0,1,0,525976,79634,63331,44625,0.7376523768942903,0.35912891621532445
26484,0.6566428571428571,2,0,2,525976,79634,63333,44623,0.7376523768942903,0.3591186009641308
26485,0.6566666666666666,81,225,81,526201,79409,63414,44542,0.7355681944495905,0.3593516792926237
26486,0.6566666666666667,35,120,35,526321,79289,63449,44507,0.734456630479084,0.3595188859090762
26487,0.6566904761904762,0,1,0,526322,79288,63449,44507,0.7344473674459965,0.3595217900561412
26488,0.6567103174603173,1,0,1,526322,79288,63450,44506,0.7344473674459965,0.3595166163141994
26489,0.6567857142857142,0,1,0,526323,79287,63450,44506,0.7344381044129089,0.35951952048985
26490,0.6568333333333333,2,4,2,526327,79283,63452,44504,0.7344010522805587,0.3595207897436726
26491,0.6568333333333334,6,9,6,526336,79274,63458,44498,0.7343176849827707,0.3595158840448567
26492,0.6568571428571428,1,1,1,526337,79273,63459,44497,0.7343084219496832,0.35951361396138
26493,0.6568712121212121,0,1,0,526338,79272,63459,44497,0.7342991589165957,0.35951651867592044
26494,0.6569047619047619,1,0,1,526338,79272,63460,44496,0.7342991589165957,0.35951134380453753
26495,0.6569523809523808,0,1,0,526339,79271,63460,44496,0.7342898958835081,0.3595142485476743
26496,0.6569999999999999,2,4,2,526343,79267,63462,44494,0.7342528437511578,0.3595155178125581
26497,0.657,5,20,5,526363,79247,63467,44489,0.7340675830894068,0.3595477468158014
26498,0.6570238095238093,0,1,0,526364,79246,63467,44489,0.7340583200563192,0.3595506526043561
26499,0.6570238095238097,0,1,0,526365,79245,63467,44489,0.7340490570232316,0.3595535584398791
26500,0.6570476190476191,0,2,0,526367,79243,63467,44489,0.7340305309570566,0.3595593702518346
26501,0.6570714285714285,0,1,0,526368,79242,63467,44489,0.734021267923969,0.3595622762282694
26502,0.6570753968253967,0,1,0,526369,79241,63467,44489,0.7340120048908815,0.35956518225167705
26503,0.6570833333333335,1,2,1,526371,79239,63468,44488,0.7339934788247063,0.35956581829350104
26504,0.6570952380952381,0,1,0,526372,79238,63468,44488,0.7339842157916188,0.35956872443948723
26505,0.6570952380952382,0,1,0,526373,79237,63468,44488,0.7339749527585313,0.359571630632451
26506,0.6571071428571429,1,0,1,526373,79237,63469,44487,0.7339749527585313,0.35956645436616985
26507,0.6571190476190475,1,2,1,526375,79235,63470,44486,0.7339564266923562,0.3595670904696858
26508,0.6571190476190476,1,0,1,526375,79235,63471,44485,0.7339564266923562,0.3595619139993534
26509,0.6571190476190477,0,1,0,526376,79234,63471,44485,0.7339471636592686,0.35956482027821113
26510,0.657142857142857,0,1,0,526377,79233,63471,44485,0.733937900626181,0.3595677266040512
26511,0.6571428571428573,2,5,2,526382,79228,63473,44483,0.7338915854607433,0.35957190548940676
26512,0.6571666666666667,2,6,2,526388,79222,63475,44481,0.733836007262218,0.3595789916170182
26513,0.6571666666666668,1,5,1,526393,79217,63476,44480,0.7337896920967801,0.3595883489494491
26514,0.6571904761904761,0,1,0,526394,79216,63476,44480,0.7337804290636926,0.3595912559824085
26515,0.6572727272727272,0,1,0,526395,79215,63476,44480,0.7337711660306051,0.35959416306237113
26516,0.657297619047619,0,1,0,526396,79214,63476,44480,0.7337619029975175,0.35959707018933823
26517,0.6573095238095239,1,0,1,526396,79214,63477,44479,0.7337619029975175,0.3595918928314456
26518,0.6573333333333332,0,4,0,526400,79210,63477,44479,0.7337248508651673,0.3596035217359668
26519,0.6573333333333333,6,20,6,526420,79190,63483,44473,0.7335395902034162,0.3596306089937977
26520,0.6573333333333334,0,1,0,526421,79189,63483,44473,0.7335303271703286,0.35963351716776376
26521,0.6573412698412698,0,1,0,526422,79188,63483,44473,0.733521064137241,0.35963642538876445
26522,0.657357142857143,0,1,0,526423,79187,63483,44473,0.7335118011041536,0.3596393336568009
26523,0.6573809523809524,0,6,0,526429,79181,63483,44473,0.7334562229056282,0.35965678425283454
26524,0.6573939393939393,0,1,0,526430,79180,63483,44473,0.7334469598725407,0.35965969285015326
26525,0.657404761904762,0,2,0,526432,79178,63483,44473,0.7334284338063656,0.3596655101859265
26526,0.6574523809523811,1,1,1,526433,79177,63484,44472,0.733419170773278,0.3596632403011751
26527,0.6574999999999999,0,2,0,526435,79175,63484,44472,0.7334006447071029,0.3596690578825204
26528,0.6575,48,158,48,526593,79017,63532,44424,0.7319370854792693,0.3598804287068316
26529,0.657547619047619,0,2,0,526595,79015,63532,44424,0.7319185594130942,0.3598862596100098
26530,0.6575833333333333,0,1,0,526596,79014,63532,44424,0.7319092963800067,0.35988917513245516
26531,0.6576111111111109,1,0,1,526596,79014,63533,44423,0.7319092963800067,0.35988398940350136
26532,0.6576190476190475,0,2,0,526598,79012,63533,44423,0.7318907703138315,0.3598898205533277
26533,0.6576666666666665,0,1,0,526599,79011,63533,44423,0.731881507280744,0.35989273619910234
26534,0.6576666666666666,3,10,3,526609,79001,63536,44420,0.7317888769498685,0.359906336847052
26535,0.6576666666666668,0,5,0,526614,78996,63536,44420,0.7317425617844306,0.3599209178712647
26536,0.6577142857142857,0,1,0,526615,78995,63536,44420,0.7317332987513432,0.35992383421788277
26537,0.6577142857142859,0,1,0,526616,78994,63536,44420,0.7317240357182556,0.35992675061176205
26538,0.6577532467532466,0,1,0,526617,78993,63536,44420,0.731714772685168,0.3599296670529037
26539,0.6577698412698413,0,1,0,526618,78992,63536,44420,0.7317055096520805,0.3599325835413088
26540,0.6577777777777777,0,2,0,526620,78990,63536,44420,0.7316869835859053,0.3599384166599141
26541,0.6577857142857142,1,0,1,526620,78990,63537,44419,0.7316869835859053,0.3599332301533924
26542,0.657797619047619,0,1,0,526621,78989,63537,44419,0.7316777205528178,0.3599361467652016
26543,0.6578333333333333,3,5,3,526626,78984,63540,44416,0.73163140538738,0.359935170178282
26544,0.6578333333333335,2,2,2,526628,78982,63542,44414,0.7316128793212049,0.35993062984213425
26545,0.6578571428571428,0,4,0,526632,78978,63542,44414,0.7315758271888547,0.3599422977178423
26546,0.6578809523809523,0,1,0,526633,78977,63542,44414,0.7315665641557672,0.35994521480496955
26547,0.6579047619047619,1,0,1,526633,78977,63543,44413,0.7315665641557672,0.3599400275549072
26548,0.6579166666666666,0,3,0,526636,78974,63543,44413,0.7315387750565046,0.359948779044794
26549,0.6579166666666667,0,1,0,526637,78973,63543,44413,0.731529512023417,0.35995169630265994
26550,0.6579404761904764,1,1,1,526638,78972,63544,44412,0.7315202489903294,0.3599494261816767
26551,0.6579761904761905,1,0,1,526638,78972,63545,44411,0.7315202489903294,0.3599442386714539
26552,0.6579999999999999,17,35,17,526673,78937,63562,44394,0.731196042832265,0.35995816137062053
26553,0.6580000000000001,3,4,3,526677,78933,63565,44391,0.7311589906999147,0.3599542668093802
26554,0.6580326617826617,0,1,0,526678,78932,63565,44391,0.7311497276668272,0.35995718560203693
26555,0.658037518037518,0,1,0,526679,78931,63565,44391,0.7311404646337397,0.3599601044420298
26556,0.658047619047619,0,1,0,526680,78930,63565,44391,0.7311312016006521,0.35996302332936
26557,0.658095238095238,0,1,0,526681,78929,63565,44391,0.7311219385675646,0.35996594226402856
26558,0.6581428571428571,0,1,0,526682,78928,63565,44391,0.731112675534477,0.3599688612460367
26559,0.6581666666666667,4,19,4,526701,78909,63569,44387,0.7309366779058135,0.3600035686478069
26560,0.6581666666666668,0,1,0,526702,78908,63569,44387,0.730927414872726,0.3600064885031834
26561,0.6581904761904762,0,1,0,526703,78907,63569,44387,0.7309181518396384,0.36000940840592405
26562,0.6582142857142855,0,1,0,526704,78906,63569,44387,0.7309088888065508,0.3600123283560299
26563,0.6582420634920635,0,1,0,526705,78905,63569,44387,0.7308996257734632,0.36001524835350224
26564,0.65825,0,3,0,526708,78902,63569,44387,0.7308718366742006,0.36002400863012923
26565,0.6583095238095237,0,1,0,526709,78901,63569,44387,0.7308625736411131,0.3600269288170787
26566,0.6583333333333331,1,0,1,526709,78901,63570,44386,0.7308625736411131,0.36002173789612857
26567,0.6583333333333333,16,51,16,526760,78850,63586,44370,0.7303901589536478,0.3600876481090732
26568,0.6583333333333334,37,104,37,526864,78746,63623,44333,0.7294268035125422,0.3601995466326506
26569,0.658452380952381,0,4,0,526868,78742,63623,44333,0.7293897513801919,0.3602112533008328
26570,0.6585,8,12,8,526880,78730,63631,44325,0.7292785949831413,0.3602047864775913
26571,0.6585000000000001,0,1,0,526881,78729,63631,44325,0.7292693319500537,0.36020771368667415
26572,0.6585108225108226,1,0,1,526881,78729,63632,44324,0.7292693319500537,0.36020251436372946
26573,0.6585238095238094,0,1,0,526882,78728,63632,44324,0.7292600689169662,0.3602054416019244
26574,0.6585476190476192,0,1,0,526883,78727,63632,44324,0.7292508058838786,0.360208368887697
26575,0.6585494227994231,1,7,1,526890,78720,63633,44323,0.7291859646522657,0.36022366164674136
26576,0.6585714285714286,1,1,1,526891,78719,63634,44322,0.7291767016191781,0.3602213896180948
26577,0.6585891053391052,2,0,2,526891,78719,63636,44320,0.7291767016191781,0.36021099001129725
26578,0.6586190476190477,2,1,2,526892,78718,63638,44318,0.7291674385860907,0.36020351766962516
26579,0.6586309523809524,0,1,0,526893,78717,63638,44318,0.7291581755530031,0.3602064453204373
26580,0.6586666666666666,1,1,1,526894,78716,63639,44317,0.7291489125199155,0.36020417286419093
26581,0.6586666666666667,2,9,2,526903,78707,63641,44315,0.7290655452221275,0.36022012322999136
26582,0.6586904761904762,0,1,0,526904,78706,63641,44315,0.72905628218904,0.36022305134895666
26583,0.6587142857142857,0,2,0,526906,78704,63641,44315,0.7290377561228649,0.3602289077297003
26584,0.6587499999999998,0,1,0,526907,78703,63641,44315,0.7290284930897774,0.3602318359914809
26585,0.65875,0,3,0,526910,78700,63641,44315,0.7290007039905146,0.36024062106247207
26586,0.6587619047619048,0,1,0,526911,78699,63641,44315,0.7289914409574271,0.3602435495146894
26587,0.6588095238095238,1,1,1,526912,78698,63642,44314,0.7289821779243395,0.36024127727376193
26588,0.6588333333333333,5,11,5,526923,78687,63647,44309,0.7288802845603765,0.360247487723178
26589,0.6588571428571428,0,1,0,526924,78686,63647,44309,0.7288710215272889,0.360250416683605
26590,0.6588809523809525,0,2,0,526926,78684,63647,44309,0.7288524954611137,0.36025627474734334
26591,0.6588888888888887,0,2,0,526928,78682,63647,44309,0.7288339693949387,0.36026213300160176
26592,0.6588939393939394,0,1,0,526929,78681,63647,44309,0.7288247063618511,0.3602650622001789
26593,0.6589285714285714,1,5,1,526934,78676,63648,44308,0.7287783911964133,0.360274507252976
26594,0.6589285714285715,0,1,0,526935,78675,63648,44308,0.7287691281633258,0.3602774367188961
26595,0.6589468309468306,0,4,0,526939,78671,63648,44308,0.7287320760309756,0.36028915505899384
26596,0.6589761904761905,0,3,0,526942,78668,63648,44308,0.728704286931713,0.36029794431433776
26597,0.6589999999999999,0,6,0,526948,78662,63648,44308,0.7286487087331875,0.3603155241115719
26598,0.659,14,24,14,526972,78638,63662,44294,0.7284263959390863,0.3603130185793772
26599,0.659047619047619,0,2,0,526974,78636,63662,44294,0.7284078698729112,0.3603188806637924
26600,0.6590714285714284,0,3,0,526977,78633,63662,44294,0.7283800807736486,0.3603276741480716
26601,0.6590833333333334,0,2,0,526979,78631,63662,44294,0.7283615547074734,0.3603335367093756
26602,0.6590952380952381,0,2,0,526981,78629,63662,44294,0.7283430286412983,0.3603393994614515
26603,0.6591190476190476,0,1,0,526982,78628,63662,44294,0.7283337656082107,0.3603423309090317
26604,0.6591666666666666,12,44,12,527026,78584,63674,44282,0.7279261921523583,0.3604089007536666
26605,0.6591666666666667,14,30,14,527056,78554,63688,44268,0.7276483011597318,0.36042402826855124
26606,0.6591666666666669,0,1,0,527057,78553,63688,44268,0.7276390381266442,0.3604269628158051
26607,0.6592142857142858,0,1,0,527058,78552,63688,44268,0.7276297750935566,0.36042989741084513
26608,0.6592380952380953,0,1,0,527059,78551,63688,44268,0.7276205120604691,0.3604328320536725
26609,0.65925,1,0,1,527059,78551,63689,44267,0.7276205120604691,0.3604276246152844
26610,0.6592500000000001,0,1,0,527060,78550,63689,44267,0.7276112490273815,0.3604305592873951
26611,0.6592619047619048,0,1,0,527061,78549,63689,44267,0.7276019859942939,0.36043349400729546
26612,0.6592777777777777,0,1,0,527062,78548,63689,44267,0.7275927229612065,0.3604364287749868
26613,0.6592857142857143,2,2,2,527064,78546,63691,44265,0.7275741968950313,0.36043188313750396
26614,0.6592857142857145,0,1,0,527065,78545,63691,44265,0.7275649338619438,0.3604348180115626
26615,0.6593333333333332,0,3,0,527068,78542,63691,44265,0.727537144762681,0.36044362292051757
26616,0.6593333333333333,6,27,6,527095,78515,63697,44259,0.7272870428693171,0.36049163503673415
26617,0.6593571428571429,0,1,0,527096,78514,63697,44259,0.7272777798362295,0.3604945712819594
26618,0.6593676046176046,0,1,0,527097,78513,63697,44259,0.727268516803142,0.3604975075750171
26619,0.6593928571428571,0,1,0,527098,78512,63697,44259,0.7272592537700545,0.36050044391590846
26620,0.6594126984126983,0,1,0,527099,78511,63697,44259,0.727249990736967,0.3605033803046347
26621,0.6594166666666667,0,1,0,527100,78510,63697,44259,0.7272407277038794,0.3605063167411969
26622,0.6594761904761904,0,1,0,527101,78509,63697,44259,0.7272314646707918,0.36050925322559624
26623,0.6594999999999999,1,3,1,527104,78506,63698,44258,0.7272036755715291,0.36051285393111987
26624,0.6595,2,4,2,527108,78502,63700,44256,0.7271666234391789,0.36051418237507943
26625,0.6595238095238095,0,1,0,527109,78501,63700,44256,0.7271573604060914,0.3605171191866859
26626,0.6595454545454545,0,1,0,527110,78500,63700,44256,0.7271480973730038,0.3605200560461403
26627,0.6595833333333334,0,1,0,527111,78499,63700,44256,0.7271388343399162,0.36052299295344387
26628,0.6596190476190474,1,0,1,527111,78499,63701,44255,0.7271388343399162,0.3605177835345488
26629,0.6596190476190477,1,1,1,527112,78498,63702,44254,0.7271295713068288,0.3605155109489051
26630,0.6596428571428572,0,1,0,527113,78497,63702,44254,0.7271203082737412,0.3605184479148846
26631,0.6596666666666667,1,5,1,527118,78492,63703,44253,0.7270739931083033,0.36052792374434806
26632,0.6596666666666668,0,2,0,527120,78490,63703,44253,0.7270554670421283,0.36053379826140797
26633,0.6596904761904762,0,2,0,527122,78488,63703,44253,0.7270369409759532,0.36053967296991224
26634,0.6597272727272727,0,2,0,527124,78486,63703,44253,0.727018414909778,0.3605455478698702
26635,0.6597619047619048,1,3,1,527127,78483,63704,44252,0.7269906258105154,0.36054915060903575
26636,0.6597857142857143,2,0,2,527127,78483,63706,44250,0.7269906258105154,0.3605387304148029
26637,0.659829365079365,0,2,0,527129,78481,63706,44250,0.7269720997443403,0.3605446056823459
26638,0.6598333333333332,0,2,0,527131,78479,63706,44250,0.7269535736781652,0.36055048114137656
26639,0.6598333333333334,1,12,1,527143,78467,63707,44249,0.7268424172811145,0.3605805273965905
26640,0.6598333333333335,0,1,0,527144,78466,63707,44249,0.726833154248027,0.3605834657539828
26641,0.6598571428571428,1,0,1,527144,78466,63708,44248,0.726833154248027,0.36057825512981406
26642,0.6598809523809525,1,2,1,527146,78464,63709,44247,0.7268146281818518,0.3605789212051079
26643,0.6599166666666666,0,1,0,527147,78463,63709,44247,0.7268053651487643,0.36058185966913864
26644,0.6599285714285714,0,1,0,527148,78462,63709,44247,0.7267961021156768,0.36058479818106254
26645,0.6599523809523811,1,2,1,527150,78460,63710,44246,0.7267775760495017,0.3605854644434665
26646,0.6599999999999998,0,4,0,527154,78456,63710,44246,0.7267405239171514,0.36059721927922933
26647,0.66,585,1654,585,528808,76802,64295,43661,0.7114194671903368,0.36244323983297777
26648,0.6600000000000001,0,2,0,528810,76800,64295,43661,0.7114009411241617,0.36244925743601664
26649,0.6600119047619049,1,1,1,528811,76799,64296,43660,0.7113916780910742,0.36244697365908735
26650,0.6600555555555556,2,1,2,528812,76798,64298,43658,0.7113824150579866,0.3624393969582254
26651,0.6601190476190476,0,4,0,528816,76794,64298,43658,0.7113453629256363,0.3624514329359413
26652,0.660142857142857,0,1,0,528817,76793,64298,43658,0.7113360998925489,0.3624544420552756
26653,0.660145721925134,2,1,2,528818,76792,64300,43656,0.7113268368594613,0.3624468650371945
26654,0.6601666666666667,1,6,1,528824,76786,64301,43655,0.711271258660936,0.3624596275354738
26655,0.6601666666666668,2,5,2,528829,76781,64303,43653,0.7112249434954981,0.36246408821429166
26656,0.6601904761904762,0,2,0,528831,76779,64303,43653,0.7112064174293231,0.3624701076125947
26657,0.6602222222222223,1,0,1,528831,76779,64304,43652,0.7112064174293231,0.3624648138768257
26658,0.6602380952380952,0,2,0,528833,76777,64304,43652,0.711187891363148,0.36247083343712894
26659,0.6602380952380953,0,1,0,528834,76776,64304,43652,0.7111786283300604,0.3624738432922576
26660,0.6602619047619049,0,1,0,528835,76775,64304,43652,0.7111693652969728,0.36247685319737266
26661,0.6602727272727273,0,1,0,528836,76774,64304,43652,0.7111601022638853,0.3624798631524754
26662,0.6602857142857144,1,0,1,528836,76774,64305,43651,0.7111601022638853,0.36247456923396304
26663,0.6603095238095239,0,1,0,528837,76773,64305,43651,0.7111508392307977,0.362477579220089
26664,0.6603227883227883,0,3,0,528840,76770,64305,43651,0.7111230501315351,0.3624866094784132
26665,0.6603333333333333,3,13,3,528853,76757,64308,43648,0.7110026307013969,0.3625098625472364
26666,0.6603571428571428,2,2,2,528855,76755,64310,43646,0.7109841046352218,0.36250529480652155
26667,0.6604047619047619,1,1,1,528856,76754,64311,43645,0.7109748416021342,0.36250301082234904
26668,0.6604166666666665,0,3,0,528859,76751,64311,43645,0.7109470525028715,0.362512043589488
26669,0.6604166666666668,0,2,0,528861,76749,64311,43645,0.7109285264366965,0.3625180656843364
26670,0.6604285714285715,0,1,0,528862,76748,64311,43645,0.7109192634036089,0.3625210768067911
26671,0.6604404761904762,0,1,0,528863,76747,64311,43645,0.7109100003705213,0.3625240879792677
26672,0.660452380952381,0,2,0,528865,76745,64311,43645,0.7108914743043462,0.3625301104742919
26673,0.6604761904761903,0,3,0,528868,76742,64311,43645,0.7108636852050836,0.3625391445920241
26674,0.6605,3,8,3,528876,76734,64314,43642,0.7107895809403831,0.36254735163155444
26675,0.6605000000000001,2,5,2,528881,76729,64316,43640,0.7107432657749454,0.36255181982071794
26676,0.6605003607503608,0,1,0,528882,76728,64316,43640,0.7107340027418578,0.3625548318489964
26677,0.6605238095238094,0,1,0,528883,76727,64316,43640,0.7107247397087703,0.36255784392732227
26678,0.660547619047619,0,1,0,528884,76726,64316,43640,0.7107154766756827,0.36256085605569677
26679,0.6605714285714285,0,1,0,528885,76725,64316,43640,0.7107062136425951,0.36256386823412123
26680,0.6605833333333335,2,2,2,528887,76723,64318,43638,0.71068768757642,0.36255930077018306
26681,0.6606190476190476,0,1,0,528888,76722,64318,43638,0.7106784245433325,0.36256231306081754
26682,0.6606190476190477,0,3,0,528891,76719,64318,43638,0.7106506354440698,0.36257135023305664
26683,0.6606402486402486,1,5,1,528896,76714,64319,43637,0.7106043202786321,0.36258111689973493
26684,0.6606666666666666,3,19,3,528915,76695,64322,43634,0.7104283226499685,0.3626224767096876
26685,0.6606666666666667,1,2,1,528917,76693,64323,43633,0.7104097965837934,0.36262320695444045
26686,0.6607142857142856,1,0,1,528917,76693,64324,43632,0.7104097965837934,0.3626179098275504
26687,0.6607142857142857,3,5,3,528922,76688,64327,43629,0.7103634814183556,0.36261708652975055
26688,0.6607619047619048,1,1,1,528923,76687,64328,43628,0.710354218385268,0.36261480280929226
26689,0.6607857142857142,1,2,1,528925,76685,64329,43627,0.710335692319093,0.3626155329476694
26690,0.6608333333333333,4,28,4,528953,76657,64333,43623,0.7100763273926415,0.3626787495843033
26691,0.6608333333333334,9,41,9,528994,76616,64342,43614,0.7096965430360517,0.36275472011977045
26692,0.6608492063492064,1,0,1,528994,76616,64343,43613,0.7096965430360517,0.362749419857106
26693,0.6608690476190477,0,2,0,528996,76614,64343,43613,0.7096780169698766,0.36275545426568073
26694,0.6608809523809523,0,2,0,528998,76612,64343,43613,0.7096594909037015,0.362761488875026
26695,0.660903318903319,1,1,1,528999,76611,64344,43612,0.7096502278706139,0.36275920580920457
26696,0.6609047619047618,0,3,0,529002,76608,64344,43612,0.7096224387713513,0.36276825819331227
26697,0.6609523809523811,3,1,3,529003,76607,64347,43609,0.7096131757382638,0.362755373660744
26698,0.6609761904761904,0,1,0,529004,76606,64347,43609,0.7096039127051762,0.3627583912157385
26699,0.6609999999999999,7,34,7,529038,76572,64354,43602,0.7092889695801994,0.362823905337261
26700,0.661,0,6,0,529044,76566,64354,43602,0.709233391381674,0.3628420211703615
26701,0.6610238095238095,0,1,0,529045,76565,64354,43602,0.7092241283485865,0.36284504065175965
26702,0.6610238095238097,0,1,0,529046,76564,64354,43602,0.7092148653154989,0.3628480601834129
26703,0.661047619047619,0,2,0,529048,76562,64354,43602,0.7091963392493238,0.3628540993974901
26704,0.6610555555555555,1,1,1,529049,76561,64355,43601,0.7091870762162362,0.3628518167141026
26705,0.661065295815296,2,4,2,529053,76557,64357,43599,0.709150024083886,0.3628532907220613
26706,0.6610833333333335,1,0,1,529053,76557,64358,43598,0.709150024083886,0.36284798801548
26707,0.6611666666666666,1,1,1,529054,76556,64359,43597,0.7091407610507985,0.36284570505938263
26708,0.6611666666666668,0,6,0,529060,76550,64359,43597,0.7090851828522732,0.36286382514752763
26709,0.6611904761904762,0,2,0,529062,76548,64359,43597,0.709066656786098,0.36286986557909195
26710,0.6612380952380953,0,1,0,529063,76547,64359,43597,0.7090573937530105,0.362872885870289
26711,0.66125,2,2,2,529065,76545,64361,43595,0.7090388676868353,0.3628683202929915
26712,0.6612857142857144,1,0,1,529065,76545,64362,43594,0.7090388676868353,0.3628630170053022
26713,0.6613095238095238,0,3,0,529068,76542,64362,43594,0.7090110785875727,0.36287207831124724
26714,0.6613095238095239,1,0,1,529068,76542,64363,43593,0.7090110785875727,0.36286677487826197
26715,0.6613333333333332,3,9,3,529077,76533,64366,43590,0.7089277112897847,0.3628780499987513
26716,0.6613333333333334,2,3,2,529080,76530,64368,43588,0.7088999221905221,0.3628765047703092
26717,0.6613629426129425,2,1,2,529081,76529,64370,43586,0.7088906591574345,0.3628689172875994
26718,0.6613809523809525,0,1,0,529082,76528,64370,43586,0.708881396124347,0.36287193832525766
26719,0.6613888888888888,0,1,0,529083,76527,64370,43586,0.7088721330912594,0.36287495941321923
26720,0.6614047619047619,0,1,0,529084,76526,64370,43586,0.7088628700581718,0.3628779805514853
26721,0.6614285714285714,0,1,0,529085,76525,64370,43586,0.7088536070250843,0.3628810017400571
26722,0.6614404761904763,0,1,0,529086,76524,64370,43586,0.7088443439919967,0.36288402297893596
26723,0.6614999999999999,3,2,3,529088,76522,64373,43583,0.7088258179258217,0.3628741517838558
26724,0.6615000000000001,1,5,1,529093,76517,64374,43582,0.7087795027603838,0.3628839540712246
26725,0.6615238095238095,1,0,1,529093,76517,64375,43581,0.7087795027603838,0.36287864910323236
26726,0.6615476190476189,1,0,1,529093,76517,64376,43580,0.7087795027603838,0.3628733440468954
26727,0.6615952380952382,0,1,0,529094,76516,64376,43580,0.7087702397272964,0.3628763655742073
26728,0.6616190476190477,0,1,0,529095,76515,64376,43580,0.7087609766942088,0.36287938715183815
26729,0.6616349206349206,0,1,0,529096,76514,64376,43580,0.7087517136611212,0.36288240877978917
26730,0.6616666666666666,42,118,42,529214,76396,64418,43538,0.7076586757567898,0.36301632564577185
26731,0.6616666666666667,13,59,13,529273,76337,64431,43525,0.7071121568046241,0.36312592815070666
26732,0.6616883116883117,0,2,0,529275,76335,64431,43525,0.707093630738449,0.3631319873185383
26733,0.6616904761904762,0,2,0,529277,76333,64431,43525,0.7070751046722739,0.36313804668858146
26734,0.6617142857142858,0,1,0,529278,76332,64431,43525,0.7070658416391863,0.36314107644943555
26735,0.6617857142857142,1,0,1,529278,76332,64432,43524,0.7070658416391863,0.3631357629154986
26736,0.6617857142857143,2,1,2,529279,76331,64434,43522,0.7070565786060988,0.3631281653358698
26737,0.661809523809524,0,1,0,529280,76330,64434,43522,0.7070473155730113,0.3631311951406735
26738,0.6618333333333334,3,11,3,529291,76319,64437,43519,0.7069454222090481,0.3631485839216275
26739,0.6618809523809523,1,0,1,529291,76319,64438,43518,0.7069454222090481,0.36314326960788407
26740,0.6618968253968254,0,1,0,529292,76318,64438,43518,0.7069361591759605,0.36314629994325576
26741,0.6619047619047618,1,0,1,529292,76318,64439,43517,0.7069361591759605,0.3631409855217591
26742,0.6619047619047619,0,2,0,529294,76316,64439,43517,0.7069176331097855,0.36314704630610933
26743,0.661904761904762,0,1,0,529295,76315,64439,43517,0.7069083700766979,0.36315007677415045
26744,0.661952380952381,0,2,0,529297,76313,64439,43517,0.7068898440105228,0.36315613786197115
26745,0.6619920634920635,0,3,0,529300,76310,64439,43517,0.7068620549112602,0.363165229873067
26746,0.6619999999999999,0,6,0,529306,76304,64439,43517,0.7068064767127348,0.3631834152610978
26747,0.662,8,23,8,529329,76281,64447,43509,0.7065934269517211,0.3632106185825194
26748,0.6620000000000001,0,4,0,529333,76277,64447,43509,0.7065563748193708,0.36322274723256476
26749,0.6620238095238095,1,0,1,529333,76277,64448,43508,0.7065563748193708,0.36321743123095546
26750,0.6620833333333335,1,1,1,529334,76276,64449,43507,0.7065471117862833,0.36321514739153304
26751,0.6621190476190476,0,1,0,529335,76275,64449,43507,0.7065378487531957,0.36321817969310916
26752,0.662142857142857,1,2,1,529337,76273,64450,43506,0.7065193226870207,0.363218928192755
26753,0.6621428571428573,0,4,0,529341,76269,64450,43506,0.7064822705546704,0.3632310582341891
26754,0.6621536796536795,2,0,2,529341,76269,64452,43504,0.7064822705546704,0.3632204253045344
26755,0.6621666666666666,1,0,1,529341,76269,64453,43503,0.7064822705546704,0.36321510870654244
26756,0.6621666666666667,1,9,1,529350,76260,64454,43502,0.7063989032568825,0.36323708688899653
26757,0.6622857142857143,1,0,1,529350,76260,64455,43501,0.7063989032568825,0.36323176994180073
26758,0.6623333333333332,1,5,1,529355,76255,64456,43500,0.7063525880914446,0.3632416183040374
26759,0.6623333333333333,1,15,1,529370,76240,64457,43499,0.7062136425951313,0.3632818045916535
26760,0.6623809523809524,3,7,3,529377,76233,64460,43496,0.7061488013635184,0.3632870900116095
26761,0.6624285714285714,0,1,0,529378,76232,64460,43496,0.706139538330431,0.3632901242817052
26762,0.6624448329448327,0,3,0,529381,76229,64460,43496,0.7061117492311683,0.3632992273961161
26763,0.6624523809523809,0,2,0,529383,76227,64460,43496,0.7060932231649931,0.363305296392506
26764,0.6624761904761906,0,1,0,529384,76226,64460,43496,0.7060839601319056,0.3633083309667396
26765,0.6624999999999999,1,0,1,529384,76226,64461,43495,0.7060839601319056,0.3633030128381821
26766,0.6625,47,148,47,529532,76078,64508,43448,0.7047130312349476,0.3635025015477804
26767,0.6625000000000001,1,1,1,529533,76077,64509,43447,0.70470376820186,0.3635002175295338
26768,0.6625952380952381,2,2,2,529535,76075,64511,43445,0.704685242135685,0.3634956492637216
26769,0.6626006493506494,0,1,0,529536,76074,64511,43445,0.7046759791025974,0.3634986905847606
26770,0.6626190476190476,0,2,0,529538,76072,64511,43445,0.7046574530364222,0.36350477337951925
26771,0.6626666666666665,0,3,0,529541,76069,64511,43445,0.7046296639371595,0.36351389795337785
26772,0.6626666666666666,6,30,6,529571,76039,64517,43439,0.704351772944533,0.36357321013073535
26773,0.6626666666666668,2,4,2,529575,76035,64519,43437,0.7043147208121827,0.3635747288067497
26774,0.6627142857142857,2,0,2,529575,76035,64521,43435,0.7043147208121827,0.3635640746630953
26775,0.6627619047619047,0,1,0,529576,76034,64521,43435,0.7043054577790951,0.3635671178297299
26776,0.6627749048337286,1,0,1,529576,76034,64522,43434,0.7043054577790951,0.3635617906050156
26777,0.6628243145743146,0,1,0,529577,76033,64522,43434,0.7042961947460077,0.3635648338034771
26778,0.6628333333333333,4,8,4,529585,76025,64526,43430,0.7042220904813072,0.36356787074630614
26779,0.6628333333333335,1,1,1,529586,76024,64527,43429,0.7042128274482197,0.3635655864649695
26780,0.6628571428571428,2,4,2,529590,76020,64529,43427,0.7041757753158694,0.3635671050758914
26781,0.6628809523809526,1,2,1,529592,76018,64530,43426,0.7041572492496944,0.36356786443856537
26782,0.6628888888888889,0,1,0,529593,76017,64530,43426,0.7041479862166068,0.3635709082993562
26783,0.6629166666666666,1,2,1,529595,76015,64531,43425,0.7041294601504317,0.3635716677829873
26784,0.6629999999999998,0,2,0,529597,76013,64531,43425,0.7041109340842565,0.36357775582310486
26785,0.6629999999999999,6,17,6,529614,75996,64537,43419,0.7039534625217682,0.363597537997739
26786,0.6630000000000001,0,3,0,529617,75993,64537,43419,0.7039256734225054,0.36360667269621144
26787,0.6630833333333334,1,0,1,529617,75993,64538,43418,0.7039256734225054,0.3636013432598337
26788,0.6631190476190476,0,1,0,529618,75992,64538,43418,0.7039164103894179,0.36360438824219077
26789,0.6631428571428571,1,0,1,529618,75992,64539,43417,0.7039164103894179,0.3635990586974181
26790,0.6631666666666667,3,5,3,529623,75987,64542,43414,0.7038700952239801,0.3635982948216514
26791,0.6632121212121211,2,0,2,529623,75987,64544,43412,0.7038700952239801,0.3635876347373094
26792,0.6632142857142856,1,6,1,529629,75981,64545,43411,0.7038145170254548,0.3636005762530153
26793,0.6632380952380953,0,1,0,529630,75980,64545,43411,0.7038052539923673,0.3636036217135295
26794,0.6632629870129869,0,1,0,529631,75979,64545,43411,0.7037959909592797,0.36360666722506074
26795,0.6633333333333333,37,122,37,529753,75857,64582,43374,0.7026659009225981,0.363781231391165
26796,0.6633333333333334,60,161,60,529914,75696,64642,43314,0.7011745525955019,0.3639526090244517
26797,0.6633412698412698,0,4,0,529918,75692,64642,43314,0.7011375004631517,0.36396484210880126
26798,0.6633571428571429,0,1,0,529919,75691,64642,43314,0.7011282374300641,0.363967900508382
26799,0.6634285714285714,0,1,0,529920,75690,64642,43314,0.7011189743969766,0.3639709589593627
26800,0.6634761904761904,0,1,0,529921,75689,64642,43314,0.701109711363889,0.3639740174617447
26801,0.6635,4,25,4,529946,75664,64646,43310,0.7008781355367001,0.3640291156050902
26802,0.6635000000000001,0,1,0,529947,75663,64646,43310,0.7008688725036126,0.36403217536752036
26803,0.6635119047619048,0,2,0,529949,75661,64646,43310,0.7008503464374375,0.36403829504669205
26804,0.6635238095238095,1,0,1,529949,75661,64647,43309,0.7008503464374375,0.364032949483063
26805,0.6635238095238097,0,1,0,529950,75660,64647,43309,0.7008410834043499,0.36403600938059494
26806,0.6635707070707071,0,1,0,529951,75659,64647,43309,0.7008318203712623,0.3640390693295676
26807,0.6635714285714285,2,1,2,529952,75658,64649,43307,0.7008225573381748,0.3640314378178456
26808,0.6636111111111112,1,1,1,529953,75657,64650,43306,0.7008132943050872,0.36402915192118557
26809,0.6636666666666666,0,8,0,529961,75649,64650,43306,0.7007391900403869,0.36405363372703964
26810,0.6636666666666667,1,13,1,529974,75636,64651,43305,0.7006187706102486,0.36408807728201376
26811,0.6636904761904764,0,1,0,529975,75635,64651,43305,0.7006095075771611,0.36409113838910373
26812,0.663702380952381,1,0,1,529975,75635,64652,43304,0.7006095075771611,0.36408579187650814
26813,0.6637142857142857,0,1,0,529976,75634,64652,43304,0.7006002445440735,0.36408885301585703
26814,0.6637222222222223,0,2,0,529978,75632,64652,43304,0.7005817184778984,0.36409497544898095
26815,0.66375,1,3,1,529981,75629,64653,43303,0.7005539293786357,0.36409881276695927
26816,0.663797619047619,1,0,1,529981,75629,64654,43302,0.7005539293786357,0.3640934659592537
26817,0.6638095238095238,2,2,2,529983,75627,64656,43300,0.7005354033124607,0.36408889486828055
26818,0.6638333333333333,4,5,4,529988,75622,64660,43296,0.7004890881470228,0.3640828133671942
26819,0.6638333333333334,0,1,0,529989,75621,64660,43296,0.7004798251139354,0.36408587502207423
26820,0.6638571428571427,0,1,0,529990,75620,64660,43296,0.7004705620808478,0.36408893672844694
26821,0.6638838383838385,1,0,1,529990,75620,64661,43295,0.7004705620808478,0.36408358911827776
26822,0.6639047619047621,1,0,1,529990,75620,64662,43294,0.7004705620808478,0.36407824141816775
26823,0.663952380952381,0,1,0,529991,75619,64662,43294,0.7004612990477602,0.36408130313758796
26824,0.6639999999999999,1,4,1,529995,75615,64663,43293,0.7004242469154099,0.36408820264406094
26825,0.664,29,72,29,530067,75543,64692,43264,0.699757308533106,0.36415362731152207
26826,0.6640079365079364,0,2,0,530069,75541,64692,43264,0.699738782466931,0.3641597575859602
26827,0.6640238095238093,0,1,0,530070,75540,64692,43264,0.6997295194338434,0.3641628228005791
26828,0.6640238095238096,0,2,0,530072,75538,64692,43264,0.6997109933676683,0.36416895338462313
26829,0.664047619047619,0,1,0,530073,75537,64692,43264,0.6997017303345807,0.3641720187540509
26830,0.6640476190476191,0,1,0,530074,75536,64692,43264,0.6996924673014931,0.36417508417508415
26831,0.6640952380952381,1,0,1,530074,75536,64693,43263,0.6996924673014931,0.36416973206845177
26832,0.6641666666666666,9,47,9,530121,75489,64702,43254,0.6992571047463781,0.3642656830297365
26833,0.6641666666666667,9,32,9,530153,75457,64711,43245,0.6989606876875765,0.36431568128590924
26834,0.6641666666666669,0,1,0,530154,75456,64711,43245,0.6989514246544889,0.36431875047387974
26835,0.6641904761904762,1,0,1,530154,75456,64712,43244,0.6989514246544889,0.3643133951137321
26836,0.6642261904761907,0,3,0,530157,75453,64712,43244,0.6989236355552262,0.3643226029301499
26837,0.6642857142857141,0,1,0,530158,75452,64712,43244,0.6989143725221386,0.36432567230572216
26838,0.6642857142857143,1,2,1,530160,75450,64713,43243,0.6988958464559636,0.3643264556460785
26839,0.6643333333333332,0,3,0,530163,75447,64713,43243,0.6988680573567009,0.36433566433566433
26840,0.6643333333333333,1,24,1,530187,75423,64714,43242,0.6986457445625995,0.36440399443812416
26841,0.6643809523809524,1,1,1,530188,75422,64715,43241,0.6986364815295121,0.3644017090415715
26842,0.6644047619047619,0,1,0,530189,75421,64715,43241,0.6986272184964245,0.364404779963257
26843,0.6644166666666667,0,1,0,530190,75420,64715,43241,0.6986179554633369,0.364407850936702
26844,0.6644642857142857,1,2,1,530192,75418,64716,43240,0.6985994293971618,0.36440863658581807
26845,0.6644761904761904,0,1,0,530193,75417,64716,43240,0.6985901663640742,0.3644117076952898
26846,0.6644999999999999,0,4,0,530197,75413,64716,43240,0.6985531142317241,0.364423992650839
26847,0.6645,3,14,3,530211,75399,64719,43237,0.6984234317684983,0.36445092552007824
26848,0.6645238095238095,0,3,0,530214,75396,64719,43237,0.6983956426692356,0.36446014178179764
26849,0.6645238095238096,1,0,1,530214,75396,64720,43236,0.6983956426692356,0.3644547845437993
26850,0.664531746031746,1,0,1,530214,75396,64721,43235,0.6983956426692356,0.3644494272154833
26851,0.6645493395493395,0,1,0,530215,75395,64721,43235,0.698386379636148,0.3644524993677822
26852,0.6645588235294118,0,1,0,530216,75394,64721,43235,0.6983771166030605,0.36445557157187536
26853,0.6645833333333333,0,1,0,530217,75393,64721,43235,0.698367853569973,0.3644586438277641
26854,0.664595238095238,0,1,0,530218,75392,64721,43235,0.6983585905368854,0.36446171613544975
26855,0.664610805860806,1,0,1,530218,75392,64722,43234,0.6983585905368854,0.36445635863975856
26856,0.6646111111111113,1,0,1,530218,75392,64723,43233,0.6983585905368854,0.3644510010537408
26857,0.6646190476190477,0,1,0,530219,75391,64723,43233,0.6983493275037979,0.36445407337469654
26858,0.6646190476190478,0,1,0,530220,75390,64723,43233,0.6983400644707103,0.364457145747452
26859,0.6646212121212122,0,1,0,530221,75389,64723,43233,0.6983308014376227,0.3644602181720086
26860,0.6646428571428572,1,1,1,530222,75388,64724,43232,0.6983215384045351,0.3644579328949587
26861,0.6646666666666667,6,12,6,530234,75376,64730,43226,0.6982103820074845,0.36446265661624594
26862,0.6647142857142859,0,1,0,530235,75375,64730,43226,0.698201118974397,0.3644657296312847
26863,0.6647619047619048,0,4,0,530239,75371,64730,43226,0.6981640668420468,0.364478022209668
26864,0.6647777777777779,1,0,1,530239,75371,64731,43225,0.6981640668420468,0.36447266349623936
26865,0.6647857142857143,1,0,1,530239,75371,64732,43224,0.6981640668420468,0.36446730469244065
26866,0.6648073593073595,1,2,1,530241,75369,64733,43223,0.6981455407758717,0.36446809228278465
26867,0.6648333333333332,1,2,1,530243,75367,64734,43222,0.6981270147096965,0.3644688799129768
26868,0.6648333333333334,2,6,2,530249,75361,64736,43220,0.6980714365111712,0.36447660249112424
26869,0.6648333333333335,0,1,0,530250,75360,64736,43220,0.6980621734780836,0.3644796761679879
26870,0.6648571428571428,0,1,0,530251,75359,64736,43220,0.6980529104449961,0.3644827498966933
26871,0.6648650793650794,0,1,0,530252,75358,64736,43220,0.6980436474119086,0.36448582367724197
26872,0.6648809523809525,0,1,0,530253,75357,64736,43220,0.698034384378821,0.3644888975096351
26873,0.6649285714285714,1,0,1,530253,75357,64737,43219,0.698034384378821,0.36448353798407773
26874,0.664952380952381,1,2,1,530255,75355,64738,43218,0.6980158583126459,0.3644843261113407
26875,0.6649999999999998,0,3,0,530258,75352,64738,43218,0.6979880692133832,0.36449354811503754
26876,0.665,202,531,202,530789,74821,64940,43016,0.6930693986438919,0.3650466322122933
26877,0.6650000000000001,1,1,1,530790,74820,64941,43015,0.6930601356108044,0.3650443416641915
26878,0.6650833333333332,0,1,0,530791,74819,64941,43015,0.6930508725777168,0.36504743961844627
26879,0.6650833333333334,0,1,0,530792,74818,64941,43015,0.6930416095446293,0.3650505376252832
26880,0.6651190476190476,0,3,0,530795,74815,64941,43015,0.6930138204453666,0.36505983196130015
26881,0.6651212121212121,0,2,0,530797,74813,64941,43015,0.6929952943791915,0.3650660284482466
26882,0.665142857142857,0,1,0,530798,74812,64941,43015,0.6929860313461039,0.3650691267706044
26883,0.6651428571428571,0,1,0,530799,74811,64941,43015,0.6929767683130165,0.3650722251455536
26884,0.6651666666666665,0,2,0,530801,74809,64941,43015,0.6929582422468413,0.36507842205323193
26885,0.6651666666666667,3,8,3,530809,74801,64944,43012,0.6928841379821409,0.36508704472341763
26886,0.6651666666666668,1,1,1,530810,74800,64945,43011,0.6928748749490533,0.3650847543947509
26887,0.6652063492063491,0,1,0,530811,74799,64945,43011,0.6928656119159657,0.3650878533231474
26888,0.6652380952380952,3,5,3,530816,74794,64948,43008,0.692819296750528,0.36508718018369807
26889,0.6652857142857144,0,2,0,530818,74792,64948,43008,0.6928007706843529,0.3650933786078098
26890,0.6653055555555555,0,1,0,530819,74791,64948,43008,0.6927915076512653,0.3650964778987937
26891,0.6653120490620491,1,0,1,530819,74791,64949,43007,0.6927915076512653,0.36509108813392416
26892,0.6653333333333332,0,2,0,530821,74789,64949,43007,0.6927729815850903,0.3650972868348671
26893,0.6653333333333333,5,19,5,530840,74770,64954,43002,0.6925969839564267,0.3651292327548144
26894,0.6653333333333334,2,3,2,530843,74767,64956,43000,0.6925691948571641,0.3651277522565744
26895,0.6653809523809522,0,1,0,530844,74766,64956,43000,0.6925599318240765,0.3651308527079123
26896,0.6654285714285715,0,1,0,530845,74765,64956,43000,0.6925506687909889,0.36513395321190506
26897,0.6654404761904762,0,1,0,530846,74764,64956,43000,0.6925414057579014,0.36513705376855404
26898,0.6654545454545455,0,1,0,530847,74763,64956,43000,0.6925321427248138,0.3651401543778606
26899,0.6654999999999999,0,1,0,530848,74762,64956,43000,0.6925228796917262,0.3651432550398261
26900,0.6655,2,12,2,530860,74750,64958,42998,0.6924117232946756,0.3651696844107756
26901,0.6655000000000001,0,2,0,530862,74748,64958,42998,0.6923931972285005,0.3651758870789666
26902,0.6655238095238096,0,1,0,530863,74747,64958,42998,0.692383934195413,0.36517898849208036
26903,0.6655555555555556,0,1,0,530864,74746,64958,42998,0.6923746711623254,0.3651820899578747
26904,0.6655714285714285,0,2,0,530866,74744,64958,42998,0.6923561450961503,0.36518829304751066
26905,0.6655963203463203,0,1,0,530867,74743,64958,42998,0.6923468820630627,0.3651913946713549
26906,0.6656190476190476,0,1,0,530868,74742,64958,42998,0.6923376190299751,0.36519449634788514
26907,0.6656428571428572,0,1,0,530869,74741,64958,42998,0.6923283559968876,0.3651975980771027
26908,0.6656666666666665,0,1,0,530870,74740,64958,42998,0.6923190929638001,0.365200699859009
26909,0.6656666666666666,1,17,1,530887,74723,64959,42997,0.6921616214013117,0.365248046211349
26910,0.6656666666666667,1,1,1,530888,74722,64960,42996,0.6921523583682241,0.3652457568086444
26911,0.6656944444444445,1,0,1,530888,74722,64961,42995,0.6921523583682241,0.3652403646032434
26912,0.6657142857142857,2,2,2,530890,74720,64963,42993,0.692133832302049,0.36523578534231566
26913,0.6657142857142858,0,1,0,530891,74719,64963,42993,0.6921245692689614,0.36523888813375016
26914,0.6657380952380954,1,0,1,530891,74719,64964,42992,0.6921245692689614,0.36523349559514406
26915,0.6657500000000002,0,2,0,530893,74717,64964,42992,0.6921060432027863,0.365239701297267
26916,0.6657777777777778,0,1,0,530894,74716,64964,42992,0.6920967801696988,0.3652428042274102
26917,0.6658095238095239,0,1,0,530895,74715,64964,42992,0.6920875171366112,0.3652459072102764
26918,0.6658333333333333,15,18,15,530913,74697,64979,42977,0.6919207825410353,0.3652208644220474
26919,0.6658333333333334,10,44,10,530957,74653,64989,42967,0.6915132090851829,0.3653035198095562
26920,0.6658571428571427,0,1,0,530958,74652,64989,42967,0.6915039460520953,0.3653066256302128
26921,0.6659166666666667,0,1,0,530959,74651,64989,42967,0.6914946830190077,0.3653097315036814
26922,0.6659285714285715,0,1,0,530960,74650,64989,42967,0.6914854199859202,0.36531283742996334
26923,0.6659523809523811,0,2,0,530962,74648,64989,42967,0.691466893919745,0.36531904944097265
26924,0.6659761904761905,1,0,1,530962,74648,64990,42966,0.691466893919745,0.36531365313653136
26925,0.6659920634920635,0,2,0,530964,74646,64990,42966,0.69144836785357,0.3653198653198653
26926,0.6659999999999999,22,62,22,531026,74584,65012,42944,0.6908740598021416,0.3653937785038459
26927,0.666,1,3,1,531029,74581,65013,42943,0.690846270702879,0.3653977060004765
26928,0.6660238095238094,0,1,0,531030,74580,65013,42943,0.6908370076697914,0.3654008151595858
26929,0.6660357142857143,0,1,0,531031,74579,65013,42943,0.6908277446367038,0.365403924371607
26930,0.6660396825396825,0,2,0,531033,74577,65013,42943,0.6908092185705287,0.3654101429543907
26931,0.6660714285714286,0,1,0,531034,74576,65013,42943,0.6907999555374412,0.3654132523251559
26932,0.6660793650793652,1,1,1,531035,74575,65014,42942,0.6907906925043537,0.36541096181829014
26933,0.6660833333333334,0,1,0,531036,74574,65014,42942,0.6907814294712661,0.3654140712754008
26934,0.6661190476190477,1,0,1,531036,74574,65015,42941,0.6907814294712661,0.36540867123345955
26935,0.6661190476190478,0,1,0,531037,74573,65015,42941,0.6907721664381785,0.3654117807239988
26936,0.6661349206349206,1,2,1,531039,74571,65016,42940,0.6907536403720034,0.3654125996715201
26937,0.6661666666666666,1,0,1,531039,74571,65017,42939,0.6907536403720034,0.36540719938728616
26938,0.6661666666666668,2,13,2,531052,74558,65019,42937,0.6906332209418652,0.3654368270990255
26939,0.6661904761904762,0,1,0,531053,74557,65019,42937,0.6906239579087776,0.3654399373585034
26940,0.6662142857142856,0,4,0,531057,74553,65019,42937,0.6905869057764275,0.365452378925866
26941,0.6662499999999999,0,1,0,531058,74552,65019,42937,0.6905776427433399,0.36545548945007617
26942,0.66625,1,4,1,531062,74548,65020,42936,0.6905405906109897,0.3654625310680603
26943,0.6662857142857144,0,2,0,531064,74546,65020,42936,0.6905220645448146,0.36546875265998197
26944,0.6663333333333332,2,16,2,531080,74530,65022,42934,0.6903738560154137,0.36550773002792347
26945,0.6663333333333334,1,2,1,531082,74528,65023,42933,0.6903553299492385,0.3655085517746316
26946,0.6663333333333336,0,1,0,531083,74527,65023,42933,0.6903460669161511,0.3655116635450366
26947,0.66634126984127,0,1,0,531084,74526,65023,42933,0.6903368038830635,0.3655147753684264
26948,0.6663571428571428,0,2,0,531086,74524,65023,42933,0.6903182778168884,0.36552099917416586
26949,0.6663636363636363,0,1,0,531087,74523,65023,42933,0.6903090147838008,0.36552411115651817
26950,0.6664166666666667,0,3,0,531090,74520,65023,42933,0.6902812256845381,0.3655334474215218
26951,0.6664285714285714,0,1,0,531091,74519,65023,42933,0.6902719626514506,0.3655365596158431
26952,0.6664999999999999,0,1,0,531092,74518,65023,42933,0.6902626996183631,0.36553967186315994
26953,0.6665000000000001,2,12,2,531104,74506,65025,42931,0.6901515432213123,0.36556621848310156
26954,0.6665238095238096,0,1,0,531105,74505,65025,42931,0.6901422801882249,0.36556933138049663
26955,0.6665454545454546,1,0,1,531105,74505,65026,42930,0.6901422801882249,0.36556392898199
26956,0.6665476190476189,0,1,0,531106,74504,65026,42930,0.6901330171551373,0.3655670419129043
26957,0.6666190476190477,0,1,0,531107,74503,65026,42930,0.6901237541220497,0.3655701548968348
26958,0.6666666666666665,69,184,69,531291,74319,65095,42861,0.6884193560339398,0.3657706093189964
26959,0.6666666666666667,41,114,41,531405,74205,65136,42820,0.6873633702619586,0.36590472121341594
26960,0.6667142857142856,0,1,0,531406,74204,65136,42820,0.687354107228871,0.36590784796281106
26961,0.6667142857142858,0,2,0,531408,74202,65136,42820,0.6873355811626959,0.36591410162191723
26962,0.6667380952380952,0,1,0,531409,74201,65136,42820,0.6873263181296083,0.36591722853163106
26963,0.6668214285714285,1,1,1,531410,74200,65137,42819,0.6873170550965209,0.3659149368905904
26964,0.6668333333333331,0,1,0,531411,74199,65137,42819,0.6873077920634333,0.36591806388760706
26965,0.6668333333333333,0,2,0,531413,74197,65137,42819,0.6872892659972581,0.36592431804197717
26966,0.6668333333333334,2,6,2,531419,74191,65139,42817,0.6872336877987328,0.3659322439491317
26967,0.6668531746031746,1,1,1,531420,74190,65140,42816,0.6872244247656453,0.3659299523101379
26968,0.6668571428571428,0,1,0,531421,74189,65140,42816,0.6872151617325577,0.3659330797829153
26969,0.6668571428571429,0,1,0,531422,74188,65140,42816,0.6872058986994701,0.36593620730915183
26970,0.6668694083694083,0,2,0,531424,74186,65140,42816,0.6871873726332951,0.3659424625220082
26971,0.6669047619047618,0,1,0,531425,74185,65140,42816,0.6871781096002075,0.3659455902086307
26972,0.6669999999999999,0,5,0,531430,74180,65140,42816,0.6871317944347697,0.36596122944374165
26973,0.667,8,20,8,531450,74160,65148,42808,0.6869465337730186,0.36598043909445316
26974,0.6670000000000001,0,1,0,531451,74159,65148,42808,0.686937270739931,0.36598356801491017
26975,0.6670238095238095,0,1,0,531452,74158,65148,42808,0.6869280077068435,0.36598669698886854
26976,0.6670476190476191,0,1,0,531453,74157,65148,42808,0.686918744673756,0.3659898260163297
26977,0.6670833333333331,0,1,0,531454,74156,65148,42808,0.6869094816406685,0.3659929550972949
26978,0.6670833333333333,0,2,0,531456,74154,65148,42808,0.6868909555744933,0.3659992134197432
26979,0.6670833333333335,1,2,1,531458,74152,65149,42807,0.6868724295083182,0.3660000513000282
26980,0.6671190476190477,0,1,0,531459,74151,65149,42807,0.6868631664752306,0.3660031806289437
26981,0.667142857142857,1,1,1,531460,74150,65150,42806,0.6868539034421431,0.36600088922329765
26982,0.6671428571428573,4,3,4,531463,74147,65154,42802,0.6868261143428804,0.36598859331845507
26983,0.6671666666666666,0,1,0,531464,74146,65154,42802,0.6868168513097929,0.3659917228169785
26984,0.6671666666666667,3,16,3,531480,74130,65157,42799,0.686668642780392,0.36602553686425093
26985,0.6671666666666668,0,1,0,531481,74129,65157,42799,0.6866593797473045,0.36602866721401206
26986,0.6671904761904763,1,0,1,531481,74129,65158,42798,0.6866593797473045,0.36602324527269153
26987,0.6672222222222223,0,3,0,531484,74126,65158,42798,0.6866315906480418,0.366032636584448
26988,0.6672499999999999,0,2,0,531486,74124,65158,42798,0.6866130645818667,0.36603889772668957
26989,0.6672539682539683,0,1,0,531487,74123,65158,42798,0.6866038015487791,0.36604202837813565
26990,0.6672619047619048,0,1,0,531488,74122,65158,42798,0.6865945385156916,0.3660451590831338
26991,0.6672936507936507,0,1,0,531489,74121,65158,42798,0.6865852754826041,0.36604828984168525
26992,0.6673095238095239,0,1,0,531490,74120,65158,42798,0.6865760124495165,0.36605142065379154
26993,0.6673333333333332,2,6,2,531496,74114,65160,42796,0.6865204342509912,0.366059361902318
26994,0.6673333333333333,5,13,5,531509,74101,65165,42791,0.6864000148208529,0.36607295623310404
26995,0.6673333333333334,0,4,0,531513,74097,65165,42791,0.6863629626885027,0.3660854835397988
26996,0.6673809523809524,1,1,1,531514,74096,65166,42790,0.6863536996554152,0.3660831921701487
26997,0.6674047619047621,0,1,0,531515,74095,65166,42790,0.6863444366223276,0.3660863241647773
26998,0.6674166666666665,0,1,0,531516,74094,65166,42790,0.68633517358924,0.3660894562129975
26999,0.6674999999999999,0,3,0,531519,74091,65166,42790,0.6863073844899774,0.36609885267922077
27000,0.6675,55,133,55,531652,73958,65221,42735,0.6850754010893327,0.36621733951479524
27001,0.6675000000000001,0,1,0,531653,73957,65221,42735,0.6850661380562452,0.3662204778390978
27002,0.667547619047619,0,1,0,531654,73956,65221,42735,0.6850568750231576,0.36622361621718896
27003,0.667611111111111,0,1,0,531655,73955,65221,42735,0.68504761199007,0.3662267546490702
27004,0.6676190476190476,1,3,1,531658,73952,65222,42734,0.6850198228908073,0.3662307389061241
27005,0.6676190476190478,0,2,0,531660,73950,65222,42734,0.6850012968246323,0.3662370162147338
27006,0.6676428571428571,0,1,0,531661,73949,65222,42734,0.6849920337915447,0.3662401549497356
27007,0.6676666666666665,0,3,0,531664,73946,65222,42734,0.684964244692282,0.36624957147754544
27008,0.6676666666666666,7,19,7,531683,73927,65229,42727,0.6847882470636185,0.36627119515833145
27009,0.6676666666666669,0,5,0,531688,73922,65229,42727,0.6847419318981808,0.36628689487265215
27010,0.6676904761904762,0,1,0,531689,73921,65229,42727,0.6847326688650932,0.3662900349770249
27011,0.6677142857142857,0,1,0,531690,73920,65229,42727,0.6847234058320056,0.36629317513523707
27012,0.6677380952380951,0,3,0,531693,73917,65229,42727,0.6846956167327429,0.36630259593292414
27013,0.6677500000000001,0,2,0,531695,73915,65229,42727,0.6846770906665679,0.366308876733938
27014,0.6677777777777777,0,1,0,531696,73914,65229,42727,0.6846678276334803,0.36631201721521595
27015,0.6677857142857142,0,1,0,531697,73913,65229,42727,0.6846585646003928,0.36631515775034296
27016,0.6677857142857144,1,0,1,531697,73913,65230,42726,0.6846585646003928,0.3663097248776138
27017,0.6678095238095239,1,1,1,531698,73912,65231,42725,0.6846493015673052,0.36630743246139735
27018,0.6678181818181816,0,1,0,531699,73911,65231,42725,0.6846400385342176,0.36631057306491993
27019,0.6678333333333333,4,3,4,531702,73908,65235,42721,0.684612249434955,0.3662982620103062
27020,0.6678333333333335,1,1,1,531703,73907,65236,42720,0.6846029864018675,0.3662959692009569
27021,0.6678571428571428,0,3,0,531706,73904,65236,42720,0.6845751973026047,0.3663053916861023
27022,0.6678611111111111,0,2,0,531708,73902,65236,42720,0.6845566712364296,0.366311673612183
27023,0.6678888888888889,0,1,0,531709,73901,65236,42720,0.6845474082033421,0.3663148146560225
27024,0.6679166666666666,0,1,0,531710,73900,65236,42720,0.6845381451702546,0.36631795575373005
27025,0.6679166666666667,0,1,0,531711,73899,65236,42720,0.684528882137167,0.366321096905307
27026,0.6679444444444443,0,1,0,531712,73898,65236,42720,0.6845196191040794,0.36632423811075476
27027,0.6679761904761904,0,2,0,531714,73896,65236,42720,0.6845010930379043,0.36633052068326816
27028,0.6679999999999998,0,2,0,531716,73894,65236,42720,0.6844825669717293,0.36633680347128134
27029,0.6679999999999999,12,40,12,531756,73854,65248,42708,0.684112045648227,0.36639728213311373
27030,0.6680000000000001,0,3,0,531759,73851,65248,42708,0.6840842565489644,0.36640671248037476
27031,0.668047619047619,1,0,1,531759,73851,65249,42707,0.6840842565489644,0.3664012766176496
27032,0.6680833333333334,0,1,0,531760,73850,65249,42707,0.6840749935158769,0.3664044201549457
27033,0.6680952380952381,0,1,0,531761,73849,65249,42707,0.6840657304827893,0.3664075637461821
27034,0.6681190476190477,0,1,0,531762,73848,65249,42707,0.6840564674497017,0.3664107073913603
27035,0.6681428571428571,0,3,0,531765,73845,65249,42707,0.6840286783504391,0.3664201386505594
27036,0.6681666666666665,0,1,0,531766,73844,65249,42707,0.6840194153173516,0.36642328251151857
27037,0.6681666666666666,4,9,4,531775,73835,65253,42703,0.6839360480195635,0.36642983404554735
27038,0.6681666666666668,0,2,0,531777,73833,65253,42703,0.6839175219533884,0.36643612274318665
27039,0.6681904761904762,0,2,0,531779,73831,65253,42703,0.6838989958872133,0.3664424116566839
27040,0.6682045454545453,0,1,0,531780,73830,65253,42703,0.6838897328541258,0.3664455561943827
27041,0.6682142857142856,0,1,0,531781,73829,65253,42703,0.6838804698210382,0.3664487007860502
27042,0.6682380952380952,0,1,0,531782,73828,65253,42703,0.6838712067879507,0.3664518454316877
27043,0.66825,0,3,0,531785,73825,65253,42703,0.683843417688688,0.3664612796924344
27044,0.6682619047619047,0,1,0,531786,73824,65253,42703,0.6838341546556004,0.36646442455396605
27045,0.6682857142857143,1,0,1,531786,73824,65254,42702,0.6838341546556004,0.3664589876937336
27046,0.6682857142857144,0,1,0,531787,73823,65254,42702,0.6838248916225129,0.36646213258957305
27047,0.6683333333333333,33,49,33,531836,73774,65287,42669,0.6833710030012227,0.3664367974030212
27048,0.6683333333333334,30,99,30,531935,73675,65317,42639,0.6824539627255548,0.3665852777825541
27049,0.6683809523809523,0,1,0,531936,73674,65317,42639,0.6824446996924673,0.36658842949627296
27050,0.6684149687172136,2,2,2,531938,73672,65319,42637,0.6824261736262922,0.36658384131924443
27051,0.6684166666666665,0,1,0,531939,73671,65319,42637,0.6824169105932046,0.36658699315610277
27052,0.6684206349206349,0,1,0,531940,73670,65319,42637,0.6824076475601171,0.3665901450471597
27053,0.6684523809523809,1,0,1,531940,73670,65320,42636,0.6824076475601171,0.3665846989837154
27054,0.668452380952381,1,2,1,531942,73668,65321,42635,0.6823891214939419,0.3665855566924327
27055,0.6684999999999998,0,1,0,531943,73667,65321,42635,0.6823798584608545,0.36658870870664306
27056,0.6685,2,18,2,531961,73649,65323,42633,0.6822131238652784,0.3666345608090676
27057,0.6685000000000001,1,2,1,531963,73647,65324,42632,0.6821945977991033,0.366635419981252
27058,0.6685238095238095,0,1,0,531964,73646,65324,42632,0.6821853347660158,0.3666385730748723
27059,0.6685476190476191,1,0,1,531964,73646,65325,42631,0.6821853347660158,0.36663312606964404
27060,0.6685476190476192,0,4,0,531968,73642,65325,42631,0.6821482826336656,0.36664573890757096
27061,0.6685714285714285,0,2,0,531970,73640,65325,42631,0.6821297565674904,0.36665204565196824
27062,0.6685714285714286,2,2,2,531972,73638,65327,42629,0.6821112305013154,0.366647458006141
27063,0.6686666666666666,1,4,1,531976,73634,65328,42628,0.6820741783689651,0.3666546248989352
27064,0.6686666666666667,7,16,7,531992,73618,65335,42621,0.6819259698395642,0.3666669534321527
27065,0.6686904761904762,0,1,0,531993,73617,65335,42621,0.6819167068064768,0.36667010788210397
27066,0.6687023809523809,0,1,0,531994,73616,65335,42621,0.6819074437733892,0.36667326238633136
27067,0.66875,1,4,1,531998,73612,65336,42620,0.6818703916410389,0.36668043223897034
27068,0.6687738095238096,1,0,1,531998,73612,65337,42619,0.6818703916410389,0.36667498343815336
27069,0.6688095238095237,0,3,0,532001,73609,65337,42619,0.6818426025417763,0.3666844478094779
27070,0.6688333333333333,1,2,1,532003,73607,65338,42618,0.6818240764756012,0.3666853086685309
27071,0.6688333333333334,0,2,0,532005,73605,65338,42618,0.681805550409426,0.36669161869853645
27072,0.6688809523809524,1,0,1,532005,73605,65339,42617,0.681805550409426,0.36668616957202593
27073,0.6689166666666668,0,1,0,532006,73604,65339,42617,0.6817962873763385,0.36668932464872955
27074,0.6689761904761905,1,0,1,532006,73604,65340,42616,0.6817962873763385,0.3666838754087076
27075,0.6689999999999999,1,1,1,532007,73603,65341,42615,0.681787024343251,0.3666815811664286
27076,0.669,14,17,14,532024,73586,65355,42601,0.6816295527807625,0.36665892053327825
27077,0.6690151515151516,0,1,0,532025,73585,65355,42601,0.681620289747675,0.36666207632589126
27078,0.6690238095238095,0,1,0,532026,73584,65355,42601,0.6816110267145874,0.3666652321728278
27079,0.669047619047619,0,1,0,532027,73583,65355,42601,0.6816017636814998,0.36666838807408936
27080,0.6690515873015873,0,1,0,532028,73582,65355,42601,0.6815925006484124,0.36667154402967733
27081,0.6690660173160172,0,1,0,532029,73581,65355,42601,0.6815832376153248,0.36667470003959307
27082,0.6690952380952381,1,2,1,532031,73579,65356,42600,0.6815647115491497,0.3666755609877861
27083,0.6691309523809522,0,1,0,532032,73578,65356,42600,0.6815554485160621,0.3666787171409389
27084,0.6691362110112111,0,4,0,532036,73574,65356,42600,0.6815183963837119,0.3666913422968995
27085,0.6691666666666666,12,26,12,532062,73548,65368,42588,0.6812775575234354,0.36670799752014877
27086,0.6691666666666667,4,25,4,532087,73523,65372,42584,0.6810459816962466,0.3667651390527703
27087,0.6691831501831501,0,1,0,532088,73522,65372,42584,0.6810367186631591,0.36676829793464594
27088,0.669202380952381,0,1,0,532089,73521,65372,42584,0.6810274556300715,0.36677145687093576
27089,0.6692124542124541,0,3,0,532092,73518,65372,42584,0.6809996665308089,0.3667809340063048
27090,0.6692142857142858,1,0,1,532092,73518,65373,42583,0.6809996665308089,0.3667754799700261
27091,0.6692619047619047,2,2,2,532094,73516,65375,42581,0.6809811404646338,0.36677088985934175
27092,0.6692857142857142,0,2,0,532096,73514,65375,42581,0.6809626143984586,0.36677720832077176
27093,0.6692857142857143,0,1,0,532097,73513,65375,42581,0.680953351365371,0.3667803676331249
27094,0.6693333333333332,0,1,0,532098,73512,65375,42581,0.6809440883322835,0.36678352699990524
27095,0.6693333333333333,4,28,4,532126,73484,65379,42577,0.680684723405832,0.3668501908479162
27096,0.669345238095238,0,1,0,532127,73483,65379,42577,0.6806754603727444,0.36685335171463035
27097,0.6693809523809523,0,1,0,532128,73482,65379,42577,0.6806661973396569,0.36685651263581454
27098,0.6694047619047621,1,0,1,532128,73482,65380,42576,0.6806661973396569,0.36685105723000566
27099,0.6694166666666667,0,2,0,532130,73480,65380,42576,0.6806476712734818,0.3668573791962501
27100,0.669468253968254,0,1,0,532131,73479,65380,42576,0.6806384082403942,0.3668605402610831
27101,0.6694999999999999,1,0,1,532131,73479,65381,42575,0.6806384082403942,0.3668550847019491
27102,0.6695,0,9,0,532140,73470,65381,42575,0.6805550409426062,0.36688353655909345
27103,0.6695238095238095,2,2,2,532142,73468,65383,42573,0.6805365148764312,0.3668789479580493
27104,0.669547619047619,1,0,1,532142,73468,65384,42572,0.6805365148764312,0.36687349189934504
27105,0.6695476190476191,0,1,0,532143,73467,65384,42572,0.6805272518433436,0.3668766535388964
27106,0.6695555555555555,0,1,0,532144,73466,65384,42572,0.680517988810256,0.36687981523294094
27107,0.6695833333333334,0,2,0,532146,73464,65384,42572,0.6804994627440809,0.36688613878451515
27108,0.6696428571428572,1,0,1,532146,73464,65385,42571,0.6804994627440809,0.3668806825526781
27109,0.669665329768271,0,1,0,532147,73463,65385,42571,0.6804901997109933,0.3668838443904373
27110,0.6696666666666665,0,1,0,532148,73462,65385,42571,0.6804809366779058,0.36688700628269544
27111,0.6696666666666666,1,18,1,532166,73444,65386,42570,0.6803142020823298,0.3669384729429207
27112,0.6696666666666669,0,1,0,532167,73443,65386,42570,0.6803049390492423,0.36694163585115463
27113,0.6696904761904762,0,1,0,532168,73442,65386,42570,0.6802956760161547,0.3669447988139158
27114,0.6697142857142856,0,1,0,532169,73441,65386,42570,0.6802864129830671,0.36694796183120565
27115,0.6697142857142857,0,1,0,532170,73440,65386,42570,0.6802771499499797,0.3669511249030256
27116,0.6697619047619048,0,1,0,532171,73439,65386,42570,0.6802678869168921,0.366954288029377
27117,0.6697857142857143,0,1,0,532172,73438,65386,42570,0.6802586238838045,0.36695745121026135
27118,0.6697857142857144,1,0,1,532172,73438,65387,42569,0.6802586238838045,0.36695199427620745
27119,0.6698095238095237,0,1,0,532173,73437,65387,42569,0.680249360850717,0.36695515749185387
27120,0.6698333333333332,0,1,0,532174,73436,65387,42569,0.6802400978176294,0.3669583207620361
27121,0.6698333333333334,2,10,2,532184,73426,65389,42567,0.6801474674867538,0.36697904183873165
27122,0.6698333333333335,0,2,0,532186,73424,65389,42567,0.6801289414205788,0.3669853695545344
27123,0.6698484848484847,0,1,0,532187,73423,65389,42567,0.6801196783874912,0.36698853349426674
27124,0.6698809523809524,0,1,0,532188,73422,65389,42567,0.6801104153544036,0.3669916974885549
27125,0.669892857142857,0,1,0,532189,73421,65389,42567,0.6801011523213161,0.3669948615374004
27126,0.6699047619047619,0,1,0,532190,73420,65389,42567,0.6800918892882285,0.3669980256408046
27127,0.669952380952381,1,0,1,532190,73420,65390,42566,0.6800918892882285,0.36699256806856
27128,0.6699999999999998,3,8,3,532198,73412,65393,42563,0.680017785023528,0.3670015089458935
27129,0.67,617,1545,617,533743,71867,66010,41946,0.6657063989032569,0.36855192289105815
27130,0.6700000000000002,2,5,2,533748,71862,66012,41944,0.6656600837378192,0.3685570180834051
27131,0.6700238095238096,1,0,1,533748,71862,66013,41943,0.6656600837378192,0.3685514696190853
27132,0.6700833333333333,0,1,0,533749,71861,66013,41943,0.6656508207047316,0.3685547080946188
27133,0.6701111111111112,0,1,0,533750,71860,66013,41943,0.665641557671644,0.3685579466270661
27134,0.6701190476190476,0,2,0,533752,71858,66013,41943,0.6656230316054689,0.3685644238627077
27135,0.6701190476190477,1,1,1,533753,71857,66014,41942,0.6656137685723813,0.36856211390258264
27136,0.670142857142857,1,1,1,533754,71856,66015,41941,0.6656045055392937,0.36855980386126175
27137,0.6701666666666665,1,0,1,533754,71856,66016,41940,0.6656045055392937,0.3685542549826004
27138,0.6701666666666667,3,9,3,533763,71847,66019,41937,0.6655211382415058,0.36856675806791817
27139,0.6701666666666668,1,1,1,533764,71846,66020,41936,0.6655118752084183,0.3685644478036948
27140,0.6702380952380952,0,1,0,533765,71845,66020,41936,0.6655026121753307,0.3685676870479254
27141,0.67025,0,3,0,533768,71842,66020,41936,0.665474823076068,0.3685774051222556
27142,0.6702619047619048,0,2,0,533770,71840,66020,41936,0.665456297009893,0.36858388412318943
27143,0.6702777777777778,0,2,0,533772,71838,66020,41936,0.6654377709437178,0.36859036335190815
27144,0.6702857142857143,0,2,0,533774,71836,66020,41936,0.6654192448775427,0.36859684280842386
27145,0.6702857142857144,1,0,1,533774,71836,66021,41935,0.6654192448775427,0.36859129303601096
27146,0.6703333333333333,5,18,5,533792,71818,66026,41930,0.6652525102819667,0.3686218658789605
27147,0.6703333333333334,0,1,0,533793,71817,66026,41930,0.6652432472488792,0.36862510659621794
27148,0.6703571428571428,0,1,0,533794,71816,66026,41930,0.6652339842157916,0.36862834737045697
27149,0.6703571428571429,0,1,0,533795,71815,66026,41930,0.665224721182704,0.3686315882016792
27150,0.6703809523809525,0,1,0,533796,71814,66026,41930,0.6652154581496165,0.36863482908988604
27151,0.6704444444444444,0,1,0,533797,71813,66026,41930,0.665206195116529,0.3686380700350791
27152,0.6704523809523809,0,1,0,533798,71812,66026,41930,0.6651969320834414,0.3686413110372598
27153,0.670452380952381,0,1,0,533799,71811,66026,41930,0.6651876690503539,0.3686445520964296
27154,0.6704722222222225,0,1,0,533800,71810,66026,41930,0.6651784060172663,0.3686477932125901
27155,0.6704880952380953,0,1,0,533801,71809,66026,41930,0.6651691429841787,0.3686510343857428
27156,0.6704999999999999,0,1,0,533802,71808,66026,41930,0.6651598799510912,0.36865427561588915
27157,0.6705,0,5,0,533807,71803,66026,41930,0.6651135647856534,0.3686704826215786
27158,0.6705000000000001,1,3,1,533810,71800,66027,41929,0.6650857756863907,0.36867465642008634
27159,0.6705476190476192,1,0,1,533810,71800,66028,41928,0.6650857756863907,0.3686691052335397
27160,0.6705555555555556,0,1,0,533811,71799,66028,41928,0.6650765126533031,0.3686723469360838
27161,0.6706111111111109,0,1,0,533812,71798,66028,41928,0.6650672496202157,0.3686755886956369
27162,0.670611111111111,0,1,0,533813,71797,66028,41928,0.6650579865871281,0.36867883051220046
27163,0.6706190476190474,0,1,0,533814,71796,66028,41928,0.6650487235540405,0.3686820723857761
27164,0.6706428571428572,0,2,0,533816,71794,66028,41928,0.6650301974878654,0.36868855630396935
27165,0.6706507936507937,1,1,1,533817,71793,66029,41927,0.6650209344547778,0.3686862469222652
27166,0.6706547619047619,0,1,0,533818,71792,66029,41927,0.6650116714216903,0.3686894890035966
27167,0.6706666666666666,6,20,6,533838,71772,66035,41921,0.6648264107599392,0.36872102943892765
27168,0.6706666666666667,1,2,1,533840,71770,66036,41920,0.6648078846937642,0.3687219632333539
27169,0.6706904761904761,0,1,0,533841,71769,66036,41920,0.6647986216606766,0.36872520648435647
27170,0.6707142857142857,1,6,1,533847,71763,66037,41919,0.6647430434621513,0.36873911437166834
27171,0.6707142857142858,1,0,1,533847,71763,66038,41918,0.6647430434621513,0.36873356145705966
27172,0.6707658730158728,0,1,0,533848,71762,66038,41918,0.6647337804290637,0.3687368050668543
27173,0.6708333333333333,12,32,12,533880,71730,66050,41906,0.6644373633702619,0.36877398007673623
27174,0.6708333333333334,11,36,11,533916,71694,66061,41895,0.66410389417911,0.3688297282307266
27175,0.6708430735930736,0,2,0,533918,71692,66061,41895,0.664085368112935,0.36883622245503445
27176,0.6708571428571429,0,1,0,533919,71691,66061,41895,0.6640761050798474,0.36883946965295017
27177,0.6708809523809524,0,1,0,533920,71690,66061,41895,0.6640668420467598,0.36884271690804243
27178,0.6708809523809525,1,0,1,533920,71690,66062,41894,0.6640668420467598,0.3688371601634033
27179,0.670952380952381,0,2,0,533922,71688,66062,41894,0.6640483159805847,0.36884365480445847
27180,0.6709642857142858,0,3,0,533925,71685,66062,41894,0.6640205268813221,0.368853397194904
27181,0.6709722222222223,0,2,0,533927,71683,66062,41894,0.6640020008151469,0.3688598924077938
27182,0.6709880952380952,1,1,1,533928,71682,66063,41893,0.6639927377820594,0.3688575830948712
27183,0.6709999999999999,13,32,13,533960,71650,66076,41880,0.6636963207232576,0.368889280366423
27184,0.671,0,2,0,533962,71648,66076,41880,0.6636777946570825,0.3688957790148686
27185,0.671011904761905,0,1,0,533963,71647,66076,41880,0.663668531623995,0.3688990284249562
27186,0.6710238095238094,1,1,1,533964,71646,66077,41879,0.6636592685909074,0.3688967187844087
27187,0.671047619047619,0,2,0,533966,71644,66077,41879,0.6636407425247323,0.3689032178501273
27188,0.671111111111111,0,1,0,533967,71643,66077,41879,0.6636314794916447,0.3689064674688607
27189,0.6711190476190477,1,1,1,533968,71642,66078,41878,0.6636222164585572,0.36890415785764624
27190,0.6711428571428572,0,1,0,533969,71641,66078,41878,0.6636129534254697,0.36890740757053886
27191,0.6711666666666665,0,1,0,533970,71640,66078,41878,0.6636036903923821,0.36891065734068607
27192,0.6711666666666666,1,2,1,533972,71638,66079,41877,0.663585164326207,0.3689115975862221
27193,0.6711666666666667,3,7,3,533979,71631,66082,41874,0.6635203230945941,0.36891766882516186
27194,0.6711904761904761,1,0,1,533979,71631,66083,41873,0.6635203230945941,0.3689121088243586
27195,0.6711904761904762,1,4,1,533983,71627,66084,41872,0.6634832709622439,0.36891954995198195
27196,0.6712142857142857,0,3,0,533986,71624,66084,41872,0.6634554818629812,0.36892930147317965
27197,0.67125,2,3,2,533989,71621,66086,41870,0.6634276927637186,0.3689279326113965
27198,0.6712777777777778,0,1,0,533990,71620,66086,41870,0.663418429730631,0.3689311833641731
27199,0.6713333333333332,6,15,6,534005,71605,66092,41864,0.6632794842343177,0.3689465845296953
27200,0.6713333333333334,1,8,1,534013,71597,66093,41863,0.6632053799696173,0.3689670368411775
27201,0.6713571428571429,0,2,0,534015,71595,66093,41863,0.6631868539034421,0.36897354086974915
27202,0.6714285714285714,0,4,0,534019,71591,66093,41863,0.663149801771092,0.36898654961482186
27203,0.6714404761904761,0,1,0,534020,71590,66093,41863,0.6631405387380044,0.3689898019444175
27204,0.6714999999999999,1,0,1,534020,71590,66094,41862,0.6631405387380044,0.3689842400310263
27205,0.6715000000000001,4,7,4,534027,71583,66098,41858,0.6630756975063915,0.36898475859697993
27206,0.6715000000000002,0,2,0,534029,71581,66098,41858,0.6630571714402164,0.3689912640273627
27207,0.6715238095238095,0,2,0,534031,71579,66098,41858,0.6630386453740412,0.3689977696871391
27208,0.671547619047619,0,2,0,534033,71577,66098,41858,0.6630201193078662,0.36900427557632126
27209,0.6715555555555555,0,1,0,534034,71576,66098,41858,0.6630108562747786,0.36900752860694325
27210,0.6715833333333333,0,1,0,534035,71575,66098,41858,0.6630015932416911,0.36901078169492124
27211,0.6716190476190477,1,0,1,534035,71575,66099,41857,0.6630015932416911,0.3690052189858241
27212,0.6716363636363636,0,1,0,534036,71574,66099,41857,0.6629923302086035,0.3690084721107986
27213,0.6716666666666665,48,118,48,534154,71456,66147,41809,0.6618992923042721,0.36912550214099676
27214,0.6716666666666667,16,54,16,534208,71402,66163,41793,0.6613990885175441,0.3692124210433323
27215,0.6716666666666669,0,2,0,534210,71400,66163,41793,0.6613805624513691,0.36921894463438554
27216,0.6716904761904761,0,1,0,534211,71399,66163,41793,0.6613712994182815,0.36922220651636156
27217,0.6716904761904763,0,2,0,534213,71397,66163,41793,0.6613527733521064,0.36922873045322024
27218,0.6717142857142856,1,0,1,534213,71397,66164,41792,0.6613527733521064,0.369223157727341
27219,0.6717499999999998,0,1,0,534214,71396,66164,41792,0.6613435103190188,0.3692264197618122
27220,0.67175,0,1,0,534215,71395,66164,41792,0.6613342472859313,0.36922968185392313
27221,0.6717619047619047,0,2,0,534217,71393,66164,41792,0.6613157212197562,0.3692362062110704
27222,0.6717777777777778,0,1,0,534218,71392,66164,41792,0.6613064581866687,0.3692394684761097
27223,0.6717857142857143,1,3,1,534221,71389,66165,41791,0.661278669087406,0.36924368262943985
27224,0.6718253968253967,0,1,0,534222,71388,66165,41791,0.6612694060543184,0.3692469451046572
27225,0.6718333333333334,3,8,3,534230,71380,66168,41788,0.6611953017896179,0.36925632687685567
27226,0.6718571428571428,0,1,0,534231,71379,66168,41788,0.6611860387565305,0.3692595898097502
27227,0.6719047619047619,0,1,0,534232,71378,66168,41788,0.6611767757234429,0.36926285280031107
27228,0.671904761904762,0,1,0,534233,71377,66168,41788,0.6611675126903553,0.36926611584853974
27229,0.6719157509157507,0,1,0,534234,71376,66168,41788,0.6611582496572678,0.3692693789544378
27230,0.6719523809523809,0,1,0,534235,71375,66168,41788,0.6611489866241802,0.36927264211800676
27231,0.6719999999999999,0,2,0,534237,71373,66168,41788,0.6611304605580051,0.3692791686181635
27232,0.672,11,34,11,534271,71339,66179,41777,0.6608155174330282,0.3693288305809965
27233,0.6720000000000002,1,0,1,534271,71339,66180,41776,0.6608155174330282,0.36932325509437297
27234,0.6720238095238095,0,1,0,534272,71338,66180,41776,0.6608062543999407,0.3693265201478155
27235,0.6720238095238096,1,1,1,534273,71337,66181,41775,0.6607969913668532,0.36932420963293017
27236,0.6720714285714285,1,1,1,534274,71336,66182,41774,0.6607877283337656,0.36932189903633633
27237,0.6720714285714287,1,0,1,534274,71336,66183,41773,0.6607877283337656,0.36931632319267255
27238,0.6720833333333335,0,4,0,534278,71332,66183,41773,0.6607506762014154,0.36932938420052164
27239,0.6721060606060605,0,1,0,534279,71331,66183,41773,0.6607414131683278,0.3693326495968312
27240,0.6721428571428569,1,0,1,534279,71331,66184,41772,0.6607414131683278,0.36932707355242567
27241,0.672142857142857,0,1,0,534280,71330,66184,41772,0.6607321501352403,0.369330338986048
27242,0.6721428571428573,2,2,2,534282,71328,66186,41770,0.6607136240690652,0.36932571751931953
27243,0.6721666666666666,0,1,0,534283,71327,66186,41770,0.6607043610359776,0.36932898308531614
27244,0.6721666666666667,0,9,0,534292,71318,66186,41770,0.6606209937381896,0.36935837577815506
27245,0.6722222222222223,1,0,1,534292,71318,66187,41769,0.6606209937381896,0.36935279917231867
27246,0.6722380952380951,0,2,0,534294,71316,66187,41769,0.6606024676720145,0.3693593314763231
27247,0.6722619047619047,0,3,0,534297,71313,66187,41769,0.6605746785727519,0.36936913036557545
27248,0.6722727272727272,0,1,0,534298,71312,66187,41769,0.6605654155396643,0.36937239677753114
27249,0.6723095238095237,0,5,0,534303,71307,66187,41769,0.6605191003742266,0.36938872970391595
27250,0.6723162393162394,1,2,1,534305,71305,66188,41768,0.6605005743080514,0.3693896863088447
27251,0.6723333333333332,5,10,5,534315,71295,66193,41763,0.6604079439771758,0.3693944700949955
27252,0.6723333333333333,2,16,2,534331,71279,66195,41761,0.660259735447775,0.3694355980184006
27253,0.6723333333333334,0,2,0,534333,71277,66195,41761,0.6602412093815999,0.3694421345034413
27254,0.6723571428571427,0,1,0,534334,71276,66195,41761,0.6602319463485123,0.3694454028327008
27255,0.6723636363636362,3,0,3,534334,71276,66198,41758,0.6602319463485123,0.36942866748058106
27256,0.6723690476190477,1,0,1,534334,71276,66199,41757,0.6602319463485123,0.36942308883246483
27257,0.6723809523809524,2,6,2,534340,71270,66201,41755,0.660176368149987,0.3694315416943154
27258,0.6724523809523809,0,1,0,534341,71269,66201,41755,0.6601671051168995,0.36943481030577574
27259,0.6724761904761906,0,2,0,534343,71267,66201,41755,0.6601485790507243,0.36944134770221726
27260,0.6724999999999999,0,3,0,534346,71264,66201,41755,0.6601207899514617,0.36945115423070457
27261,0.6725,52,138,52,534484,71126,66253,41703,0.6588424913853792,0.36961242233822866
27262,0.6725000000000001,0,2,0,534486,71124,66253,41703,0.6588239653192042,0.3696189741817118
27263,0.6725833333333333,0,1,0,534487,71123,66253,41703,0.6588147022861166,0.3696222501905589
27264,0.6725833333333334,0,1,0,534488,71122,66253,41703,0.658805439253029,0.3696255262574784
27265,0.6726190476190476,1,0,1,534488,71122,66254,41702,0.658805439253029,0.3696199390200667
27266,0.6726428571428571,0,1,0,534489,71121,66254,41702,0.6587961762199415,0.3696232151245757
27267,0.6726666666666666,4,18,4,534507,71103,66258,41698,0.6586294416243654,0.36965984344110425
27268,0.6726666666666667,0,4,0,534511,71099,66258,41698,0.6585923894920153,0.36967295229483055
27269,0.6726904761904763,0,1,0,534512,71098,66258,41698,0.6585831264589277,0.3696762296535338
27270,0.6726984126984127,1,1,1,534513,71097,66259,41697,0.6585738634258401,0.36967391882546946
27271,0.6727142857142857,1,1,1,534514,71096,66260,41696,0.6585646003927526,0.369671607915455
27272,0.6727142857142858,1,0,1,534514,71096,66261,41695,0.6585646003927526,0.36966601945190664
27273,0.6727261904761906,0,3,0,534517,71093,66261,41695,0.65853681129349,0.3696758520409973
27274,0.6727272727272726,1,0,1,534517,71093,66262,41694,0.65853681129349,0.36967026341688314
27275,0.6727380952380951,1,0,1,534517,71093,66263,41693,0.65853681129349,0.36966467469366765
27276,0.6728333333333333,3,5,3,534522,71088,66266,41690,0.6584904961280522,0.36966429622798774
27277,0.6728512876012879,0,4,0,534526,71084,66266,41690,0.6584534439957019,0.3696774079131715
27278,0.6728571428571428,1,2,1,534528,71082,66267,41689,0.6584349179295268,0.3696783747594683
27279,0.6728571428571429,1,3,1,534531,71079,66268,41688,0.6584071288302642,0.3696826199154008
27280,0.6728888888888889,1,0,1,534531,71079,66269,41687,0.6584071288302642,0.3696770303105546
27281,0.672904761904762,0,1,0,534532,71078,66269,41687,0.6583978657971766,0.36968030860639384
27282,0.6729166666666666,0,1,0,534533,71077,66269,41687,0.6583886027640891,0.36968358696037745
27283,0.6729285714285714,1,0,1,534533,71077,66270,41686,0.6583886027640891,0.3696779972153987
27284,0.6729285714285715,0,2,0,534535,71075,66270,41686,0.6583700766979139,0.36968455405681044
27285,0.6729393939393938,0,1,0,534536,71074,66270,41686,0.6583608136648265,0.36968783256473925
27286,0.6729444444444443,0,1,0,534537,71073,66270,41686,0.6583515506317389,0.3696911111308188
27287,0.6729761904761905,0,1,0,534538,71072,66270,41686,0.6583422875986513,0.36969438975505065
27288,0.6729999999999998,1,0,1,534538,71072,66271,41685,0.6583422875986513,0.3696887998084376
27289,0.6729999999999999,7,21,7,534559,71051,66278,41678,0.6581477639038127,0.36971852850641806
27290,0.6730000000000002,3,7,3,534566,71044,66281,41675,0.6580829226721998,0.36972471366850307
27291,0.6730198412698414,1,0,1,534566,71044,66282,41674,0.6580829226721998,0.36971912205681434
27292,0.6730454545454547,1,1,1,534567,71043,66283,41673,0.6580736596391122,0.36971681039071647
27293,0.673047619047619,1,0,1,534567,71043,66284,41672,0.6580736596391122,0.36971121856008515
27294,0.6731569264069265,1,0,1,534567,71043,66285,41671,0.6580736596391122,0.36970562663023226
27295,0.6731604784104784,0,1,0,534568,71042,66285,41671,0.6580643966060247,0.3697089066922183
27296,0.6731666666666665,1,1,1,534569,71041,66286,41670,0.6580551335729371,0.36970659474230555
27297,0.6731666666666666,2,11,2,534580,71030,66288,41668,0.657953240208974,0.3697314947913894
27298,0.6731904761904762,1,0,1,534580,71030,66289,41667,0.657953240208974,0.36972590219792895
27299,0.6732380952380952,0,1,0,534581,71029,66289,41667,0.6579439771758865,0.3697291829346206
27300,0.6732499999999999,0,1,0,534582,71028,66289,41667,0.6579347141427989,0.3697324637295355
27301,0.6732857142857143,0,2,0,534584,71026,66289,41667,0.6579161880766238,0.3697390254940413
27302,0.6732857142857145,0,1,0,534585,71025,66289,41667,0.6579069250435362,0.3697423064636354
27303,0.6733095238095237,0,1,0,534586,71024,66289,41667,0.6578976620104487,0.36974558749145897
27304,0.6733333333333331,0,2,0,534588,71022,66289,41667,0.6578791359442736,0.3697521497218007
27305,0.6733333333333333,50,133,50,534721,70889,66339,41617,0.6566471525436289,0.3699091604003342
27306,0.6733333333333335,53,173,53,534894,70716,66392,41564,0.655044647819482,0.37018168863555395
27307,0.6733571428571429,0,1,0,534895,70715,66392,41564,0.6550353847863944,0.37018498561618823
27308,0.6734761904761905,0,1,0,534896,70714,66392,41564,0.6550261217533069,0.3701882826555514
27309,0.6734855593752652,0,1,0,534897,70713,66392,41564,0.6550168587202193,0.37019157975364503
27310,0.6735,1,9,1,534906,70704,66393,41563,0.6549334914224314,0.3702156466281276
27311,0.6735000000000001,0,2,0,534908,70702,66393,41563,0.6549149653562563,0.37022224201665704
27312,0.6735119047619047,1,0,1,534908,70702,66394,41562,0.6549149653562563,0.37021663222404333
27313,0.6735714285714285,0,1,0,534909,70701,66394,41562,0.6549057023231687,0.3702199299858368
27314,0.6735833333333332,0,1,0,534910,70700,66394,41562,0.6548964392900811,0.3702232278063815
27315,0.6736190476190477,1,1,1,534911,70699,66395,41561,0.6548871762569936,0.370220915731338
27316,0.6736666666666666,0,3,0,534914,70696,66395,41561,0.654859387157731,0.3702308096599767
27317,0.6736666666666667,2,10,2,534924,70686,66397,41559,0.6547667568268554,0.37025257249766136
27318,0.6736746031746031,1,0,1,534924,70686,66398,41558,0.6547667568268554,0.3702469619756958
27319,0.6736818181818183,1,0,1,534924,70686,66399,41557,0.6547667568268554,0.37024135135375924
27320,0.6736904761904762,0,1,0,534925,70685,66399,41557,0.6547574937937678,0.3702446499527806
27321,0.6737142857142857,1,0,1,534925,70685,66400,41556,0.6547574937937678,0.37023903921027074
27322,0.673746031746032,0,1,0,534926,70684,66400,41556,0.6547482307606802,0.3702423378474697
27323,0.6737499999999998,0,1,0,534927,70683,66400,41556,0.6547389677275928,0.37024563654344744
27324,0.67375,1,4,1,534931,70679,66401,41555,0.6547019155952425,0.3702532209490885
27325,0.6737658730158729,1,1,1,534932,70678,66402,41554,0.6546926525621549,0.37025090883170575
27326,0.6737738095238095,1,0,1,534932,70678,66403,41553,0.6546926525621549,0.37024529764503566
27327,0.6738095238095237,1,5,1,534937,70673,66404,41552,0.6546463373967172,0.3702561817776788
27328,0.6738333333333333,1,12,1,534949,70661,66405,41551,0.6545351809996666,0.3702901650447368
27329,0.6738333333333334,1,5,1,534954,70656,66406,41550,0.6544888658342287,0.37030105341960323
27330,0.6738809523809524,0,1,0,534955,70655,66406,41550,0.6544796028011413,0.3703043536384297
27331,0.6738888888888889,1,1,1,534956,70654,66407,41549,0.6544703397680537,0.3703020418348886
27332,0.6739047619047618,0,1,0,534957,70653,66407,41549,0.6544610767349661,0.3703053421507638
27333,0.6739166666666666,1,1,1,534958,70652,66408,41548,0.6544518137018785,0.3703030303030303
27334,0.6739285714285714,0,1,0,534959,70651,66408,41548,0.654442550668791,0.37030633071596003
27335,0.6739523809523809,0,2,0,534961,70649,66408,41548,0.6544240246026158,0.37031293171831686
27336,0.6739725274725274,1,0,1,534961,70649,66409,41547,0.6544240246026158,0.3703073193340226
27337,0.6739999999999999,1,3,1,534964,70646,66410,41546,0.6543962355033532,0.37031160867084995
27338,0.674,17,53,17,535017,70593,66427,41529,0.6539052947497128,0.37039118103494406
27339,0.6740238095238095,0,2,0,535019,70591,66427,41529,0.6538867686835378,0.3703977880841955
27340,0.674047619047619,1,2,1,535021,70589,66428,41528,0.6538682426173626,0.3703987798460537
27341,0.6740952380952382,0,1,0,535022,70588,66428,41528,0.6538589795842751,0.37040208355631665
27342,0.6741309523809523,0,1,0,535023,70587,66428,41528,0.6538497165511875,0.370405387325514
27343,0.6741428571428572,0,1,0,535024,70586,66428,41528,0.6538404535180999,0.37040869115364716
27344,0.6741666666666666,16,31,16,535055,70555,66444,41512,0.6535532994923858,0.3704212658498934
27345,0.6741666666666667,7,27,7,535082,70528,66451,41505,0.6533031975990218,0.3704712004498675
27346,0.6741904761904763,0,1,0,535083,70527,66451,41505,0.6532939345659343,0.37047450728363324
27347,0.6742857142857142,1,0,1,535083,70527,66452,41504,0.6532939345659343,0.37046888807562195
27348,0.6742857142857143,1,6,1,535089,70521,66453,41503,0.6532383563674089,0.3704831107619796
27349,0.6742857142857145,1,0,1,535089,70521,66454,41502,0.6532383563674089,0.37047749122947965
27350,0.6742878787878788,0,1,0,535090,70520,66454,41502,0.6532290933343214,0.37048079841459713
27351,0.6743095238095236,0,1,0,535091,70519,66454,41502,0.6532198303012339,0.3704841056587604
27352,0.6743095238095238,0,1,0,535092,70518,66454,41502,0.6532105672681463,0.3704874129619711
27353,0.6743095238095239,0,2,0,535094,70516,66454,41502,0.6531920412019712,0.3704940277455409
27354,0.6743174603174603,1,0,1,535094,70516,66455,41501,0.6531920412019712,0.37048840800949856
27355,0.6743333333333332,4,4,4,535098,70512,66459,41497,0.653154989069621,0.3704791579248096
27356,0.6743333333333333,6,19,6,535117,70493,66465,41491,0.6529789914409574,0.3705082868981283
27357,0.6743333333333336,0,3,0,535120,70490,66465,41491,0.6529512023416948,0.37051821291111886
27358,0.674357142857143,0,2,0,535122,70488,66465,41491,0.6529326762755197,0.370524830548585
27359,0.6743809523809523,0,1,0,535123,70487,66465,41491,0.6529234132424321,0.3705281394559646
27360,0.6744285714285715,0,1,0,535124,70486,66465,41491,0.6529141502093445,0.3705314484224439
27361,0.6744444444444444,0,2,0,535126,70484,66465,41491,0.6528956241431695,0.3705380665327082
27362,0.6744761904761905,0,1,0,535127,70483,66465,41491,0.6528863611100819,0.3705413756764963
27363,0.6744999999999999,1,3,1,535130,70480,66466,41490,0.6528585720108192,0.3705456818790748
27364,0.6745,2,10,2,535140,70470,66468,41488,0.6527659416799437,0.37056753425391664
27365,0.6745000000000002,2,1,2,535141,70469,66470,41486,0.6527566786468562,0.3705595998392211
27366,0.6745238095238095,0,2,0,535143,70467,66470,41486,0.652738152580681,0.370566219752932
27367,0.6745238095238096,0,1,0,535144,70466,66470,41486,0.6527288895475934,0.37056952979848506
27368,0.6745714285714286,0,1,0,535145,70465,66470,41486,0.6527196265145059,0.3705728399031719
27369,0.6745833333333334,0,1,0,535146,70464,66470,41486,0.6527103634814183,0.3705761500669942
27370,0.6746428571428572,0,1,0,535147,70463,66470,41486,0.6527011004483309,0.3705794602899535
27371,0.6746666666666665,0,3,0,535150,70460,66470,41486,0.6526733113490681,0.3705893913136691
27372,0.6746666666666666,7,22,7,535172,70438,66477,41479,0.6524695246211419,0.3706228723071562
27373,0.6746706349206351,0,1,0,535173,70437,66477,41479,0.6524602615880544,0.37062618392365704
27374,0.6746904761904762,0,1,0,535174,70436,66477,41479,0.6524509985549668,0.3706294955993388
27375,0.6747222222222223,0,1,0,535175,70435,66477,41479,0.6524417355218792,0.37063280733420306
27376,0.6747380952380952,1,0,1,535175,70435,66478,41478,0.6524417355218792,0.37062718361584446
27377,0.67475,0,1,0,535176,70434,66478,41478,0.6524324724887918,0.37063049538923437
27378,0.6747619047619048,2,1,2,535177,70433,66480,41476,0.6524232094557042,0.37062255940094185
27379,0.6748095238095237,1,2,1,535179,70431,66481,41475,0.6524046833895291,0.37062355905849553
27380,0.6748333333333332,1,2,1,535181,70429,66482,41474,0.6523861573233539,0.3706245587696487
27381,0.6748333333333334,4,13,4,535194,70416,66486,41470,0.6522657378932157,0.37064512092665747
27382,0.6748333333333335,0,1,0,535195,70415,66486,41470,0.6522564748601282,0.3706484336595612
27383,0.6748571428571429,0,2,0,535197,70413,66486,41470,0.6522379487939531,0.3706550593030219
27384,0.6748809523809524,1,2,1,535199,70411,66487,41469,0.652219422727778,0.37065606006435464
27385,0.6749523809523811,0,1,0,535200,70410,66487,41469,0.6522101596946904,0.3706593730726946
27386,0.6749999999999998,2,0,2,535200,70410,66489,41467,0.6522101596946904,0.37064812249166496
27387,0.675,197,573,197,535773,69837,66686,41270,0.6469024417355219,0.3714437434185065
27388,0.6750000000000002,1,0,1,535773,69837,66687,41269,0.6469024417355219,0.371438086151963
27389,0.6750476190476189,0,2,0,535775,69835,66687,41269,0.6468839156693468,0.3714447724654378
27390,0.675063492063492,1,0,1,535775,69835,66688,41268,0.6468839156693468,0.37143911505539906
27391,0.6750833333333333,0,1,0,535776,69834,66688,41268,0.6468746526362592,0.37144245828157907
27392,0.6751190476190476,0,2,0,535778,69832,66688,41268,0.6468561265700841,0.37144914491449144
27393,0.6751230158730159,0,1,0,535779,69831,66688,41268,0.6468468635369966,0.371452488321227
27394,0.675142857142857,0,1,0,535780,69830,66688,41268,0.646837600503909,0.371455831788151
27395,0.6751428571428572,0,1,0,535781,69829,66688,41268,0.6468283374708215,0.371459175315265
27396,0.6751666666666665,0,5,0,535786,69824,66688,41268,0.6467820223053837,0.37147589385374286
27397,0.6751666666666667,1,12,1,535798,69812,66689,41267,0.646670865908333,0.37151036649591734
27398,0.6751666666666668,0,1,0,535799,69811,66689,41267,0.6466616028752454,0.3715137110859036
27399,0.6751803751803752,1,0,1,535799,69811,66690,41266,0.6466616028752454,0.37150805297226247
27400,0.6752142857142859,1,0,1,535799,69811,66691,41265,0.6466616028752454,0.3715023947567431
27401,0.6752380952380952,0,3,0,535802,69808,66691,41265,0.6466338137759828,0.3715124287630657
27402,0.6752380952380953,1,0,1,535802,69808,66692,41264,0.6466338137759828,0.37150677038317487
27403,0.675281746031746,0,2,0,535804,69806,66692,41264,0.6466152877098077,0.3715134599801927
27404,0.6752857142857143,1,0,1,535804,69806,66693,41263,0.6466152877098077,0.3715078014567521
27405,0.6753095238095238,1,3,1,535807,69803,66694,41262,0.646587498610545,0.37151217755368476
27406,0.6753333333333333,2,11,2,535818,69792,66696,41260,0.6464856052465819,0.3715376580340741
27407,0.6753333333333335,1,2,1,535820,69790,66697,41259,0.6464670791804068,0.37153869012778146
27408,0.6753571428571428,0,1,0,535821,69789,66697,41259,0.6464578161473192,0.3715420358763778
27409,0.6754166666666666,0,2,0,535823,69787,66697,41259,0.6464392900811442,0.37154872755434687
27410,0.6754166666666667,3,1,3,535824,69786,66700,41256,0.6464300270480566,0.3715350948289836
27411,0.6754761904761903,0,2,0,535826,69784,66700,41256,0.6464115009818815,0.37154178674351584
27412,0.6754880952380953,0,1,0,535827,69783,66700,41256,0.6464022379487939,0.37154513279118145
27413,0.6754999999999999,0,1,0,535828,69782,66700,41256,0.6463929749157064,0.37154847889911563
27414,0.6755,2,10,2,535838,69772,66702,41254,0.6463003445848309,0.37157062309729255
27415,0.6755000000000001,0,7,0,535845,69765,66702,41254,0.646235503353218,0.37159405146866753
27416,0.6755476190476191,0,1,0,535846,69764,66702,41254,0.6462262403201304,0.3715973986200436
27417,0.6755555555555555,0,1,0,535847,69763,66702,41254,0.6462169772870429,0.3716007458317195
27418,0.6755555555555556,0,1,0,535848,69762,66702,41254,0.6462077142539553,0.37160409310369674
27419,0.6755833333333334,1,1,1,535849,69761,66703,41253,0.6461984512208677,0.3716017799556813
27420,0.6755952380952379,0,1,0,535850,69760,66703,41253,0.6461891881877803,0.3716051273274301
27421,0.6756111111111112,1,2,1,535852,69758,66704,41252,0.6461706621216051,0.37160616160706245
27422,0.6756666666666666,8,11,8,535863,69747,66712,41244,0.646068768757642,0.37159769711057655
27423,0.6756666666666667,2,1,2,535864,69746,66714,41242,0.6460595057245544,0.37158972141132374
27424,0.6756904761904763,0,1,0,535865,69745,66714,41242,0.6460502426914669,0.3715930694585852
27425,0.6757142857142857,2,5,2,535870,69740,66716,41240,0.6460039275260291,0.3715984862137322
27426,0.6757500000000001,0,1,0,535871,69739,66716,41240,0.6459946644929415,0.3716018345813172
27427,0.6757619047619048,0,1,0,535872,69738,66716,41240,0.6459854014598541,0.37160518300924505
27428,0.6757777777777778,1,0,1,535872,69738,66717,41239,0.6459854014598541,0.37159952062139
27429,0.6758095238095236,1,1,1,535873,69737,66718,41238,0.6459761384267665,0.3715972065780581
27430,0.6758322510822511,0,1,0,535874,69736,66718,41238,0.6459668753936789,0.37160055508497486
27431,0.6758333333333333,8,34,8,535908,69702,66726,41230,0.6456519322687021,0.3716691306385894
27432,0.6758333333333334,16,28,16,535936,69674,66742,41214,0.6453925673422506,0.3716723180145733
27433,0.6759285714285714,0,1,0,535937,69673,66742,41214,0.645383304309163,0.3716756698260391
27434,0.6759523809523809,0,1,0,535938,69672,66742,41214,0.6453740412760754,0.3716790216979601
27435,0.675952380952381,2,1,2,535939,69671,66744,41212,0.6453647782429879,0.3716710406464472
27436,0.6759761904761905,1,0,1,535939,69671,66745,41211,0.6453647782429879,0.37166537400119043
27437,0.6759999999999999,18,57,18,535996,69614,66763,41193,0.6448367853569973,0.37175449204472644
27438,0.676,1,1,1,535997,69613,66764,41192,0.6448275223239097,0.3717521772483191
27439,0.6760175518925519,0,1,0,535998,69612,66764,41192,0.6448182592908221,0.371755532291253
27440,0.676047619047619,0,1,0,535999,69611,66764,41192,0.6448089962577346,0.3717588873947456
27441,0.6760476190476191,1,2,1,536001,69609,66765,41191,0.6447904701915596,0.37175992779783396
27442,0.6760714285714287,0,2,0,536003,69607,66765,41191,0.6447719441253844,0.3717666383869745
27443,0.6760833333333331,0,1,0,536004,69606,66765,41191,0.6447626810922968,0.37176999377239456
27444,0.6761666666666666,0,2,0,536006,69604,66765,41191,0.6447441550261217,0.37177670472494245
27445,0.6761666666666667,2,6,2,536012,69598,66767,41189,0.6446885768275964,0.37178549829853685
27446,0.6761904761904762,1,0,1,536012,69598,66768,41188,0.6446885768275964,0.37177982777607277
27447,0.6762341269841269,0,1,0,536013,69597,66768,41188,0.6446793137945088,0.37178318364399515
27448,0.6762406204906203,0,2,0,536015,69595,66768,41188,0.6446607877283338,0.37178989556159336
27449,0.67625,3,1,3,536016,69594,66771,41185,0.6446515246952462,0.37177623917890573
27450,0.6762619047619048,0,2,0,536018,69592,66771,41185,0.6446329986290711,0.3717829513346633
27451,0.6762857142857144,0,2,0,536020,69590,66771,41185,0.644614472562896,0.3717896637327917
27452,0.6763015873015874,0,2,0,536022,69588,66771,41185,0.6445959464967209,0.371796376373304
27453,0.6763095238095238,1,0,1,536022,69588,66772,41184,0.6445959464967209,0.3717907052323692
27454,0.6763333333333331,0,1,0,536023,69587,66772,41184,0.6445866834636333,0.37179406162262685
27455,0.6763333333333332,5,14,5,536037,69573,66777,41179,0.6444570010004076,0.371812698642011
27456,0.6763333333333335,0,4,0,536041,69569,66777,41179,0.6444199488680573,0.37182612778560337
27457,0.6763492063492064,0,3,0,536044,69566,66777,41179,0.6443921597687947,0.37183620027992237
27458,0.6763888888888888,1,0,1,536044,69566,66778,41178,0.6443921597687947,0.37183052806472583
27459,0.676404761904762,0,1,0,536045,69565,66778,41178,0.6443828967357071,0.3718338856632022
27460,0.6764285714285714,1,1,1,536046,69564,66779,41177,0.6443736337026196,0.37183157096287733
27461,0.676452380952381,0,2,0,536048,69562,66779,41177,0.6443551076364444,0.3718382864212247
27462,0.6764761904761905,0,1,0,536049,69561,66779,41177,0.644345844603357,0.3718416442413625
27463,0.6764999999999999,2,4,2,536053,69557,66781,41175,0.6443087924710067,0.3718437308095221
27464,0.6765000000000001,3,11,3,536064,69546,66784,41172,0.6442068991070437,0.3718636536064597
27465,0.6765000000000002,0,1,0,536065,69545,66784,41172,0.6441976360739561,0.3718670122926019
27466,0.6765714285714286,1,0,1,536065,69545,66785,41171,0.6441976360739561,0.3718613389212038
27467,0.6766269841269841,0,1,0,536066,69544,66785,41171,0.6441883730408685,0.37186469764711194
27468,0.6766666666666665,64,166,64,536232,69378,66849,41107,0.6426507095483345,0.37205955559578224
27469,0.6766666666666667,40,98,40,536330,69280,66889,41067,0.6417429323057542,0.3721623605535266
27470,0.6766746031746032,0,1,0,536331,69279,66889,41067,0.6417336692726666,0.37216573323908436
27471,0.6766785714285715,0,1,0,536332,69278,66889,41067,0.641724406239579,0.3721691059857719
27472,0.6767056277056276,0,3,0,536335,69275,66889,41067,0.6416966171403164,0.3721792245926302
27473,0.6767380952380952,0,1,0,536336,69274,66889,41067,0.6416873541072289,0.3721825975838537
27474,0.6767619047619047,0,1,0,536337,69273,66889,41067,0.6416780910741413,0.37218597063621534
27475,0.6767857142857143,1,1,1,536338,69272,66890,41066,0.6416688280410537,0.3721836538635828
27476,0.6768333333333334,4,20,4,536358,69252,66894,41062,0.6414835673793027,0.372228366299835
27477,0.6769047619047619,1,0,1,536358,69252,66895,41061,0.6414835673793027,0.3722226754779582
27478,0.6769761904761904,0,2,0,536360,69250,66895,41061,0.6414650413131275,0.3722294240828204
27479,0.6769826007326007,0,1,0,536361,69249,66895,41061,0.64145577828004,0.3722327984770193
27480,0.6769999999999999,3,3,3,536364,69246,66898,41058,0.6414279891807774,0.3722258485639687
27481,0.677,7,15,7,536379,69231,66905,41051,0.641289043684464,0.3722366297310531
27482,0.6771341991341988,0,1,0,536380,69230,66905,41051,0.6412797806513765,0.37224000507793725
27483,0.6771428571428573,3,10,3,536390,69220,66908,41048,0.641187150320501,0.3722566837160373
27484,0.6771666666666667,6,11,6,536401,69209,66914,41042,0.6410852569565378,0.37225966204388167
27485,0.6771944444444444,0,3,0,536404,69206,66914,41042,0.6410574678572751,0.37226979174225383
27486,0.6772499999999999,0,1,0,536405,69205,66914,41042,0.6410482048241877,0.37227316843088704
27487,0.6772738095238096,0,1,0,536406,69204,66914,41042,0.6410389417911001,0.3722765451807775
27488,0.6772857142857143,0,1,0,536407,69203,66914,41042,0.6410296787580125,0.37227992199192705
27489,0.6773095238095237,1,2,1,536409,69201,66915,41041,0.6410111526918374,0.3722809818399521
27490,0.6773333333333332,2,6,2,536415,69195,66917,41039,0.6409555744933121,0.3722898561242448
27491,0.6773333333333333,7,12,7,536427,69183,66924,41032,0.6408444180962615,0.3722905230685478
27492,0.6773333333333335,1,1,1,536428,69182,66925,41031,0.6408351550631739,0.3722882055655866
27493,0.677357142857143,0,1,0,536429,69181,66925,41031,0.6408258920300863,0.37229158349363045
27494,0.6773809523809524,0,4,0,536433,69177,66925,41031,0.6407888398977362,0.3723050958188153
27495,0.6773888888888889,1,1,1,536434,69176,66926,41030,0.6407795768646486,0.37230277843311615
27496,0.6774523809523809,0,1,0,536435,69175,66926,41030,0.640770313831561,0.37230615670795336
27497,0.6774999999999999,0,1,0,536436,69174,66926,41030,0.6407610507984735,0.3723095350441
27498,0.6775,55,156,55,536592,69018,66981,40975,0.639316017636815,0.37252370605402163
27499,0.6775000000000001,0,4,0,536596,69014,66981,40975,0.6392789655044648,0.37253725372537255
27500,0.6775714285714287,0,1,0,536597,69013,66981,40975,0.6392697024713773,0.37254064079717786
27501,0.6775952380952381,1,0,1,536597,69013,66982,40974,0.6392697024713773,0.37253493594697557
27502,0.6776190476190476,0,4,0,536601,69009,66982,40974,0.639232650339027,0.37254848476582747
27503,0.6776190476190478,1,0,1,536601,69009,66983,40973,0.639232650339027,0.3725427797275918
27504,0.6776666666666665,0,1,0,536602,69008,66983,40973,0.6392233873059394,0.37254616706522037
27505,0.6776666666666666,5,18,5,536620,68990,66988,40968,0.6390566527103635,0.3725786209279907
27506,0.6776666666666668,2,0,2,536620,68990,66990,40966,0.6390566527103635,0.3725672087016625
27507,0.6777222222222222,1,1,1,536621,68989,66991,40965,0.6390473896772759,0.3725648907725049
27508,0.6777380952380951,0,1,0,536622,68988,66991,40965,0.6390381266441884,0.37256827917382884
27509,0.6777777777777777,1,0,1,536622,68988,66992,40964,0.6390381266441884,0.3725625727590221
27510,0.6777857142857142,0,1,0,536623,68987,66992,40964,0.6390288636111008,0.3725659612008986
27511,0.6778095238095239,0,1,0,536624,68986,66992,40964,0.6390196005780132,0.3725693497044111
27512,0.6778192640692642,0,1,0,536625,68985,66992,40964,0.6390103375449258,0.37257273826956133
27513,0.6778333333333333,0,13,0,536638,68972,66992,40964,0.6388899181147875,0.37261679522631347
27514,0.6778333333333335,0,1,0,536639,68971,66992,40964,0.6388806550817,0.3726201846545686
27515,0.6778476800976801,1,0,1,536639,68971,66993,40963,0.6388806550817,0.3726144777775756
27516,0.6778571428571428,1,1,1,536640,68970,66994,40962,0.6388713920486124,0.37261216024451477
27517,0.6779166666666666,0,1,0,536641,68969,66994,40962,0.6388621290155249,0.37261554975393657
27518,0.6779166666666667,0,4,0,536645,68965,66994,40962,0.6388250768831746,0.3726291084083073
27519,0.6779523809523809,0,2,0,536647,68963,66994,40962,0.6388065508169996,0.3726358881055265
27520,0.677968253968254,0,1,0,536648,68962,66994,40962,0.638797287783912,0.3726392780466504
27521,0.6779761904761906,0,1,0,536649,68961,66994,40962,0.6387880247508244,0.3726426680494528
27522,0.6779999999999998,2,0,2,536649,68961,66996,40960,0.6387880247508244,0.372631253354682
27523,0.6779999999999999,15,37,15,536686,68924,67011,40945,0.6384452925265849,0.37267109011641136
27524,0.6780000000000002,2,5,2,536691,68919,67013,40943,0.6383989773611471,0.3726766306821285
27525,0.6780555555555555,0,1,0,536692,68918,67013,40943,0.6383897143280596,0.3726800229380763
27526,0.6780833333333333,1,0,1,536692,68918,67014,40942,0.6383897143280596,0.3726743127616967
27527,0.6780952380952381,1,0,1,536692,68918,67015,40941,0.6383897143280596,0.37266860248136247
27528,0.6781190476190475,1,0,1,536692,68918,67016,40940,0.6383897143280596,0.37266289209707076
27529,0.6781666666666665,1,1,1,536693,68917,67017,40939,0.638380451294972,0.3726605738421206
27530,0.6781666666666666,2,9,2,536702,68908,67019,40937,0.638297083997184,0.37267968501069687
27531,0.6781666666666668,0,2,0,536704,68906,67019,40937,0.638278557931009,0.3726864706899848
27532,0.6782142857142859,0,1,0,536705,68905,67019,40937,0.6382692948979214,0.37268986362229384
27533,0.6782857142857144,0,1,0,536706,68904,67019,40937,0.6382600318648338,0.37269325661638186
27534,0.6783333333333331,0,1,0,536707,68903,67019,40937,0.6382507688317463,0.3726966496722505
27535,0.6783333333333332,20,80,20,536787,68823,67039,40917,0.6375097261847419,0.3728540185893931
27536,0.6783333333333335,32,66,32,536853,68757,67071,40885,0.6368983660009634,0.3728954232866967
27537,0.6783809523809523,0,1,0,536854,68756,67071,40885,0.6368891029678758,0.37289882434490745
27538,0.6784444444444443,1,0,1,536854,68756,67072,40884,0.6368891029678758,0.37289310470631154
27539,0.6784523809523809,0,1,0,536855,68755,67072,40884,0.6368798399347882,0.37289650580541595
27540,0.6785,2,13,2,536868,68742,67074,40882,0.6367594205046501,0.37292928555790705
27541,0.6785000000000001,1,3,1,536871,68739,67075,40881,0.6367316314053874,0.3729337712096333
27542,0.6785082972582973,0,1,0,536872,68738,67075,40881,0.6367223683722998,0.37293717330024906
27543,0.6785238095238094,0,2,0,536874,68736,67075,40881,0.6367038423061248,0.37294397766769755
27544,0.678547619047619,0,1,0,536875,68735,67075,40881,0.6366945792730372,0.37294737994453364
27545,0.6785634920634921,0,1,0,536876,68734,67075,40881,0.6366853162399496,0.37295078228344664
27546,0.6785714285714285,1,0,1,536876,68734,67076,40880,0.6366853162399496,0.37294506176218367
27547,0.6785714285714286,1,5,1,536881,68729,67077,40879,0.6366390010745119,0.37295635355083573
27548,0.6785833333333332,0,1,0,536882,68728,67077,40879,0.6366297380414243,0.3729597562199495
27549,0.6785912698412696,1,0,1,536882,68728,67078,40878,0.6366297380414243,0.37295403536302757
27550,0.6786190476190476,0,2,0,536884,68726,67078,40878,0.6366112119752492,0.37296084084522463
27551,0.6786190476190477,0,2,0,536886,68724,67078,40878,0.636592685909074,0.3729676465757924
27552,0.6786666666666666,3,3,3,536889,68721,67081,40875,0.6365648968098114,0.37296069199605825
27553,0.6786666666666668,2,13,2,536902,68708,67083,40873,0.6364444773796732,0.37299349339757804
27554,0.6786785714285715,0,4,0,536906,68704,67083,40873,0.636407425247323,0.3730071091561185
27555,0.6786904761904762,0,1,0,536907,68703,67083,40873,0.6363981622142354,0.37301051325107687
27556,0.678706349206349,0,1,0,536908,68702,67083,40873,0.6363888991811478,0.3730139174081679
27557,0.67875,0,5,0,536913,68697,67083,40873,0.6363425840157101,0.3730309391256731
27558,0.6787857142857143,0,1,0,536914,68696,67083,40873,0.6363333209826225,0.373034343655596
27559,0.6788333333333333,3,3,3,536917,68693,67086,40870,0.6363055318833599,0.37302739063369933
27560,0.6788452380952381,0,1,0,536918,68692,67086,40870,0.6362962688502724,0.37303079534875233
27561,0.6788690476190475,0,3,0,536921,68689,67086,40870,0.6362684797510096,0.37304100986682975
27562,0.6789047619047619,0,1,0,536922,68688,67086,40870,0.6362592167179221,0.3730444148305007
27563,0.6789166666666665,0,1,0,536923,68687,67086,40870,0.6362499536848346,0.3730478198563305
27564,0.6789166666666666,0,1,0,536924,68686,67086,40870,0.636240690651747,0.3730512249443207
27565,0.6789285714285714,0,1,0,536925,68685,67086,40870,0.6362314276186595,0.3730546300944731
27566,0.6789433621933622,0,3,0,536928,68682,67086,40870,0.6362036385193968,0.3730648459179203
27567,0.6789563492063493,1,0,1,536928,68682,67087,40869,0.6362036385193968,0.3730591231481228
27568,0.6789761904761904,0,1,0,536929,68681,67087,40869,0.6361943754863092,0.3730625285257873
27569,0.6789999999999999,1,2,1,536931,68679,67088,40868,0.6361758494201342,0.3730636165298913
27570,0.679,6,18,6,536949,68661,67094,40862,0.6360091148245581,0.37309058371301007
27571,0.6790238095238095,1,0,1,536949,68661,67095,40861,0.6360091148245581,0.3730848596628988
27572,0.6790303030303031,0,1,0,536950,68660,67095,40861,0.6359998517914706,0.3730882661772628
27573,0.679047619047619,0,2,0,536952,68658,67095,40861,0.6359813257252955,0.3730950793926168
27574,0.6791641414141414,0,1,0,536953,68657,67095,40861,0.635972062692208,0.3730984860936102
27575,0.6791666666666666,7,50,7,537003,68607,67102,40854,0.6355089110378302,0.3732288212239976
27576,0.6791666666666667,9,18,9,537021,68589,67111,40845,0.6353421764422542,0.37323866440046055
27577,0.6791666666666668,1,0,1,537021,68589,67112,40844,0.6353421764422542,0.37323293704823957
27578,0.6792142857142858,0,1,0,537022,68588,67112,40844,0.6353329134091666,0.37323634768623437
27579,0.6792777777777778,0,1,0,537023,68587,67112,40844,0.6353236503760792,0.3732397583865632
27580,0.6792857142857143,1,5,1,537028,68582,67113,40843,0.6352773352106413,0.37325108521818595
27581,0.6792857142857145,0,1,0,537029,68581,67113,40843,0.6352680721775538,0.3732544962713847
27582,0.6793333333333332,0,2,0,537031,68579,67113,40843,0.6352495461113787,0.3732613185648224
27583,0.6793333333333333,9,18,9,537049,68561,67122,40834,0.6350828115158027,0.37327117327117326
27584,0.6793549783549783,0,1,0,537050,68560,67122,40834,0.6350735484827151,0.37327458544344294
27585,0.6793809523809523,0,1,0,537051,68559,67122,40834,0.6350642854496277,0.3732779976780964
27586,0.6793809523809524,0,1,0,537052,68558,67122,40834,0.6350550224165401,0.3732814099751353
27587,0.6793939393939393,0,3,0,537055,68555,67122,40834,0.6350272333172774,0.3732916472405818
27588,0.6793968253968253,0,1,0,537056,68554,67122,40834,0.6350179702841898,0.3732950597871796
27589,0.6794166666666667,1,1,1,537057,68553,67123,40833,0.6350087072511023,0.3732927431298338
27590,0.6794523809523809,0,1,0,537058,68552,67123,40833,0.6349994442180148,0.373296155780043
27591,0.6794523809523811,0,1,0,537059,68551,67123,40833,0.6349901811849272,0.3732995684926497
27592,0.6794761904761906,0,1,0,537060,68550,67123,40833,0.6349809181518397,0.3733029812676559
27593,0.6794801587301587,0,3,0,537063,68547,67123,40833,0.634953129052577,0.3733132199670872
27594,0.6794999999999999,0,1,0,537064,68546,67123,40833,0.6349438660194894,0.37331663299170775
27595,0.6795,1,7,1,537071,68539,67124,40832,0.6348790247878765,0.3733347962439769
27596,0.6795000000000002,0,1,0,537072,68538,67124,40832,0.634869761754789,0.37333820974673126
27597,0.6795238095238095,0,2,0,537074,68536,67124,40832,0.6348512356886139,0.373345036939507
27598,0.6795714285714286,0,1,0,537075,68535,67124,40832,0.6348419726555263,0.37334845062953176
27599,0.6796309523809524,0,1,0,537076,68534,67124,40832,0.6348327096224388,0.3733518643819834
27600,0.6796428571428571,0,1,0,537077,68533,67124,40832,0.6348234465893512,0.3733552781968637
27601,0.6796428571428572,0,2,0,537079,68531,67124,40832,0.6348049205231762,0.37336210601391695
27602,0.6796666666666665,0,2,0,537081,68529,67124,40832,0.634786394457001,0.3733689340807052
27603,0.6796666666666666,4,18,4,537099,68511,67128,40828,0.634619659861425,0.3734074758320453
27604,0.6796666666666669,1,0,1,537099,68511,67129,40827,0.634619659861425,0.3734017450474675
27605,0.6796987734487735,1,1,1,537100,68510,67130,40826,0.6346103968283374,0.37339942928221265
27606,0.679702380952381,0,1,0,537101,68509,67130,40826,0.63460113379525,0.3734028444688343
27607,0.6797142857142856,3,1,3,537102,68508,67133,40823,0.6345918707621624,0.373389066230072
27608,0.6797142857142857,0,1,0,537103,68507,67133,40823,0.6345826077290748,0.37339248147809384
27609,0.6797142857142859,0,1,0,537104,68506,67133,40823,0.6345733446959873,0.37339589678859225
27610,0.6797222222222223,0,1,0,537105,68505,67133,40823,0.6345640816628997,0.37339931216156885
27611,0.6798095238095238,1,0,1,537105,68505,67134,40822,0.6345640816628997,0.37339358072571277
27612,0.6798253968253968,0,3,0,537108,68502,67134,40822,0.6345362925636371,0.37340382715597675
27613,0.6798333333333332,2,3,2,537111,68499,67136,40820,0.6345085034643744,0.37340261070811115
27614,0.6798333333333333,2,4,2,537115,68495,67138,40818,0.6344714513320242,0.37340481004089177
27615,0.6798333333333335,1,1,1,537116,68494,67139,40817,0.6344621882989366,0.3734024938020876
27616,0.6798809523809524,0,2,0,537118,68492,67139,40817,0.6344436622327615,0.3734093258560594
27617,0.6798888888888888,1,1,1,537119,68491,67140,40816,0.6344343991996739,0.3734070096151207
27618,0.6799206349206349,1,0,1,537119,68491,67141,40815,0.6344343991996739,0.3734012771485554
27619,0.6799285714285714,0,1,0,537120,68490,67141,40815,0.6344251361665864,0.3734046932894195
27620,0.6799523809523808,0,2,0,537122,68488,67141,40815,0.6344066101004113,0.37341152575867087
27621,0.679952380952381,0,2,0,537124,68486,67141,40815,0.6343880840342362,0.3734183584779645
27622,0.6799999999999998,0,6,0,537130,68480,67141,40815,0.6343325058357109,0.3734388581362368
27623,0.68,607,1546,607,538676,66934,67748,40208,0.620011856682352,0.3752776688880178
27624,0.6800000000000002,0,3,0,538679,66931,67748,40208,0.6199840675830894,0.37528817704104017
27625,0.6800357142857143,1,0,1,538679,66931,67749,40207,0.6199840675830894,0.3752823461330247
27626,0.6800555555555556,0,1,0,538680,66930,67749,40207,0.6199748045500019,0.37528584895974315
27627,0.6800833333333333,1,0,1,538680,66930,67750,40206,0.6199748045500019,0.37528001792114696
27628,0.6800833333333334,1,4,1,538684,66926,67751,40205,0.6199377524176516,0.3752881985606407
27629,0.6801190476190476,0,2,0,538686,66924,67751,40205,0.6199192263514766,0.3752952048464935
27630,0.6801388888888888,0,1,0,538687,66923,67751,40205,0.619909963318389,0.37529870808752147
27631,0.6801538461538462,0,1,0,538688,66922,67751,40205,0.6199007002853014,0.375302211393953
27632,0.6801666666666667,6,8,6,538696,66914,67757,40199,0.619826596020601,0.3752952489427054
27633,0.6801666666666668,1,1,1,538697,66913,67758,40198,0.6198173329875134,0.37529292042834067
27634,0.6802380952380952,0,1,0,538698,66912,67758,40198,0.6198080699544258,0.37529642423676596
27635,0.6802857142857143,2,0,2,538698,66912,67760,40196,0.6198080699544258,0.37528475930836164
27636,0.6802857142857144,0,1,0,538699,66911,67760,40196,0.6197988069213384,0.3752882631387304
27637,0.6803333333333333,5,6,5,538705,66905,67765,40191,0.619743228722813,0.3752801225069097
27638,0.6803333333333335,3,3,3,538708,66902,67768,40188,0.6197154396235504,0.37527313474647495
27639,0.6803571428571428,0,3,0,538711,66899,67768,40188,0.6196876505242876,0.3752836478750922
27640,0.6803809523809524,0,2,0,538713,66897,67768,40188,0.6196691244581126,0.37529065695475555
27641,0.6804047619047618,1,0,1,538713,66897,67769,40187,0.6196691244581126,0.3752848231295058
27642,0.680404761904762,0,1,0,538714,66896,67769,40187,0.619659861425025,0.3752883277457673
27643,0.6804246031746031,0,4,0,538718,66892,67769,40187,0.6196228092926748,0.37530234686539843
27644,0.6804563492063492,0,2,0,538720,66890,67769,40187,0.6196042832264996,0.37530935681799077
27645,0.6804761904761905,1,2,1,538722,66888,67770,40186,0.6195857571603246,0.3753105329024787
27646,0.6805,3,7,3,538729,66881,67773,40183,0.6195209159287117,0.3753175670626915
27647,0.6805000000000001,0,4,0,538733,66877,67773,40183,0.6194838637963614,0.3753315897627499
27648,0.6805183982683981,0,13,0,538746,66864,67773,40183,0.6193634443662233,0.3753771707754538
27649,0.6805238095238095,0,1,0,538747,66863,67773,40183,0.6193541813331357,0.37538067746576237
27650,0.6805476190476188,1,3,1,538750,66860,67774,40182,0.6193263922338731,0.37538536275480655
27651,0.6805555555555556,3,2,3,538752,66858,67777,40179,0.619307866167698,0.37537487037192746
27652,0.6805714285714285,0,1,0,538753,66857,67777,40179,0.6192986031346104,0.37537837736836205
27653,0.6805714285714286,0,1,0,538754,66856,67777,40179,0.6192893401015228,0.37538188443032655
27654,0.6805952380952379,0,1,0,538755,66855,67777,40179,0.6192800770684352,0.37538539155782275
27655,0.680626984126984,1,6,1,538761,66849,67778,40178,0.6192244988699099,0.37540059984863633
27656,0.6806666666666666,5,15,5,538776,66834,67783,40173,0.6190855533735966,0.37542403767977794
27657,0.6806666666666668,0,3,0,538779,66831,67783,40173,0.619057764274334,0.3754345631938993
27658,0.6806904761904762,0,1,0,538780,66830,67783,40173,0.6190485012412464,0.3754380718297618
27659,0.6807142857142857,3,5,3,538785,66825,67786,40170,0.6190021860758087,0.37543810458432636
27660,0.6807857142857143,0,1,0,538786,66824,67786,40170,0.6189929230427211,0.37544161354842326
27661,0.6808095238095236,0,3,0,538789,66821,67786,40170,0.6189651339434584,0.3754521408342758
27662,0.6808333333333332,0,1,0,538790,66820,67786,40170,0.6189558709103709,0.3754556500607533
27663,0.6808333333333333,5,27,5,538817,66793,67791,40165,0.6187057690170069,0.3755212326333701
27664,0.6808333333333334,8,29,8,538846,66764,67799,40157,0.6184371410574678,0.3755763601163476
27665,0.6808484848484849,0,1,0,538847,66763,67799,40157,0.6184278780243803,0.37557987280209504
27666,0.6809523809523809,0,3,0,538850,66760,67799,40157,0.6184000889251177,0.3755904112535892
27667,0.680952380952381,0,3,0,538853,66757,67799,40157,0.618372299825855,0.3756009502965
27668,0.6809999999999999,12,34,12,538887,66723,67811,40145,0.6180573567008781,0.3756503349927013
27669,0.681,0,1,0,538888,66722,67811,40145,0.6180480936677906,0.375653850112757
27670,0.6810238095238096,0,1,0,538889,66721,67811,40145,0.618038830634703,0.3756573652985982
27671,0.6810357142857143,1,0,1,538889,66721,67812,40144,0.618038830634703,0.37565152294951576
27672,0.6810555555555555,0,1,0,538890,66720,67812,40144,0.6180295676016154,0.3756550381793682
27673,0.6811111111111111,0,1,0,538891,66719,67812,40144,0.618020304568528,0.37565855347501004
27674,0.6811666666666666,3,5,3,538896,66714,67815,40141,0.6179739894030901,0.3756586027794675
27675,0.6811666666666667,0,5,0,538901,66709,67815,40141,0.6179276742376524,0.3756761815629387
27676,0.6811904761904762,1,2,1,538903,66707,67816,40140,0.6179091481714772,0.3756773704455904
27677,0.6812034632034633,1,1,1,538904,66706,67817,40139,0.6178998851383897,0.3756750432870045
27678,0.6812222222222222,0,1,0,538905,66705,67817,40139,0.6178906221053022,0.37567855939500583
27679,0.68125,2,5,2,538910,66700,67819,40137,0.6178443069398644,0.37568445388769806
27680,0.6812619047619047,0,2,0,538912,66698,67819,40137,0.6178257808736893,0.37569148687227966
27681,0.6813095238095238,1,0,1,538912,66698,67820,40136,0.6178257808736893,0.3756856431473127
27682,0.6813333333333332,5,15,5,538927,66683,67825,40131,0.617686835377376,0.37570917669968357
27683,0.6813333333333333,0,6,0,538933,66677,67825,40131,0.6176312571788506,0.375730282375852
27684,0.6813690476190476,1,0,1,538933,66677,67826,40130,0.6176312571788506,0.3757244375368656
27685,0.6813809523809524,1,1,1,538934,66676,67827,40129,0.6176219941457631,0.37572211038809045
27686,0.6814285714285714,0,3,0,538937,66673,67827,40129,0.6175942050465004,0.3757326641823187
27687,0.6814404761904762,1,0,1,538937,66673,67828,40128,0.6175942050465004,0.37572681903727495
27688,0.681452380952381,0,1,0,538938,66672,67828,40128,0.6175849420134129,0.37573033707865167
27689,0.6814761904761905,0,1,0,538939,66671,67828,40128,0.6175756789803253,0.37573385518590996
27690,0.6814999999999999,1,1,1,538940,66670,67829,40127,0.6175664159472377,0.37573152803917714
27691,0.6815000000000001,5,11,5,538951,66659,67834,40122,0.6174645225832747,0.3757410026128244
27692,0.681547619047619,0,1,0,538952,66658,67834,40122,0.6174552595501871,0.37574452144596365
27693,0.6815555555555555,0,1,0,538953,66657,67834,40122,0.6174459965170995,0.37574804034501164
27694,0.6815833333333333,0,1,0,538954,66656,67834,40122,0.617436733484012,0.37575155930997023
27695,0.6816190476190477,1,1,1,538955,66655,67835,40121,0.6174274704509245,0.37574923203716193
27696,0.6816666666666665,33,98,33,539053,66557,67868,40088,0.6165196932083441,0.3759013549627268
27697,0.6816666666666668,21,67,21,539120,66490,67889,40067,0.615899069991478,0.376014715128992
27698,0.6816984126984127,0,3,0,539123,66487,67889,40067,0.6158712808922153,0.37602530172494697
27699,0.6817142857142858,1,0,1,539123,66487,67890,40066,0.6158712808922153,0.37601944572184737
27700,0.6817341269841269,0,1,0,539124,66486,67890,40066,0.6158620178591278,0.37602297469780016
27701,0.6817619047619048,0,1,0,539125,66485,67890,40066,0.6158527548260403,0.3760265037399931
27702,0.6817857142857143,0,2,0,539127,66483,67890,40066,0.6158342287598652,0.3760335620231067
27703,0.6818095238095238,0,1,0,539128,66482,67890,40066,0.6158249657267776,0.37603709126403123
27704,0.6818253968253969,1,3,1,539131,66479,67891,40065,0.6157971766275149,0.37604182309656103
27705,0.6818333333333334,4,11,4,539142,66468,67895,40061,0.6156952832635518,0.37605722385453727
27706,0.6818650793650792,0,2,0,539144,66466,67895,40061,0.6156767571973767,0.3760642841720878
27707,0.6819047619047619,0,2,0,539146,66464,67895,40061,0.6156582311312015,0.3760713447547524
27708,0.681904761904762,1,0,1,539146,66464,67896,40060,0.6156582311312015,0.37606548758965114
27709,0.6819166666666666,0,2,0,539148,66462,67896,40060,0.6156397050650265,0.37607254839375903
27710,0.6819999999999999,3,7,3,539155,66455,67899,40057,0.6155748638334136,0.37607969055129936
27711,0.682,18,22,18,539177,66433,67917,40039,0.6153710771054874,0.37605191975355023
27712,0.6820238095238096,2,0,2,539177,66433,67919,40037,0.6153710771054874,0.3760401991171222
27713,0.6820714285714286,0,1,0,539178,66432,67919,40037,0.6153618140723999,0.3760437310390818
27714,0.6820833333333334,0,1,0,539179,66431,67919,40037,0.6153525510393123,0.3760472630273885
27715,0.682095238095238,0,1,0,539180,66430,67919,40037,0.6153432880062247,0.3760507950820442
27716,0.6821071428571429,0,1,0,539181,66429,67919,40037,0.6153340249731372,0.37605432720305076
27717,0.682142857142857,0,1,0,539182,66428,67919,40037,0.6153247619400497,0.37605785939041
27718,0.6821428571428573,0,4,0,539186,66424,67919,40037,0.6152877098076994,0.3760719888034116
27719,0.6821587301587302,0,4,0,539190,66420,67919,40037,0.6152506576753493,0.37608611927820623
27720,0.6821666666666666,0,1,0,539191,66419,67919,40037,0.6152413946422617,0.3760896520628241
27721,0.6821666666666667,3,17,3,539208,66402,67922,40034,0.6150839230797732,0.3761321357435454
27722,0.6821666666666668,0,2,0,539210,66400,67922,40034,0.6150653970135981,0.37613920363793524
27723,0.6821904761904761,0,2,0,539212,66398,67922,40034,0.615046870947423,0.3761462717979555
27724,0.6822142857142857,0,1,0,539213,66397,67922,40034,0.6150376079143355,0.37614980597758174
27725,0.6822222222222223,0,2,0,539215,66395,67922,40034,0.6150190818481603,0.3761568745360757
27726,0.6822380952380953,0,1,0,539216,66394,67922,40034,0.6150098188150728,0.3761604089149472
27727,0.6822619047619046,1,0,1,539216,66394,67923,40033,0.6150098188150728,0.3761545472483486
27728,0.682261904761905,0,1,0,539217,66393,67923,40033,0.6150005557819852,0.37615808167177195
27729,0.6822777777777778,0,1,0,539218,66392,67923,40033,0.6149912927488977,0.37616161616161614
27730,0.6822857142857143,0,3,0,539221,66389,67923,40033,0.614963503649635,0.3761722200296931
27731,0.6823333333333332,0,9,0,539230,66380,67923,40033,0.614880136351847,0.37620403522126056
27732,0.6823333333333333,3,7,3,539237,66373,67926,40030,0.6148152951202341,0.37621119705271466
27733,0.6823571428571428,0,1,0,539238,66372,67926,40030,0.6148060320871466,0.37621473280577433
27734,0.6823809523809524,0,4,0,539242,66368,67926,40030,0.6147689799547964,0.37622887648264064
27735,0.682392857142857,0,2,0,539244,66366,67926,40030,0.6147504538886213,0.3762359487198767
27736,0.682452380952381,0,2,0,539246,66364,67926,40030,0.6147319278224462,0.3762430212230013
27737,0.6824999999999997,1,0,1,539246,66364,67927,40029,0.6147319278224462,0.3762371584596731
27738,0.6824999999999999,0,1,0,539247,66363,67927,40029,0.6147226647893587,0.3762406947890819
27739,0.6825,56,145,56,539392,66218,67983,39973,0.6133795249916633,0.37642549745270315
27740,0.6825000000000001,0,3,0,539395,66215,67983,39973,0.6133517358924007,0.37643613214299165
27741,0.6825238095238096,0,1,0,539396,66214,67983,39973,0.6133424728593131,0.37643967717328863
27742,0.6825833333333332,0,1,0,539397,66213,67983,39973,0.6133332098262255,0.3764432222703558
27743,0.6826666666666665,0,5,0,539402,66208,67983,39973,0.6132868946607877,0.3764609487573106
27744,0.6826666666666666,11,15,11,539417,66193,67994,39962,0.6131479491644745,0.37644953134567377
27745,0.6826666666666668,0,9,0,539426,66184,67994,39962,0.6130645818666864,0.37648145007819417
27746,0.6826904761904761,1,0,1,539426,66184,67995,39961,0.6130645818666864,0.376475575863206
27747,0.6827380952380951,1,0,1,539426,66184,67996,39960,0.6130645818666864,0.3764697015375339
27748,0.6828095238095239,0,2,0,539428,66182,67996,39960,0.6130460558005113,0.3764767952365699
27749,0.6828333333333332,0,1,0,539429,66181,67996,39960,0.6130367927674237,0.376480342186337
27750,0.6828333333333333,4,6,4,539435,66175,68000,39956,0.6129812145688984,0.37647812608945547
27751,0.6828333333333334,0,2,0,539437,66173,68000,39956,0.6129626885027233,0.3764852208161765
27752,0.6828571428571428,1,3,1,539440,66170,68001,39955,0.6129348994034607,0.376489988221437
27753,0.6828571428571429,1,1,1,539441,66169,68002,39954,0.6129256363703731,0.37648766054483945
27754,0.682904761904762,0,1,0,539442,66168,68002,39954,0.6129163733372855,0.3764912082320348
27755,0.6829166666666667,0,1,0,539443,66167,68002,39954,0.612907110304198,0.37649475598609133
27756,0.6829444444444445,0,1,0,539444,66166,68002,39954,0.6128978472711104,0.37649830380701094
27757,0.6829642857142858,0,1,0,539445,66165,68002,39954,0.612888584238023,0.37650185169479544
27758,0.6829761904761904,0,1,0,539446,66164,68002,39954,0.6128793212049354,0.37650539964944685
27759,0.6829761904761905,0,1,0,539447,66163,68002,39954,0.6128700581718478,0.37650894767096693
27760,0.6829999999999999,9,22,9,539469,66141,68011,39945,0.6126662714439216,0.3765341326848029
27761,0.6830476190476189,2,0,2,539469,66141,68013,39943,0.6126662714439216,0.37652237849251535
27762,0.6830606060606061,0,2,0,539471,66139,68013,39943,0.6126477453777465,0.37652947719688545
27763,0.6830833333333334,0,1,0,539472,66138,68013,39943,0.6126384823446589,0.3765330266494471
27764,0.683095238095238,0,1,0,539473,66137,68013,39943,0.6126292193115713,0.3765365761689291
27765,0.6830952380952381,0,1,0,539474,66136,68013,39943,0.6126199562784839,0.3765401257553333
27766,0.6830952380952382,0,1,0,539475,66135,68013,39943,0.6126106932453963,0.37654367540866157
27767,0.6831428571428572,0,1,0,539476,66134,68013,39943,0.6126014302123087,0.3765472251289158
27768,0.6831666666666665,2,0,2,539476,66134,68015,39941,0.6126014302123087,0.376535470186189
27769,0.6831666666666666,3,7,3,539483,66127,68018,39938,0.6125365889806959,0.37654268608871916
27770,0.6831666666666668,1,2,1,539485,66125,68019,39937,0.6125180629145207,0.3765439082800626
27771,0.6831818181818182,0,1,0,539486,66124,68019,39937,0.6125087998814331,0.37654745853801114
27772,0.6832142857142859,0,1,0,539487,66123,68019,39937,0.6124995368483456,0.37655100886290777
27773,0.6832380952380952,0,7,0,539494,66116,68019,39937,0.6124346956167327,0.3765758630118903
27774,0.68325,0,1,0,539495,66115,68019,39937,0.6124254325836452,0.3765794138724399
27775,0.6832619047619047,0,1,0,539496,66114,68019,39937,0.6124161695505577,0.37658296479995473
27776,0.6832857142857144,0,1,0,539497,66113,68019,39937,0.6124069065174701,0.3765865157944366
27777,0.6833095238095238,0,1,0,539498,66112,68019,39937,0.6123976434843825,0.37659006685588736
27778,0.6833333333333331,0,1,0,539499,66111,68019,39937,0.612388380451295,0.376593617984309
27779,0.6833333333333332,42,117,42,539616,65994,68061,39895,0.6113046055800512,0.37676245880119746
27780,0.6833333333333335,54,152,54,539768,65842,68115,39841,0.6098966245507429,0.37698589177067265
27781,0.6833809523809522,1,0,1,539768,65842,68116,39840,0.6098966245507429,0.37697999659355425
27782,0.6833809523809523,1,0,1,539768,65842,68117,39839,0.6098966245507429,0.3769741013048703
27783,0.6834285714285714,1,0,1,539768,65842,68118,39838,0.6098966245507429,0.3769682059046177
27784,0.6834404761904761,0,1,0,539769,65841,68118,39838,0.6098873615176553,0.37697177301072116
27785,0.6834642857142857,1,1,1,539770,65840,68119,39837,0.6098780984845678,0.3769694446284433
27786,0.6835,3,16,3,539786,65824,68122,39834,0.609729889955167,0.3770088398417536
27787,0.6835000000000001,0,6,0,539792,65818,68122,39834,0.6096743117566416,0.377030250255556
27788,0.6835238095238094,0,1,0,539793,65817,68122,39834,0.6096650487235541,0.377033818894284
27789,0.6835595238095238,0,1,0,539794,65816,68122,39834,0.6096557856904665,0.37703738760056793
27790,0.6835714285714286,0,2,0,539796,65814,68122,39834,0.6096372596242914,0.377044525215811
27791,0.6835975647159859,1,7,1,539803,65807,68123,39833,0.6095724183926785,0.3770636122680803
27792,0.6836190476190477,0,1,0,539804,65806,68123,39833,0.6095631553595909,0.37706718162799724
27793,0.6836428571428571,0,2,0,539806,65804,68123,39833,0.6095446292934158,0.37707432055056467
27794,0.6836428571428573,0,1,0,539807,65803,68123,39833,0.6095353662603283,0.37707789011321896
27795,0.6836666666666666,1,4,1,539811,65799,68124,39832,0.6094983141279781,0.3770862720224177
27796,0.6836666666666668,4,11,4,539822,65788,68128,39828,0.609396420764015,0.37710195424935616
27797,0.6836785714285715,0,1,0,539823,65787,68128,39828,0.6093871577309274,0.37710552478341147
27798,0.6836865079365082,2,2,2,539825,65785,68130,39826,0.6093686316647523,0.37710087017450833
27799,0.6837142857142857,0,1,0,539826,65784,68130,39826,0.6093593686316647,0.37710444086734213
27800,0.68375,0,3,0,539829,65781,68130,39826,0.6093315795324021,0.3771151533515771
27801,0.6838095238095236,1,0,1,539829,65781,68131,39825,0.6093315795324021,0.37710925515595706
27802,0.6838095238095238,0,3,0,539832,65778,68131,39825,0.6093037904331394,0.3771199681827221
27803,0.6838333333333333,1,7,1,539839,65771,68132,39824,0.6092389492015265,0.37713906908471045
27804,0.6838333333333334,1,4,1,539843,65767,68133,39823,0.6092018970691764,0.377147457145563
27805,0.6838333333333335,0,1,0,539844,65766,68133,39823,0.6091926340360888,0.3771510289897622
27806,0.6838571428571428,0,1,0,539845,65765,68133,39823,0.6091833710030012,0.3771546009016176
27807,0.6838809523809524,0,1,0,539846,65764,68133,39823,0.6091741079699137,0.3771581728811312
27808,0.6838888888888889,1,0,1,539846,65764,68134,39822,0.6091741079699137,0.3771522739757165
27809,0.6839444444444445,1,0,1,539846,65764,68135,39821,0.6091741079699137,0.3771463749585642
27810,0.6839999999999999,1,3,1,539849,65761,68136,39820,0.609146318870651,0.37715119197582897
27811,0.684,18,54,18,539903,65707,68154,39802,0.6086461150839231,0.37723796074268545
27812,0.6840238095238095,1,0,1,539903,65707,68155,39801,0.6086461150839231,0.37723205823255107
27813,0.684047619047619,0,5,0,539908,65702,68155,39801,0.6085997999184853,0.37724993602077667
27814,0.6840891053391053,0,2,0,539910,65700,68155,39801,0.6085812738523102,0.377257087610544
27815,0.6841190476190476,0,1,0,539911,65699,68155,39801,0.6085720108192226,0.377260663507109
27816,0.6841428571428572,1,0,1,539911,65699,68156,39800,0.6085720108192226,0.3772547607086323
27817,0.6841428571428573,2,0,2,539911,65699,68158,39798,0.6085720108192226,0.3772429547759652
27818,0.6841666666666666,10,25,10,539936,65674,68168,39788,0.6083404349920338,0.3772733306783486
27819,0.6841666666666667,8,22,8,539958,65652,68176,39780,0.6081366482641076,0.3773048030958343
27820,0.6841785714285716,0,3,0,539961,65649,68176,39780,0.6081088591648449,0.37731553936772616
27821,0.684190476190476,1,0,1,539961,65649,68177,39779,0.6081088591648449,0.37730963311454263
27822,0.6842261904761905,1,0,1,539961,65649,68178,39778,0.6081088591648449,0.37730372674931467
27823,0.6842857142857143,3,3,3,539964,65646,68181,39775,0.6080810700655823,0.37729674353307213
27824,0.6842857142857145,0,1,0,539965,65645,68181,39775,0.6080718070324947,0.377300322519446
27825,0.6843333333333333,8,22,8,539987,65623,68189,39767,0.6078680203045685,0.3773318151627289
27826,0.6843571428571429,0,1,0,539988,65622,68189,39767,0.607858757271481,0.37733539553463835
27827,0.6844087301587303,0,1,0,539989,65621,68189,39767,0.6078494942383934,0.37733897597449423
27828,0.6844166666666667,0,2,0,539991,65619,68189,39767,0.6078309681722183,0.37734613705805325
27829,0.6844761904761906,1,0,1,539991,65619,68190,39766,0.6078309681722183,0.37734022868529676
27830,0.6844999999999999,0,4,0,539995,65615,68190,39766,0.6077939160398681,0.37735455157950676
27831,0.6845,2,7,2,540002,65608,68192,39764,0.6077290748082552,0.3773678016930494
27832,0.6845000000000002,1,3,1,540005,65605,68193,39763,0.6077012857089925,0.3773726368536937
27833,0.6845198412698411,0,2,0,540007,65603,68193,39763,0.6076827596428175,0.37737979993546306
27834,0.6845714285714286,0,1,0,540008,65602,68193,39763,0.6076734966097299,0.37738338157832296
27835,0.6845833333333333,0,1,0,540009,65601,68193,39763,0.6076642335766423,0.377386963289169
27836,0.6845833333333334,0,3,0,540012,65598,68193,39763,0.6076364444773796,0.37739770882964285
27837,0.6846150793650793,0,2,0,540014,65596,68193,39763,0.6076179184112046,0.377404872863258
27838,0.6846190476190476,0,2,0,540016,65594,68193,39763,0.6075993923450295,0.37741203716886396
27839,0.6846190476190478,0,1,0,540017,65593,68193,39763,0.6075901293119419,0.3774156194236683
27840,0.6846666666666665,0,5,0,540022,65588,68193,39763,0.6075438141465042,0.3774335317177815
27841,0.6846666666666666,5,18,5,540040,65570,68198,39758,0.6073770795509281,0.3774684794166793
27842,0.6846666666666669,0,1,0,540041,65569,68198,39758,0.6073678165178406,0.37747206319367305
27843,0.6846904761904762,0,1,0,540042,65568,68198,39758,0.6073585534847531,0.3774756470387179
27844,0.6847142857142856,1,3,1,540045,65565,68199,39757,0.6073307643854904,0.3774804884069805
27845,0.68475,1,1,1,540046,65564,68200,39756,0.6073215013524028,0.377478161792632
27846,0.6847619047619048,1,0,1,540046,65564,68201,39755,0.6073215013524028,0.37747225097085996
27847,0.6847777777777777,0,5,0,540051,65559,68201,39755,0.6072751861869651,0.3774901722468048
27848,0.6847878787878788,0,1,0,540052,65558,68201,39755,0.6072659231538775,0.3774937567061996
27849,0.6848015873015874,1,0,1,540052,65558,68202,39754,0.6072659231538775,0.37748784563962323
27850,0.6848333333333332,1,2,1,540054,65556,68203,39753,0.6072473970877024,0.37748910349542775
27851,0.6848333333333333,1,9,1,540063,65547,68204,39752,0.6071640297899145,0.37751545598723635
27852,0.6848333333333335,1,0,1,540063,65547,68205,39751,0.6071640297899145,0.3775095443408232
27853,0.6848690476190475,0,1,0,540064,65546,68205,39751,0.6071547667568269,0.37751312952885646
27854,0.6848809523809526,0,1,0,540065,65545,68205,39751,0.6071455037237393,0.3775167147849871
27855,0.6849166666666666,1,0,1,540065,65545,68206,39750,0.6071455037237393,0.37751080298209794
27856,0.6849285714285713,0,4,0,540069,65541,68206,39750,0.607108451591389,0.3775251445992535
27857,0.6849696969696971,1,2,1,540071,65539,68207,39749,0.607089925525214,0.3775264037687106
27858,0.6849761904761904,0,1,0,540072,65538,68207,39749,0.6070806624921264,0.3775299894573879
27859,0.6849999999999998,2,6,2,540078,65532,68209,39747,0.6070250842936011,0.37753968027811813
27860,0.685,197,488,197,540566,65044,68406,39550,0.6025047241468746,0.3781287645562843
27861,0.6850000000000002,1,2,1,540568,65042,68407,39549,0.6024861980806996,0.3781300494306393
27862,0.685047619047619,0,1,0,540569,65041,68407,39549,0.602476935047612,0.37813366478630844
27863,0.6850833333333333,0,2,0,540571,65039,68407,39549,0.6024584089814369,0.3781408957050522
27864,0.6851190476190476,0,2,0,540573,65037,68407,39549,0.6024398829152617,0.37814812690034993
27865,0.6851666666666665,0,1,0,540574,65036,68407,39549,0.6024306198821742,0.3781517426017115
27866,0.6851666666666667,2,9,2,540583,65027,68409,39547,0.6023472525843863,0.37817239466789065
27867,0.6851666666666668,1,3,1,540586,65024,68410,39546,0.6023194634851236,0.37817729750406426
27868,0.6851865079365079,0,1,0,540587,65023,68410,39546,0.602310200452036,0.3781809140376211
27869,0.6851904761904761,0,1,0,540588,65022,68410,39546,0.6023009374189484,0.37818453064034885
27870,0.6852142857142858,1,0,1,540588,65022,68411,39545,0.6023009374189484,0.37817858406571864
27871,0.6852539682539682,1,0,1,540588,65022,68412,39544,0.6023009374189484,0.3781726373773502
27872,0.6852619047619047,0,1,0,540589,65021,68412,39544,0.602291674385861,0.3781762540046861
27873,0.685285714285714,0,1,0,540590,65020,68412,39544,0.6022824113527734,0.37817987070119735
27874,0.6852857142857143,1,0,1,540590,65020,68413,39543,0.6022824113527734,0.3781739238545183
27875,0.6853095238095237,0,2,0,540592,65018,68413,39543,0.6022638852865982,0.3781811574105068
27876,0.685333333333333,0,4,0,540596,65014,68413,39543,0.6022268331542481,0.3781956253526784
27877,0.6853333333333331,0,1,0,540597,65013,68413,39543,0.6022175701211605,0.3781992425111902
27878,0.6853333333333333,2,11,2,540608,65002,68415,39541,0.6021156767571973,0.3782271409850492
27879,0.6853333333333335,0,4,0,540612,64998,68415,39541,0.6020786246248472,0.3782416131778571
27880,0.6853571428571429,1,3,1,540615,64995,68416,39540,0.6020508355255845,0.37824652030420436
27881,0.6854166666666667,0,1,0,540616,64994,68416,39540,0.6020415724924969,0.37825013871085006
27882,0.6854256854256855,0,1,0,540617,64993,68416,39540,0.6020323094594094,0.3782537571867257
27883,0.6854523809523809,0,1,0,540618,64992,68416,39540,0.6020230464263219,0.3782573757318333
27884,0.6854523809523811,0,2,0,540620,64990,68416,39540,0.6020045203601467,0.37826461302975223
27885,0.6854999999999998,1,0,1,540620,64990,68417,39539,0.6020045203601467,0.3782586650594572
27886,0.6855,2,7,2,540627,64983,68419,39537,0.6019396791285339,0.37827210103329506
27887,0.6855000000000001,1,1,1,540628,64982,68420,39536,0.6019304160954463,0.37826977171396314
27888,0.6855108225108225,0,1,0,540629,64981,68420,39536,0.6019211530623587,0.37827339093161877
27889,0.6855119047619047,0,1,0,540630,64980,68420,39536,0.6019118900292711,0.3782770102185311
27890,0.6855436507936506,0,1,0,540631,64979,68420,39536,0.6019026269961836,0.3782806295747022
27891,0.6855714285714285,1,1,1,540632,64978,68421,39535,0.6018933639630961,0.3782783003071388
27892,0.6855952380952379,0,1,0,540633,64977,68421,39535,0.6018841009300085,0.37828191977954684
27893,0.6856190476190477,0,1,0,540634,64976,68421,39535,0.601874837896921,0.3782855393212198
27894,0.6856666666666665,1,1,1,540635,64975,68422,39534,0.6018655748638334,0.3782832100584639
27895,0.6856666666666666,4,23,4,540658,64952,68426,39530,0.6016525251028196,0.3783426810359679
27896,0.6856666666666668,0,2,0,540660,64950,68426,39530,0.6016339990366446,0.3783499234303216
27897,0.6856904761904761,0,1,0,540661,64949,68426,39530,0.601624736003557,0.37835354473147714
27898,0.6857142857142857,3,8,3,540669,64941,68429,39527,0.6015506317388566,0.3783646666921928
27899,0.6857857142857142,0,1,0,540670,64940,68429,39527,0.601541368705769,0.37836828855045135
27900,0.6858333333333333,8,32,8,540702,64908,68437,39519,0.6012449516469672,0.3784366112212359
27901,0.6858333333333334,9,29,9,540731,64879,68446,39510,0.6009763236874283,0.3784881548822194
27902,0.6859166666666667,0,1,0,540732,64878,68446,39510,0.6009670606543407,0.37849178066444417
27903,0.685952380952381,0,1,0,540733,64877,68446,39510,0.6009577976212531,0.37849540651613706
27904,0.6859999999999999,26,50,26,540783,64827,68472,39484,0.6004946459668754,0.37852192002760976
27905,0.686,2,2,2,540785,64825,68474,39482,0.6004761199007003,0.37851726154524623
27906,0.6860238095238096,0,1,0,540786,64824,68474,39482,0.6004668568676127,0.37852089045692483
27907,0.6860476190476191,0,1,0,540787,64823,68474,39482,0.6004575938345251,0.3785245194381861
27908,0.6860714285714287,0,2,0,540789,64821,68474,39482,0.6004390677683501,0.3785317776094647
27909,0.6860833333333335,0,1,0,540790,64820,68474,39482,0.6004298047352625,0.3785354067994861
27910,0.6861111111111111,0,2,0,540792,64818,68474,39482,0.6004112786690874,0.37854266538830295
27911,0.6861190476190476,1,2,1,540794,64816,68475,39481,0.6003927526029122,0.37854396579000354
27912,0.6861428571428572,0,1,0,540795,64815,68475,39481,0.6003834895698248,0.3785475953056685
27913,0.6861666666666665,0,1,0,540796,64814,68475,39481,0.6003742265367372,0.37855122489093435
27914,0.6861666666666666,0,6,0,540802,64808,68475,39481,0.6003186483382119,0.3785730038642618
27915,0.6861666666666667,0,2,0,540804,64806,68475,39481,0.6003001222720368,0.378580264078936
27916,0.686174603174603,0,3,0,540807,64803,68475,39481,0.6002723331727741,0.37859115492309464
27917,0.6861904761904762,1,0,1,540807,64803,68476,39480,0.6002723331727741,0.37858519605304797
27918,0.6862142857142857,1,1,1,540808,64802,68477,39479,0.6002630701396865,0.3785828674446927
27919,0.686218253968254,0,1,0,540809,64801,68477,39479,0.600253807106599,0.37858649789029536
27920,0.6862460317460318,0,3,0,540812,64798,68477,39479,0.6002260180073363,0.37859738964488815
27921,0.68625,1,1,1,540813,64797,68478,39478,0.6002167549742488,0.3785950611364181
27922,0.6863095238095238,1,2,1,540815,64795,68479,39477,0.6001982289080736,0.378596363357373
27923,0.6863333333333332,3,10,3,540825,64785,68482,39474,0.6001055985771981,0.37861479584496305
27924,0.6863333333333334,1,0,1,540825,64785,68483,39473,0.6001055985771981,0.3786088357727944
27925,0.6863636363636363,1,0,1,540825,64785,68484,39472,0.6001055985771981,0.3786028755862916
27926,0.6863730158730159,0,1,0,540826,64784,68484,39472,0.6000963355441106,0.37860650705954574
27927,0.6863809523809524,0,1,0,540827,64783,68484,39472,0.600087072511023,0.3786101386024651
27928,0.6864166666666667,1,0,1,540827,64783,68485,39471,0.600087072511023,0.37860417825694936
27929,0.6864285714285714,1,1,1,540828,64782,68486,39470,0.6000778094779354,0.3786018493650002
27930,0.6864444444444444,0,2,0,540830,64780,68486,39470,0.6000592834117603,0.3786091127098321
27931,0.6864484126984128,1,1,1,540831,64779,68487,39469,0.6000500203786728,0.37860678382319085
27932,0.6864523809523808,2,0,2,540831,64779,68489,39467,0.6000500203786728,0.37859486215298427
27933,0.6864545454545455,0,1,0,540832,64778,68489,39467,0.6000407573455853,0.37859849393256273
27934,0.6864642857142857,0,1,0,540833,64777,68489,39467,0.6000314943124977,0.37860212578181957
27935,0.6864999999999999,0,2,0,540835,64775,68489,39467,0.6000129682463226,0.37860938968937663
27936,0.6865000000000001,7,17,7,540852,64758,68496,39460,0.5998554966838342,0.3786294114260492
27937,0.6865238095238095,0,1,0,540853,64757,68496,39460,0.5998462336507466,0.37863304451289137
27938,0.686547619047619,0,1,0,540854,64756,68496,39460,0.5998369706176591,0.37863667766945575
27939,0.6865476190476191,0,1,0,540855,64755,68496,39460,0.5998277075845715,0.37864031089574435
27940,0.6865714285714284,1,1,1,540856,64754,68497,39459,0.5998184445514839,0.3786379818256839
27941,0.6865714285714286,1,0,1,540856,64754,68498,39458,0.5998184445514839,0.378632019345181
27942,0.6866309523809524,1,0,1,540856,64754,68499,39457,0.5998184445514839,0.3786260567502471
27943,0.6866666666666665,76,145,76,541001,64609,68575,39381,0.5984753047537886,0.37869987498797963
27944,0.6866666666666668,48,87,48,541088,64522,68623,39333,0.5976694208751714,0.378729960040441
27945,0.6866904761904763,1,0,1,541088,64522,68624,39332,0.5976694208751714,0.37872397789204076
27946,0.6867023809523809,1,0,1,541088,64522,68625,39331,0.5976694208751714,0.37871799562843633
27947,0.6867857142857141,0,1,0,541089,64521,68625,39331,0.5976601578420838,0.37872164233717215
27948,0.6867857142857143,0,1,0,541090,64520,68625,39331,0.5976508948089962,0.37872528911613756
27949,0.6868095238095239,0,1,0,541091,64519,68625,39331,0.5976416317759087,0.37872893596533463
27950,0.6868333333333332,0,3,0,541094,64516,68625,39331,0.5976138426766461,0.3787398769343361
27951,0.6868333333333334,3,11,3,541105,64505,68628,39328,0.5975119493126829,0.37876205060048346
27952,0.686845238095238,0,1,0,541106,64504,68628,39328,0.5975026862795954,0.378765698435935
27953,0.6868571428571427,0,2,0,541108,64502,68628,39328,0.5974841602134203,0.3787729943176346
27954,0.6868571428571428,0,1,0,541109,64501,68628,39328,0.5974748971803328,0.37877664236388675
27955,0.6869047619047619,1,0,1,541109,64501,68629,39327,0.5974748971803328,0.378770659167084
27956,0.686952380952381,1,1,1,541110,64500,68630,39326,0.5974656341472452,0.37876832392656945
27957,0.6869880952380951,0,1,0,541111,64499,68630,39326,0.5974563711141576,0.3787719720683843
27958,0.6869999999999998,0,3,0,541114,64496,68630,39326,0.5974285820148949,0.37878291691549
27959,0.687,5,10,5,541124,64486,68635,39321,0.5973359516840194,0.3787894843314998
27960,0.6870000000000002,0,2,0,541126,64484,68635,39321,0.5973174256178443,0.37879678242859205
27961,0.6870833333333334,0,2,0,541128,64482,68635,39321,0.5972988995516691,0.3788040808069131
27962,0.6871103896103896,0,1,0,541129,64481,68635,39321,0.5972896365185817,0.37880773010153945
27963,0.6871143578643577,0,1,0,541130,64480,68635,39321,0.5972803734854941,0.37881137946647914
27964,0.6871190476190476,1,3,1,541133,64477,68636,39320,0.5972525843862314,0.37881634343959847
27965,0.687142857142857,0,2,0,541135,64475,68636,39320,0.5972340583200563,0.37882364275735825
27966,0.6871428571428573,2,4,2,541139,64471,68638,39318,0.5971970061877061,0.37882627253369816
27967,0.6871666666666666,1,3,1,541142,64468,68639,39317,0.5971692170884434,0.37883123765476706
27968,0.6871666666666667,1,10,1,541152,64458,68640,39316,0.5970765867575679,0.3788617572802436
27969,0.6872142857142858,2,0,2,541152,64458,68642,39314,0.5970765867575679,0.37884978606945996
27970,0.6872222222222223,0,1,0,541153,64457,68642,39314,0.5970673237244803,0.37885343689470086
27971,0.6872619047619049,0,1,0,541154,64456,68642,39314,0.5970580606913928,0.37885708779030547
27972,0.6872882395382395,0,6,0,541160,64450,68642,39314,0.5970024824928675,0.3788789946416869
27973,0.6873095238095237,0,1,0,541161,64449,68642,39314,0.5969932194597799,0.3788826460298951
27974,0.6873333333333334,4,11,4,541172,64438,68646,39310,0.5968913260958169,0.3788988703396692
27975,0.6873333333333335,1,3,1,541175,64435,68647,39309,0.5968635369965541,0.3789038402220851
27976,0.6873571428571428,1,3,1,541178,64432,68648,39308,0.5968357478972914,0.3789088104877579
27977,0.6873809523809524,1,1,1,541179,64431,68649,39307,0.596826484864204,0.3789064759297461
27978,0.6874404761904762,0,2,0,541181,64429,68649,39307,0.5968079587980288,0.3789137811367317
27979,0.6874469696969697,0,1,0,541182,64428,68649,39307,0.5967986957649413,0.37891743384585724
27980,0.6874523809523809,0,2,0,541184,64426,68649,39307,0.5967801696987661,0.3789247394753839
27981,0.6874761904761906,0,1,0,541185,64425,68649,39307,0.5967709066656786,0.3789283923957891
27982,0.6874999999999999,3,2,3,541187,64423,68652,39304,0.5967523805995035,0.3789177359800245
27983,0.6875,64,146,64,541333,64277,68716,39240,0.5953999777687206,0.3790681723774839
27984,0.6875000000000001,1,0,1,541333,64277,68717,39239,0.5953999777687206,0.37906217396344527
27985,0.6875238095238094,0,1,0,541334,64276,68717,39239,0.595390714735633,0.3790658358691977
27986,0.6875238095238096,0,1,0,541335,64275,68717,39239,0.5953814517025455,0.37906949784570204
27987,0.6875595238095239,0,1,0,541336,64274,68717,39239,0.595372188669458,0.3790731598929603
27988,0.6875833333333332,0,1,0,541337,64273,68717,39239,0.5953629256363704,0.3790768220109746
27989,0.6875833333333334,1,3,1,541340,64270,68718,39238,0.5953351365371077,0.37908181010163466
27990,0.6876111111111111,0,1,0,541341,64269,68718,39238,0.5953258735040201,0.37908547248012214
27991,0.6876190476190476,0,2,0,541343,64267,68718,39238,0.5953073474378451,0.37909279744939856
27992,0.6876428571428572,0,3,0,541346,64264,68718,39238,0.5952795583385824,0.3791037854340979
27993,0.6876666666666665,2,0,2,541346,64264,68720,39236,0.5952795583385824,0.3790917874396135
27994,0.6876666666666666,8,16,8,541362,64248,68728,39228,0.5951313498091815,0.37910240055665084
27995,0.6876666666666668,2,4,2,541366,64244,68730,39226,0.5950942976768313,0.37910505460519955
27996,0.6876825396825397,1,0,1,541366,64244,68731,39225,0.5950942976768313,0.37909905382288417
27997,0.6876904761904763,0,1,0,541367,64243,68731,39225,0.5950850346437437,0.37910271774848264
27998,0.6877142857142857,1,0,1,541367,64243,68732,39224,0.5950850346437437,0.37909671682758755
27999,0.6877380952380951,1,0,1,541367,64243,68733,39223,0.5950850346437437,0.37909071579069453
28000,0.6877500000000001,1,2,1,541369,64241,68734,39222,0.5950665085775686,0.3790920425659414
28001,0.6877619047619048,0,2,0,541371,64239,68734,39222,0.5950479825113936,0.37909937077739436
28002,0.6877857142857144,0,2,0,541373,64237,68734,39222,0.5950294564452184,0.37910669927217544
28003,0.6878095238095239,0,1,0,541374,64236,68734,39222,0.5950201934121309,0.3791103636258192
28004,0.6878174603174604,0,1,0,541375,64235,68734,39222,0.5950109303790433,0.3791140280503011
28005,0.6878333333333333,0,4,0,541379,64231,68734,39222,0.5949738782466931,0.3791286864566518
28006,0.6878333333333334,0,2,0,541381,64229,68734,39222,0.594955352180518,0.37913601608490977
28007,0.6878547008547007,0,1,0,541382,64228,68734,39222,0.5949460891474304,0.3791396810053166
28008,0.6878571428571427,0,4,0,541386,64224,68734,39222,0.5949090370150802,0.3791543413955107
28009,0.6878787878787879,0,1,0,541387,64223,68734,39222,0.5948997739819927,0.3791580066702112
28010,0.6879166666666667,0,2,0,541389,64221,68734,39222,0.5948812479158175,0.37916533743220904
28011,0.687936507936508,0,1,0,541390,64220,68734,39222,0.59487198488273,0.37916900291951044
28012,0.6879404761904762,1,0,1,541390,64220,68735,39221,0.59487198488273,0.37916300113107954
28013,0.6879480519480521,1,1,1,541391,64219,68736,39220,0.5948627218496424,0.37916066473960497
28014,0.6879603174603175,1,1,1,541392,64218,68737,39219,0.5948534588165549,0.3791583282577801
28015,0.6879761904761905,0,2,0,541394,64216,68737,39219,0.5948349327503798,0.3791656595929811
28016,0.688,10,28,10,541422,64188,68747,39209,0.5945755678239283,0.37920829424451385
28017,0.6880000000000002,0,4,0,541426,64184,68747,39209,0.594538515691578,0.3792229648041937
28018,0.6880000000000003,0,1,0,541427,64183,68747,39209,0.5945292526584905,0.37922663262147943
28019,0.688047619047619,0,1,0,541428,64182,68747,39209,0.594519989625403,0.37923030050971557
28020,0.6880753968253966,0,1,0,541429,64181,68747,39209,0.5945107265923154,0.37923396846890417
28021,0.688095238095238,0,1,0,541430,64180,68747,39209,0.5945014635592278,0.3792376364990473
28022,0.6881049783549784,1,0,1,541430,64180,68748,39208,0.5945014635592278,0.37923163229775214
28023,0.6881071428571428,1,4,1,541434,64176,68749,39207,0.5944644114268777,0.3792403006296973
28024,0.6881388888888889,0,1,0,541435,64175,68749,39207,0.5944551483937901,0.3792439689694531
28025,0.6881666666666665,0,1,0,541436,64174,68749,39207,0.5944458853607025,0.37924763738017625
28026,0.6881666666666666,0,6,0,541442,64168,68749,39207,0.5943903071621772,0.3792696493349456
28027,0.6881666666666668,1,2,1,541444,64166,68750,39206,0.5943717810960021,0.3792709824710753
28028,0.688202380952381,0,1,0,541445,64165,68750,39206,0.5943625180629145,0.3792746514980023
28029,0.6883095238095238,0,1,0,541446,64164,68750,39206,0.5943532550298269,0.3792783205959176
28030,0.6883333333333331,0,1,0,541447,64163,68750,39206,0.5943439919967394,0.37928198976482314
28031,0.6883333333333332,21,76,21,541523,64087,68771,39185,0.5936400014820853,0.37943489038655204
28032,0.6883333333333335,34,83,34,541606,64004,68805,39151,0.5928711697358183,0.3795356502350831
28033,0.6883809523809523,0,1,0,541607,64003,68805,39151,0.5928619067027308,0.3795393295461155
28034,0.688392857142857,1,0,1,541607,64003,68806,39150,0.5928619067027308,0.3795333145909474
28035,0.6884166666666667,0,1,0,541608,64002,68806,39150,0.5928526436696432,0.37953699395067475
28036,0.688452380952381,0,1,0,541609,64001,68806,39150,0.5928433806365556,0.37954067338174136
28037,0.6884855699855699,1,1,1,541610,64000,68807,39149,0.592834117603468,0.37953833774442797
28038,0.6884999999999999,8,9,8,541619,63991,68815,39141,0.5927507503056801,0.37952332932552457
28039,0.6885000000000001,0,1,0,541620,63990,68815,39141,0.5927414872725926,0.37952700933763855
28040,0.6885714285714286,3,3,3,541623,63987,68818,39138,0.5927136981733299,0.37952
28041,0.6885833333333332,0,1,0,541624,63986,68818,39138,0.5927044351402423,0.37952368022962646
28042,0.6886111111111112,0,2,0,541626,63984,68818,39138,0.5926859090740673,0.3795310409030081
28043,0.6886666666666666,1,8,1,541634,63976,68819,39137,0.5926118048093668,0.3795544693685568
28044,0.6886666666666668,4,16,4,541650,63960,68823,39133,0.5924635962799659,0.379589302862464
28045,0.6887222222222223,0,1,0,541651,63959,68823,39133,0.5924543332468784,0.3795929849066853
28046,0.68875,1,5,1,541656,63954,68824,39132,0.5924080180814406,0.3796053780338746
28047,0.6888095238095236,1,2,1,541658,63952,68825,39131,0.5923894920152655,0.37960672467817197
28048,0.6888095238095238,1,1,1,541659,63951,68826,39130,0.5923802289821779,0.3796043887816377
28049,0.6888333333333333,4,6,4,541665,63945,68830,39126,0.5923246507836526,0.3796024099892307
28050,0.6888333333333334,0,1,0,541666,63944,68830,39126,0.592315387750565,0.3796060929465412
28051,0.6888571428571427,1,0,1,541666,63944,68831,39125,0.592315387750565,0.3796000737370111
28052,0.6888809523809525,0,2,0,541668,63942,68831,39125,0.5922968616843899,0.37960743982069917
28053,0.688888888888889,0,1,0,541669,63941,68831,39125,0.5922875986513024,0.3796111229697475
28054,0.6889206349206347,1,0,1,541669,63941,68832,39124,0.5922875986513024,0.37960510357541355
28055,0.6889285714285713,0,1,0,541670,63940,68832,39124,0.5922783356182149,0.3796087867732671
28056,0.6889950360097419,0,3,0,541673,63937,68832,39124,0.5922505465189521,0.3796198367956841
28057,0.689,1,1,1,541674,63936,68833,39123,0.5922412834858646,0.37961750065496463
28058,0.6890000000000001,7,27,7,541701,63909,68840,39116,0.5919911815925006,0.37967483620480463
28059,0.6890000000000002,0,1,0,541702,63908,68840,39116,0.5919819185594131,0.37967852150955117
28060,0.6890151515151516,0,1,0,541703,63907,68840,39116,0.5919726555263255,0.37968220688584103
28061,0.6890238095238095,0,2,0,541705,63905,68840,39116,0.5919541294601505,0.37968957785305907
28062,0.689047619047619,0,4,0,541709,63901,68840,39116,0.5919170773278002,0.37970432064610693
28063,0.6891428571428571,0,2,0,541711,63899,68840,39116,0.5918985512616252,0.3797116924719701
28064,0.6891666666666666,10,30,10,541741,63869,68850,39106,0.5916206602689985,0.3797620781743142
28065,0.6891666666666667,4,13,4,541754,63856,68854,39102,0.5915002408388603,0.3797859321276637
28066,0.6891666666666668,1,2,1,541756,63854,68855,39101,0.5914817147726852,0.3797872857073479
28067,0.6891904761904761,0,3,0,541759,63851,68855,39101,0.5914539256734225,0.379798352630352
28068,0.6892222222222223,0,2,0,541761,63849,68855,39101,0.5914353996072474,0.3798057309373482
28069,0.6892380952380952,0,1,0,541762,63848,68855,39101,0.5914261365741599,0.3798094201983506
28070,0.6892500000000001,1,1,1,541763,63847,68856,39100,0.5914168735410723,0.37980708519918016
28071,0.6892698412698413,1,1,1,541764,63846,68857,39099,0.5914076105079847,0.37980475010928166
28072,0.6892857142857142,1,3,1,541767,63843,68858,39098,0.591379821408722,0.3798097939596468
28073,0.6892857142857143,1,3,1,541770,63840,68859,39097,0.5913520323094594,0.37981483820200707
28074,0.6893333333333332,0,3,0,541773,63837,68859,39097,0.5913242432101967,0.37982590786329107
28075,0.6893333333333334,4,21,4,541794,63816,68863,39093,0.5911297195153581,0.37987931084744775
28076,0.6893333333333335,0,1,0,541795,63815,68863,39093,0.5911204564822705,0.3798830022933105
28077,0.6893888888888888,1,2,1,541797,63813,68864,39092,0.5911019304160955,0.3798843593605753
28078,0.6894047619047619,0,2,0,541799,63811,68864,39092,0.5910834043499203,0.37989174270915327
28079,0.6894166666666667,2,0,2,541799,63811,68866,39090,0.5910834043499203,0.3798796901876561
28080,0.6894444444444444,1,1,1,541800,63810,68867,39089,0.5910741413168328,0.3798773554650677
28081,0.6894523809523809,0,2,0,541802,63808,68867,39089,0.5910556152506576,0.3798847391080401
28082,0.6894999999999999,0,6,0,541808,63802,68867,39089,0.5910000370521323,0.37990689175924036
28083,0.6895,1,11,1,541819,63791,68868,39088,0.5908981436881693,0.37994148465673266
28084,0.6895000000000002,0,1,0,541820,63790,68868,39088,0.5908888806550817,0.37994517778339393
28085,0.6895238095238095,0,3,0,541823,63787,68868,39088,0.590861091555819,0.3799562575941677
28086,0.689547619047619,1,0,1,541823,63787,68869,39087,0.590861091555819,0.3799502303789101
28087,0.6895476190476191,0,1,0,541824,63786,68869,39087,0.5908518285227314,0.37995392377008547
28088,0.6895833333333333,0,2,0,541826,63784,68869,39087,0.5908333024565564,0.3799613107678549
28089,0.6895833333333334,0,1,0,541827,63783,68869,39087,0.5908240394234688,0.3799650043744532
28090,0.6896111111111111,0,1,0,541828,63782,68869,39087,0.5908147763903813,0.3799686980528634
28091,0.6896309523809524,3,1,3,541829,63781,68872,39084,0.5908055133572937,0.37995430904583677
28092,0.6896428571428572,0,2,0,541831,63779,68872,39084,0.5907869872911186,0.3799616966256088
28093,0.6896666666666665,0,2,0,541833,63777,68872,39084,0.5907684612249435,0.37996908449266487
28094,0.6896666666666667,4,8,4,541841,63769,68876,39080,0.5906943569602431,0.3799745257610672
28095,0.6896904761904762,0,1,0,541842,63768,68876,39080,0.5906850939271555,0.37997822028624767
28096,0.6896904761904763,1,0,1,541842,63768,68877,39079,0.5906850939271555,0.3799721917022373
28097,0.6897380952380953,0,1,0,541843,63767,68877,39079,0.5906758308940679,0.37997588627656886
28098,0.6897500000000001,0,1,0,541844,63766,68877,39079,0.5906665678609804,0.3799795809227478
28099,0.6897619047619047,1,0,1,541844,63766,68878,39078,0.5906665678609804,0.3799735521761114
28100,0.6897698412698413,0,1,0,541845,63765,68878,39078,0.5906573048278928,0.3799772468714448
28101,0.6897727272727273,1,1,1,541846,63764,68879,39077,0.5906480417948053,0.3799749127293589
28102,0.6898095238095238,0,1,0,541847,63763,68879,39077,0.5906387787617178,0.37997860754570206
28103,0.6898333333333332,0,2,0,541849,63761,68879,39077,0.5906202526955426,0.37998599739395944
28104,0.6898333333333333,1,3,1,541852,63758,68880,39076,0.5905924635962799,0.37999105354260265
28105,0.6898412698412699,0,1,0,541853,63757,68880,39076,0.5905832005631924,0.379994748767419
28106,0.6898809523809524,0,1,0,541854,63756,68880,39076,0.5905739375301049,0.37999844406410455
28107,0.6899047619047619,0,2,0,541856,63754,68880,39076,0.5905554114639298,0.38000583487309153
28108,0.6899999999999998,0,2,0,541858,63752,68880,39076,0.5905368853977546,0.38001322596958026
28109,0.69,656,1553,656,543411,62199,69536,38420,0.576151395012783,0.38183643248293064
28110,0.6900000000000002,0,5,0,543416,62194,69536,38420,0.5761050798473453,0.38185540779613175
28111,0.6900833333333333,0,1,0,543417,62193,69536,38420,0.5760958168142577,0.3818592030850884
28112,0.6901017316017315,0,2,0,543419,62191,69536,38420,0.5760772907480826,0.38186679388933614
28113,0.6901190476190476,0,1,0,543420,62190,69536,38420,0.576068027714995,0.38187058940463176
28114,0.6901190476190477,0,1,0,543421,62189,69536,38420,0.5760587646819074,0.3818743849953781
28115,0.6901666666666665,0,1,0,543422,62188,69536,38420,0.5760495016488199,0.3818781806615776
28116,0.6901666666666667,5,10,5,543432,62178,69541,38415,0.5759568713179444,0.38188541946258686
28117,0.6901666666666668,0,4,0,543436,62174,69541,38415,0.5759198191855941,0.3819006054339938
28118,0.6901825396825396,0,1,0,543437,62173,69541,38415,0.5759105561525065,0.3819044021155605
28119,0.6902380952380952,1,2,1,543439,62171,69542,38414,0.5758920300863315,0.38190585077297806
28120,0.6902380952380953,0,1,0,543440,62170,69542,38414,0.5758827670532439,0.38190964765767915
28121,0.6903333333333331,0,1,0,543441,62169,69542,38414,0.5758735040201564,0.3819134446178778
28122,0.6903333333333334,2,7,2,543448,62162,69544,38412,0.5758086627885435,0.3819277348022352
28123,0.6903333333333335,1,1,1,543449,62161,69545,38411,0.5757993997554559,0.3819253867875751
28124,0.6903593073593072,0,2,0,543451,62159,69545,38411,0.5757808736892808,0.38193298200258524
28125,0.6903809523809522,1,1,1,543452,62158,69546,38410,0.5757716106561933,0.3819306339988863
28126,0.6903809523809524,2,0,2,543452,62158,69548,38408,0.5757716106561933,0.38191834218324283
28127,0.6904166666666666,0,1,0,543453,62157,69548,38408,0.5757623476231057,0.38192213990951124
28128,0.6904523809523809,0,3,0,543456,62154,69548,38408,0.575734558523843,0.3819335335414968
28129,0.690452380952381,0,2,0,543458,62152,69548,38408,0.5757160324576679,0.3819411296738266
28130,0.6904761904761904,2,0,2,543458,62152,69550,38406,0.5757160324576679,0.3819288370890431
28131,0.6904761904761905,1,2,1,543460,62150,69551,38405,0.5756975063914929,0.38193028690766245
28132,0.6905,4,6,4,543466,62144,69555,38401,0.5756419281929676,0.3819284897309662
28133,0.6905000000000001,1,5,1,543471,62139,69556,38400,0.5755956130275297,0.38194133619789333
28134,0.6905357142857143,0,1,0,543472,62138,69556,38400,0.5755863499944421,0.3819451351727705
28135,0.6905476190476191,0,1,0,543473,62137,69556,38400,0.5755770869613547,0.3819489342232213
28136,0.6905952380952382,0,2,0,543475,62135,69556,38400,0.5755585608951795,0.38195653255085293
28137,0.6906666666666665,1,1,1,543476,62134,69557,38399,0.575549297862092,0.38195418419822347
28138,0.6906666666666667,5,14,5,543490,62120,69562,38394,0.5754196153988662,0.38197664007004
28139,0.6906666666666668,0,3,0,543493,62117,69562,38394,0.5753918262996035,0.3819880411099283
28140,0.6906666666666669,1,1,1,543494,62116,69563,38393,0.5753825632665159,0.38198569282352823
28141,0.6906904761904761,0,1,0,543495,62115,69563,38393,0.5753733002334285,0.3819894933736618
28142,0.6907142857142857,0,9,0,543504,62106,69563,38393,0.5752899329356405,0.3820237017283754
28143,0.6907857142857142,0,1,0,543505,62105,69563,38393,0.5752806699025529,0.38202750303488625
28144,0.6908333333333333,9,26,9,543531,62079,69572,38384,0.5750398310422765,0.38207101121806036
28145,0.6908333333333334,7,30,7,543561,62049,69579,38377,0.5747619400496499,0.38214207476151596
28146,0.6908333333333335,0,1,0,543562,62048,69579,38377,0.5747526770165623,0.3821458800099577
28147,0.6908669802419805,0,1,0,543563,62047,69579,38377,0.5747434139834747,0.3821496853341831
28148,0.6908809523809524,0,1,0,543564,62046,69579,38377,0.5747341509503872,0.38215349073419436
28149,0.6908849206349206,0,1,0,543565,62045,69579,38377,0.5747248879172996,0.38215729620999384
28150,0.690952380952381,2,2,2,543567,62043,69581,38375,0.5747063618511246,0.38215260212312535
28151,0.691,9,27,9,543594,62016,69590,38366,0.5744562599577606,0.38219999601522187
28152,0.6910000000000001,2,1,2,543595,62015,69592,38364,0.574446996924673,0.38219149423684234
28153,0.6910079365079365,0,1,0,543596,62014,69592,38364,0.5744377338915855,0.3821953017593497
28154,0.6910714285714286,0,1,0,543597,62013,69592,38364,0.5744284708584979,0.3821991093577214
28155,0.6911031746031746,0,2,0,543599,62011,69592,38364,0.5744099447923228,0.38220672478206724
28156,0.691138888888889,0,2,0,543601,62009,69592,38364,0.5743914187261477,0.38221434050989805
28157,0.6911666666666666,1,1,1,543602,62008,69593,38363,0.5743821556930602,0.3822119935040998
28158,0.6911666666666667,0,5,0,543607,62003,69593,38363,0.5743358405276223,0.3822310344140446
28159,0.691190476190476,0,1,0,543608,62002,69593,38363,0.5743265774945349,0.3822348428236935
28160,0.6911904761904762,0,1,0,543609,62001,69593,38363,0.5743173144614473,0.3822386513092344
28161,0.6912142857142857,0,2,0,543611,61999,69593,38363,0.5742987883952722,0.38224626850800103
28162,0.69125,1,4,1,543615,61995,69594,38362,0.574261736262922,0.3822553484061899
28163,0.6913095238095238,1,3,1,543618,61992,69595,38361,0.5742339471636593,0.3822606200113599
28164,0.6913333333333332,2,12,2,543630,61980,69597,38359,0.5741227907666087,0.3822940232611447
28165,0.6913333333333334,3,4,3,543634,61976,69600,38356,0.5740857386342584,0.382290794562054
28166,0.6913571428571429,0,1,0,543635,61975,69600,38356,0.5740764756011708,0.3822946048579203
28167,0.6913809523809523,1,0,1,543635,61975,69601,38355,0.5740764756011708,0.38228844812120005
28168,0.6913809523809524,1,1,1,543636,61974,69602,38354,0.5740672125680832,0.3822861015867953
28169,0.6914285714285714,0,3,0,543639,61971,69602,38354,0.5740394234688206,0.3822975330176925
28170,0.6914422799422799,0,3,0,543642,61968,69602,38354,0.5740116343695579,0.3823089651322741
28171,0.6914444444444446,1,0,1,543642,61968,69603,38353,0.5740116343695579,0.3823028079863638
28172,0.6914761904761906,0,1,0,543643,61967,69603,38353,0.5740023713364704,0.38230661881977673
28173,0.6914999999999999,0,5,0,543648,61962,69603,38353,0.5739560561710326,0.38232567412650154
28174,0.6915,3,13,3,543661,61949,69606,38350,0.5738356367408944,0.38235675330761026
28175,0.6915000000000002,0,2,0,543663,61947,69606,38350,0.5738171106747193,0.38236437779794014
28176,0.691515873015873,0,1,0,543664,61946,69606,38350,0.5738078476416317,0.38236819015713486
28177,0.6915238095238097,1,0,1,543664,61946,69607,38349,0.5738078476416317,0.38236203200558355
28178,0.6915277777777777,0,1,0,543665,61945,69607,38349,0.5737985846085443,0.3823658444174128
28179,0.6915357142857144,0,1,0,543666,61944,69607,38349,0.5737893215754567,0.3823696569052676
28180,0.6915468975468978,1,2,1,543668,61942,69608,38348,0.5737707955092816,0.3823711237411507
28181,0.6915476190476191,1,0,1,543668,61942,69609,38347,0.5737707955092816,0.3823649652504263
28182,0.6915714285714283,1,1,1,543669,61941,69610,38346,0.573761532476194,0.38236261928265874
28183,0.6916111111111111,0,1,0,543670,61940,69610,38346,0.5737522694431064,0.38236643200446724
28184,0.6916190476190477,0,1,0,543671,61939,69610,38346,0.5737430064100189,0.3823702448023134
28185,0.6916269841269843,0,2,0,543673,61937,69610,38346,0.5737244803438438,0.38237787062612805
28186,0.6916666666666665,30,102,30,543775,61835,69640,38316,0.5727796509689133,0.3825823007259039
28187,0.6916666666666668,21,66,21,543841,61769,69661,38295,0.5721682907851346,0.38270506875599614
28188,0.6916785714285715,0,1,0,543842,61768,69661,38295,0.5721590277520471,0.3827088933971598
28189,0.6916904761904763,0,1,0,543843,61767,69661,38295,0.5721497647189596,0.38271271811476887
28190,0.6917857142857143,2,3,2,543846,61764,69663,38293,0.5721219756196969,0.38271185424308146
28191,0.6917954545454547,0,1,0,543847,61763,69663,38293,0.5721127125866093,0.382715679219637
28192,0.6918333333333332,0,1,0,543848,61762,69663,38293,0.5721034495535218,0.38271950427265006
28193,0.6918333333333334,1,9,1,543857,61753,69664,38292,0.5720200822557339,0.3827477635064221
28194,0.691845238095238,1,1,1,543858,61752,69665,38291,0.5720108192226463,0.38274541946962803
28195,0.6918636363636366,0,1,0,543859,61751,69665,38291,0.5720015561895587,0.38274924531696686
28196,0.6919047619047619,0,3,0,543862,61748,69665,38291,0.571973767090296,0.382760723317906
28197,0.691904761904762,0,1,0,543863,61747,69665,38291,0.5719645040572084,0.3827645494712009
28198,0.6919444444444445,0,1,0,543864,61746,69665,38291,0.571955241024121,0.38276837570099065
28199,0.6919484126984129,1,2,1,543866,61744,69666,38290,0.5719367149579458,0.3827698582481956
28200,0.6919761904761904,1,1,1,543867,61743,69667,38289,0.5719274519248583,0.38276751439539347
28201,0.6919999999999998,1,2,1,543869,61741,69668,38288,0.5719089258586831,0.38276899699087263
28202,0.6920000000000001,9,32,9,543901,61709,69677,38279,0.5716125087998815,0.3828359403128375
28203,0.6920238095238095,0,1,0,543902,61708,69677,38279,0.5716032457667939,0.3828397691699921
28204,0.6920476190476189,0,1,0,543903,61707,69677,38279,0.5715939827337063,0.38284359810373453
28205,0.6920833333333334,0,1,0,543904,61706,69677,38279,0.5715847197006187,0.3828474271140671
28206,0.6920873015873016,0,1,0,543905,61705,69677,38279,0.5715754566675312,0.38285125620099214
28207,0.6921111111111109,0,1,0,543906,61704,69677,38279,0.5715661936344436,0.38285508536451196
28208,0.6921428571428571,1,1,1,543907,61703,69678,38278,0.5715569306013562,0.38285274202098396
28209,0.6921428571428572,0,7,0,543914,61696,69678,38278,0.5714920893697433,0.3828795486826575
28210,0.6921666666666666,1,0,1,543914,61696,69679,38277,0.5714920893697433,0.3828733758114691
28211,0.6921666666666667,0,3,0,543917,61693,69679,38277,0.5714643002704806,0.3828848654596379
28212,0.6921904761904761,0,1,0,543918,61692,69679,38277,0.571455037237393,0.3828886954956036
28213,0.6922619047619049,0,1,0,543919,61691,69679,38277,0.5714457742043054,0.38289252560819464
28214,0.6922727272727272,0,1,0,543920,61690,69679,38277,0.5714365111712179,0.38289635579741316
28215,0.6922936507936508,1,0,1,543920,61690,69680,38276,0.5714365111712179,0.3828901826621051
28216,0.6923333333333332,0,8,0,543928,61682,69680,38276,0.5713624069065175,0.3829208267472338
28217,0.6923333333333334,1,13,1,543941,61669,69681,38275,0.5712419874763792,0.38296446009765467
28218,0.6923333333333335,0,1,0,543942,61668,69681,38275,0.5712327244432918,0.38296829192639803
28219,0.6923809523809524,0,3,0,543945,61665,69681,38275,0.571204935344029,0.38297978787272363
28220,0.6924166666666668,0,1,0,543946,61664,69681,38275,0.5711956723109415,0.382983620008205
28221,0.6924523809523809,1,0,1,543946,61664,69682,38274,0.5711956723109415,0.3829774460165303
28222,0.6924761904761904,1,0,1,543946,61664,69683,38273,0.5711956723109415,0.3829712719012978
28223,0.6924999999999999,0,7,0,543953,61657,69683,38273,0.5711308310793286,0.38299809866906837
28224,0.6925,59,116,59,544069,61541,69742,38214,0.5700563192411723,0.38307854242895095
28225,0.6925000000000001,2,2,2,544071,61539,69744,38212,0.5700377931749973,0.3830738538962015
28226,0.6925833333333332,0,1,0,544072,61538,69744,38212,0.5700285301419097,0.38307769423558896
28227,0.69260101010101,0,1,0,544073,61537,69744,38212,0.5700192671088221,0.3830815346519765
28228,0.6926071428571429,1,0,1,544073,61537,69745,38211,0.5700192671088221,0.3830753498817019
28229,0.6926120268620269,0,1,0,544074,61536,69745,38211,0.5700100040757345,0.38307919035158955
28230,0.6926190476190476,0,4,0,544078,61532,69745,38211,0.5699729519433844,0.38309455300121315
28231,0.692642857142857,0,1,0,544079,61531,69745,38211,0.5699636889102968,0.38309839385614886
28232,0.6926437728937728,0,1,0,544080,61530,69745,38211,0.5699544258772092,0.3831022347881012
28233,0.6926666666666665,0,2,0,544082,61528,69745,38211,0.5699358998110341,0.3831099168830648
28234,0.6926666666666667,1,14,1,544096,61514,69746,38210,0.5698062173478083,0.38315751474068427
28235,0.6926666666666668,3,4,3,544100,61510,69749,38207,0.5697691652154582,0.38315432674468747
28236,0.6927135087135088,0,1,0,544101,61509,69749,38207,0.5697599021823706,0.38315816920052953
28237,0.6927207792207792,1,1,1,544102,61508,69750,38206,0.569750639149283,0.38315582566139156
28238,0.6927222222222222,1,0,1,544102,61508,69751,38205,0.569750639149283,0.3831496394652653
28239,0.6927301587301585,1,0,1,544102,61508,69752,38204,0.569750639149283,0.38314345314505777
28240,0.6927777777777777,0,1,0,544103,61507,69752,38204,0.5697413761161955,0.38314729568452827
28241,0.6928253968253968,1,0,1,544103,61507,69753,38203,0.5697413761161955,0.3831411092167285
28242,0.6928333333333332,0,1,0,544104,61506,69753,38203,0.5697321130831079,0.38314495180976643
28243,0.6928333333333333,1,7,1,544111,61499,69754,38202,0.569667271851495,0.3831656653393647
28244,0.6928333333333334,0,3,0,544114,61496,69754,38202,0.5696394827522324,0.38317719512929044
28245,0.6928571428571427,1,7,1,544121,61489,69755,38201,0.5695746415206195,0.38319791353194904
28246,0.692857142857143,0,1,0,544122,61488,69755,38201,0.569565378487532,0.3832017574657184
28247,0.6928888888888889,1,0,1,544122,61488,69756,38200,0.569565378487532,0.38319557017895833
28248,0.6929166666666666,1,0,1,544122,61488,69757,38199,0.569565378487532,0.383189382768064
28249,0.6929166666666667,0,1,0,544123,61487,69757,38199,0.5695561154544444,0.3831932267319383
28250,0.6929206349206349,2,3,2,544126,61484,69759,38197,0.5695283263551817,0.3831923837040158
28251,0.6929285714285714,0,1,0,544127,61483,69759,38197,0.5695190633220942,0.383196227929374
28252,0.692936507936508,0,1,0,544128,61482,69759,38197,0.5695098002890067,0.3832000722318643
28253,0.6929523809523809,0,1,0,544129,61481,69759,38197,0.5695005372559191,0.383203916611489
28254,0.693,6,19,6,544148,61462,69765,38191,0.5693245396272556,0.3832398422526166
28255,0.6930000000000001,1,0,1,544148,61462,69766,38190,0.5693245396272556,0.38323365311283264
28256,0.693047619047619,0,2,0,544150,61460,69766,38190,0.5693060135610805,0.38324134470647264
28257,0.6930833333333334,0,1,0,544151,61459,69766,38190,0.5692967505279929,0.383245190619073
28258,0.6930952380952381,1,1,1,544152,61458,69767,38189,0.5692874874949053,0.3832428472507953
28259,0.6931049783549783,0,1,0,544153,61457,69767,38189,0.5692782244618178,0.3832466932942617
28260,0.6931060606060606,1,0,1,544153,61457,69768,38188,0.5692782244618178,0.383240503788449
28261,0.693111111111111,0,1,0,544154,61456,69768,38188,0.5692689614287302,0.3832443498855927
28262,0.6931428571428571,1,0,1,544154,61456,69769,38187,0.5692689614287302,0.38323816023202834
28263,0.6931428571428572,0,1,0,544155,61455,69769,38187,0.5692596983956427,0.3832420063828506
28264,0.6931666666666666,2,10,2,544165,61445,69771,38185,0.5691670680647671,0.38326809194017863
28265,0.6931666666666668,0,3,0,544168,61442,69771,38185,0.5691392789655044,0.3832796330312064
28266,0.69325,0,1,0,544169,61441,69771,38185,0.569130015932417,0.3832834802160079
28267,0.6932857142857142,1,0,1,544169,61441,69772,38184,0.569130015932417,0.38327728983688836
28268,0.6933333333333332,43,102,43,544271,61339,69815,38141,0.5681851865574864,0.38340369923602735
28269,0.6933333333333335,45,161,45,544432,61178,69860,38096,0.5666938382303902,0.3837459959304551
28270,0.6933571428571429,0,1,0,544433,61177,69860,38096,0.5666845751973026,0.3837498614930545
28271,0.6934285714285715,0,1,0,544434,61176,69860,38096,0.5666753121642151,0.3837537271335321
28272,0.6934523809523809,1,0,1,544434,61176,69861,38095,0.5666753121642151,0.3837475194165466
28273,0.6934999999999999,5,12,5,544446,61164,69866,38090,0.5665641557671643,0.3837628710177927
28274,0.6935000000000001,1,2,1,544448,61162,69867,38089,0.5665456297009893,0.38376439532095397
28275,0.6935158730158731,1,0,1,544448,61162,69868,38088,0.5665456297009893,0.38375818639798487
28276,0.6935238095238094,1,0,1,544448,61162,69869,38087,0.5665456297009893,0.38375197734989774
28277,0.6935714285714286,0,1,0,544449,61161,69869,38087,0.5665363666679017,0.3837558439464775
28278,0.6935714285714287,0,2,0,544451,61159,69869,38087,0.5665178406017266,0.3837635773733954
28279,0.6935833333333333,1,0,1,544451,61159,69870,38086,0.5665178406017266,0.3837573681293768
28280,0.693611111111111,1,0,1,544451,61159,69871,38085,0.5665178406017266,0.3837511587602273
28281,0.6936111111111112,0,1,0,544452,61158,69871,38085,0.566508577568639,0.38375502554336327
28282,0.6936190476190476,0,1,0,544453,61157,69871,38085,0.5664993145355515,0.38375889240442557
28283,0.6936666666666664,0,1,0,544454,61156,69871,38085,0.566490051502464,0.3837627593434165
28284,0.6936666666666667,0,2,0,544456,61154,69871,38085,0.5664715254362889,0.38377049345519404
28285,0.6936666666666668,3,7,3,544463,61147,69874,38082,0.566406684204676,0.3837789355934253
28286,0.6936904761904762,0,1,0,544464,61146,69874,38082,0.5663974211715884,0.38378280324102065
28287,0.69375,0,2,0,544466,61144,69874,38082,0.5663788951054133,0.3837905387700804
28288,0.6937638888888888,1,0,1,544466,61144,69875,38081,0.5663788951054133,0.3837843285462333
28289,0.6937738095238093,1,3,1,544469,61141,69876,38080,0.5663511060061507,0.3837897219338648
28290,0.6937777777777778,1,3,1,544472,61138,69877,38079,0.566323316906888,0.3837951157563724
28291,0.6937857142857143,0,1,0,544473,61137,69877,38079,0.5663140538738004,0.3837989840348331
28292,0.6938095238095238,0,4,0,544477,61133,69877,38079,0.5662770017414502,0.3838144579284764
28293,0.6938333333333333,2,8,2,544485,61125,69879,38077,0.5662028974767498,0.3838329872381605
28294,0.6938333333333334,1,5,1,544490,61120,69880,38076,0.566156582311312,0.3838461228275334
28295,0.6938333333333335,0,2,0,544492,61118,69880,38076,0.5661380562451369,0.3838538621287578
28296,0.6938571428571428,0,1,0,544493,61117,69880,38076,0.5661287932120493,0.383857731896404
28297,0.6938690476190476,0,1,0,544494,61116,69880,38076,0.5661195301789618,0.38386160174207595
28298,0.6938928571428572,0,2,0,544496,61114,69880,38076,0.5661010041127867,0.3838693416675068
28299,0.6939523809523809,1,0,1,544496,61114,69881,38075,0.5661010041127867,0.38386312998417166
28300,0.6939880952380953,0,1,0,544497,61113,69881,38075,0.5660917410796992,0.3838670000403275
28301,0.694,0,5,0,544502,61108,69881,38075,0.5660454259142613,0.3838863514916871
28302,0.6940000000000001,20,48,20,544550,61060,69901,38055,0.5656008003260588,0.3839479392624729
28303,0.694047619047619,0,3,0,544553,61057,69901,38055,0.5655730112267962,0.3839595609007991
28304,0.694079365079365,1,1,1,544554,61056,69902,38054,0.5655637481937086,0.3839572192513369
28305,0.6940952380952379,0,1,0,544555,61055,69902,38054,0.565554485160621,0.38396109334167433
28306,0.6941666666666666,8,28,8,544583,61027,69910,38046,0.5652951202341695,0.3840198641405832
28307,0.6941666666666667,8,32,8,544615,60995,69918,38038,0.5649987031753677,0.38409419082528046
28308,0.6941666666666668,0,2,0,544617,60993,69918,38038,0.5649801771091927,0.38410194787490787
28309,0.6941803751803749,0,1,0,544618,60992,69918,38038,0.5649709140761051,0.38410582651721703
28310,0.6941904761904761,1,1,1,544619,60991,69919,38037,0.5649616510430175,0.38410348588278065
28311,0.6942499999999999,1,1,1,544620,60990,69920,38036,0.56495238800993,0.384101145153798
28312,0.6942539682539683,0,2,0,544622,60988,69920,38036,0.5649338619437548,0.38410890289222815
28313,0.6942857142857142,0,1,0,544623,60987,69920,38036,0.5649245989106673,0.3841127818789574
28314,0.6942857142857143,3,6,3,544629,60981,69923,38033,0.564869020712142,0.38411739753974183
28315,0.6943333333333332,0,3,0,544632,60978,69923,38033,0.5648412316128794,0.38412903616769856
28316,0.6943333333333334,7,22,7,544654,60956,69930,38026,0.5646374448849532,0.3841708593481643
28317,0.6943809523809524,1,0,1,544654,60956,69931,38025,0.5646374448849532,0.3841646376577323
28318,0.6943888888888888,1,0,1,544654,60956,69932,38024,0.5646374448849532,0.38415841584158417
28319,0.6944047619047619,0,1,0,544655,60955,69932,38024,0.5646281818518656,0.3841622970529102
28320,0.6944230769230769,1,0,1,544655,60955,69933,38023,0.5646281818518656,0.38415607508739313
28321,0.6944444444444444,0,2,0,544657,60953,69933,38023,0.5646096557856904,0.3841638376980278
28322,0.6944999999999999,0,6,0,544663,60947,69933,38023,0.5645540775871651,0.3841871274123472
28323,0.6945,4,6,4,544669,60941,69937,38019,0.5644984993886398,0.38418552950687146
28324,0.6945000000000001,0,1,0,544670,60940,69937,38019,0.5644892363555523,0.3841894117765943
28325,0.6945714285714285,0,1,0,544671,60939,69937,38019,0.5644799733224647,0.3841932941247802
28326,0.6945833333333334,0,1,0,544672,60938,69937,38019,0.5644707102893771,0.38419717655143143
28327,0.6946269841269839,0,1,0,544673,60937,69937,38019,0.5644614472562896,0.3842010590565504
28328,0.6946428571428572,1,0,1,544673,60937,69938,38018,0.5644614472562896,0.3841948360365823
28329,0.6946666666666665,1,4,1,544677,60933,69939,38017,0.5644243951239394,0.38420414350682164
28330,0.6946666666666667,6,10,6,544687,60923,69945,38011,0.5643317647930638,0.38420563203751995
28331,0.6946666666666669,0,1,0,544688,60922,69945,38011,0.5643225017599763,0.3842095155307127
28332,0.6947142857142857,0,1,0,544689,60921,69945,38011,0.5643132387268888,0.38421339910241376
28333,0.6947261904761904,0,1,0,544690,60920,69945,38011,0.5643039756938012,0.38421728275262557
28334,0.69475,0,1,0,544691,60919,69945,38011,0.5642947126607136,0.38422116648135046
28335,0.6947619047619047,0,2,0,544693,60917,69945,38011,0.5642761865945385,0.384228934174349
28336,0.6948333333333332,1,2,1,544695,60915,69946,38010,0.5642576605283635,0.38423047763457163
28337,0.6948333333333333,0,6,0,544701,60909,69946,38010,0.564202082329838,0.3842537833985382
28338,0.6948333333333335,1,2,1,544703,60907,69947,38009,0.564183556263663,0.38425532775284077
28339,0.6948452380952381,1,1,1,544704,60906,69948,38008,0.5641742932305754,0.3842529874436379
28340,0.6948809523809524,0,1,0,544705,60905,69948,38008,0.5641650301974879,0.38425687220082294
28341,0.6948928571428571,0,2,0,544707,60903,69948,38008,0.5641465041313127,0.3842646419508447
28342,0.6949047619047619,0,3,0,544710,60900,69948,38008,0.5641187150320501,0.38427629716504225
28343,0.6949166666666666,0,1,0,544711,60899,69948,38008,0.5641094519989626,0.38428018239356165
28344,0.694952380952381,0,1,0,544712,60898,69948,38008,0.564100188965875,0.38428406770064505
28345,0.6949999999999998,4,9,4,544721,60889,69952,38004,0.564016821668087,0.3842941360864773
28346,0.695,199,474,199,545195,60415,70151,37805,0.5596261439845863,0.38490124210955
28347,0.6950000000000002,1,2,1,545197,60413,70152,37804,0.5596076179184112,0.3849028172312329
28348,0.6951428571428571,1,0,1,545197,60413,70153,37803,0.5596076179184112,0.3848965545328663
28349,0.6951666666666665,1,1,1,545198,60412,70154,37802,0.5595983548853236,0.38489421060133994
28350,0.6951666666666667,1,11,1,545209,60401,70155,37801,0.5594964615213606,0.38493106046720027
28351,0.6951666666666668,0,3,0,545212,60398,70155,37801,0.5594686724220979,0.38494282019165166
28352,0.6952380952380952,1,2,1,545214,60396,70156,37800,0.5594501463559228,0.3849443969204448
28353,0.6952438672438673,0,1,0,545215,60395,70156,37800,0.5594408833228353,0.38494831712408983
28354,0.69525,0,1,0,545216,60394,70156,37800,0.5594316202897477,0.3849522374075809
28355,0.6952914030414028,0,2,0,545218,60392,70156,37800,0.5594130942235725,0.38496007821411116
28356,0.6953333333333334,3,14,3,545232,60378,70159,37797,0.5592834117603468,0.3849961802902979
28357,0.6953333333333335,0,2,0,545234,60376,70159,37797,0.5592648856941717,0.3850040235095189
28358,0.6953571428571428,1,0,1,545234,60376,70160,37796,0.5592648856941717,0.38499775903516276
28359,0.6953690476190475,1,2,1,545236,60374,70161,37795,0.5592463596279966,0.3849993378765191
28360,0.6953809523809524,0,1,0,545237,60373,70161,37795,0.5592370965949091,0.3850032597180344
28361,0.6954166666666667,0,1,0,545238,60372,70161,37795,0.5592278335618215,0.38500718163945113
28362,0.6954285714285714,0,1,0,545239,60371,70161,37795,0.5592185705287339,0.38501110364077173
28363,0.6954444444444444,0,2,0,545241,60369,70161,37795,0.5592000444625588,0.38501894788313434
28364,0.6954761904761905,0,2,0,545243,60367,70161,37795,0.5591815183963837,0.3850267924451417
28365,0.6955,1,12,1,545255,60355,70162,37794,0.559070361999333,0.3850676013000642
28366,0.6955000000000001,0,1,0,545256,60354,70162,37794,0.5590610989662456,0.3850715246362636
28367,0.6955303438391672,0,3,0,545259,60351,70162,37794,0.5590333098669829,0.3850832951245606
28368,0.6956190476190476,0,2,0,545261,60349,70162,37794,0.5590147838008077,0.385091142516532
28369,0.6956190476190477,1,0,1,545261,60349,70163,37793,0.5590147838008077,0.38508487701493754
28370,0.6956388888888888,0,1,0,545262,60348,70163,37793,0.5590055207677201,0.3850888008070022
28371,0.6956428571428571,0,2,0,545264,60346,70163,37793,0.5589869947015451,0.38509664863102333
28372,0.6956666666666667,5,7,5,545271,60339,70168,37788,0.5589221534699322,0.3850927879176985
28373,0.6956666666666668,0,3,0,545274,60336,70168,37788,0.5588943643706695,0.38510456157514983
28374,0.6956904761904761,1,0,1,545274,60336,70169,37787,0.5588943643706695,0.38509829499709547
28375,0.6957142857142857,5,6,5,545280,60330,70174,37782,0.5588387861721442,0.3850905088062622
28376,0.6957499999999999,0,1,0,545281,60329,70174,37782,0.5588295231390566,0.385094433855531
28377,0.6957500000000002,0,1,0,545282,60328,70174,37782,0.5588202601059691,0.385098358984813
28378,0.6957637085137085,0,5,0,545287,60323,70174,37782,0.5587739449405313,0.3851179858315071
28379,0.6958095238095239,0,1,0,545288,60322,70174,37782,0.5587646819074438,0.38512191144091984
28380,0.6958333333333333,4,29,4,545317,60293,70178,37778,0.5584960539479047,0.3852107146862987
28381,0.6958333333333334,13,29,13,545346,60264,70191,37765,0.5582274259883656,0.38524314233543133
28382,0.695952380952381,0,3,0,545349,60261,70191,37765,0.558199636889103,0.3852549323648828
28383,0.6959761904761905,0,1,0,545350,60260,70191,37765,0.5581903738560154,0.3852588625350676
28384,0.696,26,46,26,545396,60214,70217,37739,0.5577642743339879,0.3852766122528151
28385,0.6960000000000001,2,2,2,545398,60212,70219,37737,0.5577457482678128,0.3852719272274347
28386,0.6960238095238094,1,1,1,545399,60211,70220,37736,0.5577364852347253,0.3852695845712477
28387,0.696047619047619,0,1,0,545400,60210,70220,37736,0.5577272222016377,0.3852735180609724
28388,0.6960714285714286,0,1,0,545401,60209,70220,37736,0.5577179591685502,0.3852774516310174
28389,0.6961031746031745,0,1,0,545402,60208,70220,37736,0.5577086961354626,0.3852813852813853
28390,0.6961111111111111,1,4,1,545406,60204,70221,37735,0.5576716440031124,0.38529084430104454
28391,0.6961190476190475,1,0,1,545406,60204,70222,37734,0.5576716440031124,0.3852845677877841
28392,0.6961309523809525,0,2,0,545408,60202,70222,37734,0.5576531179369373,0.38529243587649076
28393,0.6961428571428572,0,2,0,545410,60200,70222,37734,0.5576345918707621,0.3853003042865603
28394,0.6961666666666665,0,1,0,545411,60199,70222,37734,0.5576253288376746,0.3853042386121124
28395,0.6961666666666666,3,4,3,545415,60195,70225,37731,0.5575882767053244,0.38530114576312724
28396,0.6961666666666667,0,8,0,545423,60187,70225,37731,0.557514172440624,0.3853326252578688
28397,0.6961904761904762,1,2,1,545425,60185,70226,37730,0.5574956463744488,0.3853342184547822
28398,0.6962438672438672,0,3,0,545428,60182,70226,37730,0.5574678572751862,0.3853460250020426
28399,0.69625,1,2,1,545430,60180,70227,37729,0.5574493312090111,0.3853476187071669
28400,0.6962777777777778,0,1,0,545431,60179,70227,37729,0.5574400681759235,0.38535155452057035
28401,0.6963095238095238,0,1,0,545432,60178,70227,37729,0.5574308051428359,0.38535549041437284
28402,0.6963333333333332,4,6,4,545438,60172,70231,37725,0.5573752269443106,0.38535399450442814
28403,0.6963333333333334,1,4,1,545442,60168,70232,37724,0.5573381748119605,0.38536346177420017
28404,0.6963571428571429,0,1,0,545443,60167,70232,37724,0.5573289117788729,0.3853673984329509
28405,0.6964047619047617,1,0,1,545443,60167,70233,37723,0.5573289117788729,0.3853611196240678
28406,0.6964062049062048,0,3,0,545446,60164,70233,37723,0.5573011226796102,0.38537293001113526
28407,0.6964285714285714,0,2,0,545448,60162,70233,37723,0.5572825966134352,0.3853808040046994
28408,0.6964285714285715,1,0,1,545448,60162,70234,37722,0.5572825966134352,0.38537452494789753
28409,0.696452380952381,0,2,0,545450,60160,70234,37722,0.55726407054726,0.3853823992153818
28410,0.6964761904761904,0,1,0,545451,60159,70234,37722,0.5572548075141724,0.385386336469795
28411,0.6964761904761906,1,0,1,545451,60159,70235,37721,0.5572548075141724,0.3853800572129138
28412,0.6964999999999999,1,4,1,545455,60155,70236,37720,0.5572177553818223,0.385389527458493
28413,0.6965,3,11,3,545466,60144,70239,37717,0.5571158620178591,0.38541400557934213
28414,0.6965238095238095,0,2,0,545468,60142,70239,37717,0.557097335951684,0.3854218825044196
28415,0.6966190476190478,0,1,0,545469,60141,70239,37717,0.5570880729185964,0.3854258210876985
28416,0.6966666666666665,70,170,70,545639,59971,70309,37647,0.5555133572937122,0.3856563338728513
28417,0.6966666666666668,48,111,48,545750,59860,70357,37599,0.5544851606209937,0.3857930001333894
28418,0.69675,1,0,1,545750,59860,70358,37598,0.5544851606209937,0.3857866978595908
28419,0.6967619047619047,0,1,0,545751,59859,70358,37598,0.5544758975879062,0.38579065639204985
28420,0.6967738095238096,0,1,0,545752,59858,70358,37598,0.5544666345548186,0.3857946150057462
28421,0.6967777777777777,1,0,1,545752,59858,70359,37597,0.5544666345548186,0.38578831255451235
28422,0.6967777777777779,0,1,0,545753,59857,70359,37597,0.554457371521731,0.38579227122539866
28423,0.6967857142857145,2,0,2,545753,59857,70361,37595,0.554457371521731,0.3857796658867956
28424,0.6968095238095238,0,1,0,545754,59856,70361,37595,0.5544481084886436,0.38578362459082
28425,0.6968333333333332,0,1,0,545755,59855,70361,37595,0.554438845455556,0.3857875833760903
28426,0.6968333333333334,2,11,2,545766,59844,70363,37593,0.5543369520915928,0.3858185288955941
28427,0.6968809523809523,0,1,0,545767,59843,70363,37593,0.5543276890585053,0.38582248860790674
28428,0.6968888888888888,0,1,0,545768,59842,70363,37593,0.5543184260254178,0.38582644840149843
28429,0.696888888888889,0,2,0,545770,59840,70363,37593,0.5542998999592427,0.38583436823252903
28430,0.696952380952381,1,0,1,545770,59840,70364,37592,0.5542998999592427,0.3858280647015354
28431,0.6969642857142857,0,1,0,545771,59839,70364,37592,0.5542906369261551,0.38583202471492645
28432,0.6969999999999998,2,1,2,545772,59838,70366,37590,0.5542813738930675,0.38582337726320975
28433,0.6970000000000001,6,14,6,545786,59824,70372,37584,0.5541516914298418,0.3858409986859396
28434,0.6970000000000002,0,4,0,545790,59820,70372,37584,0.5541146392974916,0.3858568436614513
28435,0.6970714285714286,0,1,0,545791,59819,70372,37584,0.554105376264404,0.3858608051086722
28436,0.6971428571428571,1,1,1,545792,59818,70373,37583,0.5540961132313165,0.3858584614121005
28437,0.6971428571428572,1,7,1,545799,59811,70374,37582,0.5540312719997036,0.3858798886983664
28438,0.6971666666666665,0,1,0,545800,59810,70374,37582,0.554022008966616,0.38588385082963694
28439,0.6971666666666667,7,2,7,545802,59808,70381,37575,0.5540034829004409,0.3858476325436678
28440,0.6972023809523809,0,2,0,545804,59806,70381,37575,0.5539849568342659,0.38585555703884744
28441,0.6972142857142856,0,2,0,545806,59804,70381,37575,0.5539664307680907,0.3858634818595385
28442,0.6972142857142858,0,1,0,545807,59803,70381,37575,0.5539571677350031,0.38586744439195714
28443,0.6972348484848486,2,1,2,545808,59802,70383,37573,0.5539479047019156,0.38585879332477535
28444,0.6972380952380952,1,0,1,545808,59802,70384,37572,0.5539479047019156,0.38585248628997476
28445,0.6972499999999999,1,2,1,545810,59800,70385,37571,0.5539293786357404,0.3858541044048023
28446,0.6972777777777779,0,1,0,545811,59799,70385,37571,0.553920115602653,0.38585806716647836
28447,0.697297619047619,0,1,0,545812,59798,70385,37571,0.5539108525695654,0.38586203000955127
28448,0.6973333333333332,1,5,1,545817,59793,70386,37570,0.5538645374041276,0.38587553793535534
28449,0.6973333333333334,8,14,8,545831,59779,70394,37562,0.5537348549409018,0.3858805642021348
28450,0.6973333333333335,2,0,2,545831,59779,70396,37560,0.5537348549409018,0.38586794604423713
28451,0.6973571428571429,0,1,0,545832,59778,70396,37560,0.5537255919078143,0.38587191025087836
28452,0.6973809523809522,1,0,1,545832,59778,70397,37559,0.5537255919078143,0.38586560095338873
28453,0.6974047619047619,0,2,0,545834,59776,70397,37559,0.5537070658416392,0.3858735295628499
28454,0.6974444444444445,0,1,0,545835,59775,70397,37559,0.5536978028085516,0.3858774939897672
28455,0.6974523809523809,0,1,0,545836,59774,70397,37559,0.5536885397754641,0.38588145849814554
28456,0.6974722222222222,1,0,1,545836,59774,70398,37558,0.5536885397754641,0.3858751489746435
28457,0.6974999999999999,0,3,0,545839,59771,70398,37558,0.5536607506762015,0.3858870429162942
28458,0.6975,47,126,47,545965,59645,70445,37511,0.5524936085071696,0.38609041129729504
28459,0.6975000000000001,1,2,1,545967,59643,70446,37510,0.5524750824409945,0.38609204038990047
28460,0.6975238095238094,0,2,0,545969,59641,70446,37510,0.5524565563748194,0.3860999886774197
28461,0.6975476190476191,0,1,0,545970,59640,70446,37510,0.5524472933417318,0.3861039629439012
28462,0.6975476190476193,1,2,1,545972,59638,70447,37509,0.5524287672755567,0.3861055925556116
28463,0.6975833333333332,0,1,0,545973,59637,70447,37509,0.5524195042424691,0.3861095670434192
28464,0.6976190476190475,0,2,0,545975,59635,70447,37509,0.5524009781762941,0.3861175162645145
28465,0.6976190476190476,0,2,0,545977,59633,70447,37509,0.5523824521101189,0.38612546581293367
28466,0.6976309523809525,0,1,0,545978,59632,70447,37509,0.5523731890770314,0.3861294407098959
28467,0.697642857142857,0,3,0,545981,59629,70447,37509,0.5523453999777688,0.386141365891824
28468,0.6976666666666665,0,1,0,545982,59628,70447,37509,0.5523361369446812,0.38614534111615556
28469,0.6976666666666667,4,8,4,545990,59620,70451,37505,0.5522620326799808,0.38615186615186614
28470,0.6976666666666668,1,5,1,545995,59615,70452,37504,0.552215717514543,0.3861654259207776
28471,0.6977142857142857,0,1,0,545996,59614,70452,37504,0.5522064544814554,0.3861694021705554
28472,0.6977380952380952,0,1,0,545997,59613,70452,37504,0.5521971914483679,0.386173378502219
28473,0.6977619047619047,1,1,1,545998,59612,70453,37503,0.5521879284152803,0.3861710343407301
28474,0.6977777777777778,0,1,0,545999,59611,70453,37503,0.5521786653821927,0.3861750108120353
28475,0.6977976190476189,0,2,0,546001,59609,70453,37503,0.5521601393160176,0.38618296400032953
28476,0.6978095238095239,0,1,0,546002,59608,70453,37503,0.5521508762829301,0.38618694071732346
28477,0.6978333333333333,1,6,1,546008,59602,70454,37502,0.5520952980844047,0.3862044817927171
28478,0.6978333333333334,0,1,0,546009,59601,70454,37502,0.5520860350513173,0.3862084590589374
28479,0.6979166666666665,0,1,0,546010,59600,70454,37502,0.5520767720182297,0.3862124364070771
28480,0.6979682539682541,0,1,0,546011,59599,70454,37502,0.5520675089851421,0.3862164138371387
28481,0.6979761904761904,0,1,0,546012,59598,70454,37502,0.5520582459520545,0.3862203913491246
28482,0.6979761904761905,1,0,1,546012,59598,70455,37501,0.5520582459520545,0.38621407017579995
28483,0.6979848484848484,0,1,0,546013,59597,70455,37501,0.552048982918967,0.3862180477455766
28484,0.6979999999999998,1,1,1,546014,59596,70456,37500,0.5520397198858794,0.3862157040454808
28485,0.698,11,40,11,546054,59556,70467,37489,0.5516691985623773,0.3863053222731722
28486,0.6980000000000001,0,3,0,546057,59553,70467,37489,0.5516414094631146,0.3863172646895159
28487,0.6981428571428572,0,1,0,546058,59552,70467,37489,0.551632146430027,0.38632124565905135
28488,0.6981666666666665,0,1,0,546059,59551,70467,37489,0.5516228833969395,0.3863252267106348
28489,0.6981666666666666,1,13,1,546072,59538,70468,37488,0.5515024639668012,0.38637066353348587
28490,0.6981666666666668,1,3,1,546075,59535,70469,37487,0.5514746748675387,0.38637628579085154
28491,0.6981774891774889,0,1,0,546076,59534,70469,37487,0.5514654118344511,0.38638026818936105
28492,0.6981904761904763,0,1,0,546077,59533,70469,37487,0.5514561488013635,0.38638425066996496
28493,0.6982142857142857,0,1,0,546078,59532,70469,37487,0.5514468857682759,0.38638823323266575
28494,0.6982738095238095,0,1,0,546079,59531,70469,37487,0.5514376227351884,0.386392215877466
28495,0.6982777777777778,0,1,0,546080,59530,70469,37487,0.5514283597021008,0.3863961986043683
28496,0.6982857142857144,0,1,0,546081,59529,70469,37487,0.5514190966690133,0.3864001814133751
28497,0.6983333333333333,30,58,30,546139,59471,70499,37457,0.5508818407499352,0.3864414823374051
28498,0.6983333333333335,21,71,21,546210,59400,70520,37436,0.5502241654007188,0.38659176339377915
28499,0.6983571428571429,0,1,0,546211,59399,70520,37436,0.5502149023676313,0.386595755666856
28500,0.6983809523809523,1,1,1,546212,59398,70521,37435,0.5502056393345437,0.3865934134024558
28501,0.6984126984126982,0,1,0,546213,59397,70521,37435,0.5501963763014561,0.38659740581625907
28502,0.6984166666666667,0,1,0,546214,59396,70521,37435,0.5501871132683686,0.3866013983125239
28503,0.698452380952381,1,0,1,546214,59396,70522,37434,0.5501871132683686,0.38659506351337397
28504,0.6984761904761904,0,1,0,546215,59395,70522,37434,0.550177850235281,0.38659905606791356
28505,0.6984772727272726,0,2,0,546217,59393,70522,37434,0.550159324169106,0.3866070414243961
28506,0.6984999999999999,4,12,4,546229,59381,70526,37430,0.5500481677720552,0.3866296185350838
28507,0.698547619047619,0,1,0,546230,59380,70526,37430,0.5500389047389678,0.38663361223014153
28508,0.6985714285714286,0,3,0,546233,59377,70526,37430,0.5500111156397051,0.38664559381036495
28509,0.6985714285714287,0,1,0,546234,59376,70526,37430,0.5500018526066175,0.38664958783546477
28510,0.6986428571428571,0,2,0,546236,59374,70526,37430,0.5499833265404424,0.38665757613321766
28511,0.6986666666666664,0,1,0,546237,59373,70526,37430,0.5499740635073549,0.38666157040587584
28512,0.6986666666666665,3,4,3,546241,59369,70529,37427,0.5499370113750046,0.38665853960907476
28513,0.6986666666666668,4,13,4,546254,59356,70533,37423,0.5498165919448664,0.3866851279719774
28514,0.6986825396825397,0,2,0,546256,59354,70533,37423,0.5497980658786913,0.3866931192328756
28515,0.6986904761904762,0,1,0,546257,59353,70533,37423,0.5497888028456037,0.3866971149871869
28516,0.6987142857142856,1,1,1,546258,59352,70534,37422,0.5497795398125163,0.3866947733895468
28517,0.6987380952380953,0,2,0,546260,59350,70534,37422,0.5497610137463411,0.38670276526267927
28518,0.69875,1,3,1,546263,59347,70535,37421,0.5497332246470784,0.386708416005291
28519,0.6988095238095237,0,1,0,546264,59346,70535,37421,0.5497239616139908,0.3867124122893135
28520,0.6988333333333333,2,7,2,546271,59339,70537,37419,0.549659120382378,0.3867277124372145
28521,0.6988333333333334,0,3,0,546274,59336,70537,37419,0.5496313312831154,0.3867397033745026
28522,0.6988690476190476,0,1,0,546275,59335,70537,37419,0.5496220682500278,0.3867437005188416
28523,0.6988809523809525,1,0,1,546275,59335,70538,37418,0.5496220682500278,0.3867373621489773
28524,0.6988846153846151,0,1,0,546276,59334,70538,37418,0.5496128052169402,0.38674135935174464
28525,0.6988888888888889,0,1,0,546277,59333,70538,37418,0.5496035421838527,0.3867453566371407
28526,0.6989166666666665,0,1,0,546278,59332,70538,37418,0.5495942791507651,0.38674935400516797
28527,0.6989166666666666,1,0,1,546278,59332,70539,37417,0.5495942791507651,0.38674301543168405
28528,0.6989285714285713,2,1,2,546279,59331,70541,37415,0.5495850161176776,0.3867343352696752
28529,0.6989444444444447,1,0,1,546279,59331,70542,37414,0.5495850161176776,0.38672799627887744
28530,0.698952380952381,0,1,0,546280,59330,70542,37414,0.5495757530845901,0.38673199371537254
28531,0.699,0,2,0,546282,59328,70542,37414,0.5495572270184149,0.3867399888362862
28532,0.6990000000000001,5,29,5,546311,59299,70547,37409,0.5492885990588758,0.38682425445671503
28533,0.699047619047619,2,0,2,546311,59299,70549,37407,0.5492885990588758,0.3868115732219304
28534,0.6990833333333333,0,1,0,546312,59298,70549,37407,0.5492793360257883,0.38681557313479137
28535,0.699095238095238,0,1,0,546313,59297,70549,37407,0.5492700729927007,0.38681957313037724
28536,0.6991190476190476,1,0,1,546313,59297,70550,37406,0.5492700729927007,0.38681323226787173
28537,0.6991428571428571,1,0,1,546313,59297,70551,37405,0.5492700729927007,0.3868068912742239
28538,0.6991666666666666,14,35,14,546348,59262,70565,37391,0.5489458668346363,0.3868581420131812
28539,0.6991666666666667,6,26,6,546374,59236,70571,37385,0.5487050279743599,0.3869241676240155
28540,0.6991666666666668,2,4,2,546378,59232,70573,37383,0.5486679758420097,0.38692749573047663
28541,0.6992142857142858,0,1,0,546379,59231,70573,37383,0.5486587128089222,0.38693150061067755
28542,0.6992142857142859,0,1,0,546380,59230,70573,37383,0.5486494497758346,0.3869355055737841
28543,0.6992438672438671,0,1,0,546381,59229,70573,37383,0.5486401867427471,0.3869395106197988
28544,0.6992857142857142,0,1,0,546382,59228,70573,37383,0.5486309237096595,0.38694351574872426
28545,0.6992857142857143,2,1,2,546383,59227,70575,37381,0.5486216606765719,0.38693482941371315
28546,0.6993095238095239,1,2,1,546385,59225,70576,37380,0.5486031346103968,0.3869364939702914
28547,0.6993333333333333,1,2,1,546387,59223,70577,37379,0.5485846085442218,0.3869381586302561
28548,0.6993333333333334,3,15,3,546402,59208,70580,37376,0.5484456630479084,0.3869792098070074
28549,0.6993403540903542,1,0,1,546402,59208,70581,37375,0.5484456630479084,0.3869728627191121
28550,0.6993571428571428,0,1,0,546403,59207,70581,37375,0.5484364000148209,0.3869768693959537
28551,0.6993809523809524,0,1,0,546404,59206,70581,37375,0.5484271369817333,0.38698087615576565
28552,0.6994047619047619,0,2,0,546406,59204,70581,37375,0.5484086109155581,0.3869888899243107
28553,0.6994047619047621,0,2,0,546408,59202,70581,37375,0.5483900848493831,0.38699690402476783
28554,0.6994166666666666,1,1,1,546409,59201,70582,37374,0.5483808218162955,0.38699456381050995
28555,0.6994920634920635,0,1,0,546410,59200,70582,37374,0.548371558783208,0.3869985710439663
28556,0.6994953102453101,0,1,0,546411,59199,70582,37374,0.5483622957501204,0.3870025783604113
28557,0.6994999999999999,3,3,3,546414,59196,70585,37371,0.5483345066508578,0.38699555748858305
28558,0.6995,2,9,2,546423,59187,70587,37369,0.5482511393530698,0.3870189320187249
28559,0.6995238095238094,0,1,0,546424,59186,70587,37369,0.5482418763199822,0.3870229402930972
28560,0.6995714285714285,0,2,0,546426,59184,70587,37369,0.5482233502538071,0.38703095709092417
28561,0.6995833333333333,1,2,1,546428,59182,70588,37368,0.548204824187632,0.3870326255825997
28562,0.6995833333333334,0,1,0,546429,59181,70588,37368,0.5481955611545445,0.38703663424789486
28563,0.699595238095238,0,2,0,546431,59179,70588,37368,0.5481770350883693,0.3870446518276073
28564,0.6996007326007327,0,1,0,546432,59178,70588,37368,0.5481677720552818,0.3870486607420297
28565,0.6996190476190478,0,1,0,546433,59177,70588,37368,0.5481585090221942,0.3870526697394997
28566,0.6996666666666665,2,4,2,546437,59173,70590,37366,0.548121456889844,0.3870560084525425
28567,0.6996666666666667,3,17,3,546454,59156,70593,37363,0.5479639853273556,0.387105129559983
28568,0.6996904761904762,0,2,0,546456,59154,70593,37363,0.5479454592611804,0.38711315105111016
28569,0.6996904761904763,0,1,0,546457,59153,70593,37363,0.547936196228093,0.3871171619213395
28570,0.69975,0,3,0,546460,59150,70593,37363,0.5479084071288303,0.38712919503072124
28571,0.6997500000000001,0,1,0,546461,59149,70593,37363,0.5478991440957427,0.38713320623342173
28572,0.6997619047619048,1,2,1,546463,59147,70594,37362,0.5478806180295676,0.3871348786123574
28573,0.6997857142857141,0,1,0,546464,59146,70594,37362,0.5478713549964801,0.3871388900402039
28574,0.6998333333333332,3,4,3,546468,59142,70597,37359,0.5478343028641298,0.3871358846022321
28575,0.6998333333333333,3,7,3,546475,59135,70600,37356,0.5477694616325169,0.38714491506979926
28576,0.6998333333333335,0,2,0,546477,59133,70600,37356,0.5477509355663418,0.3871529397133352
28577,0.699857142857143,0,3,0,546480,59130,70600,37356,0.5477231464670792,0.38716497730240657
28578,0.6998809523809524,0,1,0,546481,59129,70600,37356,0.5477138834339916,0.38716898999844535
28579,0.6999444444444446,0,1,0,546482,59128,70600,37356,0.5477046204009041,0.38717300277766264
28580,0.6999523809523811,0,1,0,546483,59127,70600,37356,0.5476953573678165,0.38717701564006096
28581,0.6999999999999998,2,4,2,546487,59123,70602,37354,0.5476583052354663,0.38718036423188945
28582,0.7,626,1446,626,547933,57677,71228,36728,0.5342639593908629,0.3890471902971241
28583,0.7000000000000002,1,6,1,547939,57671,71229,36727,0.5342083811923376,0.38906544630182843
28584,0.7000079365079366,0,1,0,547940,57670,71229,36727,0.53419911815925,0.38906956788881003
28585,0.7000238095238095,0,4,0,547944,57666,71229,36727,0.5341620660268999,0.38908605511001876
28586,0.700047619047619,0,1,0,547945,57665,71229,36727,0.5341528029938123,0.3890901771336554
28587,0.7000592185592184,0,5,0,547950,57660,71229,36727,0.5341064878283746,0.38911078856198417
28588,0.7000833333333333,0,1,0,547951,57659,71229,36727,0.534097224795287,0.3891149111096985
28589,0.7001060606060606,0,1,0,547952,57658,71229,36727,0.5340879617621994,0.38911903374476875
28590,0.7001190476190478,0,1,0,547953,57657,71229,36727,0.5340786987291118,0.3891231564671978
28591,0.7001666666666665,0,1,0,547954,57656,71229,36727,0.5340694356960243,0.3891272792769884
28592,0.7001666666666666,3,9,3,547963,57647,71232,36724,0.5339860683982364,0.3891449703828507
28593,0.7001666666666668,0,2,0,547965,57645,71232,36724,0.5339675423320612,0.389153217688012
28594,0.7002023809523809,0,2,0,547967,57643,71232,36724,0.5339490162658861,0.38916146534275753
28595,0.7002305764411028,0,1,0,547968,57642,71232,36724,0.5339397532327985,0.38916558930123135
28596,0.7002380952380952,1,1,1,547969,57641,71233,36723,0.533930490199711,0.3891632402187275
28597,0.70025,0,1,0,547970,57640,71233,36723,0.5339212271666235,0.38916736432711974
28598,0.7002777777777777,0,1,0,547971,57639,71233,36723,0.5339119641335359,0.3891714885229224
28599,0.7002857142857143,0,1,0,547972,57638,71233,36723,0.5339027011004484,0.3891756128061381
28600,0.7003333333333334,1,14,1,547986,57624,71234,36722,0.5337730186372226,0.38922688826235347
28601,0.7003333333333335,0,1,0,547987,57623,71234,36722,0.533763755604135,0.38923101383221154
28602,0.7003499278499277,0,1,0,547988,57622,71234,36722,0.5337544925710475,0.3892351394895277
28603,0.7003571428571428,1,0,1,547988,57622,71235,36721,0.5337544925710475,0.389228665613771
28604,0.7003928571428572,0,1,0,547989,57621,71235,36721,0.5337452295379599,0.3892327913336584
28605,0.700452380952381,1,0,1,547989,57621,71236,36720,0.5337452295379599,0.38922631729576745
28606,0.7004761904761904,1,0,1,547989,57621,71237,36719,0.5337452295379599,0.3892198431206275
28607,0.7004999999999998,0,1,0,547990,57620,71237,36719,0.5337359665048723,0.3892239688781946
28608,0.7005,2,10,2,548000,57610,71239,36717,0.5336433361739968,0.38925228195532563
28609,0.7005000000000001,0,2,0,548002,57608,71239,36717,0.5336248101078217,0.3892605353829844
28610,0.7005032467532467,0,1,0,548003,57607,71239,36717,0.5336155470747341,0.389264662228065
28611,0.7005238095238095,1,1,1,548004,57606,71240,36716,0.5336062840416466,0.3892623142002926
28612,0.7006309523809524,0,1,0,548005,57605,71240,36716,0.533597021008559,0.389266441195492
28613,0.7006428571428571,0,1,0,548006,57604,71240,36716,0.5335877579754715,0.3892705682782019
28614,0.7006626984126985,0,1,0,548007,57603,71240,36716,0.533578494942384,0.389274695448425
28615,0.7006666666666664,0,1,0,548008,57602,71240,36716,0.5335692319092964,0.38927882270616426
28616,0.7006666666666667,4,21,4,548029,57581,71244,36712,0.5333747082144578,0.38933961163607056
28617,0.7006666666666668,1,4,1,548033,57577,71245,36711,0.5333376560821075,0.38934965212964534
28618,0.7007142857142857,1,3,1,548036,57574,71246,36710,0.5333098669828449,0.3893555640405583
28619,0.7007142857142858,0,1,0,548037,57573,71246,36710,0.5333006039497573,0.38935969368815165
28620,0.7007380952380953,0,1,0,548038,57572,71246,36710,0.5332913409166697,0.38936382342334697
28621,0.70075,0,2,0,548040,57570,71246,36710,0.5332728148504946,0.3893720831565549
28622,0.7008333333333332,0,2,0,548042,57568,71246,36710,0.5332542887843196,0.3893803432402045
28623,0.7008333333333333,6,20,6,548062,57548,71252,36704,0.5330690281225684,0.38942409710138776
28624,0.7008333333333334,13,30,13,548092,57518,71265,36691,0.5327911371299419,0.3894638516489932
28625,0.7009166666666666,0,1,0,548093,57517,71265,36691,0.5327818740968543,0.3894679857336957
28626,0.7009220779220778,1,3,1,548096,57514,71266,36690,0.5327540849975916,0.3894739076896947
28627,0.7009285714285715,0,2,0,548098,57512,71266,36690,0.5327355589314166,0.38948217659922296
28628,0.700952380952381,1,2,1,548100,57510,71267,36689,0.5327170328652414,0.3894839647979278
28629,0.7009642857142856,0,2,0,548102,57508,71267,36689,0.5326985067990663,0.3894922343599053
28630,0.7009761904761905,0,1,0,548103,57507,71267,36689,0.5326892437659787,0.3894963692725806
28631,0.701,6,18,6,548121,57489,71273,36683,0.5325225091704028,0.3895319203160175
28632,0.7010000000000001,0,3,0,548124,57486,71273,36683,0.5324947200711401,0.389544329875012
28633,0.7010400710400709,0,1,0,548125,57485,71273,36683,0.5324854570380525,0.38954846657038483
28634,0.7010476190476189,0,1,0,548126,57484,71273,36683,0.5324761940049649,0.38955260335361647
28635,0.7010714285714286,0,1,0,548127,57483,71273,36683,0.5324669309718775,0.38955674022470954
28636,0.7011428571428573,0,1,0,548128,57482,71273,36683,0.5324576679387899,0.38956087718366694
28637,0.7011666666666666,0,1,0,548129,57481,71273,36683,0.5324484049057023,0.3895650142304915
28638,0.7011666666666667,4,4,4,548133,57477,71277,36679,0.532411352773352,0.38955563108033475
28639,0.7011904761904763,1,0,1,548133,57477,71278,36678,0.532411352773352,0.3895491476820137
28640,0.701202380952381,0,1,0,548134,57476,71278,36678,0.5324020897402646,0.3895532850436519
28641,0.7012142857142857,0,1,0,548135,57475,71278,36678,0.532392826707177,0.389557422493176
28642,0.7012380952380951,0,2,0,548137,57473,71278,36678,0.5323743006410019,0.3895656976558932
28643,0.70125,0,3,0,548140,57470,71278,36678,0.5323465115417392,0.38957811105918344
28644,0.7013174603174605,1,2,1,548142,57468,71279,36677,0.5323279854755641,0.3895799033405916
28645,0.7013333333333333,7,11,7,548153,57457,71286,36670,0.532226092111601,0.3895800354839738
28646,0.7013333333333334,0,8,0,548161,57449,71286,36670,0.5321519878469005,0.3896131493109787
28647,0.7013333333333336,1,1,1,548162,57448,71287,36669,0.5321427248138131,0.3896108035742746
28648,0.7013751248751248,0,2,0,548164,57446,71287,36669,0.5321241987476379,0.3896190830367104
28649,0.7014166666666665,0,3,0,548167,57443,71287,36669,0.5320964096483752,0.3896315028901734
28650,0.7014184704184703,1,2,1,548169,57441,71288,36668,0.5320778835822002,0.3896332975592133
28651,0.7014285714285714,1,0,1,548169,57441,71289,36667,0.5320778835822002,0.3896268117482042
28652,0.7014285714285715,2,0,2,548169,57441,71291,36665,0.5320778835822002,0.38961383971266444
28653,0.7014545454545456,1,0,1,548169,57441,71292,36664,0.5320778835822002,0.389607353488125
28654,0.7014999999999999,2,3,2,548172,57438,71294,36662,0.5320500944829375,0.3896068012752391
28655,0.7015,5,3,5,548175,57435,71299,36657,0.5320223053836748,0.38958678739956637
28656,0.7015000000000002,0,1,0,548176,57434,71299,36657,0.5320130423505873,0.3895909279314706
28657,0.7015328282828283,0,3,0,548179,57431,71299,36657,0.5319852532513246,0.3896033500552674
28658,0.701547619047619,1,0,1,548179,57431,71300,36656,0.5319852532513246,0.3895968624783445
28659,0.7015476190476191,0,1,0,548180,57430,71300,36656,0.531975990218237,0.3896010033373722
28660,0.7015606060606062,0,1,0,548181,57429,71300,36656,0.5319667271851495,0.38960514428442367
28661,0.7015833333333333,0,1,0,548182,57428,71300,36656,0.5319574641520619,0.38960928531950173
28662,0.7016190476190475,0,1,0,548183,57427,71300,36656,0.5319482011189745,0.3896134264426092
28663,0.7016428571428571,1,0,1,548183,57427,71301,36655,0.5319482011189745,0.3896069386280054
28664,0.7016666666666664,0,1,0,548184,57426,71301,36655,0.5319389380858869,0.3896110798142027
28665,0.7016666666666665,35,60,35,548244,57366,71336,36620,0.5313831561006336,0.38963249845721704
28666,0.7016666666666667,22,58,22,548302,57308,71358,36598,0.5308459001815554,0.3897301556876025
28667,0.7016904761904762,0,1,0,548303,57307,71358,36598,0.5308366371484678,0.38973430594750014
28668,0.7017142857142855,0,1,0,548304,57306,71358,36598,0.5308273741153804,0.38973845629579146
28669,0.7017142857142856,0,1,0,548305,57305,71358,36598,0.5308181110822928,0.38974260673247924
28670,0.7017222222222221,0,2,0,548307,57303,71358,36598,0.5307995850161177,0.3897509078710557
28671,0.7017380952380953,0,1,0,548308,57302,71358,36598,0.5307903219830301,0.38975505857294995
28672,0.7017380952380954,0,1,0,548309,57301,71358,36598,0.5307810589499425,0.389759209363252
28673,0.7017500000000001,0,1,0,548310,57300,71358,36598,0.530771795916855,0.3897633602419647
28674,0.7017777777777777,0,1,0,548311,57299,71358,36598,0.5307625328837675,0.3897675112090908
28675,0.7017857142857141,0,1,0,548312,57298,71358,36598,0.5307532698506799,0.3897716622646332
28676,0.7017857142857143,1,0,1,548312,57298,71359,36597,0.5307532698506799,0.38976516321422866
28677,0.7018024796840582,1,1,1,548313,57297,71360,36596,0.5307440068175924,0.38976281511933797
28678,0.7018174603174603,0,1,0,548314,57296,71360,36596,0.5307347437845048,0.3897669663017084
28679,0.7018333333333334,2,11,2,548325,57285,71362,36594,0.5306328504205418,0.38979963570127507
28680,0.7018556998556998,0,1,0,548326,57284,71362,36594,0.5306235873874542,0.3898037878949275
28681,0.7018690476190476,0,2,0,548328,57282,71362,36594,0.530605061321279,0.389812092547616
28682,0.7018809523809523,0,1,0,548329,57281,71362,36594,0.5305957982881915,0.3898162450066578
28683,0.7019047619047618,1,0,1,548329,57281,71363,36593,0.5305957982881915,0.38980974497731
28684,0.7019047619047619,0,2,0,548331,57279,71363,36593,0.5305772722220163,0.3898180501107892
28685,0.7019166666666666,1,2,1,548333,57277,71364,36592,0.5305587461558413,0.3898198553303007
28686,0.7019285714285713,1,0,1,548333,57277,71365,36591,0.5305587461558413,0.38981335492393576
28687,0.701952380952381,0,2,0,548335,57275,71365,36591,0.5305402200896662,0.3898216606652036
28688,0.7019642857142857,1,0,1,548335,57275,71366,36590,0.5305402200896662,0.38981516007031375
28689,0.7019999999999998,1,9,1,548344,57266,71367,36589,0.5304568527918782,0.38984603910287147
28690,0.7020000000000001,11,35,11,548379,57231,71378,36578,0.5301326466338138,0.38991994371542177
28691,0.7020000000000002,0,1,0,548380,57230,71378,36578,0.5301233836007262,0.38992410028995395
28692,0.7020238095238095,1,2,1,548382,57228,71379,36577,0.5301048575345512,0.38992591013272215
28693,0.7020714285714286,0,3,0,548385,57225,71379,36577,0.5300770684352885,0.3899383808447581
28694,0.7020833333333333,0,1,0,548386,57224,71379,36577,0.5300678054022009,0.3899425379260349
28695,0.7020833333333334,0,1,0,548387,57223,71379,36577,0.5300585423691133,0.3899466950959488
28696,0.7021388888888889,0,2,0,548389,57221,71379,36577,0.5300400163029383,0.3899550097016994
28697,0.7021428571428572,1,1,1,548390,57220,71380,36576,0.5300307532698507,0.38995266322657685
28698,0.7021547619047618,0,1,0,548391,57219,71380,36576,0.5300214902367631,0.3899568207260515
28699,0.7021666666666665,0,1,0,548392,57218,71380,36576,0.5300122272036756,0.38996097831417786
28700,0.7021666666666667,0,8,0,548400,57210,71380,36576,0.5299381229389751,0.389994242210991
28701,0.7022619047619046,1,2,1,548402,57208,71381,36575,0.5299195968728,0.38999605472207116
28702,0.7023333333333333,1,3,1,548405,57205,71382,36574,0.5298918077735374,0.390002026039945
28703,0.7023333333333334,5,14,5,548419,57191,71387,36569,0.5297621253103116,0.3900277303754266
28704,0.7023333333333335,0,2,0,548421,57189,71387,36569,0.5297435992441365,0.39003605025704474
28705,0.702361111111111,0,2,0,548423,57187,71387,36569,0.5297250731779614,0.39004437049362173
28706,0.7023809523809524,1,1,1,548424,57186,71388,36568,0.5297158101448738,0.3900420248736054
28707,0.7024206349206348,0,1,0,548425,57185,71388,36568,0.5297065471117863,0.3900461851887406
28708,0.7024999999999999,0,1,0,548426,57184,71388,36568,0.5296972840786988,0.39005034559262736
28709,0.7025,50,124,50,548550,57060,71438,36518,0.528548667975842,0.3902412960311184
28710,0.7025000000000001,2,2,2,548552,57058,71440,36516,0.5285301419096669,0.3902366041849232
28711,0.7025238095238094,0,1,0,548553,57057,71440,36516,0.5285208788765794,0.3902407745824116
28712,0.7025476190476191,1,0,1,548553,57057,71441,36515,0.5285208788765794,0.39023425811140083
28713,0.7026190476190475,0,1,0,548554,57056,71441,36515,0.5285116158434918,0.3902384285729553
28714,0.7026190476190476,0,1,0,548555,57055,71441,36515,0.5285023528104043,0.3902425991236507
28715,0.7026666666666666,0,4,0,548559,57051,71441,36515,0.528465300678054,0.3902592822178997
28716,0.7026666666666667,7,22,7,548581,57029,71448,36508,0.5282615139501279,0.39030544062777295
28717,0.7026666666666668,4,8,4,548589,57021,71452,36504,0.5281874096854274,0.39031275060144344
28718,0.7026904761904763,0,2,0,548591,57019,71452,36504,0.5281688836192523,0.39032109748404137
28719,0.7027499999999999,0,2,0,548593,57017,71452,36504,0.5281503575530772,0.39032944472364495
28720,0.7027500000000001,0,1,0,548594,57016,71452,36504,0.5281410945199896,0.39033361847733106
28721,0.7027857142857142,1,0,1,548594,57016,71453,36503,0.5281410945199896,0.3903270993060234
28722,0.7028333333333333,2,6,2,548600,57010,71455,36501,0.5280855163214643,0.3903391044903808
28723,0.7028333333333334,1,3,1,548603,57007,71456,36500,0.5280577272222017,0.390345107852888
28724,0.7028373015873014,2,1,2,548604,57006,71458,36498,0.5280484641891141,0.39033624229979463
28725,0.7028571428571427,1,3,1,548607,57003,71459,36497,0.5280206750898514,0.39034224598930484
28726,0.7028809523809524,0,1,0,548608,57002,71459,36497,0.5280114120567638,0.39034642081733495
28727,0.7029166666666665,0,1,0,548609,57001,71459,36497,0.5280021490236763,0.3903505957346681
28728,0.7029761904761905,0,2,0,548611,56999,71459,36497,0.5279836229575012,0.39035894583725506
28729,0.703,1,18,1,548629,56981,71460,36496,0.5278168883619252,0.39042759181402914
28730,0.7030000000000001,0,1,0,548630,56980,71460,36496,0.5278076253288376,0.3904317685823099
28731,0.7030357142857142,0,2,0,548632,56978,71460,36496,0.5277890992626626,0.3904401223869739
28732,0.703051948051948,0,1,0,548633,56977,71460,36496,0.527779836229575,0.3904442994233629
28733,0.7030584415584417,1,0,1,548633,56977,71461,36495,0.527779836229575,0.390437778158165
28734,0.7030634920634921,1,1,1,548634,56976,71462,36494,0.5277705731964875,0.39043543382903606
28735,0.7030833333333333,0,1,0,548635,56975,71462,36494,0.5277613101633999,0.3904396109940194
28736,0.7030833333333334,0,1,0,548636,56974,71462,36494,0.5277520471303123,0.3904437882483845
28737,0.7030952380952382,0,1,0,548637,56973,71462,36494,0.5277427840972247,0.3904479655921341
28738,0.7031587301587301,1,0,1,548637,56973,71463,36493,0.5277427840972247,0.3904414439475317
28739,0.7031666666666666,2,5,2,548642,56968,71465,36491,0.527696468931787,0.39044928792304645
28740,0.7031666666666667,0,3,0,548645,56965,71465,36491,0.5276686798325244,0.3904618216058894
28741,0.7031746031746031,0,1,0,548646,56964,71465,36491,0.5276594167994368,0.3904659996789899
28742,0.7031904761904761,0,2,0,548648,56962,71465,36491,0.5276408907332617,0.39047435609343734
28743,0.7032142857142857,0,5,0,548653,56957,71465,36491,0.527594575567824,0.3904952486944611
28744,0.7032499999999999,0,1,0,548654,56956,71465,36491,0.5275853125347364,0.39049942748295824
28745,0.7032738095238095,1,0,1,548654,56956,71466,36490,0.5275853125347364,0.3904929049932581
28746,0.7033095238095237,1,0,1,548654,56956,71467,36489,0.5275853125347364,0.3904863823639574
28747,0.7033333333333331,1,1,1,548655,56955,71468,36488,0.5275760495016488,0.3904840383977398
28748,0.7033333333333333,32,101,32,548756,56854,71500,36456,0.5266404831598058,0.39069767441860465
28749,0.7033333333333335,41,139,41,548895,56715,71541,36415,0.5253529215606358,0.3910125630838613
28750,0.7034404761904761,0,1,0,548896,56714,71541,36415,0.5253436585275483,0.3910167616961419
28751,0.7034523809523808,1,0,1,548896,56714,71542,36414,0.5253436585275483,0.39101022248947687
28752,0.703452380952381,1,2,1,548898,56712,71543,36413,0.5253251324613731,0.3910120805369128
28753,0.7034999999999999,7,23,7,548921,56689,71550,36406,0.5251120827003594,0.3910628927439712
28754,0.7035000000000001,0,3,0,548924,56686,71550,36406,0.5250842936010968,0.3910754952090405
28755,0.7035714285714285,0,1,0,548925,56685,71550,36406,0.5250750305680092,0.3910796962112342
28756,0.7035714285714286,3,2,3,548927,56683,71553,36403,0.525056504501834,0.39106847431407515
28757,0.7035833333333332,0,1,0,548928,56682,71553,36403,0.5250472414687465,0.39107267551162916
28758,0.7036111111111112,0,3,0,548931,56679,71553,36403,0.5250194523694839,0.3910852796459036
28759,0.7036363636363637,0,1,0,548932,56678,71553,36403,0.5250101893363963,0.3910894812045423
28760,0.7036428571428572,1,0,1,548932,56678,71554,36402,0.5250101893363963,0.39108293940696176
28761,0.7036666666666666,1,2,1,548934,56676,71555,36401,0.5249916632702212,0.39108480075636304
28762,0.7036666666666668,4,9,4,548943,56667,71559,36397,0.5249082959724332,0.3910964497550073
28763,0.7036904761904762,0,1,0,548944,56666,71559,36397,0.5248990329393457,0.39110065224632773
28764,0.70375,2,1,2,548945,56665,71561,36395,0.5248897699062581,0.3910917687513432
28765,0.7037619047619049,0,3,0,548948,56662,71561,36395,0.5248619808069954,0.3911043768872841
28766,0.7037698412698414,1,1,1,548949,56661,71562,36394,0.5248527177739079,0.39110203643006825
28767,0.7037857142857143,1,0,1,548949,56661,71563,36393,0.5248527177739079,0.39109549293958346
28768,0.7038095238095238,1,3,1,548952,56658,71564,36392,0.5248249286746453,0.3911015583019882
28769,0.7038095238095239,0,2,0,548954,56656,71564,36392,0.5248064026084701,0.39110996474937665
28770,0.7038333333333331,0,2,0,548956,56654,71564,36392,0.524787876542295,0.39111837155815404
28771,0.7038333333333333,2,4,2,548960,56650,71566,36390,0.5247508244099448,0.391122098022356
28772,0.7038333333333334,0,3,0,548963,56647,71566,36390,0.5247230353106821,0.3911347098466202
28773,0.7038571428571428,0,1,0,548964,56646,71566,36390,0.5247137722775945,0.39113891396878625
28774,0.7038809523809526,0,1,0,548965,56645,71566,36390,0.5247045092445071,0.39114311818132963
28775,0.7039166666666665,0,1,0,548966,56644,71566,36390,0.5246952462114195,0.39114732248425305
28776,0.7039285714285713,0,1,0,548967,56643,71566,36390,0.5246859831783319,0.39115152687755955
28777,0.7039523809523809,0,1,0,548968,56642,71566,36390,0.5246767201452444,0.39115573136125203
28778,0.704,1,4,1,548972,56638,71567,36389,0.5246396680128942,0.39116600556827585
28779,0.7040000000000001,26,36,26,549008,56602,71593,36363,0.5243061988217422,0.3911472059377185
28780,0.7040000000000002,1,1,1,549009,56601,71594,36362,0.5242969357886547,0.39114486408571153
28781,0.7040238095238095,0,1,0,549010,56600,71594,36362,0.5242876727555671,0.39114907166369056
28782,0.704027777777778,0,4,0,549014,56596,71594,36362,0.5242506206232168,0.39116590288087094
28783,0.704047619047619,0,4,0,549018,56592,71594,36362,0.5242135684908666,0.3911827355466145
28784,0.7041190476190476,0,3,0,549021,56589,71594,36362,0.5241857793916039,0.39119536099665414
28785,0.7041428571428571,0,1,0,549022,56588,71594,36362,0.5241765163585165,0.39119956966110814
28786,0.7041666666666666,10,34,10,549056,56554,71604,36352,0.5238615732335395,0.3912772049167976
28787,0.7041666666666667,4,19,4,549075,56535,71608,36348,0.523685575604876,0.3913310293595168
28788,0.7041904761904764,0,1,0,549076,56534,71608,36348,0.5236763125717885,0.39133524256583624
28789,0.7042142857142859,0,1,0,549077,56533,71608,36348,0.5236670495387009,0.3913394558628783
28790,0.7042222222222222,0,1,0,549078,56532,71608,36348,0.5236577865056133,0.391343669250646
28791,0.7042857142857142,2,0,2,549078,56532,71610,36346,0.5236577865056133,0.3913305626736148
28792,0.7042857142857143,1,5,1,549083,56527,71611,36345,0.5236114713401756,0.39134507709535704
28793,0.704333333333333,0,1,0,549084,56526,71611,36345,0.523602208307088,0.39134929095196563
28794,0.7043333333333333,0,6,0,549090,56520,71611,36345,0.5235466301085627,0.3913745759974156
28795,0.7043333333333334,6,8,6,549098,56512,71617,36339,0.5234725258438623,0.39136896748554134
28796,0.7043888888888888,0,1,0,549099,56511,71617,36339,0.5234632628107747,0.39137318255250403
28797,0.7044126984126984,0,1,0,549100,56510,71617,36339,0.5234539997776873,0.39137739771026075
28798,0.7044166666666666,0,1,0,549101,56509,71617,36339,0.5234447367445997,0.3913816129588144
28799,0.7044444444444444,0,1,0,549102,56508,71617,36339,0.5234354737115121,0.391385828298168
28800,0.7044999999999999,2,4,2,549106,56504,71619,36337,0.5233984215791618,0.39138958003468294
28801,0.7045,1,6,1,549112,56498,71620,36336,0.5233428433806365,0.3914083202275029
28802,0.7045000000000001,0,1,0,549113,56497,71620,36336,0.523333580347549,0.3914125364902567
28803,0.7045158730158728,0,1,0,549114,56496,71620,36336,0.5233243173144615,0.39141675284384697
28804,0.7045238095238094,1,1,1,549115,56495,71621,36335,0.5233150542813739,0.39141441344392974
28805,0.7045555555555555,0,1,0,549116,56494,71621,36335,0.5233057912482864,0.39141862995400145
28806,0.7045833333333333,0,1,0,549117,56493,71621,36335,0.5232965282151988,0.39142284655491877
28807,0.7045833333333335,0,2,0,549119,56491,71621,36335,0.5232780021490236,0.3914312800293021
28808,0.7046428571428572,0,1,0,549120,56490,71621,36335,0.5232687391159361,0.391435496902774
28809,0.7046666666666666,0,2,0,549122,56488,71621,36335,0.523250213049761,0.39144393092229296
28810,0.7046666666666667,4,12,4,549134,56476,71625,36331,0.5231390566527103,0.39146831596754555
28811,0.7046666666666668,0,1,0,549135,56475,71625,36331,0.5231297936196229,0.3914725341033985
28812,0.7047330447330447,0,1,0,549136,56474,71625,36331,0.5231205305865353,0.3914767523301546
28813,0.7047380952380954,0,1,0,549137,56473,71625,36331,0.5231112675534477,0.3914809706478169
28814,0.70475,0,2,0,549139,56471,71625,36331,0.5230927414872726,0.39148940755587164
28815,0.7047857142857142,0,1,0,549140,56470,71625,36331,0.523083478454185,0.39149362614627
28816,0.7048095238095238,0,1,0,549141,56469,71625,36331,0.5230742154210974,0.3914978448275862
28817,0.7048333333333332,0,2,0,549143,56467,71625,36331,0.5230556893549224,0.39150628246298413
28818,0.7048333333333333,1,8,1,549151,56459,71626,36330,0.522981585090222,0.391533479183955
28819,0.7048333333333335,1,2,1,549153,56457,71627,36329,0.5229630590240468,0.39153536093807256
28820,0.7048809523809524,0,1,0,549154,56456,71627,36329,0.5229537959909593,0.391539580751199
28821,0.7049444444444444,1,0,1,549154,56456,71628,36328,0.5229537959909593,0.3915330229349888
28822,0.705,194,478,194,549632,55978,71822,36134,0.5185260661751083,0.39228330727809624
28823,0.7050000000000002,1,5,1,549637,55973,71823,36133,0.5184797510096706,0.3922980044731071
28824,0.7051190476190476,2,2,2,549639,55971,71825,36131,0.5184612249434954,0.3922933269635839
28825,0.7051442307692306,1,0,1,549639,55971,71826,36130,0.5184612249434954,0.39228672870001413
28826,0.7051666666666665,1,0,1,549639,55971,71827,36129,0.5184612249434954,0.3922801302931596
28827,0.7051666666666666,2,6,2,549645,55965,71829,36127,0.5184056467449701,0.3922924901185771
28828,0.7051666666666668,1,0,1,549645,55965,71830,36126,0.5184056467449701,0.3922858911294263
28829,0.7052380952380952,0,3,0,549648,55962,71830,36126,0.5183778576457075,0.3922986708365911
28830,0.7052857142857143,1,0,1,549648,55962,71831,36125,0.5183778576457075,0.39229207162791707
28831,0.7053333333333331,0,1,0,549649,55961,71831,36125,0.51836859461262,0.392296331689942
28832,0.7053333333333334,1,8,1,549657,55953,71832,36124,0.5182944903479195,0.3923238159366617
28833,0.7053333333333335,1,1,1,549658,55952,71833,36123,0.518285227314832,0.3923214770567472
28834,0.7053571428571428,0,1,0,549659,55951,71833,36123,0.5182759642817444,0.3923257379933532
28835,0.7053809523809522,0,1,0,549660,55950,71833,36123,0.5182667012486568,0.39232999902251475
28836,0.7054047619047619,0,1,0,549661,55949,71833,36123,0.5182574382155694,0.39233426014423495
28837,0.7054166666666666,1,2,1,549663,55947,71834,36122,0.5182389121493942,0.3923361826456245
28838,0.7054166666666667,1,1,1,549664,55946,71835,36121,0.5182296491163066,0.39233384383112296
28839,0.705440476190476,0,1,0,549665,55945,71835,36121,0.5182203860832191,0.39233810527230467
28840,0.7054761904761904,0,1,0,549666,55944,71835,36121,0.5182111230501315,0.39234236680606094
28841,0.7054761904761905,0,1,0,549667,55943,71835,36121,0.5182018600170439,0.3923466284323949
28842,0.7055,3,1,3,549668,55942,71838,36118,0.5181925969839565,0.3923310884205953
28843,0.7055000000000001,0,1,0,549669,55941,71838,36118,0.5181833339508689,0.3923353501558783
28844,0.7055119047619047,0,1,0,549670,55940,71838,36118,0.5181740709177813,0.3923396119837494
28845,0.7055555555555556,0,4,0,549674,55936,71838,36118,0.5181370187854311,0.39235666022117455
28846,0.7056111111111109,1,0,1,549674,55936,71839,36117,0.5181370187854311,0.3923500592050232
28847,0.7056190476190476,2,0,2,549674,55936,71841,36115,0.5181370187854311,0.392336856742458
28848,0.7056190476190477,0,1,0,549675,55935,71841,36115,0.5181277557523436,0.39234111895708856
28849,0.705628427128427,0,4,0,549679,55931,71841,36115,0.5180907036199933,0.3923581687417161
28850,0.7056367243867244,0,1,0,549680,55930,71841,36115,0.5180814405869058,0.3923624314194144
28851,0.7056479076479074,0,1,0,549681,55929,71841,36115,0.5180721775538182,0.39236669418973535
28852,0.7056666666666664,0,2,0,549683,55927,71841,36115,0.5180536514876432,0.3923752200082571
28853,0.7056666666666667,4,13,4,549696,55914,71845,36111,0.5179332320575049,0.39240423797881013
28854,0.7056666666666668,1,1,1,549697,55913,71846,36110,0.5179239690244174,0.3924018995251187
28855,0.7057142857142855,1,0,1,549697,55913,71847,36109,0.5179239690244174,0.3923952967768577
28856,0.7057142857142857,3,6,3,549703,55907,71850,36106,0.517868390825892,0.39240107376131633
28857,0.7057380952380952,0,1,0,549704,55906,71850,36106,0.5178591277928045,0.3924053384341173
28858,0.7057619047619048,1,1,1,549705,55905,71851,36105,0.517849864759717,0.3924029996739485
28859,0.7058333333333333,16,27,16,549732,55878,71867,36089,0.517599762866353,0.39241249578653215
28860,0.7058333333333334,15,34,15,549766,55844,71882,36074,0.5172848197413761,0.39245849561565743
28861,0.7058809523809525,0,2,0,549768,55842,71882,36074,0.517266293675201,0.3924670351190217
28862,0.7059206349206348,0,1,0,549769,55841,71882,36074,0.5172570306421135,0.39247130501006366
28863,0.705952380952381,0,1,0,549770,55840,71882,36074,0.5172477676090259,0.39247557499401614
28864,0.706,27,45,27,549815,55795,71909,36047,0.5168309311200859,0.39248927505934106
28865,0.7060000000000001,1,5,1,549820,55790,71910,36046,0.5167846159546482,0.39250402892112024
28866,0.706047619047619,0,1,0,549821,55789,71910,36046,0.5167753529215606,0.392508302934611
28867,0.7060476190476191,0,1,0,549822,55788,71910,36046,0.5167660898884731,0.39251257704118303
28868,0.7060555555555555,0,1,0,549823,55787,71910,36046,0.5167568268553855,0.39251685124083935
28869,0.7060595238095237,0,2,0,549825,55785,71910,36046,0.5167383007892105,0.3925253999194172
28870,0.7060714285714286,2,2,2,549827,55783,71912,36044,0.5167197747230353,0.39252071830725166
28871,0.7061190476190475,0,1,0,549828,55782,71912,36044,0.5167105116899477,0.3925249929213948
28872,0.7061212121212121,0,1,0,549829,55781,71912,36044,0.5167012486568602,0.39252926762864143
28873,0.7061309523809526,0,1,0,549830,55780,71912,36044,0.5166919856237726,0.3925335424289946
28874,0.7061666666666666,1,2,1,549832,55778,71913,36043,0.5166734595575976,0.3925354766338855
28875,0.7061666666666667,2,9,2,549841,55769,71915,36041,0.5165900922598096,0.3925607232327633
28876,0.7061904761904763,1,1,1,549842,55768,71916,36040,0.516580829226722,0.39255838271174626
28877,0.70625,0,3,0,549845,55765,71916,36040,0.5165530401274593,0.3925712107183705
28878,0.7062857142857143,2,1,2,549846,55764,71918,36038,0.5165437770943718,0.39256225354567437
28879,0.7062976190476192,0,1,0,549847,55763,71918,36038,0.5165345140612843,0.3925665297763641
28880,0.7063333333333333,2,15,2,549862,55748,71920,36036,0.5163955685649709,0.3926174496644295
28881,0.7063333333333334,2,6,2,549868,55742,71922,36034,0.5163399903664456,0.39262988145048816
28882,0.7063534798534796,0,6,0,549874,55736,71922,36034,0.5162844121679203,0.3926555519232865
28883,0.706388888888889,0,1,0,549875,55735,71922,36034,0.5162751491348327,0.3926598306617703
28884,0.7064285714285714,0,3,0,549878,55732,71922,36034,0.51624736003557,0.3926726674367413
28885,0.7064285714285715,0,1,0,549879,55731,71922,36034,0.5162380970024825,0.39267694654824825
28886,0.7064444444444444,0,1,0,549880,55730,71922,36034,0.5162288339693949,0.3926812257530186
28887,0.7064523809523809,1,0,1,549880,55730,71923,36033,0.5162288339693949,0.3926746074125737
28888,0.7064999999999999,1,1,1,549881,55729,71924,36032,0.5162195709363074,0.3926722681749327
28889,0.7065,3,8,3,549889,55721,71927,36029,0.516145466671607,0.3926866485013624
28890,0.7065000000000002,0,1,0,549890,55720,71927,36029,0.5161362036385194,0.3926909285114824
28891,0.7065238095238096,0,4,0,549894,55716,71927,36029,0.5160991515061691,0.39270804948498556
28892,0.706547619047619,0,1,0,549895,55715,71927,36029,0.5160898884730816,0.39271232996163236
28893,0.7066190476190477,1,0,1,549895,55715,71928,36028,0.5160898884730816,0.39270571051742365
28894,0.7066666666666666,62,147,62,550042,55568,71990,35966,0.5147282226092111,0.3929250333209518
28895,0.7066666666666667,40,91,40,550133,55477,72030,35926,0.5138852865982437,0.3930505563274728
28896,0.7066666666666669,0,1,0,550134,55476,72030,35926,0.5138760235651562,0.39305485656768996
28897,0.706738095238095,0,3,0,550137,55473,72030,35926,0.5138482344658936,0.3930677578529306
28898,0.70675,1,1,1,550138,55472,72031,35925,0.513838971432806,0.39306541790211935
28899,0.7067857142857141,0,1,0,550139,55471,72031,35925,0.5138297083997184,0.3930697185872467
28900,0.7067857142857144,2,3,2,550142,55468,72033,35923,0.5138019193004557,0.3930693394316727
28901,0.7068333333333332,2,3,2,550145,55465,72035,35921,0.5137741302011931,0.39306896023460924
28902,0.7068333333333334,2,4,2,550149,55461,72037,35919,0.5137370780688428,0.39307288246881156
28903,0.7068571428571429,0,1,0,550150,55460,72037,35919,0.5137278150357553,0.39307718403571934
28904,0.706857142857143,0,1,0,550151,55459,72037,35919,0.5137185520026678,0.39308148569677603
28905,0.706888888888889,0,1,0,550152,55458,72037,35919,0.5137092889695802,0.39308578745198464
28906,0.7069285714285715,0,1,0,550153,55457,72037,35919,0.5137000259364927,0.39309008930134826
28907,0.7069545454545454,0,1,0,550154,55456,72037,35919,0.5136907629034051,0.39309439124487006
28908,0.7069761904761905,0,1,0,550155,55455,72037,35919,0.5136814998703175,0.39309869328255304
28909,0.7069880952380951,1,0,1,550155,55455,72038,35918,0.5136814998703175,0.3930920512624079
28910,0.7069999999999999,1,3,1,550158,55452,72039,35917,0.5136537107710549,0.393098315621272
28911,0.7070000000000001,4,17,4,550175,55435,72043,35913,0.5134962392085665,0.39314489643998773
28912,0.7070000000000002,0,1,0,550176,55434,72043,35913,0.5134869761754789,0.39314920030214456
28913,0.7070476190476191,1,1,1,550177,55433,72044,35912,0.5134777131423913,0.39314686080245226
28914,0.7070833333333336,0,1,0,550178,55432,72044,35912,0.5134684501093038,0.3931511648274654
28915,0.7071143023643026,0,1,0,550179,55431,72044,35912,0.5134591870762162,0.3931554689467173
28916,0.7071212121212122,0,1,0,550180,55430,72044,35912,0.5134499240431287,0.39315977316021106
28917,0.7071428571428571,0,1,0,550181,55429,72044,35912,0.5134406610100412,0.3931640774679498
28918,0.7071428571428572,2,5,2,550186,55424,72046,35910,0.5133943458446033,0.39317231261085683
28919,0.7071666666666665,0,1,0,550187,55423,72046,35910,0.5133850828115158,0.3931766174329103
28920,0.7071666666666667,2,8,2,550195,55415,72048,35908,0.5133109785468154,0.3931977705506827
28921,0.7072499999999999,0,2,0,550197,55413,72048,35908,0.5132924524806403,0.393206381883685
28922,0.7073214285714287,0,1,0,550198,55412,72048,35908,0.5132831894475527,0.3932106876916338
28923,0.7073333333333331,0,7,0,550205,55405,72048,35908,0.5132183482159398,0.3932408309879207
28924,0.7073333333333334,5,15,5,550220,55390,72053,35903,0.5130794027196265,0.39327221145104224
28925,0.7073333333333335,1,3,1,550223,55387,72054,35902,0.5130516136203639,0.3932784891936597
28926,0.7073571428571428,0,1,0,550224,55386,72054,35902,0.5130423505872763,0.3932827973008501
28927,0.7073809523809524,0,2,0,550226,55384,72054,35902,0.5130238245211012,0.3932914137983919
28928,0.7074484126984129,0,3,0,550229,55381,72054,35902,0.5129960354218386,0.39330433925265385
28929,0.7074523809523809,1,0,1,550229,55381,72055,35901,0.5129960354218386,0.3932976928638724
28930,0.7074588744588745,0,1,0,550230,55380,72055,35901,0.512986772388751,0.39330200151181516
28931,0.7074761904761906,1,0,1,550230,55380,72056,35900,0.512986772388751,0.3932953549517967
28932,0.7074999999999999,1,1,1,550231,55379,72057,35899,0.5129775093556634,0.3932930169372686
28933,0.7075,36,114,36,550345,55265,72093,35863,0.5119215235836823,0.39354534281450265
28934,0.7075000000000001,2,5,2,550350,55260,72095,35861,0.5118752084182445,0.39355362649663633
28935,0.7075468975468975,0,3,0,550353,55257,72095,35861,0.5118474193189818,0.393566583989991
28936,0.707563492063492,1,2,1,550355,55255,72096,35860,0.5118288932528067,0.39356856719530264
28937,0.7075833333333332,0,1,0,550356,55254,72096,35860,0.5118196302197191,0.3935728867133481
28938,0.7075833333333335,1,0,1,550356,55254,72097,35859,0.5118196302197191,0.3935662309439926
28939,0.7076666666666666,2,0,2,550356,55254,72099,35857,0.5118196302197191,0.39355291896697436
28940,0.7076666666666667,5,12,5,550368,55242,72104,35852,0.5117084738226685,0.3935714756185918
28941,0.7076666666666668,3,3,3,550371,55239,72107,35849,0.5116806847234059,0.393564465132619
28942,0.7076904761904763,0,1,0,550372,55238,72107,35849,0.5116714216903183,0.39356878588602107
28943,0.7077222222222223,0,2,0,550374,55236,72107,35849,0.5116528956241432,0.39357742767744414
28944,0.7077499999999999,0,1,0,550375,55235,72107,35849,0.5116436325910556,0.3935817487154714
28945,0.7077857142857144,0,1,0,550376,55234,72107,35849,0.511634369557968,0.39358606984838007
28946,0.7078333333333333,3,7,3,550383,55227,72110,35846,0.5115695283263552,0.39359634578854324
28947,0.7078333333333334,1,0,1,550383,55227,72111,35845,0.5115695283263552,0.3935896872803935
28948,0.7078547008547008,0,2,0,550385,55225,72111,35845,0.51155100226018,0.39359833095421104
28949,0.7078571428571427,0,1,0,550386,55224,72111,35845,0.5115417392270926,0.39360265293349
28950,0.707857142857143,0,1,0,550387,55223,72111,35845,0.511532476194005,0.39360697500768654
28951,0.7078636363636364,0,1,0,550388,55222,72111,35845,0.5115232131609174,0.3936112971768039
28952,0.7079166666666667,2,1,2,550389,55221,72113,35843,0.5115139501278299,0.3936023016779408
28953,0.7079285714285715,0,1,0,550390,55220,72113,35843,0.5115046870947423,0.3936066239855924
28954,0.7079722222222222,0,1,0,550391,55219,72113,35843,0.5114954240616547,0.39361094638817506
28955,0.7079761904761906,0,2,0,550393,55217,72113,35843,0.5114768979954797,0.3936195914781463
28956,0.7079999999999999,1,4,1,550397,55213,72114,35842,0.5114398458631294,0.39363022349129645
28957,0.708,11,32,11,550429,55181,72125,35831,0.5111434288043277,0.3936953368786534
28958,0.7080000000000001,1,2,1,550431,55179,72126,35830,0.5111249027381526,0.3936973266380248
28959,0.7080238095238096,0,1,0,550432,55178,72126,35830,0.511115639705065,0.39370165260196904
28960,0.7080238095238097,0,1,0,550433,55177,72126,35830,0.5111063766719774,0.3937059786609821
28961,0.708047619047619,0,1,0,550434,55176,72126,35830,0.5110971136388899,0.39371030481506714
28962,0.7080909090909091,0,1,0,550435,55175,72126,35830,0.5110878506058024,0.3937146310642272
28963,0.7080952380952382,0,1,0,550436,55174,72126,35830,0.5110785875727148,0.3937189574084656
28964,0.7081190476190478,1,2,1,550438,55172,72127,35829,0.5110600615065397,0.3937209481214492
28965,0.7081428571428572,0,1,0,550439,55171,72127,35829,0.5110507984734521,0.39372527472527474
28966,0.7081468253968254,1,0,1,550439,55171,72128,35828,0.5110507984734521,0.39371861229244276
28967,0.7081666666666666,2,9,2,550448,55162,72130,35826,0.5109674311756641,0.39374423000835274
28968,0.7081904761904763,1,0,1,550448,55162,72131,35825,0.5109674311756641,0.39373756690516226
28969,0.7082142857142857,1,3,1,550451,55159,72132,35824,0.5109396420764015,0.3937438862205027
28970,0.7082380952380953,0,1,0,550452,55158,72132,35824,0.510930379043314,0.3937482139324262
28971,0.70825,0,2,0,550454,55156,72132,35824,0.5109118529771388,0.3937568696416795
28972,0.7082619047619048,0,2,0,550456,55154,72132,35824,0.5108933269109637,0.39376552573149554
28973,0.7083333333333333,27,44,27,550500,55110,72159,35797,0.5104857534551114,0.39377605684930755
28974,0.7083333333333335,36,69,36,550569,55041,72195,35761,0.5098466041720701,0.3938349375564415
28975,0.7083809523809524,1,0,1,550569,55041,72196,35760,0.5098466041720701,0.3938282618032841
28976,0.7084007936507937,1,1,1,550570,55040,72197,35759,0.5098373411389826,0.3938259231929867
28977,0.7084523809523811,0,1,0,550571,55039,72197,35759,0.509828078105895,0.39383026057842685
28978,0.7084999999999999,4,15,4,550586,55024,72201,35755,0.5096891326095817,0.39386862600381145
28979,0.7085000000000001,0,1,0,550587,55023,72201,35755,0.5096798695764941,0.3938729648152636
28980,0.7085238095238096,1,0,1,550587,55023,72202,35754,0.5096798695764941,0.3938662877160514
28981,0.7085357142857143,1,0,1,550587,55023,72203,35753,0.5096798695764941,0.3938596104697277
28982,0.708547619047619,0,1,0,550588,55022,72203,35753,0.5096706065434066,0.39386394932525476
28983,0.7085714285714286,2,5,2,550593,55017,72205,35751,0.5096242913779688,0.39387228979375993
28984,0.708579365079365,0,3,0,550596,55014,72205,35751,0.5095965022787061,0.3938853082135184
28985,0.7085833333333333,0,1,0,550597,55013,72205,35751,0.5095872392456186,0.3938896478780133
28986,0.7086111111111112,0,1,0,550598,55012,72205,35751,0.509577976212531,0.3938939876381345
28987,0.7086666666666666,2,7,2,550605,55005,72207,35749,0.5095131349809181,0.39391101218679064
28988,0.7086666666666668,7,12,7,550617,54993,72214,35742,0.5094019785838675,0.39391634980988594
28989,0.7086904761904761,0,1,0,550618,54992,72214,35742,0.5093927155507799,0.3939206912513501
28990,0.70875,1,1,1,550619,54991,72215,35741,0.5093834525176923,0.39391835295154964
28991,0.7088095238095238,0,1,0,550620,54990,72215,35741,0.5093741894846049,0.3939226945586404
28992,0.7088333333333331,0,1,0,550621,54989,72215,35741,0.5093649264515173,0.39392703626143505
28993,0.7088333333333332,1,7,1,550628,54982,72216,35740,0.5093000852199044,0.39395075064482704
28994,0.7088333333333334,0,2,0,550630,54980,72216,35740,0.5092815591537293,0.3939594356261023
28995,0.7088571428571427,0,1,0,550631,54979,72216,35740,0.5092722961206417,0.3939637782603424
28996,0.7088809523809523,0,1,0,550632,54978,72216,35740,0.5092630330875542,0.39396812099032164
28997,0.7089047619047619,0,1,0,550633,54977,72216,35740,0.5092537700544666,0.3939724638160433
28998,0.7089166666666666,0,1,0,550634,54976,72216,35740,0.5092445070213791,0.39397680673751045
28999,0.7089285714285714,1,1,1,550635,54975,72217,35739,0.5092352439882916,0.39397446921092666
29000,0.7089379509379509,0,3,0,550638,54972,72217,35739,0.5092074548890289,0.3939874987597976
29001,0.7089523809523809,0,1,0,550639,54971,72217,35739,0.5091981918559413,0.3939918421342741
29002,0.708952380952381,1,0,1,550639,54971,72218,35738,0.5091981918559413,0.3939851613401096
29003,0.7089761904761903,0,1,0,550640,54970,72218,35738,0.5091889288228537,0.3939895047845835
29004,0.709,0,4,0,550644,54966,72218,35738,0.5091518766905035,0.3940068795201976
29005,0.7090000000000001,6,18,6,550662,54948,72224,35732,0.5089851420949275,0.394044993383326
29006,0.7090000000000002,0,1,0,550663,54947,72224,35732,0.50897587906184,0.3940493388766969
29007,0.7090476190476189,0,2,0,550665,54945,72224,35732,0.5089573529956649,0.39405803015097546
29008,0.7090595238095239,0,1,0,550666,54944,72224,35732,0.5089480899625773,0.39406237593188936
29009,0.7091190476190475,0,1,0,550667,54943,72224,35732,0.5089388269294898,0.3940667218086573
29010,0.7091547619047618,0,1,0,550668,54942,72224,35732,0.5089295638964022,0.39407106778128237
29011,0.7091666666666666,5,22,5,550690,54920,72229,35727,0.508725777168476,0.3941332862643
29012,0.7091666666666667,5,29,5,550719,54891,72234,35722,0.5084571492089369,0.39422599406266207
29013,0.7092142857142858,0,1,0,550720,54890,72234,35722,0.5084478861758495,0.39423034476669755
29014,0.7092222222222223,0,1,0,550721,54889,72234,35722,0.5084386231427619,0.39423469556676344
29015,0.7092777777777778,0,2,0,550723,54887,72234,35722,0.5084200970765868,0.394243397454999
29016,0.7092857142857143,1,4,1,550727,54883,72235,35721,0.5083830449442366,0.3942541168160346
29017,0.7092936507936508,0,3,0,550730,54880,72235,35721,0.5083552558449739,0.3942671714440238
29018,0.7093333333333333,0,2,0,550732,54878,72235,35721,0.5083367297787987,0.39427587500965794
29019,0.7093333333333334,9,18,9,550750,54860,72244,35712,0.5081699951832228,0.3942940423088813
29020,0.7093333333333335,0,1,0,550751,54859,72244,35712,0.5081607321501352,0.39429839573373376
29021,0.7093571428571427,0,2,0,550753,54857,72244,35712,0.5081422060839601,0.39430710287184356
29022,0.7093571428571428,1,1,1,550754,54856,72245,35711,0.5081329430508725,0.39430476884516436
29023,0.7093690476190475,0,1,0,550755,54855,72245,35711,0.5081236800177851,0.3943091226288011
29024,0.7093928571428572,0,3,0,550758,54852,72245,35711,0.5080958909185224,0.394322184556607
29025,0.7094015151515152,0,1,0,550759,54851,72245,35711,0.5080866278854348,0.39432653872485146
29026,0.7094047619047619,1,0,1,550759,54851,72246,35710,0.5080866278854348,0.39431985070836234
29027,0.709452380952381,0,2,0,550761,54849,72246,35710,0.5080681018192597,0.39432855928179417
29028,0.7094999999999999,0,2,0,550763,54847,72246,35710,0.5080495757530846,0.3943372682398931
29029,0.7095,3,6,3,550769,54841,72249,35707,0.5079939975545593,0.3943433317135663
29030,0.7095238095238093,1,0,1,550769,54841,72250,35706,0.5079939975545593,0.3943366428484654
29031,0.7095238095238094,0,2,0,550771,54839,72250,35706,0.5079754714883842,0.394345353139323
29032,0.7095238095238097,1,1,1,550772,54838,72251,35705,0.5079662084552966,0.39434301933887767
29033,0.7095833333333335,0,2,0,550774,54836,72251,35705,0.5079476823891215,0.3943517301553992
29034,0.7096428571428572,0,2,0,550776,54834,72251,35705,0.5079291563229464,0.3943604413567634
29035,0.7096666666666666,0,1,0,550777,54833,72251,35705,0.5079198932898589,0.3943647971017694
29036,0.7096666666666667,4,12,4,550789,54821,72255,35701,0.5078087368928081,0.39439031395682816
29037,0.7096666666666668,0,1,0,550790,54820,72255,35701,0.5077994738597206,0.394394670849858
29038,0.70975,1,1,1,550791,54819,72256,35700,0.5077902108266331,0.3943923375202996
29039,0.7097500000000001,0,1,0,550792,54818,72256,35700,0.5077809477935455,0.39439669458008353
29040,0.7097619047619047,1,0,1,550792,54818,72257,35699,0.5077809477935455,0.39439000408763
29041,0.7097619047619048,0,1,0,550793,54817,72257,35699,0.507771684760458,0.3943943612179062
29042,0.7098095238095239,1,1,1,550794,54816,72258,35698,0.5077624217273704,0.39439202775261284
29043,0.7098333333333332,0,2,0,550796,54814,72258,35698,0.5077438956611953,0.394400742442991
29044,0.7098333333333333,1,6,1,550802,54808,72259,35697,0.50768831746267,0.39442019777912823
29045,0.709857142857143,0,3,0,550805,54805,72259,35697,0.5076605283634074,0.3944332721928797
29046,0.7099047619047618,0,1,0,550806,54804,72259,35697,0.5076512653303198,0.3944376305234196
29047,0.7099523809523808,0,1,0,550807,54803,72259,35697,0.5076420022972322,0.39444198895027627
29048,0.7099523809523809,0,1,0,550808,54802,72259,35697,0.5076327392641447,0.39444634747345275
29049,0.7099999999999999,4,4,4,550812,54798,72263,35693,0.5075956871317945,0.39443701583582896
29050,0.71,633,1439,633,552251,53359,72896,35060,0.49426618251880394,0.39652110971623744
29051,0.7100000000000002,2,7,2,552258,53352,72898,35058,0.49420134128719106,0.3965388530709196
29052,0.7100476190476189,1,0,1,552258,53352,72899,35057,0.49420134128719106,0.39653202728229026
29053,0.710047619047619,0,1,0,552259,53351,72899,35057,0.49419207825410355,0.3965365125328025
29054,0.7100714285714286,0,1,0,552260,53350,72899,35057,0.494182815221016,0.39654099788478286
29055,0.7101269841269843,1,0,1,552260,53350,72900,35056,0.494182815221016,0.3965341718887858
29056,0.7101428571428571,0,2,0,552262,53348,72900,35056,0.49416428915484084,0.3965431428442152
29057,0.7101666666666665,0,2,0,552264,53346,72900,35056,0.49414576308866576,0.39655211420556097
29058,0.7101666666666666,3,11,3,552275,53335,72903,35053,0.49404386972470266,0.39658098384396073
29059,0.7101666666666668,2,2,2,552277,53333,72905,35051,0.49402534365852757,0.39657630340333094
29060,0.7101904761904763,0,1,0,552278,53332,72905,35051,0.49401608062544,0.39658079042349775
29061,0.7102142857142859,0,2,0,552280,53330,72905,35051,0.49399755455926486,0.3965897647684457
29062,0.7102380952380952,0,2,0,552282,53328,72905,35051,0.4939790284930898,0.39659873951956914
29063,0.71025,1,0,1,552282,53328,72906,35050,0.4939790284930898,0.3965919120143022
29064,0.7102619047619048,0,1,0,552283,53327,72906,35050,0.4939697654600022,0.39659639951571113
29065,0.7102896825396822,0,3,0,552286,53324,72906,35050,0.49394197636073955,0.3966098626292801
29066,0.7102976190476192,0,2,0,552288,53322,72906,35050,0.49392345029456447,0.3966188385461458
29067,0.7103095238095238,0,1,0,552289,53321,72906,35050,0.4939141872614769,0.39662332665693495
29068,0.7103333333333333,5,15,5,552304,53306,72911,35045,0.4937752417651636,0.39665651775305316
29069,0.7103333333333335,0,6,0,552310,53300,72911,35045,0.49371966356663827,0.39668345690191864
29070,0.7103571428571428,2,3,2,552313,53297,72913,35043,0.4936918744673756,0.3966832691872312
29071,0.7103571428571429,1,0,1,552313,53297,72914,35042,0.4936918744673756,0.39667643962462784
29072,0.7103809523809522,2,3,2,552316,53294,72916,35040,0.49366408536811296,0.3966762514999887
29073,0.710388888888889,0,1,0,552317,53293,72916,35040,0.4936548223350254,0.39668074219148
29074,0.710440476190476,0,2,0,552319,53291,72916,35040,0.49363629626885025,0.3966897238794987
29075,0.7104761904761905,0,2,0,552321,53289,72916,35040,0.49361777020267517,0.39669870597425533
29076,0.7104999999999998,0,1,0,552322,53288,72916,35040,0.4936085071695876,0.396703197174169
29077,0.7105,2,13,2,552335,53275,72918,35038,0.4934880877394494,0.3967479306557358
29078,0.7105000000000001,0,1,0,552336,53274,72918,35038,0.49347882470636184,0.39675242322674154
29079,0.7105158730158729,0,4,0,552340,53270,72918,35038,0.4934417725740116,0.3967703945282421
29080,0.7105555555555556,1,0,1,552340,53270,72919,35037,0.4934417725740116,0.39676356347741404
29081,0.7105555555555557,1,0,1,552340,53270,72920,35036,0.4934417725740116,0.3967567322718728
29082,0.7105714285714286,0,1,0,552341,53269,72920,35036,0.4934325095409241,0.3967612252986807
29083,0.7105833333333333,0,1,0,552342,53268,72920,35036,0.49342324650783653,0.39676571842725133
29084,0.7105833333333336,0,1,0,552343,53267,72920,35036,0.49341398347474896,0.3967702116575881
29085,0.7105952380952381,0,2,0,552345,53265,72920,35036,0.4933954574085739,0.3967791984235739
29086,0.7106111111111112,0,1,0,552346,53264,72920,35036,0.4933861943754863,0.3967836919592299
29087,0.7106547619047618,0,1,0,552347,53263,72920,35036,0.49337693134239874,0.3967881855966659
29088,0.7106666666666667,3,15,3,552362,53248,72923,35033,0.49323798584608547,0.39683510608171635
29089,0.7106666666666668,1,4,1,552366,53244,72924,35032,0.49320093371373525,0.3968462549277267
29090,0.7107142857142857,2,4,2,552370,53240,72926,35030,0.493163881581385,0.39685057210830404
29091,0.71075,1,3,1,552373,53237,72927,35029,0.49313609248212237,0.3968572270183309
29092,0.7108333333333331,1,2,1,552375,53235,72928,35028,0.49311756641594723,0.396859386152748
29093,0.7108333333333333,5,22,5,552397,53213,72933,35023,0.492913779688021,0.3969241579400698
29094,0.7108333333333334,7,24,7,552421,53189,72940,35016,0.49269146689391974,0.3969842979422935
29095,0.7108809523809525,1,0,1,552421,53189,72941,35015,0.49269146689391974,0.3969774613396218
29096,0.7108846153846153,1,0,1,552421,53189,72942,35014,0.49269146689391974,0.39697062458193033
29097,0.7109444444444445,1,0,1,552421,53189,72943,35013,0.49269146689391974,0.39696378766921386
29098,0.7109523809523809,1,1,1,552422,53188,72944,35012,0.49268220386083217,0.39696145124716553
29099,0.710952380952381,1,0,1,552422,53188,72945,35011,0.49268220386083217,0.3969546139978911
29100,0.7109761904761907,0,2,0,552424,53186,72945,35011,0.4926636777946571,0.3969636155424788
29101,0.7109999999999999,0,1,0,552425,53185,72945,35011,0.4926544147615695,0.396968116467867
29102,0.711,11,33,11,552458,53152,72956,35000,0.49234873466968027,0.3970414738179508
29103,0.7110000000000001,2,0,2,552458,53152,72958,34998,0.49234873466968027,0.3970277935337493
29104,0.7110000000000002,1,1,1,552459,53151,72959,34997,0.4923394716365927,0.3970254571856423
29105,0.7110238095238094,0,1,0,552460,53150,72959,34997,0.4923302086035051,0.39702996131462215
29106,0.7110714285714286,0,2,0,552462,53148,72959,34997,0.49231168253733004,0.39703896987917636
29107,0.7111071428571428,0,1,0,552463,53147,72959,34997,0.49230241950424247,0.39704347431475767
29108,0.7111666666666666,1,3,1,552466,53144,72960,34996,0.4922746304049798,0.39705014749262535
29109,0.7111666666666667,3,9,3,552475,53135,72963,34993,0.4921912631071918,0.3970701706608569
29110,0.7111904761904762,0,1,0,552476,53134,72963,34993,0.4921820000741043,0.3970746763194027
29111,0.7112142857142858,1,0,1,552476,53134,72964,34992,0.4921820000741043,0.3970678346912375
29112,0.7112499999999998,1,0,1,552476,53134,72965,34991,0.4921820000741043,0.3970609929078014
29113,0.71125,0,2,0,552478,53132,72965,34991,0.49216347400792915,0.39707000442563234
29114,0.7113095238095238,0,2,0,552480,53130,72965,34991,0.49214494794175406,0.3970790163525153
29115,0.7113333333333333,6,16,6,552496,53114,72971,34985,0.49199673941235317,0.39711006935379517
29116,0.7113333333333334,1,5,1,552501,53109,72972,34984,0.49195042424691543,0.3971257648167278
29117,0.7113809523809523,0,2,0,552503,53107,72972,34984,0.4919318981807403,0.3971347810786573
29118,0.7114047619047619,1,2,1,552505,53105,72973,34983,0.4919133721145652,0.39713695395513576
29119,0.7114166666666667,2,0,2,552505,53105,72975,34981,0.4919133721145652,0.39712326589923486
29120,0.7114285714285714,1,0,1,552505,53105,72976,34980,0.4919133721145652,0.3971164216381904
29121,0.7114523809523808,1,0,1,552505,53105,72977,34979,0.4919133721145652,0.3971095772217429
29122,0.7114761904761903,0,1,0,552506,53104,72977,34979,0.49190410908147764,0.39711408557837496
29123,0.7114999999999999,1,3,1,552509,53101,72978,34978,0.491876319982215,0.3971207665845434
29124,0.7115,5,12,5,552521,53089,72983,34973,0.4917651635851643,0.3971406509050442
29125,0.7115000000000002,0,1,0,552522,53088,72983,34973,0.4917559005520768,0.3971451607408501
29126,0.7115307241777827,1,9,1,552531,53079,72984,34972,0.4916725332542888,0.3971789076785045
29127,0.7115317460317461,0,1,0,552532,53078,72984,34972,0.4916632702212012,0.39718341851220895
29128,0.711547619047619,0,1,0,552533,53077,72984,34972,0.4916540071881137,0.39718792944837533
29129,0.7115833333333331,0,1,0,552534,53076,72984,34972,0.4916447441550261,0.3971924404870071
29130,0.7116071428571428,0,1,0,552535,53075,72984,34972,0.49163548112193856,0.3971969516281077
29131,0.7116190476190476,1,0,1,552535,53075,72985,34971,0.49163548112193856,0.3971901051722963
29132,0.7116666666666666,29,82,29,552617,52993,73014,34942,0.4908759124087591,0.3973616876101666
29133,0.7116666666666667,17,47,17,552664,52946,73031,34925,0.4904405498536441,0.3974576367629821
29134,0.7117380952380951,0,2,0,552666,52944,73031,34925,0.49042202378746896,0.3974666833581809
29135,0.71175,1,1,1,552667,52943,73032,34924,0.4904127607543814,0.3974643495282643
29136,0.7117500000000001,0,1,0,552668,52942,73032,34924,0.4904034977212939,0.3974688730567
29137,0.7117619047619048,0,1,0,552669,52941,73032,34924,0.4903942346882063,0.39747339668810105
29138,0.7117857142857144,0,1,0,552670,52940,73032,34924,0.49038497165511874,0.3974779204224711
29139,0.7118333333333332,0,5,0,552675,52935,73032,34924,0.490338656489681,0.3975005406389784
29140,0.7118333333333333,2,4,2,552679,52931,73034,34922,0.4903016043573308,0.3975049229963689
29141,0.7118809523809523,0,2,0,552681,52929,73034,34922,0.49028307829115564,0.397513972521656
29142,0.7119047619047619,0,1,0,552682,52928,73034,34922,0.4902738152580681,0.3975184974388162
29143,0.7119444444444444,0,1,0,552683,52927,73034,34922,0.49026455222498055,0.3975230224589921
29144,0.711952380952381,0,2,0,552685,52925,73034,34922,0.4902460261588054,0.3975320728084055
29145,0.7119999999999999,1,3,1,552688,52922,73035,34921,0.49021823705954276,0.39753879079721777
29146,0.7120000000000001,14,33,14,552721,52889,73049,34907,0.4899125569676535,0.3975921454280377
29147,0.7120238095238096,0,1,0,552722,52888,73049,34907,0.48990329393456594,0.3975966740702774
29148,0.7120714285714287,1,0,1,552722,52888,73050,34906,0.48990329393456594,0.39758981251566167
29149,0.7120898268398267,0,1,0,552723,52887,73050,34906,0.4898940309014784,0.3975943412344948
29150,0.712095238095238,0,1,0,552724,52886,73050,34906,0.4898847678683908,0.3975988700564972
29151,0.7121212121212122,1,0,1,552724,52886,73051,34905,0.4898847678683908,0.39759200829242175
29152,0.7121309523809524,0,1,0,552725,52885,73051,34905,0.4898755048353033,0.39759653719102406
29153,0.7121428571428572,2,2,2,552727,52883,73053,34903,0.48985697876912815,0.3975918711411842
29154,0.7121666666666667,2,3,2,552730,52880,73055,34901,0.4898291896698655,0.39759173397432246
29155,0.712190476190476,0,1,0,552731,52879,73055,34901,0.4898199266367779,0.39759626338573706
29156,0.7121994949494949,1,0,1,552731,52879,73056,34900,0.4898199266367779,0.39758940065391496
29157,0.7122222222222223,0,2,0,552733,52877,73056,34900,0.48980140057060284,0.3975984597331875
29158,0.7122619047619048,0,1,0,552734,52876,73056,34900,0.48979213753751527,0.397602989427634
29159,0.7123333333333332,1,5,1,552739,52871,73057,34899,0.48974582237207753,0.3976187763472713
29160,0.7123333333333334,3,9,3,552748,52862,73060,34896,0.4896624550742895,0.3976389616901023
29161,0.7123333333333335,0,3,0,552751,52859,73060,34896,0.48963466597502686,0.39765255540994815
29162,0.7123809523809524,1,4,1,552755,52855,73061,34895,0.48959761384267664,0.39766381766381764
29163,0.7124999999999999,0,3,0,552758,52852,73061,34895,0.489569824743414,0.39767741347282526
29164,0.7125,54,109,54,552867,52743,73115,34841,0.4885601541368706,0.3978009682133723
29165,0.7125000000000001,1,1,1,552868,52742,73116,34840,0.488550891103783,0.3977986344225983
29166,0.7125238095238094,1,0,1,552868,52742,73117,34839,0.488550891103783,0.3977917584864297
29167,0.7125833333333333,0,1,0,552869,52741,73117,34839,0.48854162807069546,0.39779630052523407
29168,0.7126071428571429,1,0,1,552869,52741,73118,34838,0.48854162807069546,0.397789424405394
29169,0.7126190476190476,0,1,0,552870,52740,73118,34838,0.48853236503760794,0.39779396652127247
29170,0.7126190476190477,0,1,0,552871,52739,73118,34838,0.48852310200452037,0.39779850874087946
29171,0.7126547619047621,1,2,1,552873,52737,73119,34837,0.48850457593834523,0.3978007171078174
29172,0.7126587301587302,0,1,0,552874,52736,73119,34837,0.4884953129052577,0.3978052596119809
29173,0.7126666666666666,1,1,1,552875,52735,73120,34836,0.48848604987217015,0.3978029256260634
29174,0.7126666666666667,6,15,6,552890,52720,73126,34830,0.4883471043758568,0.397829811536265
29175,0.7126666666666668,3,5,3,552895,52715,73129,34827,0.4883007892104191,0.3978318978318978
29176,0.7126729104229104,0,4,0,552899,52711,73129,34827,0.48826373707806886,0.39785007653818916
29177,0.7126904761904761,0,1,0,552900,52710,73129,34827,0.4882544740449813,0.39785462147434797
29178,0.7126904761904762,0,2,0,552902,52708,73129,34827,0.4882359479788062,0.39786371165819384
29179,0.7127142857142857,0,1,0,552903,52707,73129,34827,0.48822668494571864,0.397868256905888
29180,0.7127380952380952,0,2,0,552905,52705,73129,34827,0.4882081588795435,0.39787734771283645
29181,0.7127499999999999,0,1,0,552906,52704,73129,34827,0.488198895846456,0.3978818932720979
29182,0.7127777777777777,0,1,0,552907,52703,73129,34827,0.4881896328133684,0.3978864389352222
29183,0.7127820512820513,0,2,0,552909,52701,73129,34827,0.48817110674719333,0.39789553057307375
29184,0.7127857142857144,0,1,0,552910,52700,73129,34827,0.48816184371410576,0.3979000765478081
29185,0.7128246753246753,1,0,1,552910,52700,73130,34826,0.48816184371410576,0.3978931974499006
29186,0.7128333333333333,1,5,1,552915,52695,73131,34825,0.48811552854866797,0.39790904936014626
29187,0.7128560606060605,0,1,0,552916,52694,73131,34825,0.4881062655155804,0.39791359590488923
29188,0.7128571428571427,1,2,1,552918,52692,73132,34824,0.4880877394494053,0.39791580968051554
29189,0.7129166666666668,2,1,2,552919,52691,73134,34822,0.48807847641631774,0.3979065967341995
29190,0.7129285714285715,1,1,1,552920,52690,73135,34821,0.4880692133832302,0.3979042634640217
29191,0.7129523809523809,0,1,0,552921,52689,73135,34821,0.48805995035014266,0.3979088104216661
29192,0.7129999999999999,0,1,0,552922,52688,73135,34821,0.4880506873170551,0.3979133574832303
29193,0.713,5,22,5,552944,52666,73140,34816,0.4878469005891289,0.3979790128254955
29194,0.7130000000000001,1,2,1,552946,52664,73141,34815,0.4878283745229538,0.3979812297808617
29195,0.7130396825396823,0,1,0,552947,52663,73141,34815,0.48781911148986623,0.39798577928164797
29196,0.713047619047619,0,1,0,552948,52662,73141,34815,0.48780984845677866,0.39799032888645014
29197,0.713079365079365,0,1,0,552949,52661,73141,34815,0.48780058542369115,0.39799487859527183
29198,0.7130833333333334,0,2,0,552951,52659,73141,34815,0.487782059357516,0.398003978324988
29199,0.7130952380952381,0,1,0,552952,52658,73141,34815,0.4877727963244285,0.39800852834588957
29200,0.7130952380952382,0,2,0,552954,52656,73141,34815,0.48775427025825335,0.3980176286997976
29201,0.7131340048840048,0,1,0,552955,52655,73141,34815,0.4877450072251658,0.39802217903281123
29202,0.7131428571428572,0,1,0,552956,52654,73141,34815,0.48773574419207827,0.39802672946986933
29203,0.7131666666666666,5,11,5,552967,52643,73146,34810,0.48763385082811517,0.3980423770482431
29204,0.7131666666666667,1,3,1,552970,52640,73147,34809,0.4876060617288525,0.39804914864663976
29205,0.7132142857142857,0,2,0,552972,52638,73147,34809,0.4875875356626774,0.39805825242718446
29206,0.7132142857142858,0,2,0,552974,52636,73147,34809,0.4875690095965023,0.39806735662416376
29207,0.71325,4,0,4,552974,52636,73151,34805,0.4875690095965023,0.3980398211365378
29208,0.7132777777777778,0,1,0,552975,52635,73151,34805,0.4875597465634147,0.39804437328453796
29209,0.7132857142857144,0,2,0,552977,52633,73151,34805,0.48754122049723964,0.39805347789290696
29210,0.7133333333333332,0,1,0,552978,52632,73151,34805,0.48753195746415207,0.3980580303532829
29211,0.7133333333333333,52,99,52,553077,52533,73203,34753,0.4866149171884842,0.39815090621634625
29212,0.7133333333333334,52,107,52,553184,52426,73255,34701,0.4856237726481159,0.3982806707450044
29213,0.7133769841269841,0,3,0,553187,52423,73255,34701,0.48559598354885325,0.3982943850144621
29214,0.713392857142857,0,1,0,553188,52422,73255,34701,0.4855867205157657,0.39829895664749837
29215,0.7134166666666667,1,0,1,553188,52422,73256,34700,0.4855867205157657,0.39829205022841535
29216,0.7134999999999999,6,9,6,553197,52413,73262,34694,0.4855033532179777,0.3982917561160412
29217,0.7135000000000001,0,6,0,553203,52407,73262,34694,0.48544777501945235,0.3983191926613931
29218,0.7135018037518037,0,1,0,553204,52406,73262,34694,0.48543851198636484,0.39832376578645234
29219,0.7135714285714286,0,7,0,553211,52399,73262,34694,0.48537367075475196,0.3983557806023446
29220,0.7135833333333332,0,1,0,553212,52398,73262,34694,0.4853644077216644,0.39836035456758373
29221,0.7136031746031748,0,1,0,553213,52397,73262,34694,0.4853551446885768,0.39836492863786155
29222,0.7136111111111112,0,1,0,553214,52396,73262,34694,0.48534588165548925,0.3983695028131818
29223,0.7136190476190475,0,5,0,553219,52391,73262,34694,0.4852995664900515,0.39839237526554516
29224,0.7136190476190477,1,2,1,553221,52389,73263,34693,0.4852810404238764,0.39839461656829195
29225,0.7136666666666666,0,2,0,553223,52387,73263,34693,0.4852625143577013,0.3984037666513551
29226,0.7136666666666668,0,7,0,553230,52380,73263,34693,0.4851976731260884,0.3984357952522596
29227,0.7136666666666669,0,1,0,553231,52379,73263,34693,0.48518841009300084,0.3984403711870636
29228,0.7136904761904761,1,0,1,553231,52379,73264,34692,0.48518841009300084,0.3984334623468204
29229,0.7136904761904762,0,1,0,553232,52378,73264,34692,0.4851791470599133,0.3984380383599403
29230,0.7137380952380952,0,1,0,553233,52377,73264,34692,0.48516988402682576,0.3984426144781725
29231,0.71375,2,6,2,553239,52371,73266,34690,0.4851143058283004,0.398456254809846
29232,0.7137738095238094,0,1,0,553240,52370,73266,34690,0.4851050427952129,0.39846083161038365
29233,0.7138095238095237,0,1,0,553241,52369,73266,34690,0.4850957797621253,0.3984654085160638
29234,0.7138095238095238,0,1,0,553242,52368,73266,34690,0.48508651672903774,0.3984699855268901
29235,0.7138333333333332,3,6,3,553248,52362,73269,34687,0.48503093853051243,0.3984767200082712
29236,0.7138333333333334,1,3,1,553251,52359,73270,34686,0.4850031494312498,0.3984835429950026
29237,0.7138571428571427,0,1,0,553252,52358,73270,34686,0.4849938863981622,0.398488120950324
29238,0.7139166666666665,0,1,0,553253,52357,73270,34686,0.48498462336507464,0.39849269901083373
29239,0.7139523809523811,1,3,1,553256,52354,73271,34685,0.484956834265812,0.3984995232022427
29240,0.7139999999999997,0,1,0,553257,52353,73271,34685,0.4849475712327244,0.3985041016567476
29241,0.714,2,11,2,553268,52342,73273,34683,0.48484567786876137,0.3985406492387245
29242,0.7140000000000001,17,41,17,553309,52301,73290,34666,0.4844658935121716,0.3986109673784309
29243,0.7140476190476189,0,1,0,553310,52300,73290,34666,0.48445663047908405,0.3986155509049514
29244,0.7140476190476192,0,1,0,553311,52299,73290,34666,0.48444736744599654,0.39862013453688266
29245,0.7140555555555553,0,1,0,553312,52298,73290,34666,0.48443810441290897,0.3986247182742284
29246,0.7141666666666666,10,20,10,553332,52278,73300,34656,0.4842528437511579,0.39864724963765613
29247,0.7141666666666667,7,19,7,553351,52259,73307,34649,0.48407684612249435,0.39868596676945733
29248,0.7141666666666668,0,2,0,553353,52257,73307,34649,0.4840583200563192,0.39869514187743077
29249,0.7141904761904763,0,1,0,553354,52256,73307,34649,0.4840490570232317,0.39869972958978195
29250,0.7142380952380953,0,2,0,553356,52254,73307,34649,0.48403053095705656,0.3987089053312314
29251,0.7142857142857143,1,3,1,553359,52251,73308,34648,0.4840027418577939,0.3987157504689352
29252,0.7143015873015872,0,1,0,553360,52250,73308,34648,0.48399347882470634,0.39872033878800434
29253,0.7143095238095237,0,2,0,553362,52248,73308,34648,0.48397495275853125,0.3987295157429571
29254,0.7143333333333333,1,5,1,553367,52243,73309,34647,0.48392863759309346,0.39874554033835885
29255,0.7143333333333334,5,6,5,553373,52237,73314,34642,0.48387305939456815,0.3987384753507752
29256,0.7143650793650795,0,1,0,553374,52236,73314,34642,0.4838637963614806,0.39874306498768386
29257,0.7143809523809524,0,2,0,553376,52234,73314,34642,0.4838452702953055,0.3987522445784797
29258,0.7144047619047619,0,2,0,553378,52232,73314,34642,0.4838267442291304,0.39876142459193775
29259,0.7144166666666666,0,1,0,553379,52231,73314,34642,0.48381748119604284,0.39876601475717427
29260,0.7144444444444444,0,1,0,553380,52230,73314,34642,0.4838082181629553,0.3987706050280873
29261,0.7144999999999999,3,2,3,553382,52228,73317,34639,0.4837896920967802,0.39875902241357475
29262,0.7145,4,3,4,553385,52225,73321,34635,0.48376190299751753,0.3987451070688464
29263,0.7145238095238095,1,0,1,553385,52225,73322,34634,0.48376190299751753,0.39873818487433654
29264,0.714547619047619,1,0,1,553385,52225,73323,34633,0.48376190299751753,0.39873126252043567
29265,0.7145833333333336,0,1,0,553386,52224,73323,34633,0.48375263996442996,0.39873585318396904
29266,0.7145952380952381,0,1,0,553387,52223,73323,34633,0.4837433769313424,0.3987404439532099
29267,0.7146190476190476,0,2,0,553389,52221,73323,34633,0.4837248508651673,0.3987496258088286
29268,0.7146269841269841,1,1,1,553390,52220,73324,34632,0.48371558783207974,0.39874729424768574
29269,0.7146666666666666,0,1,0,553391,52219,73324,34632,0.48370632479899217,0.3987518854129486
29270,0.7146666666666667,3,10,3,553401,52209,73327,34629,0.48361369446811664,0.39877703309611
29271,0.7146666666666668,1,0,1,553401,52209,73328,34628,0.48361369446811664,0.3987701095155291
29272,0.7147272727272727,1,0,1,553401,52209,73329,34627,0.48361369446811664,0.3987631857754848
29273,0.71475,0,1,0,553402,52208,73329,34627,0.48360443143502907,0.3987677779697127
29274,0.7148095238095238,1,0,1,553402,52208,73330,34626,0.48360443143502907,0.3987608540433471
29275,0.7148253968253968,0,1,0,553403,52207,73330,34626,0.48359516840194156,0.3987654463164926
29276,0.7148333333333332,1,3,1,553406,52204,73331,34625,0.48356737930267885,0.3987722995773302
29277,0.7148333333333333,1,14,1,553420,52190,73332,34624,0.4834376968394531,0.3988296818485498
29278,0.7148333333333334,1,2,1,553422,52188,73333,34623,0.483419170773278,0.3988319452603933
29279,0.7148809523809524,1,0,1,553422,52188,73334,34622,0.483419170773278,0.39882502015896787
29280,0.7149285714285715,0,1,0,553423,52187,73334,34622,0.48340990774019044,0.398829614440899
29281,0.7149999999999999,1,8,1,553431,52179,73335,34621,0.48333580347549,0.3988594470046083
29282,0.715,193,379,193,553810,51800,73528,34428,0.47982511393530697,0.39926705942385304
29283,0.7150000000000002,1,1,1,553811,51799,73529,34427,0.4798158509022194,0.39926472293739707
29284,0.715050505050505,1,1,1,553812,51798,73530,34426,0.4798065878691319,0.3992623863425496
29285,0.7150595238095238,0,2,0,553814,51796,73530,34426,0.47978806180295674,0.3992716476073392
29286,0.7150833333333333,0,2,0,553816,51794,73530,34426,0.47976953573678166,0.3992809093017861
29287,0.7150952380952381,1,0,1,553816,51794,73531,34425,0.47976953573678166,0.3992739419385518
29288,0.7151190476190475,0,1,0,553817,51793,73531,34425,0.4797602727036941,0.39927857291980795
29289,0.7151190476190478,0,3,0,553820,51790,73531,34425,0.47973248360443144,0.39929246650814826
29290,0.7151428571428571,0,1,0,553821,51789,73531,34425,0.47972322057134387,0.3992970979191315
29291,0.7151569264069263,0,3,0,553824,51786,73531,34425,0.4796954314720812,0.39931099279674287
29292,0.7151666666666665,0,1,0,553825,51785,73531,34425,0.47968616843899364,0.399315624637513
29293,0.7151666666666666,2,3,2,553828,51782,73533,34423,0.479658379339731,0.39931558494286873
29294,0.7151666666666668,0,2,0,553830,51780,73533,34423,0.4796398532735559,0.39932484948319663
29295,0.7151904761904763,0,1,0,553831,51779,73533,34423,0.47963059024046834,0.39932948191457274
29296,0.7152380952380952,1,0,1,553831,51779,73534,34422,0.47963059024046834,0.3993225136599343
29297,0.7153214285714286,1,1,1,553832,51778,73535,34421,0.47962132720738077,0.39932017772827993
29298,0.7153333333333332,0,1,0,553833,51777,73535,34421,0.47961206417429325,0.39932481032042505
29299,0.7153333333333333,3,13,3,553846,51764,73538,34418,0.479491644744155,0.3993641363625815
29300,0.7153333333333335,0,1,0,553847,51763,73538,34418,0.4794823817110675,0.39936877037862173
29301,0.7153571428571428,1,1,1,553848,51762,73539,34417,0.4794731186779799,0.399366434978359
29302,0.7154166666666666,2,0,2,553848,51762,73541,34415,0.4794731186779799,0.39935249544542045
29303,0.7154166666666667,1,1,1,553849,51761,73542,34414,0.47946385564489236,0.39935015955903685
29304,0.7154239649239648,1,3,1,553852,51758,73543,34413,0.4794360665456297,0.3993570922932309
29305,0.7154246031746031,0,2,0,553854,51756,73543,34413,0.4794175404794546,0.3993663614524945
29306,0.7154761904761905,1,2,1,553856,51754,73544,34412,0.4793990144132795,0.39936866049253766
29307,0.7154999999999998,0,1,0,553857,51753,73544,34412,0.4793897513801919,0.3993732954215749
29308,0.7155,3,8,3,553865,51745,73547,34409,0.4793156471154915,0.3993894653759547
29309,0.7155000000000001,1,1,1,553866,51744,73548,34408,0.47930638408240395,0.39938712972420837
29310,0.7155000000000004,0,1,0,553867,51743,73548,34408,0.4792971210493164,0.39939176562082856
29311,0.7155476190476189,0,1,0,553868,51742,73548,34408,0.4792878580162288,0.39939640162507256
29312,0.715547619047619,0,1,0,553869,51741,73548,34408,0.4792785949831413,0.39940103773694413
29313,0.7155555555555556,0,1,0,553870,51740,73548,34408,0.4792693319500537,0.39940567395644705
29314,0.7155555555555557,0,1,0,553871,51739,73548,34408,0.47926006891696615,0.39941031028358503
29315,0.7155753968253968,0,1,0,553872,51738,73548,34408,0.47925080588387864,0.39941494671836186
29316,0.7155833333333333,0,5,0,553877,51733,73548,34408,0.47920449071844085,0.39943813050695953
29317,0.7155952380952381,0,1,0,553878,51732,73548,34408,0.4791952276853533,0.399442767587648
29318,0.7156666666666667,4,9,4,553887,51723,73552,34404,0.4791118603875653,0.3994566163920722
29319,0.7156666666666668,1,1,1,553888,51722,73553,34403,0.47910259735447774,0.39945428156748913
29320,0.7157142857142855,0,1,0,553889,51721,73553,34403,0.4790933343213902,0.39945891969718084
29321,0.7157142857142857,2,5,2,553894,51716,73555,34401,0.47904701915595244,0.3994681654028821
29322,0.7157499999999999,0,1,0,553895,51715,73555,34401,0.47903775612286487,0.39947280412466907
29323,0.7157738095238096,0,1,0,553896,51714,73555,34401,0.4790284930897773,0.3994774429541892
29324,0.7157857142857142,1,1,1,553897,51713,73556,34400,0.4790192300566898,0.39947510828794724
29325,0.7157857142857144,1,1,1,553898,51712,73557,34399,0.4790099670236022,0.39947277351325616
29326,0.7158095238095237,0,1,0,553899,51711,73557,34399,0.47900070399051464,0.39947741261177566
29327,0.7158333333333333,9,13,9,553912,51698,73566,34390,0.47888028456037646,0.3994749558591209
29328,0.7158333333333334,11,32,11,553944,51666,73577,34379,0.4785838675015747,0.3995467487942356
29329,0.7158650793650793,0,1,0,553945,51665,73577,34379,0.47857460446848715,0.3995513923109107
29330,0.7159166666666666,0,1,0,553946,51664,73577,34379,0.4785653414353996,0.39955603593552064
29331,0.7159761904761907,1,3,1,553949,51661,73578,34378,0.47853755233613693,0.3995629888771371
29332,0.7159999999999997,0,1,0,553950,51660,73578,34378,0.4785282893030494,0.3995676329063902
29333,0.716,22,59,22,554009,51601,73600,34356,0.4779817703508837,0.3996882162011238
29334,0.7160000000000001,2,1,2,554010,51600,73602,34354,0.4779725073177961,0.39967889801521744
29335,0.7160238095238093,0,1,0,554011,51599,73602,34354,0.4779632442847086,0.39968354798552697
29336,0.7160476190476192,1,0,1,554011,51599,73603,34353,0.4779632442847086,0.39967656366344007
29337,0.7160714285714286,0,1,0,554012,51598,73603,34353,0.47795398125162103,0.399681213714791
29338,0.7160833333333333,0,1,0,554013,51597,73603,34353,0.47794471821853346,0.39968586387434557
29339,0.7160952380952379,1,1,1,554014,51596,73604,34352,0.47793545518544595,0.3996835295760227
29340,0.7160952380952381,0,1,0,554015,51595,73604,34352,0.4779261921523584,0.3996881799248374
29341,0.7161111111111111,1,2,1,554017,51593,73605,34351,0.47790766608618324,0.39969049613701946
29342,0.7161666666666666,2,2,2,554019,51591,73607,34349,0.47788914002000815,0.399685827321387
29343,0.7161666666666667,2,2,2,554021,51589,73609,34347,0.47787061395383307,0.3996811580711227
29344,0.7161904761904762,0,2,0,554023,51587,73609,34347,0.47785208788765793,0.39969046012055764
29345,0.7162142857142857,0,1,0,554024,51586,73609,34347,0.47784282485457036,0.3996951113076467
29346,0.7162380952380952,0,1,0,554025,51585,73609,34347,0.47783356182148284,0.3996997626029884
29347,0.71625,1,1,1,554026,51584,73610,34346,0.4778242987883953,0.3996974281391831
29348,0.7162777777777777,0,1,0,554027,51583,73610,34346,0.4778150357553077,0.39970207962387555
29349,0.7162857142857142,1,0,1,554027,51583,73611,34345,0.4778150357553077,0.399695093566707
29350,0.7162857142857143,0,1,0,554028,51582,73611,34345,0.4778057727222202,0.3996997451324962
29351,0.7163095238095238,0,1,0,554029,51581,73611,34345,0.4777965096891326,0.39970439680655445
29352,0.716309523809524,1,2,1,554031,51579,73612,34344,0.4777779836229575,0.3997067141510422
29353,0.7163279220779221,1,0,1,554031,51579,73613,34343,0.4777779836229575,0.3996997276599707
29354,0.7163333333333333,1,11,1,554042,51568,73614,34342,0.4776760902589944,0.39974391805377724
29355,0.7163333333333334,1,2,1,554044,51566,73615,34341,0.4776575641928193,0.3997462372100062
29356,0.7163690476190476,0,1,0,554045,51565,73615,34341,0.4776483011597317,0.39975089050822993
29357,0.7163888888888887,0,1,0,554046,51564,73615,34341,0.4776390381266442,0.39975554391478957
29358,0.7164166666666667,0,1,0,554047,51563,73615,34341,0.47762977509355664,0.39976019742968893
29359,0.7164285714285714,1,1,1,554048,51562,73616,34340,0.47762051206046907,0.399757863612023
29360,0.7164999999999999,0,3,0,554051,51559,73616,34340,0.4775927229612064,0.3997718250503498
29361,0.7165,3,19,3,554070,51540,73619,34337,0.47741672533254287,0.3998393050525752
29362,0.716547619047619,1,1,1,554071,51539,73620,34336,0.47740746229945535,0.39983697234352256
29363,0.7165714285714284,0,2,0,554073,51537,73620,34336,0.4773889362332802,0.39984628462962746
29364,0.7165800865800867,0,1,0,554074,51536,73620,34336,0.47737967320019264,0.3998509409353456
29365,0.7165833333333331,0,1,0,554075,51535,73620,34336,0.47737041016710513,0.39985559734951265
29366,0.7165873015873017,0,1,0,554076,51534,73620,34336,0.47736114713401756,0.3998602538721323
29367,0.7166190476190476,0,1,0,554077,51533,73620,34336,0.47735188410093,0.3998649105032084
29368,0.7166666666666666,48,154,48,554231,51379,73668,34288,0.4759253770054467,0.4002474698542029
29369,0.7166666666666667,47,104,47,554335,51275,73715,34241,0.47496202156434103,0.4004046026474578
29370,0.7167222222222223,0,1,0,554336,51274,73715,34241,0.47495275853125346,0.40040928492077416
29371,0.7167286324786325,1,0,1,554336,51274,73716,34240,0.47495275853125346,0.4004022733119723
29372,0.7167857142857144,0,4,0,554340,51270,73716,34240,0.47491570639890324,0.40042100339141623
29373,0.7168095238095238,0,1,0,554341,51269,73716,34240,0.4749064433658157,0.40042568618507995
29374,0.7168214285714285,1,0,1,554341,51269,73717,34239,0.4749064433658157,0.4004186742760911
29375,0.7168333333333332,0,1,0,554342,51268,73717,34239,0.47489718033272815,0.400423357152046
29376,0.7168333333333333,1,4,1,554346,51264,73718,34238,0.47486012820037793,0.4004350775420458
29377,0.7168809523809524,0,1,0,554347,51263,73718,34238,0.47485086516729036,0.40043976093846856
29378,0.7168809523809526,0,2,0,554349,51261,73718,34238,0.4748323391011153,0.4004491280599773
29379,0.7169047619047619,0,2,0,554351,51259,73718,34238,0.47481381303494014,0.40045849561972935
29380,0.7169444444444444,0,2,0,554353,51257,73718,34238,0.47479528696876505,0.40046786361775544
29381,0.716952380952381,0,1,0,554354,51256,73718,34238,0.4747860239356775,0.40047254778113084
29382,0.716969696969697,0,1,0,554355,51255,73718,34238,0.47477676090258997,0.4004772320540863
29383,0.7169999999999999,0,3,0,554358,51252,73718,34238,0.47474897180332726,0.4004912855304714
29384,0.7170000000000001,1,15,1,554373,51237,73719,34237,0.474610026307014,0.40055455460139927
29385,0.7170238095238095,1,1,1,554374,51236,73720,34236,0.4746007632739264,0.40055222763010107
29386,0.7170833333333333,0,1,0,554375,51235,73720,34236,0.47459150024083885,0.4005569140410198
29387,0.7170952380952381,0,5,0,554380,51230,73720,34236,0.4745451850754011,0.400580347740622
29388,0.7171428571428572,2,3,2,554383,51227,73722,34234,0.4745173959761384,0.4005803816945741
29389,0.7171666666666665,0,1,0,554384,51226,73722,34234,0.4745081329430509,0.4005850690381465
29390,0.7171666666666667,1,4,1,554388,51222,73723,34233,0.47447108081070066,0.40059680533614184
29391,0.7171666666666668,0,1,0,554389,51221,73723,34233,0.4744618177776131,0.40060149320102045
29392,0.7171785714285714,1,0,1,554389,51221,73724,34232,0.4744618177776131,0.4005944788363194
29393,0.7171904761904762,1,0,1,554389,51221,73725,34231,0.4744618177776131,0.40058746430744746
29394,0.7172023809523813,0,3,0,554392,51218,73725,34231,0.47443402867835044,0.40060152839705554
29395,0.7172619047619047,0,1,0,554393,51217,73725,34231,0.47442476564526287,0.4006062166463814
29396,0.7172619047619048,0,1,0,554394,51216,73725,34231,0.47441550261217535,0.400610905005442
29397,0.7173333333333332,0,3,0,554397,51213,73725,34231,0.47438771351291265,0.4006249707410702
29398,0.7173333333333334,3,6,3,554403,51207,73728,34228,0.47433213531438734,0.4006320594604085
29399,0.7173333333333335,0,1,0,554404,51206,73728,34228,0.47432287228129977,0.40063674883535827
29400,0.7173571428571428,1,1,1,554405,51205,73729,34227,0.47431360924821225,0.40063442269875454
29401,0.7173809523809525,1,0,1,554405,51205,73730,34226,0.47431360924821225,0.4006274069131814
29402,0.7174642857142857,0,1,0,554406,51204,73730,34226,0.4743043462151247,0.40063209645323655
29403,0.7174999999999998,0,3,0,554409,51201,73730,34226,0.47427655711586203,0.40064616573214556
29404,0.7175,46,115,46,554524,51086,73776,34180,0.4732113083107933,0.4008631811038397
29405,0.7175000000000001,3,5,3,554529,51081,73779,34177,0.47316499314535554,0.40086560791949144
29406,0.7175555555555556,0,2,0,554531,51079,73779,34177,0.4731464670791804,0.4008750117293797
29407,0.7175833333333331,1,3,1,554534,51076,73780,34176,0.47311867797991775,0.40088209074273917
29408,0.7175833333333332,0,1,0,554535,51075,73780,34176,0.4731094149468302,0.40088679311679626
29409,0.7176190476190476,1,4,1,554539,51071,73781,34175,0.47307236281447995,0.4008985758862586
29410,0.7176666666666666,1,1,1,554540,51070,73782,34174,0.47306309978139244,0.400896250762517
29411,0.7176666666666667,4,12,4,554552,51058,73786,34170,0.47295194338434177,0.4009245787769278
29412,0.7176666666666668,3,4,3,554556,51054,73789,34167,0.47291489125199154,0.4009223078818601
29413,0.7177142857142859,0,3,0,554559,51051,73789,34167,0.4728871021527289,0.40093642188270084
29414,0.7177222222222223,0,1,0,554560,51050,73789,34167,0.4728778391196413,0.40094112677048005
29415,0.7177380952380952,0,2,0,554562,51048,73789,34167,0.47285931305346623,0.40095053687731036
29416,0.7177380952380953,0,1,0,554563,51047,73789,34167,0.47285005002037866,0.4009552420963691
29417,0.7177420634920637,0,2,0,554565,51045,73789,34167,0.4728315239542036,0.4009646528657935
29418,0.7177857142857141,1,3,1,554568,51042,73790,34166,0.4728037348549409,0.40097173974274714
29419,0.7177857142857144,0,2,0,554570,51040,73790,34166,0.4727852087887658,0.40098115156209657
29420,0.7178095238095239,1,1,1,554571,51039,73791,34165,0.4727759457556782,0.400978827285104
29421,0.7178205128205127,0,1,0,554572,51038,73791,34165,0.4727666827225907,0.4009835334436581
29422,0.7178333333333333,1,4,1,554576,51034,73792,34164,0.4727296305902405,0.4009953285288387
29423,0.7178333333333334,0,1,0,554577,51033,73792,34164,0.4727203675571529,0.4010000352125075
29424,0.717857142857143,1,0,1,554577,51033,73793,34163,0.4727203675571529,0.4009930043664022
29425,0.7178809523809523,1,2,1,554579,51031,73794,34162,0.4727018414909778,0.4009953869449368
29426,0.7179047619047618,0,1,0,554580,51030,73794,34162,0.47269257845789026,0.40100009390553104
29427,0.7179166666666668,0,5,0,554585,51025,73794,34162,0.47264626329245246,0.4010236303661357
29428,0.7179523809523809,1,0,1,554585,51025,73795,34161,0.47264626329245246,0.40101659897166203
29429,0.7179801587301587,0,2,0,554587,51023,73795,34161,0.4726277372262774,0.4010260142749812
29430,0.7179999999999999,0,2,0,554589,51021,73795,34161,0.47260921116010224,0.40103543002042685
29431,0.718,10,28,10,554617,50993,73805,34151,0.4723498462336507,0.4010969651414075
29432,0.7180000000000001,1,5,1,554622,50988,73806,34150,0.472303531068213,0.40111348633982474
29433,0.7180357142857143,0,1,0,554623,50987,73806,34150,0.4722942680351254,0.4011181977283672
29434,0.7180555555555556,0,1,0,554624,50986,73806,34150,0.47228500500203785,0.4011229092275888
29435,0.7181547619047619,0,2,0,554626,50984,73806,34150,0.47226647893586277,0.4011323325580849
29436,0.7181666666666666,2,5,2,554631,50979,73808,34148,0.47222016377042497,0.40114182339328297
29437,0.7181666666666667,2,1,2,554632,50978,73810,34146,0.47221090073733746,0.401132465579625
29438,0.7182142857142857,0,2,0,554634,50976,73810,34146,0.4721923746711623,0.4011418904631
29439,0.7182499999999998,0,2,0,554636,50974,73810,34146,0.47217384860498723,0.40115131578947366
29440,0.7182857142857145,0,1,0,554637,50973,73810,34146,0.47216458557189966,0.40115602861875727
29441,0.7183333333333333,18,53,18,554690,50920,73828,34128,0.4716736448182593,0.4012792775844229
29442,0.7183333333333334,37,75,37,554765,50845,73865,34091,0.4709789173366927,0.40137279834228123
29443,0.7183809523809525,0,2,0,554767,50843,73865,34091,0.47096039127051764,0.40138224974686226
29444,0.7183863636363637,0,1,0,554768,50842,73865,34091,0.47095112823743007,0.40138697561607384
29445,0.7183888888888891,0,1,0,554769,50841,73865,34091,0.4709418652043425,0.4013917015965714
29446,0.7184047619047618,1,0,1,554769,50841,73866,34090,0.4709418652043425,0.40138465342454466
29447,0.7184523809523811,0,1,0,554770,50840,73866,34090,0.47093260217125493,0.40138937948899095
29448,0.7184682539682538,1,0,1,554770,50840,73867,34089,0.47093260217125493,0.40138233112364446
29449,0.7184999999999998,0,1,0,554771,50839,73867,34089,0.4709233391381674,0.4013870572720422
29450,0.7184999999999999,7,14,7,554785,50825,73874,34082,0.47079365667494166,0.40140388896086304
29451,0.7185000000000001,0,4,0,554789,50821,73874,34082,0.47075660454259144,0.4014228001366265
29452,0.7185000000000002,0,1,0,554790,50820,73874,34082,0.47074734150950387,0.4014275282089939
29453,0.7185079365079367,0,1,0,554791,50819,73874,34082,0.4707380784764163,0.4014322563927398
29454,0.7185084213172448,1,3,1,554794,50816,73875,34081,0.47071028937715365,0.40143939126235323
29455,0.7185238095238096,0,1,0,554795,50815,73875,34081,0.4707010263440661,0.40144411986430456
29456,0.7185714285714286,1,1,1,554796,50814,73876,34080,0.47069176331097856,0.4014417980069263
29457,0.7186190476190477,0,2,0,554798,50812,73876,34080,0.4706732372448034,0.4014512557131414
29458,0.7186450216450218,1,0,1,554798,50812,73877,34079,0.4706732372448034,0.4014442049216054
29459,0.7186666666666666,0,4,0,554802,50808,73877,34079,0.4706361851124532,0.4014631215616054
29460,0.7186666666666668,5,5,5,554807,50803,73882,34074,0.47058986994701546,0.40145151218822533
29461,0.7186904761904762,0,1,0,554808,50802,73882,34074,0.4705806069139279,0.40145624204722186
29462,0.7187023809523809,1,4,1,554812,50798,73883,34073,0.47054355478157767,0.40146811042641184
29463,0.71875,1,2,1,554814,50796,73884,34072,0.4705250287154026,0.4014705189235047
29464,0.7187777777777776,0,1,0,554815,50795,73884,34072,0.470515765682315,0.4014752495080538
29465,0.7188214285714285,0,1,0,554816,50794,73884,34072,0.47050650264922744,0.40147998020408643
29466,0.7188333333333332,1,4,1,554820,50790,73885,34071,0.4704694505168772,0.4014918513804928
29467,0.7188333333333334,0,3,0,554823,50787,73885,34071,0.47044166141761457,0.4015060453934809
29468,0.7188809523809523,0,1,0,554824,50786,73885,34071,0.47043239838452705,0.40151077695417
29469,0.7189047619047619,0,1,0,554825,50785,73885,34071,0.4704231353514395,0.4015155086263788
29470,0.7189285714285716,0,1,0,554826,50784,73885,34071,0.4704138723183519,0.40152024041011136
29471,0.7189761904761903,1,1,1,554827,50783,73886,34070,0.47040460928526434,0.4015179192250127
29472,0.7189999999999999,1,2,1,554829,50781,73887,34069,0.47038608321908926,0.40152032999410725
29473,0.7190000000000001,5,24,5,554853,50757,73892,34064,0.47016377042498797,0.4015986607090225
29474,0.7190238095238094,0,1,0,554854,50756,73892,34064,0.4701545073919004,0.4016033954256072
29475,0.719031746031746,2,4,2,554858,50752,73894,34062,0.4701174552595502,0.40160822505718397
29476,0.7190476190476192,0,3,0,554861,50749,73894,34062,0.4700896661602875,0.4016224310525757
29477,0.7190714285714285,0,1,0,554862,50748,73894,34062,0.47008040312719995,0.40162716660771136
29478,0.7191190476190475,0,2,0,554864,50746,73894,34062,0.47006187706102487,0.40163663805301386
29479,0.7191386130209658,1,2,1,554866,50744,73895,34061,0.47004335099484973,0.4016390543010436
29480,0.7191428571428571,1,0,1,554866,50744,73896,34060,0.47004335099484973,0.40163199849063724
29481,0.7191666666666666,10,14,10,554880,50730,73906,34050,0.469913668531624,0.4016277423920736
29482,0.7191666666666667,8,22,8,554902,50708,73914,34042,0.4697098818036978,0.4016755162241888
29483,0.7192222222222223,0,1,0,554903,50707,73914,34042,0.46970061877061026,0.4016802558142279
29484,0.7192619047619049,0,1,0,554904,50706,73914,34042,0.4696913557375227,0.40168499551611836
29485,0.7192738095238096,0,1,0,554905,50705,73914,34042,0.4696820927044351,0.4016897353298642
29486,0.7192857142857142,0,2,0,554907,50703,73914,34042,0.46966356663826003,0.4016992152929376
29487,0.7192857142857143,0,2,0,554909,50701,73914,34042,0.46964504057208495,0.40170869570347995
29488,0.7193333333333333,1,0,1,554909,50701,73915,34041,0.46964504057208495,0.40170163555261856
29489,0.7193333333333334,3,20,3,554929,50681,73918,34038,0.46945977991033383,0.4017752806336241
29490,0.719357142857143,0,1,0,554930,50680,73918,34038,0.46945051687724626,0.4017800231355792
29491,0.7193809523809523,1,1,1,554931,50679,73919,34037,0.46944125384415875,0.4017777043297606
29492,0.7194047619047619,0,1,0,554932,50678,73919,34037,0.4694319908110712,0.40178244702827126
29493,0.7194166666666666,1,2,1,554934,50676,73920,34036,0.4694134647448961,0.4017848710926433
29494,0.719452380952381,0,1,0,554935,50675,73920,34036,0.4694042017118085,0.4017896140997037
29495,0.7194761904761904,0,1,0,554936,50674,73920,34036,0.46939493867872095,0.4017943572187463
29496,0.7194761904761906,0,1,0,554937,50673,73920,34036,0.4693856756456334,0.4017991004497751
29497,0.7194999999999999,0,1,0,554938,50672,73920,34036,0.46937641261254587,0.40180384379279405
29498,0.7195,4,5,4,554943,50667,73924,34032,0.4693300974471081,0.4017993128608366
29499,0.7195238095238097,1,0,1,554943,50667,73925,34031,0.4693300974471081,0.40179225011216324
29500,0.7195833333333335,0,1,0,554944,50666,73925,34031,0.4693208344140205,0.401796993990342
29501,0.7195952380952381,0,1,0,554945,50665,73925,34031,0.469311571380933,0.4018017379805422
29502,0.7196031746031746,0,1,0,554946,50664,73925,34031,0.4693023083478454,0.4018064820827676
29503,0.7196190476190476,0,1,0,554947,50663,73925,34031,0.46929304531475785,0.4018112262970222
29504,0.719642857142857,1,0,1,554947,50663,73926,34030,0.46929304531475785,0.4018041632720532
29505,0.7196666666666666,0,2,0,554949,50661,73926,34030,0.46927451924858277,0.4018136519819107
29506,0.7196666666666667,5,10,5,554959,50651,73931,34025,0.46918188891770723,0.4018257829845529
29507,0.7197142857142856,1,0,1,554959,50651,73932,34024,0.46918188891770723,0.4018187186300561
29508,0.7197824675324672,0,6,0,554965,50645,73932,34024,0.46912631071918187,0.4018471931875893
29509,0.7197857142857143,0,2,0,554967,50643,73932,34024,0.4691077846530068,0.4018566856036
29510,0.7198015873015874,0,3,0,554970,50640,73932,34024,0.46907999555374413,0.4018709250685061
29511,0.7198095238095238,1,2,1,554972,50638,73933,34023,0.469061469487569,0.40187335372839916
29512,0.7198333333333332,0,2,0,554974,50636,73933,34023,0.4690429434213939,0.4018828476594337
29513,0.7198333333333333,3,6,3,554980,50630,73936,34020,0.4689873652228686,0.40189013585351446
29514,0.7199523809523811,0,1,0,554981,50629,73936,34020,0.46897810218978103,0.40189488357806946
29515,0.7199999999999999,2,7,2,554988,50622,73938,34018,0.46891326095816815,0.401913988657845
29516,0.72,683,1350,683,556338,49272,74621,33335,0.45640816628997,0.4035372305010471
29517,0.7200000000000002,3,4,3,556342,49268,74624,33332,0.4563711141576198,0.40353510895883776
29518,0.720047619047619,0,1,0,556343,49267,74624,33332,0.4563618511245322,0.4035399944309253
29519,0.7200912698412699,0,2,0,556345,49265,74624,33332,0.4563433250583571,0.4035497657299902
29520,0.7201428571428571,1,1,1,556346,49264,74625,33331,0.45633406202526955,0.40354743023185424
29521,0.7201666666666665,0,1,0,556347,49263,74625,33331,0.456324798992182,0.4035523161488728
29522,0.7201666666666666,2,6,2,556353,49257,74627,33329,0.45626922079365667,0.4035671905649868
29523,0.7201666666666668,1,5,1,556358,49252,74628,33328,0.4562229056282189,0.40358440300314846
29524,0.7202380952380952,1,0,1,556358,49252,74629,33327,0.4562229056282189,0.40357718063914555
29525,0.7202445054945054,0,2,0,556360,49250,74629,33327,0.4562043795620438,0.40358695520544463
29526,0.7202777777777776,0,3,0,556363,49247,74629,33327,0.45617659046278114,0.40360161794269384
29527,0.7202777777777777,0,1,0,556364,49246,74629,33327,0.45616732742969357,0.4036065057585409
29528,0.7202820512820512,1,3,1,556367,49243,74630,33326,0.4561395383304309,0.4036139471230123
29529,0.7202857142857142,0,1,0,556368,49242,74630,33326,0.45613027529734335,0.4036188353841682
29530,0.7202857142857144,0,1,0,556369,49241,74630,33326,0.45612101226425583,0.4036237237637313
29531,0.7203095238095238,0,1,0,556370,49240,74630,33326,0.45611174923116826,0.40362861226170577
29532,0.7203333333333333,4,5,4,556375,49235,74634,33322,0.45606543406573047,0.4036241626997105
29533,0.7203333333333335,0,1,0,556376,49234,74634,33322,0.45605617103264295,0.40362905179514513
29534,0.7204166666666667,0,1,0,556377,49233,74634,33322,0.4560469079995554,0.4036339410090243
29535,0.7204523809523811,0,1,0,556378,49232,74634,33322,0.4560376449664678,0.40363883034135234
29536,0.7204761904761904,0,1,0,556379,49231,74634,33322,0.45602838193338024,0.40364371979213354
29537,0.7204999999999998,0,2,0,556381,49229,74634,33322,0.45600985586720516,0.4036534990490727
29538,0.7204999999999999,0,17,0,556398,49212,74634,33322,0.45585238430471675,0.4037366418688056
29539,0.7205000000000001,0,5,0,556403,49207,74634,33322,0.45580606913927896,0.4037611021580293
29540,0.7205158730158729,0,4,0,556407,49203,74634,33322,0.45576901700692873,0.4037806725234777
29541,0.7205238095238096,0,1,0,556408,49202,74634,33322,0.4557597539738412,0.4037855654112743
29542,0.7205555555555556,1,0,1,556408,49202,74635,33321,0.4557597539738412,0.4037783405838372
29543,0.7206666666666665,0,1,0,556409,49201,74635,33321,0.45575049094075365,0.4037832335619592
29544,0.7206666666666667,5,13,5,556422,49188,74640,33316,0.4556300715106154,0.4038107243285174
29545,0.7206666666666668,1,1,1,556423,49187,74641,33315,0.4556208084775279,0.4038083925238176
29546,0.7206904761904763,0,1,0,556424,49186,74641,33315,0.4556115454444403,0.40381328711167136
29547,0.7207142857142856,2,1,2,556425,49185,74643,33313,0.45560228241135275,0.40380372857523816
29548,0.7207499999999999,0,1,0,556426,49184,74643,33313,0.45559301937826524,0.4038086233438792
29549,0.7207500000000002,0,1,0,556427,49183,74643,33313,0.45558375634517767,0.40381351823118694
29550,0.7207619047619049,0,1,0,556428,49182,74643,33313,0.4555744933120901,0.4038184132371659
29551,0.7207857142857143,0,1,0,556429,49181,74643,33313,0.45556523027900253,0.40382330836182023
29552,0.7208095238095237,0,1,0,556430,49180,74643,33313,0.455555967245915,0.40382820360515437
29553,0.7208095238095238,1,0,1,556430,49180,74644,33312,0.455555967245915,0.40382097657954713
29554,0.7208333333333333,7,27,7,556457,49153,74651,33305,0.455305865352551,0.4039025928351403
29555,0.7208333333333334,8,21,8,556478,49132,74659,33297,0.4551113416577124,0.4039476397869682
29556,0.720952380952381,0,1,0,556479,49131,74659,33297,0.4551020786246249,0.40395254039889356
29557,0.7209761904761903,0,1,0,556480,49130,74659,33297,0.4550928155915373,0.4039574411297269
29558,0.7209761904761904,0,1,0,556481,49129,74659,33297,0.45508355255844973,0.4039623419794725
29559,0.721,10,22,10,556503,49107,74669,33287,0.45487976583052353,0.4039978639221303
29560,0.7210000000000001,4,6,4,556509,49101,74673,33283,0.4548241876319982,0.4039983491940183
29561,0.7210000000000002,0,1,0,556510,49100,74673,33283,0.45481492459891065,0.4040032530983334
29562,0.7210714285714286,0,2,0,556512,49098,74673,33283,0.45479639853273557,0.40401306126412645
29563,0.7211428571428571,1,0,1,556512,49098,74674,33282,0.45479639853273557,0.40400582665695556
29564,0.7211666666666667,1,2,1,556514,49096,74675,33281,0.45477787246656043,0.4040084004030251
29565,0.7211904761904762,0,1,0,556515,49095,74675,33281,0.4547686094334729,0.4040133048460717
29566,0.7212142857142857,0,1,0,556516,49094,74675,33281,0.45475934640038534,0.4040182094081942
29567,0.7212222222222223,0,1,0,556517,49093,74675,33281,0.4547500833672978,0.4040231140893971
29568,0.721253968253968,1,0,1,556517,49093,74676,33280,0.4547500833672978,0.4040158789894747
29569,0.721309523809524,0,1,0,556518,49092,74676,33280,0.45474082033421026,0.4040207837614723
29570,0.7213333333333333,5,8,5,556526,49084,74681,33275,0.4546667160695098,0.40402384681698417
29571,0.7213333333333334,0,3,0,556529,49081,74681,33275,0.45463892697024716,0.4040385642818981
29572,0.7213809523809523,0,2,0,556531,49079,74681,33275,0.454620400904072,0.4040483765208733
29573,0.7214285714285714,1,0,1,556531,49079,74682,33274,0.454620400904072,0.4040411399706143
29574,0.7214523809523808,0,1,0,556532,49078,74682,33274,0.45461113787098445,0.4040460462405285
29575,0.7215,3,11,3,556543,49067,74685,33271,0.4545092445070214,0.40407831135077366
29576,0.7215378787878786,0,1,0,556544,49066,74685,33271,0.45449998147393383,0.404083218965957
29577,0.721547619047619,0,2,0,556546,49064,74685,33271,0.4544814554077587,0.4040930345539564
29578,0.7215833333333334,0,1,0,556547,49063,74685,33271,0.4544721923746712,0.40409794252678116
29579,0.7216111111111112,0,1,0,556548,49062,74685,33271,0.4544629293415836,0.4041028506188284
29580,0.7216190476190476,1,2,1,556550,49060,74686,33270,0.4544444032754085,0.4041054293696101
29581,0.7216666666666666,21,68,21,556618,48992,74707,33249,0.45381451702545483,0.40428739922909496
29582,0.7216666666666667,26,57,26,556675,48935,74733,33223,0.45328652413946424,0.40437936658633367
29583,0.7216666666666669,0,1,0,556676,48934,74733,33223,0.45327726110637667,0.4043842886181336
29584,0.7217142857142858,0,1,0,556677,48933,74733,33223,0.4532679980732891,0.4043892107697551
29585,0.7217222222222222,2,1,2,556678,48932,74735,33221,0.4532587350402016,0.4043796331235621
29586,0.7217380952380951,0,1,0,556679,48931,74735,33221,0.453249472007114,0.4043845554581751
29587,0.7218333333333332,1,2,1,556681,48929,74736,33220,0.4532309459409389,0.4043871501783345
29588,0.7218333333333333,1,7,1,556688,48922,74737,33219,0.453166104709326,0.40441436067250214
29589,0.7218571428571426,0,1,0,556689,48921,74737,33219,0.4531568416762385,0.4044192841490139
29590,0.7218809523809524,0,1,0,556690,48920,74737,33219,0.4531475786431509,0.40442420774540716
29591,0.7219047619047619,0,2,0,556692,48918,74737,33219,0.45312905257697583,0.40443405529785603
29592,0.7219397546897547,1,3,1,556695,48915,74738,33218,0.4531012634777131,0.40444157646743695
29593,0.7219978354978355,0,1,0,556696,48914,74738,33218,0.4530920004446256,0.40444650075488237
29594,0.7219999999999999,2,5,2,556701,48909,74740,33216,0.4530456852791878,0.4044566210045662
29595,0.722,7,29,7,556730,48880,74747,33209,0.45277705731964873,0.40454872150958104
29596,0.7220238095238095,0,2,0,556732,48878,74747,33209,0.45275853125347365,0.40455857809397344
29597,0.7220238095238096,0,1,0,556733,48877,74747,33209,0.4527492682203861,0.40456350656628415
29598,0.722111111111111,0,1,0,556734,48876,74747,33209,0.4527400051872985,0.40456843515867696
29599,0.7221190476190477,1,1,1,556735,48875,74748,33208,0.452730742154211,0.4045661099131367
29600,0.7221309523809525,0,2,0,556737,48873,74748,33208,0.45271221608803586,0.40457596764171977
29601,0.7221428571428571,0,3,0,556740,48870,74748,33208,0.4526844269887732,0.404590755135359
29602,0.7221428571428572,1,1,1,556741,48869,74749,33207,0.45267516395568563,0.4045884302353916
29603,0.7221666666666665,0,1,0,556742,48868,74749,33207,0.4526659009225981,0.4045933597319525
29604,0.7221666666666667,1,5,1,556747,48863,74750,33206,0.4526195857571603,0.40461075436522925
29605,0.7221666666666668,1,1,1,556748,48862,74751,33205,0.45261032272407276,0.404608429697686
29606,0.7221904761904762,0,1,0,556749,48861,74751,33205,0.45260105969098524,0.40461335997855385
29607,0.7222142857142857,0,2,0,556751,48859,74751,33205,0.4525825336248101,0.40462322090076036
29608,0.7222222222222223,0,1,0,556752,48858,74751,33205,0.45257327059172253,0.4046281515421079
29609,0.7223095238095237,0,3,0,556755,48855,74751,33205,0.4525454814924599,0.4046429441871801
29610,0.7223095238095238,1,0,1,556755,48855,74752,33204,0.4525454814924599,0.4046356889555076
29611,0.7223333333333332,0,7,0,556762,48848,74752,33204,0.452480640260847,0.4046702091356701
29612,0.7223333333333334,1,7,1,556769,48841,74753,33203,0.4524157990292341,0.40469747940129686
29613,0.7223571428571428,0,1,0,556770,48840,74753,33203,0.45240653599614655,0.40470241214972635
29614,0.7223809523809525,1,0,1,556770,48840,74754,33202,0.45240653599614655,0.40469515613953827
29615,0.722452380952381,1,0,1,556770,48840,74755,33201,0.45240653599614655,0.4046878999524628
29616,0.7224761904761907,0,1,0,556771,48839,74755,33201,0.45239727296305904,0.40469283276450513
29617,0.7224999999999998,2,2,2,556773,48837,74757,33199,0.4523787468968839,0.40468818567458187
29618,0.7225,62,106,62,556879,48731,74819,33137,0.45139686538960316,0.4047613231054869
29619,0.7225000000000001,3,5,3,556884,48726,74822,33134,0.4513505502241654,0.40476423161495234
29620,0.7225238095238095,0,2,0,556886,48724,74822,33134,0.4513320241579903,0.40477412103887217
29621,0.7225714285714286,0,2,0,556888,48722,74822,33134,0.4513134980918152,0.4047840109460516
29622,0.7226111111111111,1,2,1,556890,48720,74823,33133,0.45129497202564006,0.4047866296898098
29623,0.7226190476190476,1,0,1,556890,48720,74824,33132,0.45129497202564006,0.40477935786541563
29624,0.7226190476190477,1,0,1,556890,48720,74825,33131,0.45129497202564006,0.404772085863337
29625,0.7226666666666666,0,1,0,556891,48719,74825,33131,0.45128570899255255,0.404777031154551
29626,0.7226666666666667,6,8,6,556899,48711,74831,33125,0.4512116047278521,0.40477296055525686
29627,0.7226666666666668,0,6,0,556905,48705,74831,33125,0.45115602652932674,0.40480263961872176
29628,0.722690476190476,1,0,1,556905,48705,74832,33124,0.45115602652932674,0.40479536594605825
29629,0.7226904761904762,0,1,0,556906,48704,74832,33124,0.4511467634962392,0.4048003128513467
29630,0.7227142857142858,0,2,0,556908,48702,74832,33124,0.4511282374300641,0.4048102070246621
29631,0.7227380952380952,0,2,0,556910,48700,74832,33124,0.451109711363889,0.4048201016816582
29632,0.7227539682539682,0,2,0,556912,48698,74832,33124,0.45109118529771386,0.40482999682237053
29633,0.7228095238095239,0,1,0,556913,48697,74832,33124,0.45108192226462634,0.40483494457413133
29634,0.7228333333333333,3,5,3,556918,48692,74835,33121,0.45103560709918855,0.40483786195347926
29635,0.7228333333333334,0,1,0,556919,48691,74835,33121,0.451026344066101,0.40484281034567055
29636,0.7228571428571428,1,2,1,556921,48689,74836,33120,0.4510078179999259,0.40484543265410894
29637,0.7228809523809524,1,1,1,556922,48688,74837,33119,0.4509985549668383,0.40484310633564363
29638,0.7229166666666665,1,1,1,556923,48687,74838,33118,0.4509892919337508,0.40484077990342887
29639,0.7229285714285715,0,1,0,556924,48686,74838,33118,0.45098002890066324,0.40484572881521685
29640,0.7229523809523809,1,0,1,556924,48686,74839,33117,0.45098002890066324,0.40483845335745633
29641,0.7229761904761903,0,1,0,556925,48685,74839,33117,0.4509707658675757,0.40484340236180044
29642,0.7229761904761905,0,1,0,556926,48684,74839,33117,0.4509615028344881,0.40484835148714565
29643,0.7229999999999999,0,2,0,556928,48682,74839,33117,0.450942976768313,0.40485825010085696
29644,0.723,4,23,4,556951,48659,74843,33113,0.45072992700729925,0.40494301227804136
29645,0.7230000000000001,3,2,3,556953,48657,74846,33110,0.45071140094112416,0.4049310846674086
29646,0.7231666666666666,0,10,0,556963,48647,74846,33110,0.45061877061024863,0.40498061328081997
29647,0.7231666666666667,0,5,0,556968,48642,74846,33110,0.45057245544481084,0.405005382131324
29648,0.723166666666667,1,0,1,556968,48642,74847,33109,0.45057245544481084,0.4049981039987278
29649,0.7231715506715507,1,2,1,556970,48640,74848,33108,0.45055392937863575,0.4050007339629104
29650,0.7232727272727273,0,1,0,556971,48639,74848,33108,0.4505446663455482,0.4050056882821388
29651,0.7233095238095238,1,0,1,556971,48639,74849,33107,0.4505446663455482,0.4049984097081203
29652,0.7233333333333332,0,2,0,556973,48637,74849,33107,0.4505261402793731,0.40500831865335685
29653,0.7233333333333333,49,103,49,557076,48534,74898,33058,0.449572047871355,0.4051622708108638
29654,0.7233333333333334,58,120,58,557196,48414,74956,33000,0.44846048390084847,0.40533569165008476
29655,0.7233571428571429,0,1,0,557197,48413,74956,33000,0.44845122086776096,0.40534067040890276
29656,0.7233611111111109,0,1,0,557198,48412,74956,33000,0.4484419578346734,0.405345649290031
29657,0.7234047619047618,0,1,0,557199,48411,74956,33000,0.4484326948015858,0.40535062829347385
29658,0.7234285714285714,1,1,1,557200,48410,74957,32999,0.4484234317684983,0.40534830301318037
29659,0.7234523809523808,0,1,0,557201,48409,74957,32999,0.44841416873541073,0.4053532822327044
29660,0.7234523809523811,1,1,1,557202,48408,74958,32998,0.44840490570232316,0.40535095693192147
29661,0.7234761904761905,0,1,0,557203,48407,74958,32998,0.4483956426692356,0.40535593636754497
29662,0.7234999999999999,2,12,2,557215,48395,74960,32996,0.448284486272185,0.4054010885724466
29663,0.7235,1,4,1,557219,48391,74961,32995,0.44824743413983476,0.4054137075172634
29664,0.7235000000000003,0,1,0,557220,48390,74961,32995,0.4482381711067472,0.40541868894759475
29665,0.7235105172605174,0,2,0,557222,48388,74961,32995,0.4482196450405721,0.40542865217551577
29666,0.7235714285714286,1,1,1,557223,48387,74962,32994,0.44821038200748453,0.4054263280126811
29667,0.7235952380952381,0,1,0,557224,48386,74962,32994,0.44820111897439696,0.4054313099041534
29668,0.7236237373737372,0,1,0,557225,48385,74962,32994,0.44819185594130945,0.4054362919180624
29669,0.7236428571428571,0,1,0,557226,48384,74962,32994,0.4481825929082219,0.4054412740544127
29670,0.7236666666666666,4,4,4,557230,48380,74966,32990,0.44814554077587165,0.40543197738724346
29671,0.7236666666666668,3,6,3,557236,48374,74969,32987,0.44808996257734635,0.40543995280294
29672,0.7236904761904762,1,0,1,557236,48374,74970,32986,0.44808996257734635,0.40543264503441495
29673,0.7237142857142856,0,1,0,557237,48373,74970,32986,0.4480806995442588,0.40543762828943325
29674,0.72375,0,6,0,557243,48367,74970,32986,0.44802512134573347,0.4054675303922412
29675,0.7237500000000001,0,2,0,557245,48365,74970,32986,0.44800659527955833,0.4054774987400278
29676,0.7237738095238097,0,2,0,557247,48363,74970,32986,0.44798806921338324,0.40548746757796655
29677,0.7238095238095238,0,2,0,557249,48361,74970,32986,0.4479695431472081,0.40549743690609363
29678,0.7238333333333332,0,8,0,557257,48353,74970,32986,0.4478954388825077,0.4055373191212088
29679,0.7238333333333334,0,2,0,557259,48351,74970,32986,0.4478769128163326,0.40554729090082003
29680,0.7238571428571429,1,2,1,557261,48349,74971,32985,0.4478583867501575,0.4055499545085696
29681,0.7238968253968252,0,1,0,557262,48348,74971,32985,0.4478491237170699,0.4055549407989377
29682,0.7239285714285717,1,0,1,557262,48348,74972,32984,0.4478491237170699,0.40554763192839227
29683,0.7239999999999999,1,3,1,557265,48345,74973,32983,0.44782133461780727,0.40555528231359433
29684,0.7240000000000001,15,50,15,557315,48295,74988,32968,0.44735818296342955,0.4056950887857943
29685,0.7240119047619049,0,1,0,557316,48294,74988,32968,0.447348919930342,0.4057000812187738
29686,0.7240476190476189,0,2,0,557318,48292,74988,32968,0.4473303938641669,0.4057100664533596
29687,0.7241190476190476,1,2,1,557320,48290,74989,32967,0.44731186779799176,0.40571273859482876
29688,0.7241309523809523,0,2,0,557322,48288,74989,32967,0.4472933417318167,0.40572272475539967
29689,0.7241428571428571,0,1,0,557323,48287,74989,32967,0.4472840786987291,0.40572771802003593
29690,0.7241666666666666,13,29,13,557352,48258,75002,32954,0.44701545073919,0.4057774713096587
29691,0.7241666666666667,7,26,7,557378,48232,75009,32947,0.44677461187891365,0.4058561943359736
29692,0.7241666666666668,1,1,1,557379,48231,75010,32946,0.4467653488458261,0.40585387486603347
29693,0.7241904761904762,0,1,0,557380,48230,75010,32946,0.4467560858127385,0.4058588745442003
29694,0.72425,0,1,0,557381,48229,75010,32946,0.44674682277965094,0.4058638743455497
29695,0.7242777777777779,0,1,0,557382,48228,75010,32946,0.44673755974656343,0.4058688742700865
29696,0.7242857142857142,0,4,0,557386,48224,75010,32946,0.4467005076142132,0.4058888752001971
29697,0.7242857142857143,0,1,0,557387,48223,75010,32946,0.44669124458112563,0.4058938757407385
29698,0.7243333333333333,2,0,2,557387,48223,75012,32944,0.44669124458112563,0.4058792366355785
29699,0.7243333333333334,9,10,9,557397,48213,75021,32935,0.4465986142502501,0.40586336077290874
29700,0.7243333333333335,0,1,0,557398,48212,75021,32935,0.44658935121716253,0.40586836235473894
29701,0.7244642857142857,1,0,1,557398,48212,75022,32934,0.44658935121716253,0.40586104059349815
29702,0.7245,1,8,1,557406,48204,75023,32933,0.44651524695246214,0.4058937352872302
29703,0.7245238095238095,0,1,0,557407,48203,75023,32933,0.44650598391937457,0.4058987379215145
29704,0.7245396825396826,1,0,1,557407,48203,75024,32932,0.44650598391937457,0.4058914155419979
29705,0.7245833333333332,0,1,0,557408,48202,75024,32932,0.446496720886287,0.4058964182710085
29706,0.7245833333333335,1,0,1,557408,48202,75025,32931,0.446496720886287,0.40588909568239806
29707,0.7246666666666667,3,13,3,557421,48189,75028,32928,0.4463763014561488,0.4059321720477828
29708,0.7246666666666668,1,1,1,557422,48188,75029,32927,0.44636703842306125,0.40592985267829623
29709,0.7247142857142856,0,1,0,557423,48187,75029,32927,0.4463577753899737,0.4059348571146781
29710,0.7247142857142858,0,1,0,557424,48186,75029,32927,0.44634851235688616,0.40593986167445417
29711,0.7247619047619047,0,1,0,557425,48185,75029,32927,0.4463392493237986,0.40594486635762894
29712,0.7247619047619048,0,1,0,557426,48184,75029,32927,0.446329986290711,0.40594987116420705
29713,0.7248055555555556,0,1,0,557427,48183,75029,32927,0.44632072325762345,0.40595487609419306
29714,0.7248333333333332,0,3,0,557430,48180,75029,32927,0.4462929341583608,0.405969891624644
29715,0.7248333333333333,3,4,3,557434,48176,75032,32924,0.4462558820260106,0.4059679408138101
29716,0.7248333333333334,0,4,0,557438,48172,75032,32924,0.4462188298936604,0.40598796488112854
29717,0.7248571428571428,0,2,0,557440,48170,75032,32924,0.44620030382748527,0.4059979776555602
29718,0.724857142857143,0,1,0,557441,48169,75032,32924,0.4461910407943977,0.40600298422798514
29719,0.7248809523809524,0,1,0,557442,48168,75032,32924,0.4461817777613102,0.4060079909238889
29720,0.7248809523809525,0,1,0,557443,48167,75032,32924,0.4461725147282226,0.4060129977432761
29721,0.7248888888888888,0,1,0,557444,48166,75032,32924,0.44616325169513504,0.4060180046861512
29722,0.7249246031746033,0,5,0,557449,48161,75032,32924,0.4461169365296973,0.4060430412530061
29723,0.7249999999999999,0,6,0,557455,48155,75032,32924,0.44606135833117194,0.4060730892092897
29724,0.725,185,379,185,557834,47776,75217,32739,0.4425506687909889,0.4066198844935726
29725,0.7250000000000001,1,2,1,557836,47774,75218,32738,0.44253214272481384,0.40662261526232113
29726,0.725031746031746,0,1,0,557837,47773,75218,32738,0.44252287969172627,0.4066276657847996
29727,0.7250714285714285,0,1,0,557838,47772,75218,32738,0.4425136166586387,0.4066327164327413
29728,0.7250833333333333,0,1,0,557839,47771,75218,32738,0.44250435362555113,0.40663776720615086
29729,0.7251190476190478,0,3,0,557842,47768,75218,32738,0.4424765645262885,0.40665292027923383
29730,0.7251666666666665,0,2,0,557844,47766,75218,32738,0.4424580384601134,0.4066630229553811
29731,0.7251666666666666,2,10,2,557854,47756,75220,32736,0.44236540812923786,0.40669880236545247
29732,0.7251666666666668,1,0,1,557854,47756,75221,32735,0.44236540812923786,0.40669143134014984
29733,0.7252777777777776,0,2,0,557856,47754,75221,32735,0.4423468820630627,0.4067015368559679
29734,0.7253253968253968,2,2,2,557858,47752,75223,32733,0.44232835599688763,0.40669690004348635
29735,0.7253333333333332,0,1,0,557859,47751,75223,32733,0.44231909296380006,0.40670195318324137
29736,0.7253333333333333,4,9,4,557868,47742,75227,32729,0.4422357256660121,0.406717948080675
29737,0.7253333333333335,1,2,1,557870,47740,75228,32728,0.44221719959983696,0.40672068399860817
29738,0.7253571428571428,1,1,1,557871,47739,75229,32727,0.4422079365667494,0.4067183655208411
29739,0.7253809523809522,0,1,0,557872,47738,75229,32727,0.4421986735336619,0.4067234201205493
29740,0.7253809523809523,1,3,1,557875,47735,75230,32726,0.4421708844343992,0.4067312113943401
29741,0.7253809523809526,0,1,0,557876,47734,75230,32726,0.44216162140131166,0.4067362664678101
29742,0.7254047619047617,0,1,0,557877,47733,75230,32726,0.4421523583682241,0.40674132166693594
29743,0.7254166666666666,0,1,0,557878,47732,75230,32726,0.4421430953351365,0.4067463769917224
29744,0.7254285714285714,0,1,0,557879,47731,75230,32726,0.442133832302049,0.4067514324421741
29745,0.7254880952380954,0,1,0,557880,47730,75230,32726,0.44212456926896143,0.4067564880182957
29746,0.7254999999999999,2,4,2,557884,47726,75232,32724,0.4420875171366112,0.4067619639527657
29747,0.7255000000000001,0,3,0,557887,47723,75232,32724,0.44205972803734855,0.40677713277064403
29748,0.725547619047619,0,1,0,557888,47722,75232,32724,0.442050465004261,0.40678218929468213
29749,0.7255555555555556,1,0,1,557888,47722,75233,32723,0.442050465004261,0.406774815091056
29750,0.7255952380952381,1,2,1,557890,47720,75234,32722,0.4420319389380859,0.40677755401407223
29751,0.7255992063492066,1,1,1,557891,47719,75235,32721,0.44202267590499833,0.40677523620089506
29752,0.7256111111111112,0,1,0,557892,47718,75235,32721,0.44201341287191076,0.40678029314138664
29753,0.7256428571428571,0,1,0,557893,47717,75235,32721,0.44200414983882325,0.4067853502076133
29754,0.7256428571428573,1,0,1,557893,47717,75236,32720,0.44200414983882325,0.4067779753098698
29755,0.7256666666666665,0,2,0,557895,47715,75236,32720,0.4419856237726481,0.40678808976191955
29756,0.7256666666666667,6,15,6,557910,47700,75242,32714,0.4418466782763348,0.40681970801104284
29757,0.7256666666666668,0,3,0,557913,47697,75242,32714,0.4418188891770721,0.40683488577433435
29758,0.7256771284271284,0,3,0,557916,47694,75242,32714,0.4417911000778095,0.4068500646701821
29759,0.7256904761904762,1,3,1,557919,47691,75243,32713,0.4417633109785468,0.4068578677677728
29760,0.7257142857142856,4,0,4,557919,47691,75247,32709,0.4417633109785468,0.40682835820895524
29761,0.7257216117216118,0,4,0,557923,47687,75247,32709,0.4417262588461966,0.4068485994328076
29762,0.7257261904761905,1,0,1,557923,47687,75248,32708,0.4417262588461966,0.4068412214689968
29763,0.7257500000000001,0,2,0,557925,47685,75248,32708,0.4417077327800215,0.40685134277860013
29764,0.7258095238095237,0,1,0,557926,47684,75248,32708,0.44169846974693394,0.40685640362225095
29765,0.725825396825397,0,4,0,557930,47680,75248,32708,0.4416614176145837,0.4068766482559586
29766,0.7258333333333333,5,23,5,557953,47657,75253,32703,0.44144836785357,0.4069561971129915
29767,0.7258333333333334,8,30,8,557983,47627,75261,32695,0.44117047686094335,0.4070491272627674
29768,0.725876984126984,0,1,0,557984,47626,75261,32695,0.4411612138278558,0.4070541950423924
29769,0.7259166666666665,0,1,0,557985,47625,75261,32695,0.44115195079476827,0.40705926294820716
29770,0.7259523809523809,0,1,0,557986,47624,75261,32695,0.4411426877616807,0.4070643309802164
29771,0.7259999999999998,0,2,0,557988,47622,75261,32695,0.44112416169550556,0.407074467422837
29772,0.726,26,51,26,558039,47571,75287,32669,0.44065174700804033,0.4071410767696909
29773,0.7260000000000001,2,5,2,558044,47566,75289,32667,0.44060543184260254,0.4071516707589147
29774,0.7260714285714286,0,1,0,558045,47565,75289,32667,0.44059616880951497,0.40715674543822916
29775,0.7260952380952381,0,2,0,558047,47563,75289,32667,0.4405776427433399,0.40716689517636795
29776,0.7260992063492064,1,0,1,558047,47563,75290,32666,0.4405776427433399,0.40715950591432026
29777,0.7261111111111112,0,1,0,558048,47562,75290,32666,0.4405683797102523,0.40716458094430874
29778,0.7261190476190476,0,1,0,558049,47561,75290,32666,0.4405591166771648,0.40716965610081396
29779,0.7261309523809523,0,1,0,558050,47560,75290,32666,0.4405498536440772,0.40717473138384064
29780,0.7261666666666666,0,1,0,558051,47559,75290,32666,0.44054059061098966,0.4071798067933936
29781,0.7261666666666667,0,1,0,558052,47558,75290,32666,0.4405313275779021,0.40718488232947747
29782,0.7261904761904762,1,0,1,558052,47558,75291,32665,0.4405313275779021,0.40717749273899007
29783,0.7262142857142857,0,2,0,558054,47556,75291,32665,0.440512801511727,0.40718764413308234
29784,0.7262222222222222,0,1,0,558055,47555,75291,32665,0.44050353847863943,0.40719272001994516
29785,0.72625,0,3,0,558058,47552,75291,32665,0.4404757493793768,0.4072079484398569
29786,0.7262857142857143,1,0,1,558058,47552,75292,32664,0.4404757493793768,0.40720055849207143
29787,0.7263095238095238,1,4,1,558062,47548,75293,32663,0.44043869724702656,0.40721347446110884
29788,0.7263333333333333,3,5,3,558067,47543,75296,32660,0.4403923820815888,0.40721668765507524
29789,0.7263333333333334,0,5,0,558072,47538,75296,32660,0.440346066916151,0.4072420758622409
29790,0.7263571428571428,0,1,0,558073,47537,75296,32660,0.44033680388306345,0.40724715388356175
29791,0.7263690476190476,1,1,1,558074,47536,75297,32659,0.44032754084997594,0.4072448407007918
29792,0.7263809523809525,2,1,2,558075,47535,75299,32657,0.44031827781688837,0.40723513567438147
29793,0.7263888888888889,0,1,0,558076,47534,75299,32657,0.4403090147838008,0.40724021398910104
29794,0.7263928571428572,0,1,0,558077,47533,75299,32657,0.44029975175071323,0.40724529243047763
29795,0.7264047619047618,2,1,2,558078,47532,75301,32655,0.4402904887176257,0.407235586815818
29796,0.7264523809523812,0,1,0,558079,47531,75301,32655,0.44028122568453815,0.40724066545282217
29797,0.7264682539682539,0,1,0,558080,47530,75301,32655,0.4402719626514506,0.40724574421649934
29798,0.7264999999999999,1,4,1,558084,47526,75302,32654,0.44023491051910035,0.4072586679970067
29799,0.7265,0,8,0,558092,47518,75302,32654,0.44016080625439996,0.40729930649104423
29800,0.7265238095238093,1,1,1,558093,47517,75303,32653,0.4401515432213124,0.407296993887988
29801,0.7265238095238096,0,1,0,558094,47516,75303,32653,0.4401422801882248,0.40730207436789784
29802,0.7265303030303031,0,1,0,558095,47515,75303,32653,0.44013301715513725,0.40730715497455344
29803,0.7265714285714284,0,1,0,558096,47514,75303,32653,0.44012375412204974,0.40731223570795966
29804,0.7265833333333334,1,0,1,558096,47514,75304,32652,0.44012375412204974,0.4073048424519123
29805,0.7265952380952381,0,1,0,558097,47513,75304,32652,0.44011449108896217,0.40730992328322835
29806,0.7266071428571429,0,1,0,558098,47512,75304,32652,0.4401052280558746,0.40731500424130535
29807,0.7266190476190476,1,1,1,558099,47511,75305,32651,0.4400959650227871,0.4073126917991068
29808,0.7266666666666666,65,126,65,558225,47385,75370,32586,0.43892882285375523,0.40747270885696063
29809,0.7266666666666667,39,70,39,558295,47315,75409,32547,0.43828041053762645,0.40754050737522224
29810,0.7266825396825396,0,1,0,558296,47314,75409,32547,0.4382711475045389,0.4075456104982407
29811,0.7267142857142858,1,1,1,558297,47313,75410,32546,0.4382618844714513,0.4075432950575389
29812,0.7267222222222222,0,1,0,558298,47312,75410,32546,0.4382526214383638,0.4075483984071727
29813,0.7267738095238094,0,3,0,558301,47309,75410,32546,0.4382248323391011,0.40756370922296664
29814,0.7267857142857141,1,0,1,558301,47309,75411,32545,0.4382248323391011,0.40755629022966916
29815,0.7267857142857143,0,1,0,558302,47308,75411,32545,0.4382155693060136,0.40756139406158814
29816,0.7268095238095236,0,2,0,558304,47306,75411,32545,0.43819704323983844,0.4075716021089279
29817,0.7268333333333332,1,1,1,558305,47305,75412,32544,0.4381877802067509,0.40756928702926776
29818,0.7268333333333333,0,11,0,558316,47294,75412,32544,0.4380858868427878,0.40762544151907615
29819,0.7268434898434897,0,1,0,558317,47293,75412,32544,0.43807662380970025,0.40763054724000153
29820,0.726857142857143,1,2,1,558319,47291,75413,32543,0.43805809774352517,0.407633339178796
29821,0.7268888888888888,0,1,0,558320,47290,75413,32543,0.4380488347104376,0.4076384452544687
29822,0.7269047619047619,1,2,1,558322,47288,75414,32542,0.43803030864426246,0.4076412376299637
29823,0.726904761904762,1,2,1,558324,47286,75415,32541,0.43801178257808737,0.4076440302153407
29824,0.7269119769119766,0,2,0,558326,47284,75415,32541,0.4379932565119123,0.4076542436580019
29825,0.7269166666666667,2,0,2,558326,47284,75417,32539,0.4379932565119123,0.4076394021773173
29826,0.7269761904761904,1,2,1,558328,47282,75418,32538,0.43797473044573715,0.40764219493861187
29827,0.7269999999999999,0,5,0,558333,47277,75418,32538,0.43792841528029935,0.40766773162939296
29828,0.727,5,14,5,558347,47263,75423,32533,0.4377987328170736,0.4077021404581683
29829,0.7270000000000002,0,2,0,558349,47261,75423,32533,0.4377802067508985,0.40771235932526256
29830,0.7270119047619048,0,1,0,558350,47260,75423,32533,0.43777094371781095,0.4077174689509105
29831,0.7270238095238096,1,0,1,558350,47260,75424,32532,0.43777094371781095,0.4077100461199118
29832,0.727047619047619,0,1,0,558351,47259,75424,32532,0.43776168068472343,0.40771515584464413
29833,0.7270714285714286,1,0,1,558351,47259,75425,32531,0.43776168068472343,0.4077077327985963
29834,0.7271071428571428,0,1,0,558352,47258,75425,32531,0.43775241765163586,0.40771284262241664
29835,0.7271190476190474,0,1,0,558353,47257,75425,32531,0.4377431546185483,0.407717952574322
29836,0.727142857142857,1,0,1,558353,47257,75426,32530,0.4377431546185483,0.40771052928421925
29837,0.7271428571428572,1,2,1,558355,47255,75427,32529,0.4377246285523732,0.40771332598014637
29838,0.7271666666666665,0,1,0,558356,47254,75427,32529,0.43771536551928564,0.4077184362583508
29839,0.7271666666666667,1,6,1,558362,47248,75428,32528,0.43765978732076033,0.4077416766947453
29840,0.7271666666666668,1,0,1,558362,47248,75429,32527,0.43765978732076033,0.4077342525853964
29841,0.7271904761904762,1,0,1,558362,47248,75430,32526,0.43765978732076033,0.407726828289919
29842,0.7272380952380954,0,2,0,558364,47246,75430,32526,0.4376412612545852,0.40773705059419346
29843,0.7272619047619047,0,1,0,558365,47245,75430,32526,0.4376319982214976,0.4077421619385491
29844,0.7272619047619048,0,1,0,558366,47244,75430,32526,0.4376227351884101,0.40774727341105677
29845,0.7273113275613277,0,2,0,558368,47242,75430,32526,0.43760420912223497,0.40775749674054756
29846,0.7273333333333332,2,4,2,558372,47238,75432,32524,0.43756715698988474,0.40776309520824455
29847,0.7273333333333334,6,14,6,558386,47224,75438,32518,0.437437474526659,0.4077901231471496
29848,0.7273333333333335,0,3,0,558389,47221,75438,32518,0.43740968542739633,0.4078054653306412
29849,0.7274126984126984,1,1,1,558390,47220,75439,32517,0.4374004223943088,0.4078031528650438
29850,0.7274361471861471,0,3,0,558393,47217,75439,32517,0.4373726332950461,0.4078184965008654
29851,0.7274920634920633,1,1,1,558394,47216,75440,32516,0.4373633702619586,0.4078161842171274
29852,0.7274999999999998,1,7,1,558401,47209,75441,32515,0.4372985290303457,0.40784456374491995
29853,0.7275,52,111,52,558512,47098,75493,32463,0.4362703323576272,0.40802654566936064
29854,0.7275000000000001,0,5,0,558517,47093,75493,32463,0.4362240171921894,0.4080521896525718
29855,0.7275238095238096,0,1,0,558518,47092,75493,32463,0.4362147541591019,0.4080573188360254
29856,0.727595238095238,0,1,0,558519,47091,75493,32463,0.4362054911260143,0.40806244814842746
29857,0.7275952380952382,2,1,2,558520,47090,75495,32461,0.43619622809292674,0.40805269575492453
29858,0.7276190476190476,0,2,0,558522,47088,75495,32461,0.43617770202675166,0.4080629549082955
29859,0.727642857142857,0,1,0,558523,47087,75495,32461,0.4361684389936641,0.40806808467843314
29860,0.7276666666666665,0,1,0,558524,47086,75495,32461,0.4361591759605765,0.40807321457754536
29861,0.7276666666666667,1,10,1,558534,47076,75496,32460,0.436066545629701,0.40811707905853956
29862,0.7276666666666668,3,1,3,558535,47075,75499,32457,0.4360572825966134,0.40809988432329125
29863,0.7276785714285714,0,1,0,558536,47074,75499,32457,0.4360480195635259,0.40810501565427315
29864,0.7277222222222222,0,1,0,558537,47073,75499,32457,0.43603875653043833,0.4081101471142965
29865,0.7277272727272727,0,1,0,558538,47072,75499,32457,0.43602949349735076,0.40811527870336606
29866,0.72775,1,2,1,558540,47070,75500,32456,0.4360109674311757,0.40811809974096525
29867,0.7277857142857143,0,1,0,558541,47069,75500,32456,0.4360017043980881,0.4081232316881484
29868,0.7278333333333332,0,1,0,558542,47068,75500,32456,0.43599244136500054,0.40812836376439815
29869,0.7278333333333333,3,10,3,558552,47058,75503,32453,0.435899811034125,0.4081573618744576
29870,0.7278333333333334,0,4,0,558556,47054,75503,32453,0.4358627589017748,0.4081778962858616
29871,0.7279047619047617,0,1,0,558557,47053,75503,32453,0.43585349586868727,0.4081830302115564
29872,0.7279166666666665,0,1,0,558558,47052,75503,32453,0.4358442328355997,0.4081881642663983
29873,0.7279166666666668,0,1,0,558559,47051,75503,32453,0.43583496980251213,0.40819329845039243
29874,0.727952380952381,1,0,1,558559,47051,75504,32452,0.43583496980251213,0.40818585462183815
29875,0.7279761904761906,0,1,0,558560,47050,75504,32452,0.43582570676942456,0.40819098890593947
29876,0.7279999999999999,1,1,1,558561,47049,75505,32451,0.43581644373633704,0.408188679245283
29877,0.728,14,19,14,558580,47030,75519,32437,0.4356404461076735,0.4081820126593429
29878,0.7280000000000001,1,4,1,558584,47026,75520,32436,0.43560339397532327,0.408195112129068
29879,0.7280238095238094,0,1,0,558585,47025,75520,32436,0.4355941309422357,0.40820024917884246
29880,0.728047619047619,1,0,1,558585,47025,75521,32435,0.4355941309422357,0.4081928014095142
29881,0.7280634920634921,1,0,1,558585,47025,75522,32434,0.4355941309422357,0.40818535345272405
29882,0.7280952380952381,1,2,1,558587,47023,75523,32433,0.4355756048760606,0.4081881796214257
29883,0.728154761904762,0,1,0,558588,47022,75523,32433,0.43556634184297305,0.4081933169718709
29884,0.7281666666666665,0,1,0,558589,47021,75523,32433,0.43555707880988553,0.4081984544516324
29885,0.7281666666666666,2,8,2,558597,47013,75525,32431,0.4354829745451851,0.4082246613967071
29886,0.7281666666666667,1,0,1,558597,47013,75526,32430,0.4354829745451851,0.4082172123409237
29887,0.728190476190476,0,1,0,558598,47012,75526,32430,0.4354737115120975,0.40822235089751013
29888,0.7282301587301587,1,1,1,558599,47011,75527,32429,0.43546444847900995,0.40822004028197384
29889,0.7282579365079366,0,3,0,558602,47008,75527,32429,0.4354366593797473,0.40823545702884045
29890,0.7282619047619048,1,0,1,558602,47008,75528,32428,0.4354366593797473,0.4082280074525404
29891,0.7282619047619049,0,1,0,558603,47007,75528,32428,0.4354273963466597,0.4082331465978473
29892,0.7282698412698413,0,1,0,558604,47006,75528,32428,0.4354181333135722,0.4082382858725483
29893,0.7282857142857143,1,1,1,558605,47005,75529,32427,0.43540887028048464,0.4082359754255212
29894,0.7283333333333333,29,46,29,558651,46959,75558,32398,0.43498277075845715,0.40825636049749864
29895,0.7283333333333334,21,67,21,558718,46892,75579,32377,0.434362147541591,0.40844466310915994
29896,0.7283452380952383,1,1,1,558719,46891,75580,32376,0.43435288450850346,0.40844235305991144
29897,0.7283888888888889,0,1,0,558720,46890,75580,32376,0.4343436214754159,0.4084475058663235
29898,0.7284242424242424,2,0,2,558720,46890,75582,32374,0.4343436214754159,0.40843257973354863
29899,0.7284523809523809,1,2,1,558722,46888,75583,32373,0.4343250954092408,0.40843542221268975
29900,0.7284523809523811,0,2,0,558724,46886,75583,32373,0.4343065693430657,0.40844572856079436
29901,0.7284999999999999,2,7,2,558731,46879,75585,32371,0.43424172811145284,0.4084668769716088
29902,0.7285,0,1,0,558732,46878,75585,32371,0.43423246507836527,0.4084720311928226
29903,0.7285119047619049,1,0,1,558732,46878,75586,32370,0.43423246507836527,0.40846456692913385
29904,0.7285714285714286,1,2,1,558734,46876,75587,32369,0.43421393901219013,0.40846741119313523
29905,0.7286190476190475,0,1,0,558735,46875,75587,32369,0.4342046759791026,0.4084725657463026
29906,0.7286190476190477,0,3,0,558738,46872,75587,32369,0.4341768868798399,0.4084880301863934
29907,0.7286666666666666,3,4,3,558742,46868,75590,32366,0.43413983474748974,0.40848625590024484
29908,0.7286666666666668,4,10,4,558752,46858,75594,32362,0.43404720441661415,0.4085079525372381
29909,0.7286904761904762,1,2,1,558754,46856,75595,32361,0.43402867835043907,0.4085107994496131
29910,0.7287142857142856,1,1,1,558755,46855,75596,32360,0.4340194153173515,0.40850848955374613
29911,0.7287142857142858,0,1,0,558756,46854,75596,32360,0.434010152284264,0.4085136465776252
29912,0.7287499999999999,1,2,1,558758,46852,75597,32359,0.43399162621808884,0.4085164939212988
29913,0.72875,1,1,1,558759,46851,75598,32358,0.4339823631850013,0.40851418399424305
29914,0.7287619047619047,0,1,0,558760,46850,75598,32358,0.43397310015191376,0.4085193414806585
29915,0.7287835497835498,1,0,1,558760,46850,75599,32357,0.43397310015191376,0.4085118739505347
29916,0.7287857142857145,0,1,0,558761,46849,75599,32357,0.4339638371188262,0.4085170315380148
29917,0.7288015873015873,1,2,1,558763,46847,75600,32356,0.4339453110526511,0.40851987929750133
29918,0.7288052503052502,1,2,1,558765,46845,75601,32355,0.43392678498647597,0.40852272727272726
29919,0.7288095238095238,2,1,2,558766,46844,75603,32353,0.4339175219533884,0.40851294872280514
29920,0.7288333333333332,2,9,2,558775,46835,75605,32351,0.43383415465560043,0.4085444396736797
29921,0.7288333333333334,1,0,1,558775,46835,75606,32350,0.43383415465560043,0.4085369703858054
29922,0.7288333333333336,0,1,0,558776,46834,75606,32350,0.43382489162251286,0.4085421297231764
29923,0.7288809523809523,0,2,0,558778,46832,75606,32350,0.4338063655563378,0.40855244878886615
29924,0.7289166666666667,0,1,0,558779,46831,75606,32350,0.4337971025232502,0.4085576085171948
29925,0.7289285714285714,0,1,0,558780,46830,75606,32350,0.43378783949016264,0.4085627683758525
29926,0.7289365079365079,0,1,0,558781,46829,75606,32350,0.4337785764570751,0.40856792836484424
29927,0.728952380952381,0,1,0,558782,46828,75606,32350,0.43376931342398756,0.4085730884841749
29928,0.7289761904761904,0,1,0,558783,46827,75606,32350,0.4337600503909,0.40857824873384946
29929,0.7289880952380952,0,2,0,558785,46825,75606,32350,0.4337415243247249,0.40858856962425005
29930,0.7289999999999999,1,3,1,558788,46822,75607,32349,0.43371373522546225,0.40859658208182287
29931,0.7290000000000001,11,19,11,558807,46803,75618,32338,0.4335377375967987,0.40861247646605425
29932,0.7290317460317461,0,1,0,558808,46802,75618,32338,0.43352847456371113,0.4086176396259793
29933,0.7290476190476189,1,1,1,558809,46801,75619,32337,0.43351921153062356,0.4086153301827188
29934,0.7290714285714286,0,2,0,558811,46799,75619,32337,0.4335006854644485,0.4086256570966438
29935,0.7290833333333334,0,3,0,558814,46796,75619,32337,0.4334728963651858,0.40864114844628663
29936,0.7290952380952382,0,1,0,558815,46795,75619,32337,0.43346363333209825,0.4086463124905222
29937,0.7291111111111113,0,2,0,558817,46793,75619,32337,0.43344510726592317,0.40865664097055476
29938,0.7291666666666665,7,29,7,558846,46764,75626,32330,0.4331764793063841,0.4087541406427795
29939,0.7291666666666667,10,17,10,558863,46747,75636,32320,0.4330190077438957,0.40876724803015163
29940,0.7291666666666669,0,2,0,558865,46745,75636,32320,0.43300048167772054,0.4087775880604566
29941,0.7292142857142856,0,1,0,558866,46744,75636,32320,0.432991218644633,0.40878275827177984
29942,0.7292380952380952,1,0,1,558866,46744,75637,32319,0.432991218644633,0.4087752804725346
29943,0.7292857142857143,0,7,0,558873,46737,75637,32319,0.43292637741302015,0.4088114754098361
29944,0.7293095238095237,0,1,0,558874,46736,75637,32319,0.4329171143799326,0.40881664663841627
29945,0.7293333333333333,3,7,3,558881,46729,75640,32316,0.4328522731483197,0.40883041305585427
29946,0.7293333333333334,7,16,7,558897,46713,75647,32309,0.4327040646189188,0.40886082356812026
29947,0.7293333333333335,2,3,2,558900,46710,75649,32307,0.43267627551965615,0.40886138425908347
29948,0.7293744588744591,0,2,0,558902,46708,75649,32307,0.43265774945348107,0.4088717332152123
29949,0.7293809523809522,0,2,0,558904,46706,75649,32307,0.4326392233873059,0.40888208269525267
29950,0.7293888888888889,0,1,0,558905,46705,75649,32307,0.4326299603542184,0.40888725763175215
29951,0.7293928571428572,0,3,0,558908,46702,75649,32307,0.4326021712549557,0.4089027832272273
29952,0.7294166666666665,0,1,0,558909,46701,75649,32307,0.4325929082218682,0.40890795868772783
29953,0.7294325396825394,0,1,0,558910,46700,75649,32307,0.4325836451887806,0.4089131342792411
29954,0.7294444444444445,0,1,0,558911,46699,75649,32307,0.43257438215569305,0.40891831000177203
29955,0.7294761904761904,0,1,0,558912,46698,75649,32307,0.4325651191226055,0.4089234858553256
29956,0.7295,0,5,0,558917,46693,75649,32307,0.43251880395716774,0.4089493670886076
29957,0.7295000000000001,0,1,0,558918,46692,75649,32307,0.43250954092408017,0.4089545437284016
29958,0.7295238095238095,0,1,0,558919,46691,75649,32307,0.4325002778909926,0.40895972049925317
29959,0.7295238095238097,1,0,1,558919,46691,75650,32306,0.4325002778909926,0.4089522386926086
29960,0.7295476190476188,1,2,1,558921,46689,75651,32305,0.4324817518248175,0.40895511051472266
29961,0.7295833333333333,1,0,1,558921,46689,75652,32304,0.4324817518248175,0.40894762827085945
29962,0.7296428571428573,0,4,0,558925,46685,75652,32304,0.4324446996924673,0.40896833736343036
29963,0.7296547619047619,1,1,1,558926,46684,75653,32303,0.4324354366593797,0.408966032385076
29964,0.7296666666666666,1,0,1,558926,46684,75654,32302,0.4324354366593797,0.4089585496163877
29965,0.7296666666666667,3,7,3,558933,46677,75657,32299,0.43237059542776685,0.40897234602917343
29966,0.7297222222222223,0,1,0,558934,46676,75657,32299,0.43236133239467933,0.40897752453308006
29967,0.7297499999999999,1,3,1,558937,46673,75658,32298,0.4323335432954167,0.40898557698395616
29968,0.7297619047619047,0,3,0,558940,46670,75658,32298,0.43230575419615397,0.40900111437544323
29969,0.7297777777777779,0,1,0,558941,46669,75658,32298,0.43229649116306645,0.40900629376828296
29970,0.7298095238095239,0,1,0,558942,46668,75658,32298,0.4322872281299789,0.40901147329230303
29971,0.7298333333333332,0,3,0,558945,46665,75658,32298,0.43225943903071623,0.409027012651495
29972,0.7298333333333333,1,5,1,558950,46660,75659,32297,0.43221312386527844,0.40904542979089886
29973,0.7298333333333334,0,1,0,558951,46659,75659,32297,0.43220386083219087,0.40905061046658897
29974,0.7298571428571426,0,1,0,558952,46658,75659,32297,0.43219459779910335,0.4090557912735102
29975,0.7298571428571428,0,1,0,558953,46657,75659,32297,0.4321853347660158,0.40906097221166754
29976,0.729857142857143,0,3,0,558956,46654,75659,32297,0.43215754566675313,0.40907651581360593
29977,0.7299404761904762,2,3,2,558959,46651,75661,32295,0.4321297565674905,0.4090770906695716
29978,0.7299960317460317,0,2,0,558961,46649,75661,32295,0.43211123050131534,0.40908745439805433
29979,0.7299999999999999,2,9,2,558970,46640,75663,32293,0.4320278632035274,0.40911912634766195
29980,0.73,670,1288,670,560258,45352,76333,31623,0.42009707658675755,0.41082169535563495
29981,0.7300000000000001,0,5,0,560263,45347,76333,31623,0.4200507614213198,0.41084838248668315
29982,0.7300476190476191,1,0,1,560263,45347,76334,31622,0.4200507614213198,0.41084072808533306
29983,0.7301190476190476,2,1,2,560264,45346,76336,31620,0.42004149838823224,0.4108307564379077
29984,0.7301666666666666,0,7,0,560271,45339,76336,31620,0.41997665715661936,0.41086812458581845
29985,0.7301666666666669,0,1,0,560272,45338,76336,31620,0.4199673941235318,0.4108734634475948
29986,0.7302063492063492,0,1,0,560273,45337,76336,31620,0.4199581310904443,0.41087880244812036
29987,0.7302500000000001,0,1,0,560274,45336,76336,31620,0.4199488680573567,0.4108841415874006
29988,0.7302857142857144,0,3,0,560277,45333,76336,31620,0.41992107895809405,0.4109001598378231
29989,0.7303214285714286,0,1,0,560278,45332,76336,31620,0.4199118159250065,0.4109054995321759
29990,0.7303333333333333,7,14,7,560292,45318,76343,31613,0.4197821334617807,0.4109266745525211
29991,0.7303333333333335,1,1,1,560293,45317,76344,31612,0.41977287042869316,0.4109243588243705
29992,0.7303333333333336,1,1,1,560294,45316,76345,31611,0.41976360739560564,0.41092204297580825
29993,0.7303571428571428,0,3,0,560297,45313,76345,31611,0.41973581829634293,0.41093806874317507
29994,0.7303650793650793,1,0,1,560297,45313,76346,31610,0.41973581829634293,0.41093041093041094
29995,0.7303888888888889,0,2,0,560299,45311,76346,31610,0.41971729223016785,0.4109410954095761
29996,0.7304761904761904,0,1,0,560300,45310,76346,31610,0.4197080291970803,0.4109464378575143
29997,0.7304999999999998,1,0,1,560300,45310,76347,31609,0.4197080291970803,0.41093877975532705
29998,0.7304999999999999,3,10,3,560310,45300,76350,31606,0.41961539886620475,0.4109692351702078
29999,0.7305000000000001,0,4,0,560314,45296,76350,31606,0.4195783467338545,0.4109906114275311
30000,0.7305086580086579,0,2,0,560316,45294,76350,31606,0.41955982066767944,0.411001300390117
30001,0.7305238095238096,0,1,0,560317,45293,76350,31606,0.41955055763459187,0.41100664507991
30002,0.7305714285714283,0,2,0,560319,45291,76350,31606,0.4195320315684168,0.41101733487652314
30003,0.7306190476190477,1,0,1,560319,45291,76351,31605,0.4195320315684168,0.41100967540574285
30004,0.7306507936507936,2,1,2,560320,45290,76353,31603,0.4195227685353292,0.41099970088304527
30005,0.7306666666666666,6,11,6,560331,45279,76359,31597,0.4194208751713661,0.41101253967428064
30006,0.7306818181818181,0,1,0,560332,45278,76359,31597,0.41941161213827854,0.4110178861788618
30007,0.7306904761904761,1,1,1,560333,45277,76360,31596,0.41940234910519103,0.4110155711368101
30008,0.7307142857142856,1,2,1,560335,45275,76361,31595,0.4193838230390159,0.4110186028359568
30009,0.73075,0,2,0,560337,45273,76361,31595,0.4193652969728408,0.41102929697663526
30010,0.7307619047619046,0,2,0,560339,45271,76361,31595,0.41934677090666567,0.411039991673822
30011,0.7307619047619047,2,0,2,560339,45271,76363,31593,0.41934677090666567,0.41102466694421314
30012,0.7308095238095238,1,0,1,560339,45271,76364,31592,0.41934677090666567,0.41101700428034293
30013,0.7308333333333333,6,14,6,560353,45257,76370,31586,0.4192170884434399,0.41104589878063064
30014,0.7308333333333334,11,26,11,560379,45231,76381,31575,0.4189762495831635,0.41110069525818294
30015,0.7308809523809525,1,0,1,560379,45231,76382,31574,0.4189762495831635,0.41109302779766943
30016,0.7308928571428571,0,1,0,560380,45230,76382,31574,0.41896698655007597,0.4110983802926931
30017,0.7309166666666667,1,0,1,560380,45230,76383,31573,0.41896698655007597,0.4110907126023723
30018,0.730952380952381,0,1,0,560381,45229,76383,31573,0.4189577235169884,0.4110960652066352
30019,0.7309740259740259,1,0,1,560381,45229,76384,31572,0.4189577235169884,0.41108839728649366
30020,0.731,10,24,10,560405,45205,76394,31562,0.4187354107228871,0.4111402034728464
30021,0.7310000000000001,4,3,4,560408,45202,76398,31558,0.41870762162362446,0.4111255862428348
30022,0.7310238095238095,0,1,0,560409,45201,76398,31558,0.4186983585905369,0.41113094229992575
30023,0.7310476190476191,0,1,0,560410,45200,76398,31558,0.4186890955574493,0.4111362984965736
30024,0.7310714285714286,1,0,1,560410,45200,76399,31557,0.4186890955574493,0.41112862670505623
30025,0.7311071428571428,1,0,1,560410,45200,76400,31556,0.4186890955574493,0.411120954713638
30026,0.7311111111111112,0,1,0,560411,45199,76400,31556,0.41867983252436175,0.4111263109895121
30027,0.7311666666666666,0,6,0,560417,45193,76400,31556,0.41862425432583644,0.4111584515759163
30028,0.7311666666666667,1,7,1,560424,45186,76401,31555,0.41855941309422356,0.41118828266506824
30029,0.7311666666666669,1,1,1,560425,45185,76402,31554,0.418550150061136,0.4111859680214754
30030,0.731181401931402,0,2,0,560427,45183,76402,31554,0.4185316239949609,0.411196684780484
30031,0.7311904761904764,0,1,0,560428,45182,76402,31554,0.41852236096187334,0.4112020433694746
30032,0.7312142857142857,1,0,1,560428,45182,76403,31553,0.41852236096187334,0.41119437023522515
30033,0.7312380952380952,0,1,0,560429,45181,76403,31553,0.4185130979287858,0.4111997289337191
30034,0.73125,0,2,0,560431,45179,76403,31553,0.4184945718626107,0.41121044674972634
30035,0.7312619047619049,0,2,0,560433,45177,76403,31553,0.4184760457964356,0.4112211651244624
30036,0.7312738095238096,0,1,0,560434,45176,76403,31553,0.41846678276334803,0.41122652452136743
30037,0.7313095238095237,0,1,0,560435,45175,76403,31553,0.41845751973026046,0.411231884057971
30038,0.7313333333333332,0,1,0,560436,45174,76403,31553,0.41844825669717295,0.41123724373427867
30039,0.7313333333333333,5,3,5,560439,45171,76408,31548,0.41842046759791024,0.411214953271028
30040,0.7313333333333334,2,4,2,560443,45167,76410,31546,0.41838341546556,0.41122104467300197
30041,0.7313412698412701,1,1,1,560444,45166,76411,31545,0.4183741524324725,0.41121873003871673
30042,0.731357142857143,0,1,0,560445,45165,76411,31545,0.41836488939938493,0.41122409073132576
30043,0.7314047619047618,0,1,0,560446,45164,76411,31545,0.41835562636629736,0.4112294515637018
30044,0.7314047619047619,0,1,0,560447,45163,76411,31545,0.41834636333320985,0.41123481253585026
30045,0.7314285714285714,1,0,1,560447,45163,76412,31544,0.41834636333320985,0.4112271370279114
30046,0.7314404761904761,0,1,0,560448,45162,76412,31544,0.4183371003001223,0.4112324981096655
30047,0.7314999999999999,1,0,1,560448,45162,76413,31543,0.4183371003001223,0.411224822371423
30048,0.7315,2,6,2,560454,45156,76415,31541,0.41828152210159697,0.4112416391775428
30049,0.7315000000000002,1,0,1,560454,45156,76416,31540,0.41828152210159697,0.41123396265776574
30050,0.731547619047619,0,1,0,560455,45155,76416,31540,0.4182722590685094,0.4112393245974314
30051,0.7316428571428572,0,2,0,560457,45153,76416,31540,0.41825373300233426,0.41125004889624867
30052,0.7316666666666666,15,74,15,560531,45079,76431,31525,0.41756826855385526,0.41153203488068507
30053,0.7316666666666667,22,61,22,560592,45018,76453,31503,0.41700322353551444,0.4116909083780923
30054,0.7316666666666669,0,1,0,560593,45017,76453,31503,0.41699396050242693,0.41169628855201257
30055,0.731690476190476,0,1,0,560594,45016,76453,31503,0.41698469746933936,0.411701668866556
30056,0.7317142857142857,0,1,0,560595,45015,76453,31503,0.4169754344362518,0.41170704932172825
30057,0.7317142857142858,0,1,0,560596,45014,76453,31503,0.4169661714031643,0.41171242991753465
30058,0.7317857142857143,0,2,0,560598,45012,76453,31503,0.41694764533698914,0.41172319153107234
30059,0.7318095238095239,0,1,0,560599,45011,76453,31503,0.41693838230390157,0.4117285725488146
30060,0.7318333333333332,1,5,1,560604,45006,76454,31502,0.41689206713846383,0.4117477910806713
30061,0.7318333333333333,1,6,1,560610,45000,76455,31501,0.4168364889399385,0.4117723951320898
30062,0.7318809523809524,1,0,1,560610,45000,76456,31500,0.4168364889399385,0.4117647058823529
30063,0.731904761904762,1,3,1,560613,44997,76457,31499,0.4168086998406758,0.41177316460991426
30064,0.7319999999999999,1,3,1,560616,44994,76458,31498,0.41678091074141316,0.4117816242221409
30065,0.732,12,23,12,560639,44971,76470,31486,0.41656786098039944,0.4118131760335875
30066,0.7320833333333332,1,1,1,560640,44970,76471,31485,0.41655859794731187,0.41181086913870907
30067,0.7320833333333333,0,1,0,560641,44969,76471,31485,0.4165493349142243,0.41181625552619877
30068,0.7320833333333334,0,1,0,560642,44968,76471,31485,0.4165400718811368,0.41182164205459565
30069,0.7321190476190474,0,1,0,560643,44967,76471,31485,0.4165308088480492,0.4118270287239052
30070,0.7321428571428571,0,1,0,560644,44966,76471,31485,0.41652154581496165,0.41183241553413297
30071,0.7321428571428572,3,1,3,560645,44965,76474,31482,0.4165122827818741,0.41181472131018876
30072,0.7321666666666665,1,0,1,560645,44965,76475,31481,0.4165122827818741,0.4118070271825864
30073,0.7321666666666666,2,8,2,560653,44957,76477,31479,0.4164381785171737,0.41183473755821864
30074,0.732174603174603,0,1,0,560654,44956,76477,31479,0.4164289154840861,0.4118401255969124
30075,0.7322142857142856,0,1,0,560655,44955,76477,31479,0.41641965245099855,0.41184551377659157
30076,0.7322222222222223,0,1,0,560656,44954,76477,31479,0.416410389417911,0.41185090209726166
30077,0.7322380952380952,1,0,1,560656,44954,76478,31478,0.416410389417911,0.41184320703370314
30078,0.73225,0,1,0,560657,44953,76478,31478,0.41640112638482346,0.4118485954651908
30079,0.7322500000000001,0,2,0,560659,44951,76478,31478,0.4163826003186483,0.41185937275118084
30080,0.7322857142857141,0,4,0,560663,44947,76478,31478,0.4163455481862981,0.41188092901537454
30081,0.7322857142857143,0,1,0,560664,44946,76478,31478,0.4163362851532106,0.4118863184339998
30082,0.7323095238095239,0,1,0,560665,44945,76478,31478,0.416327022120123,0.4118917079936668
30083,0.7323333333333332,1,1,1,560666,44944,76479,31477,0.41631775908703544,0.41188940212768743
30084,0.7323333333333334,6,13,6,560679,44931,76485,31471,0.41619733965689726,0.41191330069893456
30085,0.7323333333333335,1,2,1,560681,44929,76486,31470,0.4161788135907221,0.41191638634013533
30086,0.7323690476190476,0,1,0,560682,44928,76486,31470,0.4161695505576346,0.4119217780570172
30087,0.7323809523809524,2,4,2,560686,44924,76488,31468,0.4161324984252844,0.4119279505707404
30088,0.7324151404151403,0,1,0,560687,44923,76488,31468,0.4161232353921968,0.41193334293306805
30089,0.7324635642135643,0,1,0,560688,44922,76488,31468,0.41611397235910924,0.41193873543657544
30090,0.7324761904761904,0,1,0,560689,44921,76488,31468,0.4161047093260217,0.41194412808126823
30091,0.7324999999999998,1,0,1,560689,44921,76489,31467,0.4161047093260217,0.41193642980572864
30092,0.7325,49,99,49,560788,44822,76538,31418,0.41518766905035387,0.412093389296957
30093,0.7325000000000002,1,4,1,560792,44818,76539,31417,0.41515061691800365,0.4121072997966813
30094,0.7325238095238095,0,1,0,560793,44817,76539,31417,0.4151413538849161,0.4121127056169163
30095,0.7325476190476191,0,1,0,560794,44816,76539,31417,0.4151320908518285,0.412118111578975
30096,0.7325833333333334,0,1,0,560795,44815,76539,31417,0.415122827818741,0.4121235176828628
30097,0.7325952380952381,0,1,0,560796,44814,76539,31417,0.4151135647856534,0.41212892392858547
30098,0.7326060606060607,2,0,2,560796,44814,76541,31415,0.4151135647856534,0.4121135001115061
30099,0.7326190476190476,2,1,2,560797,44813,76543,31413,0.41510430175256585,0.4121034817516333
30100,0.7326529581529582,0,3,0,560800,44810,76543,31413,0.4150765126533032,0.41211970140246384
30101,0.7326666666666665,2,1,2,560801,44809,76545,31411,0.41506724962021563,0.41210968249803204
30102,0.7326666666666667,4,8,4,560809,44801,76549,31407,0.41499314535551524,0.4121220869200084
30103,0.7326666666666668,0,3,0,560812,44798,76549,31407,0.4149653562562525,0.41213831113444
30104,0.7327142857142858,1,0,1,560812,44798,76550,31406,0.4149653562562525,0.4121305968190646
30105,0.7327222222222223,0,1,0,560813,44797,76550,31406,0.414956093223165,0.41213600514415444
30106,0.7327738095238093,1,0,1,560813,44797,76551,31405,0.414956093223165,0.41212829059604733
30107,0.7327777777777778,0,1,0,560814,44796,76551,31405,0.41494683019007744,0.4121336990328211
30108,0.7328214285714284,1,0,1,560814,44796,76552,31404,0.41494683019007744,0.4121259842519685
30109,0.7328333333333333,0,3,0,560817,44793,76552,31404,0.4149190410908148,0.41214221032324105
30110,0.7328333333333334,1,1,1,560818,44792,76553,31403,0.4149097780577272,0.4121399041931885
30111,0.7328571428571428,3,4,3,560822,44788,76556,31400,0.414872725925377,0.4121383944978212
30112,0.7328888888888889,0,1,0,560823,44787,76556,31400,0.4148634628922894,0.41214380406106027
30113,0.7329166666666667,1,1,1,560824,44786,76557,31399,0.4148541998592019,0.412141497670145
30114,0.7329206349206349,0,2,0,560826,44784,76557,31399,0.41483567379302677,0.4121523174461494
30115,0.7329285714285715,1,1,1,560827,44783,76558,31398,0.41482641075993926,0.4121500111576377
30116,0.7329761904761903,0,1,0,560828,44782,76558,31398,0.4148171477268517,0.4121554213704384
30117,0.7329999999999999,0,2,0,560830,44780,76558,31398,0.41479862166067655,0.41216624222216386
30118,0.733,9,19,9,560849,44761,76567,31389,0.41462262403201305,0.41219960604070915
30119,0.7330000000000001,0,5,0,560854,44756,76567,31389,0.41457630886657526,0.4122266727953247
30120,0.7330476190476192,0,1,0,560855,44755,76567,31389,0.4145670458334877,0.4122320865728094
30121,0.733107142857143,2,0,2,560855,44755,76569,31387,0.4145670458334877,0.4122166478421896
30122,0.7331428571428572,1,1,1,560856,44754,76570,31386,0.4145577828004002,0.41221434200157603
30123,0.7331666666666666,0,3,0,560859,44751,76570,31386,0.4145299937011375,0.4122305843413846
30124,0.7332142857142857,0,2,0,560861,44749,76570,31386,0.4145114676349624,0.4122414132790438
30125,0.7332142857142858,0,1,0,560862,44748,76570,31386,0.4145022046018748,0.41224682796122625
30126,0.7332857142857142,0,2,0,560864,44746,76570,31386,0.41448367853569973,0.4122576577523249
30127,0.7333095238095239,0,1,0,560865,44745,76570,31386,0.41447441550261216,0.4122630728612523
30128,0.7333333333333332,0,2,0,560867,44743,76570,31386,0.4144558894364371,0.4122739035058913
30129,0.7333333333333333,25,105,25,560972,44638,76595,31361,0.41348327096224385,0.41265016644955854
30130,0.7333333333333334,58,113,58,561085,44525,76653,31303,0.41243654822335024,0.4128158463891966
30131,0.7333650793650794,0,1,0,561086,44524,76653,31303,0.4124272851902627,0.41282129056932226
30132,0.7334523809523809,1,2,1,561088,44522,76654,31302,0.4124087591240876,0.412824435534923
30133,0.7334999999999998,0,1,0,561089,44521,76654,31302,0.412399496091,0.41282988011553223
30134,0.7334999999999999,3,10,3,561099,44511,76657,31299,0.4123068657601245,0.41286110011871785
30135,0.7335,0,2,0,561101,44509,76657,31299,0.4122883396939494,0.41287199240185735
30136,0.7335119047619049,0,1,0,561102,44508,76657,31299,0.41227907666086183,0.41287743875895366
30137,0.7335595238095237,0,2,0,561104,44506,76657,31299,0.41226055059468675,0.41288833190422797
30138,0.7335714285714287,0,1,0,561105,44505,76657,31299,0.4122512875615992,0.4128937786924173
30139,0.7336190476190475,0,1,0,561106,44504,76657,31299,0.4122420245285116,0.41289922562431564
30140,0.7336428571428572,1,3,1,561109,44501,76658,31298,0.41221423542924895,0.4129078220029288
30141,0.7336666666666666,2,1,2,561110,44500,76660,31296,0.4122049723961614,0.4128977782468732
30142,0.7336666666666667,3,5,3,561115,44495,76663,31293,0.41215865723072365,0.4129017786456959
30143,0.7336904761904762,1,1,1,561116,44494,76664,31292,0.4121493941976361,0.41289948011506084
30144,0.733722222222222,0,1,0,561117,44493,76664,31292,0.4121401311645485,0.4129049284159134
30145,0.73375,2,2,2,561119,44491,76666,31290,0.4121216050983734,0.4129003312175875
30146,0.7338174603174604,1,0,1,561119,44491,76667,31289,0.4121216050983734,0.4128925837951966
30147,0.7338333333333331,1,1,1,561120,44490,76668,31288,0.41211234206528585,0.4128902847792235
30148,0.7338333333333332,0,5,0,561125,44485,76668,31288,0.41206602689984806,0.4129175299908939
30149,0.7338333333333334,0,5,0,561130,44480,76668,31288,0.4120197117344103,0.41294477879843733
30150,0.7338888888888888,0,1,0,561131,44479,76668,31288,0.41201044870132275,0.41295022899151346
30151,0.7339166666666667,0,1,0,561132,44478,76668,31288,0.4120011856682352,0.41295567932845867
30152,0.7339285714285714,0,2,0,561134,44476,76668,31288,0.4119826596020601,0.4129665804339792
30153,0.7339458874458874,1,0,1,561134,44476,76669,31287,0.4119826596020601,0.41295883214761825
30154,0.733952380952381,0,1,0,561135,44475,76669,31287,0.4119733965689725,0.41296428288587944
30155,0.7339642857142857,2,1,2,561136,44474,76671,31285,0.411964133535885,0.41295423646035456
30156,0.7339761904761904,0,1,0,561137,44473,76671,31285,0.41195487050279744,0.4129596874257504
30157,0.7339999999999999,0,5,0,561142,44468,76671,31285,0.41190855533735965,0.41298694441144246
30158,0.7340000000000001,17,31,17,561173,44437,76688,31268,0.4116214013116455,0.4130242388217423
30159,0.734047619047619,0,1,0,561174,44436,76688,31268,0.4116121382785579,0.41302969460002115
30160,0.7340476190476192,0,1,0,561175,44435,76688,31268,0.4116028752454704,0.4130351505224364
30161,0.7340555555555555,1,0,1,561175,44435,76689,31267,0.4116028752454704,0.41302739689836465
30162,0.7341190476190477,0,1,0,561176,44434,76689,31267,0.41159361221238283,0.41303285293457154
30163,0.7341428571428571,0,1,0,561177,44433,76689,31267,0.41158434917929526,0.41303830911492734
30164,0.7341666666666665,8,26,8,561203,44407,76697,31259,0.41134351031901883,0.41311817725266303
30165,0.7341666666666667,13,26,13,561229,44381,76710,31246,0.41110267145874246,0.413159321406376
30166,0.7342142857142856,0,1,0,561230,44380,76710,31246,0.4110934084256549,0.41316478459788963
30167,0.7342857142857142,1,1,1,561231,44379,76711,31245,0.4110841453925673,0.4131624880990162
30168,0.7342857142857143,0,7,0,561238,44372,76711,31245,0.41101930416095445,0.4132007352843937
30169,0.7343333333333333,0,6,0,561244,44366,76711,31245,0.41096372596242914,0.413233524222666
30170,0.7343333333333334,2,16,2,561260,44350,76713,31243,0.41081551743302824,0.41330546479171354
30171,0.7343333333333335,0,1,0,561261,44349,76713,31243,0.41080625439994073,0.4133109323737962
30172,0.7343492063492065,0,1,0,561262,44348,76713,31243,0.41079699136685316,0.41331640010054105
30173,0.7343571428571429,0,1,0,561263,44347,76713,31243,0.4107877283337656,0.41332186797195397
30174,0.7344444444444445,0,1,0,561264,44346,76713,31243,0.4107784653006781,0.4133273359880406
30175,0.7344523809523811,0,2,0,561266,44344,76713,31243,0.41075993923450294,0.413338272454258
30176,0.7344642857142857,0,1,0,561267,44343,76713,31243,0.41075067620141537,0.4133437409044003
30177,0.7344999999999999,0,2,0,561269,44341,76713,31243,0.4107321501352403,0.4133546782387807
30178,0.7345,1,4,1,561273,44337,76714,31242,0.41069509800289006,0.4133687929186679
30179,0.7345238095238096,0,1,0,561274,44336,76714,31242,0.4106858349698025,0.41337426235147795
30180,0.734547619047619,1,0,1,561274,44336,76715,31241,0.4106858349698025,0.4133665003903304
30181,0.7345714285714285,0,1,0,561275,44335,76715,31241,0.410676571936715,0.4133719699375463
30182,0.7345833333333333,1,0,1,561275,44335,76716,31240,0.410676571936715,0.41336420774065497
30183,0.7345833333333335,0,1,0,561276,44334,76716,31240,0.4106673089036274,0.4133696774022812
30184,0.7346190476190477,0,1,0,561277,44333,76716,31240,0.41065804587053983,0.4133751472086592
30185,0.7346428571428573,1,1,1,561278,44332,76717,31239,0.4106487828374523,0.4133728546664726
30186,0.7346666666666666,1,1,1,561279,44331,76718,31238,0.41063951980436475,0.4133705620029377
30187,0.7346666666666667,6,12,6,561291,44319,76724,31232,0.4105283634073141,0.4133896308453892
30188,0.7346904761904761,0,1,0,561292,44318,76724,31232,0.41051910037422656,0.41339510258107215
30189,0.7347619047619048,0,1,0,561293,44317,76724,31232,0.410509837341139,0.4134005744616077
30190,0.7348333333333332,0,2,0,561295,44315,76724,31232,0.41049131127496385,0.4134115186572597
30191,0.7348333333333333,0,9,0,561304,44306,76724,31232,0.4104079439771759,0.4134607747094178
30192,0.7348333333333334,0,3,0,561307,44303,76724,31232,0.41038015487791324,0.41347719600185345
30193,0.734857142857143,1,1,1,561308,44302,76725,31231,0.41037089184482567,0.41347490500840695
30194,0.7348809523809524,0,1,0,561309,44301,76725,31231,0.4103616288117381,0.41348037917703756
30195,0.7349047619047618,1,0,1,561309,44301,76726,31230,0.4103616288117381,0.4134726138936331
30196,0.7349325396825397,0,1,0,561310,44300,76726,31230,0.4103523657786506,0.41347808817688336
30197,0.7349761904761907,0,1,0,561311,44299,76726,31230,0.410343102745563,0.41348356260509206
30198,0.7349999999999999,3,5,3,561316,44294,76729,31227,0.4102967875801252,0.4134876391996928
30199,0.735,204,397,204,561713,43897,76933,31023,0.4066193634443662,0.4140816871329418
30200,0.7350000000000001,0,5,0,561718,43892,76933,31023,0.40657304827892843,0.4141093239004205
30201,0.7350039682539682,1,0,1,561718,43892,76934,31022,0.40657304827892843,0.4141015030568385
30202,0.7350158730158729,1,0,1,561718,43892,76935,31021,0.40657304827892843,0.4140936820044585
30203,0.7350238095238094,0,1,0,561719,43891,76935,31021,0.4065637852458409,0.4140992097394276
30204,0.7350238095238096,0,1,0,561720,43890,76935,31021,0.40655452221275334,0.4141047376219781
30205,0.7350317460317461,1,0,1,561720,43890,76936,31020,0.40655452221275334,0.41409691629955947
30206,0.7350952380952381,1,1,1,561721,43889,76937,31019,0.4065452591796658,0.4140946227372243
30207,0.7351190476190478,0,1,0,561722,43888,76937,31019,0.40653599614657826,0.4141001508537253
30208,0.735141774891775,0,4,0,561726,43884,76937,31019,0.40649894401422804,0.41412226479580255
30209,0.7351666666666665,1,3,1,561729,43881,76938,31018,0.4064711549149654,0.4141310297867795
30210,0.7351666666666666,2,9,2,561738,43872,76940,31016,0.40638778761717737,0.41416515329558806
30211,0.7351666666666667,0,2,0,561740,43870,76940,31016,0.4063692615510023,0.414176214512726
30212,0.7352222222222221,0,1,0,561741,43869,76940,31016,0.4063599985179147,0.41418174534285906
30213,0.7352380952380951,1,0,1,561741,43869,76941,31015,0.4063599985179147,0.4141739223332087
30214,0.7352420634920636,0,1,0,561742,43868,76941,31015,0.40635073548482714,0.41417945328045086
30215,0.7352500000000001,1,0,1,561742,43868,76942,31014,0.40635073548482714,0.4141716300312492
30216,0.7352619047619049,0,2,0,561744,43866,76942,31014,0.40633220941865206,0.41418269230769234
30217,0.7352698412698412,1,1,1,561745,43865,76943,31013,0.4063229463855645,0.4141804001175245
30218,0.7352857142857144,1,1,1,561746,43864,76944,31012,0.4063136833524769,0.4141781078049041
30219,0.735297619047619,0,1,0,561747,43863,76944,31012,0.4063044203193894,0.4141836393989983
30220,0.7353333333333332,0,2,0,561749,43861,76944,31012,0.40628589425321426,0.4141947030304649
30221,0.7353333333333333,6,10,6,561759,43851,76950,31006,0.40619326392233873,0.41420308054023003
30222,0.7353492063492064,0,1,0,561760,43850,76950,31006,0.40618400088925116,0.4142086138719675
30223,0.7353571428571428,2,1,2,561761,43849,76952,31004,0.40617473785616365,0.4141984957182745
30224,0.7353809523809524,1,0,1,561761,43849,76953,31003,0.40617473785616365,0.41419066958798695
30225,0.7354166666666666,1,0,1,561761,43849,76954,31002,0.40617473785616365,0.4141828432485872
30226,0.7354523809523809,1,3,1,561764,43846,76955,31001,0.40614694875690094,0.41419161756650236
30227,0.7354999999999999,2,6,2,561770,43840,76957,30999,0.40609137055837563,0.4142091690161547
30228,0.7355000000000002,0,2,0,561772,43838,76957,30999,0.40607284449220055,0.4142202386520037
30229,0.7355178571428573,0,1,0,561773,43837,76957,30999,0.406063581459113,0.4142257736918061
30230,0.7355555555555555,1,0,1,561773,43837,76958,30998,0.406063581459113,0.4142179461481927
30231,0.7355555555555557,0,1,0,561774,43836,76958,30998,0.4060543184260254,0.414223481305289
30232,0.7355952380952381,0,1,0,561775,43835,76958,30998,0.40604505539293784,0.41422901661031897
30233,0.7356349206349206,0,1,0,561776,43834,76958,30998,0.4060357923598503,0.4142345520632884
30234,0.7356666666666666,2,15,2,561791,43819,76960,30996,0.405896846863537,0.41430194479716637
30235,0.7356666666666668,2,2,2,561793,43817,76962,30994,0.4058783207973619,0.4142973626873053
30236,0.7357142857142857,0,4,0,561797,43813,76962,30994,0.4058412686650117,0.41431951555335733
30237,0.7357380952380952,0,3,0,561800,43810,76962,30994,0.40581347956574904,0.41433613175766004
30238,0.7358333333333333,5,28,5,561828,43782,76967,30989,0.40555411463929747,0.41445212716160007
30239,0.7358333333333335,6,20,6,561848,43762,76973,30983,0.4053688539775464,0.4145160211385377
30240,0.7358571428571429,0,1,0,561849,43761,76973,30983,0.40535959094445884,0.4145215669485176
30241,0.7359025974025976,0,1,0,561850,43760,76973,30983,0.4053503279113713,0.4145271129068943
30242,0.7359047619047618,1,0,1,561850,43760,76974,30982,0.4053503279113713,0.41451927965534774
30243,0.7359285714285716,1,0,1,561850,43760,76975,30981,0.4053503279113713,0.4145114461941906
30244,0.735952380952381,0,1,0,561851,43759,76975,30981,0.40534106487828375,0.4145169922397645
30245,0.736,20,40,20,561891,43719,76995,30961,0.40497054355478157,0.41458221746116763
30246,0.7360000000000001,1,3,1,561894,43716,76996,30960,0.4049427544555189,0.41459103326369917
30247,0.7360238095238094,0,1,0,561895,43715,76996,30960,0.40493349142243135,0.41459658520254433
30248,0.7360714285714286,0,1,0,561896,43714,76996,30960,0.40492422838934383,0.4146021372900876
30249,0.7360833333333333,0,2,0,561898,43712,76996,30960,0.4049057023231687,0.41461324191129206
30250,0.7361666666666666,5,2,5,561900,43710,77001,30955,0.4048871762569936,0.4145851469898882
30251,0.7361666666666667,0,12,0,561912,43698,77001,30955,0.40477601985994294,0.41465178894351196
30252,0.7361666666666669,0,2,0,561914,43696,77001,30955,0.40475749379376785,0.4146628980187807
30253,0.7361818181818179,0,1,0,561915,43695,77001,30955,0.4047482307606803,0.4146684527796383
30254,0.7361904761904762,1,0,1,561915,43695,77002,30954,0.4047482307606803,0.4146606116625809
30255,0.7362023809523807,0,2,0,561917,43693,77002,30954,0.40472970469450514,0.41467172156952053
30256,0.7362261904761906,0,2,0,561919,43691,77002,30954,0.40471117862833006,0.41468283207180656
30257,0.7362380952380952,0,1,0,561920,43690,77002,30954,0.4047019155952425,0.4146883875462194
30258,0.73625,1,3,1,561923,43687,77003,30953,0.40467412649597984,0.4146972132904609
30259,0.7362777777777777,0,1,0,561924,43686,77003,30953,0.40466486346289227,0.414702769329707
30260,0.7363095238095237,0,1,0,561925,43685,77003,30953,0.40465560042980475,0.41470832551783277
30261,0.7363333333333333,5,6,5,561931,43679,77008,30948,0.4046000222312794,0.41470245353558366
30262,0.7363333333333334,3,3,3,561934,43676,77011,30945,0.40457223313201673,0.4146955950737728
30263,0.7363809523809525,1,0,1,561934,43676,77012,30944,0.40457223313201673,0.41468775127311713
30264,0.7364285714285714,0,1,0,561935,43675,77012,30944,0.4045629700989292,0.4146933086747343
30265,0.7364999999999999,2,2,2,561937,43673,77014,30942,0.4045444440327541,0.4146887355089459
30266,0.7365,2,13,2,561950,43660,77016,30940,0.4044240246026159,0.41474530831099193
30267,0.7365000000000002,0,1,0,561951,43659,77016,30940,0.4044147615695283,0.41475086797410154
30268,0.736511904761905,0,2,0,561953,43657,77016,30940,0.40439623550335324,0.41476198774749656
30269,0.7365476190476191,1,0,1,561953,43657,77017,30939,0.40439623550335324,0.41475414231326074
30270,0.7365714285714285,0,1,0,561954,43656,77017,30939,0.40438697247026567,0.41475970239292176
30271,0.7365833333333334,1,1,1,561955,43655,77018,30938,0.4043777094371781,0.4147574169157964
30272,0.7365833333333335,0,1,0,561956,43654,77018,30938,0.40436844640409053,0.4147629772629773
30273,0.7366363636363638,1,1,1,561957,43653,77019,30937,0.404359183371003,0.4147606917817402
30274,0.7366666666666666,80,127,80,562084,43526,77099,30857,0.4031827781688836,0.4148394122312894
30275,0.7366666666666667,49,87,49,562171,43439,77148,30808,0.4023768942902664,0.414939324147777
30276,0.7366666666666668,1,1,1,562172,43438,77149,30807,0.40236763125717884,0.4149370327968213
30277,0.7366785714285713,0,2,0,562174,43436,77149,30807,0.40234910519100375,0.4149482106057137
30278,0.7367619047619048,0,1,0,562175,43435,77149,30807,0.4023398421579162,0.4149537997359985
30279,0.7368333333333332,1,1,1,562176,43434,77150,30806,0.4023305791248286,0.41495150862068964
30280,0.7368333333333333,1,5,1,562181,43429,77151,30805,0.4022842639593909,0.41497157636662446
30281,0.736857142857143,1,0,1,562181,43429,77152,30804,0.4022842639593909,0.41496369539153743
30282,0.7368888888888888,0,1,0,562182,43428,77152,30804,0.4022750009263033,0.4149692854833495
30283,0.7369166666666667,0,2,0,562184,43426,77152,30804,0.4022564748601282,0.4149804661188199
30284,0.7369285714285714,1,0,1,562184,43426,77153,30803,0.4022564748601282,0.4149725848388096
30285,0.7369404761904762,0,1,0,562185,43425,77153,30803,0.40224721182704065,0.41497817535161935
30286,0.7369999999999999,1,4,1,562189,43421,77154,30802,0.40221015969469043,0.4149926572625736
30287,0.737,5,17,5,562206,43404,77159,30797,0.402052688132202,0.41504831471273973
30288,0.7370238095238093,0,1,0,562207,43403,77159,30797,0.40204342509911445,0.41505390835579514
30289,0.7370238095238095,0,1,0,562208,43402,77159,30797,0.4020341620660269,0.41505950214962467
30290,0.7370595238095237,1,0,1,562208,43402,77160,30796,0.4020341620660269,0.4150516186420119
30291,0.7370833333333333,0,2,0,562210,43400,77160,30796,0.4020156359998518,0.415062806620303
30292,0.7371190476190477,1,0,1,562210,43400,77161,30795,0.4020156359998518,0.4150549228384662
30293,0.737142857142857,0,1,0,562211,43399,77161,30795,0.4020063729667642,0.41506051702293983
30294,0.7371428571428571,1,0,1,562211,43399,77162,30794,0.4020063729667642,0.41505263299772216
30295,0.7371428571428572,1,4,1,562215,43395,77163,30793,0.401969320834414,0.4150671267590446
30296,0.7371666666666666,0,4,0,562219,43391,77163,30793,0.4019322687020638,0.41508950717135773
30297,0.7371825396825398,0,2,0,562221,43389,77163,30793,0.4019137426358887,0.41510069828260227
30298,0.7373333333333332,1,2,1,562223,43387,77164,30792,0.4018952165697136,0.41510400517666723
30299,0.7373333333333334,2,7,2,562230,43380,77166,30790,0.40183037533810073,0.41512741000404474
30300,0.7373333333333335,0,1,0,562231,43379,77166,30790,0.40182111230501316,0.41513300705146355
30301,0.7373809523809522,2,1,2,562232,43378,77168,30788,0.4018118492719256,0.4151228325647871
30302,0.7373888888888888,1,2,1,562234,43376,77169,30787,0.4017933232057505,0.4151261410676483
30303,0.7374196497946497,0,1,0,562235,43375,77169,30787,0.40178406017266294,0.41513173862625063
30304,0.737452380952381,0,2,0,562237,43373,77169,30787,0.40176553410648785,0.41514293419633225
30305,0.7374761904761905,0,1,0,562238,43372,77169,30787,0.4017562710734003,0.4151485322078237
30306,0.7374999999999998,3,5,3,562243,43367,77172,30784,0.4017099559079625,0.4151528637509946
30307,0.7375,50,91,50,562334,43276,77222,30734,0.4008670198969951,0.4152682069990542
30308,0.7375000000000002,1,4,1,562338,43272,77223,30733,0.40082996776464486,0.4152827511654618
30309,0.7375115440115436,0,2,0,562340,43270,77223,30733,0.4008114416984698,0.41529397456859857
30310,0.7375257789596021,2,0,2,562340,43270,77225,30731,0.4008114416984698,0.4152781719165957
30311,0.7375595238095238,0,1,0,562341,43269,77225,30731,0.4008021786653822,0.4152837837837838
30312,0.7375641025641024,0,1,0,562342,43268,77225,30731,0.40079291563229463,0.41528939580264596
30313,0.7375833333333333,0,1,0,562343,43267,77225,30731,0.40078365259920706,0.41529500797318847
30314,0.7375952380952381,2,1,2,562344,43266,77227,30729,0.40077438956611955,0.4152848165416582
30315,0.7376190476190476,0,1,0,562345,43265,77227,30729,0.400765126533032,0.41529042895369894
30316,0.737642857142857,0,2,0,562347,43263,77227,30729,0.4007466004668569,0.41530165423289006
30317,0.7376666666666665,2,2,2,562349,43261,77229,30727,0.40072807440068176,0.415297075201384
30318,0.7376666666666667,5,17,5,562366,43244,77234,30722,0.40057060283819335,0.41535300002703945
30319,0.7376666666666668,0,3,0,562369,43241,77234,30722,0.4005428137389307,0.415369847085705
30320,0.7377142857142858,0,1,0,562370,43240,77234,30722,0.4005335507058431,0.41537546307563344
30321,0.7377222222222224,1,0,1,562370,43240,77235,30721,0.4005335507058431,0.4153675585781696
30322,0.73775,0,2,0,562372,43238,77235,30721,0.40051502463966804,0.4153787909517435
30323,0.7378333333333333,2,3,2,562375,43235,77237,30719,0.40048723554040533,0.4153798307055737
30324,0.7378333333333335,0,2,0,562377,43233,77237,30719,0.40046870947423024,0.41539106447425356
30325,0.7378571428571428,1,0,1,562377,43233,77238,30718,0.40046870947423024,0.415383159118876
30326,0.7379285714285715,0,1,0,562378,43232,77238,30718,0.4004594464411427,0.4153887762001352
30327,0.7379523809523809,0,1,0,562379,43231,77238,30718,0.40045018340805516,0.41539439343331214
30328,0.7379761904761907,1,0,1,562379,43231,77239,30717,0.40045018340805516,0.4153864878022394
30329,0.7379999999999999,1,1,1,562380,43230,77240,30716,0.4004409203749676,0.4153841992805561
30330,0.738,15,31,15,562411,43199,77255,30701,0.4001537663492534,0.4154397834912043
30331,0.7380000000000001,2,3,2,562414,43196,77257,30699,0.4001259772499907,0.41544082820217876
30332,0.7380238095238095,0,1,0,562415,43195,77257,30699,0.4001167142169032,0.4154464503207297
30333,0.7380357142857144,0,1,0,562416,43194,77257,30699,0.40010745118381563,0.4154520725914498
30334,0.7380396825396826,1,0,1,562416,43194,77258,30698,0.40010745118381563,0.4154441617495805
30335,0.7380476190476191,0,1,0,562417,43193,77258,30698,0.40009818815072806,0.41544978414150574
30336,0.7380476190476192,2,1,2,562418,43192,77260,30696,0.4000889251176405,0.41543958423559985
30337,0.7380714285714286,0,1,0,562419,43191,77260,30696,0.400079662084553,0.41544520686995007
30338,0.7380952380952381,0,1,0,562420,43190,77260,30696,0.4000703990514654,0.4154508296564978
30339,0.7381428571428569,1,2,1,562422,43188,77261,30695,0.4000518729852903,0.4154541640160795
30340,0.7381666666666665,1,0,1,562422,43188,77262,30694,0.4000518729852903,0.4154462521317777
30341,0.7381666666666666,5,5,5,562427,43183,77267,30689,0.40000555781985253,0.41543480615118045
30342,0.7381666666666667,0,1,0,562428,43182,77267,30689,0.39999629478676496,0.41544042993867686
30343,0.7382142857142856,0,1,0,562429,43181,77267,30689,0.39998703175367745,0.4154460538784351
30344,0.7382619047619048,0,1,0,562430,43180,77267,30689,0.3999777687205899,0.41545167797046123
30345,0.7382857142857143,0,2,0,562432,43178,77267,30689,0.39995924265441474,0.415462926611342
30346,0.7383333333333333,19,38,19,562470,43140,77286,30670,0.3996072473970877,0.4155263514428939
30347,0.7383333333333334,21,42,21,562512,43098,77307,30649,0.39921820000741043,0.4155965666399989
30348,0.7384166666666667,1,0,1,562512,43098,77308,30648,0.39921820000741043,0.4155886420958425
30349,0.7384444444444443,0,1,0,562513,43097,77308,30648,0.39920893697432286,0.4155942775781409
30350,0.7384999999999998,0,1,0,562514,43096,77308,30648,0.39919967394123534,0.4155999132132784
30351,0.7384999999999999,4,15,4,562529,43081,77312,30644,0.399060728444922,0.41565276364869447
30352,0.7385,2,3,2,562532,43078,77314,30642,0.39903293934565937,0.4156538252848616
30353,0.7385039682539685,2,1,2,562533,43077,77316,30640,0.3990236763125718,0.4156436100221116
30354,0.7385119047619049,1,2,1,562535,43075,77317,30639,0.39900515024639666,0.4156469598719375
30355,0.7385357142857143,1,2,1,562537,43073,77318,30638,0.39898662418022157,0.41565030999443775
30356,0.7385714285714287,0,3,0,562540,43070,77318,30638,0.3989588350809589,0.4156672274379986
30357,0.7386190476190477,1,0,1,562540,43070,77319,30637,0.3989588350809589,0.41565929965946247
30358,0.7386349206349208,0,2,0,562542,43068,77319,30637,0.3989403090147838,0.4156705786581643
30359,0.738642857142857,1,0,1,562542,43068,77320,30636,0.3989403090147838,0.41566265060240964
30360,0.7386666666666665,1,3,1,562545,43065,77321,30635,0.3989125199155211,0.41567164179104477
30361,0.7386666666666666,0,5,0,562550,43060,77321,30635,0.3988662047500834,0.4156998439514214
30362,0.7386666666666667,1,6,1,562556,43054,77322,30634,0.398810626551558,0.41572576267506245
30363,0.7386904761904762,1,1,1,562557,43053,77323,30633,0.3988013635184705,0.41572347528702874
30364,0.7387222222222221,0,1,0,562558,43052,77323,30633,0.39879210048538294,0.41572911718803013
30365,0.73875,2,0,2,562558,43052,77325,30631,0.39879210048538294,0.4157132581463838
30366,0.7388095238095238,1,1,1,562559,43051,77326,30630,0.39878283745229537,0.41571097026370435
30367,0.7388333333333332,0,11,0,562570,43040,77326,30630,0.39868094408833227,0.41577304194380343
30368,0.7388333333333335,0,2,0,562572,43038,77326,30630,0.3986624180221572,0.41578432969539014
30369,0.7388571428571428,0,2,0,562574,43036,77326,30630,0.39864389195598204,0.41579561805989196
30370,0.7388571428571429,0,1,0,562575,43035,77326,30630,0.39863462892289453,0.4158012624720016
30371,0.738904761904762,0,2,0,562577,43033,77326,30630,0.3986161028567194,0.41581255175596976
30372,0.7389761904761905,0,1,0,562578,43032,77326,30630,0.3986068398236319,0.4158181966278407
30373,0.7389960317460316,0,5,0,562583,43027,77326,30630,0.3985605246581941,0.4158464232863136
30374,0.7389978354978355,1,2,1,562585,43025,77327,30629,0.398541998592019,0.4158497841257773
30375,0.7389999999999999,0,2,0,562587,43023,77327,30629,0.39852347252584386,0.4158610764134036
30376,0.7390000000000001,9,18,9,562605,43005,77336,30620,0.3983567379302679,0.41589134125636673
30377,0.7390000000000002,0,1,0,562606,43004,77336,30620,0.3983474748971803,0.41589699011192005
30378,0.739047619047619,0,2,0,562608,43002,77336,30620,0.3983289488310052,0.41590828828339355
30379,0.7390476190476192,0,2,0,562610,43000,77336,30620,0.39831042276483014,0.41591958706873133
30380,0.7390714285714287,0,1,0,562611,42999,77336,30620,0.39830115973174257,0.41592523669161496
30381,0.7391666666666664,0,1,0,562612,42998,77336,30620,0.398291896698655,0.4159308864679834
30382,0.7391666666666665,9,35,9,562647,42963,77345,30611,0.3979676905405906,0.4160573028515508
30383,0.7391666666666667,7,33,7,562680,42930,77352,30604,0.3976620104487013,0.41618842984197785
30384,0.7392380952380952,1,2,1,562682,42928,77353,30603,0.3976434843825262,0.41619181025689844
30385,0.7392857142857142,0,1,0,562683,42927,77353,30603,0.39763422134943865,0.41619747042023664
30386,0.7392857142857143,0,2,0,562685,42925,77353,30603,0.39761569528326357,0.41620879120879123
30387,0.7392857142857144,2,1,2,562686,42924,77355,30601,0.397606432250176,0.41619857191431486
30388,0.7393095238095236,0,1,0,562687,42923,77355,30601,0.39759716921708843,0.4162042326315217
30389,0.7393333333333332,0,5,0,562692,42918,77355,30601,0.3975508540516507,0.4162325385274555
30390,0.7393333333333334,8,13,8,562705,42905,77363,30593,0.39743043462151245,0.41624261884677133
30391,0.7393333333333335,0,1,0,562706,42904,77363,30593,0.39742117158842494,0.41624828224281263
30392,0.7394047619047619,1,1,1,562707,42903,77364,30592,0.39741190855533737,0.4162460031294646
30393,0.7394166666666666,0,1,0,562708,42902,77364,30592,0.3974026455222498,0.4162516668027322
30394,0.7394444444444445,1,0,1,562708,42902,77365,30591,0.3974026455222498,0.41624372389207137
30395,0.7394761904761906,0,1,0,562709,42901,77365,30591,0.39739338248916223,0.4162493876884559
30396,0.7394999999999999,0,2,0,562711,42899,77365,30591,0.39737485642298714,0.4162607157436386
30397,0.7395,1,2,1,562713,42897,77366,30590,0.39735633035681206,0.41626410113353385
30398,0.7395039682539684,3,1,3,562714,42896,77369,30587,0.3973470673237245,0.41624593443381463
30399,0.7395303030303032,0,2,0,562716,42894,77369,30587,0.39732854125754935,0.4162572637824744
30400,0.7395833333333333,0,1,0,562717,42893,77369,30587,0.39731927822446184,0.4162629286880784
30401,0.7395952380952382,0,2,0,562719,42891,77369,30587,0.3973007521582867,0.41627425896186615
30402,0.7396666666666666,1,4,1,562723,42887,77370,30586,0.3972637000259365,0.41628897690308003
30403,0.7396666666666667,3,9,3,562732,42878,77373,30583,0.3971803327281485,0.41631614053715577
30404,0.7396666666666668,0,1,0,562733,42877,77373,30583,0.39717106969506094,0.4163218077865505
30405,0.7397142857142857,0,1,0,562734,42876,77373,30583,0.39716180666197337,0.41632747519024216
30406,0.7397142857142858,1,0,1,562734,42876,77374,30582,0.39716180666197337,0.4163195295270767
30407,0.7397222222222222,0,1,0,562735,42875,77374,30582,0.39715254362888586,0.41632519705405885
30408,0.7397499999999999,0,1,0,562736,42874,77374,30582,0.3971432805957983,0.4163308647353518
30409,0.7397619047619046,0,1,0,562737,42873,77374,30582,0.3971340175627107,0.4163365325709618
30410,0.7397619047619048,1,0,1,562737,42873,77375,30581,0.3971340175627107,0.4163285865984153
30411,0.7397698412698414,0,2,0,562739,42871,77375,30581,0.39711549149653563,0.4163399226705876
30412,0.7398333333333332,0,1,0,562740,42870,77375,30581,0.39710622846344806,0.41634559093817647
30413,0.7398333333333333,1,10,1,562750,42860,77376,30580,0.39701359813257253,0.41639433551198257
30414,0.7399047619047618,0,1,0,562751,42859,77376,30580,0.39700433509948496,0.41640000544669725
30415,0.7399523809523809,0,1,0,562752,42858,77376,30580,0.39699507206639745,0.41640567553582614
30416,0.7399880952380952,1,0,1,562752,42858,77377,30579,0.39699507206639745,0.41639772866538666
30417,0.7399999999999999,8,7,8,562759,42851,77385,30571,0.3969302308347845,0.41637383890387075
30418,0.74,713,1273,713,564032,41578,78098,29858,0.38513838971432807,0.41796853127274763
30419,0.7400000000000001,1,7,1,564039,41571,78099,29857,0.3850735484827152,0.41800134401075206
30420,0.7400277777777778,0,1,0,564040,41570,78099,29857,0.3850642854496276,0.4180071961583155
30421,0.740047619047619,0,1,0,564041,41569,78099,29857,0.38505502241654005,0.4180130484697449
30422,0.7400555555555556,0,1,0,564042,41568,78099,29857,0.38504575938345253,0.41801890094504723
30423,0.7400634920634919,0,1,0,564043,41567,78099,29857,0.38503649635036497,0.4180247535842294
30424,0.7400714285714285,0,1,0,564044,41566,78099,29857,0.3850272333172774,0.4180306063872982
30425,0.7400833333333332,1,0,1,564044,41566,78100,29856,0.3850272333172774,0.4180224580661421
30426,0.7400952380952383,1,0,1,564044,41566,78101,29855,0.3850272333172774,0.4180143095168088
30427,0.7401190476190476,0,2,0,564046,41564,78101,29855,0.3850087072511023,0.41802601548607515
30428,0.7401190476190478,0,1,0,564047,41563,78101,29855,0.38499944421801474,0.41803186871657005
30429,0.7401212121212122,0,1,0,564048,41562,78101,29855,0.38499018118492717,0.418037722110982
30430,0.7401515151515151,2,0,2,564048,41562,78103,29853,0.38499018118492717,0.4180214240705734
30431,0.7401666666666665,0,1,0,564049,41561,78103,29853,0.38498091815183966,0.41802727756462316
30432,0.7401666666666666,5,10,5,564059,41551,78108,29848,0.38488828782096407,0.41804507065925295
30433,0.7401666666666668,1,0,1,564059,41551,78109,29847,0.38488828782096407,0.4180369198016751
30434,0.7401904761904761,0,1,0,564060,41550,78109,29847,0.38487902478787656,0.41804277490650865
30435,0.7402380952380951,0,1,0,564061,41549,78109,29847,0.384869761754789,0.41804863017536
30436,0.7402500000000001,0,2,0,564063,41547,78109,29847,0.3848512356886139,0.4180603412051433
30437,0.7402698412698413,1,0,1,564063,41547,78110,29846,0.3848512356886139,0.41805218999061533
30438,0.7403095238095238,0,3,0,564066,41544,78110,29846,0.3848234465893512,0.41806975766914134
30439,0.7403095238095239,1,0,1,564066,41544,78111,29845,0.3848234465893512,0.4180616061297959
30440,0.7403333333333332,0,1,0,564067,41543,78111,29845,0.3848141835562637,0.418067462318597
30441,0.7403333333333333,2,8,2,564075,41535,78113,29843,0.38474007929156323,0.41809801339348257
30442,0.7403333333333335,1,1,1,564076,41534,78114,29842,0.38473081625847566,0.4180957184487783
30443,0.7403492063492062,0,1,0,564077,41533,78114,29842,0.38472155322538815,0.4181015761821366
30444,0.7403571428571429,0,2,0,564079,41531,78114,29842,0.384703027159213,0.4181132921412859
30445,0.7404166666666666,0,1,0,564080,41530,78114,29842,0.38469376412612544,0.41811915036709074
30446,0.7404761904761904,2,1,2,564081,41529,78116,29840,0.3846845010930379,0.4181087026580168
30447,0.7404761904761905,0,1,0,564082,41528,78116,29840,0.38467523805995035,0.4181145611478534
30448,0.7404999999999999,1,6,1,564088,41522,78117,29839,0.38461965986142505,0.418141561917574
30449,0.7405000000000002,0,2,0,564090,41520,78117,29839,0.3846011337952499,0.4181532812959823
30450,0.7405000000000003,0,1,0,564091,41519,78117,29839,0.38459187076216234,0.41815914123153675
30451,0.7405238095238095,1,0,1,564091,41519,78118,29838,0.38459187076216234,0.41815098728926386
30452,0.7405833333333334,1,1,1,564092,41518,78119,29837,0.3845826077290748,0.4181486931539486
30453,0.740595238095238,0,1,0,564093,41517,78119,29837,0.38457334469598725,0.4181545533537013
30454,0.7406269841269841,0,3,0,564096,41514,78119,29837,0.3845455555967246,0.41817213493854327
30455,0.7406666666666665,1,0,1,564096,41514,78120,29836,0.3845455555967246,0.41816398037841623
30456,0.7406666666666666,7,20,7,564116,41494,78127,29829,0.38436029493497353,0.4182241352719319
30457,0.7406666666666668,1,1,1,564117,41493,78128,29828,0.38435103190188596,0.41822184209419383
30458,0.7407142857142857,0,3,0,564120,41490,78128,29828,0.3843232428026233,0.4182394346448302
30459,0.7407380952380953,0,1,0,564121,41489,78128,29828,0.38431397976953574,0.4182452991572837
30460,0.7407777777777776,0,1,0,564122,41488,78128,29828,0.38430471673644817,0.4182511638342027
30461,0.7408055555555555,1,0,1,564122,41488,78129,29827,0.38430471673644817,0.41824300638014444
30462,0.7408095238095237,1,2,1,564124,41486,78130,29826,0.3842861906702731,0.41824657841597485
30463,0.7408333333333331,0,2,0,564126,41484,78130,29826,0.38426766460409795,0.41825830879259573
30464,0.7408333333333332,6,18,6,564144,41466,78136,29820,0.38410093000852197,0.41831495665348034
30465,0.7408333333333335,8,22,8,564166,41444,78144,29812,0.3838971432805958,0.4183788031885034
30466,0.740857142857143,0,1,0,564167,41443,78144,29812,0.38388788024750825,0.418384674759666
30467,0.7408809523809523,0,1,0,564168,41442,78144,29812,0.3838786172144207,0.41839054649563534
30468,0.7409126984126985,0,1,0,564169,41441,78144,29812,0.3838693541813331,0.4183964183964184
30469,0.7409206349206349,0,1,0,564170,41440,78144,29812,0.3838600911482456,0.4184022904620221
30470,0.740952380952381,0,1,0,564171,41439,78144,29812,0.383850828115158,0.41840816269245346
30471,0.741,11,17,11,564188,41422,78155,29801,0.3836933565526696,0.4184182076014771
30472,0.7410000000000001,1,2,1,564190,41420,78156,29800,0.3836748304864945,0.4184217916315642
30473,0.741060384060384,0,1,0,564191,41419,78156,29800,0.38366556745340696,0.41842766677431587
30474,0.7410873015873016,0,2,0,564193,41417,78156,29800,0.3836470413872318,0.4184394175547973
30475,0.7411111111111112,1,0,1,564193,41417,78157,29799,0.3836470413872318,0.41843125140417886
30476,0.7411190476190477,0,1,0,564194,41416,78157,29799,0.38363777835414425,0.41843712700975916
30477,0.7411428571428571,2,1,2,564195,41415,78159,29797,0.38362851532105674,0.41842666966241643
30478,0.7411666666666666,0,4,0,564199,41411,78159,29797,0.3835914631887065,0.41845017413773733
30479,0.7411904761904762,1,2,1,564201,41409,78160,29796,0.3835729371225314,0.418453760269644
30480,0.7411904761904764,1,1,1,564202,41408,78161,29795,0.38356367408944386,0.4184514697414435
30481,0.74125,1,1,1,564203,41407,78162,29794,0.3835544110563563,0.4184491790845634
30482,0.7413214285714287,0,1,0,564204,41406,78162,29794,0.3835451480232687,0.4184550561797753
30483,0.7413333333333333,4,11,4,564215,41395,78166,29790,0.3834432546593056,0.4184870408091592
30484,0.7413333333333334,0,4,0,564219,41391,78166,29790,0.38340620252695545,0.418510557592616
30485,0.7413571428571428,0,1,0,564220,41390,78166,29790,0.3833969394938679,0.4185164372014611
30486,0.7414166666666666,0,1,0,564221,41389,78166,29790,0.3833876764607803,0.41852231697551245
30487,0.7414285714285714,1,0,1,564221,41389,78167,29789,0.3833876764607803,0.41851414762988565
30488,0.7414603174603175,1,1,1,564222,41388,78168,29788,0.38337841342769274,0.4185118579296392
30489,0.7414999999999998,0,1,0,564223,41387,78168,29788,0.38336915039460523,0.41851773796979275
30490,0.7414999999999999,0,5,0,564228,41382,78168,29788,0.38332283522916744,0.41854714064914994
30491,0.7415,1,3,1,564231,41379,78169,29787,0.3832950461299048,0.41855661411348116
30492,0.7415075757575758,4,0,4,564231,41379,78173,29783,0.3832950461299048,0.4185239313116551
30493,0.7415198412698412,0,1,0,564232,41378,78173,29783,0.3832857830968172,0.41852981267829287
30494,0.741525974025974,1,4,1,564236,41374,78174,29782,0.383248730964467,0.4185451683624712
30495,0.741547619047619,1,0,1,564236,41374,78175,29781,0.383248730964467,0.41853699669735084
30496,0.7415833333333333,0,1,0,564237,41373,78175,29781,0.3832394679313795,0.41854287882620794
30497,0.7416111111111111,1,0,1,564237,41373,78176,29780,0.3832394679313795,0.4185347068992172
30498,0.7416190476190476,0,1,0,564238,41372,78176,29780,0.3832302048982919,0.41854058916123227
30499,0.7416428571428573,1,0,1,564238,41372,78177,29779,0.3832302048982919,0.41853241697235455
30500,0.7416666666666666,24,71,24,564309,41301,78201,29755,0.38257252954907556,0.4187542220220671
30501,0.7416666666666667,20,46,20,564355,41255,78221,29735,0.38214643002704807,0.4188618115227497
30502,0.7416666666666668,1,2,1,564357,41253,78222,29734,0.38212790396087293,0.4188654260639272
30503,0.7417500000000001,1,0,1,564357,41253,78223,29733,0.38212790396087293,0.41885723945566733
30504,0.7417539682539682,0,1,0,564358,41252,78223,29733,0.3821186409277854,0.4188631401000211
30505,0.7417857142857142,1,0,1,564358,41252,78224,29732,0.3821186409277854,0.41885495322889665
30506,0.7417857142857143,0,1,0,564359,41251,78224,29732,0.38210937789469784,0.4188608540072975
30507,0.741797619047619,1,0,1,564359,41251,78225,29731,0.38210937789469784,0.4188526668732918
30508,0.7418333333333332,0,2,0,564361,41249,78225,29731,0.3820908518285227,0.4188644688644689
30509,0.7418333333333333,1,2,1,564363,41247,78226,29730,0.3820723257623476,0.4188680840272201
30510,0.7418333333333336,0,1,0,564364,41246,78226,29730,0.38206306272926005,0.4188739855725879
30511,0.7419047619047618,1,1,1,564365,41245,78227,29729,0.38205379969617254,0.41887169949558994
30512,0.7419999999999999,0,2,0,564367,41243,78227,29729,0.3820352736299974,0.41888350335343516
30513,0.742,7,13,7,564380,41230,78234,29722,0.3819148541998592,0.4189029202841357
30514,0.7420097402597403,0,1,0,564381,41229,78234,29722,0.38190559116677164,0.418908824399938
30515,0.7421363636363637,1,0,1,564381,41229,78235,29721,0.38190559116677164,0.41890063424947144
30516,0.7421428571428572,1,2,1,564383,41227,78236,29720,0.38188706510059656,0.4189042524701538
30517,0.7421587301587301,1,1,1,564384,41226,78237,29719,0.381877802067509,0.4189019663119318
30518,0.7421666666666665,0,4,0,564388,41222,78237,29719,0.38184074993515876,0.4189255860503799
30519,0.7421666666666666,2,4,2,564392,41218,78239,29717,0.38180369780280854,0.41893282582646085
30520,0.7421904761904762,0,1,0,564393,41217,78239,29717,0.381794434769721,0.41893873177883667
30521,0.7421904761904763,1,1,1,564394,41216,78240,29716,0.38178517173663346,0.41893644617380027
30522,0.7421999389499387,0,1,0,564395,41215,78240,29716,0.3817759087035459,0.4189423524270065
30523,0.7422142857142856,1,0,1,564395,41215,78241,29715,0.3817759087035459,0.4189341604398703
30524,0.7422619047619048,1,0,1,564395,41215,78242,29714,0.3817759087035459,0.4189259682217429
30525,0.7423095238095238,0,1,0,564396,41214,78242,29714,0.3817666456704583,0.41893187457703585
30526,0.7423333333333332,3,3,3,564399,41211,78245,29711,0.38173885657119566,0.4189250162149968
30527,0.7423333333333333,2,10,2,564409,41201,78247,29709,0.38164622624032013,0.4189677055422366
30528,0.7423333333333335,2,5,2,564414,41196,78249,29707,0.38159991107488234,0.41898086117653693
30529,0.7423701298701301,0,1,0,564415,41195,78249,29707,0.3815906480417948,0.418986770471919
30530,0.7423809523809523,0,1,0,564416,41194,78249,29707,0.38158138500870725,0.4189926799339925
30531,0.7423809523809524,1,1,1,564417,41193,78250,29706,0.3815721219756197,0.41899039478695044
30532,0.7424047619047616,0,2,0,564419,41191,78250,29706,0.3815535959094446,0.41900221448016134
30533,0.742452380952381,0,1,0,564420,41190,78250,29706,0.38154433287635703,0.41900812457684494
30534,0.7424603174603174,0,1,0,564421,41189,78250,29706,0.38153506984326946,0.41901403484025673
30535,0.742475468975469,0,2,0,564423,41187,78250,29706,0.3815165437770944,0.41902585586729296
30536,0.7424761904761905,0,1,0,564424,41186,78250,29706,0.3815072807440068,0.41903176663093156
30537,0.7424801587301586,1,1,1,564425,41185,78251,29705,0.3814980177109193,0.4190294822965157
30538,0.7424999999999998,3,5,3,564430,41180,78254,29702,0.3814517025454815,0.4190344516238255
30539,0.7425,54,90,54,564520,41090,78308,29648,0.3806180295676016,0.41912409171873677
30540,0.7425000000000002,1,3,1,564523,41087,78309,29647,0.38059024046833895,0.4191336556677128
30541,0.742512987012987,0,1,0,564524,41086,78309,29647,0.3805809774352514,0.4191395812421359
30542,0.7426190476190476,0,1,0,564525,41085,78309,29647,0.38057171440216386,0.419145506984109
30543,0.7426428571428567,0,2,0,564527,41083,78309,29647,0.3805531883359887,0.41915735897073375
30544,0.7426428571428572,0,1,0,564528,41082,78309,29647,0.3805439253029012,0.41916328521539964
30545,0.7426666666666665,0,2,0,564530,41080,78309,29647,0.38052539923672607,0.4191751382074738
30546,0.7426666666666667,5,15,5,564545,41065,78314,29642,0.38038645374041274,0.4192229906515621
30547,0.7426666666666668,0,5,0,564550,41060,78314,29642,0.380340138574975,0.4192526378320274
30548,0.7427619047619045,0,1,0,564551,41059,78314,29642,0.38033087554188744,0.41925856777131865
30549,0.7428333333333333,2,6,2,564557,41053,78316,29640,0.38027529734336213,0.4192777219809599
30550,0.7428333333333335,1,2,1,564559,41051,78317,29639,0.380256771277187,0.41928136935917387
30551,0.7428571428571428,2,2,2,564561,41049,78319,29637,0.3802382452110119,0.4192768016297428
30552,0.7428571428571429,1,0,1,564561,41049,78320,29636,0.3802382452110119,0.41926858598005234
30553,0.7428690476190476,0,2,0,564563,41047,78320,29636,0.38021971914483677,0.41928044933010766
30554,0.7428809523809524,1,0,1,564563,41047,78321,29635,0.38021971914483677,0.4192722333833225
30555,0.7429166666666667,1,2,1,564565,41045,78322,29634,0.3802011930786617,0.41927588109622377
30556,0.7429285714285715,0,1,0,564566,41044,78322,29634,0.3801919300455741,0.41928181329409436
30557,0.7429761904761905,0,2,0,564568,41042,78322,29634,0.380173403979399,0.41929367819344615
30558,0.743,4,14,4,564582,41028,78326,29630,0.38004372151617327,0.41934388179682414
30559,0.7430000000000001,0,2,0,564584,41026,78326,29630,0.38002519544999813,0.4193557518115942
30560,0.7430011793761793,0,5,0,564589,41021,78326,29630,0.3799788802845604,0.41938542978867954
30561,0.743015873015873,0,4,0,564593,41017,78326,29630,0.37994182815221017,0.4194091751949835
30562,0.7430238095238099,0,1,0,564594,41016,78326,29630,0.3799325651191226,0.4194151119667072
30563,0.7430476190476188,0,1,0,564595,41015,78326,29630,0.37992330208603503,0.41942104890650433
30564,0.7430833333333333,0,1,0,564596,41014,78326,29630,0.3799140390529475,0.419426986014382
30565,0.7431190476190477,0,2,0,564598,41012,78326,29630,0.3798955129867724,0.4194388607344073
30566,0.7431428571428572,0,1,0,564599,41011,78326,29630,0.3798862499536848,0.4194447983465693
30567,0.7431666666666666,2,7,2,564606,41004,78328,29628,0.37982140872207193,0.4194699286442406
30568,0.7431666666666668,0,7,0,564613,40997,78328,29628,0.37975656749045905,0.41951150442477875
30569,0.7432222222222222,0,2,0,564615,40995,78328,29628,0.37973804142428397,0.419523384733019
30570,0.7432500000000001,0,1,0,564616,40994,78328,29628,0.3797287783911964,0.41952932513947494
30571,0.7432878787878788,1,0,1,564616,40994,78329,29627,0.3797287783911964,0.41952110562014133
30572,0.7433095238095236,0,1,0,564617,40993,78329,29627,0.3797195153581089,0.4195270461625602
30573,0.7433333333333333,44,91,44,564708,40902,78373,29583,0.3788765793471414,0.4197063204937221
30574,0.7433333333333334,58,103,58,564811,40799,78431,29525,0.37792248693912334,0.419842443547011
30575,0.743452380952381,1,1,1,564812,40798,78432,29524,0.37791322390603577,0.4198401638178664
30576,0.7434999999999999,3,9,3,564821,40789,78435,29521,0.3778298566082478,0.4198691509031432
30577,0.7435,0,2,0,564823,40787,78435,29521,0.3778113305420727,0.4198810946122774
30578,0.7435032467532465,1,1,1,564824,40786,78436,29520,0.37780206750898515,0.41987881546382955
30579,0.7435714285714287,0,1,0,564825,40785,78436,29520,0.3777928044758976,0.41988478771068916
30580,0.743575396825397,0,2,0,564827,40783,78436,29520,0.3777742784097225,0.41989673271410893
30581,0.7436190476190476,0,1,0,564828,40782,78436,29520,0.3777650153766349,0.41990270547068365
30582,0.7436309523809522,1,0,1,564828,40782,78437,29519,0.3777650153766349,0.41989445384845164
30583,0.7436587301587302,0,1,0,564829,40781,78437,29519,0.37775575234354736,0.41990042674253203
30584,0.7436666666666666,0,4,0,564833,40777,78437,29519,0.37771870021119713,0.41992432001820873
30585,0.7436666666666667,3,9,3,564842,40768,78440,29516,0.37763533291340917,0.4199533321950942
30586,0.7436904761904762,3,0,3,564842,40768,78443,29513,0.37763533291340917,0.4199285724448998
30587,0.7437261904761904,1,1,1,564843,40767,78444,29512,0.3776260698803216,0.419926293771966
30588,0.74375,1,7,1,564850,40760,78445,29511,0.3775612286487087,0.41995986964750753
30589,0.7437777777777778,0,1,0,564851,40759,78445,29511,0.37755196561562115,0.4199658460224847
30590,0.7437857142857144,0,1,0,564852,40758,78445,29511,0.37754270258253364,0.4199718225675618
30591,0.7438095238095238,1,0,1,564852,40758,78446,29510,0.37754270258253364,0.41996356805373714
30592,0.7438333333333331,0,1,0,564853,40757,78446,29510,0.37753343954944607,0.41996954473650505
30593,0.7438333333333332,0,5,0,564858,40752,78446,29510,0.3774871243840083,0.4199994307022288
30594,0.7438333333333333,1,4,1,564862,40748,78447,29509,0.3774500722516581,0.42001508746459426
30595,0.7438571428571429,0,2,0,564864,40746,78447,29509,0.37743154618548297,0.42002704433848126
30596,0.7438888888888888,0,1,0,564865,40745,78447,29509,0.3774222831523954,0.4200330230307171
30597,0.743952380952381,0,1,0,564866,40744,78447,29509,0.3774130201193079,0.42003900189315757
30598,0.7439999999999999,0,5,0,564871,40739,78447,29509,0.3773667049538701,0.42006889875868353
30599,0.7440000000000001,20,31,20,564902,40708,78467,29489,0.3770795509281559,0.42008917760018233
30600,0.744047619047619,0,2,0,564904,40706,78467,29489,0.3770610248619808,0.420101146805328
30601,0.7440692640692639,0,1,0,564905,40705,78467,29489,0.3770517618288933,0.42010713166367497
30602,0.7440833333333333,0,1,0,564906,40704,78467,29489,0.3770424987958057,0.4201131166925477
30603,0.7441666666666665,7,22,7,564928,40682,78474,29482,0.3768387120678795,0.42018699047944813
30604,0.7441666666666668,11,35,11,564963,40647,78485,29471,0.3765145059098151,0.42030577027296845
30605,0.7441785714285715,1,2,1,564965,40645,78486,29470,0.37649597984364,0.42030949154959707
30606,0.7442142857142856,1,0,1,564965,40645,78487,29469,0.37649597984364,0.4203012237213681
30607,0.7442261904761905,1,0,1,564965,40645,78488,29468,0.37649597984364,0.4202929556572961
30608,0.7442380952380953,0,1,0,564966,40644,78488,29468,0.37648671681055246,0.4202989502510269
30609,0.7442380952380954,1,0,1,564966,40644,78489,29467,0.37648671681055246,0.4202906819186718
30610,0.7442803030303028,0,2,0,564968,40642,78489,29467,0.3764681907443773,0.420302671554294
30611,0.7442857142857143,0,2,0,564970,40640,78489,29467,0.37644966467820223,0.42031466187399263
30612,0.7443293650793649,0,4,0,564974,40636,78489,29467,0.376412612545852,0.4203386445658531
30613,0.7443333333333332,4,3,4,564977,40633,78493,29463,0.37638482344658936,0.4203235562656928
30614,0.7443333333333334,5,13,5,564990,40620,78498,29458,0.37626440401645117,0.42036017009617854
30615,0.7443333333333335,1,1,1,564991,40619,78499,29457,0.3762551409833636,0.42035789714024774
30616,0.7443939393939394,1,0,1,564991,40619,78500,29456,0.3762551409833636,0.4203496254013557
30617,0.7444047619047618,0,1,0,564992,40618,78500,29456,0.37624587795027603,0.4203556240545709
30618,0.7444166666666666,0,1,0,564993,40617,78500,29456,0.37623661491718846,0.42036162287899764
30619,0.7444444444444446,0,1,0,564994,40616,78500,29456,0.37622735188410095,0.4203676218746432
30620,0.7444999999999999,1,2,1,564996,40614,78501,29455,0.3762088258179258,0.4203713482424467
30621,0.7445,2,8,2,565004,40606,78503,29453,0.3761347215532254,0.4204028033514609
30622,0.7445833333333333,1,0,1,565004,40606,78504,29452,0.3761347215532254,0.4203945302463673
30623,0.7446666666666666,2,2,2,565006,40604,78506,29450,0.3761161954870503,0.42038998486881546
30624,0.7446666666666667,2,11,2,565017,40593,78508,29448,0.3760143021230872,0.42043945688953616
30625,0.7446785714285714,0,1,0,565018,40592,78508,29448,0.3760050390899996,0.42044545973729297
30626,0.7446904761904761,1,0,1,565018,40592,78509,29447,0.3760050390899996,0.4204371849969303
30627,0.7448095238095239,1,1,1,565019,40591,78510,29446,0.3759957760569121,0.4204349129745706
30628,0.7448214285714286,0,1,0,565020,40590,78510,29446,0.3759865130238245,0.4204409161002913
30629,0.7448333333333332,1,3,1,565023,40587,78511,29445,0.37595872392456187,0.42045065113091157
30630,0.7448333333333333,1,9,1,565032,40578,78512,29444,0.37587535662677385,0.420496415412299
30631,0.744857142857143,1,0,1,565032,40578,78513,29443,0.37587535662677385,0.42048813927250395
30632,0.7448809523809524,0,2,0,565034,40576,78513,29443,0.37585683056059876,0.42050014995929674
30633,0.7449166666666668,1,0,1,565034,40576,78514,29442,0.37585683056059876,0.4204918735182382
30634,0.7449761904761906,0,1,0,565035,40575,78514,29442,0.3758475675275112,0.42049787908650754
30635,0.7449999999999999,1,1,1,565036,40574,78515,29441,0.3758383044944237,0.420495608083982
30636,0.745,168,363,168,565399,40211,78683,29273,0.3724758234836415,0.42129123251396006
30637,0.7450000000000001,2,3,2,565402,40208,78685,29271,0.37244803438437885,0.4212927647202752
30638,0.7450714285714285,0,1,0,565403,40207,78685,29271,0.3724387713512913,0.42129882840611416
30639,0.7450833333333332,0,1,0,565404,40206,78685,29271,0.3724295083182037,0.42130489226650547
30640,0.7450965700965702,0,1,0,565405,40205,78685,29271,0.37242024528511614,0.4213109563014566
30641,0.7451190476190476,1,0,1,565405,40205,78686,29270,0.37242024528511614,0.42130262684418857
30642,0.7451190476190477,0,2,0,565407,40203,78686,29270,0.37240171921894105,0.4213147553725908
30643,0.7451421568627451,0,1,0,565408,40202,78686,29270,0.3723924561858535,0.4213208198986642
30644,0.7451428571428569,0,1,0,565409,40201,78686,29270,0.37238319315276597,0.4213268845993292
30645,0.7451666666666666,1,8,1,565417,40193,78687,29269,0.3723090888880655,0.4213670784025798
30646,0.7451666666666668,1,3,1,565420,40190,78688,29268,0.37228129978880287,0.42137694721990265
30647,0.7451785714285716,1,0,1,565420,40190,78689,29267,0.37228129978880287,0.421368616554127
30648,0.7452142857142857,0,2,0,565422,40188,78689,29267,0.3722627737226277,0.42138075012598086
30649,0.7452380952380951,0,1,0,565423,40187,78689,29267,0.37225351068954016,0.4213868171739569
30650,0.7452619047619049,0,1,0,565424,40186,78689,29267,0.37224424765645264,0.42139288439664235
30651,0.7452738095238095,0,1,0,565425,40185,78689,29267,0.3722349846233651,0.4213989517940448
30652,0.7453095238095239,0,1,0,565426,40184,78689,29267,0.3722257215902775,0.4214050193661718
30653,0.7453333333333333,6,13,6,565439,40171,78695,29261,0.3721053021601393,0.4214339209586358
30654,0.7453333333333334,0,1,0,565440,40170,78695,29261,0.37209603912705175,0.42143999078221545
30655,0.7453571428571428,1,0,1,565440,40170,78696,29260,0.37209603912705175,0.4214316577848192
30656,0.7453571428571429,0,1,0,565441,40169,78696,29260,0.37208677609396423,0.42143772775065175
30657,0.7454166666666666,0,1,0,565442,40168,78696,29260,0.37207751306087666,0.4214437978913407
30658,0.7454166666666667,0,1,0,565443,40167,78696,29260,0.3720682500277891,0.42144986820689356
30659,0.7454761904761905,0,1,0,565444,40166,78696,29260,0.3720589869947015,0.421455938697318
30660,0.7454999999999999,5,6,5,565450,40160,78701,29255,0.3720034087961762,0.42145069509472016
30661,0.7455238095238095,0,1,0,565451,40159,78701,29255,0.37199414576308865,0.42145676664649784
30662,0.7455396825396825,1,0,1,565451,40159,78702,29254,0.37199414576308865,0.42144843184994163
30663,0.7455714285714283,0,1,0,565452,40158,78702,29254,0.37198488273000113,0.4214545035440558
30664,0.7455714285714288,1,1,1,565453,40157,78703,29253,0.37197561969691356,0.4214522403111943
30665,0.7455833333333334,0,1,0,565454,40156,78703,29253,0.371966356663826,0.42145831232260944
30666,0.7455910151939562,0,3,0,565457,40153,78703,29253,0.37193856756456334,0.4214765294066795
30667,0.7455952380952382,0,1,0,565458,40152,78703,29253,0.37192930453147577,0.42148260211800304
30668,0.7456666666666666,2,8,2,565466,40144,78705,29251,0.3718552002667754,0.421514518337056
30669,0.7456666666666668,4,2,4,565468,40142,78709,29247,0.37183667420060024,0.4214933202669011
30670,0.7457142857142856,0,1,0,565469,40141,78709,29247,0.37182741116751267,0.42149939470801867
30671,0.7457142857142857,1,6,1,565475,40135,78710,29246,0.37177183296898736,0.4215275075308802
30672,0.74575,0,2,0,565477,40133,78710,29246,0.3717533069028123,0.4215396589746177
30673,0.7457857142857144,1,1,1,565478,40132,78711,29245,0.3717440438697247,0.42153739712008303
30674,0.7458333333333332,6,20,6,565498,40112,78717,29239,0.37155878320797364,0.4216089169586596
30675,0.7458333333333335,6,17,6,565515,40095,78723,29233,0.3714013116454852,0.4216622432494807
30676,0.7458452380952381,1,0,1,565515,40095,78724,29232,0.3714013116454852,0.4216539010775023
30677,0.7458571428571428,0,1,0,565516,40094,78724,29232,0.37139204861239766,0.42165998326746096
30678,0.745857142857143,1,0,1,565516,40094,78725,29231,0.37139204861239766,0.42165164082221424
30679,0.7459047619047618,0,2,0,565518,40092,78725,29231,0.3713735225462225,0.42166380566334405
30680,0.745904761904762,1,1,1,565519,40091,78726,29230,0.37136425951313495,0.42166154556339347
30681,0.7459166666666666,1,1,1,565520,40090,78727,29229,0.37135499648004744,0.4216592853330256
30682,0.7459246031746032,0,1,0,565521,40089,78727,29229,0.37134573344695987,0.42166536830260537
30683,0.7459415584415584,1,0,1,565521,40089,78728,29228,0.37134573344695987,0.421657024972229
30684,0.746,13,47,13,565568,40042,78741,29215,0.3709103708918448,0.42183461599549504
30685,0.7460000000000001,3,2,3,565570,40040,78744,29212,0.3708918448256697,0.42182175244036274
30686,0.7460238095238094,0,3,0,565573,40037,78744,29212,0.37086405572640707,0.4218400265707808
30687,0.7460238095238095,0,3,0,565576,40034,78744,29212,0.3708362666271444,0.4218583022846085
30688,0.7460357142857141,0,1,0,565577,40033,78744,29212,0.37082700359405685,0.4218643945411221
30689,0.7460476190476188,0,1,0,565578,40032,78744,29212,0.3708177405609693,0.4218704869736006
30690,0.7460476190476192,0,1,0,565579,40031,78744,29212,0.3708084775278817,0.4218765795820516
30691,0.7460714285714286,0,2,0,565581,40029,78744,29212,0.3707899514617066,0.42188876532690167
30692,0.7460753968253969,1,3,1,565584,40026,78745,29211,0.37076216236244397,0.4218986957840461
30693,0.7460833333333333,0,1,0,565585,40025,78745,29211,0.3707528993293564,0.4219047894159108
30694,0.746095238095238,0,1,0,565586,40024,78745,29211,0.37074363629626883,0.421910883223803
30695,0.746107142857143,1,3,1,565589,40021,78746,29210,0.3707158471970062,0.4219208158195028
30696,0.7461111111111112,2,1,2,565590,40020,78748,29208,0.3707065841639186,0.421910209741723
30697,0.7461190476190476,0,1,0,565591,40019,78748,29208,0.3706973211308311,0.42191630433212474
30698,0.7461298701298701,0,2,0,565593,40017,78748,29208,0.37067879506465595,0.4219284940411701
30699,0.7461666666666666,0,5,0,565598,40012,78748,29208,0.3706324798992182,0.42195897139555044
30700,0.7461666666666668,3,9,3,565607,40003,78751,29205,0.3705491126014302,0.4219887874234193
30701,0.7461904761904761,1,0,1,565607,40003,78752,29204,0.3705491126014302,0.42198043550507897
30702,0.7461904761904762,0,1,0,565608,40002,78752,29204,0.3705398495683427,0.42198653295957
30703,0.7462121212121212,1,0,1,565608,40002,78753,29203,0.3705398495683427,0.4219781807672856
30704,0.7462142857142857,0,3,0,565611,39999,78753,29203,0.37051206046908,0.4219964740903442
30705,0.7462380952380953,1,0,1,565611,39999,78754,29202,0.37051206046908,0.421988121558937
30706,0.7463095238095238,0,2,0,565613,39997,78754,29202,0.3704935344029049,0.42200031792366943
30707,0.7463333333333331,0,2,0,565615,39995,78754,29202,0.3704750083367298,0.42201251499342457
30708,0.7463333333333333,2,6,2,565621,39989,78756,29200,0.37041943013820444,0.4220324039948547
30709,0.7463333333333334,1,5,1,565626,39984,78757,29199,0.3703731149727667,0.422054550973505
30710,0.7463809523809525,1,0,1,565626,39984,78758,29198,0.3703731149727667,0.4220461969876558
30711,0.7464285714285714,2,4,2,565630,39980,78760,29196,0.3703360628404165,0.4220538915230716
30712,0.7464484126984126,0,2,0,565632,39978,78760,29196,0.37031753677424134,0.4220660941972417
30713,0.7464999999999999,0,2,0,565634,39976,78760,29196,0.37029901070806626,0.4220782975770543
30714,0.7465,4,5,4,565639,39971,78764,29192,0.37025269554262846,0.42207538712895626
30715,0.7465303030303032,0,2,0,565641,39969,78764,29192,0.3702341694764534,0.4220875927184396
30716,0.7466468253968255,0,2,0,565643,39967,78764,29192,0.37021564341027824,0.4220997990138666
30717,0.7466547619047617,0,2,0,565645,39965,78764,29192,0.37019711734410315,0.4221120060152985
30718,0.7466666666666666,61,118,61,565763,39847,78825,29131,0.36910407943977175,0.42232305952622573
30719,0.7466666666666667,61,89,61,565852,39758,78886,29070,0.3682796694949794,0.4223571802173534
30720,0.7466666666666668,1,0,1,565852,39758,78887,29069,0.3682796694949794,0.4223487875397736
30721,0.7467142857142857,0,3,0,565855,39755,78887,29069,0.36825188039571677,0.42236719748924795
30722,0.7467380952380952,1,0,1,565855,39755,78888,29068,0.36825188039571677,0.4223588044694361
30723,0.7467500000000001,1,0,1,565855,39755,78889,29067,0.36825188039571677,0.4223504112057191
30724,0.7468055555555556,0,1,0,565856,39754,78889,29067,0.3682426173626292,0.4223565481466413
30725,0.7468095238095238,0,1,0,565857,39753,78889,29067,0.3682333543295417,0.4223626852659111
30726,0.7468333333333332,1,0,1,565857,39753,78890,29066,0.3682333543295417,0.42235429169270117
30727,0.7468333333333333,4,8,4,565865,39745,78894,29062,0.36815925006484124,0.42236981702443066
30728,0.7469047619047621,0,2,0,565867,39743,78894,29062,0.3681407239986661,0.4223820943245404
30729,0.7469761904761905,0,1,0,565868,39742,78894,29062,0.3681314609655786,0.42238823324225333
30730,0.7469999999999999,0,4,0,565872,39738,78894,29062,0.36809440883322836,0.4224127906976744
30731,0.747,8,8,8,565880,39730,78902,29054,0.3680203045685279,0.4223947429634799
30732,0.7470238095238096,0,1,0,565881,39729,78902,29054,0.36801104153544034,0.4224008839393455
30733,0.7470288600288602,0,1,0,565882,39728,78902,29054,0.3680017785023528,0.42240702509377454
30734,0.7470683760683758,0,2,0,565884,39726,78902,29054,0.3679832524361777,0.4224193079383542
30735,0.7470753968253966,0,1,0,565885,39725,78902,29054,0.3679739894030902,0.42242544962852036
30736,0.7470833333333333,0,1,0,565886,39724,78902,29054,0.3679647263700026,0.4224315914972811
30737,0.7470833333333334,0,2,0,565888,39722,78902,29054,0.36794620030382746,0.42244387577061765
30738,0.7471190476190476,2,0,2,565888,39722,78904,29052,0.36794620030382746,0.42242708000116325
30739,0.7471428571428571,0,1,0,565889,39721,78904,29052,0.36793693727073995,0.42243322234016256
30740,0.7471428571428572,1,2,1,565891,39719,78905,29051,0.3679184112045648,0.42243710920459504
30741,0.7471666666666665,0,1,0,565892,39718,78905,29051,0.3679091481714773,0.4224432520467071
30742,0.7471666666666666,1,5,1,565897,39713,78906,29050,0.3678628330060395,0.4224655701467359
30743,0.7471666666666669,1,0,1,565897,39713,78907,29049,0.3678628330060395,0.42245717111195136
30744,0.7471904761904763,0,1,0,565898,39712,78907,29049,0.36785356997295193,0.4224633149605154
30745,0.7472847985347983,1,1,1,565899,39711,78908,29048,0.36784430693986436,0.42246105964310127
30746,0.7473333333333332,1,2,1,565901,39709,78909,29047,0.3678257808736893,0.4224649485135843
30747,0.7473333333333333,3,19,3,565920,39690,78912,29044,0.36764978324502573,0.42255652224517704
30748,0.7473333333333335,1,1,1,565921,39689,78913,29043,0.3676405202119382,0.42255426875400104
30749,0.7473650793650793,0,1,0,565922,39688,78913,29043,0.36763125717885065,0.4225604166969781
30750,0.7473809523809523,1,0,1,565922,39688,78914,29042,0.36763125717885065,0.4225520151316747
30751,0.7473809523809524,0,1,0,565923,39687,78914,29042,0.3676219941457631,0.4225581632207656
30752,0.747404761904762,1,0,1,565923,39687,78915,29041,0.3676219941457631,0.42254976137818645
30753,0.7474166666666666,0,1,0,565924,39686,78915,29041,0.36761273111267556,0.42255590961339795
30754,0.7474801587301587,1,0,1,565924,39686,78916,29040,0.36761273111267556,0.422547507493525
30755,0.7474999999999998,2,4,2,565928,39682,78918,29038,0.36757567898032534,0.42255529685681026
30756,0.7475,46,82,46,566010,39600,78964,28992,0.3668161102671459,0.42267319804058784
30757,0.7475000000000002,0,1,0,566011,39599,78964,28992,0.3668068472340583,0.4226793602659241
30758,0.7475238095238095,1,0,1,566011,39599,78965,28991,0.3668068472340583,0.4226709432861933
30759,0.7475396825396823,1,1,1,566012,39598,78966,28990,0.36679758420097075,0.42266868840030325
30760,0.7475468975468974,0,3,0,566015,39595,78966,28990,0.3667697951017081,0.42268717649631843
30761,0.747547619047619,0,1,0,566016,39594,78966,28990,0.3667605320686205,0.422693339554415
30762,0.7475555555555556,0,1,0,566017,39593,78966,28990,0.366751269035533,0.42269950279223717
30763,0.7475714285714287,0,3,0,566020,39590,78966,28990,0.36672347993627036,0.4227179935841353
30764,0.7475952380952381,0,2,0,566022,39588,78966,28990,0.3667049538700952,0.4227303216775059
30765,0.7476190476190476,1,7,1,566029,39581,78967,28989,0.36664011263848234,0.42276505760536676
30766,0.7476666666666665,0,1,0,566030,39580,78967,28989,0.36663084960539477,0.4227712231474865
30767,0.7476666666666667,9,10,9,566040,39570,78976,28980,0.36653821927451924,0.42275711159737417
30768,0.7476666666666668,1,4,1,566044,39566,78977,28979,0.366501167142169,0.4227733605660515
30769,0.7477023809523808,1,1,1,566045,39565,78978,28978,0.3664919041090815,0.42277110718818844
30770,0.74775,0,1,0,566046,39564,78978,28978,0.36648264107599393,0.42277727524729364
30771,0.7478095238095238,0,1,0,566047,39563,78978,28978,0.36647337804290636,0.4227834434863804
30772,0.7478214285714286,0,1,0,566048,39562,78978,28978,0.3664641150098188,0.42278961190545666
30773,0.7478333333333333,2,5,2,566053,39557,78980,28976,0.36641779984438105,0.4228036128580392
30774,0.7478333333333335,1,0,1,566053,39557,78981,28975,0.36641779984438105,0.4227951905679099
30775,0.7478571428571428,1,0,1,566053,39557,78982,28974,0.36641779984438105,0.4227867680319855
30776,0.7478571428571429,0,2,0,566055,39555,78982,28974,0.3663992737782059,0.42279910694742373
30777,0.7478809523809524,1,0,1,566055,39555,78983,28973,0.3663992737782059,0.42279068409993
30778,0.747952380952381,1,0,1,566055,39555,78984,28972,0.3663992737782059,0.42278226100661054
30779,0.7479999999999998,0,1,0,566056,39554,78984,28972,0.3663900107451184,0.4227884306686513
30780,0.748,17,23,17,566079,39531,79001,28955,0.3661769609841046,0.42278713897730924
30781,0.7480000000000001,0,2,0,566081,39529,79001,28955,0.36615843491792954,0.4227994860113311
30782,0.7480555555555556,2,1,2,566082,39528,79003,28953,0.366149171884842,0.4227888027336049
30783,0.7480833333333335,0,2,0,566084,39526,79003,28953,0.3661306458186669,0.42280115071773827
30784,0.7481071428571429,0,1,0,566085,39525,79003,28953,0.3661213827855793,0.4228073249802856
30785,0.7481428571428572,1,0,1,566085,39525,79004,28952,0.3661213827855793,0.422798895979672
30786,0.7481666666666666,1,3,1,566088,39522,79005,28951,0.36609359368631667,0.42280899040497716
30787,0.7481666666666668,1,1,1,566089,39521,79006,28950,0.3660843306532291,0.42280673569832483
30788,0.7482142857142857,1,0,1,566089,39521,79007,28949,0.3660843306532291,0.42279830582736966
30789,0.7482142857142858,0,1,0,566090,39520,79007,28949,0.3660750676201415,0.4228044808599512
30790,0.7482459207459207,1,0,1,566090,39520,79008,28948,0.3660750676201415,0.4227960507098206
30791,0.7482539682539682,0,1,0,566091,39519,79008,28948,0.366065804587054,0.42280222588984473
30792,0.7482857142857142,0,1,0,566092,39518,79008,28948,0.36605654155396644,0.4228084012502556
30793,0.7482857142857143,0,1,0,566093,39517,79008,28948,0.36604727852087887,0.4228145767910611
30794,0.7483333333333332,0,1,0,566094,39516,79008,28948,0.3660380154877913,0.42282075251226925
30795,0.7483333333333333,32,48,32,566142,39468,79040,28916,0.3655933898995887,0.42284744969583526
30796,0.7483333333333334,20,68,20,566210,39400,79060,28896,0.36496350364963503,0.4230994494553122
30797,0.7484523809523808,1,1,1,566211,39399,79061,28895,0.36495424061654747,0.4230971974111928
30798,0.7484761904761903,0,1,0,566212,39398,79061,28895,0.36494497758345995,0.423103392734248
30799,0.7484999999999999,3,7,3,566219,39391,79064,28892,0.3648801363518471,0.42312142114435514
30800,0.7485,0,2,0,566221,39389,79064,28892,0.36486161028567193,0.4231338146775823
30801,0.7485714285714287,0,5,0,566226,39384,79064,28892,0.3648152951202342,0.42316480168726933
30802,0.7486360143124847,1,5,1,566231,39379,79065,28891,0.3647689799547964,0.4231873443679508
30803,0.7486666666666666,3,8,3,566239,39371,79068,28888,0.36469487569009595,0.42321159114548995
30804,0.7486666666666667,7,8,7,566247,39363,79075,28881,0.3646207714253955,0.42320203973975734
30805,0.7486904761904762,1,0,1,566247,39363,79076,28880,0.3646207714253955,0.42319358762070836
30806,0.748703463203463,1,0,1,566247,39363,79077,28879,0.3646207714253955,0.4231851352539492
30807,0.7487142857142856,0,1,0,566248,39362,79077,28879,0.364611508392308,0.4231913365865096
30808,0.7487142857142857,0,2,0,566250,39360,79077,28879,0.36459298232613285,0.42320373979689035
30809,0.748730607112186,1,4,1,566254,39356,79078,28878,0.36455593019378263,0.42322009555353635
30810,0.74875,1,2,1,566256,39354,79079,28877,0.36453740412760754,0.42322404772024447
30811,0.7488095238095238,0,1,0,566257,39353,79079,28877,0.36452814109452,0.42323025062289316
30812,0.7488333333333332,4,5,4,566262,39348,79083,28873,0.36448182592908224,0.42322745195760836
30813,0.7488333333333334,0,1,0,566263,39347,79083,28873,0.36447256289599467,0.4232336558194078
30814,0.7489285714285714,1,0,1,566263,39347,79084,28872,0.36447256289599467,0.42322520119028423
30815,0.7489722222222224,1,3,1,566266,39344,79085,28871,0.364444773796732,0.42323535879205454
30816,0.7489761904761906,0,3,0,566269,39341,79085,28871,0.36441698469746936,0.4232539729079927
30817,0.7489999999999999,1,5,1,566274,39336,79086,28870,0.36437066953203157,0.42327654458552033
30818,0.7490000000000001,11,16,11,566290,39320,79097,28859,0.3642224610026307,0.42328282902359965
30819,0.749047619047619,1,0,1,566290,39320,79098,28858,0.3642224610026307,0.4232743700313884
30820,0.7490476190476191,0,1,0,566291,39319,79098,28858,0.36421319796954316,0.4232805784942136
30821,0.7490833333333333,1,0,1,566291,39319,79099,28857,0.36421319796954316,0.4232721192208402
30822,0.7491190476190478,1,2,1,566293,39317,79100,28856,0.364194671903368,0.4232760770392971
30823,0.7491350038850038,0,6,0,566299,39311,79100,28856,0.3641390937048427,0.42331333343113237
30824,0.7491428571428571,0,1,0,566300,39310,79100,28856,0.36412983067175514,0.4233195434674178
30825,0.7491666666666664,0,1,0,566301,39309,79100,28856,0.3641205676386676,0.4233257536859092
30826,0.7491666666666665,8,23,8,566324,39286,79108,28848,0.36390751787765385,0.42340094519623095
30827,0.7491666666666668,9,23,9,566347,39263,79117,28839,0.36369446811664013,0.4234677395671199
30828,0.7491666666666669,1,0,1,566347,39263,79118,28838,0.36369446811664013,0.4234592737257896
30829,0.7492142857142856,0,1,0,566348,39262,79118,28838,0.36368520508355257,0.4234654919236417
30830,0.749249639249639,0,3,0,566351,39259,79118,28838,0.3636574159842899,0.4234841476129639
30831,0.7492857142857143,1,1,1,566352,39258,79119,28837,0.36364815295120234,0.4234819002863646
30832,0.7493333333333332,1,3,1,566355,39255,79120,28836,0.3636203638519397,0.4234920914658325
30833,0.7493333333333334,3,11,3,566366,39244,79123,28833,0.3635184704879766,0.423535114649588
30834,0.7493809523809523,1,2,1,566368,39242,79124,28832,0.3634999444218015,0.42353908981402594
30835,0.7494285714285713,0,1,0,566369,39241,79124,28832,0.36349068138871393,0.4235453116507279
30836,0.7494523809523809,0,1,0,566370,39240,79124,28832,0.36348141835562636,0.4235515336702315
30837,0.7494642857142858,0,2,0,566372,39238,79124,28832,0.3634628922894513,0.42356397825767594
30838,0.7494999999999998,0,1,0,566373,39237,79124,28832,0.3634536292563637,0.4235702008256328
30839,0.7495,1,4,1,566377,39233,79125,28831,0.3634165771240135,0.4235866243535496
30840,0.7495238095238095,0,1,0,566378,39232,79125,28831,0.3634073140909259,0.42359284780277096
30841,0.7495833333333333,0,1,0,566379,39231,79125,28831,0.3633980510578384,0.4235990714348682
30842,0.7496626984126981,0,1,0,566380,39230,79125,28831,0.36338878802475083,0.4236052952498494
30843,0.7496666666666666,3,0,3,566380,39230,79128,28828,0.36338878802475083,0.4235798877428076
30844,0.7496666666666667,1,10,1,566390,39220,79129,28827,0.3632961576938753,0.42363366496686117
30845,0.7497023809523808,0,3,0,566393,39217,79129,28827,0.36326836859461265,0.42365234260184587
30846,0.7497142857142856,0,1,0,566394,39216,79129,28827,0.3632591055615251,0.4236585688461708
30847,0.7497619047619049,0,3,0,566397,39213,79129,28827,0.3632313164622624,0.42367724867724865
30848,0.7498095238095237,0,3,0,566400,39210,79129,28827,0.36320352736299977,0.4236959301556506
30849,0.7498333333333332,3,3,3,566403,39207,79132,28824,0.36317573826373706,0.4236892005115315
30850,0.7498333333333334,6,5,6,566408,39202,79138,28818,0.3631294230982993,0.4236695089679506
30851,0.7498333333333335,1,1,1,566409,39201,79139,28817,0.36312016006521175,0.42366726454761977
30852,0.749857142857143,1,0,1,566409,39201,79140,28816,0.36312016006521175,0.4236587911845568
30853,0.7498809523809524,1,1,1,566410,39200,79141,28815,0.3631108970321242,0.42365654635006983
30854,0.7499047619047617,0,1,0,566411,39199,79141,28815,0.36310163399903667,0.4236627753109654
30855,0.7499523809523809,0,4,0,566415,39195,79141,28815,0.36306458186668644,0.4236876929863255
30856,0.7499761904761904,0,1,0,566416,39194,79141,28815,0.3630553188335989,0.42369392286315044
30857,0.7499999999999999,1,7,1,566423,39187,79142,28814,0.362990477601986,0.4237290628078999
30858,0.75,719,1157,719,567580,38030,79861,28095,0.3522731483196858,0.4248771266540643
30859,0.7500000000000001,2,2,2,567582,38028,79863,28093,0.3522546222535107,0.4248725820843605
30860,0.7500238095238094,0,1,0,567583,38027,79863,28093,0.35224535922042316,0.4248790078644888
30861,0.750047619047619,0,1,0,567584,38026,79863,28093,0.3522360961873356,0.4248854338389873
30862,0.7500476190476191,0,2,0,567586,38024,79863,28093,0.35221757012116045,0.42489828637113
30863,0.7500494227994229,1,0,1,567586,38024,79864,28092,0.35221757012116045,0.424889587996854
30864,0.7500595238095239,1,1,1,567587,38023,79865,28091,0.35220830708807294,0.4248873158483831
30865,0.7500833333333334,0,1,0,567588,38022,79865,28091,0.35219904405498537,0.42489374253172596
30866,0.750111111111111,1,0,1,567588,38022,79866,28090,0.35219904405498537,0.4248850435624395
30867,0.7501190476190476,1,0,1,567588,38022,79867,28089,0.35219904405498537,0.4248763443299905
30868,0.7501666666666666,2,6,2,567594,38016,79869,28087,0.35214346585646006,0.42489750843380786
30869,0.7501666666666668,1,3,1,567597,38013,79870,28086,0.3521156767571974,0.4249080924068443
30870,0.7501847041847043,2,0,2,567597,38013,79872,28084,0.3521156767571974,0.4248906909542037
30871,0.7502380952380951,0,1,0,567598,38012,79872,28084,0.35210641372410983,0.42489711934156377
30872,0.7502500000000001,0,1,0,567599,38011,79872,28084,0.35209715069102226,0.42490354792344354
30873,0.7502985347985346,1,4,1,567603,38007,79873,28083,0.35206009855867204,0.42492056286881524
30874,0.7503095238095239,1,0,1,567603,38007,79874,28082,0.35206009855867204,0.42491186127797365
30875,0.750329365079365,0,2,0,567605,38005,79874,28082,0.35204157249249696,0.4249247204442629
30876,0.7503333333333333,4,10,4,567615,37995,79878,28078,0.3519489421616214,0.4249542173051019
30877,0.7503499278499278,0,4,0,567619,37991,79878,28078,0.3519118900292712,0.42497994520879684
30878,0.7503571428571427,0,2,0,567621,37989,79878,28078,0.35189336396309606,0.4249928103289085
30879,0.750357142857143,1,3,1,567624,37986,79879,28077,0.3518655748638334,0.4250034058398801
30880,0.7504166666666667,0,1,0,567625,37985,79879,28077,0.35185631183074584,0.42500983924192426
30881,0.7504761904761904,1,0,1,567625,37985,79880,28076,0.35185631183074584,0.4250011353143307
30882,0.7504999999999998,0,1,0,567626,37984,79880,28076,0.3518470487976583,0.4250075688767787
30883,0.7505,1,9,1,567635,37975,79881,28075,0.3517636814998703,0.42505677517032553
30884,0.7505833333333335,1,1,1,567636,37974,79882,28074,0.35175441846678274,0.4250545058139535
30885,0.7506468253968255,1,1,1,567637,37973,79883,28073,0.3517451554336952,0.4250522363201405
30886,0.7506587301587302,1,2,1,567639,37971,79884,28072,0.3517266293675201,0.4250564026467604
30887,0.7506666666666665,0,1,0,567640,37970,79884,28072,0.35171736633443257,0.4250628387995518
30888,0.7506666666666666,4,13,4,567653,37957,79888,28068,0.3515969469042943,0.42511170011359334
30889,0.7506666666666668,4,1,4,567654,37956,79892,28064,0.3515876838712068,0.42508330808845807
30890,0.7507142857142857,2,1,2,567655,37955,79894,28062,0.35157842083811924,0.42507232985443144
30891,0.750714285714286,2,0,2,567655,37955,79896,28060,0.35157842083811924,0.4250549117624782
30892,0.7507499999999999,1,0,1,567655,37955,79897,28059,0.35157842083811924,0.4250462023207198
30893,0.7508095238095238,0,2,0,567657,37953,79897,28059,0.3515598947719441,0.4250590801672423
30894,0.7508095238095239,0,2,0,567659,37951,79897,28059,0.351541368705769,0.42507195879412213
30895,0.7508333333333331,0,1,0,567660,37950,79897,28059,0.35153210567268145,0.42507839840021816
30896,0.7508333333333332,13,20,13,567680,37930,79910,28046,0.3513468450109304,0.42509397356614526
30897,0.7508333333333335,7,19,7,567699,37911,79917,28039,0.35117084738226684,0.42515542077331314
30898,0.7508492063492064,0,2,0,567701,37909,79917,28039,0.35115232131609175,0.42516831442955055
30899,0.7508690476190476,0,1,0,567702,37908,79917,28039,0.3511430582830042,0.4251747615509424
30900,0.7509087301587302,0,1,0,567703,37907,79917,28039,0.3511337952499166,0.4251812088678616
30901,0.7509285714285714,1,0,1,567703,37907,79918,28038,0.3511337952499166,0.4251724922283721
30902,0.750952380952381,0,1,0,567704,37906,79918,28038,0.3511245322168291,0.42517893970641757
30903,0.7509999999999998,1,0,1,567704,37906,79919,28037,0.3511245322168291,0.42517022276814825
30904,0.7509999999999999,8,18,8,567722,37888,79927,28029,0.3509577976212531,0.4252165602196702
30905,0.7510000000000001,1,2,1,567724,37886,79928,28028,0.350939271555078,0.4252207421792032
30906,0.7511111111111112,0,1,0,567725,37885,79928,28028,0.35093000852199047,0.42522719342163157
30907,0.7511428571428571,1,0,1,567725,37885,79929,28027,0.35093000852199047,0.4252184731156694
30908,0.7511666666666666,0,1,0,567726,37884,79929,28027,0.3509207454889029,0.4252249245194277
30909,0.7511666666666668,3,5,3,567731,37879,79932,28024,0.3508744303234651,0.4252310213495592
30910,0.7511904761904762,1,0,1,567731,37879,79933,28023,0.3508744303234651,0.42522229977845893
30911,0.7513333333333333,4,4,4,567735,37875,79937,28019,0.3508373781911149,0.42521322123410327
30912,0.7513333333333334,0,4,0,567739,37871,79937,28019,0.35080032605876466,0.4252390347548945
30913,0.7513333333333335,0,1,0,567740,37870,79937,28019,0.35079106302567714,0.4252454886248084
30914,0.7513809523809524,0,1,0,567741,37869,79937,28019,0.35078179999258957,0.4252519426906265
30915,0.7514047619047619,0,1,0,567742,37868,79937,28019,0.350772536959502,0.42525839695235784
30916,0.7514285714285713,0,4,0,567746,37864,79937,28019,0.3507354848271518,0.4252842159585933
30917,0.751452380952381,1,0,1,567746,37864,79938,28018,0.3507354848271518,0.42527549254728153
30918,0.7514761904761904,0,1,0,567747,37863,79938,28018,0.35072622179406426,0.42528194775428424
30919,0.7515,1,1,1,567748,37862,79939,28017,0.3507169587609767,0.4252796794122558
30920,0.7515000000000001,3,13,3,567761,37849,79942,28014,0.3505965393308385,0.4253374428738442
30921,0.7515000000000002,0,2,0,567763,37847,79942,28014,0.35057801326466337,0.4253503590895978
30922,0.751547619047619,0,2,0,567765,37845,79942,28014,0.3505594871984883,0.42536327608982827
30923,0.7515476190476191,0,3,0,567768,37842,79942,28014,0.35053169809922563,0.42538265306122447
30924,0.7515952380952381,1,0,1,567768,37842,79943,28013,0.35053169809922563,0.42537392756814213
30925,0.7516666666666666,24,57,24,567825,37785,79967,27989,0.35000370521323504,0.4255328853346307
30926,0.7516666666666667,20,37,20,567862,37748,79987,27969,0.3496609729889955,0.42559763835841563
30927,0.7517142857142857,0,1,0,567863,37747,79987,27969,0.34965170995590794,0.4256041146752693
30928,0.7517499999999999,1,0,1,567863,37747,79988,27968,0.34965170995590794,0.4255953739633265
30929,0.7517857142857142,0,1,0,567864,37746,79988,27968,0.3496424469228204,0.425601850442828
30930,0.7518095238095239,0,1,0,567865,37745,79988,27968,0.34963318388973286,0.42560832711944363
30931,0.7518333333333332,0,1,0,567866,37744,79988,27968,0.3496239208566453,0.42561480399318236
30932,0.7518333333333334,3,5,3,567871,37739,79991,27965,0.34957760569120755,0.4256209667600146
30933,0.751845238095238,0,1,0,567872,37738,79991,27965,0.34956834265812,0.4256274447133312
30934,0.7518571428571428,0,1,0,567873,37737,79991,27965,0.3495590796250324,0.4256339228638398
30935,0.7518809523809522,0,2,0,567875,37735,79991,27965,0.3495405535588573,0.4256468797564688
30936,0.7519166666666667,0,1,0,567876,37734,79991,27965,0.34953129052576976,0.4256533584986073
30937,0.7519523809523809,0,1,0,567877,37733,79991,27965,0.3495220274926822,0.42565983743797375
30938,0.7519761904761906,0,1,0,567878,37732,79991,27965,0.34951276445959467,0.4256663165745772
30939,0.7519999999999999,2,3,2,567881,37729,79993,27963,0.34948497536033196,0.4256682701089935
30940,0.752,7,29,7,567910,37700,80000,27956,0.34921634740079294,0.42579505300353354
30941,0.7520000000000002,1,2,1,567912,37698,80001,27955,0.3491978213346178,0.42579927802232953
30942,0.7520238095238095,0,1,0,567913,37697,80001,27955,0.3491885583015302,0.4258057637238774
30943,0.752047619047619,0,2,0,567915,37695,80001,27955,0.34917003223535514,0.42581873571972584
30944,0.7520586080586079,1,0,1,567915,37695,80002,27954,0.34917003223535514,0.4258099894895581
30945,0.752095238095238,0,1,0,567916,37694,80002,27954,0.3491607692022676,0.42581647574945164
30946,0.7521212121212122,1,0,1,567916,37694,80003,27953,0.3491607692022676,0.4258077292183954
30947,0.7521666666666664,0,1,0,567917,37693,80003,27953,0.34915150616918006,0.42581421564147093
30948,0.7521666666666665,1,1,1,567918,37692,80004,27952,0.3491422431360925,0.4258119553957711
30949,0.7521666666666667,0,7,0,567925,37685,80004,27952,0.3490774019044796,0.42585736703383764
30950,0.7521785714285717,0,1,0,567926,37684,80004,27952,0.34906813887139204,0.42586385520141384
30951,0.7521825396825398,0,1,0,567927,37683,80004,27952,0.34905887583830447,0.4258703435666946
30952,0.7521857864357863,1,0,1,567927,37683,80005,27951,0.34905887583830447,0.42586159612396013
30953,0.7522142857142857,0,2,0,567929,37681,80005,27951,0.3490403497721294,0.4258745733788396
30954,0.7522857142857142,0,1,0,567930,37680,80005,27951,0.3490310867390418,0.42588106230287515
30955,0.752315295815296,0,2,0,567932,37678,80005,27951,0.34901256067286673,0.4258940407441832
30956,0.7523333333333332,3,6,3,567938,37672,80008,27948,0.34895698247434137,0.42590673575129534
30957,0.7523333333333333,1,8,1,567946,37664,80009,27947,0.348882878209641,0.42594991693466033
30958,0.7523333333333335,0,3,0,567949,37661,80009,27947,0.3488550891103783,0.42596939397634437
30959,0.7524047619047621,0,1,0,567950,37660,80009,27947,0.34884582607729075,0.42597588671940495
30960,0.7524285714285713,0,3,0,567953,37657,80009,27947,0.3488180369780281,0.4259953661362112
30961,0.7524404761904762,0,1,0,567954,37656,80009,27947,0.34880877394494053,0.42600185967105164
30962,0.7524552669552668,0,2,0,567956,37654,80009,27947,0.34879024787876545,0.4260148473346443
30963,0.7524880952380952,0,2,0,567958,37652,80009,27947,0.3487717218125903,0.4260278357901797
30964,0.7524999999999998,1,2,1,567960,37650,80010,27946,0.3487531957464152,0.42603207512653213
30965,0.7525,41,81,41,568041,37569,80051,27905,0.3480028900663233,0.42619971286312125
30966,0.7525000000000002,0,2,0,568043,37567,80051,27905,0.3479843640001482,0.4262127321603128
30967,0.7525050505050507,0,2,0,568045,37565,80051,27905,0.3479658379339731,0.4262257522529403
30968,0.7525476190476192,1,0,1,568045,37565,80052,27904,0.3479658379339731,0.42621698819288517
30969,0.7525634920634918,0,2,0,568047,37563,80052,27904,0.347947311867798,0.42623000901217406
30970,0.7525833333333333,0,1,0,568048,37562,80052,27904,0.3479380488347104,0.4262365197201601
30971,0.7526190476190476,0,2,0,568050,37560,80052,27904,0.3479195227685353,0.4262495417328608
30972,0.7526666666666665,1,3,1,568053,37557,80053,27903,0.3478917336692727,0.4262603116406966
30973,0.7526666666666667,4,12,4,568065,37545,80057,27899,0.347780577272222,0.4263034044373816
30974,0.7526666666666668,1,4,1,568069,37541,80058,27898,0.3477435251398718,0.42632069560965175
30975,0.7526923076923078,0,1,0,568070,37540,80058,27898,0.34773426210678426,0.42632721048931815
30976,0.7527142857142857,0,1,0,568071,37539,80058,27898,0.3477249990736967,0.42633372556810367
30977,0.7527279942279942,0,1,0,568072,37538,80058,27898,0.3477157360406091,0.42634024084601746
30978,0.7527380952380952,0,1,0,568073,37537,80058,27898,0.3477064730075216,0.4263467563230687
30979,0.75275,0,1,0,568074,37536,80058,27898,0.34769720997443404,0.4263532719992664
30980,0.7527579365079365,0,1,0,568075,37535,80058,27898,0.34768794694134647,0.42635978787461987
30981,0.7527777777777778,0,2,0,568077,37533,80058,27898,0.3476694208751714,0.4263728202228302
30982,0.7528095238095238,0,2,0,568079,37531,80058,27898,0.34765089480899625,0.4263858533677727
30983,0.7528333333333334,4,8,4,568087,37523,80062,27894,0.3475767905442958,0.42640292278765457
30984,0.7528333333333335,0,1,0,568088,37522,80062,27894,0.3475675275112083,0.4264094411153235
30985,0.7528571428571428,1,4,1,568092,37518,80063,27893,0.34753047537885806,0.4264267477947134
30986,0.7528571428571429,1,0,1,568092,37518,80064,27892,0.34753047537885806,0.42641797890230854
30987,0.7528809523809524,1,1,1,568093,37517,80065,27891,0.3475212123457705,0.426415728962818
30988,0.7529047619047619,1,0,1,568093,37517,80066,27890,0.3475212123457705,0.4264069594997477
30989,0.752904761904762,0,1,0,568094,37516,80066,27890,0.3475119493126829,0.4264134788857291
30990,0.7529126984126983,1,0,1,568094,37516,80067,27889,0.3475119493126829,0.42640470912009787
30991,0.7529166666666666,1,0,1,568094,37516,80068,27888,0.3475119493126829,0.4263959390862944
30992,0.7529999999999998,1,2,1,568096,37514,80069,27887,0.34749342324650784,0.4264002079478907
30993,0.753,4,17,4,568113,37497,80073,27883,0.34733595168401943,0.4264759865402264
30994,0.7530000000000001,2,0,2,568113,37497,80075,27881,0.34733595168401943,0.4264584416776286
30995,0.7530119047619047,1,0,1,568113,37497,80076,27880,0.34733595168401943,0.426449668843783
30996,0.7530357142857141,0,1,0,568114,37496,80076,27880,0.34732668865093186,0.4264561918746941
30997,0.7530555555555556,1,0,1,568114,37496,80077,27879,0.34732668865093186,0.4264474187380497
30998,0.7530732323232324,1,0,1,568114,37496,80078,27878,0.34732668865093186,0.426438645333007
30999,0.7530952380952382,0,1,0,568115,37495,80078,27878,0.3473174256178443,0.4264451684946385
31000,0.7531071428571429,0,2,0,568117,37493,80078,27878,0.3472988995516692,0.42645821541662204
31001,0.7531103896103895,1,1,1,568118,37492,80079,27877,0.34728963651858163,0.4264559653658462
31002,0.7531666666666667,5,2,5,568120,37490,80084,27872,0.34727111045240655,0.4264251399895964
31003,0.7531666666666668,1,2,1,568122,37488,80085,27871,0.3472525843862314,0.4264294129347144
31004,0.7531706349206349,0,1,0,568123,37487,80085,27871,0.3472433213531439,0.42643593745218644
31005,0.7531904761904762,0,1,0,568124,37486,80085,27871,0.3472340583200563,0.4264424621693162
31006,0.7532142857142857,3,0,3,568124,37486,80088,27868,0.3472340583200563,0.4264161336720017
31007,0.753214285714286,0,1,0,568125,37485,80088,27868,0.34722479528696876,0.4264226584854559
31008,0.7532777777777778,1,0,1,568125,37485,80089,27867,0.34722479528696876,0.426413881748072
31009,0.7532857142857142,0,2,0,568127,37483,80089,27867,0.3472062692207937,0.42642693190512626
31010,0.7533333333333333,34,100,34,568227,37383,80123,27833,0.34627996591203825,0.42678177134445533
31011,0.7533333333333334,60,88,60,568315,37295,80183,27773,0.3454648190003335,0.42683039281981927
31012,0.7534166666666665,0,3,0,568318,37292,80183,27773,0.3454370299010708,0.42685007300391914
31013,0.753452380952381,0,1,0,568319,37291,80183,27773,0.34542776686798327,0.42685663346858477
31014,0.7534526070334892,5,3,5,568322,37288,80188,27768,0.3453999777687206,0.42683226758485
31015,0.7534920634920635,1,0,1,568322,37288,80189,27767,0.3453999777687206,0.42682345707478286
31016,0.7535,1,5,1,568327,37283,80190,27766,0.3453536626032828,0.42684745345816233
31017,0.7535000000000001,1,8,1,568335,37275,80191,27765,0.34527955833858237,0.4268911439114391
31018,0.7535021645021642,1,1,1,568336,37274,80192,27764,0.34527029530549486,0.4268888957225007
31019,0.7535714285714286,0,1,0,568337,37273,80192,27764,0.3452610322724073,0.4268954595076649
31020,0.7536111111111111,0,1,0,568338,37272,80192,27764,0.3452517692393197,0.42690202349467987
31021,0.7536190476190475,0,1,0,568339,37271,80192,27764,0.34524250620623215,0.426908587683555
31022,0.7536666666666666,0,3,0,568342,37268,80192,27764,0.3452147171069695,0.42692828146143436
31023,0.7536666666666667,3,2,3,568344,37266,80195,27761,0.3451961910407944,0.4269149737801221
31024,0.7536904761904762,0,1,0,568345,37265,80195,27761,0.34518692800770684,0.426921539076677
31025,0.7537121212121211,1,0,1,568345,37265,80196,27760,0.34518692800770684,0.4269127258746636
31026,0.7537142857142857,0,1,0,568346,37264,80196,27760,0.34517766497461927,0.4269192913385827
31027,0.7537237484737485,1,0,1,568346,37264,80197,27759,0.34517766497461927,0.42691047783092134
31028,0.75375,0,3,0,568349,37261,80197,27759,0.3451498758753566,0.42693017533066746
31029,0.7537500000000001,1,0,1,568349,37261,80198,27758,0.3451498758753566,0.4269213614481921
31030,0.7537619047619047,0,1,0,568350,37260,80198,27758,0.34514061284226905,0.4269279276508044
31031,0.7537619047619049,0,1,0,568351,37259,80198,27758,0.34513134980918153,0.4269344940554009
31032,0.7538333333333331,0,1,0,568352,37258,80198,27758,0.34512208677609396,0.4269410606619909
31033,0.7538333333333332,3,1,3,568353,37257,80201,27755,0.3451128237430064,0.4269211837814557
31034,0.7538333333333334,1,2,1,568355,37255,80202,27754,0.3450942976768313,0.4269255026227138
31035,0.7538888888888887,1,0,1,568355,37255,80203,27753,0.3450942976768313,0.42691668717696285
31036,0.7539166666666667,1,1,1,568356,37254,80204,27752,0.34508503464374374,0.42691443866719997
31037,0.7539523809523808,0,1,0,568357,37253,80204,27752,0.34507577161065617,0.42692100607645567
31038,0.7539761904761905,0,1,0,568358,37252,80204,27752,0.34506650857756865,0.42692757368777307
31039,0.7539999999999998,0,1,0,568359,37251,80204,27752,0.3450572455444811,0.4269341415011615
31040,0.7539999999999999,0,1,0,568360,37250,80204,27752,0.3450479825113935,0.42694070951663027
31041,0.754,14,36,14,568396,37214,80218,27738,0.34471451332024156,0.42705382436260625
31042,0.7540000000000002,1,1,1,568397,37213,80219,27737,0.34470525028715404,0.4270515781370285
31043,0.754047619047619,0,1,0,568398,37212,80219,27737,0.34469598725406647,0.42705815332029745
31044,0.7540595238095237,1,0,1,568398,37212,80220,27736,0.34469598725406647,0.4270493317731108
31045,0.754095238095238,1,2,1,568400,37210,80221,27735,0.3446774611878914,0.42705366078989915
31046,0.7541666666666665,6,17,6,568417,37193,80227,27729,0.3445199896254029,0.42711253504205043
31047,0.7541666666666668,9,25,9,568442,37168,80236,27720,0.34428841379821407,0.4271976328442855
31048,0.7541904761904761,0,1,0,568443,37167,80236,27720,0.34427915076512655,0.4272042165610985
31049,0.7541904761904762,1,0,1,568443,37167,80237,27719,0.34427915076512655,0.4271953888358043
31050,0.7541904761904763,0,3,0,568446,37164,80237,27719,0.3442513616658639,0.4272151411001341
31051,0.7542142857142856,1,0,1,568446,37164,80238,27718,0.3442513616658639,0.42720631299898276
31052,0.7542857142857143,1,4,1,568450,37160,80239,27717,0.3442143095335137,0.42722382354301214
31053,0.7543333333333332,0,4,0,568454,37156,80239,27717,0.34417725740116345,0.4272501657083841
31054,0.7543333333333334,4,9,4,568463,37147,80243,27713,0.34409389010337543,0.4272741288930003
31055,0.7543809523809525,0,1,0,568464,37146,80243,27713,0.3440846270702879,0.4272807166314621
31056,0.7544999999999998,0,1,0,568465,37145,80243,27713,0.34407536403720035,0.4272873045730673
31057,0.7545000000000001,3,3,3,568468,37142,80246,27710,0.3440475749379377,0.4272805773145007
31058,0.7545000000000002,0,1,0,568469,37141,80246,27710,0.3440383119048501,0.4272871659650584
31059,0.7545238095238095,0,1,0,568470,37140,80246,27710,0.34402904887176255,0.42729375481881265
31060,0.7545833333333333,0,1,0,568471,37139,80246,27710,0.34401978583867504,0.4273003438757729
31061,0.7546428571428571,1,0,1,568471,37139,80247,27709,0.34401978583867504,0.42729151245990626
31062,0.7546666666666666,2,3,2,568474,37136,80249,27707,0.34399199673941233,0.4272936168900267
31063,0.7546666666666667,4,15,4,568489,37121,80253,27703,0.34385305124309906,0.42735715167222016
31064,0.7546904761904761,0,2,0,568491,37119,80253,27703,0.3438345251769239,0.42737033723118695
31065,0.7547023809523811,0,1,0,568492,37118,80253,27703,0.34382526214383635,0.4273769303157927
31066,0.7547142857142858,1,0,1,568492,37118,80254,27702,0.34382526214383635,0.4273680962665844
31067,0.7547499999999999,1,0,1,568492,37118,80255,27701,0.34382526214383635,0.4273592619448001
31068,0.754833333333333,1,0,1,568492,37118,80256,27700,0.34382526214383635,0.42735042735042733
31069,0.7548333333333332,0,2,0,568494,37116,80256,27700,0.34380673607766127,0.4273636139224883
31070,0.7548333333333334,1,7,1,568501,37109,80257,27699,0.3437418948460484,0.4274009381557832
31071,0.7548333333333335,3,1,3,568502,37108,80260,27696,0.3437326318129608,0.42738102586260107
31072,0.7548571428571429,1,0,1,568502,37108,80261,27695,0.3437326318129608,0.42737218955912537
31073,0.7548809523809523,0,1,0,568503,37107,80261,27695,0.3437233687798733,0.4273787846054134
31074,0.7548809523809525,1,1,1,568504,37106,80262,27694,0.34371410574678574,0.42737654320987656
31075,0.7549166666666668,0,1,0,568505,37105,80262,27694,0.34370484271369817,0.42738313862868255
31076,0.7549285714285715,0,1,0,568506,37104,80262,27694,0.3436955796806106,0.42738973425105714
31077,0.7549523809523809,0,2,0,568508,37102,80262,27694,0.3436770536144355,0.4274029261065498
31078,0.7549603174603174,1,0,1,568508,37102,80263,27693,0.3436770536144355,0.427394089050081
31079,0.7549880952380952,0,1,0,568509,37101,80263,27693,0.34366779058134794,0.4274006852486341
31080,0.7549999999999999,3,3,3,568512,37098,80266,27690,0.3436400014820853,0.42739396184478606
31081,0.755,167,331,167,568843,36767,80433,27523,0.34057393753010484,0.428107015087883
31082,0.7550000000000001,0,2,0,568845,36765,80433,27523,0.34055541146392976,0.4281203334992534
31083,0.7550238095238097,0,1,0,568846,36764,80433,27523,0.3405461484308422,0.42812699301569523
31084,0.7550367965367967,1,0,1,568846,36764,80434,27522,0.3405461484308422,0.4281180972529011
31085,0.7550476190476191,0,2,0,568848,36762,80434,27522,0.3405276223646671,0.42813141683778233
31086,0.7551111111111112,1,0,1,568848,36762,80435,27521,0.3405276223646671,0.428122520728653
31087,0.755142857142857,0,2,0,568850,36760,80435,27521,0.34050909629849196,0.4281358410727898
31088,0.7551428571428572,0,1,0,568851,36759,80435,27521,0.34049983326540445,0.42814250155569383
31089,0.7551666666666665,0,2,0,568853,36757,80435,27521,0.3404813071992293,0.42815582314322165
31090,0.7551666666666667,2,4,2,568857,36753,80437,27519,0.3404442550668791,0.42816467513069456
31091,0.7551666666666668,0,1,0,568858,36752,80437,27519,0.3404349920337915,0.42817133699491217
31092,0.7552142857142856,1,0,1,568858,36752,80438,27518,0.3404349920337915,0.4281624397074841
31093,0.7552261904761906,0,1,0,568859,36751,80438,27518,0.340425729000704,0.4281691017442313
31094,0.7552380952380952,1,0,1,568859,36751,80439,27517,0.340425729000704,0.4281602041451422
31095,0.7552500000000001,1,0,1,568859,36751,80440,27516,0.340425729000704,0.42815130626915837
31096,0.7552575757575756,0,2,0,568861,36749,80440,27516,0.34040720293452886,0.4281646308254882
31097,0.7552857142857143,0,1,0,568862,36748,80440,27516,0.34039793990144135,0.42817129341466453
31098,0.7553333333333332,0,2,0,568864,36746,80440,27516,0.3403794138352662,0.4281846192150882
31099,0.7553333333333333,5,12,5,568876,36734,80445,27511,0.3402682574382156,0.42822009494902324
31100,0.7553333333333334,1,2,1,568878,36732,80446,27510,0.34024973137204045,0.42822452601102085
31101,0.7553571428571427,0,2,0,568880,36730,80446,27510,0.34023120530586537,0.42823785803237857
31102,0.755357142857143,0,1,0,568881,36729,80446,27510,0.3402219422727778,0.42824452435436416
31103,0.7553626096126093,0,3,0,568884,36726,80446,27510,0.34019415317351515,0.4282645245656641
31104,0.7554047619047618,1,0,1,568884,36726,80447,27509,0.34019415317351515,0.42825562388106175
31105,0.7554166666666666,0,1,0,568885,36725,80447,27509,0.3401848901404276,0.4282622909985366
31106,0.7554761904761904,0,2,0,568887,36723,80447,27509,0.3401663640742525,0.428275625856271
31107,0.7554761904761905,0,2,0,568889,36721,80447,27509,0.34014783800807735,0.4282889615444496
31108,0.7554999999999998,0,1,0,568890,36720,80447,27509,0.34013857497498984,0.42829562969997975
31109,0.7555,0,7,0,568897,36713,80447,27509,0.3400737337433769,0.4283423126031578
31110,0.7555000000000001,0,2,0,568899,36711,80447,27509,0.3400552076772018,0.4283556524447213
31111,0.7555238095238096,0,2,0,568901,36709,80447,27509,0.34003668161102674,0.42836899311719456
31112,0.7556428571428572,0,1,0,568902,36708,80447,27509,0.34002741857793917,0.42837566376504665
31113,0.7556666666666666,2,8,2,568910,36700,80449,27507,0.3399533143132387,0.4284112324201411
31114,0.7556666666666668,2,3,2,568913,36697,80451,27505,0.33992552521397607,0.4284134450640167
31115,0.7557142857142857,3,3,3,568916,36694,80454,27502,0.3398977361147134,0.4284067543149106
31116,0.7557142857142858,1,0,1,568916,36694,80455,27501,0.3398977361147134,0.4283978502998676
31117,0.7557301587301588,0,2,0,568918,36692,80455,27501,0.33987921004853827,0.42841119748259154
31118,0.7557698412698413,1,0,1,568918,36692,80456,27500,0.33987921004853827,0.4284022931206381
31119,0.7558095238095237,0,1,0,568919,36691,80456,27500,0.33986994701545076,0.42840896698914177
31120,0.7558333333333331,1,0,1,568919,36691,80457,27499,0.33986994701545076,0.42840006231500233
31121,0.7558333333333332,3,16,3,568935,36675,80460,27496,0.33972173848604986,0.428480154586963
31122,0.7558333333333335,9,24,9,568959,36651,80469,27487,0.3394994256919486,0.4285602918706539
31123,0.7559047619047619,0,2,0,568961,36649,80469,27487,0.33948089962577344,0.4285736559810403
31124,0.755952380952381,1,0,1,568961,36649,80470,27486,0.33948089962577344,0.42856474623840335
31125,0.7559657287157286,0,1,0,568962,36648,80470,27486,0.3394716365926859,0.42857142857142855
31126,0.7559920634920636,0,3,0,568965,36645,80470,27486,0.33944384749342327,0.4285914768208823
31127,0.7559955044955045,0,2,0,568967,36643,80470,27486,0.33942532142724813,0.42860484336259724
31128,0.7559999999999999,19,32,19,568999,36611,80489,27467,0.3391289043684464,0.42864945847248664
31129,0.7560000000000001,2,7,2,569006,36604,80491,27465,0.3390640631368335,0.4286784560395823
31130,0.7560714285714286,0,1,0,569007,36603,80491,27465,0.33905480010374595,0.42868514703127925
31131,0.7560912698412701,0,1,0,569008,36602,80491,27465,0.33904553707065843,0.42869183823185103
31132,0.7560974025974025,0,2,0,569010,36600,80491,27465,0.3390270110044833,0.42870522125965815
31133,0.7560974025974027,0,1,0,569011,36599,80491,27465,0.3390177479713958,0.4287119130869131
31134,0.7561666666666664,1,1,1,569012,36598,80492,27464,0.3390084849383082,0.42870968749024385
31135,0.7561666666666667,0,5,0,569017,36593,80492,27464,0.3389621697728704,0.42874315063146884
31136,0.7561666666666668,0,5,0,569022,36588,80492,27464,0.3389158546074327,0.4287766189970649
31137,0.7561818181818183,0,1,0,569023,36587,80492,27464,0.3389065915743451,0.4287833132972163
31138,0.7561904761904761,0,1,0,569024,36586,80492,27464,0.33889732854125754,0.42879000780640125
31139,0.7561904761904762,1,2,1,569026,36584,80493,27463,0.33887880247508245,0.4287944790544444
31140,0.7562222222222224,0,3,0,569029,36581,80493,27463,0.3388510133758198,0.4288145649865717
31141,0.7562301587301588,0,2,0,569031,36579,80493,27463,0.33883248730964466,0.4288279566534462
31142,0.75625,2,1,2,569032,36578,80495,27461,0.3388232242765571,0.4288168147535096
31143,0.7562619047619046,0,1,0,569033,36577,80495,27461,0.3388139612434696,0.4288235110403198
31144,0.7563095238095238,0,1,0,569034,36576,80495,27461,0.338804698210382,0.4288302075362681
31145,0.7563333333333331,0,1,0,569035,36575,80495,27461,0.33879543517729444,0.4288369042413642
31146,0.7563333333333333,4,6,4,569041,36569,80499,27457,0.3387398569787691,0.4288414081779277
31147,0.7563333333333334,2,0,2,569041,36569,80501,27455,0.3387398569787691,0.428823566162689
31148,0.756357142857143,1,3,1,569044,36566,80502,27454,0.3387120678795065,0.4288347391440175
31149,0.7563690476190476,0,2,0,569046,36564,80502,27454,0.33869354181333133,0.4288481364616202
31150,0.7563809523809524,0,1,0,569047,36563,80502,27454,0.3386842787802438,0.4288548354343378
31151,0.7564285714285713,0,2,0,569049,36561,80502,27454,0.3386657527140687,0.42886823400765445
31152,0.7565,5,1,5,569050,36560,80507,27449,0.33865648968098117,0.42883032073614646
31153,0.7565000000000001,4,9,4,569059,36551,80511,27445,0.33857312238319315,0.4288549284330271
31154,0.7565238095238095,0,1,0,569060,36550,80511,27445,0.3385638593501056,0.4288616298148293
31155,0.756547619047619,0,1,0,569061,36549,80511,27445,0.33855459631701806,0.42886833140606934
31156,0.7565476190476191,0,1,0,569062,36548,80511,27445,0.3385453332839305,0.42887503320675696
31157,0.7565714285714285,0,1,0,569063,36547,80511,27445,0.3385360702508429,0.4288817352169021
31158,0.7565714285714286,0,1,0,569064,36546,80511,27445,0.33852680721775535,0.4288884374365145
31159,0.7566666666666666,53,94,53,569158,36452,80564,27392,0.3376560821075253,0.42904579913539254
31160,0.7566666666666667,43,81,43,569239,36371,80607,27349,0.3369057764274334,0.4292059008160703
31161,0.7567857142857143,0,1,0,569240,36370,80607,27349,0.33689651339434584,0.4292126367331565
31162,0.7568333333333334,1,6,1,569246,36364,80608,27348,0.33684093519582053,0.4292440984429935
31163,0.7568571428571428,2,1,2,569247,36363,80610,27346,0.33683167216273296,0.42923291842596806
31164,0.7568809523809523,0,1,0,569248,36362,80610,27346,0.3368224091296454,0.42923965593018143
31165,0.7569523809523812,0,1,0,569249,36361,80610,27346,0.3368131460965579,0.42924639364591016
31166,0.7569999999999999,1,2,1,569251,36359,80611,27345,0.33679462003038274,0.4292509104608816
31167,0.757,4,8,4,569259,36351,80615,27341,0.3367205157656823,0.42926898197575836
31168,0.7570833333333334,0,1,0,569260,36350,80615,27341,0.3367112527325948,0.4292757218445306
31169,0.7571428571428569,0,1,0,569261,36349,80615,27341,0.3367019896995072,0.42928246192494895
31170,0.7571428571428571,0,1,0,569262,36348,80615,27341,0.33669272666641964,0.4292892022170233
31171,0.7571428571428572,0,5,0,569267,36343,80615,27341,0.3366464115009819,0.4293229068525846
31172,0.7571666666666667,2,7,2,569274,36336,80617,27339,0.336581570269369,0.42935217903415784
31173,0.7571904761904762,0,1,0,569275,36335,80617,27339,0.33657230723628145,0.42935892200898323
31174,0.7572142857142857,0,2,0,569277,36333,80617,27339,0.3365537811701063,0.42937240859404446
31175,0.7572500000000001,0,1,0,569278,36332,80617,27339,0.3365445181370188,0.42937915220430023
31176,0.7572619047619048,1,1,1,569279,36331,80618,27338,0.33653525510393123,0.4293769338296502
31177,0.7572777777777777,0,1,0,569280,36330,80618,27338,0.33652599207084366,0.4293836778287366
31178,0.7573333333333332,0,1,0,569281,36329,80618,27338,0.33651672903775615,0.4293904220396752
31179,0.7573333333333333,3,9,3,569290,36320,80621,27335,0.33643336173996813,0.4294242400439871
31180,0.7573333333333335,1,2,1,569292,36318,80622,27334,0.33641483567379304,0.42942876893106263
31181,0.7573452380952379,0,2,0,569294,36316,80622,27334,0.3363963096076179,0.4294422623723488
31182,0.7573809523809523,0,3,0,569297,36313,80622,27334,0.33636852050835525,0.42946250412431064
31183,0.7573809523809524,0,4,0,569301,36309,80622,27334,0.336331468376005,0.4294894960954072
31184,0.757404761904762,0,1,0,569302,36308,80622,27334,0.33632220534291746,0.4294962446183338
31185,0.757452380952381,1,0,1,569302,36308,80623,27333,0.33632220534291746,0.42948728021244165
31186,0.7574999999999998,0,3,0,569305,36305,80623,27333,0.3362944162436548,0.429507526949307
31187,0.7575,41,105,41,569410,36200,80664,27292,0.33532179776946164,0.42984942984942986
31188,0.7575000000000002,2,0,2,569410,36200,80666,27290,0.33532179776946164,0.42983146952275947
31189,0.757547619047619,0,1,0,569411,36199,80666,27290,0.33531253473637407,0.4298382396950653
31190,0.7576547619047619,0,2,0,569413,36197,80666,27290,0.335294008670199,0.4298517806795092
31191,0.7576666666666667,1,9,1,569422,36188,80667,27289,0.33521064137241097,0.4299037446634214
31192,0.7576666666666668,1,0,1,569422,36188,80668,27288,0.33521064137241097,0.4298947633751339
31193,0.7576904761904761,0,1,0,569423,36187,80668,27288,0.33520137833932345,0.4299015360378102
31194,0.7576904761904762,0,1,0,569424,36186,80668,27288,0.3351921153062359,0.429908308913886
31195,0.7577142857142857,0,1,0,569425,36185,80668,27288,0.3351828522731483,0.42991508200337153
31196,0.7577619047619047,0,1,0,569426,36184,80668,27288,0.33517358924006074,0.4299218553062768
31197,0.7577777777777777,1,2,1,569428,36182,80669,27287,0.33515506317388566,0.42992642077234555
31198,0.7578333333333331,1,0,1,569428,36182,80670,27286,0.33515506317388566,0.4299174387092708
31199,0.7578333333333334,1,0,1,569428,36182,80671,27285,0.33515506317388566,0.42990845636314934
31200,0.7578333333333335,1,2,1,569430,36180,80672,27284,0.3351365371077106,0.4299130215555275
31201,0.7578571428571428,2,2,2,569432,36178,80674,27282,0.33511801104153544,0.4299086038449417
31202,0.7578571428571429,0,3,0,569435,36175,80674,27282,0.3350902219422728,0.4299289282506264
31203,0.7579166666666666,0,3,0,569438,36172,80674,27282,0.3350624328430101,0.42994925457811956
31204,0.7579166666666667,1,0,1,569438,36172,80675,27281,0.3350624328430101,0.4299402707515799
31205,0.7579880952380954,2,1,2,569439,36171,80677,27279,0.33505316980992256,0.4299290780141844
31206,0.758,7,27,7,569466,36144,80684,27272,0.3348030679165586,0.4300491989403305
31207,0.7580000000000001,1,3,1,569469,36141,80685,27271,0.33477527881729596,0.4300605563615719
31208,0.7580039682539682,1,0,1,569469,36141,80686,27270,0.33477527881729596,0.43005156833987795
31209,0.7580169830169831,2,0,2,569469,36141,80688,27268,0.33477527881729596,0.4300335914460092
31210,0.7580476190476191,1,0,1,569469,36141,80689,27267,0.33477527881729596,0.4300246025738077
31211,0.7580952380952379,0,1,0,569470,36140,80689,27267,0.3347660157842084,0.43003138454744744
31212,0.7580952380952382,0,1,0,569471,36139,80689,27267,0.3347567527511208,0.43003816673500933
31213,0.7581428571428571,0,2,0,569473,36137,80689,27267,0.33473822668494574,0.43005173175193995
31214,0.7581666666666664,0,1,0,569474,36136,80689,27267,0.33472896365185817,0.43005851458132893
31215,0.7581666666666667,3,2,3,569476,36134,80692,27264,0.33471043758568303,0.43004511183318084
31216,0.7581666666666668,0,2,0,569478,36132,80692,27264,0.33469191151950795,0.43005867878099563
31217,0.7581904761904762,0,1,0,569479,36131,80692,27264,0.3346826484864204,0.43006546257591294
31218,0.7582142857142857,0,2,0,569481,36129,80692,27264,0.3346641224202453,0.4300790308078179
31219,0.7582142857142858,0,1,0,569482,36128,80692,27264,0.3346548593871577,0.43008581524482586
31220,0.7582619047619048,1,0,1,569482,36128,80693,27263,0.3346548593871577,0.4300768247858529
31221,0.7582857142857142,0,1,0,569483,36127,80693,27263,0.33464559635407015,0.4300836094021139
31222,0.7583000610500611,0,3,0,569486,36124,80693,27263,0.3346178072548075,0.4301039645353148
31223,0.7583333333333333,21,48,21,569534,36076,80714,27242,0.3341731816666049,0.4302410057171736
31224,0.7583333333333334,18,43,18,569577,36033,80732,27224,0.3337748712438401,0.4303713423020377
31225,0.7583809523809524,0,2,0,569579,36031,80732,27224,0.33375634517766495,0.4303849498063394
31226,0.7584285714285716,0,1,0,569580,36030,80732,27224,0.33374708214457743,0.43039175388117745
31227,0.7585,3,6,3,569586,36024,80735,27221,0.33369150394605207,0.4304055656573642
31228,0.7585000000000001,2,2,2,569588,36022,80737,27219,0.333672977879877,0.4304011638019639
31229,0.7585238095238096,1,1,1,569589,36021,80738,27218,0.3336637148467894,0.4303989626654438
31230,0.7585476190476191,1,0,1,569589,36021,80739,27217,0.3336637148467894,0.43038995540655933
31231,0.7585714285714286,1,2,1,569591,36019,80740,27216,0.33364518878061433,0.43039455997469755
31232,0.7586190476190476,1,0,1,569591,36019,80741,27215,0.33364518878061433,0.4303855520764146
31233,0.7586428571428573,0,1,0,569592,36018,80741,27215,0.33363592574752676,0.43039235842044504
31234,0.7586666666666665,0,1,0,569593,36017,80741,27215,0.3336266627144392,0.4303991649797571
31235,0.7586666666666666,1,2,1,569595,36015,80742,27214,0.3336081366482641,0.4304037704218001
31236,0.7586666666666667,3,5,3,569600,36010,80745,27211,0.3335618214828263,0.4304107812277566
31237,0.7586666666666669,1,0,1,569600,36010,80746,27210,0.3335618214828263,0.4304017715912686
31238,0.75875,2,7,2,569607,36003,80748,27208,0.33349698025121344,0.4304314122541963
31239,0.7587619047619047,0,1,0,569608,36002,80748,27208,0.3334877172181259,0.430438221800348
31240,0.7587857142857142,0,1,0,569609,36001,80748,27208,0.33347845418503835,0.4304450315619611
31241,0.7587857142857143,0,1,0,569610,36000,80748,27208,0.3334691911519508,0.4304518415390457
31242,0.7588333333333332,2,1,2,569611,35999,80750,27206,0.3334599281188632,0.43044062969701763
31243,0.7588333333333334,1,1,1,569612,35998,80751,27205,0.3334506650857757,0.43043842855560654
31244,0.7588809523809523,1,2,1,569614,35996,80752,27204,0.33343213901960056,0.43044303797468353
31245,0.7588939393939396,1,1,1,569615,35995,80753,27203,0.33342287598651305,0.4304408367353397
31246,0.7589285714285714,0,1,0,569616,35994,80753,27203,0.3334136129534255,0.4304476478313844
31247,0.7589285714285715,1,0,1,569616,35994,80754,27202,0.3334136129534255,0.43043863535666815
31248,0.7589761904761906,0,1,0,569617,35993,80754,27202,0.3334043499203379,0.4304454466334362
31249,0.7589999999999998,0,3,0,569620,35990,80754,27202,0.33337656082107525,0.4304658817571845
31250,0.759,10,6,10,569626,35984,80764,27192,0.33332098262254994,0.4304166139040142
31251,0.759047619047619,0,1,0,569627,35983,80764,27192,0.3333117195894624,0.4304234269885239
31252,0.7590833333333333,0,1,0,569628,35982,80764,27192,0.3333024565563748,0.4304302402887264
31253,0.759142857142857,1,0,1,569628,35982,80765,27191,0.3333024565563748,0.4304212242571985
31254,0.7591666666666665,7,13,7,569641,35969,80772,27184,0.3331820371262366,0.43044669295203714
31255,0.7591666666666668,8,17,8,569658,35952,80780,27176,0.3330245655637482,0.4304904321378786
31256,0.7592142857142857,0,2,0,569660,35950,80780,27176,0.33300603949757307,0.4305040712226341
31257,0.7592857142857141,0,1,0,569661,35949,80780,27176,0.33299677646448556,0.4305108910891089
31258,0.7592857142857143,2,3,2,569664,35946,80782,27174,0.33296898736522285,0.43051330798479087
31259,0.759297619047619,0,1,0,569665,35945,80782,27174,0.33295972433213533,0.4305201286458911
31260,0.7593333333333332,2,3,2,569668,35942,80784,27172,0.3329319352328727,0.430522546503153
31261,0.7593333333333334,6,16,6,569684,35926,80790,27166,0.3327837267034718,0.43057756926393204
31262,0.7593333333333335,0,1,0,569685,35925,80790,27166,0.3327744636703842,0.4305843939706139
31263,0.7593571428571428,1,3,1,569688,35922,80791,27165,0.33274667457112156,0.43059584383470445
31264,0.759357142857143,1,0,1,569688,35922,80792,27164,0.33274667457112156,0.43058681799448373
31265,0.7593809523809525,2,1,2,569689,35921,80794,27162,0.332737411538034,0.4305755908881949
31266,0.7594047619047618,0,1,0,569690,35920,80794,27162,0.3327281485049465,0.4305824165372055
31267,0.7594523809523811,0,2,0,569692,35918,80794,27162,0.33270962243877134,0.4305960684844642
31268,0.7594999999999998,2,3,2,569695,35915,80796,27160,0.3326818333395087,0.43059849385652
31269,0.7595000000000001,0,10,0,569705,35905,80796,27160,0.33258920300863315,0.43066677237770556
31270,0.7595000000000002,0,1,0,569706,35904,80796,27160,0.3325799399755456,0.4306736014207789
31271,0.7595238095238096,0,3,0,569709,35901,80796,27160,0.3325521508762829,0.4306940898495108
31272,0.7595256132756133,0,3,0,569712,35898,80796,27160,0.33252436177702027,0.43071458022772685
31273,0.7595555555555557,0,1,0,569713,35897,80796,27160,0.3325150987439327,0.43072141078706566
31274,0.7595833333333333,0,2,0,569715,35895,80796,27160,0.3324965726777576,0.4307350725557053
31275,0.7596031746031743,1,2,1,569717,35893,80797,27159,0.3324780466115825,0.4307397069085834
31276,0.7596190476190476,0,1,0,569718,35892,80797,27159,0.33246878357849496,0.43074653851643907
31277,0.7596428571428572,1,0,1,569718,35892,80798,27158,0.33246878357849496,0.43073750991276766
31278,0.7596666666666665,1,5,1,569723,35887,80799,27157,0.33242246841305717,0.4307626419643424
31279,0.7596666666666667,2,6,2,569729,35881,80801,27155,0.33236689021453186,0.4307855828415509
31280,0.7596666666666668,0,1,0,569730,35880,80801,27155,0.3323576271814443,0.43079241691123976
31281,0.7596904761904762,1,0,1,569730,35880,80802,27154,0.3323576271814443,0.4307833867436622
31282,0.7596969696969699,0,1,0,569731,35879,80802,27154,0.3323483641483567,0.43079022099535164
31283,0.7597142857142858,1,0,1,569731,35879,80803,27153,0.3323483641483567,0.43078119050640945
31284,0.7598095238095237,1,0,1,569731,35879,80804,27152,0.3323483641483567,0.43077215973092603
31285,0.759833333333333,0,1,0,569732,35878,80804,27152,0.3323391011152692,0.4307789941297795
31286,0.7598333333333332,0,4,0,569736,35874,80804,27152,0.332302048982919,0.4308063338939485
31287,0.7598333333333334,1,4,1,569740,35870,80805,27151,0.33226499685056876,0.43082464575300294
31288,0.7598466810966811,1,3,1,569743,35867,80806,27150,0.3322372077513061,0.4308361235856991
31289,0.7598809523809524,1,4,1,569747,35863,80807,27149,0.3322001556189559,0.4308544404240462
31290,0.7599047619047619,0,2,0,569749,35861,80807,27149,0.33218162955278074,0.4308681161720362
31291,0.7599166666666668,0,1,0,569750,35860,80807,27149,0.33217236651969323,0.43087495437159773
31292,0.7599523809523809,0,1,0,569751,35859,80807,27149,0.33216310348660566,0.43088179278821737
31293,0.7599999999999997,0,1,0,569752,35858,80807,27149,0.3321538404535181,0.4308886314219055
31294,0.7599999999999999,1,5,1,569757,35853,80808,27148,0.33210752528808035,0.4309137950191267
31295,0.76,748,1122,748,570879,34731,81556,26400,0.3217144021638445,0.43185944937920206
31296,0.7600000000000001,4,6,4,570885,34725,81560,26396,0.3216588239653192,0.43186466190016526
31297,0.7600238095238094,1,0,1,570885,34725,81561,26395,0.3216588239653192,0.4318553664921466
31298,0.7600476190476191,0,2,0,570887,34723,81561,26395,0.3216402978991441,0.431869498347459
31299,0.7600714285714285,0,1,0,570888,34722,81561,26395,0.32163103486605654,0.4318765646219546
31300,0.7600775613275613,0,1,0,570889,34721,81561,26395,0.321621771832969,0.4318836311276916
31301,0.7600952380952382,0,1,0,570890,34720,81561,26395,0.32161250879988146,0.4318906978646813
31302,0.7601666666666667,2,1,2,570891,34719,81563,26393,0.3216032457667939,0.4318791726665794
31303,0.7601666666666668,0,2,0,570893,34717,81563,26393,0.32158471970061875,0.43189330715103913
31304,0.7602500000000001,0,1,0,570894,34716,81563,26393,0.32157545666753123,0.4319003747402183
31305,0.7602857142857142,1,1,1,570895,34715,81564,26392,0.32156619363444366,0.431898145875268
31306,0.7603333333333333,2,10,2,570905,34705,81566,26390,0.32147356330356813,0.4319502414272854
31307,0.7604166666666667,0,2,0,570907,34703,81566,26390,0.321455037237393,0.43196438217144356
31308,0.7604404761904762,0,1,0,570908,34702,81566,26390,0.3214457742043055,0.4319714528907222
31309,0.7604761904761905,1,0,1,570908,34702,81567,26389,0.3214457742043055,0.431962154818222
31310,0.7605,3,6,3,570914,34696,81570,26386,0.3213901960057801,0.43197668707638914
31311,0.7605357142857142,0,1,0,570915,34695,81570,26386,0.3213809329726926,0.4319837592704769
31312,0.7606060606060606,0,1,0,570916,34694,81570,26386,0.32137166993960503,0.4319908316961362
31313,0.7606428571428568,0,4,0,570920,34690,81570,26386,0.3213346178072548,0.43201912371471607
31314,0.7606666666666665,1,0,1,570920,34690,81571,26385,0.3213346178072548,0.43200982398690135
31315,0.7606666666666666,5,9,5,570929,34681,81576,26380,0.32125125050946685,0.4320269894040386
31316,0.7606666666666668,3,1,3,570930,34680,81579,26377,0.3212419874763793,0.4320061581800613
31317,0.7606904761904763,0,1,0,570931,34679,81579,26377,0.3212327244432917,0.4320132337526205
31318,0.7607142857142857,1,0,1,570931,34679,81580,26376,0.3212327244432917,0.4320039308819916
31319,0.7607857142857142,0,1,0,570932,34678,81580,26376,0.32122346141020414,0.4320110066498509
31320,0.7608333333333331,0,1,0,570933,34677,81580,26376,0.3212141983771166,0.43201808264950126
31321,0.7608333333333333,12,20,12,570953,34657,81592,26364,0.3210289377153655,0.4320479834810967
31322,0.7608333333333335,4,14,4,570967,34643,81596,26360,0.32089925525213975,0.43210989623461143
31323,0.7608571428571428,2,2,2,570969,34641,81598,26358,0.32088072918596466,0.43210544435154674
31324,0.7608571428571429,0,1,0,570970,34640,81598,26358,0.3208714661528771,0.4321125282796157
31325,0.7608809523809523,0,1,0,570971,34639,81598,26358,0.3208622031197895,0.43211961243995606
31326,0.7609166666666667,0,2,0,570973,34637,81598,26358,0.32084367705361444,0.43213378145749654
31327,0.760952380952381,0,1,0,570974,34636,81598,26358,0.32083441402052687,0.4321408663147195
31328,0.7609801587301588,0,1,0,570975,34635,81598,26358,0.3208251509874393,0.4321479514042595
31329,0.7609999999999999,9,24,9,570999,34611,81607,26349,0.320602838193338,0.43223425196850396
31330,0.7610000000000001,0,2,0,571001,34609,81607,26349,0.32058431212716293,0.43224843334755075
31331,0.7610238095238094,0,1,0,571002,34608,81607,26349,0.32057504909407536,0.43225552438604264
31332,0.761047619047619,0,1,0,571003,34607,81607,26349,0.3205657860609878,0.43226261565719537
31333,0.7610476190476192,1,0,1,571003,34607,81608,26348,0.3205657860609878,0.4322533016159462
31334,0.7610555555555557,0,1,0,571004,34606,81608,26348,0.3205565230279003,0.4322603930833087
31335,0.7610714285714286,1,0,1,571004,34606,81609,26347,0.3205565230279003,0.43225107869998197
31336,0.7611111111111112,1,0,1,571004,34606,81610,26346,0.3205565230279003,0.43224176401102504
31337,0.7611190476190477,2,0,2,571004,34606,81612,26344,0.3205565230279003,0.4322231337161608
31338,0.7611666666666665,0,1,0,571005,34605,81612,26344,0.3205472599948127,0.43223022527030797
31339,0.7611666666666668,1,3,1,571008,34602,81613,26343,0.32051947089555005,0.4322421855771597
31340,0.7611666666666669,0,1,0,571009,34601,81613,26343,0.3205102078624625,0.43224927802572854
31341,0.7611904761904762,2,1,2,571010,34600,81615,26341,0.3205009448293749,0.43223773814016836
31342,0.7612023809523811,1,1,1,571011,34599,81616,26340,0.3204916817962874,0.4322355142027273
31343,0.7612142857142856,1,3,1,571014,34596,81617,26339,0.3204638926970247,0.4322474768195618
31344,0.7612344599844597,1,4,1,571018,34592,81618,26338,0.3204268405646745,0.4322665353684556
31345,0.76125,0,3,0,571021,34589,81618,26338,0.3203990514654118,0.43228781984998443
31346,0.7612738095238094,0,1,0,571022,34588,81618,26338,0.3203897884323243,0.4322949151429603
31347,0.7612857142857143,1,1,1,571023,34587,81619,26337,0.3203805253992367,0.4322926925349616
31348,0.7613055555555556,0,1,0,571024,34586,81619,26337,0.32037126236614916,0.4322997882573084
31349,0.7613095238095238,0,1,0,571025,34585,81619,26337,0.32036199933306164,0.4323068842125997
31350,0.7613333333333331,0,1,0,571026,34584,81619,26337,0.3203527362999741,0.432313980400847
31351,0.7613333333333333,1,6,1,571032,34578,81620,26336,0.32029715810144876,0.432347243654989
31352,0.7613333333333334,1,3,1,571035,34575,81621,26335,0.32026936900218606,0.43235921851912656
31353,0.7613809523809522,0,2,0,571037,34573,81621,26335,0.32025084293601097,0.43237341564326526
31354,0.7614047619047619,0,1,0,571038,34572,81621,26335,0.3202415799029234,0.4323805145549773
31355,0.7614523809523811,0,1,0,571039,34571,81621,26335,0.32023231686983583,0.43238761369979967
31356,0.7615,0,2,0,571041,34569,81621,26335,0.32021379080366075,0.4324018126888218
31357,0.7615000000000001,1,1,1,571042,34568,81622,26334,0.3202045277705732,0.43239959278841417
31358,0.7615000000000002,0,1,0,571043,34567,81622,26334,0.32019526473748566,0.43240669282934596
31359,0.7615036075036072,0,2,0,571045,34565,81622,26334,0.3201767386713105,0.43242089361073255
31360,0.7615476190476191,0,2,0,571047,34563,81622,26334,0.32015821260513544,0.4324350953248928
31361,0.7616666666666664,0,1,0,571048,34562,81622,26334,0.32014894957204787,0.4324421965317919
31362,0.7616666666666666,26,47,26,571095,34515,81648,26308,0.3197135870169328,0.4325337454581326
31363,0.7616666666666667,32,39,32,571134,34476,81680,26276,0.3193523287265182,0.4325125098762181
31364,0.7616666666666668,1,0,1,571134,34476,81681,26275,0.3193523287265182,0.43250316867212063
31365,0.7617142857142858,1,0,1,571134,34476,81682,26274,0.3193523287265182,0.43249382716049384
31366,0.7617380952380954,0,2,0,571136,34474,81682,26274,0.3193338026603431,0.4325080661091723
31367,0.7617499999999999,0,1,0,571137,34473,81682,26274,0.31932453962725554,0.4325151859351079
31368,0.7617619047619048,0,1,0,571138,34472,81682,26274,0.319315276594168,0.4325223059954565
31369,0.7617857142857143,0,1,0,571139,34471,81682,26274,0.31930601356108046,0.43252942629022967
31370,0.7617875735375734,0,2,0,571141,34469,81682,26274,0.3192874874949053,0.432543667583096
31371,0.7618095238095237,1,0,1,571141,34469,81683,26273,0.3192874874949053,0.4325343255078858
31372,0.7618333333333333,1,5,1,571146,34464,81684,26272,0.3192411723294676,0.43256059009483666
31373,0.7618333333333334,1,5,1,571151,34459,81685,26271,0.3191948571640298,0.43258685987156265
31374,0.7618333333333335,1,0,1,571151,34459,81686,26270,0.3191948571640298,0.432577516507764
31375,0.7618571428571428,0,1,0,571152,34458,81686,26270,0.3191855941309422,0.43258463970491373
31376,0.7619047619047618,1,1,1,571153,34457,81687,26269,0.3191763310978547,0.4325824193920232
31377,0.7619047619047619,0,5,0,571158,34452,81687,26269,0.3191300159324169,0.43261803988735364
31378,0.7619166666666666,0,2,0,571160,34450,81687,26269,0.3191114898662418,0.4326322897280917
31379,0.7619285714285714,0,2,0,571162,34448,81687,26269,0.3190929638000667,0.4326465405076008
31380,0.7619444444444445,0,1,0,571163,34447,81687,26269,0.3190837007669791,0.43265366624942353
31381,0.7619999999999999,1,3,1,571166,34444,81688,26268,0.31905591166771646,0.4326657003557781
31382,0.762,6,20,6,571186,34424,81694,26262,0.3188706510059654,0.43275219984839997
31383,0.762047619047619,1,0,1,571186,34424,81695,26261,0.3188706510059654,0.4327428524347038
31384,0.7620476190476191,0,2,0,571188,34422,81695,26261,0.31885212493979026,0.4327571148427072
31385,0.7621071428571426,0,2,0,571190,34420,81695,26261,0.3188335988736152,0.432771378190867
31386,0.7621428571428571,0,1,0,571191,34419,81695,26261,0.3188243358405276,0.4327785102175346
31387,0.7621466033966032,0,1,0,571192,34418,81695,26261,0.3188150728074401,0.4327856424792762
31388,0.7621666666666665,0,1,0,571193,34417,81695,26261,0.3188058097743525,0.43279277497610336
31389,0.7621666666666667,3,1,3,571194,34416,81698,26258,0.31879654674126495,0.43277186274186635
31390,0.7622857142857142,0,1,0,571195,34415,81698,26258,0.3187872837081774,0.4327789955993605
31391,0.7623333333333332,3,3,3,571198,34412,81701,26255,0.31875949460891473,0.43277234740468457
31392,0.7623333333333333,2,5,2,571203,34407,81703,26253,0.318713179443477,0.4327893175074184
31393,0.7623333333333335,0,1,0,571204,34406,81703,26253,0.3187039164103894,0.4327964522989169
31394,0.7623778998778996,0,2,0,571206,34404,81703,26253,0.31868539034421434,0.43281072258766506
31395,0.7623809523809524,0,1,0,571207,34403,81703,26253,0.31867612731112677,0.432817858084938
31396,0.7624761904761903,0,1,0,571208,34402,81703,26253,0.3186668642780392,0.4328249938174924
31397,0.7624761904761904,0,1,0,571209,34401,81703,26253,0.3186576012449516,0.4328321297853398
31398,0.7624920634920634,0,1,0,571210,34400,81703,26253,0.3186483382118641,0.43283926598849193
31399,0.7624999999999998,4,1,4,571211,34399,81707,26249,0.31863907517877654,0.43280899617464713
31400,0.7625,47,77,47,571288,34322,81754,26202,0.3179258216310349,0.43291917255964574
31401,0.7625000000000002,1,4,1,571292,34318,81755,26201,0.31788876949868466,0.43293841603463373
31402,0.7625238095238095,0,2,0,571294,34316,81755,26201,0.3178702434325095,0.4329527240279591
31403,0.7625476190476188,0,2,0,571296,34314,81755,26201,0.31785171736633444,0.432967032967033
31404,0.7625714285714286,0,2,0,571298,34312,81755,26201,0.3178331913001593,0.43298134285194917
31405,0.7626190476190476,2,3,2,571301,34309,81757,26199,0.31780540220089665,0.43298406822238383
31406,0.7626428571428572,0,1,0,571302,34308,81757,26199,0.31779613916780913,0.4329912241558828
31407,0.7626666666666665,1,3,1,571305,34305,81758,26198,0.3177683500685464,0.4330033221493149
31408,0.7626666666666666,4,13,4,571318,34292,81762,26194,0.31764793063840824,0.4330588896604173
31409,0.7626666666666668,2,5,2,571323,34287,81764,26192,0.31760161547297044,0.4330759437160006
31410,0.7626904761904761,0,1,0,571324,34286,81764,26192,0.31759235243988293,0.43308310460001986
31411,0.7627518315018313,1,0,1,571324,34286,81765,26191,0.31759235243988293,0.4330737305091192
31412,0.7627738095238092,0,1,0,571325,34285,81765,26191,0.31758308940679536,0.43308089159335933
31413,0.7627777777777777,0,1,0,571326,34284,81765,26191,0.3175738263737078,0.4330880529144274
31414,0.7628333333333334,1,3,1,571329,34281,81766,26190,0.31754603727444514,0.4331001637148385
31415,0.7628333333333335,0,2,0,571331,34279,81766,26190,0.31752751120827005,0.4331144884155518
31416,0.7628571428571428,0,3,0,571334,34276,81766,26190,0.3174997221090074,0.4331359772434095
31417,0.7628571428571429,0,1,0,571335,34275,81766,26190,0.31749045907591983,0.4331431406598859
31418,0.7629166666666667,0,1,0,571336,34274,81766,26190,0.31748119604283226,0.4331503043133104
31419,0.7629166666666669,1,0,1,571336,34274,81767,26189,0.31748119604283226,0.43314092916328994
31420,0.7629761904761905,1,0,1,571336,34274,81768,26188,0.31748119604283226,0.43313155370315237
31421,0.763,10,10,10,571346,34264,81778,26178,0.3173885657119567,0.43310942721948315
31422,0.7630533910533908,1,2,1,571348,34262,81779,26177,0.3173700396457816,0.4331143797878853
31423,0.7630555555555556,0,1,0,571349,34261,81779,26177,0.3173607766126941,0.43312154604718883
31424,0.763095238095238,0,1,0,571350,34260,81779,26177,0.3173515135796065,0.4331287125436405
31425,0.7630952380952383,0,2,0,571352,34258,81779,26177,0.3173329875134314,0.43314304624803507
31426,0.7631190476190476,0,1,0,571353,34257,81779,26177,0.31732372448034385,0.4331502134560016
31427,0.7631666666666667,1,3,1,571356,34254,81780,26176,0.3172959353810812,0.4331623365877875
31428,0.7631666666666668,2,6,2,571362,34248,81782,26174,0.31724035718255583,0.4331865876667439
31429,0.7631746031746032,0,1,0,571363,34247,81782,26174,0.3172310941494683,0.4331937571374191
31430,0.7631904761904762,0,1,0,571364,34246,81782,26174,0.31722183111638075,0.43320092684541545
31431,0.7632142857142857,0,1,0,571365,34245,81782,26174,0.3172125680832932,0.4332080967907446
31432,0.7632795815295818,1,3,1,571368,34242,81783,26173,0.3171847789840305,0.43322022676487626
31433,0.7632857142857141,0,1,0,571369,34241,81783,26173,0.31717551595094295,0.4332273976230675
31434,0.7633095238095238,0,1,0,571370,34240,81783,26173,0.31716625291785544,0.4332345687186533
31435,0.7633333333333333,47,96,47,571466,34144,81830,26126,0.31627700174145024,0.4334826613572258
31436,0.7633333333333334,38,70,38,571536,34074,81868,26088,0.3156285894253214,0.4336292011568764
31437,0.7633518426018425,0,3,0,571539,34071,81868,26088,0.31560080032605875,0.43365082531292076
31438,0.7634999999999998,0,1,0,571540,34070,81868,26088,0.31559153729297124,0.43365803384421026
31439,0.7635,3,13,3,571553,34057,81871,26085,0.315471117862833,0.4337235210002993
31440,0.7635476190476189,0,4,0,571557,34053,81871,26085,0.31543406573048277,0.43375236955003493
31441,0.7635476190476191,0,1,0,571558,34052,81871,26085,0.31542480269739526,0.4337595822871111
31442,0.7635714285714286,0,1,0,571559,34051,81871,26085,0.3154155396643077,0.43376679526406814
31443,0.7636190476190475,0,1,0,571560,34050,81871,26085,0.3154062766312201,0.43377400848091796
31444,0.7636190476190479,0,1,0,571561,34049,81871,26085,0.31539701359813255,0.43378122193767255
31445,0.7636666666666666,2,5,2,571566,34044,81873,26083,0.3153506984326948,0.4337984599264889
31446,0.7636666666666667,2,8,2,571574,34036,81875,26081,0.31527659416799436,0.4338373504998586
31447,0.7636666666666669,0,1,0,571575,34035,81875,26081,0.3152673311349068,0.43384456717013775
31448,0.7636904761904763,0,2,0,571577,34033,81875,26081,0.3152488050687317,0.43385900123099447
31449,0.7636944444444442,0,1,0,571578,34032,81875,26081,0.31523954203564414,0.43386621862159597
31450,0.763702380952381,1,1,1,571579,34031,81876,26080,0.3152302790025566,0.43386401823293574
31451,0.7637380952380952,0,1,0,571580,34030,81876,26080,0.31522101596946905,0.4338712360672101
31452,0.7637489177489176,0,1,0,571581,34029,81876,26080,0.3152117529363815,0.43387845414164267
31453,0.76375,2,2,2,571583,34027,81878,26078,0.3151932268702064,0.43387405373928956
31454,0.7638095238095238,2,2,2,571585,34025,81880,26076,0.31517470080403126,0.43386965275120215
31455,0.7638333333333333,3,4,3,571589,34021,81883,26073,0.31513764867168104,0.4338702699104736
31456,0.7638333333333334,1,0,1,571589,34021,81884,26072,0.31513764867168104,0.43386084901735644
31457,0.7638333333333336,0,1,0,571590,34020,81884,26072,0.3151283856385935,0.43386806896092656
31458,0.7638571428571429,1,3,1,571593,34017,81885,26071,0.3151005965393308,0.4338803088803089
31459,0.7638712121212121,2,1,2,571594,34016,81887,26069,0.3150913335062433,0.43386868602812684
31460,0.7638809523809523,0,1,0,571595,34015,81887,26069,0.31508207047315573,0.43387590706344453
31461,0.7639999999999999,6,2,6,571597,34013,81893,26063,0.31506354440698064,0.4338338105066915
31462,0.764,25,33,25,571630,33980,81918,26038,0.31475786431509134,0.4338365157119531
31463,0.764047619047619,0,3,0,571633,33977,81918,26038,0.3147300752158287,0.4338582021161376
31464,0.7641190476190477,1,1,1,571634,33976,81919,26037,0.3147208121827411,0.4338559978671288
31465,0.7641428571428571,0,1,0,571635,33975,81919,26037,0.31471154914965355,0.4338632273545291
31466,0.7641666666666665,7,16,7,571651,33959,81926,26030,0.3145633406202527,0.4339128840287386
31467,0.7641666666666667,10,15,10,571666,33944,81936,26020,0.3144243951239394,0.4339270228803949
31468,0.7642222222222221,0,1,0,571667,33943,81936,26020,0.3144151320908518,0.43393425946000036
31469,0.7642857142857141,0,1,0,571668,33942,81936,26020,0.3144058690577643,0.43394149628097795
31470,0.7642857142857143,1,3,1,571671,33939,81937,26019,0.3143780799585016,0.43395376763734617
31471,0.7643333333333332,1,2,1,571673,33937,81938,26018,0.3143595538923265,0.4339588024351597
31472,0.7643333333333334,4,7,4,571680,33930,81942,26014,0.3142947126607136,0.4339717069264647
31473,0.764357142857143,0,1,0,571681,33929,81942,26014,0.31428544962762606,0.43397894666599934
31474,0.7643809523809524,0,1,0,571682,33928,81942,26014,0.31427618659453854,0.4339861866470922
31475,0.7644047619047619,1,0,1,571682,33928,81943,26013,0.31427618659453854,0.4339767437980681
31476,0.7644444444444443,0,2,0,571684,33926,81943,26013,0.3142576605283634,0.433991224411485
31477,0.764480158730159,0,1,0,571685,33925,81943,26013,0.31424839749527583,0.43399846508058326
31478,0.7644999999999998,1,2,1,571687,33923,81944,26012,0.31422987142910075,0.43400350379577873
31479,0.7645000000000001,4,6,4,571693,33917,81948,26008,0.31417429323057544,0.43400917813934087
31480,0.7645238095238096,0,2,0,571695,33915,81948,26008,0.3141557671644003,0.4340236637017506
31481,0.7645476190476189,0,1,0,571696,33914,81948,26008,0.31414650413131273,0.4340309068455659
31482,0.7645541125541123,1,0,1,571696,33914,81949,26007,0.31414650413131273,0.43402146159109495
31483,0.7645595238095236,0,2,0,571698,33912,81949,26007,0.31412797806513765,0.4340359485305162
31484,0.7645714285714286,0,3,0,571701,33909,81949,26007,0.314100188965875,0.4340576807530543
31485,0.7646428571428572,0,2,0,571703,33907,81949,26007,0.31408166289969985,0.4340721701104917
31486,0.7646666666666665,0,3,0,571706,33904,81949,26007,0.3140538738004372,0.43409390596050806
31487,0.7646666666666667,3,13,3,571719,33891,81952,26004,0.313933454370299,0.43415977961432506
31488,0.7646666666666668,0,2,0,571721,33889,81952,26004,0.3139149283041239,0.43417427746147297
31489,0.7647142857142858,0,1,0,571722,33888,81952,26004,0.31390566527103636,0.43418152674814664
31490,0.7647222222222222,1,0,1,571722,33888,81953,26003,0.31390566527103636,0.43417207927735385
31491,0.7647222222222223,0,1,0,571723,33887,81953,26003,0.3138964022379488,0.43417932876941057
31492,0.7647857142857142,0,1,0,571724,33886,81953,26003,0.3138871392048612,0.4341865785035649
31493,0.7648333333333333,1,3,1,571727,33883,81954,26002,0.31385935010559857,0.43419888118894545
31494,0.7648333333333334,2,8,2,571735,33875,81956,26000,0.3137852458408981,0.4342379958246347
31495,0.7648690476190477,0,2,0,571737,33873,81956,26000,0.31376671977472304,0.4342525011273863
31496,0.7648849206349204,0,2,0,571739,33871,81956,26000,0.31374819370854795,0.4342670073992417
31497,0.7649047619047619,1,0,1,571739,33871,81957,25999,0.31374819370854795,0.4342575580424253
31498,0.7649761904761904,1,0,1,571739,33871,81958,25998,0.31374819370854795,0.43424810836994104
31499,0.7649999999999999,0,5,0,571744,33866,81958,25998,0.31370187854311016,0.4342843779232928
31500,0.765,191,304,191,572048,33562,82149,25807,0.3108859164844937,0.43468813690646635
31501,0.7650000000000001,0,4,0,572052,33558,82149,25807,0.3108488643521435,0.4347174260928156
31502,0.7650454545454545,1,1,1,572053,33557,82150,25806,0.3108396013190559,0.4347152266563348
31503,0.765142857142857,0,1,0,572054,33556,82150,25806,0.31083033828596834,0.4347225497793201
31504,0.7651666666666667,1,7,1,572061,33549,82151,25805,0.31076549705435547,0.43476429558243757
31505,0.7651666666666668,0,1,0,572062,33548,82151,25805,0.3107562340212679,0.434771620642596
31506,0.7652388167388167,1,0,1,572062,33548,82152,25804,0.3107562340212679,0.4347620973176978
31507,0.7653333333333332,0,1,0,572063,33547,82152,25804,0.3107469709881804,0.4347694225876565
31508,0.7653333333333333,6,15,6,572078,33532,82158,25798,0.31060802549186706,0.4348221810214057
31509,0.7653333333333334,0,3,0,572081,33529,82158,25798,0.3105802363926044,0.4348441687595867
31510,0.7653452380952381,0,1,0,572082,33528,82158,25798,0.31057097335951683,0.4348514984998146
31511,0.7653505106005106,0,1,0,572083,33527,82158,25798,0.31056171032642926,0.4348588284871471
31512,0.7653809523809524,1,0,1,572083,33527,82159,25797,0.31056171032642926,0.43484930213741485
31513,0.7653878066378068,1,0,1,572083,33527,82160,25796,0.31056171032642926,0.4348397754665138
31514,0.7654523809523809,0,1,0,572084,33526,82160,25796,0.31055244729334175,0.4348471056269175
31515,0.7654999999999998,0,1,0,572085,33525,82160,25796,0.3105431842602542,0.4348544360344566
31516,0.7655,4,7,4,572092,33518,82164,25792,0.3104783430286413,0.43486764457932897
31517,0.7655000000000001,0,4,0,572096,33514,82164,25792,0.3104412908962911,0.4348969750109601
31518,0.7655238095238096,1,0,1,572096,33514,82165,25791,0.3104412908962911,0.4348874462524239
31519,0.7655728715728717,1,0,1,572096,33514,82166,25790,0.3104412908962911,0.4348779171725347
31520,0.7655833333333333,0,1,0,572097,33513,82166,25790,0.3104320278632035,0.4348852503246042
31521,0.7656428571428572,0,1,0,572098,33512,82166,25790,0.310422764830116,0.4348925837239891
31522,0.7656666666666665,1,2,1,572100,33510,82167,25789,0.31040423876394085,0.4348977217153746
31523,0.7656666666666666,0,8,0,572108,33502,82167,25789,0.3103301344992404,0.4349564014774586
31524,0.7656666666666667,1,3,1,572111,33499,82168,25788,0.31030234539997775,0.43496888019295965
31525,0.7656904761904761,1,0,1,572111,33499,82169,25787,0.31030234539997775,0.4349593495934959
31526,0.7657142857142856,0,1,0,572112,33498,82169,25787,0.31029308236689024,0.43496668634561864
31527,0.7657142857142857,2,4,2,572116,33494,82171,25785,0.31025603023454,0.43497697329577084
31528,0.7657380952380953,0,1,0,572117,33493,82171,25785,0.31024676720145244,0.4349843112115793
31529,0.7657619047619048,0,2,0,572119,33491,82171,25785,0.31022824113527736,0.4349989877859505
31530,0.7658095238095238,1,0,1,572119,33491,82172,25784,0.31022824113527736,0.4349894559257697
31531,0.7658333333333331,0,1,0,572120,33490,82172,25784,0.3102189781021898,0.43499679454735635
31532,0.7658333333333333,6,16,6,572136,33474,82178,25778,0.3100707695727889,0.4350570444879498
31533,0.7658333333333335,8,22,8,572158,33452,82186,25770,0.30986698284486275,0.43514234574989025
31534,0.7658611111111112,0,1,0,572159,33451,82186,25770,0.3098577198117752,0.4351496935208794
31535,0.7659523809523807,0,1,0,572160,33450,82186,25770,0.3098484567786876,0.4351570415400203
31536,0.765952380952381,0,2,0,572162,33448,82186,25770,0.3098299307125125,0.43517173832280726
31537,0.7659999999999998,0,1,0,572163,33447,82186,25770,0.30982066767942495,0.43517908708647857
31538,0.7659999999999999,16,33,16,572196,33414,82202,25754,0.30951498758753565,0.43526906435911306
31539,0.7660000000000001,2,5,2,572201,33409,82204,25752,0.3094686724220979,0.4352867598586907
31540,0.766010582010582,0,1,0,572202,33408,82204,25752,0.30945940938901034,0.43529411764705883
31541,0.7660238095238096,0,1,0,572203,33407,82204,25752,0.3094501463559228,0.43530147568417316
31542,0.766047619047619,1,0,1,572203,33407,82205,25751,0.3094501463559228,0.43529193008553363
31543,0.7660833333333332,0,1,0,572204,33406,82205,25751,0.3094408833228352,0.4352992883344321
31544,0.766095238095238,0,1,0,572205,33405,82205,25751,0.3094316202897477,0.43530664683210496
31545,0.7660952380952382,0,3,0,572208,33402,82205,25751,0.30940383119048503,0.43532872381789595
31546,0.7661190476190476,0,1,0,572209,33401,82205,25751,0.30939456815739746,0.43533608331079254
31547,0.7661666666666668,0,5,0,572214,33396,82205,25751,0.30934825299195967,0.43537288450809003
31548,0.7661904761904762,0,1,0,572215,33395,82205,25751,0.30933898995887216,0.4353802454942008
31549,0.7662222222222224,1,0,1,572215,33395,82206,25750,0.30933898995887216,0.4353706991292586
31550,0.76625,1,2,1,572217,33393,82207,25749,0.309320463892697,0.4353758750126813
31551,0.7662857142857143,1,0,1,572217,33393,82208,25748,0.309320463892697,0.43536632792817165
31552,0.7663333333333333,1,4,1,572221,33389,82209,25747,0.3092834117603468,0.43538622835497837
31553,0.7663333333333334,1,2,1,572223,33387,82210,25746,0.3092648856941717,0.4353914058140125
31554,0.7663809523809526,0,2,0,572225,33385,82210,25746,0.30924635962799657,0.43540613214726626
31555,0.7663867243867244,1,4,1,572229,33381,82211,25745,0.3092093074956464,0.43542603930588913
31556,0.766388888888889,0,1,0,572230,33380,82211,25745,0.30920004446255883,0.43543340380549683
31557,0.7664206349206348,0,2,0,572232,33378,82211,25745,0.3091815183963837,0.43544813355208634
31558,0.7664523809523809,0,1,0,572233,33377,82211,25745,0.3091722553632962,0.4354554987990934
31559,0.7664642857142856,1,2,1,572235,33375,82212,25744,0.30915372929712104,0.4354606809993403
31560,0.7664761904761904,0,1,0,572236,33374,82212,25744,0.30914446626403347,0.4354680469569336
31561,0.7665,1,0,1,572236,33374,82213,25743,0.30914446626403347,0.43545849755569466
31562,0.7665000000000001,6,8,6,572244,33366,82219,25737,0.3090703619993331,0.4354601289274656
31563,0.7665119047619048,1,0,1,572244,33366,82220,25736,0.3090703619993331,0.4354505769686305
31564,0.7665349095349093,1,3,1,572247,33363,82221,25735,0.3090425729000704,0.4354631290398998
31565,0.766547619047619,1,1,1,572248,33362,82222,25734,0.30903330986698285,0.43546094490320836
31566,0.7665714285714285,0,1,0,572249,33361,82222,25734,0.3090240468338953,0.43546831373212624
31567,0.7665714285714286,1,0,1,572249,33361,82223,25733,0.3090240468338953,0.43545876061867533
31568,0.7665952380952382,1,0,1,572249,33361,82224,25732,0.3090240468338953,0.4354492071818997
31569,0.766617216117216,0,2,0,572251,33359,82224,25732,0.3090055207677202,0.43546394544008393
31570,0.7666666666666666,57,95,57,572346,33264,82281,25675,0.3081255326244025,0.43561987817913433
31571,0.7666666666666667,49,89,49,572435,33175,82330,25626,0.30730112267961024,0.4358089148143739
31572,0.7667857142857142,0,1,0,572436,33174,82330,25626,0.30729185964652267,0.43581632653061225
31573,0.7667857142857143,2,0,2,572436,33174,82332,25624,0.30729185964652267,0.43579713595700537
31574,0.7668214285714285,1,0,1,572436,33174,82333,25623,0.30729185964652267,0.43578754018062144
31575,0.7668214285714287,1,2,1,572438,33172,82334,25622,0.30727333358034753,0.4357927679695207
31576,0.7668333333333333,1,2,1,572440,33170,82335,25621,0.30725480751417245,0.43579799629194943
31577,0.7668333333333334,0,3,0,572443,33167,82335,25621,0.3072270184149098,0.435820235422195
31578,0.7668769841269841,0,1,0,572444,33166,82335,25621,0.3072177553818222,0.43582764897001036
31579,0.7669126984126984,0,2,0,572446,33164,82335,25621,0.30719922931564714,0.43584247682231864
31580,0.7669166666666668,0,1,0,572447,33163,82335,25621,0.30718996628255957,0.43584989112683725
31581,0.7669285714285715,0,2,0,572449,33161,82335,25621,0.30717144021638443,0.43586472049266783
31582,0.7669999999999999,1,2,1,572451,33159,82336,25620,0.30715291415020934,0.43586995355484104
31583,0.767,7,12,7,572463,33147,82343,25613,0.3070417577531587,0.4358917631041525
31584,0.7670000000000001,0,2,0,572465,33145,82343,25613,0.3070232316869836,0.43590659995234693
31585,0.7670714285714285,0,1,0,572466,33144,82343,25613,0.307013968653896,0.43591401875521213
31586,0.7671428571428569,0,1,0,572467,33143,82343,25613,0.3070047056208085,0.43592143781060655
31587,0.7671428571428571,1,1,1,572468,33142,82344,25612,0.30699544258772093,0.4359192565612554
31588,0.7671428571428572,3,2,3,572470,33140,82347,25609,0.3069769165215458,0.4359052920049703
31589,0.7671666666666666,0,2,0,572472,33138,82347,25609,0.3069583904553707,0.4359201320918515
31590,0.7671666666666667,2,8,2,572480,33130,82349,25607,0.30688428619067026,0.43596029759776633
31591,0.7671666666666668,1,0,1,572480,33130,82350,25606,0.30688428619067026,0.4359506946336148
31592,0.7671904761904762,0,1,0,572481,33129,82350,25606,0.3068750231575827,0.43595811696603387
31593,0.7672182539682539,0,1,0,572482,33128,82350,25606,0.3068657601244952,0.43596553955119693
31594,0.76725,0,1,0,572483,33127,82350,25606,0.3068564970914076,0.43597296238911687
31595,0.7672500000000001,0,1,0,572484,33126,82350,25606,0.30684723405832004,0.43598038547980655
31596,0.7673333333333332,3,3,3,572487,33123,82353,25603,0.3068194449590574,0.43597384463440386
31597,0.7673333333333333,8,12,8,572499,33111,82361,25595,0.30670828856200677,0.43598610022825607
31598,0.7673333333333335,0,1,0,572500,33110,82361,25595,0.3066990255289192,0.435993526956818
31599,0.767357142857143,0,1,0,572501,33109,82361,25595,0.30668976249583163,0.4360009539384028
31600,0.7674999999999998,0,1,0,572502,33108,82361,25595,0.30668049946274406,0.43600838117302354
31601,0.7675,41,82,41,572584,33026,82402,25554,0.3059209307495646,0.4362239672243086
31602,0.7675000000000002,1,3,1,572587,33023,82403,25553,0.30589314165030196,0.43623668396612947
31603,0.7675714285714283,1,1,1,572588,33022,82404,25552,0.30588387861721444,0.4362345067777512
31604,0.7676190476190476,0,3,0,572591,33019,82404,25552,0.30585608951795173,0.4362568506598829
31605,0.7676666666666665,0,3,0,572594,33016,82404,25552,0.3058283004186891,0.436279196831034
31606,0.7676666666666666,4,10,4,572604,33006,82408,25548,0.30573567008781355,0.43631519622912185
31607,0.7676666666666668,2,3,2,572607,33003,82410,25546,0.3057078809885509,0.43631829749440637
31608,0.7677142857142857,1,0,1,572607,33003,82411,25545,0.3057078809885509,0.43630866980938715
31609,0.76775,0,1,0,572608,33002,82411,25545,0.3056986179554633,0.43631612208994486
31610,0.7677619047619046,1,1,1,572609,33001,82412,25544,0.30568935492237576,0.436313946536852
31611,0.7677857142857143,0,1,0,572610,33000,82412,25544,0.30568009188928824,0.4363213992894233
31612,0.767797619047619,0,1,0,572611,32999,82412,25544,0.30567082885620067,0.4363288522966025
31613,0.7678095238095238,0,3,0,572614,32996,82412,25544,0.305643039756938,0.4363512128459173
31614,0.7678333333333334,2,6,2,572620,32990,82414,25542,0.3055874615584127,0.4363766828401558
31615,0.7678333333333335,1,2,1,572622,32988,82415,25541,0.30556893549223757,0.4363819644962326
31616,0.7678571428571428,0,2,0,572624,32986,82415,25541,0.3055504094260625,0.436396876655219
31617,0.7679166666666666,0,1,0,572625,32985,82415,25541,0.3055411463929749,0.4364043331169053
31618,0.7679166666666667,0,3,0,572628,32982,82415,25541,0.30551335729371226,0.43642670403089384
31619,0.7679999999999998,0,2,0,572630,32980,82415,25541,0.3054948312275371,0.4364416192477914
31620,0.768,8,18,8,572648,32962,82423,25533,0.30532809663196114,0.4364988460552184
31621,0.7680000000000001,1,1,1,572649,32961,82424,25532,0.30531883359887363,0.4364966748157899
31622,0.7680000000000002,0,1,0,572650,32960,82424,25532,0.30530957056578606,0.4365041373179238
31623,0.7680238095238094,0,1,0,572651,32959,82424,25532,0.3053003075326985,0.43651160007522527
31624,0.7680476190476191,0,1,0,572652,32958,82424,25532,0.305291044499611,0.4365190630877073
31625,0.7681666666666664,0,1,0,572653,32957,82424,25532,0.3052817814665234,0.4365265263553831
31626,0.7681666666666667,2,6,2,572659,32951,82426,25530,0.3052262032679981,0.43655204254373214
31627,0.7681666666666668,1,1,1,572660,32950,82427,25529,0.3052169402349105,0.4365498726038407
31628,0.7682132034632034,1,1,1,572661,32949,82428,25528,0.30520767720182296,0.43654770251551894
31629,0.7682499999999997,0,2,0,572663,32947,82428,25528,0.3051891511356479,0.4365626336041043
31630,0.7682619047619048,0,1,0,572664,32946,82428,25528,0.3051798881025603,0.4365700995314157
31631,0.7682857142857142,0,1,0,572665,32945,82428,25528,0.30517062506947273,0.4365775657140903
31632,0.7682857142857143,0,1,0,572666,32944,82428,25528,0.3051613620363852,0.4365850321521412
31633,0.7683333333333333,20,45,20,572711,32899,82448,25508,0.30474452554744524,0.4367284743267074
31634,0.7683333333333334,19,55,19,572766,32844,82467,25489,0.3042350587276298,0.43695678261018633
31635,0.7683333333333335,0,1,0,572767,32843,82467,25489,0.3042257956945422,0.4369642734691079
31636,0.7683755411255411,0,1,0,572768,32842,82467,25489,0.30421653266145465,0.4369717645848691
31637,0.7684047619047618,0,2,0,572770,32840,82467,25489,0.30419800659527957,0.4369867475869636
31638,0.7684047619047621,0,1,0,572771,32839,82467,25489,0.304188743562192,0.4369942394733233
31639,0.7684285714285712,0,1,0,572772,32838,82467,25489,0.30417948052910443,0.4370017316165755
31640,0.7684444444444444,0,1,0,572773,32837,82467,25489,0.3041702174960169,0.43700922401673353
31641,0.7684523809523809,0,1,0,572774,32836,82467,25489,0.30416095446292934,0.43701671667381053
31642,0.7685,3,6,3,572780,32830,82470,25486,0.30410537626440404,0.43703271829343576
31643,0.7685000000000001,1,1,1,572781,32829,82471,25485,0.30409611323131647,0.4370305586994547
31644,0.7685119047619048,1,1,1,572782,32828,82472,25484,0.3040868501982289,0.437028398957333
31645,0.7685238095238094,0,1,0,572783,32827,82472,25484,0.3040775871651413,0.43703589374217555
31646,0.768547619047619,0,2,0,572785,32825,82472,25484,0.30405906109896624,0.43705088408307463
31647,0.768549062049062,0,1,0,572786,32824,82472,25484,0.3040497980658787,0.43705837963915756
31648,0.7685714285714286,1,2,1,572788,32822,82473,25483,0.3040312719997036,0.43706371666237886
31649,0.7685793650793653,0,2,0,572790,32820,82473,25483,0.30401274593352845,0.43707870950036876
31650,0.7685952380952379,0,1,0,572791,32819,82473,25483,0.30400348290044094,0.43708620630510103
31651,0.7686011904761905,0,1,0,572792,32818,82473,25483,0.30399421986735337,0.43709370336700915
31652,0.7686190476190475,0,1,0,572793,32817,82473,25483,0.3039849568342658,0.43710120068610636
31653,0.7686666666666666,1,3,1,572796,32814,82474,25482,0.30395716773500314,0.43711403869905313
31654,0.7686666666666667,5,3,5,572799,32811,82479,25477,0.3039293786357405,0.43708825144111996
31655,0.76875,1,1,1,572800,32810,82480,25476,0.3039201156026529,0.4370860927152318
31656,0.7687619047619048,0,2,0,572802,32808,82480,25476,0.30390158953647783,0.43710109120856494
31657,0.7688055555555556,0,1,0,572803,32807,82480,25476,0.30389232650339026,0.43710859084124015
31658,0.7688095238095238,0,1,0,572804,32806,82480,25476,0.3038830634703027,0.4371160907312721
31659,0.7688333333333333,0,3,0,572807,32803,82480,25476,0.30385527437104004,0.4371385919456408
31660,0.7688650793650794,1,1,1,572808,32802,82481,25475,0.3038460113379525,0.43713643461399865
31661,0.7689999999999999,2,8,2,572816,32794,82483,25473,0.3037719070732521,0.43717713285393106
31662,0.769,8,11,8,572827,32783,82491,25465,0.303670013709289,0.43718239252849883
31663,0.769047619047619,0,1,0,572828,32782,82491,25465,0.3036607506762014,0.43718989819218157
31664,0.7690555555555556,0,1,0,572829,32781,82491,25465,0.30365148764311384,0.4371974041135872
31665,0.7690952380952382,1,0,1,572829,32781,82492,25464,0.30365148764311384,0.4371877414370332
31666,0.7691071428571429,0,1,0,572830,32780,82492,25464,0.3036422246100263,0.4371952475791498
31667,0.7691428571428572,0,1,0,572831,32779,82492,25464,0.30363296157693875,0.4372027539790189
31668,0.7691666666666666,6,17,6,572848,32762,82498,25458,0.30347549001445034,0.4372724149776709
31669,0.7691666666666667,6,16,6,572864,32746,82504,25452,0.30332728148504945,0.43733461630983883
31670,0.769202380952381,0,1,0,572865,32745,82504,25452,0.30331801845196193,0.4373421310376824
31671,0.7693095238095239,1,1,1,572866,32744,82505,25451,0.30330875541887437,0.4373399776613111
31672,0.7693333333333332,1,1,1,572867,32743,82506,25450,0.3032994923857868,0.4373378241369237
31673,0.7693333333333334,3,11,3,572878,32732,82509,25447,0.3031975990218237,0.4373914986507159
31674,0.7693571428571427,0,2,0,572880,32730,82509,25447,0.3031790729556486,0.4374065352286986
31675,0.7693809523809523,0,3,0,572883,32727,82509,25447,0.30315128385638596,0.43742909203424213
31676,0.7694126984126984,0,1,0,572884,32726,82509,25447,0.3031420208232984,0.43743661148642843
31677,0.7694166666666667,0,1,0,572885,32725,82509,25447,0.3031327577902108,0.43744413119713954
31678,0.7694206349206348,1,0,1,572885,32725,82510,25446,0.3031327577902108,0.4374344604699936
31679,0.7694285714285715,1,0,1,572885,32725,82511,25445,0.3031327577902108,0.43742478941034896
31680,0.7694523809523808,1,0,1,572885,32725,82512,25444,0.3031327577902108,0.4374151180181884
31681,0.7694999999999999,0,2,0,572887,32723,82512,25444,0.30311423172403573,0.43743015799336393
31682,0.7695000000000001,1,7,1,572894,32716,82513,25443,0.30304939049242285,0.4374731339947386
31683,0.7695000000000002,1,0,1,572894,32716,82514,25442,0.30304939049242285,0.4374634616045944
31684,0.7695238095238094,1,0,1,572894,32716,82515,25441,0.30304939049242285,0.4374537888818199
31685,0.7695238095238095,0,3,0,572897,32713,82515,25441,0.3030216013931602,0.4374763558826564
31686,0.7695833333333333,1,2,1,572899,32711,82516,25440,0.30300307532698506,0.43748172860311946
31687,0.7695952380952381,0,1,0,572900,32710,82516,25440,0.3029938122938975,0.43748925193465177
31688,0.7696269841269842,0,2,0,572902,32708,82516,25440,0.3029752862277224,0.43750429937401114
31689,0.7696428571428571,0,2,0,572904,32706,82516,25440,0.3029567601615473,0.43751934784851926
31690,0.7696428571428572,1,0,1,572904,32706,82517,25439,0.3029567601615473,0.43750967409063546
31691,0.7696666666666665,2,1,2,572905,32705,82519,25437,0.30294749712845975,0.43749785009115616
31692,0.7696666666666667,2,5,2,572910,32700,82521,25435,0.30290118196302196,0.43751612625784814
31693,0.7696666666666668,1,0,1,572910,32700,82522,25434,0.30290118196302196,0.4375064506140985
31694,0.7696904761904763,0,1,0,572911,32699,82522,25434,0.30289191892993444,0.4375139765709666
31695,0.7696969696969697,0,1,0,572912,32698,82522,25434,0.3028826558968469,0.43752150278676116
31696,0.7697142857142858,1,2,1,572914,32696,82523,25433,0.30286412983067174,0.43752687987063255
31697,0.7697863247863246,1,0,1,572914,32696,82524,25432,0.30286412983067174,0.4375172034131572
31698,0.7697954545454544,0,1,0,572915,32695,82524,25432,0.3028548667975842,0.43752473033185957
31699,0.7697976190476189,1,0,1,572915,32695,82525,25431,0.3028548667975842,0.43751505350445585
31700,0.7698095238095238,1,0,1,572915,32695,82526,25430,0.3028548667975842,0.43750537634408604
31701,0.7698333333333334,5,6,5,572921,32689,82531,25425,0.30279928859905886,0.4375021509446949
31702,0.7698333333333335,0,5,0,572926,32684,82531,25425,0.3027529734336211,0.4375397959008071
31703,0.7698492063492064,0,1,0,572927,32683,82531,25425,0.30274371040053355,0.4375473256694431
31704,0.7698571428571429,0,2,0,572929,32681,82531,25425,0.30272518433435847,0.4375623859842357
31705,0.7698809523809522,1,0,1,572929,32681,82532,25424,0.30272518433435847,0.43755270630754667
31706,0.7699047619047619,1,0,1,572929,32681,82533,25423,0.30272518433435847,0.43754302629767317
31707,0.7699619130869131,1,4,1,572933,32677,82534,25422,0.30268813220200824,0.4375634692507616
31708,0.7699761904761906,0,2,0,572935,32675,82534,25422,0.3026696061358331,0.4375785324543436
31709,0.7699999999999999,5,9,5,572944,32666,82539,25417,0.30258623883804514,0.4375979202176196
31710,0.77,731,1213,731,574157,31453,83270,24686,0.2913501797028419,0.4397299560020663
31711,0.7700000000000001,3,3,3,574160,31450,83273,24683,0.29132239060357923,0.4397235137975879
31712,0.7700238095238096,0,1,0,574161,31449,83273,24683,0.29131312757049166,0.4397313475379463
31713,0.7700476190476191,0,2,0,574163,31447,83273,24683,0.2912946015043166,0.4397470158560485
31714,0.7700714285714286,0,2,0,574165,31445,83273,24683,0.2912760754381415,0.43976268529076395
31715,0.7701190476190476,0,1,0,574166,31444,83273,24683,0.2912668124050539,0.439770520426889
31716,0.7701666666666666,1,2,1,574168,31442,83274,24682,0.2912482863388788,0.4397762098211104
31717,0.7701666666666667,3,16,3,574184,31426,83277,24679,0.29110007780947794,0.4398716691916941
31718,0.7701666666666668,0,1,0,574185,31425,83277,24679,0.29109081477639037,0.43987950948238985
31719,0.7701825396825396,0,1,0,574186,31424,83277,24679,0.2910815517433028,0.43988735005258184
31720,0.7702142857142856,1,0,1,574186,31424,83278,24678,0.2910815517433028,0.439877366225803
31721,0.7702391774891773,1,1,1,574187,31423,83279,24677,0.2910722887102153,0.4398752228163993
31722,0.7702857142857144,0,2,0,574189,31421,83279,24677,0.29105376264404015,0.43989090520161145
31723,0.7703080808080807,0,1,0,574190,31420,83279,24677,0.29104449961095263,0.4398987468135551
31724,0.7703095238095237,0,1,0,574191,31419,83279,24677,0.29103523657786506,0.439906588705077
31725,0.7703333333333333,2,4,2,574195,31415,83281,24675,0.29099818444551484,0.43991798894633627
31726,0.7703333333333334,1,1,1,574196,31414,83282,24674,0.29098892141242727,0.4399158465268863
31727,0.7703571428571427,0,2,0,574198,31412,83282,24674,0.2909703953462522,0.4399315337160789
31728,0.7704166666666665,0,1,0,574199,31411,83282,24674,0.2909611323131646,0.4399393777302309
31729,0.770436507936508,0,1,0,574200,31410,83282,24674,0.29095186928007705,0.4399472220241067
31730,0.7704523809523809,1,0,1,574200,31410,83283,24673,0.29095186928007705,0.43993723588253125
31731,0.7704642857142858,1,0,1,574200,31410,83284,24672,0.29095186928007705,0.43992724938482936
31732,0.7704999999999999,1,1,1,574201,31409,83285,24671,0.29094260624698953,0.43992510699001425
31733,0.7705,3,2,3,574203,31407,83288,24668,0.2909240801808144,0.43991083370485956
31734,0.7705357142857142,0,3,0,574206,31404,83288,24668,0.29089629108155174,0.4399343700955914
31735,0.7705476190476191,0,2,0,574208,31402,83288,24668,0.29087776501537665,0.43995006242197254
31736,0.7705555555555555,1,1,1,574209,31401,83289,24667,0.2908685019822891,0.43994792038239283
31737,0.7705555555555557,1,0,1,574209,31401,83290,24666,0.2908685019822891,0.4399379314034994
31738,0.7705833333333332,0,1,0,574210,31400,83290,24666,0.2908592389492015,0.43994577818999037
31739,0.7706666666666666,4,10,4,574220,31390,83294,24662,0.290766608618326,0.43998430029258545
31740,0.7706666666666667,2,3,2,574223,31387,83296,24660,0.29073881951906333,0.43998786732563744
31741,0.7707142857142857,0,2,0,574225,31385,83296,24660,0.2907202934528882,0.4400035685609778
31742,0.77075,1,0,1,574225,31385,83297,24659,0.2907202934528882,0.4399935764756263
31743,0.7707693848978677,2,1,2,574226,31384,83299,24657,0.2907110304198007,0.4399814421584197
31744,0.7707857142857142,0,1,0,574227,31383,83299,24657,0.2907017673867131,0.43998929336188436
31745,0.7708095238095238,0,1,0,574228,31382,83299,24657,0.29069250435362554,0.43999714484555397
31746,0.770833333333333,1,1,1,574229,31381,83300,24656,0.290683241320538,0.43999500330139013
31747,0.7708333333333333,8,16,8,574245,31365,83308,24648,0.2905350327911371,0.44004070483637725
31748,0.7708333333333335,5,17,5,574262,31348,83313,24643,0.2903775612286487,0.44012430569198624
31749,0.770892857142857,1,1,1,574263,31347,83314,24642,0.29036829819556115,0.4401221668542035
31750,0.7709047619047618,1,0,1,574263,31347,83315,24641,0.29036829819556115,0.4401121668929056
31751,0.7709166666666667,1,0,1,574263,31347,83316,24640,0.29036829819556115,0.44010216657438334
31752,0.7709523809523811,1,0,1,574263,31347,83317,24639,0.29036829819556115,0.4400921658986175
31753,0.7709761904761905,2,2,2,574265,31345,83319,24637,0.29034977212938606,0.44008788539173305
31754,0.7709999999999998,0,1,0,574266,31344,83319,24637,0.2903405090962985,0.4400957467712259
31755,0.7709999999999999,12,12,12,574278,31332,83331,24625,0.2902293526992478,0.44007005379130404
31756,0.7710000000000001,1,5,1,574283,31327,83332,24624,0.2901830375338101,0.4400993726653679
31757,0.7710714285714285,0,1,0,574284,31326,83332,24624,0.2901737745007225,0.4401072386058981
31758,0.7711111111111112,0,1,0,574285,31325,83332,24624,0.29016451146763494,0.44011510482761085
31759,0.7711190476190477,0,1,0,574286,31324,83332,24624,0.29015524843454743,0.4401229713305212
31760,0.7711666666666664,3,4,3,574290,31320,83335,24621,0.2901181963021972,0.4401244167962675
31761,0.7711666666666666,1,0,1,574290,31320,83336,24620,0.2901181963021972,0.44011440829460136
31762,0.7711666666666668,2,5,2,574295,31315,83338,24618,0.2900718811367594,0.44013373142867357
31763,0.7711904761904762,0,2,0,574297,31313,83338,24618,0.29005335507058433,0.44014946988253384
31764,0.7712142857142859,0,1,0,574298,31312,83338,24618,0.29004409203749676,0.4401573395315573
31765,0.7712261904761903,0,1,0,574299,31311,83338,24618,0.2900348290044092,0.44016520946199644
31766,0.77125,1,0,1,574299,31311,83339,24617,0.2900348290044092,0.4401551995422686
31767,0.7713095238095239,0,1,0,574300,31310,83339,24617,0.2900255659713217,0.44016306971587965
31768,0.7713333333333332,1,6,1,574306,31304,83340,24616,0.2899699877727963,0.4402002861230329
31769,0.7713333333333334,1,2,1,574308,31302,83341,24615,0.2899514617066212,0.44020601963624656
31770,0.7713571428571429,0,1,0,574309,31301,83341,24615,0.28994219867353366,0.4402138922669719
31771,0.7714126984126983,0,1,0,574310,31300,83341,24615,0.2899329356404461,0.44022176517929
31772,0.7714285714285714,2,1,2,574311,31299,83343,24613,0.2899236726073586,0.4402096151094577
31773,0.7714722222222222,1,1,1,574312,31298,83344,24612,0.289914409574271,0.44020747630119833
31774,0.7714761904761903,0,2,0,574314,31296,83344,24612,0.28989588350809586,0.4402232238677828
31775,0.7715,1,0,1,574314,31296,83345,24611,0.28989588350809586,0.44021321122578566
31776,0.7715000000000001,2,6,2,574320,31290,83347,24609,0.28984030530957056,0.4402404336392422
31777,0.7715000000000002,1,0,1,574320,31290,83348,24608,0.28984030530957056,0.4402304196930123
31778,0.7715476190476189,1,1,1,574321,31289,83349,24607,0.289831042276483,0.4402282810934593
31779,0.7715714285714285,0,2,0,574323,31287,83349,24607,0.2898125162103079,0.4402440333488389
31780,0.771595238095238,0,1,0,574324,31286,83349,24607,0.28980325317722033,0.4402519098992718
31781,0.7715952380952382,1,0,1,574324,31286,83350,24606,0.28980325317722033,0.4402418950833751
31782,0.7716190476190475,0,3,0,574327,31283,83350,24606,0.2897754640779577,0.4402655263110809
31783,0.7716190476190478,0,1,0,574328,31282,83350,24606,0.2897662010448701,0.44027340395075865
31784,0.7716428571428573,0,1,0,574329,31281,83350,24606,0.2897569380117826,0.44028128187234955
31785,0.7716666666666666,26,33,26,574362,31248,83376,24580,0.2894512579198933,0.4402808626495665
31786,0.7716666666666667,17,40,17,574402,31208,83393,24563,0.2890807365963911,0.44042602786394364
31787,0.7716666666666668,0,1,0,574403,31207,83393,24563,0.2890714735633036,0.44043392504930967
31788,0.7716969696969699,0,1,0,574404,31206,83393,24563,0.289062210530216,0.4404418225178863
31789,0.7717857142857143,0,3,0,574407,31203,83393,24563,0.28903442143095337,0.44046551662303196
31790,0.771809523809524,1,0,1,574407,31203,83394,24562,0.28903442143095337,0.4404554828297319
31791,0.771833333333333,0,1,0,574408,31202,83394,24562,0.2890251583978658,0.4404633813930134
31792,0.7718333333333333,2,5,2,574413,31197,83396,24560,0.288978843232428,0.44048280933335726
31793,0.7718333333333334,1,7,1,574420,31190,83397,24559,0.28891400200081513,0.4405280812211878
31794,0.7718809523809523,1,0,1,574420,31190,83398,24558,0.28891400200081513,0.4405180454904212
31795,0.7719047619047619,0,1,0,574421,31189,83398,24558,0.2889047389677276,0.4405259475846234
31796,0.7719047619047621,0,1,0,574422,31188,83398,24558,0.28889547593464004,0.44053384996232914
31797,0.7719761904761906,1,0,1,574422,31188,83399,24557,0.28889547593464004,0.4405238137949592
31798,0.772,9,31,9,574453,31157,83408,24548,0.2886083219089259,0.44067857463423393
31799,0.7720476190476191,0,1,0,574454,31156,83408,24548,0.2885990588758383,0.4406864857101824
31800,0.7720595238095238,1,1,1,574455,31155,83409,24547,0.28858979584275074,0.4406843560374852
31801,0.7720793650793651,2,0,2,574455,31155,83411,24545,0.28858979584275074,0.44066427289048477
31802,0.7720833333333332,1,0,1,574455,31155,83412,24544,0.28858979584275074,0.440654230776136
31803,0.7721111111111111,0,2,0,574457,31153,83412,24544,0.28857126977657566,0.44067005404240805
31804,0.7721428571428571,1,0,1,574457,31153,83413,24543,0.28857126977657566,0.44066001149095085
31805,0.7721428571428572,4,1,4,574458,31152,83417,24539,0.2885620067434881,0.4406277495466054
31806,0.7721666666666666,1,1,1,574459,31151,83418,24538,0.2885527437104005,0.4406256172673239
31807,0.7721666666666667,1,4,1,574463,31147,83419,24537,0.2885156915780503,0.4406472236189929
31808,0.7721948051948053,1,3,1,574466,31144,83420,24536,0.28848790247878764,0.4406609195402299
31809,0.7722142857142857,0,1,0,574467,31143,83420,24536,0.2884786394457001,0.44066883385118266
31810,0.7722619047619048,1,0,1,574467,31143,83421,24535,0.2884786394457001,0.4406587880311793
31811,0.7723333333333332,4,4,4,574471,31139,83425,24531,0.2884415873133499,0.4406502604634453
31812,0.7723333333333333,4,0,4,574471,31139,83429,24527,0.2884415873133499,0.44061006718643336
31813,0.7723333333333335,0,1,0,574472,31138,83429,24527,0.28843232428026233,0.44061798257432855
31814,0.7723571428571429,0,1,0,574473,31137,83429,24527,0.28842306124717476,0.44062589824662257
31815,0.7723809523809524,1,1,1,574474,31136,83430,24526,0.28841379821408725,0.4406237648665158
31816,0.7724166666666668,0,1,0,574475,31135,83430,24526,0.2884045351809997,0.4406316810693304
31817,0.7724285714285715,0,1,0,574476,31134,83430,24526,0.2883952721479121,0.4406395975565936
31818,0.7724523809523811,0,1,0,574477,31133,83430,24526,0.28838600911482454,0.44064751432832067
31819,0.7724602064602065,1,1,1,574478,31132,83431,24525,0.288376746081737,0.44064538153332017
31820,0.7724841269841269,1,1,1,574479,31131,83432,24524,0.28836748304864945,0.4406432485850328
31821,0.7724999999999999,6,4,6,574483,31127,83438,24518,0.28833043091629923,0.4406146104771318
31822,0.7725,51,87,51,574570,31040,83489,24467,0.28752454703768204,0.44079125155385807
31823,0.7725000000000002,0,1,0,574571,31039,83489,24467,0.2875152840045945,0.440799192880049
31824,0.7725555555555558,1,0,1,574571,31039,83490,24466,0.2875152840045945,0.4407891180974687
31825,0.7725714285714287,0,2,0,574573,31037,83490,24466,0.28749675793841933,0.44080500153144875
31826,0.7725714285714288,0,1,0,574574,31036,83490,24466,0.2874874949053318,0.4408129436777053
31827,0.7726190476190474,0,1,0,574575,31035,83490,24466,0.28747823187224425,0.4408208861101602
31828,0.7726666666666665,3,2,3,574577,31033,83493,24463,0.28745970580606917,0.4408065446158282
31829,0.7726666666666666,2,18,2,574595,31015,83495,24461,0.2872929712104932,0.44092941091643234
31830,0.7726666666666668,1,2,1,574597,31013,83496,24460,0.28727444514431805,0.4409352297514106
31831,0.7727142857142857,1,1,1,574598,31012,83497,24459,0.2872651821112305,0.44093310017847165
31832,0.7727261904761904,0,1,0,574599,31011,83497,24459,0.28725591907814296,0.4409410492157923
31833,0.77275,1,0,1,574599,31011,83498,24458,0.28725591907814296,0.44093097045196417
31834,0.7727777777777777,1,0,1,574599,31011,83499,24457,0.28725591907814296,0.4409208913247278
31835,0.7727857142857144,0,1,0,574600,31010,83499,24457,0.2872466560450554,0.44092884057187154
31836,0.7728095238095238,2,0,2,574600,31010,83501,24455,0.2872466560450554,0.44090868115027493
31837,0.7728333333333333,0,4,0,574604,31006,83501,24455,0.28720960391270517,0.44094048069814823
31838,0.7728333333333335,1,0,1,574604,31006,83502,24454,0.28720960391270517,0.4409304002884962
31839,0.7728571428571428,0,2,0,574606,31004,83502,24454,0.2871910778465301,0.44094630170579535
31840,0.7728571428571429,0,1,0,574607,31003,83502,24454,0.2871818148134425,0.4409542528445462
31841,0.7729166666666666,0,1,0,574608,31002,83502,24454,0.28717255178035495,0.44096220427005195
31842,0.7729285714285714,0,1,0,574609,31001,83502,24454,0.28716328874726743,0.440970155982328
31843,0.7729523809523811,0,1,0,574610,31000,83502,24454,0.28715402571417986,0.44097810798139
31844,0.773,8,13,8,574623,30987,83510,24446,0.2870336062840416,0.4410008478704021
31845,0.7730000000000001,0,2,0,574625,30985,83510,24446,0.28701508021786654,0.44101675957496705
31846,0.7730476190476189,1,1,1,574626,30984,83511,24445,0.28700581718477897,0.4410146313301701
31847,0.7730595238095238,2,4,2,574630,30980,83513,24443,0.28696876505242874,0.44102628872489763
31848,0.7730952380952381,0,2,0,574632,30978,83513,24443,0.28695023898625366,0.4410422042186175
31849,0.7731666666666664,1,0,1,574632,30978,83514,24442,0.28695023898625366,0.44103211836881995
31850,0.7731666666666667,2,8,2,574640,30970,83516,24440,0.2868761347215532,0.44107561811947305
31851,0.7731666666666668,1,4,1,574644,30966,83517,24439,0.286839082589203,0.4410973738832235
31852,0.7732023809523809,0,1,0,574645,30965,83517,24439,0.2868298195561155,0.441105335354848
31853,0.7732142857142859,0,1,0,574646,30964,83517,24439,0.2868205565230279,0.4411132971138747
31854,0.7732499999999999,1,0,1,574646,30964,83518,24438,0.2868205565230279,0.44110320927042346
31855,0.7733143800643799,0,1,0,574647,30963,83518,24438,0.28681129348994033,0.4411111712784968
31856,0.7733333333333331,1,0,1,574647,30963,83519,24437,0.28681129348994033,0.44110108303249096
31857,0.7733333333333333,54,98,54,574745,30865,83573,24383,0.28590351624736005,0.44133724297712135
31858,0.7733333333333334,42,84,42,574829,30781,83615,24341,0.28512542146800546,0.441584122491927
31859,0.7733809523809524,0,1,0,574830,30780,83615,24341,0.28511615843491794,0.44159213366956335
31860,0.7734166666666666,0,1,0,574831,30779,83615,24341,0.2851068954018304,0.441600145137881
31861,0.7734444444444444,1,1,1,574832,30778,83616,24340,0.2850976323687428,0.441598026053195
31862,0.773452380952381,2,2,2,574834,30776,83618,24338,0.2850791063025677,0.4415937874224335
31863,0.7734761904761903,1,0,1,574834,30776,83619,24337,0.2850791063025677,0.4415836553989077
31864,0.7734999999999999,0,2,0,574836,30774,83619,24337,0.2850605802363926,0.44159968064451743
31865,0.7735,6,4,6,574840,30770,83625,24331,0.2850235281040424,0.4415709333768897
31866,0.7735000000000001,1,3,1,574843,30767,83626,24330,0.2849957390047797,0.4415848412799245
31867,0.7735476190476192,0,1,0,574844,30766,83626,24330,0.2849864759716922,0.4415928561057064
31868,0.7735714285714286,0,2,0,574846,30764,83626,24330,0.28496794990551705,0.44160888663012304
31869,0.7736616161616162,0,4,0,574850,30760,83626,24330,0.2849308977731668,0.4416409511708114
31870,0.7736666666666666,0,2,0,574852,30758,83626,24330,0.28491237170699174,0.44165698518733665
31871,0.7736666666666667,0,8,0,574860,30750,83626,24330,0.2848382674422913,0.4417211328976035
31872,0.7737499999999998,1,0,1,574860,30750,83627,24329,0.2848382674422913,0.44171099693168
31873,0.77375,0,1,0,574861,30749,83627,24329,0.2848290044092037,0.44171901666727187
31874,0.7737777777777777,0,2,0,574863,30747,83627,24329,0.28481047834302864,0.4417350570121287
31875,0.773809523809524,0,1,0,574864,30746,83627,24329,0.28480121530994107,0.44174307762142534
31876,0.7738333333333332,0,1,0,574865,30745,83627,24329,0.28479195227685355,0.44175109852198857
31877,0.7738333333333333,0,5,0,574870,30740,83627,24329,0.28474563711141576,0.4417912073943598
31878,0.7738333333333334,0,6,0,574876,30734,83627,24329,0.28469005891289045,0.44183934765632094
31879,0.7738968253968254,0,1,0,574877,30733,83627,24329,0.2846807958798029,0.4418473720533217
31880,0.7739285714285714,1,1,1,574878,30732,83628,24328,0.2846715328467153,0.4418452597166727
31881,0.7739444444444444,0,1,0,574879,30731,83628,24328,0.2846622698136278,0.44185328465827567
31882,0.773952380952381,0,1,0,574880,30730,83628,24328,0.28465300678054023,0.4418613098913873
31883,0.7739527417027418,0,1,0,574881,30729,83628,24328,0.28464374374745266,0.4418693354160234
31884,0.7739999999999999,0,1,0,574882,30728,83628,24328,0.2846344807143651,0.44187736123219995
31885,0.774,16,35,16,574917,30693,83644,24312,0.2843102745563007,0.4419961821652577
31886,0.7740238095238096,0,3,0,574920,30690,83644,24312,0.28428248545703805,0.4420202901712665
31887,0.774047619047619,0,1,0,574921,30689,83644,24312,0.2842732224239505,0.4420283267576953
31888,0.7740595238095238,1,1,1,574922,30688,83645,24311,0.28426395939086296,0.44202621865852104
31889,0.7740714285714287,1,0,1,574922,30688,83646,24310,0.28426395939086296,0.4420160733117568
31890,0.7741190476190476,0,1,0,574923,30687,83646,24310,0.2842546963577754,0.44202411040602213
31891,0.7741428571428571,0,1,0,574924,30686,83646,24310,0.2842454333246878,0.4420321477925667
31892,0.7741666666666666,13,17,13,574941,30669,83659,24297,0.2840879617621994,0.4420368955354219
31893,0.7741666666666667,14,21,14,574962,30648,83673,24283,0.2838934380673608,0.44206367988931566
31894,0.7741666666666669,1,0,1,574962,30648,83674,24282,0.2838934380673608,0.44205352266521025
31895,0.7741785714285712,0,1,0,574963,30647,83674,24282,0.2838841750342732,0.4420615703908682
31896,0.7742857142857144,1,5,1,574968,30642,83675,24281,0.2838378598688355,0.442091655590554
31897,0.7742857142857145,0,1,0,574969,30641,83675,24281,0.2838285968357479,0.4420997050362332
31898,0.7743095238095237,0,1,0,574970,30640,83675,24281,0.28381933380266033,0.4421077547750405
31899,0.7743333333333332,1,3,1,574973,30637,83676,24280,0.2837915447033977,0.4421217473642042
31900,0.7743333333333333,0,9,0,574982,30628,83676,24280,0.2837081774056097,0.44219421577912144
31901,0.774357142857143,1,0,1,574982,30628,83677,24279,0.2837081774056097,0.4421840566776549
31902,0.7743809523809526,0,1,0,574983,30627,83677,24279,0.28369891437252215,0.44219211015189597
31903,0.7744246031746033,0,1,0,574984,30626,83677,24279,0.2836896513394346,0.4422001639194973
31904,0.7744285714285714,0,1,0,574985,30625,83677,24279,0.283680388306347,0.442208217980475
31905,0.774452380952381,0,2,0,574987,30623,83677,24279,0.2836618622401719,0.4422243269826236
31906,0.7744761904761905,1,0,1,574987,30623,83678,24278,0.2836618622401719,0.44221416731935664
31907,0.7744999999999999,2,2,2,574989,30621,83680,24276,0.28364333617399684,0.442209956828242
31908,0.7745000000000001,2,5,2,574994,30616,83682,24274,0.28359702100855905,0.44222991437420295
31909,0.7745833333333333,0,1,0,574995,30615,83682,24274,0.2835877579754715,0.442237971178196
31910,0.7745833333333334,0,1,0,574996,30614,83682,24274,0.2835784949423839,0.44224602827576154
31911,0.7746428571428571,1,1,1,574997,30613,83683,24273,0.2835692319092964,0.4422439237692672
31912,0.7746666666666665,0,1,0,574998,30612,83683,24273,0.2835599688762088,0.44225198141568733
31913,0.7746666666666667,5,4,5,575002,30608,83688,24268,0.2835229167438586,0.4422333989357825
31914,0.7746969696969697,2,0,2,575002,30608,83690,24266,0.2835229167438586,0.44221306994204906
31915,0.7747251637251636,0,1,0,575003,30607,83690,24266,0.28351365371077103,0.44222112878829295
31916,0.7747499999999999,0,1,0,575004,30606,83690,24266,0.2835043906776835,0.44222918792826943
31917,0.7747619047619047,1,0,1,575004,30606,83691,24265,0.2835043906776835,0.4422190227989284
31918,0.7748333333333332,0,3,0,575007,30603,83691,24265,0.28347660157842086,0.4422432018662973
31919,0.7748333333333334,1,11,1,575018,30592,83692,24264,0.28337470821445776,0.4423217150357299
31920,0.7748571428571429,0,1,0,575019,30591,83692,24264,0.2833654451813702,0.4423297785069729
31921,0.7749386724386724,0,1,0,575020,30590,83692,24264,0.2833561821482826,0.4423378422722135
31922,0.774952380952381,0,1,0,575021,30589,83692,24264,0.2833469191151951,0.44234590633146775
31923,0.7749523809523811,0,2,0,575023,30587,83692,24264,0.28332839304901997,0.44236203533208146
31924,0.7749761904761904,0,1,0,575024,30586,83692,24264,0.2833191300159324,0.4423701002734731
31925,0.7749999999999999,1,7,1,575031,30579,83693,24263,0.2832542887843195,0.442416396192699
31926,0.775,188,305,188,575336,30274,83881,24075,0.2804290636926155,0.4429704318386723
31927,0.7750000000000001,4,4,4,575340,30270,83885,24071,0.2803920115602653,0.44296203603172557
31928,0.7750238095238094,0,1,0,575341,30269,83885,24071,0.28038274852717776,0.44297018770702984
31929,0.7750238095238096,1,1,1,575342,30268,83886,24070,0.2803734854940902,0.44296808863042436
31930,0.7750476190476189,0,1,0,575343,30267,83886,24070,0.2803642224610026,0.44297624086718074
31931,0.7750714285714285,0,1,0,575344,30266,83886,24070,0.28035495942791505,0.4429843934040047
31932,0.7751363636363636,0,1,0,575345,30265,83886,24070,0.28034569639482754,0.44299254624091283
31933,0.7751666666666666,0,1,0,575346,30264,83886,24070,0.28033643336173997,0.44300069937792175
31934,0.7751666666666667,1,3,1,575349,30261,83887,24069,0.2803086442624773,0.44301490889011597
31935,0.7751666666666668,0,1,0,575350,30260,83887,24069,0.28029938122938974,0.4430230631890887
31936,0.7752857142857144,0,1,0,575351,30259,83887,24069,0.2802901181963022,0.44303121778824917
31937,0.7753333333333333,4,9,4,575360,30250,83891,24065,0.2802067508985142,0.4430636104206941
31938,0.7753333333333334,1,3,1,575363,30247,83892,24064,0.28017896179925156,0.44307782953729447
31939,0.775357142857143,0,1,0,575364,30246,83892,24064,0.280169698766164,0.4430859878475419
31940,0.7753809523809524,0,1,0,575365,30245,83892,24064,0.2801604357330764,0.44309414645822975
31941,0.7753809523809525,0,1,0,575366,30244,83892,24064,0.2801511726999889,0.44310230536937467
31942,0.7754047619047619,0,1,0,575367,30243,83892,24064,0.28014190966690133,0.44311046458099324
31943,0.7754300144300145,0,2,0,575369,30241,83892,24064,0.2801233836007262,0.4431267839057177
31944,0.775452380952381,0,1,0,575370,30240,83892,24064,0.2801141205676387,0.4431349440188568
31945,0.7755,3,1,3,575371,30239,83895,24061,0.2801048575345511,0.44311233885819523
31946,0.7755000000000001,1,2,1,575373,30237,83896,24060,0.280086331468376,0.44311840433173105
31947,0.775515873015873,1,1,1,575374,30236,83897,24059,0.28007706843528846,0.4431163090523989
31948,0.7755238095238094,2,2,2,575376,30234,83899,24057,0.2800585423691133,0.4431121180306128
31949,0.7755357142857143,1,0,1,575376,30234,83900,24056,0.2800585423691133,0.4431018603794437
31950,0.775547619047619,1,1,1,575377,30233,83901,24055,0.2800492793360258,0.4430997642204539
31951,0.7756013708513708,0,1,0,575378,30232,83901,24055,0.28004001630293823,0.44310792639121704
31952,0.7756666666666664,0,2,0,575380,30230,83901,24055,0.28002149023676315,0.44312425163488994
31953,0.7756666666666665,0,1,0,575381,30229,83901,24055,0.2800122272036756,0.4431324147078329
31954,0.7756666666666666,12,6,12,575387,30223,83913,24043,0.27995664900515027,0.4430582685290974
31955,0.7756666666666667,1,5,1,575392,30218,83914,24042,0.2799103338397125,0.4430888315517877
31956,0.7757142857142856,0,1,0,575393,30217,83914,24042,0.2799010708066249,0.44309699773309497
31957,0.7757142857142857,2,6,2,575399,30211,83916,24040,0.2798454926080996,0.44312547234152366
31958,0.77575,1,0,1,575399,30211,83917,24039,0.2798454926080996,0.44311520737327187
31959,0.7757738095238095,0,1,0,575400,30210,83917,24039,0.27983622957501203,0.443123375546093
31960,0.7757857142857142,0,1,0,575401,30209,83917,24039,0.27982696654192446,0.44313154402005606
31961,0.7758095238095238,0,1,0,575402,30208,83917,24039,0.27981770350883695,0.4431397127951776
31962,0.7758333333333332,0,2,0,575404,30206,83917,24039,0.2797991774426618,0.443156051248963
31963,0.7758333333333333,5,17,5,575421,30189,83922,24034,0.2796417058801734,0.44324364199693855
31964,0.7758333333333334,8,18,8,575439,30171,83930,24026,0.2794749712845974,0.443308670221599
31965,0.775904761904762,0,2,0,575441,30169,83930,24026,0.27945644521842233,0.4433250299843159
31966,0.7759523809523808,1,0,1,575441,30169,83931,24025,0.27945644521842233,0.4433147580913016
31967,0.7759523809523811,0,1,0,575442,30168,83931,24025,0.27944718218533476,0.44332293838687653
31968,0.7759999999999999,17,26,17,575468,30142,83948,24008,0.27920634332505834,0.44336103416435824
31969,0.7760000000000001,2,5,2,575473,30137,83950,24006,0.2791600281596206,0.44338141588016916
31970,0.7761428571428571,0,1,0,575474,30136,83950,24006,0.27915076512653303,0.443389605112482
31971,0.7761666666666668,1,0,1,575474,30136,83951,24005,0.27915076512653303,0.44337932435677213
31972,0.7761904761904762,3,4,3,575478,30132,83954,24002,0.2791137129941828,0.44338123914730115
31973,0.7762142857142859,0,1,0,575479,30131,83954,24002,0.27910444996109524,0.4433894297378678
31974,0.776238095238095,0,2,0,575481,30129,83954,24002,0.27908592389492015,0.44340581182686445
31975,0.77625,1,3,1,575484,30126,83955,24001,0.2790581347956575,0.4434201045688843
31976,0.7762500000000001,0,1,0,575485,30125,83955,24001,0.27904887176256993,0.44342829693677716
31977,0.7762857142857144,2,0,2,575485,30125,83957,23999,0.27904887176256993,0.44340773039686643
31978,0.7763095238095238,0,1,0,575486,30124,83957,23999,0.27903960872948236,0.443415922990226
31979,0.7763095238095239,1,0,1,575486,30124,83958,23998,0.27903960872948236,0.44340563911163666
31980,0.7763333333333332,3,5,3,575491,30119,83961,23995,0.2789932935640446,0.4434157519311084
31981,0.7763333333333334,0,2,0,575493,30117,83961,23995,0.2789747674978695,0.4434321407451212
31982,0.7764166666666666,1,0,1,575493,30117,83962,23994,0.2789747674978695,0.4434218550756778
31983,0.7764285714285714,2,0,2,575493,30117,83964,23992,0.2789747674978695,0.4434012825962409
31984,0.7764675324675325,1,1,1,575494,30116,83965,23991,0.27896550446478197,0.4433991904929122
31985,0.7764722222222221,1,0,1,575494,30116,83966,23990,0.27896550446478197,0.44338890326396335
31986,0.7764761904761904,0,1,0,575495,30115,83966,23990,0.2789562414316944,0.4433970982349136
31987,0.7765,1,2,1,575497,30113,83967,23989,0.2789377153655193,0.44340320136039335
31988,0.7765000000000001,1,9,1,575506,30104,83968,23988,0.2788543480677313,0.44346668638615694
31989,0.7765476190476189,0,2,0,575508,30102,83968,23988,0.2788358220015562,0.44348308374930673
31990,0.7765873015873015,0,1,0,575509,30101,83968,23988,0.27882655896846864,0.44349128288561446
31991,0.7766428571428571,1,0,1,575509,30101,83969,23987,0.27882655896846864,0.4434809939358083
31992,0.7766666666666666,75,84,75,575593,30017,84044,23912,0.2780484641891141,0.443397800812179
31993,0.7766666666666667,51,70,51,575663,29947,84095,23861,0.2774000518729853,0.44344707106749925
31994,0.7766904761904762,1,0,1,575663,29947,84096,23860,0.2774000518729853,0.4434367275633282
31995,0.7767619047619049,0,1,0,575664,29946,84096,23860,0.27739078883989776,0.44344496896256924
31996,0.7767857142857143,1,0,1,575664,29946,84097,23859,0.27739078883989776,0.44343462503484804
31997,0.7768333333333333,1,4,1,575668,29942,84098,23858,0.27735373670754754,0.44345724907063194
31998,0.7768333333333334,6,5,6,575673,29937,84104,23852,0.27730742154210974,0.44343639034003235
31999,0.776904761904762,0,2,0,575675,29935,84104,23852,0.27728889547593466,0.4434528789484448
32000,0.776952380952381,0,1,0,575676,29934,84104,23852,0.2772796324428471,0.44346112371249025
32001,0.777,3,8,3,575684,29926,84107,23849,0.27720552817814664,0.4434960483496048
32002,0.7770000000000001,0,1,0,575685,29925,84107,23849,0.2771962651450591,0.44350429575631345
32003,0.7770238095238095,0,1,0,575686,29924,84107,23849,0.27718700211197156,0.4435125434697711
32004,0.7770714285714289,0,1,0,575687,29923,84107,23849,0.277177739078884,0.4435207914899948
32005,0.7770833333333335,1,1,1,575688,29922,84108,23848,0.2771684760457964,0.4435186907197322
32006,0.7771428571428572,1,0,1,575688,29922,84109,23847,0.2771684760457964,0.44350834123751603
32007,0.7771666666666667,3,5,3,575693,29917,84112,23844,0.2771221608803587,0.44351853574152267
32008,0.7771666666666668,1,0,1,575693,29917,84113,23843,0.2771221608803587,0.4435081845238095
32009,0.7772142857142856,0,1,0,575694,29916,84113,23843,0.2771128978472711,0.4435164344574862
32010,0.7772380952380952,1,1,1,575695,29915,84114,23842,0.27710363481418354,0.4435143330170955
32011,0.7772738095238095,0,1,0,575696,29914,84114,23842,0.277094371781096,0.44352258352555995
32012,0.7772857142857142,0,1,0,575697,29913,84114,23842,0.27708510874800846,0.44353083434099155
32013,0.7773225108225106,0,3,0,575700,29910,84114,23842,0.2770573196487458,0.4435555886292603
32014,0.7773333333333332,0,3,0,575703,29907,84114,23842,0.27702953054948315,0.44358034568084986
32015,0.7773333333333333,2,13,2,575716,29894,84116,23840,0.2769091111193449,0.4436669520229278
32016,0.7773333333333334,0,5,0,575721,29889,84116,23840,0.27686279595390717,0.4437082394982226
32017,0.7773809523809523,0,2,0,575723,29887,84116,23840,0.27684426988773203,0.4437247566400506
32018,0.7773888888888891,1,1,1,575724,29886,84117,23839,0.27683500685464446,0.44372266170311775
32019,0.7774047619047618,0,1,0,575725,29885,84117,23839,0.27682574382155695,0.44373092100364825
32020,0.7774761904761905,0,2,0,575727,29883,84117,23839,0.2768072177553818,0.4437474405271583
32021,0.7774999999999999,0,3,0,575730,29880,84117,23839,0.27677942865611915,0.4437722221188034
32022,0.7775,41,103,41,575833,29777,84158,23798,0.27582533624810107,0.4441997200186654
32023,0.7775000000000002,3,1,3,575834,29776,84161,23795,0.2758160732150135,0.4441768867484273
32024,0.7775555555555556,0,3,0,575837,29773,84161,23795,0.27578828411575085,0.44420176224611707
32025,0.7775714285714286,0,1,0,575838,29772,84161,23795,0.27577902108266333,0.444210054697855
32026,0.7775952380952381,0,1,0,575839,29771,84161,23795,0.27576975804957576,0.4442183474592092
32027,0.7776071428571428,0,1,0,575840,29770,84161,23795,0.2757604950164882,0.44422664053019695
32028,0.7776190476190475,0,1,0,575841,29769,84161,23795,0.2757512319834006,0.4442349339108356
32029,0.7776190476190478,1,0,1,575841,29769,84162,23794,0.2757512319834006,0.4442245579971249
32030,0.7776587301587302,1,1,1,575842,29768,84163,23793,0.2757419689503131,0.4442224753085267
32031,0.7776666666666665,1,2,1,575844,29766,84164,23792,0.27572344288413797,0.44422868665745546
32032,0.7776666666666666,1,9,1,575853,29757,84165,23791,0.27564007558635,0.44429297079255997
32033,0.7776666666666668,0,1,0,575854,29756,84165,23791,0.27563081255326244,0.4443012680448951
32034,0.7777142857142857,0,1,0,575855,29755,84165,23791,0.27562154952017487,0.4443095656071415
32035,0.7777380952380952,0,1,0,575856,29754,84165,23791,0.27561228648708735,0.44431786347931645
32036,0.7777380952380953,0,1,0,575857,29753,84165,23791,0.2756030234539998,0.44432616166143735
32037,0.77775,2,2,2,575859,29751,84167,23789,0.27558449738782465,0.4443220022413149
32038,0.7778333333333332,1,1,1,575860,29750,84168,23788,0.27557523435473713,0.44431992229818074
32039,0.7778333333333333,1,5,1,575865,29745,84169,23787,0.27552891918929934,0.44435104236718226
32040,0.7778333333333336,1,1,1,575866,29744,84170,23786,0.27551965615621177,0.4443489631982066
32041,0.7778571428571428,1,1,1,575867,29743,84171,23785,0.27551039312312425,0.4443468838738604
32042,0.7779166666666666,1,0,1,575867,29743,84172,23784,0.27551039312312425,0.44433650307321537
32043,0.7779166666666667,0,1,0,575868,29742,84172,23784,0.2755011300900367,0.4443448043941262
32044,0.7779761904761905,0,1,0,575869,29741,84172,23784,0.2754918670569491,0.4443531060252219
32045,0.7779999999999998,0,1,0,575870,29740,84172,23784,0.2754826040238616,0.4443614079665197
32046,0.778,4,29,4,575899,29711,84176,23780,0.2752139760643225,0.44456076723187077
32047,0.7780000000000001,0,2,0,575901,29709,84176,23780,0.2751954499981474,0.4445773897436856
32048,0.7780198412698414,0,1,0,575902,29708,84176,23780,0.27518618696505986,0.44458570146574933
32049,0.7780476190476192,0,2,0,575904,29706,84176,23780,0.2751676608988847,0.4446023258422765
32050,0.778063492063492,1,3,1,575907,29703,84177,23779,0.27513987179962207,0.4446168804457575
32051,0.778095238095238,1,0,1,575907,29703,84178,23778,0.27513987179962207,0.44460649576485106
32052,0.7781190476190477,0,2,0,575909,29701,84178,23778,0.275121345733447,0.44462312309504665
32053,0.7781428571428571,0,1,0,575910,29700,84178,23778,0.2751120827003594,0.44463143722652304
32054,0.7781666666666667,2,6,2,575916,29694,84180,23776,0.27505650450183405,0.4446605573218627
32055,0.7781904761904762,0,1,0,575917,29693,84180,23776,0.27504724146874654,0.4446688735528998
32056,0.7782142857142857,1,1,1,575918,29692,84181,23775,0.27503797843565897,0.4446668038229188
32057,0.7782380952380954,0,2,0,575920,29690,84181,23775,0.2750194523694839,0.44468343776302255
32058,0.7782846320346318,2,1,2,575921,29689,84183,23773,0.2750101893363963,0.44467098125771576
32059,0.778285714285714,0,1,0,575922,29688,84183,23773,0.27500092630330875,0.44467929892819064
32060,0.7783095238095238,0,1,0,575923,29687,84183,23773,0.2749916632702212,0.44468761690983916
32061,0.7783293650793648,0,1,0,575924,29686,84183,23773,0.27498240023713366,0.4446959352026787
32062,0.7783333333333331,0,2,0,575926,29684,84183,23773,0.2749638741709585,0.4447125727220009
32063,0.7783333333333333,15,46,15,575972,29638,84198,23758,0.27453777464893103,0.4449396958573676
32064,0.7783333333333334,23,45,23,576017,29593,84221,23735,0.2741209381599911,0.44507575757575757
32065,0.7783968253968254,0,1,0,576018,29592,84221,23735,0.27411167512690354,0.4450841037373188
32066,0.7784285714285715,0,1,0,576019,29591,84221,23735,0.274102412093816,0.44509245021190413
32067,0.7784523809523809,0,1,0,576020,29590,84221,23735,0.27409314906072846,0.4451007969995312
32068,0.778452380952381,0,2,0,576022,29588,84221,23735,0.2740746229945533,0.44511749151398083
32069,0.7784761904761904,2,0,2,576022,29588,84223,23733,0.2740746229945533,0.44509667860692786
32070,0.7784999999999997,0,1,0,576023,29587,84223,23733,0.2740653599614658,0.4451050262565641
32071,0.7785,0,6,0,576029,29581,84223,23733,0.27400978176294044,0.4451551187305398
32072,0.7785238095238094,1,0,1,576029,29581,84224,23732,0.27400978176294044,0.44514471142122936
32073,0.7785714285714284,0,1,0,576030,29580,84224,23732,0.2740005187298529,0.4451530612244898
32074,0.7785714285714286,1,1,1,576031,29579,84225,23731,0.27399125569676536,0.4451510035640593
32075,0.7786666666666666,2,1,2,576032,29578,84227,23729,0.2739819926636778,0.44513853715271917
32076,0.7786666666666667,5,1,5,576033,29577,84232,23724,0.2739727296305902,0.44509483874598976
32077,0.7786666666666668,0,1,0,576034,29576,84232,23724,0.2739634665975027,0.4451031894934334
32078,0.7786785714285713,0,1,0,576035,29575,84232,23724,0.27395420356441513,0.4451115405542318
32079,0.7786904761904764,0,2,0,576037,29573,84232,23724,0.27393567749824005,0.44512824361596337
32080,0.7787142857142857,1,0,1,576037,29573,84233,23723,0.27393567749824005,0.4451178324827379
32081,0.77875,1,1,1,576038,29572,84234,23722,0.2739264144651525,0.44511577288250087
32082,0.7787738095238094,1,3,1,576041,29569,84235,23721,0.2738986253658898,0.44513041846500284
32083,0.7787857142857143,1,2,1,576043,29567,84236,23720,0.2738800992997147,0.4451367125190009
32084,0.7788095238095238,0,1,0,576044,29566,84236,23720,0.27387083626662717,0.4451450662462936
32085,0.7788333333333332,0,2,0,576046,29564,84236,23720,0.27385231020045203,0.44516177464154344
32086,0.7788333333333333,1,7,1,576053,29557,84237,23719,0.27378746896883915,0.44520985058938356
32087,0.7788333333333334,1,1,1,576054,29556,84238,23718,0.2737782059357516,0.4452077936704584
32088,0.7788571428571427,1,1,1,576055,29555,84239,23717,0.27376894290266407,0.4452057365970867
32089,0.7788571428571429,0,1,0,576056,29554,84239,23717,0.2737596798695765,0.44521409397233014
32090,0.778857142857143,0,2,0,576058,29552,84239,23717,0.27374115380340136,0.4452308096641574
32091,0.7788809523809523,0,1,0,576059,29551,84239,23717,0.27373189077031385,0.44523916798077645
32092,0.7789047619047618,0,1,0,576060,29550,84239,23717,0.2737226277372263,0.4452475266112227
32093,0.7789047619047619,2,3,2,576063,29547,84241,23715,0.2736948386379636,0.4452517742480568
32094,0.7789166666666667,1,0,1,576063,29547,84242,23714,0.2736948386379636,0.4452413585925912
32095,0.7789285714285714,0,1,0,576064,29546,84242,23714,0.27368557560487605,0.4452497183627488
32096,0.7789523809523808,0,1,0,576065,29545,84242,23714,0.2736763125717885,0.4452580784468353
32097,0.778952380952381,0,1,0,576066,29544,84242,23714,0.27366704953870097,0.4452664388448684
32098,0.7789999999999999,1,2,1,576068,29542,84243,23713,0.27364852347252583,0.44527274434325415
32099,0.779,10,20,10,576088,29522,84253,23703,0.27346326281077477,0.44533583842179425
32100,0.779047619047619,0,1,0,576089,29521,84253,23703,0.2734539997776872,0.4453442056215241
32101,0.7790793650793648,2,0,2,576089,29521,84255,23701,0.2734539997776872,0.44532336251925897
32102,0.779083333333333,1,0,1,576089,29521,84256,23700,0.2734539997776872,0.4453129403806768
32103,0.7791190476190476,0,3,0,576092,29518,84256,23700,0.27342621067842454,0.44533804351911005
32104,0.7791309523809522,1,0,1,576092,29518,84257,23699,0.27342621067842454,0.4453276208730293
32105,0.7791666666666666,2,18,2,576110,29500,84259,23697,0.27325947608284856,0.445457450608117
32106,0.7791666666666667,3,15,3,576125,29485,84262,23694,0.27312053058653524,0.445551815566295
32107,0.7791879113075939,2,1,2,576126,29484,84264,23692,0.2731112675534477,0.44553934105611553
32108,0.779190476190476,1,0,1,576126,29484,84265,23691,0.2731112675534477,0.4455289139633286
32109,0.7792142857142855,0,1,0,576127,29483,84265,23691,0.27310200452036015,0.44553729266182723
32110,0.7792142857142857,1,3,1,576130,29480,84266,23690,0.2730742154210975,0.4455520030092157
32111,0.7792380952380953,0,1,0,576131,29479,84266,23690,0.27306495238800993,0.44556038292990274
32112,0.7792763347763347,1,0,1,576131,29479,84267,23689,0.27306495238800993,0.4455499548600662
32113,0.7792857142857144,1,0,1,576131,29479,84268,23688,0.27306495238800993,0.44553952639795363
32114,0.7793333333333332,0,3,0,576134,29476,84268,23688,0.2730371632887473,0.44556466782032955
32115,0.7793333333333333,6,5,6,576139,29471,84274,23682,0.2729908481233095,0.44554399563524166
32116,0.7793333333333335,0,2,0,576141,29469,84274,23682,0.2729723220571344,0.4455607608511599
32117,0.7793571428571429,1,1,1,576142,29468,84275,23681,0.27296305902404683,0.44555871229938476
32118,0.7793928571428572,0,1,0,576143,29467,84275,23681,0.27295379599095926,0.4455670956574095
32119,0.7794166666666666,1,1,1,576144,29466,84276,23680,0.27294453295787174,0.44556504722838974
32120,0.7794444444444444,1,1,1,576145,29465,84277,23679,0.2729352699247842,0.44556299864519044
32121,0.7795000000000001,2,5,2,576150,29460,84279,23677,0.2728889547593464,0.44558405630728115
32122,0.7795411255411255,0,1,0,576151,29459,84279,23677,0.27287969172625887,0.44559244203553144
32123,0.779559523809524,0,1,0,576152,29458,84279,23677,0.2728704286931713,0.44560082807942036
32124,0.7795714285714284,0,1,0,576153,29457,84279,23677,0.2728611656600837,0.4456092144389656
32125,0.7795714285714286,0,3,0,576156,29454,84279,23677,0.2728333765608211,0.4456343754117182
32126,0.7795833333333333,0,1,0,576157,29453,84279,23677,0.2728241135277335,0.44564276303406736
32127,0.7796428571428572,1,0,1,576157,29453,84280,23676,0.2728241135277335,0.44563232885994464
32128,0.7796666666666665,0,3,0,576160,29450,84280,23676,0.27279632442847085,0.4456574935060046
32129,0.7796666666666667,4,13,4,576173,29437,84284,23672,0.27267590499833266,0.44572483006646707
32130,0.7797499999999999,0,1,0,576174,29436,84284,23672,0.2726666419652451,0.44573322286661143
32131,0.779762348762349,0,1,0,576175,29435,84284,23672,0.2726573789321575,0.44574161598282713
32132,0.7797857142857144,0,1,0,576176,29434,84284,23672,0.27264811589907,0.445750009415132
32133,0.7798095238095237,1,0,1,576176,29434,84285,23671,0.27264811589907,0.4457395725449581
32134,0.7798095238095238,0,2,0,576178,29432,84285,23671,0.27262958983289487,0.44575636028096344
32135,0.7798333333333332,0,2,0,576180,29430,84285,23671,0.2726110637667198,0.4457731492815578
32136,0.7798333333333334,2,7,2,576187,29423,84287,23669,0.2725462225351069,0.44581104497852786
32137,0.7798373015873018,1,1,1,576188,29422,84288,23668,0.27253695950201934,0.4458090035788284
32138,0.7798809523809525,0,1,0,576189,29421,84288,23668,0.27252769646893177,0.4458174009681855
32139,0.7799038461538461,0,1,0,576190,29420,84288,23668,0.27251843343584425,0.44582579867389993
32140,0.7799166666666667,0,1,0,576191,29419,84288,23668,0.2725091704027567,0.4458341966959896
32141,0.7799523809523811,1,0,1,576191,29419,84289,23667,0.2725091704027567,0.4458237576762235
32142,0.779969763399431,0,1,0,576192,29418,84289,23667,0.2724999073696691,0.44583215597626447
32143,0.7799999999999998,2,7,2,576199,29411,84291,23665,0.27243506613805624,0.44587007310272064
32144,0.78,789,1138,789,577337,28273,85080,22876,0.2618937344844196,0.4472423703298207
32145,0.7800000000000001,3,7,3,577344,28266,85083,22873,0.26182889325280667,0.4472711629089345
32146,0.7800238095238095,0,1,0,577345,28265,85083,22873,0.26181963021971916,0.44727990926512573
32147,0.7800497835497834,0,4,0,577349,28261,85083,22873,0.26178257808736893,0.447314898110846
32148,0.7800714285714285,1,0,1,577349,28261,85084,22872,0.26178257808736893,0.4473040893356541
32149,0.7800833333333332,1,0,1,577349,28261,85085,22871,0.26178257808736893,0.4472932801376829
32150,0.7801190476190477,0,1,0,577350,28260,85085,22871,0.26177331505428136,0.4473020281238388
32151,0.7801666666666666,1,3,1,577353,28257,85086,22870,0.2617455259550187,0.44731746435347275
32152,0.7801666666666667,3,5,3,577358,28252,85089,22867,0.2616992107895809,0.44732878186193
32153,0.7801666666666668,0,4,0,577362,28248,85089,22867,0.26166215865723075,0.44736378753790473
32154,0.7802142857142857,0,1,0,577363,28247,85089,22867,0.2616528956241432,0.4473725398129671
32155,0.7802500000000001,0,1,0,577364,28246,85089,22867,0.2616436325910556,0.4473812924304971
32156,0.780309523809524,0,1,0,577365,28245,85089,22867,0.26163436955796804,0.44739004539051497
32157,0.7803333333333332,0,1,0,577366,28244,85089,22867,0.2616251065248805,0.4473987986930406
32158,0.7803333333333333,3,3,3,577369,28241,85092,22864,0.26159731742561787,0.44739262303101457
32159,0.7803333333333334,2,1,2,577370,28240,85094,22862,0.2615880543925303,0.44737975030331495
32160,0.7803571428571427,1,0,1,577370,28240,85095,22861,0.2615880543925303,0.44736893602864913
32161,0.7803809523809524,0,1,0,577371,28239,85095,22861,0.26157879135944273,0.44737769080234835
32162,0.7803888888888888,0,1,0,577372,28238,85095,22861,0.26156952832635516,0.4473864459187068
32163,0.7804166666666665,0,1,0,577373,28237,85095,22861,0.26156026529326765,0.44739520137774474
32164,0.7804166666666668,1,0,1,577373,28237,85096,22860,0.26156026529326765,0.4473843865588978
32165,0.7804761904761905,0,2,0,577375,28235,85096,22860,0.2615417392270925,0.4474018984245034
32166,0.7804920634920636,1,3,1,577378,28232,85097,22859,0.26151395012782985,0.44741735334990507
32167,0.7805,1,8,1,577386,28224,85098,22858,0.2614398458631294,0.44747660624094593
32168,0.7805000000000001,1,0,1,577386,28224,85099,22857,0.2614398458631294,0.4474657896282375
32169,0.7805555555555556,0,1,0,577387,28223,85099,22857,0.2614305828300419,0.4474745497259201
32170,0.780642857142857,2,1,2,577388,28222,85101,22855,0.2614213197969543,0.4474616755095248
32171,0.7806547619047619,2,2,2,577390,28220,85103,22853,0.2614027937307792,0.44745756074638265
32172,0.7806666666666665,1,0,1,577390,28220,85104,22852,0.2614027937307792,0.44744674185463656
32173,0.7806666666666666,2,6,2,577396,28214,85106,22850,0.2613472155322539,0.44747767507441644
32174,0.7806666666666667,0,3,0,577399,28211,85106,22850,0.2613194264329912,0.4475039658447739
32175,0.7807142857142857,1,1,1,577400,28210,85107,22849,0.26131016339990365,0.44750190955561214
32176,0.7807777777777777,0,1,0,577401,28209,85107,22849,0.26130090036681614,0.4475106741352971
32177,0.7808333333333333,10,16,10,577417,28193,85117,22839,0.26115269183741524,0.4475427182944035
32178,0.7808333333333334,13,13,13,577430,28180,85130,22826,0.26103227240727706,0.4475159785123319
32179,0.7808809523809523,0,1,0,577431,28179,85130,22826,0.2610230093741895,0.44752475247524753
32180,0.7809484126984129,0,1,0,577432,28178,85130,22826,0.2610137463411019,0.44753352678221314
32181,0.7809523809523811,0,2,0,577434,28176,85130,22826,0.26099522027492683,0.4475510764283754
32182,0.7809999999999999,7,14,7,577448,28162,85137,22819,0.2608655378117011,0.447598124791589
32183,0.7810000000000001,1,0,1,577448,28162,85138,22818,0.2608655378117011,0.44758728913299334
32184,0.781047619047619,0,1,0,577449,28161,85138,22818,0.2608562747786135,0.4475960689695757
32185,0.7810714285714286,0,1,0,577450,28160,85138,22818,0.26084701174552594,0.447604849150614
32186,0.7810833333333334,0,1,0,577451,28159,85138,22818,0.2608377487124384,0.44761362967612844
32187,0.7811251803751803,1,1,1,577452,28158,85139,22817,0.26082848567935085,0.447611574301128
32188,0.7811666666666666,1,5,1,577457,28153,85140,22816,0.26078217051391306,0.44764464674606136
32189,0.7811666666666668,2,3,2,577460,28150,85142,22814,0.2607543814146504,0.4476493210893964
32190,0.7811904761904762,0,1,0,577461,28149,85142,22814,0.26074511838156283,0.4476581048996331
32191,0.7811904761904763,0,1,0,577462,28148,85142,22814,0.2607358553484753,0.4476668890545897
32192,0.7812499999999999,0,1,0,577463,28147,85142,22814,0.26072659231538775,0.4476756735542866
32193,0.78125,1,2,1,577465,28145,85143,22813,0.26070806624921267,0.4476824051179403
32194,0.7813333333333332,3,5,3,577470,28140,85146,22810,0.2606617510837749,0.447693817468106
32195,0.7813333333333334,1,5,1,577475,28135,85147,22809,0.2606154359183371,0.44772691582914576
32196,0.7813809523809523,0,1,0,577476,28134,85147,22809,0.26060617288524957,0.44773570461103585
32197,0.7813809523809525,1,0,1,577476,28134,85148,22808,0.26060617288524957,0.44772486357033486
32198,0.7813888888888889,0,2,0,577478,28132,85148,22808,0.2605876468190744,0.4477424420887318
32199,0.7814242424242426,0,1,0,577479,28131,85148,22808,0.2605783837859869,0.4477512318655647
32200,0.7814285714285714,3,1,3,577480,28130,85151,22805,0.26056912075289934,0.4477274958280161
32201,0.7814404761904763,0,1,0,577481,28129,85151,22805,0.26055985771981177,0.44773628617426475
32202,0.7814999999999999,0,2,0,577483,28127,85151,22805,0.2605413316536367,0.4477538679023011
32203,0.7815000000000001,4,2,4,577485,28125,85155,22801,0.26052280558746155,0.4477280760318894
32204,0.7815048840048838,0,1,0,577486,28124,85155,22801,0.260513542554374,0.4477368679430535
32205,0.7815476190476189,0,1,0,577487,28123,85155,22801,0.26050427952128646,0.447745660199513
32206,0.7815555555555556,1,1,1,577488,28122,85156,22800,0.2604950164881989,0.4477436078708613
32207,0.7815595238095238,0,1,0,577489,28121,85156,22800,0.2604857534551113,0.4477524007776752
32208,0.7816111111111109,0,1,0,577490,28120,85156,22800,0.2604764904220238,0.44776119402985076
32209,0.7816666666666666,26,57,26,577547,28063,85182,22774,0.2599484975360332,0.44798080138481816
32210,0.7816666666666667,19,43,19,577590,28020,85201,22755,0.2595501871132684,0.4481536189069424
32211,0.7816666666666668,1,1,1,577591,28019,85202,22754,0.2595409240801808,0.44815157662537175
32212,0.7817142857142858,0,1,0,577592,28018,85202,22754,0.25953166104709324,0.4481604033719373
32213,0.7817500000000002,1,0,1,577592,28018,85203,22753,0.25953166104709324,0.4481495341828997
32214,0.7817857142857144,0,1,0,577593,28017,85203,22753,0.25952239801400573,0.44815836123695096
32215,0.7818333333333333,0,2,0,577595,28015,85203,22753,0.2595038719478306,0.4481760163882761
32216,0.7818333333333334,4,6,4,577601,28009,85207,22749,0.2594482937493053,0.4481855077032192
32217,0.781886002886003,1,3,1,577604,28006,85208,22748,0.2594205046500426,0.4482011270047681
32218,0.7819047619047618,0,1,0,577605,28005,85208,22748,0.25941124161695506,0.4482099580320375
32219,0.7819047619047619,1,1,1,577606,28004,85209,22747,0.2594019785838675,0.4482079170853776
32220,0.7819999999999999,1,0,1,577606,28004,85210,22746,0.2594019785838675,0.44819704433497537
32221,0.782,12,17,12,577623,27987,85222,22734,0.2592445070213791,0.4482167149701307
32222,0.7820000000000001,0,1,0,577624,27986,85222,22734,0.2592352439882915,0.4482255520504732
32223,0.7820357142857142,1,0,1,577624,27986,85223,22733,0.2592352439882915,0.44821467300222795
32224,0.782047619047619,0,2,0,577626,27984,85223,22733,0.2592167179221164,0.4482323481278467
32225,0.7820476190476191,1,0,1,577626,27984,85224,22732,0.2592167179221164,0.4482214685700765
32226,0.7821190476190476,0,1,0,577627,27983,85224,22732,0.25920745488902885,0.4482303066153998
32227,0.782142857142857,1,1,1,577628,27982,85225,22731,0.2591981918559413,0.4482282649419281
32228,0.7821428571428573,1,0,1,577628,27982,85226,22730,0.2591981918559413,0.44821738444549614
32229,0.7821666666666666,0,2,0,577630,27980,85226,22730,0.2591796657897662,0.44823506211792546
32230,0.7821666666666667,1,1,1,577631,27979,85227,22729,0.25917040275667863,0.4482330204307013
32231,0.7821904761904763,0,1,0,577632,27978,85227,22729,0.2591611397235911,0.4482418600982113
32232,0.7822619047619048,0,1,0,577633,27977,85227,22729,0.25915187669050355,0.4482507001143849
32233,0.7823333333333332,2,5,2,577638,27972,85229,22727,0.25910556152506575,0.44827314148208053
32234,0.7823333333333333,2,7,2,577645,27965,85231,22725,0.2590407202934529,0.4483132767804301
32235,0.7823333333333334,1,3,1,577648,27962,85232,22724,0.2590129311941902,0.4483289271199148
32236,0.7823452380952384,0,3,0,577651,27959,85232,22724,0.25898514209492757,0.44835546435688495
32237,0.7823809523809524,1,2,1,577653,27957,85233,22723,0.2589666160287524,0.44836227308603
32238,0.7824047619047618,0,2,0,577655,27955,85233,22723,0.25894808996257734,0.44837996763881766
32239,0.7824523809523809,0,1,0,577656,27954,85233,22723,0.2589388269294898,0.44838881543895653
32240,0.7824761904761905,2,0,2,577656,27954,85235,22721,0.2589388269294898,0.4483670448939319
32241,0.7824999999999999,1,1,1,577657,27953,85236,22720,0.25892956389640226,0.44836500700570325
32242,0.7825,26,82,26,577739,27871,85262,22694,0.2581699951832228,0.4488084643528132
32243,0.7825000000000002,0,2,0,577741,27869,85262,22694,0.25815146911704767,0.448826216798845
32244,0.782547619047619,1,0,1,577741,27869,85263,22693,0.25815146911704767,0.4488153158498477
32245,0.7825714285714285,0,1,0,577742,27868,85263,22693,0.25814220608396016,0.4488241925594826
32246,0.7825833333333334,0,2,0,577744,27866,85263,22693,0.258123680017785,0.4488419470321802
32247,0.7826031746031749,0,1,0,577745,27865,85263,22693,0.25811441698469745,0.4488508247952846
32248,0.7826190476190475,0,1,0,577746,27864,85263,22693,0.25810515395160993,0.4488597029095872
32249,0.7826190476190478,1,0,1,577746,27864,85264,22692,0.25810515395160993,0.44884880132921906
32250,0.7826666666666665,1,9,1,577755,27855,85265,22691,0.2580217866538219,0.4489178174336248
32251,0.7826666666666666,6,21,6,577776,27834,85271,22685,0.2578272629589833,0.44903897543498483
32252,0.7826666666666668,1,0,1,577776,27834,85272,22684,0.2578272629589833,0.4490280692030563
32253,0.7827380952380952,0,1,0,577777,27833,85272,22684,0.2578179999258957,0.4490369578557713
32254,0.7828095238095237,0,1,0,577778,27832,85272,22684,0.2578087368928082,0.44904584686040067
32255,0.7828333333333332,0,2,0,577780,27830,85272,22684,0.25779021082663306,0.449063625925486
32256,0.7828333333333333,1,4,1,577784,27826,85273,22683,0.25775315869428284,0.4490882812964026
32257,0.7828571428571428,1,5,1,577789,27821,85274,22682,0.2577068435288451,0.44912183434647446
32258,0.7828571428571429,0,1,0,577790,27820,85274,22682,0.25769758049575753,0.44913072749594074
32259,0.7828809523809523,0,1,0,577791,27819,85274,22682,0.25768831746266996,0.449139620997604
32260,0.7828968253968255,0,1,0,577792,27818,85274,22682,0.25767905442958244,0.44914851485148516
32261,0.7829047619047619,0,3,0,577795,27815,85274,22682,0.25765126533031973,0.44917519852664517
32262,0.7829166666666666,0,1,0,577796,27814,85274,22682,0.2576420022972322,0.4491840937896071
32263,0.7829166666666667,1,0,1,577796,27814,85275,22681,0.2576420022972322,0.44917318546390733
32264,0.7829653679653679,0,3,0,577799,27811,85275,22681,0.25761421319796957,0.4491998732472471
32265,0.7829761904761904,0,1,0,577800,27810,85275,22681,0.257604950164882,0.44920876987978053
32266,0.7829920634920636,0,1,0,577801,27809,85275,22681,0.2575956871317944,0.4492176668647257
32267,0.7829999999999999,6,11,6,577812,27798,85281,22675,0.2574937937678313,0.44925009410972205
32268,0.7830000000000001,3,1,3,577813,27797,85284,22672,0.2574845307347438,0.4492262577027482
32269,0.7830277777777778,0,1,0,577814,27796,85284,22672,0.25747526770165624,0.44923515891257826
32270,0.783047619047619,0,1,0,577815,27795,85284,22672,0.25746600466856867,0.44924406047516197
32271,0.7830833333333335,0,2,0,577817,27793,85284,22672,0.2574474786023936,0.44926186465867435
32272,0.7830873015873016,0,1,0,577818,27792,85284,22672,0.257438215569306,0.4492707672796449
32273,0.7830952380952381,0,1,0,577819,27791,85284,22672,0.25742895253621845,0.449279670253453
32274,0.783107142857143,0,1,0,577820,27790,85284,22672,0.25741968950313093,0.4492885735801197
32275,0.7831190476190477,0,1,0,577821,27789,85284,22672,0.25741042647004336,0.4492974772596659
32276,0.7831309523809523,0,4,0,577825,27785,85284,22672,0.25737337433769314,0.4493330955070654
32277,0.783142857142857,1,0,1,577825,27785,85285,22671,0.25737337433769314,0.4493221817028698
32278,0.7831583694083694,0,5,0,577830,27780,85285,22671,0.25732705917225535,0.44936671225545577
32279,0.7831666666666667,1,4,1,577834,27776,85286,22670,0.2572900070399051,0.4493914284581533
32280,0.7831839826839826,0,1,0,577835,27775,85286,22670,0.2572807440068176,0.4494003370006938
32281,0.7832142857142856,0,1,0,577836,27774,85286,22670,0.25727148097373004,0.4494092458964396
32282,0.7832142857142859,0,1,0,577837,27773,85286,22670,0.25726221794064247,0.44941815514541167
32283,0.7832817460317462,0,1,0,577838,27772,85286,22670,0.25725295490755495,0.44942706474763094
32284,0.7832857142857143,0,2,0,577840,27770,85286,22670,0.2572344288413798,0.44944488501189533
32285,0.7833181818181818,0,1,0,577841,27769,85286,22670,0.25722516580829224,0.4494537956739824
32286,0.7833333333333333,45,83,45,577924,27686,85331,22625,0.2564563340620253,0.4497028482836755
32287,0.7833333333333334,36,108,36,578032,27578,85367,22589,0.2554559264885694,0.4502760778998146
32288,0.7833333333333335,0,1,0,578033,27577,85367,22589,0.25544666345548184,0.450285053621975
32289,0.7834444444444444,0,1,0,578034,27576,85367,22589,0.2554374004223943,0.45029402970198346
32290,0.783452380952381,1,2,1,578036,27574,85368,22588,0.2554188743562192,0.4503010246800367
32291,0.7835,3,5,3,578041,27569,85371,22585,0.25537255919078145,0.45031303584958327
32292,0.7835000000000001,0,1,0,578042,27568,85371,22585,0.2553632961576939,0.45032201463521626
32293,0.7835714285714286,1,0,1,578042,27568,85372,22584,0.2553632961576939,0.4503110543946403
32294,0.7836190476190475,1,0,1,578042,27568,85373,22583,0.2553632961576939,0.4503000937169747
32295,0.783654761904762,1,0,1,578042,27568,85374,22582,0.2553632961576939,0.45028913260219344
32296,0.7836666666666666,0,3,0,578045,27565,85374,22582,0.2553355070584312,0.45031607075198915
32297,0.7836666666666667,1,5,1,578050,27560,85375,22581,0.25528919189299343,0.45035001296344307
32298,0.7836904761904762,0,1,0,578051,27559,85375,22581,0.2552799288599059,0.45035899481451935
32299,0.78375,2,4,2,578055,27555,85377,22579,0.2552428767275557,0.45037300035903777
32300,0.7838095238095238,0,2,0,578057,27553,85377,22579,0.25522435066138055,0.45039096784488947
32301,0.7838333333333333,1,5,1,578062,27548,85378,22578,0.2551780354959428,0.45042492917847027
32302,0.7838333333333334,2,1,2,578063,27547,85380,22576,0.25516877246285524,0.4504119865131776
32303,0.7838571428571428,0,1,0,578064,27546,85380,22576,0.2551595094297677,0.45042097282630383
32304,0.7838888888888889,0,1,0,578065,27545,85380,22576,0.2551502463966801,0.4504299594980148
32305,0.7839000721500717,1,1,1,578066,27544,85381,22575,0.2551409833635926,0.4504279814042579
32306,0.7839679487179487,0,1,0,578067,27543,85381,22575,0.255131720330505,0.4504369687537412
32307,0.7839999999999998,1,0,1,578067,27543,85382,22574,0.255131720330505,0.4504260031526229
32308,0.7839999999999999,1,2,1,578069,27541,85383,22573,0.25511319426432993,0.45043301273097336
32309,0.784,25,26,25,578095,27515,85408,22548,0.2548723554040535,0.45039250544314163
32310,0.784047619047619,1,3,1,578098,27512,85409,22547,0.25484456630479085,0.4504085179488204
32311,0.7841111111111111,0,1,0,578099,27511,85409,22547,0.2548353032717033,0.4504175156818091
32312,0.7841190476190476,0,1,0,578100,27510,85409,22547,0.2548260402386157,0.4504265137742973
32313,0.7841547619047617,0,1,0,578101,27509,85409,22547,0.2548167772055282,0.4504355122263065
32314,0.7841619769119766,0,2,0,578103,27507,85409,22547,0.25479825113935306,0.4504535102089743
32315,0.7841666666666666,12,19,12,578122,27488,85421,22535,0.25462225351068957,0.45049277332427085
32316,0.7841666666666667,4,20,4,578142,27468,85425,22531,0.25443699284893845,0.4506290125802516
32317,0.7842261904761904,1,0,1,578142,27468,85426,22530,0.25443699284893845,0.45061802472098883
32318,0.7842500000000001,1,1,1,578143,27467,85427,22529,0.2544277298158509,0.4506160492839427
32319,0.7842784580830241,3,4,3,578147,27463,85430,22526,0.2543906776835007,0.4506191362099662
32320,0.7842857142857143,6,6,6,578153,27457,85436,22520,0.25433509948497535,0.4506072793485003
32321,0.7843333333333332,1,3,1,578156,27454,85437,22519,0.2543073103857127,0.45062333660176496
32322,0.7843333333333333,2,9,2,578165,27445,85439,22517,0.25422394308792473,0.4506825187142228
32323,0.784357142857143,0,1,0,578166,27444,85439,22517,0.25421468005483716,0.4506915394007326
32324,0.7844047619047619,0,1,0,578167,27443,85439,22517,0.2542054170217496,0.4507005604483587
32325,0.7844285714285713,0,1,0,578168,27442,85439,22517,0.254196153988662,0.45070958185712284
32326,0.7844444444444444,0,1,0,578169,27441,85439,22517,0.2541868909555745,0.45071860362704674
32327,0.784452380952381,0,2,0,578171,27439,85439,22517,0.25416836488939937,0.4507366482504604
32328,0.7844999999999999,0,2,0,578173,27437,85439,22517,0.2541498388232243,0.4507546943187733
32329,0.7845,1,5,1,578178,27432,85440,22516,0.2541035236577865,0.4507888203731881
32330,0.7845833333333333,0,2,0,578180,27430,85440,22516,0.2540849975916114,0.45080687142113485
32331,0.7845887445887447,0,2,0,578182,27428,85440,22516,0.25406647152543627,0.45082492391478457
32332,0.784642857142857,0,1,0,578183,27427,85440,22516,0.25405720849234875,0.45083395070380233
32333,0.7846428571428571,0,2,0,578185,27425,85440,22516,0.2540386824261736,0.4508520053663323
32334,0.7846666666666664,0,1,0,578186,27424,85440,22516,0.2540294193930861,0.45086103323988785
32335,0.7846666666666665,1,0,1,578186,27424,85441,22515,0.2540294193930861,0.45085003704519516
32336,0.7846666666666667,5,12,5,578198,27412,85446,22510,0.2539182629960354,0.4509034093185369
32337,0.7846666666666668,0,1,0,578199,27411,85446,22510,0.25390899996294786,0.45091244165781935
32338,0.7847103174603176,0,2,0,578201,27409,85446,22510,0.2538904738967728,0.4509305074220237
32339,0.7847619047619047,0,1,0,578202,27408,85446,22510,0.2538812108636852,0.45093954084698906
32340,0.7847619047619048,0,1,0,578203,27407,85446,22510,0.25387194783059763,0.45094857463389226
32341,0.7847936507936508,0,1,0,578204,27406,85446,22510,0.2538626847975101,0.45095760878275504
32342,0.7848095238095237,1,2,1,578206,27404,85447,22509,0.253844158731335,0.45096467854066075
32343,0.7848174603174605,0,1,0,578207,27403,85447,22509,0.2538348956982474,0.4509737137361757
32344,0.7848214285714286,0,2,0,578209,27401,85447,22509,0.2538163696320723,0.45099178521338407
32345,0.7848333333333332,0,1,0,578210,27400,85447,22509,0.25380710659898476,0.4510008214951211
32346,0.7848333333333334,1,1,1,578211,27399,85448,22508,0.25379784356589724,0.4509988578756487
32347,0.7848809523809525,0,1,0,578212,27398,85448,22508,0.25378858053280967,0.4510078948423035
32348,0.7849761904761904,1,0,1,578212,27398,85449,22507,0.25378858053280967,0.4509968940987877
32349,0.7849999999999998,2,0,2,578212,27398,85451,22505,0.25378858053280967,0.45097489128910084
32350,0.785,181,311,181,578523,27087,85632,22324,0.2509077772425803,0.45180223027261135
32351,0.7850000000000001,2,8,2,578531,27079,85634,22322,0.2508336729778799,0.45185320135219936
32352,0.7850595238095238,1,1,1,578532,27078,85635,22321,0.2508244099447923,0.4518512520496366
32353,0.7851190476190477,0,1,0,578533,27077,85635,22321,0.25081514691170476,0.4518603992064456
32354,0.7851666666666666,0,1,0,578534,27076,85635,22321,0.25080588387861724,0.4518695467336073
32355,0.7851666666666667,0,6,0,578540,27070,85635,22321,0.2507503056800919,0.4519244396752445
32356,0.7851666666666668,1,0,1,578540,27070,85636,22320,0.2507503056800919,0.4519133427819397
32357,0.7851904761904761,0,1,0,578541,27069,85636,22320,0.2507410426470043,0.4519224928627832
32358,0.7852142857142858,0,1,0,578542,27068,85636,22320,0.2507317796139168,0.4519316433141654
32359,0.7852272727272728,0,1,0,578543,27067,85636,22320,0.2507225165808292,0.4519407941361087
32360,0.7852380952380952,0,1,0,578544,27066,85636,22320,0.25071325354774165,0.45194994532863564
32361,0.7852619047619048,0,1,0,578545,27065,85636,22320,0.25070399051465414,0.4519590968917688
32362,0.7853095238095237,0,1,0,578546,27064,85636,22320,0.25069472748156657,0.45196824882553055
32363,0.7853293650793651,0,1,0,578547,27063,85636,22320,0.250685464448479,0.4519774011299435
32364,0.7853333333333333,2,13,2,578560,27050,85638,22318,0.2505650450183408,0.4520742181169989
32365,0.7853333333333334,0,1,0,578561,27049,85638,22318,0.25055578198525325,0.45208337553426375
32366,0.7854047619047618,0,1,0,578562,27048,85638,22318,0.2505465189521657,0.4520925333225297
32367,0.7854047619047619,0,1,0,578563,27047,85638,22318,0.25053725591907816,0.4521016914818191
32368,0.7854761904761905,0,1,0,578564,27046,85638,22318,0.2505279928859906,0.4521108500121546
32369,0.7854999999999999,0,1,0,578565,27045,85638,22318,0.250518729852903,0.45212000891355875
32370,0.7855,3,3,3,578568,27042,85641,22315,0.25049094075364037,0.45211418846364243
32371,0.7855000000000001,0,2,0,578570,27040,85641,22315,0.2504724146874653,0.4521325093708844
32372,0.7855238095238096,0,3,0,578573,27037,85641,22315,0.2504446255882026,0.4521599935159669
32373,0.7855357142857143,1,0,1,578573,27037,85642,22314,0.2504446255882026,0.4521488926262892
32374,0.785611111111111,1,2,1,578575,27035,85643,22313,0.2504260995220275,0.4521561157493718
32375,0.7856388888888887,1,3,1,578578,27032,85644,22312,0.25039831042276484,0.45217250324254216
32376,0.7856428571428572,0,1,0,578579,27031,85644,22312,0.25038904738967727,0.4521816671057698
32377,0.7856666666666666,3,7,3,578586,27024,85647,22309,0.2503242061580644,0.4522125149494253
32378,0.7856666666666667,2,2,2,578588,27022,85649,22307,0.2503056800918893,0.45220863994810356
32379,0.785690476190476,0,1,0,578589,27021,85649,22307,0.25029641705880173,0.4522178073305222
32380,0.7856904761904763,0,1,0,578590,27020,85649,22307,0.25028715402571416,0.45222697508463927
32381,0.7857142857142856,0,1,0,578591,27019,85649,22307,0.25027789099262665,0.4522361432104772
32382,0.7857142857142857,4,5,4,578596,27014,85653,22303,0.25023157582718886,0.4522375651398098
32383,0.7857500000000001,0,2,0,578598,27012,85653,22303,0.2502130497610138,0.4522559059109804
32384,0.7857619047619049,0,2,0,578600,27010,85653,22303,0.25019452369483863,0.4522742481698538
32385,0.7858095238095238,0,1,0,578601,27009,85653,22303,0.25018526066175106,0.4522834198572356
32386,0.785809523809524,0,2,0,578603,27007,85653,22303,0.250166734595576,0.45230176434800246
32387,0.7858333333333332,1,1,1,578604,27006,85654,22302,0.2501574715624884,0.45229982964224874
32388,0.7858333333333333,8,19,8,578623,26987,85662,22294,0.2499814739338249,0.4523853006229581
32389,0.7858333333333334,9,14,9,578637,26973,85671,22285,0.24985179147059913,0.4524138211052012
32390,0.7858611111111111,0,1,0,578638,26972,85671,22285,0.2498425284375116,0.45242300586718637
32391,0.7859285714285715,1,6,1,578644,26966,85672,22284,0.24978695023898626,0.4524670050761421
32392,0.7859642857142856,0,2,0,578646,26964,85672,22284,0.24976842417281114,0.45248538011695905
32393,0.7859999999999999,11,28,11,578674,26936,85683,22273,0.24950905924635963,0.452620455607714
32394,0.786,1,3,1,578677,26933,85684,22272,0.24948127014709698,0.4526369271415507
32395,0.7860238095238096,0,1,0,578678,26932,85684,22272,0.2494720071140094,0.4526461263311926
32396,0.7860238095238097,0,1,0,578679,26931,85684,22272,0.24946274408092187,0.45265532589476254
32397,0.7860833333333332,1,0,1,578679,26931,85685,22271,0.24946274408092187,0.4526442014552254
32398,0.7861031746031746,0,1,0,578680,26930,85685,22271,0.2494534810478343,0.452653401353631
32399,0.7861666666666666,2,0,2,578680,26930,85687,22269,0.2494534810478343,0.4526311510396553
32400,0.7861666666666668,0,3,0,578683,26927,85687,22269,0.24942569194857164,0.45265875274412554
32401,0.7861904761904762,1,0,1,578683,26927,85688,22268,0.24942569194857164,0.4526476267913406
32402,0.786193722943723,0,1,0,578684,26926,85688,22268,0.24941642891548407,0.45265682806846363
32403,0.7862142857142858,1,0,1,578684,26926,85689,22267,0.24941642891548407,0.4526457016242148
32404,0.7862380952380952,0,1,0,578685,26925,85689,22267,0.24940716588239653,0.4526549032362986
32405,0.78625,1,2,1,578687,26923,85690,22266,0.24938863981622142,0.45266218056882634
32406,0.7863333333333332,6,3,6,578690,26920,85696,22260,0.24936085071695877,0.45262301748678324
32407,0.7864102564102562,0,1,0,578691,26919,85696,22260,0.2493515876838712,0.45263222106996887
32408,0.7864166666666668,0,1,0,578692,26918,85696,22260,0.24934232465078365,0.4526414250274513
32409,0.7864285714285714,0,1,0,578693,26917,85696,22260,0.2493330616176961,0.4526506293592533
32410,0.7864523809523809,1,0,1,578693,26917,85697,22259,0.2493330616176961,0.4526394989425736
32411,0.7864761904761904,1,1,1,578694,26916,85698,22258,0.24932379858460854,0.45263757270102084
32412,0.7864999999999999,1,5,1,578699,26911,85699,22257,0.24927748341917078,0.45267246989912135
32413,0.7865000000000001,3,7,3,578706,26904,85702,22254,0.2492126421875579,0.45270352740144026
32414,0.7866428571428572,0,2,0,578708,26902,85702,22254,0.24919411612138279,0.4527219464561803
32415,0.7866666666666666,55,100,55,578808,26802,85757,22199,0.24826781281262736,0.4530315707842697
32416,0.7866666666666667,43,80,43,578888,26722,85800,22156,0.24752677016562302,0.453291869552764
32417,0.7867857142857142,0,1,0,578889,26721,85800,22156,0.24751750713253548,0.45330114368721486
32418,0.7867857142857143,1,1,1,578890,26720,85801,22155,0.2475082440994479,0.4532992327365729
32419,0.7868333333333334,1,10,1,578900,26710,85802,22154,0.24741561376857238,0.45338081204977076
32420,0.7868809523809525,1,2,1,578902,26708,85803,22153,0.24739708770239727,0.45338818280428156
32421,0.7869166666666665,0,1,0,578903,26707,85803,22153,0.24738782466930972,0.45339746213671717
32422,0.7869523809523808,0,3,0,578906,26704,85803,22153,0.24736003557004704,0.453425302413165
32423,0.786952380952381,0,2,0,578908,26702,85803,22153,0.24734150950387196,0.4534438644969809
32424,0.7869999999999999,0,1,0,578909,26701,85803,22153,0.2473322464707844,0.45345314610881404
32425,0.787,2,5,2,578914,26696,85805,22151,0.24728593130534662,0.4534771838598072
32426,0.7870000000000001,0,3,0,578917,26693,85805,22151,0.24725814220608397,0.4535050364425518
32427,0.7870238095238093,1,0,1,578917,26693,85806,22150,0.24725814220608397,0.4534938476342567
32428,0.7870714285714284,1,0,1,578917,26693,85807,22149,0.24725814220608397,0.4534826583677982
32429,0.7870714285714285,0,1,0,578918,26692,85807,22149,0.2472488791729964,0.45349194324440534
32430,0.7870833333333332,0,1,0,578919,26691,85807,22149,0.24723961613990886,0.4535012285012285
32431,0.7870833333333335,1,0,1,578919,26691,85808,22148,0.24723961613990886,0.45349003869858107
32432,0.7870952380952381,0,1,0,578920,26690,85808,22148,0.2472303531068213,0.45349932429665424
32433,0.787142857142857,1,0,1,578920,26690,85809,22147,0.2472303531068213,0.45348813399676474
32434,0.7871428571428573,2,1,2,578921,26689,85811,22145,0.24722109007373375,0.45347503788344184
32435,0.7871666666666666,0,1,0,578922,26688,85811,22145,0.24721182704064618,0.45348432412507933
32436,0.7871666666666667,1,2,1,578924,26686,85812,22144,0.2471933009744711,0.45349170591849275
32437,0.7872142857142856,0,2,0,578926,26684,85812,22144,0.24717477490829598,0.45351028098631935
32438,0.7872261904761904,0,1,0,578927,26683,85812,22144,0.2471655118752084,0.4535195690908719
32439,0.7872499999999999,1,0,1,578927,26683,85813,22143,0.2471655118752084,0.4535083766845533
32440,0.7873333333333332,1,0,1,578927,26683,85814,22142,0.2471655118752084,0.45349718381976445
32441,0.7873333333333333,3,7,3,578934,26676,85817,22139,0.24710067064359553,0.45352862849533954
32442,0.7873333333333334,0,3,0,578937,26673,85817,22139,0.24707288154433288,0.4535565024993854
32443,0.7873809523809521,1,0,1,578937,26673,85818,22138,0.24707288154433288,0.4535453074102149
32444,0.7873809523809524,2,0,2,578937,26673,85820,22136,0.24707288154433288,0.45352291585568233
32445,0.7874047619047618,0,2,0,578939,26671,85820,22136,0.24705435547815777,0.45354150019464423
32446,0.7874404761904762,0,1,0,578940,26670,85820,22136,0.24704509244507022,0.4535507929352948
32447,0.7874999999999999,1,1,1,578941,26669,85821,22135,0.24703582941198265,0.4535488894352922
32448,0.7875,44,75,44,579016,26594,85865,22091,0.24634110193041608,0.4537537229126014
32449,0.7875000000000001,0,2,0,579018,26592,85865,22091,0.246322575864241,0.4537723640695931
32450,0.7875595238095238,0,1,0,579019,26591,85865,22091,0.24631331283115343,0.45378168522246415
32451,0.7876428571428573,1,0,1,579019,26591,85866,22090,0.24631331283115343,0.45377046486308825
32452,0.7876666666666665,1,1,1,579020,26590,85867,22089,0.2463040497980659,0.45376856550052386
32453,0.7876666666666666,2,6,2,579026,26584,85869,22087,0.24624847159954055,0.4538020587207988
32454,0.7876666666666668,0,1,0,579027,26583,85869,22087,0.246239208566453,0.4538113827820012
32455,0.7876904761904762,1,0,1,579027,26583,85870,22086,0.246239208566453,0.4538001602662886
32456,0.7877371794871795,0,1,0,579028,26582,85870,22086,0.24622994553336544,0.45380948467165283
32457,0.7877619047619049,0,2,0,579030,26580,85870,22086,0.24621141946719033,0.45382813463198124
32458,0.7877857142857144,1,0,1,579030,26580,85871,22085,0.24621141946719033,0.45381691153806636
32459,0.7877950937950935,0,1,0,579031,26579,85871,22085,0.2462021564341028,0.45382623705408515
32460,0.7878170995670994,1,0,1,579031,26579,85872,22084,0.2462021564341028,0.4538150134599182
32461,0.7878333333333332,0,1,0,579032,26578,85872,22084,0.24619289340101522,0.45382433932020877
32462,0.7878333333333333,1,2,1,579034,26576,85873,22083,0.24617436733484013,0.4538317680182494
32463,0.7878333333333335,2,1,2,579035,26575,85875,22081,0.24616510430175256,0.45381864518250575
32464,0.7878571428571428,1,3,1,579038,26572,85876,22080,0.2461373152024899,0.45383540245005344
32465,0.7878571428571429,0,1,0,579039,26571,85876,22080,0.24612805216940234,0.45384473083800947
32466,0.7878690476190475,1,0,1,579039,26571,85877,22079,0.24612805216940234,0.45383350462487154
32467,0.787952380952381,0,1,0,579040,26570,85877,22079,0.2461187891363148,0.4538428333573146
32468,0.7879999999999998,0,1,0,579041,26569,85877,22079,0.24610952610322723,0.4538521624732774
32469,0.7879999999999999,11,18,11,579059,26551,85888,22068,0.24594279150765128,0.45389662477632203
32470,0.7880000000000001,1,3,1,579062,26548,85889,22067,0.2459150024083886,0.4539134012136172
32471,0.7880238095238095,0,1,0,579063,26547,85889,22067,0.24590573937530105,0.45392273830583785
32472,0.7880238095238096,1,0,1,579063,26547,85890,22066,0.24590573937530105,0.45391150515294265
32473,0.7880555555555554,0,1,0,579064,26546,85890,22066,0.24589647634221348,0.4539208425903069
32474,0.7881547619047619,0,1,0,579065,26545,85890,22066,0.24588721330912594,0.45393018041184097
32475,0.7881666666666667,1,4,1,579069,26541,85891,22065,0.24585016117677572,0.45395630169114926
32476,0.7881666666666668,1,2,1,579071,26539,85892,22064,0.2458316351106006,0.4539637470938008
32477,0.7882142857142856,1,1,1,579072,26538,85893,22063,0.24582237207751306,0.453961852636777
32478,0.7882499999999999,0,1,0,579073,26537,85893,22063,0.2458131090444255,0.45397119341563785
32479,0.7882857142857143,1,0,1,579073,26537,85894,22062,0.2458131090444255,0.45395995802382766
32480,0.7882857142857144,1,0,1,579073,26537,85895,22061,0.2458131090444255,0.4539487221696366
32481,0.7883333333333331,1,1,1,579074,26536,85896,22060,0.24580384601133795,0.4539468268993333
32482,0.7883333333333333,21,36,21,579110,26500,85917,22039,0.245470376820186,0.45404726096540926
32483,0.7883333333333334,22,35,22,579145,26465,85939,22017,0.2451461706621216,0.45412730497916753
32484,0.7883809523809524,0,1,0,579146,26464,85939,22017,0.24513690762903406,0.4541366720983478
32485,0.7884999999999998,0,1,0,579147,26463,85939,22017,0.2451276445959465,0.4541460396039604
32486,0.7885,2,11,2,579158,26452,85941,22015,0.2450257512319834,0.45422658716239916
32487,0.7885000000000001,1,0,1,579158,26452,85942,22014,0.2450257512319834,0.4542153262080634
32488,0.7885555555555555,1,1,1,579159,26451,85943,22013,0.24501648819889585,0.45421343677781445
32489,0.7885714285714286,1,2,1,579161,26449,85944,22012,0.24499796213272074,0.4542209199149832
32490,0.7886190476190477,0,1,0,579162,26448,85944,22012,0.2449886990996332,0.4542302930251754
32491,0.7886666666666666,0,1,0,579163,26447,85944,22012,0.24497943606654562,0.45423966652221465
32492,0.7886666666666667,1,13,1,579176,26434,85945,22011,0.2448590166364074,0.4543502941480029
32493,0.7886893106893105,0,2,0,579178,26432,85945,22011,0.24484049057023233,0.4543690522882563
32494,0.788712121212121,0,1,0,579179,26431,85945,22011,0.24483122753714476,0.4543784319392263
32495,0.78875,0,3,0,579182,26428,85945,22011,0.2448034384378821,0.4544065732157972
32496,0.7888095238095236,0,1,0,579183,26427,85945,22011,0.24479417540479453,0.4544159544159544
32497,0.7888333333333332,1,0,1,579183,26427,85946,22010,0.24479417540479453,0.4544046906290646
32498,0.7888333333333333,3,4,3,579187,26423,85949,22007,0.24475712327244434,0.4544084245302498
32499,0.7888333333333334,1,5,1,579192,26418,85950,22006,0.24471080810700654,0.4544440773170329
32500,0.7888809523809523,0,1,0,579193,26417,85950,22006,0.244701545073919,0.454453462197716
32501,0.7888849206349206,0,2,0,579195,26415,85950,22006,0.2446830190077439,0.45447223312199253
32502,0.7889285714285714,0,1,0,579196,26414,85950,22006,0.24467375597465635,0.454481619165634
32503,0.7889761904761905,0,1,0,579197,26413,85950,22006,0.24466449294156878,0.4544910055969764
32504,0.7889920634920634,0,1,0,579198,26412,85950,22006,0.24465522990848124,0.4545003924160436
32505,0.789,5,16,5,579214,26396,85955,22001,0.24450702137908037,0.45459429303469223
32506,0.7890238095238098,0,1,0,579215,26395,85955,22001,0.2444977583459928,0.4546036862550624
32507,0.7890448717948718,0,1,0,579216,26394,85955,22001,0.24448849531290526,0.45461307986362226
32508,0.789047619047619,0,2,0,579218,26392,85955,22001,0.24446996924673015,0.4546318682454074
32509,0.7890833333333335,0,1,0,579219,26391,85955,22001,0.2444607062136426,0.4546412630186808
32510,0.7891190476190475,0,1,0,579220,26390,85955,22001,0.24445144318055503,0.45465065818024014
32511,0.7891666666666666,12,9,12,579229,26381,85967,21989,0.24436807588276704,0.45459995865205705
32512,0.7891666666666667,6,11,6,579240,26370,85973,21983,0.24426618251880397,0.4546356999565694
32513,0.7891666666666669,0,1,0,579241,26369,85973,21983,0.2442569194857164,0.45464510258107216
32514,0.7892222222222225,0,1,0,579242,26368,85973,21983,0.24424765645262886,0.4546545055945068
32515,0.7892777777777777,1,1,1,579243,26367,85974,21982,0.2442383934195413,0.45465262983722515
32516,0.7892857142857143,0,6,0,579249,26361,85974,21982,0.24418281522101598,0.4547090581883623
32517,0.7893095238095236,4,0,4,579249,26361,85978,21978,0.24418281522101598,0.4546639359523366
32518,0.7893333333333332,2,9,2,579258,26352,85980,21976,0.244099447923228,0.4547260387353087
32519,0.7893333333333333,5,8,5,579266,26344,85985,21971,0.24402534365852754,0.45474490323915967
32520,0.7893412698412701,0,2,0,579268,26342,85985,21971,0.24400681759235243,0.45476372818910027
32521,0.7893571428571429,0,2,0,579270,26340,85985,21971,0.24398829152617732,0.4547825546976879
32522,0.789357142857143,0,1,0,579271,26339,85985,21971,0.24397902849308978,0.45479196853653486
32523,0.7894047619047619,0,1,0,579272,26338,85985,21971,0.24396976546000224,0.4548013827651162
32524,0.789404761904762,0,1,0,579273,26337,85985,21971,0.24396050242691467,0.45481079738345614
32525,0.7894166666666667,1,1,1,579274,26336,85986,21970,0.24395123939382712,0.45480892642735893
32526,0.789452380952381,1,0,1,579274,26336,85987,21969,0.24395123939382712,0.45479763999585965
32527,0.7894761904761903,0,1,0,579275,26335,85987,21969,0.24394197636073955,0.4548070553163299
32528,0.7894761904761904,0,2,0,579277,26333,85987,21969,0.24392345029456444,0.45482588712682703
32529,0.7894999999999999,1,1,1,579278,26332,85988,21968,0.2439141872614769,0.45482401656314697
32530,0.7895,3,4,3,579282,26328,85991,21965,0.24387713512912668,0.4548278218375334
32531,0.7895000000000002,0,2,0,579284,26326,85991,21965,0.24385860906295156,0.4548466587977056
32532,0.789531746031746,0,1,0,579285,26325,85991,21965,0.24384934602986402,0.4548560778629116
32533,0.7895595238095237,0,3,0,579288,26322,85991,21965,0.24382155693060137,0.4548843373993
32534,0.7895714285714284,1,2,1,579290,26320,85992,21964,0.24380303086442626,0.45489188965288707
32535,0.7895833333333333,1,1,1,579291,26319,85993,21963,0.2437937678313387,0.45489002112588545
32536,0.7895833333333334,0,1,0,579292,26318,85993,21963,0.24378450479825114,0.4548994428450115
32537,0.7896349206349207,0,1,0,579293,26317,85993,21963,0.24377524176516358,0.4549088649544325
32538,0.7896428571428572,0,1,0,579294,26316,85993,21963,0.24376597873207603,0.4549182874541726
32539,0.7896666666666665,0,1,0,579295,26315,85993,21963,0.24375671569898846,0.45492771034425616
32540,0.7896666666666667,2,8,2,579303,26307,85995,21961,0.24368261143428804,0.45498052539985084
32541,0.789690476190476,1,2,1,579305,26305,85996,21960,0.24366408536811293,0.45498808660520046
32542,0.7897142857142856,0,1,0,579306,26304,85996,21960,0.2436548223350254,0.4549975136747887
32543,0.7897380952380949,1,3,1,579309,26301,85997,21959,0.2436270332357627,0.45501450476585165
32544,0.78975,0,1,0,579310,26300,85997,21959,0.24361777020267517,0.4550239333595806
32545,0.7897539682539682,1,0,1,579310,26300,85998,21958,0.24361777020267517,0.45501264039123046
32546,0.7898095238095237,0,1,0,579311,26299,85998,21958,0.24360850716958762,0.455022069337091
32547,0.7898333333333332,1,0,1,579311,26299,85999,21957,0.24360850716958762,0.45501077586206895
32548,0.7898333333333334,2,1,2,579312,26298,86001,21955,0.24359924413650005,0.4549976167284936
32549,0.7898809523809525,0,1,0,579313,26297,86001,21955,0.2435899811034125,0.45500704634004807
32550,0.7899285714285716,1,0,1,579313,26297,86002,21954,0.2435899811034125,0.45499575138339104
32551,0.7899722222222222,0,3,0,579316,26294,86002,21954,0.24356219200414983,0.45502404244735534
32552,0.7899999999999998,3,3,3,579319,26291,86005,21951,0.24353440290488718,0.4550184486546992
32553,0.79,741,1061,741,580380,25230,86746,21210,0.23370632479899217,0.45671834625323
32554,0.7900000000000001,2,6,2,580386,25224,86748,21208,0.23365074660046686,0.4567539627842867
32555,0.7901666666666667,0,8,0,580394,25216,86748,21208,0.23357664233576642,0.4568326727554713
32556,0.7901666666666668,1,1,1,580395,25215,86749,21207,0.23356737930267887,0.45683081297660594
32557,0.7901923076923077,1,0,1,580395,25215,86750,21206,0.23356737930267887,0.45681911203980957
32558,0.790218253968254,0,3,0,580398,25212,86750,21206,0.23353959020341622,0.4568486363048817
32559,0.7902261904761905,0,2,0,580400,25210,86750,21206,0.2335210641372411,0.4568683212685281
32560,0.7902857142857143,1,0,1,580400,25210,86751,21205,0.2335210641372411,0.45685661962727564
32561,0.7902976190476193,0,1,0,580401,25209,86751,21205,0.23351180110415354,0.45686646270521825
32562,0.7903333333333333,3,4,3,580405,25205,86754,21202,0.23347474897180331,0.4568707307087293
32563,0.7903333333333334,0,1,0,580406,25204,86754,21202,0.23346548593871577,0.45688057578761365
32564,0.79034126984127,0,1,0,580407,25203,86754,21202,0.23345622290562823,0.4568904212908092
32565,0.7904047619047618,1,0,1,580407,25203,86755,21201,0.23345622290562823,0.4568787173519524
32566,0.7904166666666668,1,3,1,580410,25200,86756,21200,0.23342843380636555,0.45689655172413796
32567,0.7904444444444444,0,2,0,580412,25198,86756,21200,0.23340990774019044,0.4569162463899306
32568,0.7904545454545455,0,1,0,580413,25197,86756,21200,0.2334006447071029,0.4569260943595491
32569,0.7904682539682539,0,1,0,580414,25196,86756,21200,0.23339138167401535,0.45693594275368565
32570,0.7904999999999999,1,1,1,580415,25195,86757,21199,0.23338211864092778,0.45693408630426346
32571,0.7905,2,11,2,580426,25184,86759,21197,0.23328022527696468,0.4570190379681335
32572,0.7905238095238093,1,1,1,580427,25183,86760,21196,0.23327096224387714,0.45701718450160633
32573,0.7906190476190476,0,1,0,580428,25182,86760,21196,0.23326169921078957,0.4570270386821338
32574,0.7906666666666666,1,9,1,580437,25173,86761,21195,0.23317833191300158,0.45710403726708076
32575,0.790666666666667,0,2,0,580439,25171,86761,21195,0.2331598058468265,0.45712375447526205
32576,0.7907142857142856,0,1,0,580440,25170,86761,21195,0.23315054281373893,0.4571336137172436
32577,0.7907142857142857,2,1,2,580441,25169,86763,21193,0.23314127978065138,0.45712005521763516
32578,0.7907499999999998,0,1,0,580442,25168,86763,21193,0.2331320167475638,0.4571299152304739
32579,0.7908095238095236,1,0,1,580442,25168,86764,21192,0.2331320167475638,0.45711820534943914
32580,0.7908333333333333,6,10,6,580452,25158,86770,21186,0.23303938641668828,0.45714655618850336
32581,0.7908333333333334,11,9,11,580461,25149,86781,21175,0.2329560191189003,0.45710646748985406
32582,0.7908492063492065,1,0,1,580461,25149,86782,21174,0.2329560191189003,0.4570947477494981
32583,0.7908661616161617,0,1,0,580462,25148,86782,21174,0.23294675608581275,0.45710461551746473
32584,0.7909761904761905,0,1,0,580463,25147,86782,21174,0.23293749305272518,0.45711448371149155
32585,0.7909999999999998,1,0,1,580463,25147,86783,21173,0.23293749305272518,0.4571027633851468
32586,0.7909999999999999,3,13,3,580476,25134,86786,21170,0.23281707362258697,0.45719592259847963
32587,0.791,0,2,0,580478,25132,86786,21170,0.23279854755641188,0.4572156710293292
32588,0.7910714285714288,1,0,1,580478,25132,86787,21169,0.23279854755641188,0.4572039480788752
32589,0.7911666666666666,0,3,0,580481,25129,86787,21169,0.2327707584571492,0.457233573804484
32590,0.7911666666666668,1,5,1,580486,25124,86788,21168,0.23272444329171144,0.45727123477058673
32591,0.7911904761904762,0,1,0,580487,25123,86788,21168,0.2327151802586239,0.45728111295932256
32592,0.7912261904761906,0,2,0,580489,25121,86788,21168,0.23269665419244878,0.45730087061720925
32593,0.7912380952380953,0,1,0,580490,25120,86788,21168,0.2326873911593612,0.4573107500864155
32594,0.79125,0,4,0,580494,25116,86788,21168,0.23265033902701102,0.4573502722323049
32595,0.7912597402597402,0,1,0,580495,25115,86788,21168,0.23264107599392345,0.4573601538361817
32596,0.7912619047619048,0,1,0,580496,25114,86788,21168,0.2326318129608359,0.45737003586707575
32597,0.7912777777777777,1,0,1,580496,25114,86789,21167,0.2326318129608359,0.4573583111860159
32598,0.7913333333333332,6,9,6,580505,25105,86795,21161,0.23254844566304791,0.4573769074482341
32599,0.7913333333333334,0,2,0,580507,25103,86795,21161,0.2325299195968728,0.4573966799239149
32600,0.7913943833943833,0,1,0,580508,25102,86795,21161,0.23252065656378523,0.4574065668028446
32601,0.7914007936507934,1,3,1,580511,25099,86796,21160,0.23249286746452258,0.4574245011781491
32602,0.7914285714285714,0,1,0,580512,25098,86796,21160,0.23248360443143504,0.4574343897271823
32603,0.791491879487976,1,0,1,580512,25098,86797,21159,0.23248360443143504,0.45742266035410856
32604,0.7914999999999999,0,1,0,580513,25097,86797,21159,0.23247434139834747,0.4574325492909028
32605,0.7915000000000001,3,4,3,580517,25093,86800,21156,0.23243728926599727,0.4574369175549742
32606,0.7915357142857142,0,1,0,580518,25092,86800,21156,0.2324280262329097,0.4574468085106383
32607,0.7915476190476188,0,1,0,580519,25091,86800,21156,0.23241876319982216,0.4574566998940472
32608,0.7915476190476189,0,4,0,580523,25087,86800,21156,0.23238171106747194,0.4574962697056852
32609,0.7915555555555556,1,0,1,580523,25087,86801,21155,0.23238171106747194,0.45748453786600923
32610,0.7915833333333333,0,1,0,580524,25086,86801,21155,0.23237244803438437,0.457494431348803
32611,0.7916341991341992,0,1,0,580525,25085,86801,21155,0.23236318500129682,0.45750432525951557
32612,0.7916428571428571,1,0,1,580525,25085,86802,21154,0.23236318500129682,0.45749259283289
32613,0.7916428571428572,0,1,0,580526,25084,86802,21154,0.23235392196820928,0.45750248713179636
32614,0.7916538461538462,0,1,0,580527,25083,86802,21154,0.2323446589351217,0.4575123818586846
32615,0.7916666666666665,15,41,15,580568,25042,86817,21139,0.231964874578532,0.45774236157727205
32616,0.7916666666666667,19,29,19,580597,25013,86836,21120,0.23169624661899293,0.45780677606052067
32617,0.7916695526695527,1,2,1,580599,25011,86837,21119,0.23167772055281782,0.45781487101669194
32618,0.7917380952380951,1,0,1,580599,25011,86838,21118,0.23167772055281782,0.4578031173448373
32619,0.7918095238095237,1,1,1,580600,25010,86839,21117,0.23166845751973025,0.4578012877490407
32620,0.7918235930735926,0,4,0,580604,25006,86839,21117,0.23163140538738006,0.4578409903952475
32621,0.7918333333333331,1,0,1,580604,25006,86840,21116,0.23163140538738006,0.4578292355058324
32622,0.7918333333333333,3,1,3,580605,25005,86843,21113,0.2316221423542925,0.4578038943579513
32623,0.7918333333333334,2,4,2,580609,25001,86845,21111,0.23158509022194226,0.4578200902151284
32624,0.7919999999999999,2,1,2,580610,25000,86847,21109,0.23157582718885472,0.4578065019844282
32625,0.792,7,20,7,580630,24980,86854,21102,0.23139056652710363,0.45792283321036414
32626,0.7920000000000001,0,1,0,580631,24979,86854,21102,0.2313813034940161,0.4579327705561945
32627,0.7920303030303028,0,3,0,580634,24976,86854,21102,0.2313535143947534,0.4579625851816485
32628,0.7920833333333333,0,1,0,580635,24975,86854,21102,0.23134425136166586,0.45797252425288104
32629,0.7920833333333335,0,1,0,580636,24974,86854,21102,0.23133498832857832,0.4579824637555343
32630,0.7920924908424908,2,0,2,580636,24974,86856,21100,0.23133498832857832,0.45795893562529844
32631,0.792095238095238,0,1,0,580637,24973,86856,21100,0.23132572529549075,0.4579688754802162
32632,0.792142857142857,1,0,1,580637,24973,86857,21099,0.23132572529549075,0.4579571106094808
32633,0.7921666666666666,2,0,2,580637,24973,86859,21097,0.23132572529549075,0.4579335793357934
32634,0.7921666666666667,0,1,0,580638,24972,86859,21097,0.2313164622624032,0.45794351950335366
32635,0.7922121212121211,0,1,0,580639,24971,86859,21097,0.23130719922931564,0.45795346010245724
32636,0.7922142857142858,1,0,1,580639,24971,86860,21096,0.23130719922931564,0.45794169362016196
32637,0.7922222222222223,2,0,2,580639,24971,86862,21094,0.23130719922931564,0.4579181591229784
32638,0.7922499999999999,0,1,0,580640,24970,86862,21094,0.2312979361962281,0.4579281000347343
32639,0.792281746031746,0,1,0,580641,24969,86862,21094,0.23128867316314053,0.45793804137811256
32640,0.7923333333333332,2,0,2,580641,24969,86864,21092,0.23128867316314053,0.4579145046785784
32641,0.7923333333333333,4,8,4,580649,24961,86868,21088,0.2312145688984401,0.45794696953245456
32642,0.7923809523809524,1,1,1,580650,24960,86869,21087,0.23120530586535254,0.45794514300605904
32643,0.7924047619047618,0,2,0,580652,24958,86869,21087,0.23118677979917746,0.45796503420566836
32644,0.7924523809523808,1,1,1,580653,24957,86870,21086,0.23117751676608989,0.45796320830527987
32645,0.792462481962482,0,1,0,580654,24956,86870,21086,0.23116825373300234,0.4579731549454846
32646,0.7924999999999999,1,8,1,580662,24948,86871,21085,0.2310941494683019,0.45804097060804205
32647,0.7925,48,75,48,580737,24873,86919,21037,0.23039942198673533,0.45822260945327814
32648,0.7925000000000001,3,2,3,580739,24871,86922,21034,0.23038089592056024,0.458207166975275
32649,0.792511183261183,2,1,2,580740,24870,86924,21032,0.23037163288747267,0.4581935427650211
32650,0.7925476190476194,0,1,0,580741,24869,86924,21032,0.23036236985438513,0.4582035249776693
32651,0.7925833333333333,0,1,0,580742,24868,86924,21032,0.23035310682129756,0.45821350762527235
32652,0.7925952380952381,1,0,1,580742,24868,86925,21031,0.23035310682129756,0.45820170374082225
32653,0.7926190476190476,0,1,0,580743,24867,86925,21031,0.23034384378821002,0.45821168678373786
32654,0.7926666666666665,0,2,0,580745,24865,86925,21031,0.2303253177220349,0.4582316541746557
32655,0.7926666666666666,2,10,2,580755,24855,86927,21029,0.23023268739115937,0.4583079068956499
32656,0.7926666666666669,3,4,3,580759,24851,86930,21026,0.23019563525880915,0.45831244414412453
32657,0.7927380952380951,0,1,0,580760,24850,86930,21026,0.23018637222572158,0.4583224343883512
32658,0.7927500000000001,0,1,0,580761,24849,86930,21026,0.23017710919263404,0.4583324250681199
32659,0.7927777777777777,0,1,0,580762,24848,86930,21026,0.23016784615954647,0.45834241618345906
32660,0.7928095238095237,0,1,0,580763,24847,86930,21026,0.23015858312645893,0.4583524077343971
32661,0.7928214285714286,1,1,1,580764,24846,86931,21025,0.23014932009337138,0.4583505918772209
32662,0.7928333333333332,1,0,1,580764,24846,86932,21024,0.23014932009337138,0.45833878351863966
32663,0.7928333333333333,1,3,1,580767,24843,86933,21023,0.2301215309941087,0.45835695286268696
32664,0.7928333333333335,0,2,0,580769,24841,86933,21023,0.2301030049279336,0.45837694051979766
32665,0.7928571428571428,1,2,1,580771,24839,86934,21022,0.2300844788617585,0.45838512025468264
32666,0.792904761904762,1,0,1,580771,24839,86935,21021,0.2300844788617585,0.4583733100741387
32667,0.7929166666666666,0,2,0,580773,24837,86935,21021,0.2300659527955834,0.45839330105979326
32668,0.7929166666666667,0,1,0,580774,24836,86935,21021,0.23005668976249583,0.45840329720653333
32669,0.7929646464646466,0,3,0,580777,24833,86935,21021,0.23002890066323317,0.458433288262747
32670,0.7929956709956711,0,1,0,580778,24832,86935,21021,0.2300196376301456,0.4584432861535777
32671,0.7929999999999999,8,12,8,580790,24820,86943,21013,0.22990848123309496,0.458468788863919
32672,0.7930000000000001,1,4,1,580794,24816,86944,21012,0.22987142910074473,0.458496988740508
32673,0.7930357142857143,0,1,0,580795,24815,86944,21012,0.2298621660676572,0.45850699369367404
32674,0.793047619047619,0,2,0,580797,24813,86944,21012,0.22984364000148208,0.45852700490998366
32675,0.7931031746031746,0,1,0,580798,24812,86944,21012,0.22983437696839454,0.45853701117318435
32676,0.7931428571428571,0,1,0,580799,24811,86944,21012,0.22982511393530697,0.45854701787312047
32677,0.7931666666666666,1,5,1,580804,24806,86945,21011,0.2297787987698692,0.45858524128598555
32678,0.7931666666666668,0,4,0,580808,24802,86945,21011,0.22974174663751898,0.4586252810337677
32679,0.7931904761904761,0,1,0,580809,24801,86945,21011,0.22973248360443144,0.4586352920632149
32680,0.7932142857142856,0,2,0,580811,24799,86945,21011,0.22971395753825632,0.4586553154333115
32681,0.79325,0,1,0,580812,24798,86945,21011,0.22970469450516878,0.4586653277740182
32682,0.7933333333333331,0,1,0,580813,24797,86945,21011,0.2296954314720812,0.45867534055186865
32683,0.7933333333333333,57,84,57,580897,24713,87002,20954,0.22891733669272665,0.45884336610681675
32684,0.7933333333333334,48,79,48,580976,24634,87050,20906,0.2281855570788099,0.4590689503732982
32685,0.7933809523809525,0,1,0,580977,24633,87050,20906,0.22817629404572234,0.4590790311601045
32686,0.7934999999999998,0,1,0,580978,24632,87050,20906,0.22816703101263477,0.4590891123896526
32687,0.7935,3,3,3,580981,24629,87053,20903,0.22813924191337212,0.4590837213388386
32688,0.7935000000000001,0,1,0,580982,24628,87053,20903,0.22812997888028455,0.45909380422129975
32689,0.7935277777777777,1,0,1,580982,24628,87054,20902,0.22812997888028455,0.4590819240061498
32690,0.7935833333333333,1,0,1,580982,24628,87055,20901,0.22812997888028455,0.45907004326912515
32691,0.7936428571428571,0,1,0,580983,24627,87055,20901,0.228120715847197,0.45908012651555086
32692,0.7936666666666666,0,1,0,580984,24626,87055,20901,0.22811145281410944,0.45909021020493335
32693,0.7936666666666667,6,7,6,580991,24619,87061,20895,0.22804661158249656,0.459089510919717
32694,0.7936684704184706,0,1,0,580992,24618,87061,20895,0.22803734854940902,0.45909959791707866
32695,0.79375,3,1,3,580993,24617,87064,20892,0.22802808551632148,0.45907402931288316
32696,0.7938214285714286,0,1,0,580994,24616,87064,20892,0.2280188224832339,0.4590841170783159
32697,0.7938333333333332,1,1,1,580995,24615,87065,20891,0.22800955945014637,0.4590823188151013
32698,0.7938333333333333,0,2,0,580997,24613,87065,20891,0.22799103338397125,0.4591024964838256
32699,0.7938333333333334,2,2,2,580999,24611,87067,20889,0.22797250731779614,0.4590989010989011
32700,0.7939047619047619,0,1,0,581000,24610,87067,20889,0.22796324428470857,0.45910899140640454
32701,0.7939166666666668,0,1,0,581001,24609,87067,20889,0.22795398125162103,0.45911908215745745
32702,0.7939285714285712,0,1,0,581002,24608,87067,20889,0.2279447182185335,0.45912917335208914
32703,0.7939999999999999,1,2,1,581004,24606,87068,20888,0.22792619215235838,0.4591374686771882
32704,0.794,15,26,15,581030,24580,87083,20873,0.22768535329208195,0.4592216135348602
32705,0.7940476190476191,1,0,1,581030,24580,87084,20872,0.22768535329208195,0.45920971574408165
32706,0.7941190476190476,0,1,0,581031,24579,87084,20872,0.2276760902589944,0.4592198191458934
32707,0.7941547619047619,0,1,0,581032,24578,87084,20872,0.22766682722590684,0.45922992299229926
32708,0.7941666666666666,7,20,7,581052,24558,87091,20865,0.22748156656415577,0.4593487880589129
32709,0.7941666666666667,8,15,8,581067,24543,87099,20857,0.22734262106784245,0.45940528634361233
32710,0.7941666666666669,0,1,0,581068,24542,87099,20857,0.2273333580347549,0.45941540562567457
32711,0.794186507936508,0,1,0,581069,24541,87099,20857,0.22732409500166734,0.4594255253535398
32712,0.7942857142857142,0,1,0,581070,24540,87099,20857,0.2273148319685798,0.4594356455272375
32713,0.7942857142857143,1,6,1,581076,24534,87100,20856,0.22725925377005446,0.45948446794448117
32714,0.7943333333333331,0,1,0,581077,24533,87100,20856,0.22724999073696692,0.4594945912005111
32715,0.7943333333333332,0,2,0,581079,24531,87100,20856,0.2272314646707918,0.4595148390508295
32716,0.7943333333333333,4,13,4,581092,24518,87104,20852,0.2271110452406536,0.4595988538681948
32717,0.7943333333333336,1,0,1,581092,24518,87105,20851,0.2271110452406536,0.4595869426260222
32718,0.7943888888888889,0,1,0,581093,24517,87105,20851,0.22710178220756605,0.45959707282666196
32719,0.7944166666666668,1,1,1,581094,24516,87106,20850,0.22709251917447848,0.45959529162809154
32720,0.7944404761904761,0,2,0,581096,24514,87106,20850,0.2270739931083034,0.4596155541839344
32721,0.7944761904761904,0,1,0,581097,24513,87106,20850,0.22706473007521583,0.4596256861318696
32722,0.7944999999999999,1,1,1,581098,24512,87107,20849,0.22705546704212828,0.459623905998545
32723,0.7945,2,0,2,581098,24512,87109,20847,0.22705546704212828,0.45960007936682906
32724,0.7945238095238096,0,1,0,581099,24511,87109,20847,0.22704620400904071,0.4596102120904802
32725,0.7945357142857143,0,1,0,581100,24510,87109,20847,0.22703694097595317,0.45962034526092993
32726,0.7945476190476188,0,1,0,581101,24509,87109,20847,0.2270276779428656,0.45963047887820796
32727,0.7945476190476191,0,1,0,581102,24508,87109,20847,0.22701841490977806,0.4596406129423437
32728,0.7945833333333333,0,2,0,581104,24506,87109,20847,0.22699988884360295,0.45966088241130687
32729,0.7945912698412699,0,4,0,581108,24502,87109,20847,0.22696283671125272,0.4597014267128272
32730,0.7946428571428571,0,1,0,581109,24501,87109,20847,0.22695357367816518,0.4597115639057952
32731,0.7946666666666665,1,6,1,581115,24495,87110,20846,0.22689799547963985,0.45976048168324474
32732,0.7946666666666666,4,6,4,581121,24489,87114,20842,0.22684241728111454,0.4597736648209834
32733,0.7946904761904762,1,0,1,581121,24489,87115,20841,0.22684241728111454,0.4597617471872932
32734,0.794702380952381,0,2,0,581123,24487,87115,20841,0.22682389121493943,0.45978203318037414
32735,0.7947049062049061,0,1,0,581124,24486,87115,20841,0.22681462818185186,0.45979217684823614
32736,0.7948333333333334,0,1,0,581125,24485,87115,20841,0.22680536514876432,0.4598023209636853
32737,0.7948809523809522,1,0,1,581125,24485,87116,20840,0.22680536514876432,0.4597904026475455
32738,0.7949047619047619,0,3,0,581128,24482,87116,20840,0.22677757604950166,0.4598208375623318
32739,0.7949206349206348,1,0,1,581128,24482,87117,20839,0.22677757604950166,0.45980891860285517
32740,0.7949999999999998,4,7,4,581135,24475,87121,20835,0.22671273481788876,0.45983226660781285
32741,0.795,161,295,161,581430,24180,87282,20674,0.2239801400570603,0.46091764391135687
32742,0.7950000000000002,0,1,0,581431,24179,87282,20674,0.22397087702397273,0.46092792009453104
32743,0.7950238095238094,0,1,0,581432,24178,87282,20674,0.22396161399088518,0.4609381967359315
32744,0.7950833333333336,0,1,0,581433,24177,87282,20674,0.2239523509577976,0.46094847383558896
32745,0.7951666666666665,1,0,1,581433,24177,87283,20673,0.2239523509577976,0.4609364548494983
32746,0.7951666666666667,2,3,2,581436,24174,87285,20671,0.22392456185853496,0.46094324896866984
32747,0.7951666666666668,0,1,0,581437,24173,87285,20671,0.22391529882544742,0.4609535277852109
32748,0.7951944444444443,0,1,0,581438,24172,87285,20671,0.22390603579235985,0.46096380706018775
32749,0.7952597402597402,1,1,1,581439,24171,87286,20670,0.2238967727592723,0.46096206596641465
32750,0.7952857142857143,1,1,1,581440,24170,87287,20669,0.22388750972618474,0.46096032471732196
32751,0.7952857142857144,0,1,0,581441,24169,87287,20669,0.2238782466930972,0.46097060529015565
32752,0.7953333333333332,0,1,0,581442,24168,87287,20669,0.22386898366000962,0.46098088632156475
32753,0.7953333333333333,5,7,5,581449,24161,87292,20664,0.22380414242839675,0.46099274958170666
32754,0.7953571428571428,0,1,0,581450,24160,87292,20664,0.2237948793953092,0.46100303408888094
32755,0.7953636363636363,0,1,0,581451,24159,87292,20664,0.22378561636222163,0.46101331905494947
32756,0.7954361471861469,0,2,0,581453,24157,87292,20664,0.22376709029604655,0.4610338903638919
32757,0.795452380952381,0,1,0,581454,24156,87292,20664,0.22375782726295898,0.4610441767068273
32758,0.7955,3,8,3,581462,24148,87295,20661,0.22368372299825856,0.4610904059452342
32759,0.7955000000000001,0,1,0,581463,24147,87295,20661,0.223674459965171,0.4611006963042314
32760,0.7956666666666666,1,3,1,581466,24144,87296,20660,0.22364667086590834,0.46111954289795554
32761,0.7956666666666667,0,1,0,581467,24143,87296,20660,0.22363740783282077,0.4611298350556882
32762,0.7957142857142857,2,3,2,581470,24140,87298,20658,0.2236096187335581,0.4611366578865128
32763,0.7957366522366524,0,1,0,581471,24139,87298,20658,0.22360035570047057,0.46114695180480836
32764,0.7957380952380952,0,1,0,581472,24138,87298,20658,0.223591092667383,0.4611572461826949
32765,0.7957500000000001,0,2,0,581474,24136,87298,20658,0.2235725666012079,0.4611778363173639
32766,0.7957619047619048,0,1,0,581475,24135,87298,20658,0.22356330356812035,0.461188132074208
32767,0.7957857142857143,0,1,0,581476,24134,87298,20658,0.22355404053503278,0.4611984282907662
32768,0.7958095238095236,0,1,0,581477,24133,87298,20658,0.22354477750194524,0.4612087249670693
32769,0.7958333333333332,0,3,0,581480,24130,87298,20658,0.22351698840268258,0.46123961775475575
32770,0.7958333333333333,10,15,10,581495,24115,87308,20648,0.22337804290636926,0.46127381989589616
32771,0.7958333333333334,6,15,6,581510,24100,87314,20642,0.22323909741005596,0.4613562201063877
32772,0.7958492063492065,0,1,0,581511,24099,87314,20642,0.2232298343769684,0.4613665318164547
32773,0.7959848484848486,1,0,1,581511,24099,87315,20641,0.2232298343769684,0.4613544926240501
32774,0.7959999999999999,15,27,15,581538,24072,87330,20626,0.22297973248360442,0.46145241397825404
32775,0.796,2,2,2,581540,24070,87332,20624,0.22296120641742934,0.4614489640667651
32776,0.7961190476190477,0,2,0,581542,24068,87332,20624,0.22294268035125422,0.4614696142486351
32777,0.7961554834054833,0,2,0,581544,24066,87332,20624,0.2229241542850791,0.46149026627880957
32778,0.796157287157287,0,1,0,581545,24065,87332,20624,0.22291489125199154,0.46150059298708856
32779,0.7961666666666666,1,0,1,581545,24065,87333,20623,0.22291489125199154,0.46148854278553525
32780,0.7961666666666667,1,3,1,581548,24062,87334,20622,0.2228871021527289,0.46150747471130604
32781,0.7962142857142857,0,1,0,581549,24061,87334,20622,0.22287783911964135,0.4615178031913703
32782,0.79625,0,3,0,581552,24058,87334,20622,0.22285005002037866,0.4615487914055506
32783,0.7962698412698412,2,1,2,581553,24057,87336,20620,0.22284078698729112,0.46153501801821967
32784,0.7962857142857144,1,0,1,581553,24057,87337,20619,0.22284078698729112,0.4615229653505238
32785,0.7963333333333332,2,5,2,581558,24052,87339,20617,0.22279447182185336,0.46155051601782
32786,0.7963333333333334,1,5,1,581563,24047,87340,20616,0.22274815665641556,0.46159013053310344
32787,0.7964047619047621,0,1,0,581564,24046,87340,20616,0.22273889362332802,0.4616004657202991
32788,0.7964166666666667,1,0,1,581564,24046,87341,20615,0.22273889362332802,0.461588410469985
32789,0.7964285714285714,0,2,0,581566,24044,87341,20615,0.2227203675571529,0.4616090821558924
32790,0.796488095238095,0,1,0,581567,24043,87341,20615,0.22271110452406537,0.4616194186931793
32791,0.7964999999999999,0,8,0,581575,24035,87341,20615,0.22263700025936492,0.46170212765957447
32792,0.7965000000000001,1,3,1,581578,24032,87342,20614,0.22260921116010227,0.46172109483492363
32793,0.7965000000000002,0,1,0,581579,24031,87342,20614,0.2225999481270147,0.46173143689102925
32794,0.7965119047619048,0,1,0,581580,24030,87342,20614,0.22259068509392715,0.4617417794104471
32795,0.796547619047619,0,1,0,581581,24029,87342,20614,0.2225814220608396,0.46175212239320834
32796,0.7965714285714286,0,1,0,581582,24028,87342,20614,0.22257215902775204,0.4617624658393441
32797,0.796595238095238,1,1,1,581583,24027,87343,20613,0.2225628959946645,0.461760752688172
32798,0.7965952380952381,0,2,0,581585,24025,87343,20613,0.2225443699284894,0.4617814418208701
32799,0.796642857142857,0,1,0,581586,24024,87343,20613,0.22253510689540182,0.4617917870824652
32800,0.7966666666666664,1,1,1,581587,24023,87344,20612,0.22252584386231428,0.46179007505320935
32801,0.7966666666666665,49,73,49,581660,23950,87393,20563,0.22184964244692282,0.4619549345135129
32802,0.7966666666666667,44,71,44,581731,23879,87437,20519,0.22119196709770647,0.4621604576782738
32803,0.7966666666666669,1,1,1,581732,23878,87438,20518,0.22118270406461893,0.4621587530408145
32804,0.7966904761904763,0,3,0,581735,23875,87438,20518,0.22115491496535625,0.4621899849075305
32805,0.7967380952380952,0,2,0,581737,23873,87438,20518,0.22113638889918114,0.4622108084972179
32806,0.7967857142857143,0,1,0,581738,23872,87438,20518,0.2211271258660936,0.4622212209957198
32807,0.7967857142857144,2,0,2,581738,23872,87440,20516,0.2211271258660936,0.46219699017752547
32808,0.7968333333333333,1,1,1,581739,23871,87441,20515,0.22111786283300605,0.46219528680214483
32809,0.7968333333333334,0,3,0,581742,23868,87441,20515,0.22109007373374337,0.4622265281752022
32810,0.7969047619047619,2,0,2,581742,23868,87443,20513,0.22109007373374337,0.4622022937743629
32811,0.7969166666666666,0,1,0,581743,23867,87443,20513,0.22108081070065583,0.46221270842721945
32812,0.7969523809523809,0,1,0,581744,23866,87443,20513,0.22107154766756826,0.4622231235494265
32813,0.796952380952381,2,1,2,581745,23865,87445,20511,0.22106228463448072,0.4622093023255814
32814,0.7969761904761906,1,2,1,581747,23863,87446,20510,0.2210437585683056,0.4622180154598517
32815,0.7969999999999999,0,2,0,581749,23861,87446,20510,0.2210252325021305,0.4622388496991278
32816,0.797,2,5,2,581754,23856,87448,20508,0.22097891733669273,0.4622667027319448
32817,0.7970000000000002,0,2,0,581756,23854,87448,20508,0.22096039127051761,0.462287543392994
32818,0.7970238095238095,0,1,0,581757,23853,87448,20508,0.22095112823743007,0.46229796442821397
32819,0.7970396825396826,0,1,0,581758,23852,87448,20508,0.2209418652043425,0.4623083859332732
32820,0.797083333333333,0,1,0,581759,23851,87448,20508,0.22093260217125496,0.4623188079082035
32821,0.7970833333333335,0,1,0,581760,23850,87448,20508,0.2209233391381674,0.46232923035303664
32822,0.7971428571428569,1,0,1,581760,23850,87449,20507,0.2209233391381674,0.46231710891178396
32823,0.7971428571428573,2,1,2,581761,23849,87451,20505,0.22091407610507985,0.4623032871894305
32824,0.7971666666666666,0,1,0,581762,23848,87451,20505,0.2209048130719923,0.46231371045926994
32825,0.7971666666666667,0,5,0,581767,23843,87451,20505,0.2208584979065545,0.46236583385947505
32826,0.7973095238095239,0,3,0,581770,23840,87451,20505,0.22083070880729186,0.4623971135415492
32827,0.7973333333333332,1,1,1,581771,23839,87452,20504,0.22082144577420432,0.46239541754053626
32828,0.7973333333333333,6,10,6,581781,23829,87458,20498,0.22072881544332876,0.4624269632503892
32829,0.7973333333333334,0,2,0,581783,23827,87458,20498,0.22071028937715365,0.4624478285391991
32830,0.7973809523809524,0,2,0,581785,23825,87458,20498,0.22069176331097853,0.4624686957110304
32831,0.7973928571428571,1,0,1,581785,23825,87459,20497,0.22069176331097853,0.46245656784441136
32832,0.7974047619047618,1,0,1,581785,23825,87460,20496,0.22069176331097853,0.4624444394305183
32833,0.7974999999999999,0,3,0,581788,23822,87460,20496,0.22066397421171588,0.4624757434902297
32834,0.7975,45,71,45,581859,23751,87505,20451,0.22000629886249953,0.4626713723360934
32835,0.7975000000000001,1,2,1,581861,23749,87506,20450,0.21998777279632442,0.46268015113464106
32836,0.7975238095238093,0,1,0,581862,23748,87506,20450,0.21997850976323688,0.4626906194850446
32837,0.7975357142857142,0,3,0,581865,23745,87506,20450,0.21995072066397423,0.46272202737866275
32838,0.7975714285714285,0,1,0,581866,23744,87506,20450,0.21994145763088666,0.4627324976241119
32839,0.7975833333333334,2,0,2,581866,23744,87508,20448,0.21994145763088666,0.46270818247646633
32840,0.7976666666666665,0,1,0,581867,23743,87508,20448,0.2199321945977991,0.46271865311941346
32841,0.7976666666666666,2,4,2,581871,23739,87510,20446,0.2198951424654489,0.4627362227000113
32842,0.7976666666666667,1,2,1,581873,23737,87511,20445,0.21987661639927378,0.4627450092797972
32843,0.7976785714285713,0,1,0,581874,23736,87511,20445,0.21986735336618624,0.4627554831262307
32844,0.7977380952380951,1,0,1,581874,23736,87512,20444,0.21986735336618624,0.46274332277048436
32845,0.7977878787878787,0,1,0,581875,23735,87512,20444,0.21985809033309867,0.46275379705289843
32846,0.7978201308495424,2,3,2,581878,23732,87514,20442,0.219830301233836,0.46276090007696835
32847,0.7978333333333332,1,1,1,581879,23731,87515,20441,0.21982103820074844,0.4627592139817079
32848,0.7978333333333333,2,1,2,581880,23730,87517,20439,0.2198117751676609,0.46274536439584324
32849,0.7978571428571429,1,0,1,581880,23730,87518,20438,0.2198117751676609,0.4627332005071545
32850,0.7978809523809524,0,1,0,581881,23729,87518,20438,0.21980251213457336,0.46274367740620825
32851,0.7978928571428571,0,1,0,581882,23728,87518,20438,0.2197932491014858,0.4627541547796948
32852,0.7979285714285714,0,1,0,581883,23727,87518,20438,0.21978398606839825,0.46276463262764633
32853,0.7979999999999999,14,28,14,581911,23699,87532,20424,0.2195246211419467,0.4628878362758652
32854,0.7980000000000002,2,1,2,581912,23698,87534,20422,0.21951535810885917,0.4628739800543971
32855,0.798047619047619,2,0,2,581912,23698,87536,20420,0.21951535810885917,0.462849630536289
32856,0.7980714285714287,1,1,1,581913,23697,87537,20419,0.21950609507577162,0.46284794632332943
32857,0.7980952380952381,0,2,0,581915,23695,87537,20419,0.2194875690095965,0.4628689304982545
32858,0.798142857142857,0,5,0,581920,23690,87537,20419,0.21944125384415872,0.4629213992609218
32859,0.7981666666666666,2,6,2,581926,23684,87539,20417,0.2193856756456334,0.4629600235822317
32860,0.7981666666666668,0,1,0,581927,23683,87539,20417,0.21937641261254584,0.4629705215419501
32861,0.7982142857142859,0,1,0,581928,23682,87539,20417,0.2193671495794583,0.4629810199777773
32862,0.798238095238095,0,1,0,581929,23681,87539,20417,0.21935788654637076,0.46299151888974555
32863,0.79825,0,2,0,581931,23679,87539,20417,0.21933936048019564,0.4630125181422351
32864,0.7982803030303031,1,0,1,581931,23679,87540,20416,0.21933936048019564,0.463000340174623
32865,0.7983333333333333,27,36,27,581967,23643,87567,20389,0.21900589128904369,0.4630496002906977
32866,0.7983333333333335,21,27,21,581994,23616,87588,20368,0.21875578939567972,0.4630774827209895
32867,0.7983844488844487,3,2,3,581996,23614,87591,20365,0.2187372633295046,0.4630619159144137
32868,0.7985,3,3,3,581999,23611,87594,20362,0.21870947423024195,0.46305687581015625
32869,0.7985487012987013,1,3,1,582002,23608,87595,20361,0.2186816851309793,0.4630762582728741
32870,0.7985714285714286,3,1,3,582003,23607,87598,20358,0.21867242209789173,0.46305015353121803
32871,0.7986666666666666,2,3,2,582006,23604,87600,20356,0.21864463299862907,0.46305732484076434
32872,0.7986666666666667,1,3,1,582009,23601,87601,20355,0.21861684389936642,0.46307671307671305
32873,0.7986666666666669,0,1,0,582010,23600,87601,20355,0.21860758086627885,0.46308724832214765
32874,0.7986904761904762,0,2,0,582012,23598,87601,20355,0.21858905480010374,0.4631083202511774
32875,0.7987142857142857,0,1,0,582013,23597,87601,20355,0.2185797917670162,0.463118856934838
32876,0.79875,1,3,1,582016,23594,87602,20354,0.21855200266775354,0.463138254300537
32877,0.7987857142857143,0,1,0,582017,23593,87602,20354,0.21854273963466597,0.4631487928641318
32878,0.7988095238095237,0,3,0,582020,23590,87602,20354,0.21851495053540332,0.4631804114327326
32879,0.798809523809524,0,1,0,582021,23589,87602,20354,0.21850568750231575,0.4631909519149808
32880,0.7988333333333333,1,1,1,582022,23588,87603,20353,0.2184964244692282,0.46318927652989234
32881,0.7988333333333334,1,2,1,582024,23586,87604,20352,0.2184778984030531,0.46319814283763483
32882,0.7988333333333335,0,1,0,582025,23585,87604,20352,0.21846863536996555,0.4632086851628468
32883,0.7988571428571428,1,0,1,582025,23585,87605,20351,0.21846863536996555,0.4631964675892207
32884,0.7988593073593071,0,1,0,582026,23584,87605,20351,0.21845937233687798,0.46320701035620804
32885,0.7988809523809525,0,1,0,582027,23583,87605,20351,0.21845010930379044,0.463217553603132
32886,0.7988888888888889,0,1,0,582028,23582,87605,20351,0.21844084627070287,0.4632280973300253
32887,0.7989682539682538,0,3,0,582031,23579,87605,20351,0.21841305717144022,0.4632597313908491
32888,0.7989999999999999,1,5,1,582036,23574,87606,20350,0.21836674200600245,0.46330024587924595
32889,0.799,6,17,6,582053,23557,87612,20344,0.21820927044351401,0.46340630053985105
32890,0.799047619047619,0,1,0,582054,23556,87612,20344,0.21820000741042647,0.46341685649202735
32891,0.7990476190476191,0,1,0,582055,23555,87612,20344,0.2181907443773389,0.46342741292512357
32892,0.7991666666666666,6,11,6,582066,23544,87618,20338,0.21808885101337583,0.4634702155781414
32893,0.7991666666666667,6,18,6,582084,23526,87624,20332,0.21792211641779985,0.4635870308723608
32894,0.7992088744588745,0,1,0,582085,23525,87624,20332,0.21791285338471228,0.46359760129511823
32895,0.7992380952380952,0,2,0,582087,23523,87624,20332,0.2178943273185372,0.4636187435868202
32896,0.79925,1,0,1,582087,23523,87625,20331,0.2178943273185372,0.4636065125188124
32897,0.7992857142857143,0,1,0,582088,23522,87625,20331,0.21788506428544963,0.46361708434998744
32898,0.7993333333333332,4,4,4,582092,23518,87629,20327,0.2178480121530994,0.4636104458889269
32899,0.7993333333333333,5,8,5,582100,23510,87634,20322,0.21777390788839898,0.46363387479467055
32900,0.7993333333333336,0,1,0,582101,23509,87634,20322,0.2177646448553114,0.46364445255640985
32901,0.799392857142857,0,1,0,582102,23508,87634,20322,0.21775538182222387,0.4636550308008214
32902,0.7994999999999999,2,2,2,582104,23506,87636,20320,0.21773685575604876,0.46365171359466983
32903,0.7995,0,8,0,582112,23498,87636,20320,0.21766275149134834,0.46373636405130314
32904,0.7995000000000002,1,0,1,582112,23498,87637,20319,0.21766275149134834,0.4637241253394801
32905,0.7995714285714286,1,2,1,582114,23496,87638,20318,0.21764422542517323,0.4637330533619391
32906,0.7995833333333334,0,1,0,582115,23495,87638,20318,0.21763496239208566,0.4637436377330929
32907,0.7996666666666665,0,3,0,582118,23492,87638,20318,0.217607173292823,0.46377539374572013
32908,0.7996666666666666,0,1,0,582119,23491,87638,20318,0.21759791025973546,0.46378598004976146
32909,0.7997380952380954,1,2,1,582121,23489,87639,20317,0.21757938419356035,0.46379491393872985
32910,0.79975,0,1,0,582122,23488,87639,20317,0.21757012116047278,0.4638055016550622
32911,0.7997777777777777,0,1,0,582123,23487,87639,20317,0.21756085812738524,0.46381608985480777
32912,0.7998333333333332,0,3,0,582126,23484,87639,20317,0.21753306902812256,0.4638478573548549
32913,0.7998333333333334,2,2,2,582128,23482,87641,20315,0.21751454296194747,0.46384455556316645
32914,0.7998333333333335,0,1,0,582129,23481,87641,20315,0.2175052799288599,0.46385514658872956
32915,0.7998571428571428,0,1,0,582130,23480,87641,20315,0.21749601689577236,0.4638657380979564
32916,0.7998809523809524,0,2,0,582132,23478,87641,20315,0.21747749082959725,0.4638869225675336
32917,0.7999047619047619,0,1,0,582133,23477,87641,20315,0.21746822779650968,0.46389751552795033
32918,0.7999999999999998,2,6,2,582139,23471,87643,20313,0.21741264959798437,0.46393659784396124
32919,0.8,780,1027,780,583166,22444,88423,19533,0.2078995146170662,0.46532625008933465
32920,0.8000000000000002,1,5,1,583171,22439,88424,19532,0.20785319945162845,0.4653689452240833
32921,0.8000238095238095,1,0,1,583171,22439,88425,19531,0.20785319945162845,0.4653562068143912
32922,0.8001111111111109,0,3,0,583174,22436,88425,19531,0.2078254103523658,0.46538947268091596
32923,0.8001190476190476,0,1,0,583175,22435,88425,19531,0.20781614731927822,0.4654005623600057
32924,0.8001190476190477,0,1,0,583176,22434,88425,19531,0.20780688428619068,0.46541165256761585
32925,0.800142857142857,0,1,0,583177,22433,88425,19531,0.2077976212531031,0.4654227433037842
32926,0.8001666666666665,0,2,0,583179,22431,88425,19531,0.207779095186928,0.4654449263619465
32927,0.8001666666666667,1,6,1,583185,22425,88426,19530,0.2077235169884027,0.4654987486592778
32928,0.8001666666666668,0,1,0,583186,22424,88426,19530,0.20771425395531512,0.4655098441149831
32929,0.8002380952380952,0,1,0,583187,22423,88426,19530,0.20770499092222758,0.4655209400996353
32930,0.8002857142857144,1,0,1,583187,22423,88427,19529,0.20770499092222758,0.4655081998474447
32931,0.8003095238095238,2,0,2,583187,22423,88429,19527,0.20770499092222758,0.4654827175208582
32932,0.8003333333333333,7,8,7,583195,22415,88436,19520,0.20763088665752713,0.4654822940264695
32933,0.8003333333333335,1,0,1,583195,22415,88437,19519,0.20763088665752713,0.4654695473839844
32934,0.8003571428571429,0,1,0,583196,22414,88437,19519,0.2076216236244396,0.4654806476999022
32935,0.8003809523809524,0,1,0,583197,22413,88437,19519,0.20761236059135202,0.46549174854526376
32936,0.8004285714285713,0,1,0,583198,22412,88437,19519,0.20760309755826448,0.4655028499201068
32937,0.8004761904761906,0,1,0,583199,22411,88437,19519,0.20759383452517693,0.46551395182446936
32938,0.8004920634920635,0,1,0,583200,22410,88437,19519,0.20758457149208936,0.4655250542583892
32939,0.8005,3,6,3,583206,22404,88440,19516,0.20752899329356406,0.4655534351145038
32940,0.8005476190476192,0,1,0,583207,22403,88440,19516,0.2075197302604765,0.46556454113886303
32941,0.8005555555555556,1,0,1,583207,22403,88441,19515,0.2075197302604765,0.46555179159311033
32942,0.8005568842921784,1,0,1,583207,22403,88442,19514,0.2075197302604765,0.4655390414390343
32943,0.8006666666666666,1,13,1,583220,22390,88443,19513,0.20739931083033827,0.4656707157005465
32944,0.8006666666666667,0,2,0,583222,22388,88443,19513,0.2073807847641632,0.46569294288919116
32945,0.8007142857142857,1,5,1,583227,22383,88444,19512,0.2073344695987254,0.4657357679914071
32946,0.8007500000000001,0,1,0,583228,22382,88444,19512,0.20732520656563785,0.46574688499546474
32947,0.8008333333333333,7,20,7,583248,22362,88451,19505,0.20713994590388676,0.4658800487257267
32948,0.8008333333333334,4,19,4,583267,22343,88455,19501,0.20696394827522324,0.4660405314979447
32949,0.8008571428571429,0,1,0,583268,22342,88455,19501,0.20695468524213567,0.4660516693353727
32950,0.8008809523809522,1,0,1,583268,22342,88456,19500,0.20695468524213567,0.4660389082739831
32951,0.8008968253968254,0,1,0,583269,22341,88456,19500,0.20694542220904813,0.46605004660500465
32952,0.8009523809523809,1,0,1,583269,22341,88457,19499,0.20694542220904813,0.4660372848948375
32953,0.800952380952381,0,1,0,583270,22340,88457,19499,0.2069361591759606,0.4660484237194962
32954,0.8009761904761905,1,0,1,583270,22340,88458,19498,0.2069361591759606,0.4660356613604857
32955,0.8009999999999999,10,7,10,583277,22333,88468,19488,0.2068713179443477,0.46598598790081536
32956,0.801,0,2,0,583279,22331,88468,19488,0.2068527918781726,0.4660082737511657
32957,0.8010238095238097,0,3,0,583282,22328,88468,19488,0.20682500277890992,0.46604170652381866
32958,0.8010793650793651,0,2,0,583284,22326,88468,19488,0.2068064767127348,0.4660639977041182
32959,0.8011298701298702,0,1,0,583285,22325,88468,19488,0.20679721367964726,0.4660751440939421
32960,0.8011587301587301,1,0,1,583285,22325,88469,19487,0.20679721367964726,0.4660623744379604
32961,0.8011666666666666,0,1,0,583286,22324,88469,19487,0.20678795064655972,0.4660735213221401
32962,0.8011666666666667,0,3,0,583289,22321,88469,19487,0.20676016154729704,0.46610696517412936
32963,0.8011904761904762,1,1,1,583290,22320,88470,19486,0.2067508985142095,0.466105343730565
32964,0.80125,1,2,1,583292,22318,88471,19485,0.20673237244803438,0.4661148721383633
32965,0.8012619047619047,0,1,0,583293,22317,88471,19485,0.20672310941494684,0.46612602267834075
32966,0.8012857142857144,0,2,0,583295,22315,88471,19485,0.20670458334877173,0.4661483253588517
32967,0.8013333333333332,4,4,4,583299,22311,88475,19481,0.2066675312164215,0.4661418453292496
32968,0.8013333333333335,4,3,4,583302,22308,88479,19477,0.20663974211715885,0.466124207251406
32969,0.8013571428571429,1,1,1,583303,22307,88480,19476,0.20663047908407128,0.4661225857406122
32970,0.8013690476190476,0,2,0,583305,22305,88480,19476,0.20661195301789617,0.4661448983987937
32971,0.8014285714285714,0,1,0,583306,22304,88480,19476,0.20660268998480863,0.4661560555289612
32972,0.8014393939393939,0,1,0,583307,22303,88480,19476,0.20659342695172106,0.46616721319323107
32973,0.8014642857142857,0,1,0,583308,22302,88480,19476,0.20658416391863352,0.46617837139164153
32974,0.8014999999999999,1,4,1,583312,22298,88481,19475,0.2065471117862833,0.46621023148923946
32975,0.8015000000000001,0,2,0,583314,22296,88481,19475,0.20652858572010818,0.4662325536855713
32976,0.801547619047619,0,2,0,583316,22294,88481,19475,0.20651005965393307,0.46625487801958393
32977,0.8015714285714287,0,1,0,583317,22293,88481,19475,0.20650079662084553,0.4662660409883164
32978,0.8016190476190477,0,2,0,583319,22291,88481,19475,0.20648227055467042,0.46628836852942585
32979,0.8016349206349206,1,4,1,583323,22287,88482,19474,0.2064452184223202,0.46632025095184504
32980,0.801656981906982,0,1,0,583324,22286,88482,19474,0.20643595538923265,0.46633141762452107
32981,0.8016666666666665,17,41,17,583365,22245,88499,19457,0.20605617103264293,0.46657234665004077
32982,0.8016666666666667,17,28,17,583393,22217,88516,19440,0.20579680610619142,0.4666682670379528
32983,0.8016666666666669,2,1,2,583394,22216,88518,19438,0.20578754307310385,0.4666538627742834
32984,0.8017499999999999,0,3,0,583397,22213,88518,19438,0.2057597539738412,0.46668747449040837
32985,0.8017619047619046,1,2,1,583399,22211,88519,19437,0.20574122790766608,0.4666970802919708
32986,0.8017857142857143,1,0,1,583399,22211,88520,19436,0.20574122790766608,0.4666842749777895
32987,0.8018095238095237,0,1,0,583400,22210,88520,19436,0.20573196487457854,0.46669548095855545
32988,0.8018279220779219,1,0,1,583400,22210,88521,19435,0.20573196487457854,0.4666826749909953
32989,0.8018333333333332,2,1,2,583401,22209,88523,19433,0.20572270184149097,0.46666826761442776
32990,0.8018333333333334,0,3,0,583404,22206,88523,19433,0.20569491274222831,0.4667018900549965
32991,0.801888888888889,0,1,0,583405,22205,88523,19433,0.20568564970914077,0.46671309861184496
32992,0.8019999999999999,3,1,3,583406,22204,88526,19430,0.2056763866760532,0.46668588173127734
32993,0.802,7,10,7,583416,22194,88533,19423,0.20558375634517767,0.46670831631304516
32994,0.8020238095238095,0,1,0,583417,22193,88533,19423,0.2055744933120901,0.46671953094963475
32995,0.8020833333333335,0,1,0,583418,22192,88533,19423,0.20556523027900256,0.4667307461251952
32996,0.8020952380952383,1,0,1,583418,22192,88534,19422,0.20556523027900256,0.4667179314653722
32997,0.802142857142857,1,0,1,583418,22192,88535,19421,0.20556523027900256,0.46670511618965227
32998,0.8021428571428573,0,2,0,583420,22190,88535,19421,0.20554670421282745,0.4667275480041335
32999,0.8021666666666666,0,2,0,583422,22188,88535,19421,0.20552817814665233,0.46674998197505346
33000,0.8021666666666667,1,2,1,583424,22186,88536,19420,0.20550965208047722,0.4667596019804836
33001,0.8021904761904761,0,1,0,583425,22185,88536,19420,0.20550038904738968,0.4667708208148059
33002,0.8022380952380952,1,2,1,583427,22183,88537,19419,0.20548186298121457,0.4667804432479208
33003,0.8022619047619046,0,1,0,583428,22182,88537,19419,0.20547259994812703,0.4667916636619312
33004,0.8022619047619048,1,0,1,583428,22182,88538,19418,0.20547259994812703,0.4667788461538461
33005,0.8022763347763344,0,1,0,583429,22181,88538,19418,0.20546333691503946,0.4667900670689199
33006,0.8023333333333332,1,3,1,583432,22178,88539,19417,0.2054355478157768,0.46681091477341025
33007,0.8023333333333333,3,5,3,583437,22173,88542,19414,0.20538923265033904,0.46682857623776663
33008,0.8023333333333335,0,1,0,583438,22172,88542,19414,0.20537996961725147,0.46683980185639395
33009,0.8023809523809524,2,2,2,583440,22170,88544,19412,0.20536144355107636,0.466836611995575
33010,0.802420634920635,1,1,1,583441,22169,88545,19411,0.2053521805179888,0.4668350168350168
33011,0.8024285714285715,1,2,1,583443,22167,88546,19410,0.2053336544518137,0.46684464968612455
33012,0.8024920634920635,1,0,1,583443,22167,88547,19409,0.2053336544518137,0.4668318260534924
33013,0.8024999999999999,1,0,1,583443,22167,88548,19408,0.2053336544518137,0.46681900180396874
33014,0.8025,46,88,46,583531,22079,88594,19362,0.20451850754010895,0.4672184551531092
33015,0.8025000000000001,2,0,2,583531,22079,88596,19360,0.20451850754010895,0.4671927411375757
33016,0.8025238095238096,0,3,0,583534,22076,88596,19360,0.20449071844084626,0.46722656627087555
33017,0.8025476190476191,1,0,1,583534,22076,88597,19359,0.20449071844084626,0.46721370821769037
33018,0.8026190476190476,0,1,0,583535,22075,88597,19359,0.20448145540775872,0.46722498431240045
33019,0.8026666666666665,2,3,2,583538,22072,88599,19357,0.20445366630849604,0.4672330975886456
33020,0.8026666666666666,0,4,0,583542,22068,88599,19357,0.20441661417614584,0.4672782136391068
33021,0.8026666666666668,0,1,0,583543,22067,88599,19357,0.20440735114305827,0.46728949401313247
33022,0.8026904761904763,1,0,1,583543,22067,88600,19356,0.20440735114305827,0.46727663375419454
33023,0.8027272727272728,0,1,0,583544,22066,88600,19356,0.20439808810997073,0.4672879146347352
33024,0.8027380952380951,1,0,1,583544,22066,88601,19355,0.20439808810997073,0.46727505371671374
33025,0.8028055555555556,1,1,1,583545,22065,88602,19354,0.20438882507688316,0.46727347352664234
33026,0.8028333333333332,1,1,1,583546,22064,88603,19353,0.20437956204379562,0.4672718931839583
33027,0.8028333333333333,3,2,3,583548,22062,88606,19350,0.2043610359776205,0.4672558678643871
33028,0.8028333333333335,1,3,1,583551,22059,88607,19349,0.20433324687835785,0.46727685471406494
33029,0.8028571428571428,1,2,1,583553,22057,88608,19348,0.20431472081218274,0.4672865595942519
33030,0.8028690476190475,0,2,0,583555,22055,88608,19348,0.20429619474600763,0.46730913218848874
33031,0.8029285714285712,1,2,1,583557,22053,88609,19347,0.20427766867983252,0.4673188405797101
33032,0.8029523809523809,1,0,1,583557,22053,88610,19346,0.20427766867983252,0.4673059735742409
33033,0.8029999999999998,0,1,0,583558,22052,88610,19346,0.20426840564674498,0.46731726170346394
33034,0.8029999999999999,2,8,2,583566,22044,88612,19344,0.20419430138204453,0.4673818498115396
33035,0.8030000000000002,1,4,1,583570,22040,88613,19343,0.20415724924969433,0.46741415557112825
33036,0.8030158730158731,1,0,1,583570,22040,88614,19342,0.20415724924969433,0.4674012855831038
33037,0.803069264069264,1,1,1,583571,22039,88615,19341,0.20414798621660676,0.46739971000483327
33038,0.8030952380952381,0,3,0,583574,22036,88615,19341,0.2041201971173441,0.4674335983759093
33039,0.8031190476190477,0,1,0,583575,22035,88615,19341,0.20411093408425654,0.4674448955916473
33040,0.8031428571428572,1,0,1,583575,22035,88616,19340,0.20411093408425654,0.4674320241691843
33041,0.8031666666666666,1,5,1,583580,22030,88617,19339,0.20406461891881877,0.4674756460151321
33042,0.8031666666666668,0,1,0,583581,22029,88617,19339,0.20405535588573123,0.46748694643202476
33043,0.8032380952380953,0,1,0,583582,22028,88617,19339,0.20404609285264366,0.46749824739526674
33044,0.8033333333333331,0,1,0,583583,22027,88617,19339,0.20403682981955612,0.46750954890489776
33045,0.8033333333333332,50,68,50,583651,21959,88667,19289,0.20340694356960243,0.46763479441427463
33046,0.8033333333333335,46,65,46,583716,21894,88713,19243,0.20280484641891142,0.4677783990081921
33047,0.8033809523809525,1,0,1,583716,21894,88714,19242,0.20280484641891142,0.4677654609101517
33048,0.8034166666666666,1,1,1,583717,21893,88715,19241,0.20279558338582385,0.46776389361598675
33049,0.8034523809523811,0,3,0,583720,21890,88715,19241,0.2027677942865612,0.4677980112324038
33050,0.8035,4,7,4,583727,21883,88719,19237,0.20270295305494831,0.4678258754863813
33051,0.8035000000000001,0,2,0,583729,21881,88719,19237,0.2026844269887732,0.46784863076997907
33052,0.8035714285714286,1,1,1,583730,21880,88720,19236,0.20267516395568566,0.46784706683529526
33053,0.8036190476190476,1,0,1,583730,21880,88721,19235,0.20267516395568566,0.4678341237991001
33054,0.8036666666666666,2,2,2,583732,21878,88723,19233,0.20265663788951055,0.467830994137822
33055,0.8036666666666668,1,4,1,583736,21874,88724,19232,0.20261958575716033,0.4678635722278986
33056,0.8036904761904762,0,1,0,583737,21873,88724,19232,0.20261032272407278,0.4678749543851113
33057,0.8037142857142857,0,1,0,583738,21872,88724,19232,0.2026010596909852,0.46788633709614635
33058,0.80375,1,1,1,583739,21871,88725,19231,0.20259179665789767,0.4678847744635298
33059,0.8038055555555554,0,1,0,583740,21870,88725,19231,0.2025825336248101,0.46789615824432496
33060,0.8038055555555556,0,1,0,583741,21869,88725,19231,0.20257327059172256,0.4679075425790754
33061,0.8038333333333333,0,3,0,583744,21866,88725,19231,0.20254548149245988,0.46794169890746284
33062,0.8038888888888889,0,2,0,583746,21864,88725,19231,0.2025269554262848,0.4679644725635722
33063,0.8039047619047618,1,0,1,583746,21864,88726,19230,0.2025269554262848,0.46795152577018545
33064,0.8039166666666666,0,1,0,583747,21863,88726,19230,0.20251769239319722,0.4679629133915752
33065,0.8039999999999999,0,3,0,583750,21860,88726,19230,0.20248990329393457,0.4679970795814067
33066,0.804,14,24,14,583774,21836,88740,19216,0.20226759049983326,0.46808925265516904
33067,0.8040476190476191,1,1,1,583775,21835,88741,19215,0.2022583274667457,0.46808769792935445
33068,0.8040476190476195,0,1,0,583776,21834,88741,19215,0.20224906443365814,0.4680991010743258
33069,0.8041150793650793,0,1,0,583777,21833,88741,19215,0.2022398014005706,0.4681105047748977
33070,0.8041666666666666,7,15,7,583792,21818,88748,19208,0.2021008559042573,0.46819090332959584
33071,0.8041666666666667,7,6,7,583798,21812,88755,19201,0.20204527770573197,0.46816862945895205
33072,0.8041666666666668,0,2,0,583800,21810,88755,19201,0.20202675163955686,0.46819146082758284
33073,0.8042142857142857,0,1,0,583801,21809,88755,19201,0.20201748860646931,0.46820287734698857
33074,0.8042698412698411,0,1,0,583802,21808,88755,19201,0.20200822557338174,0.4682142944231754
33075,0.8042777777777775,1,0,1,583802,21808,88756,19200,0.20200822557338174,0.4682013265704253
33076,0.8042857142857143,2,2,2,583804,21806,88758,19198,0.20198969950720663,0.4681982245634572
33077,0.8043333333333332,0,1,0,583805,21805,88758,19198,0.2019804364741191,0.4682096431968393
33078,0.8043333333333333,1,6,1,583811,21799,88759,19197,0.20192485827559375,0.4682651966045468
33079,0.8043333333333336,0,1,0,583812,21798,88759,19197,0.2019155952425062,0.4682766190998902
33080,0.8044444444444443,0,1,0,583813,21797,88759,19197,0.20190633220941864,0.46828804215251013
33081,0.8044444444444444,1,0,1,583813,21797,88760,19196,0.20190633220941864,0.46827507135364577
33082,0.8044523809523809,0,1,0,583814,21796,88760,19196,0.2018970691763311,0.4682864949258392
33083,0.8044642857142857,0,1,0,583815,21795,88760,19196,0.20188780614324353,0.4682979190554024
33084,0.8044761904761906,1,0,1,583815,21795,88761,19195,0.20188780614324353,0.4682849475481825
33085,0.8044999999999999,1,2,1,583817,21793,88762,19194,0.20186928007706845,0.4682948251884744
33086,0.8045,2,4,2,583821,21789,88764,19192,0.20183222794471822,0.46831458480759375
33087,0.8045000000000002,1,0,1,583821,21789,88765,19191,0.20183222794471822,0.4683016105417277
33088,0.8045238095238095,0,1,0,583822,21788,88765,19191,0.20182296491163065,0.4683130383855145
33089,0.8045454545454546,1,0,1,583822,21788,88766,19190,0.20182296491163065,0.4683000634486798
33090,0.8045833333333333,0,1,0,583823,21787,88766,19190,0.2018137018785431,0.46831149181248016
33091,0.8045833333333334,0,1,0,583824,21786,88766,19190,0.20180443884545557,0.46832292073408827
33092,0.8046428571428572,0,2,0,583826,21784,88766,19190,0.20178591277928046,0.4683457802508908
33093,0.8046666666666665,0,3,0,583829,21781,88766,19190,0.20175812368001778,0.4683800737106734
33094,0.8046666666666666,0,3,0,583832,21778,88766,19190,0.20173033458075512,0.4684143721929311
33095,0.804690476190476,0,1,0,583833,21777,88766,19190,0.20172107154766758,0.4684258061366466
33096,0.8047539682539682,1,1,1,583834,21776,88767,19189,0.20171180851458,0.46842426461613573
33097,0.8048333333333332,0,1,0,583835,21775,88767,19189,0.20170254548149247,0.4684356996387072
33098,0.8048333333333333,1,7,1,583842,21768,88768,19188,0.2016377042498796,0.4685027834749487
33099,0.8049166666666667,0,1,0,583843,21767,88768,19188,0.20162844121679202,0.4685142229276035
33100,0.804952380952381,1,0,1,583843,21767,88769,19187,0.20162844121679202,0.4685012452996044
33101,0.8049999999999998,1,4,1,583847,21763,88770,19186,0.2015913890844418,0.468534030135046
33102,0.805,167,262,167,584109,21501,88937,19019,0.1991644744155026,0.4693731490621915
33103,0.8050000000000002,1,2,1,584111,21499,88938,19018,0.1991459483493275,0.46938322185749193
33104,0.8050114052614054,0,1,0,584112,21498,88938,19018,0.19913668531623996,0.46939480698983116
33105,0.805047619047619,3,0,3,584112,21498,88941,19015,0.19913668531623996,0.4693555155135389
33106,0.8051666666666665,0,1,0,584113,21497,88941,19015,0.1991274222831524,0.4693671011058452
33107,0.8051666666666667,4,1,4,584114,21496,88945,19011,0.19911815925006485,0.46932628928333375
33108,0.8051666666666668,0,1,0,584115,21495,88945,19011,0.19910889621697728,0.46933787587024145
33109,0.8052499999999999,0,1,0,584116,21494,88945,19011,0.19909963318388973,0.4693494630292556
33110,0.8052857142857143,1,0,1,584116,21494,88946,19010,0.19909963318388973,0.46933636184080585
33111,0.8053333333333331,1,0,1,584116,21494,88947,19009,0.19909963318388973,0.4693232600054317
33112,0.8053333333333333,3,3,3,584119,21491,88950,19006,0.19907184408462708,0.4693187149665407
33113,0.8053333333333335,0,2,0,584121,21489,88950,19006,0.19905331801845197,0.4693418940609952
33114,0.8053571428571428,0,1,0,584122,21488,88950,19006,0.1990440549853644,0.4693534844668346
33115,0.8053946886446888,1,0,1,584122,21488,88951,19005,0.1990440549853644,0.4693403798187341
33116,0.8054166666666666,3,0,3,584122,21488,88954,19002,0.1990440549853644,0.46930106199061494
33117,0.8054761904761905,1,0,1,584122,21488,88955,19001,0.1990440549853644,0.46928795475314283
33118,0.8054999999999999,0,5,0,584127,21483,88955,19001,0.19899773981992663,0.46934591443533247
33119,0.8055,1,1,1,584128,21482,88956,19000,0.1989884767868391,0.46934439998023814
33120,0.8055000000000001,0,1,0,584129,21481,88956,19000,0.19897921375375152,0.4693559941701045
33121,0.8055555555555556,0,1,0,584130,21480,88956,19000,0.19896995072066398,0.46936758893280633
33122,0.8055897435897437,0,1,0,584131,21479,88956,19000,0.1989606876875764,0.4693791842683861
33123,0.8056190476190476,0,1,0,584132,21478,88956,19000,0.19895142465448887,0.46939078017688624
33124,0.8056428571428573,0,2,0,584134,21476,88956,19000,0.19893289858831376,0.46941397371281746
33125,0.8056666666666666,0,5,0,584139,21471,88956,19000,0.198886583422876,0.4694719675817252
33126,0.8056666666666668,1,1,1,584140,21470,88957,18999,0.19887732038978842,0.46947045886975214
33127,0.8057142857142857,1,5,1,584145,21465,88958,18998,0.19883100522435065,0.46951535971134123
33128,0.8057500000000001,0,1,0,584146,21464,88958,18998,0.1988217421912631,0.46952696357075774
33129,0.8057857142857142,0,1,0,584147,21463,88958,18998,0.19881247915817554,0.4695385680037567
33130,0.8058095238095236,0,1,0,584148,21462,88958,18998,0.198803216125088,0.4695501730103806
33131,0.8058333333333333,9,10,9,584158,21452,88967,18989,0.19871058579421247,0.469548230755916
33132,0.8058333333333334,8,9,8,584167,21443,88975,18981,0.19862721849642448,0.4695477933900653
33133,0.8058412698412698,0,1,0,584168,21442,88975,18981,0.1986179554633369,0.46955940924721074
33134,0.8059166666666665,0,1,0,584169,21441,88975,18981,0.19860869243024937,0.46957102567908565
33135,0.805952380952381,1,1,1,584170,21440,88976,18980,0.1985994293971618,0.46956952003958435
33136,0.8059557664557664,0,1,0,584171,21439,88976,18980,0.19859016636407426,0.4695811375838096
33137,0.8059722222222223,0,1,0,584172,21438,88976,18980,0.19858090333098669,0.46959275570290465
33138,0.8059999999999999,19,16,19,584188,21422,88995,18961,0.19843269480158582,0.4695292573607706
33139,0.806,3,1,3,584189,21421,88998,18958,0.19842343176849828,0.4695014735382253
33140,0.8060238095238094,1,0,1,584189,21421,88999,18957,0.19842343176849828,0.4694883352320571
33141,0.8060833333333334,0,1,0,584190,21420,88999,18957,0.19841416873541073,0.46949996285013745
33142,0.8061666666666666,0,1,0,584191,21419,88999,18957,0.19840490570232316,0.46951159104418466
33143,0.8061666666666667,1,1,1,584192,21418,89000,18956,0.19839564266923562,0.4695100807450339
33144,0.80625,1,1,1,584193,21417,89001,18955,0.19838637963614805,0.46950857029624493
33145,0.8062777777777776,0,1,0,584194,21416,89001,18955,0.1983771166030605,0.46952020014366747
33146,0.806277777777778,0,1,0,584195,21415,89001,18955,0.19836785356997294,0.4695318305672529
33147,0.8062857142857144,0,1,0,584196,21414,89001,18955,0.1983585905368854,0.469543461567044
33148,0.8063095238095238,0,3,0,584199,21411,89001,18955,0.19833080143762274,0.46957835802407966
33149,0.8063333333333332,1,2,1,584201,21409,89002,18954,0.19831227537144763,0.46958848450313406
33150,0.8063333333333333,0,4,0,584205,21405,89002,18954,0.1982752232390974,0.46963502564483756
33151,0.8063665223665224,0,1,0,584206,21404,89002,18954,0.19826596020600987,0.46964666237177266
33152,0.8063809523809523,0,1,0,584207,21403,89002,18954,0.1982566971729223,0.4696582996753971
33153,0.8064166666666667,0,1,0,584208,21402,89002,18954,0.19824743413983476,0.4696699375557538
33154,0.8064285714285714,0,2,0,584210,21400,89002,18954,0.19822890807365964,0.46969321504683553
33155,0.8064761904761905,1,0,1,584210,21400,89003,18953,0.19822890807365964,0.46968007335266276
33156,0.8064999999999999,0,3,0,584213,21397,89003,18953,0.198201118974397,0.4697149938042131
33157,0.8065000000000001,1,4,1,584217,21393,89004,18952,0.19816406684204677,0.46974841987854754
33158,0.8065454545454545,0,4,0,584221,21389,89004,18952,0.19812701470969654,0.4697949976450757
33159,0.8066666666666665,44,78,44,584299,21311,89048,18908,0.19740449812886732,0.47012605982247196
33160,0.8066666666666668,41,56,41,584355,21255,89089,18867,0.19688576827596427,0.4702407656647226
33161,0.8067142857142856,0,1,0,584356,21254,89089,18867,0.19687650524287673,0.4702524862291568
33162,0.8067380952380953,0,1,0,584357,21253,89089,18867,0.19686724220978918,0.4702642073778664
33163,0.8067380952380954,0,1,0,584358,21252,89089,18867,0.19685797917670161,0.4702759291108951
33164,0.8067405070419774,2,0,2,584358,21252,89091,18865,0.19685797917670161,0.47024952015355087
33165,0.8068333333333332,1,1,1,584359,21251,89092,18864,0.19684871614361407,0.47024803689392997
33166,0.8068333333333334,2,1,2,584360,21250,89094,18862,0.1968394531105265,0.47023334662943755
33167,0.8069841269841269,0,2,0,584362,21248,89094,18862,0.1968209270443514,0.47025679381700325
33168,0.8069999999999999,2,0,2,584362,21248,89096,18860,0.1968209270443514,0.4702303779794555
33169,0.807,4,7,4,584369,21241,89100,18856,0.1967560858127385,0.47025962042048036
33170,0.8070119047619047,0,1,0,584370,21240,89100,18856,0.19674682277965097,0.4702713487629689
33171,0.8070238095238096,0,1,0,584371,21239,89100,18856,0.19673755974656343,0.4702830776904851
33172,0.8070714285714287,0,1,0,584372,21238,89100,18856,0.19672829671347586,0.47029480720307276
33173,0.8071031746031746,1,6,1,584378,21232,89101,18855,0.19667271851495052,0.47035198443385634
33174,0.807142857142857,1,0,1,584378,21232,89102,18854,0.19667271851495052,0.47033877164097193
33175,0.8071428571428573,2,5,2,584383,21227,89104,18852,0.19662640334951276,0.47037101724094915
33176,0.8071507936507939,1,3,1,584386,21224,89105,18851,0.1965986142502501,0.4703930131004367
33177,0.8071666666666667,0,1,0,584387,21223,89105,18851,0.19658935121716256,0.47040475121026104
33178,0.8071746031746031,0,1,0,584388,21222,89105,18851,0.196580088184075,0.4704164899059217
33179,0.8071904761904761,0,2,0,584390,21220,89105,18851,0.19656156211789988,0.4704399690549275
33180,0.8072261904761906,0,1,0,584391,21219,89105,18851,0.19655229908481234,0.47045170950836035
33181,0.8072857142857143,0,1,0,584392,21218,89105,18851,0.19654303605172477,0.47046345054780503
33182,0.8073109668109669,0,1,0,584393,21217,89105,18851,0.19653377301863723,0.47047519217330536
33183,0.8073333333333332,1,1,1,584394,21216,89106,18850,0.19652450998554966,0.47047371836469826
33184,0.8073333333333333,4,4,4,584398,21212,89110,18846,0.19648745785319946,0.470467821658595
33185,0.8073333333333335,2,1,2,584399,21211,89112,18844,0.1964781948201119,0.47045312695044317
33186,0.8073650793650795,0,2,0,584401,21209,89112,18844,0.19645966875393678,0.4704766184805133
33187,0.8073809523809521,0,2,0,584403,21207,89112,18844,0.1964411426877617,0.47050011235674516
33188,0.8073809523809525,1,1,1,584404,21206,89113,18843,0.19643187965467412,0.4704986391670204
33189,0.8074126984126986,0,1,0,584405,21205,89113,18843,0.19642261662158658,0.47051038753495805
33190,0.8074166666666668,0,1,0,584406,21204,89113,18843,0.196413353588499,0.4705221364896247
33191,0.8074285714285716,1,0,1,584406,21204,89114,18842,0.196413353588499,0.47050891474803974
33192,0.8074999999999999,3,0,3,584406,21204,89117,18839,0.196413353588499,0.4704692455610219
33193,0.8075,42,60,42,584466,21144,89159,18797,0.19585757160324577,0.4706191632658171
33194,0.8075000000000001,1,2,1,584468,21142,89160,18796,0.19583904553707066,0.47062947568731534
33195,0.807545815295815,0,2,0,584470,21140,89160,18796,0.19582051947089554,0.4706530448717949
33196,0.8076428571428571,1,1,1,584471,21139,89161,18795,0.195811256437808,0.4706515750989132
33197,0.8076666666666665,1,5,1,584476,21134,89162,18794,0.19576494127237024,0.47069725505910637
33198,0.8076666666666666,1,7,1,584483,21127,89163,18793,0.19570010004075736,0.47076653306613225
33199,0.8076666666666668,0,1,0,584484,21126,89163,18793,0.1956908370076698,0.4707783261103735
33200,0.8077142857142857,1,0,1,584484,21126,89164,18792,0.1956908370076698,0.47076506839019994
33201,0.8078333333333332,2,2,2,584486,21124,89166,18790,0.19567231094149468,0.47076213859798566
33202,0.8078333333333333,0,3,0,584489,21121,89166,18790,0.19564452184223202,0.4707975244919947
33203,0.8078333333333334,0,1,0,584490,21120,89166,18790,0.19563525880914448,0.4708093209721874
33204,0.8078571428571428,1,0,1,584490,21120,89167,18789,0.19563525880914448,0.4707960610388634
33205,0.8079642857142858,0,4,0,584494,21116,89167,18789,0.19559820667679426,0.4708432527252224
33206,0.8079999999999998,0,1,0,584495,21115,89167,18789,0.1955889436437067,0.47085505212510026
33207,0.8079999999999999,8,18,8,584513,21097,89175,18781,0.1954222090481307,0.4709614323687246
33208,0.8080000000000002,2,2,2,584515,21095,89177,18779,0.19540368298195562,0.4709585193359081
33209,0.808025974025974,0,1,0,584516,21094,89177,18779,0.19539441994886805,0.47097033080029094
33210,0.808121212121212,0,1,0,584517,21093,89177,18779,0.1953851569157805,0.47098214285714285
33211,0.8081309523809526,0,1,0,584518,21092,89177,18779,0.19537589388269294,0.47099395550650847
33212,0.8081547619047619,0,1,0,584519,21091,89177,18779,0.1953666308496054,0.4710057687484324
33213,0.8081666666666666,0,4,0,584523,21087,89177,18779,0.19532957871725518,0.4710530276426027
33214,0.8081666666666668,1,1,1,584524,21086,89178,18778,0.19532031568416763,0.4710515753562111
33215,0.8081818181818181,0,1,0,584525,21085,89178,18778,0.19531105265108006,0.4710633921180042
33216,0.8082142857142857,0,1,0,584526,21084,89178,18778,0.19530178961799252,0.4710752094726807
33217,0.8082499999999999,0,3,0,584529,21081,89178,18778,0.19527400051872984,0.471110665094458
33218,0.8083167388167389,0,2,0,584531,21079,89178,18778,0.19525547445255476,0.4711343051408786
33219,0.8083333333333331,1,0,1,584531,21079,89179,18777,0.19525547445255476,0.471121035728623
33220,0.8083333333333332,22,32,22,584563,21047,89201,18755,0.19495905739375302,0.47120747701120547
33221,0.8083333333333335,21,34,21,584597,21013,89222,18734,0.19464411426877617,0.47133116964802374
33222,0.8083333333333336,1,0,1,584597,21013,89223,18733,0.19464411426877617,0.47131786846475116
33223,0.8083809523809525,0,1,0,584598,21012,89223,18733,0.1946348512356886,0.4713297270096867
33224,0.8085,1,4,1,584602,21008,89224,18732,0.1945977991033384,0.4713638651233015
33225,0.8085692640692639,0,3,0,584605,21005,89224,18732,0.19457001000407573,0.4713994513929084
33226,0.8085714285714286,2,1,2,584606,21004,89226,18730,0.19456074697098819,0.47138470831026325
33227,0.8085833333333334,0,1,0,584607,21003,89226,18730,0.19455148393790062,0.47139657211889363
33228,0.8085952380952383,1,0,1,584607,21003,89227,18729,0.19455148393790062,0.4713832678948958
33229,0.8086428571428571,0,1,0,584608,21002,89227,18729,0.19454222090481307,0.4713951322644786
33230,0.8086666666666666,0,2,0,584610,21000,89227,18729,0.19452369483863796,0.4714188627954391
33231,0.8086666666666668,0,9,0,584619,20991,89227,18729,0.19444032754084997,0.47152567975830817
33232,0.8087380952380951,1,1,1,584620,20990,89228,18728,0.19443106450776243,0.4715242459338335
33233,0.80875,0,3,0,584623,20987,89228,18728,0.19440327540849975,0.47155986403122246
33234,0.8087738095238093,0,1,0,584624,20986,89228,18728,0.1943940123754122,0.47157173792617213
33235,0.8088333333333333,2,2,2,584626,20984,89230,18726,0.1943754863092371,0.47156887433895744
33236,0.8088465423465422,0,2,0,584628,20982,89230,18726,0.19435696024306198,0.47159262617104863
33237,0.808857142857143,1,0,1,584628,20982,89231,18725,0.19435696024306198,0.4715793185080716
33238,0.8089747474747475,0,3,0,584631,20979,89231,18725,0.19432917114379933,0.4716149506346968
33239,0.8089761904761904,0,1,0,584632,20978,89231,18725,0.19431990811071176,0.47162682920686094
33240,0.8089999999999999,2,4,2,584636,20974,89233,18723,0.19428285597836156,0.4716477315666171
33241,0.809,7,9,7,584645,20965,89240,18716,0.19419948868057357,0.4716615004662181
33242,0.809047619047619,0,2,0,584647,20963,89240,18716,0.19418096261439846,0.4716852743264699
33243,0.8090964868464867,0,4,0,584651,20959,89240,18716,0.19414391048204824,0.47173282923755516
33244,0.8091666666666666,4,9,4,584660,20950,89244,18712,0.19406054318426025,0.4717865967424739
33245,0.8091666666666667,4,13,4,584673,20937,89248,18708,0.19394012375412206,0.4718880060537268
33246,0.8092142857142857,1,0,1,584673,20937,89249,18707,0.19394012375412206,0.4718746846937746
33247,0.8092142857142858,1,0,1,584673,20937,89250,18706,0.19394012375412206,0.47186136266175616
33248,0.809284632034632,2,3,2,584676,20934,89252,18704,0.19391233465485938,0.4718704273676775
33249,0.8093333333333332,0,8,0,584684,20926,89252,18704,0.19383823039015896,0.47196568256371435
33250,0.8093333333333333,2,9,2,584693,20917,89254,18702,0.19375486309237097,0.47204624044019283
33251,0.8093333333333335,0,1,0,584694,20916,89254,18702,0.1937456000592834,0.4720581553839164
33252,0.809345238095238,2,0,2,584694,20916,89256,18700,0.1937456000592834,0.4720315024232633
33253,0.8093888888888889,1,0,1,584694,20916,89257,18699,0.1937456000592834,0.4720181749337372
33254,0.8094603174603175,0,1,0,584695,20915,89257,18699,0.19373633702619586,0.47203009037209065
33255,0.8094642857142857,0,1,0,584696,20914,89257,18699,0.1937270739931083,0.4720420064120365
33256,0.8094999999999999,0,3,0,584699,20911,89257,18699,0.19369928489384564,0.47207775814188335
33257,0.8095,2,2,2,584701,20909,89259,18697,0.19368075882767052,0.47207493814068574
33258,0.8095000000000002,1,0,1,584701,20909,89260,18696,0.19368075882767052,0.47206160838277994
33259,0.8095238095238095,1,0,1,584701,20909,89261,18695,0.19368075882767052,0.47204827795172205
33260,0.8095833333333334,0,1,0,584702,20908,89261,18695,0.19367149579458298,0.4720601974597884
33261,0.8096428571428571,2,0,2,584702,20908,89263,18693,0.19367149579458298,0.4720335345067044
33262,0.8096428571428572,1,0,1,584702,20908,89264,18692,0.19367149579458298,0.472020202020202
33263,0.8096666666666665,2,0,2,584702,20908,89266,18690,0.19367149579458298,0.47199353502702157
33264,0.8096666666666666,2,5,2,584707,20903,89268,18688,0.19362518062914522,0.4720264706625243
33265,0.8096666666666669,0,2,0,584709,20901,89268,18688,0.1936066545629701,0.4720503170072495
33266,0.809702380952381,1,0,1,584709,20901,89269,18687,0.1936066545629701,0.47203698090330404
33267,0.8097857142857141,0,1,0,584710,20900,89269,18687,0.19359739152988253,0.47204890494354207
33268,0.8098333333333332,0,1,0,584711,20899,89269,18687,0.193588128496795,0.47206082958621737
33269,0.8098333333333333,2,5,2,584716,20894,89271,18685,0.19354181333135723,0.47209378710932565
33270,0.8098809523809523,0,1,0,584717,20893,89271,18685,0.19353255029826966,0.4721057152963768
33271,0.8099047619047619,0,1,0,584718,20892,89271,18685,0.19352328726518211,0.4721176440862117
33272,0.8099999999999998,0,8,0,584726,20884,89271,18685,0.19344918300048167,0.47221309611059165
33273,0.81,817,1021,817,585747,19863,90088,17868,0.18399162621808884,0.4735628528265882
33274,0.8100000000000002,4,1,4,585748,19862,90092,17864,0.1839823631850013,0.4735195886126279
33275,0.810047619047619,0,1,0,585749,19861,90092,17864,0.18397310015191373,0.473532140490391
33276,0.8100858585858586,0,1,0,585750,19860,90092,17864,0.1839638371188262,0.4735446930336126
33277,0.8101190476190476,0,1,0,585751,19859,90092,17864,0.18395457408573865,0.4735572462423455
33278,0.810142857142857,0,1,0,585752,19858,90092,17864,0.18394531105265108,0.4735698001166428
33279,0.8101547619047619,0,1,0,585753,19857,90092,17864,0.18393604801956354,0.47358235465655735
33280,0.8101666666666667,1,1,1,585754,19856,90093,17863,0.18392678498647597,0.47358095389591454
33281,0.8101666666666668,0,5,0,585759,19851,90093,17863,0.1838804698210382,0.47364373972530094
33282,0.8101879509379508,0,2,0,585761,19849,90093,17863,0.1838619437548631,0.47366885871871023
33283,0.8102142857142858,0,1,0,585762,19848,90093,17863,0.18385268072177555,0.47368141921455276
33284,0.8102857142857144,0,2,0,585764,19846,90093,17863,0.18383415465560043,0.4737065422047787
33285,0.8103207070707069,1,3,1,585767,19843,90094,17862,0.18380636555633778,0.47373027449940325
33286,0.810325396825397,0,1,0,585768,19842,90094,17862,0.1837971025232502,0.47374283895607894
33287,0.8103333333333331,0,2,0,585770,19840,90094,17862,0.1837785764570751,0.47376796986897246
33288,0.8103333333333333,1,0,1,585770,19840,90095,17861,0.1837785764570751,0.47375401182992494
33289,0.8103333333333335,1,0,1,585770,19840,90096,17860,0.1837785764570751,0.4737400530503979
33290,0.8103571428571428,0,1,0,585771,19839,90096,17860,0.18376931342398756,0.4737526194328762
33291,0.8104166666666667,1,1,1,585772,19838,90097,17859,0.1837600503909,0.4737512268880813
33292,0.8104761904761905,1,1,1,585773,19837,90098,17858,0.18375078735781245,0.47374983419551664
33293,0.8105,2,5,2,585778,19832,90100,17856,0.18370447219237468,0.47378475907450646
33294,0.8105952380952381,1,1,1,585779,19831,90101,17855,0.1836952091592871,0.47378336782890196
33295,0.8106190476190477,0,1,0,585780,19830,90101,17855,0.18368594612619957,0.47379594002918934
33296,0.8106428571428572,1,1,1,585781,19829,90102,17854,0.183676683093112,0.47379454926624737
33297,0.8106666666666666,3,4,3,585785,19825,90105,17851,0.1836396309607618,0.47380295148104895
33298,0.8106666666666668,2,2,2,585787,19823,90107,17849,0.1836211048945867,0.47380016988744955
33299,0.8107142857142855,0,1,0,585788,19822,90107,17849,0.18361184186149912,0.47381274720607364
33300,0.8107741702741703,0,1,0,585789,19821,90107,17849,0.18360257882841158,0.47382532519246084
33301,0.8108333333333333,6,20,6,585809,19801,90113,17843,0.1834173181666605,0.4739931994474551
33302,0.8108333333333334,8,11,8,585820,19790,90121,17835,0.18331542480269739,0.47401993355481725
33303,0.8108571428571429,2,1,2,585821,19789,90123,17833,0.18330616176960984,0.4740045717930998
33304,0.8109523809523808,0,1,0,585822,19788,90123,17833,0.18329689873652227,0.47401717126073206
33305,0.8109999999999999,9,20,9,585842,19768,90132,17824,0.1831116380747712,0.474143434773356
33306,0.811,0,2,0,585844,19766,90132,17824,0.1830931120085961,0.4741686618781591
33307,0.8110054945054945,1,0,1,585844,19766,90133,17823,0.1830931120085961,0.4741546729096278
33308,0.811111111111111,0,1,0,585845,19765,90133,17823,0.18308384897550853,0.4741672874321592
33309,0.8111111111111111,0,1,0,585846,19764,90133,17823,0.183074585942421,0.47417990262590787
33310,0.8111190476190475,0,2,0,585848,19762,90133,17823,0.18305605987624587,0.4742051350272715
33311,0.8111666666666666,1,0,1,585848,19762,90134,17822,0.18305605987624587,0.47419114516815664
33312,0.8111666666666667,0,2,0,585850,19760,90134,17822,0.18303753381007076,0.474216380182002
33313,0.8111904761904762,0,1,0,585851,19759,90134,17822,0.18302827077698322,0.47422899869614965
33314,0.8112045454545455,0,1,0,585852,19758,90134,17822,0.18301900774389565,0.47424161788185204
33315,0.8112142857142858,0,1,0,585853,19757,90134,17822,0.1830097447108081,0.4742542377391628
33316,0.8112222222222222,0,1,0,585854,19756,90134,17822,0.18300048167772054,0.47426685826813564
33317,0.81125,0,2,0,585856,19754,90134,17822,0.18298195561154545,0.4742921013412817
33318,0.8112777777777778,1,0,1,585856,19754,90135,17821,0.18298195561154545,0.4742781104457751
33319,0.8112857142857142,0,1,0,585857,19753,90135,17821,0.18297269257845789,0.47429073295363816
33320,0.8113095238095238,0,1,0,585858,19752,90135,17821,0.18296342954537034,0.47430335613339364
33321,0.8113333333333332,1,6,1,585864,19746,90136,17820,0.182907851346845,0.47436511739338766
33322,0.8113333333333334,1,1,1,585865,19745,90137,17819,0.18289858831375747,0.47436375252901714
33323,0.8113888888888888,1,1,1,585866,19744,90138,17818,0.1828893252806699,0.47436238751930143
33324,0.8114141414141414,1,5,1,585871,19739,90139,17817,0.18284301011523213,0.4744115454254979
33325,0.8114285714285714,1,2,1,585873,19737,90140,17816,0.18282448404905702,0.47442281575373474
33326,0.8114523809523808,1,0,1,585873,19737,90141,17815,0.18282448404905702,0.47440881976991905
33327,0.8114999999999999,0,3,0,585876,19734,90141,17815,0.18279669494979436,0.4744467229486804
33328,0.8115000000000001,2,3,2,585879,19731,90143,17813,0.1827689058505317,0.4744566375452802
33329,0.8115238095238095,0,1,0,585880,19730,90143,17813,0.18275964281744414,0.47446927523106835
33330,0.8115555555555554,1,0,1,585880,19730,90144,17812,0.18275964281744414,0.4744552767566992
33331,0.8115555555555555,0,1,0,585881,19729,90144,17812,0.1827503797843566,0.4744679150795131
33332,0.8115714285714286,0,1,0,585882,19728,90144,17812,0.18274111675126903,0.47448055407565265
33333,0.8116666666666665,18,30,18,585912,19698,90162,17794,0.1824632257586424,0.47460791635548916
33334,0.8116666666666668,18,31,18,585943,19667,90180,17776,0.18217607173292824,0.4747482840584355
33335,0.8117857142857143,0,1,0,585944,19666,90180,17776,0.18216680869984067,0.47476096362373804
33336,0.8118095238095238,1,0,1,585944,19666,90181,17775,0.18216680869984067,0.4747469351780134
33337,0.8118333333333332,2,2,2,585946,19664,90183,17773,0.18214828263366556,0.4747442369848011
33338,0.8118333333333334,2,0,2,585946,19664,90185,17771,0.18214828263366556,0.47471617470281824
33339,0.8118809523809525,0,2,0,585948,19662,90185,17771,0.18212975656749045,0.474741538214944
33340,0.8119047619047619,1,0,1,585948,19662,90186,17770,0.18212975656749045,0.4747275058773242
33341,0.811904761904762,1,0,1,585948,19662,90187,17769,0.18212975656749045,0.4747134727899335
33342,0.811952380952381,1,2,1,585950,19660,90188,17768,0.18211123050131536,0.47472480495885433
33343,0.8119642857142857,0,1,0,585951,19659,90188,17768,0.1821019674682278,0.4747374889785449
33344,0.8119999999999998,0,6,0,585957,19653,90188,17768,0.18204638926970246,0.47481360733278105
33345,0.812,2,11,2,585968,19642,90190,17766,0.18194449590573938,0.4749251497005988
33346,0.8120000000000002,0,3,0,585971,19639,90190,17766,0.1819167068064767,0.47496324020852826
33347,0.8120458152958153,0,3,0,585974,19636,90190,17766,0.18188891770721405,0.47500133682690765
33348,0.8120476190476191,0,1,0,585975,19635,90190,17766,0.1818796546741265,0.4750140370578327
33349,0.8120555555555555,0,1,0,585976,19634,90190,17766,0.18187039164103894,0.47502673796791445
33350,0.8120833333333334,0,1,0,585977,19633,90190,17766,0.1818611286079514,0.4750394395572074
33351,0.8121428571428573,0,1,0,585978,19632,90190,17766,0.18185186557486382,0.4750521418257661
33352,0.8121666666666666,0,2,0,585980,19630,90190,17766,0.1818333395086887,0.4750775484008985
33353,0.8121666666666667,5,0,5,585980,19630,90195,17761,0.1818333395086887,0.47500735471102673
33354,0.8121785714285711,0,2,0,585982,19628,90195,17761,0.18181481344251363,0.475032763647062
33355,0.8122499999999999,1,0,1,585982,19628,90196,17760,0.18181481344251363,0.47501872258478656
33356,0.8123095238095239,1,0,1,585982,19628,90197,17759,0.18181481344251363,0.47500468077139113
33357,0.8123333333333332,0,3,0,585985,19625,90197,17759,0.18178702434325095,0.47504279905842073
33358,0.8123333333333334,2,9,2,585994,19616,90199,17757,0.18170365704546296,0.47512910389853635
33359,0.8123809523809523,2,0,2,585994,19616,90201,17755,0.18170365704546296,0.4751010141553611
33360,0.8123809523809524,1,0,1,585994,19616,90202,17754,0.18170365704546296,0.4750869681562751
33361,0.8124999999999999,1,1,1,585995,19615,90203,17753,0.18169439401237542,0.4750856347677157
33362,0.8125,48,70,48,586065,19545,90251,17705,0.1810459816962466,0.4753020134228188
33363,0.8125000000000001,1,2,1,586067,19543,90252,17704,0.1810274556300715,0.47531344806293124
33364,0.8125396825396822,0,1,0,586068,19542,90252,17704,0.18101819259698396,0.47532620952585514
33365,0.8125476190476191,0,1,0,586069,19541,90252,17704,0.18100892956389641,0.4753389716740502
33366,0.8125714285714285,1,0,1,586069,19541,90253,17703,0.18100892956389641,0.47532488454516164
33367,0.8125952380952381,1,0,1,586069,19541,90254,17702,0.18100892956389641,0.475310796659775
33368,0.8126190476190476,1,0,1,586069,19541,90255,17701,0.18100892956389641,0.4752967080178293
33369,0.8126309523809523,0,2,0,586071,19539,90255,17701,0.1809904034977213,0.4753222341568206
33370,0.8126666666666666,5,6,5,586077,19533,90260,17696,0.18093482529919597,0.4753283730425206
33371,0.8126666666666668,1,4,1,586081,19529,90261,17695,0.18089777316684574,0.4753653556845046
33372,0.8126904761904761,0,1,0,586082,19528,90261,17695,0.1808885101337582,0.475378126427209
33373,0.8127142857142856,0,1,0,586083,19527,90261,17695,0.18087924710067063,0.4753908978561066
33374,0.8127142857142857,1,1,1,586084,19526,90262,17694,0.1808699840675831,0.4753895754970446
33375,0.8127261904761904,1,0,1,586084,19526,90263,17693,0.1808699840675831,0.47537548026545584
33376,0.8127420634920636,0,1,0,586085,19525,90263,17693,0.18086072103449555,0.47538825299586224
33377,0.8128095238095238,1,1,1,586086,19524,90264,17692,0.18085145800140798,0.47538693035253654
33378,0.8128333333333332,1,0,1,586086,19524,90265,17691,0.18085145800140798,0.475372833534865
33379,0.8128333333333333,2,1,2,586087,19523,90267,17689,0.18084219496832044,0.4753574115876599
33380,0.8128333333333334,0,2,0,586089,19521,90267,17689,0.18082366890214532,0.4753829615694706
33381,0.8128571428571427,0,1,0,586090,19520,90267,17689,0.18081440586905775,0.4753957375903679
33382,0.8128809523809523,1,0,1,586090,19520,90268,17688,0.18081440586905775,0.4753816383573425
33383,0.8129166666666666,0,2,0,586092,19518,90268,17688,0.18079587980288267,0.47540719238832446
33384,0.8129444444444444,0,1,0,586093,19517,90268,17688,0.1807866167697951,0.47541997043408146
33385,0.8129761904761905,0,1,0,586094,19516,90268,17688,0.18077735373670756,0.47543274916675626
33386,0.813,5,4,5,586098,19512,90273,17683,0.18074030160435733,0.47541336201102297
33387,0.8130000000000002,0,1,0,586099,19511,90273,17683,0.18073103857126976,0.47542614400172073
33388,0.8130000000000003,0,1,0,586100,19510,90273,17683,0.18072177553818222,0.4754389266797516
33389,0.8130476190476191,0,1,0,586101,19509,90273,17683,0.18071251250509468,0.475451710045171
33390,0.813095238095238,0,1,0,586102,19508,90273,17683,0.1807032494720071,0.4754644940980345
33391,0.8131031746031744,0,1,0,586103,19507,90273,17683,0.18069398643891957,0.4754772788383974
33392,0.8131071428571427,0,1,0,586104,19506,90273,17683,0.180684723405832,0.4754900642663153
33393,0.8131666666666665,1,2,1,586106,19504,90274,17682,0.1806661973396569,0.4755015328349379
33394,0.8131666666666666,0,3,0,586109,19501,90274,17682,0.18063840824039423,0.4755398972648791
33395,0.8131666666666668,1,3,1,586112,19498,90275,17681,0.18061061914113158,0.47556416256488876
33396,0.8132619047619047,0,1,0,586113,19497,90275,17681,0.180601356108044,0.4755769541126473
33397,0.8133095238095239,0,1,0,586114,19496,90275,17681,0.18059209307495647,0.47558974634854884
33398,0.8133333333333331,2,2,2,586116,19494,90277,17679,0.18057356700878135,0.47558711968364137
33399,0.8133333333333332,46,69,46,586185,19425,90323,17633,0.17993441772574012,0.4758216849263317
33400,0.8133333333333335,52,58,52,586243,19367,90375,17581,0.179397161806662,0.475830897477536
33401,0.8133838383838384,0,1,0,586244,19366,90375,17581,0.17938789877357442,0.4758437762199908
33402,0.813416666666667,1,0,1,586244,19366,90376,17580,0.17938789877357442,0.4758295891300817
33403,0.8134999999999999,1,6,1,586250,19360,90377,17579,0.17933232057504908,0.4758926879449904
33404,0.813547619047619,1,1,1,586251,19359,90378,17578,0.17932305754196154,0.4758913826244687
33405,0.8135833333333333,1,1,1,586252,19358,90379,17577,0.179313794508874,0.4758900771625829
33406,0.8136428571428571,1,0,1,586252,19358,90380,17576,0.179313794508874,0.4758758867168463
33407,0.8136666666666668,4,6,4,586258,19352,90384,17572,0.17925821631034866,0.47589643592243525
33408,0.8137380952380951,0,1,0,586259,19351,90384,17572,0.17924895327726112,0.4759093248110934
33409,0.8137499999999999,0,1,0,586260,19350,90384,17572,0.17923969024417355,0.47592221439791993
33410,0.81375,1,2,1,586262,19348,90385,17571,0.17922116417799844,0.47593380102386307
33411,0.8138095238095238,1,0,1,586262,19348,90386,17570,0.17922116417799844,0.4759196056124384
33412,0.8138214285714285,0,1,0,586263,19347,90386,17570,0.1792119011449109,0.4759324972235014
33413,0.8138243145743145,0,3,0,586266,19344,90386,17570,0.17918411204564821,0.4759711762474942
33414,0.8138333333333333,4,5,4,586271,19339,90390,17566,0.17913779688021045,0.4759788646524861
33415,0.8139166666666666,0,1,0,586272,19338,90390,17566,0.1791285338471229,0.4759917624105788
33416,0.8139285714285713,0,1,0,586273,19337,90390,17566,0.17911927081403534,0.4760046608676801
33417,0.8139444444444445,1,0,1,586273,19337,90391,17565,0.17911927081403534,0.475990461221614
33418,0.8139642857142857,1,0,1,586273,19337,90392,17564,0.17911927081403534,0.47597626080594024
33419,0.814,0,1,0,586274,19336,90392,17564,0.1791100077809478,0.4759891598915989
33420,0.8140000000000001,11,29,11,586303,19307,90403,17553,0.1788413798214087,0.4762072707542051
33421,0.814047619047619,0,3,0,586306,19304,90403,17553,0.17881359072214606,0.47624603196136417
33422,0.8140714285714284,0,2,0,586308,19302,90403,17553,0.17879506465597095,0.4762718762718763
33423,0.8140833333333335,1,0,1,586308,19302,90404,17552,0.17879506465597095,0.4762576653823194
33424,0.8141666666666666,3,13,3,586321,19289,90407,17549,0.17867464522583273,0.4763830826863565
33425,0.8141666666666667,11,18,11,586339,19271,90418,17538,0.17850791063025678,0.47645956152028035
33426,0.8142777777777779,1,0,1,586339,19271,90419,17537,0.17850791063025678,0.47644533797000654
33427,0.8142857142857142,0,1,0,586340,19270,90419,17537,0.1784986475971692,0.4764582823919363
33428,0.8142857142857143,0,3,0,586343,19267,90419,17537,0.17847085849790656,0.4764971198782741
33429,0.8143333333333332,2,2,2,586345,19265,90421,17535,0.17845233243173145,0.4764945652173913
33430,0.8143333333333334,1,8,1,586353,19257,90422,17534,0.178378228167031,0.47658394716099045
33431,0.8144871794871794,0,1,0,586354,19256,90422,17534,0.17836896513394346,0.47659690133188365
33432,0.8144999999999999,1,0,1,586354,19256,90423,17533,0.17836896513394346,0.4765826741689092
33433,0.8145,1,8,1,586362,19248,90424,17532,0.17829486086924304,0.4766721044045677
33434,0.8145238095238096,0,2,0,586364,19246,90424,17532,0.17827633480306793,0.4766980259938006
33435,0.8145277777777779,1,1,1,586365,19245,90425,17531,0.17826707176998036,0.47669675875571027
33436,0.8145317460317462,0,1,0,586366,19244,90425,17531,0.17825780873689281,0.4767097212780422
33437,0.8146428571428571,1,0,1,586366,19244,90426,17530,0.17825780873689281,0.4766954913797792
33438,0.8146666666666665,0,6,0,586372,19238,90426,17530,0.17820223053836748,0.4767732811140122
33439,0.8146666666666667,3,4,3,586376,19234,90429,17527,0.17816517840601725,0.47678245967193494
33440,0.8146904761904762,0,1,0,586377,19233,90429,17527,0.1781559153729297,0.4767954298150163
33441,0.8148333333333333,2,7,2,586384,19226,90431,17525,0.17809107414131684,0.4768577725776169
33442,0.8148333333333335,0,1,0,586385,19225,90431,17525,0.17808181110822927,0.47687074829931975
33443,0.8148571428571428,0,1,0,586386,19224,90431,17525,0.17807254807514172,0.4768837247272035
33444,0.8148809523809524,0,1,0,586387,19223,90431,17525,0.17806328504205418,0.47689670186132577
33445,0.8148968253968255,0,2,0,586389,19221,90431,17525,0.17804475897587907,0.4769226582485169
33446,0.8149999999999998,1,5,1,586394,19216,90432,17524,0.1779984438104413,0.4769733260751225
33447,0.815,170,247,170,586641,18969,90602,17354,0.17571047463781542,0.4777689067532968
33448,0.8150000000000002,1,1,1,586642,18968,90603,17353,0.17570121160472785,0.47776768260785774
33449,0.8151269841269841,0,1,0,586643,18967,90603,17353,0.1756919485716403,0.47778083700440527
33450,0.8151666666666665,1,0,1,586643,18967,90604,17352,0.1756919485716403,0.4777664583275971
33451,0.8151666666666667,1,5,1,586648,18962,90605,17351,0.17564563340620254,0.4778178613719605
33452,0.8151666666666668,1,1,1,586649,18961,90606,17350,0.17563637037311497,0.47781663958580045
33453,0.8151749639249637,3,3,3,586652,18958,90609,17347,0.17560858127385232,0.4778129734196392
33454,0.8152857142857144,1,1,1,586653,18957,90610,17346,0.17559931824076475,0.47781175109495083
33455,0.8153225108225108,0,2,0,586655,18955,90610,17346,0.17558079217458963,0.4778380760860582
33456,0.8153333333333334,3,5,3,586660,18950,90613,17343,0.17553447700915187,0.4778607444961838
33457,0.8153333333333335,0,1,0,586661,18949,90613,17343,0.17552521397606433,0.47787391160586357
33458,0.8153809523809524,0,2,0,586663,18947,90613,17343,0.17550668790988921,0.4779002480022045
33459,0.8154166666666667,0,1,0,586664,18946,90613,17343,0.17549742487680167,0.4779134172889856
33460,0.8154545454545457,1,0,1,586664,18946,90614,17342,0.17549742487680167,0.47789902998236333
33461,0.8154761904761904,1,0,1,586664,18946,90615,17341,0.17549742487680167,0.4778846418827679
33462,0.8154999999999998,0,1,0,586665,18945,90615,17341,0.1754881618437141,0.4778978118282533
33463,0.8155,3,4,3,586669,18941,90618,17338,0.17545110971136388,0.4779073293089666
33464,0.8155000000000001,0,1,0,586670,18940,90618,17338,0.17544184667827634,0.47792050278405646
33465,0.8155396825396827,0,4,0,586674,18936,90618,17338,0.1754047945459261,0.4779732039477312
33466,0.8155714285714286,0,1,0,586675,18935,90618,17338,0.17539553151283857,0.47798638105477903
33467,0.8156666666666665,1,1,1,586676,18934,90619,17337,0.175386268479751,0.47798516721347634
33468,0.8156666666666667,2,2,2,586678,18932,90621,17335,0.1753677424135759,0.47798273912923595
33469,0.8156666666666668,2,4,2,586682,18928,90623,17333,0.1753306902812257,0.47800667383690465
33470,0.815672077922078,0,1,0,586683,18927,90623,17333,0.17532142724813812,0.47801985659128515
33471,0.8157142857142857,1,1,1,586684,18926,90624,17332,0.17531216421505058,0.47801864416128853
33472,0.8157619047619048,0,1,0,586685,18925,90624,17332,0.175302901181963,0.4780318283365971
33473,0.8158333333333333,5,6,5,586691,18919,90629,17327,0.1752473229834377,0.47803895602273355
33474,0.8158333333333334,7,12,7,586703,18907,90636,17320,0.17513616658638706,0.4780964474011097
33475,0.8158571428571428,1,0,1,586703,18907,90637,17319,0.17513616658638706,0.478082040523381
33476,0.8158809523809523,0,1,0,586704,18906,90637,17319,0.1751269035532995,0.4780952380952381
33477,0.8158809523809524,0,1,0,586705,18905,90637,17319,0.17511764052021195,0.47810843639575973
33478,0.8159166666666665,0,1,0,586706,18904,90637,17319,0.17510837748712438,0.4781216354250062
33479,0.8159404761904763,1,1,1,586707,18903,90638,17318,0.17509911445403684,0.4781204273763839
33480,0.816,20,18,20,586725,18885,90658,17298,0.17493237985846086,0.47806981179006713
33481,0.8160000000000001,0,1,0,586726,18884,90658,17298,0.1749231168253733,0.47808302470841857
33482,0.8160119047619045,1,1,1,586727,18883,90659,17297,0.17491385379228575,0.47808181315644005
33483,0.8160277777777778,0,1,0,586728,18882,90659,17297,0.1749045907591982,0.4780950275021421
33484,0.816047619047619,0,1,0,586729,18881,90659,17297,0.17489532772611063,0.47810824257836254
33485,0.8160833333333334,1,3,1,586732,18878,90660,17296,0.17486753862684798,0.47813346602532203
33486,0.8160865800865801,0,1,0,586733,18877,90660,17296,0.1748582755937604,0.4781466839908219
33487,0.8161666666666666,2,2,2,586735,18875,90662,17294,0.17483974952758533,0.4781442671901352
33488,0.8161666666666667,2,4,2,586739,18871,90664,17292,0.1748026973952351,0.47816829355971574
33489,0.8161904761904762,1,0,1,586739,18871,90665,17291,0.1748026973952351,0.4781538631712848
33490,0.8162142857142857,0,1,0,586740,18870,90665,17291,0.17479343436214753,0.478167086087221
33491,0.81625,0,2,0,586742,18868,90665,17291,0.17477490829597242,0.4781935341132222
33492,0.8163095238095238,0,1,0,586743,18867,90665,17291,0.17476564526288488,0.4782067592234084
33493,0.8163095238095239,2,0,2,586743,18867,90667,17289,0.17476564526288488,0.47817789578493197
33494,0.8163333333333332,3,4,3,586747,18863,90670,17286,0.17472859313053465,0.47818750172895513
33495,0.8163333333333334,4,2,4,586749,18861,90674,17282,0.17471006706435954,0.47815621282129317
33496,0.8163809523809524,0,1,0,586750,18860,90674,17282,0.174700804031272,0.4781694427535831
33497,0.816404761904762,0,1,0,586751,18859,90674,17282,0.17469154099818446,0.4781826734180017
33498,0.8164285714285713,1,3,1,586754,18856,90675,17281,0.17466375189892178,0.47820793092951824
33499,0.8164523809523807,0,1,0,586755,18855,90675,17281,0.17465448886583423,0.47822116448970553
33500,0.8164999999999999,0,1,0,586756,18854,90675,17281,0.17464522583274666,0.478234398782344
33501,0.8165,4,1,4,586757,18853,90679,17277,0.17463596279965912,0.4781898699141987
33502,0.8165000000000002,1,0,1,586757,18853,90680,17276,0.17463596279965912,0.4781754269423455
33503,0.8166666666666665,33,63,33,586820,18790,90713,17243,0.1740523917151432,0.4785335664529737
33504,0.8166666666666668,36,72,36,586892,18718,90749,17207,0.1733854533328393,0.47897007654836465
33505,0.81675,0,1,0,586893,18717,90749,17207,0.17337619029975176,0.47898340941988643
33506,0.8167500000000001,0,1,0,586894,18716,90749,17207,0.1733669272666642,0.478996743033711
33507,0.8167543859649125,0,1,0,586895,18715,90749,17207,0.17335766423357665,0.4790100773899003
33508,0.8167857142857141,0,1,0,586896,18714,90749,17207,0.17334840120048908,0.4790234124885165
33509,0.8167857142857144,2,1,2,586897,18713,90751,17205,0.17333913816740154,0.47900773985188483
33510,0.8168095238095234,1,0,1,586897,18713,90752,17204,0.17333913816740154,0.47899323440153685
33511,0.8168333333333332,1,7,1,586904,18706,90753,17203,0.17327429693578866,0.4790720989167061
33512,0.8168333333333334,1,3,1,586907,18703,90754,17202,0.17324650783652598,0.4790976187160563
33513,0.8168809523809525,0,1,0,586908,18702,90754,17202,0.17323724480343844,0.47911096256684493
33514,0.8168888888888888,2,0,2,586908,18702,90756,17200,0.17323724480343844,0.4790819452955267
33515,0.8169166666666666,1,0,1,586908,18702,90757,17199,0.17323724480343844,0.4790674354474806
33516,0.8169444444444445,0,1,0,586909,18701,90757,17199,0.1732279817703509,0.4790807799442897
33517,0.8169999999999998,1,4,1,586913,18697,90758,17198,0.17319092963800067,0.47911965454798716
33518,0.8170000000000001,1,7,1,586920,18690,90759,17197,0.1731260884063878,0.47919859559171846
33519,0.8170000000000002,0,2,0,586922,18688,90759,17197,0.17310756234021268,0.47922530305141425
33520,0.8170833333333333,0,1,0,586923,18687,90759,17197,0.17309829930712511,0.4792386578976703
33521,0.8170833333333334,0,1,0,586924,18686,90759,17197,0.17308903627403757,0.47925201348828134
33522,0.8171428571428571,0,1,0,586925,18685,90759,17197,0.17307977324095003,0.47926536982330975
33523,0.8171428571428572,3,1,3,586926,18684,90762,17194,0.17307051020786246,0.4792351859077987
33524,0.8171666666666667,3,1,3,586927,18683,90765,17191,0.17306124717477492,0.4792049952611919
33525,0.8172261904761904,0,1,0,586928,18682,90765,17191,0.17305198414168735,0.47921835363643966
33526,0.8172499999999999,0,1,0,586929,18681,90765,17191,0.1730427211085998,0.4792317127564674
33527,0.8172857142857142,1,0,1,586929,18681,90766,17190,0.1730427211085998,0.4792171949485657
33528,0.8173253968253965,0,2,0,586931,18679,90766,17190,0.1730241950424247,0.4792439153586663
33529,0.8173333333333332,3,2,3,586933,18677,90769,17187,0.17300566897624958,0.47922708008030335
33530,0.8173333333333334,9,6,9,586939,18671,90778,17178,0.17295009077772425,0.4791765460682306
33531,0.8173333333333335,2,3,2,586942,18668,90780,17176,0.1729223016784616,0.47918759067068406
33532,0.8173809523809524,1,0,1,586942,18668,90781,17175,0.1729223016784616,0.47917306029071227
33533,0.8174047619047619,1,0,1,586942,18668,90782,17174,0.1729223016784616,0.4791585290999386
33534,0.8174285714285715,0,1,0,586943,18667,90782,17174,0.17291303864537405,0.47917189810552163
33535,0.8174523809523809,1,1,1,586944,18666,90783,17173,0.17290377561228648,0.47917073579061914
33536,0.8174999999999999,2,4,2,586948,18662,90785,17171,0.17286672347993626,0.47919515530377027
33537,0.8175,50,76,50,587024,18586,90835,17121,0.17216273296528214,0.4794858151062817
33538,0.8175000000000001,1,3,1,587027,18583,90836,17120,0.1721349438660195,0.4795115256421029
33539,0.8175714285714286,0,2,0,587029,18581,90836,17120,0.17211641779984438,0.4795383882804403
33540,0.8175793650793648,0,3,0,587032,18578,90836,17120,0.17208862870058173,0.47957868788167407
33541,0.8176190476190474,0,1,0,587033,18577,90836,17120,0.17207936566749416,0.47959212258733225
33542,0.8176190476190476,0,1,0,587034,18576,90836,17120,0.1720701026344066,0.4796055580457194
33543,0.8176666666666665,0,2,0,587036,18574,90836,17120,0.1720515765682315,0.47963243122093346
33544,0.8176666666666667,0,9,0,587045,18565,90836,17120,0.1719682092704435,0.4797533977861847
33545,0.8176666666666668,0,1,0,587046,18564,90836,17120,0.17195894623735597,0.47976684228225536
33546,0.8176702741702742,0,1,0,587047,18563,90836,17120,0.1719496832042684,0.4797802875318779
33547,0.8177777777777777,1,2,1,587049,18561,90837,17119,0.1719311571380933,0.479792600896861
33548,0.8178333333333332,0,1,0,587050,18560,90837,17119,0.17192189410500575,0.47980604837579527
33549,0.8178333333333333,0,1,0,587051,18559,90837,17119,0.17191263107191818,0.4798194966085543
33550,0.8178333333333334,3,2,3,587053,18557,90840,17116,0.1718941050057431,0.4798026518655566
33551,0.8178571428571427,2,1,2,587054,18556,90842,17114,0.17188484197265552,0.4797869358003925
33552,0.8179166666666666,0,2,0,587056,18554,90842,17114,0.1718663159064804,0.47981383873500055
33553,0.8179166666666667,1,0,1,587056,18554,90843,17113,0.1718663159064804,0.47979925421257746
33554,0.8179761904761904,0,2,0,587058,18552,90843,17113,0.1718477898403053,0.4798261601009393
33555,0.8179999999999998,0,1,0,587059,18551,90843,17113,0.17183852680721776,0.47983961417676085
33556,0.818,11,7,11,587066,18544,90854,17102,0.17177368557560488,0.47977332660046007
33557,0.8180357142857143,0,5,0,587071,18539,90854,17102,0.1717273704101671,0.47984063297887264
33558,0.818095238095238,0,1,0,587072,18538,90854,17102,0.17171810737707954,0.47985409652076316
33559,0.8180952380952381,0,1,0,587073,18537,90854,17102,0.171708844343992,0.47986756081820475
33560,0.8181298701298703,0,3,0,587076,18534,90854,17102,0.17168105524472935,0.47990795824447186
33561,0.8181428571428572,0,1,0,587077,18533,90854,17102,0.17167179221164178,0.47992142556475376
33562,0.8181666666666666,0,2,0,587079,18531,90854,17102,0.17165326614546667,0.4799483624729885
33563,0.8181904761904761,1,1,1,587080,18530,90855,17101,0.17164400311237912,0.47994723695658276
33564,0.8181904761904764,1,0,1,587080,18530,90856,17100,0.17164400311237912,0.4799326410328375
33565,0.8182142857142857,1,1,1,587081,18529,90857,17099,0.17163474007929155,0.4799315145391265
33566,0.8182380952380952,0,1,0,587082,18528,90857,17099,0.171625477046204,0.4799449855446712
33567,0.8182499999999999,0,1,0,587083,18527,90857,17099,0.17161621401311644,0.4799584573064616
33568,0.8182777777777779,0,2,0,587085,18525,90857,17099,0.17159768794694136,0.47998540309903437
33569,0.8183333333333331,0,3,0,587088,18522,90857,17099,0.17156989884767868,0.480025827461329
33570,0.8183333333333332,16,25,16,587113,18497,90873,17083,0.17133832302048982,0.4801292861157954
33571,0.8183333333333335,21,29,21,587142,18468,90894,17062,0.17106969506095077,0.4802139037433155
33572,0.8184523809523809,1,0,1,587142,18468,90895,17061,0.17106969506095077,0.48019927383264377
33573,0.8184999999999999,0,4,0,587146,18464,90895,17061,0.17103264292860054,0.4802533427163969
33574,0.8185000000000001,0,1,0,587147,18463,90895,17061,0.171023379895513,0.4802668618398829
33575,0.818547619047619,0,2,0,587149,18461,90895,17061,0.1710048538293379,0.480293902370362
33576,0.8185714285714286,2,1,2,587150,18460,90897,17059,0.17099559079625032,0.48027816098426196
33577,0.8185833333333332,0,1,0,587151,18459,90897,17059,0.17098632776316278,0.4802916830902641
33578,0.818611111111111,0,1,0,587152,18458,90897,17059,0.1709770647300752,0.48030520595771037
33579,0.8186190476190477,0,1,0,587153,18457,90897,17059,0.17096780169698766,0.48031872958666516
33580,0.818642857142857,0,1,0,587154,18456,90897,17059,0.1709585386639001,0.48033225397719276
33581,0.8186468253968253,0,1,0,587155,18455,90897,17059,0.17094927563081255,0.48034577912935744
33582,0.8186666666666668,0,8,0,587163,18447,90897,17059,0.17087517136611213,0.4804540077733341
33583,0.8186785714285714,1,0,1,587163,18447,90898,17058,0.17087517136611213,0.48043937473595266
33584,0.8186911976911976,0,1,0,587164,18446,90898,17058,0.17086590833302456,0.4804529067147364
33585,0.8187121212121212,0,1,0,587165,18445,90898,17058,0.17085664529993702,0.4804664394558206
33586,0.8187142857142856,0,1,0,587166,18444,90898,17058,0.17084738226684945,0.4804799729592699
33587,0.8187380952380952,1,0,1,587166,18444,90899,17057,0.17084738226684945,0.4804653390045351
33588,0.8187380952380954,0,1,0,587167,18443,90899,17057,0.1708381192337619,0.4804788732394366
33589,0.81875,2,2,2,587169,18441,90901,17055,0.1708195931675868,0.4804766734279919
33590,0.8187738095238095,0,1,0,587170,18440,90901,17055,0.17081033013449923,0.4804902098887167
33591,0.8187976190476189,0,1,0,587171,18439,90901,17055,0.17080106710141169,0.48050374711218796
33592,0.8188015873015874,2,1,2,587172,18438,90903,17053,0.17079180406832414,0.4804880110450537
33593,0.8188095238095238,1,1,1,587173,18437,90904,17052,0.17078254103523657,0.4804869114373468
33594,0.818809523809524,1,0,1,587173,18437,90905,17051,0.17078254103523657,0.4804722723174031
33595,0.8188571428571428,0,1,0,587174,18436,90905,17051,0.17077327800214903,0.48048581170569504
33596,0.8188809523809524,0,1,0,587175,18435,90905,17051,0.17076401496906146,0.4804993518570704
33597,0.8189285714285713,1,0,1,587175,18435,90906,17050,0.17076401496906146,0.4804847118500775
33598,0.818952380952381,1,1,1,587176,18434,90907,17049,0.17075475193597392,0.48048361187047317
33599,0.819,1,1,1,587177,18433,90908,17048,0.17074548890288635,0.48048251176686113
33600,0.8190000000000001,3,8,3,587185,18425,90911,17045,0.17067138463818593,0.48054694107696644
33601,0.8190909090909091,0,1,0,587186,18424,90911,17045,0.17066212160509836,0.4805604894414841
33602,0.8191507936507937,0,2,0,587188,18422,90911,17045,0.17064359553892328,0.4805875884625144
33603,0.8191666666666666,4,17,4,587205,18405,90915,17041,0.17048612397643484,0.4807594651018451
33604,0.8191666666666667,5,13,5,587218,18392,90920,17036,0.17036570454629663,0.48086259455797675
33605,0.8192857142857143,0,1,0,587219,18391,90920,17036,0.17035644151320908,0.4808761678945437
33606,0.8193333333333332,2,4,2,587223,18387,90922,17034,0.17031938938085886,0.4809011603286186
33607,0.8193333333333334,3,6,3,587229,18381,90925,17031,0.17026381118233355,0.4809386648593697
33608,0.8193333333333335,0,1,0,587230,18380,90925,17031,0.17025454814924598,0.4809522464770834
33609,0.8194047619047619,0,1,0,587231,18379,90925,17031,0.17024528511615844,0.4809658288619034
33610,0.8195,0,3,0,587234,18376,90925,17031,0.17021749601689576,0.48100658061965146
33611,0.8195000000000001,0,1,0,587235,18375,90925,17031,0.17020823298380822,0.48102016607354686
33612,0.819562049062049,0,1,0,587236,18374,90925,17031,0.17019896995072067,0.4810337522948736
33613,0.8195714285714285,1,0,1,587236,18374,90926,17030,0.17019896995072067,0.4810190938876963
33614,0.8195833333333333,0,2,0,587238,18372,90926,17030,0.17018044388454556,0.481046268572397
33615,0.8196388888888889,0,1,0,587239,18371,90926,17030,0.170171180851458,0.4810598570661846
33616,0.8196428571428571,1,0,1,587239,18371,90927,17029,0.170171180851458,0.481045197740113
33617,0.8196428571428572,1,1,1,587240,18370,90928,17028,0.17016191781837045,0.4810441267868241
33618,0.8196666666666667,1,1,1,587241,18369,90929,17027,0.17015265478528288,0.4810430557125099
33619,0.8196904761904762,0,1,0,587242,18368,90929,17027,0.17014339175219534,0.4810566464189857
33620,0.819730519480519,0,1,0,587243,18367,90929,17027,0.1701341287191078,0.4810702378934283
33621,0.8197380952380953,0,1,0,587244,18366,90929,17027,0.17012486568602023,0.48108383013590256
33622,0.81975,0,1,0,587245,18365,90929,17027,0.17011560265293268,0.4810974231464738
33623,0.8197619047619048,0,1,0,587246,18364,90929,17027,0.17010633961984511,0.48111101692520697
33624,0.8198333333333333,0,3,0,587249,18361,90929,17027,0.17007855052058246,0.4811518028710297
33625,0.8198333333333335,0,2,0,587251,18359,90929,17027,0.17006002445440735,0.4811789973435822
33626,0.8198452380952379,0,1,0,587252,18358,90929,17027,0.1700507614213198,0.4811925957326551
33627,0.8198809523809524,1,0,1,587252,18358,90930,17026,0.1700507614213198,0.4811779335292788
33628,0.8199523809523811,0,1,0,587253,18357,90930,17026,0.17004149838823224,0.48119153265692566
33629,0.8199999999999998,3,3,3,587256,18354,90933,17023,0.17001370928896958,0.48118834270853944
33630,0.82,726,910,726,588166,17444,91659,16297,0.16158434917929526,0.48300287484069826
33631,0.8200000000000002,1,5,1,588171,17439,91660,16296,0.1615380340138575,0.4830591373943975
33632,0.8200714285714286,0,1,0,588172,17438,91660,16296,0.16152877098076995,0.48307345704630344
33633,0.8200833333333333,1,0,1,588172,17438,91661,16295,0.16152877098076995,0.4830581329855038
33634,0.8201666666666665,0,1,0,588173,17437,91661,16295,0.16151950794768238,0.4830724534566584
33635,0.8201666666666667,1,2,1,588175,17435,91662,16294,0.16150098188150727,0.4830857718876931
33636,0.8202857142857143,0,1,0,588176,17434,91662,16294,0.16149171884841973,0.48310009487666034
33637,0.8203333333333331,0,2,0,588178,17432,91662,16294,0.16147319278224462,0.483128743402716
33638,0.8203333333333334,2,8,2,588186,17424,91664,16292,0.1613990885175442,0.48321271799738996
33639,0.8203571428571428,1,0,1,588186,17424,91665,16291,0.1613990885175442,0.4831973898858075
33640,0.8204166666666666,0,1,0,588187,17423,91665,16291,0.16138982548445663,0.48321172213323843
33641,0.8204761904761905,0,1,0,588188,17422,91665,16291,0.1613805624513691,0.4832260552309198
33642,0.8205,2,5,2,588193,17417,91667,16289,0.1613342472859313,0.48326707411143416
33643,0.8205238095238094,0,2,0,588195,17415,91667,16289,0.1613157212197562,0.4832957512461429
33644,0.8205476190476192,0,1,0,588196,17414,91667,16289,0.16130645818666864,0.483310091089814
33645,0.8205555555555556,1,0,1,588196,17414,91668,16288,0.16130645818666864,0.48329475995489884
33646,0.8205952380952379,1,0,1,588196,17414,91669,16287,0.16130645818666864,0.48327942791015105
33647,0.8206666666666667,4,9,4,588205,17405,91673,16283,0.16122309088888065,0.48334718594158155
33648,0.8206666666666668,0,5,0,588210,17400,91673,16283,0.16117677572344288,0.4834189353679898
33649,0.8207142857142857,1,2,1,588212,17398,91674,16282,0.16115824965726777,0.48343230403800475
33650,0.8207380952380952,1,0,1,588212,17398,91675,16281,0.16115824965726777,0.4834169660619377
33651,0.8207777777777777,0,1,0,588213,17397,91675,16281,0.16114898662418023,0.48343132014965257
33652,0.8207857142857143,0,1,0,588214,17396,91675,16281,0.16113972359109266,0.4834456750898239
33653,0.820790931290931,2,1,2,588215,17395,91677,16279,0.16113046055800512,0.4834293520223318
33654,0.8208333333333333,9,15,9,588230,17380,91686,16270,0.1609915150616918,0.4835066864784547
33655,0.8208333333333334,6,6,6,588236,17374,91692,16264,0.16093593686316648,0.4835008026636542
33656,0.8208571428571431,0,1,0,588237,17373,91692,16264,0.16092667383007891,0.4835151767398995
33657,0.8209166666666668,0,1,0,588238,17372,91692,16264,0.16091741079699137,0.4835295516708289
33658,0.820952380952381,1,0,1,588238,17372,91693,16263,0.16091741079699137,0.4835141965214806
33659,0.821,4,18,4,588256,17354,91697,16259,0.1607506762014154,0.4837116591794841
33660,0.8210000000000001,0,1,0,588257,17353,91697,16259,0.16074141316832782,0.48372605022015946
33661,0.8210238095238094,1,0,1,588257,17353,91698,16258,0.16074141316832782,0.48371068995269406
33662,0.8210555555555554,0,1,0,588258,17352,91698,16258,0.16073215013524028,0.48372508182088664
33663,0.8210952380952378,1,1,1,588259,17351,91699,16257,0.16072288710215274,0.4837241133063556
33664,0.8211111111111111,0,1,0,588260,17350,91699,16257,0.16071362406906517,0.48373850685869013
33665,0.8211428571428573,1,2,1,588262,17348,91700,16256,0.16069509800289006,0.48375193429353647
33666,0.8211547619047619,1,1,1,588263,17347,91701,16255,0.16068583496980252,0.4837509672043331
33667,0.8211666666666666,1,3,1,588266,17344,91702,16254,0.16065804587053986,0.483778796356926
33668,0.8211666666666667,0,4,0,588270,17340,91702,16254,0.16062099373818964,0.48383639935702805
33669,0.821222222222222,0,2,0,588272,17338,91702,16254,0.16060246767201453,0.4838652060014289
33670,0.8212222222222222,1,0,1,588272,17338,91703,16253,0.16060246767201453,0.48384984073114823
33671,0.8212878787878788,0,1,0,588273,17337,91703,16253,0.16059320463892698,0.4838642453111045
33672,0.8213095238095238,0,2,0,588275,17335,91703,16253,0.16057467857275187,0.48389305704418245
33673,0.8213333333333332,2,1,2,588276,17334,91705,16251,0.1605654155396643,0.48387673068334075
33674,0.8213333333333334,1,2,1,588278,17332,91706,16250,0.1605468894734892,0.4838901792627003
33675,0.8213452380952379,0,1,0,588279,17331,91706,16250,0.16053762644040165,0.48390458890444
33676,0.8214285714285714,2,1,2,588280,17330,91708,16248,0.16052836340731408,0.48388826017034964
33677,0.8214404761904762,0,1,0,588281,17329,91708,16248,0.16051910037422654,0.48390267147154303
33678,0.8214503552003553,0,4,0,588285,17325,91708,16248,0.1604820482418763,0.4839603252613707
33679,0.8214538239538237,0,1,0,588286,17324,91708,16248,0.16047278520878877,0.4839747408554748
33680,0.8214999999999999,0,1,0,588287,17323,91708,16248,0.1604635221757012,0.48398915730839115
33681,0.8215,2,4,2,588291,17319,91710,16246,0.160426470043351,0.4840160881870997
33682,0.8215119047619048,0,1,0,588292,17318,91710,16246,0.16041720701026344,0.48403050887856036
33683,0.8216666666666665,16,42,16,588334,17276,91726,16230,0.16002815962058617,0.48439085536918763
33684,0.8216666666666668,20,22,20,588356,17254,91746,16210,0.15982437289265997,0.484401147501793
33685,0.8216666666666669,0,1,0,588357,17253,91746,16210,0.15981510985957242,0.48441562322565224
33686,0.8216904761904762,0,1,0,588358,17252,91746,16210,0.15980584682648485,0.4844300998147152
33687,0.8217142857142855,0,1,0,588359,17251,91746,16210,0.1597965837933973,0.4844445772690595
33688,0.8217380952380953,0,1,0,588360,17250,91746,16210,0.15978732076030974,0.4844590555887627
33689,0.8217857142857143,0,2,0,588362,17248,91746,16210,0.15976879469413466,0.48448801482455617
33690,0.8218333333333332,0,1,0,588363,17247,91746,16210,0.1597595316610471,0.4845024957408016
33691,0.8218333333333334,1,6,1,588369,17241,91747,16209,0.15970395346252178,0.48457399103139015
33692,0.8219047619047619,0,1,0,588370,17240,91747,16209,0.1596946904294342,0.48458847798140453
33693,0.8219444444444445,0,1,0,588371,17239,91747,16209,0.15968542739634667,0.48460296579765605
33694,0.8219761904761905,1,2,1,588373,17237,91748,16208,0.15966690133017156,0.4846165346090596
33695,0.8220000000000001,8,9,8,588382,17228,91756,16200,0.15958353403238357,0.48462366878066293
33696,0.8220833333333333,0,1,0,588383,17227,91756,16200,0.159574270999296,0.4846381667514285
33697,0.8221428571428571,0,1,0,588384,17226,91756,16200,0.15956500796620846,0.48465266558966075
33698,0.8221428571428572,1,1,1,588385,17225,91757,16199,0.1595557449331209,0.48465174724748683
33699,0.8221587301587302,1,0,1,588385,17225,91758,16198,0.1595557449331209,0.48463632827693504
33700,0.8221666666666665,2,0,2,588385,17225,91760,16196,0.1595557449331209,0.48460548756769695
33701,0.8221666666666667,0,1,0,588386,17224,91760,16196,0.15954648190003334,0.4846199880311191
33702,0.8221746031746031,0,1,0,588387,17223,91760,16196,0.1595372188669458,0.48463448936233877
33703,0.822190476190476,1,0,1,588387,17223,91761,16195,0.1595372188669458,0.4846190675683763
33704,0.8222499999999999,0,1,0,588388,17222,91761,16195,0.15952795583385823,0.4846335697399527
33705,0.82225,0,1,0,588389,17221,91761,16195,0.1595186928007707,0.48464807277950683
33706,0.8222619047619049,0,1,0,588390,17220,91761,16195,0.15950942976768312,0.48466257668711654
33707,0.8223273809523809,0,2,0,588392,17218,91761,16195,0.15949090370150804,0.4846915871068147
33708,0.8223333333333332,0,5,0,588397,17213,91761,16195,0.15944458853607024,0.48476412835249044
33709,0.8223333333333334,3,1,3,588398,17212,91764,16192,0.1594353255029827,0.48473236738115194
33710,0.8223333333333335,0,2,0,588400,17210,91764,16192,0.1594167994368076,0.4847613915334411
33711,0.8223571428571429,0,2,0,588402,17208,91764,16192,0.15939827337063248,0.48479041916167664
33712,0.8223809523809522,0,1,0,588403,17207,91764,16192,0.15938901033754493,0.48480493427946947
33713,0.8223809523809524,3,0,3,588403,17207,91767,16189,0.15938901033754493,0.48475865373098576
33714,0.8224761904761906,0,2,0,588405,17205,91767,16189,0.15937048427136982,0.48478768641073244
33715,0.8224999999999999,1,2,1,588407,17203,91768,16188,0.1593519582051947,0.4848012937617921
33716,0.8225,32,72,32,588479,17131,91800,16156,0.1586850198228908,0.4853546429537057
33717,0.8225108225108226,0,1,0,588480,17130,91800,16156,0.15867575678980325,0.4853692242985039
33718,0.8225595238095237,1,2,1,588482,17128,91801,16155,0.15865723072362814,0.48538292822161466
33719,0.8225674603174602,0,2,0,588484,17126,91801,16155,0.15863870465745303,0.4854120969922779
33720,0.8225952380952383,1,0,1,588484,17126,91802,16154,0.15863870465745303,0.4853966346153846
33721,0.8226111111111112,0,1,0,588485,17125,91802,16154,0.15862944162436549,0.4854112202890712
33722,0.8226190476190476,2,1,2,588486,17124,91804,16152,0.15862017859127792,0.4853948791922106
33723,0.8226666666666667,1,4,1,588490,17120,91805,16151,0.15858312645892772,0.4854377686273331
33724,0.8226666666666668,1,0,1,588490,17120,91806,16150,0.15858312645892772,0.48542230237451156
33725,0.8226794871794872,0,3,0,588493,17117,91806,16150,0.15855533735966504,0.4854660774942135
33726,0.822702380952381,0,1,0,588494,17116,91806,16150,0.1585460743265775,0.48548067095532976
33727,0.8227380952380952,0,1,0,588495,17115,91806,16150,0.15853681129348993,0.4854952652938524
33728,0.8228214285714285,0,1,0,588496,17114,91806,16150,0.15852754826040238,0.4855098605098605
33729,0.8228333333333333,1,5,1,588501,17109,91807,16149,0.15848123309496462,0.48556738228396173
33730,0.8228571428571427,0,3,0,588504,17106,91807,16149,0.15845344399570196,0.4856111862877763
33731,0.822904761904762,0,1,0,588505,17105,91807,16149,0.1584441809626144,0.48562578937872136
33732,0.8229166666666665,0,1,0,588506,17104,91807,16149,0.15843491792952685,0.4856403933479686
33733,0.8229761904761904,0,1,0,588507,17103,91807,16149,0.15842565489643928,0.48565499819559727
33734,0.8229761904761905,1,1,1,588508,17102,91808,16148,0.15841639186335174,0.48565413533834584
33735,0.8229999999999998,2,1,2,588509,17101,91810,16146,0.15840712883026417,0.48563780190693895
33736,0.823,2,8,2,588517,17093,91812,16144,0.15833302456556375,0.4857237416132623
33737,0.8230000000000001,3,1,3,588518,17092,91815,16141,0.15832376153247618,0.4856919327174796
33738,0.8230238095238094,0,1,0,588519,17091,91815,16141,0.15831449849938864,0.4857065479056331
33739,0.823047619047619,0,2,0,588521,17089,91815,16141,0.15829597243321353,0.4857357809208547
33740,0.8230476190476191,0,1,0,588522,17088,91815,16141,0.15828670940012599,0.4857503987480815
33741,0.8230952380952382,0,1,0,588523,17087,91815,16141,0.15827744636703842,0.4857650174551583
33742,0.823154761904762,0,2,0,588525,17085,91815,16141,0.1582589203008633,0.48579425750917954
33743,0.8231666666666664,0,1,0,588526,17084,91815,16141,0.15824965726777576,0.48580887885628293
33744,0.8231666666666666,2,2,2,588528,17082,91817,16139,0.15823113120160065,0.4858071701634508
33745,0.8231666666666668,2,0,2,588528,17082,91819,16137,0.15823113120160065,0.4857762124085614
33746,0.8231666666666669,0,1,0,588529,17081,91819,16137,0.1582218681685131,0.4857908362935758
33747,0.8232142857142856,1,2,1,588531,17079,91820,16136,0.158203342102338,0.48580460635255157
33748,0.8232142857142857,0,1,0,588532,17078,91820,16136,0.15819407906925043,0.48581923285361595
33749,0.8232142857142858,1,0,1,588532,17078,91821,16135,0.15819407906925043,0.4858037515430705
33750,0.8232261904761904,0,1,0,588533,17077,91821,16135,0.15818481603616288,0.48581837889919305
33751,0.8232777777777778,0,1,0,588534,17076,91821,16135,0.15817555300307531,0.4858330071361898
33752,0.8232925685425685,0,2,0,588536,17074,91821,16135,0.15815702693690023,0.4858622662531242
33753,0.8233333333333331,1,0,1,588536,17074,91822,16134,0.15815702693690023,0.4858467839074922
33754,0.8233333333333333,52,69,52,588605,17005,91874,16082,0.15751787765385897,0.4860519237162632
33755,0.8233333333333335,32,63,32,588668,16942,91906,16050,0.15693430656934307,0.4864815712900097
33756,0.8233412698412697,0,4,0,588672,16938,91906,16050,0.15689725443699284,0.48654056020371045
33757,0.8233571428571428,0,2,0,588674,16936,91906,16050,0.15687872837081773,0.4865700600254653
33758,0.8233809523809522,0,1,0,588675,16935,91906,16050,0.1568694653377302,0.4865848112778536
33759,0.823452380952381,1,1,1,588676,16934,91907,16049,0.15686020230464262,0.48658399781705725
33760,0.8234642857142858,0,1,0,588677,16933,91907,16049,0.15685093927155508,0.4865987508337881
33761,0.8234999999999999,1,3,1,588680,16930,91908,16048,0.15682315017229242,0.4866274486020984
33762,0.8235000000000001,0,3,0,588683,16927,91908,16048,0.15679536107302974,0.4866717210007582
33763,0.8235714285714286,0,4,0,588687,16923,91908,16048,0.15675830894067955,0.48673076339813776
33764,0.8236190476190476,0,1,0,588688,16922,91908,16048,0.15674904590759198,0.4867455262359721
33765,0.8236666666666665,0,1,0,588689,16921,91908,16048,0.15673978287450444,0.48676028996936516
33766,0.8236666666666668,0,1,0,588690,16920,91908,16048,0.15673051984141687,0.4867750545983984
33767,0.8237142857142856,0,1,0,588691,16919,91908,16048,0.15672125680832932,0.48678982012315347
33768,0.8237380952380954,1,0,1,588691,16919,91909,16047,0.15672125680832932,0.4867742522599041
33769,0.82375,1,3,1,588694,16916,91910,16046,0.15669346770906667,0.48680298525574905
33770,0.8237878787878788,0,1,0,588695,16915,91910,16046,0.1566842046759791,0.48681775431570645
33771,0.823809523809524,1,1,1,588696,16914,91911,16045,0.15667494164289156,0.4868169543978883
33772,0.8238333333333331,1,0,1,588696,16914,91912,16044,0.15667494164289156,0.4868013835791007
33773,0.8238333333333333,1,1,1,588697,16913,91913,16043,0.156665678609804,0.4868005825949751
33774,0.8238333333333334,1,0,1,588697,16913,91914,16042,0.156665678609804,0.48678500986193296
33775,0.8238571428571428,1,0,1,588697,16913,91915,16041,0.156665678609804,0.48676943618377133
33776,0.8239047619047619,0,1,0,588698,16912,91915,16041,0.15665641557671645,0.4867842078111249
33777,0.8239087301587301,0,1,0,588699,16911,91915,16041,0.15664715254362888,0.48679898033503277
33778,0.824,1,2,1,588701,16909,91916,16040,0.15662862647745376,0.4868129533521503
33779,0.8240000000000001,17,21,17,588722,16888,91933,16023,0.15643410278261513,0.4868584971590046
33780,0.824047619047619,2,1,2,588723,16887,91935,16021,0.1564248397495276,0.4868421052631579
33781,0.8240476190476191,0,2,0,588725,16885,91935,16021,0.15640631368335248,0.48687169513158696
33782,0.8240952380952379,0,1,0,588726,16884,91935,16021,0.15639705065026493,0.4868864914146786
33783,0.8241666666666666,3,13,3,588739,16871,91938,16018,0.15627663122012672,0.4870321384049378
33784,0.8241666666666667,6,9,6,588748,16862,91944,16012,0.15619326392233873,0.48707185009429943
33785,0.8241666666666668,1,0,1,588748,16862,91945,16011,0.15619326392233873,0.4870562467678642
33786,0.8241904761904761,1,0,1,588748,16862,91946,16010,0.15619326392233873,0.48704064249209056
33787,0.8242222222222222,0,1,0,588749,16861,91946,16010,0.1561840008892512,0.4870554592193727
33788,0.8242857142857143,1,3,1,588752,16858,91947,16009,0.1561562117899885,0.4870843094897618
33789,0.824293650793651,0,1,0,588753,16857,91947,16009,0.15614694875690097,0.4870991297997931
33790,0.8243333333333333,0,1,0,588754,16856,91947,16009,0.1561376857238134,0.48711395101171456
33791,0.8243333333333334,0,5,0,588759,16851,91947,16009,0.15609137055837563,0.4871880706025563
33792,0.8243333333333335,0,1,0,588760,16850,91947,16009,0.1560821075252881,0.487202897227548
33793,0.824392857142857,0,2,0,588762,16848,91947,16009,0.15606358145911298,0.48723255318501385
33794,0.8244761904761903,0,1,0,588763,16847,91947,16009,0.1560543184260254,0.48724738251765276
33795,0.8244999999999999,1,0,1,588763,16847,91948,16008,0.1560543184260254,0.48723177598539036
33796,0.8245,0,6,0,588769,16841,91948,16008,0.1559987402275001,0.4873207707997199
33797,0.824547619047619,0,1,0,588770,16840,91948,16008,0.15598947719441253,0.4873356064296152
33798,0.8245833333333334,0,1,0,588771,16839,91948,16008,0.155980214161325,0.48735044296282765
33799,0.8246428571428571,0,2,0,588773,16837,91948,16008,0.15596168809514988,0.4873801187395342
33800,0.8246666666666667,2,9,2,588782,16828,91950,16006,0.15587832079736189,0.48748248766522506
33801,0.8247301587301586,1,1,1,588783,16827,91951,16005,0.15586905776427434,0.4874817251461988
33802,0.8247976190476191,0,1,0,588784,16826,91951,16005,0.15585979473118677,0.48749657336054336
33803,0.8248333333333332,0,1,0,588785,16825,91951,16005,0.15585053169809923,0.4875114224794395
33804,0.8248333333333333,0,1,0,588786,16824,91951,16005,0.15584126866501166,0.4875262725029699
33805,0.824845238095238,1,0,1,588786,16824,91952,16004,0.15584126866501166,0.4875106616303156
33806,0.8249166666666667,0,1,0,588787,16823,91952,16004,0.15583200563192412,0.48752551253541293
33807,0.8249523809523811,1,1,1,588788,16822,91953,16003,0.15582274259883655,0.4875247524752475
33808,0.8249999999999998,2,6,2,588794,16816,91955,16001,0.15576716440031124,0.4875826553310784
33809,0.825,163,242,163,589036,16574,92118,15838,0.15352551039312312,0.48864618042700236
33810,0.8250000000000002,3,2,3,589038,16572,92121,15835,0.153506984326948,0.4886289999074274
33811,0.8251428571428572,0,1,0,589039,16571,92121,15835,0.15349772129386047,0.48864407825711287
33812,0.8251666666666666,1,3,1,589042,16568,92122,15834,0.15346993219459779,0.48867353867045243
33813,0.8251666666666668,0,1,0,589043,16567,92122,15834,0.15346066916151024,0.48868862072158264
33814,0.8252380952380952,0,2,0,589045,16565,92122,15834,0.15344214309533513,0.48871878761690174
33815,0.8253051948051947,0,1,0,589046,16564,92122,15834,0.1534328800622476,0.48873387246126304
33816,0.8253333333333334,3,4,3,589050,16560,92125,15831,0.15339582792989737,0.48874687413170326
33817,0.8253333333333335,0,2,0,589052,16558,92125,15831,0.15337730186372225,0.4887770539380654
33818,0.8253333333333336,0,1,0,589053,16557,92125,15831,0.1533680388306347,0.4887921452389774
33819,0.8253809523809523,0,1,0,589054,16556,92125,15831,0.15335877579754714,0.48880723747182514
33820,0.8254166666666667,1,0,1,589054,16556,92126,15830,0.15335877579754714,0.4887914530970172
33821,0.8254761904761904,2,0,2,589054,16556,92128,15828,0.15335877579754714,0.4887598814229249
33822,0.8255,2,3,2,589057,16553,92130,15826,0.1533309866982845,0.48877358781926555
33823,0.8255000000000001,1,1,1,589058,16552,92131,15825,0.15332172366519692,0.4887728943385737
33824,0.8255555555555556,1,0,1,589058,16552,92132,15824,0.15332172366519692,0.4887571040276748
33825,0.8255833333333333,0,2,0,589060,16550,92132,15824,0.15330319759902183,0.48878729844937296
33826,0.8256666666666664,0,1,0,589061,16549,92132,15824,0.15329393456593426,0.4888023970592778
33827,0.8256666666666667,3,3,3,589064,16546,92135,15821,0.1532661454666716,0.4888003213149195
33828,0.8256666666666668,0,1,0,589065,16545,92135,15821,0.15325688243358404,0.48881542359265895
33829,0.8257142857142857,1,3,1,589068,16542,92136,15820,0.1532290933343214,0.4888449415981707
33830,0.8257777777777778,1,0,1,589068,16542,92137,15819,0.1532290933343214,0.48882914619449336
33831,0.8258333333333333,5,15,5,589083,16527,92142,15814,0.1530901478380081,0.48897684054296403
33832,0.8258333333333334,6,9,6,589092,16518,92148,15808,0.1530067805402201,0.4890181278228052
33833,0.8258333333333335,0,1,0,589093,16517,92148,15808,0.15299751750713253,0.48903325599381287
33834,0.8258571428571427,1,1,1,589094,16516,92149,15807,0.152988254474045,0.48903257742165024
33835,0.825952380952381,0,1,0,589095,16515,92149,15807,0.15297899144095742,0.4890477074438463
33836,0.8259999999999998,0,1,0,589096,16514,92149,15807,0.15296972840786988,0.48906283840227716
33837,0.826,17,19,17,589115,16495,92166,15790,0.15279373077920635,0.4890816168499303
33838,0.8260000000000001,0,5,0,589120,16490,92166,15790,0.15274741561376856,0.48915737298636924
33839,0.8260238095238097,0,1,0,589121,16489,92166,15790,0.15273815258068102,0.48917252702995756
33840,0.8260952380952381,1,0,1,589121,16489,92167,15789,0.15273815258068102,0.4891567011586839
33841,0.8261190476190479,1,0,1,589121,16489,92168,15788,0.15273815258068102,0.48914087430678194
33842,0.8261428571428572,2,0,2,589121,16489,92170,15786,0.15273815258068102,0.4891092176607281
33843,0.8261666666666666,0,4,0,589125,16485,92170,15786,0.1527011004483308,0.4891698428929999
33844,0.8261666666666667,0,5,0,589130,16480,92170,15786,0.15265478528289303,0.4892456455711895
33845,0.82625,0,1,0,589131,16479,92170,15786,0.1526455222498055,0.48926080892608087
33846,0.8262619047619048,0,1,0,589132,16478,92170,15786,0.15263625921671792,0.48927597322092736
33847,0.8262878787878788,0,2,0,589134,16476,92170,15786,0.1526177331505428,0.489306304630835
33848,0.8263095238095238,2,2,2,589136,16474,92172,15784,0.1525992070843677,0.4893049786099572
33849,0.8263333333333333,0,3,0,589139,16471,92172,15784,0.15257141798510504,0.48935048829638816
33850,0.8263333333333334,2,2,2,589141,16469,92174,15782,0.15255289191892993,0.4893491674676754
33851,0.8263809523809527,0,1,0,589142,16468,92174,15782,0.15254362888584239,0.4893643410852713
33852,0.8263888888888886,0,2,0,589144,16466,92174,15782,0.15252510281966727,0.4893946911436368
33853,0.826404761904762,0,2,0,589146,16464,92174,15782,0.15250657675349216,0.4894250449668176
33854,0.8264166666666665,0,1,0,589147,16463,92174,15782,0.15249731372040462,0.48944022329043263
33855,0.8264285714285714,1,1,1,589148,16462,92175,15781,0.15248805068731705,0.48943956827838603
33856,0.8264285714285715,1,0,1,589148,16462,92176,15780,0.15248805068731705,0.48942373301904346
33857,0.8264339826839826,1,0,1,589148,16462,92177,15779,0.15248805068731705,0.48940789677739527
33858,0.82645670995671,0,1,0,589149,16461,92177,15779,0.1524787876542295,0.4894230769230769
33859,0.8264999999999999,0,3,0,589152,16458,92177,15779,0.15245099855496683,0.48946862301082605
33860,0.8265,3,6,3,589158,16452,92180,15776,0.15239542035644152,0.48951222539406725
33861,0.826547619047619,1,0,1,589158,16452,92181,15775,0.15239542035644152,0.4894963850187731
33862,0.8265714285714286,1,1,1,589159,16451,92182,15774,0.15238615732335395,0.4894957331264546
33863,0.8265833333333333,0,1,0,589160,16450,92182,15774,0.1523768942902664,0.4895109235352532
33864,0.8266428571428571,0,2,0,589162,16448,92182,15774,0.1523583682240913,0.48954130718142885
33865,0.8266666666666665,41,72,41,589234,16376,92223,15733,0.1516914298417874,0.48998723099442526
33866,0.8266666666666667,47,56,47,589290,16320,92270,15686,0.15117269998888436,0.49009560707367367
33867,0.8268293650793649,0,2,0,589292,16318,92270,15686,0.15115417392270925,0.49012623422072243
33868,0.8268333333333332,0,5,0,589297,16313,92270,15686,0.15110785875727148,0.4902028188380887
33869,0.8268333333333334,0,3,0,589300,16310,92270,15686,0.15108006965800883,0.4902487810976372
33870,0.8268571428571425,0,2,0,589302,16308,92270,15686,0.1510615435918337,0.49027942739263614
33871,0.8268571428571428,0,1,0,589303,16307,92270,15686,0.15105228055874614,0.49029475197699496
33872,0.826857142857143,1,0,1,589303,16307,92271,15685,0.15105228055874614,0.4902788197049262
33873,0.8268809523809524,1,0,1,589303,16307,92272,15684,0.15105228055874614,0.4902628864368104
33874,0.8269999999999998,1,1,1,589304,16306,92273,15683,0.1510430175256586,0.49026227765794494
33875,0.8270000000000001,5,3,5,589307,16303,92278,15678,0.15101522842639595,0.49022857321534663
33876,0.8270833333333333,1,1,1,589308,16302,92279,15677,0.15100596539330838,0.4902279621001282
33877,0.8271428571428571,1,1,1,589309,16301,92280,15676,0.15099670236022084,0.4902273509084655
33878,0.8271428571428572,1,1,1,589310,16300,92281,15675,0.15098743932713327,0.490226739640344
33879,0.8271666666666667,1,2,1,589312,16298,92282,15674,0.15096891326095818,0.4902414612786188
33880,0.8271666666666668,0,1,0,589313,16297,92282,15674,0.1509596502278706,0.49025679522066873
33881,0.8271746031746031,1,4,1,589317,16293,92283,15673,0.1509225980955204,0.4903021960833385
33882,0.8271926406926409,0,1,0,589318,16292,92283,15673,0.15091333506243285,0.49031753480369156
33883,0.8273333333333333,2,3,2,589321,16289,92285,15671,0.1508855459631702,0.4903316645807259
33884,0.8273333333333334,3,3,3,589324,16286,92288,15668,0.1508577568639075,0.49032984915816485
33885,0.8273333333333335,2,1,2,589325,16285,92290,15666,0.15084849383081997,0.4903132922287252
33886,0.8273809523809524,0,1,0,589326,16284,92290,15666,0.1508392307977324,0.49032863849765257
33887,0.8273993506493506,0,2,0,589328,16282,92290,15666,0.15082070473155731,0.4903593339176161
33888,0.8274999999999999,1,0,1,589328,16282,92291,15665,0.15082070473155731,0.49034338122515414
33889,0.8275,33,42,33,589370,16240,92324,15632,0.15043165734188002,0.4904618473895582
33890,0.8275000000000001,1,2,1,589372,16238,92325,15631,0.1504131312757049,0.4904766387398412
33891,0.8275833333333331,0,1,0,589373,16237,92325,15631,0.15040386824261737,0.4904920296221915
33892,0.8276190476190476,0,2,0,589375,16235,92325,15631,0.15038534217644225,0.4905228142848177
33893,0.8276666666666667,4,4,4,589379,16231,92329,15627,0.15034829004409203,0.49052043442777327
33894,0.8276666666666668,1,0,1,589379,16231,92330,15626,0.15034829004409203,0.4905044417239539
33895,0.8278333333333333,2,3,2,589382,16228,92332,15624,0.15032050094482938,0.4905186487504709
33896,0.8278333333333334,0,1,0,589383,16227,92332,15624,0.1503112379117418,0.4905340491664312
33897,0.827845238095238,1,0,1,589383,16227,92333,15623,0.1503112379117418,0.4905180533751962
33898,0.827952380952381,0,1,0,589384,16226,92333,15623,0.15030197487865427,0.4905334547395523
33899,0.8279761904761904,1,0,1,589384,16226,92334,15622,0.15030197487865427,0.49051745792514445
33900,0.8279999999999998,1,0,1,589384,16226,92335,15621,0.15030197487865427,0.49050146010613244
33901,0.828,7,16,7,589400,16210,92342,15614,0.1501537663492534,0.49063599798893914
33902,0.8280000000000001,2,3,2,589403,16207,92344,15612,0.15012597724999074,0.49065024042238914
33903,0.8280476190476189,1,0,1,589403,16207,92345,15611,0.15012597724999074,0.49063423219561253
33904,0.8280714285714288,0,1,0,589404,16206,92345,15611,0.15011671421690317,0.49064965270138605
33905,0.8280833333333333,0,2,0,589406,16204,92345,15611,0.15009818815072806,0.4906804966210907
33906,0.8280952380952381,0,1,0,589407,16203,92345,15611,0.15008892511764052,0.4906959200352046
33907,0.8281428571428572,1,0,1,589407,16203,92346,15610,0.15008892511764052,0.4906799107283186
33908,0.8281666666666666,4,4,4,589411,16199,92350,15606,0.1500518729852903,0.49067756642037413
33909,0.8281666666666667,2,3,2,589414,16196,92352,15604,0.15002408388602764,0.49069182389937105
33910,0.8282142857142857,1,0,1,589414,16196,92353,15603,0.15002408388602764,0.4906758074153275
33911,0.8282619047619049,0,1,0,589415,16195,92353,15603,0.15001482085294007,0.4906912384426694
33912,0.8282857142857142,0,1,0,589416,16194,92353,15603,0.15000555781985253,0.4907066704406076
33913,0.8282857142857144,0,1,0,589417,16193,92353,15603,0.149996294786765,0.4907221034092339
33914,0.8283333333333331,1,0,1,589417,16193,92354,15602,0.149996294786765,0.490706085862557
33915,0.8283333333333333,12,33,12,589450,16160,92366,15590,0.14969061469487568,0.4910236220472441
33916,0.8283333333333335,10,25,10,589475,16135,92376,15580,0.14945903886768683,0.4912501970676336
33917,0.8283809523809523,0,1,0,589476,16134,92376,15580,0.14944977583459929,0.49126568707826196
33918,0.8283888888888888,0,1,0,589477,16133,92376,15580,0.14944051280151172,0.4912811780657774
33919,0.8284166666666667,0,4,0,589481,16129,92376,15580,0.14940346066916152,0.491343151786559
33920,0.8284444444444443,1,0,1,589481,16129,92377,15579,0.14940346066916152,0.4913271098776334
33921,0.8284761904761905,1,0,1,589481,16129,92378,15578,0.14940346066916152,0.4913110669568234
33922,0.8284999999999999,1,5,1,589486,16124,92379,15577,0.14935714550372373,0.4913725119081417
33923,0.8285000000000001,1,1,1,589487,16123,92380,15576,0.14934788247063618,0.4913719675699549
33924,0.8285238095238094,0,1,0,589488,16122,92380,15576,0.14933861943754864,0.49138746924096155
33925,0.8285476190476192,0,1,0,589489,16121,92380,15576,0.14932935640446107,0.49140297189008425
33926,0.8286428571428571,0,1,0,589490,16120,92380,15576,0.14932009337137353,0.49141847551741547
33927,0.8286666666666666,2,2,2,589492,16118,92382,15574,0.14930156730519842,0.491417392401868
33928,0.8286666666666668,3,3,3,589495,16115,92385,15571,0.14927377820593576,0.4914157672158051
33929,0.8286904761904761,0,1,0,589496,16114,92385,15571,0.1492645151728482,0.49143127662931985
33930,0.8287142857142856,0,4,0,589500,16110,92385,15571,0.14922746304049797,0.49149332407436636
33931,0.82875,1,0,1,589500,16110,92386,15570,0.14922746304049797,0.4914772727272727
33932,0.8287500000000001,0,1,0,589501,16109,92386,15570,0.14921820000741043,0.49149278701979227
33933,0.8287976190476191,0,1,0,589502,16108,92386,15570,0.14920893697432286,0.49150830229181136
33934,0.8288333333333333,0,1,0,589503,16107,92386,15570,0.14919967394123532,0.4915238185434227
33935,0.8288333333333334,0,1,0,589504,16106,92386,15570,0.14919041090814777,0.49153933577471903
33936,0.8289166666666666,0,1,0,589505,16105,92386,15570,0.1491811478750602,0.49155485398579324
33937,0.8289761904761906,0,1,0,589506,16104,92386,15570,0.14917188484197266,0.491570373176738
33938,0.829,1,1,1,589507,16103,92387,15569,0.1491626218088851,0.4915698408689063
33939,0.8290000000000001,7,12,7,589519,16091,92394,15562,0.14905146541183445,0.4916437620446719
33940,0.8290714285714286,0,1,0,589520,16090,92394,15562,0.1490422023787469,0.4916592948312903
33941,0.8290833333333333,0,1,0,589521,16089,92394,15562,0.14903293934565934,0.49167482859941236
33942,0.8291666666666666,3,13,3,589534,16076,92397,15559,0.14891251991552115,0.4918286707760392
33943,0.8291666666666667,10,10,10,589544,16066,92407,15549,0.1488198895846456,0.49182350150245135
33944,0.8291904761904761,0,1,0,589545,16065,92407,15549,0.14881062655155805,0.4918390586449042
33945,0.8292499999999999,0,3,0,589548,16062,92407,15549,0.14878283745229537,0.49188573597798235
33946,0.8292738095238095,0,1,0,589549,16061,92407,15549,0.14877357441920783,0.4919012970578931
33947,0.8292857142857142,0,2,0,589551,16059,92407,15549,0.14875504835303272,0.4919324221716021
33948,0.8292857142857143,1,1,1,589552,16058,92408,15548,0.14874578531994517,0.49193191166234257
33949,0.8293333333333333,3,2,3,589554,16056,92411,15545,0.14872725925377006,0.49191481282237903
33950,0.8293333333333334,4,2,4,589556,16054,92415,15541,0.14870873318759495,0.49188162683968983
33951,0.8293809523809526,0,1,0,589557,16053,92415,15541,0.14869947015450738,0.49189719567006396
33952,0.8294166666666666,0,2,0,589559,16051,92415,15541,0.1486809440883323,0.49192833628766774
33953,0.8294444444444444,0,1,0,589560,16050,92415,15541,0.14867168105524473,0.4919439080750847
33954,0.8294523809523809,1,0,1,589560,16050,92416,15540,0.14867168105524473,0.4919278252611586
33955,0.8294999999999999,0,1,0,589561,16049,92416,15540,0.14866241802215718,0.4919433980182975
33956,0.8295,3,1,3,589562,16048,92419,15537,0.1486531549890696,0.4919107171125534
33957,0.8295000000000001,0,1,0,589563,16047,92419,15537,0.14864389195598207,0.4919262917933131
33958,0.8295158730158732,0,1,0,589564,16046,92419,15537,0.1486346289228945,0.4919418674603426
33959,0.8295714285714284,0,1,0,589565,16045,92419,15537,0.14862536588980696,0.49195744411373565
33960,0.8295714285714287,1,1,1,589566,16044,92420,15536,0.14861610285671942,0.49195693476884106
33961,0.8295833333333333,1,0,1,589566,16044,92421,15535,0.14861610285671942,0.4919408467652554
33962,0.8295833333333335,0,1,0,589567,16043,92421,15535,0.14860683982363185,0.49195642535942746
33963,0.8296666666666666,0,2,0,589569,16041,92421,15535,0.14858831375745674,0.4919875855079807
33964,0.8296666666666667,6,2,6,589571,16039,92427,15529,0.14856978769128162,0.49192219969589457
33965,0.8296969696969698,1,0,1,589571,16039,92428,15528,0.14856978769128162,0.4919061044761935
33966,0.8297619047619048,1,0,1,589571,16039,92429,15527,0.14856978769128162,0.49189000823671036
33967,0.8298214285714285,0,1,0,589572,16038,92429,15527,0.14856052465819408,0.49190559163630604
33968,0.8298333333333332,2,3,2,589575,16035,92431,15525,0.14853273555893143,0.4919201520912547
33969,0.8298333333333333,1,2,1,589577,16033,92432,15524,0.14851420949275632,0.49193522831701364
33970,0.8298333333333335,0,1,0,589578,16032,92432,15524,0.14850494645966875,0.4919508175941184
33971,0.829904761904762,1,1,1,589579,16031,92433,15523,0.1484956834265812,0.49195030740952017
33972,0.82990873015873,0,2,0,589581,16029,92433,15523,0.1484771573604061,0.49198149087221094
33973,0.8299761904761902,1,0,1,589581,16029,92434,15522,0.1484771573604061,0.4919653893695921
33974,0.8299999999999998,1,4,1,589585,16025,92435,15521,0.14844010522805587,0.4920116655043429
33975,0.83,771,947,771,590532,15078,93206,14750,0.13966801289414205,0.4945018103795092
33976,0.8300000000000002,1,4,1,590536,15074,93207,14749,0.13963096076179185,0.49455118532676123
33977,0.8300238095238093,0,3,0,590539,15071,93207,14749,0.13960317166252917,0.49460093896713614
33978,0.8301388888888889,0,1,0,590540,15070,93207,14749,0.13959390862944163,0.494617525738623
33979,0.8301666666666666,0,2,0,590542,15068,93207,14749,0.13957538256326651,0.49465070261931116
33980,0.8301666666666668,0,1,0,590543,15067,93207,14749,0.13956611953017897,0.4946672927287363
33981,0.830202380952381,1,0,1,590543,15067,93208,14748,0.13956611953017897,0.49465034378668454
33982,0.8302619047619045,0,1,0,590544,15066,93208,14748,0.1395568564970914,0.4946669349969813
33983,0.830297619047619,1,0,1,590544,15066,93209,14747,0.1395568564970914,0.49464998490591355
33984,0.8302976190476191,0,2,0,590546,15064,93209,14747,0.1395383304309163,0.4946831706417094
33985,0.8303333333333334,1,1,1,590547,15063,93210,14746,0.13952906739782875,0.4946828139152605
33986,0.8303333333333335,1,1,1,590548,15062,93211,14745,0.13951980436474118,0.49468245714094006
33987,0.8304166666666666,2,1,2,590549,15061,93213,14743,0.13951054133165364,0.49466514561803787
33988,0.8304761904761904,0,1,0,590550,15060,93213,14743,0.1395012782985661,0.4946817434486461
33989,0.8304761904761905,1,1,1,590551,15059,93214,14742,0.13949201526547853,0.49468138653065336
33990,0.8304880952380952,1,0,1,590551,15059,93215,14741,0.13949201526547853,0.49466442953020134
33991,0.8305,0,3,0,590554,15056,93215,14741,0.13946422616621587,0.49471423297647416
33992,0.8305833333333333,0,1,0,590555,15055,93215,14741,0.1394549631331283,0.494730836353873
33993,0.830595238095238,1,2,1,590557,15053,93216,14740,0.1394364370669532,0.49474708824220454
33994,0.8306190476190476,0,1,0,590558,15052,93216,14740,0.13942717403386565,0.4947636949516649
33995,0.8306428571428571,0,1,0,590559,15051,93216,14740,0.1394179110007781,0.49478030277600615
33996,0.8306666666666667,6,7,6,590566,15044,93222,14734,0.13935306976916523,0.4947948149640674
33997,0.8306666666666668,1,1,1,590567,15043,93223,14733,0.13934380673607766,0.4947944653412144
33998,0.8308333333333331,0,1,0,590568,15042,93223,14733,0.13933454370299012,0.4948110831234257
33999,0.8308333333333333,9,14,9,590582,15028,93232,14724,0.13920486123976436,0.49489109975799944
34000,0.8308333333333334,3,8,3,590590,15020,93235,14721,0.1391307569750639,0.4949732692243031
34001,0.8308650793650793,0,1,0,590591,15019,93235,14721,0.13912149394197637,0.49498991257565567
34002,0.8308809523809522,0,1,0,590592,15018,93235,14721,0.1391122309088888,0.4950065570463028
34003,0.8309523809523809,1,0,1,590592,15018,93236,14720,0.1391122309088888,0.49498957562714374
34004,0.830952380952381,1,1,1,590593,15017,93237,14719,0.13910296787580126,0.4949892386333064
34005,0.8309534632034632,0,1,0,590594,15016,93237,14719,0.1390937048427137,0.4950058853203296
34006,0.8309603174603174,0,1,0,590595,15015,93237,14719,0.13908444180962615,0.4950225331270599
34007,0.831,6,10,6,590605,15005,93243,14713,0.13899181147875062,0.49508715256746755
34008,0.8310000000000001,0,1,0,590606,15004,93243,14713,0.13898254844566305,0.4951038126324999
34009,0.8310714285714286,1,0,1,590606,15004,93244,14712,0.13898254844566305,0.49508682191412035
34010,0.8311071428571428,0,1,0,590607,15003,93244,14712,0.1389732854125755,0.4951034830893488
34011,0.8311428571428572,1,1,1,590608,15002,93245,14711,0.13896402237948793,0.4951031535018342
34012,0.8311666666666666,0,1,0,590609,15001,93245,14711,0.1389547593464004,0.495119816908993
34013,0.8311666666666667,1,0,1,590609,15001,93246,14710,0.1389547593464004,0.49510282386994714
34014,0.8311904761904763,1,0,1,590609,15001,93247,14709,0.1389547593464004,0.49508582968697407
34015,0.8312142857142857,0,1,0,590610,15000,93247,14709,0.13894549631331282,0.4951024941936787
34016,0.83125,1,3,1,590613,14997,93248,14708,0.13891770721405017,0.49513549907422993
34017,0.831281746031746,0,1,0,590614,14996,93248,14708,0.13890844418096263,0.49515216805817397
34018,0.8313095238095236,0,2,0,590616,14994,93248,14708,0.13888991811478751,0.49518550939330686
34019,0.8313095238095238,0,1,0,590617,14993,93248,14708,0.13888065508169994,0.4952021817447224
34020,0.8313333333333333,1,3,1,590620,14990,93249,14707,0.1388528659824373,0.49523520894366435
34021,0.8313333333333334,1,0,1,590620,14990,93250,14706,0.1388528659824373,0.4952182112068966
34022,0.8313571428571429,0,1,0,590621,14989,93250,14706,0.13884360294934975,0.4952348880282876
34023,0.8313888888888888,1,1,1,590622,14988,93251,14705,0.13883433991626218,0.4952345670696797
34024,0.8314285714285714,0,1,0,590623,14987,93251,14705,0.13882507688317464,0.49525124612690286
34025,0.8314444444444443,0,1,0,590624,14986,93251,14705,0.13881581385008707,0.49526792630763533
34026,0.8314484126984126,0,2,0,590626,14984,93251,14705,0.13879728778391195,0.49530129004008216
34027,0.8314642857142854,0,1,0,590627,14983,93251,14705,0.1387880247508244,0.49531797359202373
34028,0.8315,0,7,0,590634,14976,93251,14705,0.13872318351921153,0.49543478993295376
34029,0.8316666666666666,14,20,14,590654,14956,93265,14691,0.13853792285746044,0.49553074510068473
34030,0.8316666666666667,14,16,14,590670,14940,93279,14677,0.13838971432805958,0.49555998244251614
34031,0.8317142857142857,0,1,0,590671,14939,93279,14677,0.13838045129497203,0.49557671528903297
34032,0.8317579365079365,0,2,0,590673,14937,93279,14677,0.13836192522879692,0.49561018437225635
34033,0.8317857142857144,0,1,0,590674,14936,93279,14677,0.13835266219570935,0.4956269206091919
34034,0.8318181818181819,0,1,0,590675,14935,93279,14677,0.1383433991626218,0.495643657976496
34035,0.8318333333333332,1,3,1,590678,14932,93280,14676,0.13831561006335916,0.49567684409619023
34036,0.8318333333333334,1,2,1,590680,14930,93281,14675,0.13829708399718404,0.49569329505151155
34037,0.8319999999999999,1,0,1,590680,14930,93282,14674,0.13829708399718404,0.49567625996486964
34038,0.8320000000000001,5,12,5,590692,14918,93287,14669,0.1381859276001334,0.49579207084192384
34039,0.8320634920634921,0,1,0,590693,14917,93287,14669,0.13817666456704583,0.4958088284999662
34040,0.8320714285714286,0,1,0,590694,14916,93287,14669,0.1381674015339583,0.49582558729085685
34041,0.8321428571428571,1,1,1,590695,14915,93288,14668,0.13815813850087072,0.49582530507385997
34042,0.8321428571428572,1,2,1,590697,14913,93289,14667,0.1381396124346956,0.49584178498985804
34043,0.8321468253968254,0,1,0,590698,14912,93289,14667,0.13813034940160807,0.49585854829439807
34044,0.8321666666666667,0,1,0,590699,14911,93289,14667,0.1381210863685205,0.4958753127324363
34045,0.8322222222222222,1,0,1,590699,14911,93290,14666,0.1381210863685205,0.4958582682489772
34046,0.8322380952380951,1,0,1,590699,14911,93291,14665,0.1381210863685205,0.4958412226129294
34047,0.8322619047619046,1,0,1,590699,14911,93292,14664,0.1381210863685205,0.4958241758241758
34048,0.8322857142857143,0,1,0,590700,14910,93292,14664,0.13811182333543295,0.4958409413674173
34049,0.832297619047619,1,0,1,590700,14910,93293,14663,0.13811182333543295,0.4958238934162919
34050,0.8323333333333331,0,4,0,590704,14906,93293,14663,0.13807477120308273,0.4958909668910007
34051,0.8323333333333334,0,4,0,590708,14902,93293,14663,0.13803771907073253,0.49595805851513614
34052,0.8323809523809522,1,0,1,590708,14902,93294,14662,0.13803771907073253,0.49594100933567853
34053,0.8323809523809524,0,1,0,590709,14901,93294,14662,0.13802845603764496,0.4959577850691743
34054,0.8323888888888888,1,0,1,590709,14901,93295,14661,0.13802845603764496,0.4959407347270144
34055,0.8324444444444444,0,3,0,590712,14898,93295,14661,0.1380006669383823,0.49599106871003756
34056,0.8325,28,62,28,590774,14836,93323,14633,0.13742635888695395,0.49655570260273507
34057,0.8325000000000001,1,2,1,590776,14834,93324,14632,0.13740783282077884,0.4965723206407385
34058,0.8325714285714285,1,0,1,590776,14834,93325,14631,0.13740783282077884,0.49655523502460547
34059,0.8326190476190476,0,1,0,590777,14833,93325,14631,0.13739856978769127,0.49657208797176217
34060,0.8326666666666666,2,1,2,590778,14832,93327,14629,0.13738930675460373,0.49655476731950715
34061,0.8326666666666667,1,11,1,590789,14821,93328,14628,0.13728741339064063,0.49672314849400656
34062,0.8326666666666668,1,3,1,590792,14818,93329,14627,0.13725962429137797,0.4967566649685855
34063,0.8326785714285714,0,1,0,590793,14817,93329,14627,0.1372503612582904,0.4967735362043201
34064,0.8327142857142859,0,1,0,590794,14816,93329,14627,0.13724109822520286,0.4967904085860816
34065,0.8327420634920637,1,1,1,590795,14815,93330,14626,0.13723183519211532,0.4967901905505927
34066,0.8327857142857141,0,1,0,590796,14814,93330,14626,0.13722257215902775,0.4968070652173913
34067,0.8328095238095239,1,1,1,590797,14813,93331,14625,0.1372133091259402,0.49680684829132415
34068,0.8328333333333334,1,1,1,590798,14812,93332,14624,0.13720404609285264,0.4968066313357793
34069,0.8328571428571427,0,4,0,590802,14808,93332,14624,0.13716699396050241,0.49687415058439793
34070,0.832857142857143,0,1,0,590803,14807,93332,14624,0.13715773092741487,0.49689103326424516
34071,0.8328809523809523,0,1,0,590804,14806,93332,14624,0.13714846789432733,0.4969079170914033
34072,0.8328809523809524,0,1,0,590805,14805,93332,14624,0.13713920486123976,0.4969248020659893
34073,0.832888888888889,1,0,1,590805,14805,93333,14623,0.13713920486123976,0.4969077069457659
34074,0.8329761904761903,0,1,0,590806,14804,93333,14623,0.13712994182815222,0.4969245930607945
34075,0.833,3,12,3,590818,14792,93336,14620,0.13701878543110155,0.49707602339181284
34076,0.833047619047619,0,1,0,590819,14791,93336,14620,0.137009522398014,0.4970929244160348
34077,0.8331428571428573,0,1,0,590820,14790,93336,14620,0.13700025936492646,0.49710982658959535
34078,0.8331666666666666,3,2,3,590822,14788,93339,14617,0.13698173329875135,0.49709233123618435
34079,0.8331666666666667,1,1,1,590823,14787,93340,14616,0.13697247026566378,0.4970921334557698
34080,0.8331865079365081,1,1,1,590824,14786,93341,14615,0.13696320723257624,0.49709193564844734
34081,0.8332207792207792,0,1,0,590825,14785,93341,14615,0.13695394419948867,0.49710884353741497
34082,0.8332619047619048,0,2,0,590827,14783,93341,14615,0.13693541813331359,0.4971426627661746
34083,0.833281746031746,0,1,0,590828,14782,93341,14615,0.13692615510022602,0.4971595741062013
34084,0.8332857142857142,1,0,1,590828,14782,93342,14614,0.13692615510022602,0.4971424683630426
34085,0.8333095238095238,1,0,1,590828,14782,93343,14613,0.13692615510022602,0.4971253614560299
34086,0.8333253968253967,0,1,0,590829,14781,93343,14613,0.13691689206713847,0.4971422739334558
34087,0.8333333333333333,48,49,48,590878,14732,93391,14565,0.1364630034458483,0.49714987882718364
34088,0.8333333333333335,34,39,34,590917,14693,93425,14531,0.1361017451554337,0.49722830550232683
34089,0.8333492063492064,1,2,1,590919,14691,93426,14530,0.13608321908925858,0.4972451319256699
34090,0.8334166666666667,0,1,0,590920,14690,93426,14530,0.13607395605617104,0.4972621492128679
34091,0.8334523809523808,0,1,0,590921,14689,93426,14530,0.13606469302308347,0.4972791676648756
34092,0.8334523809523811,0,2,0,590923,14687,93426,14530,0.13604616695690838,0.4973132080637985
34093,0.8334999999999998,0,2,0,590925,14685,93426,14530,0.13602764089073327,0.4973472531233955
34094,0.8334999999999999,0,1,0,590926,14684,93426,14530,0.1360183778576457,0.497364277401246
34095,0.8335000000000001,0,1,0,590927,14683,93426,14530,0.13600911482455816,0.49738130284462395
34096,0.8335714285714286,2,2,2,590929,14681,93428,14528,0.13599058875838305,0.4973809442295183
34097,0.8335833333333333,1,2,1,590931,14679,93429,14527,0.13597206269220793,0.49739779497363557
34098,0.8336666666666666,1,2,1,590933,14677,93430,14526,0.13595353662603282,0.49741464917987877
34099,0.8336666666666668,1,4,1,590937,14673,93431,14525,0.1359164844936826,0.4974655798342352
34100,0.8336953295568648,1,3,1,590940,14670,93432,14524,0.13588869539441994,0.49749948619579365
34101,0.8337023809523808,0,1,0,590941,14669,93432,14524,0.1358794323613324,0.4975165279347789
34102,0.8337619047619046,0,1,0,590942,14668,93432,14524,0.13587016932824483,0.4975335708413264
34103,0.8338095238095238,1,1,1,590943,14667,93433,14523,0.1358609062951573,0.4975334018499486
34104,0.8338095238095239,0,2,0,590945,14665,93433,14523,0.13584238022898218,0.4975674934904755
34105,0.8338333333333332,1,5,1,590950,14660,93434,14522,0.1357960650635444,0.4976355287505997
34106,0.8338333333333334,2,0,2,590950,14660,93436,14520,0.1357960650635444,0.4976010966415353
34107,0.8339119769119762,1,1,1,590951,14659,93437,14519,0.13578680203045684,0.4976009322091987
34108,0.8339285714285716,1,0,1,590951,14659,93438,14518,0.13578680203045684,0.49758371319875244
34109,0.833952380952381,0,2,0,590953,14657,93438,14518,0.13576827596428173,0.497617823479006
34110,0.83397619047619,0,2,0,590955,14655,93438,14518,0.13574974989810665,0.4976519384362253
34111,0.834,1,1,1,590956,14654,93439,14517,0.13574048686501908,0.4976517774502074
34112,0.8340000000000001,14,19,14,590975,14635,93453,14503,0.13556448923635556,0.4977349166037477
34113,0.8340000000000002,0,1,0,590976,14634,93453,14503,0.135555226203268,0.497751999176305
34114,0.8340476190476189,0,1,0,590977,14633,93453,14503,0.13554596317018044,0.4977690829214717
34115,0.8341666666666666,8,7,8,590984,14626,93461,14495,0.13548112193856757,0.4977507640534322
34116,0.8341666666666667,5,21,5,591005,14605,93466,14490,0.13528659824372893,0.4980237154150198
34117,0.8341666666666668,1,0,1,591005,14605,93467,14489,0.13528659824372893,0.49800646181343233
34118,0.8342380952380951,0,1,0,591006,14604,93467,14489,0.13527733521064136,0.4980235795552195
34119,0.8342857142857143,1,2,1,591008,14602,93468,14488,0.13525880914446625,0.49804056376761774
34120,0.8343214285714287,1,0,1,591008,14602,93469,14487,0.13525880914446625,0.49802330777957304
34121,0.8343333333333333,2,1,2,591009,14601,93471,14485,0.1352495461113787,0.4980059134979028
34122,0.8343333333333334,2,6,2,591015,14595,93473,14483,0.13519396791285337,0.49807414540202216
34123,0.8343690476190477,0,2,0,591017,14593,93473,14483,0.13517544184667826,0.4981084055578484
34124,0.8343809523809524,0,1,0,591018,14592,93473,14483,0.13516617881359072,0.4981255374032674
34125,0.8343968253968254,0,2,0,591020,14590,93473,14483,0.1351476527474156,0.4981598046297252
34126,0.8345,2,0,2,591020,14590,93475,14481,0.1351476527474156,0.4981252794881497
34127,0.8345000000000001,1,0,1,591020,14590,93476,14480,0.1351476527474156,0.49810801513587893
34128,0.8345238095238094,0,1,0,591021,14589,93476,14480,0.13513838971432807,0.4981251505039733
34129,0.8345454545454545,0,1,0,591022,14588,93476,14480,0.1351291266812405,0.4981422870510527
34130,0.8345714285714285,1,1,1,591023,14587,93477,14479,0.13511986364815295,0.4981421592238354
34131,0.8346428571428572,0,2,0,591025,14585,93477,14479,0.13510133758197784,0.49817643820533997
34132,0.8346666666666666,0,4,0,591029,14581,93477,14479,0.13506428544962762,0.4982450103234687
34133,0.8346666666666667,3,9,3,591038,14572,93480,14476,0.13498091815183963,0.498347562654916
34134,0.8346666666666668,0,3,0,591041,14569,93480,14476,0.13495312905257698,0.4983990359786538
34135,0.8347142857142855,0,1,0,591042,14568,93480,14476,0.13494386601948943,0.49841619611623744
34136,0.8347142857142857,0,1,0,591043,14567,93480,14476,0.13493460298640186,0.49843335743552664
34137,0.8347380952380952,0,1,0,591044,14566,93480,14476,0.13492533995331432,0.49845051993664347
34138,0.8347619047619047,1,1,1,591045,14565,93481,14475,0.13491607692022675,0.4984504132231405
34139,0.8347619047619048,1,0,1,591045,14565,93482,14474,0.13491607692022675,0.4984331416371087
34140,0.8347777777777777,0,1,0,591046,14564,93482,14474,0.1349068138871392,0.49845030649493766
34141,0.8348333333333333,0,2,0,591048,14562,93482,14474,0.1348882878209641,0.49848463975754237
34142,0.8349166666666668,1,0,1,591048,14562,93483,14473,0.1348882878209641,0.4984673669708972
34143,0.8349999999999999,1,7,1,591055,14555,93484,14472,0.13482344658935122,0.49857029662038793
34144,0.835,154,209,154,591264,14346,93638,14318,0.1328874726740524,0.49951158247278815
34145,0.8350000000000002,1,5,1,591269,14341,93639,14317,0.1328411575086146,0.4995812687556703
34146,0.8350238095238096,0,2,0,591271,14339,93639,14317,0.13282263144243953,0.49961613623673923
34147,0.8350357142857142,1,0,1,591271,14339,93640,14316,0.13282263144243953,0.4995986738789042
34148,0.8350357142857143,0,2,0,591273,14337,93640,14316,0.13280410537626441,0.49963354622552614
34149,0.8351190476190475,1,0,1,591273,14337,93641,14315,0.13280410537626441,0.49961608264693563
34150,0.8351666666666666,0,2,0,591275,14335,93641,14315,0.1327855793100893,0.49965095986038394
34151,0.8352142857142859,0,1,0,591276,14334,93641,14315,0.13277631627700173,0.499668400293204
34152,0.8353333333333333,0,7,0,591283,14327,93641,14315,0.13271147504538885,0.49979051742196773
34153,0.8353333333333335,0,1,0,591284,14326,93641,14315,0.1327022120123013,0.4998079675988967
34154,0.8353928571428572,0,4,0,591288,14322,93641,14315,0.1326651598799511,0.4998777804937668
34155,0.8354365079365078,0,1,0,591289,14321,93641,14315,0.13265589684686355,0.4998952367649113
34156,0.8354444444444442,1,0,1,591289,14321,93642,14314,0.13265589684686355,0.4998777719573948
34157,0.8354761904761904,1,1,1,591290,14320,93643,14313,0.13264663381377598,0.49987776341983026
34158,0.8354761904761905,0,1,0,591291,14319,93643,14313,0.13263737078068844,0.4998952221290863
34159,0.8355,2,0,2,591291,14319,93645,14311,0.13263737078068844,0.4998602864128536
34160,0.8355555555555556,0,1,0,591292,14318,93645,14311,0.13262810774760087,0.49987774634112264
34161,0.8355555555555557,0,1,0,591293,14317,93645,14311,0.13261884471451332,0.49989520748917143
34162,0.835642857142857,1,0,1,591293,14317,93646,14310,0.13261884471451332,0.499877737799979
34163,0.8356666666666667,1,1,1,591294,14316,93647,14309,0.13260958168142575,0.4998777292576419
34164,0.8356666666666668,2,2,2,591296,14314,93649,14307,0.13259105561525067,0.4998777121693861
34165,0.8357142857142857,4,3,4,591299,14311,93653,14303,0.132563266515988,0.49986020828964844
34166,0.8357380952380953,0,1,0,591300,14310,93653,14303,0.13255400348290045,0.4998776779785412
34167,0.8357499999999999,1,0,1,591300,14310,93654,14302,0.13255400348290045,0.4998601985181043
34168,0.8358333333333331,0,1,0,591301,14309,93654,14302,0.13254474044981288,0.49987766942784245
34169,0.8358333333333333,4,13,4,591314,14296,93658,14298,0.1324243210196747,0.5000349723718263
34170,0.8358333333333334,4,14,4,591328,14282,93662,14294,0.13229463855644893,0.5002099664053752
34171,0.8358650793650791,1,1,1,591329,14281,93663,14293,0.13228537552336136,0.5002099811017009
34172,0.8358888888888889,1,0,1,591329,14281,93664,14292,0.13228537552336136,0.5001924894130823
34173,0.8359444444444444,1,1,1,591330,14280,93665,14291,0.13227611249027382,0.5001925028875434
34174,0.8359523809523808,1,0,1,591330,14280,93666,14290,0.13227611249027382,0.5001750087504375
34175,0.835952380952381,0,1,0,591331,14279,93666,14290,0.13226684945718625,0.500192516363891
34176,0.8359523809523811,0,1,0,591332,14278,93666,14290,0.1322575864240987,0.5002100252030244
34177,0.8359679519826573,2,4,2,591336,14274,93668,14288,0.1322205342917485,0.5002450808766893
34178,0.8359761904761904,1,0,1,591336,14274,93669,14287,0.1322205342917485,0.5002275830678198
34179,0.8359999999999999,0,4,0,591340,14270,93669,14287,0.13218348215939826,0.5002976503134082
34180,0.836,19,16,19,591356,14254,93688,14268,0.1320352736299974,0.5002454245845313
34181,0.8360000000000001,2,4,2,591360,14250,93690,14266,0.1319982214976472,0.5002805442558563
34182,0.836011904761905,1,2,1,591362,14248,93691,14265,0.1319796954314721,0.500298109634202
34183,0.8361190476190475,0,1,0,591363,14247,93691,14265,0.13197043239838452,0.5003156565656566
34184,0.8361269841269842,0,3,0,591366,14244,93691,14265,0.13194264329912186,0.5003683047458697
34185,0.8361388888888888,2,1,2,591367,14243,93693,14263,0.13193338026603432,0.5003508033396478
34186,0.8361666666666666,1,5,1,591372,14238,93694,14262,0.13188706510059653,0.500421052631579
34187,0.8361666666666668,0,1,0,591373,14237,93694,14262,0.131877802067509,0.5004386118811186
34188,0.8361904761904762,0,1,0,591374,14236,93694,14262,0.13186853903442144,0.5004561723629728
34189,0.83625,3,1,3,591375,14235,93697,14259,0.13185927600133387,0.5004211412929037
34190,0.8362500000000002,0,1,0,591376,14234,93697,14259,0.13185001296824633,0.5004387042431474
34191,0.8362857142857143,0,1,0,591377,14233,93697,14259,0.13184074993515876,0.5004562684262249
34192,0.8363095238095238,0,1,0,591378,14232,93697,14259,0.13183148690207122,0.500473833842266
34193,0.8363174603174602,0,2,0,591380,14230,93697,14259,0.1318129608358961,0.5005089683737582
34194,0.8363333333333333,2,1,2,591381,14229,93699,14257,0.13180369780280854,0.5004914694937864
34195,0.8363333333333334,0,2,0,591383,14227,93699,14257,0.13178517173663346,0.5005266114309788
34196,0.8364641747141747,0,1,0,591384,14226,93699,14257,0.13177590870354589,0.5005441842502545
34197,0.836468253968254,1,0,1,591384,14226,93700,14256,0.13177590870354589,0.5005266484095218
34198,0.8364999999999999,0,1,0,591385,14225,93700,14256,0.13176664567045834,0.5005442224640989
34199,0.8365,4,3,4,591388,14222,93704,14252,0.13173885657119566,0.5005267963756409
34200,0.8366666666666666,52,58,52,591446,14164,93756,14200,0.13120160065211753,0.500634607248625
34201,0.8366666666666667,43,52,43,591498,14112,93799,14157,0.1307199229315647,0.5007959248646928
34202,0.836738095238095,0,1,0,591499,14111,93799,14157,0.13071065989847716,0.5008136408659969
34203,0.8367380952380951,0,2,0,591501,14109,93799,14157,0.13069213383230205,0.5008490766291658
34204,0.8367380952380953,1,0,1,591501,14109,93800,14156,0.13069213383230205,0.5008314169467539
34205,0.8367619047619048,0,1,0,591502,14108,93800,14156,0.1306828707992145,0.5008491367110105
34206,0.8368333333333332,0,2,0,591504,14106,93800,14156,0.1306643447330394,0.5008845800014153
34207,0.8368333333333333,1,2,1,591506,14104,93801,14155,0.13064581866686428,0.500902367387381
34208,0.8368452380952381,0,3,0,591509,14101,93801,14155,0.13061802956760163,0.5009555492638732
34209,0.8368888888888888,0,1,0,591510,14100,93801,14155,0.13060876653451406,0.5009732790656521
34210,0.8369642857142858,1,0,1,591510,14100,93802,14154,0.13060876653451406,0.5009556169038012
34211,0.8369999999999999,0,1,0,591511,14099,93802,14154,0.13059950350142652,0.5009733479630482
34212,0.8370000000000001,0,4,0,591515,14095,93802,14154,0.1305624513690763,0.5010442847534426
34213,0.8370952380952381,0,1,0,591516,14094,93802,14154,0.13055318833598872,0.5010620220900595
34214,0.8371111111111111,1,0,1,591516,14094,93803,14153,0.13055318833598872,0.5010443586929585
34215,0.8371428571428571,0,2,0,591518,14092,93803,14153,0.13053466226981364,0.5010798371393167
34216,0.8371428571428572,1,2,1,591520,14090,93804,14152,0.13051613620363853,0.501097655973373
34217,0.8371666666666667,3,1,3,591521,14089,93807,14149,0.13050687317055096,0.5010623981868404
34218,0.8371666666666668,0,1,0,591522,14088,93807,14149,0.13049761013746342,0.5010801430746893
34219,0.8372380952380953,0,3,0,591525,14085,93807,14149,0.13046982103820076,0.5011333852801587
34220,0.8372936507936507,0,3,0,591528,14082,93807,14149,0.13044203193893808,0.5011866388013178
34221,0.8373333333333332,1,1,1,591529,14081,93808,14148,0.13043276890585054,0.5011867228736406
34222,0.8373333333333334,4,9,4,591538,14072,93812,14144,0.13034940160806255,0.5012758718457613
34223,0.8373690476190476,0,1,0,591539,14071,93812,14144,0.13034013857497498,0.5012936381357433
34224,0.8373809523809524,1,0,1,591539,14071,93813,14143,0.13034013857497498,0.5012759622882257
34225,0.8374999999999999,2,2,2,591541,14069,93815,14141,0.1303216125087999,0.5012761432116271
34226,0.8375,32,40,32,591581,14029,93847,14109,0.1299510911852977,0.5014215651432227
34227,0.8375000000000001,1,1,1,591582,14028,93848,14108,0.12994182815221017,0.501421666192778
34228,0.8375641025641025,1,0,1,591582,14028,93849,14107,0.12994182815221017,0.5014039452639062
34229,0.8375714285714285,0,1,0,591583,14027,93849,14107,0.1299325651191226,0.5014217672567001
34230,0.8376190476190476,0,1,0,591584,14026,93849,14107,0.12992330208603506,0.5014395905164754
34231,0.837638888888889,0,1,0,591585,14025,93849,14107,0.1299140390529475,0.5014574150433669
34232,0.837642857142857,0,2,0,591587,14023,93849,14107,0.12989551298677238,0.5014930678990401
34233,0.8376666666666667,0,2,0,591589,14021,93849,14107,0.1298769869205973,0.5015287258248009
34234,0.8376666666666668,0,1,0,591590,14020,93849,14107,0.12986772388750972,0.5015465566893021
34235,0.8377142857142857,0,1,0,591591,14019,93849,14107,0.12985846085442218,0.5015643888217308
34236,0.8377857142857142,1,0,1,591591,14019,93850,14106,0.12985846085442218,0.5015466666666667
34237,0.8377857142857144,1,0,1,591591,14019,93851,14105,0.12985846085442218,0.5015289432513156
34238,0.8378035714285711,1,1,1,591592,14018,93852,14104,0.1298491978213346,0.5015290519877675
34239,0.8378333333333332,0,1,0,591593,14017,93852,14104,0.12983993478824707,0.5015468866683261
34240,0.8378333333333333,1,2,1,591595,14015,93853,14103,0.12982140872207196,0.5015648339142187
34241,0.8378571428571427,0,1,0,591596,14014,93853,14103,0.1298121456889844,0.5015826724045951
34242,0.837857142857143,1,0,1,591596,14014,93854,14102,0.1298121456889844,0.5015649452269171
34243,0.8378611111111112,0,1,0,591597,14013,93854,14102,0.12980288265589685,0.5015827849902188
34244,0.8379761904761905,0,1,0,591598,14012,93854,14102,0.1297936196228093,0.5016006260226222
34245,0.838,4,25,4,591623,13987,93858,14098,0.12956204379562045,0.5019761438490298
34246,0.8380000000000001,0,3,0,591626,13984,93858,14098,0.12953425469635776,0.5020297699594046
34247,0.8381212121212119,1,0,1,591626,13984,93859,14097,0.12953425469635776,0.5020120366083829
34248,0.8381428571428572,0,1,0,591627,13983,93859,14097,0.12952499166327022,0.5020299145299145
34249,0.8381666666666666,1,0,1,591627,13983,93860,14096,0.12952499166327022,0.5020121799209374
34250,0.8382142857142857,0,2,0,591629,13981,93860,14096,0.1295064655970951,0.5020479395946861
34251,0.8382222222222222,0,1,0,591630,13980,93860,14096,0.12949720256400757,0.5020658213420716
34252,0.8382619047619048,0,2,0,591632,13978,93860,14096,0.12947867649783246,0.5021015886585453
34253,0.8383333333333333,21,15,21,591647,13963,93881,14075,0.12933973100151913,0.5019972893929667
34254,0.8383333333333334,11,34,11,591681,13929,93892,14064,0.12902478787654229,0.502411317114993
34255,0.8383635408708935,1,6,1,591687,13923,93893,14063,0.12896920967801698,0.5025012506253127
34256,0.838404761904762,0,2,0,591689,13921,93893,14063,0.12895068361184187,0.5025371640937679
34257,0.8384393939393939,1,1,1,591690,13920,93894,14062,0.1289414205787543,0.502537345436352
34258,0.8384761904761904,1,1,1,591691,13919,93895,14061,0.12893215754566675,0.5025375268048606
34259,0.8384999999999999,1,8,1,591699,13911,93896,14060,0.1288580532809663,0.5026634728826285
34260,0.8385000000000001,2,3,2,591702,13908,93898,14058,0.12883026418170365,0.5026818279339198
34261,0.8385714285714286,2,1,2,591703,13907,93900,14056,0.1288210011486161,0.5026642348818081
34262,0.8386666666666666,1,2,1,591705,13905,93901,14055,0.128802475082441,0.5026824034334764
34263,0.8386666666666668,3,3,3,591708,13902,93904,14052,0.12877468598317834,0.5026829791800815
34264,0.8387142857142856,1,0,1,591708,13902,93905,14051,0.12877468598317834,0.502665187994133
34265,0.83875,2,0,2,591708,13902,93907,14049,0.12877468598317834,0.5026296018031555
34266,0.8388333333333331,0,1,0,591709,13901,93907,14049,0.12876542295009077,0.5026475849731664
34267,0.8388333333333332,3,3,3,591712,13898,93910,14046,0.12873763385082812,0.5026481534497567
34268,0.8388333333333334,0,1,0,591713,13897,93910,14046,0.12872837081774055,0.5026661417886411
34269,0.8388809523809523,0,2,0,591715,13895,93910,14046,0.12870984475156547,0.5027021223291936
34270,0.8388888888888889,0,1,0,591716,13894,93910,14046,0.1287005817184779,0.5027201145311382
34271,0.8389841269841268,0,1,0,591717,13893,93910,14046,0.12869131868539035,0.5027381080210459
34272,0.8389999999999997,1,0,1,591717,13893,93911,14045,0.12869131868539035,0.5027203092562101
34273,0.839,0,3,0,591720,13890,93911,14045,0.12866352958612767,0.5027742974762842
34274,0.8390000000000001,2,10,2,591730,13880,93913,14043,0.12857089925525214,0.5029187408229775
34275,0.8390476190476192,0,1,0,591731,13879,93913,14043,0.1285616362221646,0.5029367523816346
34276,0.8391666666666666,5,7,5,591738,13872,93918,14038,0.1284967949905517,0.5029738445001791
34277,0.8391666666666667,5,7,5,591745,13865,93923,14033,0.12843195375893882,0.5030109685282099
34278,0.8391746031746032,0,1,0,591746,13864,93923,14033,0.12842269072585127,0.503028999534
34279,0.8391969696969699,0,1,0,591747,13863,93923,14033,0.12841342769276373,0.5030470318325208
34280,0.8392142857142857,1,0,1,591747,13863,93924,14032,0.12841342769276373,0.5030292167055028
34281,0.8392499999999999,1,0,1,591747,13863,93925,14031,0.12841342769276373,0.50301140030114
34282,0.8392857142857143,0,1,0,591748,13862,93925,14031,0.12840416465967616,0.503029433908149
34283,0.839309523809524,0,2,0,591750,13860,93925,14031,0.12838563859350105,0.5030655050016134
34284,0.8393333333333333,3,2,3,591752,13858,93928,14028,0.12836711252732594,0.503048124506921
34285,0.8393333333333334,2,4,2,591756,13854,93930,14026,0.12833006039497574,0.5030846484935437
34286,0.8394523809523811,0,1,0,591757,13853,93930,14026,0.12832079736188817,0.5031026937838516
34287,0.8394999999999999,1,0,1,591757,13853,93931,14025,0.12832079736188817,0.5030848697897984
34288,0.8395,1,2,1,591759,13851,93932,14024,0.12830227129571306,0.5031031390134529
34289,0.8395151515151514,1,0,1,591759,13851,93933,14023,0.12830227129571306,0.5030853124775777
34290,0.8395238095238095,0,1,0,591760,13850,93933,14023,0.12829300826262552,0.5031033616761741
34291,0.8395317460317461,1,0,1,591760,13850,93934,14022,0.12829300826262552,0.5030855338691159
34292,0.8395396825396824,0,3,0,591763,13847,93934,14022,0.12826521916336286,0.5031396892604686
34293,0.8395833333333332,0,1,0,591764,13846,93934,14022,0.1282559561302753,0.5031577436486293
34294,0.8395833333333335,1,0,1,591764,13846,93935,14021,0.1282559561302753,0.5031399145943231
34295,0.8396666666666666,1,0,1,591764,13846,93936,14020,0.1282559561302753,0.503122084260389
34296,0.8396666666666667,1,4,1,591768,13842,93937,14019,0.12821890399792507,0.5031764832561645
34297,0.8397135642135641,2,0,2,591768,13842,93939,14017,0.12821890399792507,0.5031408162532754
34298,0.8397222222222225,1,0,1,591768,13842,93940,14016,0.12821890399792507,0.5031229808313591
34299,0.8397619047619047,0,1,0,591769,13841,93940,14016,0.12820964096483753,0.503141041748932
34300,0.8397738095238095,0,1,0,591770,13840,93940,14016,0.12820037793174996,0.5031591039632395
34301,0.8398095238095239,1,0,1,591770,13840,93941,14015,0.12820037793174996,0.5031412672769701
34302,0.8398333333333332,2,1,2,591771,13839,93943,14013,0.12819111489866242,0.5031236535975873
34303,0.8398333333333333,5,1,5,591772,13838,93948,14008,0.12818185186557488,0.503052503052503
34304,0.8399999999999999,2,2,2,591774,13836,93950,14006,0.12816332579939976,0.503052941599023
34305,0.84,738,832,738,592606,13004,94688,13268,0.12045648227055467,0.5050243605359318
34306,0.8400000000000002,4,1,4,592607,13003,94692,13264,0.12044721923746711,0.5049682110633114
34307,0.840047619047619,0,1,0,592608,13002,94692,13264,0.12043795620437957,0.5049874362293459
34308,0.8400555555555553,1,0,1,592608,13002,94693,13263,0.12043795620437957,0.5049685893774986
34309,0.8400808080808082,1,1,1,592609,13001,94694,13262,0.12042869317129201,0.5049689677493051
34310,0.8401190476190474,0,1,0,592610,13000,94694,13262,0.12041943013820446,0.5049881958723631
34311,0.8401428571428571,0,1,0,592611,12999,94694,13262,0.1204101671051169,0.5050074254598074
34312,0.8401623376623377,1,0,1,592611,12999,94695,13261,0.1204101671051169,0.504988575780655
34313,0.8401648629148627,0,1,0,592612,12998,94695,13261,0.12040090407202934,0.5050078068471762
34314,0.8401666666666666,0,6,0,592618,12992,94695,13261,0.12034532587350402,0.5051232240124938
34315,0.8401666666666668,1,0,1,592618,12992,94696,13260,0.12034532587350402,0.5051043730001523
34316,0.8402142857142857,0,1,0,592619,12991,94696,13260,0.12033606284041647,0.5051236143385014
34317,0.840297619047619,0,1,0,592620,12990,94696,13260,0.12032679980732891,0.5051428571428571
34318,0.8403095238095238,1,0,1,592620,12990,94697,13259,0.12032679980732891,0.5051240047239894
34319,0.8403333333333333,0,1,0,592621,12989,94697,13259,0.12031753677424135,0.5051432490094483
34320,0.8403333333333335,0,1,0,592622,12988,94697,13259,0.1203082737411538,0.505162494761306
34321,0.8404102564102566,0,1,0,592623,12987,94697,13259,0.12029901070806624,0.5051817419797302
34322,0.8404166666666666,0,1,0,592624,12986,94697,13259,0.1202897476749787,0.5052009906648885
34323,0.8404166666666667,0,1,0,592625,12985,94697,13259,0.12028048464189114,0.5052202408169486
34324,0.8405,1,9,1,592634,12976,94698,13258,0.12019711734410315,0.5053747045818403
34325,0.8406428571428571,0,1,0,592635,12975,94698,13258,0.1201878543110156,0.5053939694278199
34326,0.8406666666666665,0,1,0,592636,12974,94698,13258,0.12017859127792804,0.5054132357426044
34327,0.8406666666666667,2,2,2,592638,12972,94700,13256,0.12016006521175293,0.5054140613085253
34328,0.8406666666666668,1,0,1,592638,12972,94701,13255,0.12016006521175293,0.5053952034163267
34329,0.8407023809523809,0,2,0,592640,12970,94701,13255,0.12014153914557783,0.5054337464251668
34330,0.8407142857142857,2,4,2,592644,12966,94703,13253,0.12010448701322761,0.5054731301727755
34331,0.8407380952380952,0,2,0,592646,12964,94703,13253,0.1200859609470525,0.5055116908875921
34332,0.8408095238095238,1,1,1,592647,12963,94704,13252,0.12007669791396496,0.5055121113866107
34333,0.8408333333333333,5,9,5,592656,12954,94709,13247,0.11999333061617697,0.5055913896416168
34334,0.8408333333333334,6,6,6,592662,12948,94715,13241,0.11993775241765163,0.5055939516590935
34335,0.8408928571428569,0,1,0,592663,12947,94715,13241,0.11992848938456409,0.5056132579807545
34336,0.8408928571428571,0,1,0,592664,12946,94715,13241,0.11991922635147653,0.5056325657769122
34337,0.8409047619047618,1,0,1,592664,12946,94716,13240,0.11991922635147653,0.5056136867028183
34338,0.840952380952381,3,1,3,592665,12945,94719,13237,0.11990996331838898,0.505576350164235
34339,0.841,8,8,8,592673,12937,94727,13229,0.11983585905368854,0.5055797599938852
34340,0.8410119047619048,1,2,1,592675,12935,94728,13228,0.11981733298751343,0.5055995107594695
34341,0.8410238095238097,0,1,0,592676,12934,94728,13228,0.11980806995442587,0.5056188364803914
34342,0.8410277777777779,1,0,1,592676,12934,94729,13227,0.11980806995442587,0.5055999388402584
34343,0.8411111111111111,0,1,0,592677,12933,94729,13227,0.11979880692133832,0.5056192660550459
34344,0.8411428571428573,0,1,0,592678,12932,94729,13227,0.11978954388825076,0.5056385947475056
34345,0.8411666666666666,1,2,1,592680,12930,94730,13226,0.11977101782207566,0.5056583575470256
34346,0.8412222222222222,0,1,0,592681,12929,94730,13226,0.11976175478898811,0.5056776906901166
34347,0.8412380952380951,0,1,0,592682,12928,94730,13226,0.11975249175590055,0.5056970253116159
34348,0.8413333333333332,1,0,1,592682,12928,94731,13225,0.11975249175590055,0.5056781248805109
34349,0.8413333333333333,2,5,2,592687,12923,94733,13223,0.11970617659046279,0.5057370152222137
34350,0.8413333333333334,1,2,1,592689,12921,94734,13222,0.11968765052428768,0.5057567991431741
34351,0.8413571428571427,0,2,0,592691,12919,94734,13222,0.11966912445811256,0.5057954936689492
34352,0.8413888888888889,0,1,0,592692,12918,94734,13222,0.11965986142502501,0.5058148431522571
34353,0.8414285714285714,1,2,1,592694,12916,94735,13221,0.1196413353588499,0.5058346405478823
34354,0.8414285714285715,1,0,1,592694,12916,94736,13220,0.1196413353588499,0.5058157330884604
34355,0.8414761904761903,0,2,0,592696,12914,94736,13220,0.1196228092926748,0.505854442488712
34356,0.8415,4,3,4,592699,12911,94740,13216,0.11959502019341213,0.5058368737321545
34357,0.8416666666666666,21,24,21,592723,12887,94761,13195,0.11937270739931083,0.5059044551798175
34358,0.8416666666666667,12,24,12,592747,12863,94773,13183,0.11915039460520953,0.5061429778084927
34359,0.8417142857142857,1,1,1,592748,12862,94774,13182,0.11914113157212197,0.5061434495469206
34360,0.8417380952380954,0,1,0,592749,12861,94774,13182,0.11913186853903442,0.5061628844603157
34361,0.8418095238095237,0,1,0,592750,12860,94774,13182,0.11912260550594687,0.5061823208662929
34362,0.8418333333333332,2,0,2,592750,12860,94776,13180,0.11912260550594687,0.5061443932411674
34363,0.8418333333333333,0,1,0,592751,12859,94776,13180,0.11911334247285932,0.5061638311763125
34364,0.8418333333333335,0,1,0,592752,12858,94776,13180,0.11910407943977176,0.5061832706045011
34365,0.841892857142857,0,1,0,592753,12857,94776,13180,0.1190948164066842,0.5062027115259055
34366,0.841904761904762,0,1,0,592754,12856,94776,13180,0.11908555337359665,0.5062221539406975
34367,0.8419285714285715,0,1,0,592755,12855,94776,13180,0.1190762903405091,0.5062415978490493
34368,0.8419444444444444,0,1,0,592756,12854,94776,13180,0.11906702730742154,0.5062610432511331
34369,0.8419523809523811,1,0,1,592756,12854,94777,13179,0.11906702730742154,0.5062420773633465
34370,0.8419642857142858,0,1,0,592757,12853,94777,13179,0.11905776427433398,0.5062615242778119
34371,0.8419999999999999,1,3,1,592760,12850,94778,13178,0.11902997517507133,0.5063009067158445
34372,0.8420000000000001,9,11,9,592771,12839,94787,13169,0.11892808181110823,0.5063442017840665
34373,0.8420119047619048,0,1,0,592772,12838,94787,13169,0.11891881877802067,0.5063636713192602
34374,0.8420436507936507,0,1,0,592773,12837,94787,13169,0.11890955574493312,0.506383142351765
34375,0.8420555555555557,1,0,1,592773,12837,94788,13168,0.11890955574493312,0.5063641607383196
34376,0.8420714285714284,0,1,0,592774,12836,94788,13168,0.11890029271184557,0.5063836332871866
34377,0.8420714285714286,1,1,1,592775,12835,94789,13167,0.11889102967875802,0.506384124298131
34378,0.8420833333333333,1,1,1,592776,12834,94790,13166,0.11888176664567046,0.5063846153846154
34379,0.8421314192343603,0,1,0,592777,12833,94790,13166,0.1188725036125829,0.5064040924650948
34380,0.8421428571428571,0,1,0,592778,12832,94790,13166,0.11886324057949535,0.5064235710439264
34381,0.8421666666666667,4,2,4,592780,12830,94794,13162,0.11884471451332024,0.5063865804863035
34382,0.8422619047619048,0,1,0,592781,12829,94794,13162,0.11883545148023268,0.5064060636374129
34383,0.8423333333333332,0,2,0,592783,12827,94794,13162,0.11881692541405758,0.5064450344376467
34384,0.8423333333333334,2,4,2,592787,12823,94796,13160,0.11877987328170736,0.5064850094292422
34385,0.8424166666666667,0,1,0,592788,12822,94796,13160,0.1187706102486198,0.5065045031175429
34386,0.8424444444444447,0,1,0,592789,12821,94796,13160,0.11876134721553225,0.5065239983064547
34387,0.8424603174603176,0,1,0,592790,12820,94796,13160,0.1187520841824447,0.5065434949961509
34388,0.8424999999999998,0,1,0,592791,12819,94796,13160,0.11874282114935715,0.5065629931868048
34389,0.8425,35,43,35,592834,12776,94831,13125,0.11834451072659231,0.5067371916142234
34390,0.8425000000000001,1,0,1,592834,12776,94832,13124,0.11834451072659231,0.5067181467181467
34391,0.8425238095238095,0,1,0,592835,12775,94832,13124,0.11833524769350476,0.5067377118807675
34392,0.8425476190476189,0,1,0,592836,12774,94832,13124,0.1183259846604172,0.5067572785543285
34393,0.8425833333333332,0,1,0,592837,12773,94832,13124,0.11831672162732965,0.5067768467390045
34394,0.8426190476190476,0,1,0,592838,12772,94832,13124,0.1183074585942421,0.5067964164349706
34395,0.8426309523809523,0,1,0,592839,12771,94832,13124,0.11829819556115455,0.506815987642402
34396,0.8426666666666667,4,5,4,592844,12766,94836,13120,0.11825188039571677,0.5068376728733679
34397,0.8426666666666668,0,1,0,592845,12765,94836,13120,0.11824261736262921,0.5068572532354646
34398,0.8427500000000001,0,1,0,592846,12764,94836,13120,0.11823335432954167,0.506876835110493
34399,0.8427803030303029,0,1,0,592847,12763,94836,13120,0.11822409129645411,0.5068964184986284
34400,0.8428571428571427,1,3,1,592850,12760,94837,13119,0.11819630219719145,0.5069361258162989
34401,0.842857142857143,0,1,0,592851,12759,94837,13119,0.11818703916410389,0.5069557152793879
34402,0.8428809523809524,1,0,1,592851,12759,94838,13118,0.11818703916410389,0.5069366619005294
34403,0.8429047619047619,0,1,0,592852,12758,94838,13118,0.11817777613101633,0.5069562528984387
34404,0.8429166666666665,0,1,0,592853,12757,94838,13118,0.11816851309792878,0.506975845410628
34405,0.8429166666666668,0,1,0,592854,12756,94838,13118,0.11815925006484124,0.506995439437273
34406,0.843,5,8,5,592862,12748,94843,13113,0.1180851458001408,0.5070569583542787
34407,0.8430000000000001,2,1,2,592863,12747,94845,13111,0.11807588276705325,0.5070384407146724
34408,0.8430000000000003,1,0,1,592863,12747,94846,13110,0.11807588276705325,0.5070193757976563
34409,0.8430158730158728,0,1,0,592864,12746,94846,13110,0.11806661973396569,0.5070389851485149
34410,0.843047619047619,0,1,0,592865,12745,94846,13110,0.11805735670087814,0.5070585960162445
34411,0.8430952380952382,0,1,0,592866,12744,94846,13110,0.11804809366779058,0.5070782084010211
34412,0.8431666666666665,0,2,0,592868,12742,94846,13110,0.11802956760161547,0.5071174377224199
34413,0.8431666666666667,0,7,0,592875,12735,94846,13110,0.11796472637000259,0.5072547881601858
34414,0.8432142857142857,1,0,1,592875,12735,94847,13109,0.11796472637000259,0.5072357220244544
34415,0.8433095238095238,0,2,0,592877,12733,94847,13109,0.11794620030382749,0.5072749787168176
34416,0.8433253968253968,0,1,0,592878,12732,94847,13109,0.11793693727073994,0.5072946093417438
34417,0.8433333333333332,0,1,0,592879,12731,94847,13109,0.11792767423765238,0.5073142414860681
34418,0.8433333333333333,42,36,42,592915,12695,94889,13067,0.11759420504650042,0.5072199363403462
34419,0.8433333333333334,41,39,41,592954,12656,94930,13026,0.11723294675608581,0.5072034888248579
34420,0.8433333333333336,0,1,0,592955,12655,94930,13026,0.11722368372299825,0.5072232389704451
34421,0.8433809523809523,0,1,0,592956,12654,94930,13026,0.1172144206899107,0.5072429906542056
34422,0.8434761904761904,0,2,0,592958,12652,94930,13026,0.1171958946237356,0.5072824986369655
34423,0.8434999999999999,3,9,3,592967,12643,94933,13023,0.11711252732594761,0.5074027896828489
34424,0.8436190476190477,0,3,0,592970,12640,94933,13023,0.11708473822668494,0.5074621049760355
34425,0.8436666666666665,0,2,0,592972,12638,94933,13023,0.11706621216050983,0.5075016562098126
34426,0.8436666666666666,0,2,0,592974,12636,94933,13023,0.11704768609433473,0.5075412136092599
34427,0.8436666666666668,1,5,1,592979,12631,94934,13022,0.11700137092889695,0.5076209410205434
34428,0.8436904761904762,0,1,0,592980,12630,94934,13022,0.11699210789580941,0.5076407297676594
34429,0.84375,3,5,3,592985,12625,94937,13019,0.11694579273037163,0.5076821088753705
34430,0.8438095238095238,0,2,0,592987,12623,94937,13019,0.11692726666419652,0.5077217065751501
34431,0.8438253968253967,0,1,0,592988,12622,94937,13019,0.11691800363110898,0.5077415077415077
34432,0.8438333333333332,2,6,2,592994,12616,94939,13017,0.11686242543258364,0.5078219482698084
34433,0.8438333333333334,0,2,0,592996,12614,94939,13017,0.11684389936640854,0.5078615738753853
34434,0.8438928571428569,0,1,0,592997,12613,94939,13017,0.11683463633332099,0.5078813889972689
34435,0.8439047619047618,0,2,0,592999,12611,94939,13017,0.11681611026714588,0.5079210238801312
34436,0.8439126984126982,0,1,0,593000,12610,94939,13017,0.11680684723405832,0.5079408436414719
34437,0.8439880952380951,0,1,0,593001,12609,94939,13017,0.11679758420097076,0.5079606649496605
34438,0.8439999999999999,1,0,1,593001,12609,94940,13016,0.11679758420097076,0.5079414634146342
34439,0.8440000000000001,13,24,13,593025,12585,94953,13003,0.11657527140686946,0.5081678911989995
34440,0.8440000000000002,0,1,0,593026,12584,94953,13003,0.1165660083737819,0.5081877515926057
34441,0.8440476190476189,2,1,2,593027,12583,94955,13001,0.11655674534069435,0.5081691682301438
34442,0.844095238095238,0,2,0,593029,12581,94955,13001,0.11653821927451925,0.5082088968806192
34443,0.8441666666666666,9,10,9,593039,12571,94964,12992,0.11644558894364371,0.5082345577592614
34444,0.8441666666666667,7,7,7,593046,12564,94971,12985,0.11638074771203083,0.5082390700223101
34445,0.8442777777777777,0,1,0,593047,12563,94971,12985,0.11637148467894327,0.5082589635196493
34446,0.8442857142857143,2,1,2,593048,12562,94973,12983,0.11636222164585572,0.5082403601487571
34447,0.8443333333333333,3,1,3,593049,12561,94976,12980,0.11635295861276816,0.5082024979444815
34448,0.8443333333333334,0,2,0,593051,12559,94976,12980,0.11633443254659305,0.5082422960961667
34449,0.8443333333333335,0,1,0,593052,12558,94976,12980,0.11632516951350551,0.5082621975095936
34450,0.8444166666666665,0,1,0,593053,12557,94976,12980,0.11631590648041795,0.5082821004816541
34451,0.8444166666666666,0,1,0,593054,12556,94976,12980,0.1163066434473304,0.5083020050125313
34452,0.8444999999999999,1,0,1,593054,12556,94977,12979,0.1163066434473304,0.5082827491678089
34453,0.8445,1,1,1,593055,12555,94978,12978,0.11629738041424284,0.5082833979555869
34454,0.8445238095238095,1,0,1,593055,12555,94979,12977,0.11629738041424284,0.5082641391195363
34455,0.844547619047619,0,1,0,593056,12554,94979,12977,0.11628811738115528,0.5082840468450119
34456,0.8445833333333335,0,1,0,593057,12553,94979,12977,0.11627885434806773,0.5083039561300431
34457,0.844642857142857,0,2,0,593059,12551,94979,12977,0.11626032828189262,0.5083437793795048
34458,0.8446666666666666,0,1,0,593060,12550,94979,12977,0.11625106524880507,0.5083636933443021
34459,0.8446666666666667,1,4,1,593064,12546,94980,12976,0.11621401311645485,0.5084241046939895
34460,0.8447817460317463,0,1,0,593065,12545,94980,12976,0.1162047500833673,0.5084440264879903
34461,0.8447857142857143,1,0,1,593065,12545,94981,12975,0.1162047500833673,0.5084247648902821
34462,0.844797619047619,0,2,0,593067,12543,94981,12975,0.11618622401719218,0.5084646132142018
34463,0.8448160173160173,0,1,0,593068,12542,94981,12975,0.11617696098410464,0.508484539718619
34464,0.8448333333333333,1,1,1,593069,12541,94982,12974,0.11616769795101708,0.508485204781501
34465,0.8448333333333334,0,1,0,593070,12540,94982,12974,0.11615843491792953,0.5085051344359959
34466,0.8449285714285714,0,1,0,593071,12539,94982,12974,0.11614917188484197,0.5085250656528044
34467,0.8449999999999999,1,7,1,593078,12532,94983,12973,0.1160843306532291,0.5086453636541854
34468,0.845,144,187,144,593265,12345,95127,12829,0.11435214346585645,0.5096130928735998
34469,0.8450000000000002,1,1,1,593266,12344,95128,12828,0.11434288043276891,0.509613856666137
34470,0.8451428571428571,2,0,2,593266,12344,95130,12826,0.11434288043276891,0.5095748907429479
34471,0.8451666666666666,0,2,0,593268,12342,95130,12826,0.1143243543665938,0.5096153846153846
34472,0.8451666666666668,1,1,1,593269,12341,95131,12825,0.11431509133350624,0.5096161487721529
34473,0.8452380952380952,0,2,0,593271,12339,95131,12825,0.11429656526733113,0.509656652360515
34474,0.8452380952380953,0,1,0,593272,12338,95131,12825,0.11428730223424358,0.509676906569169
34475,0.8452619047619047,0,2,0,593274,12336,95131,12825,0.11426877616806848,0.5097174198163825
34476,0.8453333333333333,1,4,1,593278,12332,95132,12824,0.11423172403571825,0.5097789791699793
34477,0.8453333333333335,0,1,0,593279,12331,95132,12824,0.1142224610026307,0.5097992446829656
34478,0.8453571428571428,1,0,1,593279,12331,95133,12823,0.1142224610026307,0.5097797566987358
34479,0.8454166666666666,0,1,0,593280,12330,95133,12823,0.11421319796954314,0.5098000238540135
34480,0.8454393939393939,1,0,1,593280,12330,95134,12822,0.11421319796954314,0.509780534351145
34481,0.8454444444444446,1,1,1,593281,12329,95135,12821,0.11420393493645559,0.5097813121272365
34482,0.8454999999999999,1,1,1,593282,12328,95136,12820,0.11419467190336804,0.5097820900270399
34483,0.8455000000000001,1,0,1,593282,12328,95137,12819,0.11419467190336804,0.5097625959358969
34484,0.8455833333333332,1,0,1,593282,12328,95138,12818,0.11419467190336804,0.5097431002942814
34485,0.8455952380952381,0,1,0,593283,12327,95138,12818,0.11418540887028049,0.5097633724398489
34486,0.8456666666666667,2,2,2,593285,12325,95140,12816,0.11416688280410538,0.5097649258183843
34487,0.8456666666666668,0,1,0,593286,12324,95140,12816,0.11415761977101782,0.5097852028639618
34488,0.8457142857142856,1,2,1,593288,12322,95141,12815,0.11413909370484271,0.5098062616859609
34489,0.8457619047619047,1,0,1,593288,12322,95142,12814,0.11413909370484271,0.5097867600254615
34490,0.845797619047619,0,1,0,593289,12321,95142,12814,0.11412983067175515,0.5098070419733439
34491,0.8458333333333333,9,4,9,593293,12317,95151,12805,0.11409277853940494,0.509712602499801
34492,0.8458333333333334,6,7,6,593300,12310,95157,12799,0.11402793730779207,0.5097375443068223
34493,0.8458333333333335,1,1,1,593301,12309,95158,12798,0.11401867427470451,0.509738319990441
34494,0.846,22,16,22,593317,12293,95180,12776,0.11387046574530364,0.5096334117834777
34495,0.8460000000000001,2,1,2,593318,12292,95182,12774,0.11386120271221609,0.5096146174100376
34496,0.8461111111111111,0,1,0,593319,12291,95182,12774,0.11385193967912853,0.5096349491322562
34497,0.8461666666666666,0,1,0,593320,12290,95182,12774,0.11384267664604097,0.5096552824768592
34498,0.84625,0,2,0,593322,12288,95182,12774,0.11382415057986588,0.5096959540339957
34499,0.8462857142857143,0,1,0,593323,12287,95182,12774,0.11381488754677832,0.5097162922469175
34500,0.8463333333333333,3,0,3,593323,12287,95185,12771,0.11381488754677832,0.509657594381036
34501,0.8463333333333334,1,2,1,593325,12285,95186,12770,0.11379636148060321,0.5096787068449411
34502,0.8463809523809523,2,0,2,593325,12285,95188,12768,0.11379636148060321,0.509639564124057
34503,0.8463809523809525,0,1,0,593326,12284,95188,12768,0.11378709844751565,0.5096599073926233
34504,0.8464166666666668,0,2,0,593328,12282,95188,12768,0.11376857238134054,0.5097005988023952
34505,0.846436507936508,0,1,0,593329,12281,95188,12768,0.113759309348253,0.5097209469439897
34506,0.8464999999999999,0,1,0,593330,12280,95188,12768,0.11375004631516544,0.5097412967103162
34507,0.8465,4,1,4,593331,12279,95192,12764,0.11374078328207789,0.5096833446472068
34508,0.8465317460317461,0,1,0,593332,12278,95192,12764,0.11373152024899033,0.5097036977877166
34509,0.846547619047619,0,1,0,593333,12277,95192,12764,0.11372225721590278,0.5097240525538117
34510,0.8465595238095237,0,1,0,593334,12276,95192,12764,0.11371299418281522,0.509744408945687
34511,0.8465714285714284,0,1,0,593335,12275,95192,12764,0.11370373114972766,0.5097647669635369
34512,0.8466071428571428,0,1,0,593336,12274,95192,12764,0.11369446811664011,0.5097851266075565
34513,0.8466190476190475,0,1,0,593337,12273,95192,12764,0.11368520508355257,0.5098054878779407
34514,0.8466428571428571,1,2,1,593339,12271,95193,12763,0.11366667901737745,0.5098266357753455
34515,0.8466428571428573,0,1,0,593340,12270,95193,12763,0.1136574159842899,0.5098470019574162
34516,0.8466666666666666,40,46,40,593386,12224,95233,12723,0.11323131646226241,0.5100012025494047
34517,0.8466666666666667,41,37,41,593423,12187,95274,12682,0.1128885842380229,0.5099521492621336
34518,0.8466666666666669,2,0,2,593423,12187,95276,12680,0.1128885842380229,0.5099127357542124
34519,0.8467142857142858,0,1,0,593424,12186,95276,12680,0.11287932120493534,0.5099332421780745
34520,0.8467619047619047,1,0,1,593424,12186,95277,12679,0.11287932120493534,0.5099135330786245
34521,0.8467857142857143,0,5,0,593429,12181,95277,12679,0.11283300603949757,0.5100160901045857
34522,0.8468333333333333,1,0,1,593429,12181,95278,12678,0.11283300603949757,0.5099963795808359
34523,0.8469999999999999,0,3,0,593432,12178,95278,12678,0.1128052169402349,0.510057933698101
34524,0.847,3,5,3,593437,12173,95281,12675,0.11275890177479714,0.5101014166130071
34525,0.8470000000000002,1,1,1,593438,12172,95282,12674,0.11274963874170958,0.5101022297351686
34526,0.8470238095238096,0,1,0,593439,12171,95282,12674,0.11274037570862203,0.5101227611189374
34527,0.8471428571428571,0,1,0,593440,12170,95282,12674,0.11273111267553448,0.5101432941555305
34528,0.8471428571428572,2,1,2,593441,12169,95284,12672,0.11272184964244693,0.5101243911275714
34529,0.8471507936507936,1,1,1,593442,12168,95285,12671,0.11271258660935937,0.5101252063287572
34530,0.8471666666666665,2,0,2,593442,12168,95287,12669,0.11271258660935937,0.5100857591496557
34531,0.8471666666666667,0,1,0,593443,12167,95287,12669,0.11270332357627182,0.510106297310356
34532,0.8473333333333332,0,3,0,593446,12164,95287,12669,0.11267553447700915,0.51016792171707
34533,0.8473333333333334,1,1,1,593447,12163,95288,12668,0.11266627144392159,0.5101687406870444
34534,0.8473333333333335,0,2,0,593449,12161,95288,12668,0.1126477453777465,0.5102098352732691
34535,0.8473809523809525,0,1,0,593450,12160,95288,12668,0.11263848234465894,0.5102303850491381
34536,0.847392857142857,0,1,0,593451,12159,95288,12668,0.11262921931157138,0.5102509364804447
34537,0.8474285714285713,0,1,0,593452,12158,95288,12668,0.11261995627848383,0.510271489567389
34538,0.8474523809523808,1,1,1,593453,12157,95289,12667,0.11261069324539627,0.5102723171124718
34539,0.8474523809523811,1,0,1,593453,12157,95290,12666,0.11261069324539627,0.5102525883253435
34540,0.8474999999999998,1,1,1,593454,12156,95291,12665,0.11260143021230871,0.5102534144474437
34541,0.8475,39,51,39,593505,12105,95330,12626,0.11212901552484346,0.5105333387246775
34542,0.8475000000000001,0,3,0,593508,12102,95330,12626,0.11210122642558079,0.5105952766095115
34543,0.8476190476190476,1,0,1,593508,12102,95331,12625,0.11210122642558079,0.5105754842884297
34544,0.8476470588235294,0,2,0,593510,12100,95331,12625,0.11208270035940568,0.5106167846309403
34545,0.8476666666666667,2,1,2,593511,12099,95333,12623,0.11207343732631812,0.5105978480705444
34546,0.8476666666666668,1,1,1,593512,12098,95334,12622,0.11206417429323058,0.5105987055016181
34547,0.8477142857142855,1,0,1,593512,12098,95335,12621,0.11206417429323058,0.5105789069137101
34548,0.8477142857142859,0,1,0,593513,12097,95335,12621,0.11205491126014303,0.5105995630714459
34549,0.8477857142857141,0,1,0,593514,12096,95335,12621,0.11204564822705547,0.5106202209005948
34550,0.847797619047619,0,1,0,593515,12095,95335,12621,0.11203638519396791,0.5106408804013595
34551,0.8477976190476191,1,1,1,593516,12094,95336,12620,0.11202712216088036,0.5106417415230234
34552,0.8478333333333332,0,1,0,593517,12093,95336,12620,0.1120178591277928,0.5106624044025412
34553,0.8479999999999999,0,1,0,593518,12092,95336,12620,0.11200859609470525,0.5106830689543541
34554,0.848,11,14,11,593532,12078,95347,12609,0.11187891363147949,0.5107546481954065
34555,0.8480000000000001,1,1,1,593533,12077,95348,12608,0.11186965059839193,0.5107555195462832
34556,0.8480238095238094,1,0,1,593533,12077,95349,12607,0.11186965059839193,0.510735699238373
34557,0.8480476190476189,0,1,0,593534,12076,95349,12607,0.11186038756530438,0.5107563910383665
34558,0.8481190476190479,0,2,0,593536,12074,95349,12607,0.11184186149912928,0.510797779668571
34559,0.8481666666666666,0,2,0,593538,12072,95349,12607,0.11182333543295417,0.5108391750070911
34560,0.8481666666666667,1,0,1,593538,12072,95350,12606,0.11182333543295417,0.5108193532701192
34561,0.8481785714285713,0,1,0,593539,12071,95350,12606,0.11181407239986661,0.5108400534911051
34562,0.8481857864357863,0,2,0,593541,12069,95350,12606,0.1117955463336915,0.5108814589665653
34563,0.8482142857142857,0,1,0,593542,12068,95350,12606,0.11178628330060394,0.5109021642214476
34564,0.8482619047619048,1,0,1,593542,12068,95351,12605,0.11178628330060394,0.5108823410205487
34565,0.8483333333333333,12,29,12,593571,12039,95363,12593,0.11151765534106488,0.5112455342643716
34566,0.8483333333333334,13,24,13,593595,12015,95376,12580,0.11129534254696358,0.511486074405367
34567,0.8483333333333336,1,0,1,593595,12015,95377,12579,0.11129534254696358,0.5114662112710417
34568,0.8484166666666666,0,1,0,593596,12014,95377,12579,0.11128607951387602,0.5114870084983532
34569,0.8484999999999999,3,0,3,593596,12014,95380,12576,0.11128607951387602,0.5114274095160635
34570,0.8485,2,0,2,593596,12014,95382,12574,0.11128607951387602,0.5113876687815194
34571,0.8485714285714284,0,1,0,593597,12013,95382,12574,0.11127681648078847,0.5114084678895351
34572,0.8485833333333334,0,1,0,593598,12012,95382,12574,0.11126755344770091,0.5114292686894981
34573,0.8485873015873017,1,1,1,593599,12011,95383,12573,0.11125829041461337,0.5114301985030915
34574,0.8486428571428571,0,1,0,593600,12010,95383,12573,0.11124902738152581,0.5114510027254607
34575,0.8486666666666666,1,0,1,593600,12010,95384,12572,0.11124902738152581,0.5114311284679847
34576,0.8486666666666668,2,1,2,593601,12009,95386,12570,0.11123976434843826,0.5114121811302331
34577,0.8486944444444443,0,1,0,593602,12008,95386,12570,0.1112305013153507,0.5114329888518186
34578,0.848714285714286,0,1,0,593603,12007,95386,12570,0.11122123828226314,0.5114537982666721
34579,0.8487380952380953,0,1,0,593604,12006,95386,12570,0.11121197524917559,0.511474609375
34580,0.8487420634920633,0,1,0,593605,12005,95386,12570,0.11120271221608803,0.5114954221770092
34581,0.8487499999999999,0,1,0,593606,12004,95386,12570,0.11119344918300048,0.5115162366729064
34582,0.84875,0,2,0,593608,12002,95386,12570,0.11117492311682538,0.511557870747192
34583,0.8488333333333334,0,3,0,593611,11999,95386,12570,0.11114713401756271,0.5116203345679515
34584,0.8488809523809525,0,1,0,593612,11998,95386,12570,0.11113787098447515,0.5116411592315206
34585,0.8488888888888888,0,1,0,593613,11997,95386,12570,0.1111286079513876,0.5116619855904262
34586,0.8489999999999999,2,3,2,593616,11994,95388,12568,0.11110081885212494,0.5116847162283201
34587,0.8490000000000001,6,5,6,593621,11989,95394,12562,0.11105450368668716,0.5116695857602541
34588,0.8490238095238095,1,1,1,593622,11988,95395,12561,0.11104524065359961,0.5116705364780643
34589,0.8490476190476189,1,1,1,593623,11987,95396,12560,0.11103597762051207,0.5116714873507965
34590,0.8490833333333333,0,1,0,593624,11986,95396,12560,0.11102671458742451,0.5116923327629757
34591,0.8491190476190473,0,2,0,593626,11984,95396,12560,0.1110081885212494,0.5117340286831812
34592,0.8491666666666666,4,4,4,593630,11980,95400,12556,0.11097113638889917,0.5117378545810238
34593,0.8491666666666667,6,7,6,593637,11973,95406,12550,0.1109062951572863,0.5117644660114994
34594,0.8492261904761904,0,1,0,593638,11972,95406,12550,0.11089703212419874,0.511785335616997
34595,0.8492857142857143,2,1,2,593639,11971,95408,12548,0.1108877690911112,0.5117663852522534
34596,0.8492936507936508,0,1,0,593640,11970,95408,12548,0.11087850605802364,0.5117872583408108
34597,0.8493333333333333,0,1,0,593641,11969,95408,12548,0.11086924302493609,0.5118081331321124
34598,0.8493333333333334,2,3,2,593644,11966,95410,12546,0.11084145392567342,0.5118309399477807
34599,0.8495,4,2,4,593646,11964,95414,12542,0.11082292785949831,0.5117930302782991
34600,0.849642857142857,1,0,1,593646,11964,95415,12541,0.11082292785949831,0.5117731075290757
34601,0.8496666666666663,0,1,0,593647,11963,95415,12541,0.11081366482641077,0.5117939928174992
34602,0.8496666666666667,0,2,0,593649,11961,95415,12541,0.11079513876023565,0.5118357685086932
34603,0.8496944444444445,1,0,1,593649,11961,95416,12540,0.11079513876023565,0.511815844251255
34604,0.8497500000000002,0,2,0,593651,11959,95416,12540,0.11077661269406054,0.5118576268419119
34605,0.8497619047619047,0,1,0,593652,11958,95416,12540,0.11076734966097299,0.5118785206955669
34606,0.8497842712842711,0,1,0,593653,11957,95416,12540,0.11075808662788543,0.5118994162550516
34607,0.8498333333333332,1,0,1,593653,11957,95417,12539,0.11075808662788543,0.511879490529066
34608,0.8498333333333333,1,2,1,593655,11955,95418,12538,0.11073956056171033,0.5119013595721227
34609,0.8498809523809524,0,1,0,593656,11954,95418,12538,0.11073029752862278,0.5119222603299036
34610,0.8498809523809525,0,1,0,593657,11953,95418,12538,0.11072103449553522,0.5119431627944959
34611,0.8499761904761904,1,0,1,593657,11953,95419,12537,0.11072103449553522,0.5119232339730502
34612,0.8499999999999999,0,4,0,593661,11949,95419,12537,0.110683982363185,0.5120068610634648
34613,0.85,754,779,754,594440,11170,96173,11783,0.1034680795879803,0.5133533742865857
34614,0.8500000000000001,4,0,4,594440,11170,96177,11779,0.1034680795879803,0.5132685520066234
34615,0.8501309523809524,0,2,0,594442,11168,96177,11779,0.10344955352180518,0.5133132871399312
34616,0.8501428571428571,1,0,1,594442,11168,96178,11778,0.10344955352180518,0.5132920770504663
34617,0.8501666666666666,1,3,1,594445,11165,96179,11777,0.10342176442254251,0.5133379827390812
34618,0.8501666666666668,1,1,1,594446,11164,96180,11776,0.10341250138945496,0.5133391455972102
34619,0.8502857142857144,1,1,1,594447,11163,96181,11775,0.1034032383563674,0.5133403086581219
34620,0.8503333333333332,0,2,0,594449,11161,96181,11775,0.1033847122901923,0.5133850715033136
34621,0.8503333333333333,2,4,2,594453,11157,96183,11773,0.10334766015784208,0.5134321849105975
34622,0.8503333333333335,0,2,0,594455,11155,96183,11773,0.10332913409166697,0.5134769713886951
34623,0.8503571428571429,0,1,0,594456,11154,96183,11773,0.10331987105857943,0.5134993675579012
34624,0.8503809523809523,1,2,1,594458,11152,96184,11772,0.10330134499240431,0.5135229453847496
34625,0.8504166666666666,1,0,1,594458,11152,96185,11771,0.10330134499240431,0.5135017231601449
34626,0.8504523809523811,0,2,0,594460,11150,96185,11771,0.1032828189262292,0.5135465293835347
34627,0.8504761904761905,0,1,0,594461,11149,96185,11771,0.10327355589314165,0.5135689354275742
34628,0.8504999999999999,1,2,1,594463,11147,96186,11770,0.10325502982696654,0.5135925295632063
34629,0.8505119047619049,1,1,1,594464,11146,96187,11769,0.10324576679387899,0.5135937159066114
34630,0.8506190476190474,0,1,0,594465,11145,96187,11769,0.10323650376079144,0.5136161298769312
34631,0.8506269841269841,0,1,0,594466,11144,96187,11769,0.10322724072770388,0.5136385458036923
34632,0.8506666666666667,3,2,3,594468,11142,96190,11766,0.10320871466152877,0.5136196961760083
34633,0.8506666666666668,0,2,0,594470,11140,96190,11766,0.10319018859535366,0.5136645420413866
34634,0.8506825396825397,0,1,0,594471,11139,96190,11766,0.10318092556226612,0.5136869679109365
34635,0.8507142857142856,1,2,1,594473,11137,96191,11765,0.103162399496091,0.5137105929613134
34636,0.8507738095238095,0,1,0,594474,11136,96191,11765,0.10315313646300345,0.5137330247587442
34637,0.8507936507936509,2,1,2,594475,11135,96193,11763,0.10314387342991589,0.5137129880338894
34638,0.8508333333333333,4,6,4,594481,11129,96197,11759,0.10308829523139057,0.5137626703949668
34639,0.8508333333333334,1,7,1,594488,11122,96198,11758,0.10302345399977769,0.5138986013986014
34640,0.8509047619047619,0,1,0,594489,11121,96198,11758,0.10301419096669014,0.513921062983522
34641,0.8509516594516594,0,1,0,594490,11120,96198,11758,0.10300492793360258,0.5139435265320396
34642,0.850952380952381,0,1,0,594491,11119,96198,11758,0.10299566490051502,0.5139659920444114
34643,0.851,7,7,7,594498,11112,96205,11751,0.10293082366890215,0.5139745440230941
34644,0.8510000000000001,1,1,1,594499,11111,96206,11750,0.10292156063581459,0.513975766589388
34645,0.8510000000000002,0,1,0,594500,11110,96206,11750,0.10291229760272703,0.5139982502187227
34646,0.8510833333333333,0,1,0,594501,11109,96206,11750,0.10290303456963948,0.514020735815215
34647,0.8511666666666667,0,3,0,594504,11106,96206,11750,0.10287524547037682,0.5140882044102205
34648,0.8512142857142857,0,1,0,594505,11105,96206,11750,0.10286598243728927,0.5141106978779261
34649,0.85125,1,1,1,594506,11104,96207,11749,0.10285671940420171,0.5141119327878177
34650,0.8513333333333333,1,6,1,594512,11098,96208,11748,0.10280114120567639,0.5142256850214479
34651,0.8513333333333334,0,3,0,594515,11095,96208,11748,0.10277335210641372,0.5142932189292124
34652,0.8513333333333335,1,0,1,594515,11095,96209,11747,0.10277335210641372,0.5142719551703003
34653,0.8513809523809521,0,1,0,594516,11094,96209,11747,0.10276408907332617,0.5142944704697693
34654,0.8513928571428571,0,1,0,594517,11093,96209,11747,0.10275482604023861,0.5143169877408056
34655,0.8514285714285714,1,0,1,594517,11093,96210,11746,0.10275482604023861,0.5142957222295197
34656,0.8514999999999999,0,1,0,594518,11092,96210,11746,0.10274556300715106,0.5143182415272791
34657,0.8515,2,3,2,594521,11089,96212,11744,0.1027177739078884,0.5143432750843078
34658,0.8516666666666666,18,24,18,594545,11065,96230,11726,0.1024954611137871,0.5145013382475538
34659,0.8516666666666667,13,18,13,594563,11047,96243,11713,0.10232872651821112,0.5146309314586994
34660,0.8517857142857143,1,1,1,594564,11046,96244,11712,0.10231946348512357,0.5146322172422885
34661,0.8518095238095238,1,0,1,594564,11046,96245,11711,0.10231946348512357,0.5146108889572439
34662,0.8518333333333333,5,5,5,594569,11041,96250,11706,0.1022731483196858,0.5146173121730339
34663,0.8519076479076477,1,2,1,594571,11039,96251,11705,0.10225462225351069,0.5146412240590925
34664,0.8519166666666669,0,2,0,594573,11037,96251,11705,0.10223609618733558,0.5146864831589131
34665,0.8519761904761903,1,0,1,594573,11037,96252,11704,0.10223609618733558,0.5146651422540786
34666,0.8519999999999999,2,1,2,594574,11036,96254,11702,0.10222683315424802,0.5146450875186912
34667,0.852,8,7,8,594581,11029,96262,11694,0.10216199192263514,0.51463275095718
34668,0.8520476190476187,0,1,0,594582,11028,96262,11694,0.10215272888954759,0.5146554000528123
34669,0.8520833333333334,1,0,1,594582,11028,96263,11693,0.10215272888954759,0.5146340389947626
34670,0.8521071428571427,1,0,1,594582,11028,96264,11692,0.10215272888954759,0.514612676056338
34671,0.8521666666666665,1,2,1,594584,11026,96265,11691,0.10213420282337249,0.5146366157503192
34672,0.8521666666666667,1,3,1,594587,11023,96266,11690,0.10210641372410982,0.5146832210628275
34673,0.8522222222222223,1,1,1,594588,11022,96267,11689,0.10209715069102226,0.5146845141121043
34674,0.8522301587301588,2,0,2,594588,11022,96269,11687,0.10209715069102226,0.5146417719846756
34675,0.8522738095238096,1,2,1,594590,11020,96270,11686,0.10207862462484717,0.5146657271205849
34676,0.8522857142857143,0,1,0,594591,11019,96270,11686,0.10206936159175961,0.5146883946267342
34677,0.8523095238095239,2,0,2,594591,11019,96272,11684,0.10206936159175961,0.5146456415451702
34678,0.8523333333333332,0,4,0,594595,11015,96272,11684,0.10203230945940939,0.5147363319970043
34679,0.8523333333333334,2,9,2,594604,11006,96274,11682,0.1019489421616214,0.5148977433004231
34680,0.8523809523809522,0,1,0,594605,11005,96274,11682,0.10193967912853384,0.5149204390179398
34681,0.8523809523809525,1,3,1,594608,11002,96275,11681,0.10191189002927119,0.5149671560199268
34682,0.8523928571428572,0,1,0,594609,11001,96275,11681,0.10190262699618363,0.5149898598007231
34683,0.8524047619047619,0,2,0,594611,10999,96275,11681,0.10188410093000852,0.5150352733686067
34684,0.8524999999999998,1,0,1,594611,10999,96276,11680,0.10188410093000852,0.5150138895013008
34685,0.8525,39,30,39,594641,10969,96315,11641,0.1016062099373819,0.5148606811145511
34686,0.8525000000000001,1,3,1,594644,10966,96316,11640,0.10157842083811923,0.5149075466690259
34687,0.8525714285714286,0,2,0,594646,10964,96316,11640,0.10155989477194413,0.5149531056450186
34688,0.8526428571428571,0,1,0,594647,10963,96316,11640,0.10155063173885658,0.5149758881564395
34689,0.8526666666666665,1,2,1,594649,10961,96317,11639,0.10153210567268146,0.515
34690,0.8526666666666667,0,5,0,594654,10956,96317,11639,0.1014857905072437,0.5151139632662093
34691,0.8527777777777777,0,2,0,594656,10954,96317,11639,0.10146726444106859,0.5151595626964104
34692,0.8528333333333332,1,3,1,594659,10951,96318,11638,0.10143947534180592,0.5152065164460579
34693,0.8528333333333333,1,1,1,594660,10950,96319,11637,0.10143021230871836,0.515207862930004
34694,0.8528333333333334,0,1,0,594661,10949,96319,11637,0.1014209492756308,0.5152306738687683
34695,0.8528571428571428,1,1,1,594662,10948,96320,11636,0.10141168624254326,0.5152320226709175
34696,0.8528611111111111,0,1,0,594663,10947,96320,11636,0.10140242320945571,0.5152548377097816
34697,0.8528928571428568,0,2,0,594665,10945,96320,11636,0.1013838971432806,0.5153004738496967
34698,0.8529166666666668,1,0,1,594665,10945,96321,11635,0.1013838971432806,0.5152790079716564
34699,0.852952380952381,0,1,0,594666,10944,96321,11635,0.10137463411019304,0.5153018291332654
34700,0.8529761904761906,0,1,0,594667,10943,96321,11635,0.10136537107710548,0.5153246523164142
34701,0.8529880952380953,0,1,0,594668,10942,96321,11635,0.10135610804401793,0.5153474775213713
34702,0.8529999999999999,1,0,1,594668,10942,96322,11634,0.10135610804401793,0.5153260099220411
34703,0.853,1,7,1,594675,10935,96323,11633,0.10129126681240505,0.5154643743353421
34704,0.8530000000000001,0,1,0,594676,10934,96323,11633,0.1012820037793175,0.515487215846147
34705,0.8530079365079366,1,0,1,594676,10934,96324,11632,0.1012820037793175,0.5154657449259948
34706,0.8530833333333334,1,3,1,594679,10931,96325,11631,0.10125421468005484,0.5155128091481251
34707,0.8531190476190479,0,1,0,594680,10930,96325,11631,0.10124495164696728,0.5155356588803688
34708,0.8531428571428572,0,2,0,594682,10928,96325,11631,0.10122642558079217,0.5155813644221818
34709,0.8531666666666665,0,1,0,594683,10927,96325,11631,0.10121716254770462,0.5156042202322901
34710,0.8531666666666667,0,1,0,594684,10926,96325,11631,0.10120789951461706,0.5156270780688922
34711,0.8532142857142857,1,1,1,594685,10925,96326,11630,0.1011986364815295,0.5156284637552649
34712,0.853238095238095,0,1,0,594686,10924,96326,11630,0.10118937344844196,0.5156513257071916
34713,0.8533258130758132,0,1,0,594687,10923,96326,11630,0.10118011041535441,0.5156741896865162
34714,0.8533333333333333,36,48,36,594735,10875,96362,11594,0.1007354848271518,0.515999821976946
34715,0.8533333333333334,29,48,29,594783,10827,96391,11565,0.1002908592389492,0.5164790996784566
34716,0.8533571428571429,0,1,0,594784,10826,96391,11565,0.10028159620586165,0.5165021660488589
34717,0.8534285714285714,0,2,0,594786,10824,96391,11565,0.10026307013968654,0.5165483049711912
34718,0.8534444444444444,0,2,0,594788,10822,96391,11565,0.10024454407351142,0.5165944521374012
34719,0.8534999999999999,1,3,1,594791,10819,96392,11564,0.10021675497424877,0.5166420944466783
34720,0.8535,0,1,0,594792,10818,96392,11564,0.10020749194116121,0.5166651773746761
34721,0.8535238095238096,0,1,0,594793,10817,96392,11564,0.10019822890807366,0.5166882623653992
34722,0.8535595238095237,0,1,0,594794,10816,96392,11564,0.1001889658749861,0.5167113494191242
34723,0.8535714285714286,0,1,0,594795,10815,96392,11564,0.10017970284189855,0.5167344385361277
34724,0.8536111111111111,1,0,1,594795,10815,96393,11563,0.10017970284189855,0.5167128429707749
34725,0.8536666666666666,1,1,1,594796,10814,96394,11562,0.10017043980881099,0.5167143367894173
34726,0.8536666666666668,1,1,1,594797,10813,96395,11561,0.10016117677572345,0.516715830875123
34727,0.8537777777777777,0,1,0,594798,10812,96395,11561,0.10015191374263589,0.5167389263844813
34728,0.8538333333333332,0,1,0,594799,10811,96395,11561,0.10014265070954834,0.5167620239585196
34729,0.8538333333333334,0,1,0,594800,10810,96395,11561,0.10013338767646078,0.5167851235975146
34730,0.853940476190476,0,1,0,594801,10809,96395,11561,0.10012412464337322,0.5168082253017434
34731,0.8539523809523808,0,3,0,594804,10806,96395,11561,0.10009633554411056,0.516877542808602
34732,0.8539846558670083,2,5,2,594809,10801,96397,11559,0.10005002037867279,0.5169499105545617
34733,0.8539999999999999,0,1,0,594810,10800,96397,11559,0.10004075734558524,0.5169730309942305
34734,0.8540000000000001,14,14,14,594824,10786,96411,11545,0.09991107488235948,0.5169943128386548
34735,0.8541468253968254,2,0,2,594824,10786,96413,11543,0.09991107488235948,0.5169510502037709
34736,0.8541666666666665,5,9,5,594833,10777,96418,11538,0.09982770758457149,0.5170513107775039
34737,0.8541666666666667,3,16,3,594849,10761,96421,11535,0.09967949905517062,0.5173573735199138
34738,0.8541666666666669,0,1,0,594850,10760,96421,11535,0.09967023602208307,0.5173805786050684
34739,0.8542380952380954,0,1,0,594851,10759,96421,11535,0.09966097298899551,0.5174037857719566
34740,0.8542499999999998,0,1,0,594852,10758,96421,11535,0.09965170995590797,0.5174269950208585
34741,0.8542857142857143,2,1,2,594853,10757,96423,11533,0.09964244692282041,0.5174069089277703
34742,0.8543333333333333,3,3,3,594856,10754,96426,11530,0.09961465782355775,0.5174115957637767
34743,0.8543333333333334,0,2,0,594858,10752,96426,11530,0.09959613175738263,0.5174580378781078
34744,0.8543333333333335,0,1,0,594859,10751,96426,11530,0.09958686872429508,0.5174812620618464
34745,0.854387445887446,0,1,0,594860,10750,96426,11530,0.09957760569120754,0.5175044883303411
34746,0.8543968253968254,0,1,0,594861,10749,96426,11530,0.09956834265811998,0.5175277166838727
34747,0.8544545454545456,1,1,1,594862,10748,96427,11529,0.09955907962503242,0.517529290299412
34748,0.8544837662337662,0,1,0,594863,10747,96427,11529,0.09954981659194487,0.5175525228945951
34749,0.8545238095238095,0,1,0,594864,10746,96427,11529,0.09954055355885731,0.5175757575757576
34750,0.8545595238095238,0,2,0,594866,10744,96427,11529,0.0995220274926822,0.5176222331971445
34751,0.8545833333333335,0,1,0,594867,10743,96427,11529,0.09951276445959464,0.517645474137931
34752,0.854595238095238,0,1,0,594868,10742,96427,11529,0.0995035014265071,0.517668717165821
34753,0.8546428571428573,0,1,0,594869,10741,96427,11529,0.09949423839341955,0.5176919622810956
34754,0.8546666666666666,2,0,2,594869,10741,96429,11527,0.09949423839341955,0.5176486437937848
34755,0.8546666666666667,1,0,1,594869,10741,96430,11526,0.09949423839341955,0.5176269816320115
34756,0.8547499999999999,1,0,1,594869,10741,96431,11525,0.09949423839341955,0.5176053175244768
34757,0.8547730880230878,1,0,1,594869,10741,96432,11524,0.09949423839341955,0.5175836514709184
34758,0.8547857142857143,0,1,0,594870,10740,96432,11524,0.09948497536033199,0.5176068990298239
34759,0.8548333333333333,1,2,1,594872,10738,96433,11523,0.09946644929415688,0.5176317326265666
34760,0.8548333333333334,0,1,0,594873,10737,96433,11523,0.09945718626106932,0.5176549865229111
34761,0.8548809523809525,0,2,0,594875,10735,96433,11523,0.09943866019489421,0.5177015005840596
34762,0.8549047619047618,0,1,0,594876,10734,96433,11523,0.09942939716180667,0.5177247607494272
34763,0.8549999999999999,3,2,3,594878,10732,96436,11520,0.09941087109563156,0.5177062735933848
34764,0.855,152,166,152,595044,10566,96588,11368,0.09787320760309756,0.5182821190845263
34765,0.8550000000000001,4,0,4,595044,10566,96592,11364,0.09787320760309756,0.5181942544459645
34766,0.855047619047619,0,1,0,595045,10565,96592,11364,0.09786394457001,0.5182178849924757
34767,0.8550476190476191,2,0,2,595045,10565,96594,11362,0.09786394457001,0.5181739408035755
34768,0.8550595238095238,0,1,0,595046,10564,96594,11362,0.09785468153692245,0.5181975736568457
34769,0.8551190476190478,1,0,1,595046,10564,96595,11361,0.09785468153692245,0.5181755986316989
34770,0.8551587301587301,1,0,1,595046,10564,96596,11360,0.09785468153692245,0.5181536216018975
34771,0.8551666666666665,1,1,1,595047,10563,96597,11359,0.0978454185038349,0.5181552778031202
34772,0.8551666666666666,2,0,2,595047,10563,96599,11357,0.0978454185038349,0.5181113138686131
34773,0.8551904761904763,0,4,0,595051,10559,96599,11357,0.09780836637148468,0.5182058769848512
34774,0.8553333333333332,2,1,2,595052,10558,96601,11355,0.09779910333839713,0.5181855519554602
34775,0.8553333333333333,1,6,1,595058,10552,96602,11354,0.0977435251398718,0.518305487081165
34776,0.8553333333333335,2,1,2,595059,10551,96604,11352,0.09773426210678425,0.5182851664155596
34777,0.8553571428571429,0,2,0,595061,10549,96604,11352,0.09771573604060914,0.5183324962330487
34778,0.8553730158730158,0,2,0,595063,10547,96604,11352,0.09769720997443403,0.5183798346956482
34779,0.8554047619047619,0,1,0,595064,10546,96604,11352,0.09768794694134647,0.5184035071696045
34780,0.8554166666666667,1,0,1,595064,10546,96605,11351,0.09768794694134647,0.5183815134493309
34781,0.8554444444444443,0,1,0,595065,10545,96605,11351,0.09767868390825891,0.5184051881622214
34782,0.8554999999999998,0,1,0,595066,10544,96605,11351,0.09766942087517137,0.5184288650376798
34783,0.8554999999999999,2,4,2,595070,10540,96607,11349,0.09763236874282115,0.5184796016263877
34784,0.8555238095238096,1,2,1,595072,10538,96608,11348,0.09761384267664604,0.518504980352737
34785,0.8555555555555556,0,1,0,595073,10537,96608,11348,0.09760457964355848,0.5185286726068083
34786,0.8555714285714285,1,0,1,595073,10537,96609,11347,0.09760457964355848,0.5185066715408517
34787,0.8556666666666666,4,1,4,595074,10536,96613,11343,0.09759531661047094,0.5184423419717538
34788,0.8556666666666668,2,3,2,595077,10533,96615,11341,0.09756752751120827,0.5184694157447197
34789,0.8557023809523808,0,1,0,595078,10532,96615,11341,0.09755826447812072,0.5184931193709139
34790,0.8557142857142856,2,1,2,595079,10531,96617,11339,0.09754900144503316,0.5184727937814357
34791,0.8557619047619045,1,1,1,595080,10530,96618,11338,0.0975397384119456,0.5184744832632157
34792,0.8558333333333333,10,6,10,595086,10524,96628,11328,0.09748416021342028,0.5183964854475562
34793,0.8558333333333334,4,10,4,595096,10514,96632,11324,0.09739152988254474,0.5185456543639527
34794,0.855952380952381,1,1,1,595097,10513,96633,11323,0.09738226684945718,0.5185473529950541
34795,0.8559731379731379,0,1,0,595098,10512,96633,11323,0.09737300381636964,0.518571101442638
34796,0.856,15,15,15,595113,10497,96648,11308,0.09723405832005631,0.5185966521440036
34797,0.8560000000000001,2,1,2,595114,10496,96650,11306,0.09722479528696877,0.5185762774057426
34798,0.8560714285714286,0,2,0,595116,10494,96650,11306,0.09720626922079366,0.5186238532110091
34799,0.8561666666666666,0,3,0,595119,10491,96650,11306,0.09717848012153099,0.5186952332889847
34800,0.8561666666666667,0,1,0,595120,10490,96650,11306,0.09716921708844344,0.5187190310148652
34801,0.856178571428571,0,2,0,595122,10488,96650,11306,0.09715069102226834,0.5187666330182619
34802,0.8561904761904762,1,0,1,595122,10488,96651,11305,0.09715069102226834,0.5187445510026155
34803,0.8561904761904764,1,0,1,595122,10488,96652,11304,0.09715069102226834,0.5187224669603524
34804,0.8562063492063493,1,0,1,595122,10488,96653,11303,0.09715069102226834,0.5187003808911936
34805,0.856238095238095,0,2,0,595124,10486,96653,11303,0.09713216495609323,0.5187479921061086
34806,0.85625,0,1,0,595125,10485,96653,11303,0.09712290192300567,0.5187718009913714
34807,0.8562857142857143,0,1,0,595126,10484,96653,11303,0.09711363888991811,0.5187956120622389
34808,0.8563333333333333,0,5,0,595131,10479,96653,11303,0.09706732372448035,0.5189147002111836
34809,0.856439393939394,0,1,0,595132,10478,96653,11303,0.09705806069139279,0.5189385244020017
34810,0.8564999999999998,1,1,1,595133,10477,96654,11302,0.09704879765830524,0.5189402635566371
34811,0.8564999999999999,1,1,1,595134,10476,96655,11301,0.09703953462521768,0.5189420030307205
34812,0.8565,2,4,2,595138,10472,96657,11299,0.09700248249286747,0.5189931560332552
34813,0.8565584415584415,0,1,0,595139,10471,96657,11299,0.09699321945977991,0.5190169958658705
34814,0.8566666666666666,31,44,31,595183,10427,96688,11268,0.09658564600392752,0.5193823461627103
34815,0.8566666666666667,32,40,32,595223,10387,96720,11236,0.09621512468042535,0.5196318734680664
34816,0.8567142857142857,0,1,0,595224,10386,96720,11236,0.0962058616473378,0.5196559060216446
34817,0.8567142857142858,1,0,1,595224,10386,96721,11235,0.0962058616473378,0.5196336894685722
34818,0.8567380952380952,0,1,0,595225,10385,96721,11235,0.09619659861425026,0.5196577243293247
34819,0.8567857142857143,1,0,1,595225,10385,96722,11234,0.09619659861425026,0.5196355058050789
34820,0.8568095238095238,0,1,0,595226,10384,96722,11234,0.0961873355811627,0.5196595429734481
34821,0.8568333333333332,1,0,1,595226,10384,96723,11233,0.0961873355811627,0.5196373224776796
34822,0.8568333333333333,0,2,0,595228,10382,96723,11233,0.09616880951498759,0.5196854036548693
34823,0.8569444444444444,0,1,0,595229,10381,96723,11233,0.09615954648190003,0.519709447580272
34824,0.8569761904761904,0,1,0,595230,10380,96723,11233,0.09615028344881248,0.519733493730625
34825,0.856984126984127,1,0,1,595230,10380,96724,11232,0.09615028344881248,0.5197112715158245
34826,0.857,1,4,1,595234,10376,96725,11231,0.09611323131646227,0.519785254778544
34827,0.8570555555555555,0,1,0,595235,10375,96725,11231,0.09610396828337471,0.5198093122280848
34828,0.8570833333333334,1,0,1,595235,10375,96726,11230,0.09610396828337471,0.5197870863226105
34829,0.8571190476190477,0,1,0,595236,10374,96726,11230,0.09609470525028715,0.5198111460840585
34830,0.8571428571428571,1,0,1,595236,10374,96727,11229,0.09609470525028715,0.5197889182058048
34831,0.8572222222222221,0,1,0,595237,10373,96727,11229,0.0960854422171996,0.5198129802796038
34832,0.857285714285714,0,1,0,595238,10372,96727,11229,0.09607617918411204,0.5198370445812693
34833,0.8573095238095239,1,2,1,595240,10370,96728,11228,0.09605765311793693,0.5198629502731734
34834,0.8573333333333334,1,1,1,595241,10369,96729,11227,0.09604839008484939,0.5198647897758845
34835,0.8573333333333335,0,1,0,595242,10368,96729,11227,0.09603912705176183,0.5198888631627692
34836,0.8573650793650794,0,1,0,595243,10367,96729,11227,0.09602986401867428,0.5199129387792906
34837,0.8574047619047619,1,0,1,595243,10367,96730,11226,0.09602986401867428,0.5198907053211689
34838,0.8574166666666667,0,1,0,595244,10366,96730,11226,0.09602060098558672,0.5199147832530567
34839,0.857452380952381,0,1,0,595245,10365,96730,11226,0.09601133795249917,0.5199388634153119
34840,0.8574999999999998,1,2,1,595247,10363,96731,11225,0.09599281188632405,0.5199647952566241
34841,0.8575,35,41,35,595288,10322,96766,11190,0.09561302752973434,0.5201747861658609
34842,0.8575000000000002,3,5,3,595293,10317,96769,11187,0.09556671236429656,0.5202287946428571
34843,0.8575119047619048,1,0,1,595293,10317,96770,11186,0.09556671236429656,0.5202064828163512
34844,0.8575833333333331,1,0,1,595293,10317,96771,11185,0.09556671236429656,0.5201841689145196
34845,0.8576111111111109,0,1,0,595294,10316,96771,11185,0.09555744933120901,0.5202083624017487
34846,0.8576190476190476,0,2,0,595296,10314,96771,11185,0.09553892326503391,0.520256756128192
34847,0.8576666666666665,1,0,1,595296,10314,96772,11184,0.09553892326503391,0.5202344404130617
34848,0.8576666666666667,1,5,1,595301,10309,96773,11183,0.09549260809959613,0.5203331472175693
34849,0.8577777777777778,1,0,1,595301,10309,96774,11182,0.09549260809959613,0.5203108277883766
34850,0.8578095238095238,0,1,0,595302,10308,96774,11182,0.09548334506650857,0.5203350395532806
34851,0.8578333333333333,0,2,0,595304,10306,96774,11182,0.09546481900033348,0.5203834698436337
34852,0.8578333333333334,0,1,0,595305,10305,96774,11182,0.09545555596724592,0.520407688369712
34853,0.8578571428571428,1,1,1,595306,10304,96775,11181,0.09544629293415836,0.5204095880847103
34854,0.8578571428571429,2,0,2,595306,10304,96777,11179,0.09544629293415836,0.5203649397197784
34855,0.8578766233766233,0,1,0,595307,10303,96777,11179,0.09543702990107081,0.520389163020203
34856,0.8579999999999999,0,1,0,595308,10302,96777,11179,0.09542776686798325,0.5204133885759509
34857,0.858,12,12,12,595320,10290,96789,11167,0.09531661047093261,0.5204362212797689
34858,0.8580238095238094,0,1,0,595321,10289,96789,11167,0.09530734743784505,0.5204604772557793
34859,0.8580476190476192,1,1,1,595322,10288,96790,11166,0.0952980844047575,0.5204623846368975
34860,0.8581587301587299,1,0,1,595322,10288,96791,11165,0.0952980844047575,0.5204400316971985
34861,0.8581666666666666,2,6,2,595328,10282,96793,11163,0.09524250620623217,0.520540918629051
34862,0.8581666666666667,1,2,1,595330,10280,96794,11162,0.09522398014005706,0.5205671112769331
34863,0.8582103174603174,0,1,0,595331,10279,96794,11162,0.09521471710696951,0.5205913903269437
34864,0.8583333333333332,2,0,2,595331,10279,96796,11160,0.09521471710696951,0.5205466672885862
34865,0.8583333333333333,11,33,11,595364,10246,96807,11149,0.09490903701508022,0.5211030614629586
34866,0.8583333333333334,8,19,8,595383,10227,96815,11141,0.09473303938641668,0.5213871209284912
34867,0.8583809523809522,1,0,1,595383,10227,96816,11140,0.09473303938641668,0.5213647212991998
34868,0.8583809523809524,1,0,1,595383,10227,96817,11139,0.09473303938641668,0.5213423195731536
34869,0.858392857142857,0,1,0,595384,10226,96817,11139,0.09472377635332914,0.5213667212731102
34870,0.858452380952381,0,1,0,595385,10225,96817,11139,0.09471451332024158,0.5213911252574425
34871,0.8584722222222222,2,2,2,595387,10223,96819,11137,0.09469598725406647,0.5213951310861423
34872,0.8584999999999999,5,3,5,595390,10220,96824,11132,0.0946681981548038,0.5213563132259273
34873,0.8585,2,3,2,595393,10217,96826,11130,0.09464040905554115,0.5213847379022813
34874,0.858531746031746,0,1,0,595394,10216,96826,11130,0.0946311460224536,0.5214091633092851
34875,0.8585714285714287,2,1,2,595395,10215,96828,11128,0.09462188298936604,0.5213887457245936
34876,0.858642857142857,1,0,1,595395,10215,96829,11127,0.09462188298936604,0.5213663199325274
34877,0.8586666666666667,2,3,2,595398,10212,96831,11125,0.09459409389010337,0.5213947602755776
34878,0.8586875901875902,0,1,0,595399,10211,96831,11125,0.09458483085701583,0.5214191976003
34879,0.85875,4,2,4,595401,10209,96835,11121,0.09456630479084072,0.5213783403656821
34880,0.8588095238095238,1,1,1,595402,10208,96836,11120,0.09455704175775316,0.5213803450862715
34881,0.8588333333333332,0,2,0,595404,10206,96836,11120,0.09453851569157805,0.5214292413016974
34882,0.858892857142857,0,2,0,595406,10204,96836,11120,0.09451998962540294,0.5214781466891765
34883,0.858904761904762,0,1,0,595407,10203,96836,11120,0.0945107265923154,0.5215026028232425
34884,0.8590000000000001,8,3,8,595410,10200,96844,11112,0.09448293749305273,0.5213963963963963
34885,0.859047619047619,0,1,0,595411,10199,96844,11112,0.09447367445996517,0.5214208624653934
34886,0.8590714285714285,0,1,0,595412,10198,96844,11112,0.09446441142687761,0.521445330830596
34887,0.859095238095238,1,0,1,595412,10198,96845,11111,0.09446441142687761,0.5214228729644751
34888,0.8591150793650795,0,1,0,595413,10197,96845,11111,0.09445514839379006,0.5214473437206683
34889,0.8591428571428571,0,1,0,595414,10196,96845,11111,0.0944458853607025,0.5214718167738301
34890,0.8591666666666665,4,5,4,595419,10191,96849,11107,0.09439957019526474,0.5215043666071931
34891,0.8591666666666667,4,8,4,595427,10183,96853,11103,0.0943254659305643,0.5216104481819036
34892,0.8592380952380952,0,1,0,595428,10182,96853,11103,0.09431620289747675,0.5216349541930937
34893,0.8592500000000001,0,2,0,595430,10180,96853,11103,0.09429767683130164,0.5216839731240897
34894,0.8592857142857143,2,0,2,595430,10180,96855,11101,0.09429767683130164,0.5216390207227104
34895,0.8593333333333333,4,2,4,595432,10178,96859,11097,0.09427915076512654,0.5215981198589894
34896,0.8593333333333334,0,10,0,595442,10168,96859,11097,0.09418652043425099,0.5218434046555372
34897,0.8594166666666667,1,0,1,595442,10168,96860,11096,0.09418652043425099,0.5218209179834462
34898,0.8594841269841271,0,2,0,595444,10166,96860,11096,0.09416799436807588,0.5218700028219359
34899,0.8594999999999999,0,1,0,595445,10165,96860,11096,0.09415873133498832,0.5218945487042002
34900,0.8595000000000002,1,0,1,595445,10165,96861,11095,0.09415873133498832,0.5218720602069614
34901,0.8595238095238095,1,2,1,595447,10163,96862,11094,0.09414020526881323,0.5218986686738486
34902,0.859547619047619,1,0,1,595447,10163,96863,11093,0.09414020526881323,0.5218761761385021
34903,0.8595476190476191,2,0,2,595447,10163,96865,11091,0.09414020526881323,0.5218311847181707
34904,0.8595833333333335,0,2,0,595449,10161,96865,11091,0.09412167920263811,0.521880293619424
34905,0.8596111111111111,2,0,2,595449,10161,96867,11089,0.09412167920263811,0.5218352941176471
34906,0.8596666666666667,3,4,3,595453,10157,96870,11086,0.09408462707028789,0.5218660264557736
34907,0.8596666666666668,1,0,1,595453,10157,96871,11085,0.09408462707028789,0.5218435175595518
34908,0.8597142857142857,0,1,0,595454,10156,96871,11085,0.09407536403720033,0.5218680853067181
34909,0.8597142857142858,0,1,0,595455,10155,96871,11085,0.09406610100411279,0.5218926553672316
34910,0.8597380952380952,0,1,0,595456,10154,96871,11085,0.09405683797102524,0.5219172277414191
34911,0.8597857142857143,1,1,1,595457,10153,96872,11084,0.09404757493793768,0.5219192918020436
34912,0.8598333333333333,0,2,0,595459,10151,96872,11084,0.09402904887176257,0.5219684483164587
34913,0.8598333333333334,0,1,0,595460,10150,96872,11084,0.09401978583867501,0.5219930300461524
34914,0.8598492063492061,0,1,0,595461,10149,96872,11084,0.09401052280558746,0.522017614091273
34915,0.8598571428571428,2,1,2,595462,10148,96874,11082,0.0940012597724999,0.5219971738106454
34916,0.859857142857143,0,1,0,595463,10147,96874,11082,0.09399199673941236,0.5220217626831222
34917,0.8599999999999999,3,3,3,595466,10144,96877,11079,0.09396420764014969,0.5220279885030391
34918,0.86,712,692,712,596158,9452,97589,10367,0.08755418874356219,0.523083909379888
34919,0.8600000000000001,0,1,0,596159,9451,97589,10367,0.08754492571047463,0.5231103037642547
34920,0.8600476190476191,0,1,0,596160,9450,97589,10367,0.08753566267738708,0.5231367008124338
34921,0.8600952380952381,1,0,1,596160,9450,97590,10366,0.08753566267738708,0.5231126362535325
34922,0.8601666666666666,2,3,2,596163,9447,97592,10364,0.08750787357812442,0.5231437080409873
34923,0.8601944444444443,1,0,1,596163,9447,97593,10363,0.08750787357812442,0.5231196365471984
34924,0.8602619047619047,0,1,0,596164,9446,97593,10363,0.08749861054503687,0.5231460447271442
34925,0.8602857142857142,0,1,0,596165,9445,97593,10363,0.08748934751194931,0.5231724555735057
34926,0.8602857142857144,1,0,1,596165,9445,97594,10362,0.08748934751194931,0.5231483818851921
34927,0.8603333333333333,2,1,2,596166,9444,97596,10360,0.08748008447886176,0.5231266410826095
34928,0.8604047619047619,0,1,0,596167,9443,97596,10360,0.0874708214457742,0.5231530576175327
34929,0.8604761904761904,1,0,1,596167,9443,97597,10359,0.0874708214457742,0.5231289768710231
34930,0.8604999999999999,2,2,2,596169,9441,97599,10357,0.0874522953795991,0.5231336498636225
34931,0.8605000000000002,0,1,0,596170,9440,97599,10357,0.08744303234651155,0.5231600747588019
34932,0.8605238095238096,0,1,0,596171,9439,97599,10357,0.08743376931342399,0.5231865023237018
34933,0.86056746031746,2,0,2,596171,9439,97601,10355,0.08743376931342399,0.5231383247448722
34934,0.8606111111111112,0,1,0,596172,9438,97601,10355,0.08742450628033643,0.5231647552164906
34935,0.8606666666666666,3,4,3,596176,9434,97604,10352,0.08738745414798621,0.5231982209643182
34936,0.8606666666666668,2,1,2,596177,9433,97606,10350,0.08737819111489867,0.5231764646413587
34937,0.8608333333333333,5,9,5,596186,9424,97611,10345,0.08729482381711068,0.5232940462340028
34938,0.8608333333333335,2,5,2,596191,9419,97613,10343,0.0872485086516729,0.5233782005869851
34939,0.8608571428571428,1,1,1,596192,9418,97614,10342,0.08723924561858534,0.5233805668016195
34940,0.860873015873016,0,1,0,596193,9417,97614,10342,0.0872299825854978,0.5234070550129055
34941,0.860904761904762,0,1,0,596194,9416,97614,10342,0.08722071955241024,0.523433545905456
34942,0.860952380952381,0,1,0,596195,9415,97614,10342,0.08721145651932269,0.5234600394796781
34943,0.861,4,9,4,596204,9406,97618,10338,0.0871280892215347,0.5236021069692058
34944,0.8610000000000001,2,2,2,596206,9404,97620,10336,0.08710956315535959,0.5236068895643363
34945,0.8610357142857145,1,0,1,596206,9404,97621,10335,0.08710956315535959,0.5235827549521253
34946,0.8610476190476191,0,1,0,596207,9403,97621,10335,0.08710030012227203,0.5236092815888135
34947,0.8610555555555556,1,0,1,596207,9403,97622,10334,0.08710030012227203,0.5235851446521761
34948,0.8610714285714286,3,2,3,596209,9401,97625,10331,0.08708177405609693,0.5235657814717211
34949,0.8611666666666666,1,0,1,596209,9401,97626,10330,0.08708177405609693,0.5235416349906239
34950,0.8611666666666667,2,3,2,596212,9398,97628,10328,0.08705398495683427,0.5235729494068742
34951,0.8612222222222222,0,1,0,596213,9397,97628,10328,0.08704472192374671,0.5235994930291509
34952,0.86125,1,1,1,596214,9396,97629,10327,0.08703545889065915,0.5236018861228008
34953,0.8613134920634918,0,1,0,596215,9395,97629,10327,0.0870261958575716,0.5236284352499746
34954,0.86131454729481,3,5,3,596220,9390,97632,10324,0.08697988069213383,0.523688749112306
34955,0.8613333333333333,0,3,0,596223,9387,97632,10324,0.08695209159287116,0.5237684541626503
34956,0.8613333333333334,0,7,0,596230,9380,97632,10324,0.08688725036125829,0.523954526999594
34957,0.8614393939393941,1,0,1,596230,9380,97633,10323,0.08688725036125829,0.5239303659341217
34958,0.8615,3,2,3,596232,9378,97636,10320,0.08686872429508319,0.5239110569600974
34959,0.861547619047619,0,1,0,596233,9377,97636,10320,0.08685946126199563,0.5239376554805301
34960,0.8615714285714284,1,0,1,596233,9377,97637,10319,0.08685946126199563,0.5239134849715679
34961,0.8616587301587301,0,1,0,596234,9376,97637,10319,0.08685019822890808,0.5239400863163239
34962,0.8616666666666666,12,22,12,596256,9354,97649,10307,0.08664641150098189,0.5242357967549972
34963,0.8616666666666667,16,20,16,596276,9334,97665,10291,0.0864611508392308,0.5243821656050955
34964,0.861686147186147,0,1,0,596277,9333,97665,10291,0.08645188780614324,0.5244088870770485
34965,0.86175,0,1,0,596278,9332,97665,10291,0.08644262477305568,0.5244356112724864
34966,0.8617500000000001,0,1,0,596279,9331,97665,10291,0.08643336173996813,0.5244623381918255
34967,0.8617857142857143,1,0,1,596279,9331,97666,10290,0.08643336173996813,0.5244381020335355
34968,0.8618333333333333,0,2,0,596281,9329,97666,10290,0.08641483567379303,0.5244915642999134
34969,0.862,6,5,6,596286,9324,97672,10284,0.08636852050835525,0.5244798041615667
34970,0.8620000000000002,0,1,0,596287,9323,97672,10284,0.0863592574752677,0.5245065537818127
34971,0.8620158730158729,1,0,1,596287,9323,97673,10283,0.0863592574752677,0.5244823013363256
34972,0.8620555555555554,1,0,1,596287,9323,97674,10282,0.0863592574752677,0.5244580464167304
34973,0.8621428571428571,0,1,0,596288,9322,97674,10282,0.08634999444218015,0.5244847990206081
34974,0.8621666666666666,1,2,1,596290,9320,97675,10281,0.08633146837600504,0.5245140554053365
34975,0.8621904761904763,0,3,0,596293,9317,97675,10281,0.08630367927674237,0.5245943463618736
34976,0.8622142857142856,1,1,1,596294,9316,97676,10280,0.08629441624365482,0.5245968565013268
34977,0.8623095238095237,1,0,1,596294,9316,97677,10279,0.08629441624365482,0.5245725950497576
34978,0.8623095238095239,1,0,1,596294,9316,97678,10278,0.08629441624365482,0.524548331121772
34979,0.8623333333333332,0,1,0,596295,9315,97678,10278,0.08628515321056726,0.5245751033532384
34980,0.8623333333333334,2,3,2,596298,9312,97680,10276,0.08625736411130461,0.5246069021850113
34981,0.8623333333333335,0,2,0,596300,9310,97680,10276,0.0862388380451295,0.5246604717655469
34982,0.8623412698412699,0,1,0,596301,9309,97680,10276,0.08622957501204194,0.5246872606586673
34983,0.8623809523809524,0,1,0,596302,9308,97680,10276,0.08622031197895438,0.5247140522875817
34984,0.8624444444444443,0,1,0,596303,9307,97680,10276,0.08621104894586683,0.524740846652709
34985,0.8624761904761904,0,1,0,596304,9306,97680,10276,0.08620178591277929,0.5247676437544684
34986,0.8624999999999998,0,1,0,596305,9305,97680,10276,0.08619252287969173,0.5247944435932792
34987,0.8625,28,40,28,596345,9265,97708,10248,0.08582200155618956,0.5251883359811408
34988,0.8625714285714285,0,1,0,596346,9264,97708,10248,0.085812738523102,0.5252152521525215
34989,0.8626666666666665,2,2,2,596348,9262,97710,10246,0.0857942124569269,0.525220422390814
34990,0.8626666666666667,1,6,1,596354,9256,97711,10245,0.08573863425840157,0.5253576739654376
34991,0.8626666666666668,2,4,2,596358,9252,97713,10243,0.08570158212605135,0.5254167735316748
34992,0.8626746031746032,0,1,0,596359,9251,97713,10243,0.0856923190929638,0.5254437262747512
34993,0.8627380952380952,1,0,1,596359,9251,97714,10242,0.0856923190929638,0.52541938131637
34994,0.86275,0,2,0,596361,9249,97714,10242,0.0856737930267887,0.5254732953670925
34995,0.8627619047619046,0,1,0,596362,9248,97714,10242,0.08566452999370114,0.5255002565418163
34996,0.8628333333333331,0,3,0,596365,9245,97714,10242,0.08563674089443847,0.5255811566685482
34997,0.8628333333333333,1,4,1,596369,9241,97715,10241,0.08559968876208826,0.5256647161482394
34998,0.8628333333333335,0,2,0,596371,9239,97715,10241,0.08558116269591315,0.5257186858316222
34999,0.8628571428571428,2,0,2,596371,9239,97717,10239,0.08558116269591315,0.5256699866516069
35000,0.8628571428571429,0,1,0,596372,9238,97717,10239,0.08557189966282559,0.5256969759203163
35001,0.8629166666666666,0,2,0,596374,9236,97717,10239,0.08555337359665048,0.5257509627727857
35002,0.8629444444444445,1,0,1,596374,9236,97718,10238,0.08555337359665048,0.5257266098387594
35003,0.8629761904761906,1,0,1,596374,9236,97719,10237,0.08555337359665048,0.5257022544035331
35004,0.863,1,6,1,596380,9230,97720,10236,0.08549779539812516,0.5258399260248638
35005,0.8630000000000001,0,1,0,596381,9229,97720,10236,0.0854885323650376,0.525866940662728
35006,0.8630952380952379,0,1,0,596382,9228,97720,10236,0.08547926933195005,0.5258939580764488
35007,0.8631190476190475,0,1,0,596383,9227,97720,10236,0.0854700062988625,0.5259209782664543
35008,0.8631666666666665,0,1,0,596384,9226,97720,10236,0.08546074326577495,0.5259480012331723
35009,0.8631666666666666,2,1,2,596385,9225,97722,10234,0.0854514802326874,0.5259263065933502
35010,0.8631666666666667,0,1,0,596386,9224,97722,10234,0.08544221719959984,0.5259533353890431
35011,0.8632857142857142,1,0,1,596386,9224,97723,10233,0.08544221719959984,0.5259289715783523
35012,0.8633095238095239,0,1,0,596387,9223,97723,10233,0.08543295416651228,0.5259560032894737
35013,0.8633333333333332,1,0,1,596387,9223,97724,10232,0.08543295416651228,0.5259316371112824
35014,0.8633333333333333,42,43,42,596430,9180,97766,10190,0.08503464374374746,0.5260712441920495
35015,0.8633333333333334,40,26,40,596456,9154,97806,10150,0.08479380488347105,0.52579776212184
35016,0.863420634920635,0,1,0,596457,9153,97806,10150,0.08478454185038349,0.5258250012951354
35017,0.8634285714285714,1,1,1,596458,9152,97807,10149,0.08477527881729593,0.5258276773224185
35018,0.8634285714285715,0,1,0,596459,9151,97807,10149,0.08476601578420838,0.5258549222797927
35019,0.8634880952380954,1,0,1,596459,9151,97808,10148,0.08476601578420838,0.5258303539043474
35020,0.8634999999999999,2,1,2,596460,9150,97810,10146,0.08475675275112082,0.5258084577114428
35021,0.8635,0,1,0,596461,9149,97810,10146,0.08474748971803327,0.5258357087328324
35022,0.8635714285714287,0,2,0,596463,9147,97810,10146,0.08472896365185817,0.5258902192505054
35023,0.8636190476190477,0,1,0,596464,9146,97810,10146,0.08471970061877061,0.5259174787476675
35024,0.8636428571428573,0,1,0,596465,9145,97810,10146,0.08471043758568306,0.5259447410709658
35025,0.8636666666666666,1,2,1,596467,9143,97811,10145,0.08469191151950795,0.5259746992948984
35026,0.8636666666666667,4,4,4,596471,9139,97815,10141,0.08465485938715774,0.5259854771784233
35027,0.8636904761904762,0,3,0,596474,9136,97815,10141,0.08462707028789507,0.5260673341287545
35028,0.8636904761904763,0,1,0,596475,9135,97815,10141,0.08461780725480751,0.5260946254409629
35029,0.86375,0,1,0,596476,9134,97815,10141,0.08460854422171996,0.5261219195849546
35030,0.8637857142857144,0,2,0,596478,9132,97815,10141,0.08459001815554486,0.5261765163700514
35031,0.8638095238095238,0,1,0,596479,9131,97815,10141,0.0845807551224573,0.5262038190120382
35032,0.8638333333333332,1,0,1,596479,9131,97816,10140,0.0845807551224573,0.526179233044471
35033,0.8638333333333335,0,2,0,596481,9129,97816,10140,0.08456222905628219,0.5262338471119414
35034,0.863857142857143,0,1,0,596482,9128,97816,10140,0.08455296602319463,0.5262611583973428
35035,0.8639047619047617,1,2,1,596484,9126,97817,10139,0.08453443995701952,0.5262912016610434
35036,0.863904761904762,0,1,0,596485,9125,97817,10139,0.08452517692393197,0.5263185215946844
35037,0.8639166666666666,0,2,0,596487,9123,97817,10139,0.08450665085775687,0.5263731699719655
35038,0.8639285714285714,0,1,0,596488,9122,97817,10139,0.08449738782466931,0.5264004984164893
35039,0.8639999999999999,1,2,1,596490,9120,97818,10138,0.0844788617584942,0.5264305743067816
35040,0.8640000000000001,6,9,6,596499,9111,97824,10132,0.08439549446070621,0.526529127474926
35041,0.8640000000000002,0,1,0,596500,9110,97824,10132,0.08438623142761865,0.5265564910092506
35042,0.8640952380952379,0,1,0,596501,9109,97824,10132,0.0843769683945311,0.5265838573878696
35043,0.8641309523809524,0,1,0,596502,9108,97824,10132,0.08436770536144356,0.5266112266112266
35044,0.8641428571428571,1,1,1,596503,9107,97825,10131,0.084358442328356,0.5266139931385799
35045,0.8641666666666665,0,11,0,596514,9096,97825,10131,0.0842565489643929,0.5269152753939772
35046,0.8641666666666667,3,6,3,596520,9090,97828,10128,0.08420097076586758,0.5270059319388074
35047,0.8642142857142856,1,0,1,596520,9090,97829,10127,0.08420097076586758,0.5269813186241349
35048,0.86425,0,1,0,596521,9089,97829,10127,0.08419170773278002,0.5270087427144047
35049,0.8642500000000001,0,1,0,596522,9088,97829,10127,0.08418244469969247,0.5270361696591205
35050,0.8642619047619047,0,2,0,596524,9086,97829,10127,0.08416391863351735,0.527091032113673
35051,0.8643333333333332,2,3,2,596527,9083,97831,10125,0.0841361295342547,0.5271241149521033
35052,0.8643333333333334,3,4,3,596531,9079,97834,10122,0.08409907740190448,0.5271600437477215
35053,0.8643333333333335,0,2,0,596533,9077,97834,10122,0.08408055133572936,0.5272149591124538
35054,0.8643809523809522,0,1,0,596534,9076,97834,10122,0.08407128830264182,0.5272424210855298
35055,0.864440476190476,0,1,0,596535,9075,97834,10122,0.08406202526955427,0.5272698859196749
35056,0.8644761904761904,0,2,0,596537,9073,97834,10122,0.08404349920337915,0.5273248241729617
35057,0.8644999999999999,2,0,2,596537,9073,97836,10120,0.08404349920337915,0.527275569217944
35058,0.8645,1,1,1,596538,9072,97837,10119,0.0840342361702916,0.5272784117555104
35059,0.8645238095238096,1,1,1,596539,9071,97838,10118,0.08402497313720404,0.5272812548856115
35060,0.8645714285714285,0,1,0,596540,9070,97838,10118,0.08401571010411649,0.5273087346258079
35061,0.8645833333333336,0,1,0,596541,9069,97838,10118,0.08400644707102894,0.5273362172304165
35062,0.864595238095238,0,1,0,596542,9068,97838,10118,0.08399718403794139,0.5273637026998853
35063,0.8646190476190476,1,0,1,596542,9068,97839,10117,0.08399718403794139,0.527339066979411
35064,0.864642857142857,0,1,0,596543,9067,97839,10117,0.08398792100485383,0.5273665554628857
35065,0.8646666666666666,0,1,0,596544,9066,97839,10117,0.08397865797176628,0.5273940468122817
35066,0.8646666666666667,2,4,2,596548,9062,97841,10115,0.08394160583941605,0.5274547635187986
35067,0.8648095238095237,0,1,0,596549,9061,97841,10115,0.08393234280632851,0.5274822695035462
35068,0.8648333333333332,0,1,0,596550,9060,97841,10115,0.08392307977324096,0.527509778357236
35069,0.8648333333333333,0,2,0,596552,9058,97841,10115,0.08390455370706584,0.5275648046732384
35070,0.864857142857143,0,1,0,596553,9057,97841,10115,0.08389529067397829,0.527592322136449
35071,0.8648928571428571,0,1,0,596554,9056,97841,10115,0.08388602764089073,0.527619842470398
35072,0.8649999999999999,1,7,1,596561,9049,97842,10114,0.08382118640927785,0.5277879246464541
35073,0.865,133,170,133,596731,8879,97975,9981,0.08224647078439364,0.5292152704135737
35074,0.8650000000000001,1,2,1,596733,8877,97976,9980,0.08222794471821854,0.5292464336851037
35075,0.8650862585556854,1,6,1,596739,8871,97977,9979,0.0821723665196932,0.5293899204244031
35076,0.8651428571428572,1,0,1,596739,8871,97978,9978,0.0821723665196932,0.5293649530479071
35077,0.8651666666666665,0,1,0,596740,8870,97978,9978,0.08216310348660566,0.529393039049236
35078,0.8651666666666666,1,1,1,596741,8869,97979,9977,0.0821538404535181,0.5293961583359864
35079,0.8651666666666668,2,1,2,596742,8868,97981,9975,0.08214457742043055,0.5293743034548639
35080,0.8652380952380951,0,1,0,596743,8867,97981,9975,0.08213531438734299,0.5294023988960832
35081,0.8652777777777777,1,0,1,596743,8867,97982,9974,0.08213531438734299,0.5293774215805955
35082,0.8653333333333333,1,4,1,596747,8863,97983,9973,0.08209826225499277,0.5294648545338713
35083,0.8653333333333335,1,0,1,596747,8863,97984,9972,0.08209826225499277,0.529439872577648
35084,0.8654523809523809,0,1,0,596748,8862,97984,9972,0.08208899922190523,0.5294679834342148
35085,0.8654761904761906,0,1,0,596749,8861,97984,9972,0.08207973618881767,0.529496097276058
35086,0.8654999999999999,1,1,1,596750,8860,97985,9971,0.08207047315573011,0.5294992299930965
35087,0.8655555555555555,0,1,0,596751,8859,97985,9971,0.08206121012264256,0.5295273499734466
35088,0.8656349206349205,0,1,0,596752,8858,97985,9971,0.082051947089555,0.5295554729406766
35089,0.8656666666666666,0,1,0,596753,8857,97985,9971,0.08204268405646745,0.5295835988952624
35090,0.8656666666666668,0,1,0,596754,8856,97985,9971,0.08203342102337989,0.52961172783768
35091,0.8657142857142857,0,2,0,596756,8854,97985,9971,0.08201489495720479,0.529667994687915
35092,0.8657857142857143,2,0,2,596756,8854,97987,9969,0.08201489495720479,0.5296180205068267
35093,0.8658333333333332,5,10,5,596766,8844,97992,9964,0.08192226462632925,0.5297745640153126
35094,0.8658333333333335,3,3,3,596769,8841,97995,9961,0.08189447552706658,0.5297840655249442
35095,0.8658690476190476,0,3,0,596772,8838,97995,9961,0.08186668642780393,0.5298686100324486
35096,0.8658928571428572,1,0,1,596772,8838,97996,9960,0.08186668642780393,0.5298436003830195
35097,0.8659761904761905,0,1,0,596773,8837,97996,9960,0.08185742339471637,0.5298717880512848
35098,0.866,14,15,14,596788,8822,98010,9946,0.08171847789840306,0.5299445865302643
35099,0.8660000000000001,0,1,0,596789,8821,98010,9946,0.0817092148653155,0.529972824638994
35100,0.8660555555555557,0,1,0,596790,8820,98010,9946,0.08169995183222795,0.5300010657572205
35101,0.8660714285714285,0,3,0,596793,8817,98010,9946,0.08167216273296528,0.5300858071736929
35102,0.8660714285714286,0,1,0,596794,8816,98010,9946,0.08166289969987772,0.5301140603347191
35103,0.8660833333333332,0,1,0,596795,8815,98010,9946,0.08165363666679018,0.5301423165076489
35104,0.8660952331981743,1,2,1,596797,8813,98011,9945,0.08163511060061507,0.5301737925151935
35105,0.8661388888888888,0,1,0,596798,8812,98011,9945,0.08162584756752751,0.5302020578983846
35106,0.8661666666666666,1,0,1,596798,8812,98012,9944,0.08162584756752751,0.5301770100234592
35107,0.8661666666666668,0,1,0,596799,8811,98012,9944,0.08161658453443996,0.5302052785923753
35108,0.8661904761904762,0,1,0,596800,8810,98012,9944,0.0816073215013524,0.5302335501759624
35109,0.8662222222222219,0,1,0,596801,8809,98012,9944,0.08159805846826484,0.5302618247747027
35110,0.86625,1,0,1,596801,8809,98013,9943,0.08159805846826484,0.5302367747440273
35111,0.8662619047619047,0,1,0,596802,8808,98013,9943,0.08158879543517729,0.5302650525305317
35112,0.8663333333333333,0,2,0,596804,8806,98013,9943,0.08157026936900219,0.5303216171529148
35113,0.8663333333333334,1,0,1,596804,8806,98014,9942,0.08157026936900219,0.5302965649669298
35114,0.8663333333333335,1,0,1,596804,8806,98015,9941,0.08157026936900219,0.530271510108284
35115,0.8664285714285712,1,1,1,596805,8805,98016,9940,0.08156100633591463,0.5302747399306482
35116,0.8664523809523809,0,1,0,596806,8804,98016,9940,0.08155174330282708,0.5303030303030303
35117,0.8664563492063492,2,2,2,596808,8802,98018,9938,0.08153321723665197,0.5303094983991462
35118,0.8664880952380952,0,1,0,596809,8801,98018,9938,0.08152395420356441,0.5303377981749293
35119,0.8664999999999999,1,2,1,596811,8799,98019,9937,0.08150542813738931,0.530369342442357
35120,0.8665,1,1,1,596812,8798,98020,9936,0.08149616510430176,0.53037258460553
35121,0.8665277777777779,1,1,1,596813,8797,98021,9935,0.0814869020712142,0.5303758274610293
35122,0.8666230158730157,3,0,3,596813,8797,98024,9932,0.0814869020712142,0.5303006033424101
35123,0.8666428571428572,0,1,0,596814,8796,98024,9932,0.08147763903812665,0.5303289192652713
35124,0.8666428571428573,1,0,1,596814,8796,98025,9931,0.08147763903812665,0.5303038393763015
35125,0.8666666666666666,28,37,28,596851,8759,98053,9903,0.08113490681388714,0.5306505197728003
35126,0.8666666666666667,38,51,38,596902,8708,98091,9865,0.08066249212642188,0.531147364453777
35127,0.8666666666666668,0,1,0,596903,8707,98091,9865,0.08065322909333432,0.531175963816498
35128,0.8667857142857143,0,1,0,596904,8706,98091,9865,0.08064396606024676,0.5312045662592214
35129,0.8668174603174604,1,1,1,596905,8705,98092,9864,0.08063470302715921,0.5312079271904787
35130,0.8668333333333332,1,0,1,596905,8705,98093,9863,0.08063470302715921,0.5311826798793623
35131,0.8668333333333333,2,1,2,596906,8704,98095,9861,0.08062543999407167,0.5311607864260706
35132,0.8668484848484849,0,2,0,596908,8702,98095,9861,0.08060691392789655,0.5312180143295804
35133,0.8669166666666667,1,2,1,596910,8700,98096,9860,0.08058838786172144,0.53125
35134,0.8669444444444444,0,1,0,596911,8699,98096,9860,0.08057912482863389,0.5312786249259119
35135,0.8669523809523809,0,2,0,596913,8697,98096,9860,0.08056059876245877,0.5313358840329795
35136,0.8669761904761905,0,1,0,596914,8696,98096,9860,0.08055133572937123,0.5313645182151325
35137,0.8669999999999999,1,0,1,596914,8696,98097,9859,0.08055133572937123,0.5313392616545406
35138,0.867,1,4,1,596918,8692,98098,9858,0.08051428359702101,0.5314285714285715
35139,0.8670714285714286,0,1,0,596919,8691,98098,9858,0.08050502056393345,0.5314572214135533
35140,0.8671190476190476,0,1,0,596920,8690,98098,9858,0.0804957575308459,0.5314858744878154
35141,0.8671428571428571,1,1,1,596921,8689,98099,9857,0.08048649449775834,0.5314892699234336
35142,0.8671428571428572,3,1,3,596922,8688,98102,9854,0.0804772314646708,0.5314421313774135
35143,0.8671666666666665,0,1,0,596923,8687,98102,9854,0.08046796843158324,0.531470794455531
35144,0.8671666666666666,2,0,2,596923,8687,98104,9852,0.08046796843158324,0.5314202492043799
35145,0.8671666666666669,1,0,1,596923,8687,98105,9851,0.08046796843158324,0.5313949724889416
35146,0.8672142857142856,1,0,1,596923,8687,98106,9850,0.08046796843158324,0.5313696930463397
35147,0.8673333333333332,0,1,0,596924,8686,98106,9850,0.08045870539849569,0.5313983599482089
35148,0.8673333333333333,2,10,2,596934,8676,98108,9848,0.08036607506762014,0.5316346361477002
35149,0.8673333333333335,0,1,0,596935,8675,98108,9848,0.08035681203453258,0.5316633374723317
35150,0.8673809523809523,0,1,0,596936,8674,98108,9848,0.08034754900144503,0.5316920418961235
35151,0.8673888888888888,0,1,0,596937,8673,98108,9848,0.08033828596835747,0.5317207494195778
35152,0.8674761904761904,1,0,1,596937,8673,98109,9847,0.08033828596835747,0.531695464362851
35153,0.8674761904761905,0,1,0,596938,8672,98109,9847,0.08032902293526993,0.5317241751714455
35154,0.8675,34,35,34,596973,8637,98143,9813,0.08000481677720553,0.531869918699187
35155,0.8675000000000002,1,1,1,596974,8636,98144,9812,0.07999555374411797,0.5318733738074588
35156,0.8675974025974027,0,1,0,596975,8635,98144,9812,0.07998629071103042,0.531902206320811
35157,0.8676190476190476,0,1,0,596976,8634,98144,9812,0.07997702767794286,0.5319310419603166
35158,0.8676190476190477,1,0,1,596976,8634,98145,9811,0.07997702767794286,0.5319056654920032
35159,0.8676428571428572,1,0,1,596976,8634,98146,9810,0.07997702767794286,0.5318802862719584
35160,0.8676666666666667,2,3,2,596979,8631,98148,9808,0.0799492385786802,0.5319160475079994
35161,0.8676666666666668,1,0,1,596979,8631,98149,9807,0.0799492385786802,0.5318906605922551
35162,0.8677142857142855,0,1,0,596980,8630,98149,9807,0.07993997554559265,0.5319195096816185
35163,0.8677142857142858,0,2,0,596982,8628,98149,9807,0.07992144947941754,0.5319772172497966
35164,0.86775,1,0,1,596982,8628,98150,9806,0.07992144947941754,0.5319518281436476
35165,0.8678015873015873,0,2,0,596984,8626,98150,9806,0.07990292341324243,0.5320095486111112
35166,0.8678095238095238,0,2,0,596986,8624,98150,9806,0.07988439734706733,0.5320672816060771
35167,0.86782683982684,1,0,1,596986,8624,98151,9805,0.07988439734706733,0.5320418904986706
35168,0.8678333333333335,1,1,1,596987,8623,98152,9804,0.07987513431397977,0.5320453682096923
35169,0.8678571428571428,1,0,1,596987,8623,98153,9803,0.07987513431397977,0.532019971779008
35170,0.8678571428571429,0,1,0,596988,8622,98153,9803,0.07986587128089222,0.5320488466757124
35171,0.868,7,3,7,596991,8619,98160,9796,0.07983808218162955,0.5319576432256313
35172,0.8680000000000001,0,1,0,596992,8618,98160,9796,0.079828819148542,0.531986531986532
35173,0.8681111111111111,0,1,0,596993,8617,98160,9796,0.07981955611545444,0.5320154238852984
35174,0.8681666666666666,3,7,3,597000,8610,98163,9793,0.07975471488384156,0.5321414986686953
35175,0.8681785714285712,0,3,0,597003,8607,98163,9793,0.0797269257845789,0.5322282608695652
35176,0.8682142857142857,0,1,0,597004,8606,98163,9793,0.07971766275149135,0.5322571878906462
35177,0.8683333333333333,11,9,11,597013,8597,98174,9782,0.07963429545370336,0.5322378801893466
35178,0.8683333333333334,12,11,12,597024,8586,98186,9770,0.07953240208974026,0.5322510350838963
35179,0.8684999999999999,1,2,1,597026,8584,98187,9769,0.07951387602356516,0.5322835503732359
35180,0.8685,1,1,1,597027,8583,98188,9768,0.0795046129904776,0.5322870688245872
35181,0.8685238095238096,0,1,0,597028,8582,98188,9768,0.07949534995739005,0.5323160762942779
35182,0.8685476190476191,0,2,0,597030,8580,98188,9768,0.07947682389121494,0.5323741007194245
35183,0.8685714285714284,1,0,1,597030,8580,98189,9767,0.07947682389121494,0.5323486128522374
35184,0.8685714285714287,0,1,0,597031,8579,98189,9767,0.07946756085812738,0.5323776300010902
35185,0.8686666666666666,0,1,0,597032,8578,98189,9767,0.07945829782503983,0.5324066503134369
35186,0.8686666666666667,0,2,0,597034,8576,98189,9767,0.07943977175886473,0.5324647004306821
35187,0.8687380952380953,0,2,0,597036,8574,98189,9767,0.07942124569268962,0.532522763208113
35188,0.8687456819066726,1,4,1,597040,8570,98190,9766,0.07938419356033939,0.5326134380453752
35189,0.8687489177489178,1,0,1,597040,8570,98191,9765,0.07938419356033939,0.5325879465503136
35190,0.86875,2,0,2,597040,8570,98193,9763,0.07938419356033939,0.5325369552173675
35191,0.8687500000000001,0,2,0,597042,8568,98193,9763,0.0793656674941643,0.5325950575527795
35192,0.868857142857143,0,1,0,597043,8567,98193,9763,0.07935640446107674,0.5326241134751774
35193,0.8688888888888888,1,0,1,597043,8567,98194,9762,0.07935640446107674,0.532598614217906
35194,0.868993783993784,0,1,0,597044,8566,98194,9762,0.07934714142798918,0.5326276735050196
35195,0.8690000000000001,7,6,7,597050,8560,98201,9755,0.07929156322946386,0.5326235326235326
35196,0.8690295815295812,0,2,0,597052,8558,98201,9755,0.07927303716328875,0.5326817015235079
35197,0.8690476190476188,0,1,0,597053,8557,98201,9755,0.07926377413020119,0.5327107907383136
35198,0.8690714285714287,1,0,1,597053,8557,98202,9754,0.07926377413020119,0.53268527114849
35199,0.8691309523809524,0,1,0,597054,8556,98202,9754,0.07925451109711364,0.5327143637356636
35200,0.869142857142857,0,1,0,597055,8555,98202,9754,0.07924524806402608,0.5327434595007919
35201,0.8691666666666665,4,14,4,597069,8541,98206,9750,0.07911556560080032,0.5330490405117271
35202,0.8691666666666668,4,6,4,597075,8535,98210,9746,0.079059987402275,0.5331218204693398
35203,0.86925,0,1,0,597076,8534,98210,9746,0.07905072436918745,0.5331509846827134
35204,0.8693333333333332,1,1,1,597077,8533,98211,9745,0.07904146133609989,0.5331546121019806
35205,0.8693333333333334,3,2,3,597079,8531,98214,9742,0.07902293526992478,0.5331363213484376
35206,0.869376984126984,0,1,0,597080,8530,98214,9742,0.07901367223683722,0.5331654991243433
35207,0.8693888888888889,0,1,0,597081,8529,98214,9742,0.07900440920374968,0.5331946800941383
35208,0.8694404761904759,1,0,1,597081,8529,98215,9741,0.07900440920374968,0.5331691297208538
35209,0.8695,1,2,1,597083,8527,98216,9740,0.07898588313757457,0.5332019488695462
35210,0.8695833333333334,1,0,1,597083,8527,98217,9739,0.07898588313757457,0.5331763932990256
35211,0.8696666666666667,2,1,2,597084,8526,98219,9737,0.07897662010448701,0.5331544653123802
35212,0.8697142857142858,1,0,1,597084,8526,98220,9736,0.07897662010448701,0.5331289015441901
35213,0.8697619047619048,0,1,0,597085,8525,98220,9736,0.07896735707139946,0.533158096489787
35214,0.8698333333333333,1,1,1,597086,8524,98221,9735,0.0789580940383119,0.533161728462676
35215,0.8698809523809524,0,1,0,597087,8523,98221,9735,0.07894883100522435,0.5331909300032862
35216,0.8699166666666666,1,0,1,597087,8523,98222,9734,0.07894883100522435,0.5331653612313085
35217,0.8699523809523809,1,0,1,597087,8523,98223,9733,0.07894883100522435,0.5331397896581945
35218,0.8699999999999999,2,1,2,597088,8522,98225,9731,0.07893956797213679,0.533117843642141
35219,0.87,626,624,626,597712,7898,98851,9105,0.07315943532550298,0.535493736399459
35220,0.8700000000000001,0,3,0,597715,7895,98851,9105,0.07313164622624033,0.5355882352941177
35221,0.8701428571428572,0,1,0,597716,7894,98851,9105,0.07312238319315277,0.5356197423377845
35222,0.8701666666666665,1,1,1,597717,7893,98852,9104,0.07311312016006521,0.5356239336353474
35223,0.8701666666666666,1,2,1,597719,7891,98853,9103,0.0730945940938901,0.5356596445804401
35224,0.8701904761904761,0,1,0,597720,7890,98853,9103,0.07308533106080255,0.5356911669510975
35225,0.8702023809523809,0,1,0,597721,7889,98853,9103,0.07307606802771499,0.535722693032015
35226,0.8702142857142857,0,1,0,597722,7888,98853,9103,0.07306680499462744,0.5357542228238479
35227,0.8702604617604618,0,1,0,597723,7887,98853,9103,0.07305754196153989,0.5357857563272513
35228,0.8702669552669552,0,1,0,597724,7886,98853,9103,0.07304827892845234,0.5358172935428807
35229,0.8702896825396826,1,1,1,597725,7885,98854,9102,0.07303901589536478,0.5358215105669041
35230,0.8703333333333333,0,1,0,597726,7884,98854,9102,0.07302975286227723,0.5358530554574356
35231,0.8703333333333334,1,2,1,597728,7882,98855,9101,0.07301122679610211,0.535888830006477
35232,0.8703571428571428,1,1,1,597729,7881,98856,9100,0.07300196376301456,0.5358930569459984
35233,0.8703809523809524,0,1,0,597730,7880,98856,9100,0.072992700729927,0.535924617196702
35234,0.8704166666666667,0,1,0,597731,7879,98856,9100,0.07298343769683946,0.5359561811649685
35235,0.8704285714285716,0,1,0,597732,7878,98856,9100,0.0729741746637519,0.5359877488514548
35236,0.8704999999999998,1,0,1,597732,7878,98857,9099,0.0729741746637519,0.5359604170348118
35237,0.8704999999999999,2,1,2,597733,7877,98859,9097,0.07296491163066435,0.5359373158948981
35238,0.8705000000000002,1,0,1,597733,7877,98860,9096,0.07296491163066435,0.5359099746656454
35239,0.8705454545454545,0,1,0,597734,7876,98860,9096,0.07295564859757679,0.5359415507895358
35240,0.870547619047619,0,1,0,597735,7875,98860,9096,0.07294638556448924,0.5359731306346119
35241,0.8706666666666665,1,1,1,597736,7874,98861,9095,0.07293712253140168,0.5359773704991455
35242,0.8706666666666666,3,1,3,597737,7873,98864,9092,0.07292785949831412,0.5359269083407014
35243,0.8706666666666668,0,2,0,597739,7871,98864,9092,0.07290933343213903,0.5359900960914933
35244,0.8706666666666669,0,1,0,597740,7870,98864,9092,0.07290007039905147,0.5360216955547695
35245,0.8707142857142854,1,0,1,597740,7870,98865,9091,0.07290007039905147,0.5359943399563705
35246,0.8707142857142856,0,1,0,597741,7869,98865,9091,0.07289080736596391,0.5360259433962264
35247,0.8707142857142857,0,1,0,597742,7868,98865,9091,0.07288154433287636,0.5360575505631229
35248,0.8707222222222222,1,0,1,597742,7868,98866,9090,0.07288154433287636,0.5360301922396509
35249,0.8707261904761903,1,0,1,597742,7868,98867,9089,0.07288154433287636,0.5360028306893908
35250,0.8707777777777777,0,1,0,597743,7867,98867,9089,0.0728722812997888,0.5360344420853975
35251,0.8708333333333332,3,7,3,597750,7860,98870,9086,0.07280744006817592,0.5361737283134663
35252,0.8708333333333335,0,2,0,597752,7858,98870,9086,0.07278891400200081,0.5362370160528801
35253,0.8708809523809525,1,0,1,597752,7858,98871,9085,0.07278891400200081,0.5362096441008086
35254,0.8709166666666667,1,1,1,597753,7857,98872,9084,0.07277965096891326,0.5362139188949885
35255,0.8709444444444443,1,0,1,597753,7857,98873,9083,0.07277965096891326,0.5361865407319952
35256,0.8709999999999998,1,0,1,597753,7857,98874,9082,0.07277965096891326,0.5361591593364425
35257,0.871,5,5,5,597758,7852,98879,9077,0.07273333580347549,0.5361805186366589
35258,0.8710238095238094,0,1,0,597759,7851,98879,9077,0.07272407277038793,0.5362121928166351
35259,0.8710436507936505,0,3,0,597762,7848,98879,9077,0.07269628367112527,0.5363072378138848
35260,0.8710476190476188,0,1,0,597763,7847,98879,9077,0.07268702063803772,0.53633892696762
35261,0.871047619047619,0,1,0,597764,7846,98879,9077,0.07267775760495017,0.536370619866454
35262,0.8710714285714286,1,0,1,597764,7846,98880,9076,0.07267775760495017,0.5363432218413899
35263,0.8711904761904762,0,1,0,597765,7845,98880,9076,0.07266849457186261,0.5363749187400272
35264,0.8712142857142857,0,1,0,597766,7844,98880,9076,0.07265923153877506,0.5364066193853428
35265,0.8712499999999999,0,1,0,597767,7843,98880,9076,0.0726499685056875,0.536438323778001
35266,0.8713333333333333,1,4,1,597771,7839,98881,9075,0.07261291637333729,0.536537779354381
35267,0.8713531746031744,2,0,2,597771,7839,98883,9073,0.07261291637333729,0.5364829706717124
35268,0.8714285714285714,1,0,1,597771,7839,98884,9072,0.07261291637333729,0.5364555614688664
35269,0.8714999999999999,1,2,1,597773,7837,98885,9071,0.07259439030716218,0.5364916016087059
35270,0.8715,4,4,4,597777,7833,98889,9067,0.07255733817481196,0.536508875739645
35271,0.8715151515151515,0,1,0,597778,7832,98889,9067,0.0725480751417244,0.5365406237055447
35272,0.8716190476190476,1,0,1,597778,7832,98890,9066,0.0725480751417244,0.536513196828027
35273,0.8716208791208796,1,1,1,597779,7831,98891,9065,0.07253881210863686,0.5365175189393939
35274,0.8716666666666666,13,18,13,597797,7813,98904,9052,0.07237207751306088,0.5367328787429588
35275,0.8716666666666667,9,19,9,597816,7794,98913,9043,0.07219607988439734,0.5370909306883649
35276,0.8716666666666668,1,0,1,597816,7794,98914,9042,0.07219607988439734,0.5370634354953671
35277,0.8716937229437228,0,1,0,597817,7793,98914,9042,0.07218681685130979,0.5370953370953371
35278,0.8717142857142858,0,1,0,597818,7792,98914,9042,0.07217755381822225,0.5371272424854461
35279,0.87175,1,1,1,597819,7791,98915,9041,0.07216829078513469,0.5371316539923955
35280,0.8718333333333332,1,1,1,597820,7790,98916,9040,0.07215902775204713,0.5371360665478313
35281,0.8718333333333333,2,5,2,597825,7785,98918,9038,0.07211271258660935,0.5372406823990965
35282,0.8719047619047618,1,0,1,597825,7785,98919,9037,0.07211271258660935,0.537213173225538
35283,0.872,4,10,4,597835,7775,98923,9033,0.07202008225573382,0.5374226558781533
35284,0.872047619047619,1,0,1,597835,7775,98924,9032,0.07202008225573382,0.5373951329803058
35285,0.8721212121212119,1,1,1,597836,7774,98925,9031,0.07201081922264627,0.5373995834573043
35286,0.872126984126984,3,0,3,597836,7774,98928,9028,0.07201081922264627,0.5373169860730865
35287,0.8721428571428571,1,1,1,597837,7773,98929,9027,0.07200155618955871,0.5373214285714286
35288,0.8721428571428572,2,1,2,597838,7772,98931,9025,0.07199229315647115,0.537298327082217
35289,0.8721666666666666,1,3,1,597841,7769,98932,9024,0.07196450405720849,0.5373667599595069
35290,0.8722380952380953,1,0,1,597841,7769,98933,9023,0.07196450405720849,0.537339209147213
35291,0.8723333333333332,1,1,1,597842,7768,98934,9022,0.07195524102412094,0.5373436569386539
35292,0.8723333333333333,5,3,5,597845,7765,98939,9017,0.07192745192485828,0.537301871052318
35293,0.8723333333333335,1,1,1,597846,7764,98940,9016,0.07191818889177072,0.5373063170441001
35294,0.8724444444444444,0,2,0,597848,7762,98940,9016,0.07189966282559561,0.5373703659554178
35295,0.8724761904761905,0,1,0,597849,7761,98940,9016,0.07189039979250805,0.5374023961375692
35296,0.8724999999999998,2,2,2,597851,7759,98942,9014,0.07187187372633295,0.5374113158051631
35297,0.8725,34,28,34,597879,7731,98976,8980,0.07161250879988143,0.5373705942193765
35298,0.8725000000000002,1,0,1,597879,7731,98977,8979,0.07161250879988143,0.5373429084380611
35299,0.8725714285714287,0,1,0,597880,7730,98977,8979,0.07160324576679387,0.5373750673289844
35300,0.8726666666666667,1,6,1,597886,7724,98978,8978,0.07154766756826855,0.5375404143216381
35301,0.8726666666666668,1,2,1,597888,7722,98979,8977,0.07152914150209344,0.5375771004251751
35302,0.8727142857142858,0,1,0,597889,7721,98979,8977,0.07151987846900588,0.5376092945262906
35303,0.8727380952380952,0,1,0,597890,7720,98979,8977,0.07151061543591834,0.5376414924836797
35304,0.8727619047619047,0,1,0,597891,7719,98979,8977,0.07150135240283079,0.5376736942980355
35305,0.8728333333333333,0,2,0,597893,7717,98979,8977,0.07148282633665567,0.5377381095004193
35306,0.8728333333333335,1,3,1,597896,7714,98980,8976,0.07145503723739301,0.5378070701018574
35307,0.8728571428571428,1,3,1,597899,7711,98981,8975,0.07142724813813035,0.5378760637660314
35308,0.8729166666666666,0,1,0,597900,7710,98981,8975,0.0714179851050428,0.5379083008690441
35309,0.8729166666666669,1,0,1,597900,7710,98982,8974,0.0714179851050428,0.5378806041716615
35310,0.8729285714285713,0,1,0,597901,7709,98982,8974,0.07140872207195524,0.5379128454114968
35311,0.8729999999999998,1,1,1,597902,7708,98983,8973,0.07139945903886769,0.5379173910437024
35312,0.873,2,3,2,597905,7705,98985,8971,0.07137166993960502,0.5379587431038618
35313,0.8730000000000001,1,0,1,597905,7705,98986,8970,0.07137166993960502,0.5379310344827586
35314,0.8731309523809524,1,0,1,597905,7705,98987,8969,0.07137166993960502,0.5379033225380833
35315,0.8731666666666666,4,1,4,597906,7704,98991,8965,0.07136240690651748,0.5378247045413642
35316,0.8732142857142857,1,1,1,597907,7703,98992,8964,0.07135314387342992,0.5378292434151317
35317,0.8732177033492823,0,1,0,597908,7702,98992,8964,0.07134388084034236,0.5378615144605784
35318,0.8732539682539682,1,0,1,597908,7702,98993,8963,0.07134388084034236,0.5378337833783379
35319,0.8733333333333333,29,42,29,597950,7660,99022,8934,0.07095483345066508,0.5383873689285283
35320,0.8733333333333334,26,27,26,597977,7633,99048,8908,0.07070473155730113,0.538540596094553
35321,0.8734166666666667,1,0,1,597977,7633,99049,8907,0.07070473155730113,0.5385126964933494
35322,0.8734999999999999,1,2,1,597979,7631,99050,8906,0.07068620549112602,0.5385499183648788
35323,0.8735714285714287,0,2,0,597981,7629,99050,8906,0.0706676794249509,0.5386150589658301
35324,0.8735833333333334,0,1,0,597982,7628,99050,8906,0.07065841639186335,0.538647635176001
35325,0.8736666666666665,1,0,1,597982,7628,99051,8905,0.07065841639186335,0.5386197302364967
35326,0.8736666666666666,1,2,1,597984,7626,99052,8904,0.07063989032568824,0.5386569872958258
35327,0.8736666666666667,0,3,0,597987,7623,99052,8904,0.07061210122642558,0.5387547649301143
35328,0.8736818181818182,0,1,0,597988,7622,99052,8904,0.07060283819333803,0.5387873653636693
35329,0.8737380952380951,0,2,0,597990,7620,99052,8904,0.07058431212716292,0.5388525780682644
35330,0.87375,2,2,2,597992,7618,99054,8902,0.0705657860609878,0.5388619854721549
35331,0.8737777777777777,0,2,0,597994,7616,99054,8902,0.0705472599948127,0.5389272308996247
35332,0.8738333333333332,0,1,0,597995,7615,99054,8902,0.07053799696172515,0.5389598595386571
35333,0.8738333333333334,0,1,0,597996,7614,99054,8902,0.0705287339286376,0.5389924921288447
35334,0.8739999999999999,0,1,0,597997,7613,99054,8902,0.07051947089555004,0.5390251286709052
35335,0.8740000000000001,10,20,10,598017,7593,99064,8892,0.07033421023379896,0.5393994540491356
35336,0.8741666666666665,2,9,2,598026,7584,99066,8890,0.07025084293601097,0.5396382177977419
35337,0.8741666666666668,11,4,11,598030,7580,99077,8879,0.07021379080366075,0.539461692690929
35338,0.8741666666666669,1,0,1,598030,7580,99078,8878,0.07021379080366075,0.5394337100498238
35339,0.8742142857142856,0,1,0,598031,7579,99078,8878,0.07020452777057319,0.5394664884243787
35340,0.87425,0,1,0,598032,7578,99078,8878,0.07019526473748565,0.5394992707826932
35341,0.8742500000000001,0,1,0,598033,7577,99078,8878,0.0701860017043981,0.5395320571254938
35342,0.8742857142857143,0,1,0,598034,7576,99078,8878,0.07017673867131054,0.5395648474535067
35343,0.8743095238095238,0,1,0,598035,7575,99078,8878,0.07016747563822298,0.5395976417674588
35344,0.8743333333333332,0,1,0,598036,7574,99078,8878,0.07015821260513543,0.5396304400680768
35345,0.8743333333333334,2,1,2,598037,7573,99080,8876,0.07014894957204787,0.5396072709587209
35346,0.8744047619047618,0,1,0,598038,7572,99080,8876,0.07013968653896031,0.5396400778210116
35347,0.8744126984126983,0,1,0,598039,7571,99080,8876,0.07013042350587276,0.5396728886727062
35348,0.8744523809523809,0,1,0,598040,7570,99080,8876,0.07012116047278522,0.5397057035145324
35349,0.874452380952381,0,1,0,598041,7569,99080,8876,0.07011189743969766,0.539738522347218
35350,0.8744999999999998,0,1,0,598042,7568,99080,8876,0.0701026344066101,0.5397713451714912
35351,0.8745,1,2,1,598044,7566,99081,8875,0.07008410834043499,0.5398090140502403
35352,0.8745952380952382,0,1,0,598045,7565,99081,8875,0.07007484530734744,0.5398418491484185
35353,0.874642857142857,0,3,0,598048,7562,99081,8875,0.07004705620808478,0.5399403784145526
35354,0.8746666666666667,2,3,2,598051,7559,99083,8873,0.07001926710882211,0.5399829600778968
35355,0.8747222222222223,0,1,0,598052,7558,99083,8873,0.07001000407573456,0.5400158237477938
35356,0.8747499999999999,0,1,0,598053,7557,99083,8873,0.070000741042647,0.5400486914181376
35357,0.8747777777777779,0,1,0,598054,7556,99083,8873,0.06999147800955945,0.5400815630896585
35358,0.8748095238095237,1,0,1,598054,7556,99084,8872,0.06999147800955945,0.5400535670805942
35359,0.8748333333333334,2,1,2,598055,7555,99086,8870,0.06998221497647189,0.5400304414003044
35360,0.8749761904761906,1,0,1,598055,7555,99087,8869,0.06998221497647189,0.540002435460302
35361,0.875,140,138,140,598193,7417,99227,8729,0.06870391641038942,0.5406292580205624
35362,0.8750000000000001,4,6,4,598199,7411,99231,8725,0.0686483382118641,0.5407164105106594
35363,0.8750833333333332,0,1,0,598200,7410,99231,8725,0.06863907517877654,0.5407499225286644
35364,0.8750833333333334,0,1,0,598201,7409,99231,8725,0.06862981214568899,0.5407834387008801
35365,0.8751089466089467,1,4,1,598205,7405,99232,8724,0.06859276001333876,0.5408890817781635
35366,0.875142857142857,0,1,0,598206,7404,99232,8724,0.06858349698025121,0.5409226190476191
35367,0.8751428571428572,1,0,1,598206,7404,99233,8723,0.06858349698025121,0.5408941526632356
35368,0.8751666666666665,0,2,0,598208,7402,99233,8723,0.06856497091407611,0.5409612403100775
35369,0.8751666666666666,2,2,2,598210,7400,99235,8721,0.068546444847901,0.540971403759072
35370,0.8751904761904761,0,1,0,598211,7399,99235,8721,0.06853718181481344,0.5410049627791563
35371,0.8753333333333333,1,2,1,598213,7397,99236,8720,0.06851865574863833,0.5410436185394304
35372,0.8753333333333334,2,1,2,598214,7396,99238,8718,0.06850939271555077,0.541020230855157
35373,0.8753571428571431,0,1,0,598215,7395,99238,8718,0.06850012968246323,0.5410538074846397
35374,0.8753809523809521,0,1,0,598216,7394,99238,8718,0.06849086664937568,0.5410873882820258
35375,0.8754285714285714,0,1,0,598217,7393,99238,8718,0.06848160361628812,0.5411209732480914
35376,0.8754523809523808,0,2,0,598219,7391,99238,8718,0.06846307755011301,0.5411881556893662
35377,0.8755,4,5,4,598224,7386,99242,8714,0.06841676238467524,0.5412422360248447
35378,0.8755238095238095,1,1,1,598225,7385,99243,8713,0.06840749935158769,0.541247359920487
35379,0.8755595238095235,0,1,0,598226,7384,99243,8713,0.06839823631850013,0.5412809840342921
35380,0.8755714285714284,0,1,0,598227,7383,99243,8713,0.06838897328541257,0.5413146123260437
35381,0.8755952380952381,1,0,1,598227,7383,99244,8712,0.06838897328541257,0.5412861136999068
35382,0.8756666666666665,0,1,0,598228,7382,99244,8712,0.06837971025232502,0.541319746489375
35383,0.8756666666666666,2,2,2,598230,7380,99246,8710,0.0683611841861499,0.5413300186451212
35384,0.8756666666666668,0,2,0,598232,7378,99246,8710,0.06834265811997481,0.5413973147687717
35385,0.8757023809523808,0,1,0,598233,7377,99246,8710,0.06833339508688725,0.5414309691054889
35386,0.8757142857142857,2,3,2,598236,7374,99248,8708,0.06830560598762458,0.5414749409277453
35387,0.8757857142857145,1,0,1,598236,7374,99249,8707,0.06830560598762458,0.5414464274609788
35388,0.8758333333333331,0,1,0,598237,7373,99249,8707,0.06829634295453703,0.5414800995024875
35389,0.8758333333333332,2,4,2,598241,7369,99251,8705,0.06825929082218682,0.5415577951972129
35390,0.8758333333333335,3,9,3,598250,7360,99254,8702,0.06817592352439883,0.5417756194745361
35391,0.8758809523809525,1,0,1,598250,7360,99255,8701,0.06817592352439883,0.5417470892223398
35392,0.875952380952381,0,2,0,598252,7358,99255,8701,0.06815739745822372,0.541814558814372
35393,0.8759761904761904,1,0,1,598252,7358,99256,8700,0.06815739745822372,0.5417860256569934
35394,0.8759999999999999,14,14,14,598266,7344,99270,8686,0.06802771499499796,0.5418590143480974
35395,0.8760000000000001,1,1,1,598267,7343,99271,8685,0.0680184519619104,0.5418642375842276
35396,0.8760000000000002,0,1,0,598268,7342,99271,8685,0.06800918892882285,0.5418980470456105
35397,0.8760436507936508,0,2,0,598270,7340,99271,8685,0.06799066286264775,0.5419656786271451
35398,0.8761666666666664,0,1,0,598271,7339,99271,8685,0.0679813998295602,0.5419995007488767
35399,0.8761666666666666,0,2,0,598273,7337,99271,8685,0.06796287376338508,0.54206715765822
35400,0.8761904761904762,0,1,0,598274,7336,99271,8685,0.06795361073029753,0.5421009924474127
35401,0.8762976190476189,0,2,0,598276,7334,99271,8685,0.06793508466412242,0.5421686746987951
35402,0.8763333333333333,2,5,2,598281,7329,99273,8683,0.06788876949868465,0.542280789407944
35403,0.8763333333333334,1,3,1,598284,7326,99274,8682,0.06786098039942198,0.5423538230884558
35404,0.8763809523809524,1,0,1,598284,7326,99275,8681,0.06786098039942198,0.5423252327106891
35405,0.8765000000000001,1,0,1,598284,7326,99276,8680,0.06786098039942198,0.5422966387604649
35406,0.876547619047619,1,0,1,598284,7326,99277,8679,0.06786098039942198,0.5422680412371134
35407,0.8765714285714286,0,1,0,598285,7325,99277,8679,0.06785171736633443,0.5423019245188703
35408,0.8765714285714288,0,1,0,598286,7324,99277,8679,0.06784245433324688,0.5423358120352434
35409,0.8766031746031747,0,2,0,598288,7322,99277,8679,0.06782392826707177,0.5424035997750141
35410,0.8766111111111111,0,1,0,598289,7321,99277,8679,0.06781466523398422,0.5424375
35411,0.8766666666666666,18,36,18,598325,7285,99295,8661,0.06748119604283226,0.5431456164555375
35412,0.8766666666666667,32,27,32,598352,7258,99327,8629,0.0672310941494683,0.5431484861836722
35413,0.8766666666666668,2,0,2,598352,7258,99329,8627,0.0672310941494683,0.5430909663204281
35414,0.8767045454545455,0,1,0,598353,7257,99329,8627,0.06722183111638075,0.5431251573910854
35415,0.8767857142857143,1,1,1,598354,7256,99330,8626,0.06721256808329319,0.5431305880871427
35416,0.8769404761904761,1,0,1,598354,7256,99331,8625,0.06721256808329319,0.5431018197846483
35417,0.8769761904761902,1,0,1,598354,7256,99332,8624,0.06721256808329319,0.5430730478589421
35418,0.877,6,1,6,598355,7255,99338,8618,0.06720330505020564,0.5429345429345429
35419,0.877047619047619,0,1,0,598356,7254,99338,8618,0.06719404201711808,0.54296875
35420,0.8770476190476191,0,1,0,598357,7253,99338,8618,0.06718477898403052,0.5430029613760947
35421,0.8770952380952381,0,1,0,598358,7252,99338,8618,0.06717551595094298,0.5430371770636421
35422,0.8771428571428571,1,0,1,598358,7252,99339,8617,0.06717551595094298,0.5430083811204235
35423,0.8771428571428572,0,2,0,598360,7250,99339,8617,0.06715698988476787,0.5430768261170984
35424,0.8771666666666667,1,3,1,598363,7247,99340,8616,0.0671292007855052,0.5431507281094371
35425,0.877201465201465,1,0,1,598363,7247,99341,8615,0.0671292007855052,0.5431219266170723
35426,0.8772680375180374,2,0,2,598363,7247,99343,8613,0.0671292007855052,0.5430643127364438
35427,0.8773095238095239,0,1,0,598364,7246,99343,8613,0.06711993775241765,0.54309855602497
35428,0.8773333333333332,0,1,0,598365,7245,99343,8613,0.06711067471933009,0.5431328036322361
35429,0.8773333333333333,0,1,0,598366,7244,99343,8613,0.06710141168624255,0.5431670555590591
35430,0.877357142857143,1,1,1,598367,7243,99344,8612,0.06709214865315499,0.5431725007883949
35431,0.8774761904761905,0,1,0,598368,7242,99344,8612,0.06708288562006744,0.5432067617005172
35432,0.8774999999999998,1,1,1,598369,7241,99345,8611,0.06707362258697988,0.5432122129699722
35433,0.8775,29,39,29,598408,7202,99374,8582,0.06671236429656527,0.5437151545869234
35434,0.8775000000000002,1,1,1,598409,7201,99375,8581,0.06670310126347771,0.5437206944620454
35435,0.877547619047619,0,2,0,598411,7199,99375,8581,0.0666845751973026,0.5437896070975919
35436,0.8775714285714286,0,1,0,598412,7198,99375,8581,0.06667531216421504,0.5438240699664111
35437,0.8776190476190476,1,0,1,598412,7198,99376,8580,0.06667531216421504,0.5437951578146787
35438,0.8776666666666665,0,4,0,598416,7194,99376,8580,0.06663826003186483,0.5439330543933054
35439,0.8776666666666667,0,3,0,598419,7191,99376,8580,0.06661047093260217,0.544036522731596
35440,0.8777142857142857,0,1,0,598420,7190,99376,8580,0.06660120789951461,0.5440710209258085
35441,0.8777380952380952,1,1,1,598421,7189,99377,8579,0.06659194486642707,0.5440766108574328
35442,0.8778095238095238,1,1,1,598422,7188,99378,8578,0.06658268183333951,0.5440822022072815
35443,0.8778333333333334,0,5,0,598427,7183,99378,8578,0.06653636666790173,0.5442548061671214
35444,0.877904761904762,0,1,0,598428,7182,99378,8578,0.06652710363481418,0.5442893401015229
35445,0.8779642857142856,0,1,0,598429,7181,99378,8578,0.06651784060172664,0.5443238784186814
35446,0.878,7,9,7,598438,7172,99385,8571,0.06643447330393865,0.5444324461665502
35447,0.8780357142857141,1,0,1,598438,7172,99386,8570,0.06643447330393865,0.544403506543006
35448,0.8780476190476191,1,0,1,598438,7172,99387,8569,0.06643447330393865,0.5443745632424878
35449,0.8781190476190475,1,0,1,598438,7172,99388,8568,0.06643447330393865,0.5443456162642948
35450,0.8781666666666667,0,2,0,598440,7170,99388,8568,0.06641594723776353,0.5444147922226458
35451,0.8781666666666668,0,1,0,598441,7169,99388,8568,0.06640668420467598,0.5444493867954502
35452,0.8782380952380953,0,1,0,598442,7168,99388,8568,0.06639742117158842,0.5444839857651246
35453,0.87825,0,1,0,598443,7167,99388,8568,0.06638815813850087,0.5445185891325072
35454,0.8782857142857143,1,0,1,598443,7167,99389,8567,0.06638815813850087,0.5444896402694801
35455,0.8783095238095239,1,0,1,598443,7167,99390,8566,0.06638815813850087,0.5444606877264349
35456,0.8783333333333333,7,12,7,598455,7155,99397,8559,0.06627700174145022,0.5446735395189003
35457,0.8783333333333334,6,16,6,598471,7139,99403,8553,0.06612879321204936,0.5450548049961764
35458,0.8783809523809524,2,0,2,598471,7139,99405,8551,0.06612879321204936,0.5449968132568515
35459,0.8785,2,1,2,598472,7138,99407,8549,0.0661195301789618,0.544973544973545
35460,0.8785238095238096,0,1,0,598473,7137,99407,8549,0.06611026714587424,0.5450082876450338
35461,0.8785714285714286,1,1,1,598474,7136,99408,8548,0.06610100411278669,0.5450140270339199
35462,0.8786666666666667,3,8,3,598482,7128,99411,8545,0.06602689984808625,0.545205129841128
35463,0.8787142857142857,0,1,0,598483,7127,99411,8545,0.0660176368149987,0.5452399183256764
35464,0.8787380952380951,0,1,0,598484,7126,99411,8545,0.06600837378191114,0.5452747112500798
35465,0.8787500000000001,0,1,0,598485,7125,99411,8545,0.0659991107488236,0.5453095086151882
35466,0.8788095238095238,0,2,0,598487,7123,99411,8545,0.06598058468264849,0.5453791166709216
35467,0.8788095238095239,1,0,1,598487,7123,99412,8544,0.06598058468264849,0.5453500989340653
35468,0.8788333333333332,0,1,0,598488,7122,99412,8544,0.06597132164956093,0.5453849099961701
35469,0.8788571428571429,0,1,0,598489,7121,99412,8544,0.06596205861647338,0.545419725502713
35470,0.8788809523809523,1,2,1,598491,7119,99413,8543,0.06594353255029826,0.545460349891457
35471,0.8789999999999999,0,2,0,598493,7117,99413,8543,0.06592500648412317,0.5455300127713921
35472,0.879,2,1,2,598494,7116,99415,8541,0.06591574345103561,0.545506802069362
35473,0.879047619047619,1,0,1,598494,7116,99416,8540,0.06591574345103561,0.5454777721001532
35474,0.8791666666666665,4,11,4,598505,7105,99420,8536,0.06581385008707251,0.5457451569592737
35475,0.8791666666666668,7,2,7,598507,7103,99427,8529,0.0657953240208974,0.5456115660184238
35476,0.8792142857142857,1,0,1,598507,7103,99428,8528,0.0657953240208974,0.5455824963214125
35477,0.8792658730158729,2,1,2,598508,7102,99430,8526,0.06578606098780986,0.5455592526234962
35478,0.8792857142857141,0,1,0,598509,7101,99430,8526,0.0657767979547223,0.5455941639470148
35479,0.8793095238095239,0,1,0,598510,7100,99430,8526,0.06576753492163474,0.5456290797388967
35480,0.8793333333333332,0,3,0,598513,7097,99430,8526,0.06573974582237208,0.5457338539333034
35481,0.8793333333333334,0,5,0,598518,7092,99430,8526,0.06569343065693431,0.545908567038033
35482,0.8794166666666666,0,1,0,598519,7091,99430,8526,0.06568416762384675,0.5459435230838189
35483,0.8794444444444445,0,1,0,598520,7090,99430,8526,0.0656749045907592,0.5459784836065574
35484,0.8794761904761904,0,1,0,598521,7089,99430,8526,0.06566564155767164,0.5460134486071085
35485,0.8794999999999998,0,1,0,598522,7088,99430,8526,0.06565637852458409,0.5460484180863328
35486,0.8795000000000001,2,1,2,598523,7087,99432,8524,0.06564711549149653,0.5460252386137979
35487,0.8795238095238095,1,1,1,598524,7086,99433,8523,0.06563785245840899,0.5460311358831443
35488,0.8796049783549783,1,0,1,598524,7086,99434,8522,0.06563785245840899,0.546002050230651
35489,0.8796666666666666,1,2,1,598526,7084,99435,8521,0.06561932639223388,0.5460429349567446
35490,0.8796666666666667,0,1,0,598527,7083,99435,8521,0.06561006335914632,0.5460779287362215
35491,0.8796666666666668,0,1,0,598528,7082,99435,8521,0.06560080032605876,0.5461129270012177
35492,0.8797142857142856,0,1,0,598529,7081,99435,8521,0.06559153729297121,0.5461479297525959
35493,0.8797261904761906,0,1,0,598530,7080,99435,8521,0.06558227425988365,0.5461829369912186
35494,0.8797380952380951,0,1,0,598531,7079,99435,8521,0.0655730112267961,0.5462179487179487
35495,0.8798134920634919,0,1,0,598532,7078,99435,8521,0.06556374819370855,0.5462529649336496
35496,0.8798333333333332,0,1,0,598533,7077,99435,8521,0.065554485160621,0.5462879856391845
35497,0.8798333333333334,0,1,0,598534,7076,99435,8521,0.06554522212753344,0.5463230108354171
35498,0.8799523809523809,0,1,0,598535,7075,99435,8521,0.06553595909444589,0.5463580405232111
35499,0.8799999999999999,2,2,2,598537,7073,99437,8519,0.06551743302827077,0.5463699332991278
35500,0.88,656,567,656,599104,6506,100093,7863,0.06026529326762755,0.5472197090959705
35501,0.8800000000000001,2,1,2,599105,6505,100095,7861,0.06025603023454,0.5471947654183489
35502,0.8800454545454547,0,1,0,599106,6504,100095,7861,0.060246767201452445,0.5472328576400974
35503,0.8800595238095237,0,2,0,599108,6502,100095,7861,0.06022824113527733,0.5473090579962403
35504,0.8800793650793652,0,1,0,599109,6501,100095,7861,0.060218978102189784,0.5473471661328506
35505,0.8801190476190475,0,1,0,599110,6500,100095,7861,0.06020971506910223,0.5473852795766312
35506,0.8801190476190476,0,1,0,599111,6499,100095,7861,0.06020045203601467,0.5474233983286908
35507,0.8801439393939394,0,1,0,599112,6498,100095,7861,0.060191189002927116,0.5474615223901386
35508,0.8801666666666667,2,2,2,599114,6496,100097,7859,0.06017266293675201,0.5474747474747474
35509,0.8801666666666668,1,0,1,599114,6496,100098,7858,0.06017266293675201,0.5474432214016999
35510,0.8802380952380954,0,1,0,599115,6495,100098,7858,0.060163399903664455,0.5474813627813001
35511,0.8803928571428571,1,0,1,599115,6495,100099,7857,0.060163399903664455,0.5474498327759197
35512,0.8804365079365079,1,0,1,599115,6495,100100,7856,0.060163399903664455,0.5474182983764198
35513,0.8805,0,2,0,599117,6493,100100,7856,0.06014487383748935,0.5474945989267544
35514,0.8805000000000001,1,0,1,599117,6493,100101,7855,0.06014487383748935,0.5474630610538054
35515,0.8805952380952381,0,1,0,599118,6492,100101,7855,0.060135610804401794,0.5475012197671987
35516,0.8806666666666666,3,2,3,599120,6490,100104,7852,0.06011708473822668,0.5474829173058151
35517,0.8806666666666668,1,3,1,599123,6487,100105,7851,0.06008929563896402,0.5475659087738876
35518,0.8807142857142857,2,1,2,599124,6486,100107,7849,0.060080032605876466,0.5475409836065573
35519,0.8808333333333331,0,2,0,599126,6484,100107,7849,0.06006150653970136,0.5476173864508477
35520,0.8808333333333332,2,6,2,599132,6478,100109,7847,0.06000592834117603,0.547783595113438
35521,0.8808333333333335,6,5,6,599137,6473,100115,7841,0.059959613175738266,0.5477853849378231
35522,0.8809724303474304,0,1,0,599138,6472,100115,7841,0.05995035014265071,0.5478236568154824
35523,0.8809999999999998,1,1,1,599139,6471,100116,7840,0.059941087109563154,0.5478303402976731
35524,0.8809999999999999,4,2,4,599141,6469,100120,7836,0.05992256104338805,0.5477804963299545
35525,0.8810000000000001,4,4,4,599145,6465,100124,7832,0.05988550891103783,0.5478072322864936
35526,0.881047619047619,0,1,0,599146,6464,100124,7832,0.059876245877950277,0.5478455512031337
35527,0.8810714285714286,0,1,0,599147,6463,100124,7832,0.05986698284486272,0.5478838754809374
35528,0.8810833333333332,1,0,1,599147,6463,100125,7831,0.05986698284486272,0.5478522456974955
35529,0.8811666666666667,1,1,1,599148,6462,100126,7830,0.059857719811775165,0.5478589420654912
35530,0.8811904761904762,1,0,1,599148,6462,100127,7829,0.059857719811775165,0.5478273038975578
35531,0.8812142857142856,0,1,0,599149,6461,100127,7829,0.059848456778687616,0.5478656403079076
35532,0.88125,1,1,1,599150,6460,100128,7828,0.05983919374560006,0.5478723404255319
35533,0.8813095238095238,2,1,2,599151,6459,100130,7826,0.059829930712512504,0.5478473923696184
35534,0.8813333333333333,1,1,1,599152,6458,100131,7825,0.05982066767942495,0.5478540922775327
35535,0.8813333333333334,3,3,3,599155,6455,100134,7822,0.05979287858016229,0.547874203263991
35536,0.881357142857143,0,2,0,599157,6453,100134,7822,0.05977435251398718,0.5479509632224168
35537,0.8813809523809525,1,0,1,599157,6453,100135,7821,0.05977435251398718,0.5479192938209332
35538,0.8814166666666666,1,0,1,599157,6453,100136,7820,0.05977435251398718,0.5478876199817838
35539,0.8814285714285713,1,0,1,599157,6453,100137,7819,0.05977435251398718,0.5478559417040358
35540,0.8814285714285716,0,1,0,599158,6452,100137,7819,0.059765089480899626,0.547894331161096
35541,0.8814444444444445,0,1,0,599159,6451,100137,7819,0.05975582644781207,0.5479327259985984
35542,0.8815,1,1,1,599160,6450,100138,7818,0.059746563414724514,0.5479394449116904
35543,0.8815000000000001,1,1,1,599161,6449,100139,7817,0.059737300381636965,0.5479461657086779
35544,0.8816024531024529,1,0,1,599161,6449,100140,7816,0.059737300381636965,0.5479144759901857
35545,0.8816190476190476,0,1,0,599162,6448,100140,7816,0.05972803734854941,0.5479528883903534
35546,0.8816309523809522,0,3,0,599165,6445,100140,7816,0.05970024824928675,0.5480681579131899
35547,0.8816428571428571,0,4,0,599169,6441,100140,7816,0.05966319611693653,0.5482219260714035
35548,0.8816547619047619,0,1,0,599170,6440,100140,7816,0.059653933083848976,0.5482603815937149
35549,0.8816666666666666,12,11,12,599181,6429,100152,7804,0.05955203971988588,0.5483032389517319
35550,0.8816666666666667,9,13,9,599194,6416,100161,7795,0.059431620289747675,0.5485187530786011
35551,0.8816904761904764,1,1,1,599195,6415,100162,7794,0.05942235725666012,0.5485255823773665
35552,0.8817142857142858,0,1,0,599196,6414,100162,7794,0.05941309422357257,0.5485641891891891
35553,0.8817351537351535,1,3,1,599199,6411,100163,7793,0.0593853051243099,0.5486482680934948
35554,0.8817619047619045,1,0,1,599199,6411,100164,7792,0.0593853051243099,0.5486164894740547
35555,0.8817857142857143,2,0,2,599199,6411,100166,7790,0.0593853051243099,0.5485529188085346
35556,0.8818055555555556,0,1,0,599200,6410,100166,7790,0.05937604209122235,0.5485915492957747
35557,0.8818181818181818,1,0,1,599200,6410,100167,7789,0.05937604209122235,0.5485597577294176
35558,0.8818333333333332,0,3,0,599203,6407,100167,7789,0.059348252991959685,0.5486756832910679
35559,0.8818333333333334,0,1,0,599204,6406,100167,7789,0.059338989958872136,0.5487143360338147
35560,0.8819166666666668,1,0,1,599204,6406,100168,7788,0.059338989958872136,0.5486825419191208
35561,0.8819444444444445,0,1,0,599205,6405,100168,7788,0.05932972692578458,0.548721200591841
35562,0.882,5,6,5,599211,6399,100173,7783,0.05927414872725925,0.5487942462276124
35563,0.8820476190476191,1,0,1,599211,6399,100174,7782,0.05927414872725925,0.5487624286016501
35564,0.8820595238095238,0,1,0,599212,6398,100174,7782,0.0592648856941717,0.5488011283497884
35565,0.8820833333333334,1,2,1,599214,6396,100175,7781,0.05924635962799659,0.5488467235663399
35566,0.8821666666666665,0,2,0,599216,6394,100175,7781,0.059227833561821486,0.5489241622574956
35567,0.8821666666666667,4,1,4,599217,6393,100179,7777,0.05921857052873393,0.5488355681016232
35568,0.8822619047619048,1,0,1,599217,6393,100180,7776,0.05921857052873393,0.5488037264450562
35569,0.8823076923076922,0,2,0,599219,6391,100180,7776,0.05920004446255882,0.5488812027952283
35570,0.8823333333333333,0,2,0,599221,6389,100180,7776,0.05918151839638371,0.5489587010236499
35571,0.8823333333333335,1,1,1,599222,6388,100181,7775,0.05917225536329616,0.5489656146296689
35572,0.8824761904761904,0,1,0,599223,6387,100181,7775,0.0591629923302086,0.5490043779127242
35573,0.8824761904761905,0,1,0,599224,6386,100181,7775,0.05915372929712105,0.5490431466704329
35574,0.8824999999999998,1,0,1,599224,6386,100182,7774,0.05915372929712105,0.5490112994350282
35575,0.8825,25,25,25,599249,6361,100207,7749,0.058922153469932195,0.5491849751948973
35576,0.8826060606060608,1,0,1,599249,6361,100208,7748,0.058922153469932195,0.5491530228931888
35577,0.8826239177489174,1,1,1,599250,6360,100209,7747,0.05891289043684464,0.5491599914935847
35578,0.8826666666666665,1,0,1,599250,6360,100210,7746,0.05891289043684464,0.5491280306252658
35579,0.8826666666666667,2,1,2,599251,6359,100212,7744,0.05890362740375708,0.5491030277245976
35580,0.8826666666666668,1,0,1,599251,6359,100213,7743,0.05890362740375708,0.549071053751241
35581,0.8827357087357085,0,2,0,599253,6357,100213,7743,0.05888510133758198,0.5491489361702128
35582,0.8827857142857143,0,1,0,599254,6356,100213,7743,0.05887583830449442,0.54918788566565
35583,0.8828571428571429,0,1,0,599255,6355,100213,7743,0.05886657527140687,0.5492268406866222
35584,0.8829166666666667,1,0,1,599255,6355,100214,7742,0.05886657527140687,0.5491948641554941
35585,0.883,5,6,5,599261,6349,100219,7737,0.058810997072881545,0.549268777509584
35586,0.8830000000000001,2,1,2,599262,6348,100221,7735,0.05880173403979399,0.5492437690832919
35587,0.8830476190476191,0,1,0,599263,6347,100221,7735,0.05879247100670643,0.5492827723334753
35588,0.8830833333333333,0,1,0,599264,6346,100221,7735,0.058783207973618884,0.5493217811234997
35589,0.8831666666666667,3,3,3,599267,6343,100224,7732,0.058755418874356216,0.5493428063943162
35590,0.8831666666666668,1,0,1,599267,6343,100225,7731,0.058755418874356216,0.5493107858462413
35591,0.8832738095238095,1,0,1,599267,6343,100226,7730,0.058755418874356216,0.5492787607475307
35592,0.8833095238095239,0,1,0,599268,6342,100226,7730,0.05874615584126867,0.5493177942012507
35593,0.8833333333333333,26,27,26,599295,6315,100252,7704,0.058496053947904705,0.5495399101219773
35594,0.8833333333333334,28,28,28,599323,6287,100280,7676,0.05823668902145319,0.5497385948578386
35595,0.8833809523809524,0,1,0,599324,6286,100280,7676,0.05822742598836563,0.5497779687723822
35596,0.883436507936508,0,1,0,599325,6285,100280,7676,0.058218162955278076,0.5498173483274837
35597,0.8835,1,3,1,599328,6282,100281,7675,0.058190373856015415,0.5499032743426238
35598,0.8835714285714286,0,1,0,599329,6281,100281,7675,0.05818111082292786,0.5499426769848094
35599,0.8835858585858586,0,1,0,599330,6280,100281,7675,0.0581718477898403,0.5499820852740953
35600,0.8836309523809526,0,1,0,599331,6279,100281,7675,0.058162584756752754,0.5500214992116955
35601,0.8836666666666667,2,4,2,599335,6275,100283,7673,0.05812553262440254,0.5501147117866361
35602,0.88375,2,3,2,599338,6272,100285,7671,0.05809774352513987,0.5501685433550886
35603,0.8837539682539682,1,0,1,599338,6272,100286,7670,0.05809774352513987,0.5501362788696026
35604,0.8838095238095239,0,1,0,599339,6271,100286,7670,0.05808848049205232,0.5501757406211893
35605,0.8838333333333332,0,1,0,599340,6270,100286,7670,0.058079217458964764,0.5502152080344332
35606,0.8838333333333334,1,1,1,599341,6269,100287,7669,0.05806995442587721,0.5502224135457024
35607,0.8838809523809524,0,2,0,599343,6267,100287,7669,0.058051428359702104,0.5503013777267508
35608,0.8839166666666665,1,0,1,599343,6267,100288,7668,0.058051428359702104,0.5502691065662002
35609,0.8839166666666667,0,1,0,599344,6266,100288,7668,0.05804216532661455,0.5503085976747524
35610,0.884,11,11,11,599355,6255,100299,7657,0.05794027196265145,0.5503881541115584
35611,0.8841666666666664,1,0,1,599355,6255,100300,7656,0.05794027196265145,0.5503558335130472
35612,0.8841666666666665,4,10,4,599365,6245,100304,7652,0.05784764163177591,0.5506224364970858
35613,0.8841666666666668,3,6,3,599371,6239,100307,7649,0.057792063433250586,0.5507632488479263
35614,0.8842380952380954,1,0,1,599371,6239,100308,7648,0.057792063433250586,0.5507308994023187
35615,0.8842500000000001,1,0,1,599371,6239,100309,7647,0.057792063433250586,0.5506985452974219
35616,0.8842857142857143,2,2,2,599373,6237,100311,7645,0.057773537367075474,0.5507131537242472
35617,0.884297619047619,0,1,0,599374,6236,100311,7645,0.05776427433398792,0.5507528276060802
35618,0.8843333333333332,1,1,1,599375,6235,100312,7644,0.05775501130090037,0.5507601412205491
35619,0.8843333333333334,0,2,0,599377,6233,100312,7644,0.05773648523472526,0.5508395186279456
35620,0.8844166666666666,1,0,1,599377,6233,100313,7643,0.05773648523472526,0.5508071490343038
35621,0.8845000000000001,2,3,2,599380,6230,100315,7641,0.057708696135462596,0.5508615096243962
35622,0.8845357142857142,0,1,0,599381,6229,100315,7641,0.05769943310237504,0.550901225666907
35623,0.8845476190476191,0,1,0,599382,6228,100315,7641,0.057690170069287484,0.5509409474367294
35624,0.8846428571428572,0,2,0,599384,6226,100315,7641,0.05767164400311238,0.5510204081632653
35625,0.8846666666666667,1,1,1,599385,6225,100316,7640,0.057662380970024824,0.5510277677605482
35626,0.8847499999999999,1,2,1,599387,6223,100317,7639,0.05764385490384972,0.551074880969557
35627,0.8847857142857143,1,0,1,599387,6223,100318,7638,0.05764385490384972,0.5510424933265998
35628,0.8848333333333334,0,1,0,599388,6222,100318,7638,0.05763459187076216,0.5510822510822511
35629,0.8848571428571429,1,1,1,599389,6221,100319,7637,0.05762532883767461,0.5510896233222687
35630,0.884952380952381,0,2,0,599391,6219,100319,7637,0.0576068027714995,0.551169168591224
35631,0.8849999999999999,2,1,2,599392,6218,100321,7635,0.057597539738411946,0.551144156500397
35632,0.885,110,141,110,599533,6077,100431,7525,0.05629145207306681,0.5532274665490369
35633,0.8850000000000001,2,3,2,599536,6074,100433,7523,0.05626366297380414,0.5532838126057219
35634,0.8850833333333334,1,0,1,599536,6074,100434,7522,0.05626366297380414,0.5532509561635776
35635,0.8850952380952382,0,1,0,599537,6073,100434,7522,0.05625439994071659,0.5532916513424053
35636,0.8851190476190477,0,1,0,599538,6072,100434,7522,0.056245136907629036,0.5533323525084596
35637,0.8851666666666667,2,1,2,599539,6071,100436,7520,0.05623587387454148,0.5533073357368847
35638,0.8852380952380952,0,2,0,599541,6069,100436,7520,0.056217347808366375,0.5533887703289425
35639,0.8852380952380954,0,1,0,599542,6068,100436,7520,0.05620808477527882,0.55342949661466
35640,0.8852878787878788,0,2,0,599544,6066,100436,7520,0.05618955870910371,0.5535109671720889
35641,0.8853333333333333,1,6,1,599550,6060,100437,7519,0.056133980510578385,0.55372265998969
35642,0.8853333333333334,0,3,0,599553,6057,100437,7519,0.056106191411315724,0.5538450206246317
35643,0.8853809523809524,0,1,0,599554,6056,100437,7519,0.05609692837822817,0.5538858195211787
35644,0.8854642857142858,0,1,0,599555,6055,100437,7519,0.05608766534514061,0.5539266244290555
35645,0.8855,0,1,0,599556,6054,100437,7519,0.056078402312053056,0.5539674353495911
35646,0.8855000000000001,3,0,3,599556,6054,100440,7516,0.056078402312053056,0.5538688282977156
35647,0.8855119047619049,1,0,1,599556,6054,100441,7515,0.056078402312053056,0.5538359495909795
35648,0.8855238095238096,1,0,1,599556,6054,100442,7514,0.056078402312053056,0.5538030660377359
35649,0.8855555555555555,1,1,1,599557,6053,100443,7513,0.05606913927896551,0.5538109980834439
35650,0.8856428571428572,0,2,0,599559,6051,100443,7513,0.056050613212790396,0.5538926570333235
35651,0.8856666666666666,1,4,1,599563,6047,100444,7512,0.05601356108044018,0.5540231580500037
35652,0.8856666666666668,0,1,0,599564,6046,100444,7512,0.05600429804735262,0.5540640212420711
35653,0.8856904761904759,0,1,0,599565,6045,100444,7512,0.055995035014265074,0.5541048904624917
35654,0.8857142857142857,2,1,2,599566,6044,100446,7510,0.05598577198117752,0.5540799763907334
35655,0.8857857142857145,0,2,0,599568,6042,100446,7510,0.055967245915002406,0.5541617473435655
35656,0.8858333333333333,4,4,4,599572,6038,100450,7506,0.05593019378265219,0.5541937389249852
35657,0.8858333333333335,3,3,3,599575,6035,100453,7503,0.05590240468338953,0.5542177574235485
35658,0.8859999999999999,8,12,8,599587,6023,100461,7495,0.05579124828633888,0.5544459239532475
35659,0.8860634920634919,1,0,1,599587,6023,100462,7494,0.05579124828633888,0.5544129614559443
35660,0.886111111111111,0,1,0,599588,6022,100462,7494,0.05578198525325132,0.554453980467594
35661,0.8861666666666668,0,3,0,599591,6019,100462,7494,0.05575419615398866,0.5545770739288093
35662,0.8861904761904763,1,1,1,599592,6018,100463,7493,0.055744933120901105,0.5545851528384279
35663,0.886228354978355,0,1,0,599593,6017,100463,7493,0.055735670087813556,0.5546262028127313
35664,0.8862380952380954,1,0,1,599593,6017,100464,7492,0.055735670087813556,0.5545932341402028
35665,0.88625,0,1,0,599594,6016,100464,7492,0.055726407054726,0.5546342907906426
35666,0.8862857142857145,0,1,0,599595,6015,100464,7492,0.055717144021638444,0.5546753535203969
35667,0.8863333333333334,0,2,0,599597,6013,100464,7492,0.05569861795546334,0.5547574972232506
35668,0.8863690476190474,0,1,0,599598,6012,100464,7492,0.05568935492237578,0.5547985781990521
35669,0.8863690476190479,0,1,0,599599,6011,100464,7492,0.05568009188928823,0.554839665259572
35670,0.88647113997114,0,2,0,599601,6009,100464,7492,0.05566156582311312,0.5549218576401748
35671,0.8865,1,0,1,599601,6009,100465,7491,0.05566156582311312,0.5548888888888889
35672,0.8865000000000001,0,3,0,599604,6006,100465,7491,0.055633776723850455,0.5550122249388753
35673,0.8865000000000002,1,0,1,599604,6006,100466,7490,0.055633776723850455,0.5549792531120332
35674,0.8866190476190476,0,1,0,599605,6005,100466,7490,0.055624513690762906,0.5550203779177473
35675,0.8866666666666666,25,24,25,599629,5981,100491,7465,0.055402200896661605,0.5551836977539789
35676,0.8866666666666667,30,36,30,599665,5945,100521,7435,0.05506873170550965,0.5556801195814649
35677,0.8866904761904761,2,0,2,599665,5945,100523,7433,0.05506873170550965,0.5556136941246823
35678,0.8867222222222222,0,1,0,599666,5944,100523,7433,0.0550594686724221,0.5556552291246168
35679,0.8868333333333333,0,1,0,599667,5943,100523,7433,0.05505020563933454,0.5556967703349283
35680,0.8868333333333334,1,2,1,599669,5941,100524,7432,0.05503167957315944,0.5557466537052269
35681,0.8868333333333335,1,0,1,599669,5941,100525,7431,0.05503167957315944,0.5557134310499551
35682,0.8868571428571427,0,1,0,599670,5940,100525,7431,0.05502241654007188,0.5557549921471842
35683,0.8868690476190477,0,2,0,599672,5938,100525,7431,0.055003890473896776,0.5558381329942405
35684,0.8868849206349206,0,1,0,599673,5937,100525,7431,0.05499462744080922,0.5558797127468582
35685,0.8868928571428571,0,1,0,599674,5936,100525,7431,0.054985364407721664,0.5559212987207302
35686,0.8869047619047621,1,0,1,599674,5936,100526,7430,0.054985364407721664,0.5558880742181654
35687,0.8869206349206348,0,1,0,599675,5935,100526,7430,0.05497610137463411,0.5559296670407782
35688,0.8869523809523809,1,0,1,599675,5935,100527,7429,0.05497610137463411,0.5558964381921581
35689,0.8869999999999999,0,1,0,599676,5934,100527,7429,0.05496683834154656,0.5559380378657487
35690,0.887,3,2,3,599678,5932,100530,7426,0.05494831227537145,0.5559215451414883
35691,0.8870000000000001,2,0,2,599678,5932,100532,7424,0.05494831227537145,0.5558550464210842
35692,0.8870238095238094,0,1,0,599679,5931,100532,7424,0.05493904924228389,0.5558966679146388
35693,0.887035714285714,0,1,0,599680,5930,100532,7424,0.05492978620919634,0.5559382956417552
35694,0.8871428571428572,0,1,0,599681,5929,100532,7424,0.054920523176108786,0.5559799296038344
35695,0.8871666666666665,1,2,1,599683,5927,100533,7423,0.054901997109933674,0.5560299625468165
35696,0.8872142857142857,0,1,0,599684,5926,100533,7423,0.054892734076846125,0.5560716158513747
35697,0.8872222222222221,0,1,0,599685,5925,100533,7423,0.05488347104375857,0.5561132753970632
35698,0.8873333333333332,0,2,0,599687,5923,100533,7423,0.05486494497758346,0.5561966132174434
35699,0.8873333333333333,2,6,2,599693,5917,100535,7421,0.054809366779058136,0.5563802669065827
35700,0.8874047619047617,0,1,0,599694,5916,100535,7421,0.05480010374597058,0.5564219839544126
35701,0.8874047619047619,1,0,1,599694,5916,100536,7420,0.05480010374597058,0.5563887222555489
35702,0.8874761904761905,1,1,1,599695,5915,100537,7419,0.054790840712883024,0.5563971801409929
35703,0.8874880952380952,0,1,0,599696,5914,100537,7419,0.054781577679795475,0.5564389109727743
35704,0.8875,20,23,20,599719,5891,100557,7399,0.05456852791878172,0.5567343867569601
35705,0.8875000000000002,1,0,1,599719,5891,100558,7398,0.05456852791878172,0.5567010309278351
35706,0.8875714285714286,0,1,0,599720,5890,100558,7398,0.054559264885694174,0.5567429259482239
35707,0.8876190476190476,0,1,0,599721,5889,100558,7398,0.05455000185260662,0.5567848272747798
35708,0.8876190476190478,1,0,1,599721,5889,100559,7397,0.05455000185260662,0.5567514677103719
35709,0.8876666666666665,0,1,0,599722,5888,100559,7397,0.05454073881951906,0.5567933759879563
35710,0.8876666666666668,2,0,2,599722,5888,100561,7395,0.05454073881951906,0.556726643077618
35711,0.8876785714285714,0,1,0,599723,5887,100561,7395,0.054531475786431506,0.5567685589519651
35712,0.8877272727272728,0,2,0,599725,5885,100561,7395,0.0545129497202564,0.5568524096385542
35713,0.8877380952380952,1,0,1,599725,5885,100562,7394,0.0545129497202564,0.5568190375781309
35714,0.8877777777777777,1,0,1,599725,5885,100563,7393,0.0545129497202564,0.5567856604910378
35715,0.8878174603174602,1,1,1,599726,5884,100564,7392,0.054503686687168845,0.5567942151250377
35716,0.8878333333333335,1,0,1,599726,5884,100565,7391,0.054503686687168845,0.5567608286252355
35717,0.8878571428571429,0,1,0,599727,5883,100565,7391,0.05449442365408129,0.5568027723368992
35718,0.8879166666666666,1,0,1,599727,5883,100566,7390,0.05449442365408129,0.556769381451066
35719,0.8879390331890333,0,2,0,599729,5881,100566,7390,0.054475897587906184,0.5568532891266672
35720,0.8879761904761905,0,1,0,599730,5880,100566,7390,0.05446663455481863,0.5568952524491334
35721,0.8879761904761907,0,1,0,599731,5879,100566,7390,0.05445737152173107,0.5569372220966162
35722,0.8879999999999998,0,1,0,599732,5878,100566,7390,0.054448108488643523,0.5569791980705456
35723,0.888,3,4,3,599736,5874,100569,7387,0.05441105635629331,0.5570469798657718
35724,0.8880000000000001,1,2,1,599738,5872,100570,7386,0.054392530290118195,0.5570976014481822
35725,0.8880158730158727,0,3,0,599741,5869,100570,7386,0.054364741190855534,0.5572236891738966
35726,0.8880476190476189,0,1,0,599742,5868,100570,7386,0.05435547815776798,0.5572657311000453
35727,0.8880714285714285,0,2,0,599744,5866,100570,7386,0.05433695209159287,0.5573498339873226
35728,0.8880833333333333,1,0,1,599744,5866,100571,7385,0.05433695209159287,0.5573164289487585
35729,0.8881388888888888,0,1,0,599745,5865,100571,7385,0.05432768905850532,0.5573584905660377
35730,0.888142857142857,1,1,1,599746,5864,100572,7384,0.05431842602541776,0.5573671497584541
35731,0.8881666666666667,1,1,1,599747,5863,100573,7383,0.054309162992330205,0.5573758115657557
35732,0.8881666666666668,1,0,1,599747,5863,100574,7382,0.054309162992330205,0.5573423933559833
35733,0.8881904761904762,0,1,0,599748,5862,100574,7382,0.054299899959242656,0.5573844759891271
35734,0.8883095238095237,0,1,0,599749,5861,100574,7382,0.0542906369261551,0.557426564977724
35735,0.8883333333333332,1,0,1,599749,5861,100575,7381,0.0542906369261551,0.5573931430297538
35736,0.8883333333333333,6,19,6,599768,5842,100581,7375,0.05411463929749157,0.557993493228418
35737,0.8883333333333334,11,13,11,599781,5829,100592,7364,0.053994219867353366,0.558174789661184
35738,0.8883588747853453,0,1,0,599782,5828,100592,7364,0.05398495683426581,0.5582171012734991
35739,0.8884166666666666,1,0,1,599782,5828,100593,7363,0.05398495683426581,0.5581836100371466
35740,0.888452380952381,1,0,1,599782,5828,100594,7362,0.05398495683426581,0.5581501137225171
35741,0.8884761904761905,1,0,1,599782,5828,100595,7361,0.05398495683426581,0.5581166123284556
35742,0.8885,2,0,2,599782,5828,100597,7359,0.05398495683426581,0.5580495942974141
35743,0.8885714285714286,3,1,3,599783,5827,100600,7356,0.05397569380117826,0.5579913524994311
35744,0.8886666666666666,1,3,1,599786,5824,100601,7355,0.05394790470191559,0.5580848319295849
35745,0.8887380952380952,1,0,1,599786,5824,100602,7354,0.05394790470191559,0.5580512976172408
35746,0.8888095238095238,0,1,0,599787,5823,100602,7354,0.053938641668828044,0.5580936480230705
35747,0.8888333333333331,1,0,1,599787,5823,100603,7353,0.053938641668828044,0.5580601092896175
35748,0.8888333333333333,1,1,1,599788,5822,100604,7352,0.05392937863574049,0.5580689236374677
35749,0.8888333333333334,1,0,1,599788,5822,100605,7351,0.05392937863574049,0.5580353753890533
35750,0.8889242424242424,0,1,0,599789,5821,100605,7351,0.05392011560265293,0.5580777406620103
35751,0.8889880952380952,0,1,0,599790,5820,100605,7351,0.053910852569565376,0.5581201123680813
35752,0.889,4,3,4,599793,5817,100609,7347,0.053883063470302715,0.5581130355515042
35753,0.8891666666666665,3,3,3,599796,5814,100612,7344,0.053855274371040054,0.5581395348837209
35754,0.8891666666666667,3,3,3,599799,5811,100615,7341,0.053827485271777394,0.5581660583941606
35755,0.8891904761904762,0,1,0,599800,5810,100615,7341,0.05381822223868984,0.5582085012546575
35756,0.8892619047619046,1,0,1,599800,5810,100616,7340,0.05381822223868984,0.5581749049429657
35757,0.8892857142857143,0,1,0,599801,5809,100616,7340,0.05380895920560228,0.558217354931934
35758,0.8893333333333334,1,2,1,599803,5807,100617,7339,0.05379043313942718,0.5582686748820934
35759,0.8895000000000001,1,1,1,599804,5806,100618,7338,0.05378117010633962,0.558277541083384
35760,0.8895634920634921,0,1,0,599805,5805,100618,7338,0.053771907073252065,0.5583200182606711
35761,0.8895833333333333,0,1,0,599806,5804,100618,7338,0.05376264404016451,0.558362501902298
35762,0.8896111111111111,1,0,1,599806,5804,100619,7337,0.05376264404016451,0.5583288943002815
35763,0.8896666666666665,1,3,1,599809,5801,100620,7336,0.05373485494090185,0.5584227753672832
35764,0.8896666666666667,2,0,2,599809,5801,100622,7334,0.05373485494090185,0.5583555386372288
35765,0.8897142857142858,1,0,1,599809,5801,100623,7333,0.05373485494090185,0.5583219125932694
35766,0.8897738095238096,0,2,0,599811,5799,100623,7333,0.05371632887472674,0.5584069448674992
35767,0.8898095238095237,1,0,1,599811,5799,100624,7332,0.05371632887472674,0.5583733150559744
35768,0.8898333333333334,1,3,1,599814,5796,100625,7331,0.053688539775464075,0.5584672811762017
35769,0.8898809523809524,1,2,1,599816,5794,100626,7330,0.05367001370928897,0.5585187442852789
35770,0.8899404761904761,0,1,0,599817,5793,100626,7330,0.053660750676201414,0.5585613045797455
35771,0.8899999999999999,1,1,1,599818,5792,100627,7329,0.05365148764311386,0.5585702309275208
35772,0.89,640,470,640,600288,5322,101267,6689,0.04929786209196339,0.5569061693447673
35773,0.8900000000000001,2,0,2,600288,5322,101269,6687,0.04929786209196339,0.5568323757182113
35774,0.8900376845376842,0,1,0,600289,5321,101269,6687,0.04928859905887584,0.5568787475016655
35775,0.8900414862914863,0,2,0,600291,5319,101269,6687,0.04927007299270073,0.5569715142428786
35776,0.8900793650793652,0,1,0,600292,5318,101269,6687,0.049260809959613176,0.5570179092044981
35777,0.8900887445887448,0,1,0,600293,5317,101269,6687,0.04925154692652562,0.5570643118960347
35778,0.8901666666666666,0,1,0,600294,5316,101269,6687,0.049242283893438064,0.5571107223194202
35779,0.8901666666666667,1,1,1,600295,5315,101270,6686,0.049233020860350515,0.5571202399800017
35780,0.890202380952381,1,0,1,600295,5315,101271,6685,0.049233020860350515,0.5570833333333334
35781,0.8902142857142856,1,0,1,600295,5315,101272,6684,0.049233020860350515,0.5570464205350446
35782,0.8903095238095239,0,1,0,600296,5314,101272,6684,0.04922375782726296,0.5570928488081347
35783,0.8904166666666669,0,1,0,600297,5313,101272,6684,0.049214494794175404,0.5571392848212053
35784,0.8904746642246643,0,2,0,600299,5311,101272,6684,0.0491959687280003,0.5572321800750313
35785,0.8904761904761905,0,1,0,600300,5310,101272,6684,0.04918670569491274,0.5572786393196598
35786,0.8905,1,5,1,600305,5305,101273,6683,0.04914039052947497,0.5574741408074741
35787,0.8905555555555555,1,1,1,600306,5304,101274,6682,0.049131127496387414,0.5574837310195228
35788,0.8905714285714283,1,0,1,600306,5304,101275,6681,0.049131127496387414,0.5574468085106383
35789,0.8905833333333334,1,0,1,600306,5304,101276,6680,0.049131127496387414,0.5574098798397864
35790,0.8906031746031745,0,1,0,600307,5303,101276,6680,0.049121864463299865,0.5574563965617959
35791,0.8906309523809525,0,1,0,600308,5302,101276,6680,0.04911260143021231,0.5575029210482391
35792,0.8906666666666666,2,2,2,600310,5300,101278,6678,0.0490940753640372,0.5575221238938053
35793,0.8906666666666669,0,1,0,600311,5299,101278,6678,0.04908481233094965,0.5575686732904734
35794,0.8907261904761904,0,2,0,600313,5297,101278,6678,0.049066286264774536,0.5576617954070981
35795,0.8908333333333333,5,5,5,600318,5292,101283,6673,0.049019971099336763,0.557709987463435
35796,0.8908333333333335,3,1,3,600319,5291,101286,6670,0.049010708066249214,0.5576456817991807
35797,0.8909523809523808,0,2,0,600321,5289,101286,6670,0.0489921820000741,0.5577389413830588
35798,0.8909761904761905,0,1,0,600322,5288,101286,6670,0.04898291896698655,0.5577855828733902
35799,0.8909999999999999,6,0,6,600322,5288,101292,6664,0.04898291896698655,0.5575635876840697
35800,0.8910833333333333,1,0,1,600322,5288,101293,6663,0.04898291896698655,0.5575265668144925
35801,0.8911107503607503,0,1,0,600323,5287,101293,6663,0.048973655933899,0.5575732217573222
35802,0.891111111111111,0,1,0,600324,5286,101293,6663,0.04896439290081144,0.557619884509164
35803,0.8911111111111112,0,1,0,600325,5285,101293,6663,0.048955129867723886,0.5576665550719786
35804,0.8911666666666668,0,1,0,600326,5284,101293,6663,0.04894586683463633,0.5577132334477275
35805,0.89125,1,2,1,600328,5282,101294,6662,0.048927340768461225,0.5577695914266577
35806,0.8912857142857142,1,0,1,600328,5282,101295,6661,0.048927340768461225,0.5577325630076195
35807,0.8913095238095237,1,0,1,600328,5282,101296,6660,0.048927340768461225,0.5576955283872048
35808,0.8913333333333333,0,1,0,600329,5281,101296,6660,0.04891807773537367,0.5577422326438322
35809,0.8914285714285713,1,1,1,600330,5280,101297,6659,0.04890881470228612,0.5577519055197253
35810,0.8915,0,1,0,600331,5279,101297,6659,0.048899551669198564,0.5577986262355503
35811,0.8915000000000001,1,3,1,600334,5276,101298,6658,0.0488717625699359,0.5579017931959108
35812,0.8915238095238096,1,0,1,600334,5276,101299,6657,0.0488717625699359,0.5578647448252745
35813,0.8916190476190476,0,2,0,600336,5274,101299,6657,0.04885323650376079,0.5579582599949711
35814,0.8916666666666666,5,15,5,600351,5259,101304,6652,0.04871429100744748,0.5584753589119301
35815,0.8916666666666667,5,11,5,600362,5248,101309,6647,0.048612397643484385,0.5588062211013031
35816,0.8917857142857143,0,1,0,600363,5247,101309,6647,0.04860313461039683,0.5588532032957794
35817,0.8918333333333334,1,2,1,600365,5245,101310,6646,0.04858460854422172,0.5589101000756875
35818,0.8918571428571428,1,0,1,600365,5245,101311,6645,0.04858460854422172,0.5588730025231287
35819,0.8919047619047619,2,0,2,600365,5245,101313,6643,0.04858460854422172,0.5587987886944819
35820,0.8919285714285714,1,0,1,600365,5245,101314,6642,0.04858460854422172,0.5587616724152435
35821,0.892,10,13,10,600378,5232,101324,6632,0.04846418911408352,0.5590020229265004
35822,0.892047619047619,0,1,0,600379,5231,101324,6632,0.04845492608099596,0.5590491443985501
35823,0.8920833333333333,0,2,0,600381,5229,101324,6632,0.04843640001482085,0.5591434111794958
35824,0.892095238095238,1,0,1,600381,5229,101325,6631,0.04843640001482085,0.559106239460371
35825,0.8921428571428571,0,3,0,600384,5226,101325,6631,0.04840861091555819,0.5592477017795395
35826,0.8921428571428572,1,0,1,600384,5226,101326,6630,0.04840861091555819,0.5592105263157895
35827,0.8921666666666666,0,1,0,600385,5225,101326,6630,0.048399347882470634,0.559257697174188
35828,0.8921666666666667,0,1,0,600386,5224,101326,6630,0.048390084849383085,0.5593048759912266
35829,0.8922499999999998,0,1,0,600387,5223,101326,6630,0.04838082181629553,0.5593520627689192
35830,0.8923333333333333,1,0,1,600387,5223,101327,6629,0.04838082181629553,0.5593148835639554
35831,0.8923333333333335,3,1,3,600388,5222,101330,6626,0.04837155878320797,0.5592505064145847
35832,0.8923928571428571,0,1,0,600389,5221,101330,6626,0.04836229575012042,0.5592977125010551
35833,0.892404761904762,0,1,0,600390,5220,101330,6626,0.04835303271703287,0.5593449265574878
35834,0.8924920634920636,0,1,0,600391,5219,101330,6626,0.04834376968394531,0.5593921485859012
35835,0.8925,19,22,19,600413,5197,101349,6607,0.048139982956019116,0.559725516773975
35836,0.892547619047619,0,1,0,600414,5196,101349,6607,0.04813071992293157,0.559772939083284
35837,0.8926666666666665,1,2,1,600416,5194,101350,6606,0.048112193856756455,0.5598305084745763
35838,0.8926666666666666,1,3,1,600419,5191,101351,6605,0.048084404757493794,0.5599355713801288
35839,0.89275,1,0,1,600419,5191,101352,6604,0.048084404757493794,0.5598982619754133
35840,0.8928333333333334,0,1,0,600420,5190,101352,6604,0.04807514172440624,0.5599457351195524
35841,0.8928465235744645,2,0,2,600420,5190,101354,6602,0.04807514172440624,0.5598710990502035
35842,0.8928571428571428,0,1,0,600421,5189,101354,6602,0.04806587869131868,0.5599185819692987
35843,0.8928571428571429,2,0,2,600421,5189,101356,6600,0.04806587869131868,0.5598439223004495
35844,0.8929166666666667,0,1,0,600422,5188,101356,6600,0.04805661565823113,0.5598914149983033
35845,0.8929761904761905,1,0,1,600422,5188,101357,6599,0.04805661565823113,0.5598540765249852
35846,0.893,1,5,1,600427,5183,101358,6598,0.04801030049279336,0.5600543247602071
35847,0.8930000000000001,1,2,1,600429,5181,101359,6597,0.04799177442661825,0.5601120733571064
35848,0.8930357142857142,0,1,0,600430,5180,101359,6597,0.0479825113935307,0.5601596331833234
35849,0.8930595238095239,1,0,1,600430,5180,101360,6596,0.0479825113935307,0.5601222826086957
35850,0.8931190476190476,0,1,0,600431,5179,101360,6596,0.047973248360443144,0.5601698513800425
35851,0.8931666666666668,1,0,1,600431,5179,101361,6595,0.047973248360443144,0.5601324953286904
35852,0.8931904761904762,0,1,0,600432,5178,101361,6595,0.04796398532735559,0.5601800730485008
35853,0.8932142857142857,0,1,0,600433,5177,101361,6595,0.04795472229426803,0.560227658851512
35854,0.8932261904761906,0,1,0,600434,5176,101361,6595,0.04794545926118048,0.5602752527397842
35855,0.8932380952380952,1,0,1,600434,5176,101362,6594,0.04794545926118048,0.5602378929481733
35856,0.8933333333333333,28,31,28,600465,5145,101390,6566,0.047658305235466304,0.5606694560669456
35857,0.8933333333333334,29,18,29,600483,5127,101419,6537,0.047491570639890325,0.5604423868312757
35858,0.8934444444444445,1,0,1,600483,5127,101420,6536,0.047491570639890325,0.5604046986195661
35859,0.8935,2,1,2,600484,5126,101422,6534,0.04748230760680277,0.560377358490566
35860,0.8935674603174603,0,1,0,600485,5125,101422,6534,0.04747304457371522,0.5604254224204477
35861,0.8936666666666666,1,1,1,600486,5124,101423,6533,0.047463781540627664,0.560435789654285
35862,0.8936666666666667,1,3,1,600489,5121,101424,6532,0.047435992441365,0.5605423496095426
35863,0.89375,1,1,1,600490,5120,101425,6531,0.04742672940827745,0.5605527422538837
35864,0.8938095238095238,0,1,0,600491,5119,101425,6531,0.04741746637518989,0.5606008583690987
35865,0.8938333333333334,0,1,0,600492,5118,101425,6531,0.047408203342102335,0.5606489827453001
35866,0.8938672438672439,0,1,0,600493,5117,101425,6531,0.047398940309014786,0.5606971153846154
35867,0.893904761904762,0,1,0,600494,5116,101425,6531,0.04738967727592723,0.5607452562891732
35868,0.8939433621933622,0,1,0,600495,5115,101425,6531,0.047380414242839675,0.5607934054611026
35869,0.8939444444444444,0,1,0,600496,5114,101425,6531,0.04737115120975212,0.5608415629025333
35870,0.8939999999999999,1,0,1,600496,5114,101426,6530,0.04737115120975212,0.5608038474750945
35871,0.894,11,5,11,600501,5109,101437,6519,0.04732483604431435,0.5606295149638802
35872,0.8940183982683984,0,5,0,600506,5104,101437,6519,0.04727852087887658,0.5608706874300955
35873,0.894047619047619,1,0,1,600506,5104,101438,6518,0.04727852087887658,0.5608329031147823
35874,0.8941666666666666,3,2,3,600508,5102,101441,6515,0.04725999481270147,0.5608160454506327
35875,0.8941666666666667,4,5,4,600513,5097,101445,6511,0.0472136796472637,0.5609062715368711
35876,0.8942142857142856,3,0,3,600513,5097,101448,6508,0.0472136796472637,0.5607927617406291
35877,0.8943333333333332,1,2,1,600515,5095,101449,6507,0.04719515358108859,0.5608515773142562
35878,0.8944047619047619,1,0,1,600515,5095,101450,6506,0.04719515358108859,0.5608137229549177
35879,0.8944444444444444,0,3,0,600518,5092,101450,6506,0.04716736448182593,0.5609587859975858
35880,0.8944999999999999,0,1,0,600519,5091,101450,6506,0.047158101448738374,0.5610071570233681
35881,0.8945000000000001,1,0,1,600519,5091,101451,6505,0.047158101448738374,0.5609692997585374
35882,0.8945032467532468,2,0,2,600519,5091,101453,6503,0.047158101448738374,0.5608935656373987
35883,0.8945238095238095,1,0,1,600519,5091,101454,6502,0.047158101448738374,0.5608556887777106
35884,0.8945476190476189,0,1,0,600520,5090,101454,6502,0.04714883841565082,0.560904071773637
35885,0.8945714285714286,1,0,1,600520,5090,101455,6501,0.04714883841565082,0.5608661892847899
35886,0.8945833333333333,1,0,1,600520,5090,101456,6500,0.04714883841565082,0.5608283002588438
35887,0.8946190476190476,2,0,2,600520,5090,101458,6498,0.04714883841565082,0.5607525025888851
35888,0.8946428571428571,0,1,0,600521,5089,101458,6498,0.04713957538256327,0.5608008975576076
35889,0.8946666666666667,2,5,2,600526,5084,101460,6496,0.047093260217125496,0.5609671848013817
35890,0.8946666666666668,1,1,1,600527,5083,101461,6495,0.04708399718403794,0.5609777163586112
35891,0.8947142857142856,1,0,1,600527,5083,101462,6494,0.04708399718403794,0.5609397944199707
35892,0.89475,0,2,0,600529,5081,101462,6494,0.047065471117862835,0.561036717062635
35893,0.8948095238095237,0,1,0,600530,5080,101462,6494,0.04705620808477528,0.561085190945222
35894,0.8948333333333331,1,1,1,600531,5079,101463,6493,0.04704694505168772,0.5610957483581058
35895,0.8948333333333334,0,2,0,600533,5077,101463,6493,0.04702841898551262,0.5611927398444252
35896,0.8949523809523808,0,1,0,600534,5076,101463,6493,0.04701915595242506,0.5612412481631948
35897,0.8949999999999999,2,0,2,600534,5076,101465,6491,0.04701915595242506,0.5611653842828737
35898,0.895,106,91,106,600625,4985,101571,6385,0.04617621994145763,0.5615655233069481
35899,0.8950000000000001,2,5,2,600630,4980,101573,6383,0.04612990477601986,0.5617354571856024
35900,0.8950714285714286,1,0,1,600630,4980,101574,6382,0.04612990477601986,0.5616968843513466
35901,0.8951190476190475,3,0,3,600630,4980,101577,6379,0.04612990477601986,0.5615811250990405
35902,0.8951309523809523,0,1,0,600631,4979,101577,6379,0.0461206417429323,0.561630568762106
35903,0.8951666666666667,0,1,0,600632,4978,101577,6379,0.046111378709844754,0.5616800211323413
35904,0.8953095238095237,1,0,1,600632,4978,101578,6378,0.046111378709844754,0.5616414230362804
35905,0.8953333333333333,2,1,2,600633,4977,101580,6376,0.0461021156767572,0.5616136703954901
35906,0.8953333333333334,1,0,1,600633,4977,101581,6375,0.0461021156767572,0.5615750528541226
35907,0.8953571428571427,1,1,1,600634,4976,101582,6374,0.04609285264366964,0.5615859030837005
35908,0.8954126984126982,2,0,2,600634,4976,101584,6372,0.04609285264366964,0.561508635882975
35909,0.8954166666666667,1,0,1,600634,4976,101585,6371,0.04609285264366964,0.5614699920683881
35910,0.8954761904761903,2,0,2,600634,4976,101587,6369,0.04609285264366964,0.5613926840017629
35911,0.8954999999999999,0,1,0,600635,4975,101587,6369,0.046083589610582086,0.5614421720733427
35912,0.8955,0,3,0,600638,4972,101587,6369,0.046055800511319425,0.5615906886517944
35913,0.8955000000000001,0,1,0,600639,4971,101587,6369,0.04604653747823187,0.5616402116402116
35914,0.8956428571428573,2,0,2,600639,4971,101589,6367,0.04604653747823187,0.5615628858705239
35915,0.8956666666666665,0,1,0,600640,4970,101589,6367,0.04603727444514432,0.5616124195113346
35916,0.8956666666666666,1,5,1,600645,4965,101590,6366,0.04599095927970655,0.5618215514958962
35917,0.8956666666666667,0,1,0,600646,4964,101590,6366,0.04598169624661899,0.5618711385701677
35918,0.8957142857142856,1,1,1,600647,4963,101591,6365,0.045972433213531436,0.5618820621468926
35919,0.8957142857142857,0,2,0,600649,4961,101591,6365,0.04595390714735633,0.5619812820060038
35920,0.895738095238095,1,0,1,600649,4961,101592,6364,0.04595390714735633,0.5619426048565122
35921,0.8957499999999999,1,0,1,600649,4961,101593,6363,0.04595390714735633,0.5619039208760156
35922,0.8958333333333333,3,2,3,600651,4959,101596,6360,0.04593538108118122,0.5618870924993374
35923,0.8958333333333335,0,3,0,600654,4956,101596,6360,0.04590759198191856,0.5620360551431601
35924,0.8959999999999999,7,4,7,600658,4952,101603,6353,0.04587053984956834,0.5619637328615656
35925,0.8960000000000001,0,1,0,600659,4951,101603,6353,0.045861276816480785,0.5620134465675867
35926,0.8961071428571425,1,0,1,600659,4951,101604,6352,0.045861276816480785,0.5619746969831019
35927,0.8961190476190475,0,1,0,600660,4950,101604,6352,0.045852013783393236,0.5620244204565563
35928,0.8961666666666666,0,3,0,600663,4947,101604,6352,0.04582422468413057,0.5621736436852819
35929,0.8961666666666668,0,2,0,600665,4945,101604,6352,0.04580569861795546,0.5622731698681066
35930,0.89625,1,0,1,600665,4945,101605,6351,0.04580569861795546,0.5622344192634561
35931,0.8964285714285714,0,2,0,600667,4943,101605,6351,0.04578717255178035,0.5623339826456526
35932,0.8964761904761904,0,1,0,600668,4942,101605,6351,0.0457779095186928,0.5623837775613212
35933,0.8965000000000001,5,1,5,600669,4941,101610,6346,0.04576864648560525,0.5622397448391956
35934,0.8965476190476189,1,0,1,600669,4941,101611,6345,0.04576864648560525,0.562200956937799
35935,0.89665873015873,1,1,1,600670,4940,101612,6344,0.04575938345251769,0.5622119815668203
35936,0.8966666666666666,19,20,19,600690,4920,101631,6325,0.04557412279076661,0.5624722098710538
35937,0.8966666666666667,27,28,27,600718,4892,101658,6298,0.04531475786431509,0.5628239499553173
35938,0.8967142857142855,0,1,0,600719,4891,101658,6298,0.04530549483122754,0.562874251497006
35939,0.8967857142857143,0,1,0,600720,4890,101658,6298,0.045296231798139984,0.5629245620307473
35940,0.8968333333333334,2,1,2,600721,4889,101660,6296,0.04528696876505243,0.5628967367009388
35941,0.8969523809523808,0,1,0,600722,4888,101660,6296,0.04527770573196487,0.5629470672389127
35942,0.897,1,1,1,600723,4887,101661,6295,0.04526844269887732,0.56295832588088
35943,0.8970238095238094,0,1,0,600724,4886,101661,6295,0.04525917966578977,0.5630086754315357
35944,0.8970303030303031,0,1,0,600725,4885,101661,6295,0.04524991663270221,0.5630590339892666
35945,0.897047619047619,0,1,0,600726,4884,101661,6295,0.045240653599614655,0.5631094015564898
35946,0.8970833333333331,0,1,0,600727,4883,101661,6295,0.045231390566527106,0.5631597781356236
35947,0.8971190476190475,0,1,0,600728,4882,101661,6295,0.04522212753343955,0.5632101637290865
35948,0.8971428571428571,0,1,0,600729,4881,101661,6295,0.045212864500351994,0.5632605583392984
35949,0.8971428571428572,0,1,0,600730,4880,101661,6295,0.04520360146726444,0.5633109619686801
35950,0.8971666666666668,0,1,0,600731,4879,101661,6295,0.04519433843417689,0.5633613746196527
35951,0.8971984126984125,1,0,1,600731,4879,101662,6294,0.04519433843417689,0.5633222948178644
35952,0.8973333333333332,0,4,0,600735,4875,101662,6294,0.04515728630182667,0.5635240397528875
35953,0.8973333333333333,1,2,1,600737,4873,101663,6293,0.04513876023565156,0.5635858857245208
35954,0.8973333333333335,0,1,0,600738,4872,101663,6293,0.045129497202564005,0.5636363636363636
35955,0.8973809523809524,1,0,1,600738,4872,101664,6292,0.045129497202564005,0.5635972769616625
35956,0.8974999999999999,1,0,1,600738,4872,101665,6291,0.045129497202564005,0.5635581832840634
35957,0.8975,20,28,20,600766,4844,101685,6271,0.04487013227611249,0.5641925326135853
35958,0.8975000000000002,0,1,0,600767,4843,101685,6271,0.04486086924302494,0.5642432967428469
35959,0.8976666666666666,0,2,0,600769,4841,101685,6271,0.044842343176849826,0.5643448524118071
35960,0.8976666666666668,0,2,0,600771,4839,101685,6271,0.04482381711067472,0.5644464446444645
35961,0.8976785714285714,0,1,0,600772,4838,101685,6271,0.044814554077587165,0.5644972544783509
35962,0.8976904761904759,0,1,0,600773,4837,101685,6271,0.04480529104449961,0.564548073460569
35963,0.8977104839604838,1,0,1,600773,4837,101686,6270,0.04480529104449961,0.5645088682812641
35964,0.8977777777777777,0,1,0,600774,4836,101686,6270,0.044796028011412053,0.564559697460832
35965,0.8978333333333333,0,1,0,600775,4835,101686,6270,0.044786764978324504,0.5646105357946871
35966,0.8979007936507938,1,1,1,600776,4834,101687,6269,0.04477750194523695,0.5646221741871567
35967,0.8979166666666666,1,1,1,600777,4833,101688,6268,0.04476823891214939,0.5646338167732636
35968,0.8979761904761904,1,1,1,600778,4832,101689,6267,0.04475897587906184,0.5646454635552752
35969,0.898,9,4,9,600782,4828,101698,6258,0.04472192374671162,0.5644957604185459
35970,0.8980000000000001,0,1,0,600783,4827,101698,6258,0.04471266071362407,0.5645466847090663
35971,0.898047619047619,1,0,1,600783,4827,101699,6257,0.04471266071362407,0.5645073980512451
35972,0.8980660173160168,1,1,1,600784,4826,101700,6256,0.044703397680536515,0.5645190398844974
35973,0.8980714285714286,0,2,0,600786,4824,101700,6256,0.0446848716143614,0.5646209386281589
35974,0.898095238095238,0,3,0,600789,4821,101700,6256,0.04465708251509874,0.5647738557371129
35975,0.8981031746031743,0,1,0,600790,4820,101700,6256,0.04464781948201119,0.5648248465149873
35976,0.8981904761904762,1,1,1,600791,4819,101701,6255,0.04463855644892364,0.5648365540906628
35977,0.8982464773788302,0,3,0,600794,4816,101701,6255,0.044610767349660976,0.5649896125011291
35978,0.8982698412698413,0,1,0,600795,4815,101701,6255,0.04460150431657342,0.5650406504065041
35979,0.8983333333333333,9,5,9,600800,4810,101710,6246,0.04455518915113565,0.5649421128798843
35980,0.8983333333333334,11,11,11,600811,4799,101721,6235,0.04445329578717255,0.5650715968823636
35981,0.8983809523809524,1,2,1,600813,4797,101722,6234,0.04443476972099744,0.5651346206146315
35982,0.8985,2,3,2,600816,4794,101724,6232,0.04440698062173478,0.5652095048068202
35983,0.8985000000000001,1,1,1,600817,4793,101725,6231,0.044397717588647224,0.565221335268505
35984,0.8985595238095239,1,0,1,600817,4793,101726,6230,0.044397717588647224,0.5651818924067858
35985,0.8985620490620491,0,4,0,600821,4789,101726,6230,0.04436066545629701,0.565387058716762
35986,0.8985714285714286,2,2,2,600823,4787,101728,6228,0.0443421393901219,0.5654108034498411
35987,0.8986111111111111,0,1,0,600824,4786,101728,6228,0.04433287635703435,0.5654621390956964
35988,0.8986666666666666,1,4,1,600828,4782,101729,6227,0.04429582422468413,0.565628122445272
35989,0.8986666666666667,2,2,2,600830,4780,101731,6225,0.044277298158509025,0.5656519763743753
35990,0.898690476190476,0,3,0,600833,4777,101731,6225,0.04424950905924636,0.5658062170514452
35991,0.8988095238095238,1,1,1,600834,4776,101732,6224,0.04424024602615881,0.5658181818181818
35992,0.8988333333333333,1,0,1,600834,4776,101733,6223,0.04424024602615881,0.565778707155196
35993,0.8988333333333334,0,1,0,600835,4775,101733,6223,0.04423098299307125,0.5658301509365339
35994,0.8988730158730158,0,2,0,600837,4773,101733,6223,0.04421245692689614,0.5659330665696617
35995,0.8989999999999999,1,0,1,600837,4773,101734,6222,0.04421245692689614,0.5658935879945429
35996,0.899,3,2,3,600839,4771,101737,6219,0.044193930860721035,0.5658780709736124
35997,0.899047619047619,1,0,1,600839,4771,101738,6218,0.044193930860721035,0.5658385658385658
35998,0.899126984126984,0,1,0,600840,4770,101738,6218,0.04418466782763348,0.5658900618856935
35999,0.899142857142857,0,1,0,600841,4769,101738,6218,0.044175404794545924,0.5659415673068171
36000,0.8991428571428571,1,0,1,600841,4769,101739,6217,0.044175404794545924,0.5659020571636628
36001,0.8991666666666666,6,3,6,600844,4766,101745,6211,0.04414761569528326,0.565819440648629
36002,0.8991666666666667,2,4,2,600848,4762,101747,6209,0.044110563562933046,0.5659465864552
36003,0.8991666666666669,1,0,1,600848,4762,101748,6208,0.044110563562933046,0.5659070191431176
36004,0.8992142857142857,0,1,0,600849,4761,101748,6208,0.04410130052984549,0.5659586106299571
36005,0.8992738095238094,0,1,0,600850,4760,101748,6208,0.04409203749675794,0.5660102115244348
36006,0.8993333333333332,0,2,0,600852,4758,101748,6208,0.04407351143058283,0.5661134415465986
36007,0.8993333333333333,2,1,2,600853,4757,101750,6206,0.04406424839749527,0.5660859253853872
36008,0.8993333333333335,1,0,1,600853,4757,101751,6205,0.04406424839749527,0.5660463419084109
36009,0.8993412698412696,0,2,0,600855,4755,101751,6205,0.04404572233132017,0.5661496350364964
36010,0.8994047619047619,0,1,0,600856,4754,101751,6205,0.04403645929823261,0.5662012957386623
36011,0.8994166666666668,1,1,1,600857,4753,101752,6204,0.044027196265145056,0.5662133795747011
36012,0.8995000000000001,1,2,1,600859,4751,101753,6203,0.04400867019896995,0.5662771590286654
36013,0.8995833333333334,0,1,0,600860,4750,101753,6203,0.043999407165882395,0.5663288596731489
36014,0.8996190476190474,0,2,0,600862,4748,101753,6203,0.04398088109970729,0.5664322892886494
36015,0.8996666666666667,0,1,0,600863,4747,101753,6203,0.043971618066619735,0.5664840182648402
36016,0.8996666666666668,1,0,1,600863,4747,101754,6202,0.043971618066619735,0.5664444241483241
36017,0.8997380952380952,0,1,0,600864,4746,101754,6202,0.04396235503353218,0.5664961636828645
36018,0.8997857142857143,0,1,0,600865,4745,101754,6202,0.04395309200044462,0.5665479126701379
36019,0.8999047619047619,1,0,1,600865,4745,101755,6201,0.04395309200044462,0.5665083135391924
36020,0.8999999999999999,1,0,1,600865,4745,101756,6200,0.04395309200044462,0.5664687071722248
36021,0.9,610,486,610,601351,4259,102366,5590,0.03945125791989329,0.5675703117067723
36022,0.9000000000000001,0,4,0,601355,4255,102366,5590,0.03941420578754307,0.5678009141696293
36023,0.9000101010101008,0,2,0,601357,4253,102366,5590,0.03939567972136796,0.5679162856852585
36024,0.9000555555555555,0,1,0,601358,4252,102366,5590,0.03938641668828041,0.5679739890266206
36025,0.9001349206349205,1,0,1,601358,4252,102367,5589,0.03938641668828041,0.5679300884056498
36026,0.9001666666666667,2,1,2,601359,4251,102369,5587,0.039377153655192856,0.5678999796706647
36027,0.9002380952380951,1,0,1,601359,4251,102370,5586,0.039377153655192856,0.5678560536749009
36028,0.9002619047619048,1,0,1,601359,4251,102371,5585,0.039377153655192856,0.5678121187474583
36029,0.9002878787878789,0,1,0,601360,4250,102371,5585,0.0393678906221053,0.5678698525673614
36030,0.9003131313131313,1,0,1,601360,4250,102372,5584,0.0393678906221053,0.5678259101077893
36031,0.9003333333333333,1,0,1,601360,4250,102373,5583,0.0393678906221053,0.5677819587104648
36032,0.9004047619047618,0,2,0,601362,4248,102373,5583,0.039349364555930195,0.5678974671956057
36033,0.9004650072150071,0,1,0,601363,4247,102373,5583,0.03934010152284264,0.5679552390640895
36034,0.9005,0,1,0,601364,4246,102373,5583,0.039330838489755084,0.5680130226879642
36035,0.9006190476190475,0,2,0,601366,4244,102373,5583,0.03931231242357998,0.568128625216241
36036,0.9006666666666665,1,0,1,601366,4244,102374,5582,0.03931231242357998,0.568084673315693
36037,0.9006666666666667,2,1,2,601367,4243,102376,5580,0.03930304939049242,0.5680545658149242
36038,0.9007420634920632,1,1,1,601368,4242,102377,5579,0.03929378635740487,0.5680684248039914
36039,0.9008095238095236,1,0,1,601368,4242,102378,5578,0.03929378635740487,0.5680244399185336
36040,0.9008333333333332,5,5,5,601373,4237,102383,5573,0.0392474711919671,0.5680937818552497
36041,0.9008333333333334,2,6,2,601379,4231,102385,5571,0.03919189299344177,0.5683533972658641
36042,0.9009047619047618,0,1,0,601380,4230,102385,5571,0.039182629960354216,0.5684113865932048
36043,0.901,5,6,5,601386,4224,102390,5566,0.039127051761828895,0.5685393258426966
36044,0.901047619047619,1,0,1,601386,4224,102391,5565,0.039127051761828895,0.5684952497701502
36045,0.9010714285714286,0,1,0,601387,4223,102391,5565,0.03911778872874134,0.5685533306089089
36046,0.9011666666666668,0,1,0,601388,4222,102391,5565,0.03910852569565378,0.5686114233166445
36047,0.9011865079365076,0,1,0,601389,4221,102391,5565,0.039099262662566234,0.5686695278969958
36048,0.9011993521184698,2,0,2,601389,4221,102393,5563,0.039099262662566234,0.5685813573180704
36049,0.90125,1,1,1,601390,4220,102394,5562,0.03908999962947868,0.5685953792680434
36050,0.9013333333333332,1,1,1,601391,4219,102395,5561,0.03908073659639112,0.5686094069529652
36051,0.9013333333333334,2,4,2,601395,4215,102397,5559,0.039043684464040905,0.5687538367096379
36052,0.9014285714285714,1,0,1,601395,4215,102398,5558,0.039043684464040905,0.5687097104266857
36053,0.9015,0,1,0,601396,4214,102398,5558,0.03903442143095335,0.5687679083094556
36054,0.9015119047619048,0,2,0,601398,4212,102398,5558,0.039015895364778244,0.5688843398157626
36055,0.9015714285714286,1,0,1,601398,4212,102399,5557,0.039015895364778244,0.5688402088238305
36056,0.9015833333333332,0,1,0,601399,4211,102399,5557,0.03900663233169069,0.5688984438984439
36057,0.9016190476190477,0,1,0,601400,4210,102399,5557,0.03899736929860313,0.5689566908979216
36058,0.9016309523809524,0,1,0,601401,4209,102399,5557,0.03898810626551558,0.5690149498259267
36059,0.9016666666666666,6,7,6,601408,4202,102405,5551,0.0389232650339027,0.5691582077309546
36060,0.9016666666666668,7,7,7,601415,4195,102412,5544,0.03885842380228982,0.5692576239860355
36061,0.9016944444444444,0,1,0,601416,4194,102412,5544,0.038849160769202265,0.5693160813308688
36062,0.9017499999999998,0,1,0,601417,4193,102412,5544,0.038839897736114716,0.5693745506829619
36063,0.9017857142857142,0,2,0,601419,4191,102412,5544,0.038821371669939604,0.5694915254237288
36064,0.9018095238095236,0,1,0,601420,4190,102412,5544,0.03881210863685205,0.5695500308198068
36065,0.9018333333333334,0,2,0,601422,4188,102412,5544,0.03879358257067694,0.5696670776818742
36066,0.9018809523809524,0,1,0,601423,4187,102412,5544,0.03878431953758939,0.569725619155277
36067,0.901904761904762,0,1,0,601424,4186,102412,5544,0.03877505650450183,0.5697841726618705
36068,0.9019357864357864,1,1,1,601425,4185,102413,5543,0.03876579347141428,0.5697985197368421
36069,0.9019880952380952,0,1,0,601426,4184,102413,5543,0.038756530438326726,0.5698570987971625
36070,0.902,7,4,7,601430,4180,102420,5536,0.03871947830597651,0.569781803211198
36071,0.902047619047619,1,0,1,601430,4180,102421,5535,0.03871947830597651,0.5697375193000515
36072,0.9020714285714284,0,1,0,601431,4179,102421,5535,0.038710215272888954,0.5697961704756023
36073,0.9020833333333336,1,1,1,601432,4178,102422,5534,0.0387009522398014,0.5698105436573312
36074,0.9021428571428572,0,1,0,601433,4177,102422,5534,0.03869168920671385,0.5698692204716301
36075,0.9021666666666666,0,1,0,601434,4176,102422,5534,0.03868242617362629,0.5699279093717816
36076,0.9021666666666668,0,1,0,601435,4175,102422,5534,0.03867316314053874,0.5699866103615202
36077,0.90225,0,2,0,601437,4173,102422,5534,0.03865463707436363,0.5701040486247039
36078,0.9022619047619048,1,0,1,601437,4173,102423,5533,0.03865463707436363,0.5700597568514321
36079,0.9023333333333332,0,4,0,601441,4169,102423,5533,0.038617584942013415,0.5702947845804989
36080,0.902392857142857,0,1,0,601442,4168,102423,5533,0.03860832190892586,0.570353571796722
36081,0.9023931623931624,0,1,0,601443,4167,102423,5533,0.0385990588758383,0.5704123711340207
36082,0.9024761904761904,0,1,0,601444,4166,102423,5533,0.03858979584275075,0.5704711825961439
36083,0.9025,13,13,13,601457,4153,102436,5520,0.03846937641261255,0.5706606016747648
36084,0.9025357142857144,1,0,1,601457,4153,102437,5519,0.03846937641261255,0.570616211745244
36085,0.9026666666666664,0,1,0,601458,4152,102437,5519,0.03846011337952499,0.5706752145589908
36086,0.9026666666666666,1,2,1,601460,4150,102438,5518,0.03844158731334988,0.5707488622258998
36087,0.9028333333333332,0,4,0,601464,4146,102438,5518,0.03840453518099966,0.5709850993377483
36088,0.9028333333333336,1,0,1,601464,4146,102439,5517,0.03840453518099966,0.5709407016454517
36089,0.9028571428571428,1,0,1,601464,4146,102440,5516,0.03840453518099966,0.570896294762989
36090,0.9029040404040404,0,1,0,601465,4145,102440,5516,0.038395272147912114,0.5709553876410309
36091,0.902904761904762,1,1,1,601466,4144,102441,5515,0.03838600911482456,0.5709700797183973
36092,0.9029166666666666,0,1,0,601467,4143,102441,5515,0.038376746081737,0.571029198591841
36093,0.9029365079365078,0,1,0,601468,4142,102441,5515,0.038367483048649446,0.5710883297090193
36094,0.9029592352092354,1,2,1,601470,4140,102442,5514,0.03834895698247434,0.5711622125543816
36095,0.9029761904761904,1,0,1,601470,4140,102443,5513,0.03834895698247434,0.5711177872164094
36096,0.903,2,2,2,601472,4138,102445,5511,0.03833043091629923,0.5711472691470618
36097,0.9031349206349206,0,3,0,601475,4135,102445,5511,0.03830264181703657,0.5713249015135807
36098,0.9031666666666668,1,0,1,601475,4135,102446,5510,0.03830264181703657,0.5712804561949196
36099,0.9032575757575756,0,1,0,601476,4134,102446,5510,0.03829337878394902,0.5713396930734135
36100,0.9033055555555556,1,0,1,601476,4134,102447,5509,0.03829337878394902,0.5712952400705175
36101,0.9033333333333332,30,23,30,601499,4111,102477,5479,0.03808032902293527,0.5713242961418143
36102,0.9033333333333334,21,14,21,601513,4097,102498,5458,0.03795064655970951,0.5712192569335427
36103,0.9034484126984128,0,2,0,601515,4095,102498,5458,0.0379321204935344,0.5713388464356747
36104,0.9035,2,6,2,601521,4089,102500,5456,0.03787654229500908,0.5716081718177056
36105,0.9035714285714286,0,1,0,601522,4088,102500,5456,0.03786727926192152,0.5716680637049455
36106,0.9035833333333332,0,1,0,601523,4087,102500,5456,0.03785801622883397,0.5717279681441895
36107,0.9036666666666668,0,1,0,601524,4086,102500,5456,0.03784875319574642,0.5717878851393837
36108,0.9037023809523808,1,0,1,601524,4086,102501,5455,0.03784875319574642,0.5717430038780003
36109,0.9037142857142856,2,1,2,601525,4085,102503,5453,0.03783949016265886,0.5717131474103586
36110,0.90375,0,1,0,601526,4084,102503,5453,0.037830227129571306,0.5717730942644438
36111,0.9038095238095236,1,0,1,601526,4084,102504,5452,0.037830227129571306,0.5717281879194631
36112,0.9038095238095238,0,1,0,601527,4083,102504,5452,0.03782096409648375,0.5717881489250131
36113,0.9038333333333334,0,1,0,601528,4082,102504,5452,0.0378117010633962,0.5718481225089155
36114,0.9038571428571428,0,1,0,601529,4081,102504,5452,0.037802438030308645,0.5719081086751285
36115,0.9038888888888889,0,1,0,601530,4080,102504,5452,0.03779317499722109,0.5719681074276123
36116,0.9039545454545456,1,0,1,601530,4080,102505,5451,0.03779317499722109,0.5719231979855209
36117,0.904,5,6,5,601536,4074,102510,5446,0.03773759679869577,0.5720588235294117
36118,0.9041191237383184,1,1,1,601537,4073,102511,5445,0.03772833376560821,0.5720739651187224
36119,0.90415873015873,1,0,1,601537,4073,102512,5444,0.03772833376560821,0.5720290007355259
36120,0.9041666666666666,2,3,2,601540,4070,102514,5442,0.03770054466634555,0.5721194280908326
36121,0.9041666666666668,1,2,1,601542,4068,102515,5441,0.03768201860017044,0.5721947628562415
36122,0.9042142857142856,0,1,0,601543,4067,102515,5441,0.03767275556708288,0.5722549432057215
36123,0.9042499999999998,1,0,1,601543,4067,102516,5440,0.03767275556708288,0.5722099505627433
36124,0.9042857142857144,0,2,0,601545,4065,102516,5440,0.03765422950090778,0.572330352446081
36125,0.9043333333333332,1,2,1,601547,4063,102517,5439,0.037635703434732666,0.5724058093033045
36126,0.9044642857142856,1,0,1,601547,4063,102518,5438,0.037635703434732666,0.5723608041258815
36127,0.9044761904761904,0,1,0,601548,4062,102518,5438,0.03762644040164512,0.5724210526315789
36128,0.9045,3,3,3,601551,4059,102521,5435,0.03759865130238245,0.5724668211502001
36129,0.904642857142857,0,1,0,601552,4058,102521,5435,0.0375893882692949,0.5725271252501843
36130,0.9046428571428572,1,0,1,601552,4058,102522,5434,0.0375893882692949,0.5724820901812052
36131,0.9046666666666664,0,1,0,601553,4057,102522,5434,0.037580125236207344,0.5725424085976188
36132,0.9046666666666668,1,3,1,601556,4054,102523,5433,0.03755233613694468,0.572678402023822
36133,0.9048333333333334,3,2,3,601558,4052,102526,5430,0.03753381007076957,0.5726639949377769
36134,0.9048571428571428,0,1,0,601559,4051,102526,5430,0.037524547037682016,0.5727243961607426
36135,0.905,97,69,97,601628,3982,102623,5333,0.03688539775464078,0.572517444981213
36136,0.9050961538461536,0,3,0,601631,3979,102623,5333,0.03685760865537812,0.5727018900343642
36137,0.9051666666666668,1,1,1,601632,3978,102624,5332,0.036848345622290564,0.572717508055854
36138,0.90525,0,1,0,601633,3977,102624,5332,0.03683908258920301,0.5727790310452251
36139,0.905297619047619,1,1,1,601634,3976,102625,5331,0.03682981955611545,0.5727946706779843
36140,0.9053095238095236,1,0,1,601634,3976,102626,5330,0.03682981955611545,0.5727487642381259
36141,0.9053333333333332,1,1,1,601635,3975,102627,5329,0.0368205565230279,0.5727644024075667
36142,0.9053809523809524,0,2,0,601637,3973,102627,5329,0.03680203045685279,0.5728875510642872
36143,0.9054166666666664,0,2,0,601639,3971,102627,5329,0.036783504390677686,0.573010752688172
36144,0.9054761904761904,1,0,1,601639,3971,102628,5328,0.036783504390677686,0.5729648349284869
36145,0.9055,1,1,1,601640,3970,102629,5327,0.03677424135759013,0.5729805313542002
36146,0.9055555555555556,1,0,1,601640,3970,102630,5326,0.03677424135759013,0.572934595524957
36147,0.9055833333333334,0,1,0,601641,3969,102630,5326,0.036764978324502574,0.5729962345346961
36148,0.9056190476190474,1,0,1,601641,3969,102631,5325,0.036764978324502574,0.5729502905100065
36149,0.9056190476190475,0,1,0,601642,3968,102631,5325,0.03675571529141502,0.5730119444743356
36150,0.9056428571428572,0,1,0,601643,3967,102631,5325,0.03674645225832747,0.573073611708997
36151,0.9056666666666664,1,0,1,601643,3967,102632,5324,0.03674645225832747,0.5730276611774836
36152,0.9056666666666668,1,0,1,601643,3967,102633,5323,0.03674645225832747,0.5729817007534984
36153,0.9057142857142856,1,1,1,601644,3966,102634,5322,0.036737189225239913,0.5729974160206718
36154,0.9058333333333332,5,1,5,601645,3965,102639,5317,0.03672792619215236,0.572829131652661
36155,0.9058333333333334,4,2,4,601647,3963,102643,5313,0.03670940012597725,0.5727684346701164
36156,0.9059285714285714,1,1,1,601648,3962,102644,5312,0.0367001370928897,0.5727841276687513
36157,0.9059642857142858,0,1,0,601649,3961,102644,5312,0.03669087405980214,0.5728458966893131
36158,0.906,9,3,9,601652,3958,102653,5303,0.03666308496053948,0.5726163481265522
36159,0.9060173160173162,1,0,1,601652,3958,102654,5302,0.03666308496053948,0.5725701943844492
36160,0.9061111111111112,0,1,0,601653,3957,102654,5302,0.036653821927451924,0.5726320336969435
36161,0.906186507936508,1,0,1,601653,3957,102655,5301,0.036653821927451924,0.5725858716785482
36162,0.90625,1,1,1,601654,3956,102656,5300,0.03664455889436437,0.5726015557476232
36163,0.9063333333333332,2,1,2,601655,3955,102658,5298,0.03663529586127682,0.5725710580352318
36164,0.9064047619047618,1,0,1,601655,3955,102659,5297,0.03663529586127682,0.57252485948984
36165,0.906468253968254,0,1,0,601656,3954,102659,5297,0.03662603282818926,0.5725867473786618
36166,0.9065,4,4,4,601660,3950,102663,5293,0.036588980695839046,0.5726495726495726
36167,0.9065476190476188,1,0,1,601660,3950,102664,5292,0.036588980695839046,0.5726033326119887
36168,0.906595238095238,0,1,0,601661,3949,102664,5292,0.03657971766275149,0.5726652959636404
36169,0.9066190476190475,0,1,0,601662,3948,102664,5292,0.036570454629663934,0.5727272727272728
36170,0.9066666666666666,23,20,23,601682,3928,102687,5269,0.03638519396791285,0.5729042078938784
36171,0.9066666666666668,33,20,33,601702,3908,102720,5236,0.036199933306161766,0.5726159230096238
36172,0.9067380952380952,0,1,0,601703,3907,102720,5236,0.03619067027307422,0.5726785518976266
36173,0.90675,0,1,0,601704,3906,102720,5236,0.03618140723998666,0.5727411944869831
36174,0.9068084970584968,3,0,3,601704,3906,102723,5233,0.03618140723998666,0.5726009410219937
36175,0.9068333333333334,1,2,1,601706,3904,102724,5232,0.036162881173811556,0.5726795096322241
36176,0.906952380952381,0,1,0,601707,3903,102724,5232,0.036153618140724,0.5727422003284073
36177,0.9069999999999996,0,1,0,601708,3902,102724,5232,0.036144355107636444,0.5728049047514779
36178,0.907,3,1,3,601709,3901,102727,5229,0.03613509207454889,0.5727272727272728
36179,0.9070833333333332,1,0,1,601709,3901,102728,5228,0.03613509207454889,0.5726804688355789
36180,0.907095238095238,0,1,0,601710,3900,102728,5228,0.03612582904146134,0.5727432077125328
36181,0.9071428571428573,1,0,1,601710,3900,102729,5227,0.03612582904146134,0.5726963953106169
36182,0.9071666666666666,1,0,1,601710,3900,102730,5226,0.03612582904146134,0.5726495726495726
36183,0.9072222222222224,0,1,0,601711,3899,102730,5226,0.036116566008373784,0.5727123287671233
36184,0.9073333333333332,3,3,3,601714,3896,102733,5223,0.03608877690911112,0.5727601710713894
36185,0.9073809523809524,1,0,1,601714,3896,102734,5222,0.03608877690911112,0.5727133143233165
36186,0.907440476190476,0,3,0,601717,3893,102734,5222,0.036060987809848455,0.5729018102029622
36187,0.9075,20,20,20,601737,3873,102754,5202,0.03587572714809737,0.5732231404958678
36188,0.9075000000000002,0,1,0,601738,3872,102754,5202,0.03586646411500982,0.5732863125413269
36189,0.9075238095238096,0,1,0,601739,3871,102754,5202,0.035857201081922266,0.5733494985120687
36190,0.9076428571428572,2,0,2,601739,3871,102756,5200,0.035857201081922266,0.5732554293903649
36191,0.9076666666666666,1,0,1,601739,3871,102757,5199,0.035857201081922266,0.5732083792723264
36192,0.9076904761904764,0,1,0,601740,3870,102757,5199,0.03584793804883471,0.5732715845186901
36193,0.9078333333333332,1,1,1,601741,3869,102758,5198,0.035838675015747154,0.5732877467740156
36194,0.9078571428571428,0,4,0,601745,3865,102758,5198,0.03580162288339694,0.5735407701644047
36195,0.9079523809523812,0,1,0,601746,3864,102758,5198,0.03579235985030939,0.5736040609137056
36196,0.907968253968254,0,1,0,601747,3863,102758,5198,0.03578309681722183,0.5736673656329323
36197,0.9079999999999998,0,1,0,601748,3862,102758,5198,0.035773833784134276,0.5737306843267108
36198,0.908,7,3,7,601751,3859,102765,5191,0.035746044684871615,0.5735911602209944
36199,0.9080476190476188,0,1,0,601752,3858,102765,5191,0.03573678165178406,0.5736545474638082
36200,0.9081666666666663,1,0,1,601752,3858,102766,5190,0.03573678165178406,0.5736074270557029
36201,0.9081666666666668,2,1,2,601753,3857,102768,5188,0.035727518618696504,0.5735765616362631
36202,0.908181818181818,0,1,0,601754,3856,102768,5188,0.035718255585608955,0.5736399823087129
36203,0.9082142857142856,2,0,2,601754,3856,102770,5186,0.035718255585608955,0.5735456757354568
36204,0.9082228327228326,0,1,0,601755,3855,102770,5186,0.0357089925525214,0.573609114036058
36205,0.9082857142857144,1,0,1,601755,3855,102771,5185,0.0357089925525214,0.5735619469026548
36206,0.9083333333333332,9,7,9,601762,3848,102780,5176,0.03564415132090852,0.5735815602836879
36207,0.9083333333333334,4,5,4,601767,3843,102784,5172,0.03559783615547075,0.5737104825291182
36208,0.908404761904762,0,1,0,601768,3842,102784,5172,0.03558857312238319,0.5737741291324606
36209,0.9085,2,2,2,601770,3840,102786,5170,0.03557004705620809,0.5738068812430632
36210,0.9085714285714286,1,1,1,601771,3839,102787,5169,0.03556078402312053,0.5738232682060391
36211,0.9086111111111111,0,1,0,601772,3838,102787,5169,0.035551520990032975,0.5738869767958255
36212,0.9086666666666666,0,3,0,601775,3835,102787,5169,0.035523731890770315,0.5740781874722346
36213,0.9086666666666668,0,2,0,601777,3833,102787,5169,0.0355052058245952,0.5742057320595423
36214,0.908746031746032,0,1,0,601778,3832,102787,5169,0.035495942791507654,0.5742695256082657
36215,0.90875,3,0,3,601778,3832,102790,5166,0.035495942791507654,0.574127583907535
36216,0.9087738095238096,1,0,1,601778,3832,102791,5165,0.035495942791507654,0.5740802489718795
36217,0.9088333333333332,1,1,1,601779,3831,102792,5164,0.0354866797584201,0.5740967204002223
36218,0.9088593073593072,1,0,1,601779,3831,102793,5163,0.0354866797584201,0.5740493662441628
36219,0.908952380952381,0,3,0,601782,3828,102793,5163,0.03545889065915744,0.574240907574241
36220,0.909,0,2,0,601784,3826,102793,5163,0.035440364592982325,0.5743686728223384
36221,0.9090476190476192,0,1,0,601785,3825,102793,5163,0.03543110155989477,0.5744325767690254
36222,0.9090782828282828,1,0,1,601785,3825,102794,5162,0.03543110155989477,0.5743852231000334
36223,0.9091428571428573,0,2,0,601787,3823,102794,5162,0.035412575493719664,0.5745130773511408
36224,0.9091666666666666,2,2,2,601789,3821,102796,5160,0.03539404942754455,0.57454626433582
36225,0.9091666666666668,3,3,3,601792,3818,102799,5157,0.03536626032828189,0.5745961002785516
36226,0.909190476190476,0,2,0,601794,3816,102799,5157,0.035347734262106786,0.5747241725175527
36227,0.9092142857142856,0,1,0,601795,3815,102799,5157,0.03533847122901923,0.5747882300490414
36228,0.9093333333333332,3,2,3,601797,3813,102802,5154,0.03531994516284412,0.5747741719638675
36229,0.9094166666666668,1,0,1,601797,3813,102803,5153,0.03531994516284412,0.5747267454829356
36230,0.9094999999999998,1,0,1,601797,3813,102804,5152,0.03531994516284412,0.5746793084216397
36231,0.9095,1,1,1,601798,3812,102805,5151,0.03531068212975657,0.5746959723306928
36232,0.9096103896103896,0,1,0,601799,3811,102805,5151,0.035301419096669014,0.5747600981923677
36233,0.9096388888888888,1,1,1,601800,3810,102806,5150,0.03529215606358146,0.5747767857142857
36234,0.9096428571428572,1,2,1,601802,3808,102807,5149,0.03527362999740635,0.5748576532321089
36235,0.9096666666666668,2,0,2,601802,3808,102809,5147,0.03527362999740635,0.5747627024008933
36236,0.9098333333333332,2,0,2,601802,3808,102811,5145,0.03527362999740635,0.5746677091477717
36237,0.9098333333333334,0,1,0,601803,3807,102811,5145,0.0352643669643188,0.5747319034852547
36238,0.9098968253968254,0,1,0,601804,3806,102811,5145,0.03525510393123124,0.5747961121662384
36239,0.9099166666666666,0,1,0,601805,3805,102811,5145,0.035245840898143685,0.5748603351955307
36240,0.9099761904761904,2,1,2,601806,3804,102813,5143,0.035236577865056136,0.5748295518050743
36241,0.9099999999999998,2,0,2,601806,3804,102815,5141,0.035236577865056136,0.5747344885410844
36242,0.91,530,407,530,602213,3397,103345,4611,0.03146652339842158,0.5757992007992008
36243,0.9101666666666666,1,0,1,602213,3397,103346,4610,0.03146652339842158,0.5757462220557013
36244,0.9101666666666668,1,0,1,602213,3397,103347,4609,0.03146652339842158,0.5756932300774419
36245,0.9102222222222224,0,1,0,602214,3396,103347,4609,0.03145726036533403,0.5757651467832605
36246,0.9103333333333332,3,1,3,602215,3395,103350,4606,0.03144799733224647,0.5756780402449694
36247,0.9103571428571428,0,1,0,602216,3394,103350,4606,0.031438734299158916,0.57575
36248,0.9104761904761904,0,1,0,602217,3393,103350,4606,0.03142947126607136,0.5758219777472184
36249,0.9105,2,1,2,602218,3392,103352,4604,0.03142020823298381,0.5757878939469735
36250,0.9105714285714284,0,1,0,602219,3391,103352,4604,0.031410945199896255,0.5758599124452783
36251,0.9106666666666666,1,2,1,602221,3389,103353,4603,0.03139241913372114,0.575950950950951
36252,0.9106666666666668,1,0,1,602221,3389,103354,4602,0.03139241913372114,0.5758978851207609
36253,0.9108333333333332,3,2,3,602223,3387,103357,4599,0.03137389306754604,0.5758827948910593
36254,0.9108333333333334,1,2,1,602225,3385,103358,4598,0.031355367001370926,0.5759739446323437
36255,0.9108730158730158,0,1,0,602226,3384,103358,4598,0.03134610396828338,0.5760461037334001
36256,0.911,1,1,1,602227,3383,103359,4597,0.03133684093519582,0.5760651629072682
36257,0.9110714285714286,0,1,0,602228,3382,103359,4597,0.031327577902108265,0.5761373605715002
36258,0.9110833333333334,0,1,0,602229,3381,103359,4597,0.03131831486902071,0.576209576334921
36259,0.9111904761904762,0,1,0,602230,3380,103359,4597,0.03130905183593316,0.5762818102043374
36260,0.9112344877344872,1,0,1,602230,3380,103360,4596,0.03130905183593316,0.5762286860581746
36261,0.9113333333333332,2,2,2,602232,3378,103362,4594,0.03129052576975805,0.5762669342699448
36262,0.9114761904761906,1,0,1,602232,3378,103363,4593,0.03129052576975805,0.5762137749341363
36263,0.9114920634920636,0,2,0,602234,3376,103363,4593,0.031271999703582944,0.5763583887564312
36264,0.9115,1,3,1,602237,3373,103364,4592,0.03124421060432028,0.5765222849968613
36265,0.9115436507936509,1,0,1,602237,3373,103365,4591,0.03124421060432028,0.5764691109994977
36266,0.9116388888888888,0,3,0,602240,3370,103365,4591,0.031216421505057615,0.5766863459364402
36267,0.9116666666666666,10,5,10,602245,3365,103375,4581,0.031170106339619846,0.5765164862824063
36268,0.9116666666666668,9,12,9,602257,3353,103384,4572,0.031058949942569195,0.5769085173501577
36269,0.911690476190476,0,1,0,602258,3352,103384,4572,0.03104968690948164,0.5769813225643614
36270,0.9117500000000004,1,1,1,602259,3351,103385,4571,0.031040423876394087,0.5770007573844989
36271,0.912,2,5,2,602264,3346,103387,4569,0.030994108710956314,0.5772583701831965
36272,0.912063492063492,0,1,0,602265,3345,103387,4569,0.03098484567786876,0.5773313115996968
36273,0.912126984126984,0,2,0,602267,3343,103387,4569,0.030966319611693653,0.5774772497472194
36274,0.912142857142857,1,0,1,602267,3343,103388,4568,0.030966319611693653,0.5774238402224751
36275,0.9121666666666668,1,0,1,602267,3343,103389,4567,0.030966319611693653,0.5773704171934261
36276,0.9123333333333332,1,1,1,602268,3342,103390,4566,0.030957056578606097,0.5773899848254932
36277,0.9123333333333334,0,1,0,602269,3341,103390,4566,0.030947793545518545,0.5774630074617427
36278,0.9123571428571428,0,1,0,602270,3340,103390,4566,0.03093853051243099,0.5775360485707058
36279,0.9125,15,22,15,602292,3318,103405,4551,0.0307347437845048,0.578345406023637
36280,0.9125952380952378,0,1,0,602293,3317,103405,4551,0.030725480751417244,0.5784189120488052
36281,0.9126190476190478,0,1,0,602294,3316,103405,4551,0.03071621771832969,0.5784924367611541
36282,0.9126666666666666,0,2,0,602296,3314,103405,4551,0.030697691652154583,0.5786395422759059
36283,0.9127857142857144,0,1,0,602297,3313,103405,4551,0.030688428619067027,0.5787131230925737
36284,0.9128333333333332,0,6,0,602303,3307,103405,4551,0.030632850420541702,0.5791550012725885
36285,0.9128787878787878,0,1,0,602304,3306,103405,4551,0.03062358738745415,0.5792287132493318
36286,0.9129166666666668,1,1,1,602305,3305,103406,4550,0.030614324354366593,0.5792488860598345
36287,0.913,2,6,2,602311,3299,103408,4548,0.030558746155841268,0.5795845546068561
36288,0.9130865800865802,0,1,0,602312,3298,103408,4548,0.030549483122753716,0.5796584246749936
36289,0.9131031746031746,0,1,0,602313,3297,103408,4548,0.03054022008966616,0.5797323135755258
36290,0.9131428571428571,2,0,2,602313,3297,103410,4546,0.03054022008966616,0.5796251434400101
36291,0.9131666666666668,0,2,0,602315,3295,103410,4546,0.03052169402349105,0.5797729881392679
36292,0.9132142857142856,1,1,1,602316,3294,103411,4545,0.0305124309904035,0.5797933409873708
36293,0.9132380952380952,0,1,0,602317,3293,103411,4545,0.030503167957315943,0.579867313090074
36294,0.9133333333333332,19,26,19,602343,3267,103430,4526,0.030262329097039534,0.5807776209418709
36295,0.9133333333333334,25,10,25,602353,3257,103455,4501,0.03016969876616399,0.5801753029131219
36296,0.9135,0,3,0,602356,3254,103455,4501,0.03014190966690133,0.5803997421018697
36297,0.9137142857142856,0,2,0,602358,3252,103455,4501,0.030123383600726222,0.5805494647233329
36298,0.9137380952380956,0,1,0,602359,3251,103455,4501,0.030114120567638666,0.58062435500516
36299,0.9139047619047618,0,1,0,602360,3250,103455,4501,0.030104857534551114,0.580699264611018
36300,0.914,8,12,8,602372,3238,103463,4493,0.029993701137500463,0.581166731341353
36301,0.914003968253968,1,1,1,602373,3237,103464,4492,0.029984438104412908,0.5811877345064045
36302,0.914047619047619,0,1,0,602374,3236,103464,4492,0.029975175071325355,0.5812629399585921
36303,0.9141071428571428,0,1,0,602375,3235,103464,4492,0.0299659120382378,0.5813381648764074
36304,0.9141666666666666,5,1,5,602376,3234,103469,4487,0.029956649005150247,0.5811423390752494
36305,0.9141666666666668,2,2,2,602378,3232,103471,4485,0.029938122938975138,0.5811843980821563
36306,0.9141904761904762,0,1,0,602379,3231,103471,4485,0.029928859905887582,0.5812597200622084
36307,0.9142857142857144,1,1,1,602380,3230,103472,4484,0.02991959687280003,0.5812807881773399
36308,0.9144166666666668,1,0,1,602380,3230,103473,4483,0.02991959687280003,0.5812265007130818
36309,0.9144523809523808,0,1,0,602381,3229,103473,4483,0.029910333839712474,0.5813018672199171
36310,0.9145,2,0,2,602381,3229,103475,4481,0.029910333839712474,0.5811932555123217
36311,0.9146666666666668,0,1,0,602382,3228,103475,4481,0.02990107080662492,0.5812686470359321
36312,0.914732683982684,0,3,0,602385,3225,103475,4481,0.029873281707362257,0.5814949390085647
36313,0.9148333333333336,0,1,0,602386,3224,103475,4481,0.029864018674274705,0.581570408825438
36314,0.9148809523809522,0,1,0,602387,3223,103475,4481,0.02985475564118715,0.5816458982346833
36315,0.9148809523809524,1,0,1,602387,3223,103476,4480,0.02985475564118715,0.5815915876931066
36316,0.9149047619047618,0,1,0,602388,3222,103476,4480,0.029845492608099596,0.5816670994546871
36317,0.915,77,84,77,602472,3138,103553,4403,0.029067397828745043,0.5838748176634398
36318,0.9150238095238096,1,1,1,602473,3137,103554,4402,0.02905813479565749,0.5838970685767343
36319,0.9150714285714286,0,1,0,602474,3136,103554,4402,0.029048871762569935,0.5839745290527991
36320,0.9152222222222224,0,2,0,602476,3134,103554,4402,0.029030345696394826,0.5841295116772823
36321,0.9154166666666664,0,2,0,602478,3132,103554,4402,0.029011819630219718,0.5842845765861429
36322,0.9154523809523808,0,1,0,602479,3131,103554,4402,0.029002556597132165,0.5843621399176955
36323,0.9154761904761906,0,1,0,602480,3130,103554,4402,0.02899329356404461,0.5844397238449283
36324,0.9155,0,1,0,602481,3129,103554,4402,0.028984030530957057,0.5845173283760456
36325,0.9155555555555556,0,1,0,602482,3128,103554,4402,0.0289747674978695,0.5845949535192563
36326,0.915559523809524,0,2,0,602484,3126,103554,4402,0.028956241431694393,0.584750265674814
36327,0.9155952380952382,0,1,0,602485,3125,103554,4402,0.02894697839860684,0.5848279527036003
36328,0.9156666666666666,0,1,0,602486,3124,103554,4402,0.028937715365519284,0.5849056603773585
36329,0.9157142857142856,0,4,0,602490,3120,103554,4402,0.028900663233169067,0.5852166976867854
36330,0.9158333333333332,1,0,1,602490,3120,103555,4401,0.028900663233169067,0.5851615476665337
36331,0.9158333333333334,1,2,1,602492,3118,103556,4400,0.02888213716699396,0.5852620377760043
36332,0.9159285714285714,1,0,1,602492,3118,103557,4399,0.02888213716699396,0.5852068644406013
36333,0.9159474969474968,0,1,0,602493,3117,103557,4399,0.028872874133906407,0.5852847259180415
36334,0.9159880952380952,1,4,1,602497,3113,103558,4398,0.02883582200155619,0.5855412062308614
36335,0.916,4,5,4,602502,3108,103562,4394,0.028789506836118417,0.5857104772060784
36336,0.9161666666666666,0,1,0,602503,3107,103562,4394,0.028780243803030865,0.58578856152513
36337,0.916190476190476,0,1,0,602504,3106,103562,4394,0.02877098076994331,0.5858666666666666
36338,0.9162142857142856,0,2,0,602506,3104,103562,4394,0.0287524547037682,0.5860229394505201
36339,0.91625,2,0,2,602506,3104,103564,4392,0.0287524547037682,0.5859124866595518
36340,0.9163333333333332,2,1,2,602507,3103,103566,4390,0.028743191670680648,0.5858801548111571
36341,0.9164285714285714,2,0,2,602507,3103,103568,4388,0.028743191670680648,0.5857695901748765
36342,0.9165,2,2,2,602509,3101,103570,4386,0.02872466560450554,0.5858154133831975
36343,0.9165873015873016,1,0,1,602509,3101,103571,4385,0.02872466560450554,0.5857600854929201
36344,0.9166666666666664,17,13,17,602522,3088,103588,4368,0.028604246174367336,0.5858369098712446
36345,0.9166666666666669,13,21,13,602543,3067,103601,4355,0.028409722479528696,0.5867690649420642
36346,0.9166816516816512,3,1,3,602544,3066,103604,4352,0.028400459446441144,0.5866810461040711
36347,0.9168333333333334,0,3,0,602547,3063,103604,4352,0.02837267034717848,0.5869184086311531
36348,0.917,2,0,2,602547,3063,103606,4350,0.02837267034717848,0.5868069607446378
36349,0.9170833333333336,1,1,1,602548,3062,103607,4349,0.028363407314090927,0.5868303872621778
36350,0.9171428571428571,2,0,2,602548,3062,103609,4347,0.028363407314090927,0.586718855446079
36351,0.9171666666666668,0,1,0,602549,3061,103609,4347,0.02835414428100337,0.5867980561555075
36352,0.91725,1,0,1,602549,3061,103610,4346,0.02835414428100337,0.5867422708248954
36353,0.917269841269841,0,1,0,602550,3060,103610,4346,0.02834488124791582,0.586821496084256
36354,0.9172857142857144,0,1,0,602551,3059,103610,4346,0.028335618214828263,0.5869007427413909
36355,0.9173333333333332,1,0,1,602551,3059,103611,4345,0.028335618214828263,0.5868449486763911
36356,0.9173571428571428,1,0,1,602551,3059,103612,4344,0.028335618214828263,0.5867891395380251
36357,0.9173809523809524,1,0,1,602551,3059,103613,4343,0.028335618214828263,0.5867333153201837
36358,0.9175,11,21,11,602572,3038,103624,4332,0.028141094519989626,0.5877883310719132
36359,0.9175555555555556,1,1,1,602573,3037,103625,4331,0.02813183148690207,0.5878121606948968
36360,0.9176190476190476,1,0,1,602573,3037,103626,4330,0.02813183148690207,0.5877562101262386
36361,0.9176428571428572,1,1,1,602574,3036,103627,4329,0.028122568453814518,0.5877800407331976
36362,0.9176666666666664,1,2,1,602576,3034,103628,4328,0.02810404238763941,0.5878837272480304
36363,0.9176666666666666,0,2,0,602578,3032,103628,4328,0.0280855163214643,0.5880434782608696
36364,0.9176666666666669,0,1,0,602579,3031,103628,4328,0.028076253288376745,0.5881233863296643
36365,0.9176904761904762,1,0,1,602579,3031,103629,4327,0.028076253288376745,0.58806740962218
36366,0.9177803030303028,0,1,0,602580,3030,103629,4327,0.028066990255289193,0.5881473426668479
36367,0.917809523809524,1,0,1,602580,3030,103630,4326,0.028066990255289193,0.5880913539967374
36368,0.9178946886446886,0,1,0,602581,3029,103630,4326,0.028057727222201637,0.5881713120326308
36369,0.9178968253968252,0,1,0,602582,3028,103630,4326,0.028048464189114084,0.5882512918139788
36370,0.9179166666666666,1,0,1,602582,3028,103631,4325,0.028048464189114084,0.5881952944376445
36371,0.9179761904761904,1,0,1,602582,3028,103632,4324,0.028048464189114084,0.588139281828074
36372,0.918,3,9,3,602591,3019,103635,4321,0.027965096891326095,0.588692098092643
36373,0.9181666666666666,1,0,1,602591,3019,103636,4320,0.027965096891326095,0.588636053958305
36374,0.9181666666666668,0,1,0,602592,3018,103636,4320,0.027955833858238542,0.588716271463614
36375,0.9182142857142856,1,0,1,602592,3018,103637,4319,0.027955833858238542,0.5886602153468721
36376,0.91825,0,1,0,602593,3017,103637,4319,0.027946570825150986,0.5887404580152672
36377,0.9182936507936508,0,1,0,602594,3016,103637,4319,0.027937307792063434,0.5888207225630538
36378,0.9183333333333332,4,9,4,602603,3007,103641,4315,0.027853940494275444,0.5893198579623053
36379,0.9183333333333334,3,4,3,602607,3003,103644,4312,0.027816888361925227,0.5894736842105263
36380,0.9183333333333336,1,0,1,602607,3003,103645,4311,0.027816888361925227,0.5894175553732568
36381,0.9185,0,2,0,602609,3001,103645,4311,0.02779836229575012,0.5895787746170679
36382,0.9185555555555556,0,1,0,602610,3000,103645,4311,0.027789099262662566,0.5896594173163726
36383,0.9185714285714286,0,1,0,602611,2999,103645,4311,0.02777983622957501,0.5897400820793434
36384,0.918577922077922,1,1,1,602612,2998,103646,4310,0.027770573196487458,0.5897646414887794
36385,0.9188333333333332,1,0,1,602612,2998,103647,4309,0.027770573196487458,0.5897084986998768
36386,0.9188888888888888,1,0,1,602612,2998,103648,4308,0.027770573196487458,0.5896523405420202
36387,0.9189166666666666,1,1,1,602613,2997,103649,4307,0.027761310163399902,0.5896768893756845
36388,0.919,2,4,2,602617,2993,103651,4305,0.027724258031049685,0.5898876404494382
36389,0.919047619047619,2,0,2,602617,2993,103653,4303,0.027724258031049685,0.5897752192982456
36390,0.9191666666666666,2,4,2,602621,2989,103655,4301,0.02768720589869947,0.5899862825788752
36391,0.9191666666666668,1,3,1,602624,2986,103656,4300,0.027659416799436808,0.5901729343947296
36392,0.9193333333333332,1,0,1,602624,2986,103657,4299,0.027659416799436808,0.5901166781056967
36393,0.9193333333333336,1,1,1,602625,2985,103658,4298,0.027650153766349255,0.590141425236853
36394,0.9193809523809524,1,1,1,602626,2984,103659,4297,0.0276408907332617,0.5901661859634666
36395,0.9194126984126983,0,3,0,602629,2981,103659,4297,0.02761310163399904,0.5904094531464689
36396,0.9194166666666668,0,1,0,602630,2980,103659,4297,0.027603838600911482,0.5904905867802666
36397,0.9194880952380952,1,0,1,602630,2980,103660,4296,0.027603838600911482,0.5904343045629467
36398,0.9195833333333334,1,0,1,602630,2980,103661,4295,0.027603838600911482,0.5903780068728522
36399,0.9196428571428572,0,1,0,602631,2979,103661,4295,0.02759457556782393,0.5904591696453121
36400,0.9196666666666664,0,2,0,602633,2977,103661,4295,0.02757604950164882,0.5906215621562156
36401,0.9196666666666666,1,0,1,602633,2977,103662,4294,0.02757604950164882,0.5905652592490717
36402,0.91975,1,0,1,602633,2977,103663,4293,0.02757604950164882,0.5905089408528198
36403,0.9198095238095236,0,1,0,602634,2976,103663,4293,0.027566786468561266,0.5905901774659513
36404,0.9198333333333332,0,2,0,602636,2974,103663,4293,0.027548260402386157,0.5907527177652401
36405,0.9199999999999998,1,1,1,602637,2973,103664,4292,0.027538997369298605,0.5907777013076394
36406,0.92,561,345,561,602982,2628,104225,3731,0.02434325095409241,0.5867274728730932
36407,0.9200000000000002,0,1,0,602983,2627,104225,3731,0.024333987921004854,0.5868197546398238
36408,0.920030303030303,0,2,0,602985,2625,104225,3731,0.024315461854829745,0.5870044052863436
36409,0.9201190476190476,1,2,1,602987,2623,104226,3730,0.024296935788654637,0.5871241932945065
36410,0.9201309523809522,0,1,0,602988,2622,104226,3730,0.024287672755567084,0.5872166246851386
36411,0.920142857142857,1,2,1,602990,2620,104227,3729,0.024269146689391976,0.5873365884391243
36412,0.9201666666666668,0,1,0,602991,2619,104227,3729,0.02425988365630442,0.5874291115311909
36413,0.9201825396825396,2,0,2,602991,2619,104229,3727,0.02425988365630442,0.5872990860384494
36414,0.9203333333333332,0,1,0,602992,2618,104229,3727,0.024250620623216868,0.587391646966115
36415,0.920376623376623,1,0,1,602992,2618,104230,3726,0.024250620623216868,0.5873266078184111
36416,0.9205,1,1,1,602993,2617,104231,3725,0.02424135759012931,0.587354146956796
36417,0.9205555555555556,0,1,0,602994,2616,104231,3725,0.02423209455704176,0.5874467749566314
36418,0.9205833333333334,1,0,1,602994,2616,104232,3724,0.02423209455704176,0.5873817034700315
36419,0.9206666666666666,0,1,0,602995,2615,104232,3724,0.024222831523954203,0.5874743650418047
36420,0.9208333333333332,2,6,2,603001,2609,104234,3722,0.024167253325428878,0.5879008055599432
36421,0.9208333333333334,1,2,1,603003,2607,104235,3721,0.02414872725925377,0.5880214917825537
36422,0.920904761904762,0,1,0,603004,2606,104235,3721,0.024139464226166217,0.5881144302196933
36423,0.920952380952381,0,2,0,603006,2604,104235,3721,0.02412093815999111,0.588300395256917
36424,0.921,1,5,1,603011,2599,104236,3720,0.024074622994553336,0.5887007437885742
36425,0.9211666666666666,0,1,0,603012,2598,104236,3720,0.024065359961465783,0.5887939221272555
36426,0.92125,1,0,1,603012,2598,104237,3719,0.024065359961465783,0.5887288269748299
36427,0.9212619047619048,0,1,0,603013,2597,104237,3719,0.024056096928378227,0.5888220392653578
36428,0.9214047619047618,0,1,0,603014,2596,104237,3719,0.024046833895290675,0.5889152810768012
36429,0.9215,2,0,2,603014,2596,104239,3717,0.024046833895290675,0.5887850467289719
36430,0.9215555555555556,1,0,1,603014,2596,104240,3716,0.024046833895290675,0.5887198986058302
36431,0.9216666666666664,3,6,3,603020,2590,104243,3713,0.02399125569676535,0.5890845629065524
36432,0.9216666666666667,7,7,7,603027,2583,104250,3706,0.02392641446515247,0.5892828748608682
36433,0.9217289377289376,0,1,0,603028,2582,104250,3706,0.023917151432064916,0.5893765903307888
36434,0.9218333333333334,1,0,1,603028,2582,104251,3705,0.023917151432064916,0.5893112772387467
36435,0.9219642857142858,1,0,1,603028,2582,104252,3704,0.023917151432064916,0.5892459433662106
36436,0.9219880952380952,0,1,0,603029,2581,104252,3704,0.02390788839897736,0.5893396976929196
36437,0.922,4,3,4,603032,2578,104256,3700,0.0238800992997147,0.5893596686842943
36438,0.9222857142857144,1,1,1,603033,2577,104257,3699,0.023870836266627143,0.5893881453154876
36439,0.9224126984126986,0,1,0,603034,2576,104257,3699,0.02386157323353959,0.5894820717131474
36440,0.9224285714285714,0,1,0,603035,2575,104257,3699,0.023852310200452035,0.5895760280522793
36441,0.9225,17,13,17,603048,2562,104274,3682,0.023731890770313832,0.5896860986547086
36442,0.9226428571428572,0,1,0,603049,2561,104274,3682,0.023722627737226276,0.5897805542207272
36443,0.9226666666666664,1,1,1,603050,2560,104275,3681,0.023713364704138724,0.5898093254286172
36444,0.9226666666666666,2,1,2,603051,2559,104277,3679,0.023704101671051168,0.5897723629368388
36445,0.9226666666666667,0,2,0,603053,2557,104277,3679,0.02368557560487606,0.5899615137908916
36446,0.9227698412698412,1,0,1,603053,2557,104278,3678,0.02368557560487606,0.5898957497995189
36447,0.9228333333333332,0,1,0,603054,2556,104278,3678,0.023676312571788507,0.5899903753609239
36448,0.9228571428571428,1,0,1,603054,2556,104279,3677,0.023676312571788507,0.5899245948981229
36449,0.9229166666666668,0,1,0,603055,2555,104279,3677,0.02366704953870095,0.5900192554557124
36450,0.923,2,0,2,603055,2555,104281,3675,0.02366704953870095,0.5898876404494382
36451,0.9230555555555552,0,2,0,603057,2553,104281,3675,0.023648523472525843,0.5900770712909441
36452,0.9231666666666666,0,1,0,603058,2552,104281,3675,0.02363926043943829,0.5901718323430223
36453,0.9232142857142857,1,0,1,603058,2552,104282,3674,0.02363926043943829,0.5901060070671378
36454,0.9233333333333332,19,19,19,603077,2533,104301,3655,0.02346326281077476,0.5906593406593407
36455,0.9233333333333336,16,10,16,603087,2523,104317,3639,0.02337063247989922,0.5905550146056475
36456,0.9234563492063492,0,1,0,603088,2522,104317,3639,0.023361369446811664,0.590650868365525
36457,0.92375,0,2,0,603090,2520,104317,3639,0.023342843380636556,0.590842669264491
36458,0.924,7,6,7,603096,2514,104324,3632,0.02328726518211123,0.5909534656687276
36459,0.9241428571428572,1,0,1,603096,2514,104325,3631,0.02328726518211123,0.5908868999186331
36460,0.9241666666666666,1,1,1,603097,2513,104326,3630,0.023278002149023678,0.5909164903141787
36461,0.9241666666666668,0,1,0,603098,2512,104326,3630,0.023268739115936122,0.5910126994464344
36462,0.9242380952380952,1,2,1,603100,2510,104327,3629,0.023250213049761013,0.591138621925395
36463,0.9242857142857144,0,1,0,603101,2509,104327,3629,0.02324095001667346,0.5912349299446074
36464,0.9244444444444444,0,1,0,603102,2508,104327,3629,0.023231686983585905,0.5913312693498453
36465,0.9245238095238096,0,1,0,603103,2507,104327,3629,0.023222423950498353,0.5914276401564538
36466,0.924532634032634,0,1,0,603104,2506,104327,3629,0.023213160917410797,0.5915240423797881
36467,0.9245555555555556,1,0,1,603104,2506,104328,3628,0.023213160917410797,0.5914574502771438
36468,0.9246666666666664,0,1,0,603105,2505,104328,3628,0.023203897884323244,0.5915538887983043
36469,0.9246666666666666,2,2,2,603107,2503,104330,3626,0.023185371818148136,0.5916136400717898
36470,0.9249285714285712,1,0,1,603107,2503,104331,3625,0.023185371818148136,0.5915469973890339
36471,0.9249999999999998,1,0,1,603107,2503,104332,3624,0.023185371818148136,0.5914803329525053
36472,0.925,62,58,62,603165,2445,104394,3562,0.022648115899069992,0.5929748626602297
36473,0.9251666666666668,0,1,0,603166,2444,104394,3562,0.022638852865982436,0.5930735930735931
36474,0.9252023809523808,0,4,0,603170,2440,104394,3562,0.02260180073363222,0.5934688437187604
36475,0.9252023809523812,0,2,0,603172,2438,104394,3562,0.02258327466745711,0.5936666666666667
36476,0.9252857142857144,0,1,0,603173,2437,104394,3562,0.02257401163436956,0.5937656276046007
36477,0.9253333333333332,1,3,1,603176,2434,104395,3561,0.022546222535106894,0.5939949958298583
36478,0.925654761904762,1,0,1,603176,2434,104396,3560,0.022546222535106894,0.5939272605939273
36479,0.9256666666666666,0,1,0,603177,2433,104396,3560,0.02253695950201934,0.59402636409144
36480,0.925702380952381,0,1,0,603178,2432,104396,3560,0.022527696468931786,0.5941255006675568
36481,0.9257142857142856,1,0,1,603178,2432,104397,3559,0.022527696468931786,0.5940577532966116
36482,0.9257619047619046,1,1,1,603179,2431,104398,3558,0.022518433435844233,0.594089163466355
36483,0.9258333333333332,1,1,1,603180,2430,104399,3557,0.022509170402756677,0.5941205946216803
36484,0.9258333333333334,0,1,0,603181,2429,104399,3557,0.022499907369669125,0.5942198463080521
36485,0.9259841269841268,0,1,0,603182,2428,104399,3557,0.02249064433658157,0.5943191311612365
36486,0.926,11,2,11,603184,2426,104410,3546,0.02247211827040646,0.5937709310113864
36487,0.9261190476190476,0,2,0,603186,2424,104410,3546,0.022453592204231352,0.5939698492462312
36488,0.9261666666666666,1,0,1,603186,2424,104411,3545,0.022453592204231352,0.5939018261015245
36489,0.9261666666666668,0,2,0,603188,2422,104411,3545,0.022435066138056244,0.5941008882185352
36490,0.9261904761904762,1,1,1,603189,2421,104412,3544,0.02242580310496869,0.5941324392288349
36491,0.9261904761904765,0,1,0,603190,2420,104412,3544,0.022416540071881135,0.5942320590207915
36492,0.92625,1,0,1,603190,2420,104413,3543,0.022416540071881135,0.5941640114036558
36493,0.9262619047619048,1,0,1,603190,2420,104414,3542,0.022416540071881135,0.5940959409594095
36494,0.9263095238095238,0,1,0,603191,2419,104414,3542,0.022407277038793583,0.5941956047643013
36495,0.9263333333333332,0,1,0,603192,2418,104414,3542,0.022398014005706027,0.5942953020134228
36496,0.9263650793650792,1,0,1,603192,2418,104415,3541,0.022398014005706027,0.5942272193321027
36497,0.9265833333333332,1,0,1,603192,2418,104416,3540,0.022398014005706027,0.594159113796576
36498,0.9266666666666664,17,21,17,603213,2397,104433,3523,0.02220349031086739,0.5951013513513513
36499,0.9266666666666667,18,20,18,603233,2377,104451,3505,0.022018229649116306,0.5958857531451887
36500,0.9268214285714284,0,1,0,603234,2376,104451,3505,0.022008966616028754,0.5959870770277164
36501,0.9268333333333334,2,0,2,603234,2376,104453,3503,0.022008966616028754,0.5958496342915461
36502,0.9268611111111108,1,1,1,603235,2375,104454,3502,0.021999703582941198,0.5958822528500936
36503,0.9269166666666666,0,1,0,603236,2374,104454,3502,0.021990440549853645,0.5959836623553437
36504,0.9269761904761904,2,0,2,603236,2374,104456,3500,0.021990440549853645,0.595846101464079
36505,0.927,2,2,2,603238,2372,104458,3498,0.021971914483678537,0.5959114139693356
36506,0.9270000000000002,0,1,0,603239,2371,104458,3498,0.02196265145059098,0.596012949395127
36507,0.927012987012987,0,1,0,603240,2370,104458,3498,0.02195338841750343,0.5961145194274029
36508,0.9270753968253967,0,1,0,603241,2369,104458,3498,0.021944125384415872,0.5962161240838588
36509,0.927142857142857,1,0,1,603241,2369,104459,3497,0.021944125384415872,0.5961472894647118
36510,0.9271428571428572,1,0,1,603241,2369,104460,3496,0.021944125384415872,0.596078431372549
36511,0.9271666666666668,1,1,1,603242,2368,104461,3495,0.02193486235132832,0.5961112058673034
36512,0.9271785714285716,1,0,1,603242,2368,104462,3494,0.02193486235132832,0.596042306380075
36513,0.9273333333333336,1,0,1,603242,2368,104463,3493,0.02193486235132832,0.5959733833816755
36514,0.9273888888888888,1,1,1,603243,2367,104464,3492,0.021925599318240764,0.5960061443932412
36515,0.9274285714285716,0,1,0,603244,2366,104464,3492,0.02191633628515321,0.596107886650734
36516,0.9275,20,20,20,603264,2346,104484,3472,0.021731075623402128,0.5967686490202819
36517,0.927538961038961,0,1,0,603265,2345,104484,3472,0.02172181259031457,0.5968712394705175
36518,0.9276666666666666,0,2,0,603267,2343,104484,3472,0.021703286524139463,0.5970765262252794
36519,0.9277142857142858,1,0,1,603267,2343,104485,3471,0.021703286524139463,0.5970072239422085
36520,0.9277380952380953,0,2,0,603269,2341,104485,3471,0.021684760457964355,0.5972126634549209
36521,0.9278333333333332,1,1,1,603270,2340,104486,3470,0.021675497424876802,0.5972461273666093
36522,0.9278571428571428,0,1,0,603271,2339,104486,3470,0.021666234391789246,0.5973489412979859
36523,0.9279166666666668,1,0,1,603271,2339,104487,3469,0.021666234391789246,0.5972796143250688
36524,0.928,4,6,4,603277,2333,104491,3465,0.02161065619326392,0.5976198689203174
36525,0.928142857142857,0,3,0,603280,2330,104491,3465,0.02158286709400126,0.5979292493528904
36526,0.9281666666666666,1,2,1,603282,2328,104492,3464,0.021564341027826152,0.5980662983425414
36527,0.9281666666666668,0,1,0,603283,2327,104492,3464,0.021555077994738596,0.5981695734760836
36528,0.9283333333333332,2,5,2,603288,2322,104494,3462,0.021508762829300827,0.5985477178423236
36529,0.9283333333333336,1,2,1,603290,2320,104495,3461,0.021490236763125718,0.5986853485556132
36530,0.928376984126984,0,1,0,603291,2319,104495,3461,0.021480973730038162,0.5987889273356402
36531,0.9283928571428572,0,1,0,603292,2318,104495,3461,0.02147171069695061,0.5988925419622773
36532,0.9284603174603174,0,1,0,603293,2317,104495,3461,0.021462447663863054,0.5989961924541364
36533,0.9284761904761905,2,0,2,603293,2317,104497,3459,0.021462447663863054,0.5988573407202216
36534,0.9284999999999998,1,0,1,603293,2317,104498,3458,0.021462447663863054,0.5987878787878788
36535,0.9285714285714286,1,0,1,603293,2317,104499,3457,0.021462447663863054,0.5987183927952893
36536,0.9285873015873014,2,1,2,603294,2316,104501,3455,0.0214531846307755,0.598683070525039
36537,0.9286666666666666,1,0,1,603294,2316,104502,3454,0.0214531846307755,0.5986135181975737
36538,0.9286666666666668,2,0,2,603294,2316,104504,3452,0.0214531846307755,0.5984743411927878
36539,0.92875,0,1,0,603295,2315,104504,3452,0.021443921597687945,0.5985781168718571
36540,0.9288333333333332,1,1,1,603296,2314,104505,3451,0.021434658564600393,0.5986123156981786
36541,0.9288888888888888,0,1,0,603297,2313,104505,3451,0.021425395531512837,0.5987161693268563
36542,0.929,3,2,3,603299,2311,104508,3448,0.02140686946533773,0.598715054696996
36543,0.929047619047619,1,1,1,603300,2310,104509,3447,0.021397606432250176,0.5987493486190725
36544,0.9291666666666668,0,3,0,603303,2307,104509,3447,0.021369817332987512,0.5990615224191866
36545,0.9293809523809524,0,1,0,603304,2306,104509,3447,0.02136055429989996,0.5991656527029376
36546,0.9294523809523808,0,1,0,603305,2305,104509,3447,0.021351291266812403,0.5992698191933241
36547,0.9295000000000002,1,0,1,603305,2305,104510,3446,0.021351291266812403,0.5992001391062424
36548,0.9295476190476192,0,1,0,603306,2304,104510,3446,0.02134202823372485,0.599304347826087
36549,0.9296666666666666,1,1,1,603307,2303,104511,3445,0.021332765200637295,0.5993389004871259
36550,0.92975,2,0,2,603307,2303,104513,3443,0.021332765200637295,0.5991994430908458
36551,0.9299761904761904,1,0,1,603307,2303,104514,3442,0.021332765200637295,0.5991296779808529
36552,0.93,447,342,447,603649,1961,104961,2995,0.018164807884693764,0.604317998385795
36553,0.9300000000000002,0,2,0,603651,1959,104961,2995,0.018146281818518656,0.6045619701251513
36554,0.9301666666666664,0,2,0,603653,1957,104961,2995,0.018127755752343547,0.6048061389337641
36555,0.9302380952380952,1,0,1,603653,1957,104962,2994,0.018127755752343547,0.6047263179155726
36556,0.930253968253968,0,1,0,603654,1956,104962,2994,0.01811849271925599,0.6048484848484849
36557,0.930281746031746,2,1,2,603655,1955,104964,2992,0.01810922968616844,0.6048109965635738
36558,0.9303333333333332,1,2,1,603657,1953,104965,2991,0.01809070361999333,0.6049757281553398
36559,0.9304047619047616,0,1,0,603658,1952,104965,2991,0.018081440586905778,0.605098118551487
36560,0.9304761904761903,1,1,1,603659,1951,104966,2990,0.018072177553818222,0.6051406597854685
36561,0.9305,0,2,0,603661,1949,104966,2990,0.018053651487643114,0.6053857056084228
36562,0.9306493506493506,1,1,1,603662,1948,104967,2989,0.01804438845455556,0.6054283978124367
36563,0.9306666666666666,1,0,1,603662,1948,104968,2988,0.01804438845455556,0.6053484602917342
36564,0.9306666666666668,0,1,0,603663,1947,104968,2988,0.018035125421468005,0.6054711246200608
36565,0.9307142857142856,1,0,1,603663,1947,104969,2987,0.018035125421468005,0.6053911633563032
36566,0.9308174603174604,0,1,0,603664,1946,104969,2987,0.018025862388380453,0.6055138860733833
36567,0.9308333333333332,1,2,1,603666,1944,104970,2986,0.018007336322205345,0.6056795131845841
36568,0.9308333333333334,0,4,0,603670,1940,104970,2986,0.017970284189855128,0.606171335769387
36569,0.931,2,3,2,603673,1937,104972,2984,0.017942495090592463,0.6063808169071327
36570,0.9311315604330308,0,3,0,603676,1934,104972,2984,0.017914705991329802,0.6067507116714111
36571,0.9311904761904762,2,0,2,603676,1934,104974,2982,0.017914705991329802,0.6065907241659886
36572,0.93125,0,1,0,603677,1933,104974,2982,0.017905442958242247,0.6067141403865717
36573,0.9313333333333332,1,0,1,603677,1933,104975,2981,0.017905442958242247,0.6066341066341067
36574,0.9313333333333336,1,0,1,603677,1933,104976,2980,0.017905442958242247,0.6065540403012416
36575,0.9314047619047616,1,2,1,603679,1931,104977,2979,0.017886916892067138,0.6067209775967414
36576,0.9315,1,0,1,603679,1931,104978,2978,0.017886916892067138,0.6066408637196985
36577,0.9316428571428572,2,0,2,603679,1931,104980,2976,0.017886916892067138,0.6064805380069289
36578,0.9316507936507936,0,1,0,603680,1930,104980,2976,0.017877653858979586,0.6066041581736649
36579,0.9316666666666664,1,4,1,603684,1926,104981,2975,0.01784060172662937,0.607018975719241
36580,0.9316666666666668,3,4,3,603688,1922,104984,2972,0.017803549594279152,0.6072742133224356
36581,0.9316746031746028,0,3,0,603691,1919,104984,2972,0.017775760495016488,0.6076466980167655
36582,0.931770215895216,3,1,3,603692,1918,104987,2969,0.017766497461928935,0.6075301821158174
36583,0.9317857142857144,0,4,0,603696,1914,104987,2969,0.01772944532957872,0.6080278517304936
36584,0.9318809523809524,0,1,0,603697,1913,104987,2969,0.017720182296491162,0.6081523965587874
36585,0.9319999999999996,0,1,0,603698,1912,104987,2969,0.01771091926340361,0.6082769924195861
36586,0.932,0,2,0,603700,1910,104987,2969,0.0176923931972285,0.608526337364214
36587,0.9320476190476192,0,1,0,603701,1909,104987,2969,0.017683130164140946,0.6086510865108651
36588,0.9320595238095236,0,1,0,603702,1908,104987,2969,0.017673867131053393,0.6087758868156654
36589,0.932142857142857,0,1,0,603703,1907,104987,2969,0.017664604097965837,0.6089007383100903
36590,0.932309523809524,0,1,0,603704,1906,104987,2969,0.017655341064878285,0.609025641025641
36591,0.9323214285714284,0,1,0,603705,1905,104987,2969,0.01764607803179073,0.6091505949938449
36592,0.9323333333333332,1,2,1,603707,1903,104988,2968,0.01762755196561562,0.6093204680763703
36593,0.9324047619047616,0,1,0,603708,1902,104988,2968,0.017618288932528068,0.6094455852156058
36594,0.9325,6,10,6,603718,1892,104994,2962,0.017525658601652526,0.6102183765966214
36595,0.932547619047619,1,1,1,603719,1891,104995,2961,0.01751639556856497,0.6102638087386645
36596,0.9325833333333334,1,0,1,603719,1891,104996,2960,0.01751639556856497,0.6101834673263244
36597,0.9326666666666664,1,0,1,603719,1891,104997,2959,0.01751639556856497,0.6101030927835052
36598,0.9326666666666666,1,0,1,603719,1891,104998,2958,0.01751639556856497,0.6100226850897092
36599,0.9326666666666668,1,0,1,603719,1891,104999,2957,0.01751639556856497,0.6099422442244224
36600,0.9327023809523808,1,0,1,603719,1891,105000,2956,0.01751639556856497,0.6098617701671136
36601,0.9328246753246752,0,2,0,603721,1889,105000,2956,0.01749786950238986,0.6101135190918473
36602,0.9328333333333332,1,2,1,603723,1887,105001,2955,0.017479343436214753,0.6102850061957868
36603,0.9328611111111108,0,1,0,603724,1886,105001,2955,0.0174700804031272,0.6104110720925429
36604,0.933215367965368,0,2,0,603726,1884,105001,2955,0.017451554336952092,0.6106633601983881
36605,0.9333095238095236,0,1,0,603727,1883,105001,2955,0.017442291303864536,0.6107895824720959
36606,0.9333333333333332,16,19,16,603746,1864,105017,2939,0.017266293675201008,0.6119092234020403
36607,0.9333333333333336,10,9,10,603755,1855,105027,2929,0.01718292637741302,0.6122491638795987
36608,0.9333928571428572,0,1,0,603756,1854,105027,2929,0.017173663344325466,0.6123771691407067
36609,0.9335,1,1,1,603757,1853,105028,2928,0.01716440031123791,0.6124241790420414
36610,0.9336428571428572,2,0,2,603757,1853,105030,2926,0.01716440031123791,0.6122619794936179
36611,0.9336666666666668,0,1,0,603758,1852,105030,2926,0.017155137278150358,0.6123901213897028
36612,0.93375,1,1,1,603759,1851,105031,2925,0.017145874245062802,0.6124371859296482
36613,0.9337500000000002,0,1,0,603760,1850,105031,2925,0.01713661121197525,0.612565445026178
36614,0.9338095238095238,0,1,0,603761,1849,105031,2925,0.017127348178887693,0.6126937578550482
36615,0.933888888888889,0,1,0,603762,1848,105031,2925,0.01711808514580014,0.6128221244500315
36616,0.934,7,4,7,603766,1844,105038,2918,0.017081033013449924,0.6127677446451071
36617,0.9341309523809525,0,2,0,603768,1842,105038,2918,0.017062506947274816,0.6130252100840337
36618,0.9341666666666666,1,1,1,603769,1841,105039,2917,0.01705324391418726,0.6130727196300967
36619,0.9341666666666668,2,0,2,603769,1841,105041,2915,0.01705324391418726,0.612910008410429
36620,0.93425,0,1,0,603770,1840,105041,2915,0.017043980881099707,0.6130389064143007
36621,0.9342857142857144,0,1,0,603771,1839,105041,2915,0.01703471784801215,0.6131678586453513
36622,0.9343095238095238,0,1,0,603772,1838,105041,2915,0.0170254548149246,0.6132968651378077
36623,0.9343333333333332,0,1,0,603773,1837,105041,2915,0.017016191781837046,0.6134259259259259
36624,0.9345238095238096,1,0,1,603773,1837,105042,2914,0.017016191781837046,0.613344559040202
36625,0.9346111111111112,0,1,0,603774,1836,105042,2914,0.01700692874874949,0.6134736842105263
36626,0.9346428571428572,0,1,0,603775,1835,105042,2914,0.016997665715661938,0.6136028637607918
36627,0.9346666666666666,1,3,1,603778,1832,105043,2913,0.016969876616399274,0.6139093782929399
36628,0.9347142857142856,0,1,0,603779,1831,105043,2913,0.01696061358331172,0.6140387858347386
36629,0.9347857142857144,1,2,1,603781,1829,105044,2912,0.016942087517136613,0.614216410040076
36630,0.9348095238095238,0,1,0,603782,1828,105044,2912,0.016932824484049057,0.6143459915611814
36631,0.9348333333333332,1,0,1,603782,1828,105045,2911,0.016932824484049057,0.6142646127875079
36632,0.934952380952381,0,1,0,603783,1827,105045,2911,0.016923561450961504,0.614394259181089
36633,0.9349761904761904,1,0,1,603783,1827,105046,2910,0.016923561450961504,0.6143128562381254
36634,0.9349999999999998,0,1,0,603784,1826,105046,2910,0.01691429841787395,0.6144425675675675
36635,0.935,60,36,60,603820,1790,105106,2850,0.016580829226721997,0.6142241379310345
36636,0.9351639194139192,0,1,0,603821,1789,105106,2850,0.016571566193634445,0.6143565423582669
36637,0.9351666666666668,1,0,1,603821,1789,105107,2849,0.016571566193634445,0.6142733937041829
36638,0.9351785714285712,0,2,0,603823,1787,105107,2849,0.016553040127459336,0.6145383951682485
36639,0.9353333333333332,1,0,1,603823,1787,105108,2848,0.016553040127459336,0.6144552319309601
36640,0.9353571428571428,0,1,0,603824,1786,105108,2848,0.01654377709437178,0.6145878290893396
36641,0.9353809523809524,0,1,0,603825,1785,105108,2848,0.016534514061284228,0.6147204834880208
36642,0.9354166666666665,1,0,1,603825,1785,105109,2847,0.016534514061284228,0.6146373056994818
36643,0.9355,1,1,1,603826,1784,105110,2846,0.016525251028196672,0.6146868250539956
36644,0.9356666666666666,1,2,1,603828,1782,105111,2845,0.016506724962021564,0.6148692457315755
36645,0.935668498168498,1,0,1,603828,1782,105112,2844,0.016506724962021564,0.6147859922178989
36646,0.9357142857142856,1,1,1,603829,1781,105113,2843,0.01649746192893401,0.6148356401384083
36647,0.9358333333333332,1,0,1,603829,1781,105114,2842,0.01649746192893401,0.6147523253298723
36648,0.9358333333333334,1,2,1,603831,1779,105115,2841,0.016478935862758903,0.6149350649350649
36649,0.9358333333333336,2,0,2,603831,1779,105117,2839,0.016478935862758903,0.6147682979644868
36650,0.936,10,5,10,603836,1774,105127,2829,0.01643262069732113,0.6145991744514447
36651,0.936111111111111,1,1,1,603837,1773,105128,2828,0.016423357664233577,0.6146489893501412
36652,0.9361428571428572,0,1,0,603838,1772,105128,2828,0.01641409463114602,0.6147826086956522
36653,0.9361666666666666,0,1,0,603839,1771,105128,2828,0.01640483159805847,0.6149162861491628
36654,0.9363333333333332,0,1,0,603840,1770,105128,2828,0.016395568564970913,0.6150500217485864
36655,0.9363333333333334,0,1,0,603841,1769,105128,2828,0.01638630553188336,0.6151838155318686
36656,0.9364761904761904,0,1,0,603842,1768,105128,2828,0.016377042498795805,0.6153176675369887
36657,0.9365,1,0,1,603842,1768,105129,2827,0.016377042498795805,0.615233949945593
36658,0.9365714285714286,0,1,0,603843,1767,105129,2827,0.016367779465708252,0.6153678711362647
36659,0.9366666666666664,11,11,11,603854,1756,105140,2816,0.016265886101745154,0.615923009623797
36660,0.9366666666666668,14,8,14,603862,1748,105154,2802,0.01619178183704472,0.6158241758241758
36661,0.9367142857142858,2,1,2,603863,1747,105156,2800,0.016182518803957168,0.615790631185397
36662,0.9367301587301584,1,0,1,603863,1747,105157,2799,0.016182518803957168,0.615706115266168
36663,0.9367380952380951,1,0,1,603863,1747,105158,2798,0.016182518803957168,0.6156215621562157
36664,0.9368333333333332,0,1,0,603864,1746,105158,2798,0.016173255770869612,0.6157570422535211
36665,0.9369761904761904,1,0,1,603864,1746,105159,2797,0.016173255770869612,0.6156724631300903
36666,0.937,0,3,0,603867,1743,105159,2797,0.01614546667160695,0.616079295154185
36667,0.9373809523809524,0,1,0,603868,1742,105159,2797,0.016136203638519395,0.616215025335977
36668,0.9375,8,10,8,603878,1732,105167,2789,0.016043573307643853,0.6168989161689892
36669,0.9376666666666664,1,0,1,603878,1732,105168,2788,0.016043573307643853,0.6168141592920354
36670,0.9376666666666666,1,2,1,603880,1730,105169,2787,0.016025047241468745,0.6170024352446314
36671,0.9377380952380954,0,2,0,603882,1728,105169,2787,0.016006521175293636,0.6172757475083056
36672,0.9378333333333334,1,0,1,603882,1728,105170,2786,0.016006521175293636,0.6171909614532566
36673,0.9378571428571428,1,0,1,603882,1728,105171,2785,0.016006521175293636,0.6171061378240638
36674,0.9379999999999998,1,0,1,603882,1728,105172,2784,0.016006521175293636,0.6170212765957447
36675,0.938,1,3,1,603885,1725,105173,2783,0.015978732076030976,0.6173469387755102
36676,0.9381428571428568,0,1,0,603886,1724,105173,2783,0.01596946904294342,0.6174839139116929
36677,0.9381666666666666,1,0,1,603886,1724,105174,2782,0.01596946904294342,0.61739902352419
36678,0.9381666666666668,2,1,2,603887,1723,105176,2780,0.015960206009855867,0.6173662003109038
36679,0.938238095238095,0,1,0,603888,1722,105176,2780,0.015950942976768315,0.6175033318525099
36680,0.9382380952380952,0,2,0,603890,1720,105176,2780,0.015932416910593206,0.6177777777777778
36681,0.9383214285714284,0,1,0,603891,1719,105176,2780,0.01592315387750565,0.6179150922427206
36682,0.9383333333333332,3,1,3,603892,1718,105179,2777,0.015913890844418098,0.617797552836485
36683,0.9383333333333336,1,6,1,603898,1712,105180,2776,0.015858312645892773,0.6185383244206774
36684,0.9383809523809524,0,1,0,603899,1711,105180,2776,0.015849049612805217,0.6186761756184533
36685,0.9384242424242424,1,1,1,603900,1710,105181,2775,0.015839786579717664,0.6187290969899666
36686,0.9385,1,1,1,603901,1709,105182,2774,0.01583052354663011,0.6187820655810841
36687,0.938550505050505,0,2,0,603903,1707,105182,2774,0.015811997480455,0.6190582459272483
36688,0.9385714285714286,1,0,1,603903,1707,105183,2773,0.015811997480455,0.6189732142857143
36689,0.9386666666666666,0,1,0,603904,1706,105183,2773,0.015802734447367447,0.6191114087966064
36690,0.9386666666666668,1,1,1,603905,1705,105184,2772,0.01579347141427989,0.6191646191646192
36691,0.93875,1,0,1,603905,1705,105185,2771,0.01579347141427989,0.6190795352993744
36692,0.9387738095238096,0,1,0,603906,1704,105185,2771,0.01578420838119234,0.6192178770949721
36693,0.9388333333333332,1,0,1,603906,1704,105186,2770,0.01578420838119234,0.6191327670987931
36694,0.9388888888888888,1,0,1,603906,1704,105187,2769,0.01578420838119234,0.6190476190476191
36695,0.939,4,1,4,603907,1703,105191,2765,0.015774945348104783,0.618845120859445
36696,0.9391111111111112,0,2,0,603909,1701,105191,2765,0.015756419281929675,0.6191222570532915
36697,0.9391428571428572,0,1,0,603910,1700,105191,2765,0.015747156248842122,0.6192609182530795
36698,0.9391666666666666,1,4,1,603914,1696,105192,2764,0.015710104116491905,0.6197309417040359
36699,0.9391666666666668,2,1,2,603915,1695,105194,2762,0.01570084108340435,0.6196993493381198
36700,0.9393181818181818,1,0,1,603915,1695,105195,2761,0.01570084108340435,0.6196140035906643
36701,0.9393333333333332,1,1,1,603916,1694,105196,2760,0.015691578050316797,0.6196677144140099
36702,0.9394047619047616,0,1,0,603917,1693,105196,2760,0.01568231501722924,0.6198068717718392
36703,0.9395,0,1,0,603918,1692,105196,2760,0.01567305198414169,0.6199460916442049
36704,0.9396190476190478,1,0,1,603918,1692,105197,2759,0.01567305198414169,0.6198607054594473
36705,0.9396428571428572,2,0,2,603918,1692,105199,2757,0.01567305198414169,0.6196898179366149
36706,0.9396666666666664,0,1,0,603919,1691,105199,2757,0.015663788951054133,0.6198291366906474
36707,0.9396666666666668,0,1,0,603920,1690,105199,2757,0.01565452591796658,0.6199685181020913
36708,0.93975,0,1,0,603921,1689,105199,2757,0.015645262884879024,0.6201079622132254
36709,0.9398465978465976,2,2,2,603923,1687,105201,2755,0.015626736818703916,0.620216118865376
36710,0.94,437,279,437,604202,1408,105638,2318,0.013042350587276298,0.6221148684916801
36711,0.9400476190476188,3,0,3,604202,1408,105641,2315,0.013042350587276298,0.6218103679828095
36712,0.9400714285714286,0,1,0,604203,1407,105641,2315,0.013033087554188744,0.6219774314884471
36713,0.940095238095238,0,1,0,604204,1406,105641,2315,0.01302382452110119,0.6221445847890352
36714,0.9401666666666668,1,0,1,604204,1406,105642,2314,0.01302382452110119,0.6220430107526882
36715,0.940277777777778,1,0,1,604204,1406,105643,2313,0.01302382452110119,0.6219413820919603
36716,0.940404761904762,1,0,1,604204,1406,105644,2312,0.01302382452110119,0.6218396987627757
36717,0.9405,0,2,0,604206,1404,105644,2312,0.013005298454926081,0.6221743810548978
36718,0.9406666666666668,1,0,1,604206,1404,105645,2311,0.013005298454926081,0.6220726783310901
36719,0.9407142857142856,0,1,0,604207,1403,105645,2311,0.012996035421838527,0.6222401723209477
36720,0.9408333333333332,0,1,0,604208,1402,105645,2311,0.012986772388750973,0.6224077565311069
36721,0.9408333333333334,1,0,1,604208,1402,105646,2310,0.012986772388750973,0.6223060344827587
36722,0.9409761904761904,1,0,1,604208,1402,105647,2309,0.012986772388750973,0.6222042576125034
36723,0.941,1,4,1,604212,1398,105648,2308,0.012949720256400756,0.6227738801942796
36724,0.9410714285714286,1,0,1,604212,1398,105649,2307,0.012949720256400756,0.622672064777328
36725,0.9412499999999998,0,1,0,604213,1397,105649,2307,0.012940457223313202,0.6228401727861771
36726,0.9415,1,2,1,604215,1395,105650,2306,0.012921931157138094,0.6230748446365847
36727,0.9415833333333332,1,0,1,604215,1395,105651,2305,0.012921931157138094,0.6229729729729729
36728,0.9416666666666664,0,4,0,604219,1391,105651,2305,0.012884879024787877,0.6236471861471862
36729,0.9416666666666668,5,9,5,604228,1382,105656,2300,0.012801511726999889,0.6246605105920695
36730,0.9417738095238094,0,1,0,604229,1381,105656,2300,0.012792248693912335,0.6248302091822874
36731,0.9419285714285712,0,1,0,604230,1380,105656,2300,0.01278298566082478,0.625
36732,0.9419523809523808,1,1,1,604231,1379,105657,2299,0.012773722627737226,0.6250679717237629
36733,0.942,4,2,4,604233,1377,105661,2295,0.012755196561562118,0.625
36734,0.9420714285714284,0,3,0,604236,1374,105661,2295,0.012727407462299455,0.6255110384300899
36735,0.9420714285714286,0,1,0,604237,1373,105661,2295,0.012718144429211901,0.6256815703380589
36736,0.9421666666666666,1,2,1,604239,1371,105662,2294,0.012699618363036793,0.6259208731241473
36737,0.9423333333333332,1,0,1,604239,1371,105663,2293,0.012699618363036793,0.6258187772925764
36738,0.9423690476190476,0,1,0,604240,1370,105663,2293,0.012690355329949238,0.625989625989626
36739,0.9425,5,5,5,604245,1365,105668,2288,0.012644040164511467,0.6263345195729537
36740,0.9426666666666668,1,1,1,604246,1364,105669,2287,0.012634777131423913,0.6264037250068475
36741,0.942904761904762,0,1,0,604247,1363,105669,2287,0.012625514098336359,0.6265753424657534
36742,0.9429999999999998,0,1,0,604248,1362,105669,2287,0.012616251065248805,0.6267470539873938
36743,0.943,2,1,2,604249,1361,105671,2285,0.01260698803216125,0.6267142073505211
36744,0.9433333333333332,8,12,8,604261,1349,105679,2277,0.0124958316351106,0.6279646993932708
36745,0.9433333333333336,9,7,9,604268,1342,105688,2268,0.01243099040349772,0.6282548476454294
36746,0.9434603174603176,0,1,0,604269,1341,105688,2268,0.012421727370410167,0.628428927680798
36747,0.9435,3,0,3,604269,1341,105691,2265,0.012421727370410167,0.6281198003327787
36748,0.94375,0,1,0,604270,1340,105691,2265,0.012412464337322612,0.6282940360610264
36749,0.9438809523809524,1,0,1,604270,1340,105692,2264,0.012412464337322612,0.6281908990011099
36750,0.943952380952381,1,1,1,604271,1339,105693,2263,0.012403201304235058,0.6282620766240977
36751,0.9439761904761902,1,0,1,604271,1339,105694,2262,0.012403201304235058,0.628158844765343
36752,0.944,7,1,7,604272,1338,105701,2255,0.012393938271147504,0.6276092401892569
36753,0.9441309523809523,0,1,0,604273,1337,105701,2255,0.01238467523805995,0.6277839643652561
36754,0.9441666666666668,0,3,0,604276,1334,105701,2255,0.012356886138797287,0.6283087210922262
36755,0.9443095238095238,0,1,0,604277,1333,105701,2255,0.012347623105709733,0.6284838350055741
36756,0.9443333333333334,0,1,0,604278,1332,105701,2255,0.012338360072622179,0.6286590465570114
36757,0.9447738095238098,0,1,0,604279,1331,105701,2255,0.012329097039534625,0.6288343558282209
36758,0.9447777777777776,0,2,0,604281,1329,105701,2255,0.012310570973359516,0.6291852678571429
36759,0.9448333333333332,2,1,2,604282,1328,105703,2253,0.012301307940271962,0.6291538676347389
36760,0.945,46,42,46,604324,1286,105749,2207,0.011912260550594687,0.6318350987689665
36761,0.9450476190476192,0,1,0,604325,1285,105749,2207,0.011902997517507133,0.6320160366552119
36762,0.9454166666666668,1,0,1,604325,1285,105750,2206,0.011902997517507133,0.6319106273274133
36763,0.9454285714285712,1,1,1,604326,1284,105751,2205,0.011893734484419579,0.6319862424763543
36764,0.9454880952380952,0,1,0,604327,1283,105751,2205,0.011884471451332024,0.6321674311926605
36765,0.9455,0,1,0,604328,1282,105751,2205,0.01187520841824447,0.6323487238313736
36766,0.9455436507936508,1,3,1,604331,1279,105752,2204,0.011847419318981808,0.6327878265862762
36767,0.9455873015873014,0,1,0,604332,1278,105752,2204,0.011838156285894253,0.6329695577254452
36768,0.9457142857142856,2,0,2,604332,1278,105754,2202,0.011838156285894253,0.6327586206896552
36769,0.9457619047619048,0,1,0,604333,1277,105754,2202,0.0118288932528067,0.6329405001437195
36770,0.9458333333333332,1,3,1,604336,1274,105755,2201,0.011801104153544037,0.6333812949640287
36771,0.9458333333333334,1,1,1,604337,1273,105756,2200,0.011791841120456482,0.6334581053843938
36772,0.945936507936508,2,0,2,604337,1273,105758,2198,0.011791841120456482,0.6332469029098242
36773,0.946,7,2,7,604339,1271,105765,2191,0.011773315054281374,0.6328711727325246
36774,0.9463095238095238,0,1,0,604340,1270,105765,2191,0.01176405202119382,0.6330540306269864
36775,0.9463333333333334,1,0,1,604340,1270,105766,2190,0.01176405202119382,0.6329479768786127
36776,0.9464523809523808,1,0,1,604340,1270,105767,2189,0.01176405202119382,0.6328418618097716
36777,0.9464761904761904,0,1,0,604341,1269,105767,2189,0.011754788988106266,0.6330248698669751
36778,0.9465,1,0,1,604341,1269,105768,2188,0.011754788988106266,0.632918715649407
36779,0.9466666666666664,13,10,13,604351,1259,105781,2175,0.011662158657230724,0.6333721607454863
36780,0.9466666666666668,24,12,24,604363,1247,105805,2151,0.011551002260180073,0.6330194231901118
36781,0.9468531746031748,0,1,0,604364,1246,105805,2151,0.011541739227092519,0.6332057697968796
36782,0.947,0,2,0,604366,1244,105805,2151,0.01152321316091741,0.6335787923416789
36783,0.9470476190476192,0,1,0,604367,1243,105805,2151,0.011513950127829856,0.6337654684737772
36784,0.9471904761904764,0,2,0,604369,1241,105805,2151,0.011495424061654748,0.6341391509433962
36785,0.9472261904761906,1,1,1,604370,1240,105806,2150,0.011486161028567194,0.6342182890855457
36786,0.9473690476190476,1,0,1,604370,1240,105807,2149,0.011486161028567194,0.6341103570374742
36787,0.9475,10,7,10,604377,1233,105817,2139,0.011421319796954314,0.6343416370106761
36788,0.947547619047619,0,1,0,604378,1232,105817,2139,0.01141205676386676,0.6345298131118362
36789,0.9475476190476192,0,1,0,604379,1231,105817,2139,0.011402793730779206,0.6347181008902077
36790,0.9476666666666668,2,1,2,604380,1230,105819,2137,0.011393530697691652,0.6346896346896347
36791,0.948,1,1,1,604381,1229,105820,2136,0.011384267664604097,0.6347696879643387
36792,0.9481666666666664,1,1,1,604382,1228,105821,2135,0.011375004631516543,0.6348498364555456
36793,0.9481666666666666,1,0,1,604382,1228,105822,2134,0.011375004631516543,0.6347412254610351
36794,0.9482825956723014,0,1,0,604383,1227,105822,2134,0.011365741598428989,0.6349300803332342
36795,0.9483333333333333,3,7,3,604390,1220,105825,2131,0.01130090036681611,0.635929573261713
36796,0.9483333333333336,3,1,3,604391,1219,105828,2128,0.011291637333728555,0.6357932476844935
36797,0.9484166666666666,1,2,1,604393,1217,105829,2127,0.011273111267553447,0.6360645933014354
36798,0.9485,0,1,0,604394,1216,105829,2127,0.011263848234465893,0.6362548609033802
36799,0.9485119047619048,0,2,0,604396,1214,105829,2127,0.011245322168290784,0.6366357378030529
36800,0.9485714285714286,1,0,1,604396,1214,105830,2126,0.011245322168290784,0.6365269461077845
36801,0.9485833333333332,0,1,0,604397,1213,105830,2126,0.01123605913520323,0.6367175801138065
36802,0.9486666666666664,1,0,1,604397,1213,105831,2125,0.01123605913520323,0.6366087477531456
36803,0.948690476190476,1,1,1,604398,1212,105832,2124,0.011226796102115676,0.6366906474820144
36804,0.9488333333333332,0,1,0,604399,1211,105832,2124,0.011217533069028122,0.6368815592203898
36805,0.9488809523809524,0,1,0,604400,1210,105832,2124,0.011208270035940568,0.6370725854829035
36806,0.9488928571428572,0,1,0,604401,1209,105832,2124,0.011199007002853013,0.6372637263726373
36807,0.949,0,1,0,604402,1208,105832,2124,0.01118974396976546,0.6374549819927972
36808,0.949051587301587,1,0,1,604402,1208,105833,2123,0.01118974396976546,0.6373461422996097
36809,0.9491461038961038,0,1,0,604403,1207,105833,2123,0.011180480936677905,0.6375375375375375
36810,0.9491666666666666,2,1,2,604404,1206,105835,2121,0.01117121790359035,0.6375112714156899
36811,0.94925,1,0,1,604404,1206,105836,2120,0.01117121790359035,0.6374022850270595
36812,0.9492857142857144,1,0,1,604404,1206,105837,2119,0.01117121790359035,0.6372932330827068
36813,0.9495833333333332,1,0,1,604404,1206,105838,2118,0.01117121790359035,0.6371841155234657
36814,0.9496666666666668,1,0,1,604404,1206,105839,2117,0.01117121790359035,0.6370749322900993
36815,0.95,400,247,400,604651,959,106239,1717,0.008883248730964468,0.6416292974588939
36816,0.9500000000000002,0,1,0,604652,958,106239,1717,0.008873985697876913,0.6418691588785047
36817,0.9501666666666668,1,0,1,604652,958,106240,1716,0.008873985697876913,0.6417352281226627
36818,0.950404761904762,2,0,2,604652,958,106242,1714,0.008873985697876913,0.6414670658682635
36819,0.9504166666666668,0,1,0,604653,957,106242,1714,0.00886472266478936,0.641707225758143
36820,0.9506666666666668,1,2,1,604655,955,106243,1713,0.00884619659861425,0.6420539730134932
36821,0.9507142857142856,0,1,0,604656,954,106243,1713,0.008836933565526697,0.6422947131608548
36822,0.9507337662337662,1,0,1,604656,954,106244,1712,0.008836933565526697,0.6421605401350338
36823,0.9508333333333334,1,0,1,604656,954,106245,1711,0.008836933565526697,0.6420262664165103
36824,0.9511666666666668,0,1,0,604657,953,106245,1711,0.008827670532439142,0.6422672672672672
36825,0.9515,0,1,0,604658,952,106245,1711,0.008818407499351588,0.6425084491175366
36826,0.9516666666666664,1,0,1,604658,952,106246,1710,0.008818407499351588,0.642374154770849
36827,0.9516666666666668,1,2,1,604660,950,106247,1709,0.00879988143317648,0.6427228281308762
36828,0.9517142857142856,0,1,0,604661,949,106247,1709,0.008790618400088926,0.6429646350639578
36829,0.9518333333333334,0,1,0,604662,948,106247,1709,0.008781355367001371,0.6432066240120436
36830,0.951904761904762,0,1,0,604663,947,106247,1709,0.008772092333913817,0.6434487951807228
36831,0.952,3,0,3,604663,947,106250,1706,0.008772092333913817,0.6430456087448172
36832,0.9520833333333332,0,1,0,604664,946,106250,1706,0.008762829300826263,0.6432880844645551
36833,0.9521428571428572,1,1,1,604665,945,106251,1705,0.008753566267738709,0.6433962264150943
36834,0.9522222222222224,0,1,0,604666,944,106251,1705,0.008744303234651155,0.6436391090977728
36835,0.9525,6,5,6,604671,939,106257,1699,0.008697988069213384,0.6440485216072782
36836,0.9526666666666668,1,0,1,604671,939,106258,1698,0.008697988069213384,0.6439135381114903
36837,0.9528333333333332,1,2,1,604673,937,106259,1697,0.008679462003038275,0.6442672741078208
36838,0.953,0,1,0,604674,936,106259,1697,0.008670198969950721,0.6445119635396885
36839,0.9531666666666668,1,1,1,604675,935,106260,1696,0.008660935936863167,0.6446218167996959
36840,0.9533333333333333,9,10,9,604685,925,106269,1687,0.008568305605987625,0.6458652373660031
36841,0.9533333333333336,5,4,5,604689,921,106274,1682,0.008531253473637408,0.6461774875144064
36842,0.9534325396825396,0,1,0,604690,920,106274,1682,0.008521990440549854,0.6464258262874711
36843,0.953452380952381,0,3,0,604693,917,106274,1682,0.008494201341287191,0.6471719892266257
36844,0.953595238095238,1,0,1,604693,917,106275,1681,0.008494201341287191,0.647036181678214
36845,0.9537307692307692,3,0,3,604693,917,106278,1678,0.008494201341287191,0.6466281310211947
36846,0.9538095238095238,0,1,0,604694,916,106278,1678,0.008484938308199637,0.6468774094063223
36847,0.954,3,2,3,604696,914,106281,1675,0.008466412242024528,0.6469679412900734
36848,0.9541369463869463,2,2,2,604698,912,106283,1673,0.00844788617584942,0.6471953578336557
36849,0.9541666666666668,1,0,1,604698,912,106284,1672,0.00844788617584942,0.6470588235294118
36850,0.9542698412698414,1,1,1,604699,911,106285,1671,0.008438623142761866,0.6471727343144849
36851,0.9542857142857144,0,1,0,604700,910,106285,1671,0.008429360109674312,0.6474234792716002
36852,0.9543373015873012,2,0,2,604700,910,106287,1669,0.008429360109674312,0.6471500581620784
36853,0.9543690476190476,1,2,1,604702,908,106288,1668,0.008410834043499203,0.6475155279503105
36854,0.954404761904762,0,1,0,604703,907,106288,1668,0.008401571010411649,0.6477669902912622
36855,0.955,48,21,48,604724,886,106336,1620,0.00820704731557301,0.6464485235434956
36856,0.9550000000000002,1,1,1,604725,885,106337,1619,0.008197784282485457,0.6465654952076677
36857,0.9551666666666666,0,1,0,604726,884,106337,1619,0.008188521249397902,0.6468238114262884
36858,0.9552976190476192,0,1,0,604727,883,106337,1619,0.008179258216310348,0.6470823341326939
36859,0.9553333333333334,1,0,1,604727,883,106338,1618,0.008179258216310348,0.6469412235105958
36860,0.9554761904761904,0,1,0,604728,882,106338,1618,0.008169995183222794,0.6472
36861,0.9555,0,1,0,604729,881,106338,1618,0.00816073215013524,0.6474589835934373
36862,0.9555714285714284,1,0,1,604729,881,106339,1617,0.00816073215013524,0.6473178542834267
36863,0.9555782828282828,0,1,0,604730,880,106339,1617,0.008151469117047686,0.6475770925110133
36864,0.9558333333333332,0,1,0,604731,879,106339,1617,0.008142206083960131,0.6478365384615384
36865,0.9558333333333334,1,0,1,604731,879,106340,1616,0.008142206083960131,0.6476953907815631
36866,0.956,3,5,3,604736,874,106343,1613,0.00809589091852236,0.648572577402493
36867,0.9561428571428572,0,1,0,604737,873,106343,1613,0.008086627885434806,0.6488334674175382
36868,0.9563333333333331,1,0,1,604737,873,106344,1612,0.008086627885434806,0.648692152917505
36869,0.9563333333333334,0,1,0,604738,872,106344,1612,0.008077364852347252,0.6489533011272142
36870,0.9563333333333336,0,1,0,604739,871,106344,1612,0.008068101819259698,0.6492146596858639
36871,0.9566666666666666,7,3,7,604742,868,106351,1605,0.008040312719997035,0.6490093004448039
36872,0.9566666666666668,11,8,11,604750,860,106362,1594,0.007966208455296603,0.6495517522412388
36873,0.9567142857142856,0,1,0,604751,859,106362,1594,0.007956945422209049,0.6498165511618427
36874,0.957,1,0,1,604751,859,106363,1593,0.007956945422209049,0.649673735725938
36875,0.9571666666666668,1,1,1,604752,858,106364,1592,0.007947682389121495,0.649795918367347
36876,0.9573095238095236,1,0,1,604752,858,106365,1591,0.007947682389121495,0.6496529195590037
36877,0.957404761904762,0,1,0,604753,857,106365,1591,0.00793841935603394,0.6499183006535948
36878,0.9574642857142855,0,1,0,604754,856,106365,1591,0.007929156322946386,0.6501838986514099
36879,0.9575,3,5,3,604759,851,106368,1588,0.007882841157508615,0.6510865108651086
36880,0.9575714285714284,1,2,1,604761,849,106369,1587,0.007864315091333507,0.6514778325123153
36881,0.957642857142857,1,0,1,604761,849,106370,1586,0.007864315091333507,0.6513347022587269
36882,0.9577922632922632,3,3,3,604764,846,106373,1583,0.007836525992070844,0.6517085220255249
36883,0.9579166666666664,0,1,0,604765,845,106373,1583,0.00782726295898329,0.6519769357495881
36884,0.958,2,2,2,604767,843,106375,1581,0.007808736892808181,0.6522277227722773
36885,0.9580476190476191,1,0,1,604767,843,106376,1580,0.007808736892808181,0.6520841931489889
36886,0.958111111111111,0,2,0,604769,841,106376,1580,0.007790210826633072,0.6526228831061545
36887,0.958154761904762,2,0,2,604769,841,106378,1578,0.007790210826633072,0.6523356758991319
36888,0.9583333333333331,4,3,4,604772,838,106382,1574,0.00776242172737041,0.6525704809286899
36889,0.9583333333333336,4,0,4,604772,838,106386,1570,0.00776242172737041,0.6519933554817275
36890,0.9584166666666668,0,1,0,604773,837,106386,1570,0.007753158694282856,0.6522642293311176
36891,0.9585,0,2,0,604775,835,106386,1570,0.007734632628107747,0.6528066528066528
36892,0.9586254138018844,0,1,0,604776,834,106386,1570,0.007725369595020193,0.6530782029950083
36893,0.959,0,1,0,604777,833,106386,1570,0.007716106561932639,0.6533499791926758
36894,0.9591666666666668,1,0,1,604777,833,106387,1569,0.007716106561932639,0.6532056619483764
36895,0.9593333333333331,1,0,1,604777,833,106388,1568,0.007716106561932639,0.6530612244897959
36896,0.9595,0,1,0,604778,832,106388,1568,0.0077068435288450855,0.6533333333333333
36897,0.9595584415584416,0,1,0,604779,831,106388,1568,0.007697580495757531,0.6536056690287619
36898,0.9595714285714284,0,1,0,604780,830,106388,1568,0.007688317462669977,0.6538782318598833
36899,0.9596666666666668,1,2,1,604782,828,106389,1567,0.007669791396494869,0.6542797494780793
36900,0.9598333333333332,1,2,1,604784,826,106390,1566,0.00765126533031976,0.6546822742474916
36901,0.96,373,192,373,604976,634,106763,1193,0.005872762977509356,0.6529830322933772
36902,0.9601666666666666,1,1,1,604977,633,106764,1192,0.0058634999444218015,0.6531506849315069
36903,0.960404761904762,0,1,0,604978,632,106764,1192,0.005854236911334247,0.6535087719298246
36904,0.9604761904761904,0,2,0,604980,630,106764,1192,0.005835710845159139,0.6542261251372119
36905,0.9606666666666668,0,1,0,604981,629,106764,1192,0.005826447812071585,0.6545853926414058
36906,0.9607619047619048,1,1,1,604982,628,106765,1191,0.0058171847789840305,0.6547553600879604
36907,0.9608333333333334,0,1,0,604983,627,106765,1191,0.005807921745896476,0.6551155115511551
36908,0.960904761904762,0,1,0,604984,626,106765,1191,0.005798658712808922,0.6554760594386351
36909,0.9609523809523808,1,0,1,604984,626,106766,1190,0.005798658712808922,0.6552863436123348
36910,0.961,2,0,2,604984,626,106768,1188,0.005798658712808922,0.6549062844542448
36911,0.9610714285714284,1,0,1,604984,626,106769,1187,0.005798658712808922,0.6547159404302262
36912,0.96154329004329,0,1,0,604985,625,106769,1187,0.005789395679721368,0.6550772626931567
36913,0.9615833333333332,0,1,0,604986,624,106769,1187,0.005780132646633814,0.6554389839867476
36914,0.9616666666666666,0,2,0,604988,622,106769,1187,0.005761606580458705,0.65616362631288
36915,0.9616666666666668,0,1,0,604989,621,106769,1187,0.005752343547371151,0.6565265486725663
36916,0.962,1,1,1,604990,620,106770,1186,0.005743080514283597,0.6566998892580288
36917,0.9620833333333332,0,1,0,604991,619,106770,1186,0.005733817481196043,0.6570637119113574
36918,0.9621428571428572,0,1,0,604992,618,106770,1186,0.0057245544481084884,0.6574279379157428
36919,0.9623333333333334,0,1,0,604993,617,106770,1186,0.005715291415020934,0.6577925679423183
36920,0.9623809523809524,1,0,1,604993,617,106771,1185,0.005715291415020934,0.6576026637069923
36921,0.9625,2,0,2,604993,617,106773,1183,0.005715291415020934,0.6572222222222223
36922,0.9625476190476192,0,1,0,604994,616,106773,1183,0.00570602838193338,0.6575875486381323
36923,0.9628333333333332,1,0,1,604994,616,106774,1182,0.00570602838193338,0.657397107897664
36924,0.9633333333333332,4,9,4,605003,607,106778,1178,0.005622661084145392,0.6599439775910364
36925,0.9633333333333334,14,4,14,605007,603,106792,1164,0.005585608951795175,0.6587436332767402
36926,0.9635364635364636,1,0,1,605007,603,106793,1163,0.005585608951795175,0.6585503963759909
36927,0.963809523809524,0,1,0,605008,602,106793,1163,0.005576345918707622,0.6589235127478753
36928,0.963952380952381,0,1,0,605009,601,106793,1163,0.005567082885620068,0.659297052154195
36929,0.9639642857142856,1,0,1,605009,601,106794,1162,0.005567082885620068,0.659103800340329
36930,0.964,3,1,3,605010,600,106797,1159,0.005557819852532514,0.6588971006253553
36931,0.9640277777777776,1,0,1,605010,600,106798,1158,0.005557819852532514,0.658703071672355
36932,0.9644880952380954,0,1,0,605011,599,106798,1158,0.005548556819444959,0.6590779738190097
36933,0.9645,0,1,0,605012,598,106798,1158,0.005539293786357405,0.6594533029612756
36934,0.9646190476190476,1,0,1,605012,598,106799,1157,0.005539293786357405,0.6592592592592592
36935,0.965,28,25,28,605037,573,106827,1129,0.00530771795916855,0.663337250293772
36936,0.9653333333333332,1,1,1,605038,572,106828,1128,0.005298454926080996,0.6635294117647059
36937,0.9654166666666668,1,1,1,605039,571,106829,1127,0.005289191892993442,0.6637220259128387
36938,0.9655,0,1,0,605040,570,106829,1127,0.0052799288599058875,0.6641131408367708
36939,0.966,3,1,3,605041,569,106832,1124,0.005270665826818333,0.6639102185469581
36940,0.9663333333333334,1,0,1,605041,569,106833,1123,0.005270665826818333,0.6637115839243499
36941,0.9665,1,0,1,605041,569,106834,1122,0.005270665826818333,0.6635127143701951
36942,0.9666666666666666,5,3,5,605044,566,106839,1117,0.005242876727555671,0.6636957813428401
36943,0.9666666666666668,7,5,7,605049,561,106846,1110,0.0051965615621179,0.6642728904847397
36944,0.9669444444444444,0,1,0,605050,560,106846,1110,0.0051872985290303455,0.6646706586826348
36945,0.967059523809524,1,0,1,605050,560,106847,1109,0.0051872985290303455,0.664469742360695
36946,0.9671428571428572,0,1,0,605051,559,106847,1109,0.005178035495942791,0.6648681055155875
36947,0.9672142857142856,1,0,1,605051,559,106848,1108,0.005178035495942791,0.6646670665866826
36948,0.9674722222222224,1,0,1,605051,559,106849,1107,0.005178035495942791,0.6644657863145258
36949,0.9675,3,4,3,605055,555,106852,1104,0.0051409833635925745,0.6654611211573237
36950,0.9676190476190476,0,1,0,605056,554,106852,1104,0.00513172033050502,0.6658624849215923
36951,0.9677936507936508,0,1,0,605057,553,106852,1104,0.005122457297417466,0.6662643331321666
36952,0.968,6,4,6,605061,549,106858,1098,0.005085405165067249,0.6666666666666666
36953,0.9683333333333332,2,0,2,605061,549,106860,1096,0.005085405165067249,0.6662613981762918
36954,0.9683333333333334,2,2,2,605063,547,106862,1094,0.005066879098892141,0.6666666666666666
36955,0.9685,0,1,0,605064,546,106862,1094,0.005057616065804587,0.6670731707317074
36956,0.9685454545454546,1,0,1,605064,546,106863,1093,0.005057616065804587,0.6668700427089689
36957,0.9687142857142856,2,0,2,605064,546,106865,1091,0.005057616065804587,0.6664630421502749
36958,0.968876984126984,2,0,2,605064,546,106867,1089,0.005057616065804587,0.6660550458715596
36959,0.969,1,0,1,605064,546,106868,1088,0.005057616065804587,0.6658506731946144
36960,0.9691666666666666,2,0,2,605064,546,106870,1086,0.005057616065804587,0.6654411764705882
36961,0.9692261904761904,1,0,1,605064,546,106871,1085,0.005057616065804587,0.6652360515021459
36962,0.9697532467532466,1,1,1,605065,545,106872,1084,0.005048353032717033,0.665438919582566
36963,0.97,308,166,308,605231,379,107180,776,0.0035106895401830376,0.6718614718614718
36964,0.9700000000000002,0,1,0,605232,378,107180,776,0.0035014265070954834,0.6724436741767764
36965,0.9705,0,1,0,605233,377,107180,776,0.003492163474007929,0.6730268863833477
36966,0.9705555555555556,0,1,0,605234,376,107180,776,0.003482900440920375,0.6736111111111112
36967,0.9705833333333334,1,0,1,605234,376,107181,775,0.003482900440920375,0.6733275412684622
36968,0.9708333333333332,2,0,2,605234,376,107183,773,0.003482900440920375,0.6727589208006962
36969,0.9712380952380952,0,1,0,605235,375,107183,773,0.003473637407832821,0.6733449477351916
36970,0.9712651515151516,0,2,0,605237,373,107183,773,0.0034551113416577124,0.6745200698080279
36971,0.9713492063492064,1,0,1,605237,373,107184,772,0.0034551113416577124,0.674235807860262
36972,0.9716666666666668,2,2,2,605239,371,107186,770,0.003436585275482604,0.6748466257668712
36973,0.9718095238095238,1,0,1,605239,371,107187,769,0.003436585275482604,0.6745614035087719
36974,0.972,1,0,1,605239,371,107188,768,0.003436585275482604,0.6742756804214223
36975,0.9724642857142858,1,0,1,605239,371,107189,767,0.003436585275482604,0.6739894551845342
36976,0.97249531024531,0,2,0,605241,369,107189,767,0.0034180592093074956,0.6751760563380281
36977,0.9725,2,6,2,605247,363,107191,765,0.0033624810107821704,0.6781914893617021
36978,0.9725833333333334,1,0,1,605247,363,107192,764,0.0033624810107821704,0.6779059449866903
36979,0.9728214285714286,0,1,0,605248,362,107192,764,0.003353217977694616,0.6785079928952042
36980,0.973,1,0,1,605248,362,107193,763,0.003353217977694616,0.6782222222222222
36981,0.973035714285714,0,1,0,605249,361,107193,763,0.003343954944607062,0.6788256227758007
36982,0.9733333333333332,2,1,2,605250,360,107195,761,0.0033346919115195077,0.6788581623550402
36983,0.9733333333333334,2,4,2,605254,356,107197,759,0.0032976397791692914,0.6807174887892377
36984,0.974,3,4,3,605258,352,107200,756,0.0032605876468190746,0.6823104693140795
36985,0.9741666666666668,1,1,1,605259,351,107201,755,0.0032513246137315203,0.6826401446654611
36986,0.9742857142857144,0,1,0,605260,350,107201,755,0.003242061580643966,0.6832579185520362
36987,0.974547619047619,0,2,0,605262,348,107201,755,0.0032235355144688577,0.6844968268359021
36988,0.974984126984127,1,0,1,605262,348,107202,754,0.0032235355144688577,0.6842105263157895
36989,0.975,19,12,19,605274,336,107221,735,0.0031123791174182073,0.6862745098039216
36990,0.976,0,1,0,605275,335,107221,735,0.003103116084330653,0.6869158878504673
36991,0.9760588023088024,1,0,1,605275,335,107222,734,0.003103116084330653,0.686623012160898
36992,0.9766666666666666,4,4,4,605279,331,107226,730,0.0030660639519804363,0.6880301602262017
36993,0.9766666666666668,2,2,2,605281,329,107228,728,0.0030475378858053283,0.6887417218543046
36994,0.9773333333333334,1,0,1,605281,329,107229,727,0.0030475378858053283,0.6884469696969697
36995,0.9775,1,4,1,605285,325,107230,726,0.0030104857534551115,0.6907706945765937
36996,0.978,0,1,0,605286,324,107230,726,0.0030012227203675573,0.6914285714285714
36997,0.9782857142857144,1,0,1,605286,324,107231,725,0.0030012227203675573,0.6911344137273594
36998,0.9783333333333332,0,3,0,605289,321,107231,725,0.0029734336211048947,0.6931166347992351
36999,0.9783333333333334,1,1,1,605290,320,107232,724,0.0029641705880173405,0.6934865900383141
37000,0.9788571428571428,0,3,0,605293,317,107232,724,0.002936381488754678,0.6954851104707013
37001,0.979,1,0,1,605293,317,107233,723,0.002936381488754678,0.6951923076923077
37002,0.979923076923077,0,1,0,605294,316,107233,723,0.0029271184556671236,0.6958614051973051
37003,0.98,291,126,291,605420,190,107524,432,0.001759976286635296,0.6945337620578779
37004,0.9801984126984128,0,3,0,605423,187,107524,432,0.0017321871873726333,0.6978998384491115
37005,0.9808333333333334,1,0,1,605423,187,107525,431,0.0017321871873726333,0.6974110032362459
37006,0.9813333333333332,0,3,0,605426,184,107525,431,0.0017043980881099707,0.7008130081300813
37007,0.9816666666666668,1,0,1,605426,184,107526,430,0.0017043980881099707,0.7003257328990228
37008,0.982,1,0,1,605426,184,107527,429,0.0017043980881099707,0.6998368678629691
37009,0.9825,1,1,1,605427,183,107528,428,0.0016951350550224165,0.7004909983633388
37010,0.9826666666666668,0,1,0,605428,182,107528,428,0.0016858720219348623,0.7016393442622951
37011,0.9833333333333332,3,2,3,605430,180,107531,425,0.0016673459557597539,0.7024793388429752
37012,0.9833333333333334,2,0,2,605430,180,107533,423,0.0016673459557597539,0.7014925373134329
37013,0.9835393217893216,0,1,0,605431,179,107533,423,0.0016580829226721999,0.7026578073089701
37014,0.984,0,2,0,605433,177,107533,423,0.0016395568564970915,0.705
37015,0.9841666666666667,1,0,1,605433,177,107534,422,0.0016395568564970915,0.7045075125208681
37016,0.9843333333333332,0,2,0,605435,175,107534,422,0.001621030790321983,0.7068676716917923
37017,0.9846031746031744,1,0,1,605435,175,107535,421,0.001621030790321983,0.7063758389261745
37018,0.985,9,6,9,605441,169,107544,412,0.0015654525917966578,0.7091222030981067
37019,0.986,2,0,2,605441,169,107546,410,0.0015654525917966578,0.7081174438687392
37020,0.9864444444444443,0,1,0,605442,168,107546,410,0.0015561895587091036,0.7093425605536332
37021,0.9866666666666666,5,1,5,605443,167,107551,405,0.0015469265256215494,0.708041958041958
37022,0.9866666666666668,3,2,3,605445,165,107554,402,0.0015284004594464412,0.708994708994709
37023,0.9870714285714286,1,0,1,605445,165,107555,401,0.0015284004594464412,0.7084805653710248
37024,0.9875,6,2,6,605447,163,107561,395,0.0015098743932713328,0.7078853046594982
37025,0.988,0,1,0,605448,162,107561,395,0.0015006113601837786,0.7091561938958707
37026,0.9883333333333332,1,2,1,605450,160,107562,394,0.0014820852940086702,0.7111913357400722
37027,0.989404761904762,0,1,0,605451,159,107562,394,0.001472822260921116,0.7124773960216998
37028,0.99,209,97,209,605548,62,107771,185,0.0005743080514283597,0.7489878542510121
37029,0.9906666666666666,1,1,1,605549,61,107772,184,0.0005650450183408056,0.7510204081632653
37030,0.9916666666666668,2,0,2,605549,61,107774,182,0.0005650450183408056,0.7489711934156379
37031,0.9925,2,0,2,605549,61,107776,180,0.0005650450183408056,0.7468879668049793
37032,0.9933333333333332,2,1,2,605550,60,107778,178,0.0005557819852532514,0.7478991596638656
37033,0.9942857142857144,1,1,1,605551,59,107779,177,0.0005465189521656972,0.75
37034,0.995,3,4,3,605555,55,107782,174,0.0005094668198154803,0.759825327510917
37035,0.9966666666666666,3,0,3,605555,55,107785,171,0.0005094668198154803,0.7566371681415929
37036,0.9966666666666668,1,0,1,605555,55,107786,170,0.0005094668198154803,0.7555555555555555
37037,0.9975,1,0,1,605555,55,107787,169,0.0005094668198154803,0.7544642857142857
37038,0.9977777777777778,0,1,0,605556,54,107787,169,0.0005002037867279261,0.757847533632287
37039,0.9985714285714288,0,5,0,605561,49,107787,169,0.00045388862129015523,0.7752293577981652
37040,1.0,169,49,169,605610,0,107956,0,0.0,
