,y_proba,y_test,Neg,Pos,TN,FP,FN,TP,FP/P,Prec
0,0.0393,0,1,0,1,605609,0,107956,5.609776205120605,0.1512910526721462
1,0.0397,0,1,0,2,605608,0,107956,5.609766942087517,0.15129126469384666
2,0.0454,0,1,0,3,605607,0,107956,5.60975767905443,0.1512914767161414
3,0.047,0,1,0,4,605606,0,107956,5.609748416021342,0.15129168873903037
4,0.0486,0,1,0,5,605605,0,107956,5.609739152988254,0.15129190076251364
5,0.0508,0,2,0,7,605603,0,107956,5.609720626922079,0.15129232481126298
6,0.0511,0,1,0,8,605602,0,107956,5.609711363888992,0.15129253683652905
7,0.0529,0,2,0,10,605600,0,107956,5.609692837822816,0.15129296088884403
8,0.0532,0,1,0,11,605599,0,107956,5.609683574789729,0.15129317291589295
9,0.0539,0,1,0,12,605598,0,107956,5.609674311756642,0.15129338494353617
10,0.0562,0,1,0,13,605597,0,107956,5.609665048723554,0.15129359697177364
11,0.0563,0,2,0,15,605595,0,107956,5.609646522657379,0.15129402103003148
12,0.057,0,1,0,16,605594,0,107956,5.609637259624291,0.15129423306005185
13,0.0571,0,2,0,18,605592,0,107956,5.609618733558117,0.15129465712187548
14,0.0573,0,1,0,19,605591,0,107956,5.609609470525029,0.15129486915367873
15,0.0579,0,2,0,21,605589,0,107956,5.609590944458853,0.15129529321906818
16,0.0586,1,29,1,50,605560,1,107955,5.6093223164993145,0.15130025297295782
17,0.0589,0,2,0,52,605558,1,107955,5.609303790433139,0.15130067707245698
18,0.0593,0,2,0,54,605556,1,107955,5.609285264366965,0.15130110117433368
19,0.0611,0,2,0,56,605554,1,107955,5.609266738300789,0.15130152527858792
20,0.0618,0,5,0,61,605549,1,107955,5.609220423135351,0.1513025855496255
21,0.062,0,1,0,62,605548,1,107955,5.609211160102264,0.15130279760561624
22,0.0621,0,3,0,65,605545,1,107955,5.6091833710030015,0.15130343377715488
23,0.0623,0,3,0,68,605542,1,107955,5.609155581903739,0.15130406995404325
24,0.0626,0,24,0,92,605518,1,107955,5.608933269109637,0.15130915956174937
25,0.0633,0,1,0,93,605517,1,107955,5.60892400607655,0.15130937163616792
26,0.0637,0,25,0,118,605492,1,107955,5.608692430249361,0.1513146736898466
27,0.064,0,2,0,120,605490,1,107955,5.608673904183186,0.1513150978701932
28,0.0647,0,1,0,121,605489,1,107955,5.608664641150098,0.15131530996125836
29,0.0652,0,8,0,129,605481,1,107955,5.608590536885398,0.15131700671118362
30,0.0658,0,30,0,159,605451,1,107955,5.608312645892771,0.15132336986232245
31,0.066,0,2,0,161,605449,1,107955,5.608294119826596,0.15132379409142646
32,0.0663,0,1,0,162,605448,1,107955,5.608284856793508,0.15132400620687045
33,0.0664,0,1,0,163,605447,1,107955,5.608275593760421,0.1513242183229091
34,0.0671,0,2,0,165,605445,1,107955,5.608257067694246,0.1513246425567704
35,0.0675,0,1,0,166,605444,1,107955,5.608247804661159,0.15132485467459303
36,0.0676,0,1,0,167,605443,1,107955,5.6082385416280705,0.15132506679301036
37,0.0677,0,1,0,168,605442,1,107955,5.608229278594983,0.15132527891202233
38,0.0685,0,3,0,171,605439,1,107955,5.608201489495721,0.15132591527262634
39,0.0686,0,18,0,189,605421,1,107955,5.608034754900144,0.15132973354864757
40,0.0687,0,1,0,190,605420,1,107955,5.608025491867057,0.15132994568074296
41,0.0688,0,2,0,192,605418,1,107955,5.6080069658008815,0.15133036994671792
42,0.0695,0,7,0,199,605411,1,107955,5.607942124569269,0.15133185489636455
43,0.0698,0,4,0,203,605407,1,107955,5.607905072436918,0.15133270345210426
44,0.0699,0,3,0,206,605404,1,107955,5.607877283337656,0.15133333987515402
45,0.0707,0,1,0,207,605403,1,107955,5.6078680203045685,0.15133355201736015
46,0.0709,1,17,1,224,605386,2,107954,5.60771054874208,0.1513359688227213
47,0.0712,0,3,0,227,605383,2,107954,5.607682759642818,0.15133660527913173
48,0.0713,0,1,0,228,605382,2,107954,5.6076734966097295,0.1513368174324582
49,0.0715,0,2,0,230,605380,2,107954,5.607654970543555,0.15133724174089558
50,0.0717,1,20,1,250,605360,3,107953,5.607469709881804,0.15134029521402245
51,0.0718,0,5,0,255,605355,3,107953,5.607423394716366,0.1513413560481587
52,0.0719,0,3,0,258,605352,3,107953,5.6073956056171035,0.1513419925557791
53,0.0721,0,2,0,260,605350,3,107953,5.607377079550928,0.15134241689716713
54,0.0723,0,2,0,262,605348,3,107953,5.607358553484753,0.15134284124093475
55,0.0725,1,14,1,276,605334,4,107952,5.607228871021527,0.15134462193285722
56,0.073,0,1,0,277,605333,4,107952,5.60721960798844,0.15134483411259175
57,0.0733,0,1,0,278,605332,4,107952,5.6072103449553525,0.1513450462929212
58,0.0735,0,1,0,279,605331,4,107952,5.607201081922264,0.15134525847384558
59,0.0736,0,42,0,321,605289,4,107952,5.606812034532587,0.15135417060993409
60,0.0739,0,3,0,324,605286,4,107952,5.6067842454333245,0.15135480723124678
61,0.0741,0,2,0,326,605284,4,107952,5.606765719367149,0.15135523164843054
62,0.0745,0,2,0,328,605282,4,107952,5.606747193300975,0.1513556560679945
63,0.0749,0,15,0,343,605267,4,107952,5.606608247804661,0.15135883929059657
64,0.075,0,1,0,344,605266,4,107952,5.606598984771574,0.15135905151019743
65,0.0751,1,14,1,358,605252,5,107951,5.606469302308348,0.1513608327502829
66,0.0753,0,40,0,398,605212,5,107951,5.606098780984846,0.1513693223007924
67,0.0754,1,0,1,398,605212,6,107950,5.606098780984846,0.15136813234580643
68,0.0755,0,1,0,399,605211,6,107950,5.606089517951758,0.1513683445953999
69,0.0757,0,23,0,422,605188,6,107950,5.605876468190744,0.15137322650034074
70,0.0758,1,10,1,432,605178,7,107949,5.605783837859869,0.15137415916099095
71,0.0761,0,6,0,438,605172,7,107949,5.605728259661343,0.1513754327806922
72,0.0762,0,1,0,439,605171,7,107949,5.605718996628256,0.15137564505272605
73,0.0763,0,3,0,442,605168,7,107949,5.605691207528993,0.15137628187239963
74,0.0764,0,34,0,476,605134,7,107949,5.605376264404017,0.15138349953651958
75,0.0765,0,3,0,479,605131,7,107949,5.605348475304754,0.1513841364222808
76,0.0767,0,24,0,503,605107,7,107949,5.605126162510652,0.15138923170129695
77,0.077,0,2,0,505,605105,7,107949,5.605107636444477,0.151389656323364
78,0.0771,0,2,0,507,605103,7,107949,5.6050891103783025,0.15139008094781306
79,0.0772,0,2,0,509,605101,7,107949,5.605070584312127,0.15139050557464415
80,0.0778,0,3,0,512,605098,7,107949,5.6050427952128645,0.15139114251935706
81,0.0779,1,5,1,517,605093,8,107948,5.604996480047427,0.15139101398096322
82,0.0783,0,5,0,522,605088,8,107948,5.604950164881989,0.15139207557542678
83,0.0784,0,1,0,523,605087,8,107948,5.604940901848901,0.1513922878961061
84,0.0786,0,2,0,525,605085,8,107948,5.604922375782726,0.15139271253925135
85,0.0787,0,2,0,527,605083,8,107948,5.6049038497165515,0.1513931371847788
86,0.0788,2,11,2,538,605072,10,107946,5.604801956352588,0.1513930924604989
87,0.079,0,2,0,540,605070,10,107946,5.604783430286413,0.15139351711602544
88,0.0791,0,1,0,541,605069,10,107946,5.604774167253326,0.1513937294446821
89,0.0792,1,30,1,571,605039,11,107945,5.604496276260699,0.15139890937244033
90,0.0793,0,9,0,580,605030,11,107945,5.604412908962911,0.15140082050562784
91,0.0796,0,9,0,589,605021,11,107945,5.604329541665122,0.15140273168706503
92,0.0799,0,2,0,591,605019,11,107945,5.604311015598948,0.15140315640060367
93,0.08,0,17,0,608,605002,11,107945,5.60415354403646,0.15140676656189028
94,0.0803,1,10,1,618,604992,12,107944,5.604060913705584,0.15140769998990092
95,0.0804,1,1,1,619,604991,13,107943,5.604051650672496,0.15140672208086584
96,0.0805,0,31,0,650,604960,13,107943,5.603764496646782,0.1514133058775177
97,0.0806,0,25,0,675,604935,13,107943,5.603532920819593,0.15141861580803448
98,0.0809,1,44,1,719,604891,14,107942,5.603125347363741,0.15142677176842262
99,0.0812,0,4,0,723,604887,14,107942,5.603088295231391,0.1514276214912693
100,0.0813,0,32,0,755,604855,14,107942,5.602791878172589,0.1514344196173665
101,0.0814,0,5,0,760,604850,14,107942,5.602745563007151,0.15143548187970685
102,0.0815,0,3,0,763,604847,14,107942,5.602717773907888,0.15143611924426442
103,0.0816,0,53,0,816,604794,14,107942,5.602226833154248,0.15144738023616036
104,0.0817,0,1,0,817,604793,14,107942,5.6022175701211605,0.15144759272380337
105,0.0818,0,5,0,822,604788,14,107942,5.6021712549557225,0.15144865517096234
106,0.082,1,10,1,832,604778,15,107941,5.6020786246248475,0.15144958952967438
107,0.0821,0,1,0,833,604777,15,107941,5.602069361591759,0.15144980202548552
108,0.0823,0,2,0,835,604775,15,107941,5.602050835525585,0.15145022701889674
109,0.0824,0,1,0,836,604774,15,107941,5.602041572492497,0.15145043951649678
110,0.0825,0,6,0,842,604768,15,107941,5.601985994293972,0.15145171451461958
111,0.0826,1,21,1,863,604747,16,107940,5.601791470599133,0.15145498655089823
112,0.0831,0,28,0,891,604719,16,107940,5.601532105672682,0.15146093713823863
113,0.0832,0,19,0,910,604700,16,107940,5.601356108044018,0.15146497530309833
114,0.0835,0,29,0,939,604671,16,107940,5.6010874800844785,0.1514711392330458
115,0.0836,0,1,0,940,604670,16,107940,5.601078217051391,0.1514713517913024
116,0.0837,0,1,0,941,604669,16,107940,5.601068954018304,0.15147156435015555
117,0.0839,0,42,0,983,604627,16,107940,5.600679906628627,0.15148049236071837
118,0.0841,0,1,0,984,604626,16,107940,5.600670643595539,0.1514807049452261
119,0.0842,0,5,0,989,604621,16,107940,5.600624328430101,0.1514817678767151
120,0.0843,0,1,0,990,604620,16,107940,5.6006150653970135,0.15148198046480296
121,0.0845,0,14,0,1004,604606,16,107940,5.600485382933788,0.15148495676068632
122,0.0847,0,11,0,1015,604595,16,107940,5.600383489569825,0.15148729536092964
123,0.0848,0,30,0,1045,604565,16,107940,5.600105598577198,0.15149367372860542
124,0.0849,0,35,0,1080,604530,16,107940,5.599781392419134,0.15150111583645628
125,0.085,0,2,0,1082,604528,16,107940,5.599762866352958,0.15150154112184688
126,0.0857,0,3,0,1085,604525,16,107940,5.599735077253696,0.15150217905440969
127,0.0858,0,4,0,1089,604521,16,107940,5.599698025121346,0.15150302963951712
128,0.0859,0,2,0,1091,604519,16,107940,5.599679499055171,0.15150345493565243
129,0.086,0,4,0,1095,604515,16,107940,5.599642446922821,0.15150430553508643
130,0.0861,0,5,0,1100,604510,16,107940,5.599596131757383,0.15150536879781037
131,0.0863,0,4,0,1104,604506,16,107940,5.599559079625032,0.1515062194187349
132,0.0864,0,2,0,1106,604504,16,107940,5.599540553558858,0.151506644732779
133,0.0865,0,1,0,1107,604503,16,107940,5.5995312905257695,0.15150685739069653
134,0.0868,0,1,0,1108,604502,16,107940,5.599522027492682,0.15150707004921102
135,0.0869,0,1,0,1109,604501,16,107940,5.599512764459595,0.1515072827083225
136,0.0872,0,4,0,1113,604497,16,107940,5.599475712327244,0.15150813335073837
137,0.0873,0,1,0,1114,604496,16,107940,5.599466449294157,0.15150834601283483
138,0.0874,1,5,1,1119,604491,17,107939,5.599420134128719,0.15150821835127662
139,0.0876,0,1,0,1120,604490,17,107939,5.599410871095632,0.1515084310155819
140,0.0877,0,2,0,1122,604488,17,107939,5.5993923450294565,0.15150885634598352
141,0.0878,0,2,0,1124,604486,17,107939,5.599373818963281,0.1515092816787732
142,0.0879,0,4,0,1128,604482,17,107939,5.599336766830931,0.15151013235151686
143,0.088,0,11,0,1139,604471,17,107939,5.599234873466968,0.15151247175081764
144,0.0882,2,44,2,1183,604427,19,107937,5.5988273000111155,0.1515194479226912
145,0.0883,0,17,0,1200,604410,19,107937,5.598669828448627,0.15152306390003747
146,0.0884,0,5,0,1205,604405,19,107937,5.598623513283189,0.15152412745563226
147,0.0885,0,2,0,1207,604403,19,107937,5.598604987217015,0.15152455288205072
148,0.0886,0,1,0,1208,604402,19,107937,5.598595724183927,0.15152476559615577
149,0.0888,0,5,0,1213,604397,19,107937,5.598549409018489,0.1515258291756395
150,0.0889,0,4,0,1217,604393,19,107937,5.598512356886139,0.15152668004997683
151,0.0891,0,2,0,1219,604391,19,107937,5.598493830819963,0.15152710549072898
152,0.0892,0,4,0,1223,604387,19,107937,5.598456778687614,0.1515279563794004
153,0.0894,0,2,0,1225,604385,19,107937,5.598438252621438,0.15152838182731967
154,0.0895,1,18,1,1243,604367,20,107936,5.598271518025863,0.1515310198047741
155,0.0897,0,5,0,1248,604362,20,107936,5.598225202860425,0.15153208348191347
156,0.0898,1,17,1,1265,604345,21,107935,5.598067731297936,0.15153450890099399
157,0.0899,0,12,0,1277,604333,21,107935,5.597956574900886,0.15153706189243374
158,0.09,0,8,0,1285,604325,21,107935,5.597882470636185,0.1515387639345183
159,0.0901,0,37,0,1322,604288,21,107935,5.597539738411945,0.15154663637652813
160,0.0903,0,11,0,1333,604277,21,107935,5.597437845047983,0.15154897698999736
161,0.0904,0,1,0,1334,604276,21,107935,5.597428582014895,0.15154918977662518
162,0.0905,1,4,1,1338,604272,22,107934,5.597391529882545,0.1515488496305844
163,0.0909,0,3,0,1341,604269,22,107934,5.597363740783282,0.15154948799710194
164,0.091,0,21,0,1362,604248,22,107934,5.597169217088443,0.15155395671331204
165,0.0911,0,25,0,1387,604223,22,107934,5.596937641261254,0.15155927695718782
166,0.0912,0,4,0,1391,604219,22,107934,5.5969005891289045,0.15156012823087173
167,0.0913,1,52,1,1443,604167,23,107933,5.596418911408351,0.15157000421289143
168,0.0914,0,33,0,1476,604134,23,107933,5.596113231316462,0.15157702856613212
169,0.0915,1,28,1,1504,604106,24,107932,5.59585386639001,0.15158179760068985
170,0.0917,0,9,0,1513,604097,24,107932,5.595770499092223,0.1515837135846995
171,0.0918,0,37,0,1550,604060,24,107932,5.595427766867983,0.15159159091675187
172,0.0919,1,9,1,1559,604051,25,107931,5.5953443995701955,0.15159231553606692
173,0.0921,0,8,0,1567,604043,25,107931,5.595270295305495,0.151594018882712
174,0.0922,0,16,0,1583,604027,25,107931,5.595122086776094,0.1515974256908413
175,0.0923,0,3,0,1586,604024,25,107931,5.595094297676831,0.15159806448441263
176,0.0924,0,4,0,1590,604020,25,107931,5.595057245544481,0.15159891621754867
177,0.0925,0,1,0,1591,604019,25,107931,5.595047982511393,0.15159912915232812
178,0.0926,1,7,1,1598,604012,26,107930,5.594983141279781,0.15159942804329565
179,0.0927,0,16,0,1614,603996,26,107930,5.59483493275038,0.15160283512612266
180,0.0928,0,27,0,1641,603969,26,107930,5.594584830857015,0.15160858492567064
181,0.0929,0,21,0,1662,603948,26,107930,5.594390307162177,0.151613057293525
182,0.093,0,5,0,1667,603943,26,107930,5.594343991996739,0.15161412218190604
183,0.0933,0,1,0,1668,603942,26,107930,5.594334728963652,0.15161433516137732
184,0.0935,0,1,0,1669,603941,26,107930,5.594325465930564,0.15161454814144698
185,0.0936,0,5,0,1674,603936,26,107930,5.594279150765127,0.1516156130507708
186,0.0937,0,19,0,1693,603917,26,107930,5.594103153136463,0.15161965984263473
187,0.0938,0,10,0,1703,603907,26,107930,5.594010522805587,0.15162178981986044
188,0.0942,1,4,1,1707,603903,27,107929,5.593973470673237,0.15162145000505736
189,0.0943,0,13,0,1720,603890,27,107929,5.593853051243099,0.15162421907816453
190,0.0944,0,3,0,1723,603887,27,107929,5.593825262143836,0.15162485810939905
191,0.0945,0,2,0,1725,603885,27,107929,5.593806736077661,0.15162528413321458
192,0.0946,0,26,0,1751,603859,27,107929,5.593565897217385,0.15163082266067987
193,0.0948,0,12,0,1763,603847,27,107929,5.593454740820334,0.15163337904059704
194,0.0949,0,1,0,1764,603846,27,107929,5.593445477787247,0.15163359207614766
195,0.0951,1,9,1,1773,603837,28,107928,5.593362110489458,0.15163431750648038
196,0.0952,0,8,0,1781,603829,28,107928,5.593288006224758,0.151636021844534
197,0.0953,0,4,0,1785,603825,28,107928,5.593250954092408,0.15163687402792822
198,0.0954,0,49,0,1834,603776,28,107928,5.592797065471117,0.15164731405190923
199,0.0955,0,4,0,1838,603772,28,107928,5.592760013338768,0.15164816636223127
200,0.0956,0,9,0,1847,603763,28,107928,5.59267664604098,0.15165008409548525
201,0.0957,1,28,1,1875,603735,29,107927,5.592417281114528,0.15165485862670763
202,0.0959,0,6,0,1881,603729,29,107927,5.592361702916003,0.1516561372348438
203,0.096,0,9,0,1890,603720,29,107927,5.592278335618214,0.15165805518747358
204,0.0961,0,3,0,1893,603717,29,107927,5.592250546518952,0.15165869451579722
205,0.0962,0,14,0,1907,603703,29,107927,5.592120864055726,0.15166167811924736
206,0.0964,1,19,1,1926,603684,30,107926,5.591944866427063,0.15166453534941893
207,0.0966,0,13,0,1939,603671,30,107926,5.591824446996925,0.15166730607352194
208,0.0967,1,4,1,1943,603667,31,107925,5.591787394864575,0.15166696646392877
209,0.0969,0,2,0,1945,603665,31,107925,5.5917688687983995,0.15166739274020152
210,0.097,0,10,0,1955,603655,31,107925,5.591676238467524,0.15166952415750865
211,0.0972,0,12,0,1967,603643,31,107925,5.591565082070473,0.15167208193735526
212,0.0973,0,26,0,1993,603617,31,107925,5.591324243210197,0.15167762408965318
213,0.0974,0,2,0,1995,603615,31,107925,5.591305717144022,0.15167805042583693
214,0.0975,0,1,0,1996,603614,31,107925,5.5912964541109345,0.15167826359482756
215,0.0976,1,28,1,2024,603586,32,107924,5.591037089184483,0.15168304029458476
216,0.0977,1,31,1,2055,603555,33,107923,5.590749935158768,0.15168845698672342
217,0.0978,0,38,0,2093,603517,33,107923,5.590397939901441,0.1516965590914202
218,0.0979,0,4,0,2097,603513,33,107923,5.590360887769091,0.15169741199489484
219,0.098,0,2,0,2099,603511,33,107923,5.590342361702916,0.1516978384502287
220,0.0981,0,3,0,2102,603508,33,107923,5.590314572603654,0.15169847813772525
221,0.0983,0,20,0,2122,603488,33,107923,5.590129311941903,0.15170274285890997
222,0.0984,0,5,0,2127,603483,33,107923,5.590082996776465,0.15170380907667352
223,0.0985,2,28,2,2155,603455,35,107921,5.589823631850013,0.15170739524527113
224,0.0986,0,7,0,2162,603448,35,107921,5.5897587906184,0.15170888807355956
225,0.0987,0,8,0,2170,603440,35,107921,5.589684686353699,0.15171059419900726
226,0.0988,2,19,2,2189,603421,37,107919,5.5895086887250365,0.15171226136587285
227,0.0989,1,39,1,2228,603382,38,107918,5.589147430434622,0.1517193870378181
228,0.0992,0,2,0,2230,603380,38,107918,5.5891289043684464,0.15171981363647866
229,0.0993,0,3,0,2233,603377,38,107918,5.589101115269184,0.15172045353896765
230,0.0994,0,2,0,2235,603375,38,107918,5.5890825892030085,0.15172088014362575
231,0.0995,0,1,0,2236,603374,38,107918,5.589073326169921,0.15172109344685444
232,0.0996,0,1,0,2237,603373,38,107918,5.589064063136833,0.1517213067506829
233,0.0997,0,10,0,2247,603363,38,107918,5.588971432805958,0.15172343982195505
234,0.0998,1,10,1,2257,603353,39,107917,5.588878802475082,0.15172438033376917
235,0.1,0,5,0,2262,603348,39,107917,5.588832487309645,0.15172544691500356
236,0.1001,1,8,1,2270,603340,40,107916,5.5887583830449445,0.15172596083547976
237,0.1005,0,3,0,2273,603337,40,107916,5.588730593945682,0.1517266008016838
238,0.1008,0,8,0,2281,603329,40,107916,5.588656489680981,0.15172830740462148
239,0.1009,0,3,0,2284,603326,40,107916,5.588628700581719,0.15172894739062093
240,0.101,0,2,0,2286,603324,40,107916,5.588610174515543,0.15172937405095327
241,0.1011,0,6,0,2292,603318,40,107916,5.588554596317018,0.1517306540463476
242,0.1012,1,0,1,2292,603318,41,107915,5.588554596317018,0.1517294613720117
243,0.1013,1,22,1,2314,603296,42,107914,5.588350809589092,0.1517329621349531
244,0.1014,0,40,0,2354,603256,42,107914,5.58798028826559,0.15174149640732876
245,0.1015,0,17,0,2371,603239,42,107914,5.587822816703102,0.15174512376380328
246,0.1016,1,44,1,2415,603195,43,107913,5.587415243247249,0.15175332017077575
247,0.1017,0,14,0,2429,603181,43,107913,5.587285560784023,0.15175630788615851
248,0.1018,0,1,0,2430,603180,43,107913,5.587276297750935,0.15175652129890183
249,0.1019,0,7,0,2437,603173,43,107913,5.587211456519323,0.15175801520491192
250,0.102,0,18,0,2455,603155,43,107913,5.587044721923747,0.15176185681256926
251,0.1022,0,5,0,2460,603150,43,107913,5.586998406758309,0.1517629239603242
252,0.1023,0,25,0,2485,603125,43,107913,5.58676683093112,0.15176825992422346
253,0.1024,0,7,0,2492,603118,43,107913,5.586701989699507,0.15176975406135598
254,0.1025,0,1,0,2493,603117,43,107913,5.58669272666642,0.15176996751191932
255,0.1026,0,1,0,2494,603116,43,107913,5.5866834636333325,0.1517701809630831
256,0.1027,0,1,0,2495,603115,43,107913,5.586674200600244,0.15177039441484724
257,0.1028,2,27,2,2522,603088,45,107911,5.586424098706881,0.15177377183371565
258,0.1029,1,45,1,2567,603043,46,107910,5.586007262217941,0.1517821853202673
259,0.103,0,1,0,2568,603042,46,107910,5.585997999184853,0.15178239881173414
260,0.1031,0,2,0,2570,603040,46,107910,5.585979473118678,0.1517828257964695
261,0.1032,4,20,4,2590,603020,50,107906,5.585794212456927,0.1517823233360434
262,0.1033,0,2,0,2592,603018,50,107906,5.585775686390752,0.15178275033618222
263,0.1034,1,15,1,2607,603003,51,107905,5.585636740894438,0.1517847597720099
264,0.1035,0,15,0,2622,602988,51,107905,5.585497795398125,0.15178796246411205
265,0.1036,0,1,0,2623,602987,51,107905,5.585488532365037,0.15178817598172437
266,0.1038,1,20,1,2643,602967,52,107904,5.585303271703286,0.1517912532653604
267,0.1039,0,4,0,2647,602963,52,107904,5.585266219570936,0.15179210738436305
268,0.104,0,1,0,2648,602962,52,107904,5.585256956537849,0.1517923209156156
269,0.1041,0,5,0,2653,602957,52,107904,5.585210641372411,0.15179338858088995
270,0.1042,2,22,2,2675,602935,54,107902,5.585006854644485,0.15179569999873388
271,0.1043,0,1,0,2676,602934,54,107902,5.584997591611398,0.15179591354405236
272,0.1044,0,8,0,2684,602926,54,107902,5.584923487346697,0.15179762192823018
273,0.1046,1,8,1,2692,602918,55,107901,5.5848493830819965,0.15179813707849676
274,0.1047,0,7,0,2699,602911,55,107901,5.584784541850383,0.15179963197019747
275,0.1048,0,1,0,2700,602910,55,107901,5.584775278817296,0.1517998455285582
276,0.1049,0,1,0,2701,602909,55,107901,5.584766015784209,0.15180005908751987
277,0.105,0,4,0,2705,602905,55,107901,5.584728963651858,0.1518009133293754
278,0.1051,0,7,0,2712,602898,55,107901,5.584664122420246,0.15180240827575728
279,0.1053,0,6,0,2718,602892,55,107901,5.58460854422172,0.1518036896818061
280,0.1054,0,20,0,2738,602872,55,107901,5.5844232835599685,0.1518079611915478
281,0.1056,0,2,0,2740,602870,55,107901,5.584404757493794,0.15180838835574326
282,0.1058,1,38,1,2778,602832,56,107900,5.584052762236467,0.15181531153796368
283,0.1059,0,29,0,2807,602803,56,107900,5.583784134276928,0.1518215063113565
284,0.106,0,8,0,2815,602795,56,107900,5.583710030012227,0.15182321530332984
285,0.1061,0,9,0,2824,602786,56,107900,5.5836266627144395,0.15182513796528987
286,0.1062,0,4,0,2828,602782,56,107900,5.583589610582089,0.15182599249734763
287,0.1063,1,0,1,2828,602782,57,107899,5.583589610582089,0.15182479903078877
288,0.1064,2,5,2,2833,602777,59,107897,5.583543295416651,0.15182348024551343
289,0.1065,0,1,0,2834,602776,59,107897,5.583534032383564,0.1518236938789007
290,0.1067,0,4,0,2838,602772,59,107897,5.583496980251214,0.15182454841846205
291,0.1068,0,8,0,2846,602764,59,107897,5.583422875986513,0.1518262575264437
292,0.1069,1,28,1,2874,602736,60,107896,5.583163511060062,0.15183104616735527
293,0.1071,2,49,2,2923,602687,62,107894,5.582709622438771,0.1518391288255667
294,0.1072,0,49,0,2972,602638,62,107894,5.582255733817481,0.15184960001801467
295,0.1074,0,7,0,2979,602631,62,107894,5.582190892585868,0.1518510960205482
296,0.1075,0,17,0,2996,602614,62,107894,5.58203342102338,0.15185472929228103
297,0.1076,0,11,0,3007,602603,62,107894,5.581931527659417,0.15185708032546233
298,0.1077,0,8,0,3015,602595,62,107894,5.581857423394716,0.15185879021350085
299,0.1078,2,32,2,3047,602563,64,107892,5.581561006335915,0.15186324256990238
300,0.108,0,8,0,3055,602555,64,107892,5.581486902071214,0.15186495262841562
301,0.1081,0,44,0,3099,602511,64,107892,5.5810793286153615,0.15187435863868817
302,0.1082,0,6,0,3105,602505,64,107892,5.581023750416836,0.15187564136672874
303,0.1083,0,9,0,3114,602496,64,107892,5.5809403831190485,0.15187756549941722
304,0.1084,0,11,0,3125,602485,64,107892,5.580838489755085,0.15187991728335798
305,0.1088,0,5,0,3130,602480,64,107892,5.580792174589647,0.1518809863001357
306,0.1089,0,32,0,3162,602448,64,107892,5.580495757530846,0.1518878283638821
307,0.109,0,2,0,3164,602446,64,107892,5.580477231464671,0.1518882560133345
308,0.1091,0,12,0,3176,602434,64,107892,5.58036607506762,0.1518908219606209
309,0.1092,0,6,0,3182,602428,64,107892,5.580310496869095,0.15189210496677555
310,0.1095,0,1,0,3183,602427,64,107892,5.580301233836007,0.15189231880324192
311,0.1096,0,25,0,3208,602402,64,107892,5.580069658008818,0.15189766491058632
312,0.1097,0,8,0,3216,602394,64,107892,5.579995553744118,0.15189937574441845
313,0.1098,0,4,0,3220,602390,64,107892,5.579958501611768,0.15190023117578652
314,0.1099,0,21,0,3241,602369,64,107892,5.5797639779169295,0.1519047223485451
315,0.11,2,36,2,3277,602333,66,107890,5.579430508725777,0.15191003389076388
316,0.1101,0,47,0,3324,602286,66,107890,5.578995146170662,0.15192008741495067
317,0.1102,0,1,0,3325,602285,66,107890,5.578985883137575,0.1519203013341782
318,0.1103,0,28,0,3353,602257,66,107890,5.578726518211123,0.15192629131714983
319,0.1104,1,35,1,3388,602222,67,107889,5.578402312053059,0.1519325851873862
320,0.1106,0,9,0,3397,602213,67,107889,5.578318944755271,0.1519345108167559
321,0.1107,0,12,0,3409,602201,67,107889,5.57820778835822,0.15193707839851286
322,0.1108,0,2,0,3411,602199,67,107889,5.578189262292045,0.1519375063372427
323,0.1109,0,1,0,3412,602198,67,107889,5.578179999258957,0.15193772030751163
324,0.1111,0,36,0,3448,602162,67,107889,5.577846530067806,0.1519454236385837
325,0.1112,1,2,1,3450,602160,68,107888,5.57782800400163,0.15194465726260759
326,0.1113,0,4,0,3454,602156,68,107888,5.57779095186928,0.15194551323579947
327,0.1114,2,18,2,3472,602138,70,107886,5.577624217273704,0.151946976440233
328,0.1115,0,18,0,3490,602120,70,107886,5.5774574826781285,0.15195082858454717
329,0.1117,0,11,0,3501,602109,70,107886,5.577355589314165,0.15195318276889275
330,0.1118,0,8,0,3509,602101,70,107886,5.577281485049465,0.15195489494878076
331,0.1119,0,12,0,3521,602089,70,107886,5.577170328652414,0.15195746329096094
332,0.112,1,9,1,3530,602080,71,107885,5.577086961354626,0.15195819512229475
333,0.1121,0,6,0,3536,602074,71,107885,5.5770313831561005,0.151959479350216
334,0.1123,0,1,0,3537,602073,71,107885,5.577022120123013,0.15195969339031323
335,0.1124,0,1,0,3538,602072,71,107885,5.577012857089925,0.15195990743101342
336,0.1125,0,3,0,3541,602069,71,107885,5.5769850679906625,0.15196054955673186
337,0.1126,3,56,3,3597,602013,74,107882,5.5764663381377595,0.15196895315504405
338,0.1127,1,4,1,3601,602009,75,107881,5.57642928600541,0.15196861485582272
339,0.1128,0,34,0,3635,601975,75,107881,5.576114342880433,0.1519758937023847
340,0.1129,0,3,0,3638,601972,75,107881,5.57608655378117,0.1519765359870283
341,0.113,1,6,1,3644,601966,76,107880,5.576030975582645,0.15197662591604377
342,0.1131,0,4,0,3648,601962,76,107880,5.575993923450294,0.15197748231296543
343,0.1132,0,1,0,3649,601961,76,107880,5.575984660417207,0.15197769641370393
344,0.1133,0,13,0,3662,601948,76,107880,5.575864240987069,0.15198047977819978
345,0.1134,0,8,0,3670,601940,76,107880,5.575790136722368,0.15198219266856386
346,0.1135,0,2,0,3672,601938,76,107880,5.575771610656194,0.15198262089718773
347,0.1136,3,18,3,3690,601920,79,107877,5.575604876060617,0.15198289088288625
348,0.1138,0,2,0,3692,601918,79,107877,5.575586349994442,0.15198331912735366
349,0.1139,0,33,0,3725,601885,79,107877,5.575280669902553,0.15199038550950883
350,0.114,1,11,1,3736,601874,80,107876,5.57517877653859,0.15199154631912645
351,0.1141,0,20,0,3756,601854,80,107876,5.574993515876839,0.15199582939991263
352,0.1142,0,1,0,3757,601853,80,107876,5.574984252843751,0.1519960435602885
353,0.1143,0,12,0,3769,601841,80,107876,5.574873096446701,0.15199861353187255
354,0.1144,0,15,0,3784,601826,80,107876,5.574734150950388,0.15200182611856808
355,0.1145,0,11,0,3795,601815,80,107876,5.5746322575864244,0.15200418210178795
356,0.1146,0,7,0,3802,601808,80,107876,5.574567416354811,0.15200568140186335
357,0.1147,0,1,0,3803,601807,80,107876,5.574558153321724,0.15200589559000285
358,0.1148,0,18,0,3821,601789,80,107876,5.574391418726147,0.1520097510797348
359,0.115,0,1,0,3822,601788,80,107876,5.57438215569306,0.15200996527934346
360,0.1151,0,6,0,3828,601782,80,107876,5.574326577494535,0.15201125048967248
361,0.1153,0,15,0,3843,601767,80,107876,5.574187631998221,0.15201446361057602
362,0.1155,0,21,0,3864,601746,80,107876,5.573993108303383,0.15201896220804878
363,0.1156,0,23,0,3887,601723,80,107876,5.573780058542369,0.15202388954888607
364,0.1157,0,1,0,3888,601722,80,107876,5.573770795509281,0.15202410378834214
365,0.1158,2,7,2,3895,601715,82,107874,5.573705954277669,0.15202321343763783
366,0.1159,0,7,0,3902,601708,82,107874,5.5736411130460555,0.15202471314097596
367,0.116,0,1,0,3903,601707,82,107874,5.573631850012968,0.1520249273867254
368,0.1161,0,4,0,3907,601703,82,107874,5.573594797880618,0.1520257843757619
369,0.1162,0,7,0,3914,601696,82,107874,5.573529956649005,0.1520272841298251
370,0.1163,0,3,0,3917,601693,82,107874,5.5735021675497425,0.15202792689062486
371,0.1164,0,4,0,3921,601689,82,107874,5.573465115417393,0.15202878391347915
372,0.1165,0,1,0,3922,601688,82,107874,5.5734558523843045,0.15202899817070248
373,0.1166,0,4,0,3926,601684,82,107874,5.573418800251955,0.15202985520563506
374,0.1167,0,1,0,3927,601683,82,107874,5.573409537218867,0.152030069465878
375,0.1168,2,26,2,3953,601657,84,107872,5.57316869835859,0.15203325022655875
376,0.1169,0,3,0,3956,601654,84,107872,5.573140909259328,0.15203389304972614
377,0.1171,0,44,0,4000,601610,84,107872,5.572733335803475,0.15204332174741572
378,0.1172,0,5,0,4005,601605,84,107872,5.572687020638038,0.15204439326433414
379,0.1174,0,4,0,4009,601601,84,107872,5.572649968505687,0.15204525048874307
380,0.1175,0,14,0,4023,601587,84,107872,5.572520286042462,0.1520482508502958
381,0.1176,0,17,0,4040,601570,84,107872,5.572362814479973,0.15205189430566557
382,0.1178,1,15,1,4055,601555,85,107871,5.57222386898366,0.15205391400935403
383,0.1179,0,16,0,4071,601539,85,107871,5.572075660454259,0.15205734342622743
384,0.118,0,5,0,4076,601534,85,107871,5.572029345288821,0.1520584151507249
385,0.1181,0,8,0,4084,601526,85,107871,5.571955241024121,0.15206012994134455
386,0.1182,0,1,0,4085,601525,85,107871,5.571945977991033,0.15206034429289142
387,0.1183,0,6,0,4091,601519,85,107871,5.571890399792508,0.15206163041486348
388,0.1184,0,5,0,4096,601514,85,107871,5.57184408462707,0.1520627021997928
389,0.1185,0,1,0,4097,601513,85,107871,5.571834821593983,0.1520629165585917
390,0.1186,1,28,1,4125,601485,86,107870,5.5715754566675315,0.15206772349528797
391,0.1187,1,19,1,4144,601466,87,107869,5.571399459038868,0.15207060133787278
392,0.1188,0,2,0,4146,601464,87,107869,5.571380932972692,0.1520710301085668
393,0.1189,0,43,0,4189,601421,87,107869,5.570982622549928,0.15208024926334784
394,0.119,0,6,0,4195,601415,87,107869,5.570927044351403,0.15208153574590713
395,0.1191,0,15,0,4210,601400,87,107869,5.570788098855089,0.15208475204753064
396,0.1192,0,3,0,4213,601397,87,107869,5.570760309755826,0.15208539532418022
397,0.1193,0,30,0,4243,601367,87,107869,5.570482418763199,0.15209182838998583
398,0.1194,1,10,1,4253,601357,88,107868,5.570389788432324,0.15209277732736437
399,0.1195,0,4,0,4257,601353,88,107868,5.570352736299974,0.15209363512924745
400,0.1196,0,7,0,4264,601346,88,107868,5.570287895068361,0.15209513630582588
401,0.1197,1,6,1,4270,601340,89,107867,5.570232316869836,0.15209522748647433
402,0.1199,1,11,1,4281,601329,90,107866,5.570130423505873,0.1520963909785038
403,0.1201,0,4,0,4285,601325,90,107866,5.570093371373522,0.1520972488370552
404,0.1204,1,9,1,4294,601316,91,107865,5.570010004075734,0.15209798344851314
405,0.1205,1,10,1,4304,601306,92,107864,5.569917373744859,0.15209893255495863
406,0.1206,2,25,2,4329,601281,94,107862,5.56968579791767,0.15210190328325882
407,0.1208,0,5,0,4334,601276,94,107862,5.569639482752232,0.15210297572545822
408,0.1209,0,2,0,4336,601274,94,107862,5.569620956686057,0.1521034047065725
409,0.121,0,12,0,4348,601262,94,107862,5.569509800289007,0.15210597864407352
410,0.1211,0,3,0,4351,601259,94,107862,5.569482011189744,0.1521066221420604
411,0.1212,0,3,0,4354,601256,94,107862,5.5694542220904815,0.152107265645492
412,0.1213,0,4,0,4358,601252,94,107862,5.569417169958131,0.15210812365853726
413,0.1214,0,38,0,4396,601214,94,107862,5.569065174700804,0.1521162752652748
414,0.1215,0,9,0,4405,601205,94,107862,5.568981807403016,0.15211820603694715
415,0.1216,0,1,0,4406,601204,94,107862,5.568972544369928,0.15211842057015848
416,0.1217,1,28,1,4434,601176,95,107861,5.568713179443477,0.15212323193288926
417,0.1218,0,3,0,4437,601173,95,107861,5.568685390344214,0.15212387558283524
418,0.1219,0,3,0,4440,601170,95,107861,5.568657601244952,0.15212451923822795
419,0.122,3,48,3,4488,601122,98,107858,5.568212975656749,0.15213123078225055
420,0.1221,0,1,0,4489,601121,98,107858,5.568203712623662,0.15213144536015877
421,0.1223,1,6,1,4495,601115,99,107857,5.568148134425136,0.15213153692952613
422,0.1224,1,7,1,4502,601108,100,107856,5.568083293193523,0.1521318430837109
423,0.1225,0,10,0,4512,601098,100,107856,5.567990662862647,0.1521339889470967
424,0.1228,0,6,0,4518,601092,100,107856,5.567935084664122,0.15213527649418576
425,0.1229,2,12,2,4530,601080,102,107854,5.567823928267072,0.1521354597183941
426,0.123,0,2,0,4532,601078,102,107854,5.5678054022008965,0.15213588891459265
427,0.1231,0,61,0,4593,601017,102,107854,5.5672403571825555,0.15214898056204867
428,0.1232,0,1,0,4594,601016,102,107854,5.567231094149468,0.15214919519799117
429,0.1233,0,1,0,4595,601015,102,107854,5.567221831116381,0.15214940983453926
430,0.1234,0,2,0,4597,601013,102,107854,5.567203305050206,0.15214983910945212
431,0.1235,0,1,0,4598,601012,102,107854,5.567194042017118,0.15215005374781693
432,0.1236,1,34,1,4632,600978,103,107853,5.566879098892141,0.152156155698608
433,0.1237,1,27,1,4659,600951,104,107852,5.5666289969987774,0.15216075552727626
434,0.1238,0,3,0,4662,600948,104,107852,5.566601207899515,0.15216139954853272
435,0.1239,0,18,0,4680,600930,104,107852,5.566434473303938,0.152165263790559
436,0.124,0,3,0,4683,600927,104,107852,5.566406684204676,0.15216590784997863
437,0.1241,0,1,0,4684,600926,104,107852,5.5663974211715885,0.15216612253766343
438,0.1242,6,104,6,4788,600822,110,107846,5.565434065730483,0.15218127529393172
439,0.1243,1,29,1,4817,600793,111,107845,5.565165437770943,0.1521863066897344
440,0.1244,0,3,0,4820,600790,111,107845,5.565137648671681,0.1521869509691167
441,0.1245,1,34,1,4854,600756,112,107844,5.564822705546704,0.1521930567315834
442,0.1246,0,1,0,4855,600755,112,107844,5.564813442513617,0.15219327151181417
443,0.1247,0,1,0,4856,600754,112,107844,5.564804179480529,0.15219348629265111
444,0.1248,0,1,0,4857,600753,112,107844,5.5647949164474415,0.1521937010740943
445,0.1249,0,24,0,4881,600729,112,107844,5.56457260365334,0.1521988560106016
446,0.1251,0,17,0,4898,600712,112,107844,5.5644151320908515,0.1522025076352469
447,0.1252,0,6,0,4904,600706,112,107844,5.564359553892326,0.1522037964857808
448,0.1253,0,3,0,4907,600703,112,107844,5.564331764793064,0.1522044409192333
449,0.1254,0,48,0,4955,600655,112,107844,5.563887139204861,0.1522147525966868
450,0.1255,0,3,0,4958,600652,112,107844,5.563859350105599,0.15221539712291954
451,0.1256,0,2,0,4960,600650,112,107844,5.563840824039423,0.15221582681010706
452,0.1257,0,11,0,4971,600639,112,107844,5.56373893067546,0.15221819013300247
453,0.1258,1,3,1,4974,600636,113,107843,5.5637111415761975,0.15221763806690106
454,0.1259,1,8,1,4982,600628,114,107842,5.563637037311497,0.15221816026084378
455,0.126,0,23,0,5005,600605,114,107842,5.563423987550483,0.15222310208103076
456,0.1262,0,2,0,5007,600603,114,107842,5.563405461484308,0.1522235318196896
457,0.1263,2,33,2,5040,600570,116,107840,5.5630997813924195,0.15222822941516917
458,0.1264,0,4,0,5044,600566,116,107840,5.563062729260069,0.1522290889687552
459,0.1265,0,6,0,5050,600560,116,107840,5.5630071510615435,0.15223037831733485
460,0.1266,0,6,0,5056,600554,116,107840,5.562951572863018,0.15223166768775567
461,0.1267,0,15,0,5071,600539,116,107840,5.562812627366705,0.15223489120936673
462,0.1268,0,1,0,5072,600538,116,107840,5.562803364333617,0.1522351061156614
463,0.1269,0,15,0,5087,600523,116,107840,5.562664418837304,0.1522383297828938
464,0.127,1,5,1,5092,600518,117,107839,5.562618103671866,0.15223820757047646
465,0.1271,0,10,0,5102,600508,117,107839,5.56252547334099,0.15224035677429282
466,0.1272,0,1,0,5103,600507,117,107839,5.562516210307903,0.152240571698012
467,0.1273,3,33,3,5136,600474,120,107836,5.562210530216014,0.15224407392243508
468,0.1274,3,10,3,5146,600464,123,107833,5.562117899885139,0.1522426326809234
469,0.1275,0,8,0,5154,600456,123,107833,5.562043795620438,0.15224435223475163
470,0.1276,2,30,2,5184,600426,125,107831,5.561765904627811,0.15224840700480194
471,0.1277,0,2,0,5186,600424,125,107831,5.561747378561636,0.1522488369302017
472,0.128,0,6,0,5192,600418,125,107831,5.561691800363111,0.1522501267209696
473,0.1281,1,13,1,5205,600405,126,107830,5.561571380932973,0.15225172435702838
474,0.1282,0,4,0,5209,600401,126,107830,5.561534328800622,0.15225258425570187
475,0.1283,0,34,0,5243,600367,126,107830,5.5612193856756456,0.15225989378661586
476,0.1284,0,4,0,5247,600363,126,107830,5.561182333543296,0.15226075377757192
477,0.1285,0,7,0,5254,600356,126,107830,5.561117492311682,0.15226225878512142
478,0.1286,0,5,0,5259,600351,126,107830,5.561071177146244,0.1522633338087297
479,0.1287,1,42,1,5301,600309,127,107829,5.560682129756567,0.15227116748430392
480,0.1288,5,103,5,5404,600206,132,107824,5.55972803734855,0.1522873324576642
481,0.1289,5,72,5,5476,600134,137,107819,5.559061098966246,0.1522968332643551
482,0.1291,0,10,0,5486,600124,137,107819,5.55896846863537,0.15229898452276525
483,0.1292,0,6,0,5492,600118,137,107819,5.558912890436845,0.15230027530698353
484,0.1293,5,116,5,5608,600002,142,107814,5.557838378598689,0.1523192468099054
485,0.1294,0,11,0,5619,599991,142,107814,5.5577364852347255,0.152321614003857
486,0.1295,0,20,0,5639,599971,142,107814,5.557551224572975,0.15232591818136865
487,0.1296,3,47,3,5686,599924,145,107811,5.557115862017859,0.15233244081471173
488,0.1298,0,3,0,5689,599921,145,107811,5.557088072918597,0.15233308653558125
489,0.1299,0,1,0,5690,599920,145,107811,5.557078809885509,0.15233330177708762
490,0.13,0,2,0,5692,599918,145,107811,5.557060283819334,0.15233373226192512
491,0.1301,0,20,0,5712,599898,145,107811,5.556875023157582,0.15233803724412154
492,0.1302,0,9,0,5721,599889,145,107811,5.5567916558597945,0.15233997456549386
493,0.1303,0,6,0,5727,599883,145,107811,5.556736077661269,0.15234126614045054
494,0.1304,0,18,0,5745,599865,145,107811,5.556569343065694,0.15234514099672733
495,0.1305,0,24,0,5769,599841,145,107811,5.556347030271592,0.15235030777839956
496,0.1306,0,60,0,5829,599781,145,107811,5.555791248286339,0.15236322626598378
497,0.1307,0,1,0,5830,599780,145,107811,5.555781985253251,0.15236344159267148
498,0.1308,0,6,0,5836,599774,145,107811,5.555726407054726,0.1523647335655787
499,0.1309,0,11,0,5847,599763,145,107811,5.555624513690763,0.15236710223948308
500,0.131,0,9,0,5856,599754,145,107811,5.555541146392975,0.15236904030018444
501,0.1311,0,6,0,5862,599748,145,107811,5.55548556819445,0.15237033236804282
502,0.1312,2,5,2,5867,599743,147,107809,5.555439253029012,0.15236901316087015
503,0.1313,0,2,0,5869,599741,147,107809,5.555420726962836,0.15236944385555792
504,0.1314,1,33,1,5902,599708,148,107808,5.555115046870948,0.15237535264220173
505,0.1315,0,11,0,5913,599697,148,107808,5.555013153506985,0.15237772171221406
506,0.1316,0,10,0,5923,599687,148,107808,5.554920523176109,0.15237987547615178
507,0.1317,4,86,4,6009,599601,152,107804,5.554123902330579,0.1523936076222249
508,0.1318,1,1,1,6010,599600,153,107803,5.554114639297492,0.1523926248545737
509,0.1319,2,20,2,6030,599580,155,107801,5.553929378635741,0.15239453703167036
510,0.132,0,6,0,6036,599574,155,107801,5.5538738004372155,0.15239582965188195
511,0.1321,0,19,0,6055,599555,155,107801,5.553697802808552,0.15239992309388767
512,0.1322,0,7,0,6062,599548,155,107801,5.553632961576938,0.15240143125953384
513,0.1323,0,9,0,6071,599539,155,107801,5.553549594279151,0.15240337037351204
514,0.1324,0,9,0,6080,599530,155,107801,5.553466226981363,0.15240530953683637
515,0.1325,1,9,1,6089,599521,156,107800,5.553382859683575,0.15240605043537517
516,0.1326,3,80,3,6169,599441,159,107797,5.55264181703657,0.1524196946431046
517,0.1327,0,10,0,6179,599431,159,107797,5.552549186705695,0.1524218498136386
518,0.1329,0,46,0,6225,599385,159,107797,5.552123087183667,0.15243176438314324
519,0.133,0,12,0,6237,599373,159,107797,5.552011930786617,0.15243435100470892
520,0.1331,0,7,0,6244,599366,159,107797,5.551947089555004,0.15243585990782887
521,0.1333,0,3,0,6247,599363,159,107797,5.551919300455741,0.15243650658973923
522,0.1334,0,17,0,6264,599346,159,107797,5.551761828893253,0.15244017122420783
523,0.1335,0,2,0,6266,599344,159,107797,5.551743302827077,0.15244060236925874
524,0.1336,0,4,0,6270,599340,159,107797,5.5517062506947275,0.15244146466667705
525,0.1337,1,4,1,6274,599336,160,107796,5.551669198562378,0.15244112838904195
526,0.1338,0,3,0,6277,599333,160,107796,5.551641409463115,0.1524417751216539
527,0.1339,0,7,0,6284,599326,160,107796,5.551576568231502,0.15244328418575578
528,0.134,0,16,0,6300,599310,160,107796,5.551428359702101,0.15244673358732638
529,0.1341,0,4,0,6304,599306,160,107796,5.551391307569751,0.15244759596211013
530,0.1342,0,2,0,6306,599304,160,107796,5.551372781503575,0.1524480271531608
531,0.1343,0,6,0,6312,599298,160,107796,5.55131720330505,0.15244932074094816
532,0.1344,0,10,0,6322,599288,160,107796,5.551224572974174,0.1524514767693796
533,0.1345,1,7,1,6329,599281,161,107795,5.551159731742562,0.15245178736090603
534,0.1346,0,8,0,6337,599273,161,107795,5.551085627477861,0.15245351225058976
535,0.1347,5,81,5,6418,599192,166,107790,5.550335321797769,0.1524649849642565
536,0.1348,0,4,0,6422,599188,166,107790,5.5502982696654195,0.1524658475935602
537,0.1349,2,6,2,6428,599182,168,107788,5.550242691466894,0.1524647439070965
538,0.135,0,15,0,6443,599167,168,107788,5.55010374597058,0.1524679788671132
539,0.1351,2,46,2,6489,599121,170,107786,5.549677646448553,0.15247550243525668
540,0.1352,2,51,2,6540,599070,172,107784,5.549205231761088,0.15248410562860223
541,0.1353,0,7,0,6547,599063,172,107784,5.549140390529475,0.15248561569901264
542,0.1355,0,1,0,6548,599062,172,107784,5.549131127496388,0.15248583142579855
543,0.1356,0,5,0,6553,599057,172,107784,5.54908481233095,0.15248691006888396
544,0.1357,0,4,0,6557,599053,172,107784,5.549047760198599,0.15248777299433958
545,0.1358,3,88,3,6645,598965,175,107781,5.548232613286895,0.15250316238082706
546,0.1359,0,26,0,6671,598939,175,107781,5.5479917744266185,0.15250877292279827
547,0.136,2,29,2,6700,598910,177,107779,5.547723146467079,0.15251263285547106
548,0.1361,0,39,0,6739,598871,177,107779,5.547361888176664,0.15252105002476474
549,0.1362,1,17,1,6756,598854,178,107778,5.547204416614176,0.1525235200217369
550,0.1363,1,39,1,6795,598815,179,107777,5.546843158323761,0.1525307390969612
551,0.1364,1,10,1,6805,598805,180,107776,5.546750527992886,0.1525316984181573
552,0.1365,6,109,6,6914,598696,186,107770,5.545740857386343,0.15254803486650453
553,0.1366,0,4,0,6918,598692,186,107770,5.545703805253992,0.15254889859610282
554,0.1367,2,11,2,6929,598681,188,107768,5.54560191189003,0.15254887472414852
555,0.1368,0,7,0,6936,598674,188,107768,5.545537070658416,0.1525503863020602
556,0.1369,0,18,0,6954,598656,188,107768,5.545370336062841,0.15255427335424618
557,0.137,0,17,0,6971,598639,188,107768,5.545212864500352,0.15255794464097894
558,0.1371,2,53,2,7024,598586,190,107766,5.544721923746712,0.15256699209459307
559,0.1372,1,17,1,7041,598569,191,107765,5.544564452184223,0.15256946430442256
560,0.1373,0,6,0,7047,598563,191,107765,5.544508873985698,0.1525707603266471
561,0.1374,6,155,6,7202,598408,197,107759,5.543073103857127,0.15259704857349607
562,0.1375,1,22,1,7224,598386,198,107758,5.542869317129201,0.15260060270992884
563,0.1376,0,14,0,7238,598372,198,107758,5.542739634665975,0.152603628227097
564,0.1378,0,10,0,7248,598362,198,107758,5.542647004335099,0.15260578938424063
565,0.1379,0,6,0,7254,598356,198,107758,5.542591426136574,0.15260708610790893
566,0.138,1,52,1,7306,598304,199,107757,5.5421097484160216,0.15261712514924347
567,0.1381,0,14,0,7320,598290,199,107757,5.541980065952796,0.15262015134969767
568,0.1382,1,37,1,7357,598253,200,107756,5.5416373337285565,0.15262694951480787
569,0.1383,2,6,2,7363,598247,202,107754,5.54158175553003,0.15262584613902813
570,0.1384,0,14,0,7377,598233,202,107754,5.541452073066805,0.1526288727696119
571,0.1385,0,3,0,7380,598230,202,107754,5.541424283967542,0.15262952134892577
572,0.1386,1,4,1,7384,598226,203,107753,5.541387231835192,0.15262918585397017
573,0.1387,0,29,0,7413,598197,203,107753,5.5411186038756535,0.15263545576882215
574,0.1388,0,28,0,7441,598169,203,107753,5.540859238949202,0.15264150996852344
575,0.1389,1,59,1,7500,598110,204,107752,5.5403127199970355,0.15265306816346538
576,0.139,0,10,0,7510,598100,204,107752,5.54022008966616,0.15265523084159285
577,0.1391,0,3,0,7513,598097,204,107752,5.540192300566898,0.15265587965698046
578,0.1392,0,16,0,7529,598081,204,107752,5.540044092037497,0.15265934009886192
579,0.1393,0,7,0,7536,598074,204,107752,5.539979250805884,0.1526608540915183
580,0.1394,1,22,1,7558,598052,205,107751,5.539775464077958,0.1526644120243184
581,0.1395,0,2,0,7560,598050,205,107751,5.539756938011783,0.15266484462334284
582,0.1396,0,9,0,7569,598041,205,107751,5.539673570713995,0.1526667913492927
583,0.1397,0,6,0,7575,598035,205,107751,5.53961799251547,0.15266808919417502
584,0.1398,1,10,1,7585,598025,206,107750,5.539525362184594,0.15266905175162057
585,0.1399,2,20,2,7605,598005,208,107748,5.539340101522843,0.1526709769565273
586,0.14,0,11,0,7616,597994,208,107748,5.53923820815888,0.1526733565523945
587,0.1401,1,46,1,7662,597948,209,107747,5.5388121086368525,0.1526821077094212
588,0.1402,0,37,0,7699,597911,209,107747,5.538469376412612,0.15269011334102356
589,0.1403,1,6,1,7705,597905,210,107746,5.538413798214087,0.15269021088328366
590,0.1404,1,8,1,7713,597897,211,107745,5.5383396939493865,0.15269074119737772
591,0.1406,0,1,0,7714,597896,211,107745,5.538330430916299,0.152690957583247
592,0.1407,0,4,0,7718,597892,211,107745,5.5382933787839494,0.15269182313285726
593,0.1409,2,11,2,7729,597881,213,107743,5.538191485419986,0.15269180186614967
594,0.141,1,3,1,7732,597878,214,107742,5.538163696320724,0.15269125024800884
595,0.1411,0,5,0,7737,597873,214,107742,5.538117381155286,0.15269233222082865
596,0.1412,0,6,0,7743,597867,214,107742,5.5380618029567605,0.15269363060845312
597,0.1413,5,98,5,7841,597769,219,107737,5.53715402571418,0.15270883592768877
598,0.1414,0,6,0,7847,597763,219,107737,5.537098447515654,0.15271013465627215
599,0.1415,0,3,0,7850,597760,219,107737,5.537070658416392,0.15271078402884775
600,0.1416,0,11,0,7861,597749,219,107737,5.536968765052428,0.1527131651088753
601,0.1417,0,6,0,7867,597743,219,107737,5.536913186853903,0.152714463911096
602,0.1418,0,9,0,7876,597734,219,107737,5.536829819556115,0.1527164121558505
603,0.1419,0,3,0,7879,597731,219,107737,5.536802030456853,0.1527170615818152
604,0.142,3,14,3,7893,597717,222,107734,5.536672347993627,0.15271648916792235
605,0.1421,0,2,0,7895,597715,222,107734,5.536653821927452,0.15271692213044458
606,0.1422,1,33,1,7928,597682,223,107733,5.536348141835562,0.15272286526371
607,0.1423,0,4,0,7932,597678,223,107733,5.536311089703212,0.15272373127155658
608,0.1424,0,2,0,7934,597676,223,107733,5.536292563637037,0.15272416427916286
609,0.1425,1,2,1,7936,597674,224,107732,5.536274037570863,0.15272339617184996
610,0.1426,1,78,1,8014,597596,225,107731,5.535551520990033,0.1527390841411147
611,0.1427,0,5,0,8019,597591,225,107731,5.535505205824595,0.15274016690249276
612,0.1428,1,26,1,8045,597565,226,107730,5.535264366964319,0.15274459623278203
613,0.1429,1,70,1,8115,597495,227,107729,5.53461595464819,0.15275855614669948
614,0.143,1,18,1,8133,597477,228,107728,5.534449220052614,0.15276125381981126
615,0.1431,0,11,0,8144,597466,228,107728,5.534347326688651,0.15276363667302897
616,0.1433,6,91,6,8235,597375,234,107722,5.533504390677684,0.15277614285694024
617,0.1434,1,27,1,8262,597348,235,107721,5.5332542887843195,0.15278079166719852
618,0.1435,1,19,1,8281,597329,236,107720,5.533078291155656,0.15278370723169596
619,0.1436,4,86,4,8367,597243,240,107716,5.532281670310127,0.15279753858025785
620,0.1437,0,3,0,8370,597240,240,107716,5.532253881210863,0.15279818882313223
621,0.1438,3,21,3,8391,597219,243,107713,5.532059357516025,0.15279913523573904
622,0.1439,0,17,0,8408,597202,243,107713,5.531901885953537,0.15280282019817992
623,0.144,0,6,0,8414,597196,243,107713,5.5318463077550115,0.15280412081559464
624,0.1441,4,79,4,8493,597117,247,107709,5.531114528141095,0.15281643980216394
625,0.1442,0,62,0,8555,597055,247,107709,5.530540220089666,0.15282988347872478
626,0.1443,0,21,0,8576,597034,247,107709,5.530345696394828,0.15283443751835776
627,0.1444,1,25,1,8601,597009,248,107708,5.530114120567639,0.15283865721984854
628,0.1445,0,8,0,8609,597001,248,107708,5.530040016302938,0.15284039227539312
629,0.1446,0,1,0,8610,597000,248,107708,5.530030753269851,0.15284060916010603
630,0.1447,1,9,1,8619,596991,249,107707,5.529947385972062,0.15284135899349793
631,0.1448,0,7,0,8626,596984,249,107707,5.52988254474045,0.1528428772327162
632,0.1449,1,27,1,8653,596957,250,107706,5.5296324428470855,0.15284753137315285
633,0.145,1,30,1,8683,596927,251,107705,5.52935455185446,0.1528528366580002
634,0.1451,0,24,0,8707,596903,251,107705,5.529132239060358,0.15285804305372633
635,0.1452,2,27,2,8734,596876,253,107703,5.528882137166994,0.15286149601393173
636,0.1453,0,10,0,8744,596866,253,107703,5.528789506836119,0.15286366558846615
637,0.1454,0,5,0,8749,596861,253,107703,5.528743191670681,0.15286475039882821
638,0.1455,1,66,1,8815,596795,254,107702,5.528131831486902,0.15287786889085403
639,0.1456,0,1,0,8816,596794,254,107702,5.5281225684538144,0.1528780858940292
640,0.1457,1,7,1,8823,596787,255,107701,5.528057727222202,0.15287840247101442
641,0.1458,0,1,0,8824,596786,255,107701,5.528048464189114,0.15287861947771925
642,0.1459,1,2,1,8826,596784,256,107700,5.528029938122939,0.15287785102287632
643,0.146,2,34,2,8860,596750,258,107698,5.527714994997962,0.15288282456618515
644,0.1461,0,3,0,8863,596747,258,107698,5.527687205898699,0.15288347564394666
645,0.1462,0,2,0,8865,596745,258,107698,5.527668679832525,0.15288390969886848
646,0.1463,0,1,0,8866,596744,258,107698,5.527659416799437,0.15288412672725363
647,0.1464,0,20,0,8886,596724,258,107698,5.527474156137686,0.1528884674243564
648,0.1465,0,83,0,8969,596641,258,107698,5.526705324391418,0.15290648395161988
649,0.1466,0,13,0,8982,596628,258,107698,5.526584904961281,0.1529093062019576
650,0.1467,1,34,1,9016,596594,259,107697,5.526269961836304,0.15291548521846793
651,0.1468,1,12,1,9028,596582,260,107696,5.526158805439253,0.1529168879334581
652,0.1469,1,15,1,9043,596567,261,107695,5.52601985994294,0.1529189420982532
653,0.147,2,26,2,9069,596541,263,107693,5.525779021082664,0.15292218211560363
654,0.1471,0,4,0,9073,596537,263,107693,5.525741968950313,0.15292305070786533
655,0.1473,1,9,1,9082,596528,264,107692,5.525658601652525,0.15292380222089688
656,0.1474,0,14,0,9096,596514,264,107692,5.525528919189299,0.15292684242962998
657,0.1475,1,32,1,9128,596482,265,107691,5.525232502130498,0.1529325890086669
658,0.1476,0,29,0,9157,596453,265,107691,5.524963874170958,0.15293888750028403
659,0.1477,2,59,2,9216,596394,267,107689,5.524417355218793,0.15294929717093014
660,0.1478,0,10,0,9226,596384,267,107689,5.524324724887918,0.15295146952091615
661,0.1479,0,4,0,9230,596380,267,107689,5.524287672755567,0.15295233847818893
662,0.148,1,5,1,9235,596375,268,107688,5.524241357590129,0.15295222160516886
663,0.1481,0,12,0,9247,596363,268,107688,5.524130201193079,0.152954828556454
664,0.1482,0,9,0,9256,596354,268,107688,5.524046833895291,0.15295678382823752
665,0.1483,0,6,0,9262,596348,268,107688,5.523991255696766,0.15295808737053218
666,0.1484,0,2,0,9264,596346,268,107688,5.52397272963059,0.15295852188956782
667,0.1485,0,4,0,9268,596342,268,107688,5.52393567749824,0.15295939093504538
668,0.1486,0,5,0,9273,596337,268,107688,5.5238893623328025,0.15296047725577927
669,0.1487,0,9,0,9282,596328,268,107688,5.523805995035015,0.15296243267198473
670,0.1488,0,11,0,9293,596317,268,107688,5.5237041016710515,0.15296482269302064
671,0.1489,0,14,0,9307,596303,268,107688,5.523574419207826,0.1529678646459969
672,0.149,0,5,0,9312,596298,268,107688,5.523528104042388,0.1529689510870955
673,0.1491,0,2,0,9314,596296,268,107688,5.5235095779762124,0.1529693856678561
674,0.1492,0,9,0,9323,596287,268,107688,5.523426210678425,0.15297134131183635
675,0.1493,0,4,0,9327,596283,268,107688,5.523389158546074,0.15297221050298948
676,0.1494,2,7,2,9334,596276,270,107686,5.5233243173144615,0.15297132515675563
677,0.1495,4,18,4,9352,596258,274,107682,5.523157582718886,0.15297042361564905
678,0.1496,0,3,0,9355,596255,274,107682,5.523129793619622,0.1529710755365892
679,0.1497,1,9,1,9364,596246,275,107681,5.523046426321835,0.1529718280446694
680,0.1498,0,8,0,9372,596238,275,107681,5.522972322057134,0.15297356656092534
681,0.1499,0,5,0,9377,596233,275,107681,5.522926006891697,0.1529746531536523
682,0.15,1,2,1,9379,596231,276,107680,5.522907480825522,0.15297388448255533
683,0.1501,0,10,0,9389,596221,276,107680,5.522814850494646,0.1529760577126613
684,0.1502,0,3,0,9392,596218,276,107680,5.522787061395383,0.15297670969373403
685,0.1503,2,7,2,9399,596211,278,107678,5.522722220163771,0.15297582431320847
686,0.1504,0,10,0,9409,596201,278,107678,5.522629589832895,0.1529779976387987
687,0.1505,2,14,2,9423,596187,280,107676,5.522499907369669,0.152978633626146
688,0.1506,1,59,1,9482,596128,281,107675,5.521953388417503,0.15299025437515895
689,0.1507,1,13,1,9495,596115,282,107674,5.521832968987365,0.15299187682671936
690,0.1508,0,8,0,9503,596107,282,107674,5.521758864722665,0.152993615911768
691,0.1509,0,1,0,9504,596106,282,107674,5.521749601689577,0.15299383330017904
692,0.151,0,15,0,9519,596091,282,107674,5.521610656193264,0.15299709420047886
693,0.1511,0,7,0,9526,596084,282,107674,5.521545814961651,0.15299861600152326
694,0.1512,0,8,0,9534,596076,282,107674,5.52147171069695,0.15300035523978686
695,0.1513,0,3,0,9537,596073,282,107674,5.521443921597688,0.1530010074643302
696,0.1514,0,25,0,9562,596048,282,107674,5.521212345770499,0.15300644288511656
697,0.1515,1,14,1,9576,596034,283,107673,5.521082663307273,0.15300828327698887
698,0.1516,5,109,5,9685,595925,288,107668,5.5200729927007295,0.15302596813782968
699,0.1517,0,7,0,9692,595918,288,107668,5.520008151469117,0.15302749059816426
700,0.1518,1,69,1,9761,595849,289,107667,5.5193690021860755,0.15304129543606684
701,0.1519,0,10,0,9771,595839,289,107667,5.5192763718552005,0.15304347084459835
702,0.152,1,12,1,9783,595827,290,107666,5.519165215458149,0.15304487748989684
703,0.1521,2,5,2,9788,595822,292,107664,5.519118900292712,0.15304355737001163
704,0.1522,7,149,7,9937,595673,299,107657,5.517738708362666,0.15306755008317574
705,0.1523,1,12,1,9949,595661,300,107656,5.5176275519656155,0.1530689575255539
706,0.1524,0,11,0,9960,595650,300,107656,5.517525658601652,0.1530713515880712
707,0.1525,1,12,1,9972,595638,301,107655,5.517414502204602,0.1530727591487474
708,0.1526,1,12,1,9984,595626,302,107654,5.5173033458075516,0.15307416676146057
709,0.1527,1,8,1,9992,595618,303,107653,5.517229241542851,0.1530747037770646
710,0.1528,0,12,0,10004,595606,303,107653,5.5171180851458,0.15307731575422426
711,0.1529,1,1,1,10005,595605,304,107652,5.5171088221127125,0.1530763291371433
712,0.153,1,25,1,10030,595580,305,107651,5.516877246285524,0.15308056669856704
713,0.1531,0,11,0,10041,595569,305,107651,5.51677535292156,0.15308296123545975
714,0.1532,0,11,0,10052,595558,305,107651,5.516673459557597,0.1530853558472659
715,0.1533,0,4,0,10056,595554,305,107651,5.516636407425247,0.15308622663376967
716,0.1534,0,2,0,10058,595552,305,107651,5.516617881359072,0.1530866620307365
717,0.1535,0,10,0,10068,595542,305,107651,5.516525251028197,0.15308883905272094
718,0.1537,2,54,2,10122,595488,307,107649,5.5160250472414685,0.1530981871242731
719,0.1538,0,20,0,10142,595468,307,107649,5.5158397865797175,0.1531025419666997
720,0.1539,0,5,0,10147,595463,307,107649,5.51579347141428,0.1531036307160168
721,0.154,1,27,1,10174,595436,308,107648,5.515543369520916,0.15310830569320308
722,0.1541,1,21,1,10195,595415,309,107647,5.515348845826077,0.15311167436157835
723,0.1542,2,22,2,10217,595393,311,107645,5.515145059098151,0.1531140564236926
724,0.1543,2,66,2,10283,595327,313,107643,5.514533698914373,0.1531260224476151
725,0.1544,0,1,0,10284,595326,313,107643,5.514524435881285,0.1531262402751757
726,0.1545,0,33,0,10317,595293,313,107643,5.514218755789396,0.15313342893236367
727,0.1546,1,5,1,10322,595288,314,107642,5.514172440623958,0.15313331341669867
728,0.1547,0,12,0,10334,595276,314,107642,5.514061284226908,0.15313592766154802
729,0.1548,0,26,0,10360,595250,314,107642,5.513820445366631,0.15314159216494141
730,0.1549,4,76,4,10436,595174,318,107638,5.513116454851977,0.1531533326124198
731,0.155,0,1,0,10437,595173,318,107638,5.513107191818889,0.15315355052780905
732,0.1551,0,6,0,10443,595167,318,107638,5.513051613620364,0.15315485803316709
733,0.1552,2,69,2,10512,595098,320,107636,5.512412464337323,0.1531674858481303
734,0.1553,4,75,4,10587,595023,324,107632,5.511717736855756,0.15317901388305782
735,0.1554,0,10,0,10597,595013,324,107632,5.511625106524881,0.15318119391726975
736,0.1555,0,12,0,10609,595001,324,107632,5.51151395012783,0.15318381004023437
737,0.1556,1,24,1,10633,594977,325,107631,5.511291637333729,0.1531878373146904
738,0.1557,0,6,0,10639,594971,325,107631,5.511236059135204,0.15318914549061916
739,0.1558,2,129,2,10768,594842,327,107629,5.510041127866908,0.15321486580940707
740,0.1559,0,4,0,10772,594838,327,107629,5.5100040757345585,0.1532157382482024
741,0.156,1,17,1,10789,594821,328,107628,5.50984660417207,0.15321824075484483
742,0.1561,2,15,2,10804,594806,330,107626,5.509707658675757,0.1532191016354608
743,0.1562,0,5,0,10809,594801,330,107626,5.509661343510319,0.15322019227620806
744,0.1563,0,6,0,10815,594795,330,107626,5.509605765311794,0.15322150106560026
745,0.1564,0,2,0,10817,594793,330,107626,5.509587239245619,0.15322193733369968
746,0.1565,0,12,0,10829,594781,330,107626,5.509476082848568,0.15322455499446902
747,0.1566,0,13,0,10842,594768,330,107626,5.50935566341843,0.15322739089456913
748,0.1567,0,42,0,10884,594726,330,107626,5.5089666160287525,0.1532365537508258
749,0.1568,1,27,1,10911,594699,331,107625,5.508716514135388,0.15324123908623372
750,0.1569,1,20,1,10931,594679,332,107624,5.508531253473637,0.1532443973612529
751,0.157,0,15,0,10946,594664,332,107624,5.508392307977324,0.15324767047137355
752,0.1571,0,35,0,10981,594629,332,107624,5.508068101819259,0.15325530827208997
753,0.1572,2,27,2,11008,594602,334,107622,5.507817999925896,0.15325878921825514
754,0.1573,0,10,0,11018,594592,334,107622,5.50772536959502,0.1532609717265677
755,0.1575,1,25,1,11043,594567,335,107621,5.507493793767831,0.15326522241906726
756,0.1576,1,6,1,11049,594561,336,107620,5.507438215569306,0.1532653261765841
757,0.1577,0,2,0,11051,594559,336,107620,5.507419689503131,0.15326576271862302
758,0.1578,0,2,0,11053,594557,336,107620,5.507401163436956,0.15326619926314874
759,0.1579,3,85,3,11138,594472,339,107617,5.5066138056245135,0.15328113672198254
760,0.158,4,44,4,11182,594428,343,107613,5.506206232168661,0.15328591919845136
761,0.1581,0,2,0,11184,594426,343,107613,5.506187706102486,0.15328635588621145
762,0.1582,0,5,0,11189,594421,343,107613,5.5061413909370485,0.1532874476164972
763,0.1583,0,4,0,11193,594417,343,107613,5.506104338804699,0.15328832101192258
764,0.1584,7,133,7,11326,594284,350,107606,5.5048723554040535,0.15330892305062047
765,0.1585,2,30,2,11356,594254,352,107604,5.504594464411427,0.1533130633261999
766,0.1586,0,1,0,11357,594253,352,107604,5.504585201378339,0.15331328176537387
767,0.1587,0,26,0,11383,594227,352,107604,5.504344362518063,0.1533189614023889
768,0.1588,0,1,0,11384,594226,352,107604,5.504335099484975,0.15331917985837026
769,0.1589,0,7,0,11391,594219,352,107604,5.504270258253363,0.1533207090676709
770,0.159,0,4,0,11395,594215,352,107604,5.504233206121012,0.15332158291525308
771,0.1591,2,37,2,11432,594178,354,107602,5.503890473896773,0.15332725355524524
772,0.1592,1,29,1,11461,594149,355,107601,5.503621845937234,0.1533323833273958
773,0.1593,3,49,3,11510,594100,358,107598,5.503167957315943,0.15333947082648092
774,0.1594,2,55,2,11565,594045,360,107596,5.502658490496128,0.1533490773771772
775,0.1595,1,14,1,11579,594031,361,107595,5.502528808032903,0.15335093055274462
776,0.1596,0,8,0,11587,594023,361,107595,5.502454703768202,0.15335267909318176
777,0.1597,0,5,0,11592,594018,361,107595,5.502408388602764,0.15335377195120387
778,0.1598,0,9,0,11601,594009,361,107595,5.502325021304976,0.1533557391348966
779,0.1599,0,16,0,11617,593993,361,107595,5.502176812775575,0.1533592364749682
780,0.16,0,4,0,11621,593989,361,107595,5.502139760643225,0.15336011083491072
781,0.1601,3,54,3,11675,593935,364,107592,5.501639556856497,0.1533682951618398
782,0.1602,0,16,0,11691,593919,364,107592,5.501491348327097,0.15337179317216693
783,0.1603,1,21,1,11712,593898,365,107591,5.5012968246322576,0.15337517765781075
784,0.1604,0,9,0,11721,593889,365,107591,5.50121345733447,0.15337714546387637
785,0.1605,0,6,0,11727,593883,365,107591,5.501157879135945,0.15337845736263925
786,0.1606,0,7,0,11734,593876,365,107591,5.501093037904331,0.15337998793956095
787,0.1607,0,31,0,11765,593845,365,107591,5.500805883878617,0.15338676657599554
788,0.1608,4,81,4,11846,593764,369,107587,5.500055578198525,0.15339965295551014
789,0.1609,2,65,2,11911,593699,371,107585,5.499453481047834,0.15341145669942563
790,0.161,4,26,4,11937,593673,375,107581,5.499212642187558,0.15341231565167543
791,0.1611,0,22,0,11959,593651,375,107581,5.499008855459632,0.15341712871061217
792,0.1612,0,17,0,11976,593634,375,107581,5.498851383897144,0.15342084809937037
793,0.1613,3,2,3,11978,593632,378,107578,5.498832857830968,0.1534176637526561
794,0.1614,1,28,1,12006,593604,379,107577,5.498573492904517,0.153422582756806
795,0.1615,0,17,0,12023,593587,379,107577,5.498416021342028,0.15342630254833392
796,0.1616,4,104,4,12127,593483,383,107573,5.497452665900923,0.15344423270038343
797,0.1617,0,58,0,12185,593425,383,107573,5.4969154099818445,0.15345692855043808
798,0.1618,0,5,0,12190,593420,383,107573,5.4968690948164065,0.15345802311863313
799,0.1619,4,48,4,12238,593372,387,107569,5.496424469228204,0.15346370093916606
800,0.162,0,4,0,12242,593368,387,107569,5.496387417095854,0.15346457670232846
801,0.1621,0,11,0,12253,593357,387,107569,5.496285523731891,0.15346698510256432
802,0.1622,0,3,0,12256,593354,387,107569,5.4962577346326285,0.1534676419521117
803,0.1623,1,68,1,12324,593286,388,107568,5.495627848382674,0.15348132421303154
804,0.1624,1,28,1,12352,593258,389,107567,5.495368483456223,0.15348624835015875
805,0.1625,1,53,1,12405,593205,390,107566,5.494877542702582,0.15349664869122723
806,0.1626,0,10,0,12415,593195,390,107566,5.494784912371707,0.15349883911918613
807,0.1627,0,47,0,12462,593148,390,107566,5.494349549816592,0.15350913496804688
808,0.1628,0,10,0,12472,593138,390,107566,5.494256919485716,0.15351132575238619
809,0.1629,0,3,0,12475,593135,390,107566,5.494229130386453,0.15351198299988156
810,0.163,2,1,2,12476,593134,392,107564,5.494219867353366,0.1535097859562893
811,0.1631,2,31,2,12507,593103,394,107562,5.493932713327652,0.1535141615465308
812,0.1632,0,15,0,12522,593088,394,107562,5.493793767831339,0.15351744808392206
813,0.1633,0,17,0,12539,593071,394,107562,5.49363629626885,0.15352117299641896
814,0.1634,4,46,4,12585,593025,398,107558,5.493210196746823,0.15352642013865594
815,0.1635,3,93,3,12678,592932,401,107555,5.49234873466968,0.15354317781771826
816,0.1636,2,23,2,12701,592909,403,107553,5.492135684908667,0.15354580262740877
817,0.1637,0,1,0,12702,592908,403,107553,5.492126421875579,0.15354602183419205
818,0.1638,0,11,0,12713,592897,403,107553,5.492024528511616,0.1535484331501178
819,0.1639,0,7,0,12720,592890,403,107553,5.491959687280003,0.15354996766332163
820,0.164,1,9,1,12729,592881,404,107552,5.491876319982215,0.15355073218994536
821,0.1641,0,11,0,12740,592870,404,107552,5.491774426618252,0.1535531436762409
822,0.1642,0,2,0,12742,592868,404,107552,5.491755900552077,0.15355358213643241
823,0.1643,1,38,1,12780,592830,405,107551,5.491403905294749,0.1535607048163785
824,0.1644,0,7,0,12787,592823,405,107551,5.491339064063137,0.1535622396034119
825,0.1645,2,20,2,12807,592803,407,107549,5.491153803401386,0.15356420771269305
826,0.1646,0,4,0,12811,592799,407,107549,5.491116751269035,0.15356508478642047
827,0.1647,2,39,2,12850,592760,409,107547,5.490755492978621,0.15357121947945687
828,0.1648,0,12,0,12862,592748,409,107547,5.49064433658157,0.15357385101992732
829,0.1649,0,12,0,12874,592736,409,107547,5.49053318018452,0.15357648265058554
830,0.165,0,14,0,12888,592722,409,107547,5.490403497721294,0.153579553000347
831,0.1651,0,13,0,12901,592709,409,107547,5.490283078291156,0.15358240414933966
832,0.1652,0,21,0,12922,592688,409,107547,5.490088554596317,0.15358701007518905
833,0.1653,3,54,3,12976,592634,412,107544,5.489588350809589,0.15359522864185965
834,0.1654,0,11,0,12987,592623,412,107544,5.489486457445626,0.15359764170547885
835,0.1655,4,57,4,13044,592566,416,107540,5.488958464559635,0.15360531119573323
836,0.1656,2,1,2,13045,592565,418,107538,5.488949201526548,0.1536031126848478
837,0.1657,1,6,1,13051,592559,419,107537,5.488893623328022,0.15360322012981076
838,0.1658,0,38,0,13089,592521,419,107537,5.488541628070696,0.15361155789948833
839,0.1659,1,24,1,13113,592497,420,107536,5.488319315276594,0.15361561526385184
840,0.166,8,226,8,13339,592271,428,107528,5.486225869798807,0.15365554966497522
841,0.1661,0,42,0,13381,592229,428,107528,5.48583682240913,0.15366477219949212
842,0.1662,0,11,0,13392,592218,428,107528,5.485734929045167,0.15366718780814753
843,0.1663,2,58,2,13450,592160,430,107526,5.4851976731260885,0.15367750676732134
844,0.1664,4,36,4,13486,592124,434,107522,5.4848642039349365,0.15368057560537757
845,0.1665,3,7,3,13493,592117,437,107519,5.484799362703323,0.15367848424037642
846,0.1666,1,20,1,13513,592097,438,107518,5.484614102041572,0.1536816677744188
847,0.1667,1,43,1,13556,592054,439,107517,5.484215791618808,0.1536899042413136
848,0.1668,0,2,0,13558,592052,439,107517,5.484197265552632,0.15369034362586106
849,0.1669,3,36,3,13594,592016,442,107514,5.48386379636148,0.15369462353294355
850,0.167,0,2,0,13596,592014,442,107514,5.483845270295306,0.15369506295673654
851,0.1671,0,7,0,13603,592007,442,107514,5.4837804290636925,0.15369660095979965
852,0.1672,5,61,5,13664,591946,447,107509,5.4832153840453515,0.1537039552222802
853,0.1673,2,20,2,13684,591926,449,107507,5.4830301233836005,0.15370593037503236
854,0.1674,0,61,0,13745,591865,449,107507,5.4824650783652595,0.15371933677642227
855,0.1675,1,16,1,13761,591849,450,107506,5.482316869835859,0.1537216435143811
856,0.1676,1,9,1,13770,591840,451,107505,5.482233502538071,0.15372241168521975
857,0.1677,1,29,1,13799,591811,452,107504,5.481964874578532,0.15372757627106526
858,0.1678,2,61,2,13860,591750,454,107502,5.481399829560191,0.15373856635376087
859,0.1679,1,18,1,13878,591732,455,107501,5.481233094964615,0.15374131369657898
860,0.168,2,17,2,13895,591715,457,107499,5.481075623402127,0.1537426310113928
861,0.1681,0,8,0,13903,591707,457,107499,5.481001519137426,0.15374439006530263
862,0.1682,0,2,0,13905,591705,457,107499,5.480982993071251,0.1537448298350696
863,0.1683,0,14,0,13919,591691,457,107499,5.480853310608025,0.15374790829388293
864,0.1684,0,12,0,13931,591679,457,107499,5.480742154210975,0.15375054707098906
865,0.1685,3,11,3,13942,591668,460,107496,5.480640260847012,0.15374933491999015
866,0.1686,4,30,4,13972,591638,464,107492,5.480362369854385,0.15375109064122552
867,0.1687,2,21,2,13993,591617,466,107490,5.480167846159547,0.15375328812327727
868,0.1688,0,8,0,14001,591609,466,107490,5.480093741894846,0.15375504756837013
869,0.1689,3,36,3,14037,591573,469,107487,5.479760272703694,0.15375933396275
870,0.169,2,11,2,14048,591562,471,107485,5.479658379339731,0.1537593323481826
871,0.1691,0,17,0,14065,591545,471,107485,5.4795009077772425,0.1537630716850493
872,0.1692,0,27,0,14092,591518,471,107485,5.479250805883878,0.15376901100567522
873,0.1693,1,16,1,14108,591502,472,107484,5.479102597354478,0.15377132016950268
874,0.1694,5,64,5,14172,591438,477,107479,5.478509763236874,0.15377934719000969
875,0.1695,1,18,1,14190,591420,478,107478,5.478343028641298,0.15378209695835443
876,0.1696,1,21,1,14211,591399,479,107477,5.47814850494646,0.1537855070141198
877,0.1697,0,6,0,14217,591393,479,107477,5.478092926747935,0.15378682730693835
878,0.1698,1,27,1,14244,591366,480,107476,5.47784282485457,0.1537915580345772
879,0.1699,2,88,2,14332,591278,482,107474,5.477027677942866,0.15380850430481774
880,0.17,1,44,1,14376,591234,483,107473,5.476620104487013,0.15381697907706665
881,0.1701,1,94,1,14470,591140,484,107472,5.475749379376783,0.15383646430350467
882,0.1702,1,16,1,14486,591124,485,107471,5.475601170847383,0.15383877640120527
883,0.1703,0,9,0,14495,591115,485,107471,5.475517803549594,0.1538407583318303
884,0.1704,0,10,0,14505,591105,485,107471,5.475425173218719,0.15384296053686355
885,0.1705,1,10,1,14515,591095,486,107470,5.475332542887843,0.1538439515292063
886,0.1706,3,33,3,14548,591062,489,107467,5.4750268627959535,0.1538475854259451
887,0.1707,4,52,4,14600,591010,493,107463,5.474545185075401,0.15385419336180498
888,0.1708,2,28,2,14628,590982,495,107461,5.47428582014895,0.1538579382999042
889,0.1709,1,17,1,14645,590965,496,107460,5.474128348586461,0.15386047177578122
890,0.171,2,50,2,14695,590915,498,107458,5.4736651969320835,0.15386906423931052
891,0.1711,5,71,5,14766,590844,503,107453,5.4730075215828675,0.1538786504882593
892,0.1712,0,5,0,14771,590839,503,107453,5.47296120641743,0.15387975230992193
893,0.1713,2,39,2,14810,590800,505,107451,5.472599948127015,0.15388592354325306
894,0.1714,0,6,0,14816,590794,505,107451,5.47254436992849,0.15388724588074387
895,0.1715,1,12,1,14828,590782,506,107450,5.472433213531438,0.1538886788345421
896,0.1716,7,114,7,14942,590668,513,107443,5.471377227759458,0.15390532451143157
897,0.1717,0,5,0,14947,590663,513,107443,5.47133091259402,0.1539064268177039
898,0.1718,1,42,1,14989,590621,514,107442,5.470941865204343,0.15391447476803669
899,0.1719,1,21,1,15010,590600,515,107441,5.470747341509504,0.1539178930750486
900,0.172,2,54,2,15064,590546,517,107439,5.470247137722776,0.15392737666282227
901,0.1721,0,2,0,15066,590544,517,107439,5.470228611656601,0.1539278177262197
902,0.1722,0,4,0,15070,590540,517,107439,5.470191559524251,0.1539286998605975
903,0.1723,1,28,1,15098,590512,518,107438,5.469932194597799,0.1539336628698331
904,0.1724,1,34,1,15132,590478,519,107437,5.4696172514728225,0.1539399497073426
905,0.1725,4,76,4,15208,590402,523,107433,5.4689132609581685,0.15395186541231093
906,0.1726,0,1,0,15209,590401,523,107433,5.46890399792508,0.15395208602618962
907,0.1727,1,31,1,15240,590370,524,107432,5.468616843899366,0.153957712932895
908,0.1728,0,7,0,15247,590363,524,107432,5.468552002667754,0.153959257375017
909,0.1729,1,11,1,15258,590352,525,107431,5.468450109303791,0.1539604719518819
910,0.173,1,7,1,15265,590345,526,107430,5.468385268072177,0.1539608039840923
911,0.1731,1,19,1,15284,590326,527,107429,5.468209270443514,0.15396378384963202
912,0.1732,4,47,4,15331,590279,531,107425,5.467773907888399,0.15396930503479986
913,0.1733,0,13,0,15344,590266,531,107425,5.467653488458261,0.15397217392799964
914,0.1734,1,25,1,15369,590241,532,107424,5.467421912631072,0.15397647868246223
915,0.1735,0,21,0,15390,590220,532,107424,5.467227388936234,0.15398111357655195
916,0.1736,2,28,2,15418,590192,534,107422,5.466968024009781,0.15398486842293876
917,0.1737,5,61,5,15479,590131,539,107417,5.466402978991441,0.15399227006600263
918,0.1738,0,19,0,15498,590112,539,107417,5.4662269813627775,0.15399646466311795
919,0.1739,1,11,1,15509,590101,540,107416,5.466125087998814,0.1539976803432748
920,0.174,6,118,6,15627,589983,546,107410,5.465032050094483,0.1540164584387856
921,0.1741,1,19,1,15646,589964,547,107409,5.464856052465819,0.1540194415327235
922,0.1742,0,3,0,15649,589961,547,107409,5.464828263366557,0.15402010410542466
923,0.1743,0,6,0,15655,589955,547,107409,5.464772685168032,0.15402142926792894
924,0.1744,0,29,0,15684,589926,547,107409,5.464504057208492,0.15402783454150445
925,0.1745,1,6,1,15690,589920,548,107408,5.464448479009967,0.15402794667645642
926,0.1746,0,10,0,15700,589910,548,107408,5.464355848679092,0.15403015553879293
927,0.1747,0,8,0,15708,589902,548,107408,5.464281744414391,0.15403192267427687
928,0.1748,4,47,4,15755,589855,552,107404,5.463846381859276,0.15403745236705443
929,0.1749,3,41,3,15796,589814,555,107401,5.463466597502686,0.15404287056359947
930,0.175,2,23,2,15819,589791,557,107399,5.463253547741672,0.1540455256099485
931,0.1751,1,6,1,15825,589785,558,107398,5.463197969543147,0.1540456379458478
932,0.1752,0,5,0,15830,589780,558,107398,5.463151654377709,0.15404674272567406
933,0.1753,0,17,0,15847,589763,558,107398,5.462994182815221,0.1540504990956178
934,0.1754,1,38,1,15885,589725,559,107397,5.462642187557894,0.15405768287329907
935,0.1755,2,10,2,15895,589715,561,107395,5.462549557227018,0.1540574658231843
936,0.1757,4,107,4,16002,589608,565,107391,5.46155841268665,0.1540762612284953
937,0.1758,1,37,1,16039,589571,566,107390,5.461215680462411,0.1540832270385287
938,0.1759,6,76,6,16115,589495,572,107384,5.460511689947756,0.15409274780844306
939,0.176,0,2,0,16117,589493,572,107384,5.460493163881582,0.15409319004645008
940,0.1761,4,106,4,16223,589387,576,107380,5.459511282374301,0.15411177624657885
941,0.1762,2,88,2,16311,589299,578,107378,5.458696135462596,0.154128814357299
942,0.1763,3,29,3,16340,589270,581,107375,5.458427507503057,0.15413158782450173
943,0.1764,0,2,0,16342,589268,581,107375,5.4584089814368815,0.1541320303225612
944,0.1765,0,5,0,16347,589263,581,107375,5.4583626662714435,0.15413313657882574
945,0.1766,2,19,2,16366,589244,583,107373,5.458186668642781,0.15413491201047347
946,0.1767,1,4,1,16370,589240,584,107372,5.45814961651043,0.1541345828093688
947,0.1768,0,10,0,16380,589230,584,107372,5.458056986179555,0.15413679547288123
948,0.1769,1,32,1,16412,589198,585,107371,5.457760569120753,0.15414266210526165
949,0.177,0,14,0,16426,589184,585,107371,5.457630886657527,0.15414576020558318
950,0.1771,4,101,4,16527,589083,589,107367,5.456695320315684,0.15416325651518414
951,0.1772,1,18,1,16545,589065,590,107366,5.4565285857201085,0.15416602649795888
952,0.1773,3,75,3,16620,588990,593,107363,5.455833858238542,0.15417898680697864
953,0.1774,0,34,0,16654,588956,593,107363,5.455518915113565,0.15418651508863035
954,0.1775,8,138,8,16792,588818,601,107355,5.454240616547482,0.15420735937762597
955,0.1776,4,65,4,16857,588753,605,107351,5.453638519396791,0.15421689862434348
956,0.1777,1,21,1,16878,588732,606,107350,5.453443995701953,0.15422033610982613
957,0.1778,5,102,5,16980,588630,611,107345,5.452499166327022,0.15423686195624842
958,0.1779,4,76,4,17056,588554,615,107341,5.451795175812368,0.1542488450125378
959,0.178,2,26,2,17082,588528,617,107339,5.451554336952092,0.15425217749943596
960,0.1781,0,87,0,17169,588441,617,107339,5.450748453073475,0.15427146511828452
961,0.1782,1,25,1,17194,588416,618,107338,5.450516877246286,0.15427579288081708
962,0.1783,0,18,0,17212,588398,618,107338,5.450350142650709,0.15427978428599354
963,0.1784,0,36,0,17248,588362,618,107338,5.450016673459557,0.15428776771596953
964,0.1785,4,28,4,17276,588334,622,107334,5.449757308533106,0.1542891149226355
965,0.1786,1,16,1,17292,588318,623,107333,5.4496091000037055,0.15429144786681828
966,0.1787,3,90,3,17382,588228,626,107330,5.448775427025826,0.1543077644136075
967,0.1788,1,23,1,17405,588205,627,107329,5.448562377264811,0.1543116511917462
968,0.1789,2,42,2,17447,588163,629,107327,5.448173329875134,0.1543185380091734
969,0.179,2,8,2,17455,588155,631,107325,5.4480992256104335,0.15431788117559095
970,0.1791,1,12,1,17467,588143,632,107324,5.447988069213383,0.154319327876089
971,0.1792,1,16,1,17483,588127,633,107323,5.447839860683982,0.1543216622330865
972,0.1793,8,89,8,17572,588038,641,107315,5.44701545073919,0.15433168477018147
973,0.1794,6,111,6,17683,587927,647,107309,5.4459872540664716,0.15434902680528625
974,0.1795,6,202,6,17885,587725,653,107303,5.444116121382786,0.15438658586416662
975,0.1796,0,26,0,17911,587699,653,107303,5.443875282522509,0.15439236146083032
976,0.1797,0,23,0,17934,587676,653,107303,5.443662232761495,0.15439747100272094
977,0.1798,0,9,0,17943,587667,653,107303,5.443578865463707,0.15439947048074018
978,0.1799,0,10,0,17953,587657,653,107303,5.4434862351328315,0.1544016921837228
979,0.18,2,64,2,18017,587593,655,107301,5.442893401015229,0.15441347889030557
980,0.1801,4,32,4,18049,587561,659,107297,5.4425969839564265,0.1544157223490267
981,0.1802,4,8,4,18057,587553,663,107293,5.442522879691726,0.15441263243941822
982,0.1803,0,20,0,18077,587533,663,107293,5.442337619029975,0.15441707708116853
983,0.1804,3,89,3,18166,587444,666,107290,5.4415132090851825,0.15443320752978837
984,0.1805,3,73,3,18239,587371,669,107287,5.440837007669791,0.15444578483224838
985,0.1806,3,60,3,18299,587311,672,107284,5.440281225684538,0.15445547405322527
986,0.1807,1,32,1,18331,587279,673,107283,5.439984808625736,0.154461372778816
987,0.1808,0,33,0,18364,587246,673,107283,5.4396791285338475,0.15446871188964031
988,0.1809,6,82,6,18446,587164,679,107277,5.438919559820667,0.15447964621904525
989,0.181,0,17,0,18463,587147,679,107277,5.438762088258179,0.1544834279921201
990,0.1811,4,55,4,18518,587092,683,107273,5.438252621438364,0.15449079374680463
991,0.1812,4,43,4,18561,587049,687,107269,5.437854311015599,0.1544954905389173
992,0.1813,2,76,2,18637,586973,689,107267,5.437150320500945,0.15450996773450104
993,0.1814,1,22,1,18659,586951,690,107266,5.4369465337730185,0.15451364630943926
994,0.1815,1,16,1,18675,586935,691,107265,5.436798325243617,0.15451598962834917
995,0.1816,1,34,1,18709,586901,692,107264,5.436483382118641,0.1545223397895313
996,0.1817,1,36,1,18745,586865,693,107263,5.436149912927489,0.15452913583661804
997,0.1818,1,12,1,18757,586853,694,107262,5.436038756530438,0.1545305893115694
998,0.1819,0,21,0,18778,586832,694,107262,5.4358442328356,0.15453526467596607
999,0.182,1,50,1,18828,586782,695,107261,5.435381081181222,0.15454517947735227
1000,0.1821,3,81,3,18909,586701,698,107258,5.43463077550113,0.1545595633171412
1001,0.1822,0,7,0,18916,586694,698,107258,5.434565934269517,0.1545611223831043
1002,0.1823,2,16,2,18932,586678,700,107256,5.434417725740117,0.1545622494358253
1003,0.1824,1,94,1,19026,586584,701,107255,5.433547000629886,0.15458197074537464
1004,0.1825,4,54,4,19080,586530,705,107251,5.433046796843159,0.15458912826958363
1005,0.1826,1,18,1,19098,586512,706,107250,5.432880062247582,0.1545919205721847
1006,0.1827,4,72,4,19170,586440,710,107246,5.432213123865279,0.15460309131220754
1007,0.1828,3,46,3,19216,586394,713,107243,5.431787024343251,0.15460968777617112
1008,0.1829,2,17,2,19233,586377,715,107241,5.4316295527807625,0.15461103950589516
1009,0.183,7,146,7,19379,586231,722,107234,5.43027714994998,0.15463505728479449
1010,0.1831,2,71,2,19450,586160,724,107232,5.429619474600763,0.15464845282322265
1011,0.1832,0,2,0,19452,586158,724,107232,5.429600948534588,0.15464889888807165
1012,0.1833,3,32,3,19484,586126,727,107229,5.429304531475786,0.15465237865162867
1013,0.1834,6,58,6,19542,586068,733,107223,5.428767275556709,0.1546580007529306
1014,0.1835,4,97,4,19639,585971,737,107219,5.427868761347216,0.154674764494583
1015,0.1836,6,162,6,19801,585809,743,107213,5.426368149987032,0.15470360248303805
1016,0.1837,5,64,5,19865,585745,748,107208,5.425775315869428,0.15471179142019734
1017,0.1838,2,27,2,19892,585718,750,107206,5.425525213976064,0.15471538004167845
1018,0.1839,0,12,0,19904,585706,750,107206,5.4254140575790135,0.15471805943611888
1019,0.184,3,32,3,19936,585674,753,107203,5.425117640520212,0.15472154509386227
1020,0.1841,7,79,7,20015,585595,760,107196,5.424385860906296,0.15473064748242976
1021,0.1842,1,30,1,20045,585565,761,107195,5.424107969913669,0.15473612795196026
1022,0.1843,4,72,4,20117,585493,765,107191,5.423441031531365,0.15474733067314966
1023,0.1844,1,13,1,20130,585480,766,107190,5.423320612101226,0.15474901468231625
1024,0.1845,2,56,2,20186,585424,768,107188,5.422801882248323,0.1547590858951332
1025,0.1846,0,14,0,20200,585410,768,107188,5.422672199785097,0.15476221415597505
1026,0.1847,1,14,1,20214,585396,769,107187,5.4225425173218715,0.15476412213409801
1027,0.1848,0,7,0,20221,585389,769,107187,5.422477676090259,0.15476568636510651
1028,0.1849,5,56,5,20277,585333,774,107182,5.421958946237356,0.15477209879930398
1029,0.185,2,13,2,20290,585320,776,107180,5.421838526807218,0.1547725631768953
1030,0.1851,0,8,0,20298,585312,776,107180,5.421764422542517,0.1547743511838404
1031,0.1852,5,125,5,20423,585187,781,107175,5.420606543406573,0.15479619043217277
1032,0.1853,2,31,2,20454,585156,783,107173,5.420319389380859,0.15480068002351483
1033,0.1854,0,4,0,20458,585152,783,107173,5.4202823372485085,0.15480157440508432
1034,0.1855,0,19,0,20477,585133,783,107173,5.420106339619845,0.1548058228586781
1035,0.1856,2,21,2,20498,585112,785,107171,5.419911815925007,0.15480807704363678
1036,0.1857,3,75,3,20573,585037,788,107168,5.41921708844344,0.1548211873650147
1037,0.1858,1,7,1,20580,585030,789,107167,5.419152247211827,0.1548215320205086
1038,0.1859,4,140,4,20720,584890,793,107163,5.41785542257957,0.15484796684646984
1039,0.186,0,55,0,20775,584835,793,107163,5.417345955759754,0.1548602741626421
1040,0.1861,2,7,2,20782,584828,795,107161,5.417281114528141,0.1548593980540153
1041,0.1862,4,61,4,20843,584767,799,107157,5.416716069509801,0.15486816471173134
1042,0.1863,1,24,1,20867,584743,800,107156,5.416493756715699,0.15487231517894953
1043,0.1864,5,88,5,20955,584655,805,107151,5.415678609803995,0.1548859073208385
1044,0.1865,4,66,4,21021,584589,809,107147,5.415067249620216,0.15489579839707635
1045,0.1866,4,140,4,21161,584449,813,107143,5.413770424987958,0.15492226630730258
1046,0.1867,3,129,3,21290,584320,816,107140,5.412575493719664,0.15494750238625518
1047,0.1868,2,15,2,21305,584305,818,107138,5.41243654822335,0.15494841946480042
1048,0.1869,3,34,3,21339,584271,821,107135,5.412121605098373,0.15495237241215726
1049,0.187,0,4,0,21343,584267,821,107135,5.412084552966023,0.1549532688652911
1050,0.1871,0,35,0,21378,584232,821,107135,5.4117603468079585,0.1549611132726902
1051,0.1872,1,31,1,21409,584201,822,107134,5.411473192782244,0.1549668395206376
1052,0.1873,3,51,3,21460,584150,825,107131,5.411000778094779,0.15497460511716654
1053,0.1874,1,17,1,21477,584133,826,107130,5.410843306532291,0.15497719391895703
1054,0.1875,0,15,0,21492,584118,826,107130,5.410704361035978,0.15498055690577042
1055,0.1876,4,61,4,21553,584057,830,107126,5.410139316017637,0.15498934435598097
1056,0.1877,2,42,2,21595,584015,832,107124,5.40975026862796,0.15499631767271127
1057,0.1878,0,15,0,21610,584000,832,107124,5.409611323131646,0.15499968167796227
1058,0.1879,5,105,5,21715,583895,837,107119,5.408638704657453,0.1550171197689193
1059,0.188,0,8,0,21723,583887,837,107119,5.4085646003927526,0.15501891445226235
1060,0.1881,4,83,4,21806,583804,841,107115,5.407795768646485,0.15503264492653987
1061,0.1882,1,18,1,21824,583786,842,107114,5.40762903405091,0.1550354609929078
1062,0.1883,0,7,0,21831,583779,842,107114,5.407564192819296,0.15503703178350337
1063,0.1884,1,8,1,21839,583771,843,107113,5.407490088554597,0.1550376039971978
1064,0.1885,0,14,0,21853,583757,843,107113,5.407360406091371,0.15504074572640295
1065,0.1886,3,100,3,21953,583657,846,107110,5.406434102782615,0.15505952079355267
1066,0.1887,0,22,0,21975,583635,846,107110,5.406230316054689,0.15506445938805202
1067,0.1888,0,8,0,21983,583627,846,107110,5.406156211789988,0.1550662553185945
1068,0.1889,0,13,0,21996,583614,846,107110,5.40603579235985,0.15506917379445337
1069,0.189,5,115,5,22111,583499,851,107105,5.404970543554781,0.15508887872065613
1070,0.1891,4,154,4,22265,583345,855,107101,5.403544036459298,0.1551185755294404
1071,0.1892,1,12,1,22277,583333,856,107100,5.4034328800622475,0.15512004785402783
1072,0.1893,1,24,1,22301,583309,857,107099,5.403210567268146,0.15512421640537188
1073,0.1894,3,28,3,22329,583281,860,107096,5.402951202341694,0.15512683649658085
1074,0.1895,2,26,2,22355,583255,862,107094,5.402710363481418,0.1551302312308702
1075,0.1896,2,30,2,22385,583225,864,107092,5.402432472488791,0.155134525152937
1076,0.1897,1,8,1,22393,583217,865,107091,5.402358368224092,0.15513509911517756
1077,0.1898,6,109,6,22502,583108,871,107085,5.401348697617548,0.15515225451431702
1078,0.1899,1,12,1,22514,583096,872,107084,5.401237541220497,0.15515372801298213
1079,0.19,3,131,3,22645,582965,875,107081,5.400024083886028,0.1551795097718123
1080,0.1901,3,63,3,22708,582902,878,107078,5.399440512801512,0.155190005507406
1081,0.1902,0,14,0,22722,582888,878,107078,5.399310830338286,0.1551931544452915
1082,0.1903,3,74,3,22796,582814,881,107075,5.398625365889807,0.15520612736251774
1083,0.1904,1,13,1,22809,582801,882,107074,5.398504946459669,0.1552078275049828
1084,0.1905,8,69,8,22878,582732,890,107066,5.397865797176627,0.15521355527270303
1085,0.1906,0,11,0,22889,582721,890,107066,5.397763903812664,0.15521603045577836
1086,0.1907,13,155,13,23044,582566,903,107053,5.396328133684094,0.15523499207533434
1087,0.1908,3,24,3,23068,582542,906,107050,5.396105820889992,0.155236719683523
1088,0.1909,3,41,3,23109,582501,909,107047,5.395726036533403,0.15524227464948054
1089,0.191,0,11,0,23120,582490,909,107047,5.39562414316944,0.1552447511881161
1090,0.1911,3,30,3,23150,582460,912,107044,5.395346252176813,0.15524783032440712
1091,0.1912,1,14,1,23164,582446,913,107043,5.395216569713587,0.15524975742905253
1092,0.1913,4,48,4,23212,582398,917,107039,5.3947719441253845,0.15525566512966377
1093,0.1914,0,15,0,23227,582383,917,107039,5.3946329986290715,0.15525904308246619
1094,0.1915,5,66,5,23293,582317,922,107034,5.394021638445293,0.155267780854746
1095,0.1916,2,122,2,23415,582195,924,107032,5.392891548408611,0.15529281354328836
1096,0.1917,0,9,0,23424,582186,924,107032,5.392808181110823,0.15529484139996344
1097,0.1918,2,36,2,23460,582150,926,107030,5.392474711919671,0.15530050204590964
1098,0.1919,1,9,1,23469,582141,927,107029,5.392391344621883,0.15530130446769302
1099,0.192,1,31,1,23500,582110,928,107028,5.392104190596169,0.15530706476786943
1100,0.1921,6,100,6,23600,582010,934,107022,5.391177887287413,0.155322249184363
1101,0.1922,0,2,0,23602,582008,934,107022,5.391159361221238,0.155322700027575
1102,0.1923,0,45,0,23647,581963,934,107022,5.390742524732298,0.15533284469182929
1103,0.1924,6,124,6,23771,581839,940,107016,5.3895939086294415,0.15535344883901547
1104,0.1925,2,53,2,23824,581786,942,107014,5.389102967875801,0.15536295005807202
1105,0.1926,2,18,2,23842,581768,944,107012,5.3889362332802255,0.1553645576236244
1106,0.1927,1,27,1,23869,581741,945,107011,5.388686131386861,0.15536942179478244
1107,0.1928,10,171,10,24040,581570,955,107001,5.38710215272889,0.15539573987286714
1108,0.1929,3,84,3,24124,581486,958,106998,5.386324057949535,0.155411018992453
1109,0.193,1,9,1,24133,581477,959,106997,5.386240690651747,0.15541182383067478
1110,0.1931,3,49,3,24182,581428,962,106994,5.385786802030457,0.15541920508060464
1111,0.1932,0,38,0,24220,581390,962,106994,5.38543480677313,0.15542778449237635
1112,0.1933,2,51,2,24271,581339,964,106992,5.384962392085664,0.15543684651715525
1113,0.1934,5,80,5,24351,581259,969,106987,5.38422134943866,0.15544877848908675
1114,0.1935,0,53,0,24404,581206,969,106987,5.38373040868502,0.15546075010934432
1115,0.1936,11,148,11,24552,581058,980,106976,5.382359479788062,0.15548068845434965
1116,0.1937,6,78,6,24630,580980,986,106970,5.3816369632072325,0.15549095137728033
1117,0.1938,2,71,2,24701,580909,988,106968,5.3809792878580165,0.15550454514397197
1118,0.1939,3,27,3,24728,580882,991,106965,5.380729185964652,0.15550696593864624
1119,0.194,1,25,1,24753,580857,992,106964,5.380497610137463,0.15551139031812056
1120,0.1941,6,71,6,24824,580786,998,106958,5.379839934788247,0.15552007723804206
1121,0.1942,3,79,3,24903,580707,1001,106955,5.379108155174331,0.15553425956356465
1122,0.1943,10,212,10,25115,580495,1011,106945,5.377144392159769,0.15556994064936577
1123,0.1944,7,99,7,25214,580396,1018,106938,5.376227351884101,0.15558374822138873
1124,0.1945,2,35,2,25249,580361,1020,106936,5.375903145726037,0.15558921397881847
1125,0.1946,2,41,2,25290,580320,1022,106934,5.375523361369447,0.15559603872803943
1126,0.1947,2,20,2,25310,580300,1024,106932,5.375338100707696,0.15559810951760103
1127,0.1948,5,124,5,25434,580176,1029,106927,5.374189484604839,0.1556200453207161
1128,0.1949,10,90,10,25524,580086,1039,106917,5.3733558116269595,0.15562814136182812
1129,0.195,5,99,5,25623,579987,1044,106912,5.372438771351291,0.15564442516294244
1130,0.1951,3,32,3,25655,579955,1047,106909,5.37214235429249,0.1556479885392159
1131,0.1952,1,24,1,25679,579931,1048,106908,5.371920041498388,0.1556521979677916
1132,0.1953,2,141,2,25820,579790,1050,106906,5.370613953833043,0.15568169903421603
1133,0.1954,5,94,5,25914,579696,1055,106901,5.369743228722813,0.1556968643906105
1134,0.1955,5,121,5,26035,579575,1060,106896,5.368622401719219,0.15571815852381238
1135,0.1956,4,31,4,26066,579544,1064,106892,5.368335247693505,0.15572027108135353
1136,0.1957,5,68,5,26134,579476,1069,106887,5.3677053614435515,0.15572954835852165
1137,0.1958,5,130,5,26264,579346,1074,106882,5.366501167142169,0.1557528984535752
1138,0.1959,7,45,7,26309,579301,1081,106875,5.366084330653229,0.15575450030312923
1139,0.196,1,19,1,26328,579282,1082,106874,5.365908333024565,0.15575758282373103
1140,0.1961,8,123,8,26451,579159,1090,106866,5.364768979954796,0.15577566415218105
1141,0.1962,8,100,8,26551,579059,1098,106858,5.363842676646041,0.15578852834963997
1142,0.1963,4,115,4,26666,578944,1102,106854,5.362777427840972,0.15580972822901204
1143,0.1964,9,170,9,26836,578774,1111,106845,5.361202712216088,0.15583727988868454
1144,0.1965,4,36,4,26872,578738,1115,106841,5.360869243024936,0.15584053770608494
1145,0.1966,0,55,0,26927,578683,1115,106841,5.3603597762051205,0.15585304088551238
1146,0.1967,2,10,2,26937,578673,1117,106839,5.3602671458742455,0.15585285159121942
1147,0.1968,2,63,2,27000,578610,1119,106837,5.359683574789729,0.15586471309962696
1148,0.1969,8,82,8,27082,578528,1127,106829,5.35892400607655,0.1558735082591992
1149,0.197,0,64,0,27146,578464,1127,106829,5.358331171958946,0.15588806539684485
1150,0.1971,2,76,2,27222,578388,1129,106827,5.357627181444292,0.15590289179308683
1151,0.1972,2,36,2,27258,578352,1131,106825,5.35729371225314,0.1559086192326946
1152,0.1973,1,13,1,27271,578339,1132,106824,5.357173292823002,0.15591034542145446
1153,0.1974,2,32,2,27303,578307,1134,106822,5.3568768757642005,0.15591516342177897
1154,0.1975,2,14,2,27317,578293,1136,106820,5.356747193300975,0.1559158854086844
1155,0.1976,1,47,1,27364,578246,1137,106819,5.3563118307458595,0.1559253501492559
1156,0.1977,1,26,1,27390,578220,1138,106818,5.356070991885583,0.15593003599800304
1157,0.1978,2,49,2,27439,578171,1140,106816,5.355617103264293,0.15593872584443208
1158,0.1979,0,36,0,27475,578135,1140,106816,5.355283634073141,0.15594692175060698
1159,0.198,2,71,2,27546,578064,1142,106814,5.354625958723925,0.15596062364391905
1160,0.1981,3,39,3,27585,578025,1145,106811,5.35426470043351,0.1559658078722497
1161,0.1982,1,60,1,27645,577965,1146,106810,5.353708918448257,0.15597824102807492
1162,0.1983,3,28,3,27673,577937,1149,106807,5.353449553521805,0.15598092133702524
1163,0.1984,4,64,4,27737,577873,1153,106803,5.352856719404202,0.15599057072250233
1164,0.1985,7,132,7,27869,577741,1160,106796,5.351633999036644,0.15601201980316623
1165,0.1986,2,10,2,27879,577731,1162,106794,5.351541368705769,0.1560118330228991
1166,0.1987,10,192,10,28071,577539,1172,106784,5.349762866352958,0.15604327196367798
1167,0.1988,0,27,0,28098,577512,1172,106784,5.349512764459595,0.15604942890211254
1168,0.1989,5,46,5,28144,577466,1177,106779,5.349086664937567,0.15605375267630747
1169,0.199,0,14,0,28158,577452,1177,106779,5.348956982474341,0.1560569456806254
1170,0.1991,3,125,3,28283,577327,1180,106776,5.347799103338397,0.15608175961806922
1171,0.1992,1,29,1,28312,577298,1181,106775,5.347530475378858,0.15608714274646127
1172,0.1993,1,63,1,28375,577235,1182,106774,5.3469469042943425,0.1561002852301651
1173,0.1994,7,93,7,28468,577142,1189,106767,5.346085442217199,0.156112874666074
1174,0.1995,4,133,4,28601,577009,1193,106763,5.344853458816555,0.15613830341107854
1175,0.1996,1,57,1,28658,576952,1194,106762,5.344325465930564,0.1561500861471317
1176,0.1997,0,6,0,28664,576946,1194,106762,5.344269887732039,0.15615145646972098
1177,0.1998,2,54,2,28718,576892,1196,106760,5.343769683945311,0.1561613218421068
1178,0.1999,3,12,3,28730,576880,1199,106757,5.343658527548261,0.15616035995711175
1179,0.2,0,27,0,28757,576853,1199,106757,5.343408425654896,0.15616652769854156
1180,0.2001,2,33,2,28790,576820,1201,106755,5.343102745563007,0.15617159784954102
1181,0.2002,1,19,1,28809,576801,1202,106754,5.342926747934343,0.1561747043032382
1182,0.2003,3,20,3,28829,576781,1205,106751,5.342741487272592,0.15617557041952682
1183,0.2004,3,39,3,28868,576742,1208,106748,5.342380228982178,0.1561807780655167
1184,0.2005,4,95,4,28963,576647,1212,106744,5.34150024083886,0.15619755015796227
1185,0.2006,4,97,4,29060,576550,1216,106740,5.340601726629368,0.15621478435217842
1186,0.2007,4,60,4,29120,576490,1220,106736,5.340045944644114,0.15622356292061484
1187,0.2008,2,20,2,29140,576470,1222,106734,5.339860683982363,0.15622566612607655
1188,0.2009,1,55,1,29195,576415,1223,106733,5.339351217162548,0.15623700867162021
1189,0.201,1,26,1,29221,576389,1224,106732,5.339110378302271,0.15624171998811337
1190,0.2011,1,25,1,29246,576364,1225,106731,5.338878802475082,0.1562462029439536
1191,0.2012,5,141,5,29387,576223,1230,106726,5.337572714809737,0.1562722838747842
1192,0.2013,2,26,2,29413,576197,1232,106724,5.337331875949461,0.15627576249668704
1193,0.2014,1,11,1,29424,576186,1233,106723,5.337229982585498,0.15627704423283337
1194,0.2015,1,8,1,29432,576178,1234,106722,5.3371558783207975,0.1562776394786938
1195,0.2016,0,13,0,29445,576165,1234,106722,5.337035458890659,0.15628061450869618
1196,0.2017,3,115,3,29560,576050,1237,106719,5.33597021008559,0.15630322993574694
1197,0.2018,2,18,2,29578,576032,1239,106717,5.335803475490015,0.1563048792455207
1198,0.2019,0,38,0,29616,575994,1239,106717,5.335451480232687,0.15631357924509784
1199,0.202,1,64,1,29680,575930,1240,106716,5.334858646115084,0.156326998180609
1200,0.2021,2,71,2,29751,575859,1242,106714,5.334200970765868,0.15634078699274656
1201,0.2022,1,48,1,29799,575811,1243,106713,5.333756345177665,0.15635054591486894
1202,0.2023,0,60,0,29859,575751,1243,106713,5.3332005631924115,0.15636429174286115
1203,0.2024,9,165,9,30024,575586,1252,106704,5.331672162732965,0.15639097744360902
1204,0.2025,4,116,4,30140,575470,1256,106700,5.330597650894809,0.15641262441913306
1205,0.2026,2,77,2,30217,575393,1258,106698,5.329884397347067,0.15642780801975104
1206,0.2027,6,136,6,30353,575257,1264,106692,5.32862462484716,0.15645158215643692
1207,0.2028,4,35,4,30388,575222,1268,106688,5.328300418689095,0.15645466410523381
1208,0.2029,1,16,1,30404,575206,1269,106687,5.328152210159694,0.15645709810776764
1209,0.203,8,132,8,30536,575074,1277,106679,5.326929489792137,0.15647749258162413
1210,0.2031,3,54,3,30590,575020,1280,106676,5.32642928600541,0.1564861756560109
1211,0.2032,0,17,0,30607,575003,1280,106676,5.326271814442921,0.1564900781746247
1212,0.2033,0,12,0,30619,574991,1280,106676,5.326160658045871,0.1564928330108396
1213,0.2034,5,23,5,30642,574968,1285,106671,5.3259476082848565,0.15649192607817333
1214,0.2035,6,76,6,30718,574892,1291,106665,5.3252436177702025,0.15650195068057404
1215,0.2036,4,81,4,30799,574811,1295,106661,5.324493312090111,0.15651560152141247
1216,0.2037,11,133,11,30932,574678,1306,106650,5.323261328689466,0.15653253645821102
1217,0.2038,3,42,3,30974,574636,1309,106647,5.322872281299789,0.15653847226482975
1218,0.2039,1,24,1,30998,574612,1310,106646,5.322649968505687,0.15654274885579325
1219,0.204,4,73,4,31071,574539,1314,106642,5.321973767090296,0.15655457213281052
1220,0.2041,2,33,2,31104,574506,1316,106640,5.3216680869984065,0.15655968030348852
1221,0.2042,6,111,6,31215,574395,1322,106634,5.320639890325689,0.15657776687923716
1222,0.2043,5,110,5,31325,574285,1327,106629,5.319620956686057,0.15659686832698402
1223,0.2044,4,30,4,31355,574255,1331,106625,5.319343065693431,0.15659881330043474
1224,0.2045,3,117,3,31472,574138,1334,106622,5.318259290822187,0.1566220106939303
1225,0.2046,6,85,6,31557,574053,1340,106616,5.317471933009744,0.15663413494664807
1226,0.2047,2,34,2,31591,574019,1342,106614,5.317156989884768,0.1566394811888345
1227,0.2048,7,92,7,31683,573927,1349,106607,5.316304790840713,0.15665198211992348
1228,0.2049,1,81,1,31764,573846,1350,106606,5.315554485160621,0.1566693903464168
1229,0.205,2,14,2,31778,573832,1352,106604,5.315424802697395,0.1566701350310683
1230,0.2051,10,127,10,31905,573705,1362,106594,5.314248397495276,0.15668698616343696
1231,0.2052,3,42,3,31947,573663,1365,106591,5.313859350105599,0.15669294116609384
1232,0.2053,0,22,0,31969,573641,1365,106591,5.313655563377672,0.1566980089146056
1233,0.2054,11,126,11,32095,573515,1376,106580,5.3124884212086405,0.1567134003337769
1234,0.2055,2,48,2,32143,573467,1378,106578,5.312043795620438,0.15672198163356837
1235,0.2056,0,38,0,32181,573429,1378,106578,5.311691800363111,0.15673073953650477
1236,0.2057,4,77,4,32258,573352,1382,106574,5.310978546815369,0.15674352797216168
1237,0.2058,0,16,0,32274,573336,1382,106574,5.310830338285968,0.15674721654336604
1238,0.2059,1,5,1,32279,573331,1383,106573,5.31078402312053,0.15674712900644797
1239,0.206,3,66,3,32345,573265,1386,106570,5.310172662936752,0.1567586252546574
1240,0.2061,5,52,5,32397,573213,1391,106565,5.309690985216199,0.15676441426465698
1241,0.2062,0,16,0,32413,573197,1391,106565,5.309542776686798,0.15676810413056336
1242,0.2063,2,15,2,32428,573182,1393,106563,5.309403831190485,0.1567690825235934
1243,0.2064,5,131,5,32559,573051,1398,106558,5.308190373856015,0.1567930972073648
1244,0.2065,0,23,0,32582,573028,1398,106558,5.307977324095002,0.15679840373403808
1245,0.2066,9,188,9,32770,572840,1407,106549,5.306235873874542,0.15683062280961277
1246,0.2067,5,55,5,32825,572785,1412,106544,5.305726407054726,0.15683711427011066
1247,0.2068,1,32,1,32857,572753,1413,106543,5.3054299899959245,0.1568432612587149
1248,0.2069,2,45,2,32902,572708,1415,106541,5.305013153506985,0.15685116945332273
1249,0.207,0,20,0,32922,572688,1415,106541,5.304827892845233,0.15685578795958358
1250,0.2071,2,137,2,33059,572551,1417,106539,5.303558857312239,0.1568849489758353
1251,0.2072,3,144,3,33203,572407,1420,106536,5.3022249805476305,0.1569144979770025
1252,0.2073,2,51,2,33254,572356,1422,106534,5.301752565860165,0.15692380208870363
1253,0.2074,3,51,3,33305,572305,1425,106531,5.3012801511727,0.1569318657230907
1254,0.2075,0,20,0,33325,572285,1425,106531,5.3010948905109485,0.15693648941686703
1255,0.2076,1,61,1,33386,572224,1426,106530,5.300529845492608,0.1569493513113735
1256,0.2077,8,76,8,33462,572148,1434,106522,5.2998258549779536,0.15695698940574948
1257,0.2078,0,12,0,33474,572136,1434,106522,5.299714698580903,0.15695976471212306
1258,0.2079,3,26,3,33500,572110,1437,106519,5.299473859720627,0.15696205143016287
1259,0.208,0,12,0,33512,572098,1437,106519,5.299362703323577,0.156964826993724
1260,0.2081,4,38,4,33550,572060,1441,106515,5.299010708066249,0.15696864753343404
1261,0.2082,8,99,8,33649,571961,1449,106507,5.298093667790582,0.15698161151299692
1262,0.2083,10,121,10,33770,571840,1459,106497,5.296972840786987,0.15699718576459784
1263,0.2084,1,21,1,33791,571819,1460,106496,5.296778317092149,0.15700080346151862
1264,0.2085,2,41,2,33832,571778,1462,106494,5.296398532735559,0.15700780807699566
1265,0.2086,3,51,3,33883,571727,1465,106491,5.295926118048094,0.15701588574765046
1266,0.2087,2,52,2,33935,571675,1467,106489,5.2954444403275405,0.15702543927427584
1267,0.2088,0,15,0,33950,571660,1467,106489,5.2953054948312275,0.15702891252512355
1268,0.2089,0,32,0,33982,571628,1467,106489,5.295009077772426,0.15703632264048828
1269,0.209,2,13,2,33995,571615,1469,106487,5.294888658342288,0.15703684696402606
1270,0.2091,4,50,4,34045,571565,1473,106483,5.29442550668791,0.1570434541507386
1271,0.2092,1,42,1,34087,571523,1474,106482,5.2940364592982325,0.15705193914499155
1272,0.2093,7,72,7,34159,571451,1481,106475,5.293369520915928,0.15705991509397782
1273,0.2094,4,43,4,34202,571408,1485,106471,5.292971210493164,0.15706490391353028
1274,0.2095,11,200,11,34402,571208,1496,106460,5.2911186038756535,0.15709757580408104
1275,0.2096,2,61,2,34463,571147,1498,106458,5.2905535588573125,0.15710923030379056
1276,0.2097,8,122,8,34585,571025,1506,106450,5.2894234688206305,0.15712756928299937
1277,0.2098,9,129,9,34714,570896,1515,106441,5.288228537552336,0.15714629497576538
1278,0.2099,7,52,7,34766,570844,1522,106434,5.287746859831783,0.1571496490362894
1279,0.21,2,50,2,34816,570794,1524,106432,5.287283708177406,0.1571587623629335
1280,0.2101,1,57,1,34873,570737,1525,106431,5.286755715291415,0.1571707464026652
1281,0.2102,0,40,0,34913,570697,1525,106431,5.286385193967913,0.15718003095426566
1282,0.2103,7,83,7,34996,570614,1532,106424,5.285616362221646,0.15719058605277694
1283,0.2104,3,64,3,35060,570550,1535,106421,5.285023528104042,0.1572017117424528
1284,0.2105,5,162,5,35222,570388,1540,106416,5.283522916743858,0.15723311327947234
1285,0.2106,9,165,9,35387,570223,1549,106407,5.281994516284412,0.1572602456290735
1286,0.2107,3,186,3,35573,570037,1552,106404,5.280271592130127,0.15729974971948774
1287,0.2108,7,124,7,35697,569913,1559,106397,5.279122976027271,0.15731986810782037
1288,0.2109,2,38,2,35735,569875,1561,106395,5.278770980769943,0.15732621586052908
1289,0.211,1,43,1,35778,569832,1562,106394,5.278372670347179,0.1573349738105308
1290,0.2111,5,101,5,35879,569731,1567,106389,5.277437104005336,0.15735224516358043
1291,0.2112,2,47,2,35926,569684,1569,106387,5.277001741450221,0.15736069140667178
1292,0.2113,0,53,0,35979,569631,1569,106387,5.27651080069658,0.15737302852882615
1293,0.2114,5,106,5,36085,569525,1574,106382,5.275528919189299,0.15739147545446341
1294,0.2115,2,42,2,36127,569483,1576,106380,5.275139871799622,0.15739876276701048
1295,0.2116,10,130,10,36257,569353,1586,106370,5.27393567749824,0.157416574543119
1296,0.2117,4,85,4,36342,569268,1590,106366,5.273148319685798,0.1574313903681579
1297,0.2118,7,171,7,36513,569097,1597,106359,5.271564341027826,0.1574625142126208
1298,0.2119,14,122,14,36635,568975,1611,106345,5.270434250991144,0.1574734940472665
1299,0.212,1,54,1,36689,568921,1612,106344,5.2699340472044165,0.15748483928531762
1300,0.2121,4,14,4,36703,568907,1616,106340,5.269804364741191,0.15748311358658387
1301,0.2122,2,53,2,36756,568854,1618,106338,5.26931342398755,0.15749297977464188
1302,0.2123,6,157,6,36913,568697,1624,106332,5.267859127792804,0.15752212127182685
1303,0.2124,3,67,3,36980,568630,1627,106329,5.267238504575938,0.15753401317709667
1304,0.2125,2,60,2,37040,568570,1629,106327,5.266682722590685,0.15754552176109837
1305,0.2126,4,14,4,37054,568556,1633,106323,5.26655304012746,0.15754379673986002
1306,0.2127,10,104,10,37158,568452,1643,106313,5.265589684686354,0.15755559342882336
1307,0.2128,2,43,2,37201,568409,1645,106311,5.265191374263589,0.1575631373013991
1308,0.2129,7,147,7,37348,568262,1652,106304,5.263829708399719,0.15758873112490104
1309,0.213,1,20,1,37368,568242,1653,106303,5.263644447737967,0.15759215471169455
1310,0.2131,4,83,4,37451,568159,1657,106299,5.2628756159917005,0.1576065522241563
1311,0.2132,6,61,6,37512,568098,1663,106293,5.2623105709733595,0.15761331334492898
1312,0.2133,4,80,4,37592,568018,1667,106289,5.261569528326355,0.15762701558785538
1313,0.2134,3,52,3,37644,567966,1670,106286,5.2610878506058025,0.15763542414408857
1314,0.2135,1,57,1,37701,567909,1671,106285,5.260559857719811,0.15764750205430483
1315,0.2136,2,53,2,37754,567856,1673,106283,5.260068916966171,0.15765739706499698
1316,0.2137,1,52,1,37806,567804,1674,106282,5.259587239245619,0.15766830938485593
1317,0.2138,7,140,7,37946,567664,1681,106275,5.258290414613361,0.1576923133992839
1318,0.2139,4,58,4,38004,567606,1685,106271,5.257753158694283,0.15770088606674512
1319,0.214,1,5,1,38009,567601,1686,106270,5.257706843528845,0.15770080623739557
1320,0.2141,4,149,4,38158,567452,1690,106266,5.256326651598799,0.15773068257045234
1321,0.2142,5,103,5,38261,567349,1695,106261,5.255372559190781,0.15774854886358575
1322,0.2143,1,28,1,38289,567321,1696,106260,5.25511319426433,0.1577538558837022
1323,0.2144,5,106,5,38395,567215,1701,106255,5.254131312757049,0.15777243232809182
1324,0.2145,13,129,13,38524,567086,1714,106242,5.252936381488754,0.15778639830810542
1325,0.2146,7,80,7,38604,567006,1721,106235,5.252195338841751,0.15779639089122618
1326,0.2147,4,73,4,38677,566933,1725,106231,5.251519137426359,0.15780849837483882
1327,0.2148,2,20,2,38697,566913,1727,106229,5.251333876764607,0.15781068481835928
1328,0.2149,11,160,11,38857,566753,1738,106218,5.249851791470599,0.15783443863108515
1329,0.215,8,147,8,39004,566606,1746,106210,5.248490125606729,0.1578589094195144
1330,0.2151,2,27,2,39031,566579,1748,106208,5.248240023713365,0.15786274110528295
1331,0.2152,9,134,9,39165,566445,1757,106199,5.246998777279632,0.1578829217238242
1332,0.2153,4,126,4,39291,566319,1761,106195,5.2458316351106005,0.1579074933756026
1333,0.2154,2,19,2,39310,566300,1763,106193,5.245655637481937,0.15790945035859108
1334,0.2155,8,126,8,39436,566174,1771,106185,5.244488495312905,0.1579290230368003
1335,0.2156,2,58,2,39494,566116,1773,106183,5.2439512393938275,0.15794014270436219
1336,0.2157,3,121,3,39615,565995,1776,106180,5.242830412390233,0.15796481571019452
1337,0.2158,3,25,3,39640,565970,1779,106177,5.242598836563044,0.15796693282868182
1338,0.2159,0,21,0,39661,565949,1779,106177,5.242404312868206,0.15797186836991872
1339,0.216,0,22,0,39683,565927,1779,106177,5.242200526140279,0.15797703926773238
1340,0.2161,1,24,1,39707,565903,1780,106176,5.241978213346178,0.1579814277785796
1341,0.2162,1,72,1,39779,565831,1781,106175,5.241311274963874,0.15799710121635818
1342,0.2163,0,47,0,39826,565784,1781,106175,5.240875912408759,0.1580081522831006
1343,0.2164,9,70,9,39896,565714,1790,106166,5.24022750009263,0.15801333571471096
1344,0.2165,2,69,2,39965,565645,1792,106164,5.239588350809589,0.15802705828591163
1345,0.2166,3,77,3,40042,565568,1795,106161,5.238875097261848,0.15804141253392365
1346,0.2167,2,9,2,40051,565559,1797,106159,5.23879172996406,0.15804102316746016
1347,0.2168,1,10,1,40061,565549,1798,106158,5.238699099633184,0.15804212253259234
1348,0.2169,5,106,5,40167,565443,1803,106153,5.237717218125903,0.15806079845621474
1349,0.217,1,48,1,40215,565395,1804,106152,5.237272592537701,0.1580708423982238
1350,0.2171,2,90,2,40305,565305,1806,106150,5.236438919559821,0.15808952200817628
1351,0.2172,2,32,2,40337,565273,1808,106148,5.236142502501019,0.15809454872576223
1352,0.2173,4,59,4,40396,565214,1812,106144,5.235595983548853,0.15810342618990167
1353,0.2174,3,58,3,40454,565156,1815,106141,5.2350587276297755,0.1581133239087915
1354,0.2175,8,139,8,40593,565017,1823,106133,5.233771166030605,0.15813603516352528
1355,0.2176,2,41,2,40634,564976,1825,106131,5.233391381674015,0.1581431873009818
1356,0.2177,6,127,6,40761,564849,1831,106125,5.232214976471896,0.15816559210938128
1357,0.2178,7,111,7,40872,564738,1838,106118,5.231186779799177,0.15818297816520982
1358,0.2179,3,43,3,40915,564695,1841,106115,5.230788469376413,0.15818935317004815
1359,0.218,10,75,10,40990,564620,1851,106105,5.230093741894846,0.15819449103581945
1360,0.2181,1,20,1,41010,564600,1852,106104,5.229908481233095,0.15819795319544835
1361,0.2182,6,65,6,41075,564535,1858,106098,5.229306384082404,0.1582057548614518
1362,0.2183,3,25,3,41100,564510,1861,106095,5.229074808255215,0.15820788690809046
1363,0.2184,3,44,3,41144,564466,1864,106092,5.228667234799363,0.15821450195210557
1364,0.2185,7,133,7,41277,564333,1871,106085,5.227435251398718,0.15823709983920478
1365,0.2186,4,74,4,41351,564259,1875,106081,5.226749786950239,0.15824954500701136
1366,0.2187,2,19,2,41370,564240,1877,106079,5.226573789321575,0.15825151905286886
1367,0.2188,2,91,2,41461,564149,1879,106077,5.225730853310608,0.15827049383342334
1368,0.2189,3,82,3,41543,564067,1882,106074,5.224971284597428,0.15828609203137847
1369,0.219,4,60,4,41603,564007,1886,106070,5.2244155026121755,0.1582952406962185
1370,0.2191,4,94,4,41697,563913,1890,106066,5.223544777501945,0.15831242471778967
1371,0.2192,1,20,1,41717,563893,1891,106065,5.223359516840194,0.15831589442920302
1372,0.2193,2,43,2,41760,563850,1893,106063,5.22296120641743,0.15832354350490288
1373,0.2194,5,86,5,41846,563764,1898,106058,5.2221645855719,0.1583375881950727
1374,0.2195,1,23,1,41869,563741,1899,106057,5.221951535810886,0.15834176871235806
1375,0.2196,1,54,1,41923,563687,1900,106056,5.221451332024158,0.15835327879500047
1376,0.2197,5,38,5,41961,563649,1905,106051,5.221099336766831,0.15835598028968195
1377,0.2198,10,110,10,42071,563539,1915,106041,5.2200804031272,0.15836942561008394
1378,0.2199,0,28,0,42099,563511,1915,106041,5.219821038200749,0.15837604846225536
1379,0.22,4,85,4,42184,563426,1919,106037,5.219033680388306,0.1583911284118764
1380,0.2201,2,27,2,42211,563399,1921,106035,5.218783578494943,0.1583950023452648
1381,0.2202,4,79,4,42290,563320,1925,106031,5.218051798881025,0.15840866750031
1382,0.2203,4,114,4,42404,563206,1929,106027,5.216995813109045,0.15843062132321628
1383,0.2204,2,28,2,42432,563178,1931,106025,5.216736448182593,0.15843473505050037
1384,0.2205,9,166,9,42598,563012,1940,106016,5.215198784690059,0.158462725027951
1385,0.2206,4,48,4,42646,562964,1944,106012,5.214754159101856,0.15846906316519577
1386,0.2207,2,102,2,42748,562862,1946,106010,5.213809329726926,0.15849071272231458
1387,0.2208,5,94,5,42842,562768,1951,106005,5.212938604616696,0.15850669808739287
1388,0.2209,2,38,2,42880,562730,1953,106003,5.212586609359368,0.158513188372639
1389,0.221,2,24,2,42904,562706,1955,106001,5.2123642965652675,0.15851636067814454
1390,0.2211,12,103,12,43007,562603,1967,105989,5.211410204157249,0.15852567784239116
1391,0.2212,3,101,3,43108,562502,1970,105986,5.210474637815406,0.15854585273034072
1392,0.2213,2,43,2,43151,562459,1972,105984,5.210076327392642,0.15855353410836825
1393,0.2214,5,139,5,43290,562320,1977,105979,5.2087887657934715,0.1585802163402908
1394,0.2215,8,137,8,43427,562183,1985,105971,5.2075197302604765,0.1586026574711818
1395,0.2216,2,70,2,43497,562113,1987,105969,5.206871317944348,0.15861675662568367
1396,0.2217,0,41,0,43538,562072,1987,105969,5.206491533587758,0.1586264914877979
1397,0.2218,1,59,1,43597,562013,1988,105968,5.205945014635592,0.158639242732952
1398,0.2219,6,68,6,43665,561945,1994,105962,5.205315128385639,0.15864783570167704
1399,0.222,4,28,4,43693,561917,1998,105958,5.205055763459187,0.15864944787572524
1400,0.2221,7,117,7,43810,561800,2005,105951,5.203971988587943,0.15866842580542748
1401,0.2222,4,64,4,43874,561736,2009,105947,5.20337915447034,0.1586785944827111
1402,0.2223,10,143,10,44017,561593,2019,105937,5.2020545407388195,0.15869998352133988
1403,0.2224,7,52,7,44069,561541,2026,105930,5.201572863018266,0.15870352419805506
1404,0.2225,0,41,0,44110,561500,2026,105930,5.201193078661677,0.15871327330206914
1405,0.2226,1,34,1,44144,561466,2027,105929,5.2008781355367,0.15872009829261532
1406,0.2227,4,91,4,44235,561375,2031,105925,5.200035199525733,0.15873670013487187
1407,0.2228,7,88,7,44323,561287,2038,105918,5.199220052614028,0.15874881033565397
1408,0.2229,2,59,2,44382,561228,2040,105916,5.198673533661863,0.15876032760543451
1409,0.223,3,55,3,44437,561173,2043,105913,5.198164066842047,0.15876963390027674
1410,0.2231,3,56,3,44493,561117,2046,105910,5.197645336989144,0.1587791798532893
1411,0.2232,8,173,8,44666,560944,2054,105902,5.196042832264997,0.15881028003467068
1412,0.2233,3,40,3,44706,560904,2057,105899,5.195672310941495,0.15881602212347576
1413,0.2234,3,61,3,44767,560843,2060,105896,5.195107265923154,0.1588267672957484
1414,0.2235,10,156,10,44923,560687,2070,105886,5.193662232761495,0.15885131861026475
1415,0.2236,4,59,4,44982,560628,2074,105882,5.19311571380933,0.15886033217806184
1416,0.2237,1,9,1,44991,560619,2075,105881,5.193032346511542,0.15886121530382596
1417,0.2238,0,14,0,45005,560605,2075,105881,5.192902664048316,0.15886455229367158
1418,0.2239,3,50,3,45055,560555,2078,105878,5.192439512393938,0.15887268487604905
1419,0.224,2,77,2,45132,560478,2080,105876,5.191726258846197,0.15888851871527745
1420,0.2241,3,65,3,45197,560413,2083,105873,5.191124161695505,0.15890023203249054
1421,0.2242,2,27,2,45224,560386,2085,105871,5.190874059802142,0.15890414659808452
1422,0.2243,7,153,7,45377,560233,2092,105864,5.189456815739746,0.1589318072292774
1423,0.2244,16,173,16,45550,560060,2108,105848,5.187854311015599,0.15895288838698438
1424,0.2245,7,133,7,45683,559927,2115,105841,5.186622327614955,0.15897579937756096
1425,0.2246,4,47,4,45730,559880,2119,105837,5.186186965059839,0.1589819698160029
1426,0.2247,1,9,1,45739,559871,2120,105836,5.1861035977620515,0.15898285582095426
1427,0.2248,1,67,1,45806,559804,2121,105835,5.185482974545185,0.15899759479237244
1428,0.2249,10,101,10,45907,559703,2131,105825,5.1845474082033425,0.1590090875214867
1429,0.225,1,62,1,45969,559641,2132,105824,5.183973100151913,0.15902263830554575
1430,0.2251,4,62,4,46031,559579,2136,105820,5.183398792100485,0.1590324001088069
1431,0.2252,5,44,5,46075,559535,2141,105815,5.182991218644633,0.15903659727962727
1432,0.2253,5,175,5,46250,559360,2146,105810,5.181370187854311,0.159072116902446
1433,0.2254,11,118,11,46368,559242,2157,105799,5.18027714994998,0.1590864322650784
1434,0.2255,6,211,6,46579,559031,2163,105793,5.178322649968505,0.15912933347773245
1435,0.2256,5,75,5,46654,558956,2168,105788,5.1776279224869395,0.1591409625359537
1436,0.2257,2,35,2,46689,558921,2170,105786,5.177303716328875,0.15914681205403283
1437,0.2258,11,104,11,46793,558817,2181,105775,5.176340360887769,0.15915779907070804
1438,0.2259,13,195,13,46988,558622,2194,105762,5.174534069435696,0.15918805991715634
1439,0.226,5,89,5,47077,558533,2199,105757,5.173709659490903,0.1592030589049963
1440,0.2261,6,68,6,47145,558465,2205,105751,5.17307977324095,0.15921176243872476
1441,0.2262,7,39,7,47184,558426,2212,105744,5.172718514950535,0.1592122498757848
1442,0.2263,2,72,2,47256,558354,2214,105742,5.172051576568231,0.15922697923191828
1443,0.2264,2,34,2,47290,558320,2216,105740,5.171736633443254,0.15923259946390386
1444,0.2265,7,95,7,47385,558225,2223,105733,5.170856645299937,0.15924651860509248
1445,0.2266,4,64,4,47449,558161,2227,105729,5.170263811182333,0.15925680459112201
1446,0.2267,3,66,3,47515,558095,2230,105726,5.169652450998555,0.15926883903943984
1447,0.2268,3,80,3,47595,558015,2233,105723,5.16891140835155,0.15928423564719815
1448,0.2269,9,158,9,47753,557857,2242,105714,5.167447849123717,0.15931075951179302
1449,0.227,6,80,6,47833,557777,2248,105708,5.1667068064767125,0.15932236599169536
1450,0.2271,7,106,7,47939,557671,2255,105701,5.165724924969432,0.1593389531062511
1451,0.2272,5,59,5,47998,557612,2260,105696,5.165178406017266,0.15934678912360473
1452,0.2273,3,39,3,48037,557573,2263,105693,5.164817147726851,0.15935235636984257
1453,0.2274,4,27,4,48064,557546,2267,105689,5.164567045833488,0.15935377354934527
1454,0.2275,6,114,6,48178,557432,2273,105683,5.163511060061507,0.15937356265504474
1455,0.2276,1,17,1,48195,557415,2274,105682,5.163353588499018,0.15937638083116046
1456,0.2277,8,236,8,48431,557179,2282,105674,5.161167512690355,0.15942297915224038
1457,0.2278,1,36,1,48467,557143,2283,105673,5.160834043499204,0.15943036981605754
1458,0.2279,1,40,1,48507,557103,2284,105672,5.160463522175701,0.15943872354871563
1459,0.228,16,155,16,48662,556948,2300,105656,5.15902775204713,0.15945572317704088
1460,0.2281,4,38,4,48700,556910,2304,105652,5.158675756789803,0.1594597939513585
1461,0.2282,19,298,19,48998,556612,2323,105633,5.155915372929712,0.15950743304970216
1462,0.2283,1,56,1,49054,556556,2324,105632,5.155396643076809,0.15951965302904916
1463,0.2284,12,167,12,49221,556389,2336,105620,5.153849716551187,0.15954465875841567
1464,0.2285,5,41,5,49262,556348,2341,105615,5.153469932194597,0.15954819227056496
1465,0.2286,3,78,3,49340,556270,2344,105612,5.152747415613769,0.15956318497859134
1466,0.2287,18,192,18,49532,556078,2362,105594,5.150968913260958,0.15958662297936138
1467,0.2288,4,139,4,49671,555939,2366,105590,5.149681351661788,0.15961507356442423
1468,0.2289,7,144,7,49815,555795,2373,105583,5.1483474748971805,0.15964093150966618
1469,0.229,6,56,6,49871,555739,2379,105577,5.1478287450442775,0.15964682542082756
1470,0.2291,2,40,2,49911,555699,2381,105575,5.1474582237207755,0.15965394072653696
1471,0.2292,11,182,11,50093,555517,2392,105564,5.14577235169884,0.15968391165379128
1472,0.2293,1,39,1,50132,555478,2393,105563,5.145411093408426,0.15969206146063558
1473,0.2294,2,42,2,50174,555436,2395,105561,5.145022046018749,0.15969966580786296
1474,0.2295,4,75,4,50249,555361,2399,105557,5.144327318537182,0.15971270263482004
1475,0.2296,2,27,2,50276,555334,2401,105555,5.144077216643818,0.15971668464749753
1476,0.2297,5,71,5,50347,555263,2406,105550,5.143419541294602,0.15972748720137164
1477,0.2298,11,185,11,50532,555078,2417,105539,5.141705880173404,0.159758226022037
1478,0.2299,7,105,7,50637,554973,2424,105532,5.140733261699211,0.15977471782953953
1479,0.23,2,54,2,50691,554919,2426,105530,5.140233057912483,0.15978523701300176
1480,0.2301,1,18,1,50709,554901,2427,105529,5.140066323316907,0.1597883197310843
1481,0.2302,7,78,7,50787,554823,2434,105522,5.139343806736077,0.15979828725893283
1482,0.2303,7,122,7,50909,554701,2441,105515,5.138213716699396,0.15981890775140256
1483,0.2304,7,134,7,51043,554567,2448,105508,5.136972470265664,0.15984244214672574
1484,0.2305,9,126,9,51169,554441,2457,105499,5.135805328096632,0.15986150256083886
1485,0.2306,5,74,5,51243,554367,2462,105494,5.1351198636481525,0.159873064175637
1486,0.2307,2,31,2,51274,554336,2464,105492,5.134832709622438,0.15987802881963178
1487,0.2308,4,30,4,51304,554306,2468,105488,5.1345548186298124,0.15988020503369232
1488,0.2309,1,23,1,51327,554283,2469,105487,5.134341768868798,0.1598845052063598
1489,0.231,2,55,2,51382,554228,2471,105485,5.133832302048983,0.15989528779939155
1490,0.2311,10,116,10,51498,554112,2481,105475,5.132757790210826,0.15991067137466325
1491,0.2312,7,104,7,51602,554008,2488,105468,5.131794434769721,0.15992697232348108
1492,0.2313,6,67,6,51669,553941,2494,105462,5.131173811552855,0.1599355780910915
1493,0.2314,4,48,4,51717,553893,2498,105458,5.130729185964652,0.15994212490767437
1494,0.2315,4,135,4,51852,553758,2502,105454,5.129478676497833,0.15996978210348112
1495,0.2316,4,68,4,51920,553690,2506,105450,5.128848790247879,0.1599811876080954
1496,0.2317,2,69,2,51989,553621,2508,105448,5.128209640964838,0.1599953874328788
1497,0.2318,6,108,6,52097,553513,2514,105442,5.1272092333913815,0.16001396149964717
1498,0.2319,6,90,6,52187,553423,2520,105436,5.126375560413502,0.16002816991192348
1499,0.232,0,32,0,52219,553391,2520,105436,5.1260791433547,0.16003594266780202
1500,0.2321,13,121,13,52340,553270,2533,105423,5.124958316351106,0.16004876323264403
1501,0.2322,3,18,3,52358,553252,2536,105420,5.12479158175553,0.16004931134160857
1502,0.2323,10,211,10,52569,553041,2546,105410,5.1228370817740565,0.16008784252738625
1503,0.2324,6,70,6,52639,552971,2552,105404,5.122188669457928,0.16009720903740268
1504,0.2325,3,47,3,52686,552924,2555,105401,5.1217533069028125,0.16010481145330954
1505,0.2326,0,15,0,52701,552909,2555,105401,5.121614361406499,0.16010845954033814
1506,0.2327,1,19,1,52720,552890,2556,105400,5.121438363777836,0.16011180482765955
1507,0.2328,2,41,2,52761,552849,2558,105398,5.121058579421246,0.16011922576175813
1508,0.2329,1,110,1,52871,552739,2559,105397,5.120039645781615,0.1601447117313139
1509,0.233,5,100,5,52971,552639,2564,105392,5.119113342472859,0.1601626671083885
1510,0.2331,4,61,4,53032,552578,2568,105388,5.1185482974545184,0.1601724101245353
1511,0.2332,6,41,6,53073,552537,2574,105382,5.118168513097928,0.16017473275585598
1512,0.2333,15,103,15,53176,552434,2589,105367,5.117214420689911,0.16018066254079882
1513,0.2334,1,31,1,53207,552403,2590,105366,5.116927266664197,0.16018693492700325
1514,0.2335,3,59,3,53266,552344,2593,105363,5.11638074771203,0.1601974739511667
1515,0.2336,0,10,0,53276,552334,2593,105363,5.116288117381155,0.16019990968485487
1516,0.2337,4,30,4,53306,552304,2597,105359,5.1160102263885285,0.16020210959108236
1517,0.2338,2,55,2,53361,552249,2599,105357,5.115500759568713,0.16021295426136622
1518,0.2339,1,43,1,53404,552206,2600,105356,5.115102449145948,0.1602221539565851
1519,0.234,7,136,7,53540,552070,2607,105349,5.113842676646041,0.160246357345924
1520,0.2341,1,34,1,53574,552036,2608,105348,5.113527733521064,0.1602533678945639
1521,0.2342,3,139,3,53713,551897,2611,105345,5.112240171921894,0.1602834268047386
1522,0.2343,3,50,3,53763,551847,2614,105342,5.111777020267517,0.16029178820704545
1523,0.2344,6,73,6,53836,551774,2620,105336,5.111100818852125,0.16030192813988525
1524,0.2345,5,52,5,53888,551722,2625,105331,5.110619141131572,0.16030822475508064
1525,0.2346,2,42,2,53930,551680,2627,105329,5.110230093741895,0.1603159165247356
1526,0.2347,2,109,2,54039,551571,2629,105327,5.109220423135351,0.1603399614552031
1527,0.2348,6,138,6,54177,551433,2635,105321,5.107942124569269,0.1603659817831334
1528,0.2349,8,102,8,54279,551331,2643,105313,5.106997295194338,0.1603806628858255
1529,0.235,7,149,7,54428,551182,2650,105306,5.105617103264293,0.16040811103934877
1530,0.2351,2,22,2,54450,551160,2652,105304,5.105413316536366,0.16041092885519997
1531,0.2352,2,34,2,54484,551126,2654,105302,5.10509837341139,0.160416679361636
1532,0.2353,4,35,4,54519,551091,2658,105298,5.104774167253326,0.16042011672956127
1533,0.2354,9,113,9,54632,550978,2667,105289,5.103727444514432,0.16043622489017428
1534,0.2355,4,80,4,54712,550898,2671,105285,5.102986401867428,0.16045066696333188
1535,0.2356,0,12,0,54724,550886,2671,105285,5.1028752454703765,0.16045360127161976
1536,0.2357,22,216,22,54940,550670,2693,105263,5.100874430323465,0.1604782805560934
1537,0.2358,13,132,13,55072,550538,2706,105250,5.099651709955908,0.1604939401147932
1538,0.2359,7,142,7,55214,550396,2713,105243,5.098336359257475,0.16051973723344706
1539,0.236,5,88,5,55302,550308,2718,105238,5.097521212345771,0.1605348823728617
1540,0.2361,2,23,2,55325,550285,2720,105236,5.097308162584757,0.16053795378027555
1541,0.2362,9,164,9,55489,550121,2729,105227,5.095789025158398,0.16056659973021967
1542,0.2363,2,91,2,55580,550030,2731,105225,5.09494608914743,0.16058633661704222
1543,0.2364,5,73,5,55653,549957,2736,105220,5.094269887732039,0.16059782318365876
1544,0.2365,3,49,3,55702,549908,2739,105217,5.093815999110749,0.16060599122304903
1545,0.2366,1,17,1,55719,549891,2740,105216,5.093658527548261,0.16060887763373005
1546,0.2367,6,140,6,55859,549751,2746,105210,5.092361702916003,0.1606355187560786
1547,0.2368,2,9,2,55868,549742,2748,105208,5.092278335618214,0.1606351629895412
1548,0.2369,12,209,12,56077,549533,2760,105196,5.090342361702916,0.16067105626908232
1549,0.237,2,26,2,56103,549507,2762,105194,5.090101522842639,0.16067487295727362
1550,0.2371,5,106,5,56209,549401,2767,105189,5.089119641335359,0.16069448051452054
1551,0.2372,1,23,1,56232,549378,2768,105188,5.088906591574345,0.16069884473070706
1552,0.2373,3,75,3,56307,549303,2771,105185,5.088211864092779,0.16071341262177458
1553,0.2374,0,19,0,56326,549284,2771,105185,5.088035866464115,0.16071807831998156
1554,0.2375,9,199,9,56525,549085,2780,105176,5.086192522879692,0.1607554171806053
1555,0.2376,10,116,10,56641,548969,2790,105166,5.085118011041535,0.16077109465171563
1556,0.2377,2,18,2,56659,548951,2792,105164,5.08495127644596,0.1607729527682441
1557,0.2378,0,21,0,56680,548930,2792,105164,5.084756752751121,0.1607781144606127
1558,0.2379,7,156,7,56836,548774,2799,105157,5.083311719589462,0.16080748580507728
1559,0.238,6,100,6,56936,548674,2805,105151,5.082385416280707,0.16082437961228158
1560,0.2381,3,57,3,56993,548617,2808,105148,5.081857423394716,0.1608345506412855
1561,0.2382,9,151,9,57144,548466,2817,105139,5.080458705398495,0.16086015253861277
1562,0.2383,1,102,1,57246,548364,2818,105138,5.079513876023565,0.16088397587153522
1563,0.2384,1,40,1,57286,548324,2819,105137,5.079143354700063,0.16089253987613644
1564,0.2385,15,211,15,57497,548113,2834,105122,5.077188854718589,0.16092524129907307
1565,0.2386,3,60,3,57557,548053,2837,105119,5.076633072733336,0.16093616995217186
1566,0.2387,4,98,4,57655,547955,2841,105115,5.075725295490756,0.16095518091475647
1567,0.2388,5,86,5,57741,547869,2846,105110,5.074928674645226,0.1609699546233493
1568,0.2389,13,189,13,57930,547680,2859,105097,5.073177961391678,0.16099985140407827
1569,0.239,8,104,8,58034,547576,2867,105089,5.072214605950572,0.1610152222043468
1570,0.2391,5,54,5,58088,547522,2872,105084,5.0717144021638445,0.16102211747976575
1571,0.2392,5,79,5,58167,547443,2877,105079,5.070982622549928,0.1610351834880663
1572,0.2393,2,41,2,58208,547402,2879,105077,5.070602838193338,0.16104273087716234
1573,0.2394,2,85,2,58293,547317,2881,105075,5.069815480380896,0.16106114115439796
1574,0.2395,2,54,2,58347,547263,2883,105073,5.069315276594168,0.16107190159672316
1575,0.2396,5,96,5,58443,547167,2888,105068,5.068426025417763,0.16108917798032918
1576,0.2397,3,43,3,58486,547124,2891,105065,5.068027714994998,0.16109593998058844
1577,0.2398,8,117,8,58603,547007,2899,105057,5.066943940123754,0.1611145531726947
1578,0.2399,5,111,5,58714,546896,2904,105052,5.065915743451035,0.16113555068809168
1579,0.24,16,280,16,58994,546616,2920,105036,5.06332209418652,0.16118419033471854
1580,0.2401,3,88,3,59082,546528,2923,105033,5.062506947274816,0.161202097731448
1581,0.2402,2,39,2,59121,546489,2925,105031,5.062145688984401,0.1612091723968566
1582,0.2403,2,62,2,59183,546427,2927,105029,5.061571380932973,0.16122193977797425
1583,0.2404,1,15,1,59198,546412,2928,105028,5.061432435436659,0.1612243644848336
1584,0.2405,1,29,1,59227,546383,2929,105027,5.06116380747712,0.1612302543712869
1585,0.2406,6,128,6,59355,546255,2935,105021,5.059978139241913,0.1612542148029407
1586,0.2407,2,35,2,59390,546220,2937,105019,5.059653933083849,0.16126030535640526
1587,0.2408,13,224,13,59614,545996,2950,105006,5.057579013672237,0.16129904362813016
1588,0.2409,3,55,3,59669,545941,2953,105003,5.057069546852421,0.16130880690197621
1589,0.241,2,58,2,59727,545883,2955,105001,5.056532290933343,0.1613206039785891
1590,0.2411,1,14,1,59741,545869,2956,105000,5.056402608470117,0.16132278538384837
1591,0.2412,6,142,6,59883,545727,2962,104994,5.055087257771684,0.1613502561005408
1592,0.2413,5,147,5,60030,545580,2967,104989,5.053725591907814,0.16138026865712937
1593,0.2414,3,48,3,60078,545532,2970,104986,5.053280966319612,0.16138830900912812
1594,0.2415,8,154,8,60232,545378,2978,104978,5.051854459224129,0.1614162089686264
1595,0.2416,8,67,8,60299,545311,2986,104970,5.051233836007262,0.16142252349368966
1596,0.2417,5,54,5,60353,545257,2991,104965,5.050733632220535,0.16142948100802496
1597,0.2418,12,156,12,60509,545101,3003,104953,5.049288599058876,0.16145274084922176
1598,0.2419,9,141,9,60650,544960,3012,104944,5.04798251139353,0.16147615647849528
1599,0.242,1,17,1,60667,544943,3013,104943,5.047825039831042,0.16147909017889292
1600,0.2421,4,51,4,60718,544892,3017,104939,5.047352625143577,0.16148660190110967
1601,0.2422,5,53,5,60771,544839,3022,104934,5.0468616843899365,0.16149332151382098
1602,0.2423,6,115,6,60886,544724,3028,104928,5.045796435584868,0.1615141645065358
1603,0.2424,3,41,3,60927,544683,3031,104925,5.045416651228278,0.16152048620090886
1604,0.2425,8,49,8,60976,544634,3039,104917,5.044962762606988,0.16152234389601433
1605,0.2426,4,107,4,61083,544527,3043,104913,5.04397161806662,0.16154379157427937
1606,0.2427,5,74,5,61157,544453,3048,104908,5.043286153618141,0.16155574480142787
1607,0.2428,8,94,8,61251,544359,3056,104900,5.042415428507911,0.1615688038209713
1608,0.2429,0,23,0,61274,544336,3056,104900,5.042202378746897,0.1615745275985928
1609,0.243,7,102,7,61376,544234,3063,104893,5.0412575493719665,0.161590875129212
1610,0.2431,6,89,6,61465,544145,3069,104887,5.040433139427174,0.1616052829444465
1611,0.2432,6,76,6,61541,544069,3075,104881,5.03972914891252,0.16161645735418753
1612,0.2433,0,33,0,61574,544036,3075,104881,5.0394234688206305,0.16162467619125404
1613,0.2434,12,210,12,61784,543826,3087,104869,5.037478231872244,0.16166148960605523
1614,0.2435,13,197,13,61981,543629,3100,104856,5.035653414353996,0.1616937939967771
1615,0.2436,9,111,9,62092,543518,3109,104847,5.034625217681278,0.1617098393651724
1616,0.2437,2,31,2,62123,543487,3111,104845,5.0343380636555635,0.16171498553210392
1617,0.2438,8,68,8,62191,543419,3119,104837,5.03370817740561,0.16172160381084016
1618,0.2439,1,50,1,62241,543369,3120,104836,5.033245025751232,0.16173278515284517
1619,0.244,4,79,4,62320,543290,3124,104832,5.032513246137315,0.1617473253492398
1620,0.2441,3,28,3,62348,543262,3127,104829,5.032253881210863,0.1617504331953383
1621,0.2442,5,102,5,62450,543160,3132,104824,5.031309051835933,0.16176942640559025
1622,0.2443,4,34,4,62484,543126,3136,104820,5.030994108710956,0.16177274032095268
1623,0.2444,9,161,9,62645,542965,3145,104811,5.02950276038386,0.16180130168453294
1624,0.2445,7,151,7,62796,542814,3152,104804,5.028104042387639,0.16182996766612417
1625,0.2446,1,52,1,62848,542762,3153,104803,5.027622364667087,0.161841668403944
1626,0.2447,8,60,8,62908,542702,3161,104795,5.027066582681833,0.16184630971263186
1627,0.2448,4,104,4,63012,542598,3165,104791,5.0261032272407276,0.161867130890392
1628,0.2449,1,34,1,63046,542564,3166,104790,5.025788284115751,0.1618743376884981
1629,0.245,8,123,8,63169,542441,3174,104782,5.024648931045982,0.16189474107069743
1630,0.2451,1,31,1,63200,542410,3175,104781,5.0243617770202675,0.1619012007274514
1631,0.2452,10,61,10,63261,542349,3185,104771,5.023796732001927,0.16190351094078378
1632,0.2453,9,70,9,63331,542279,3194,104762,5.023148319685798,0.1619093689580722
1633,0.2454,2,49,2,63380,542230,3196,104760,5.022694431064508,0.1619190404797601
1634,0.2455,4,73,4,63453,542157,3200,104756,5.022018229649117,0.16193212997729214
1635,0.2456,10,181,10,63634,541976,3210,104746,5.020341620660269,0.16196449169813304
1636,0.2457,1,29,1,63663,541947,3211,104745,5.0200729927007295,0.1619704588892394
1637,0.2458,13,145,13,63808,541802,3224,104732,5.018729852903035,0.1619899340173912
1638,0.2459,3,51,3,63859,541751,3227,104729,5.018257438215569,0.16199882440292043
1639,0.246,3,58,3,63917,541693,3230,104726,5.017720182296491,0.1620094706374658
1640,0.2461,3,37,3,63954,541656,3233,104723,5.017377450072251,0.16201485506181357
1641,0.2462,4,136,4,64090,541520,3237,104719,5.016117677572344,0.16204376399443549
1642,0.2463,1,31,1,64121,541489,3238,104718,5.01583052354663,0.16205024086709058
1643,0.2464,4,101,4,64222,541388,3242,104714,5.014894957204787,0.16207038517138161
1644,0.2465,4,25,4,64247,541363,3246,104710,5.0146633813775985,0.16207146870400094
1645,0.2466,8,142,8,64389,541221,3254,104702,5.013348030679166,0.1620967205069335
1646,0.2467,8,132,8,64521,541089,3262,104694,5.012125310311609,0.16211947356929496
1647,0.2468,2,72,2,64593,541017,3264,104692,5.011458371929304,0.16213495552950322
1648,0.2469,3,45,3,64638,540972,3267,104689,5.011041535440365,0.1621423626330226
1649,0.247,2,45,2,64683,540927,3269,104687,5.010624698951425,0.16215106859516676
1650,0.2471,3,69,3,64752,540858,3272,104684,5.009985549668383,0.16216450672458183
1651,0.2472,5,112,5,64864,540746,3277,104679,5.008948089962577,0.162186156408568
1652,0.2473,2,77,2,64941,540669,3279,104677,5.008234836414836,0.16220291130649295
1653,0.2474,2,68,2,65009,540601,3281,104675,5.007604950164882,0.16221740774490295
1654,0.2475,4,76,4,65085,540525,3285,104671,5.006900959650228,0.16223132195487883
1655,0.2476,10,135,10,65220,540390,3295,104661,5.005650450183408,0.16225228702846753
1656,0.2477,8,170,8,65390,540220,3303,104653,5.004075734558524,0.1622846669034058
1657,0.2478,3,113,3,65503,540107,3306,104650,5.00302901181963,0.1623092110671152
1658,0.2479,8,148,8,65651,539959,3314,104642,5.001658082922672,0.16233608076934414
1659,0.248,15,282,15,65933,539677,3329,104627,4.999045907591982,0.16238763068365245
1660,0.2481,2,81,2,66014,539596,3331,104625,4.99829560191189,0.16240544781992514
1661,0.2482,5,152,5,66166,539444,3336,104620,4.996887620882582,0.16243727331445323
1662,0.2483,6,60,6,66226,539384,3342,104614,4.996331838897328,0.1624446038652294
1663,0.2484,8,155,8,66381,539229,3350,104606,4.994896068768758,0.16247330449571706
1664,0.2485,6,51,6,66432,539178,3356,104600,4.9944236540812925,0.16247836987284436
1665,0.2486,4,102,4,66534,539076,3360,104596,4.9934788247063615,0.16249891248959097
1666,0.2487,8,133,8,66667,538943,3368,104588,4.992246841305717,0.16252208518315356
1667,0.2488,0,103,0,66770,538840,3368,104588,4.991292748897699,0.1625481017301081
1668,0.2489,10,104,10,66874,538736,3378,104578,4.9903293934565935,0.16256136194766474
1669,0.249,13,205,13,67079,538531,3391,104565,4.988430471673645,0.16259625312550538
1670,0.2491,5,156,5,67235,538375,3396,104560,4.9869854385119865,0.1626291926866635
1671,0.2492,3,56,3,67291,538319,3399,104557,4.9864667086590835,0.16263945146497924
1672,0.2493,4,49,4,67340,538270,3403,104553,4.986012820037793,0.16264663834368093
1673,0.2494,1,37,1,67377,538233,3404,104552,4.985670087813554,0.16265469791609946
1674,0.2495,4,69,4,67446,538164,3408,104548,4.985030938530512,0.16266694880444119
1675,0.2496,6,120,6,67566,538044,3414,104542,4.983919374560006,0.1626895077079177
1676,0.2497,16,153,16,67719,537891,3430,104526,4.98250213049761,0.1627074003334283
1677,0.2498,9,123,9,67842,537768,3439,104517,4.981362777427841,0.16272682687591958
1678,0.2499,3,59,3,67901,537709,3442,104514,4.980816258475675,0.16273786519635702
1679,0.25,4,65,4,67966,537644,3446,104510,4.980214161324985,0.16274912248463763
1680,0.2501,2,42,2,68008,537602,3448,104508,4.979825113935307,0.16275715998816404
1681,0.2502,7,48,7,68056,537554,3455,104501,4.979380488347104,0.1627601996713677
1682,0.2503,8,52,8,68108,537502,3463,104493,4.978898810626552,0.1627629498672108
1683,0.2504,3,45,3,68153,537457,3466,104490,4.978481974137612,0.1627704467814321
1684,0.2505,8,132,8,68285,537325,3474,104482,4.977259253770055,0.16279348776189728
1685,0.2506,9,84,9,68369,537241,3483,104473,4.9764811589907,0.16280305556681013
1686,0.2507,6,60,6,68429,537181,3489,104467,4.975925377005447,0.16281045058973145
1687,0.2508,8,78,8,68507,537103,3497,104459,4.975202860424617,0.16281980541241534
1688,0.2509,4,50,4,68557,537053,3501,104455,4.974739708770239,0.16282727573155753
1689,0.251,0,29,0,68586,537024,3501,104455,4.974471080810701,0.16283463683144733
1690,0.2511,9,217,9,68803,536807,3510,104446,4.972461002630701,0.16287799043435275
1691,0.2512,4,113,4,68916,536694,3514,104442,4.971414279891808,0.1629014748820843
1692,0.2513,6,134,6,69050,536560,3520,104436,4.970173033458075,0.16292769377656022
1693,0.2514,2,51,2,69101,536509,3522,104434,4.96970061877061,0.16293804597288683
1694,0.2515,5,88,5,69189,536421,3527,104429,4.968885471858905,0.1629538893656862
1695,0.2516,1,33,1,69222,536388,3528,104428,4.9685797917670165,0.1629609747571846
1696,0.2517,9,149,9,69371,536239,3537,104419,4.96719959983697,0.1629871163709811
1697,0.2518,9,123,9,69494,536116,3546,104410,4.966060246767201,0.16300665390632074
1698,0.2519,4,100,4,69594,536016,3550,104406,4.965133943458446,0.16302687915155945
1699,0.252,6,53,6,69647,535963,3556,104400,4.964643002704806,0.16303252998689804
1700,0.2521,5,77,5,69724,535886,3561,104395,4.963929749157064,0.16304560029112217
1701,0.2522,3,22,3,69746,535864,3564,104392,4.963725962429137,0.16304728108756497
1702,0.2523,2,51,2,69797,535813,3566,104390,4.963253547741672,0.1630576551500071
1703,0.2524,9,110,9,69907,535703,3575,104381,4.962234614102042,0.16307390904943725
1704,0.2525,4,92,4,69999,535611,3579,104377,4.961382415057987,0.16309212047725896
1705,0.2526,6,112,6,70111,535499,3585,104371,4.960344955352181,0.16311281979152015
1706,0.2527,12,121,12,70232,535378,3597,104359,4.959224128348587,0.16312797290136416
1707,0.2528,5,109,5,70341,535269,3602,104354,4.958214457742043,0.16314923009335186
1708,0.2529,7,87,7,70428,535182,3609,104347,4.957408573863426,0.16316226472919915
1709,0.253,13,171,13,70599,535011,3622,104334,4.9558245952054545,0.16318888862820544
1710,0.2531,9,132,9,70731,534879,3631,104325,4.954601874837897,0.16321080593988774
1711,0.2532,11,168,11,70899,534711,3642,104314,4.9530456852791875,0.16323930988615468
1712,0.2533,13,170,13,71069,534541,3655,104301,4.951470969654304,0.1632657214146847
1713,0.2534,9,93,9,71162,534448,3664,104292,4.950609507577161,0.16327770297773742
1714,0.2535,6,98,6,71260,534350,3670,104286,4.9497017303345805,0.16329489724976357
1715,0.2536,5,68,5,71328,534282,3675,104281,4.949071844084627,0.16330573490791042
1716,0.2537,1,55,1,71383,534227,3676,104280,4.948562377264811,0.16331849141826166
1717,0.2538,11,182,11,71565,534045,3687,104269,4.9468765052428765,0.16335063934051267
1718,0.2539,4,59,4,71624,533986,3691,104265,4.946329986290711,0.16336049610576403
1719,0.254,5,109,5,71733,533877,3696,104260,4.945320315684167,0.1633818443375012
1720,0.2541,8,58,8,71791,533819,3704,104252,4.94478305976509,0.16338620623723693
1721,0.2542,4,37,4,71828,533782,3708,104248,4.94444032754085,0.1633904361863862
1722,0.2543,14,191,14,72019,533591,3722,104234,4.942671088221127,0.163421001058284
1723,0.2544,6,95,6,72114,533496,3728,104228,4.941791100077809,0.16343747451875734
1724,0.2545,10,74,10,72188,533422,3738,104218,4.941105635629331,0.16344332225079983
1725,0.2546,8,55,8,72243,533367,3746,104210,4.940596168809515,0.1634469248420191
1726,0.2547,5,66,5,72309,533301,3751,104205,4.939984808625736,0.16345728510790486
1727,0.2548,2,74,2,72383,533227,3753,104203,4.9392993441772575,0.1634736363208509
1728,0.2549,2,40,2,72423,533187,3755,104201,4.938928822853756,0.1634812704349627
1729,0.255,5,42,5,72465,533145,3760,104196,4.938539775464078,0.16348548108469407
1730,0.2551,3,16,3,72481,533129,3763,104193,4.938391566934677,0.1634856477573346
1731,0.2552,7,161,7,72642,532968,3770,104186,4.9369002186075805,0.16351776807490812
1732,0.2553,2,39,2,72681,532929,3772,104184,4.936538960317166,0.16352515173917342
1733,0.2554,13,151,13,72832,532778,3785,104171,4.935140242320945,0.16354684597981942
1734,0.2555,1,59,1,72891,532719,3786,104170,4.9345937233687795,0.1635606832587782
1735,0.2556,0,37,0,72928,532682,3786,104170,4.93425099114454,0.16357018585165783
1736,0.2557,9,112,9,73040,532570,3795,104161,4.933213531438734,0.16358713491254548
1737,0.2558,5,61,5,73101,532509,3800,104156,4.932648486420393,0.1635962397807324
1738,0.2559,3,42,3,73143,532467,3803,104153,4.932259439030716,0.1636030913260658
1739,0.256,4,151,4,73294,532316,3807,104149,4.930860721034495,0.1636366493051464
1740,0.2561,11,232,11,73526,532084,3818,104138,4.928711697358183,0.16368185947672353
1741,0.2562,4,98,4,73624,531986,3822,104134,4.927803920115602,0.1637018172671823
1742,0.2563,6,182,6,73806,531804,3828,104128,4.9261180480936675,0.16374077731581363
1743,0.2564,10,98,10,73904,531706,3838,104118,4.925210270851087,0.16375286242733839
1744,0.2565,6,73,6,73977,531633,3844,104112,4.924534069435696,0.16376377321095723
1745,0.2566,7,66,7,74043,531567,3851,104105,4.923922709251918,0.16377156772675217
1746,0.2567,4,36,4,74079,531531,3855,104101,4.923589240060766,0.16377558083922772
1747,0.2568,5,40,5,74119,531491,3860,104096,4.923218718737263,0.16377930952017583
1748,0.2569,9,72,9,74191,531419,3869,104087,4.92255178035496,0.16378602247657773
1749,0.257,7,67,7,74258,531352,3876,104080,4.9219311571380935,0.16379408024776845
1750,0.2571,10,132,10,74390,531220,3886,104070,4.9207084367705365,0.16381495065245794
1751,0.2572,3,85,3,74475,531135,3889,104067,4.919921078958094,0.16383292244042053
1752,0.2573,5,71,5,74546,531064,3894,104062,4.919263403608878,0.16384465444651927
1753,0.2574,3,88,3,74634,530976,3897,104059,4.918448256697173,0.16386340910343525
1754,0.2575,6,80,6,74714,530896,3903,104053,4.917707214050169,0.16387615383282753
1755,0.2576,6,78,6,74792,530818,3909,104047,4.916984697469339,0.1638883857197987
1756,0.2577,3,30,3,74822,530788,3912,104044,4.9167068064767125,0.16389217934823702
1757,0.2578,11,146,11,74968,530642,3923,104033,4.91535440364593,0.16391538976641587
1758,0.2579,7,59,7,75027,530583,3930,104026,4.914807884693764,0.16392140672445554
1759,0.258,2,78,2,75105,530505,3932,104024,4.914085368112935,0.16393892162533155
1760,0.2581,10,122,10,75227,530383,3942,104014,4.912955278076253,0.1639572696592197
1761,0.2582,11,146,11,75373,530237,3953,104003,4.91160287524547,0.16398051210898082
1762,0.2583,0,25,0,75398,530212,3953,104003,4.911371299418281,0.16398697602548032
1763,0.2584,2,56,2,75454,530156,3955,104001,4.910852569565378,0.16399882048136344
1764,0.2585,5,86,5,75540,530070,3960,103996,4.910055948719849,0.16401447167960434
1765,0.2586,12,160,12,75700,529910,3972,103984,4.90857386342584,0.16404004455003518
1766,0.2587,4,64,4,75764,529846,3976,103980,4.907981029308237,0.1640513327001417
1767,0.2588,4,50,4,75814,529796,3980,103976,4.907517877653859,0.16405899913533573
1768,0.2589,9,178,9,75992,529618,3989,103967,4.905869057764274,0.16409321559064688
1769,0.259,15,227,15,76219,529391,4004,103952,4.9037663492534,0.16413223166593774
1770,0.2591,6,69,6,76288,529322,4010,103946,4.903127199970358,0.16414219572124283
1771,0.2592,2,47,2,76335,529275,4012,103944,4.902691837415243,0.16415173897182492
1772,0.2593,6,115,6,76450,529160,4018,103938,4.901626588610174,0.1641736350454432
1773,0.2594,6,131,6,76581,529029,4024,103932,4.900413131275705,0.16419969002829557
1774,0.2595,7,135,7,76716,528894,4031,103925,4.899162621808885,0.16422547363464118
1775,0.2596,9,86,9,76802,528808,4040,103916,4.898366000963356,0.1642359069673349
1776,0.2597,9,170,9,76972,528638,4049,103907,4.896791285338471,0.1642681548348339
1777,0.2598,4,62,4,77034,528576,4053,103903,4.896216977287043,0.16427897210816486
1778,0.2599,12,202,12,77236,528374,4065,103891,4.8943458446033565,0.16431559551770222
1779,0.26,5,108,5,77344,528266,4070,103886,4.893345437029901,0.16433705817588176
1780,0.2601,2,52,2,77396,528214,4072,103884,4.892863759309348,0.16434793339007558
1781,0.2602,11,228,11,77624,527986,4083,103873,4.890751787765386,0.16439268887520792
1782,0.2603,5,47,5,77671,527939,4088,103868,4.890316425210271,0.1643983051786384
1783,0.2604,2,45,2,77716,527894,4090,103866,4.889899588721331,0.16440736988729898
1784,0.2605,2,49,2,77765,527845,4092,103864,4.88944570010004,0.16441747703452064
1785,0.2606,5,70,5,77835,527775,4097,103859,4.888797287783912,0.1644290839315173
1786,0.2607,2,34,2,77869,527741,4099,103857,4.888482344658935,0.16443528953543235
1787,0.2608,2,38,2,77907,527703,4101,103855,4.888130349401608,0.16444253734415526
1788,0.2609,0,11,0,77918,527692,4101,103855,4.888028456037645,0.16444540152989406
1789,0.261,3,54,3,77972,527638,4104,103852,4.887528252250917,0.1644554941487593
1790,0.2611,2,68,2,78040,527570,4106,103850,4.886898366000963,0.16447055842387
1791,0.2612,10,92,10,78132,527478,4116,103840,4.886046166956908,0.1644812915202798
1792,0.2613,5,66,5,78198,527412,4121,103835,4.88543480677313,0.16449187085245554
1793,0.2614,7,69,7,78267,527343,4128,103828,4.884795657490089,0.16450058700415576
1794,0.2615,2,89,2,78356,527254,4130,103826,4.883971247545296,0.1645211383659758
1795,0.2616,1,32,1,78388,527222,4131,103825,4.883674830486495,0.16452815717371289
1796,0.2617,5,139,5,78527,527083,4136,103820,4.882387268887324,0.164557784635673
1797,0.2618,0,26,0,78553,527057,4136,103820,4.882146430027048,0.1645645664685826
1798,0.2619,3,61,3,78614,526996,4139,103817,4.881581385008707,0.16457650682531907
1799,0.262,1,11,1,78625,526985,4140,103816,4.881479491644744,0.1645780523493146
1800,0.2621,3,32,3,78657,526953,4143,103813,4.881183074585943,0.16458242834902326
1801,0.2622,6,116,6,78773,526837,4149,103807,4.880108562747786,0.16460475323637425
1802,0.2623,9,201,9,78974,526636,4158,103798,4.8782466930971875,0.16464530783555456
1803,0.2624,9,162,9,79136,526474,4167,103789,4.876746081737004,0.16467569887491412
1804,0.2625,5,74,5,79210,526400,4172,103784,4.876060617288525,0.16468840846482932
1805,0.2626,12,150,12,79360,526250,4184,103772,4.8746711623253915,0.16471170848002134
1806,0.2627,1,60,1,79420,526190,4185,103771,4.874115380340139,0.16472607034403716
1807,0.2628,6,49,6,79469,526141,4191,103765,4.873661491718848,0.1647309281067334
1808,0.2629,7,107,7,79576,526034,4198,103758,4.87267034717848,0.16474963162440934
1809,0.263,7,78,7,79654,525956,4205,103751,4.871947830597651,0.16476075381089936
1810,0.2631,6,83,6,79737,525873,4211,103745,4.871178998851384,0.16477451407043636
1811,0.2632,12,164,12,79901,525709,4223,103733,4.869659861425025,0.1648015226184462
1812,0.2633,3,75,3,79976,525634,4226,103730,4.868965133943458,0.16481718051874591
1813,0.2634,6,83,6,80059,525551,4232,103724,4.868196302197191,0.16483095625918717
1814,0.2635,2,52,2,80111,525499,4234,103722,4.867714624476639,0.16484192358487718
1815,0.2636,15,141,15,80252,525358,4249,103707,4.866408536811294,0.1648589573414512
1816,0.2637,8,204,8,80456,525154,4257,103699,4.864518878061433,0.16490181330135978
1817,0.2638,3,24,3,80480,525130,4260,103696,4.864296565267331,0.16490412292112602
1818,0.2639,3,73,3,80553,525057,4263,103693,4.86362036385194,0.16491928429423458
1819,0.264,9,61,9,80614,524996,4272,103684,4.863055318833599,0.1649233314245721
1820,0.2641,9,67,9,80681,524929,4281,103675,4.862434695616733,0.16492895368149105
1821,0.2642,4,83,4,80764,524846,4285,103671,4.861665863870466,0.16494541913742986
1822,0.2643,2,29,2,80793,524817,4287,103669,4.8613972359109265,0.164950372800667
1823,0.2644,16,128,16,80921,524689,4303,103653,4.860211567675719,0.16496271138965724
1824,0.2645,18,201,18,81122,524488,4321,103635,4.858349698025122,0.16499157012241233
1825,0.2646,3,31,3,81153,524457,4324,103632,4.858062543999407,0.16499572512812674
1826,0.2647,18,296,18,81449,524161,4342,103614,4.855320686205491,0.16504957986539764
1827,0.2648,5,53,5,81502,524108,4347,103609,4.854829745451851,0.16505686479735296
1828,0.2649,7,165,7,81667,523943,4354,103602,4.8533013449924045,0.16509094965301294
1829,0.265,0,49,0,81716,523894,4354,103602,4.852847456371114,0.16510384129938677
1830,0.2651,1,78,1,81794,523816,4355,103601,4.852124939790285,0.16512303619442892
1831,0.2652,4,84,4,81878,523732,4359,103597,4.85134684501093,0.16513982296370805
1832,0.2653,16,159,16,82037,523573,4375,103581,4.84987402275001,0.16516039122767295
1833,0.2654,12,157,12,82194,523416,4387,103569,4.848419726555263,0.16518576999449747
1834,0.2655,5,67,5,82261,523349,4392,103564,4.847799103338397,0.16519676573942477
1835,0.2656,6,55,6,82316,523294,4398,103558,4.847289636518582,0.16520326967130997
1836,0.2657,8,180,8,82496,523114,4406,103550,4.8456222905628215,0.1652400648513398
1837,0.2658,5,58,5,82554,523056,4411,103545,4.845085034643744,0.16524869893281371
1838,0.2659,4,82,4,82636,522974,4415,103541,4.844325465930564,0.16526499764570682
1839,0.266,2,66,2,82702,522908,4417,103539,4.843714105746786,0.1652797443359135
1840,0.2661,5,65,5,82767,522843,4422,103534,4.843112008596095,0.16529023255962463
1841,0.2662,8,65,8,82832,522778,4430,103526,4.842509911445403,0.16529672491314124
1842,0.2663,6,94,6,82926,522684,4436,103520,4.841639186335174,0.16531353999655066
1843,0.2664,4,75,4,83001,522609,4440,103516,4.840944458853607,0.16532800958275104
1844,0.2665,5,66,5,83067,522543,4445,103511,4.840333098669828,0.1653387726937293
1845,0.2666,5,122,5,83189,522421,4450,103506,4.839203008633147,0.16536433162333627
1846,0.2667,5,45,5,83234,522376,4455,103501,4.838786172144207,0.16536955344260934
1847,0.2668,7,53,7,83287,522323,4462,103494,4.838295231390567,0.165374222815935
1848,0.2669,8,115,8,83402,522208,4470,103486,4.837229982585498,0.16539394656173784
1849,0.267,3,51,3,83453,522157,4473,103483,4.836757567898032,0.16540342689086376
1850,0.2671,4,116,4,83569,522041,4477,103479,4.835683056059876,0.16542876326896022
1851,0.2672,12,101,12,83670,521940,4489,103467,4.834747489718033,0.1654394658198581
1852,0.2673,3,59,3,83729,521881,4492,103464,4.834200970765868,0.16545107100880313
1853,0.2674,1,22,1,83751,521859,4493,103463,4.833997184037941,0.16545555729688063
1854,0.2675,6,114,6,83865,521745,4499,103457,4.83294119826596,0.16547771760167115
1855,0.2676,2,90,2,83955,521655,4501,103455,4.83210752528808,0.16549887219849307
1856,0.2677,16,136,16,84091,521519,4517,103439,4.830847752788173,0.1655135225087126
1857,0.2678,4,76,4,84167,521443,4521,103435,4.830143762273519,0.16552831112633187
1858,0.2679,8,131,8,84298,521312,4529,103427,4.828930304939049,0.16555233465495192
1859,0.268,10,171,10,84469,521141,4539,103417,4.827346326281077,0.16558430121782125
1860,0.2681,7,55,7,84524,521086,4546,103410,4.826836859461262,0.16558953139811944
1861,0.2682,4,32,4,84556,521054,4550,103406,4.82654044240246,0.16559267206866732
1862,0.2683,6,41,6,84597,521013,4556,103400,4.826160658045871,0.16559552731925825
1863,0.2684,3,50,3,84647,520963,4559,103397,4.825697506391493,0.16560477929399706
1864,0.2685,11,147,11,84794,520816,4570,103386,4.824335840527622,0.16562907520321948
1865,0.2686,10,101,10,84895,520715,4580,103376,4.823400274185779,0.16564251046722353
1866,0.2687,5,86,5,84981,520629,4585,103371,4.822603653340249,0.16565865384615386
1867,0.2688,4,75,4,85056,520554,4589,103367,4.821908925858684,0.1656732182439764
1868,0.2689,8,57,8,85113,520497,4597,103359,4.821380932972692,0.16567765638224205
1869,0.269,4,102,4,85215,520395,4601,103355,4.820436103597762,0.16569939879759518
1870,0.2691,17,193,17,85408,520202,4618,103338,4.818648338211864,0.16572794046893544
1871,0.2692,6,96,6,85504,520106,4624,103332,4.8177590870354585,0.16574543098110797
1872,0.2693,6,76,6,85580,520030,4630,103326,4.8170550965208045,0.16575760881422494
1873,0.2694,3,35,3,85615,519995,4633,103323,4.816730890362741,0.16576290111949277
1874,0.2695,3,33,3,85648,519962,4636,103320,4.816425210270851,0.16576766214971714
1875,0.2696,9,81,9,85729,519881,4645,103311,4.815674904590759,0.1657771601689367
1876,0.2697,5,95,5,85824,519786,4650,103306,4.8147949164474415,0.16579574123885396
1877,0.2698,6,59,6,85883,519727,4656,103300,4.814248397495276,0.1658034081990026
1878,0.2699,3,37,3,85920,519690,4659,103297,4.813905665271037,0.16580923839502268
1879,0.27,4,47,4,85967,519643,4663,103293,4.813470302715921,0.1658163920531162
1880,0.2701,10,124,10,86091,519519,4673,103283,4.812321686613065,0.16583601208730864
1881,0.2702,1,27,1,86118,519492,4674,103282,4.812071584719701,0.16584186237704207
1882,0.2703,15,166,15,86284,519326,4689,103267,4.810533921227167,0.16586598307401465
1883,0.2704,6,77,6,86361,519249,4695,103261,4.809820667679425,0.16587845978377858
1884,0.2705,4,130,4,86491,519119,4699,103257,4.808616473378043,0.16590774708536318
1885,0.2706,9,123,9,86614,518996,4708,103248,4.807477120308274,0.1659284782175481
1886,0.2707,8,80,8,86694,518916,4716,103240,4.806736077661269,0.16593908923163966
1887,0.2708,0,29,0,86723,518887,4716,103240,4.806467449701731,0.1659468243622283
1888,0.2709,2,49,2,86772,518838,4718,103238,4.80601356108044,0.16595721423105858
1889,0.271,7,98,7,86870,518740,4725,103231,4.80510578383786,0.16597397627863678
1890,0.2711,4,38,4,86908,518702,4729,103227,4.804753788580533,0.16597875320173203
1891,0.2712,2,19,2,86927,518683,4731,103225,4.804577790951869,0.16598114190523358
1892,0.2713,6,90,6,87017,518593,4737,103219,4.80374411797399,0.1659971181000045
1893,0.2714,4,67,4,87084,518526,4741,103215,4.8031234947571235,0.16600964067031126
1894,0.2715,12,193,12,87277,518333,4753,103203,4.8013357293712255,0.1660450882973794
1895,0.2716,7,81,7,87358,518252,4760,103196,4.800585423691134,0.16605733705796785
1896,0.2717,6,78,6,87436,518174,4766,103190,4.799862907110304,0.1660701295858788
1897,0.2718,3,18,3,87454,518156,4769,103187,4.799696172514728,0.1660709141327737
1898,0.2719,11,123,11,87577,518033,4780,103176,4.7985568194449595,0.16608902961805125
1899,0.272,3,69,3,87646,517964,4783,103173,4.797917670161918,0.16610345221746572
1900,0.2721,7,177,7,87823,517787,4790,103166,4.796278113305421,0.1661413987854153
1901,0.2722,4,42,4,87865,517745,4794,103162,4.795889065915744,0.16614726521040993
1902,0.2723,8,84,8,87949,517661,4802,103154,4.795110971136389,0.1661590006684761
1903,0.2724,11,131,11,88080,517530,4813,103143,4.7938975138019195,0.16617929247768148
1904,0.2725,6,82,6,88162,517448,4819,103137,4.7931379450887395,0.16619318868486993
1905,0.2726,5,57,5,88219,517391,4824,103132,4.792609952202749,0.16620173627730156
1906,0.2727,10,121,10,88340,517270,4834,103122,4.791489125199155,0.16622071206591962
1907,0.2728,8,109,8,88449,517161,4842,103114,4.790479454592612,0.16623916811091854
1908,0.2729,8,117,8,88566,517044,4850,103106,4.789395679721368,0.16625977586067886
1909,0.273,6,48,6,88614,516996,4856,103100,4.7889510541331655,0.16626457838786252
1910,0.2731,5,38,5,88652,516958,4861,103095,4.788599058875838,0.16626804482842597
1911,0.2732,2,39,2,88691,516919,4863,103093,4.788237800585423,0.1662758140165029
1912,0.2733,3,37,3,88728,516882,4866,103090,4.787895068361184,0.16628170304465362
1913,0.2734,13,162,13,88890,516720,4879,103077,4.786394457001,0.1663076781591392
1914,0.2735,1,18,1,88908,516702,4880,103076,4.786227722405425,0.16631116302934276
1915,0.2736,3,54,3,88962,516648,4883,103073,4.785727518618697,0.16632161892206332
1916,0.2737,9,98,9,89060,516550,4892,103064,4.784819741376116,0.1663358155238584
1917,0.2738,3,38,3,89098,516512,4895,103061,4.784467746118789,0.16634198068669875
1918,0.2739,0,45,0,89143,516467,4895,103061,4.784050909629849,0.16635406309319353
1919,0.274,7,78,7,89221,516389,4902,103054,4.78332839304902,0.16636558973142
1920,0.2741,5,80,5,89301,516309,4907,103049,4.782587350402015,0.16638034868363694
1921,0.2742,3,73,3,89374,516236,4910,103046,4.781911148986624,0.16639592302053022
1922,0.2743,7,108,7,89482,516128,4917,103039,4.780910741413169,0.16641552279110483
1923,0.2744,7,34,7,89516,516094,4924,103032,4.780595798288192,0.16641523696307375
1924,0.2745,6,72,6,89588,516022,4930,103026,4.779928859905888,0.16642651296829972
1925,0.2746,10,174,10,89762,515848,4940,103016,4.7783170921486535,0.16645983608676543
1926,0.2747,3,49,3,89811,515799,4943,103013,4.777863203527363,0.1664689760379566
1927,0.2748,2,64,2,89875,515735,4945,103011,4.777270369409759,0.16648350049939717
1928,0.2749,13,205,13,90080,515530,4958,102998,4.775371447626811,0.1665211599151534
1929,0.275,4,37,4,90117,515493,4962,102994,4.775028715402572,0.16652573134115997
1930,0.2751,7,97,7,90214,515396,4969,102987,4.774130201193079,0.16654241788664953
1931,0.2752,5,61,5,90275,515335,4974,102982,4.773565156174738,0.16655210838453416
1932,0.2753,6,63,6,90338,515272,4980,102976,4.772981585090222,0.16656099170559388
1933,0.2754,7,128,7,90466,515144,4987,102969,4.771795916855015,0.1665860449464742
1934,0.2755,8,73,8,90539,515071,4995,102961,4.771119715439624,0.16659493359567143
1935,0.2756,3,40,3,90579,515031,4998,102958,4.770749194116122,0.1666016709035274
1936,0.2757,4,56,4,90635,514975,5002,102954,4.770230464263219,0.1666113744459315
1937,0.2758,10,153,10,90788,514822,5012,102944,4.768813220200823,0.1666391481564217
1938,0.2759,11,83,11,90871,514739,5023,102933,4.768044388454555,0.16664669921900296
1939,0.276,4,64,4,90935,514675,5027,102929,4.767451554336952,0.16665857086417835
1940,0.2761,2,43,2,90978,514632,5029,102927,4.767053243914187,0.1666674763059076
1941,0.2762,3,59,3,91037,514573,5032,102924,4.766506724962022,0.1666793522883512
1942,0.2763,2,40,2,91077,514533,5034,102922,4.76613620363852,0.16668745090735357
1943,0.2764,5,42,5,91119,514491,5039,102917,4.7657471562488425,0.16669204156732664
1944,0.2765,4,99,4,91218,514392,5043,102913,4.764830115973174,0.16671337507391
1945,0.2766,1,62,1,91280,514330,5044,102912,4.764255807921746,0.1667287708872695
1946,0.2767,6,52,6,91332,514278,5050,102906,4.763774130201193,0.16673471768548764
1947,0.2768,9,113,9,91445,514165,5059,102897,4.762727407462299,0.16675309774382477
1948,0.2769,5,54,5,91499,514111,5064,102892,4.762227203675572,0.16676093957403773
1949,0.277,2,31,2,91530,514080,5066,102890,4.761940049649858,0.16676661750166136
1950,0.2771,6,53,6,91583,514027,5072,102884,4.761449108896217,0.16677284081496357
1951,0.2772,13,178,13,91761,513849,5085,102871,4.759800289006632,0.16680341159683487
1952,0.2773,5,116,5,91877,513733,5090,102866,4.758725777168476,0.16682803572500118
1953,0.2774,4,37,4,91914,513696,5094,102862,4.758383044944236,0.1668326418601332
1954,0.2775,6,56,6,91970,513640,5100,102856,4.757864315091333,0.16683968752433107
1955,0.2776,7,135,7,92105,513505,5107,102849,4.7566138056245135,0.16686676812351345
1956,0.2777,10,152,10,92257,513353,5117,102839,4.755205824595206,0.16689440953469048
1957,0.2778,21,186,21,92443,513167,5138,102818,4.75348290044092,0.16691640218511813
1958,0.2779,11,134,11,92577,513033,5149,102807,4.752241654007188,0.16693784099766174
1959,0.278,5,71,5,92648,512962,5154,102802,4.751583978657972,0.1669503251245607
1960,0.2781,6,61,6,92709,512901,5160,102796,4.751018933639631,0.16695874756576692
1961,0.2782,7,178,7,92887,512723,5167,102789,4.749370113750047,0.1669975565058033
1962,0.2783,4,67,4,92954,512656,5171,102785,4.74874949053318,0.16701032267918453
1963,0.2784,3,20,3,92974,512636,5174,102782,4.7485642298714295,0.16701168961583834
1964,0.2785,7,84,7,93058,512552,5181,102775,4.747786135092075,0.1670250127168156
1965,0.2786,4,41,4,93099,512511,5185,102771,4.747406350735485,0.16703072737378957
1966,0.2787,6,91,6,93190,512420,5191,102765,4.746563414724517,0.1670473109714964
1967,0.2788,0,17,0,93207,512403,5191,102765,4.746405943162029,0.16705192727840198
1968,0.2789,5,75,5,93282,512328,5196,102760,4.745711215680463,0.16706552558333115
1969,0.279,5,69,5,93351,512259,5201,102755,4.745072066397421,0.1670774974228229
1970,0.2791,8,94,8,93445,512165,5209,102747,4.744201341287191,0.16709220181099085
1971,0.2792,2,20,2,93465,512145,5211,102745,4.74401608062544,0.16709492754801672
1972,0.2793,11,138,11,93603,512007,5222,102734,4.742737782059358,0.1671175340509255
1973,0.2794,6,53,6,93656,511954,5228,102728,4.742246841305717,0.167123813614194
1974,0.2795,1,27,1,93683,511927,5229,102727,4.741996739412353,0.1671297998548777
1975,0.2796,4,40,4,93723,511887,5233,102723,4.741626218088851,0.16713525650412456
1976,0.2797,8,82,8,93805,511805,5241,102715,4.740866649375672,0.16714671613617132
1977,0.2798,5,69,5,93874,511736,5246,102710,4.74022750009263,0.16715870882062867
1978,0.2799,9,84,9,93958,511652,5255,102701,4.739449405313276,0.1671693635418074
1979,0.28,9,87,9,94045,511565,5264,102692,4.738643521434659,0.16718083798800829
1980,0.2801,6,100,6,94145,511465,5270,102686,4.737717218125903,0.16719992314593643
1981,0.2802,8,137,8,94282,511328,5278,102678,4.736448182592908,0.16722637889532024
1982,0.2803,5,66,5,94348,511262,5283,102673,4.73583682240913,0.16723757401027797
1983,0.2804,3,41,3,94389,511221,5286,102670,4.73545703805254,0.16724467372872384
1984,0.2805,6,78,6,94467,511143,5292,102664,4.734734521471711,0.1672577862422553
1985,0.2806,6,56,6,94523,511087,5298,102658,4.734215791618808,0.16726490643508296
1986,0.2807,8,130,8,94653,510957,5306,102650,4.733011597317426,0.1672894865932103
1987,0.2808,6,77,6,94730,510880,5312,102644,4.732298343769684,0.16730233862082006
1988,0.2809,4,66,4,94796,510814,5316,102640,4.731686983585905,0.16731490869731064
1989,0.281,11,51,11,94847,510763,5327,102629,4.73121456889844,0.1673138873672953
1990,0.2811,6,123,6,94970,510640,5333,102623,4.730075215828671,0.16733929814777673
1991,0.2812,4,59,4,95029,510581,5337,102619,4.729528696876505,0.16734996738421395
1992,0.2813,4,82,4,95111,510499,5341,102615,4.728769128163326,0.16736691708230444
1993,0.2814,8,102,8,95213,510397,5349,102607,4.727824298788395,0.1673838996156632
1994,0.2815,9,68,9,95281,510329,5358,102598,4.7271944125384415,0.16739024386264595
1995,0.2816,1,43,1,95324,510286,5359,102597,4.726796102115677,0.16740062948393086
1996,0.2817,5,84,5,95408,510202,5364,102592,4.7260180073363225,0.16741678280139818
1997,0.2818,3,54,3,95462,510148,5367,102589,4.725517803549594,0.1674274607213209
1998,0.2819,7,123,7,95585,510025,5374,102582,4.724378450479825,0.1674515635635897
1999,0.282,1,28,1,95613,509997,5375,102581,4.724119085553373,0.1674578584278247
2000,0.2821,5,106,5,95719,509891,5380,102576,4.723137204046093,0.16748004382276924
2001,0.2822,7,76,7,95795,509815,5387,102569,4.722433213531438,0.16749131264043476
2002,0.2823,6,73,6,95868,509742,5393,102563,4.721757012116047,0.16750312344338197
2003,0.2824,12,137,12,96005,509605,5405,102551,4.720487976583052,0.167524291193748
2004,0.2825,7,58,7,96063,509547,5412,102544,4.719950720663975,0.16753064495311973
2005,0.2826,8,99,8,96162,509448,5420,102536,4.719033680388306,0.1675468639702999
2006,0.2827,5,48,5,96210,509400,5425,102531,4.718589054800104,0.1675532045279615
2007,0.2828,11,110,11,96320,509290,5436,102520,4.717570121160473,0.1675683627269904
2008,0.2829,5,27,5,96347,509263,5441,102515,4.717320019267109,0.1675689547515602
2009,0.283,7,83,7,96430,509180,5448,102508,4.7165511875208415,0.16758216607159204
2010,0.2831,5,76,5,96506,509104,5453,102503,4.7158471970061875,0.16759618513195565
2011,0.2832,2,57,2,96563,509047,5455,102501,4.715319204120197,0.1676090838331578
2012,0.2833,3,30,3,96593,509017,5458,102498,4.71504131312757,0.16761322289723066
2013,0.2834,13,154,13,96747,508863,5471,102485,4.713614806032087,0.16763774478692986
2014,0.2835,0,32,0,96779,508831,5471,102485,4.713318388973286,0.16764651996676025
2015,0.2836,2,54,2,96833,508777,5473,102483,4.712818185186557,0.1676586068121585
2016,0.2837,4,93,4,96926,508684,5477,102479,4.711956723109415,0.16767867164733466
2017,0.2838,10,51,10,96977,508633,5487,102469,4.71148430842195,0.16767904539667683
2018,0.2839,3,70,3,97047,508563,5490,102466,4.710835896105821,0.16769416836189444
2019,0.284,2,59,2,97106,508504,5492,102464,4.710289377153655,0.16770763771588693
2020,0.2841,19,235,19,97341,508269,5511,102445,4.70811256437808,0.1677462773081999
2021,0.2842,2,31,2,97372,508238,5513,102443,4.707825410352366,0.16775206695476033
2022,0.2843,7,73,7,97445,508165,5520,102436,4.707149208936975,0.16776258145663042
2023,0.2844,2,55,2,97500,508110,5522,102434,4.706639742117159,0.16777496789748159
2024,0.2845,4,22,4,97522,508088,5526,102430,4.7064359553892325,0.16777556108091818
2025,0.2846,9,108,9,97630,507980,5535,102421,4.705435547815777,0.16779297543745833
2026,0.2847,2,44,2,97674,507936,5537,102419,4.705027974359925,0.16780234453719556
2027,0.2848,1,16,1,97690,507920,5538,102418,4.7048797658305235,0.16780537996978723
2028,0.2849,8,49,8,97739,507871,5546,102410,4.704425877209234,0.16780794420930686
2029,0.285,4,70,4,97809,507801,5550,102406,4.703777464893105,0.16782173918031093
2030,0.2851,0,55,0,97864,507746,5550,102406,4.703267998073289,0.16783686687907276
2031,0.2852,0,31,0,97895,507715,5550,102406,4.702980844047575,0.16784539460205436
2032,0.2853,6,62,6,97957,507653,5556,102400,4.702406535996147,0.16785426839963086
2033,0.2854,3,61,3,98018,507592,5559,102397,4.701841490977806,0.16786696153537195
2034,0.2855,6,127,6,98145,507465,5565,102391,4.700665085775686,0.16789373229090146
2035,0.2856,14,102,14,98247,507363,5579,102377,4.699720256400756,0.16790271263161347
2036,0.2857,4,62,4,98309,507301,5583,102373,4.699145948349328,0.1679143279851199
2037,0.2858,14,119,14,98428,507182,5597,102359,4.698043647411908,0.16792799828067348
2038,0.2859,1,101,1,98529,507081,5598,102358,4.697108081070065,0.16795446303895878
2039,0.286,4,54,4,98583,507027,5602,102354,4.696607877283338,0.16796388466328946
2040,0.2861,10,92,10,98675,506935,5612,102344,4.695755678239283,0.16797559082128222
2041,0.2862,5,61,5,98736,506874,5617,102339,4.695190633220942,0.16798558139763925
2042,0.2863,2,55,2,98791,506819,5619,102337,4.694681166401127,0.16799801692834018
2043,0.2864,1,33,1,98824,506786,5620,102336,4.694375486309237,0.16800575254218367
2044,0.2865,8,87,8,98911,506699,5628,102328,4.69356960243062,0.16801882346759667
2045,0.2866,4,94,4,99005,506605,5632,102324,4.69269887732039,0.1680392952216104
2046,0.2867,7,97,7,99102,506508,5639,102317,4.691800363110897,0.16805650227898
2047,0.2868,2,33,2,99135,506475,5641,102315,4.691494683019008,0.16806287882521068
2048,0.2869,10,68,10,99203,506407,5651,102305,4.690864796769054,0.1680679861740856
2049,0.287,2,62,2,99265,506345,5653,102303,4.6902904887176255,0.16808237273432264
2050,0.2871,9,144,9,99409,506201,5662,102294,4.688956611953018,0.16810984478097601
2051,0.2872,2,71,2,99480,506130,5664,102292,4.688298936603801,0.1681267278303546
2052,0.2873,3,52,3,99532,506078,5667,102289,4.687817258883249,0.16813699625390593
2053,0.2874,7,135,7,99667,505943,5674,102282,4.6865667494164285,0.16816474166632414
2054,0.2875,5,30,5,99697,505913,5679,102277,4.6862888584238025,0.1681661980631053
2055,0.2876,7,103,7,99800,505810,5686,102270,4.685334766015784,0.16818510722273386
2056,0.2877,5,87,5,99887,505723,5691,102265,4.684528882137167,0.1682023329407817
2057,0.2878,5,79,5,99966,505644,5696,102260,4.6837971025232505,0.16821735010791178
2058,0.2879,11,143,11,100109,505501,5707,102249,4.68247248879173,0.16824187577128755
2059,0.288,14,93,14,100202,505408,5721,102235,4.681611026714587,0.16824846167897928
2060,0.2881,3,53,3,100255,505355,5724,102232,4.681120085960947,0.16825903121692862
2061,0.2882,2,15,2,100270,505340,5726,102230,4.680981140464634,0.16826044735586024
2062,0.2883,5,85,5,100355,505255,5731,102225,4.680193782652192,0.16827714492658194
2063,0.2884,6,48,6,100403,505207,5737,102219,4.679749157063989,0.16828222697085735
2064,0.2885,2,34,2,100437,505173,5739,102217,4.679434213939012,0.1682889082796885
2065,0.2886,3,53,3,100490,505120,5742,102214,4.6789432731853715,0.1682994859500703
2066,0.2887,2,29,2,100519,505091,5744,102212,4.678674645225833,0.16830478360884105
2067,0.2888,3,63,3,100582,505028,5747,102209,4.678091074141316,0.16831813608195811
2068,0.2889,5,58,5,100640,504970,5752,102204,4.677553818222239,0.16832736579629562
2069,0.289,6,58,6,100698,504912,5758,102198,4.6770165623031605,0.16833522755349112
2070,0.2891,6,119,6,100817,504793,5764,102192,4.675914261365741,0.1683600088964307
2071,0.2892,2,30,2,100847,504763,5766,102190,4.675636370373115,0.16836559008687657
2072,0.2893,12,118,12,100965,504645,5778,102178,4.674543332468784,0.16838188400901086
2073,0.2894,12,112,12,101077,504533,5790,102166,4.673505872762978,0.1683965195261571
2074,0.2895,5,86,5,101163,504447,5795,102161,4.672709251917448,0.16841353889167304
2075,0.2896,3,48,3,101211,504399,5798,102158,4.6722646263292456,0.1684227533438737
2076,0.2897,6,133,6,101344,504266,5804,102152,4.6710326429286,0.16845146417157802
2077,0.2898,2,44,2,101388,504222,5806,102150,4.670625069472748,0.16846094476657894
2078,0.2899,7,133,7,101521,504089,5813,102143,4.669393086072104,0.16848830150833344
2079,0.29,4,54,4,101575,504035,5817,102139,4.668892882285376,0.1684978240571189
2080,0.2901,5,72,5,101647,503963,5822,102134,4.668225943903072,0.16851098091559602
2081,0.2902,5,55,5,101702,503908,5827,102129,4.667716477083256,0.16851941383116872
2082,0.2903,4,106,4,101808,503802,5831,102125,4.666734595575975,0.16854340539371904
2083,0.2904,6,73,6,101881,503729,5837,102119,4.666058394160584,0.16855547926212516
2084,0.2905,5,103,5,101984,503626,5842,102114,4.6651043017525655,0.16857727737973388
2085,0.2906,9,62,9,102046,503564,5851,102105,4.664529993701137,0.16858217937520328
2086,0.2907,18,158,18,102204,503406,5869,102087,4.663066434473304,0.16860145369145474
2087,0.2908,22,159,22,102363,503247,5891,102065,4.661593612212383,0.16861552389511525
2088,0.2909,4,74,4,102437,503173,5895,102061,4.660908147763903,0.16863064533717537
2089,0.291,3,109,3,102546,503064,5898,102058,4.659898477157361,0.16865689893938743
2090,0.2911,5,156,5,102702,502908,5903,102053,4.658453443995702,0.16869351908635433
2091,0.2912,0,27,0,102729,502881,5903,102053,4.658203342102338,0.1687010483788314
2092,0.2913,10,63,10,102792,502818,5913,102043,4.657619771017822,0.1687048759963033
2093,0.2914,1,46,1,102838,502772,5914,102042,4.657193671495794,0.1687163326245755
2094,0.2915,5,115,5,102953,502657,5919,102037,4.656128422690726,0.16874154531052069
2095,0.2916,5,54,5,103007,502603,5924,102032,4.655628218903998,0.16874974157963069
2096,0.2917,9,101,9,103108,502502,5933,102023,4.654692652562155,0.1687655597369836
2097,0.2918,14,120,14,103228,502382,5947,102009,4.653581088591649,0.16877981306803047
2098,0.2919,6,61,6,103289,502321,5953,102003,4.653016043573308,0.16878859684540082
2099,0.292,5,48,5,103337,502273,5958,101998,4.652571417985105,0.16879512668984611
2100,0.2921,6,58,6,103395,502215,5964,101992,4.652034162066027,0.1688030757670798
2101,0.2922,5,134,5,103529,502081,5969,101987,4.6507929156322945,0.16883364124568756
2102,0.2923,7,89,7,103618,501992,5976,101980,4.649968505687502,0.1688488870344983
2103,0.2924,7,60,7,103678,501932,5983,101973,4.649412723702249,0.16885602868000762
2104,0.2925,6,87,6,103765,501845,5989,101967,4.648606839823632,0.1688720992626844
2105,0.2926,2,34,2,103799,501811,5991,101965,4.648291896698655,0.16887885573457706
2106,0.2927,4,66,4,103865,501745,5995,101961,4.647680536514876,0.1688918115771584
2107,0.2928,3,73,3,103938,501672,5998,101958,4.647004335099485,0.16890810595894837
2108,0.2929,10,141,10,104079,501531,6008,101948,4.64569824743414,0.16893379885629822
2109,0.293,7,76,7,104155,501455,6015,101941,4.644994256919485,0.1689454355017269
2110,0.2931,6,86,6,104241,501369,6021,101935,4.644197636073956,0.16896125336480447
2111,0.2932,6,65,6,104306,501304,6027,101929,4.643595538923265,0.1689711935520769
2112,0.2933,2,73,2,104379,501231,6029,101927,4.642919337507873,0.16898888848361457
2113,0.2934,4,51,4,104430,501180,6033,101923,4.642446922820408,0.16899766706516134
2114,0.2935,2,49,2,104479,501131,6035,101921,4.6419930341991185,0.16900864270411176
2115,0.2936,5,44,5,104523,501087,6040,101916,4.641585460743266,0.16901408450704225
2116,0.2937,3,46,3,104569,501041,6043,101913,4.641159361221238,0.16902284419706975
2117,0.2938,8,90,8,104659,500951,6051,101905,4.640325688243358,0.16903705030720437
2118,0.2939,6,69,6,104728,500882,6057,101899,4.6396865389603175,0.16904812859064902
2119,0.294,6,49,6,104777,500833,6063,101893,4.639232650339027,0.169053599811523
2120,0.2941,16,102,16,104879,500731,6079,101877,4.638287820964097,0.1690601518731912
2121,0.2942,11,56,11,104935,500675,6090,101866,4.637769091111194,0.1690606946249301
2122,0.2943,1,34,1,104969,500641,6091,101865,4.637454147986217,0.16906885574583488
2123,0.2944,4,54,4,105023,500587,6095,101861,4.6369539441994885,0.16907849308156056
2124,0.2945,9,68,9,105091,500519,6104,101852,4.636324057949535,0.16908516512249094
2125,0.2946,6,46,6,105137,500473,6110,101846,4.635897958427507,0.1690898012514963
2126,0.2947,4,90,4,105227,500383,6114,101842,4.635064285449627,0.1691095520777118
2127,0.2948,5,62,5,105289,500321,6119,101837,4.634489977398199,0.16912006483348224
2128,0.2949,13,193,13,105482,500128,6132,101824,4.632702212012301,0.16915634469193558
2129,0.295,4,51,4,105533,500077,6136,101820,4.632229797324836,0.16916515616459293
2130,0.2951,9,84,9,105617,499993,6145,101811,4.6314517025454816,0.1691763431283275
2131,0.2952,12,119,12,105736,499874,6157,101799,4.630349401608062,0.16919323286901689
2132,0.2953,8,104,8,105840,499770,6165,101791,4.629386046166957,0.16921143491682472
2133,0.2954,4,48,4,105888,499722,6169,101787,4.628941420578754,0.1692194131758627
2134,0.2955,15,115,15,106003,499607,6184,101772,4.627876171773686,0.1692310506352899
2135,0.2956,5,55,5,106058,499552,6189,101767,4.62736670495387,0.16923962156525904
2136,0.2957,6,74,6,106132,499478,6195,101761,4.626681240505391,0.16925216095429604
2137,0.2958,6,44,6,106176,499434,6201,101755,4.626273667049539,0.169256257183681
2138,0.2959,4,57,4,106233,499377,6205,101751,4.625745674163548,0.1692667784565018
2139,0.296,8,108,8,106341,499269,6213,101743,4.624745266590092,0.16928613738161635
2140,0.2961,5,38,5,106379,499231,6218,101738,4.624393271332766,0.16928993009622792
2141,0.2962,11,189,11,106568,499042,6229,101727,4.622642558079217,0.16932797797489552
2142,0.2963,7,91,7,106659,498951,6236,101720,4.6217996220682505,0.16934395034885985
2143,0.2964,9,94,9,106753,498857,6245,101711,4.62092889695802,0.16935800775266083
2144,0.2965,3,50,3,106803,498807,6248,101708,4.620465745303642,0.16936795916838046
2145,0.2966,8,71,8,106874,498736,6256,101700,4.619808069954426,0.16937691943854133
2146,0.2967,6,72,6,106946,498664,6262,101694,4.619141131572122,0.1693889312710083
2147,0.2968,5,46,5,106992,498618,6267,101689,4.618715032050095,0.1693949928953019
2148,0.2969,11,111,11,107103,498507,6278,101678,4.617686835377376,0.16941109824470788
2149,0.297,16,102,16,107205,498405,6294,101662,4.616742006002445,0.16941774835143408
2150,0.2971,6,92,6,107297,498313,6300,101656,4.61588980695839,0.16943542083007623
2151,0.2972,6,114,6,107411,498199,6306,101650,4.6148338211864095,0.16945931392733837
2152,0.2973,3,67,3,107478,498132,6309,101647,4.614213197969543,0.16947408962301114
2153,0.2974,6,150,6,107628,497982,6315,101641,4.61282374300641,0.16950817430285361
2154,0.2975,7,83,7,107711,497899,6322,101634,4.612054911260143,0.16952194458019826
2155,0.2976,5,94,5,107805,497805,6327,101629,4.611184186149913,0.16954160091019194
2156,0.2977,4,49,4,107854,497756,6331,101625,4.610730297528622,0.1695499189997681
2157,0.2978,3,55,3,107909,497701,6334,101622,4.6102208307088075,0.16956132169130836
2158,0.2979,1,18,1,107927,497683,6335,101621,4.610054096113231,0.1695650287667027
2159,0.298,7,94,7,108021,497589,6342,101614,4.6091833710030015,0.1695819279943525
2160,0.2981,4,68,4,108089,497521,6346,101610,4.608553484753047,0.16959563100557307
2161,0.2982,7,122,7,108211,497399,6353,101603,4.607423394716366,0.16962046871295922
2162,0.2983,5,104,5,108315,497295,6358,101598,4.606460039275261,0.16964299131898353
2163,0.2984,1,52,1,108367,497243,6359,101597,4.605978361554707,0.16965633558212545
2164,0.2985,2,73,2,108440,497170,6361,101595,4.605302160139316,0.16967424615667248
2165,0.2986,2,95,2,108535,497075,6363,101593,4.604422171995998,0.16969839710824697
2166,0.2987,2,55,2,108590,497020,6365,101591,4.603912705176183,0.16971121479558512
2167,0.2988,4,34,4,108624,496986,6369,101587,4.603597762051206,0.1697153062366662
2168,0.2989,5,68,5,108692,496918,6374,101582,4.602967875801252,0.16972765246449456
2169,0.299,8,101,8,108793,496817,6382,101574,4.6020323094594096,0.16974520004478677
2170,0.2991,9,76,9,108869,496741,6391,101565,4.601328318944756,0.16975427289714629
2171,0.2992,7,98,7,108967,496643,6398,101558,4.600420541702175,0.16977236748183303
2172,0.2993,4,86,4,109053,496557,6402,101554,4.599623920856645,0.16979122604332642
2173,0.2994,6,77,6,109130,496480,6408,101548,4.598910667308903,0.1698047583056312
2174,0.2995,4,67,4,109197,496413,6412,101544,4.598290044092037,0.16981823107681657
2175,0.2996,2,52,2,109249,496361,6414,101542,4.597808366371485,0.16983022329709
2176,0.2997,10,110,10,109359,496251,6424,101532,4.596789432731854,0.16984758683334922
2177,0.2998,6,71,6,109430,496180,6430,101526,4.596131757382637,0.16985942921770905
2178,0.2999,7,74,7,109504,496106,6437,101519,4.595446292934159,0.16987073833925956
2179,0.3,11,123,11,109627,495983,6448,101508,4.594306939864389,0.16989042512774252
2180,0.3001,6,68,6,109695,495915,6454,101502,4.593677053614435,0.16990142563736887
2181,0.3002,6,63,6,109758,495852,6460,101496,4.59309348252992,0.1699110066493903
2182,0.3003,11,92,11,109850,495760,6471,101485,4.592241283485865,0.16992189135112057
2183,0.3004,10,104,10,109954,495656,6481,101475,4.591277928044759,0.16993758488505872
2184,0.3005,11,109,11,110063,495547,6492,101464,4.590268257438216,0.1699533174430622
2185,0.3006,13,111,13,110174,495436,6505,101451,4.589240060765497,0.16996684464563644
2186,0.3007,11,78,11,110252,495358,6516,101440,4.5885175441846675,0.16997375996568354
2187,0.3008,2,86,2,110338,495272,6518,101438,4.5877209233391385,0.16999547518895275
2188,0.3009,9,122,9,110460,495150,6527,101429,4.5865908333024565,0.17001771768701213
2189,0.301,6,90,6,110550,495060,6533,101423,4.585757160324577,0.1700350219536852
2190,0.3011,7,80,7,110630,494980,6540,101416,4.585016117677572,0.17004808885371464
2191,0.3012,3,61,3,110691,494919,6543,101413,4.584451072659231,0.17006130813037032
2192,0.3013,12,107,12,110798,494812,6555,101401,4.583459928118863,0.170075124158648
2193,0.3014,2,34,2,110832,494778,6557,101399,4.583144984993886,0.17008203939434094
2194,0.3015,8,75,8,110907,494703,6565,101391,4.58245025751232,0.17009230087872046
2195,0.3016,1,23,1,110930,494680,6566,101390,4.582237207751306,0.17009747177344942
2196,0.3017,5,89,5,111019,494591,6571,101385,4.581412797806514,0.17011591070781373
2197,0.3018,4,59,4,111078,494532,6575,101381,4.580866278854348,0.17012718299483315
2198,0.3019,10,130,10,111208,494402,6585,101371,4.579662084552966,0.170150376066052
2199,0.302,8,128,8,111336,494274,6593,101363,4.578476416317759,0.17017579498923002
2200,0.3021,6,52,6,111388,494222,6599,101357,4.577994738597206,0.1701822931970402
2201,0.3022,4,118,4,111506,494104,6603,101353,4.576901700692875,0.17021044340733252
2202,0.3023,5,40,5,111546,494064,6608,101348,4.576531179369373,0.17021491001189093
2203,0.3024,2,47,2,111593,494017,6610,101346,4.576095816814258,0.1702255598685172
2204,0.3025,4,36,4,111629,493981,6614,101342,4.5757623476231055,0.1702302783530957
2205,0.3026,6,92,6,111721,493889,6620,101336,4.57491014857905,0.17024822546096013
2206,0.3027,9,99,9,111820,493790,6629,101327,4.573993108303383,0.17026399850785645
2207,0.3028,14,170,14,111990,493620,6643,101313,4.5724183926784985,0.17029312544437777
2208,0.3029,8,68,8,112058,493552,6651,101305,4.571788506428545,0.1703014337899697
2209,0.303,10,125,10,112183,493427,6661,101295,4.5706306272926005,0.17032327709417172
2210,0.3031,14,174,14,112357,493253,6675,101281,4.569018859535366,0.17035358785199836
2211,0.3032,8,48,8,112405,493205,6683,101273,4.568574233947164,0.17035617802509093
2212,0.3033,2,24,2,112429,493181,6685,101271,4.568351921153062,0.17036026457981468
2213,0.3034,9,106,9,112535,493075,6694,101262,4.567370039645781,0.17037808516043929
2214,0.3035,7,66,7,112601,493009,6701,101255,4.566758679462003,0.17038723530282837
2215,0.3036,3,41,3,112642,492968,6704,101252,4.566378895105413,0.1703948032715156
2216,0.3037,2,55,2,112697,492913,6706,101250,4.565869428285598,0.1704077837226485
2217,0.3038,4,59,4,112756,492854,6710,101246,4.565322909333432,0.1704191213600404
2218,0.3039,8,77,8,112833,492777,6718,101238,4.564609655785691,0.1704300396454635
2219,0.304,16,112,16,112945,492665,6734,101222,4.5635721960798845,0.17043983114632918
2220,0.3041,6,142,6,113087,492523,6740,101216,4.562256845381452,0.17047221085359054
2221,0.3042,11,112,11,113199,492411,6751,101205,4.5612193856756456,0.17048900299183312
2222,0.3043,6,44,6,113243,492367,6757,101199,4.560811812219793,0.1704932560153378
2223,0.3044,0,44,0,113287,492323,6757,101199,4.560404238763941,0.1705058953164331
2224,0.3045,22,151,22,113438,492172,6779,101177,4.5590055207677205,0.17051853125226468
2225,0.3046,6,81,6,113519,492091,6785,101171,4.5582552150876285,0.17053342368127405
2226,0.3047,5,58,5,113577,492033,6790,101166,4.55771795916855,0.17054310610773113
2227,0.3048,8,80,8,113657,491953,6798,101158,4.5569769165215455,0.17055492142280282
2228,0.3049,5,51,5,113708,491902,6803,101153,4.55650450183408,0.1705625953747966
2229,0.305,8,81,8,113789,491821,6811,101145,4.5557541961539885,0.17057470411456982
2230,0.3051,6,77,6,113866,491744,6817,101139,4.555040942606247,0.1705884634911104
2231,0.3052,10,101,10,113967,491643,6827,101129,4.554105376264404,0.17060353727908875
2232,0.3053,1,62,1,114029,491581,6828,101128,4.553531068212975,0.17061998383692503
2233,0.3054,10,49,10,114078,491532,6838,101118,4.553077179591686,0.17062009617818275
2234,0.3055,4,40,4,114118,491492,6842,101114,4.552706658268184,0.17062601458642
2235,0.3056,1,55,1,114173,491437,6843,101113,4.552197191448368,0.1706404522825078
2236,0.3057,12,83,12,114256,491354,6855,101101,4.551428359702101,0.17064755973027487
2237,0.3058,4,62,4,114318,491292,6859,101097,4.550854051650672,0.17065981981434497
2238,0.3059,7,68,7,114386,491224,6866,101090,4.550224165400719,0.17066961105089531
2239,0.306,8,60,8,114446,491164,6874,101082,4.549668383415465,0.17067569894942305
2240,0.3061,6,83,6,114529,491081,6880,101076,4.548899551669199,0.17069121871395593
2241,0.3062,9,126,9,114655,490955,6889,101067,4.547732409500167,0.1707149396475131
2242,0.3063,7,96,7,114751,490859,6896,101060,4.546843158323761,0.1707328198621771
2243,0.3064,9,107,9,114858,490752,6905,101051,4.545852013783393,0.17075107763901162
2244,0.3065,5,48,5,114906,490704,6910,101046,4.545407388195191,0.17075792141951837
2245,0.3066,14,57,14,114963,490647,6924,101032,4.5448793953092,0.1707547504643565
2246,0.3067,4,53,4,115016,490594,6928,101028,4.54438845455556,0.1707644408084892
2247,0.3068,6,69,6,115085,490525,6934,101022,4.543749305272518,0.1707759484876096
2248,0.3069,4,48,4,115133,490477,6938,101018,4.543304679684316,0.1707841993592507
2249,0.307,8,103,8,115236,490374,6946,101010,4.542350587276298,0.170802727162047
2250,0.3071,11,76,11,115312,490298,6957,100999,4.541646596761644,0.1708092549091235
2251,0.3072,5,56,5,115368,490242,6962,100994,4.541127866908741,0.1708184210704355
2252,0.3073,2,69,2,115437,490173,6964,100992,4.540488717625699,0.17083555352566543
2253,0.3074,14,116,14,115553,490057,6978,100978,4.539414205787543,0.17084944208041825
2254,0.3075,6,93,6,115646,489964,6984,100972,4.538552743710401,0.17086791124588788
2255,0.3076,7,79,7,115725,489885,6991,100965,4.5378209640964835,0.17088093424727088
2256,0.3077,5,97,5,115822,489788,6996,100960,4.536922449886991,0.17090197512306432
2257,0.3078,7,86,7,115908,489702,7003,100953,4.536125829041461,0.17091703278563627
2258,0.3079,11,136,11,116044,489566,7014,100942,4.534866056541554,0.17094095253578276
2259,0.308,7,80,7,116124,489486,7021,100935,4.53412501389455,0.17095428516262126
2260,0.3081,3,68,3,116192,489418,7024,100932,4.533495127644596,0.1709697636995003
2261,0.3082,13,80,13,116272,489338,7037,100919,4.532754084997592,0.17097467713216447
2262,0.3083,2,29,2,116301,489309,7039,100917,4.532485457038052,0.1709802685750882
2263,0.3084,1,23,1,116324,489286,7040,100916,4.532272407277039,0.17098552698906477
2264,0.3085,2,45,2,116369,489241,7042,100914,4.531855570788099,0.1709957553524074
2265,0.3086,6,66,6,116435,489175,7048,100908,4.531244210604321,0.17100645163477002
2266,0.3087,7,64,7,116499,489111,7055,100901,4.530651376486717,0.1710151657932381
2267,0.3088,8,107,8,116606,489004,7063,100893,4.529660231946348,0.17103494338842204
2268,0.3089,9,99,9,116705,488905,7072,100884,4.528743191670681,0.17105100298581358
2269,0.309,8,90,8,116795,488815,7080,100876,4.527909518692801,0.17106586330807153
2270,0.3091,2,41,2,116836,488774,7082,100874,4.527529734336211,0.17107494640870485
2271,0.3092,20,182,20,117018,488592,7102,100854,4.525843862314276,0.17109964271536324
2272,0.3093,3,92,3,117110,488500,7105,100851,4.524991663270221,0.17112213265100085
2273,0.3094,8,86,8,117196,488414,7113,100843,4.524195042424692,0.171135854134953
2274,0.3095,10,172,10,117368,488242,7123,100833,4.522601800733632,0.1711717523235581
2275,0.3096,13,138,13,117506,488104,7136,100820,4.52132350216755,0.1711935665722572
2276,0.3097,14,100,14,117606,488004,7150,100806,4.520397198858794,0.1712029347327661
2277,0.3098,9,97,9,117703,487907,7159,100797,4.519498684649301,0.1712184731206175
2278,0.3099,15,144,15,117847,487763,7174,100782,4.518164807884694,0.17123924253880332
2279,0.31,10,125,10,117972,487638,7184,100772,4.517006928748749,0.17126153532400876
2280,0.3101,8,93,8,118065,487545,7192,100764,4.516145466671607,0.17127733894942965
2281,0.3102,9,152,9,118217,487393,7201,100755,4.514737485642299,0.17130892224406102
2282,0.3103,1,52,1,118269,487341,7202,100754,4.514255807921746,0.1713226604545184
2283,0.3104,9,89,9,118358,487252,7211,100745,4.513431397976953,0.17133590817640226
2284,0.3105,4,37,4,118395,487215,7215,100741,4.513088665752714,0.17134105273183708
2285,0.3106,6,44,6,118439,487171,7221,100735,4.512681092296861,0.17134541916564894
2286,0.3107,4,45,4,118484,487126,7225,100731,4.512264255807922,0.17135289704809162
2287,0.3108,6,113,6,118597,487013,7231,100725,4.511217533069028,0.17137738243911402
2288,0.3109,4,93,4,118690,486920,7235,100721,4.510356070991886,0.17139886427257459
2289,0.311,4,59,4,118749,486861,7239,100717,4.5098095520397194,0.1714104340189728
2290,0.3111,10,114,10,118863,486747,7249,100707,4.508753566267739,0.17142959278513722
2291,0.3112,9,88,9,118951,486659,7258,100698,4.507938419356034,0.17144258091756803
2292,0.3113,25,149,25,119100,486510,7283,100673,4.506558227425988,0.17145080835105922
2293,0.3114,2,41,2,119141,486469,7285,100671,4.506178443069398,0.17145995844262016
2294,0.3115,9,80,9,119221,486389,7294,100662,4.5054374004223945,0.17147062180287573
2295,0.3116,4,63,4,119284,486326,7298,100658,4.504853829337878,0.1714833794447549
2296,0.3117,10,132,10,119416,486194,7308,100648,4.503631108970321,0.1715078334543199
2297,0.3118,5,82,5,119498,486112,7313,100643,4.502871540257142,0.17152474201327642
2298,0.3119,2,43,2,119541,486069,7315,100641,4.502473229834377,0.17153448892979495
2299,0.312,3,53,3,119594,486016,7318,100638,4.501982289080736,0.17154574928322316
2300,0.3121,4,86,4,119680,485930,7322,100634,4.501185668235207,0.1715652511916858
2301,0.3122,1,40,1,119720,485890,7323,100633,4.500815146911704,0.17157553923716545
2302,0.3123,11,74,11,119794,485816,7334,100622,4.500129682463226,0.17158165057516736
2303,0.3124,12,57,12,119851,485759,7346,100610,4.4996016895772355,0.17158137623237243
2304,0.3125,11,96,11,119947,485663,7357,100599,4.49871243840083,0.17159392899420395
2305,0.3126,2,43,2,119990,485620,7359,100597,4.498314127978065,0.17160368941876472
2306,0.3127,6,70,6,120060,485550,7365,100591,4.497665715661936,0.17161570338877505
2307,0.3128,4,60,4,120120,485490,7369,100587,4.497109933676683,0.1716276188964931
2308,0.3129,10,119,10,120239,485371,7379,100577,4.496007632739264,0.17164833739512722
2309,0.313,7,237,7,120476,485134,7386,100570,4.493812293897514,0.17170789340690862
2310,0.3131,11,70,11,120546,485064,7397,100559,4.493163881581385,0.17171285963836802
2311,0.3132,17,158,17,120704,484906,7414,100542,4.491700322353552,0.1717351498339733
2312,0.3133,6,66,6,120770,484840,7420,100536,4.491088962169773,0.17174602306893347
2313,0.3134,8,109,8,120879,484731,7428,100528,4.490079291563229,0.1717666879108224
2314,0.3135,1,20,1,120899,484711,7429,100527,4.489894030901478,0.17177114268041377
2315,0.3136,10,84,10,120983,484627,7439,100517,4.489115936122124,0.17178164691084588
2316,0.3137,7,94,7,121077,484533,7446,100510,4.488245211011893,0.17179933782645038
2317,0.3138,4,94,4,121171,484439,7450,100506,4.487374485901664,0.17182128234278438
2318,0.3139,10,113,10,121284,484326,7460,100496,4.48632776316277,0.1718403206445722
2319,0.314,5,64,5,121348,484262,7465,100491,4.485734929045167,0.1718520469326365
2320,0.3141,13,75,13,121423,484187,7478,100478,4.4850402015636,0.17185567803785073
2321,0.3142,6,45,6,121468,484142,7484,100472,4.48462336507466,0.17186040703780614
2322,0.3143,5,51,5,121519,484091,7489,100467,4.484150950387194,0.1718683176006487
2323,0.3144,3,38,3,121557,484053,7492,100464,4.483798955129868,0.1718752405832508
2324,0.3145,13,141,13,121698,483912,7505,100451,4.482492867464523,0.1718982892482926
2325,0.3146,12,146,12,121844,483766,7517,100439,4.481140464633739,0.1719242389229808
2326,0.3147,3,88,3,121932,483678,7520,100436,4.480325317722035,0.17194588727542912
2327,0.3148,9,94,9,122026,483584,7529,100427,4.479454592611805,0.17196080210817946
2328,0.3149,8,107,8,122133,483477,7537,100419,4.4784634480714365,0.1719809692136956
2329,0.315,7,82,7,122215,483395,7544,100412,4.477703879358257,0.17199519704285834
2330,0.3151,8,48,8,122263,483347,7552,100404,4.477259253770055,0.17199799229465987
2331,0.3152,1,49,1,122312,483298,7553,100403,4.476805365148764,0.17201101248755785
2332,0.3153,4,32,4,122344,483266,7557,100399,4.476508948089963,0.17201476874577026
2333,0.3154,7,67,7,122411,483199,7564,100392,4.475888324873097,0.17202458571156853
2334,0.3155,7,55,7,122466,483144,7571,100385,4.475378858053281,0.17203086736049109
2335,0.3156,10,114,10,122580,483030,7581,100375,4.4743228722812995,0.17205029096425295
2336,0.3157,10,75,10,122655,482955,7591,100365,4.473628144799733,0.17205821847356512
2337,0.3158,4,107,4,122762,482848,7595,100361,4.472637000259365,0.17208410706967828
2338,0.3159,10,85,10,122847,482763,7605,100351,4.471849642446923,0.17209499343181608
2339,0.316,10,70,10,122917,482693,7615,100341,4.471201230130794,0.1721014554897313
2340,0.3161,7,67,7,122984,482626,7622,100334,4.470580606913928,0.1721112940853575
2341,0.3162,5,59,5,123043,482567,7627,100329,4.470034087961762,0.1721216134610634
2342,0.3163,7,106,7,123149,482461,7634,100322,4.4690522064544815,0.17214297603052936
2343,0.3164,3,39,3,123188,482422,7637,100319,4.468690948164067,0.17215023483846167
2344,0.3165,10,149,10,123337,482273,7647,100309,4.4673107562340215,0.1721800536233526
2345,0.3166,16,124,16,123461,482149,7663,100293,4.466162140131164,0.17219396952829638
2346,0.3167,6,101,6,123562,482048,7669,100287,4.465226573789321,0.172215305623052
2347,0.3168,8,98,8,123660,481950,7677,100279,4.464318796546741,0.17223291866258808
2348,0.3169,10,54,10,123714,481896,7687,100269,4.463818592760013,0.17223467573626033
2349,0.317,2,52,2,123766,481844,7689,100267,4.46333691503946,0.17224721745509017
2350,0.3171,15,107,15,123873,481737,7704,100252,4.462345770499092,0.17225755125955988
2351,0.3172,11,72,11,123945,481665,7715,100241,4.461678832116788,0.17226321777056774
2352,0.3173,8,54,8,123999,481611,7723,100233,4.46117862833006,0.17226782436529378
2353,0.3174,4,63,4,124062,481548,7727,100229,4.460595057245545,0.1722807879995256
2354,0.3175,2,55,2,124117,481493,7729,100227,4.460085590425729,0.17229423090146462
2355,0.3176,8,59,8,124176,481434,7737,100219,4.459539071473563,0.17230032338868706
2356,0.3177,3,64,3,124240,481370,7740,100216,4.45894623735596,0.17231501446045813
2357,0.3178,2,62,2,124302,481308,7742,100214,4.458371929304532,0.172330539515272
2358,0.3179,10,104,10,124406,481204,7752,100204,4.457408573863426,0.17234712972645716
2359,0.318,14,108,14,124514,481096,7766,100190,4.45640816628997,0.17235921732159384
2360,0.3181,12,127,12,124641,480969,7778,100178,4.455231761087851,0.1723797937526994
2361,0.3182,1,75,1,124716,480894,7779,100177,4.454537033606284,0.17240061885724808
2362,0.3183,5,57,5,124773,480837,7784,100172,4.454009040720293,0.17241041016576336
2363,0.3184,8,105,8,124878,480732,7792,100164,4.4530364222461,0.17243017683027598
2364,0.3185,10,57,10,124935,480675,7802,100154,4.45250842936011,0.17243285028812266
2365,0.3186,6,57,6,124992,480618,7808,100148,4.451980436474119,0.1724412241763464
2366,0.3187,9,44,9,125036,480574,7817,100139,4.451572863018266,0.17244146420004375
2367,0.3188,11,87,11,125123,480487,7828,100128,4.450766979139649,0.17245162457049854
2368,0.3189,9,82,9,125205,480405,7837,100119,4.45000741042647,0.1724631539781301
2369,0.319,10,82,10,125287,480323,7847,100109,4.449247841713291,0.17247326129503543
2370,0.3191,2,43,2,125330,480280,7849,100107,4.448849531290525,0.1724831879418388
2371,0.3192,16,142,16,125472,480138,7865,100091,4.447534180592093,0.17250258087755008
2372,0.3193,10,101,10,125573,480037,7875,100081,4.4465986142502505,0.17251834971505797
2373,0.3194,7,110,7,125683,479927,7882,100074,4.445579680610619,0.17254108182572098
2374,0.3195,11,90,11,125773,479837,7893,100063,4.444746007632739,0.17255216416623556
2375,0.3196,17,109,17,125882,479728,7910,100046,4.443736337026196,0.172560342478276
2376,0.3197,8,88,8,125970,479640,7918,100038,4.442921190114491,0.17257511929036465
2377,0.3198,11,139,11,126109,479501,7929,100027,4.441633628515321,0.17260080617329965
2378,0.3199,9,121,9,126230,479380,7938,100018,4.440512801511727,0.1726239993924729
2379,0.32,7,102,7,126332,479278,7945,100011,4.439567972136796,0.17264439683819302
2380,0.3201,12,94,12,126426,479184,7957,99999,4.438697247026567,0.17265527475771905
2381,0.3202,7,115,7,126541,479069,7964,99992,4.437631998221498,0.17267956225682612
2382,0.3203,4,46,4,126587,479023,7968,99988,4.43720589869947,0.1726875655212077
2383,0.3204,8,105,8,126692,478918,7976,99980,4.436233280225277,0.17270745450839353
2384,0.3205,3,48,3,126740,478870,7979,99977,4.435788654637074,0.17271748838639572
2385,0.3206,13,125,13,126865,478745,7992,99964,4.43463077550113,0.17273621111819584
2386,0.3207,8,71,8,126936,478674,8000,99956,4.433973100151913,0.1727459689266025
2387,0.3208,6,92,6,127028,478582,8006,99950,4.433120901107859,0.17276486002502886
2388,0.3209,7,96,7,127124,478486,8013,99943,4.432231649931453,0.17278352226461674
2389,0.321,9,151,9,127275,478335,8022,99934,4.430832931935233,0.1728157656730691
2390,0.3211,11,82,11,127357,478253,8033,99923,4.4300733632220535,0.17282453785698473
2391,0.3212,10,109,10,127466,478144,8043,99913,4.42906369261551,0.17284281653885344
2392,0.3213,2,69,2,127535,478075,8045,99911,4.4284245433324685,0.1728605883187482
2393,0.3214,22,153,22,127688,477922,8067,99889,4.427007299270073,0.1728748673874329
2394,0.3215,12,109,12,127797,477813,8079,99877,4.42599762866353,0.17289030448856654
2395,0.3216,2,81,2,127878,477732,8081,99875,4.425247322983438,0.17291168562707862
2396,0.3217,1,119,1,127997,477613,8082,99874,4.424145022046019,0.1729458844961012
2397,0.3218,2,57,2,128054,477556,8084,99872,4.423617029160028,0.17296009199415338
2398,0.3219,10,81,10,128135,477475,8094,99862,4.422866723479936,0.17297003310025166
2399,0.322,10,103,10,128238,477372,8104,99852,4.421912631071918,0.1729865702049811
2400,0.3221,6,83,6,128321,477289,8110,99846,4.421143799325651,0.17300285028632817
2401,0.3222,8,99,8,128420,477190,8118,99838,4.420226759049983,0.17302106656869337
2402,0.3223,14,65,14,128485,477125,8132,99824,4.4196246618992925,0.1730204922792136
2403,0.3224,10,81,10,128566,477044,8142,99814,4.4188743562192005,0.1730304511682251
2404,0.3225,3,60,3,128626,476984,8145,99811,4.418318574233947,0.1730441491344412
2405,0.3226,11,92,11,128718,476892,8156,99800,4.417466375189893,0.17305598135573236
2406,0.3227,9,72,9,128790,476820,8165,99791,4.4167994368075885,0.17306468312259043
2407,0.3228,3,43,3,128833,476777,8168,99788,4.416401126384823,0.17307328748710032
2408,0.3229,8,85,8,128918,476692,8176,99780,4.415613768572381,0.17308733121469908
2409,0.323,4,46,4,128964,476646,8180,99776,4.415187669050354,0.17309540579644775
2410,0.3231,6,36,6,129000,476610,8186,99770,4.414854199859202,0.17309760921614212
2411,0.3232,10,57,10,129057,476553,8196,99760,4.414326206973211,0.17310038121645702
2412,0.3233,4,44,4,129101,476509,8200,99756,4.413918633517359,0.1731078583637736
2413,0.3234,9,102,9,129203,476407,8209,99747,4.412973804142428,0.1731255879504438
2414,0.3235,11,97,11,129300,476310,8220,99736,4.412075289932936,0.17313895070879756
2415,0.3236,3,33,3,129333,476277,8223,99733,4.411769609841047,0.1731445634624399
2416,0.3237,11,73,11,129406,476204,8234,99722,4.411093408425655,0.1731507172796505
2417,0.3238,10,112,10,129518,476092,8244,99712,4.410055948719849,0.17317003702648817
2418,0.3239,5,81,5,129599,476011,8249,99707,4.409305643039757,0.17318722013207855
2419,0.324,9,133,9,129732,475878,8258,99698,4.408073659639112,0.17321431053414318
2420,0.3241,13,74,13,129806,475804,8271,99685,4.4073881951906335,0.17321790685834135
2421,0.3242,14,168,14,129974,475636,8285,99671,4.4058320056319245,0.17324837000071266
2422,0.3243,9,47,9,130021,475589,8294,99662,4.405396643076809,0.17324959017889582
2423,0.3244,17,123,17,130144,475466,8311,99645,4.40425729000704,0.1732622050352019
2424,0.3245,8,89,8,130233,475377,8319,99637,4.4034328800622475,0.17327752019950818
2425,0.3246,5,57,5,130290,475320,8324,99632,4.402904887176257,0.17328750921816083
2426,0.3247,3,46,3,130336,475274,8327,99629,4.402478787654229,0.17329706054760544
2427,0.3248,10,65,10,130401,475209,8337,99619,4.4018766905035385,0.1733022747674087
2428,0.3249,22,131,22,130532,475078,8359,99597,4.400663233169069,0.1733101318136338
2429,0.325,18,179,18,130711,474899,8377,99579,4.3990051502463965,0.17333823053276193
2430,0.3251,19,152,19,130863,474747,8396,99560,4.3975971692170885,0.17335675866740263
2431,0.3252,14,108,14,130971,474639,8410,99546,4.396596761643632,0.17336921027195068
2432,0.3253,13,117,13,131088,474522,8423,99533,4.395512986772388,0.17338582540000522
2433,0.3254,7,78,7,131166,474444,8430,99526,4.39479047019156,0.1733993065839678
2434,0.3255,0,16,0,131182,474428,8430,99526,4.394642261662159,0.1734041404014956
2435,0.3256,4,47,4,131229,474381,8434,99522,4.3942068991070435,0.17341258017469852
2436,0.3257,10,80,10,131309,474301,8444,99512,4.393465856460039,0.17342235188118776
2437,0.3258,5,8,5,131317,474293,8449,99507,4.393391752195339,0.17341756709654932
2438,0.3259,11,111,11,131428,474182,8460,99496,4.39236355552262,0.173435272051569
2439,0.326,2,79,2,131507,474103,8462,99494,4.391631775908704,0.17345627679363734
2440,0.3261,17,154,17,131661,473949,8479,99477,4.3902052688132205,0.17347835640518566
2441,0.3262,4,47,4,131708,473902,8483,99473,4.389769906258105,0.17348681055155876
2442,0.3263,6,79,6,131787,473823,8489,99467,4.389038126644189,0.17350206701669313
2443,0.3264,10,82,10,131869,473741,8499,99457,4.388278557931009,0.1735124686408536
2444,0.3265,8,58,8,131927,473683,8507,99449,4.387741302011931,0.17351849137720454
2445,0.3266,4,62,4,131989,473621,8511,99445,4.387166993960502,0.17353149549964578
2446,0.3267,15,104,15,132093,473517,8526,99430,4.3862036385193965,0.17354135722850456
2447,0.3268,13,117,13,132210,473400,8539,99417,4.3851198636481525,0.173558047334489
2448,0.3269,8,108,8,132318,473292,8547,99409,4.384119456074697,0.173579232444155
2449,0.327,13,163,13,132481,473129,8560,99396,4.382609581681426,0.1736098860311777
2450,0.3271,12,102,12,132583,473027,8572,99384,4.381664752306495,0.17362349780140493
2451,0.3272,7,104,7,132687,472923,8579,99377,4.38070139686539,0.17364494146426698
2452,0.3273,9,95,9,132782,472828,8588,99368,4.379821408722072,0.17366077358108062
2453,0.3274,18,114,18,132896,472714,8606,99350,4.3787654229500905,0.1736693796498294
2454,0.3275,10,71,10,132967,472643,8616,99340,4.3781077476008745,0.17367649038520375
2455,0.3276,8,82,8,133049,472561,8624,99332,4.377348178887695,0.17368983358775156
2456,0.3277,6,71,6,133120,472490,8630,99326,4.376690503538478,0.17370272954936553
2457,0.3278,8,89,8,133209,472401,8638,99318,4.375866093593686,0.17371820772092583
2458,0.3279,10,126,10,133335,472275,8648,99308,4.374698951424654,0.1737420462120112
2459,0.328,10,153,10,133488,472122,8658,99298,4.373281707362259,0.17377410661159917
2460,0.3281,6,84,6,133572,472038,8664,99292,4.372503612582904,0.17379097894386783
2461,0.3282,9,96,9,133668,471942,8673,99283,4.371614361406499,0.17380716880388639
2462,0.3283,17,164,17,133832,471778,8690,99266,4.37009522398014,0.17383248926527553
2463,0.3284,6,71,6,133903,471707,8696,99260,4.369437548630923,0.17384542364094596
2464,0.3285,4,69,4,133972,471638,8700,99256,4.368798399347883,0.17386064663492698
2465,0.3286,7,92,7,134064,471546,8707,99249,4.367946200303828,0.1738785378288177
2466,0.3287,7,69,7,134133,471477,8714,99242,4.367307051020786,0.1738894271962209
2467,0.3288,7,83,7,134216,471394,8721,99235,4.36653821927452,0.17390458599194925
2468,0.3289,8,45,8,134261,471349,8729,99227,4.366121382785579,0.17390671882448613
2469,0.329,10,99,10,134360,471250,8739,99217,4.365204342509911,0.17392241794880334
2470,0.3291,9,59,9,134419,471191,8748,99208,4.364657823557746,0.1739273736454657
2471,0.3292,5,81,5,134500,471110,8753,99203,4.363907517877654,0.17394483380178954
2472,0.3293,8,119,8,134619,470991,8761,99195,4.3628052169402345,0.17396954677947196
2473,0.3294,7,98,7,134717,470893,8768,99188,4.361897439697654,0.17398931029099374
2474,0.3295,10,94,10,134811,470799,8778,99178,4.361026714587425,0.1740035124224311
2475,0.3296,15,117,15,134928,470682,8793,99163,4.359942939716181,0.1740174959857505
2476,0.3297,3,73,3,135001,470609,8796,99160,4.359266738300789,0.17403544243368804
2477,0.3298,10,85,10,135086,470524,8806,99150,4.3584793804883475,0.1740469110403494
2478,0.3299,10,79,10,135165,470445,8816,99140,4.35774760087443,0.17405654994425765
2479,0.33,6,107,6,135272,470338,8822,99134,4.356756456334062,0.17408055180939536
2480,0.3301,4,51,4,135323,470287,8826,99130,4.356284041646597,0.1740903415247525
2481,0.3302,9,87,9,135410,470200,8835,99121,4.35547815776798,0.17410388866737744
2482,0.3303,14,111,14,135521,470089,8849,99107,4.354449961095261,0.17411752717868714
2483,0.3304,6,58,6,135579,470031,8855,99101,4.353912705176183,0.17412656466338214
2484,0.3305,5,48,5,135627,469983,8860,99096,4.35346807958798,0.17413399545581545
2485,0.3306,12,119,12,135746,469864,8872,99084,4.352365778650562,0.1741529981650344
2486,0.3307,19,129,19,135875,469735,8891,99065,4.351170847382267,0.17416490857946554
2487,0.3308,8,86,8,135961,469649,8899,99057,4.350374226536737,0.1741796288416159
2488,0.3309,6,95,6,136056,469554,8905,99051,4.34949423839342,0.17420001582821115
2489,0.331,14,123,14,136179,469431,8919,99037,4.34835488532365,0.17421737019498018
2490,0.3311,21,116,21,136295,469315,8940,99016,4.347280373485494,0.1742224161624124
2491,0.3312,16,140,16,136435,469175,8956,99000,4.345983548853236,0.17424209090509085
2492,0.3313,13,127,13,136562,469048,8969,98987,4.344807143651117,0.1742621493393893
2493,0.3314,13,85,13,136647,468963,8982,98974,4.344019785838675,0.17426932916855215
2494,0.3315,5,56,5,136703,468907,8987,98969,4.343501055985772,0.17427924406032302
2495,0.3316,0,41,0,136744,468866,8987,98969,4.343121271629182,0.1742918277316474
2496,0.3317,11,80,11,136824,468786,8998,98958,4.342380228982178,0.1743003889076767
2497,0.3318,14,135,14,136959,468651,9012,98944,4.341129719515358,0.17432147922374228
2498,0.3319,3,70,3,137029,468581,9015,98941,4.340481307199229,0.17433861594792802
2499,0.332,21,132,21,137161,468449,9036,98920,4.339258586831672,0.1743486161563286
2500,0.3321,20,173,20,137334,468276,9056,98900,4.337656082107525,0.17437268149569093
2501,0.3322,7,106,7,137440,468170,9063,98893,4.336674200600244,0.1743950848494788
2502,0.3323,6,50,6,137490,468120,9069,98887,4.3362110489458665,0.17440172696280645
2503,0.3324,11,88,11,137578,468032,9080,98876,4.335395902034162,0.17441277949861353
2504,0.3325,13,130,13,137708,467902,9093,98863,4.33419170773278,0.1744338482439812
2505,0.3326,10,86,10,137794,467816,9103,98853,4.333395086887251,0.1744457522821965
2506,0.3327,13,110,13,137904,467706,9116,98840,4.332376153247619,0.17446067927405717
2507,0.3328,5,79,5,137983,467627,9121,98835,4.3316443736337025,0.1744777231305895
2508,0.3329,13,163,13,138146,467464,9134,98822,4.330134499240431,0.17450899368870146
2509,0.333,7,135,7,138281,467329,9141,98815,4.328883989773612,0.1745403996156455
2510,0.3331,3,59,3,138340,467270,9144,98812,4.328337470821446,0.17455421652693426
2511,0.3332,5,87,5,138427,467183,9149,98807,4.327531586942828,0.17457375572006573
2512,0.3333,12,115,12,138542,467068,9161,98795,4.3264663381377595,0.1745917298003227
2513,0.3334,3,103,3,138645,466965,9164,98792,4.325512245729742,0.17461913860544367
2514,0.3335,8,124,8,138769,466841,9172,98784,4.324363629626885,0.1746457458563536
2515,0.3336,5,57,5,138826,466784,9177,98779,4.3238356367408946,0.17465605069638573
2516,0.3337,7,120,7,138946,466664,9184,98772,4.322724072770388,0.17468289956776717
2517,0.3338,20,163,20,139109,466501,9204,98752,4.321214198377117,0.17470407056663123
2518,0.3339,3,110,3,139219,466391,9207,98749,4.320195264737485,0.1747336943058357
2519,0.334,12,73,12,139292,466318,9219,98737,4.319519063322094,0.17473874224633001
2520,0.3341,9,62,9,139354,466256,9228,98728,4.318944755270666,0.17474477153335316
2521,0.3342,13,130,13,139484,466126,9241,98715,4.317740560969284,0.17476599609447616
2522,0.3343,6,90,6,139574,466036,9247,98709,4.316906887991404,0.17478507999185472
2523,0.3344,9,100,9,139674,465936,9256,98700,4.315980584682649,0.17480288185662976
2524,0.3345,10,94,10,139768,465842,9266,98690,4.315109859572418,0.17481737084877386
2525,0.3346,20,167,20,139935,465675,9286,98670,4.313562933046797,0.17483985859713475
2526,0.3347,14,115,14,140050,465560,9300,98656,4.312497684241728,0.1748550200632382
2527,0.3348,5,44,5,140094,465516,9305,98651,4.312090110785876,0.17486134424735938
2528,0.3349,15,100,15,140194,465416,9320,98636,4.31116380747712,0.17487040201967194
2529,0.335,17,142,17,140336,465274,9337,98619,4.309848456778687,0.17488956238151565
2530,0.3351,16,122,16,140458,465152,9353,98603,4.308718366742006,0.17490399198233275
2531,0.3352,2,48,2,140506,465104,9355,98601,4.308273741153803,0.17491595781481448
2532,0.3353,6,64,6,140570,465040,9361,98595,4.3076809070362,0.17492703611379706
2533,0.3354,10,95,10,140665,464945,9371,98585,4.306800918892883,0.17494188419427537
2534,0.3355,10,115,10,140780,464830,9381,98575,4.305735670087814,0.17496294850063454
2535,0.3356,11,112,11,140892,464718,9392,98564,4.304698210382007,0.17498162554457625
2536,0.3357,11,102,11,140994,464616,9403,98553,4.303753381007077,0.1749972033261774
2537,0.3358,9,63,9,141057,464553,9412,98544,4.3031698099225615,0.17500359618325084
2538,0.3359,7,82,7,141139,464471,9419,98537,4.302410241209381,0.1750188274411731
2539,0.336,9,143,9,141282,464328,9428,98528,4.301085627477861,0.17505010162457182
2540,0.3361,17,103,17,141385,464225,9445,98511,4.300131535069843,0.17505722043729208
2541,0.3362,6,59,6,141444,464166,9451,98505,4.299585016117677,0.17506677969897153
2542,0.3363,12,122,12,141566,464044,9463,98493,4.298454926080996,0.17508714982303386
2543,0.3364,18,124,18,141690,463920,9481,98475,4.297306309978139,0.17509935187901743
2544,0.3365,4,71,4,141761,463849,9485,98471,4.296648634628923,0.17511559254517
2545,0.3366,17,116,17,141877,463733,9502,98454,4.295574122790766,0.1751267816580604
2546,0.3367,4,68,4,141945,463665,9506,98450,4.294944236540813,0.1751420972576786
2547,0.3368,8,108,8,142053,463557,9514,98442,4.2939438289673575,0.17516401274735363
2548,0.3369,2,88,2,142141,463469,9516,98440,4.293128682055652,0.17518850917141388
2549,0.337,8,125,8,142266,463344,9524,98432,4.291970802919708,0.17521574435362136
2550,0.3371,10,123,10,142389,463221,9534,98422,4.2908314498499385,0.17523943145378826
2551,0.3372,9,85,9,142474,463136,9543,98413,4.290044092037497,0.17525273840751207
2552,0.3373,9,83,9,142557,463053,9552,98404,4.289275260291229,0.1752654254911774
2553,0.3374,22,145,22,142702,462908,9574,98382,4.287932120493535,0.17527837659676815
2554,0.3375,11,99,11,142801,462809,9585,98371,4.287015080217866,0.1752931323283082
2555,0.3376,17,200,17,143001,462609,9602,98354,4.285162473600356,0.17533063677996588
2556,0.3377,14,122,14,143123,462487,9616,98340,4.284032383563674,0.17534819115342165
2557,0.3378,14,126,14,143249,462361,9630,98326,4.282865241394642,0.17536700512050396
2558,0.3379,16,89,16,143338,462272,9646,98310,4.28204083144985,0.17537131053084115
2559,0.338,9,77,9,143415,462195,9655,98301,4.2813275779021085,0.17538216151408753
2560,0.3381,9,92,9,143507,462103,9664,98292,4.280475378858053,0.17539771054345596
2561,0.3382,7,93,7,143600,462010,9671,98285,4.279613916780911,0.17541652165377167
2562,0.3383,14,132,14,143732,461878,9685,98271,4.278391196413353,0.1754372497317678
2563,0.3384,14,131,14,143863,461747,9699,98257,4.277177739078884,0.17545767530231926
2564,0.3385,9,70,9,143933,461677,9708,98248,4.2765293267627555,0.17546635710139752
2565,0.3386,18,151,18,144084,461526,9726,98230,4.275130608766535,0.17548717655549917
2566,0.3387,8,73,8,144157,461453,9734,98222,4.2744544073511435,0.17549828025193193
2567,0.3388,4,68,4,144225,461385,9738,98218,4.273824521101189,0.17551371239968336
2568,0.3389,9,94,9,144319,461291,9747,98209,4.27295379599096,0.17552993744414655
2569,0.339,9,133,9,144452,461158,9756,98200,4.2717218125903145,0.17555840803206532
2570,0.3391,8,96,8,144548,461062,9764,98192,4.2708325614139095,0.1755767504568586
2571,0.3392,11,100,11,144648,460962,9775,98181,4.269906258105154,0.17559193265407955
2572,0.3393,11,87,11,144735,460875,9786,98170,4.269100374226537,0.1756030373225769
2573,0.3394,3,58,3,144793,460817,9789,98167,4.268563118307458,0.1756168333977359
2574,0.3395,6,46,6,144839,460771,9795,98161,4.268137018785431,0.17562243707642433
2575,0.3396,17,128,17,144967,460643,9812,98144,4.266951350550224,0.17563758641485933
2576,0.3397,11,91,11,145058,460552,9823,98133,4.266108414539257,0.17564996375417274
2577,0.3398,12,51,12,145109,460501,9835,98121,4.265635999851791,0.17564829168919233
2578,0.3399,15,164,15,145273,460337,9850,98106,4.264116862425433,0.17567773255282992
2579,0.34,13,91,13,145364,460246,9863,98093,4.263273926414465,0.1756871721301933
2580,0.3401,10,165,10,145529,460081,9873,98083,4.2617455259550185,0.17572433908313687
2581,0.3402,14,97,14,145626,459984,9887,98069,4.260847011745526,0.17573420445728274
2582,0.3403,11,67,11,145693,459917,9898,98058,4.26022638852866,0.17573905640933735
2583,0.3404,10,72,10,145765,459845,9908,98048,4.259559450146356,0.17574696223110883
2584,0.3405,9,103,9,145868,459742,9917,98039,4.258605357738338,0.17576611609215803
2585,0.3406,6,122,6,145990,459620,9923,98033,4.257475267701656,0.17579570091078145
2586,0.3407,4,117,4,146107,459503,9927,98029,4.256391492830413,0.17582667900676552
2587,0.3408,7,108,7,146215,459395,9934,98022,4.2553910852569565,0.17585039566428723
2588,0.3409,12,156,12,146371,459239,9946,98010,4.253946052095298,0.17588187686294637
2589,0.341,13,95,13,146466,459144,9959,97997,4.25306606395198,0.17589263759084325
2590,0.3411,5,86,5,146552,459058,9964,97992,4.252269443106451,0.1759123956556862
2591,0.3412,12,129,12,146681,458929,9976,97980,4.251074511838156,0.17593538621211005
2592,0.3413,13,119,13,146800,458810,9989,97967,4.249972210900737,0.17595374808945052
2593,0.3414,7,93,7,146893,458717,9996,97960,4.249110748823595,0.17597278134357985
2594,0.3415,15,127,15,147020,458590,10011,97945,4.247934343621475,0.17599072834592613
2595,0.3416,4,54,4,147074,458536,10015,97941,4.2474341398347475,0.17600188327639776
2596,0.3417,16,152,16,147226,458384,10031,97925,4.2460261588054395,0.1760262731683291
2597,0.3418,7,94,7,147320,458290,10038,97918,4.245155433695209,0.17604565198630728
2598,0.3419,16,90,16,147410,458200,10054,97902,4.244321760717329,0.176050436790373
2599,0.342,6,86,6,147496,458114,10060,97896,4.2435251398717995,0.1760687757414435
2600,0.3421,3,40,3,147536,458074,10063,97893,4.243154618548298,0.17607699737574353
2601,0.3422,9,63,9,147599,458011,10072,97884,4.242571047463781,0.17608361291251046
2602,0.3423,6,55,6,147654,457956,10078,97878,4.242061580643966,0.17609214261811978
2603,0.3424,7,186,7,147840,457770,10085,97871,4.240338656489681,0.17614070955886985
2604,0.3425,9,62,9,147902,457708,10094,97862,4.239764348438253,0.17614702017747538
2605,0.3426,6,156,6,148058,457552,10100,97856,4.238319315276594,0.17618759542534498
2606,0.3427,10,141,10,148199,457411,10110,97846,4.237013227611249,0.1762174992841153
2607,0.3428,7,105,7,148304,457306,10117,97839,4.2360406091370555,0.17624044168640626
2608,0.3429,9,107,9,148411,457199,10126,97830,4.235049464596687,0.17626106023288873
2609,0.343,7,74,7,148485,457125,10133,97823,4.234364000148209,0.1762741734360697
2610,0.3431,8,79,8,148564,457046,10141,97815,4.233632220534291,0.17628739450060465
2611,0.3432,22,203,22,148767,456843,10163,97793,4.231751824817518,0.17631924361202664
2612,0.3433,4,87,4,148854,456756,10167,97789,4.230945940938901,0.1763409642139051
2613,0.3434,16,95,16,148949,456661,10183,97773,4.2300659527955835,0.17634741015161406
2614,0.3435,5,94,5,149043,456567,10188,97768,4.229195227685353,0.1763698846365465
2615,0.3436,18,213,18,149256,456354,10206,97750,4.227222201637704,0.17641092646867737
2616,0.3437,8,103,8,149359,456251,10214,97742,4.226268109229686,0.17643183217116462
2617,0.3438,11,112,11,149471,456139,10225,97731,4.22523064952388,0.17645115279758788
2618,0.3439,12,108,12,149579,456031,10237,97719,4.2242302419504245,0.17646772009029346
2619,0.344,11,72,11,149651,455959,10248,97708,4.22356330356812,0.17647430675839448
2620,0.3441,12,72,12,149723,455887,10260,97696,4.222896365185816,0.17647940778528243
2621,0.3442,7,62,7,149785,455825,10267,97689,4.222322057134388,0.17648876089854998
2622,0.3443,6,73,6,149858,455752,10273,97683,4.221645855718997,0.17650311237995428
2623,0.3444,9,83,9,149941,455669,10282,97674,4.220877023972729,0.1765161933918022
2624,0.3445,6,93,6,150034,455576,10288,97668,4.220015561895587,0.17653693487864305
2625,0.3446,11,92,11,150126,455484,10299,97657,4.219163362851532,0.17654992126781419
2626,0.3447,10,127,10,150253,455357,10309,97647,4.217986957649413,0.17657557630686216
2627,0.3448,1,25,1,150278,455332,10310,97646,4.217755381822224,0.1765820701727736
2628,0.3449,30,180,30,150458,455152,10340,97616,4.2160880358664645,0.1765948824823434
2629,0.345,19,126,19,150584,455026,10359,97597,4.214920893697433,0.1766068368489911
2630,0.3451,6,68,6,150652,454958,10365,97591,4.214291007447478,0.1766196301142523
2631,0.3452,18,199,18,150851,454759,10383,97573,4.212447663863055,0.17665643127684075
2632,0.3453,12,121,12,150972,454638,10395,97561,4.211326836859461,0.17667724860059508
2633,0.3454,21,163,21,151135,454475,10416,97540,4.20981696246619,0.17669809697200256
2634,0.3455,17,133,17,151268,454342,10433,97523,4.208584979065545,0.17671531986989572
2635,0.3456,16,92,16,151360,454250,10449,97507,4.20773278002149,0.17672091156070516
2636,0.3457,14,109,14,151469,454141,10463,97493,4.206723109414947,0.17673493657026218
2637,0.3458,7,142,7,151611,453999,10470,97486,4.205407758716514,0.1767699937441635
2638,0.3459,9,100,9,151711,453899,10479,97477,4.204481455407759,0.1767886161167697
2639,0.346,1,72,1,151783,453827,10480,97476,4.203814517025455,0.17681021144452325
2640,0.3461,16,106,16,151889,453721,10496,97460,4.202832635518174,0.17682031855234487
2641,0.3462,10,161,10,152050,453560,10506,97450,4.201341287191078,0.17685704433676339
2642,0.3463,11,66,11,152116,453494,10517,97439,4.200729927007299,0.1768617962619774
2643,0.3464,9,101,9,152217,453393,10526,97430,4.199794360665456,0.17688077658340337
2644,0.3465,25,169,25,152386,453224,10551,97405,4.198228908073659,0.17689769336522412
2645,0.3466,18,97,18,152483,453127,10569,97387,4.197330393864167,0.17690194981417368
2646,0.3467,9,108,9,152591,453019,10578,97378,4.196329986290711,0.1769232027064101
2647,0.3468,9,100,9,152691,452919,10587,97369,4.195403682981955,0.17694189224551507
2648,0.3469,8,112,8,152803,452807,10595,97361,4.194366223276149,0.17696594494772505
2649,0.347,24,156,24,152959,452651,10619,97337,4.192921190114491,0.1769802250230914
2650,0.3471,11,99,11,153058,452552,10630,97326,4.192004149838823,0.17699562448397643
2651,0.3472,10,56,10,153114,452496,10640,97316,4.19148541998592,0.17699868318625275
2652,0.3473,11,105,11,153219,452391,10651,97305,4.190512801511727,0.17701602340202585
2653,0.3474,9,195,9,153414,452196,10660,97296,4.188706510059654,0.17706536218907645
2654,0.3475,9,153,9,153567,452043,10669,97287,4.187289265997258,0.17710119600240293
2655,0.3476,3,72,3,153639,451971,10672,97284,4.186622327614955,0.17711991697845264
2656,0.3477,9,139,9,153778,451832,10681,97275,4.185334766015784,0.17715126560032926
2657,0.3478,11,93,11,153871,451739,10692,97264,4.184473303938642,0.17716478780625972
2658,0.3479,8,90,8,153961,451649,10700,97256,4.183639630960762,0.1771818438527614
2659,0.348,8,60,8,154021,451589,10708,97248,4.1830838489755084,0.17718922011453309
2660,0.3481,13,166,13,154187,451423,10721,97235,4.181546185482975,0.17722333402593238
2661,0.3482,16,190,16,154377,451233,10737,97219,4.179786209196339,0.1772607265540102
2662,0.3483,13,128,13,154505,451105,10750,97206,4.178600540961132,0.17728260056792586
2663,0.3484,12,74,12,154579,451031,10762,97194,4.177915076512654,0.17728852204842901
2664,0.3485,14,158,14,154737,450873,10776,97180,4.17645151728482,0.17731861699507165
2665,0.3486,10,83,10,154820,450790,10786,97170,4.175682685538553,0.1773304620775239
2666,0.3487,6,69,6,154889,450721,10792,97164,4.175043536255512,0.17734378564844813
2667,0.3488,4,45,4,154934,450676,10796,97160,4.174626699766572,0.1773523463226221
2668,0.3489,12,75,12,155009,450601,10808,97148,4.173931972285005,0.17735860768344625
2669,0.349,8,56,8,155065,450545,10816,97140,4.173413242432102,0.17736472607429454
2670,0.3491,5,144,5,155209,450401,10821,97135,4.172079365667495,0.17740386020279944
2671,0.3492,18,133,18,155342,450268,10839,97117,4.1708473822668495,0.17741991468527635
2672,0.3493,21,129,21,155471,450139,10860,97096,4.169652450998555,0.1774301716812704
2673,0.3494,10,85,10,155556,450054,10870,97086,4.168865093186112,0.17744270205066345
2674,0.3495,15,116,15,155672,449938,10885,97071,4.1677905813479565,0.17745777491778014
2675,0.3496,18,96,18,155768,449842,10903,97053,4.166901330171552,0.17746185282366816
2676,0.3497,16,126,16,155894,449716,10919,97037,4.16573418800252,0.17747867867208778
2677,0.3498,24,127,24,156021,449589,10943,97013,4.1645577828004,0.17748379991291652
2678,0.3499,13,61,13,156082,449528,10956,97000,4.163992737782059,0.1774840447332982
2679,0.35,8,47,8,156129,449481,10964,96992,4.163557375226945,0.17748726835543568
2680,0.3501,6,71,6,156200,449410,10970,96986,4.162899699877728,0.1775012994238611
2681,0.3502,10,52,10,156252,449358,10980,96976,4.162418022157175,0.17750313910538243
2682,0.3503,10,152,10,156404,449206,10990,96966,4.1610100411278665,0.1775374790359081
2683,0.3504,26,175,26,156579,449031,11016,96940,4.159389010337545,0.1775552181342965
2684,0.3505,25,159,25,156738,448872,11041,96915,4.157916188076624,0.17756927152900306
2685,0.3506,7,144,7,156882,448728,11048,96908,4.156582311312016,0.17760558320931905
2686,0.3507,5,80,5,156962,448648,11053,96903,4.155841268665012,0.17762409014006023
2687,0.3508,11,106,11,157068,448542,11064,96892,4.154859387157731,0.17764202451625677
2688,0.3509,11,178,11,157246,448364,11075,96881,4.153210567268146,0.17768342671643023
2689,0.351,18,134,18,157380,448230,11093,96863,4.151969320834414,0.1776999521182624
2690,0.3511,7,86,7,157466,448144,11100,96856,4.1511726999888845,0.17771743119266056
2691,0.3512,12,124,12,157590,448020,11112,96844,4.150024083886028,0.17773976625359722
2692,0.3513,7,56,7,157646,447964,11119,96837,4.149505354033125,0.17774747109495026
2693,0.3514,12,169,12,157815,447795,11131,96825,4.147939901441328,0.17778451030076017
2694,0.3515,12,97,12,157912,447698,11143,96813,4.147041387231835,0.17779806101254153
2695,0.3516,15,99,15,158011,447599,11158,96798,4.146124346956167,0.17780773957240764
2696,0.3517,6,125,6,158136,447474,11164,96792,4.144966467820223,0.1778395122972958
2697,0.3518,8,134,8,158270,447340,11172,96784,4.14372522138649,0.17787122053061435
2698,0.3519,17,79,17,158349,447261,11189,96767,4.142993441772574,0.17787135956237546
2699,0.352,18,183,18,158532,447078,11207,96749,4.141298306717552,0.17790400255963754
2700,0.3521,9,75,9,158607,447003,11216,96740,4.140603579235985,0.17791493407731226
2701,0.3522,9,46,9,158653,446957,11225,96731,4.140177479713958,0.17791637851120495
2702,0.3523,15,134,15,158787,446823,11240,96716,4.1389362332802255,0.1779375536989986
2703,0.3524,22,190,22,158977,446633,11262,96694,4.13717625699359,0.17796649163395156
2704,0.3525,10,61,10,159038,446572,11272,96684,4.136611211975249,0.17797134316049892
2705,0.3526,9,129,9,159167,446443,11281,96675,4.135416280706955,0.17799999263511795
2706,0.3527,17,106,17,159273,446337,11298,96658,4.134434399199674,0.17800900560778643
2707,0.3528,14,93,14,159366,446244,11312,96644,4.133572937122532,0.17801830211756384
2708,0.3529,8,93,8,159459,446151,11320,96636,4.132711475045389,0.17803668842474119
2709,0.353,11,128,11,159587,446023,11331,96625,4.131525806810182,0.1780620217894473
2710,0.3531,10,108,10,159695,445915,11341,96615,4.130525399236726,0.1780823180284961
2711,0.3532,18,131,18,159826,445784,11359,96597,4.129311941902256,0.17809805284477148
2712,0.3533,15,154,15,159980,445630,11374,96582,4.127885434806773,0.178125899094819
2713,0.3534,14,152,14,160132,445478,11388,96568,4.126477453777465,0.17815462156348355
2714,0.3535,16,112,16,160244,445366,11404,96552,4.125439994071659,0.1781671765839112
2715,0.3536,12,104,12,160348,445262,11416,96540,4.124476638630553,0.17818317392700656
2716,0.3537,10,123,10,160471,445139,11426,96530,4.123337285560784,0.1782084631020051
2717,0.3538,14,140,14,160611,444999,11440,96516,4.122040460928527,0.17823328993656684
2718,0.3539,19,75,19,160686,444924,11459,96497,4.12134573344696,0.17822914146292812
2719,0.354,17,101,17,160787,444823,11476,96480,4.120410167105117,0.1782365883802602
2720,0.3541,7,111,7,160898,444712,11483,96473,4.119381970432398,0.17826251651468536
2721,0.3542,15,161,15,161059,444551,11498,96458,4.117890622105302,0.17829278255999437
2722,0.3543,18,120,18,161179,444431,11516,96440,4.116779058134796,0.17830499324238128
2723,0.3544,13,78,13,161257,444353,11529,96427,4.1160565415539665,0.17831095824549725
2724,0.3545,6,46,6,161303,444307,11535,96421,4.1156304420319385,0.17831700966104955
2725,0.3546,9,68,9,161371,444239,11544,96412,4.115000555781985,0.17832575913112156
2726,0.3547,8,110,8,161481,444129,11552,96404,4.113981622142354,0.17834988798093734
2727,0.3548,11,67,11,161548,444062,11563,96393,4.113360998925488,0.1783552747222248
2728,0.3549,20,153,20,161701,443909,11583,96373,4.111943754863092,0.17837536693800646
2729,0.355,13,215,13,161916,443694,11596,96360,4.109952202749268,0.17842660178426603
2730,0.3551,18,185,18,162101,443509,11614,96342,4.1082385416280705,0.1784603529492397
2731,0.3552,7,111,7,162212,443398,11621,96335,4.1072103449553525,0.17848639975691685
2732,0.3553,21,170,21,162382,443228,11642,96314,4.105635629330468,0.17851066274729308
2733,0.3554,13,131,13,162513,443097,11655,96301,4.104422171995998,0.17853421777611336
2734,0.3555,21,200,21,162713,442897,11676,96280,4.102569565378488,0.17856844783809397
2735,0.3556,18,80,18,162793,442817,11694,96262,4.101828522731483,0.1785675197883798
2736,0.3557,21,138,21,162931,442679,11715,96241,4.100550224165401,0.1785812365471684
2737,0.3558,6,46,6,162977,442633,11721,96235,4.100124124643373,0.1785873349317458
2738,0.3559,5,77,5,163054,442556,11726,96230,4.099410871095632,0.1786052347314147
2739,0.356,15,139,15,163193,442417,11741,96215,4.0981233094964615,0.17862845133597707
2740,0.3561,14,134,14,163327,442283,11755,96201,4.096882063062729,0.17865154767829686
2741,0.3562,6,90,6,163417,442193,11761,96195,4.0960483900848494,0.17867225866846959
2742,0.3563,7,93,7,163510,442100,11768,96188,4.095186928007707,0.17869244716582944
2743,0.3564,9,122,9,163632,441978,11777,96179,4.094056837971025,0.1787192213424707
2744,0.3565,21,133,21,163765,441845,11798,96158,4.092824854570381,0.17873134536424518
2745,0.3566,12,86,12,163851,441759,11810,96146,4.092028233724851,0.17874159935304562
2746,0.3567,18,209,18,164060,441550,11828,96128,4.090092259809552,0.17878358422699087
2747,0.3568,13,133,13,164193,441417,11841,96115,4.088860276408908,0.1788079593400951
2748,0.3569,33,273,33,164466,441144,11874,96082,4.086331468376005,0.17884838038367465
2749,0.357,2,70,2,164536,441074,11876,96080,4.085683056059876,0.17886862985289134
2750,0.3571,18,197,18,164733,440877,11894,96062,4.083858238541628,0.17890672869730082
2751,0.3572,13,126,13,164859,440751,11907,96049,4.082691096372597,0.17892883755588673
2752,0.3573,13,93,13,164952,440658,11920,96036,4.081829634295453,0.1789399546110074
2753,0.3574,9,84,9,165036,440574,11929,96027,4.081051539516099,0.17895419501640883
2754,0.3575,12,155,12,165191,440419,11941,96015,4.079615769387528,0.17898753621135124
2755,0.3576,6,111,6,165302,440308,11947,96009,4.0785875727148095,0.1790153957454267
2756,0.3577,17,149,17,165451,440159,11964,95992,4.077207380784764,0.1790391139809494
2757,0.3578,9,66,9,165517,440093,11973,95983,4.076596020600985,0.179047373879823
2758,0.3579,10,100,10,165617,439993,11983,95973,4.0756697172922305,0.17906546310773444
2759,0.358,12,107,12,165724,439886,11995,95961,4.0746785727518615,0.17908283521229007
2760,0.3581,14,112,14,165836,439774,12009,95947,4.0736411130460555,0.17909882196143143
2761,0.3582,14,120,14,165956,439654,12023,95933,4.072529549075549,0.17911749164934923
2762,0.3583,5,97,5,166053,439557,12028,95928,4.071631034866057,0.1791422728927981
2763,0.3584,20,191,20,166244,439366,12048,95908,4.069861795546334,0.1791755250581945
2764,0.3585,11,114,11,166358,439252,12059,95897,4.068805809774353,0.1791968218197175
2765,0.3586,15,120,15,166478,439132,12074,95882,4.067694245803846,0.1792140018765864
2766,0.3587,18,142,18,166620,438990,12092,95864,4.066378895105413,0.17923395917390542
2767,0.3588,13,118,13,166738,438872,12105,95851,4.065285857201082,0.179253557449371
2768,0.3589,10,82,10,166820,438790,12115,95841,4.064526288487903,0.17926569914576596
2769,0.359,7,92,7,166912,438698,12122,95834,4.063674089443848,0.1792858051529188
2770,0.3591,8,61,8,166973,438637,12130,95826,4.063109044425507,0.1792939829324013
2771,0.3592,12,84,12,167057,438553,12142,95814,4.062330949646152,0.17930373694483379
2772,0.3593,10,112,10,167169,438441,12152,95804,4.061293489940346,0.17932596467912662
2773,0.3594,5,91,5,167260,438350,12157,95799,4.060450553929378,0.1793488333779526
2774,0.3595,9,116,9,167376,438234,12166,95790,4.059376042091222,0.17937396072086648
2775,0.3596,6,45,6,167421,438189,12172,95784,4.0589592056022825,0.17937985628486833
2776,0.3597,9,96,9,167517,438093,12181,95775,4.058069954425878,0.17939827822607834
2777,0.3598,15,130,15,167647,437963,12196,95760,4.056865760124495,0.1794189120573781
2778,0.3599,18,165,18,167812,437798,12214,95742,4.055337359665049,0.1794467143981707
2779,0.36,12,176,12,167988,437622,12226,95730,4.053707065841639,0.17948746793862214
2780,0.3601,13,101,13,168089,437521,12239,95717,4.052771499499796,0.1795014608861334
2781,0.3602,6,106,6,168195,437415,12245,95711,4.051789617992515,0.17952791647753064
2782,0.3603,12,98,12,168293,437317,12257,95699,4.050881840749935,0.17954245275939185
2783,0.3604,8,69,8,168362,437248,12265,95691,4.050242691466894,0.17955338228202478
2784,0.3605,15,101,15,168463,437147,12280,95676,4.0493071251250505,0.179564320609283
2785,0.3606,20,146,20,168609,437001,12300,95656,4.047954722294268,0.1795827333537342
2786,0.3607,7,85,7,168694,436916,12307,95649,4.047167364481826,0.17960061213185244
2787,0.3608,8,97,8,168791,436819,12315,95641,4.046268850272333,0.1796210043946963
2788,0.3609,10,145,10,168936,436674,12325,95631,4.0449257104746374,0.1796545213740243
2789,0.361,5,100,5,169036,436574,12330,95626,4.043999407165883,0.17968057121382938
2790,0.3611,11,125,11,169161,436449,12341,95615,4.042841528029938,0.17970582486317435
2791,0.3612,21,125,21,169286,436324,12362,95594,4.041683648893994,0.1797156704604845
2792,0.3613,16,109,16,169395,436215,12378,95578,4.04067397828745,0.1797278264287044
2793,0.3614,18,189,18,169584,436026,12396,95560,4.038923265033903,0.17976395164658213
2794,0.3615,19,152,19,169736,435874,12415,95541,4.037515284004594,0.17978604292313916
2795,0.3616,23,186,23,169922,435688,12438,95518,4.035792359850309,0.17981348102242822
2796,0.3617,14,173,14,170095,435515,12452,95504,4.034189855126162,0.17985043849655097
2797,0.3618,11,168,11,170263,435347,12463,95493,4.032633665567453,0.1798903624444277
2798,0.3619,12,145,12,170408,435202,12475,95481,4.031290525769758,0.17992096976914657
2799,0.362,23,171,23,170579,435031,12498,95458,4.029706547111786,0.17994341070220118
2800,0.3621,5,79,5,170658,434952,12503,95453,4.0289747674978695,0.17996248149998587
2801,0.3622,22,242,22,170900,434710,12525,95431,4.026733113490681,0.1800106009533313
2802,0.3623,5,41,5,170941,434669,12530,95426,4.026353329134092,0.18001678944340166
2803,0.3624,18,142,18,171083,434527,12548,95408,4.025037978435659,0.18003717437044167
2804,0.3625,14,93,14,171176,434434,12562,95394,4.024176516358517,0.18004710962803022
2805,0.3626,17,158,17,171334,434276,12579,95377,4.0227129571306826,0.18007450160765634
2806,0.3627,17,95,17,171429,434181,12596,95360,4.021832968987365,0.18008048479721117
2807,0.3628,5,74,5,171503,434107,12601,95355,4.021147504538886,0.18009791070936157
2808,0.3629,18,118,18,171621,433989,12619,95337,4.020054466634555,0.1801101778488115
2809,0.363,14,92,14,171713,433897,12633,95323,4.0192022675905,0.18011979894939723
2810,0.3631,22,146,22,171859,433751,12655,95301,4.017849864759717,0.18013541201999048
2811,0.3632,12,104,12,171963,433647,12667,95289,4.016886509318612,0.18015223013748355
2812,0.3633,11,90,11,172053,433557,12678,95278,4.016052836340731,0.18016583622490948
2813,0.3634,12,145,12,172198,433412,12690,95266,4.014709696543036,0.1801966414339163
2814,0.3635,13,79,13,172277,433333,12703,95253,4.013977916929119,0.18020341060868053
2815,0.3636,11,97,11,172374,433236,12714,95242,4.013079402719627,0.1802194225682053
2816,0.3637,8,107,8,172481,433129,12722,95234,4.012088258179258,0.1802435068314776
2817,0.3638,5,87,5,172568,433042,12727,95229,4.011282374300641,0.1802654319468606
2818,0.3639,21,131,21,172699,432911,12748,95208,4.010068916966171,0.18027755108223714
2819,0.364,5,70,5,172769,432841,12753,95203,4.009420504650042,0.18029368764724152
2820,0.3641,13,74,13,172843,432767,12766,95190,4.008735040201564,0.18029877433200053
2821,0.3642,7,71,7,172914,432696,12773,95183,4.008077364852348,0.1803121548688241
2822,0.3643,13,140,13,173054,432556,12786,95170,4.00678054022009,0.18033979754645404
2823,0.3644,13,144,13,173198,432412,12799,95157,4.005446663455482,0.1803688237936649
2824,0.3645,18,135,18,173333,432277,12817,95139,4.004196153988662,0.18038701897553355
2825,0.3646,13,165,13,173498,432112,12830,95126,4.002667753529216,0.18042326235969333
2826,0.3647,5,64,5,173562,432048,12835,95121,4.002074919411612,0.18043739294230124
2827,0.3648,23,160,23,173722,431888,12858,95098,4.000592834117604,0.18045640681156616
2828,0.3649,17,153,17,173875,431735,12875,95081,3.9991755900552075,0.180482369555974
2829,0.365,16,98,16,173973,431637,12891,95065,3.998267812812627,0.18049105566335424
2830,0.3651,13,140,13,174113,431497,12904,95052,3.9969709881803697,0.18051881211435214
2831,0.3652,15,128,15,174241,431369,12919,95037,3.995785319945163,0.18053935555445796
2832,0.3653,4,88,4,174329,431281,12923,95033,3.994970173033458,0.1805633139152673
2833,0.3654,20,121,20,174450,431160,12943,95013,3.993849346029864,0.18057368964199988
2834,0.3655,19,132,19,174582,431028,12962,94994,3.992626625662307,0.18058940500587428
2835,0.3656,19,136,19,174718,430892,12981,94975,3.9913668531623996,0.180606503165249
2836,0.3657,15,201,15,174919,430691,12996,94960,3.989504983511801,0.1806521817707947
2837,0.3658,13,113,13,175032,430578,13009,94947,3.9884582607729073,0.18067075781361497
2838,0.3659,14,130,14,175162,430448,13023,94933,3.9872540664715252,0.18069362995616514
2839,0.366,11,168,11,175330,430280,13034,94922,3.985697876912816,0.1807342698618817
2840,0.3661,12,144,12,175474,430136,13046,94910,3.9843640001482084,0.1807651139138285
2841,0.3662,10,155,10,175629,429981,13056,94900,3.982928230019638,0.180802886749568
2842,0.3663,13,119,13,175748,429862,13069,94887,3.981825929082219,0.18082359375625298
2843,0.3664,11,78,11,175826,429784,13080,94876,3.9811034125013895,0.18083330156672892
2844,0.3665,7,81,7,175907,429703,13087,94869,3.9803531068212976,0.18085029319140175
2845,0.3666,14,151,14,176058,429552,13101,94855,3.978954388825077,0.1808804993068361
2846,0.3667,14,76,14,176134,429476,13115,94841,3.978250398310423,0.1808848463811015
2847,0.3668,15,152,15,176286,429324,13130,94826,3.9768424172811145,0.18091386053610609
2848,0.3669,16,127,16,176413,429197,13146,94810,3.975666012078995,0.18093269746396518
2849,0.367,8,107,8,176520,429090,13154,94802,3.974674867538627,0.18095714383880648
2850,0.3671,17,101,17,176621,428989,13171,94785,3.973739301196784,0.1809654545662824
2851,0.3672,16,95,16,176716,428894,13187,94769,3.9728593130534664,0.18097325951995843
2852,0.3673,14,167,14,176883,428727,13201,94755,3.9713123865278446,0.1810090891377354
2853,0.3674,23,143,23,177026,428584,13224,94732,3.9699877727963244,0.18102255616109578
2854,0.3675,7,69,7,177095,428515,13231,94725,3.9693486235132833,0.18103547129424355
2855,0.3676,22,163,22,177258,428352,13253,94703,3.9678387491200118,0.18105744137805777
2856,0.3677,6,131,6,177389,428221,13259,94697,3.9666252917855425,0.18109340278972993
2857,0.3678,20,124,20,177513,428097,13279,94677,3.9654766756826856,0.1811050281766117
2858,0.3679,15,207,15,177720,427890,13294,94662,3.963559227833562,0.1811532632159096
2859,0.368,14,129,14,177849,427761,13308,94648,3.9623642965652675,0.18117605171426984
2860,0.3681,14,143,14,177992,427618,13322,94634,3.9610396828337473,0.18120371008631847
2861,0.3682,13,143,13,178135,427475,13335,94621,3.9597150691022267,0.18123295332659128
2862,0.3683,14,88,14,178223,427387,13349,94607,3.958899922190522,0.1812415468377031
2863,0.3684,5,96,5,178319,427291,13354,94602,3.958010671014117,0.1812670413283949
2864,0.3685,17,189,17,178508,427102,13371,94585,3.9562599577605693,0.18130603216104677
2865,0.3686,14,118,14,178626,426984,13385,94571,3.9551669198562376,0.1813250759747294
2866,0.3687,16,117,16,178743,426867,13401,94555,3.954083144984994,0.1813406415532908
2867,0.3688,8,105,8,178848,426762,13409,94547,3.953110526510801,0.18136460333506615
2868,0.3689,28,194,28,179042,426568,13437,94519,3.951313498091815,0.18138813672189097
2869,0.369,11,75,11,179117,426493,13448,94508,3.9506187706102485,0.18139696468912728
2870,0.3691,15,128,15,179245,426365,13463,94493,3.9494331023750417,0.18141796804503338
2871,0.3692,13,135,13,179380,426230,13476,94480,3.9481825929082217,0.18144456607324613
2872,0.3693,10,90,10,179470,426140,13486,94470,3.947348919930342,0.18146021013810723
2873,0.3694,11,163,11,179633,425977,13497,94459,3.945839045537071,0.1814997425235764
2874,0.3695,12,110,12,179743,425867,13509,94447,3.9448201118974398,0.18151923646106005
2875,0.3696,20,137,20,179880,425730,13529,94427,3.943551076364445,0.18153557483605912
2876,0.3697,13,133,13,180013,425597,13542,94414,3.9423190929638,0.1815615438904177
2877,0.3698,7,46,7,180059,425551,13549,94407,3.9418929934417726,0.18156658807057494
2878,0.3699,5,69,5,180128,425482,13554,94402,3.9412538441587315,0.18158281462787854
2879,0.37,17,133,17,180261,425349,13571,94385,3.940021860758087,0.18160251205424313
2880,0.3701,22,126,22,180387,425223,13593,94363,3.938854718589055,0.18161189870396816
2881,0.3702,9,115,9,180502,425108,13602,94354,3.937789469783986,0.18163792539204024
2882,0.3703,12,127,12,180629,424981,13614,94342,3.936613064581867,0.18166343489504605
2883,0.3704,16,109,16,180738,424872,13630,94326,3.9356033939753234,0.1816763546854957
2884,0.3705,14,87,14,180825,424785,13644,94312,3.934797510096706,0.18168473329647444
2885,0.3706,17,162,17,180987,424623,13661,94295,3.9332968987365224,0.18171464470301665
2886,0.3707,23,124,23,181111,424499,13684,94272,3.9321482826336656,0.18172180017772774
2887,0.3708,14,110,14,181221,424389,13698,94258,3.9311293489940344,0.18173825357131151
2888,0.3709,14,129,14,181350,424260,13712,94244,3.92993441772574,0.18176137503278664
2889,0.371,12,93,12,181443,424167,13724,94232,3.9290729556485977,0.18177504200432484
2890,0.3711,10,83,10,181526,424084,13734,94222,3.9283041239023304,0.18178836440249582
2891,0.3712,22,180,22,181706,423904,13756,94200,3.926636777946571,0.1818167780986057
2892,0.3713,8,117,8,181823,423787,13764,94192,3.925553003075327,0.18184520994094355
2893,0.3714,29,147,29,181970,423640,13793,94163,3.9241913372114565,0.18185101283692834
2894,0.3715,20,189,20,182159,423451,13813,94143,3.922440623957909,0.18188580238565363
2895,0.3716,12,159,12,182318,423292,13825,94131,3.9209678016969876,0.18192272086861233
2896,0.3717,19,120,19,182438,423172,13844,94112,3.919856237726481,0.18193487523294746
2897,0.3718,33,288,33,182726,422884,13877,94079,3.9171884841972657,0.18198401046109683
2898,0.3719,22,227,22,182953,422657,13899,94057,3.9150857756863906,0.18202913023452044
2899,0.372,20,120,20,183073,422537,13919,94037,3.9139742117158844,0.18203974648356286
2900,0.3721,26,182,26,183255,422355,13945,94011,3.912288339693949,0.1820627229523245
2901,0.3722,15,109,15,183364,422246,13960,93996,3.911278669087406,0.18207739780955443
2902,0.3723,13,112,13,183476,422134,13973,93983,3.9102412093815997,0.1820963076201714
2903,0.3724,12,65,12,183541,422069,13985,93971,3.909639112230909,0.18210022478877608
2904,0.3725,15,114,15,183655,421955,14000,93956,3.908583126458928,0.18211668291623942
2905,0.3726,9,101,9,183756,421854,14009,93947,3.9076475601170846,0.18213807262878512
2906,0.3727,17,108,17,183864,421746,14026,93930,3.906647152543629,0.18214925650990157
2907,0.3728,10,121,10,183985,421625,14036,93920,3.905526325540035,0.18217614369259716
2908,0.3729,26,113,26,184098,421512,14062,93894,3.9044796028011413,0.18217482916380484
2909,0.373,5,93,5,184191,421419,14067,93889,3.9036181407239985,0.1821997717869701
2910,0.3731,13,98,13,184289,421321,14080,93876,3.902710363481418,0.18221379394678153
2911,0.3732,5,65,5,184354,421256,14085,93871,3.9021082663307274,0.18222884841990422
2912,0.3733,16,106,16,184460,421150,14101,93855,3.9011263848234465,0.18224094911699887
2913,0.3734,12,129,12,184589,421021,14113,93843,3.899931453555152,0.18226755026570124
2914,0.3735,26,154,26,184743,420867,14139,93817,3.898504946459669,0.1822807781085093
2915,0.3736,10,47,10,184790,420820,14149,93807,3.8980695839045536,0.1822815359473949
2916,0.3737,12,131,12,184921,420689,14161,93795,3.8968561265700843,0.18230887646651792
2917,0.3738,14,137,14,185058,420552,14175,93781,3.8955870910370893,0.1823351797376408
2918,0.3739,6,86,6,185144,420466,14181,93775,3.8947904701915594,0.18235613263042036
2919,0.374,20,113,20,185257,420353,14201,93755,3.8937437474526657,0.182364405922491
2920,0.3741,22,176,22,185433,420177,14223,93733,3.8921134536292565,0.18239185849662393
2921,0.3742,11,121,11,185554,420056,14234,93722,3.8909926266256623,0.1824173086430326
2922,0.3743,19,129,19,185683,419927,14253,93703,3.889797695357368,0.1824328796993945
2923,0.3744,18,158,18,185841,419769,14271,93685,3.8883341361295343,0.18246035672134212
2924,0.3745,26,208,26,186049,419561,14297,93659,3.886407425247323,0.18249288804021668
2925,0.3746,10,134,10,186183,419427,14307,93649,3.885166178813591,0.18252461623619112
2926,0.3747,20,141,20,186324,419286,14327,93629,3.8838600911482457,0.18254291646764084
2927,0.3748,13,109,13,186433,419177,14340,93616,3.8828504205417023,0.1825609943973494
2928,0.3749,9,127,9,186560,419050,14349,93607,3.881674015339583,0.18259186941756378
2929,0.375,6,104,6,186664,418946,14355,93601,3.8807106598984773,0.1826193500303387
2930,0.3751,22,191,22,186855,418755,14377,93579,3.8789414205787542,0.18265233226762229
2931,0.3752,15,178,15,187033,418577,14392,93564,3.8772926006891697,0.1826918758701217
2932,0.3753,15,158,15,187191,418419,14407,93549,3.875829041461336,0.1827243108944309
2933,0.3754,9,66,9,187257,418353,14416,93540,3.8752176812775576,0.18273350094648685
2934,0.3755,12,109,12,187366,418244,14428,93528,3.874208010671014,0.1827532573098958
2935,0.3756,24,190,24,187556,418054,14452,93504,3.872448034384379,0.18278279295798325
2936,0.3757,20,146,20,187702,417908,14472,93484,3.871095631553596,0.1828030160815969
2937,0.3758,16,126,16,187828,417782,14488,93468,3.8699284893845642,0.18282249388753055
2938,0.3759,19,127,19,187955,417655,14507,93449,3.8687520841824448,0.18283754382669673
2939,0.376,26,175,26,188130,417480,14533,93423,3.867131053392123,0.1828585856806478
2940,0.3761,16,153,16,188283,417327,14549,93407,3.8657138093297267,0.18288776545129168
2941,0.3762,15,116,15,188399,417211,14564,93392,3.8646392974915704,0.18290530999622015
2942,0.3763,20,134,20,188533,417077,14584,93372,3.8633980510578385,0.1829213104541296
2943,0.3764,14,145,14,188678,416932,14598,93358,3.862054911260143,0.18295087107331126
2944,0.3765,23,158,23,188836,416774,14621,93335,3.8605913520323094,0.18297069841935742
2945,0.3766,9,125,9,188961,416649,14630,93326,3.8594334728963653,0.1830011275062503
2946,0.3767,21,168,21,189129,416481,14651,93305,3.8578772833376562,0.18302778028427616
2947,0.3768,8,67,8,189196,416414,14659,93297,3.85725666012079,0.18303901622684227
2948,0.3769,11,137,11,189333,416277,14670,93286,3.855987624587795,0.18307059186008404
2949,0.377,10,84,10,189417,416193,14680,93276,3.8552095298084406,0.18308474117169052
2950,0.3771,9,77,9,189494,416116,14689,93267,3.854496276260699,0.1830979832463981
2951,0.3772,10,85,10,189579,416031,14699,93257,3.8537089184482567,0.1831125021598781
2952,0.3773,12,69,12,189648,415962,14711,93245,3.8530697691652156,0.1831180639700554
2953,0.3774,13,112,13,189760,415850,14724,93232,3.8520323094594096,0.18313749062037157
2954,0.3775,29,211,29,189971,415639,14753,93203,3.8500778094779355,0.18316687694805067
2955,0.3776,13,116,13,190087,415523,14766,93190,3.849003297639779,0.18318776992135055
2956,0.3777,17,103,17,190190,415420,14783,93173,3.848049205231761,0.18319756662006753
2957,0.3778,23,199,23,190389,415221,14806,93150,3.846205861647338,0.18323232442448525
2958,0.3779,4,110,4,190499,415111,14810,93146,3.8451869280077067,0.18326555266331795
2959,0.378,20,203,20,190702,414908,14830,93126,3.843306532290933,0.1833066290838802
2960,0.3781,23,196,23,190898,414712,14853,93103,3.8414909778057726,0.18334038970885067
2961,0.3782,14,96,14,190994,414616,14867,93089,3.8406017266293677,0.18335253739868623
2962,0.3783,15,128,15,191122,414488,14882,93074,3.8394160583941606,0.18337464191566744
2963,0.3784,11,90,11,191212,414398,14893,93063,3.838582385416281,0.18338946244144871
2964,0.3785,15,126,15,191338,414272,14908,93048,3.837415243247249,0.18341086493731767
2965,0.3786,12,66,12,191404,414206,14920,93036,3.83680388306347,0.18341541118440507
2966,0.3787,18,138,18,191542,414068,14938,93018,3.835525584497388,0.18343634018687166
2967,0.3788,16,118,16,191660,413950,14954,93002,3.834432546593056,0.18345326579242216
2968,0.3789,16,131,16,191791,413819,14970,92986,3.833219089258587,0.18347490652223242
2969,0.379,17,112,17,191903,413707,14987,92969,3.832181629552781,0.18348806732507558
2970,0.3791,8,86,8,191989,413621,14995,92961,3.831385008707251,0.18350632276709397
2971,0.3792,18,166,18,192155,413455,15013,92943,3.8298473452147173,0.1835374547292841
2972,0.3793,20,135,20,192290,413320,15033,92923,3.828596835747897,0.18355414297086578
2973,0.3794,14,107,14,192397,413213,15047,92909,3.827605691207529,0.18357036445758138
2974,0.3795,37,234,37,192631,412979,15084,92872,3.825438141465041,0.18359556470185884
2975,0.3796,14,134,14,192765,412845,15098,92858,3.824196895031309,0.18362161189472873
2976,0.3797,23,163,23,192928,412682,15121,92835,3.8226870206380377,0.18364367568251908
2977,0.3798,7,89,7,193017,412593,15128,92828,3.821862610693245,0.1836647072440599
2978,0.3799,39,247,39,193264,412346,15167,92789,3.8195746415206195,0.18369148841398833
2979,0.38,8,115,8,193379,412231,15175,92781,3.818509392715551,0.18372038684229286
2980,0.3801,11,105,11,193484,412126,15186,92770,3.8175367742413577,0.1837408099885917
2981,0.3802,20,132,20,193616,411994,15206,92750,3.8163140538738003,0.18375651815573835
2982,0.3803,13,106,13,193722,411888,15219,92737,3.81533217236652,0.18377408967054742
2983,0.3804,31,192,31,193914,411696,15250,92706,3.813553670013709,0.18379387869199568
2984,0.3805,18,128,18,194042,411568,15268,92688,3.8123680017785024,0.18381139738545502
2985,0.3806,12,115,12,194157,411453,15280,92676,3.811302752973434,0.1838338996566355
2986,0.3807,18,90,18,194247,411363,15298,92658,3.8104690799955536,0.1838375781961466
2987,0.3808,13,73,13,194320,411290,15311,92645,3.8097928785801622,0.1838431543750682
2988,0.3809,9,93,9,194413,411197,15320,92636,3.80893141650302,0.18386250999835263
2989,0.381,15,106,15,194519,411091,15335,92621,3.807949534995739,0.18387689790991676
2990,0.3811,15,164,15,194683,410927,15350,92606,3.8064303975693803,0.18391247445549747
2991,0.3812,17,99,17,194782,410828,15367,92589,3.8055133572937123,0.18392108331661425
2992,0.3813,10,150,10,194932,410678,15377,92579,3.8041239023305793,0.18395968660147796
2993,0.3814,24,184,24,195116,410494,15401,92555,3.802419504242469,0.18398804092643062
2994,0.3815,13,126,13,195242,410368,15414,92542,3.8012523620734373,0.1840130440834344
2995,0.3816,18,149,18,195391,410219,15432,92524,3.799872170143392,0.1840383655267204
2996,0.3817,15,113,15,195504,410106,15447,92509,3.7988254474044982,0.18405539030868556
2997,0.3818,10,113,10,195617,409993,15457,92499,3.7977787246656045,0.1840805425758022
2998,0.3819,16,208,16,195825,409785,15473,92483,3.795852013783393,0.18413078276935818
2999,0.382,18,116,18,195941,409669,15491,92465,3.7947775019452368,0.18414407309602615
3000,0.3821,20,186,20,196127,409483,15511,92445,3.7930545777909517,0.1841798026808626
3001,0.3822,11,89,11,196216,409394,15522,92434,3.7922301678461596,0.18419458459870713
3002,0.3823,11,100,11,196316,409294,15533,92423,3.791303864537404,0.18421341114612422
3003,0.3824,21,189,21,196505,409105,15554,92402,3.7895531512838563,0.18424867449507185
3004,0.3825,10,118,10,196623,408987,15564,92392,3.788460113379525,0.18427576743341864
3005,0.3826,11,143,11,196766,408844,15575,92381,3.787135499648005,0.18431043942341263
3006,0.3827,38,207,38,196973,408637,15613,92343,3.785218051798881,0.18432472354185797
3007,0.3828,17,105,17,197078,408532,15630,92326,3.784245433324688,0.18433567997316605
3008,0.3829,10,95,10,197173,408437,15640,92316,3.7833654451813703,0.18435436233033053
3009,0.383,16,139,16,197312,408298,15656,92300,3.7820778835822,0.1843794821393613
3010,0.3831,38,275,38,197587,408023,15694,92262,3.779530549483123,0.1844188812376945
3011,0.3832,24,153,24,197740,407870,15718,92238,3.7781133054207268,0.18443616178905356
3012,0.3833,18,139,18,197879,407731,15736,92220,3.776825743821557,0.18445807689153537
3013,0.3834,23,114,23,197993,407617,15759,92197,3.775769758049576,0.1844626200946752
3014,0.3835,12,120,12,198113,407497,15771,92185,3.7746581940790693,0.18448733394438863
3015,0.3836,3,56,3,198169,407441,15774,92182,3.7741394642261663,0.18450311534897312
3016,0.3837,7,100,7,198269,407341,15781,92175,3.7732131609174107,0.1845286237077491
3017,0.3838,11,95,11,198364,407246,15792,92164,3.772333172774093,0.18454576400152178
3018,0.3839,16,113,16,198477,407133,15808,92148,3.7712864500351997,0.18456139929218215
3019,0.384,21,167,21,198644,406966,15829,92127,3.769739523509578,0.18458884416331225
3020,0.3841,14,115,14,198759,406851,15843,92113,3.768674274704509,0.18460850883029636
3021,0.3842,13,144,13,198903,406707,15856,92100,3.7673403979399014,0.184640552357926
3022,0.3843,9,112,9,199015,406595,15865,92091,3.7663029382340953,0.18466730567932527
3023,0.3844,11,98,11,199113,406497,15876,92080,3.765395160991515,0.1846856152610329
3024,0.3845,23,158,23,199271,406339,15899,92057,3.7639316017636815,0.184706538575751
3025,0.3846,10,104,10,199375,406235,15909,92047,3.762968246322576,0.18472872790909564
3026,0.3847,13,130,13,199505,406105,15922,92034,3.761764052021194,0.18475566056863646
3027,0.3848,8,89,8,199594,406016,15930,92026,3.7609396420764014,0.18477558117588477
3028,0.3849,13,123,13,199717,405893,15943,92013,3.759800289006632,0.1847999421577567
3029,0.385,16,227,16,199944,405666,15959,91997,3.7576975804957575,0.1848580264154659
3030,0.3851,18,135,18,200079,405531,15977,91979,3.756447071028938,0.18487869590560993
3031,0.3852,22,131,22,200210,405400,15999,91957,3.755233613694468,0.1848913355999815
3032,0.3853,8,78,8,200288,405322,16007,91949,3.754511097113639,0.18490722362655374
3033,0.3854,12,142,12,200430,405180,16019,91937,3.7531957464152064,0.18494036615122797
3034,0.3855,14,163,14,200593,405017,16033,91923,3.751685872021935,0.18497806576246628
3035,0.3856,8,132,8,200725,404885,16041,91915,3.750463151654378,0.18501409017713366
3036,0.3857,18,120,18,200845,404765,16059,91897,3.7493515876838712,0.18502925530843914
3037,0.3858,10,80,10,200925,404685,16069,91887,3.748610545036867,0.185042652425026
3038,0.3859,7,137,7,201062,404548,16076,91880,3.747341509503872,0.18508222743277977
3039,0.386,26,170,26,201232,404378,16102,91854,3.7457667938789876,0.18510293572361314
3040,0.3861,11,118,11,201350,404260,16113,91843,3.7446737559746563,0.18512889460454784
3041,0.3862,22,188,22,201538,404072,16135,91821,3.7429323057541963,0.18516292829299869
3042,0.3863,32,215,32,201753,403857,16167,91789,3.740940753640372,0.185190640093938
3043,0.3864,22,149,22,201902,403708,16189,91767,3.7395605617103262,0.1852101518744639
3044,0.3865,18,135,18,202037,403573,16207,91749,3.7383100522435067,0.18523102143656045
3045,0.3866,19,181,19,202218,403392,16226,91730,3.7366334432546595,0.1852674694317764
3046,0.3867,11,145,11,202363,403247,16237,91719,3.735290303456964,0.1853036370174921
3047,0.3868,15,196,15,202559,403051,16252,91704,3.7334747489718034,0.18535234611070125
3048,0.3869,8,140,8,202699,402911,16260,91696,3.732177924339546,0.18539163416611573
3049,0.387,19,144,19,202843,402767,16279,91677,3.730844047574938,0.18541432396793164
3050,0.3871,14,128,14,202971,402639,16293,91663,3.729658379339731,0.18543926587389895
3051,0.3872,25,171,25,203142,402468,16318,91638,3.728074400681759,0.18546222875253487
3052,0.3873,12,147,12,203289,402321,16330,91626,3.726712734817889,0.18549763436158132
3053,0.3874,10,73,10,203362,402248,16340,91616,3.7260365334024974,0.18550856106134483
3054,0.3875,13,109,13,203471,402139,16353,91603,3.725026862795954,0.18552806931555346
3055,0.3876,13,85,13,203556,402054,16366,91590,3.7242395049835118,0.18553856625422369
3056,0.3877,17,183,17,203739,401871,16383,91573,3.7225443699284892,0.18557931599127764
3057,0.3878,15,65,15,203804,401806,16398,91558,3.7219422727777984,0.1855790045483659
3058,0.3879,10,119,10,203923,401687,16408,91548,3.7208399718403795,0.18560726631321783
3059,0.388,12,103,12,204026,401584,16420,91536,3.7198858794323613,0.1856262167423751
3060,0.3881,17,116,17,204142,401468,16437,91519,3.718811367594205,0.185641812055896
3061,0.3882,5,78,5,204220,401390,16442,91514,3.7180888510133756,0.1856629282781231
3062,0.3883,10,152,10,204372,401238,16452,91504,3.7166808699840677,0.1857036745396171
3063,0.3884,14,137,14,204509,401101,16466,91490,3.7154118344510727,0.18573217943486584
3064,0.3885,9,112,9,204621,400989,16475,91481,3.7143743747452667,0.18575953865210063
3065,0.3886,14,146,14,204767,400843,16489,91467,3.7130219719144835,0.185791472852471
3066,0.3887,16,118,16,204885,400725,16505,91451,3.7119289340101522,0.18580954780403758
3067,0.3888,19,169,19,205054,400556,16524,91432,3.7103634814183555,0.18584193110401068
3068,0.3889,3,114,3,205168,400442,16527,91429,3.7093074956463745,0.18588003765214864
3069,0.389,10,79,10,205247,400363,16537,91419,3.7085757160324575,0.1858933429853065
3070,0.3891,8,130,8,205377,400233,16545,91411,3.7073715217310754,0.1859292496196435
3071,0.3892,26,220,26,205597,400013,16571,91385,3.7053336544518136,0.18596941786494858
3072,0.3893,26,216,26,205813,399797,16597,91359,3.703332839304902,0.18600811147578367
3073,0.3894,15,76,15,205889,399721,16612,91344,3.7026288487902477,0.18601203506664088
3074,0.3895,16,66,16,205955,399655,16628,91328,3.702017488606469,0.18601051360230395
3075,0.3896,11,111,11,206066,399544,16639,91317,3.700989291933751,0.18603433558583796
3076,0.3897,8,76,8,206142,399468,16647,91309,3.700285301419097,0.1860498760129346
3077,0.3898,9,92,9,206234,399376,16656,91300,3.6994331023750417,0.18606983019344742
3078,0.3899,10,80,10,206314,399296,16666,91290,3.6986920597280375,0.1860835816757918
3079,0.39,17,139,17,206453,399157,16683,91273,3.697404498128867,0.18610810921028484
3080,0.3901,19,191,19,206644,398966,16702,91254,3.6956352588091446,0.18614907592509486
3081,0.3902,22,142,22,206786,398824,16724,91232,3.6943199081107116,0.1861664789330199
3082,0.3903,18,115,18,206901,398709,16742,91214,3.693254659305643,0.18618027730888323
3083,0.3904,28,253,28,207154,398456,16770,91186,3.6909111119344917,0.18622993942513102
3084,0.3905,6,74,6,207228,398382,16776,91180,3.6902256474860127,0.18624811566257185
3085,0.3906,9,99,9,207327,398283,16785,91171,3.689308607210345,0.18627082422454408
3086,0.3907,9,68,9,207395,398215,16794,91162,3.6886787209603913,0.18628174188815574
3087,0.3908,4,100,4,207495,398115,16798,91158,3.6877524176516356,0.18631316259021038
3088,0.3909,26,152,26,207647,397963,16824,91132,3.6863444366223277,0.18632780952575675
3089,0.391,14,98,14,207745,397865,16838,91118,3.6854366593797474,0.1863418564653577
3090,0.3911,2,79,2,207824,397786,16840,91116,3.6847048797658304,0.18636863829560935
3091,0.3912,23,119,23,207943,397667,16863,91093,3.6836025788284115,0.18637572632785007
3092,0.3913,18,143,18,208086,397524,16881,91075,3.6822779650968913,0.18640029963221375
3093,0.3914,25,125,25,208211,397399,16906,91050,3.681120085960947,0.18640635972230468
3094,0.3915,14,158,14,208369,397241,16920,91036,3.6796565267331136,0.1864433508029254
3095,0.3916,16,71,16,208440,397170,16936,91020,3.678998851383897,0.18644380261783322
3096,0.3917,10,152,10,208592,397018,16946,91010,3.6775908703545888,0.1864852016687567
3097,0.3918,11,134,11,208726,396884,16957,90999,3.676349623920857,0.1865180791296274
3098,0.3919,16,212,16,208938,396672,16973,90983,3.674385860906295,0.18657247439275718
3099,0.392,20,139,20,209077,396533,16993,90963,3.6730982993071253,0.1865923002445148
3100,0.3921,8,100,8,209177,396433,17001,90955,3.6721719959983696,0.1866172330873965
3101,0.3922,16,146,16,209323,396287,17017,90939,3.670819593167587,0.18664644333430483
3102,0.3923,25,253,25,209576,396034,17042,90914,3.6684760457964356,0.18670166013619524
3103,0.3924,23,179,23,209755,395855,17065,90891,3.6668179628737634,0.18673188891125966
3104,0.3925,16,104,16,209859,395751,17081,90875,3.665854607432658,0.18674505677871714
3105,0.3926,12,125,12,209984,395626,17093,90863,3.6646967282967133,0.18677297945071727
3106,0.3927,26,140,26,210124,395486,17119,90837,3.663399903664456,0.18678326955541893
3107,0.3928,12,138,12,210262,395348,17131,90825,3.6621216050983736,0.1868162156269476
3108,0.3929,17,134,17,210396,395214,17148,90808,3.6608803586646412,0.1868392788803799
3109,0.393,17,191,17,210587,395023,17165,90791,3.659111119344918,0.18688428081529146
3110,0.3931,21,171,21,210758,394852,17186,90770,3.6575271406869465,0.18691492560057
3111,0.3932,27,194,27,210952,394658,17213,90743,3.655730112267961,0.18694440266913337
3112,0.3933,8,141,8,211093,394517,17221,90735,3.654424024602616,0.18698531896828866
3113,0.3934,52,299,52,211392,394218,17273,90683,3.6516543777094372,0.187013431607689
3114,0.3935,13,126,13,211518,394092,17286,90670,3.6504872355404054,0.1870402383025072
3115,0.3936,16,130,16,211648,393962,17302,90654,3.6492830412390234,0.18706357198276574
3116,0.3937,17,183,17,211831,393779,17319,90637,3.647587906184001,0.18710571079402827
3117,0.3938,11,109,11,211940,393670,17330,90626,3.6465782355774574,0.18712935890447163
3118,0.3939,20,137,20,212077,393533,17350,90606,3.6453092000444625,0.18714873207901037
3119,0.394,14,71,14,212148,393462,17364,90592,3.644651524695246,0.1871526730488747
3120,0.3941,13,145,13,212293,393317,17377,90579,3.643308384897551,0.18718691619686875
3121,0.3942,14,123,14,212416,393194,17391,90565,3.6421690318277817,0.18721098728912536
3122,0.3943,11,118,11,212534,393076,17402,90554,3.6410759939234505,0.1872381779459504
3123,0.3944,6,83,6,212617,392993,17408,90548,3.640307162177183,0.18726023232776537
3124,0.3945,8,73,8,212690,392920,17416,90540,3.639630960761792,0.18727505895006827
3125,0.3946,24,142,24,212832,392778,17440,90516,3.6383156100633594,0.18728972426721624
3126,0.3947,16,134,16,212966,392644,17456,90500,3.637074363629627,0.1873147550212773
3127,0.3948,12,100,12,213066,392544,17468,90488,3.6361480603208713,0.1873333443746998
3128,0.3949,32,167,32,213233,392377,17500,90456,3.63460113379525,0.18734427845652638
3129,0.395,13,131,13,213364,392246,17513,90443,3.63338767646078,0.1873732361831324
3130,0.3951,23,200,23,213564,392046,17536,90420,3.6315350698432693,0.18741216997674448
3131,0.3952,9,64,9,213628,391982,17545,90411,3.630942235725666,0.18742187386632891
3132,0.3953,24,181,24,213809,391801,17569,90387,3.6292656267368186,0.18745178229238388
3133,0.3954,16,127,16,213936,391674,17585,90371,3.628089221534699,0.1874741984669481
3134,0.3955,12,92,12,214028,391582,17597,90359,3.6272370224906445,0.1874897549700067
3135,0.3956,14,135,14,214163,391447,17611,90345,3.6259865130238245,0.1875186802603613
3136,0.3957,10,98,10,214261,391349,17621,90335,3.625078735781244,0.18753996395977446
3137,0.3958,20,135,20,214396,391214,17641,90315,3.6238282263144246,0.1875587970817957
3138,0.3959,12,149,12,214545,391065,17653,90303,3.622448034384379,0.187596599690881
3139,0.396,11,124,11,214669,390941,17664,90292,3.621299418281522,0.18762636810027575
3140,0.3961,23,148,23,214817,390793,17687,90269,3.6199284893845642,0.18764525154761758
3141,0.3962,9,111,9,214928,390682,17696,90260,3.6189002927118454,0.18767335770217614
3142,0.3963,27,134,27,215062,390548,17723,90233,3.6176590462781135,0.18768004559248389
3143,0.3964,14,144,14,215206,390404,17737,90219,3.6163251695135057,0.18771261466887768
3144,0.3965,25,216,25,215422,390188,17762,90194,3.6143243543665937,0.18775474518195936
3145,0.3966,19,183,19,215605,390005,17781,90175,3.612629219311571,0.18779416052313716
3146,0.3967,20,146,20,215751,389859,17801,90155,3.6112768164807885,0.18781743865803915
3147,0.3968,4,36,4,215787,389823,17805,90151,3.6109433472896364,0.18782475717434693
3148,0.3969,14,96,14,215883,389727,17819,90137,3.6100540961132315,0.18783863761399064
3149,0.397,25,215,25,216098,389512,17844,90112,3.608062543999407,0.1878805063966774
3150,0.3971,17,192,17,216290,389320,17861,90095,3.606284041646597,0.1879269526401969
3151,0.3972,16,96,16,216386,389224,17877,90079,3.6053947904701915,0.18793748422188053
3152,0.3973,12,132,12,216518,389092,17889,90067,3.6041720701026345,0.187968920546207
3153,0.3974,20,191,20,216709,388901,17909,90047,3.6024028307829115,0.18800997185498217
3154,0.3975,22,116,22,216825,388785,17931,90025,3.601328318944755,0.18801821181679582
3155,0.3976,12,112,12,216937,388673,17943,90013,3.600290859238949,0.1880418478919375
3156,0.3977,9,95,9,217032,388578,17952,90004,3.5994108710956314,0.1880639054540288
3157,0.3978,22,215,22,217247,388363,17974,89982,3.5974193189818076,0.18811109136710952
3158,0.3979,18,146,18,217393,388217,17992,89964,3.5960669161510244,0.18813796449461606
3159,0.398,14,136,14,217529,388081,18006,89950,3.594807143651117,0.18816771297258963
3160,0.3981,9,62,9,217591,388019,18015,89941,3.594232835599689,0.18817683488158005
3161,0.3982,14,180,14,217771,387839,18029,89927,3.592565489643929,0.18822394226462327
3162,0.3983,18,151,18,217922,387688,18047,89909,3.5911667716477083,0.18825285753469975
3163,0.3984,13,105,13,218027,387583,18060,89896,3.590194153173515,0.18827215437747
3164,0.3985,21,158,21,218185,387425,18081,89875,3.5887305939456815,0.18829876388015923
3165,0.3986,20,164,20,218349,387261,18101,89855,3.5872114565193227,0.18832946285599309
3166,0.3987,26,167,26,218516,387094,18127,89829,3.5856645299937013,0.18835115941147731
3167,0.3988,18,155,18,218671,386939,18145,89811,3.5842287598651303,0.18838175144205557
3168,0.3989,7,78,7,218749,386861,18152,89804,3.583506243284301,0.18840065874356204
3169,0.399,17,126,17,218875,386735,18169,89787,3.582339101115269,0.18842152093712358
3170,0.3991,37,176,37,219051,386559,18206,89750,3.5807088072918596,0.1884281002458488
3171,0.3992,24,156,24,219207,386403,18230,89726,3.5792637741302014,0.1884489287567025
3172,0.3993,12,136,12,219343,386267,18242,89714,3.5780040016302936,0.18848231336965132
3173,0.3994,5,76,5,219419,386191,18247,89709,3.5773000111156397,0.1885038873712965
3174,0.3995,20,174,20,219593,386017,18267,89689,3.5756882433584054,0.1885387192930087
3175,0.3996,34,227,34,219820,385790,18301,89655,3.5735855348475303,0.18857070744250123
3176,0.3997,18,134,18,219954,385656,18319,89637,3.5723442884137984,0.18859314149377332
3177,0.3998,15,74,15,220028,385582,18334,89622,3.5716588239653193,0.18859689733251403
3178,0.3999,12,110,12,220138,385472,18346,89610,3.570639890325688,0.1886200697984769
3179,0.4,13,95,13,220233,385377,18359,89597,3.5697599021823705,0.1886355884743165
3180,0.4001,15,160,15,220393,385217,18374,89582,3.568277816888362,0.1886735229012698
3181,0.4002,32,160,32,220553,385057,18406,89550,3.566795731594353,0.18868242567008073
3182,0.4003,17,93,17,220646,384964,18423,89533,3.5659342695172107,0.18869033945420097
3183,0.4004,15,175,15,220821,384789,18438,89518,3.5643132387268888,0.18873430077987463
3184,0.4005,20,134,20,220955,384655,18458,89498,3.5630719922931564,0.18875341925496622
3185,0.4006,16,143,16,221098,384512,18474,89482,3.5617473785616363,0.18878298037527902
3186,0.4007,12,198,12,221296,384314,18486,89470,3.5599132980103003,0.18884132853789912
3187,0.4008,11,55,11,221351,384259,18497,89459,3.559403831190485,0.18884441798707247
3188,0.4009,17,178,17,221529,384081,18514,89442,3.5577550113009004,0.18888628429875634
3189,0.401,3,50,3,221579,384031,18517,89439,3.5572918596465226,0.18890109193824317
3190,0.4011,20,184,20,221763,383847,18537,89419,3.555587461558413,0.18894025769863038
3191,0.4012,18,148,18,221911,383699,18555,89401,3.5542165326614548,0.18896850560135278
3192,0.4013,29,175,29,222086,383524,18584,89372,3.552595501871133,0.18898869941805385
3193,0.4014,8,48,8,222134,383476,18592,89364,3.55215087628293,0.18899416293037813
3194,0.4015,21,189,21,222323,383287,18613,89343,3.550400163029382,0.18903370501237754
3195,0.4016,16,115,16,222438,383172,18629,89327,3.5493349142243136,0.18905225196243802
3196,0.4017,9,83,9,222521,383089,18638,89318,3.5485660824780467,0.18907001801412765
3197,0.4018,20,172,20,222693,382917,18658,89298,3.5469728407869874,0.18910453924589435
3198,0.4019,12,101,12,222794,382816,18670,89286,3.5460372744451445,0.18912438413732627
3199,0.402,21,133,21,222927,382683,18691,89265,3.5448052910445,0.1891416003458008
3200,0.4021,20,212,20,223139,382471,18711,89245,3.542841528029938,0.1891922258307965
3201,0.4022,30,180,30,223319,382291,18741,89215,3.5411741820741782,0.1892128626146857
3202,0.4023,16,164,16,223483,382127,18757,89199,3.5396550446478194,0.18925117646809214
3203,0.4024,16,138,16,223621,381989,18773,89183,3.538376746081737,0.18927907430832053
3204,0.4025,22,175,22,223796,381814,18795,89161,3.536755715291415,0.18931153458251498
3205,0.4026,11,110,11,223906,381704,18806,89150,3.535736781651784,0.18933682202975868
3206,0.4027,13,80,13,223986,381624,18819,89137,3.53499573900478,0.18934661112539058
3207,0.4028,24,211,24,224197,381413,18843,89113,3.533041239023306,0.1893901718502272
3208,0.4029,11,112,11,224309,381301,18854,89102,3.5320037793175,0.18941630899462802
3209,0.403,15,110,15,224419,381191,18869,89087,3.5309848456778687,0.18943475986544128
3210,0.4031,19,149,19,224568,381042,18888,89068,3.5296046537478234,0.18946204079896195
3211,0.4032,11,131,11,224699,380911,18899,89057,3.5283911964133536,0.18949588057059205
3212,0.4033,28,138,28,224837,380773,18927,89029,3.527112897847271,0.1895032375341101
3213,0.4034,8,71,8,224908,380702,18935,89021,3.5264552224980545,0.18951807767556625
3214,0.4035,17,153,17,225061,380549,18952,89004,3.525037978435659,0.18955048737842162
3215,0.4036,13,121,13,225182,380428,18965,88991,3.523917151432065,0.18957690251140238
3216,0.4037,21,215,21,225397,380213,18986,88970,3.521925599318241,0.1896275014226858
3217,0.4038,20,140,20,225537,380073,19006,88950,3.5206287746859832,0.1896495481031847
3218,0.4039,20,187,20,225724,379886,19026,88930,3.5188965874986105,0.18969062489334834
3219,0.404,16,106,16,225830,379780,19042,88914,3.5179147059913296,0.1897058635271627
3220,0.4041,10,97,10,225927,379683,19052,88904,3.517016191781837,0.1897278413613694
3221,0.4042,9,159,9,226086,379524,19061,88895,3.5155433695209157,0.18977667430228065
3222,0.4043,18,94,18,226180,379430,19079,88877,3.5146726444106857,0.18978362484438627
3223,0.4044,10,89,10,226269,379341,19089,88867,3.5138482344658937,0.18980239551652256
3224,0.4045,21,183,21,226452,379158,19110,88846,3.512153099410871,0.18984025777557456
3225,0.4046,17,195,17,226647,378963,19127,88829,3.510346807958798,0.18988995108937307
3226,0.4047,14,127,14,226774,378836,19141,88815,3.509170402756679,0.18991726736391026
3227,0.4048,27,260,27,227034,378576,19168,88788,3.5067620141539146,0.18997612139574294
3228,0.4049,23,248,23,227282,378328,19191,88765,3.5044647819482013,0.1900371018191238
3229,0.405,17,115,17,227397,378213,19208,88748,3.5033995331431322,0.19005441567925374
3230,0.4051,13,117,13,227514,378096,19221,88735,3.5023157582718887,0.1900794934355259
3231,0.4052,8,73,8,227587,378023,19229,88727,3.5016395568564973,0.1900953401178361
3232,0.4053,13,167,13,227754,377856,19242,88714,3.5000926303308755,0.19014081488308293
3233,0.4054,22,143,22,227897,377713,19264,88692,3.4987680165993553,0.1901609116540346
3234,0.4055,17,161,17,228058,377552,19281,88675,3.497276668272259,0.19019704993490297
3235,0.4056,20,155,20,228213,377397,19301,88655,3.495840898143688,0.1902255542300001
3236,0.4057,12,112,12,228325,377285,19313,88643,3.494803438437882,0.19025042495836267
3237,0.4058,14,191,14,228516,377094,19327,88629,3.493034199118159,0.19030410780657173
3238,0.4059,14,95,14,228611,376999,19341,88615,3.492154210974842,0.19031859007675886
3239,0.406,9,77,9,228688,376922,19350,88606,3.4914409574271,0.19033441597497894
3240,0.4061,28,173,28,228861,376749,19378,88578,3.489838452702953,0.19035645900624723
3241,0.4062,12,78,12,228939,376671,19390,88566,3.489115936122124,0.19036749011793988
3242,0.4063,12,109,12,229048,376562,19402,88554,3.4881062655155803,0.19039121423472855
3243,0.4064,10,94,10,229142,376468,19412,88544,3.4872355404053503,0.19041229043551564
3244,0.4065,16,129,16,229271,376339,19428,88528,3.486040609137056,0.19043726485209747
3245,0.4066,12,136,12,229407,376203,19440,88516,3.4847808366371487,0.1904720917371573
3246,0.4067,17,135,17,229542,376068,19457,88499,3.4835303271703286,0.19049781839863786
3247,0.4068,13,157,13,229699,375911,19470,88486,3.4820760309755827,0.1905395599024111
3248,0.4069,18,133,18,229832,375778,19488,88468,3.480844047574938,0.19056276198394817
3249,0.407,34,160,34,229992,375618,19522,88434,3.479361962280929,0.1905691603527191
3250,0.4071,14,136,14,230128,375482,19536,88420,3.478102189781022,0.190600600989002
3251,0.4072,11,78,11,230206,375404,19547,88409,3.4773796732001925,0.19061345844122524
3252,0.4073,11,87,11,230293,375317,19558,88398,3.4765737893215753,0.19063002059454623
3253,0.4074,36,319,36,230612,374998,19594,88362,3.4736188817666456,0.19069837707182322
3254,0.4075,24,138,24,230750,374860,19618,88338,3.4723405832005634,0.19071325869282682
3255,0.4076,21,136,21,230886,374724,19639,88317,3.4710808107006557,0.19073257011798092
3256,0.4077,16,199,16,231085,374525,19655,88301,3.4692374671162325,0.19078660230842692
3257,0.4078,20,158,20,231243,374367,19675,88281,3.467773907888399,0.19081677646936765
3258,0.4079,12,87,12,231330,374280,19687,88269,3.4669680240097818,0.19083167404966825
3259,0.408,22,205,22,231535,374075,19709,88247,3.465069102226833,0.1908777864778228
3260,0.4081,26,132,26,231667,373943,19735,88221,3.463846381859276,0.19088678477769797
3261,0.4082,19,149,19,231816,373794,19754,88202,3.4624661899292306,0.19091507285777365
3262,0.4083,16,122,16,231938,373672,19770,88186,3.4613360998925486,0.19093747428863417
3263,0.4084,24,123,24,232061,373549,19794,88162,3.4601967468227794,0.19094628458061427
3264,0.4085,10,110,10,232171,373439,19804,88152,3.4591778131831488,0.19097426076331644
3265,0.4086,47,332,47,232503,373107,19851,88105,3.456102486198081,0.1910292880497472
3266,0.4087,11,123,11,232626,372984,19862,88094,3.4549631331283117,0.19106094847292648
3267,0.4088,18,150,18,232776,372834,19880,88076,3.4535736781651782,0.1910915363086069
3268,0.4089,9,108,9,232884,372726,19889,88067,3.4525732705917225,0.19112052483436162
3269,0.409,19,164,19,233048,372562,19908,88048,3.4510541331653637,0.19115520722520135
3270,0.4091,19,145,19,233193,372417,19927,88029,3.449710993367668,0.19118202785994448
3271,0.4092,18,144,18,233337,372273,19945,88011,3.4483771166030603,0.19121020934901062
3272,0.4093,9,74,9,233411,372199,19954,88002,3.4476916521545813,0.19122513858075058
3273,0.4094,34,253,34,233664,371946,19988,87968,3.4453481047834305,0.19127054188391743
3274,0.4095,21,125,21,233789,371821,20009,87947,3.444190225647486,0.1912856049137826
3275,0.4096,28,183,28,233972,371638,20037,87919,3.4424950905924634,0.1913125031280124
3276,0.4097,14,131,14,234103,371507,20051,87905,3.441281633257994,0.19134241160439866
3277,0.4098,18,169,18,234272,371338,20069,87887,3.4397161806661973,0.19138113125374273
3278,0.4099,14,146,14,234418,371192,20083,87873,3.4383637778354146,0.1914173374140917
3279,0.41,23,147,23,234565,371045,20106,87850,3.437002111971544,0.1914381285479249
3280,0.4101,16,140,16,234705,370905,20122,87834,3.4357052873392866,0.19146835128471745
3281,0.4102,13,100,13,234805,370805,20135,87821,3.434778984030531,0.19148718127624687
3282,0.4103,17,168,17,234973,370637,20152,87804,3.433222794471822,0.19152737211549578
3283,0.4104,21,144,21,235117,370493,20173,87783,3.431888917707214,0.19155050668156307
3284,0.4105,23,137,23,235254,370356,20196,87760,3.430619882174219,0.19156720132018965
3285,0.4106,21,168,21,235422,370188,20217,87739,3.42906369261551,0.19160040792528066
3286,0.4107,20,111,20,235533,370077,20237,87719,3.4280354959427917,0.19161154750150722
3287,0.4108,10,60,10,235593,370017,20247,87709,3.4274797139575384,0.19161900350864927
3288,0.4109,19,180,19,235773,369837,20266,87690,3.4258123680017785,0.19166082001717932
3289,0.411,26,123,26,235896,369714,20292,87664,3.4246730149320093,0.19166641158953862
3290,0.4111,23,205,23,236101,369509,20315,87641,3.422774093149061,0.19171169200481242
3291,0.4112,8,107,8,236208,369402,20323,87633,3.4217829486086924,0.19174242672880631
3292,0.4113,20,142,20,236350,369260,20343,87613,3.42046759791026,0.19176663974452418
3293,0.4114,23,126,23,236476,369134,20366,87590,3.419300455741228,0.1917788423643163
3294,0.4115,39,270,39,236746,368864,20405,87551,3.4167994368075885,0.19182323105068852
3295,0.4116,25,178,25,236924,368686,20430,87526,3.4151506169180035,0.19185378727433736
3296,0.4117,42,226,42,237150,368460,20472,87484,3.4130571714402165,0.19187444072079027
3297,0.4118,11,144,11,237294,368316,20483,87473,3.4117232946756086,0.1919155574180158
3298,0.4119,9,84,9,237378,368232,20492,87464,3.410945199896254,0.19193497419332187
3299,0.412,12,111,12,237489,368121,20504,87452,3.4099170032235353,0.19196045419724173
3300,0.4121,18,159,18,237648,367962,20522,87434,3.4084441809626145,0.19199553794938912
3301,0.4122,19,198,19,237846,367764,20541,87415,3.4066101004112785,0.1920453272229167
3302,0.4123,30,189,30,238035,367575,20571,87385,3.404859387157731,0.1920718304905926
3303,0.4124,20,184,20,238219,367391,20591,87365,3.403154989069621,0.192114012789276
3304,0.4125,13,91,13,238310,367300,20604,87352,3.4023120530586537,0.19212936487687285
3305,0.4126,19,92,19,238402,367208,20623,87333,3.4014598540145986,0.1921344829179326
3306,0.4127,36,211,36,238613,366997,20659,87297,3.3995053540331246,0.19215970274755995
3307,0.4128,11,93,11,238706,366904,20670,87286,3.3986438919559823,0.192179484356767
3308,0.4129,29,147,29,238853,366757,20699,87257,3.3972822260921114,0.1921901086750629
3309,0.413,26,134,26,238987,366623,20725,87231,3.3960409796583795,0.19220057551547415
3310,0.4131,28,238,28,239225,366385,20753,87203,3.3938363777835416,0.1922515586832103
3311,0.4132,18,136,18,239361,366249,20771,87185,3.392576605283634,0.19227715610210086
3312,0.4133,17,115,17,239476,366134,20788,87168,3.3915113564785653,0.1922956439636269
3313,0.4134,16,113,16,239589,366021,20804,87152,3.3904646337396716,0.19231507614089982
3314,0.4135,19,123,19,239712,365898,20823,87133,3.3893252806699024,0.19233341647701813
3315,0.4136,16,82,16,239794,365816,20839,87117,3.388565711956723,0.1923397058726125
3316,0.4137,28,225,28,240019,365591,20867,87089,3.3864815295120234,0.1923853494742423
3317,0.4138,16,121,16,240140,365470,20883,87073,3.3853607025084296,0.1924082352395242
3318,0.4139,22,133,22,240273,365337,20905,87051,3.3841287191077845,0.1924255285286082
3319,0.414,15,131,15,240404,365206,20920,87036,3.382915261773315,0.1924544823346792
3320,0.4141,13,123,13,240527,365083,20933,87023,3.381775908703546,0.19248362109770717
3321,0.4142,14,125,14,240652,364958,20947,87009,3.380618029567602,0.19251184267877963
3322,0.4143,19,143,19,240795,364815,20966,86990,3.3792934158360812,0.19253881652482818
3323,0.4144,22,128,22,240923,364687,20988,86968,3.3781077476008745,0.19255405121165492
3324,0.4145,33,231,33,241154,364456,21021,86935,3.3759679869576495,0.1925935607931926
3325,0.4146,32,245,32,241399,364211,21053,86903,3.373698543851199,0.19264088456576386
3326,0.4147,27,141,27,241540,364070,21080,86876,3.3723924561858536,0.1926527788249591
3327,0.4148,14,115,14,241655,363955,21094,86862,3.371327207380785,0.19267685113915403
3328,0.4149,7,76,7,241731,363879,21101,86855,3.3706232168661305,0.19269680121756957
3329,0.415,29,198,29,241929,363681,21130,86826,3.368789136314795,0.1927295247354647
3330,0.4151,14,110,14,242039,363571,21144,86812,3.367770202675164,0.19275150261000082
3331,0.4152,22,101,22,242140,363470,21166,86790,3.366834636333321,0.19275529693954604
3332,0.4153,10,82,10,242222,363388,21176,86780,3.3660750676201414,0.19277247605338452
3333,0.4154,18,173,18,242395,363215,21194,86762,3.364472562895995,0.19281429939752476
3334,0.4155,24,128,24,242523,363087,21218,86738,3.3632868946607877,0.19282609903851497
3335,0.4156,16,122,16,242645,362965,21234,86722,3.362156804624106,0.19284969323106962
3336,0.4157,20,70,20,242715,362895,21254,86702,3.3615083923079774,0.19284381345960938
3337,0.4158,20,254,20,242969,362641,21274,86682,3.3591555819037384,0.19291689942424492
3338,0.4159,15,137,15,243106,362504,21289,86667,3.3578865463707435,0.19294878787811323
3339,0.416,13,100,13,243206,362404,21302,86654,3.3569602430619883,0.19296839161088322
3340,0.4161,38,262,38,243468,362142,21340,86616,3.354533328393049,0.1930127150936585
3341,0.4162,28,206,28,243674,361936,21368,86588,3.3526251435770127,0.193050985008606
3342,0.4163,25,112,25,243786,361824,21393,86563,3.3515876838712066,0.1930542143282477
3343,0.4164,16,127,16,243913,361697,21409,86547,3.3504112786690876,0.19308010815537965
3344,0.4165,17,147,17,244060,361550,21426,86530,3.3490496128052167,0.19311283699339404
3345,0.4166,7,58,7,244118,361492,21433,86523,3.348512356886139,0.19312523018202515
3346,0.4167,32,250,32,244368,361242,21465,86491,3.34619659861425,0.19317539694416092
3347,0.4168,14,67,14,244435,361175,21479,86477,3.345575975397384,0.19317907660414788
3348,0.4169,30,168,30,244603,361007,21509,86447,3.344019785838675,0.1931975130404466
3349,0.417,17,140,17,244743,360867,21526,86430,3.3427229612064173,0.1932273187613599
3350,0.4171,28,152,28,244895,360715,21554,86402,3.3413149801771094,0.19324248462930285
3351,0.4172,15,99,15,244994,360616,21569,86387,3.3403979399014414,0.19325821079500585
3352,0.4173,11,65,11,245059,360551,21580,86376,3.33979584275075,0.19326646186066182
3353,0.4174,22,191,22,245250,360360,21602,86354,3.3380266034310275,0.19330936572393076
3354,0.4175,19,152,19,245402,360208,21621,86335,3.336618622401719,0.19334084287515424
3355,0.4176,12,134,12,245536,360074,21633,86323,3.335377375967987,0.19337719563527533
3356,0.4177,19,104,19,245640,359970,21652,86304,3.3344140205268813,0.19338791863294746
3357,0.4178,13,96,13,245736,359874,21665,86291,3.333524769350476,0.19340602691829256
3358,0.4179,23,200,23,245936,359674,21688,86268,3.331672162732965,0.19345116629516843
3359,0.418,9,88,9,246024,359586,21697,86259,3.3308570158212607,0.19347306799448238
3360,0.4181,11,55,11,246079,359531,21708,86248,3.330347549001445,0.19347703682766573
3361,0.4182,42,279,42,246358,359252,21750,86206,3.3277631627700175,0.19352217268519142
3362,0.4183,11,115,11,246473,359137,21761,86195,3.326697913964949,0.19355222620427007
3363,0.4184,29,166,29,246639,358971,21790,86166,3.3251602504724147,0.19357186663881007
3364,0.4185,28,203,28,246842,358768,21818,86138,3.3232798547556412,0.1936094366000908
3365,0.4186,13,70,13,246912,358698,21831,86125,3.3226314424395125,0.19361633728471775
3366,0.4187,12,110,12,247022,358588,21843,86113,3.3216125087998813,0.19364246988425932
3367,0.4188,23,127,23,247149,358461,21866,86090,3.320436103597762,0.19365607095698806
3368,0.4189,14,51,14,247200,358410,21880,86076,3.319963688910297,0.19365289345446202
3369,0.419,28,280,28,247480,358130,21908,86048,3.3173700396457817,0.1937241376205035
3370,0.4191,24,263,24,247743,357867,21932,86024,3.314933861943755,0.1937953236267462
3371,0.4192,18,184,18,247927,357683,21950,86006,3.3132294638556448,0.1938429846130961
3372,0.4193,25,146,25,248073,357537,21975,85981,3.311877061024862,0.19386135399239715
3373,0.4194,18,76,18,248149,357461,21993,85963,3.311173070510208,0.19386185682326623
3374,0.4195,27,168,27,248317,357293,22020,85936,3.309616880951499,0.19388623036850025
3375,0.4196,29,164,29,248481,357129,22049,85907,3.3080977435251397,0.19390523569190765
3376,0.4197,19,147,19,248628,356982,22068,85888,3.3067360776612693,0.1939350147898932
3377,0.4198,23,162,23,248790,356820,22091,85865,3.3052354663010854,0.1939641054022612
3378,0.4199,15,85,15,248875,356735,22106,85850,3.3044481084886437,0.19397403888518588
3379,0.42,27,175,27,249050,356560,22133,85823,3.3028270776983217,0.1940015778183158
3380,0.4201,26,154,26,249204,356406,22159,85797,3.301400570602838,0.19402175019165405
3381,0.4202,37,214,37,249418,356192,22196,85760,3.299418281522102,0.19404822243139527
3382,0.4203,30,217,30,249635,355975,22226,85730,3.297408203342102,0.19408881493304356
3383,0.4204,21,150,21,249785,355825,22247,85709,3.296018748378969,0.19411642138544258
3384,0.4205,8,96,8,249881,355729,22255,85701,3.295129497202564,0.19414403189633692
3385,0.4206,18,115,18,249996,355614,22273,85683,3.294064248397495,0.19416175500853167
3386,0.4207,17,126,17,250122,355488,22290,85666,3.2928971062284633,0.1941861572149408
3387,0.4208,17,157,17,250279,355331,22307,85649,3.2914428100337174,0.1942242278561386
3388,0.4209,13,77,13,250356,355254,22320,85636,3.2907295564859758,0.1942343895302683
3389,0.421,19,116,19,250472,355138,22339,85617,3.2896550446478194,0.19425077423965695
3390,0.4211,10,88,10,250560,355050,22349,85607,3.2888398977361146,0.19427128129134452
3391,0.4212,23,125,23,250685,354925,22372,85584,3.2876820186001705,0.1942843392530005
3392,0.4213,19,167,19,250852,354758,22391,85565,3.2861350920745487,0.19432325815367354
3393,0.4214,11,108,11,250960,354650,22402,85554,3.285134684501093,0.19435080099226723
3394,0.4215,34,229,34,251189,354421,22436,85520,3.2830134499240433,0.1943897022555297
3395,0.4216,19,180,19,251369,354241,22455,85501,3.2813461039682834,0.19443446384470894
3396,0.4217,17,151,17,251520,354090,22472,85484,3.2799473859720627,0.19447010059739658
3397,0.4218,40,265,40,251785,353825,22512,85444,3.277492682203861,0.19451406768972998
3398,0.4219,19,140,19,251925,353685,22531,85425,3.276195857571603,0.194541231126597
3399,0.422,19,193,19,252118,353492,22550,85406,3.2744080921857055,0.19459190973757
3400,0.4221,28,260,28,252378,353232,22578,85378,3.2719997035829413,0.19465584459998633
3401,0.4222,14,137,14,252515,353095,22592,85364,3.2707306680499464,0.19469095171954504
3402,0.4223,24,168,24,252683,352927,22616,85340,3.2691744784912373,0.1947214825665633
3403,0.4224,13,118,13,252801,352809,22629,85327,3.2680814405869056,0.19475003195354867
3404,0.4225,20,112,20,252913,352697,22649,85307,3.2670439808810996,0.19476306152455228
3405,0.4226,19,83,19,252996,352614,22668,85288,3.2662751491348327,0.194765038752963
3406,0.4227,14,161,14,253157,352453,22682,85274,3.2647838008077366,0.19481092096215222
3407,0.4228,19,188,19,253345,352265,22701,85255,3.263042350587276,0.19485966355823733
3408,0.4229,7,67,7,253412,352198,22708,85248,3.2624217273704104,0.19487662477197185
3409,0.423,39,292,39,253704,351906,22747,85209,3.2597169217088444,0.19493497134621324
3410,0.4231,7,74,7,253778,351832,22754,85202,3.2590314572603654,0.19495508358617408
3411,0.4232,23,205,23,253983,351627,22777,85179,3.2571325354774165,0.19500418950289145
3412,0.4233,16,126,16,254109,351501,22793,85163,3.2559653933083847,0.19503096202114212
3413,0.4234,10,92,10,254201,351409,22803,85153,3.25511319426433,0.19505362354029898
3414,0.4235,20,136,20,254337,351273,22823,85133,3.2538534217644224,0.1950775195574763
3415,0.4236,11,120,11,254457,351153,22834,85122,3.2527418577939162,0.1951108818978855
3416,0.4237,11,98,11,254555,351055,22845,85111,3.251834080551336,0.19513442129831302
3417,0.4238,26,141,26,254696,350914,22871,85085,3.2505279928859907,0.19514953015947284
3418,0.4239,37,222,37,254918,350692,22908,85048,3.2484715995405535,0.1951806122917336
3419,0.424,14,116,14,255034,350576,22922,85034,3.247397087702397,0.1952067216087785
3420,0.4241,11,121,11,255155,350455,22933,85023,3.2462762606988034,0.19524063213296652
3421,0.4242,13,104,13,255259,350351,22946,85010,3.2453129052576974,0.19526324131008518
3422,0.4243,36,223,36,255482,350128,22982,84974,3.243247248879173,0.19529673501845543
3423,0.4244,16,135,16,255617,349993,22998,84958,3.241996739412353,0.1953277495625944
3424,0.4245,21,231,21,255848,349762,23019,84937,3.239856978769128,0.19539267401121235
3425,0.4246,24,169,24,256017,349593,23043,84913,3.2382915261773313,0.19542422889442262
3426,0.4247,18,123,18,256140,349470,23061,84895,3.2371521731075625,0.1954462261001692
3427,0.4248,12,102,12,256242,349368,23073,84883,3.236207343732632,0.1954699010480114
3428,0.4249,16,149,16,256391,349219,23089,84867,3.234827151802586,0.19550734186313312
3429,0.425,29,222,29,256613,348997,23118,84838,3.232770758457149,0.19555360909101385
3430,0.4251,23,166,23,256779,348831,23141,84815,3.2312330949646153,0.19558580039940412
3431,0.4252,20,122,20,256901,348709,23161,84795,3.230103004927934,0.19560373145345833
3432,0.4253,29,194,29,257095,348515,23190,84766,3.228305976508948,0.19563747314098703
3433,0.4254,17,114,17,257209,348401,23207,84749,3.2272499907369667,0.19565739351263997
3434,0.4255,19,84,19,257293,348317,23226,84730,3.226471895957612,0.19566005537505166
3435,0.4256,15,91,15,257384,348226,23241,84715,3.225628959946645,0.19567331345379624
3436,0.4257,9,86,9,257470,348140,23250,84706,3.2248323391011153,0.1956954667479889
3437,0.4258,18,150,18,257620,347990,23268,84688,3.2234428841379823,0.1957298499114815
3438,0.4259,13,109,13,257729,347881,23281,84675,3.222433213531439,0.19575500050860467
3439,0.426,17,104,17,257833,347777,23298,84658,3.221469858090333,0.19577046261287823
3440,0.4261,17,172,17,258005,347605,23315,84641,3.2198766163992736,0.1958167339894412
3441,0.4262,37,229,37,258234,347376,23352,84604,3.217755381822224,0.19585165979906477
3442,0.4263,10,107,10,258341,347269,23362,84594,3.2167642372818555,0.19588156429237977
3443,0.4264,30,213,30,258554,347056,23392,84564,3.2147912112342065,0.19592233909457393
3444,0.4265,18,101,18,258655,346955,23410,84546,3.2138556448923636,0.19593465600311472
3445,0.4266,19,147,19,258802,346808,23429,84527,3.212493979028493,0.19596601249608772
3446,0.4267,13,138,13,258940,346670,23442,84514,3.2112156804624106,0.1960044899625218
3447,0.4268,11,93,11,259033,346577,23453,84503,3.2103542183852682,0.1960262596269834
3448,0.4269,28,139,28,259172,346438,23481,84475,3.209066656786098,0.19603725113886097
3449,0.427,21,114,21,259286,346324,23502,84454,3.208010671014117,0.19604993755484262
3450,0.4271,23,162,23,259448,346162,23525,84431,3.206510059653933,0.19608075375122216
3451,0.4272,25,209,25,259657,345953,23550,84406,3.2045740857386344,0.19612927811431852
3452,0.4273,24,196,24,259853,345757,23574,84382,3.2027585312534734,0.19617379498255216
3453,0.4274,19,122,19,259975,345635,23593,84363,3.201628441216792,0.19619393578574784
3454,0.4275,21,135,21,260110,345500,23614,84342,3.2003779317499723,0.19621628412300335
3455,0.4276,26,253,26,260363,345247,23640,84316,3.198034384378821,0.19628319943756795
3456,0.4277,38,242,38,260605,345005,23678,84278,3.195792730371633,0.19632270553457742
3457,0.4278,28,184,28,260789,344821,23706,84250,3.1940883322835227,0.19635444949670333
3458,0.4279,36,317,36,261106,344504,23742,84214,3.1911519507947683,0.19643215353682375
3459,0.428,18,169,18,261275,344335,23760,84196,3.1895864982029716,0.19647586755683952
3460,0.4281,28,230,28,261505,344105,23788,84168,3.1874560005928343,0.19652884958893044
3461,0.4282,22,135,22,261640,343970,23810,84146,3.1862054911260143,0.19654953330405778
3462,0.4283,20,173,20,261813,343797,23830,84126,3.1846029864018672,0.19659144285303665
3463,0.4284,18,99,18,261912,343698,23848,84108,3.1836859461261997,0.19660313319588785
3464,0.4285,20,143,20,262055,343555,23868,84088,3.182361332394679,0.19663130227783454
3465,0.4286,17,102,17,262157,343453,23885,84071,3.181416503019749,0.19664627015091551
3466,0.4287,41,216,41,262373,343237,23926,84030,3.179415687872837,0.19666859364285097
3467,0.4288,25,202,25,262575,343035,23951,84005,3.1775445551891512,0.19671459348070439
3468,0.4289,14,152,14,262727,342883,23965,83991,3.176136574159843,0.19675829401650136
3469,0.429,26,120,26,262847,342763,23991,83965,3.1750250101893362,0.1967646838266999
3470,0.4291,27,187,27,263034,342576,24018,83938,3.173292823001964,0.19680010503758377
3471,0.4292,34,249,34,263283,342327,24052,83904,3.170986327763163,0.19685100332918065
3472,0.4293,31,147,31,263430,342180,24083,83873,3.1696246618992925,0.1968604844937132
3473,0.4294,31,186,31,263616,341994,24114,83842,3.1679017377450074,0.19688800383246133
3474,0.4295,7,79,7,263695,341915,24121,83835,3.1671699581310904,0.1969113329418673
3475,0.4296,27,171,27,263866,341744,24148,83808,3.1655859794731187,0.1969395044553897
3476,0.4297,19,119,19,263985,341625,24167,83789,3.1644836785357,0.19695872726332467
3477,0.4298,17,142,17,264127,341483,24184,83772,3.163168327837267,0.19699239279961434
3478,0.4299,17,121,17,264248,341362,24201,83755,3.162047500833673,0.19701635079284055
3479,0.43,37,238,37,264486,341124,24238,83718,3.159842898958835,0.19705678817066108
3480,0.4301,43,346,43,264832,340778,24281,83675,3.156637889510541,0.19713607867066554
3481,0.4302,13,121,13,264953,340657,24294,83662,3.1555170625069473,0.19716769694498715
3482,0.4303,20,197,20,265150,340460,24314,83642,3.153692244988699,0.1972214231482049
3483,0.4304,13,118,13,265268,340342,24327,83629,3.152599207084368,0.197251698819023
3484,0.4305,43,271,43,265539,340071,24370,83586,3.1500889251176405,0.19729639779349803
3485,0.4306,32,165,32,265704,339906,24402,83554,3.148560524658194,0.19731261512303405
3486,0.4307,20,170,20,265874,339736,24422,83534,3.14698580903331,0.19735393484064545
3487,0.4308,17,128,17,266002,339608,24439,83517,3.145800140798103,0.19738138847858197
3488,0.4309,7,83,7,266085,339525,24446,83510,3.145031309051836,0.19740683394990957
3489,0.431,32,187,32,266272,339338,24478,83478,3.1432991218644633,0.19743339892530085
3490,0.4311,20,109,20,266381,339229,24498,83458,3.14228945125792,0.1974463373607421
3491,0.4312,27,149,27,266530,339080,24525,83431,3.1409092593278745,0.19746468139291048
3492,0.4313,19,163,19,266693,338917,24544,83412,3.139399384934603,0.19750478892048617
3493,0.4314,21,146,21,266839,338771,24565,83391,3.13804698210382,0.19753317446856894
3494,0.4315,23,177,23,267016,338594,24588,83368,3.136407425247323,0.19757229323967562
3495,0.4316,11,88,11,267104,338506,24599,83357,3.135592278335618,0.1975925833742234
3496,0.4317,20,128,20,267232,338378,24619,83337,3.1344066101004113,0.19761450268546293
3497,0.4318,22,153,22,267385,338225,24641,83315,3.1329893660380157,0.19764435166295014
3498,0.4319,36,238,36,267623,337987,24677,83279,3.1307847641631774,0.19768744688629036
3499,0.432,32,224,32,267847,337763,24709,83247,3.1287098447515653,0.19773164532908957
3500,0.4321,14,78,14,267925,337685,24723,83233,3.1279873281707364,0.1977416028775201
3501,0.4322,28,176,28,268101,337509,24751,83205,3.126357034347327,0.19777093227228
3502,0.4323,23,138,23,268239,337371,24774,83182,3.125078735781244,0.19779195487845766
3503,0.4324,21,118,21,268357,337253,24795,83161,3.123985697876913,0.197807399372999
3504,0.4325,35,204,35,268561,337049,24830,83126,3.122096039127052,0.19783661569584102
3505,0.4326,29,200,29,268761,336849,24859,83097,3.120243432509541,0.19787544112814504
3506,0.4327,17,110,17,268871,336739,24876,83080,3.11922449886991,0.19789480704779916
3507,0.4328,11,93,11,268964,336646,24887,83069,3.1183630367927675,0.1979176345853734
3508,0.4329,33,174,33,269138,336472,24920,83036,3.116751269035533,0.197936630529096
3509,0.433,12,134,12,269272,336338,24932,83024,3.115510022601801,0.19797692685555676
3510,0.4331,26,180,26,269452,336158,24958,82998,3.113842676646041,0.19801219593659639
3511,0.4332,21,183,21,269635,335975,24979,82977,3.1121475415910185,0.19805848880062632
3512,0.4333,26,167,26,269802,335808,25005,82951,3.110600615065397,0.1980876828915916
3513,0.4334,17,92,17,269894,335716,25022,82934,3.109748416021342,0.19809865042398184
3514,0.4335,19,144,19,270038,335572,25041,82915,3.108414539256734,0.19813040787407973
3515,0.4336,37,144,37,270182,335428,25078,82878,3.1070806624921263,0.19812768643050782
3516,0.4337,22,165,22,270347,335263,25100,82856,3.10555226203268,0.19816368067464046
3517,0.4338,40,226,40,270573,335037,25140,82816,3.103458816554893,0.19819410175348748
3518,0.4339,12,136,12,270709,334901,25152,82804,3.102199044054985,0.19823559689254378
3519,0.434,22,165,22,270874,334736,25174,82782,3.100670643595539,0.19827169128037594
3520,0.4341,20,137,20,271011,334599,25194,82762,3.099401608062544,0.19829835562019452
3521,0.4342,15,104,15,271115,334495,25209,82747,3.0984382526214382,0.19831896117840486
3522,0.4343,28,167,28,271282,334328,25237,82719,3.096891326095817,0.19834455109376162
3523,0.4344,26,152,26,271434,334176,25263,82693,3.0954833450665085,0.19836687304644865
3524,0.4345,19,176,19,271610,334000,25282,82674,3.093853051243099,0.19841410791170075
3525,0.4346,33,244,33,271854,333756,25315,82641,3.091592871169736,0.19846684774385984
3526,0.4347,13,104,13,271958,333652,25328,82628,3.0906295157286303,0.19849140001921783
3527,0.4348,20,187,20,272145,333465,25348,82608,3.0888973285412575,0.19854208275951576
3528,0.4349,20,123,20,272268,333342,25368,82588,3.0877579754714883,0.19856225807227176
3529,0.435,34,143,34,272411,333199,25402,82554,3.086433361739968,0.19856501336129864
3530,0.4351,10,79,10,272490,333120,25412,82544,3.085701582126051,0.1985834712652527
3531,0.4352,26,168,26,272658,332952,25438,82518,3.084145392567342,0.19861361831179147
3532,0.4353,20,160,20,272818,332792,25458,82498,3.0826633072733336,0.19865154470370103
3533,0.4354,28,186,28,273004,332606,25486,82470,3.0809403831190485,0.19868650560379303
3534,0.4355,25,167,25,273171,332439,25511,82445,3.079393456593427,0.19871819592946463
3535,0.4356,30,191,30,273362,332248,25541,82415,3.077624217273704,0.19875175745123147
3536,0.4357,26,177,26,273539,332071,25567,82389,3.075984660417207,0.19878637262944554
3537,0.4358,20,125,20,273664,331946,25587,82369,3.0748267812812626,0.1988076704922583
3538,0.4359,22,193,22,273857,331753,25609,82347,3.0730390158953647,0.19885776382516301
3539,0.436,31,233,31,274090,331520,25640,82316,3.0708807291859648,0.19890971302641627
3540,0.4361,24,204,24,274294,331316,25664,82292,3.0689910704361036,0.19896133537068916
3541,0.4362,15,99,15,274393,331217,25679,82277,3.0680740301604357,0.19897991264685824
3542,0.4363,10,69,10,274462,331148,25689,82267,3.0674348808773946,0.19899374720317356
3543,0.4364,28,114,28,274576,331034,25717,82239,3.066378895105413,0.19899436933939552
3544,0.4365,16,89,16,274665,330945,25733,82223,3.065554485160621,0.19900621538938157
3545,0.4366,18,107,18,274772,330838,25751,82205,3.0645633406202526,0.19902286202647182
3546,0.4367,26,196,26,274968,330642,25777,82179,3.062747786135092,0.19906690793346268
3547,0.4368,38,219,38,275187,330423,25815,82141,3.060719181888918,0.19909880648820547
3548,0.4369,31,177,31,275364,330246,25846,82110,3.0590796250324206,0.1991240578529232
3549,0.437,23,203,23,275567,330043,25869,82087,3.057199229315647,0.19917744401038506
3550,0.4371,20,122,20,275689,329921,25889,82067,3.0560691392789656,0.19919754944318765
3551,0.4372,20,134,20,275823,329787,25909,82047,3.0548278928452333,0.1992234735354536
3552,0.4373,25,197,25,276020,329590,25934,82022,3.053003075326985,0.19927018648630263
3553,0.4374,38,226,38,276246,329364,25972,81984,3.050909629849198,0.1993056973657341
3554,0.4375,25,187,25,276433,329177,25997,81959,3.049177442661825,0.19934766111457036
3555,0.4376,23,156,23,276589,329021,26020,81936,3.0477324095001666,0.1993785237871602
3556,0.4377,30,221,30,276810,328800,26050,81906,3.045685279187817,0.19942732757739112
3557,0.4378,19,192,19,277002,328608,26069,81887,3.0439067768350068,0.1994835503477509
3558,0.4379,19,178,19,277180,328430,26088,81868,3.0422579569454222,0.19953302233986028
3559,0.438,21,123,21,277303,328307,26109,81847,3.041118603875653,0.19955187563695587
3560,0.4381,12,112,12,277415,328195,26121,81835,3.040081144169847,0.19958295734458453
3561,0.4382,12,103,12,277518,328092,26133,81823,3.0391270517618287,0.199609675176561
3562,0.4383,15,127,15,277645,327965,26148,81808,3.0379506465597097,0.1996422409480371
3563,0.4384,54,303,54,277948,327662,26202,81754,3.0351439475341806,0.19968442855188853
3564,0.4385,48,322,48,278270,327340,26250,81706,3.0321612508799882,0.19974770563701882
3565,0.4386,21,127,21,278397,327213,26271,81685,3.0309848456778687,0.19976864645950823
3566,0.4387,38,248,38,278645,326965,26309,81647,3.0286876134721554,0.19981547286912768
3567,0.4388,36,180,36,278825,326785,26345,81611,3.0270202675163955,0.19983300522042333
3568,0.4389,45,241,45,279066,326544,26390,81566,3.024787876542295,0.19986278209306316
3569,0.439,35,251,35,279317,326293,26425,81531,3.0224628552373187,0.19991712111106752
3570,0.4391,37,250,37,279567,326043,26462,81494,3.0201470969654305,0.19996711954988136
3571,0.4392,32,182,32,279749,325861,26494,81462,3.0184612249434957,0.1999936168593475
3572,0.4393,9,106,9,279855,325755,26503,81453,3.017479343436215,0.20002799552071668
3573,0.4394,16,126,16,279981,325629,26519,81437,3.016312201267183,0.20005846717731277
3574,0.4395,26,177,26,280158,325452,26545,81411,3.0146726444106857,0.2000943806637615
3575,0.4396,16,92,16,280250,325360,26561,81395,3.0138204453666306,0.20010817322466842
3576,0.4397,24,127,24,280377,325233,26585,81371,3.0126440401645116,0.20012346164818842
3577,0.4398,30,196,30,280573,325037,26615,81341,3.010828485679351,0.2001609339088238
3578,0.4399,28,203,28,280776,324834,26643,81313,3.0089480899625776,0.20020583680293097
3579,0.44,28,232,28,281008,324602,26671,81285,3.006799066286265,0.20026509841409063
3580,0.4401,39,261,39,281269,324341,26710,81246,3.004381414650413,0.2003170713065261
3581,0.4402,23,157,23,281426,324184,26733,81223,3.002927118455667,0.20034927862617075
3582,0.4403,25,163,25,281589,324021,26758,81198,3.0014172440623956,0.2003805349699792
3583,0.4404,6,55,6,281644,323966,26764,81192,3.0009077772425803,0.20039589493481555
3584,0.4405,16,112,16,281756,323854,26780,81176,2.9998703175367742,0.20041972199590155
3585,0.4406,20,166,20,281922,323688,26800,81156,2.99833265404424,0.20046240033197973
3586,0.4407,50,327,50,282249,323361,26850,81106,2.99530364222461,0.2005256300266771
3587,0.4408,26,184,26,282433,323177,26876,81080,2.9935992441365,0.20056548185931228
3588,0.4409,16,79,16,282512,323098,26892,81064,2.9928674645225835,0.20057303754435102
3589,0.441,17,199,17,282711,322899,26909,81047,2.99102412093816,0.2006382041163918
3590,0.4411,43,296,43,283007,322603,26952,81004,2.988282263144244,0.2007001860720949
3591,0.4412,14,133,14,283140,322470,26966,80990,2.9870502797435994,0.20073861101472265
3592,0.4413,15,122,15,283262,322348,26981,80975,2.9859201897069174,0.20076960649405068
3593,0.4414,18,85,18,283347,322263,26999,80957,2.9851328318944756,0.20077625117801695
3594,0.4415,24,169,24,283516,322094,27023,80933,2.983567379302679,0.20081284876695607
3595,0.4416,14,134,14,283650,321960,27037,80919,2.9823261328689465,0.20085186867521018
3596,0.4417,47,347,47,283997,321613,27084,80872,2.9791118603875653,0.2009317117408102
3597,0.4418,28,191,28,284188,321422,27112,80844,2.9773426210678426,0.20097149647248339
3598,0.4419,35,261,35,284449,321161,27147,80809,2.974924969431991,0.20103241535437968
3599,0.442,18,167,18,284616,320994,27165,80791,2.9733780429063694,0.20108017969809724
3600,0.4421,19,137,19,284753,320857,27184,80772,2.9721090073733745,0.20111097555206423
3601,0.4422,38,189,38,284942,320668,27222,80734,2.9703582941198268,0.20113003921255998
3602,0.4423,18,165,18,285107,320503,27240,80716,2.9688298936603803,0.20117691335654592
3603,0.4424,23,129,23,285236,320374,27263,80693,2.9676349623920855,0.20119581017635457
3604,0.4425,16,128,16,285364,320246,27279,80677,2.9664492941568787,0.201228166006939
3605,0.4426,21,172,21,285536,320074,27300,80656,2.9648560524658194,0.20127267736381105
3606,0.4427,16,127,16,285663,319947,27316,80640,2.9636796472637,0.2013045855207483
3607,0.4428,22,113,22,285776,319834,27338,80618,2.962632924524806,0.20131751121233007
3608,0.4429,13,101,13,285877,319733,27351,80605,2.9616973581829633,0.20134236570098266
3609,0.443,31,236,31,286113,319497,27382,80574,2.959511282374301,0.20139925163283517
3610,0.4431,15,96,15,286209,319401,27397,80559,2.9586220311978955,0.20141764176417642
3611,0.4432,12,79,12,286288,319322,27409,80547,2.9578902515839784,0.20143346946124857
3612,0.4433,29,187,29,286475,319135,27438,80518,2.956158064396606,0.20146977502983837
3613,0.4434,17,138,17,286613,318997,27455,80501,2.9548797658305235,0.20150538926352574
3614,0.4435,37,224,37,286837,318773,27492,80464,2.9528048464189114,0.20154444603080376
3615,0.4436,28,172,28,287009,318601,27520,80436,2.951211604727852,0.20157529251673403
3616,0.4437,39,171,39,287180,318430,27559,80397,2.9496276260698804,0.20158364403613596
3617,0.4438,13,84,13,287264,318346,27572,80384,2.948849531290526,0.20160008025480902
3618,0.4439,22,145,22,287409,318201,27594,80362,2.9475063914928303,0.2016293534522773
3619,0.444,13,129,13,287538,318072,27607,80349,2.946311460224536,0.20166858674618054
3620,0.4441,19,136,19,287674,317936,27626,80330,2.9450516877246287,0.20169936675488243
3621,0.4442,41,221,41,287895,317715,27667,80289,2.943004557412279,0.20172912835046883
3622,0.4443,31,229,31,288124,317486,27698,80258,2.940883322835229,0.20178305643831207
3623,0.4444,18,127,18,288251,317359,27716,80240,2.9397069176331097,0.20181137276502203
3624,0.4445,28,156,28,288407,317203,27744,80212,2.9382618844714514,0.20183435451606005
3625,0.4446,28,176,28,288583,317027,27772,80184,2.936631590648042,0.20186752129220994
3626,0.4447,23,178,23,288761,316849,27795,80161,2.9349827707584573,0.2019117906349966
3627,0.4448,17,112,17,288873,316737,27812,80144,2.933945311052651,0.20193458492596017
3628,0.4449,11,101,11,288974,316636,27823,80133,2.933009744710808,0.20196386310422437
3629,0.445,22,189,22,289163,316447,27845,80111,2.93125903145726,0.2020158463579098
3630,0.4451,26,134,26,289297,316313,27871,80085,2.9300177850235283,0.20203179632591486
3631,0.4452,17,135,17,289432,316178,27888,80068,2.9287672755567082,0.20206639309923632
3632,0.4453,22,209,22,289641,315969,27910,80046,2.9268313016414096,0.20212870724593765
3633,0.4454,16,111,16,289752,315858,27926,80030,2.925803104968691,0.20215313421977932
3634,0.4455,19,189,19,289941,315669,27945,80011,2.924052391715143,0.20221138293570562
3635,0.4456,23,194,23,290135,315475,27968,79988,2.922255363296158,0.20226418147841896
3636,0.4457,36,193,36,290328,315282,28004,79952,2.92046759791026,0.2022902887909441
3637,0.4458,30,181,30,290509,315101,28034,79922,2.9187909889214123,0.2023223964174238
3638,0.4459,27,183,27,290692,314918,28061,79895,2.91709585386639,0.2023616243639394
3639,0.446,34,197,34,290889,314721,28095,79861,2.915271036348142,0.20239392572393064
3640,0.4461,12,107,12,290996,314614,28107,79849,2.9142798918077735,0.20242456199947778
3641,0.4462,22,142,22,291138,314472,28129,79827,2.912964541109341,0.20245296082414616
3642,0.4463,17,96,17,291234,314376,28146,79810,2.9120752899329356,0.20246787049768383
3643,0.4464,17,105,17,291339,314271,28163,79793,2.9111026714587425,0.20248741321206706
3644,0.4465,40,283,40,291622,313988,28203,79753,2.9084812330949648,0.20255193134573235
3645,0.4466,34,245,34,291867,313743,28237,79719,2.906211789988514,0.2026091464995349
3646,0.4467,20,112,20,291979,313631,28257,79699,2.9051743302827076,0.20262629344316477
3647,0.4468,20,136,20,292115,313495,28277,79679,2.9039145577828003,0.20265582159552767
3648,0.4469,33,145,33,292260,313350,28310,79646,2.902571417985105,0.20266364034239534
3649,0.447,29,195,29,292455,313155,28339,79617,2.900765126533032,0.20270538633100119
3650,0.4471,26,168,26,292623,312987,28365,79591,2.899208936974323,0.202739328235408
3651,0.4472,8,78,8,292701,312909,28373,79583,2.8984864203934935,0.2027633684253437
3652,0.4473,19,123,19,292824,312786,28392,79564,2.8973470673237243,0.20278832674907607
3653,0.4474,26,213,26,293037,312573,28418,79538,2.8953740412760753,0.20284562279558593
3654,0.4475,14,83,14,293120,312490,28432,79524,2.8946052095298085,0.20286010193513496
3655,0.4476,18,139,18,293259,312351,28450,79506,2.8933176479306386,0.20289544400125556
3656,0.4477,20,155,20,293414,312196,28470,79486,2.8918818778020676,0.2029350340327102
3657,0.4478,17,127,17,293541,312069,28487,79469,2.890705472599948,0.20296625104076743
3658,0.4479,29,179,29,293720,311890,28516,79440,2.889047389677276,0.20300002555388036
3659,0.448,19,161,19,293881,311729,28535,79421,2.8875560413501797,0.20304486769781413
3660,0.4481,15,98,15,293979,311631,28550,79406,2.8866482641075994,0.20306518309009122
3661,0.4482,19,98,19,294077,311533,28569,79387,2.885740486865019,0.20307735598076332
3662,0.4483,32,257,32,294334,311276,28601,79355,2.8833598873615176,0.20314567968236008
3663,0.4484,26,166,26,294500,311110,28627,79329,2.8818222238689835,0.2031789857058337
3664,0.4485,54,277,54,294777,310833,28681,79275,2.879256363703731,0.20321295641207052
3665,0.4486,38,252,38,295029,310581,28719,79237,2.8769220793656674,0.2032666526430283
3666,0.4487,17,136,17,295165,310445,28736,79220,2.87566230686576,0.20330283705233984
3667,0.4488,16,130,16,295295,310315,28752,79204,2.874458112564378,0.20333796297484846
3668,0.4489,19,137,19,295432,310178,28771,79185,2.873189077031383,0.20337063357329793
3669,0.449,23,119,23,295551,310059,28794,79162,2.872086776093964,0.20338573715190084
3670,0.4491,22,96,22,295647,309963,28816,79140,2.871197524917559,0.20339087593773372
3671,0.4492,24,138,24,295785,309825,28840,79116,2.8699192263514766,0.20341388539649974
3672,0.4493,30,147,30,295932,309678,28870,79086,2.868557560487606,0.20342932987622311
3673,0.4494,23,180,23,296112,309498,28893,79063,2.8668902145318462,0.20347641683030462
3674,0.4495,27,127,27,296239,309371,28920,79036,2.8657138093297267,0.20348757875115536
3675,0.4496,21,150,21,296389,309221,28941,79015,2.8643243543665937,0.20352311480645793
3676,0.4497,19,144,19,296533,309077,28960,78996,2.862990477601986,0.20355963955235226
3677,0.4498,27,140,27,296673,308937,28987,78969,2.8616936529697283,0.2035776708790274
3678,0.4499,22,120,22,296793,308817,29009,78947,2.8605820889992217,0.2035954859141127
3679,0.45,29,168,29,296961,308649,29038,78918,2.8590258994405127,0.2036241475667433
3680,0.4501,10,78,10,297039,308571,29048,78908,2.8583033828596838,0.2036445846097466
3681,0.4502,30,215,30,297254,308356,29078,78878,2.8563118307458595,0.2036959564501051
3682,0.4503,21,125,21,297379,308231,29099,78857,2.8551539516099154,0.20371853428677716
3683,0.4504,17,152,17,297531,308079,29116,78840,2.853745970580607,0.20376357842339093
3684,0.4505,17,133,17,297664,307946,29133,78823,2.8525139871799623,0.20379864984008542
3685,0.4506,47,227,47,297891,307719,29180,78776,2.8504112786690876,0.20382152421117997
3686,0.4507,31,274,31,298165,307445,29211,78745,2.8478732076030977,0.2039022242937414
3687,0.4508,35,145,35,298310,307300,29246,78710,2.846530067805402,0.20390663454314656
3688,0.4509,17,156,17,298466,307144,29263,78693,2.845085034643744,0.20395400130106756
3689,0.451,19,119,19,298585,307025,29282,78674,2.8439827337063246,0.20397771319085609
3690,0.4511,14,151,14,298736,306874,29296,78660,2.8425840157101043,0.20402869785803587
3691,0.4512,8,67,8,298803,306807,29304,78652,2.841963392493238,0.2040476419022516
3692,0.4513,30,198,30,299001,306609,29334,78622,2.840129311941902,0.204090532693371
3693,0.4514,28,175,28,299176,306434,29362,78594,2.8385082811515803,0.2041254142555866
3694,0.4515,29,214,29,299390,306220,29391,78565,2.8365259920708437,0.20417895707992775
3695,0.4516,25,167,25,299557,306053,29416,78540,2.8349790655452223,0.20421588536452823
3696,0.4517,28,185,28,299742,305868,29444,78512,2.8332654044240244,0.20425620479733597
3697,0.4518,65,361,65,300103,305507,29509,78447,2.8299214494794174,0.20431353755918677
3698,0.4519,32,181,32,300284,305326,29541,78415,2.8282448404905702,0.204343554637112
3699,0.452,24,132,24,300416,305194,29565,78391,2.8270221201230132,0.20436409140086292
3700,0.4521,19,149,19,300565,305045,29584,78372,2.8256419281929674,0.20440408223944165
3701,0.4522,14,135,14,300700,304910,29598,78358,2.824391418726148,0.20444701879624702
3702,0.4523,23,156,23,300856,304754,29621,78335,2.822946385564489,0.20448250928635384
3703,0.4524,40,182,40,301038,304572,29661,78295,2.8212605135425544,0.20449660064722214
3704,0.4525,43,205,43,301243,304367,29704,78252,2.8193615917596055,0.2045167647189502
3705,0.4526,29,209,29,301452,304158,29733,78223,2.817425617844307,0.20456821860918822
3706,0.4527,34,149,34,301601,304009,29767,78189,2.8160454259142615,0.2045772086719449
3707,0.4528,24,121,24,301722,303888,29791,78165,2.8149245989106673,0.20459203304253598
3708,0.4529,38,142,38,301864,303746,29829,78127,2.813609248212235,0.2045889602040469
3709,0.453,14,80,14,301944,303666,29843,78113,2.81286820556523,0.2046026627970632
3710,0.4531,21,141,21,302085,303525,29864,78092,2.8115621178998853,0.20463448955366245
3711,0.4532,17,137,17,302222,303388,29881,78075,2.8102930823668903,0.20467253704815408
3712,0.4533,22,166,22,302388,303222,29903,78053,2.808755418874356,0.2047157563438463
3713,0.4534,32,221,32,302609,303001,29935,78021,2.8067082885620067,0.20476770370214845
3714,0.4535,22,140,22,302749,302861,29957,77999,2.805411463929749,0.20479703828178333
3715,0.4536,36,200,36,302949,302661,29993,77963,2.8035588573122383,0.2048294379755349
3716,0.4537,20,97,20,303046,302564,30013,77943,2.8026603431027457,0.20483985839945126
3717,0.4538,16,112,16,303158,302452,30029,77927,2.8016228833969397,0.20486672502951003
3718,0.4539,27,220,27,303378,302232,30056,77900,2.7995850161176774,0.20492881420138268
3719,0.454,31,193,31,303571,302039,30087,77869,2.7977972507317794,0.20496804489507986
3720,0.4541,24,129,24,303700,301910,30111,77845,2.796602319463485,0.2049874261036721
3721,0.4542,27,204,27,303904,301706,30138,77818,2.794712660713624,0.20504105142230794
3722,0.4543,24,211,24,304115,301495,30162,77794,2.7927581607321503,0.20510481453456336
3723,0.4544,32,161,32,304276,301334,30194,77762,2.7912668124050537,0.20512482326376433
3724,0.4545,22,175,22,304451,301159,30216,77740,2.7896457816147318,0.20517341032834607
3725,0.4546,39,222,39,304673,300937,30255,77701,2.787589388269295,0.20521183822014694
3726,0.4547,17,101,17,304774,300836,30272,77684,2.786653821927452,0.2052308992919793
3727,0.4548,43,312,43,305086,300524,30315,77641,2.783763755604135,0.20530985151983921
3728,0.4549,19,128,19,305214,300396,30334,77622,2.782578087368928,0.20533942828119295
3729,0.455,19,149,19,305363,300247,30353,77603,2.7811978954388823,0.20538044197432845
3730,0.4551,15,75,15,305438,300172,30368,77588,2.780503167957316,0.20538966539601863
3731,0.4552,17,73,17,305511,300099,30385,77571,2.7798269665419246,0.20539359758519343
3732,0.4553,40,255,40,305766,299844,30425,77531,2.777464893104598,0.20544816164292812
3733,0.4554,19,116,19,305882,299728,30444,77512,2.7763903812664417,0.20547131799385007
3734,0.4555,7,79,7,305961,299649,30451,77505,2.775658601652525,0.2054996102387884
3735,0.4556,14,122,14,306083,299527,30465,77491,2.7745285116158436,0.20553660567930443
3736,0.4557,35,193,35,306276,299334,30500,77456,2.7727407462299456,0.2055680883250617
3737,0.4558,17,109,17,306385,299225,30517,77439,2.771731075623402,0.20559172100333453
3738,0.4559,17,156,17,306541,299069,30534,77422,2.7702860424617435,0.20564103789997637
3739,0.456,17,128,17,306669,298941,30551,77405,2.7691003742265368,0.20567509685236457
3740,0.4561,27,142,27,306811,298799,30578,77378,2.767785023528104,0.205695723024002
3741,0.4562,39,241,39,307052,298558,30617,77339,2.7655526325540034,0.20574519083685158
3742,0.4563,15,111,15,307163,298447,30632,77324,2.764524435881285,0.20577426145178845
3743,0.4564,15,90,15,307253,298357,30647,77309,2.763690762903405,0.20579184701303818
3744,0.4565,20,181,20,307434,298176,30667,77289,2.7620141539145577,0.20584874755303423
3745,0.4566,6,84,6,307518,298092,30673,77283,2.761236059135203,0.20588211788211788
3746,0.4567,30,250,30,307768,297842,30703,77253,2.7589203008633145,0.2059558245244538
3747,0.4568,15,96,15,307864,297746,30718,77238,2.7580310496869096,0.2059767883429693
3748,0.4569,59,333,59,308197,297413,30777,77179,2.754946459668754,0.20603483256449684
3749,0.457,27,179,27,308376,297234,30804,77152,2.753288376746082,0.20607608190477208
3750,0.4571,22,169,22,308545,297065,30826,77130,2.751722924154285,0.20612247624901456
3751,0.4572,25,131,25,308676,296934,30851,77105,2.7505094668198153,0.206141605554501
3752,0.4573,29,188,29,308864,296746,30880,77076,2.7487680165993553,0.20618369170353804
3753,0.4574,22,105,22,308969,296641,30902,77054,2.747795398125162,0.20619489155594803
3754,0.4575,41,235,41,309204,296406,30943,77013,2.745618585349587,0.2062374972885686
3755,0.4576,15,113,15,309317,296293,30958,76998,2.744571862610693,0.20626803217864884
3756,0.4577,10,106,10,309423,296187,30968,76988,2.7435899811034123,0.2063053527165539
3757,0.4578,45,216,45,309639,295971,31013,76943,2.741589165956501,0.2063290731911379
3758,0.4579,27,169,27,309808,295802,31040,76916,2.740023713364704,0.20636513396186928
3759,0.458,16,100,16,309908,295702,31056,76900,2.739097410055949,0.20638643914954832
3760,0.4581,26,173,26,310081,295529,31082,76874,2.737494905331802,0.2064269084835514
3761,0.4582,9,113,9,310194,295416,31091,76865,2.736448182592908,0.20647038124427516
3762,0.4583,29,183,29,310377,295233,31120,76836,2.7347530475378856,0.20651008280722125
3763,0.4584,52,374,52,310751,294859,31172,76784,2.7312886731631405,0.2066068781061395
3764,0.4585,27,137,27,310888,294722,31199,76757,2.7300196376301455,0.2066254081657375
3765,0.4586,15,138,15,311026,294584,31214,76742,2.7287413390640634,0.2066701496797962
3766,0.4587,44,234,44,311260,294350,31258,76698,2.7265737893215753,0.20670640995235118
3767,0.4588,39,174,39,311434,294176,31297,76659,2.724962021564341,0.20671996979788854
3768,0.4589,18,77,18,311511,294099,31315,76641,2.7242487680165994,0.2067243890597184
3769,0.459,19,171,19,311682,293928,31334,76622,2.7226647893586278,0.20677911213061664
3770,0.4591,12,91,12,311773,293837,31346,76610,2.7218218533476604,0.20680421220849407
3771,0.4592,32,220,32,311993,293617,31378,76578,2.719783986068398,0.20685854752225177
3772,0.4593,52,338,52,312331,293279,31430,76526,2.716653080884805,0.20693608793823773
3773,0.4594,33,208,33,312539,293071,31463,76493,2.7147263700025936,0.20698174064573388
3774,0.4595,13,134,13,312673,292937,31476,76480,2.7134851235688613,0.20702891312527577
3775,0.4596,11,75,11,312748,292862,31487,76469,2.712790396087295,0.2070473369416594
3776,0.4597,18,125,18,312873,292737,31505,76451,2.7116325169513504,0.2070787782918188
3777,0.4598,5,63,5,312936,292674,31510,76446,2.7110489458668345,0.20710338101430428
3778,0.4599,15,112,15,313048,292562,31525,76431,2.7100114861610285,0.20713401067228918
3779,0.46,25,192,25,313240,292370,31550,76406,2.708232983808218,0.2071881033472894
3780,0.4601,27,140,27,313380,292230,31577,76379,2.7069361591759606,0.20720872252169642
3781,0.4602,21,95,21,313475,292135,31598,76358,2.706056171032643,0.20721696205898077
3782,0.4603,37,243,37,313718,291892,31635,76321,2.703805253992367,0.20727405061744153
3783,0.4604,30,179,30,313897,291713,31665,76291,2.702147171069695,0.20731024662775405
3784,0.4605,26,158,26,314055,291555,31691,76265,2.7006836118418613,0.20734326572780165
3785,0.4606,39,215,39,314270,291340,31730,76226,2.6986920597280375,0.20738044324012558
3786,0.4607,35,282,35,314552,291058,31765,76191,2.696079884397347,0.20746414557970205
3787,0.4608,11,113,11,314665,290945,31776,76180,2.6950331616584533,0.2075042560435819
3788,0.4609,35,142,35,314807,290803,31811,76145,2.693717810960021,0.20750896584802206
3789,0.461,23,94,23,314901,290709,31834,76122,2.692847085849791,0.20751245123776343
3790,0.4611,27,259,27,315160,290450,31861,76095,2.690447960280114,0.20760070386992047
3791,0.4612,29,97,29,315257,290353,31890,76066,2.6895494460706213,0.20759294687229646
3792,0.4613,27,197,27,315454,290156,31917,76039,2.687724628552373,0.20764619942926582
3793,0.4614,25,171,25,315625,289985,31942,76014,2.6861406498944014,0.20768909204669958
3794,0.4615,19,112,19,315737,289873,31961,75995,2.6851031901885953,0.20771152437491117
3795,0.4616,17,134,17,315871,289739,31978,75978,2.683861943754863,0.20775080184951752
3796,0.4617,29,188,29,316059,289551,32007,75949,2.682120493534403,0.20779480164158687
3797,0.4618,13,130,13,316189,289421,32020,75936,2.680916299233021,0.20784055047528854
3798,0.4619,32,241,32,316430,289180,32052,75904,2.6786839082589204,0.20790831699006257
3799,0.462,21,88,21,316518,289092,32073,75883,2.6778687613472156,0.20791287074457154
3800,0.4621,21,107,21,316625,288985,32094,75862,2.676877616806847,0.20792825485751562
3801,0.4622,18,126,18,316751,288859,32112,75844,2.6757104746378153,0.20796099840143897
3802,0.4623,16,94,16,316845,288765,32128,75828,2.6748397495275853,0.20797985699122035
3803,0.4624,27,167,27,317012,288598,32155,75801,2.673292823001964,0.20801648742175471
3804,0.4625,15,148,15,317160,288450,32170,75786,2.671921894105006,0.20806839521628834
3805,0.4626,10,124,10,317284,288326,32180,75776,2.670773278002149,0.2081175055341635
3806,0.4627,25,220,25,317504,288106,32205,75751,2.668735410722887,0.20818893136589375
3807,0.4628,20,140,20,317644,287966,32225,75731,2.6674385860906296,0.20822552839314046
3808,0.4629,39,210,39,317854,287756,32264,75692,2.6654933491422432,0.20826087913539212
3809,0.463,14,93,14,317947,287663,32278,75678,2.6646318870651005,0.20828367841779485
3810,0.4631,10,95,10,318042,287568,32288,75668,2.6637518989217828,0.20831635630829543
3811,0.4632,40,212,40,318254,287356,32328,75628,2.6617881359072215,0.20835078130165516
3812,0.4633,26,193,26,318447,287163,32354,75602,2.6600003705213235,0.20840489021818534
3813,0.4634,44,237,44,318684,286926,32398,75558,2.657805031679573,0.20844506240275432
3814,0.4635,11,104,11,318788,286822,32409,75547,2.6568416762384675,0.20848085791003093
3815,0.4636,22,105,22,318893,286717,32431,75525,2.6558690577642743,0.20849321724151257
3816,0.4637,18,118,18,319011,286599,32449,75507,2.654776019859943,0.20852181405444814
3817,0.4638,20,133,20,319144,286466,32469,75487,2.6535440364592984,0.20855470185355557
3818,0.4639,30,141,30,319285,286325,32499,75457,2.652237948793953,0.20857035452288947
3819,0.464,21,143,21,319428,286182,32520,75436,2.650913335062433,0.2086068724455088
3820,0.4641,21,159,21,319587,286023,32541,75415,2.6494405128015117,0.2086526596539379
3821,0.4642,42,303,42,319890,285720,32583,75373,2.6466338137759826,0.20873569966739872
3822,0.4643,21,145,21,320035,285575,32604,75352,2.6452906739782875,0.2087735192989164
3823,0.4644,28,182,28,320217,285393,32632,75324,2.6436048019563527,0.2088174386014521
3824,0.4645,16,156,16,320373,285237,32648,75308,2.642159768794694,0.2088726788611685
3825,0.4646,39,193,39,320566,285044,32687,75269,2.640372003408796,0.20889892954181502
3826,0.4647,32,208,32,320774,284836,32719,75237,2.638445292526585,0.20894929639267593
3827,0.4648,30,140,30,320914,284696,32749,75207,2.637148467894327,0.20896463769404533
3828,0.4649,16,77,16,320991,284619,32765,75191,2.6364352143465855,0.20897418081765376
3829,0.465,30,125,30,321116,284494,32795,75161,2.6352773352106413,0.20898082884987002
3830,0.4651,35,252,35,321368,284242,32830,75126,2.6329430508725777,0.2090503328064825
3831,0.4652,38,144,38,321512,284098,32868,75088,2.63160917410797,0.2090504641049484
3832,0.4653,15,127,15,321639,283971,32883,75073,2.6304327689058504,0.2090913648466483
3833,0.4654,31,312,31,321951,283659,32914,75042,2.6275427025825335,0.20920488094541137
3834,0.4655,45,242,45,322193,283417,32959,74997,2.6253010485753454,0.2092468486164045
3835,0.4656,27,112,27,322305,283305,32986,74970,2.6242635888695394,0.2092526690391459
3836,0.4657,23,140,23,322445,283165,33009,74947,2.622966764237282,0.2092836877848271
3837,0.4658,18,104,18,322549,283061,33027,74929,2.6220034087961763,0.20930472918237938
3838,0.4659,31,149,31,322698,282912,33058,74898,2.6206232168661305,0.20932338391883962
3839,0.466,36,240,36,322938,282672,33094,74862,2.6184000889251178,0.20938428233398781
3840,0.4661,36,193,36,323131,282479,33130,74826,2.61661232353922,0.20941772435314368
3841,0.4662,33,217,33,323348,282262,33163,74793,2.6146022453592206,0.20947193009480333
3842,0.4663,32,214,32,323562,282048,33195,74761,2.612619956278484,0.20952666552693458
3843,0.4664,25,188,25,323750,281860,33220,74736,2.6108785060580235,0.20958171151667432
3844,0.4665,29,145,29,323895,281715,33249,74707,2.6095353662603284,0.20960266201300706
3845,0.4666,19,136,19,324031,281579,33268,74688,2.6082755937604207,0.20964052241717587
3846,0.4667,21,100,21,324131,281479,33289,74667,2.6073492904516655,0.2096527828474839
3847,0.4668,21,105,21,324236,281374,33310,74646,2.6063766719774724,0.20966799617998988
3848,0.4669,7,74,7,324310,281300,33317,74639,2.6056912075289933,0.20969604342317083
3849,0.467,15,94,15,324404,281206,33332,74624,2.6048204824187633,0.20971812382317398
3850,0.4671,31,244,31,324648,280962,33363,74593,2.6025603023454,0.20979314030178173
3851,0.4672,29,189,29,324837,280773,33392,74564,2.600809589091852,0.20984023617017086
3852,0.4673,23,160,23,324997,280613,33415,74541,2.5993275037978436,0.2098835997905134
3853,0.4674,29,135,29,325132,280478,33444,74512,2.5980769943310236,0.20989887039071523
3854,0.4675,32,173,32,325305,280305,33476,74480,2.596474489606877,0.2099299575799428
3855,0.4676,47,259,47,325564,280046,33523,74433,2.5940753640372005,0.20997858829437005
3856,0.4677,19,120,19,325684,279926,33542,74414,2.592963800066694,0.21000733758537
3857,0.4678,26,149,26,325833,279777,33568,74388,2.591583608136648,0.21003769429503197
3858,0.4679,18,111,18,325944,279666,33586,74370,2.5905554114639298,0.21006338338474054
3859,0.468,16,97,16,326041,279569,33602,74354,2.589656897254437,0.21008524453059
3860,0.4681,40,190,40,326231,279379,33642,74314,2.5878969209678018,0.21010876664225756
3861,0.4682,30,148,30,326379,279231,33672,74284,2.5865259920708437,0.21012969746686844
3862,0.4683,18,98,18,326477,279133,33690,74266,2.5856182148282634,0.21014773669421816
3863,0.4684,34,191,34,326668,278942,33724,74232,2.5838489755085403,0.21018534773227926
3864,0.4685,39,210,39,326878,278732,33763,74193,2.581903738560154,0.21022313522703123
3865,0.4686,16,127,16,327005,278605,33779,74177,2.580727333358035,0.21026299527753683
3866,0.4687,22,102,22,327107,278503,33801,74155,2.5797825039831044,0.21027454360882214
3867,0.4688,33,226,33,327333,278277,33834,74122,2.577689058505317,0.2103354436306573
3868,0.4689,25,139,25,327472,278138,33859,74097,2.576401496906147,0.2103624001022045
3869,0.469,4,64,4,327536,278074,33863,74093,2.5758086627885435,0.2103916607745757
3870,0.4691,26,165,26,327701,277909,33889,74067,2.574280262329097,0.2104319612700866
3871,0.4692,21,141,21,327842,277768,33910,74046,2.572974174663752,0.21046916836737595
3872,0.4693,19,132,19,327974,277636,33929,74027,2.571751454296195,0.21050551237974993
3873,0.4694,26,127,26,328101,277509,33955,74001,2.5705750490940753,0.2105231714602714
3874,0.4695,28,228,28,328329,277281,33983,73973,2.568463077550113,0.21059688999982917
3875,0.4696,19,189,19,328518,277092,34002,73954,2.5667123642965652,0.21066754784273287
3876,0.4697,31,163,31,328681,276929,34033,73923,2.565202489903294,0.21069567794967678
3877,0.4698,25,99,25,328780,276830,34058,73898,2.564285449627626,0.2106988891676741
3878,0.4699,27,174,27,328954,276656,34085,73871,2.5626736818703915,0.21074268173350413
3879,0.47,30,168,30,329122,276488,34115,73841,2.5611174923116824,0.21077615612752584
3880,0.4701,17,107,17,329229,276381,34132,73824,2.5601263477713143,0.21080224439970874
3881,0.4702,22,137,22,329366,276244,34154,73802,2.5588573122383194,0.21083514738062997
3882,0.4703,22,88,22,329454,276156,34176,73780,2.5580421653266145,0.21083855333546705
3883,0.4704,25,146,25,329600,276010,34201,73755,2.556689762495832,0.21087015567595385
3884,0.4705,25,204,25,329804,275806,34226,73730,2.5548001037459707,0.2109367847660899
3885,0.4706,30,165,30,329969,275641,34256,73700,2.553271703286524,0.21096865240552926
3886,0.4707,31,188,31,330157,275453,34287,73669,2.5515302530660637,0.2110121963095995
3887,0.4708,16,104,16,330261,275349,34303,73653,2.5505668976249583,0.21103890522117352
3888,0.4709,24,156,24,330417,275193,34327,73629,2.5491218644633,0.21107900304453275
3889,0.471,25,163,25,330580,275030,34352,73604,2.5476119900700285,0.21112111842218487
3890,0.4711,18,155,18,330735,274875,34370,73586,2.5461762199414575,0.21117427775274708
3891,0.4712,32,251,32,330986,274624,34402,73554,2.5438511986364816,0.21125401375158684
3892,0.4713,15,98,15,331084,274526,34417,73539,2.5429434213939013,0.21127950239179463
3893,0.4714,37,231,37,331315,274295,34454,73502,2.5408036607506763,0.21133592296655807
3894,0.4715,41,258,41,331573,274037,34495,73461,2.538413798214087,0.211399777840448
3895,0.4716,17,125,17,331698,273912,34512,73444,2.537255919078143,0.21143725745344832
3896,0.4717,45,238,45,331936,273674,34557,73399,2.535051317203305,0.21148000564722697
3897,0.4718,16,83,16,332019,273591,34573,73383,2.5342824854570383,0.2114942329972851
3898,0.4719,24,103,24,332122,273488,34597,73359,2.53332839304902,0.21150247803786684
3899,0.472,34,162,34,332284,273326,34631,73325,2.531827781688836,0.211523982333817
3900,0.4721,25,212,25,332496,273114,34656,73300,2.529864018674275,0.21159652900864284
3901,0.4722,43,226,43,332722,272888,34699,73257,2.5277705731964875,0.21163674182784672
3902,0.4723,18,146,18,332868,272742,34717,73239,2.5264181703657047,0.21168503472734052
3903,0.4724,29,192,29,333060,272550,34746,73210,2.524639668012894,0.21173646459972234
3904,0.4725,48,185,48,333245,272365,34794,73162,2.5229260068916965,0.21174032709455412
3905,0.4726,34,204,34,333449,272161,34828,73128,2.5210363481418354,0.21178780673580683
3906,0.4727,22,128,22,333577,272033,34850,73106,2.5198506799066287,0.21181610887207764
3907,0.4728,46,253,46,333830,271780,34896,73060,2.5175071325354774,0.21186637281057882
3908,0.4729,28,160,28,333990,271620,34924,73032,2.516025047241469,0.21190069983635668
3909,0.473,16,109,16,334099,271511,34940,73016,2.5150153766349255,0.21193114037506494
3910,0.4731,32,208,32,334307,271303,34972,72984,2.513088665752714,0.21198593034299873
3911,0.4732,50,193,50,334500,271110,35022,72934,2.511300900366816,0.21199032681866273
3912,0.4733,36,176,36,334676,270934,35058,72898,2.5096706065434065,0.21201633355824936
3913,0.4734,34,220,34,334896,270714,35092,72864,2.5076327392641447,0.21207411417494718
3914,0.4735,16,89,16,334985,270625,35108,72848,2.506808329319352,0.21209236242732327
3915,0.4736,38,236,38,335221,270389,35146,72810,2.5046222535106897,0.21215096780585024
3916,0.4737,28,150,28,335371,270239,35174,72782,2.503232798547556,0.212179429247772
3917,0.4738,15,100,15,335471,270139,35189,72767,2.502306495238801,0.21220684385808355
3918,0.4739,45,278,45,335749,269861,35234,72722,2.499731372040461,0.21227556533745107
3919,0.474,11,71,11,335820,269790,35245,72711,2.499073696691245,0.21229427067366227
3920,0.4741,34,232,34,336052,269558,35279,72677,2.496924673014932,0.21235992811956697
3921,0.4742,14,95,14,336147,269463,35293,72663,2.4960446848716145,0.21238666456217883
3922,0.4743,20,139,20,336286,269324,35313,72643,2.494757123272444,0.212426930083897
3923,0.4744,29,229,29,336515,269095,35342,72614,2.4926358886953945,0.21250245091583775
3924,0.4745,26,140,26,336655,268955,35368,72588,2.491339064063137,0.21252960827772785
3925,0.4746,28,161,28,336816,268794,35396,72560,2.489847715736041,0.21256525483808597
3926,0.4747,52,318,52,337134,268476,35448,72508,2.4869020712141983,0.21264340848837482
3927,0.4748,18,114,18,337248,268362,35466,72490,2.4858460854422173,0.21267294896318636
3928,0.4749,21,142,21,337390,268220,35487,72469,2.4845307347437844,0.21271306088544098
3929,0.475,21,149,21,337539,268071,35508,72448,2.483150542813739,0.21275758474563827
3930,0.4751,38,198,38,337737,267873,35546,72410,2.481316462262403,0.2127934689655375
3931,0.4752,32,216,32,337953,267657,35578,72378,2.4793156471154916,0.21285455908950549
3932,0.4753,18,91,18,338044,267566,35596,72360,2.478472711104524,0.21286985991068644
3933,0.4754,19,125,19,338169,267441,35615,72341,2.4773148319685796,0.21290415619426573
3934,0.4755,24,225,24,338394,267216,35639,72317,2.4752306495238803,0.2129896063121994
3935,0.4756,20,117,20,338511,267099,35659,72297,2.4741468746526363,0.21301665311317752
3936,0.4757,24,154,24,338665,266945,35683,72273,2.472720367557153,0.21305767972218456
3937,0.4758,23,148,23,338813,266797,35706,72250,2.471349438660195,0.21309729919450696
3938,0.4759,22,106,22,338919,266691,35728,72228,2.470367557152914,0.21311286767634743
3939,0.476,8,72,8,338991,266619,35736,72220,2.4697006187706103,0.2131395736618276
3940,0.4761,33,202,33,339193,266417,35769,72187,2.467829486086924,0.21319003910172354
3941,0.4762,15,85,15,339278,266332,35784,72172,2.4670421282744823,0.2132087065440881
3942,0.4763,13,106,13,339384,266226,35797,72159,2.4660602467672015,0.2132452679640055
3943,0.4764,36,198,36,339582,266028,35833,72123,2.4642261662158655,0.21328637206455103
3944,0.4765,14,92,14,339674,265936,35847,72109,2.463373967171811,0.21331183718144034
3945,0.4766,38,164,38,339838,265772,35885,72071,2.4618548297454517,0.21332690036496244
3946,0.4767,13,129,13,339967,265643,35898,72058,2.4606598984771573,0.21337810666832494
3947,0.4768,23,177,23,340144,265466,35921,72035,2.4590203416206604,0.21343640463287517
3948,0.4769,20,105,20,340249,265361,35941,72015,2.4580477231464672,0.21345620316797875
3949,0.477,20,149,20,340398,265212,35961,71995,2.4566675312164215,0.21350387150919167
3950,0.4771,17,158,17,340556,265054,35978,71978,2.455203971988588,0.21356429063115667
3951,0.4772,25,176,25,340732,264878,36003,71953,2.4535736781651782,0.21361751145233068
3952,0.4773,26,219,26,340951,264659,36029,71927,2.451545073919004,0.21369575680509587
3953,0.4774,36,187,36,341138,264472,36065,71891,2.4498128867316313,0.21373040435481905
3954,0.4775,28,143,28,341281,264329,36093,71863,2.448488273000111,0.21375583000190368
3955,0.4776,17,139,17,341420,264190,36110,71846,2.4472007114009413,0.21380447333023841
3956,0.4777,35,224,35,341644,263966,36145,71811,2.445125791989329,0.21386515455197944
3957,0.4778,30,166,30,341810,263800,36175,71781,2.443588128496795,0.21390066779704453
3958,0.4779,22,82,22,341892,263718,36197,71759,2.4428285597836155,0.21390140009598274
3959,0.478,21,136,21,342028,263582,36218,71738,2.441568787283708,0.21393892401288322
3960,0.4781,34,236,34,342264,263346,36252,71704,2.4393827114750453,0.21400984927622743
3961,0.4782,33,189,33,342453,263157,36285,71671,2.4376319982214976,0.2140531855161456
3962,0.4783,35,232,35,342685,262925,36320,71636,2.435482974545185,0.21411939825622234
3963,0.4784,12,43,12,342728,262882,36332,71624,2.4350846641224204,0.21411873030678075
3964,0.4785,32,161,32,342889,262721,36364,71592,2.4335933157953242,0.21414662307478322
3965,0.4786,12,57,12,342946,262664,36376,71580,2.4330653229093335,0.2141549287346968
3966,0.4787,20,127,20,343073,262537,36396,71560,2.431888917707214,0.21418929233126907
3967,0.4788,25,171,25,343244,262366,36421,71535,2.4303049390492424,0.21424014902620836
3968,0.4789,43,191,43,343435,262175,36464,71492,2.4285356997295193,0.21426152421426153
3969,0.479,33,123,33,343558,262052,36497,71459,2.42739634665975,0.214262797928704
3970,0.4791,25,173,25,343731,261879,36522,71434,2.4257938419356035,0.21431507321946638
3971,0.4792,16,148,16,343879,261731,36538,71418,2.4244229130386454,0.21437254801905453
3972,0.4793,39,152,39,344031,261579,36577,71379,2.423014932009337,0.21437839006721568
3973,0.4794,29,196,29,344227,261383,36606,71350,2.4211993775241765,0.21443619959547144
3974,0.4795,38,218,38,344445,261165,36644,71312,2.4191800363110896,0.21448701714705076
3975,0.4796,27,165,27,344610,261000,36671,71285,2.417651635851643,0.21452969589358534
3976,0.4797,34,247,34,344857,260753,36705,71251,2.4153636666790175,0.21460886013421526
3977,0.4798,47,317,47,345174,260436,36752,71204,2.4124272851902626,0.21470268966349054
3978,0.4799,14,114,14,345288,260322,36766,71190,2.4113712994182817,0.21474335770650838
3979,0.48,30,209,30,345497,260113,36796,71160,2.4094353255029826,0.2148077265578541
3980,0.4801,26,153,26,345650,259960,36822,71134,2.408018081440587,0.2148453309332093
3981,0.4802,10,126,10,345776,259834,36832,71124,2.406850939271555,0.21490340164008725
3982,0.4803,8,93,8,345869,259741,36840,71116,2.4059894771944124,0.21494482510571034
3983,0.4804,16,145,16,346014,259596,36856,71100,2.4046463373967173,0.2150010886131069
3984,0.4805,19,119,19,346133,259477,36875,71081,2.4035440364592984,0.21503336782047325
3985,0.4806,26,167,26,346300,259310,36901,71055,2.4019971099336765,0.2150802899822923
3986,0.4807,13,86,13,346386,259224,36914,71042,2.401200489088147,0.2151053998897858
3987,0.4808,38,175,38,346561,259049,36952,71004,2.399579458297825,0.21512908532871994
3988,0.4809,15,87,15,346648,258962,36967,70989,2.398773574419208,0.21515012835239172
3989,0.481,23,133,23,346781,258829,36990,70966,2.397541591018563,0.21518215861368425
3990,0.4811,17,106,17,346887,258723,37007,70949,2.3965597095112825,0.2152108762648936
3991,0.4812,37,202,37,347089,258521,37044,70912,2.3946885768275963,0.21525469518839946
3992,0.4813,16,135,16,347224,258386,37060,70896,2.3934380673607767,0.21530481471808358
3993,0.4814,26,71,26,347295,258315,37086,70870,2.3927803920115602,0.21528927502771997
3994,0.4815,21,145,21,347440,258170,37107,70849,2.3914372522138647,0.21533406885316653
3995,0.4816,18,138,18,347578,258032,37125,70831,2.3901589536477825,0.2153814810422577
3996,0.4817,23,123,23,347701,257909,37148,70808,2.3890196005780133,0.2154071739520621
3997,0.4818,17,91,17,347792,257818,37165,70791,2.388176664567046,0.21542623604344374
3998,0.4819,10,116,10,347908,257702,37175,70781,2.3871021527288896,0.21547842658524186
3999,0.482,34,210,34,348118,257492,37209,70747,2.3851569157805033,0.2155350217372098
4000,0.4821,38,198,38,348316,257294,37247,70709,2.3833228352291673,0.21557424779651405
4001,0.4822,21,115,21,348431,257179,37268,70688,2.3822575864240987,0.21559961813784248
4002,0.4823,21,175,21,348606,257004,37289,70667,2.3806365556337767,0.21566449273814284
4003,0.4824,16,109,16,348715,256895,37305,70651,2.3796268850272333,0.2156979477691683
4004,0.4825,22,159,22,348874,256736,37327,70629,2.378154062766312,0.21575000381836787
4005,0.4826,6,68,6,348942,256668,37333,70623,2.3775241765163586,0.21578045225808226
4006,0.4827,28,149,28,349091,256519,37361,70595,2.376143984586313,0.21581161307678667
4007,0.4828,23,161,23,349252,256358,37384,70572,2.3746526362592166,0.2158627229070443
4008,0.4829,24,180,24,349432,256178,37408,70548,2.372985290303457,0.21592404644870625
4009,0.483,16,131,16,349563,256047,37424,70532,2.3717718329689874,0.21597224561285325
4010,0.4831,27,151,27,349714,255896,37451,70505,2.3703731149727667,0.21600730389919148
4011,0.4832,32,202,32,349916,255694,37483,70473,2.368501982289081,0.2160641634500118
4012,0.4833,14,99,14,350015,255595,37497,70459,2.367584942013413,0.21609610677985855
4013,0.4834,32,228,32,350243,255367,37529,70427,2.3654729704694506,0.21617034076747885
4014,0.4835,18,150,18,350393,255217,37547,70409,2.3640835155063176,0.21622659124271404
4015,0.4836,33,210,33,350603,255007,37580,70376,2.362138278557931,0.21628665295974284
4016,0.4837,16,82,16,350685,254925,37596,70360,2.3613787098447516,0.21630262692715618
4017,0.4838,27,153,27,350838,254772,37623,70333,2.359961465782356,0.21633933652204673
4018,0.4839,35,164,35,351002,254608,37658,70298,2.3584423283559968,0.21636411762171212
4019,0.484,10,78,10,351080,254530,37668,70288,2.357719811775168,0.21639194872205358
4020,0.4841,13,96,13,351176,254434,37681,70275,2.3568305605987625,0.21642455244542036
4021,0.4842,28,154,28,351330,254280,37709,70247,2.355404053503279,0.21645964742532978
4022,0.4843,33,234,33,351564,254046,37742,70214,2.3532365037607916,0.21653611299574416
4023,0.4844,8,75,8,351639,253971,37750,70206,2.352541776279225,0.21656687550319734
4024,0.4845,15,68,15,351707,253903,37765,70191,2.351911890029271,0.21657605509512673
4025,0.4846,19,135,19,351842,253768,37784,70172,2.3506613805624514,0.2166203617953942
4026,0.4847,14,83,14,351925,253685,37798,70158,2.3498925488161846,0.2166420148034696
4027,0.4848,46,192,46,352117,253493,37844,70112,2.348114046463374,0.21665919871448217
4028,0.4849,23,107,23,352224,253386,37867,70089,2.3471229019230058,0.2166751680964526
4029,0.485,20,173,20,352397,253213,37887,70069,2.3455203971988587,0.2167426581127313
4030,0.4851,13,83,13,352480,253130,37900,70056,2.344751565452592,0.21676681539423118
4031,0.4852,25,115,25,352595,253015,37925,70031,2.3436863166475232,0.21678336831287184
4032,0.4853,12,85,12,352680,252930,37937,70019,2.342898958835081,0.2168113231500949
4033,0.4854,22,151,22,352831,252779,37959,69997,2.3415002408388603,0.21685936996554886
4034,0.4855,21,151,21,352982,252628,37980,69976,2.3401015228426396,0.21690989572354963
4035,0.4856,32,246,32,353228,252382,38012,69944,2.337822816703101,0.21699769798278762
4036,0.4857,32,198,32,353426,252184,38044,69912,2.3359887361517657,0.21705330087924096
4037,0.4858,21,85,21,353511,252099,38065,69891,2.3352013783393235,0.2170595360104351
4038,0.4859,19,103,19,353614,251996,38084,69872,2.3342472859313053,0.2170827792759765
4039,0.486,45,236,45,353850,251760,38129,69827,2.3320612101226423,0.21713253334245478
4040,0.4861,10,77,10,353927,251683,38139,69817,2.3313479565749007,0.2171601866251944
4041,0.4862,25,141,25,354068,251542,38164,69792,2.330041868909556,0.2171945701357466
4042,0.4863,38,195,38,354263,251347,38202,69754,2.3282355774574826,0.21723382985415804
4043,0.4864,16,126,16,354389,251221,38218,69738,2.3270684352884508,0.21728008873407506
4044,0.4865,23,160,23,354549,251061,38241,69715,2.3255863499944422,0.2173323440656408
4045,0.4866,28,139,28,354688,250922,38269,69687,2.324298788395272,0.21735821514679876
4046,0.4867,61,234,61,354922,250688,38330,69626,2.3221312386527844,0.2173679576915152
4047,0.4868,18,123,18,355045,250565,38348,69608,2.320991885583015,0.2174074640897265
4048,0.4869,24,97,24,355142,250468,38372,69584,2.3200933713735226,0.21741467011610613
4049,0.487,40,222,40,355364,250246,38412,69544,2.3180369780280854,0.21746771318677882
4050,0.4871,37,173,37,355537,250073,38449,69507,2.316434473303939,0.21749483697352776
4051,0.4872,16,98,16,355635,249975,38465,69491,2.3155266960613585,0.21752236544734024
4052,0.4873,26,137,26,355772,249838,38491,69465,2.3142576605283636,0.2175519804073247
4053,0.4874,24,140,24,355912,249698,38515,69441,2.312960835896106,0.21758857425761188
4054,0.4875,45,159,45,356071,249539,38560,69396,2.3114880136351847,0.21758665558812923
4055,0.4876,26,128,26,356199,249411,38586,69370,2.3103023453999776,0.2176102088894884
4056,0.4877,12,96,12,356295,249315,38598,69358,2.3094130942235727,0.2176463020086421
4057,0.4878,25,168,25,356463,249147,38623,69333,2.3078569046648636,0.21769969856819896
4058,0.4879,24,79,24,356542,249068,38647,69309,2.3071251250509466,0.21769474553752313
4059,0.488,26,128,26,356670,248940,38673,69283,2.30593945681574,0.21771839244806315
4060,0.4881,26,143,26,356813,248797,38699,69257,2.3046148430842197,0.2177523313651141
4061,0.4882,14,138,14,356951,248659,38713,69243,2.303336544518137,0.21781240759730985
4062,0.4883,20,125,20,357076,248534,38733,69223,2.302178665382193,0.21784885934849588
4063,0.4884,29,175,29,357251,248359,38762,69194,2.3005576345918706,0.21789748482930407
4064,0.4885,27,191,27,357442,248168,38789,69167,2.298788395272148,0.2179620905352388
4065,0.4886,33,117,33,357559,248051,38822,69134,2.297704620400904,0.2179611267872062
4066,0.4887,17,80,17,357639,247971,38839,69117,2.2969635777538997,0.21797419013018468
4067,0.4888,22,94,22,357733,247877,38861,69095,2.2960928526436697,0.2179845538407178
4068,0.4889,28,179,28,357912,247698,38889,69067,2.2944347697209975,0.21803860906350134
4069,0.489,29,199,29,358111,247499,38918,69038,2.2925914261365743,0.2181040447088334
4070,0.4891,25,204,25,358315,247295,38943,69013,2.290701767386713,0.21818291032790824
4071,0.4892,43,219,43,358534,247076,38986,68970,2.2886731631405386,0.21822772634363352
4072,0.4893,22,127,22,358661,246949,39008,68948,2.2874967579384196,0.21826101545757004
4073,0.4894,25,117,25,358778,246832,39033,68923,2.2864129830671756,0.21827999556618263
4074,0.4895,18,157,18,358935,246675,39051,68905,2.2849586868724296,0.21834400152100894
4075,0.4896,25,196,25,359131,246479,39076,68880,2.283143132387269,0.21841773978227988
4076,0.4897,29,116,29,359247,246363,39105,68851,2.2820686205491127,0.21842621203372947
4077,0.4898,29,183,29,359430,246180,39134,68822,2.2803734854940902,0.21848115250061903
4078,0.4899,24,123,24,359553,246057,39158,68798,2.279234132424321,0.21850693176223976
4079,0.49,29,166,29,359719,245891,39187,68769,2.277696468931787,0.21855018114790567
4080,0.4901,23,125,23,359844,245766,39210,68746,2.276538589795843,0.21857989520272678
4081,0.4902,27,151,27,359995,245615,39237,68719,2.275139871799622,0.2186177759962333
4082,0.4903,20,122,20,360117,245493,39257,68699,2.2740097817629406,0.21865292559963334
4083,0.4904,25,132,25,360249,245361,39282,68674,2.272787061395383,0.21868263091693602
4084,0.4905,39,209,39,360458,245152,39321,68635,2.2708510874800845,0.2187311775185078
4085,0.4906,18,127,18,360585,245025,39339,68617,2.269674682277965,0.21877490897265034
4086,0.4907,23,116,23,360701,244909,39362,68594,2.2686001704398087,0.21879854419255956
4087,0.4908,35,221,35,360922,244688,39397,68559,2.266553040127459,0.21886562361331474
4088,0.4909,24,98,24,361020,244590,39421,68535,2.265645262884879,0.21887425149700598
4089,0.491,23,138,23,361158,244452,39444,68512,2.2643669643187967,0.2189133574468629
4090,0.4911,35,232,35,361390,244220,39479,68477,2.262217940642484,0.2189883497443212
4091,0.4912,16,106,16,361496,244114,39495,68461,2.261236059135203,0.21902263456770374
4092,0.4913,28,125,28,361621,243989,39523,68433,2.260078179999259,0.21904027245200403
4093,0.4914,21,131,21,361752,243858,39544,68412,2.2588647226647893,0.21907964261696608
4094,0.4915,16,139,16,361891,243719,39560,68396,2.2575771610656195,0.21913717700206656
4095,0.4916,20,100,20,361991,243619,39580,68376,2.256650857756864,0.21915735829099825
4096,0.4917,42,226,42,362217,243393,39622,68334,2.254557412279077,0.21921104042960668
4097,0.4918,33,134,33,362351,243259,39655,68301,2.2533161658453444,0.2192226216459109
4098,0.4919,26,146,26,362497,243113,39681,68275,2.2519637630145617,0.21926021555101674
4099,0.492,20,84,20,362581,243029,39701,68255,2.2511856682352067,0.21926922039038305
4100,0.4921,37,195,37,362776,242834,39738,68218,2.249379376783134,0.21931381248151435
4101,0.4922,19,94,19,362870,242740,39757,68199,2.248508651672904,0.21933240925068903
4102,0.4923,26,192,26,363062,242548,39783,68173,2.2467301493200935,0.21940261520785528
4103,0.4924,12,82,12,363144,242466,39795,68161,2.245970580606914,0.21943037791305972
4104,0.4925,28,167,28,363311,242299,39823,68133,2.2444236540812925,0.21947801773013093
4105,0.4926,30,117,30,363428,242182,39853,68103,2.2433398792100485,0.21948531189068116
4106,0.4927,28,129,28,363557,242053,39881,68075,2.242144947941754,0.2195061394005056
4107,0.4928,44,296,44,363853,241757,39925,68031,2.239403090147838,0.2196050202073676
4108,0.4929,42,223,42,364076,241534,39967,67989,2.2373374337693135,0.21965734371920664
4109,0.493,45,227,45,364303,241307,40012,67944,2.235234725258439,0.2197050292480865
4110,0.4931,31,126,31,364429,241181,40043,67913,2.234067583089407,0.21971633224844223
4111,0.4932,46,219,46,364648,240962,40089,67867,2.2320389788432324,0.21975591670471362
4112,0.4933,34,238,34,364886,240724,40123,67833,2.2298343769683946,0.21983944619632678
4113,0.4934,26,115,26,365001,240609,40149,67807,2.228769128163326,0.21985564951234696
4114,0.4935,23,135,23,365136,240474,40172,67784,2.227518618696506,0.21989372538587806
4115,0.4936,24,114,24,365250,240360,40196,67760,2.226462632924525,0.21991431909645592
4116,0.4937,31,111,31,365361,240249,40227,67729,2.225434436251806,0.2199150588678412
4117,0.4938,42,178,42,365539,240071,40269,67687,2.2237856163622216,0.21993579370804334
4118,0.4939,6,79,6,365618,239992,40275,67681,2.223053836748305,0.2199770535601109
4119,0.494,10,59,10,365677,239933,40285,67671,2.222507317796139,0.21999388824592658
4120,0.4941,36,205,36,365882,239728,40321,67635,2.2206083960131906,0.22004925771807277
4121,0.4942,49,178,49,366060,239550,40370,67586,2.218959576123606,0.22005235465722026
4122,0.4943,45,180,45,366240,239370,40415,67541,2.217292230167846,0.2200670552700946
4123,0.4944,27,176,27,366416,239194,40442,67514,2.2156619363444365,0.2201246788476336
4124,0.4945,24,137,24,366553,239057,40466,67490,2.2143929008114416,0.2201619979970445
4125,0.4946,23,124,23,366677,238933,40489,67467,2.213244284708585,0.2201925587467363
4126,0.4947,12,114,12,366791,238819,40501,67455,2.2121882989366037,0.2202439645546145
4127,0.4948,26,141,26,366932,238678,40527,67429,2.2108822112712585,0.22027918342279007
4128,0.4949,15,159,15,367091,238519,40542,67414,2.2094093890103377,0.2203554373016314
4129,0.495,23,132,23,367223,238387,40565,67391,2.2081866686427802,0.2203919183198268
4130,0.4951,12,90,12,367313,238297,40577,67379,2.2073529956649005,0.22042620290765386
4131,0.4952,14,110,14,367423,238187,40591,67365,2.2063340620252694,0.22046983819448082
4132,0.4953,33,135,33,367558,238052,40624,67332,2.20508355255845,0.2204830639457208
4133,0.4954,24,146,24,367704,237906,40648,67308,2.203731149727667,0.22052723662741552
4134,0.4955,22,157,22,367861,237749,40670,67286,2.2022768535329207,0.22058452308751456
4135,0.4956,32,172,32,368033,237577,40702,67254,2.2006836118418613,0.2206271671844399
4136,0.4957,18,179,18,368212,237398,40720,67236,2.199025528919189,0.22071075454479802
4137,0.4958,12,121,12,368333,237277,40732,67224,2.1979047019155953,0.2207677478891695
4138,0.4959,23,150,23,368483,237127,40755,67201,2.1965152469524623,0.22081767040824374
4139,0.496,30,172,30,368655,236955,40785,67171,2.194922005261403,0.2208656938242702
4140,0.4961,28,126,28,368781,236829,40813,67143,2.193754863092371,0.22088547629386918
4141,0.4962,30,139,30,368920,236690,40843,67113,2.192467301493201,0.22090960260431924
4142,0.4963,9,109,9,369029,236581,40852,67104,2.1914576308866573,0.22096580338179364
4143,0.4964,20,103,20,369132,236478,40872,67084,2.1905035384786395,0.2209894519076828
4144,0.4965,27,138,27,369270,236340,40899,67057,2.189225239912557,0.2210206429200025
4145,0.4966,14,85,14,369355,236255,40913,67043,2.1884378821001147,0.22104662740934658
4146,0.4967,44,246,44,369601,236009,40957,66999,2.1861591759605767,0.22111297391488013
4147,0.4968,23,175,23,369776,235834,40980,66976,2.1845381451702544,0.22118159902248935
4148,0.4969,14,89,14,369865,235745,40994,66962,2.1837137352254623,0.22121060959938157
4149,0.497,17,89,17,369954,235656,41011,66945,2.18288932528067,0.22123191926001567
4150,0.4971,36,184,36,370138,235472,41047,66909,2.18118492719256,0.22127382342144514
4151,0.4972,16,172,16,370310,235300,41063,66893,2.1795916855015007,0.2213585357701866
4152,0.4973,23,125,23,370435,235175,41086,66870,2.178433806365556,0.22139085235643696
4153,0.4974,25,108,25,370543,235067,41111,66845,2.1774333987921004,0.22140557513447628
4154,0.4975,30,178,30,370721,234889,41141,66815,2.175784578902516,0.22145878079176942
4155,0.4976,26,122,26,370843,234767,41167,66789,2.1746544888658343,0.2214812505803234
4156,0.4977,35,122,35,370965,234645,41202,66754,2.173524398829153,0.22148049595386846
4157,0.4978,25,108,25,371073,234537,41227,66729,2.1725239912556966,0.22149528987672024
4158,0.4979,22,145,22,371218,234392,41249,66707,2.1711808514580015,0.22154507321512193
4159,0.498,13,134,13,371352,234258,41262,66694,2.169939605024269,0.22161009064568435
4160,0.4981,20,84,20,371436,234174,41282,66674,2.1691615102449147,0.22162022017763122
4161,0.4982,35,180,35,371616,233994,41317,66639,2.1674941642891548,0.2216622925626927
4162,0.4983,34,252,34,371868,233742,41351,66605,2.165159879951091,0.2217601640768844
4163,0.4984,35,145,35,372013,233597,41386,66570,2.1638167401533956,0.2217765443902894
4164,0.4985,27,117,27,372130,233480,41413,66543,2.162732965282152,0.22179299587031662
4165,0.4986,16,106,16,372236,233374,41429,66527,2.1617510837748712,0.22182987052393957
4166,0.4987,26,124,26,372360,233250,41455,66501,2.1606024676720144,0.2218541389353163
4167,0.4988,18,142,18,372502,233108,41473,66483,2.159287116973582,0.22191254076390812
4168,0.4989,13,112,13,372614,232996,41486,66470,2.158249657267776,0.22196175859696926
4169,0.499,12,120,12,372734,232876,41498,66458,2.1571380932972692,0.22201955006781723
4170,0.4991,28,126,28,372860,232750,41526,66430,2.1559709511282374,0.22204024333177352
4171,0.4992,21,109,21,372969,232641,41547,66409,2.154961280521694,0.2220665440561779
4172,0.4993,19,117,19,373086,232524,41566,66390,2.15387750565045,0.22210401653987435
4173,0.4994,31,165,31,373251,232359,41597,66359,2.1523491051910035,0.2221459704470437
4174,0.4995,19,90,19,373341,232269,41616,66340,2.151515432213124,0.2221634311089083
4175,0.4996,30,116,30,373457,232153,41646,66310,2.1504409203749675,0.22217159245869672
4176,0.4997,23,155,23,373612,231998,41669,66287,2.1490051502463965,0.22222706471998258
4177,0.4998,40,189,40,373801,231809,41709,66247,2.147254436992849,0.22226360147086455
4178,0.4999,40,209,40,374010,231600,41749,66207,2.14531846307755,0.2223151235531737
4179,0.5,11,106,11,374116,231494,41760,66196,2.1443365815702693,0.22236554805334408
4180,0.5001,25,119,25,374235,231375,41785,66171,2.1432342806328504,0.22238914319130487
4181,0.5002,18,105,18,374340,231270,41803,66153,2.142261662158657,0.22242059289295044
4182,0.5003,12,98,12,374438,231172,41815,66141,2.141353884916077,0.22246252266130306
4183,0.5004,39,201,39,374639,230971,41854,66102,2.1394920152654784,0.22251096531828876
4184,0.5005,11,67,11,374706,230904,41865,66091,2.138871392048612,0.2225323658647452
4185,0.5006,26,139,26,374845,230765,41891,66065,2.1375838304494423,0.2225684735370414
4186,0.5007,7,45,7,374890,230720,41898,66058,2.1371669939605025,0.22258388425018028
4187,0.5008,32,142,32,375032,230578,41930,66026,2.1358516432620696,0.2226065730738628
4188,0.5009,23,105,23,375137,230473,41953,66003,2.1348790247878764,0.22262510287510626
4189,0.501,14,47,14,375184,230426,41967,65989,2.1344436622327616,0.22262368638564176
4190,0.5011,16,162,16,375346,230264,41983,65973,2.1329430508725777,0.22270344352663576
4191,0.5012,34,171,34,375517,230093,42017,65939,2.131359072214606,0.22274281158793643
4192,0.5013,24,195,24,375712,229898,42041,65915,2.1295527807625327,0.22282658301021252
4193,0.5014,32,164,32,375876,229734,42073,65883,2.128033643336174,0.22286607333137134
4194,0.5015,21,128,21,376004,229606,42094,65862,2.1268479751009672,0.2229073876020415
4195,0.5016,16,95,16,376099,229511,42110,65846,2.1259679869576495,0.22293698811946222
4196,0.5017,19,154,19,376253,229357,42129,65827,2.1245414798621662,0.22300327931053174
4197,0.5018,21,102,21,376355,229255,42150,65806,2.1235966504872357,0.22302506939243072
4198,0.5019,25,166,25,376521,229089,42175,65781,2.1220589869947015,0.22308474921151694
4199,0.502,33,186,33,376707,228903,42208,65748,2.1203360628404164,0.22313856053432704
4200,0.5021,21,112,21,376819,228791,42229,65727,2.1192986031346104,0.2231680236861584
4201,0.5022,25,77,25,376896,228714,42254,65702,2.1185853495868687,0.22316042606380088
4202,0.5023,42,202,42,377098,228512,42296,65660,2.116714216903183,0.2232027521314061
4203,0.5024,27,112,27,377210,228400,42323,65633,2.115676757197377,0.22321644169191893
4204,0.5025,32,160,32,377370,228240,42355,65601,2.114194671903368,0.2232533921406475
4205,0.5026,21,154,21,377524,228086,42376,65580,2.1127681648078847,0.2233149223948295
4206,0.5027,27,194,27,377718,227892,42403,65553,2.110971136388899,0.22339109543526045
4207,0.5028,11,89,11,377807,227803,42414,65542,2.110146726444107,0.22342974995312687
4208,0.5029,33,155,33,377962,227648,42447,65509,2.108710956315536,0.2234604665759303
4209,0.503,27,99,27,378061,227549,42474,65482,2.107793916039868,0.22346441161515335
4210,0.5031,14,76,14,378137,227473,42488,65468,2.107089925525214,0.22348527519193284
4211,0.5032,38,212,38,378349,227261,42526,65430,2.1051261625106523,0.22354633384695805
4212,0.5033,16,95,16,378444,227166,42542,65414,2.1042461743673346,0.2235764577209652
4213,0.5034,29,137,29,378581,227029,42571,65385,2.10297713883434,0.22360420499702477
4214,0.5035,12,89,12,378670,226940,42583,65373,2.1021527288895476,0.22364041284513517
4215,0.5036,41,199,41,378869,226741,42624,65332,2.1003093853051245,0.22368380507612823
4216,0.5037,20,94,20,378963,226647,42644,65312,2.099438660194894,0.2237026431793505
4217,0.5038,29,154,29,379117,226493,42673,65283,2.0980121530994107,0.22374355670103094
4218,0.5039,23,145,23,379262,226348,42696,65260,2.0966690133017156,0.22379358590985157
4219,0.504,33,195,33,379457,226153,42729,65227,2.0948627218496423,0.22385544649598463
4220,0.5041,28,121,28,379578,226032,42757,65199,2.0937418948460484,0.22387383211265285
4221,0.5042,14,119,14,379697,225913,42771,65185,2.0926395939086295,0.22392802423925964
4222,0.5043,10,85,10,379782,225828,42781,65175,2.0918522360961873,0.22396676322924505
4223,0.5044,23,121,23,379903,225707,42804,65152,2.0907314090925935,0.22399856975372948
4224,0.5045,46,219,46,380122,225488,42850,65106,2.088702804846419,0.22404454324590323
4225,0.5046,29,133,29,380255,225355,42879,65077,2.0874708214457742,0.22406966174526222
4226,0.5047,32,122,32,380377,225233,42911,65045,2.0863407314090927,0.2240782973563274
4227,0.5048,37,144,37,380521,225089,42948,65008,2.085006854644485,0.22409056281174916
4228,0.5049,32,131,32,380652,224958,42980,64976,2.083793397310015,0.22410617588830561
4229,0.505,44,154,44,380806,224804,43024,64932,2.082366890214532,0.2241074633459425
4230,0.5051,36,157,36,380963,224647,43060,64896,2.080912594019786,0.22413251226933478
4231,0.5052,25,142,25,381105,224505,43085,64871,2.079597243321353,0.22417546721220835
4232,0.5053,11,95,11,381200,224410,43096,64860,2.0787172551780353,0.22421958723683755
4233,0.5054,41,220,41,381420,224190,43137,64819,2.0766793878987735,0.2242802127269393
4234,0.5055,17,100,17,381520,224090,43154,64802,2.0757530845900183,0.22431219971477231
4235,0.5056,16,155,16,381675,223935,43170,64786,2.0743173144614473,0.22438963566903689
4236,0.5057,24,93,24,381768,223842,43194,64762,2.0734558523843045,0.22439744424886696
4237,0.5058,23,149,23,381917,223693,43217,64739,2.072075660454259,0.2244515171686914
4238,0.5059,20,125,20,382042,223568,43237,64719,2.070917781318315,0.22449503446218524
4239,0.506,17,104,17,382146,223464,43254,64702,2.069954425877209,0.22453030544894262
4240,0.5061,23,110,23,382256,223354,43277,64679,2.0689354922375784,0.22455413095027305
4241,0.5062,25,174,25,382430,223180,43302,64654,2.0673237244803437,0.22462252548343836
4242,0.5063,24,156,24,382586,223024,43326,64630,2.0658786913186855,0.22467964985712002
4243,0.5064,19,102,19,382688,222922,43345,64611,2.064933861943755,0.22470812045921684
4244,0.5065,22,107,22,382795,222815,43367,64589,2.0639427174033864,0.22473243239481705
4245,0.5066,22,97,22,382892,222718,43389,64567,2.063044203193894,0.22474894268757506
4246,0.5067,21,84,21,382976,222634,43410,64546,2.0622661084145393,0.2247579915035866
4247,0.5068,14,91,14,383067,222543,43424,64532,2.061423172403572,0.22479143081076375
4248,0.5069,17,141,17,383208,222402,43441,64515,2.0601170847382266,0.2248559687993392
4249,0.507,25,191,25,383399,222211,43466,64490,2.058347845418504,0.2249381760091524
4250,0.5071,14,85,14,383484,222126,43480,64476,2.057560487606062,0.22496702744572614
4251,0.5072,47,192,47,383676,221934,43527,64429,2.0557819852532515,0.2249906587094003
4252,0.5073,13,66,13,383742,221868,43540,64416,2.0551706250694726,0.2250073353732657
4253,0.5074,18,115,18,383857,221753,43558,64398,2.054105376264404,0.22504901258426496
4254,0.5075,22,84,22,383941,221669,43580,64376,2.0533272814850494,0.22505549826076315
4255,0.5076,13,84,13,384025,221585,43593,64363,2.052549186705695,0.22508637934169848
4256,0.5077,21,77,21,384102,221508,43614,64342,2.051835933157953,0.2250900822109498
4257,0.5078,18,132,18,384234,221376,43632,64324,2.050613212790396,0.22514525726286314
4258,0.5079,19,85,19,384319,221291,43651,64305,2.049825854977954,0.22516071653664618
4259,0.508,39,125,39,384444,221166,43690,64266,2.04866797584201,0.22515345161019087
4260,0.5081,19,109,19,384553,221057,43709,64247,2.0476583052354664,0.22518786978100552
4261,0.5082,22,172,22,384725,220885,43731,64225,2.046065063544407,0.22526393321875768
4262,0.5083,24,159,24,384884,220726,43755,64201,2.044592241283486,0.22532438133276242
4263,0.5084,35,245,35,385129,220481,43790,64166,2.042322798177035,0.2254230678700285
4264,0.5085,28,156,28,385285,220325,43818,64138,2.0408777650153764,0.22547044782625508
4265,0.5086,39,141,39,385426,220184,43857,64099,2.0395716773500316,0.22547602213287463
4266,0.5087,10,73,10,385499,220111,43867,64089,2.03889547593464,0.2255066854327938
4267,0.5088,25,123,25,385622,219988,43892,64064,2.037756122864871,0.22553616943376564
4268,0.5089,28,153,28,385775,219835,43920,64036,2.036338878802475,0.22558133800212068
4269,0.509,33,175,33,385950,219660,43953,64003,2.034717848012153,0.22563041355411176
4270,0.5091,16,154,16,386104,219506,43969,63987,2.0332913409166697,0.225709276772266
4271,0.5092,27,152,27,386256,219354,43996,63960,2.0318833598873614,0.22575658103729432
4272,0.5093,28,128,28,386384,219226,44024,63932,2.0306976916521546,0.22578207219997315
4273,0.5094,19,145,19,386529,219081,44043,63913,2.029354551854459,0.2258457776489961
4274,0.5095,30,124,30,386653,218957,44073,63883,2.0282059357516027,0.2258626785461745
4275,0.5096,22,119,22,386772,218838,44095,63861,2.0271036348141838,0.22589750936508443
4276,0.5097,29,140,29,386912,218698,44124,63832,2.0258068101819258,0.2259299897356033
4277,0.5098,31,128,31,387040,218570,44155,63801,2.024621141946719,0.22594742377935412
4278,0.5099,28,103,28,387143,218467,44183,63773,2.023667049538701,0.225953089569161
4279,0.51,21,101,21,387244,218366,44204,63752,2.022731483196858,0.225976364499961
4280,0.5101,40,208,40,387452,218158,44244,63712,2.0208047723146465,0.22603327775215526
4281,0.5102,16,84,16,387536,218074,44260,63696,2.020026677535292,0.22605671292188664
4282,0.5103,21,161,21,387697,217913,44281,63675,2.018535329208196,0.22612824410131113
4283,0.5104,18,106,18,387803,217807,44299,63657,2.0175534477009154,0.22616391439047268
4284,0.5105,32,216,32,388019,217591,44331,63625,2.0155526325540034,0.22624957328174783
4285,0.5106,21,152,21,388171,217439,44352,63604,2.0141446515246955,0.22631412274989948
4286,0.5107,25,145,25,388316,217294,44377,63579,2.012801511727,0.2263620924759589
4287,0.5108,32,132,32,388448,217162,44409,63547,2.011578791359443,0.226380344057369
4288,0.5109,12,89,12,388537,217073,44421,63535,2.0107543814146505,0.22641906146652982
4289,0.511,25,141,25,388678,216932,44446,63510,2.0094482937493052,0.2264639390676147
4290,0.5111,19,104,19,388782,216828,44465,63491,2.0084849383081997,0.22649552830881958
4291,0.5112,21,132,21,388914,216696,44486,63470,2.0072622179406423,0.22654426304405245
4292,0.5113,13,101,13,389015,216595,44499,63457,2.0063266515987994,0.22659006184565725
4293,0.5114,33,162,33,389177,216433,44532,63424,2.0048260402386155,0.22663002890762068
4294,0.5115,22,103,22,389280,216330,44554,63402,2.0038719478305977,0.22665265325382866
4295,0.5116,32,154,32,389434,216176,44586,63370,2.0024454407351144,0.22668898857433123
4296,0.5117,22,173,22,389607,216003,44608,63348,2.0008429360109674,0.2267684740702557
4297,0.5118,24,174,24,389781,215829,44632,63324,1.999231168253733,0.22684334397266015
4298,0.5119,40,213,40,389994,215616,44672,63284,1.997258142206084,0.22690570096808893
4299,0.512,32,165,32,390159,215451,44704,63252,1.9957297417466375,0.22695127070752738
4300,0.5121,38,204,38,390363,215247,44742,63214,1.9938400829967764,0.22701204118350504
4301,0.5122,36,214,36,390577,215033,44778,63178,1.9918577939160398,0.2270866356829888
4302,0.5123,22,94,22,390671,214939,44800,63156,1.9909870688058098,0.22710224923137776
4303,0.5124,42,209,42,390880,214730,44842,63114,1.989051094890511,0.22715624595096529
4304,0.5125,20,104,20,390984,214626,44862,63094,1.9880877394494054,0.22718565461616017
4305,0.5126,21,112,21,391096,214514,44883,63073,1.9870502797435992,0.22721885390886462
4306,0.5127,20,97,20,391193,214417,44903,63053,1.9861517655341066,0.2272425847839406
4307,0.5128,25,140,25,391333,214277,44928,63028,1.984854940901849,0.22728764356935505
4308,0.5129,23,84,23,391417,214193,44951,63005,1.9840768461224942,0.22729240470710466
4309,0.513,25,88,25,391505,214105,44976,62980,1.9832616992107897,0.22729487341429525
4310,0.5131,53,251,53,391756,213854,45029,62927,1.9809366779058135,0.22735303362586304
4311,0.5132,20,94,20,391850,213760,45049,62907,1.9800659527955833,0.22737442485009055
4312,0.5133,13,73,13,391923,213687,45062,62894,1.979389751380192,0.2273981220691226
4313,0.5134,23,144,23,392067,213543,45085,62871,1.978055874615584,0.22745229981115284
4314,0.5135,24,165,24,392232,213378,45109,62847,1.9765274741561376,0.22752104262829215
4315,0.5136,22,112,22,392344,213266,45131,62825,1.9754900144503316,0.2275517854620397
4316,0.5137,22,93,22,392437,213173,45153,62803,1.974628552373189,0.22756688987448184
4317,0.5138,49,198,49,392635,212975,45202,62754,1.9727944718218533,0.22759303519034996
4318,0.5139,15,122,15,392757,212853,45217,62739,1.9716643817851718,0.22765174605939215
4319,0.514,34,206,34,392963,212647,45251,62705,1.9697561969691355,0.22772669165286616
4320,0.5141,28,137,28,393100,212510,45279,62677,1.9684871614361406,0.22776148582600195
4321,0.5142,35,148,35,393248,212362,45314,62642,1.9671162325391827,0.22778577766141583
4322,0.5143,14,86,14,393334,212276,45328,62628,1.966319611693653,0.2278177109099904
4323,0.5144,32,93,32,393427,212183,45360,62596,1.9654581496165104,0.22780489047561858
4324,0.5145,16,76,16,393503,212107,45376,62580,1.9647541591018562,0.22782294029204148
4325,0.5146,17,125,17,393628,211982,45393,62563,1.9635962799659121,0.22787885410406308
4326,0.5147,12,68,12,393696,211914,45405,62551,1.9629663937159583,0.22790155393219536
4327,0.5148,24,115,24,393811,211799,45429,62527,1.9619011449108896,0.2279295436816051
4328,0.5149,53,207,53,394018,211592,45482,62474,1.959983697061766,0.2279523910298979
4329,0.515,13,117,13,394135,211475,45495,62461,1.9588999221905221,0.22801311255183693
4330,0.5151,22,98,22,394233,211377,45517,62439,1.9579921449479418,0.2280326934875975
4331,0.5152,28,102,28,394335,211275,45545,62411,1.9570473155730113,0.22803870128541467
4332,0.5153,9,111,9,394446,211164,45554,62402,1.9560191189002927,0.22810583186507094
4333,0.5154,31,112,31,394558,211052,45585,62371,1.9549816591944866,0.22811175358327573
4334,0.5155,21,112,21,394670,210940,45606,62350,1.9539441994886806,0.22814592557356655
4335,0.5156,18,101,18,394771,210839,45624,62332,1.9530086331468377,0.2281794187523566
4336,0.5157,16,90,16,394861,210749,45640,62316,1.9521749601689578,0.2282094006921429
4337,0.5158,20,124,20,394985,210625,45660,62296,1.951026344066101,0.22825652844596056
4338,0.5159,34,139,34,395124,210486,45694,62262,1.949738782466931,0.22827665097452593
4339,0.516,27,119,27,395243,210367,45721,62235,1.948636481529512,0.22829986573832914
4340,0.5161,12,97,12,395340,210270,45733,62223,1.9477379673200192,0.22834715020202354
4341,0.5162,17,97,17,395437,210173,45750,62206,1.9468394531105264,0.2283803083203918
4342,0.5163,15,96,15,395533,210077,45765,62191,1.9459502019341213,0.22841832312280547
4343,0.5164,31,164,31,395697,209913,45796,62160,1.9444310645077625,0.22846809495980858
4344,0.5165,18,110,18,395807,209803,45814,62142,1.9434121308681314,0.22850944124731104
4345,0.5166,32,207,32,396014,209596,45846,62110,1.9414946830190078,0.22859267001832864
4346,0.5167,18,111,18,396125,209485,45864,62092,1.9404664863462893,0.22863497277015357
4347,0.5168,37,226,37,396351,209259,45901,62055,1.938373040868502,0.22872022822264976
4348,0.5169,21,185,21,396536,209074,45922,62034,1.9366593797473044,0.22881656019003496
4349,0.517,16,67,16,396603,209007,45938,62018,1.9360387565304382,0.228827598929988
4350,0.5171,28,116,28,396719,208891,45966,61990,1.9349642446922821,0.2288458769718068
4351,0.5172,41,208,41,396927,208683,46007,61949,1.9330375338100707,0.2289049336368205
4352,0.5173,46,195,46,397122,208488,46053,61903,1.9312312423579978,0.2289388330232885
4353,0.5174,11,103,11,397225,208385,46064,61892,1.9302771499499796,0.228994698032019
4354,0.5175,26,129,26,397354,208256,46090,61866,1.9290822186816852,0.22902984577339128
4355,0.5176,28,156,28,397510,208100,46118,61838,1.9276371855200267,0.22908223369810846
4356,0.5177,41,177,41,397687,207923,46159,61797,1.9259976286635296,0.22911537891146375
4357,0.5178,46,175,46,397862,207748,46205,61751,1.9243765978732077,0.22913257563107842
4358,0.5179,18,135,18,397997,207613,46223,61733,1.9231260884063879,0.22919590415302252
4359,0.518,11,85,11,398082,207528,46234,61722,1.9223387305939457,0.2292367688022284
4360,0.5181,41,149,41,398231,207379,46275,61681,1.9209585386639,0.22924626477365642
4361,0.5182,43,149,43,398380,207230,46318,61638,1.9195783467338545,0.22925004091226922
4362,0.5183,15,103,15,398483,207127,46333,61623,1.9186242543258365,0.22929488372093024
4363,0.5184,30,159,30,398642,206968,46363,61593,1.9171514320649152,0.2293445436977074
4364,0.5185,21,112,21,398754,206856,46384,61572,1.9161139723591092,0.22937994546023516
4365,0.5186,33,196,33,398950,206660,46417,61539,1.9142984178739486,0.22945275709454546
4366,0.5187,20,127,20,399077,206533,46437,61519,1.9131220126718294,0.22950397684031457
4367,0.5188,22,155,22,399232,206378,46459,61497,1.9116862425432584,0.22957349510032665
4368,0.5189,19,122,19,399354,206256,46478,61478,1.9105561525065768,0.2296234322125692
4369,0.519,30,154,30,399508,206102,46508,61448,1.9091296454110933,0.22966922070641002
4370,0.5191,30,121,30,399629,205981,46538,61418,1.9080088184074993,0.22968672283740776
4371,0.5192,22,132,22,399761,205849,46560,61396,1.9067860980399423,0.2297367584052087
4372,0.5193,43,129,43,399890,205720,46603,61353,1.9055911667716476,0.2297237084991744
4373,0.5194,25,122,25,400012,205598,46628,61328,1.9044610767349661,0.22975656174370424
4374,0.5195,18,122,18,400134,205476,46646,61310,1.9033309866982844,0.22980966017707077
4375,0.5196,25,130,25,400264,205346,46671,61285,1.9021267923969025,0.22984949236960445
4376,0.5197,18,104,18,400368,205242,46689,61267,1.9011634369557968,0.22988717078972942
4377,0.5198,19,104,19,400472,205138,46708,61248,1.900200081514691,0.22992199289752466
4378,0.5199,16,106,16,400578,205032,46724,61232,1.8992182000074105,0.22996725054832798
4379,0.52,20,110,20,400688,204922,46744,61212,1.8981992663677794,0.2300044338566286
4380,0.5201,29,130,29,400818,204792,46773,61183,1.8969950720663975,0.2300328978287433
4381,0.5202,32,181,32,400999,204611,46805,61151,1.8953184630775501,0.23009685357575574
4382,0.5203,18,129,18,401128,204482,46823,61133,1.8941235318092555,0.2301564294185193
4383,0.5204,53,211,53,401339,204271,46876,61080,1.8921690318277817,0.23018567859175207
4384,0.5205,27,149,27,401488,204122,46903,61053,1.8907888398977362,0.2302366361836523
4385,0.5206,32,120,32,401608,204002,46935,61021,1.8896772759272296,0.23024794074476554
4386,0.5207,18,99,18,401707,203903,46953,61003,1.8887602356515618,0.2302816848240508
4387,0.5208,45,174,45,401881,203729,46998,60958,1.8871484678943273,0.2303022060018059
4388,0.5209,24,99,24,401980,203630,47022,60934,1.8862314276186594,0.23031856186026822
4389,0.521,23,118,23,402098,203512,47045,60911,1.8851383897143281,0.2303543942849147
4390,0.5211,22,79,22,402177,203433,47067,60889,1.8844066101004113,0.23035918311756115
4391,0.5212,51,230,51,402407,203203,47118,60838,1.8822761124902738,0.2304111861415462
4392,0.5213,24,130,24,402537,203073,47142,60814,1.8810719181888917,0.23045470220207892
4393,0.5214,23,132,23,402669,202941,47165,60791,1.8798491978213345,0.23050293479744588
4394,0.5215,33,179,33,402848,202762,47198,60758,1.8781911148986625,0.23056314511232545
4395,0.5216,32,194,32,403042,202568,47230,60726,1.8763940864796769,0.23063951324375034
4396,0.5217,29,132,29,403174,202436,47259,60697,1.8751713661121197,0.2306704214218665
4397,0.5218,26,147,26,403321,202289,47285,60671,1.8738097002482492,0.23072330392455126
4398,0.5219,43,203,43,403524,202086,47328,60628,1.8719293045314758,0.23077567240421143
4399,0.522,30,114,30,403638,201972,47358,60598,1.8708733187594946,0.23078798034809764
4400,0.5221,23,89,23,403727,201883,47381,60575,1.8700489088147023,0.23079883257511677
4401,0.5222,45,230,45,403957,201653,47426,60530,1.8679184112045648,0.23086927832849574
4402,0.5223,16,102,16,404059,201551,47442,60514,1.8669735818296342,0.2309121782763818
4403,0.5224,29,146,29,404205,201405,47471,60485,1.8656211789988515,0.23095574477834205
4404,0.5225,18,107,18,404312,201298,47489,60467,1.8646300344584832,0.23099726854239488
4405,0.5226,11,83,11,404395,201215,47500,60456,1.8638612027122161,0.23103821210604156
4406,0.5227,38,204,38,404599,201011,47538,60418,1.861971543962355,0.23110672496165308
4407,0.5228,15,97,15,404696,200914,47553,60403,1.8610730297528624,0.23114837534488764
4408,0.5229,27,137,27,404833,200777,47580,60376,1.8598039942198674,0.2311901452405295
4409,0.523,27,104,27,404937,200673,47607,60349,1.8588406387787617,0.23120273386917578
4410,0.5231,15,84,15,405021,200589,47622,60334,1.8580625439994072,0.23123296911349325
4411,0.5232,36,169,36,405190,200420,47658,60298,1.8564970914076104,0.23127670509899584
4412,0.5233,24,96,24,405286,200324,47682,60274,1.8556078402312053,0.23129110737611186
4413,0.5234,29,142,29,405428,200182,47711,60245,1.8542924895327726,0.2313316207612882
4414,0.5235,65,348,65,405776,199834,47776,60180,1.8510689540183038,0.23144907581899435
4415,0.5236,19,73,19,405849,199761,47795,60161,1.8503927526029122,0.23145789890813398
4416,0.5237,37,151,37,406000,199610,47832,60124,1.8489940346066915,0.23148297873978763
4417,0.5238,57,295,57,406295,199315,47889,60067,1.8462614398458632,0.23157736465907425
4418,0.5239,13,59,13,406354,199256,47902,60054,1.8457149208936974,0.23159153137171726
4419,0.524,5,73,5,406427,199183,47907,60049,1.845038719478306,0.23164192692260216
4420,0.5241,23,142,23,406569,199041,47930,60026,1.8437233687798733,0.23170067974693806
4421,0.5242,19,118,19,406687,198923,47949,60007,1.8426303308755418,0.2317498937936894
4422,0.5243,42,198,42,406885,198725,47991,59965,1.8407962503242061,0.2318025435849859
4423,0.5244,33,166,33,407051,198559,48024,59932,1.8392585868316722,0.23185333338491476
4424,0.5245,24,157,24,407208,198402,48048,59908,1.837804290636926,0.23192288335720646
4425,0.5246,29,153,29,407361,198249,48077,59879,1.8363870465745304,0.23197405938139218
4426,0.5247,27,122,27,407483,198127,48104,59852,1.8352569565378487,0.23200338012008728
4427,0.5248,22,93,22,407576,198034,48126,59830,1.8343954944607062,0.23202153072937673
4428,0.5249,32,121,32,407697,197913,48158,59798,1.833274667457112,0.2320351090950716
4429,0.525,26,113,26,407810,197800,48184,59772,1.8322279447182186,0.2320593853369155
4430,0.5251,17,112,17,407922,197688,48201,59755,1.8311904850124125,0.23210963203505242
4431,0.5252,31,128,31,408050,197560,48232,59724,1.8300048167772056,0.2321325850033426
4432,0.5253,23,88,23,408138,197472,48255,59701,1.8291896698655008,0.2321433431969919
4433,0.5254,36,163,36,408301,197309,48291,59665,1.8276797954722295,0.2321830224069361
4434,0.5255,41,155,41,408456,197154,48332,59624,1.8262440253436585,0.23220057793113116
4435,0.5256,34,199,34,408655,196955,48366,59590,1.8244006817592353,0.23227893741838665
4436,0.5257,16,145,16,408800,196810,48382,59574,1.8230575419615398,0.2323623939091363
4437,0.5258,22,138,22,408938,196672,48404,59552,1.8217792433954574,0.2324216310728113
4438,0.5259,45,237,45,409175,196435,48449,59507,1.819583904553707,0.232501894960577
4439,0.526,25,75,25,409250,196360,48474,59482,1.8188891770721405,0.23249505554209238
4440,0.5261,10,71,10,409321,196289,48484,59472,1.8182315017229242,0.23252958817020578
4441,0.5262,25,142,25,409463,196147,48509,59447,1.8169161510244916,0.23258370697277714
4442,0.5263,26,188,26,409651,195959,48535,59421,1.8151747008040313,0.23267679536377164
4443,0.5264,17,123,17,409774,195836,48552,59404,1.8140353477342621,0.23273781538943739
4444,0.5265,19,153,19,409927,195683,48571,59385,1.8126181036718663,0.23282026753650006
4445,0.5266,20,87,20,410014,195596,48591,59365,1.8118122197932491,0.23283953232062943
4446,0.5267,37,166,37,410180,195430,48628,59328,1.8102745563007152,0.23287983105535448
4447,0.5268,30,114,30,410294,195316,48658,59298,1.809218570528734,0.23289371362140338
4448,0.5269,20,124,20,410418,195192,48678,59278,1.8080699544258771,0.2329469092623885
4449,0.527,12,69,12,410487,195123,48690,59266,1.807430805142836,0.2329739100354182
4450,0.5271,29,139,29,410626,194984,48719,59237,1.806143243543666,0.23301379508380504
4451,0.5272,31,184,31,410810,194800,48750,59206,1.804438845455556,0.23308898215002796
4452,0.5273,18,88,18,410898,194712,48768,59188,1.8036236985438512,0.2331153997636865
4453,0.5274,10,92,10,410990,194620,48778,59178,1.8027714994997963,0.23316968612833827
4454,0.5275,17,93,17,411083,194527,48795,59161,1.8019100374226538,0.2332037778688783
4455,0.5276,36,125,36,411208,194402,48831,59125,1.8007521582867094,0.23320987508233837
4456,0.5277,24,103,24,411311,194299,48855,59101,1.7997980658786914,0.23323204419889504
4457,0.5278,12,79,12,411390,194220,48867,59089,1.7990662862647746,0.23326845868089963
4458,0.5279,43,188,43,411578,194032,48910,59046,1.7973248360443144,0.2333114691913165
4459,0.528,47,192,47,411770,193840,48957,58999,1.7955463336915038,0.23334612144487205
4460,0.5281,22,88,22,411858,193752,48979,58977,1.7947311867797993,0.2333606353050105
4461,0.5282,18,79,18,411937,193673,48997,58959,1.7939994071658825,0.23337898603502327
4462,0.5283,20,94,20,412031,193579,49017,58939,1.7931286820556522,0.23340514339571833
4463,0.5284,26,119,26,412150,193460,49043,58913,1.7920263811182333,0.2334362233677929
4464,0.5285,22,90,22,412240,193370,49065,58891,1.7911927081403536,0.2334526541954563
4465,0.5286,32,157,32,412397,193213,49097,58859,1.7897384119456075,0.233500745818655
4466,0.5287,12,120,12,412517,193093,49109,58847,1.788626847975101,0.2335754544732873
4467,0.5288,9,88,9,412605,193005,49118,58838,1.7878117010633963,0.23362968198441092
4468,0.5289,25,143,25,412748,192862,49143,58813,1.786487087331876,0.23368630177808683
4469,0.529,13,122,13,412870,192740,49156,58800,1.7853569972951944,0.23376003816490418
4470,0.5291,22,104,22,412974,192636,49178,58778,1.7843936418540887,0.23378968553859372
4471,0.5292,30,112,30,413086,192524,49208,58748,1.7833561821482826,0.23380241332102264
4472,0.5293,16,115,16,413201,192409,49224,58732,1.782290933343214,0.23386065994799735
4473,0.5294,34,142,34,413343,192267,49258,58698,1.7809755826447813,0.2338891877353416
4474,0.5295,38,153,38,413496,192114,49296,58660,1.7795583385823854,0.23391579669343712
4475,0.5296,37,158,37,413654,191956,49333,58623,1.7780947793545518,0.2339501714030306
4476,0.5297,45,167,45,413821,191789,49378,58578,1.7765478528289302,0.23396853419180644
4477,0.5298,16,89,16,413910,191700,49394,58562,1.775723442884138,0.2340027651021729
4478,0.5299,27,161,27,414071,191539,49421,58535,1.7742320945570418,0.23407071506833976
4479,0.53,39,181,39,414252,191358,49460,58496,1.7725554855681944,0.2341207265042785
4480,0.5301,14,102,14,414354,191256,49474,58482,1.7716106561932639,0.234173413737597
4481,0.5302,42,229,42,414583,191027,49516,58440,1.769489421616214,0.23425944112848593
4482,0.5303,27,181,27,414764,190846,49543,58413,1.7678128126273667,0.23434660333227686
4483,0.5304,31,198,31,414962,190648,49574,58382,1.765978732076031,0.2344376179576758
4484,0.5305,23,140,23,415102,190508,49597,58359,1.7646819074437734,0.23449874832741988
4485,0.5306,26,170,26,415272,190338,49623,58333,1.7631071918188892,0.23457902208138465
4486,0.5307,7,61,7,415333,190277,49630,58326,1.7625421468005484,0.23461502878082727
4487,0.5308,35,200,35,415533,190077,49665,58291,1.7606895401830376,0.2346960961154416
4488,0.5309,26,133,26,415666,189944,49691,58265,1.759457556782393,0.2347416894633152
4489,0.531,21,85,21,415751,189859,49712,58244,1.7586701989699507,0.23475733868594897
4490,0.5311,32,135,32,415886,189724,49744,58212,1.7574196895031309,0.23478639648941663
4491,0.5312,25,127,25,416013,189597,49769,58187,1.7562432843010116,0.23482952894456463
4492,0.5313,17,164,17,416177,189433,49786,58170,1.7547241468746526,0.23493253312762769
4493,0.5314,25,119,25,416296,189314,49811,58145,1.7536218459372337,0.2349682169571525
4494,0.5315,32,155,32,416451,189159,49843,58113,1.7521860758086627,0.23501650004852956
4495,0.5316,19,102,19,416553,189057,49862,58094,1.7512412464337324,0.23505468316939845
4496,0.5317,34,171,34,416724,188886,49896,58060,1.7496572677757605,0.23511212977736023
4497,0.5318,22,111,22,416835,188775,49918,58038,1.7486290711030419,0.23514968822549864
4498,0.5319,31,176,31,417011,188599,49949,58007,1.7469987772796325,0.23522136525469778
4499,0.532,10,41,10,417052,188558,49959,57997,1.7466189929230427,0.23522946198616942
4500,0.5321,16,58,16,417110,188500,49975,57981,1.7460817370039645,0.23523517025653093
4501,0.5322,36,145,36,417255,188355,50011,57945,1.7447385972062692,0.23526187576126675
4502,0.5323,25,97,25,417352,188258,50036,57920,1.7438400829967764,0.23527691345286744
4503,0.5324,31,67,31,417419,188191,50067,57889,1.7432194597799104,0.23524463589076722
4504,0.5325,23,110,23,417529,188081,50090,57866,1.7422005261402793,0.2352783323236307
4505,0.5326,45,155,45,417684,187926,50135,57821,1.7407647560117085,0.23528669729437185
4506,0.5327,24,125,24,417809,187801,50159,57797,1.7396068768757642,0.23533172094235294
4507,0.5328,13,103,13,417912,187698,50172,57784,1.7386527844677462,0.23538996749252492
4508,0.5329,23,89,23,418001,187609,50195,57761,1.7378283745229537,0.2354036760810205
4509,0.533,24,94,24,418095,187515,50219,57737,1.7369576494127237,0.23541907915124036
4510,0.5331,25,148,25,418243,187367,50244,57712,1.7355867205157658,0.2354832523390417
4511,0.5332,46,229,46,418472,187138,50290,57666,1.7334654859387157,0.23555987647260665
4512,0.5333,49,145,49,418617,186993,50339,57617,1.7321223461410205,0.23554637995175995
4513,0.5334,32,173,32,418790,186820,50371,57585,1.7305198414168736,0.23561301937358073
4514,0.5335,18,83,18,418873,186737,50389,57567,1.7297510096706066,0.23563674765865478
4515,0.5336,28,156,28,419029,186581,50417,57539,1.7283059765089481,0.235699655906931
4516,0.5337,48,278,48,419307,186303,50465,57491,1.725730853310608,0.23581794465819503
4517,0.5338,25,101,25,419408,186202,50490,57466,1.724795286968765,0.23583728680007224
4518,0.5339,16,83,16,419491,186119,50506,57450,1.724026455222498,0.235867454396906
4519,0.534,14,105,14,419596,186014,50520,57436,1.7230538367483048,0.23592524132265352
4520,0.5341,35,187,35,419783,185827,50555,57401,1.7213216495609323,0.23599667801404445
4521,0.5342,33,162,33,419945,185665,50588,57368,1.7198210382007484,0.23605024832018698
4522,0.5343,15,105,15,420050,185560,50603,57353,1.7188484197265552,0.2361051075899602
4523,0.5344,53,191,53,420241,185369,50656,57300,1.7170791804068324,0.23612410320230437
4524,0.5345,25,131,25,420372,185238,50681,57275,1.7158657230723628,0.23617290619471945
4525,0.5346,51,271,51,420643,184967,50732,57224,1.7133554411056355,0.23627632736146265
4526,0.5347,22,127,22,420770,184840,50754,57202,1.7121790359035163,0.23633088472248617
4527,0.5348,28,157,28,420927,184683,50782,57174,1.7107247397087701,0.23639588682568624
4528,0.5349,21,147,21,421074,184536,50803,57153,1.7093630738448997,0.23647331901741495
4529,0.535,33,132,33,421206,184404,50836,57120,1.7081403534773427,0.2364982362001292
4530,0.5351,33,163,33,421369,184241,50869,57087,1.7066304790840714,0.2365535702446463
4531,0.5352,24,122,24,421491,184119,50893,57063,1.7055003890473897,0.23659725850187824
4532,0.5353,11,78,11,421569,184041,50904,57052,1.7047778724665605,0.23663897334223724
4533,0.5354,28,106,28,421675,183935,50932,57024,1.7037959909592797,0.236654368585527
4534,0.5355,25,119,25,421794,183816,50957,56999,1.7026936900218608,0.23669206652409527
4535,0.5356,28,150,28,421944,183666,50985,56971,1.7013042350587275,0.23675079060992282
4536,0.5357,30,147,30,422091,183519,51015,56941,1.699942569194857,0.23680029942609998
4537,0.5358,36,139,36,422230,183380,51051,56905,1.6986550075956872,0.23682293942609817
4538,0.5359,32,98,32,422328,183282,51083,56873,1.697747230353107,0.23681788844704463
4539,0.536,38,156,38,422484,183126,51121,56835,1.6963021971914483,0.23685098828559642
4540,0.5361,27,75,27,422559,183051,51148,56808,1.6956074697098817,0.23683914299651046
4541,0.5362,34,209,34,422768,182842,51182,56774,1.6936714957945829,0.23693743322649571
4542,0.5363,30,150,30,422918,182692,51212,56744,1.6922820408314498,0.23699026044537996
4543,0.5364,44,191,44,423109,182501,51256,56700,1.690512801511727,0.2370391428129481
4544,0.5365,23,120,23,423229,182381,51279,56677,1.6894012375412204,0.23708472420918772
4545,0.5366,18,90,18,423319,182291,51297,56659,1.6885675645633407,0.23711655157982842
4546,0.5367,31,106,31,423425,182185,51328,56628,1.6875856830560598,0.237122769698467
4547,0.5368,28,138,28,423563,182047,51356,56600,1.6863073844899774,0.23717038135824042
4548,0.5369,29,139,29,423702,181908,51385,56571,1.6850198228908073,0.23721585548413068
4549,0.537,22,76,22,423778,181832,51407,56549,1.6843158323761533,0.23722108725108126
4550,0.5371,28,135,28,423913,181697,51435,56521,1.6830653229093335,0.23726586571963496
4551,0.5372,44,249,44,424162,181448,51479,56477,1.6807588276705325,0.23737312178207418
4552,0.5373,39,181,39,424343,181267,51518,56438,1.6790822186816852,0.23742874571422562
4553,0.5374,35,106,35,424449,181161,51553,56403,1.6781003371744043,0.2374223367176845
4554,0.5375,33,145,33,424594,181016,51586,56370,1.676757197376709,0.23746134986898976
4555,0.5376,34,142,34,424736,180874,51620,56336,1.6754418466782763,0.23749420344842123
4556,0.5377,26,78,26,424814,180796,51646,56310,1.674719330097447,0.2374887181260702
4557,0.5378,58,202,58,425016,180594,51704,56252,1.6728481974137612,0.2375045388142506
4558,0.5379,31,104,31,425120,180490,51735,56221,1.6718848419726555,0.2375090299986059
4559,0.538,18,78,18,425198,180412,51753,56203,1.6711623253918264,0.23752931978107897
4560,0.5381,38,166,38,425364,180246,51791,56165,1.6696246618992923,0.23757354776215997
4561,0.5382,22,124,22,425488,180122,51813,56143,1.6684760457964356,0.23762724059848053
4562,0.5383,41,143,41,425631,179979,51854,56102,1.6671514320649152,0.23763877652161758
4563,0.5384,20,93,20,425724,179886,51874,56082,1.666289969987773,0.23766781936533768
4564,0.5385,24,92,24,425816,179794,51898,56058,1.6654377709437178,0.23768295371673762
4565,0.5386,47,220,47,426036,179574,51945,56011,1.6633999036644558,0.23775282806630305
4566,0.5387,25,114,25,426150,179460,51970,55986,1.6623439178924748,0.23778700848602227
4567,0.5388,47,222,47,426372,179238,52017,55939,1.6602875245470377,0.23785914438911968
4568,0.5389,34,121,34,426493,179117,52051,55905,1.6591666975434436,0.23787134821420974
4569,0.539,30,160,30,426653,178957,52081,55875,1.6576846122494349,0.23793605641479867
4570,0.5391,12,54,12,426707,178903,52093,55863,1.657184408462707,0.2379518328889192
4571,0.5392,39,179,39,426886,178724,52132,55824,1.6555263255400348,0.23800671930692224
4572,0.5393,43,228,43,427114,178496,52175,55781,1.6534143539960724,0.23809849024872268
4573,0.5394,15,71,15,427185,178425,52190,55766,1.6527566786468562,0.23812187487990571
4574,0.5395,39,135,39,427320,178290,52229,55727,1.6515061691800363,0.23813227244174567
4575,0.5396,10,51,10,427371,178239,52239,55717,1.651033754492571,0.23815161825300485
4576,0.5397,23,123,23,427494,178116,52262,55694,1.6498944014228019,0.23820195885548096
4577,0.5398,24,147,24,427641,177969,52286,55670,1.6485327355589314,0.2382735759012836
4578,0.5399,43,165,43,427806,177804,52329,55627,1.647004335099485,0.23830168229583903
4579,0.54,34,121,34,427927,177683,52363,55593,1.645883508095891,0.23831427150671308
4580,0.5401,31,174,31,428101,177509,52394,55562,1.6442717403386564,0.23839087659983438
4581,0.5402,10,42,10,428143,177467,52404,55552,1.6438826929489792,0.23840116042039491
4582,0.5403,25,102,25,428245,177365,52429,55527,1.6429378635740486,0.23842381876577984
4583,0.5404,42,167,42,428412,177198,52471,55485,1.6413909370484272,0.23845747218318486
4584,0.5405,13,92,13,428504,177106,52484,55472,1.640538738004372,0.23850923131164598
4585,0.5406,17,102,17,428606,177004,52501,55455,1.6395939086294415,0.23855819735953437
4586,0.5407,35,154,35,428760,176850,52536,55420,1.6381674015339582,0.2386016274163689
4587,0.5408,26,104,26,428864,176746,52562,55394,1.6372040460928527,0.23862324459377962
4588,0.5409,30,136,30,429000,176610,52592,55364,1.6359442735929453,0.23866467793804477
4589,0.541,41,169,41,429169,176441,52633,55323,1.6343788210011485,0.23870402650972541
4590,0.5411,23,100,23,429269,176341,52656,55300,1.6334525176923933,0.23873148535880953
4591,0.5412,25,81,25,429350,176260,52681,55275,1.6327022120123014,0.23873280497548965
4592,0.5413,15,40,15,429390,176220,52696,55260,1.6323316906887992,0.23872472783825816
4593,0.5414,23,160,23,429550,176060,52719,55237,1.6308496053947905,0.23881416533720715
4594,0.5415,8,60,8,429610,176000,52727,55229,1.6302938234095372,0.23884979825194938
4595,0.5416,37,159,37,429769,175841,52764,55192,1.6288210011486162,0.23889227945791294
4596,0.5417,25,135,25,429904,175706,52789,55167,1.6275704916817963,0.2389495523512927
4597,0.5418,29,148,29,430052,175558,52818,55138,1.6261995627848382,0.23900717827790685
4598,0.5419,23,108,23,430160,175450,52841,55115,1.6251991552113825,0.2390432199162926
4599,0.542,23,122,23,430282,175328,52864,55092,1.6240690651747007,0.23909382866070653
4600,0.5421,42,183,42,430465,175145,52906,55050,1.6223739301196785,0.23914507265579182
4601,0.5422,16,78,16,430543,175067,52922,55034,1.6216514135388491,0.2391732326239347
4602,0.5423,35,145,35,430688,174922,52957,54999,1.6203082737411538,0.23920824979014532
4603,0.5424,16,98,16,430786,174824,52973,54983,1.6194004964985735,0.23925728981275593
4604,0.5425,22,108,22,430894,174716,52995,54961,1.6184000889251176,0.23929692568258903
4605,0.5426,43,179,43,431073,174537,53038,54918,1.6167420060024453,0.23934104726416944
4606,0.5427,32,95,32,431168,174442,53070,54886,1.6158620178591279,0.2393340542803321
4607,0.5428,31,101,31,431269,174341,53101,54855,1.6149264515172848,0.23933663763765511
4608,0.5429,41,179,41,431448,174162,53142,54814,1.6132683685946125,0.23938753406470548
4609,0.543,36,191,36,431639,173971,53178,54778,1.6114991292748897,0.2394677135200591
4610,0.5431,17,119,17,431758,173852,53195,54761,1.6103968283374708,0.23953580942466088
4611,0.5432,31,111,31,431869,173741,53226,54730,1.6093686316647524,0.23954900184268463
4612,0.5433,21,106,21,431975,173635,53247,54709,1.6083867501574716,0.2395902673159794
4613,0.5434,58,230,58,432205,173405,53305,54651,1.606256252547334,0.23963850983968848
4614,0.5435,62,230,62,432435,173175,53367,54589,1.6041257549371966,0.23967352171545986
4615,0.5436,34,117,34,432552,173058,53401,54555,1.6030419800659528,0.23968314639322008
4616,0.5437,23,150,23,432702,172908,53424,54532,1.6016525251028197,0.23976433345058037
4617,0.5438,33,131,33,432833,172777,53457,54499,1.60043906776835,0.2397921469930833
4618,0.5439,27,69,27,432902,172708,53484,54472,1.599799918485309,0.23977462804824368
4619,0.544,25,109,25,433011,172599,53509,54447,1.5987902478787654,0.23980603049602284
4620,0.5441,20,124,20,433135,172475,53529,54427,1.5976416317759088,0.23987007606808225
4621,0.5442,13,83,13,433218,172392,53542,54414,1.5968728000296417,0.23991428798179942
4622,0.5443,12,127,12,433345,172265,53554,54402,1.5956963948275222,0.24000847057577857
4623,0.5444,26,123,26,433468,172142,53580,54376,1.5945570417577533,0.2400515632311781
4624,0.5445,27,121,27,433589,172021,53607,54349,1.5934362147541592,0.24008923443919247
4625,0.5446,22,113,22,433702,171908,53629,54327,1.5923894920152655,0.2401352575861383
4626,0.5447,9,59,9,433761,171849,53638,54318,1.5918429730630999,0.24016766371751846
4627,0.5448,29,133,29,433894,171716,53667,54289,1.5906109896624552,0.24021149974558084
4628,0.5449,16,83,16,433977,171633,53683,54273,1.589842157916188,0.24024594300284188
4629,0.545,16,101,16,434078,171532,53699,54257,1.588906591574345,0.24029957172404323
4630,0.5451,35,137,35,434215,171395,53734,54222,1.5876375560413503,0.24032763488566908
4631,0.5452,19,125,19,434340,171270,53753,54203,1.586479676905406,0.24039685461230392
4632,0.5453,21,142,21,434482,171128,53774,54182,1.5851643262069732,0.24047756424481825
4633,0.5454,50,278,50,434760,170850,53824,54132,1.582589203008633,0.24060591513987786
4634,0.5455,23,99,23,434859,170751,53847,54109,1.5816721627329653,0.24063417237392154
4635,0.5456,25,124,25,434983,170627,53872,54084,1.5805235466301086,0.24068247660328154
4636,0.5457,34,141,34,435124,170486,53906,54050,1.5792174589647634,0.2407186375458724
4637,0.5458,33,127,33,435251,170359,53939,54017,1.5780410537626441,0.24074321674332372
4638,0.5459,30,210,30,435461,170149,53969,53987,1.5760958168142576,0.24086715208623335
4639,0.546,14,105,14,435566,170044,53983,53973,1.5751231983400644,0.24093260779315856
4640,0.5461,25,131,25,435697,169913,54008,53948,1.5739097410055949,0.24098882788873452
4641,0.5462,23,119,23,435816,169794,54031,53925,1.572807440068176,0.24103898193716225
4642,0.5463,26,130,26,435946,169664,54057,53899,1.5716032457667939,0.241090878186462
4643,0.5464,33,85,33,436031,169579,54090,53866,1.5708158879543517,0.24107050952135872
4644,0.5465,14,57,14,436088,169522,54104,53852,1.5702878950683612,0.24108445924771907
4645,0.5466,10,59,10,436147,169463,54114,53842,1.5697413761161956,0.24111417120082398
4646,0.5467,26,135,26,436282,169328,54140,53816,1.5684908666493758,0.2411716201197433
4647,0.5468,46,200,46,436482,169128,54186,53770,1.566638260031865,0.24123141526617556
4648,0.5469,27,91,27,436573,169037,54213,53743,1.5657953240208975,0.24123799263847742
4649,0.547,26,107,26,436680,168930,54239,53717,1.5648041794805292,0.24126532133826192
4650,0.5471,44,146,44,436826,168784,54283,53673,1.5634517766497462,0.24127359444746624
4651,0.5472,26,109,26,436935,168675,54309,53647,1.5624421060432028,0.24130315488345733
4652,0.5473,38,124,38,437059,168551,54347,53609,1.5612934899403461,0.2413080662585524
4653,0.5474,17,91,17,437150,168460,54364,53592,1.5604505539293787,0.24134887323689946
4654,0.5475,19,120,19,437270,168340,54383,53573,1.559338989958872,0.24141442817680803
4655,0.5476,36,170,36,437440,168170,54419,53537,1.557764274333988,0.24147636294749378
4656,0.5477,27,155,27,437595,168015,54446,53510,1.5563285042054171,0.24155287213632773
4657,0.5478,24,77,24,437672,167938,54470,53486,1.5556152506576753,0.24155466435436088
4658,0.5479,57,228,57,437900,167710,54527,53429,1.5535032791137129,0.2416082192648063
4659,0.548,10,66,10,437966,167644,54537,53419,1.5528919189299344,0.24164604660209985
4660,0.5481,29,148,29,438114,167496,54566,53390,1.5515209900329765,0.24170839256449028
4661,0.5482,28,146,28,438260,167350,54594,53362,1.5501685872021935,0.24177208307658848
4662,0.5483,25,101,25,438361,167249,54619,53337,1.5492330208603504,0.24179685020808211
4663,0.5484,32,163,32,438524,167086,54651,53305,1.547723146467079,0.24186559342259892
4664,0.5485,10,88,10,438612,166998,54661,53295,1.5469079995553745,0.24192779616238375
4665,0.5486,29,152,29,438764,166846,54690,53266,1.545500018526066,0.24199498437159264
4666,0.5487,18,92,18,438856,166754,54708,53248,1.5446478194820112,0.24203416332578795
4667,0.5488,41,206,41,439062,166548,54749,53207,1.542739634665975,0.2421196332279129
4668,0.5489,17,63,17,439125,166485,54766,53190,1.542156063581459,0.2421304199385456
4669,0.549,20,89,20,439214,166396,54786,53170,1.5413316536366668,0.24215953289671444
4670,0.5491,50,168,50,439382,166228,54836,53120,1.5397754640779577,0.24217225595856812
4671,0.5492,24,103,24,439485,166125,54860,53096,1.5388213716699397,0.2422030736106486
4672,0.5493,16,81,16,439566,166044,54876,53080,1.5380710659898478,0.24223727204687756
4673,0.5494,18,95,18,439661,165949,54894,53062,1.53719107784653,0.24228006812443212
4674,0.5495,19,116,19,439777,165833,54913,53043,1.5361165660083738,0.2423426963212047
4675,0.5496,33,106,33,439883,165727,54946,53010,1.5351346845010931,0.24234583083794695
4676,0.5497,40,145,40,440028,165582,54986,52970,1.5337915447033976,0.24236794904645118
4677,0.5498,15,98,15,440126,165484,55001,52955,1.5328837674608173,0.2424246586003415
4678,0.5499,37,141,37,440267,165343,55038,52918,1.5315776797954723,0.24245284315567142
4679,0.55,26,86,26,440353,165257,55064,52892,1.5307810589499427,0.2424581364113519
4680,0.5501,31,120,31,440473,165137,55095,52861,1.529669494979436,0.24248387599886237
4681,0.5502,24,99,24,440572,165038,55119,52837,1.5287524547037683,0.24251061388410786
4682,0.5503,17,75,17,440647,164963,55136,52820,1.5280577272222016,0.24253500043621404
4683,0.5504,54,186,54,440833,164777,55190,52766,1.5263348030679165,0.2425543455776559
4684,0.5505,14,98,14,440931,164679,55204,52752,1.5254270258253362,0.24261489851953033
4685,0.5506,36,163,36,441094,164516,55240,52716,1.5239171514320649,0.2426714296236282
4686,0.5507,36,97,36,441191,164419,55276,52680,1.5230186372225722,0.24265427293538894
4687,0.5508,12,45,12,441236,164374,55288,52668,1.5226018007336322,0.24266271044314003
4688,0.5509,28,105,28,441341,164269,55316,52640,1.521629182259439,0.24268241520637687
4689,0.551,38,127,38,441468,164142,55354,52602,1.5204527770573197,0.24269183922046286
4690,0.5511,42,181,42,441649,163961,55396,52560,1.5187761680684724,0.2427478166090125
4691,0.5512,28,109,28,441758,163852,55424,52532,1.517766497461929,0.24277210884353742
4692,0.5513,9,93,9,441851,163759,55433,52523,1.5169050353847864,0.2428449894119714
4693,0.5514,14,65,14,441916,163694,55447,52509,1.5163029382340953,0.24286897036581362
4694,0.5515,27,130,27,442046,163564,55474,52482,1.5150987439327133,0.24292048915508735
4695,0.5516,17,81,17,442127,163483,55491,52465,1.5143484382526213,0.24295200696463964
4696,0.5517,10,75,10,442202,163408,55501,52455,1.5136537107710548,0.2430013480772527
4697,0.5518,19,113,19,442315,163295,55520,52436,1.5126069880321613,0.24306196142418104
4698,0.5519,44,125,44,442440,163170,55564,52392,1.511449108896217,0.243048403707518
4699,0.552,26,111,26,442551,163059,55590,52366,1.5104209122234984,0.24308227921550424
4700,0.5521,44,143,44,442694,162916,55634,52322,1.5090962984919782,0.24308904561462194
4701,0.5522,21,107,21,442801,162809,55655,52301,1.50810515395161,0.24313606991771652
4702,0.5523,25,103,25,442904,162706,55680,52276,1.507151061543592,0.2431645440083356
4703,0.5524,28,100,28,443004,162606,55708,52248,1.5062247582348365,0.24317908905582394
4704,0.5525,37,169,37,443173,162437,55745,52211,1.5046593056430397,0.2432400954120234
4705,0.5526,17,47,17,443220,162390,55762,52194,1.5042239430879247,0.24323341908063975
4706,0.5527,24,107,24,443327,162283,55786,52170,1.5032327985475564,0.24327008715196335
4707,0.5528,10,63,10,443390,162220,55796,52160,1.5026492274630405,0.2433062785707622
4708,0.5529,19,42,19,443432,162178,55815,52141,1.5022601800733633,0.243286876105245
4709,0.553,31,150,31,443582,162028,55846,52110,1.50087072511023,0.2433477477140909
4710,0.5531,21,150,21,443732,161878,55867,52089,1.499481270147097,0.24344408249870306
4711,0.5532,16,81,16,443813,161797,55883,52073,1.498730964467005,0.2434796839201384
4712,0.5533,43,192,43,444005,161605,55926,52030,1.4969524621141947,0.24354623540150255
4713,0.5534,23,91,23,444096,161514,55949,52007,1.4961095261032273,0.2435685482926738
4714,0.5535,44,163,44,444259,161351,55993,51963,1.494599651709956,0.24359863862662554
4715,0.5536,23,127,23,444386,161224,56016,51940,1.4934232465078365,0.24366215683698936
4716,0.5537,21,92,21,444478,161132,56037,51919,1.4925710474637814,0.24369282472271897
4717,0.5538,24,96,24,444574,161036,56061,51895,1.4916817962873763,0.24371744837529527
4718,0.5539,17,71,17,444645,160965,56078,51878,1.49102412093816,0.24373834234623643
4719,0.554,23,92,23,444737,160873,56101,51855,1.490171921894105,0.2437619871385055
4720,0.5541,13,97,13,444834,160776,56114,51842,1.4892734076846124,0.24382695726608283
4721,0.5542,11,91,11,444925,160685,56125,51831,1.4884304716736447,0.243892224585443
4722,0.5543,32,167,32,445092,160518,56157,51799,1.4868835451480233,0.24397010131077587
4723,0.5544,27,151,27,445243,160367,56184,51772,1.4854848271518026,0.2440475348710044
4724,0.5545,30,142,30,445385,160225,56214,51742,1.48416947645337,0.24410403506206155
4725,0.5546,21,78,21,445463,160147,56235,51721,1.4834469598725406,0.2441189797421036
4726,0.5547,28,109,28,445572,160038,56263,51693,1.4824372892659972,0.24414469303030734
4727,0.5548,33,121,33,445693,159917,56296,51660,1.481316462262403,0.24416642640740724
4728,0.5549,20,99,20,445792,159818,56316,51640,1.4803994219867354,0.24420925195547105
4729,0.555,13,64,13,445856,159754,56329,51627,1.4798065878691318,0.24423671001651048
4730,0.5551,26,105,26,445961,159649,56355,51601,1.4788339693949386,0.24426508875739644
4731,0.5552,27,99,27,446060,159550,56382,51574,1.4779169291192709,0.24428298061802542
4732,0.5553,25,155,25,446215,159395,56407,51549,1.4764811589906999,0.24437291413834952
4733,0.5554,18,73,18,446288,159322,56425,51531,1.4758049575753085,0.24439301314185713
4734,0.5555,46,185,46,446473,159137,56471,51485,1.4740912964541109,0.2444426508152045
4735,0.5556,20,118,20,446591,159019,56491,51465,1.4729982585497796,0.2445078960871135
4736,0.5557,24,104,24,446695,158915,56515,51441,1.472034903108674,0.24454258495122555
4737,0.5558,31,119,31,446814,158796,56546,51410,1.470932602171255,0.24456961266567082
4738,0.5559,39,169,39,446983,158627,56585,51371,1.4693671495794582,0.24462613929656474
4739,0.556,38,176,38,447159,158451,56623,51333,1.4677368557560488,0.24469454295847157
4740,0.5561,21,75,21,447234,158376,56644,51312,1.467042128274482,0.24470642096829576
4741,0.5562,23,121,23,447355,158255,56667,51289,1.465921301270888,0.24476482266254343
4742,0.5563,34,189,34,447544,158066,56701,51255,1.4641705880173403,0.24486315276536993
4743,0.5564,44,162,44,447706,157904,56745,51211,1.4626699766571567,0.24489395787007148
4744,0.5565,33,137,33,447843,157767,56778,51178,1.4614009411241617,0.24493527004714158
4745,0.5566,34,195,34,448038,157572,56812,51144,1.4595946496720886,0.24504110849192204
4746,0.5567,46,163,46,448201,157409,56858,51098,1.4580847752788173,0.24506611288829633
4747,0.5568,25,124,25,448325,157285,56883,51073,1.4569361591759606,0.24512137762888875
4748,0.5569,31,225,31,448550,157060,56914,51042,1.4548519767312609,0.245273952196519
4749,0.557,39,171,39,448721,156889,56953,51003,1.4532679980732892,0.24533411579089143
4750,0.5571,10,49,10,448770,156840,56963,50993,1.452814109451999,0.24535564611972113
4751,0.5572,22,110,22,448880,156730,56985,50971,1.451795175812368,0.24540565524479901
4752,0.5573,29,122,29,449002,156608,57014,50942,1.4506650857756864,0.2454444712117562
4753,0.5574,18,68,18,449070,156540,57032,50924,1.4500351995257328,0.2454594532063394
4754,0.5575,17,68,17,449138,156472,57049,50907,1.449405313275779,0.24547808601642404
4755,0.5576,17,104,17,449242,156368,57066,50890,1.4484419578346734,0.24553937604338555
4756,0.5577,28,125,28,449367,156243,57094,50862,1.447284078698729,0.24558557253567032
4757,0.5578,44,234,44,449601,156009,57138,50818,1.4451165289562415,0.24570293046845915
4758,0.5579,24,117,24,449718,155892,57162,50794,1.4440327540849975,0.24575442942434417
4759,0.558,12,128,12,449846,155764,57174,50782,1.4428470858497906,0.24586290705218208
4760,0.5581,34,141,34,449987,155623,57208,50748,1.4415409981844456,0.24590664385984465
4761,0.5582,27,137,27,450124,155486,57235,50721,1.4402719626514506,0.2459712812853104
4762,0.5583,16,98,16,450222,155388,57251,50705,1.4393641854088703,0.24602970503607594
4763,0.5584,18,104,18,450326,155284,57269,50687,1.4384008299677646,0.24608804152040822
4764,0.5585,51,205,51,450531,155079,57320,50636,1.436501908184816,0.2461463675473349
4765,0.5586,37,190,37,450721,154889,57357,50599,1.4347419318981807,0.24623822315658336
4766,0.5587,31,142,31,450863,154747,57388,50568,1.433426581199748,0.24629471787253732
4767,0.5588,23,112,23,450975,154635,57411,50545,1.432389121493942,0.24634467297007506
4768,0.5589,17,104,17,451079,154531,57428,50528,1.4314257660528364,0.2464071316060256
4769,0.559,22,138,22,451217,154393,57450,50506,1.4301474674867538,0.24649217419313907
4770,0.5591,49,171,49,451388,154222,57499,50457,1.4285634888287821,0.24651771798767827
4771,0.5592,25,124,25,451512,154098,57524,50432,1.4274148727259255,0.24657507456118907
4772,0.5593,19,73,19,451585,154025,57543,50413,1.426738671310534,0.24659309913029867
4773,0.5594,27,131,27,451716,153894,57570,50386,1.4255252139760644,0.24665165459173682
4774,0.5595,32,149,32,451865,153745,57602,50354,1.4241450220460188,0.2467136046722424
4775,0.5596,24,107,24,451972,153638,57626,50330,1.4231538775056505,0.24675439284593662
4776,0.5597,19,121,19,452093,153517,57645,50311,1.4220330505020564,0.24683066114567184
4777,0.5598,41,146,41,452239,153371,57686,50270,1.4206806476712734,0.24685598676101572
4778,0.5599,35,127,35,452366,153244,57721,50235,1.4195042424691542,0.24688051346822032
4779,0.56,38,137,38,452503,153107,57759,50197,1.4182352069361592,0.24690611104552787
4780,0.5601,12,49,12,452552,153058,57771,50185,1.417781318314869,0.246921173176936
4781,0.5602,19,107,19,452659,152951,57790,50166,1.4167901737745008,0.24698080416705642
4782,0.5603,28,132,28,452791,152819,57818,50138,1.4155674534069436,0.24703754982582518
4783,0.5604,20,106,20,452897,152713,57838,50118,1.4145855718996627,0.24709240697920928
4784,0.5605,39,146,39,453043,152567,57877,50079,1.41323316906888,0.24712552924804831
4785,0.5606,18,93,18,453136,152474,57895,50061,1.4123717069917374,0.2471720937121979
4786,0.5607,38,185,38,453321,152289,57933,50023,1.4106580458705398,0.24725671240460279
4787,0.5608,29,117,29,453438,152172,57962,49994,1.409574270999296,0.24729182948665948
4788,0.5609,25,111,25,453549,152061,57987,49969,1.4085460743265774,0.2473345542741177
4789,0.561,37,188,37,453737,151873,58024,49932,1.4068046241061174,0.24742697158147717
4790,0.5611,25,81,25,453818,151792,58049,49907,1.4060543184260255,0.2474330561876856
4791,0.5612,24,126,24,453944,151666,58073,49883,1.4048871762569937,0.24749812700633592
4792,0.5613,15,75,15,454019,151591,58088,49868,1.404192448775427,0.24753423773571795
4793,0.5614,31,129,31,454148,151462,58119,49837,1.4029975175071325,0.2475769874664057
4794,0.5615,29,109,29,454257,151353,58148,49808,1.401987846900589,0.24760266652084648
4795,0.5616,35,128,35,454385,151225,58183,49773,1.4008021786653821,0.2476293296450711
4796,0.5617,36,123,36,454508,151102,58219,49737,1.399662825595613,0.24764612450769025
4797,0.5618,7,62,7,454570,151040,58226,49730,1.3990885175441847,0.2476963689794292
4798,0.5619,33,161,33,454731,150879,58259,49697,1.3975971692170885,0.24777141831525207
4799,0.562,29,110,29,454841,150769,58288,49668,1.3965782355774574,0.24779856014608082
4800,0.5621,35,130,35,454971,150639,58323,49633,1.3953740412760753,0.2478279539825837
4801,0.5622,30,160,30,455131,150479,58353,49603,1.3938919559820668,0.24791335552423507
4802,0.5623,27,121,27,455252,150358,58380,49576,1.3927711289784728,0.247961827403043
4803,0.5624,26,132,26,455384,150226,58406,49550,1.3915484086109156,0.2480277911260612
4804,0.5625,32,182,32,455566,150044,58438,49518,1.3898625365889807,0.2481334121726581
4805,0.5626,28,125,28,455691,149919,58466,49490,1.3887046574530364,0.2481833818934953
4806,0.5627,18,87,18,455778,149832,58484,49472,1.3878987735744193,0.24822381888973627
4807,0.5628,38,129,38,455907,149703,58522,49434,1.3867038423061246,0.24824116060802362
4808,0.5629,27,127,27,456034,149576,58549,49407,1.3855274371040054,0.24829759326173592
4809,0.563,10,82,10,456116,149494,58559,49397,1.384767868390826,0.2483621682227954
4810,0.5631,39,152,39,456268,149342,58598,49358,1.3833598873615176,0.24840463009562155
4811,0.5632,16,78,16,456346,149264,58614,49342,1.3826373707806885,0.2484416382183821
4812,0.5633,15,42,15,456388,149222,58629,49327,1.3822483233910112,0.24843741343446707
4813,0.5634,12,49,12,456437,149173,58641,49315,1.381794434769721,0.24845330700092702
4814,0.5635,25,114,25,456551,149059,58666,49290,1.38073844899774,0.24850137888267648
4815,0.5636,25,158,25,456709,148901,58691,49265,1.3792748897699063,0.24860470514619057
4816,0.5637,28,93,28,456802,148808,58719,49237,1.3784134276927638,0.2486152137140549
4817,0.5638,40,142,40,456944,148666,58759,49197,1.377098076994331,0.2486417369594113
4818,0.5639,15,76,15,457020,148590,58774,49182,1.3763940864796769,0.2486802985255749
4819,0.564,21,109,21,457129,148481,58795,49161,1.3753844158731334,0.24873761649851753
4820,0.5641,23,101,23,457230,148380,58818,49138,1.3744488495312905,0.24877732662339636
4821,0.5642,23,104,23,457334,148276,58841,49115,1.3734854940901848,0.24882086822600827
4822,0.5643,35,147,35,457481,148129,58876,49080,1.3721238282263144,0.248873023036474
4823,0.5644,28,127,28,457608,148002,58904,49052,1.3709474230241951,0.24892669014584834
4824,0.5645,37,192,37,457800,147810,58941,49015,1.3691689206713846,0.24902832465388036
4825,0.5646,21,106,21,457906,147704,58962,48994,1.368187039164104,0.24908234959175996
4826,0.5647,42,208,42,458114,147496,59004,48952,1.3662603282818926,0.24918553510343705
4827,0.5648,24,71,24,458185,147425,59028,48928,1.3656026529326764,0.2491838678298778
4828,0.5649,25,126,25,458311,147299,59053,48903,1.3644355107636446,0.24924822376938055
4829,0.565,27,95,27,458406,147204,59080,48876,1.3635555226203269,0.249265605875153
4830,0.5651,17,90,17,458496,147114,59097,48859,1.362721849642447,0.2493149566521919
4831,0.5652,14,68,14,458564,147046,59111,48845,1.3620919633924933,0.24934785161135528
4832,0.5653,26,112,26,458676,146934,59137,48819,1.3610545036866872,0.24939081393388607
4833,0.5654,40,154,40,458830,146780,59177,48779,1.359627996591204,0.24943367474777434
4834,0.5655,10,60,10,458890,146720,59187,48769,1.3590722146059506,0.2494718372900777
4835,0.5656,10,65,10,458955,146655,59197,48759,1.3584701174552596,0.2495164113113697
4836,0.5657,23,140,23,459095,146515,59220,48736,1.357173292823002,0.24960691622578118
4837,0.5658,36,173,36,459268,146342,59256,48700,1.355570788098855,0.24968981039981133
4838,0.5659,30,135,30,459403,146207,59286,48670,1.3543202786320352,0.24974727648722014
4839,0.566,20,72,20,459475,146135,59306,48650,1.3536533402497313,0.24976255871858716
4840,0.5661,20,134,20,459609,146001,59326,48630,1.3524120938159991,0.24985742250720594
4841,0.5662,19,103,19,459712,145898,59345,48611,1.3514580014079811,0.24991645630793433
4842,0.5663,46,116,46,459828,145782,59391,48565,1.3503834895698248,0.24988808677262833
4843,0.5664,49,226,49,460054,145556,59440,48516,1.3482900440920376,0.24998969454635392
4844,0.5665,20,109,20,460163,145447,59460,48496,1.3472803734854941,0.2500528505798095
4845,0.5666,24,126,24,460289,145321,59484,48472,1.3461132313164623,0.25012255344620293
4846,0.5667,27,76,27,460365,145245,59511,48445,1.3454092408018081,0.2501161650059373
4847,0.5668,28,132,28,460497,145113,59539,48417,1.344186520434251,0.2501782669353589
4848,0.5669,20,98,20,460595,145015,59559,48397,1.3432787431916706,0.25022749364051866
4849,0.567,11,105,11,460700,144910,59570,48386,1.3423061247174775,0.25032075159341116
4850,0.5671,24,96,24,460796,144814,59594,48362,1.3414168735410723,0.25035201060173107
4851,0.5672,26,111,26,460907,144703,59620,48336,1.3403886768683537,0.25039499790197833
4852,0.5673,38,155,38,461062,144548,59658,48298,1.338952906739783,0.25044854443441916
4853,0.5674,31,145,31,461207,144403,59689,48267,1.3376097669420874,0.2505164270514351
4854,0.5675,26,100,26,461307,144303,59715,48241,1.336683463633332,0.25054532989862055
4855,0.5676,36,181,36,461488,144122,59751,48205,1.3350068546444849,0.2506408356600997
4856,0.5677,21,68,21,461556,144054,59772,48184,1.334376968394531,0.2506476347028163
4857,0.5678,33,118,33,461674,143936,59805,48151,1.3332839304901998,0.25067287218812306
4858,0.5679,26,130,26,461804,143806,59831,48125,1.3320797361888177,0.2507411517680833
4859,0.568,35,149,35,461953,143657,59866,48090,1.3306995442587721,0.25079923023567513
4860,0.5681,27,132,27,462085,143525,59893,48063,1.329476823891215,0.25086644257469154
4861,0.5682,25,97,25,462182,143428,59918,48038,1.328578309681722,0.25089572038899854
4862,0.5683,27,122,27,462304,143306,59945,48011,1.3274482196450406,0.2509499939890339
4863,0.5684,26,102,26,462406,143204,59971,47985,1.32650339027011,0.2509820125634843
4864,0.5685,30,118,30,462524,143086,60001,47955,1.3254103523657788,0.2510194146806183
4865,0.5686,28,105,28,462629,142981,60029,47927,1.3244377338915854,0.2510476250340478
4866,0.5687,30,136,30,462765,142845,60059,47897,1.323177961391678,0.25110882763104087
4867,0.5688,14,101,14,462866,142744,60073,47883,1.3222423950498352,0.2511868727934658
4868,0.5689,18,92,18,462958,142652,60091,47865,1.3213901960057801,0.2512374223822546
4869,0.569,30,145,30,463103,142507,60121,47835,1.3200470562080848,0.2513107984575133
4870,0.5691,23,107,23,463210,142400,60144,47812,1.3190559116677165,0.2513616385927281
4871,0.5692,22,102,22,463312,142298,60166,47790,1.318111082292786,0.2514098733218299
4872,0.5693,33,108,33,463420,142190,60199,47757,1.3171106747193302,0.2514227652976883
4873,0.5694,22,114,22,463534,142076,60221,47735,1.316054688947349,0.2514870054949397
4874,0.5695,32,131,32,463665,141945,60253,47703,1.3148412316128792,0.2515344216654012
4875,0.5696,11,48,11,463713,141897,60264,47692,1.3143966060246768,0.25155467880520493
4876,0.5697,20,84,20,463797,141813,60284,47672,1.3136185112453223,0.25158719687574216
4877,0.5698,28,112,28,463909,141701,60312,47644,1.3125810515395162,0.25162533998785286
4878,0.5699,18,98,18,464007,141603,60330,47626,1.3116732742969357,0.2516844669685936
4879,0.57,19,73,19,464080,141530,60349,47607,1.3109970728815443,0.2517064350180028
4880,0.5701,29,99,29,464179,141431,60378,47578,1.3100800326058766,0.25172346290388287
4881,0.5702,26,126,26,464305,141305,60404,47552,1.3089128904368446,0.2517883901576325
4882,0.5703,31,165,31,464470,141140,60435,47521,1.307384489977398,0.25188565734306506
4883,0.5704,18,108,18,464578,141032,60453,47503,1.3063840824039423,0.2519585222902909
4884,0.5705,13,73,13,464651,140959,60466,47490,1.305707880988551,0.25200452111711924
4885,0.5706,23,72,23,464723,140887,60489,47467,1.305040942606247,0.2520095140002336
4886,0.5707,31,148,31,464871,140739,60520,47436,1.303670013709289,0.25208449581506576
4887,0.5708,12,61,12,464932,140678,60532,47424,1.3031049686909482,0.25211853143507246
4888,0.5709,18,88,18,465020,140590,60550,47406,1.3022898217792434,0.25216493967956766
4889,0.571,14,102,14,465122,140488,60564,47392,1.3013449924043128,0.2522461145411965
4890,0.5711,39,166,39,465288,140322,60603,47353,1.2998073289117789,0.2523138404156121
4891,0.5712,23,99,23,465387,140223,60626,47330,1.2988902886361111,0.2523553342255256
4892,0.5713,33,145,33,465532,140078,60659,47297,1.2975471488384156,0.25241894596397596
4893,0.5714,25,101,25,465633,139977,60684,47272,1.2966115824965727,0.25245528681061047
4894,0.5715,29,103,29,465736,139874,60713,47243,1.2956574900885547,0.25247839586996373
4895,0.5716,27,88,27,465824,139786,60740,47216,1.2948423431768499,0.2524892781895381
4896,0.5717,20,109,20,465933,139677,60760,47196,1.2938326725703064,0.25255654910019104
4897,0.5718,29,145,29,466078,139532,60789,47167,1.2924895327726111,0.25263659687518414
4898,0.5719,27,172,27,466250,139360,60816,47140,1.2908962910815518,0.2527613941018767
4899,0.572,39,174,39,466424,139186,60855,47101,1.2892845233243173,0.25284104634247156
4900,0.5721,22,92,22,466516,139094,60877,47079,1.2884323242802622,0.25287769977386626
4901,0.5722,52,163,52,466679,138931,60929,47027,1.286922449886991,0.2528904376257004
4902,0.5723,19,71,19,466750,138860,60948,47008,1.2862647745377747,0.2529106677857404
4903,0.5724,39,168,39,466918,138692,60987,46969,1.2847085849790656,0.2529825865421386
4904,0.5725,34,141,34,467059,138551,61021,46935,1.2834024973137204,0.2530379651294437
4905,0.5726,27,69,27,467128,138482,61048,46908,1.2827633480306793,0.2530233561680781
4906,0.5727,16,80,16,467208,138402,61064,46892,1.2820223053836748,0.25306809718609347
4907,0.5728,14,72,14,467280,138330,61078,46878,1.2813553670013709,0.2531100168459246
4908,0.5729,31,148,31,467428,138182,61109,46847,1.279984438104413,0.2531873382010388
4909,0.573,39,106,39,467534,138076,61148,46808,1.2790025565971321,0.25317496376106097
4910,0.5731,36,120,36,467654,137956,61184,46772,1.2778909926266258,0.25319388506344465
4911,0.5732,27,77,27,467731,137879,61211,46745,1.277177739078884,0.25319026778750325
4912,0.5733,10,44,10,467775,137835,61221,46735,1.2767701656230317,0.2532101641653573
4913,0.5734,17,70,17,467845,137765,61238,46718,1.276121753306903,0.253237425670658
4914,0.5735,36,134,36,467979,137631,61274,46682,1.2748805068731706,0.25327567778724236
4915,0.5736,22,94,22,468073,137537,61296,46660,1.2740097817629406,0.2533157434703062
4916,0.5737,27,113,27,468186,137424,61323,46633,1.2729630590240468,0.253361730333538
4917,0.5738,19,83,19,468269,137341,61342,46614,1.2721942272777798,0.25339892908591777
4918,0.5739,25,71,25,468340,137270,61367,46589,1.2715365519285635,0.2533952648496946
4919,0.574,29,105,29,468445,137165,61396,46560,1.2705639334543704,0.25342223431759425
4920,0.5741,27,83,27,468528,137082,61423,46533,1.2697951017081033,0.2534270075974185
4921,0.5742,21,91,21,468619,136991,61444,46512,1.2689521656971359,0.25346724576709917
4922,0.5743,21,79,21,468698,136912,61465,46491,1.268220386083219,0.253490946167729
4923,0.5744,63,220,63,468918,136692,61528,46428,1.2661825188039573,0.2535386631716907
4924,0.5745,42,218,42,469136,136474,61570,46386,1.2641631775908704,0.2536694739144701
4925,0.5746,20,102,20,469238,136372,61590,46366,1.2632183482159398,0.2537293830511443
4926,0.5747,19,97,19,469335,136275,61609,46347,1.262319834006447,0.2537865098399974
4927,0.5748,21,140,21,469475,136135,61630,46326,1.2610230093741894,0.25389535297954086
4928,0.5749,21,71,21,469546,136064,61651,46305,1.2603653340249732,0.2539082848510438
4929,0.575,39,147,39,469693,135917,61690,46266,1.2590036681611028,0.2539534424177887
4930,0.5751,34,108,34,469801,135809,61724,46232,1.2580032605876468,0.25396476617904756
4931,0.5752,14,46,14,469847,135763,61738,46218,1.2575771610656192,0.25397156846044366
4932,0.5753,42,117,42,469964,135646,61780,46176,1.2564933861943755,0.25396266678399754
4933,0.5754,22,69,22,470033,135577,61802,46154,1.2558542369113344,0.2539687780290649
4934,0.5755,43,150,43,470183,135427,61845,46111,1.254464781948201,0.25400191695402613
4935,0.5756,31,130,31,470313,135297,61876,46080,1.253260587646819,0.2540564680196497
4936,0.5757,25,119,25,470432,135178,61901,46055,1.2521582867094,0.25412038646383384
4937,0.5758,23,66,23,470498,135112,61924,46032,1.2515469265256216,0.254118270547189
4938,0.5759,33,196,33,470694,134916,61957,45999,1.249731372040461,0.25425752425172043
4939,0.576,20,119,20,470813,134797,61977,45979,1.2486290711030419,0.2543423905828207
4940,0.5761,33,137,33,470950,134660,62010,45946,1.2473600355700472,0.25439907865740896
4941,0.5762,27,117,27,471067,134543,62037,45919,1.2462762606988032,0.25445246090589707
4942,0.5763,15,69,15,471136,134474,62052,45904,1.245637111415762,0.2544877978467441
4943,0.5764,27,108,27,471244,134366,62079,45877,1.244636703842306,0.2545286086006114
4944,0.5765,42,161,42,471405,134205,62121,45835,1.2431453555152099,0.25458231504110196
4945,0.5766,23,108,23,471513,134097,62144,45812,1.2421449479417541,0.25463984569977044
4946,0.5767,47,170,47,471683,133927,62191,45765,1.24057023231687,0.25468579569485567
4947,0.5768,24,122,24,471805,133805,62215,45741,1.2394401422801882,0.2547592260479209
4948,0.5769,13,82,13,471887,133723,62228,45728,1.2386805735670088,0.25482165047840355
4949,0.577,25,124,25,472011,133599,62253,45703,1.2375319574641521,0.25489397775819567
4950,0.5771,17,116,17,472127,133483,62270,45686,1.2364574456259958,0.25498830712902343
4951,0.5772,27,103,27,472230,133380,62297,45659,1.2355033532179778,0.2550226486966527
4952,0.5773,18,110,18,472340,133270,62315,45641,1.2344844195783466,0.2551044932955492
4953,0.5774,26,87,26,472427,133183,62341,45615,1.2336785356997295,0.25512030335909797
4954,0.5775,19,73,19,472500,133110,62360,45596,1.2330023342843381,0.25514532248497535
4955,0.5776,54,194,54,472694,132916,62414,45542,1.2312053058653525,0.25519730132580215
4956,0.5777,21,98,21,472792,132818,62435,45521,1.2302975286227722,0.2552498331828708
4957,0.5778,28,76,28,472868,132742,62463,45493,1.2295935381081182,0.2552416753162959
4958,0.5779,20,82,20,472950,132660,62483,45473,1.2288339693949386,0.25527555253658785
4959,0.578,19,88,19,473038,132572,62502,45454,1.228018822483234,0.2553222562996416
4960,0.5781,16,53,16,473091,132519,62518,45438,1.2275278817295936,0.25533134408874053
4961,0.5782,25,137,25,473228,132382,62543,45413,1.2262588461965986,0.2554233808599792
4962,0.5783,22,86,22,473314,132296,62565,45391,1.225462225351069,0.25545481661573444
4963,0.5784,29,110,29,473424,132186,62594,45362,1.224443291711438,0.2554914727285016
4964,0.5785,24,87,24,473511,132099,62618,45338,1.2236374078328207,0.2555160423136099
4965,0.5786,17,79,17,473590,132020,62635,45321,1.222905628218904,0.255558500290401
4966,0.5787,27,117,27,473707,131903,62662,45294,1.2218218533476601,0.2556138083601867
4967,0.5788,29,81,29,473788,131822,62691,45265,1.2210715476675682,0.2556088250407992
4968,0.5789,27,110,27,473898,131712,62718,45238,1.2200526140279373,0.2556541395874541
4969,0.579,24,125,24,474023,131587,62742,45214,1.218894734891993,0.2557338476592327
4970,0.5791,8,44,8,474067,131543,62750,45206,1.2184871614361406,0.25576382327481345
4971,0.5792,12,104,12,474171,131439,62762,45194,1.217523805995035,0.2558638533003459
4972,0.5793,20,69,20,474240,131370,62782,45174,1.2168846567119938,0.2558795541054921
4973,0.5794,35,137,35,474377,131233,62817,45139,1.2156156211789988,0.2559306465878938
4974,0.5795,29,152,29,474529,131081,62846,45110,1.2142076401496906,0.2560289685625259
4975,0.5796,43,118,43,474647,130963,62889,45067,1.2131146022453592,0.25601886042151906
4976,0.5797,13,51,13,474698,130912,62902,45054,1.2126421875578939,0.25603809826898377
4977,0.5798,34,159,34,474857,130753,62936,45020,1.2111693652969728,0.25612579861525947
4978,0.5799,23,113,23,474970,130640,62959,44997,1.210122642558079,0.25619317114275464
4979,0.58,27,103,27,475073,130537,62986,44970,1.209168550150061,0.2562290962753622
4980,0.5801,51,183,51,475256,130354,63037,44919,1.2074734150950388,0.25628020288350173
4981,0.5802,35,142,35,475398,130212,63072,44884,1.2061580643966061,0.25633937954036645
4982,0.5803,45,147,45,475545,130065,63117,44839,1.2047963985327355,0.2563634908292549
4983,0.5804,23,123,23,475668,129942,63140,44816,1.2036570454629665,0.25644605683287747
4984,0.5805,43,157,43,475825,129785,63183,44773,1.2022027492682203,0.2564935436932137
4985,0.5806,28,101,28,475926,129684,63211,44745,1.2012671829263775,0.25652271124640974
4986,0.5807,26,113,26,476039,129571,63237,44719,1.2002204601874837,0.25657811693155086
4987,0.5808,29,86,29,476125,129485,63266,44690,1.199423839341954,0.25658102483134776
4988,0.5809,25,115,25,476240,129370,63291,44665,1.1983585905368854,0.25664377855029163
4989,0.581,30,147,30,476387,129223,63321,44635,1.196996924673015,0.25673250583809776
4990,0.5811,31,126,31,476513,129097,63352,44604,1.1958297825039832,0.25678608643588696
4991,0.5812,29,109,29,476622,128988,63381,44575,1.1948201118974398,0.2568231708371024
4992,0.5813,26,84,26,476706,128904,63407,44549,1.1940420171180852,0.25683614581471637
4993,0.5814,28,180,28,476886,128724,63435,44521,1.1923746711623253,0.2569828855089613
4994,0.5815,22,91,22,476977,128633,63457,44499,1.191531735151358,0.25702354273040223
4995,0.5816,25,119,25,477096,128514,63482,44474,1.190429434213939,0.25709297754757554
4996,0.5817,27,101,27,477197,128413,63509,44447,1.189493867872096,0.2571271549230591
4997,0.5818,29,94,29,477291,128319,63538,44418,1.1886231427618659,0.25714236093020026
4998,0.5819,29,126,29,477417,128193,63567,44389,1.187456000592834,0.2572052705380631
4999,0.582,12,62,12,477479,128131,63579,44377,1.1868816925414059,0.2572460407633269
5000,0.5821,19,84,19,477563,128047,63598,44358,1.186103597762051,0.25728952176561004
5001,0.5822,26,93,26,477656,127954,63624,44332,1.1852421356849088,0.2573163228585027
5002,0.5823,23,87,23,477743,127867,63647,44309,1.1844362518062914,0.2573471331660626
5003,0.5824,24,73,24,477816,127794,63671,44285,1.1837600503909,0.2573527275263106
5004,0.5825,37,119,37,477935,127675,63708,44248,1.1826577494534811,0.25737103238077513
5005,0.5826,24,94,24,478029,127581,63732,44224,1.181787024343251,0.257408108029452
5006,0.5827,21,94,21,478123,127487,63753,44203,1.1809162992330209,0.2574582095637486
5007,0.5828,35,121,35,478244,127366,63788,44168,1.1797954722294268,0.25748831135518324
5008,0.5829,17,62,17,478306,127304,63805,44151,1.1792211641779984,0.2575078008806976
5009,0.583,28,98,28,478404,127206,63833,44123,1.178313386935418,0.2575337508536208
5010,0.5831,10,66,10,478470,127140,63843,44113,1.1777020267516396,0.2575896480645595
5011,0.5832,26,133,26,478603,127007,63869,44087,1.176470043350995,0.25767706640793947
5012,0.5833,17,70,17,478673,126937,63886,44070,1.1758216310348661,0.2577087487646704
5013,0.5834,16,107,16,478780,126830,63902,44054,1.1748304864944978,0.2578006132815243
5014,0.5835,18,79,18,478859,126751,63920,44036,1.174098706880581,0.2578416390006265
5015,0.5836,18,58,18,478917,126693,63938,44018,1.1735614509615029,0.25785098792696426
5016,0.5837,27,97,27,479014,126596,63965,43991,1.17266293675201,0.25788014327000297
5017,0.5838,29,148,29,479162,126448,63994,43962,1.1712920078550522,0.25797781820315707
5018,0.5839,10,67,10,479229,126381,64004,43952,1.170671384638186,0.2580357300112133
5019,0.584,13,105,13,479334,126276,64017,43939,1.1696987661639928,0.2581382369356402
5020,0.5841,41,119,41,479453,126157,64058,43898,1.168596465226574,0.258140013525036
5021,0.5842,25,78,25,479531,126079,64083,43873,1.1678739486457446,0.2581493598192431
5022,0.5843,26,114,26,479645,125965,64109,43847,1.1668179628737634,0.258209078274798
5023,0.5844,29,96,29,479741,125869,64138,43818,1.1659287116973582,0.25822838520334496
5024,0.5845,31,107,31,479848,125762,64169,43787,1.16493756715699,0.2582557254834886
5025,0.5846,24,96,24,479944,125666,64193,43763,1.1640483159805848,0.25829698575804616
5026,0.5847,24,98,24,480042,125568,64217,43739,1.1631405387380043,0.2583413562345325
5027,0.5848,26,99,26,480141,125469,64243,43713,1.1622234984623365,0.25837855090967127
5028,0.5849,42,132,42,480273,125337,64285,43671,1.1610007780947793,0.25839605225788126
5029,0.585,31,124,31,480397,125213,64316,43640,1.1598521619919226,0.25844965739430154
5030,0.5851,39,127,39,480524,125086,64355,43601,1.1586757567898032,0.2584727928056104
5031,0.5852,56,219,56,480743,124867,64411,43545,1.1566471525436288,0.25856233522551836
5032,0.5853,12,72,12,480815,124795,64423,43533,1.155980214161325,0.25862007509148804
5033,0.5854,34,96,34,480911,124699,64457,43499,1.1550909629849198,0.2586178194746668
5034,0.5855,13,63,13,480974,124636,64470,43486,1.1545073919004039,0.25865740355218236
5035,0.5856,19,80,19,481054,124556,64489,43467,1.1537663492533996,0.25869672604345834
5036,0.5857,51,163,51,481217,124393,64540,43416,1.1522564748601283,0.2587227145147161
5037,0.5858,17,60,17,481277,124333,64557,43399,1.151700692874875,0.2587401330694203
5038,0.5859,26,80,26,481357,124253,64583,43373,1.1509596502278707,0.2587486428119743
5039,0.586,30,103,30,481460,124150,64613,43343,1.1500055578198525,0.2587749935818213
5040,0.5861,26,82,26,481542,124068,64639,43317,1.149245989106673,0.2587866296263106
5041,0.5862,30,182,30,481724,123886,64669,43287,1.1475601170847383,0.25893535439335297
5042,0.5863,60,188,60,481912,123698,64729,43227,1.145818666864278,0.25896061105286805
5043,0.5864,23,88,23,482000,123610,64752,43204,1.1450035199525732,0.2589950483772345
5044,0.5865,27,112,27,482112,123498,64779,43177,1.1439660602467672,0.25904904754762265
5045,0.5866,34,130,34,482242,123368,64813,43143,1.142761865945385,0.25909999939943906
5046,0.5867,8,58,8,482300,123310,64821,43135,1.142224610026307,0.2591546757187059
5047,0.5868,30,146,30,482446,123164,64851,43105,1.1408722071955242,0.2592485670810554
5048,0.5869,28,129,28,482575,123035,64879,43077,1.1396772759272296,0.2593250337121942
5049,0.587,27,134,27,482709,122901,64906,43050,1.1384360294934974,0.2594139233870239
5050,0.5871,32,87,32,482796,122814,64938,43018,1.13763014561488,0.2594071108109412
5051,0.5872,46,184,46,482980,122630,64984,42972,1.1359257475267701,0.25948961969058343
5052,0.5873,33,108,33,483088,122522,65017,42939,1.1349253399533143,0.2595113047787696
5053,0.5874,17,46,17,483134,122476,65034,42922,1.1344992404312868,0.2595073701012104
5054,0.5875,35,143,35,483277,122333,65069,42887,1.1331746266997667,0.25957511197191624
5055,0.5876,38,163,38,483440,122170,65107,42849,1.1316647523064953,0.2596610087323278
5056,0.5877,27,122,27,483562,122048,65134,42822,1.1305346622698136,0.25973190998968887
5057,0.5878,35,118,35,483680,121930,65169,42787,1.1294416243654823,0.2597606804397846
5058,0.5879,24,125,24,483805,121805,65193,42763,1.128283745229538,0.2598500315978805
5059,0.588,23,116,23,483921,121689,65216,42740,1.1272092333913817,0.25992981773288165
5060,0.5881,25,133,25,484054,121556,65241,42715,1.125977249990737,0.2600276372579457
5061,0.5882,36,137,36,484191,121419,65277,42679,1.124708214457742,0.2600823897914661
5062,0.5883,24,107,24,484298,121312,65301,42655,1.1237170699173737,0.26014380942506726
5063,0.5884,30,88,30,484386,121224,65331,42625,1.122901923005669,0.26014806315571043
5064,0.5885,30,114,30,484500,121110,65361,42595,1.1218459372336878,0.2601936410005803
5065,0.5886,26,115,26,484615,120995,65387,42569,1.120780688428619,0.2602589811939057
5066,0.5887,28,79,28,484694,120916,65415,42541,1.1200489088147023,0.2602580495176101
5067,0.5888,23,107,23,484801,120809,65438,42518,1.119057764274334,0.26032437992493584
5068,0.5889,26,89,26,484890,120720,65464,42492,1.1182333543295417,0.2603485037864863
5069,0.589,18,67,18,484957,120653,65482,42474,1.1176127311126756,0.2603738191715657
5070,0.5891,28,95,28,485052,120558,65510,42446,1.1167327429693579,0.2603985178277834
5071,0.5892,13,62,13,485114,120496,65523,42433,1.1161584349179294,0.26043859595283836
5072,0.5893,23,84,23,485198,120412,65546,42410,1.115380340138575,0.2604684870594883
5073,0.5894,26,104,26,485302,120308,65572,42384,1.1144169846974694,0.26051680475991446
5074,0.5895,15,94,15,485396,120214,65587,42369,1.1135462595872392,0.2605992016385477
5075,0.5896,17,89,17,485485,120125,65604,42352,1.112721849642447,0.260664586372225
5076,0.5897,10,70,10,485555,120055,65614,42342,1.1120734373263181,0.26073141745229284
5077,0.5898,16,57,16,485612,119998,65630,42326,1.1115454444403274,0.260750104728814
5078,0.5899,32,150,32,485762,119848,65662,42294,1.1101559894771944,0.26084543178201824
5079,0.59,20,75,20,485837,119773,65682,42274,1.109461261995628,0.26087493134707834
5080,0.5901,40,174,40,486011,119599,65722,42234,1.1078494942383934,0.26097273114877684
5081,0.5902,22,95,22,486106,119504,65744,42212,1.1069695060950757,0.26102550149645054
5082,0.5903,26,90,26,486196,119414,65770,42186,1.106135833117196,0.2610519801980198
5083,0.5904,51,107,51,486303,119307,65821,42135,1.1051446885768277,0.26099156353365294
5084,0.5905,27,114,27,486417,119193,65848,42108,1.1040887028048465,0.26105231833652615
5085,0.5906,52,185,52,486602,119008,65900,42056,1.1023750416836489,0.261113594595937
5086,0.5907,13,64,13,486666,118944,65913,42043,1.1017822075660455,0.2611577332331182
5087,0.5908,22,107,22,486773,118837,65935,42021,1.1007910630256772,0.26123040196943886
5088,0.5909,18,69,18,486842,118768,65953,42003,1.1001519137426359,0.26125980431794293
5089,0.591,37,152,37,486994,118616,65990,41966,1.0987439327133277,0.26133688707327096
5090,0.5911,17,61,17,487055,118555,66007,41949,1.098178887694987,0.261357972386981
5091,0.5912,41,115,41,487170,118440,66048,41908,1.097113638889918,0.261356549504827
5092,0.5913,21,106,21,487276,118334,66069,41887,1.0961317573826375,0.26143264615749495
5093,0.5914,16,51,16,487327,118283,66085,41871,1.0956593426951722,0.26144211196723155
5094,0.5915,40,130,40,487457,118153,66125,41831,1.09445514839379,0.26146989698969897
5095,0.5916,45,172,45,487629,117981,66170,41786,1.0928619067027308,0.2615433725362559
5096,0.5917,27,135,27,487764,117846,66197,41759,1.091611397235911,0.261639672942577
5097,0.5918,44,101,44,487865,117745,66241,41715,1.090675830894068,0.2616016555876082
5098,0.5919,33,99,33,487964,117646,66274,41682,1.0897587906184,0.2616112673227556
5099,0.592,27,154,27,488118,117492,66301,41655,1.0883322835229168,0.2617391468265189
5100,0.5921,25,105,25,488223,117387,66326,41630,1.0873596650487236,0.26179590861354446
5101,0.5922,24,121,24,488344,117266,66350,41606,1.0862388380451296,0.26188378065360796
5102,0.5923,43,133,43,488477,117133,66393,41563,1.0850068546444849,0.2619032615818924
5103,0.5924,27,127,27,488604,117006,66420,41536,1.0838304494423654,0.26198735981632626
5104,0.5925,9,60,9,488664,116946,66429,41527,1.083274667457112,0.2620446385188644
5105,0.5926,34,149,34,488813,116797,66463,41493,1.0818944755270665,0.2621327942384232
5106,0.5927,14,52,14,488865,116745,66477,41479,1.0814127978065138,0.2621536555769036
5107,0.5928,19,79,19,488944,116666,66496,41460,1.080681018192597,0.26219597030216407
5108,0.5929,12,50,12,488994,116616,66508,41448,1.0802178665382194,0.26222289705435775
5109,0.593,24,96,24,489090,116520,66532,41424,1.079328615361814,0.2622701717064276
5110,0.5931,43,91,43,489181,116429,66575,41381,1.0784856793508466,0.26222039161016414
5111,0.5932,19,78,19,489259,116351,66594,41362,1.0777631627700175,0.26226119596989467
5112,0.5933,39,160,39,489419,116191,66633,41323,1.0762810774760088,0.26234493441852785
5113,0.5934,31,184,31,489603,116007,66664,41292,1.0745766793878988,0.26250643678599356
5114,0.5935,46,167,46,489770,115840,66710,41246,1.0730297528622772,0.2625695478909642
5115,0.5936,37,103,37,489873,115737,66747,41209,1.0720756604542592,0.262568017024964
5116,0.5937,21,52,21,489925,115685,66768,41188,1.0715939827337064,0.26255633537957457
5117,0.5938,21,90,21,490015,115595,66789,41167,1.0707603097558265,0.26260828517115115
5118,0.5939,38,125,38,490140,115470,66827,41129,1.0696024306198821,0.262638969597507
5119,0.594,31,112,31,490252,115358,66858,41098,1.068564970914076,0.2626808815257964
5120,0.5941,28,90,28,490342,115268,66886,41070,1.0677312979361961,0.26270004733334185
5121,0.5942,15,87,15,490429,115181,66901,41055,1.066925414057579,0.2627755446888041
5122,0.5943,33,98,33,490527,115083,66934,41022,1.0660176368149987,0.2627846641683482
5123,0.5944,43,140,43,490667,114943,66977,40979,1.0647208121827412,0.2628173060889419
5124,0.5945,30,109,30,490776,114834,67007,40949,1.0637111415761977,0.26285923367761566
5125,0.5946,47,152,47,490928,114682,67054,40902,1.0623031605468896,0.26289335664335667
5126,0.5947,20,66,20,490994,114616,67074,40882,1.0616918003631108,0.2629101338923973
5127,0.5948,17,131,17,491125,114485,67091,40865,1.0604783430286413,0.26305117476665596
5128,0.5949,27,144,27,491269,114341,67118,40838,1.0591444662640335,0.2631670522428937
5129,0.595,30,87,30,491356,114254,67148,40808,1.0583385823854163,0.2631721504946409
5130,0.5951,28,65,28,491421,114189,67176,40780,1.0577364852347253,0.26314940407436327
5131,0.5952,12,35,12,491456,114154,67188,40768,1.057412279076661,0.2631517796052207
5132,0.5953,22,89,22,491545,114065,67210,40746,1.0565878691318686,0.2631983515383274
5133,0.5954,36,148,36,491693,113917,67246,40710,1.0552169402349105,0.2632787288119151
5134,0.5955,22,92,22,491785,113825,67268,40688,1.0543647411908554,0.26333059354229094
5135,0.5956,33,103,33,491888,113722,67301,40655,1.0534106487828374,0.26334881491413875
5136,0.5957,24,82,24,491970,113640,67325,40631,1.052651080069658,0.26337419216832714
5137,0.5958,50,190,50,492160,113450,67375,40581,1.0508911037830226,0.26345995286663076
5138,0.5959,30,139,30,492299,113311,67405,40551,1.0496035421838528,0.26355435390154813
5139,0.596,24,61,24,492360,113250,67429,40527,1.0490384971655118,0.2635439630113736
5140,0.5961,5,32,5,492392,113218,67434,40522,1.0487420801067102,0.263574866657994
5141,0.5962,10,58,10,492450,113160,67444,40512,1.048204824187632,0.26362642511322815
5142,0.5963,46,147,46,492597,113013,67490,40466,1.0468431583237616,0.2636582203428482
5143,0.5964,24,110,24,492707,112903,67514,40442,1.0458242246841305,0.26373210733965896
5144,0.5965,32,98,32,492805,112805,67546,40410,1.0449164474415502,0.26374702215840484
5145,0.5966,21,87,21,492892,112718,67567,40389,1.044110563562933,0.26379590743728243
5146,0.5967,25,80,25,492972,112638,67592,40364,1.0433695209159286,0.2638135449209814
5147,0.5968,23,107,23,493079,112531,67615,40341,1.0423783763755605,0.2638874352399393
5148,0.5969,34,118,34,493197,112413,67649,40307,1.041285338471229,0.26392744892613934
5149,0.597,23,92,23,493289,112321,67672,40284,1.040433139427174,0.263975623341306
5150,0.5971,11,54,11,493343,112267,67683,40273,1.039932935640446,0.2640159958043792
5151,0.5972,32,93,32,493436,112174,67715,40241,1.0390714735633035,0.2640225699570252
5152,0.5973,29,131,29,493567,112043,67744,40212,1.037858016228834,0.26410955305244493
5153,0.5974,28,112,28,493679,111931,67772,40184,1.036820556523028,0.2641685566840877
5154,0.5975,14,66,14,493745,111865,67786,40170,1.0362091963392492,0.26421547669944423
5155,0.5976,20,96,20,493841,111769,67806,40150,1.035319945162844,0.2642855732331045
5156,0.5977,37,129,37,493970,111640,67843,40113,1.0341250138945497,0.2643308534262914
5157,0.5978,37,103,37,494073,111537,67880,40076,1.0331709214865314,0.2643308951079393
5158,0.5979,38,123,38,494196,111414,67918,40038,1.0320315684167625,0.2643609856588226
5159,0.598,38,104,38,494300,111310,67956,40000,1.0310682129756568,0.2643579406516423
5160,0.5981,49,156,49,494456,111154,68005,39951,1.0296231798139983,0.2643923099831243
5161,0.5982,27,90,27,494546,111064,68032,39924,1.0287895068361184,0.26441836437332766
5162,0.5983,42,198,42,494744,110866,68074,39882,1.0269554262847826,0.26456072385703294
5163,0.5984,35,132,35,494876,110734,68109,39847,1.0257327059172254,0.2646216986206759
5164,0.5985,50,138,50,495014,110596,68159,39797,1.024454407351143,0.26462002885772606
5165,0.5986,33,128,33,495142,110468,68192,39764,1.023268739115936,0.26468395548218754
5166,0.5987,11,82,11,495224,110386,68203,39753,1.0225091704027567,0.2647746421649272
5167,0.5988,38,144,38,495368,110242,68241,39715,1.0211752936381489,0.2648425882086198
5168,0.5989,21,65,21,495433,110177,68262,39694,1.0205731964874578,0.2648544414863449
5169,0.599,37,93,37,495526,110084,68299,39657,1.0197117344103153,0.2648372857133317
5170,0.5991,33,112,33,495638,109972,68332,39624,1.0186742747045092,0.2648733923366935
5171,0.5992,23,85,23,495723,109887,68355,39601,1.0178869168920672,0.2649108958578615
5172,0.5993,29,103,29,495826,109784,68384,39572,1.016932824484049,0.26495085567369236
5173,0.5994,30,117,30,495943,109667,68414,39542,1.0158490496128052,0.265010823743876
5174,0.5995,27,112,27,496055,109555,68441,39515,1.0148115899069992,0.2650768095525592
5175,0.5996,12,47,12,496102,109508,68453,39503,1.0143762273518842,0.26510123413707715
5176,0.5997,22,80,22,496182,109428,68475,39481,1.0136351847048797,0.26513508250005036
5177,0.5998,29,102,29,496284,109326,68504,39452,1.0126903553299493,0.2651736143784699
5178,0.5999,23,91,23,496375,109235,68527,39429,1.0118474193189817,0.2652222461389442
5179,0.6,21,95,21,496470,109140,68548,39408,1.0109674311756642,0.26528798772114065
5180,0.6001,17,74,17,496544,109066,68565,39391,1.0102819667271852,0.2653360905851526
5181,0.6002,15,62,15,496606,109004,68580,39376,1.0097076586757567,0.26537269173743094
5182,0.6003,22,86,22,496692,108918,68602,39354,1.008911037830227,0.2654176108773066
5183,0.6004,39,111,39,496803,108807,68641,39315,1.0078828411575087,0.2654230971766517
5184,0.6005,17,87,17,496890,108720,68658,39298,1.0070769572788913,0.2654947371265657
5185,0.6006,36,107,36,496997,108613,68694,39262,1.006085812738523,0.2655080304311074
5186,0.6007,35,111,35,497108,108502,68729,39227,1.0050576160658047,0.26553351068510583
5187,0.6008,23,93,23,497201,108409,68752,39204,1.0041961539886621,0.2655863643446038
5188,0.6009,45,192,45,497393,108217,68797,39159,1.0024176516358516,0.2657081207252198
5189,0.601,15,93,15,497486,108124,68812,39144,1.001556189558709,0.2658011244805389
5190,0.6011,27,92,27,497578,108032,68839,39117,1.0007039905146542,0.26583259145491983
5191,0.6012,15,56,15,497634,107976,68854,39102,1.0001852606617512,0.26585893199526783
5192,0.6013,22,73,22,497707,107903,68876,39080,0.9995090592463596,0.2658810882891219
5193,0.6014,16,54,16,497761,107849,68892,39064,0.9990088554596317,0.2658988653148462
5194,0.6015,27,83,27,497844,107766,68919,39037,0.9982400237133647,0.26591418431503444
5195,0.6016,16,60,16,497904,107706,68935,39021,0.9976842417281114,0.26594287349976486
5196,0.6017,19,78,19,497982,107628,68954,39002,0.9969617251472822,0.265989224578872
5197,0.6018,22,113,22,498095,107515,68976,38980,0.9959150024083886,0.26608416669510904
5198,0.6019,44,132,44,498227,107383,69020,38936,0.9946922820408315,0.26610351355599754
5199,0.602,23,71,23,498298,107312,69043,38913,0.9940346066916151,0.2661172850059839
5200,0.6021,27,83,27,498381,107229,69070,38886,0.9932657749453481,0.2661328405707833
5201,0.6022,54,164,54,498545,107065,69124,38832,0.9917466375189892,0.2661603734141209
5202,0.6023,26,129,26,498674,106936,69150,38806,0.9905517062506948,0.2662650437073733
5203,0.6024,39,118,39,498792,106818,69189,38767,0.9894586683463633,0.2662843012673009
5204,0.6025,23,129,23,498921,106689,69212,38744,0.9882637370780688,0.26640446116080946
5205,0.6026,12,100,12,499021,106589,69224,38732,0.9873374337693134,0.2665272052903572
5206,0.6027,10,58,10,499079,106531,69234,38722,0.9868001778502353,0.26658313425540264
5207,0.6028,60,186,60,499265,106345,69294,38662,0.9850772536959502,0.26662161137048557
5208,0.6029,20,83,20,499348,106262,69314,38642,0.9843084219496832,0.26667310771269254
5209,0.603,13,61,13,499409,106201,69327,38629,0.9837433769313424,0.26671960229234276
5210,0.6031,20,101,20,499510,106100,69347,38609,0.9828078105894994,0.2668044143764382
5211,0.6032,19,66,19,499576,106034,69366,38590,0.9821964504057209,0.26682984843456137
5212,0.6033,45,138,45,499714,105896,69411,38545,0.9809181518396384,0.2668563634978988
5213,0.6034,38,137,38,499851,105759,69449,38507,0.9796491163066434,0.26691666782194
5214,0.6035,11,80,11,499931,105679,69460,38496,0.9789080736596392,0.2670088434194555
5215,0.6036,28,81,28,500012,105598,69488,38468,0.9781577679795472,0.2670165063234906
5216,0.6037,23,104,23,500116,105494,69511,38445,0.9771944125384416,0.26709230993684824
5217,0.6038,21,78,21,500194,105416,69532,38424,0.9764718959576124,0.2671301446051168
5218,0.6039,31,80,31,500274,105336,69563,38393,0.975730853310608,0.2671207619895776
5219,0.604,28,86,28,500360,105250,69591,38365,0.9749342324650784,0.26713783379173484
5220,0.6041,37,127,37,500487,105123,69628,38328,0.973757827262959,0.26718531066357154
5221,0.6042,11,113,11,500600,105010,69639,38317,0.9727111045240654,0.26733971966203157
5222,0.6043,17,97,17,500697,104913,69656,38300,0.9718125903145726,0.2674338223485298
5223,0.6044,17,90,17,500787,104823,69673,38283,0.9709789173366927,0.26751498888935477
5224,0.6045,27,96,27,500883,104727,69700,38256,0.9700896661602876,0.2675562829147521
5225,0.6046,25,73,25,500956,104654,69725,38231,0.9694134647448961,0.26756482485915245
5226,0.6047,32,145,32,501101,104509,69757,38199,0.9680703249472007,0.2676724500378395
5227,0.6048,27,97,27,501198,104412,69784,38172,0.967171810737708,0.2677158727486955
5228,0.6049,9,31,9,501229,104381,69793,38163,0.9668846567119938,0.26772785946795374
5229,0.605,17,93,17,501322,104288,69810,38146,0.9660231946348512,0.2678152688262634
5230,0.6051,31,97,31,501419,104191,69841,38115,0.9651246804253585,0.26783832023948395
5231,0.6052,23,105,23,501524,104086,69864,38092,0.9641520619511653,0.2679176806538283
5232,0.6053,35,106,35,501630,103980,69899,38057,0.9631701804438846,0.2679372276237882
5233,0.6054,29,100,29,501730,103880,69928,38028,0.9622438771351292,0.2679764354370437
5234,0.6055,24,58,24,501788,103822,69952,38004,0.961706621216051,0.2679621508045069
5235,0.6056,15,62,15,501850,103760,69967,37989,0.9611323131646227,0.26800189066589536
5236,0.6057,17,84,17,501934,103676,69984,37972,0.960354218385268,0.26807296961481986
5237,0.6058,29,131,29,502065,103545,70013,37943,0.9591407610507985,0.268171152323872
5238,0.6059,8,39,8,502104,103506,70021,37935,0.9587795027603838,0.26820370331092114
5239,0.606,33,133,33,502237,103373,70054,37902,0.9575475193597391,0.2682852592461511
5240,0.6061,33,129,33,502366,103244,70087,37869,0.9563525880914446,0.26835939991354446
5241,0.6062,24,100,24,502466,103144,70111,37845,0.9554262847826892,0.2684251962919093
5242,0.6063,34,144,34,502610,103000,70145,37811,0.9540924080180815,0.2685230557271804
5243,0.6064,37,156,37,502766,102844,70182,37774,0.952647374856423,0.2686284828400347
5244,0.6065,27,103,27,502869,102741,70209,37747,0.9516932824484049,0.26868486988212514
5245,0.6066,51,135,51,503004,102606,70260,37696,0.9504427729815851,0.26867756696269474
5246,0.6067,32,93,32,503097,102513,70292,37664,0.9495813109044425,0.2686888719262076
5247,0.6068,20,79,20,503176,102434,70312,37644,0.9488495312905257,0.26873598994845727
5248,0.6069,42,98,42,503274,102336,70354,37602,0.9479417540479455,0.2687047120867813
5249,0.607,21,74,21,503348,102262,70375,37581,0.9472562895994664,0.2687370837296111
5250,0.6071,27,86,27,503434,102176,70402,37554,0.9464596687539368,0.26876118228011164
5251,0.6072,28,114,28,503548,102062,70430,37526,0.9454036829819557,0.2688339971917357
5252,0.6073,31,95,31,503643,101967,70461,37495,0.944523694838638,0.26885459838522324
5253,0.6074,19,103,19,503746,101864,70480,37476,0.9435696024306199,0.26895363858188603
5254,0.6075,23,88,23,503834,101776,70503,37453,0.9427544555189151,0.2690028657822724
5255,0.6076,25,58,25,503892,101718,70528,37428,0.942217199599837,0.2689836574533224
5256,0.6077,29,111,29,504003,101607,70557,37399,0.9411890029271185,0.2690459404630016
5257,0.6078,16,55,16,504058,101552,70573,37383,0.9406795361073029,0.26906826933458095
5258,0.6079,31,151,31,504209,101401,70604,37352,0.9392808181110823,0.2691977831109958
5259,0.608,45,170,45,504379,101231,70649,37307,0.9377061024861981,0.26929073611572274
5260,0.6081,31,111,31,504490,101120,70680,37276,0.9366779058134795,0.26934304459666464
5261,0.6082,39,129,39,504619,100991,70719,37237,0.935482974545185,0.26938825708250136
5262,0.6083,37,124,37,504743,100867,70756,37200,0.9343343584423284,0.2694344050352365
5263,0.6084,20,74,20,504817,100793,70776,37180,0.9336488939938493,0.2694730128358447
5264,0.6085,31,120,31,504937,100673,70807,37149,0.9325373300233428,0.2695433239976201
5265,0.6086,23,111,23,505048,100562,70830,37126,0.9315091333506244,0.2696386032188717
5266,0.6087,32,124,32,505172,100438,70862,37094,0.9303605172477676,0.2697117761684553
5267,0.6088,23,82,23,505254,100356,70885,37071,0.9296009485345882,0.2697504857124146
5268,0.6089,24,132,24,505386,100224,70909,37047,0.928378228167031,0.26988220381580963
5269,0.609,12,98,12,505484,100126,70921,37035,0.9274704509244507,0.2700111547743163
5270,0.6091,41,154,41,505638,99972,70962,36994,0.9260439438289674,0.2700962282610283
5271,0.6092,32,115,32,505753,99857,70994,36962,0.9249786950238986,0.2701525372937969
5272,0.6093,34,134,34,505887,99723,71028,36928,0.9237374485901664,0.2702358563054789
5273,0.6094,28,89,28,505976,99634,71056,36900,0.922913038645374,0.2702623522346082
5274,0.6095,33,123,33,506099,99511,71089,36867,0.9217736855756049,0.27032952529000276
5275,0.6096,21,71,21,506170,99440,71110,36846,0.9211160102263886,0.27035792377793755
5276,0.6097,23,68,23,506238,99372,71133,36823,0.9204861239764348,0.27036969051727305
5277,0.6098,33,108,33,506346,99264,71166,36790,0.9194857164029789,0.2704073382627486
5278,0.6099,24,97,24,506443,99167,71190,36766,0.9185872021934862,0.27047148227435575
5279,0.61,25,89,25,506532,99078,71215,36741,0.917762792248694,0.2705144346520001
5280,0.6101,17,66,17,506598,99012,71232,36724,0.9171514320649153,0.2705546059998821
5281,0.6102,35,77,35,506675,98935,71267,36689,0.9164381785171737,0.27051996696749836
5282,0.6103,25,80,25,506755,98855,71292,36664,0.9156971358701693,0.2705450896184299
5283,0.6104,16,54,16,506809,98801,71308,36648,0.9151969320834414,0.27056678159307196
5284,0.6105,23,57,23,506866,98744,71331,36625,0.9146689391974508,0.2705567744461435
5285,0.6106,23,93,23,506959,98651,71354,36602,0.9138074771203083,0.27061876631202264
5286,0.6107,9,60,9,507019,98591,71363,36593,0.913251695135055,0.2706903183808735
5287,0.6108,20,67,20,507086,98524,71383,36573,0.9126310719181889,0.27071659622345423
5288,0.6109,28,98,28,507184,98426,71411,36545,0.9117232946756085,0.27076186736410046
5289,0.611,31,101,31,507285,98325,71442,36514,0.9107877283337656,0.2707970245997078
5290,0.6111,34,158,34,507443,98167,71476,36480,0.9093241691059321,0.2709306557145722
5291,0.6112,59,204,59,507647,97963,71535,36421,0.907434510356071,0.27102184783902844
5292,0.6113,44,151,44,507798,97812,71579,36377,0.9060357923598503,0.2710877940814821
5293,0.6114,32,123,32,507921,97689,71611,36345,0.9048964392900811,0.2711625408478446
5294,0.6115,25,83,25,508004,97606,71636,36320,0.9041276075438142,0.2711945402685065
5295,0.6116,33,130,33,508134,97476,71669,36287,0.9029234132424321,0.2712783056600106
5296,0.6117,23,77,23,508211,97399,71692,36264,0.9022101596946904,0.2713091880325894
5297,0.6118,18,75,18,508286,97324,71710,36246,0.9015154322131239,0.27136333008909186
5298,0.6119,22,55,22,508341,97269,71732,36224,0.9010059653933084,0.27135505232484103
5299,0.612,27,130,27,508471,97139,71759,36197,0.8998017710919264,0.27147207055858885
5300,0.6121,35,80,35,508551,97059,71794,36162,0.899060728444922,0.2714436913099286
5301,0.6122,41,117,41,508668,96942,71835,36121,0.8979769535736781,0.2714578808534303
5302,0.6123,18,79,18,508747,96863,71853,36103,0.8972451739597613,0.27152053908517965
5303,0.6124,37,131,37,508878,96732,71890,36066,0.8960317166252918,0.2715854154430037
5304,0.6125,19,62,19,508940,96670,71909,36047,0.8954574085738635,0.27160800801705887
5305,0.6126,26,69,26,509009,96601,71935,36021,0.8948182592908221,0.27160652078840614
5306,0.6127,8,70,8,509079,96531,71943,36013,0.8941698469746934,0.27170599951714147
5307,0.6128,45,150,45,509229,96381,71988,35968,0.8927803920115602,0.27176631481915237
5308,0.6129,16,56,16,509285,96325,72004,35952,0.8922616621586572,0.27179328227885424
5309,0.613,27,95,27,509380,96230,72031,35925,0.8913816740153396,0.27183988498354206
5310,0.6131,23,91,23,509471,96139,72054,35902,0.8905387380043721,0.2719003945744125
5311,0.6132,43,153,43,509624,95986,72097,35859,0.8891214939419764,0.2719784595547802
5312,0.6133,31,133,31,509757,95853,72128,35828,0.8878895105413317,0.27208177337656914
5313,0.6134,19,65,19,509822,95788,72147,35809,0.8872874133906407,0.2721110663616952
5314,0.6135,30,80,30,509902,95708,72177,35779,0.8865463707436363,0.272110550852936
5315,0.6136,32,109,32,510011,95599,72209,35747,0.8855367001370928,0.2721590303473269
5316,0.6137,17,55,17,510066,95544,72226,35730,0.8850272333172774,0.2721788015905663
5317,0.6138,54,177,54,510243,95367,72280,35676,0.8833876764607803,0.2722465145028731
5318,0.6139,22,82,22,510325,95285,72302,35654,0.8826281077476009,0.2722947326617738
5319,0.614,18,80,18,510405,95205,72320,35636,0.8818870651005966,0.2723611100496022
5320,0.6141,22,86,22,510491,95119,72342,35614,0.8810904442550669,0.2724178287043057
5321,0.6142,20,36,20,510527,95083,72362,35594,0.8807569750639149,0.27238152084911654
5322,0.6143,32,74,32,510601,95009,72394,35562,0.8800715106154359,0.2723575679132426
5323,0.6144,38,91,38,510692,94918,72432,35524,0.8792285746044685,0.2723355974302755
5324,0.6145,33,109,33,510801,94809,72465,35491,0.8782189039979251,0.2723791250959325
5325,0.6146,42,158,42,510959,94651,72507,35449,0.8767553447700915,0.2724750192159877
5326,0.6147,54,195,54,511154,94456,72561,35395,0.8749490533180184,0.27258165127723316
5327,0.6148,18,42,18,511196,94414,72579,35377,0.8745600059283412,0.27256897627724574
5328,0.6149,22,101,22,511297,94313,72601,35355,0.8736244395864982,0.27265786470062003
5329,0.615,27,88,27,511385,94225,72628,35328,0.8728092926747935,0.272691485338047
5330,0.6151,27,89,27,511474,94136,72655,35301,0.8719848827300011,0.2727272727272727
5331,0.6152,19,82,19,511556,94054,72674,35282,0.8712253140168217,0.2727933444671244
5332,0.6153,17,78,17,511634,93976,72691,35265,0.8705027974359925,0.2728623269705434
5333,0.6154,22,72,22,511706,93904,72713,35243,0.8698358590536885,0.2728905820499121
5334,0.6155,24,79,24,511785,93825,72737,35219,0.8691040794397717,0.27292241406032053
5335,0.6156,27,96,27,511881,93729,72764,35192,0.8682148282633666,0.2729733712893943
5336,0.6157,21,88,21,511969,93641,72785,35171,0.8673996813516618,0.2730413315529609
5337,0.6158,44,146,44,512115,93495,72829,35127,0.8660472785208789,0.2731025796520035
5338,0.6159,30,131,30,512246,93364,72859,35097,0.8648338211864093,0.27321132483788857
5339,0.616,30,86,30,512332,93278,72889,35067,0.8640372003408796,0.27322451205734544
5340,0.6161,25,92,25,512424,93186,72914,35042,0.8631850012968246,0.2732788470536856
5341,0.6162,29,97,29,512521,93089,72943,35013,0.8622864870873319,0.2733212596212393
5342,0.6163,38,121,38,512642,92968,72981,34975,0.8611656600837378,0.27336391987056735
5343,0.6164,24,95,24,512737,92873,73005,34951,0.8602856719404202,0.27343065465014393
5344,0.6165,22,105,22,512842,92768,73027,34929,0.859313053466227,0.273530310030776
5345,0.6166,18,40,18,512882,92728,73045,34911,0.8589425321427249,0.2735135812721817
5346,0.6167,21,112,21,512994,92616,73066,34890,0.8579050724369187,0.27363418192085076
5347,0.6168,30,111,30,513105,92505,73096,34860,0.8568768757642002,0.2737015663643858
5348,0.6169,12,32,12,513137,92473,73108,34848,0.8565804587053985,0.27370190306390935
5349,0.617,15,67,15,513204,92406,73123,34833,0.8559598354885324,0.27376040364982435
5350,0.6171,21,72,21,513276,92334,73144,34812,0.8552928971062285,0.2737954792128734
5351,0.6172,19,65,19,513341,92269,73163,34793,0.8546907999555374,0.2738269506225307
5352,0.6173,21,55,21,513396,92214,73184,34772,0.854181333135722,0.27382546107444916
5353,0.6174,21,65,21,513461,92149,73205,34751,0.8535792359850309,0.2738455476753349
5354,0.6175,18,78,18,513539,92071,73223,34733,0.8528567194042017,0.27391091763666764
5355,0.6176,29,120,29,513659,91951,73252,34704,0.8517451554336952,0.2740041845959496
5356,0.6177,51,173,51,513832,91778,73303,34653,0.8501426507095483,0.27408626048991147
5357,0.6178,34,90,34,513922,91688,73337,34619,0.8493089777316685,0.27408615516163
5358,0.6179,58,152,58,514074,91536,73395,34561,0.8479009967023602,0.2740826506578269
5359,0.618,34,112,34,514186,91424,73429,34527,0.8468635369965541,0.27413041579661934
5360,0.6181,19,92,19,514278,91332,73448,34508,0.8460113379524992,0.2742212333121424
5361,0.6182,12,62,12,514340,91270,73460,34496,0.8454370299010708,0.27428716823306776
5362,0.6183,24,101,24,514441,91169,73484,34472,0.8445014635592278,0.27436903558551745
5363,0.6184,32,114,32,514555,91055,73516,34440,0.8434454777872467,0.27443324435236466
5364,0.6185,19,80,19,514635,90975,73535,34421,0.8427044351402423,0.2744983891033207
5365,0.6186,18,65,18,514700,90910,73553,34403,0.8421023379895513,0.27453656045262664
5366,0.6187,18,64,18,514764,90846,73571,34385,0.8415095038719478,0.2745725898539499
5367,0.6188,17,54,17,514818,90792,73588,34368,0.8410093000852199,0.27459252157238734
5368,0.6189,25,82,25,514900,90710,73613,34343,0.8402497313720405,0.27462755791544385
5369,0.619,63,179,63,515079,90531,73676,34280,0.8385916484493683,0.27465527878151763
5370,0.6191,25,76,25,515155,90455,73701,34255,0.8378876579347141,0.274677251222837
5371,0.6192,17,61,17,515216,90394,73718,34238,0.8373226129163733,0.2747127543488029
5372,0.6193,33,131,33,515347,90263,73751,34205,0.8361091555819037,0.27480958961339463
5373,0.6194,15,78,15,515425,90185,73766,34190,0.8353866390010745,0.27489447236180903
5374,0.6195,26,56,26,515481,90129,73792,34164,0.8348679091481714,0.2748666457483527
5375,0.6196,29,110,29,515591,90019,73821,34135,0.8338489755085405,0.27494079932986454
5376,0.6197,36,74,36,515665,89945,73857,34099,0.8331635110600615,0.27489439231240526
5377,0.6198,17,58,17,515723,89887,73874,34082,0.8326262551409833,0.2749235696020779
5378,0.6199,30,117,30,515840,89770,73904,34052,0.8315424802697395,0.2750076723037909
5379,0.62,31,118,31,515958,89652,73935,34021,0.8304494423654081,0.2750883377940213
5380,0.6201,23,64,23,516022,89588,73958,33998,0.8298566082478046,0.2750958846471283
5381,0.6202,22,94,22,516116,89494,73980,33976,0.8289858831375746,0.2751761561512918
5382,0.6203,29,72,29,516188,89422,74009,33947,0.8283189447552707,0.27516637080628037
5383,0.6204,13,37,13,516225,89385,74022,33934,0.8279762125310312,0.2751725200496274
5384,0.6205,23,98,23,516323,89287,74045,33911,0.8270684352884509,0.2752560918196724
5385,0.6206,30,112,30,516435,89175,74075,33881,0.8260309755826448,0.275329931088285
5386,0.6207,24,111,24,516546,89064,74099,33857,0.8250027789099262,0.27543706933721657
5387,0.6208,25,81,25,516627,88983,74124,33832,0.8242524732298344,0.2754712372267231
5388,0.6209,35,94,35,516721,88889,74159,33797,0.8233817481196043,0.27547560438843877
5389,0.621,38,129,38,516850,88760,74197,33759,0.8221868168513098,0.275540936507807
5390,0.6211,28,115,28,516965,88645,74225,33731,0.821121568046241,0.27563411126364645
5391,0.6212,29,97,29,517062,88548,74254,33702,0.8202230538367483,0.275680981595092
5392,0.6213,29,94,29,517156,88454,74283,33673,0.8193523287265182,0.2757211754976377
5393,0.6214,28,77,28,517233,88377,74311,33645,0.8186390751787765,0.27572896690760684
5394,0.6215,36,110,36,517343,88267,74347,33609,0.8176201415391455,0.2757638911680725
5395,0.6216,66,138,66,517481,88129,74413,33543,0.8163418429730631,0.27568380564139655
5396,0.6217,12,48,12,517529,88081,74425,33531,0.8158972173848605,0.27572114593954544
5397,0.6218,18,75,18,517604,88006,74443,33513,0.8152024899032939,0.2757840337724965
5398,0.6219,8,21,8,517625,87985,74451,33505,0.8150079662084553,0.27578401514527945
5399,0.622,13,56,13,517681,87929,74464,33492,0.8144892363555523,0.2758336696288122
5400,0.6221,25,106,25,517787,87823,74489,33467,0.8135073548482715,0.27592546788688266
5401,0.6222,20,63,20,517850,87760,74509,33447,0.8129237837637556,0.27594940886252445
5402,0.6223,18,65,18,517915,87695,74527,33429,0.8123216866130646,0.275989894653413
5403,0.6224,52,213,52,518128,87482,74579,33377,0.8103486605654155,0.2761647870659198
5404,0.6225,35,139,35,518267,87343,74614,33342,0.8090610989662456,0.2762729419563326
5405,0.6226,43,99,43,518366,87244,74657,33299,0.8081440586905776,0.2762416730959077
5406,0.6227,32,87,32,518453,87157,74689,33267,0.8073381748119605,0.2762489204809673
5407,0.6228,22,69,22,518522,87088,74711,33245,0.8066990255289191,0.27627500353186574
5408,0.6229,34,75,34,518597,87013,74745,33211,0.8060042980473526,0.27624268033005056
5409,0.623,16,88,16,518685,86925,74761,33195,0.8051891511356478,0.27634865134865133
5410,0.6231,30,121,30,518806,86804,74791,33165,0.8040683241320538,0.2764464153239587
5411,0.6232,38,147,38,518953,86657,74829,33127,0.8027066582681833,0.2765561343752087
5412,0.6233,15,38,15,518991,86619,74844,33112,0.8023546630108562,0.27655327358829374
5413,0.6234,34,121,34,519112,86498,74878,33078,0.8012338360072622,0.2766274168729511
5414,0.6235,17,74,17,519186,86424,74895,33061,0.8005483715587832,0.27669581955894046
5415,0.6236,41,156,41,519342,86268,74936,33020,0.7991033383971248,0.27680906713164777
5416,0.6237,25,94,25,519436,86174,74961,32995,0.7982326132868947,0.27687569753878943
5417,0.6238,23,114,23,519550,86060,74984,32972,0.7971766275149135,0.27700114254990255
5418,0.6239,28,80,28,519630,85980,75012,32944,0.7964355848679091,0.27701725471729843
5419,0.624,31,71,31,519701,85909,75043,32913,0.7957779095186928,0.27699415933076366
5420,0.6241,32,130,32,519831,85779,75075,32881,0.7945737152173108,0.27710264621607955
5421,0.6242,24,63,24,519894,85716,75099,32857,0.7939901441327949,0.2771035564588903
5422,0.6243,33,105,33,519999,85611,75132,32824,0.7930175256586016,0.27714780259213917
5423,0.6244,41,149,41,520148,85462,75173,32783,0.791637333728556,0.2772463951964142
5424,0.6245,20,85,20,520233,85377,75193,32763,0.790849975916114,0.27732351447435244
5425,0.6246,27,123,27,520356,85254,75220,32736,0.7897106228463449,0.2774472412916349
5426,0.6247,38,106,38,520462,85148,75258,32698,0.788728741339064,0.27746380869948917
5427,0.6248,16,53,16,520515,85095,75274,32682,0.7882378005854237,0.27749051172979444
5428,0.6249,35,152,35,520667,84943,75309,32647,0.7868298195561154,0.27763415256399354
5429,0.625,26,101,26,520768,84842,75335,32621,0.7858942532142725,0.27771298196027683
5430,0.6251,25,80,25,520848,84762,75360,32596,0.7851532105672682,0.2777484278873191
5431,0.6252,41,95,41,520943,84667,75401,32555,0.7842732224239505,0.2777209056320486
5432,0.6253,21,61,21,521004,84606,75422,32534,0.7837081774056097,0.27773604234249616
5433,0.6254,27,104,27,521108,84502,75449,32507,0.782744821964504,0.277816236357887
5434,0.6255,23,69,23,521177,84433,75472,32484,0.7821056726814628,0.2778381244814698
5435,0.6256,32,118,32,521295,84315,75504,32452,0.7810126347771315,0.2779209879503627
5436,0.6257,38,118,38,521413,84197,75542,32414,0.7799195968728,0.2779669156426066
5437,0.6258,14,35,14,521448,84162,75556,32400,0.7795953907147356,0.2779636588253462
5438,0.6259,25,53,25,521501,84109,75581,32375,0.7791044499610953,0.2779351670615707
5439,0.626,33,107,33,521608,84002,75614,32342,0.778113305420727,0.2779859726328818
5440,0.6261,26,99,26,521707,83903,75640,32316,0.7771962651450591,0.27806124643991087
5441,0.6262,21,94,21,521801,83809,75661,32295,0.776325540034829,0.2781557913594708
5442,0.6263,42,142,42,521943,83667,75703,32253,0.7750101893363963,0.2782349896480331
5443,0.6264,38,96,38,522039,83571,75741,32215,0.7741209381599911,0.27822880140949685
5444,0.6265,22,81,22,522120,83490,75763,32193,0.7733706324798992,0.27828635149503383
5445,0.6266,23,78,23,522198,83412,75786,32170,0.77264811589907,0.2783305358965929
5446,0.6267,17,47,17,522245,83365,75803,32153,0.7722127533439549,0.27833757509652174
5447,0.6268,46,138,46,522383,83227,75849,32107,0.7709344547778725,0.27838278391454385
5448,0.6269,27,79,27,522462,83148,75876,32080,0.7702026751639557,0.27840455444857154
5449,0.627,29,115,29,522577,83033,75905,32051,0.7691374263588869,0.27850092106635155
5450,0.6271,37,126,37,522703,82907,75942,32014,0.7679702841898551,0.2785739769058745
5451,0.6272,23,89,23,522792,82818,75965,31991,0.7671458742450628,0.27864540236392615
5452,0.6273,20,52,20,522844,82766,75985,31971,0.76666419652451,0.2786459468175044
5453,0.6274,39,125,39,522969,82641,76024,31932,0.7655063173885657,0.278704406797413
5454,0.6275,21,89,21,523058,82552,76045,31911,0.7646819074437734,0.27878877890672094
5455,0.6276,25,96,25,523154,82456,76070,31886,0.7637926562673681,0.2788651589092372
5456,0.6277,32,133,32,523287,82323,76102,31854,0.7625606728667235,0.2789878872277254
5457,0.6278,24,146,24,523433,82177,76126,31830,0.7612082700359406,0.2791933828624558
5458,0.6279,24,90,24,523523,82087,76150,31806,0.7603745970580607,0.279262114440747
5459,0.628,22,78,22,523601,82009,76172,31784,0.7596520804772314,0.2793141933159333
5460,0.6281,22,71,22,523672,81938,76194,31762,0.7589944051280151,0.279349164467898
5461,0.6282,18,43,18,523715,81895,76212,31744,0.7585960947052502,0.27934071929531235
5462,0.6283,29,87,29,523802,81808,76241,31715,0.7577902108266331,0.27937070021053
5463,0.6284,11,42,11,523844,81766,76252,31704,0.7574011634369558,0.27940424781880674
5464,0.6285,18,60,18,523904,81706,76270,31686,0.7568453814517025,0.2794377028361789
5465,0.6286,26,96,26,524000,81610,76296,31660,0.7559561302752973,0.27950913745916833
5466,0.6287,20,117,20,524117,81493,76316,31640,0.7548723554040535,0.27967082990816117
5467,0.6288,32,108,32,524225,81385,76348,31608,0.7538719478305976,0.27973414282300674
5468,0.6289,16,40,16,524265,81345,76364,31592,0.7535014265070955,0.27973117755917015
5469,0.629,21,58,21,524323,81287,76385,31571,0.7529641705880173,0.2797409133601517
5470,0.6291,38,107,38,524430,81180,76423,31533,0.751973026047649,0.2797636474940779
5471,0.6292,47,123,47,524553,81057,76470,31486,0.7508336729778798,0.2797686217712341
5472,0.6293,56,174,56,524727,80883,76526,31430,0.7492219052206455,0.27984293892959855
5473,0.6294,40,122,40,524849,80761,76566,31390,0.7480918151839638,0.279890504765896
5474,0.6295,33,156,33,525005,80605,76599,31357,0.7466467820223054,0.2800682374377021
5475,0.6296,33,107,33,525112,80498,76632,31324,0.7456556374819371,0.2801237681314947
5476,0.6297,34,107,34,525219,80391,76666,31290,0.7446644929415688,0.2801729927203374
5477,0.6298,26,60,26,525279,80331,76692,31264,0.7441087109563156,0.2801559209642009
5478,0.6299,20,90,20,525369,80241,76712,31244,0.7432750379784356,0.2802529488271965
5479,0.63,17,95,17,525464,80146,76729,31227,0.7423950498351181,0.28038213929767536
5480,0.6301,30,91,30,525555,80055,76759,31197,0.7415521138241505,0.2804174306978751
5481,0.6302,34,93,34,525648,79962,76793,31163,0.740690651747008,0.28043194600674914
5482,0.6303,42,153,42,525801,79809,76835,31121,0.7392734076846122,0.2805462904534391
5483,0.6304,19,92,19,525893,79717,76854,31102,0.7384212086405573,0.2806558442144398
5484,0.6305,33,99,33,525992,79618,76887,31069,0.7375041683648894,0.28069240290187647
5485,0.6306,36,77,36,526069,79541,76923,31033,0.7367909148171478,0.2806536798885814
5486,0.6307,23,74,23,526143,79467,76946,31010,0.7361054503686687,0.28069190872308264
5487,0.6308,42,131,42,526274,79336,76988,30968,0.7348919930341992,0.28075137800986366
5488,0.6309,15,69,15,526343,79267,77003,30953,0.7342528437511578,0.28082925058972963
5489,0.631,28,97,28,526440,79170,77031,30925,0.7333543295416651,0.28089377355919887
5490,0.6311,41,124,41,526564,79046,77072,30884,0.7322057134388084,0.28094241790230146
5491,0.6312,28,93,28,526657,78953,77100,30856,0.7313442513616658,0.28099700388857013
5492,0.6313,32,117,32,526774,78836,77132,30824,0.730260476490422,0.28108699616997995
5493,0.6314,21,75,21,526849,78761,77153,30803,0.7295657490088555,0.2811416158592238
5494,0.6315,19,71,19,526920,78690,77172,30784,0.7289080736596392,0.2811991888484937
5495,0.6316,23,64,23,526984,78626,77195,30761,0.7283152395420357,0.2812125755345699
5496,0.6317,28,78,28,527062,78548,77223,30733,0.7275927229612065,0.28122912491649965
5497,0.6318,22,56,22,527118,78492,77245,30711,0.7270739931083033,0.2812285376775363
5498,0.6319,21,67,21,527185,78425,77266,30690,0.7264533698914373,0.2812628877789488
5499,0.632,13,73,13,527258,78352,77279,30677,0.7257771684760458,0.2813655082592705
5500,0.6321,24,80,24,527338,78272,77303,30653,0.7250361258290414,0.281413816846454
5501,0.6322,34,116,34,527454,78156,77337,30619,0.7239616139908852,0.2814893128016548
5502,0.6323,15,74,15,527528,78082,77352,30604,0.7232761495424062,0.2815818044642364
5503,0.6324,32,105,32,527633,77977,77384,30572,0.722303531068213,0.28164239191517193
5504,0.6325,24,78,24,527711,77899,77408,30548,0.7215810144873838,0.28168598485896335
5505,0.6326,43,138,43,527849,77761,77451,30505,0.7203027159213012,0.28175973989987624
5506,0.6327,43,166,43,528015,77595,77494,30462,0.7187650524287673,0.28190677142619175
5507,0.6328,40,128,40,528143,77467,77534,30422,0.7175793841935604,0.28197499281669125
5508,0.6329,29,66,29,528209,77401,77563,30393,0.7169680240097818,0.2819544687088335
5509,0.633,25,69,25,528278,77332,77588,30368,0.7163288747267406,0.2819684308263695
5510,0.6331,16,66,16,528344,77266,77604,30352,0.715717514542962,0.2820346038766749
5511,0.6332,35,121,35,528465,77145,77639,30317,0.7145966875393679,0.28211833020044297
5512,0.6333,29,100,29,528565,77045,77668,30288,0.7136703842306125,0.2821872117615272
5513,0.6334,22,52,22,528617,76993,77690,30266,0.7131887065100596,0.28217678702952664
5514,0.6335,20,78,20,528695,76915,77710,30246,0.7124661899292304,0.2822482059704557
5515,0.6336,24,74,24,528769,76841,77734,30222,0.7117807254807514,0.2822823944780176
5516,0.6337,42,117,42,528886,76724,77776,30180,0.7106969506095075,0.28230936167028364
5517,0.6338,19,82,19,528968,76642,77795,30161,0.7099373818963282,0.2823984345009035
5518,0.6339,42,131,42,529099,76511,77837,30119,0.7087239245618585,0.2824627215605364
5519,0.634,12,28,12,529127,76483,77849,30107,0.708464559635407,0.2824561403508772
5520,0.6341,27,112,27,529239,76371,77876,30080,0.707427099929601,0.2825713238955012
5521,0.6342,23,110,23,529349,76261,77899,30057,0.7064081662899699,0.2827084783385692
5522,0.6343,33,103,33,529452,76158,77932,30024,0.7054540738819519,0.2827597897948805
5523,0.6344,33,87,33,529539,76071,77965,29991,0.7046481900033347,0.28276856932737454
5524,0.6345,33,136,33,529675,75935,77998,29958,0.7033884175034273,0.2829082186735667
5525,0.6346,17,50,17,529725,75885,78015,29941,0.7029252658490496,0.28292669098331225
5526,0.6347,19,81,19,529806,75804,78034,29922,0.7021749601689578,0.28301458487032516
5527,0.6348,29,103,29,529909,75701,78063,29893,0.7012208677609396,0.2830937363865371
5528,0.6349,39,142,39,530051,75559,78102,29854,0.6999055170625069,0.28320985077741834
5529,0.635,22,73,22,530124,75486,78124,29832,0.6992293156471155,0.28325642340340684
5530,0.6351,18,69,18,530193,75417,78142,29814,0.6985901663640742,0.2833195541237848
5531,0.6352,6,17,6,530210,75400,78148,29808,0.6984326948015859,0.28332446201809747
5532,0.6353,25,70,25,530280,75330,78173,29783,0.697784282485457,0.28334268834492404
5533,0.6354,27,97,27,530377,75233,78200,29756,0.6968857682759643,0.2834201678271057
5534,0.6355,19,59,19,530436,75174,78219,29737,0.6963392493237985,0.28344978124314896
5535,0.6356,39,93,39,530529,75081,78258,29698,0.6954777872466561,0.28343465770812853
5536,0.6357,19,66,19,530595,75015,78277,29679,0.6948664270628775,0.28348329417158574
5537,0.6358,13,53,13,530648,74962,78290,29666,0.6943754863092371,0.2835378674924494
5538,0.6359,17,46,17,530694,74916,78307,29649,0.6939493867872096,0.28354611963850235
5539,0.636,37,102,37,530796,74814,78344,29612,0.6930045574122791,0.28356922605481394
5540,0.6361,10,47,10,530843,74767,78354,29602,0.6925691948571641,0.28362828042809646
5541,0.6362,33,117,33,530960,74650,78387,29569,0.6914854199859202,0.28371985914276665
5542,0.6363,20,90,20,531050,74560,78407,29549,0.6906517470080403,0.2838275269189023
5543,0.6364,21,80,21,531130,74480,78428,29528,0.689910704361036,0.2839012383662795
5544,0.6365,23,69,23,531199,74411,78451,29505,0.6892715550779948,0.28393125216521037
5545,0.6366,27,133,27,531332,74278,78478,29478,0.6880395716773501,0.28410887081229036
5546,0.6367,23,68,23,531400,74210,78501,29455,0.6874096854273963,0.284136400906767
5547,0.6368,26,41,26,531441,74169,78527,29429,0.6870299010708066,0.2840691905249136
5548,0.6369,57,167,57,531608,74002,78584,29372,0.685482974545185,0.2841333410722232
5549,0.637,45,125,45,531733,73877,78629,29327,0.6843250954092408,0.28416534242858804
5550,0.6371,30,131,30,531864,73746,78659,29297,0.6831116380747712,0.2843181972574556
5551,0.6372,26,118,26,531982,73628,78685,29271,0.6820186001704398,0.28446340586400254
5552,0.6373,49,100,49,532082,73528,78734,29222,0.6810922968616844,0.28439902676399026
5553,0.6374,17,90,17,532172,73438,78751,29205,0.6802586238838045,0.28452987539335367
5554,0.6375,35,137,35,532309,73301,78786,29170,0.6789895883508096,0.28466590547569554
5555,0.6376,65,193,65,532502,73108,78851,29105,0.6772018229649116,0.28474851535518964
5556,0.6377,50,119,50,532621,72989,78901,29055,0.6760995220274927,0.28473011642036766
5557,0.6378,49,154,49,532775,72835,78950,29006,0.6746730149320094,0.2848165277245903
5558,0.6379,25,71,25,532846,72764,78975,28981,0.674015339582793,0.28483954985502974
5559,0.638,11,48,11,532894,72716,78986,28970,0.6735707139945903,0.28489664260566844
5560,0.6381,30,101,30,532995,72615,79016,28940,0.6726351476527475,0.2849687361528236
5561,0.6382,33,77,33,533072,72538,79049,28907,0.6719218941050057,0.28495243728128544
5562,0.6383,35,102,35,533174,72436,79084,28872,0.6709770647300752,0.28499230070675563
5563,0.6384,22,85,22,533259,72351,79106,28850,0.6701897069176331,0.28507623442456104
5564,0.6385,15,38,15,533297,72313,79121,28835,0.669837711660306,0.28507731245303913
5565,0.6386,27,90,27,533387,72223,79148,28808,0.6690040386824262,0.2851402044916907
5566,0.6387,13,52,13,533439,72171,79161,28795,0.6685223609618733,0.2851950161440485
5567,0.6388,46,104,46,533543,72067,79207,28749,0.6675590055207677,0.28516306935407076
5568,0.6389,12,74,12,533617,71993,79219,28737,0.6668735410722887,0.2852874019656507
5569,0.639,16,41,16,533658,71952,79235,28721,0.666493756715699,0.28528999831136453
5570,0.6391,13,56,13,533714,71896,79248,28708,0.665975026862796,0.28535644705975904
5571,0.6392,30,98,30,533812,71798,79278,28678,0.6650672496202157,0.28542139416378043
5572,0.6393,40,117,40,533929,71681,79318,28638,0.6639834747489718,0.28546935276468066
5573,0.6394,15,64,15,533993,71617,79333,28623,0.6633906406313683,0.28554469273743016
5574,0.6395,14,44,14,534037,71573,79347,28609,0.6629830671755159,0.28557026212293624
5575,0.6396,20,57,20,534094,71516,79367,28589,0.6624550742895253,0.2855901303631187
5576,0.6397,30,61,30,534155,71455,79397,28559,0.6618900292711846,0.28555002299678045
5577,0.6398,41,129,41,534284,71326,79438,28518,0.6606950980028901,0.2856255758984015
5578,0.6399,20,70,20,534354,71256,79458,28498,0.6600466856867613,0.2856827796379093
5579,0.64,13,66,13,534420,71190,79471,28485,0.6594353255029827,0.28577878103837473
5580,0.6401,55,130,55,534550,71060,79526,28430,0.6582311312016007,0.2857573625489999
5581,0.6402,40,118,40,534668,70942,79566,28390,0.6571380932972692,0.2858092054926912
5582,0.6403,27,88,27,534756,70854,79593,28363,0.6563229463855645,0.2858683491740327
5583,0.6404,58,150,58,534906,70704,79651,28305,0.6549334914224314,0.285883101536224
5584,0.6405,28,100,28,535006,70604,79679,28277,0.654007188113676,0.28597000434866154
5585,0.6406,37,61,37,535067,70543,79716,28240,0.6534421430953351,0.2858791492463278
5586,0.6407,27,94,27,535161,70449,79743,28213,0.6525714179851051,0.28595609251788934
5587,0.6408,45,105,45,535266,70344,79788,28168,0.6515987995109118,0.28593470846191327
5588,0.6409,34,123,34,535389,70221,79822,28134,0.6504594464411427,0.28604544761323775
5589,0.641,34,82,34,535471,70139,79856,28100,0.6496998777279632,0.28603711356996714
5590,0.6411,36,96,36,535567,70043,79892,28064,0.6488106265515581,0.28605502155809476
5591,0.6412,24,55,24,535622,69988,79916,28040,0.6483011597317425,0.2860407230587179
5592,0.6413,25,82,25,535704,69906,79941,28015,0.6475415910185631,0.28609797694059497
5593,0.6414,29,95,29,535799,69811,79970,27986,0.6466616028752454,0.2861641972657648
5594,0.6415,32,110,32,535909,69701,80002,27954,0.6456426692356145,0.28625262403358764
5595,0.6416,26,86,26,535995,69615,80028,27928,0.6448460483900849,0.28631475349333113
5596,0.6417,20,63,20,536058,69552,80048,27908,0.644262477305569,0.2863533757438949
5597,0.6418,36,110,36,536168,69442,80084,27872,0.643243543665938,0.286413054647841
5598,0.6419,8,60,8,536228,69382,80092,27864,0.6426877616806848,0.2865310655451124
5599,0.642,33,124,33,536352,69258,80125,27831,0.641539145577828,0.28665451286963506
5600,0.6421,28,118,28,536470,69140,80153,27803,0.6404461076734966,0.2867973964081986
5601,0.6422,26,86,26,536556,69054,80179,27777,0.639649486827967,0.2868606128202745
5602,0.6423,19,96,19,536652,68958,80198,27758,0.6387602356515617,0.28700525249183173
5603,0.6424,21,46,21,536698,68912,80219,27737,0.6383341361295343,0.2869869320944862
5604,0.6425,17,72,17,536770,68840,80236,27720,0.6376671977472304,0.2870753935376968
5605,0.6426,40,80,40,536850,68760,80276,27680,0.636926155100226,0.2870178349232684
5606,0.6427,22,70,22,536920,68690,80298,27658,0.6362777427840972,0.28706356125710963
5607,0.6428,37,106,37,537026,68584,80335,27621,0.6352958612768165,0.2871056597889923
5608,0.6429,20,46,20,537072,68538,80355,27601,0.634869761754789,0.2870947274259146
5609,0.643,32,77,32,537149,68461,80387,27569,0.6341565082070473,0.2870873685306675
5610,0.6431,19,73,19,537222,68388,80406,27550,0.6334803067916559,0.28716462715503766
5611,0.6432,27,98,27,537320,68290,80433,27523,0.6325725295490755,0.28725747028065085
5612,0.6433,31,106,31,537426,68184,80464,27492,0.6315906480417948,0.28734478866173335
5613,0.6434,36,137,36,537563,68047,80500,27456,0.6303216125087999,0.28748835115127275
5614,0.6435,19,63,19,537626,67984,80519,27437,0.629738041424284,0.28753628656165836
5615,0.6436,27,102,27,537728,67882,80546,27410,0.6287932120493535,0.28764219451790285
5616,0.6437,29,114,29,537842,67768,80575,27381,0.6277372262773723,0.28776970856236006
5617,0.6438,15,84,15,537926,67684,80590,27366,0.6269591314980177,0.28791162546028404
5618,0.6439,27,81,27,538007,67603,80617,27339,0.6262088258179258,0.28795475132185966
5619,0.644,16,70,16,538077,67533,80633,27323,0.625560413501797,0.28804714514632707
5620,0.6441,42,90,42,538167,67443,80675,27281,0.6247267405239172,0.2880051518094675
5621,0.6442,11,36,11,538203,67407,80686,27270,0.6243932713327652,0.28803194017554423
5622,0.6443,15,62,15,538265,67345,80701,27255,0.6238189632813368,0.288107822410148
5623,0.6444,12,46,12,538311,67299,80713,27243,0.6233928637593094,0.28815764422161577
5624,0.6445,30,76,30,538387,67223,80743,27213,0.6226888732446553,0.2881634122580372
5625,0.6446,23,84,23,538471,67139,80766,27190,0.6219107784653006,0.28824645655100767
5626,0.6447,26,61,26,538532,67078,80792,27164,0.6213457334469599,0.2882366673033255
5627,0.6448,27,125,27,538657,66953,80819,27137,0.6201878543110156,0.28841534700818366
5628,0.6449,33,102,33,538759,66851,80852,27104,0.6192430249360851,0.2884785269543931
5629,0.645,9,42,9,538801,66809,80861,27095,0.6188539775464078,0.2885393593457148
5630,0.6451,39,100,39,538901,66709,80900,27056,0.6179276742376524,0.2885511651469098
5631,0.6452,28,80,28,538981,66629,80928,27028,0.617186631590648,0.28858494293005327
5632,0.6453,29,96,29,539077,66533,80957,26999,0.6162973804142429,0.2886605653680024
5633,0.6454,25,106,25,539183,66427,80982,26974,0.6153154989069621,0.2887977644778964
5634,0.6455,21,53,21,539236,66374,81003,26953,0.6148245581533217,0.28880174011807946
5635,0.6456,18,59,18,539295,66315,81021,26935,0.614278039201156,0.2888471849865952
5636,0.6457,35,122,35,539417,66193,81056,26900,0.6131479491644745,0.2889583534744825
5637,0.6458,34,97,34,539514,66096,81090,26866,0.6122494349549816,0.2889998063724963
5638,0.6459,28,70,28,539584,66026,81118,26838,0.6116010226388529,0.28900327360441075
5639,0.646,39,79,39,539663,65947,81157,26799,0.6108692430249361,0.2889504668664956
5640,0.6461,44,105,44,539768,65842,81201,26755,0.6098966245507429,0.28894024644426924
5641,0.6462,26,108,26,539876,65734,81227,26729,0.608896216977287,0.28907779327947397
5642,0.6463,11,47,11,539923,65687,81238,26718,0.608460854422172,0.28914019804123153
5643,0.6464,24,83,24,540006,65604,81262,26694,0.607692022675905,0.28921536761359945
5644,0.6465,23,63,23,540069,65541,81285,26671,0.607108451591389,0.2892356743157073
5645,0.6466,22,50,22,540119,65491,81307,26649,0.6066452999370113,0.2892229216409811
5646,0.6467,23,85,23,540204,65406,81330,26626,0.6058579421245692,0.28931241307371347
5647,0.6468,18,51,18,540255,65355,81348,26608,0.605385527437104,0.28933375379228604
5648,0.6469,20,91,20,540346,65264,81368,26588,0.6045425914261365,0.2894656621521578
5649,0.647,33,124,33,540470,65140,81401,26555,0.6033939753232799,0.28960139593216644
5650,0.6471,31,116,31,540586,65024,81432,26524,0.6023194634851236,0.28972779307030194
5651,0.6472,11,36,11,540622,64988,81443,26513,0.6019859942939716,0.2897563961049606
5652,0.6473,29,123,29,540745,64865,81472,26484,0.6008466412242025,0.2899210719329166
5653,0.6474,25,63,25,540808,64802,81497,26459,0.6002630701396865,0.28992669376842245
5654,0.6475,26,75,26,540883,64727,81523,26433,0.59956834265812,0.2899627029398859
5655,0.6476,18,72,18,540955,64655,81541,26415,0.5989014042758161,0.29005160865268476
5656,0.6477,52,111,52,541066,64544,81593,26363,0.5978732076030976,0.28999966999240984
5657,0.6478,28,65,28,541131,64479,81621,26335,0.5972711104524066,0.28998832779086925
5658,0.6479,28,71,28,541202,64408,81649,26307,0.5966134351031902,0.2899961417626633
5659,0.648,30,66,30,541268,64342,81679,26277,0.5960020749194116,0.2899723016144517
5660,0.6481,20,112,20,541380,64230,81699,26257,0.5949646152136056,0.29017427917822447
5661,0.6482,38,98,38,541478,64132,81737,26219,0.5940568379710253,0.2901904793527465
5662,0.6483,50,162,50,541640,63970,81787,26169,0.5925562266108415,0.29031828620242073
5663,0.6484,27,61,27,541701,63909,81814,26142,0.5919911815925006,0.2903021621081387
5664,0.6485,31,77,31,541778,63832,81845,26111,0.591277928044759,0.2903060827412917
5665,0.6486,49,111,49,541889,63721,81894,26062,0.5902497313720405,0.29027766949199735
5666,0.6487,26,86,26,541975,63635,81920,26036,0.5894531105265108,0.29035028046971706
5667,0.6488,31,98,31,542073,63537,81951,26005,0.5885453332839304,0.2904223716244891
5668,0.6489,36,113,36,542186,63424,81987,25969,0.5874986105450368,0.2905037307171702
5669,0.649,41,80,41,542266,63344,82028,25928,0.5867575678980326,0.2904382113092571
5670,0.6491,19,74,19,542340,63270,82047,25909,0.5860721034495535,0.2905280391123471
5671,0.6492,32,111,32,542451,63159,82079,25877,0.585043906776835,0.29063524866346196
5672,0.6493,24,59,24,542510,63100,82103,25853,0.5844973878246693,0.2906366283318157
5673,0.6494,19,65,19,542575,63035,82122,25834,0.5838952906739783,0.290697543575375
5674,0.6495,19,65,19,542640,62970,82141,25815,0.5832931935232872,0.29075857408346006
5675,0.6496,46,117,46,542757,62853,82187,25769,0.5822094186520435,0.2907742998352554
5676,0.6497,41,119,41,542876,62734,82228,25728,0.5811071177146244,0.2908367434604689
5677,0.6498,25,63,25,542939,62671,82253,25703,0.5805235466301085,0.29084346074637335
5678,0.6499,27,61,27,543000,62610,82280,25676,0.5799585016117678,0.2908275377749587
5679,0.65,42,86,42,543086,62524,82322,25634,0.5791618807662381,0.2907733841511831
5680,0.6501,19,51,19,543137,62473,82341,25615,0.5786894660787728,0.2907887566978476
5681,0.6502,17,56,17,543193,62417,82358,25598,0.5781707362258698,0.2908367891836619
5682,0.6503,31,124,31,543317,62293,82389,25567,0.5770221201230131,0.2909970407466424
5683,0.6504,39,143,39,543460,62150,82428,25528,0.5756975063914929,0.2911562763749173
5684,0.6505,16,70,16,543530,62080,82444,25512,0.5750490940753641,0.29125947575121014
5685,0.6506,14,62,14,543592,62018,82458,25498,0.5744747860239356,0.29135243841126196
5686,0.6507,42,107,42,543699,61911,82500,25456,0.5734836414835673,0.2913685945494294
5687,0.6508,28,80,28,543779,61831,82528,25428,0.5727425988365631,0.2914083361028662
5688,0.6509,30,124,30,543903,61707,82558,25398,0.5715939827337063,0.29157912863785085
5689,0.651,46,128,46,544031,61579,82604,25352,0.5704083144984994,0.291633594459974
5690,0.6511,21,60,21,544091,61519,82625,25331,0.5698525325132462,0.29166378814047206
5691,0.6512,19,61,19,544152,61458,82644,25312,0.5692874874949053,0.2917137259421459
5692,0.6513,20,70,20,544222,61388,82664,25292,0.5686390751787765,0.2917858790955238
5693,0.6514,34,99,34,544321,61289,82698,25258,0.5677220349031087,0.291841427201405
5694,0.6515,32,119,32,544440,61170,82730,25226,0.5666197339656898,0.291981110236585
5695,0.6516,25,101,25,544541,61069,82755,25201,0.5656841676238468,0.29211776979251186
5696,0.6517,19,52,19,544593,61017,82774,25182,0.5652024899032939,0.2921379598371211
5697,0.6518,38,101,38,544694,60916,82812,25144,0.5642669235614509,0.29216825470601904
5698,0.6519,27,109,27,544803,60807,82839,25117,0.5632572529549076,0.2923164657138867
5699,0.652,20,49,20,544852,60758,82859,25097,0.5628033643336174,0.29231844388795064
5700,0.6521,20,46,20,544898,60712,82879,25077,0.5623772648115899,0.29231020293977084
5701,0.6522,23,63,23,544961,60649,82902,25054,0.561793693727074,0.29233515746239924
5702,0.6523,19,67,19,545028,60582,82921,25035,0.5611730705102078,0.29240688181085533
5703,0.6524,28,123,28,545151,60459,82949,25007,0.5600337174404387,0.2925958860833548
5704,0.6525,14,54,14,545205,60405,82963,24993,0.5595335136537107,0.29266493360500245
5705,0.6526,34,111,34,545316,60294,82997,24959,0.5585053169809923,0.2927638910067681
5706,0.6527,23,58,23,545374,60236,83020,24936,0.5579680610619141,0.2927722725778425
5707,0.6528,34,88,34,545462,60148,83054,24902,0.5571529141502094,0.29279247501469724
5708,0.6529,9,38,9,545500,60110,83063,24893,0.5568009188928823,0.2928484877004341
5709,0.653,50,151,50,545651,59959,83113,24843,0.5554022008966616,0.29295299639159456
5710,0.6531,28,59,28,545710,59900,83141,24815,0.5548556819444959,0.29292333116921443
5711,0.6532,22,68,22,545778,59832,83163,24793,0.5542257956945422,0.29297488921713444
5712,0.6533,23,98,23,545876,59734,83186,24770,0.5533180184519619,0.29312221906655306
5713,0.6534,25,59,25,545935,59675,83211,24745,0.5527714994997962,0.29311774461028195
5714,0.6535,21,90,21,546025,59585,83232,24724,0.5519378265219164,0.29325457543085554
5715,0.6536,34,72,34,546097,59513,83266,24690,0.5512708881396124,0.2932199565336152
5716,0.6537,13,50,13,546147,59463,83279,24677,0.5508077364852347,0.2932850011884954
5717,0.6538,11,48,11,546195,59415,83290,24666,0.5503631108970322,0.2933599743104863
5718,0.6539,32,77,32,546272,59338,83322,24634,0.5496498573492905,0.29335969132567996
5719,0.654,49,116,49,546388,59222,83371,24585,0.5485753455111342,0.2933525839130383
5720,0.6541,18,42,18,546430,59180,83389,24567,0.5481862981214569,0.29334782141449844
5721,0.6542,44,111,44,546541,59069,83433,24523,0.5471581014487383,0.2933653938175902
5722,0.6543,28,80,28,546621,58989,83461,24495,0.5464170588017341,0.2934095155958028
5723,0.6544,32,68,32,546689,58921,83493,24463,0.5457871725517803,0.2933776264031469
5724,0.6545,33,110,33,546799,58811,83526,24430,0.5447682389121494,0.29348518158119197
5725,0.6546,24,78,24,546877,58733,83550,24406,0.5440457223313202,0.2935565739304057
5726,0.6547,22,82,22,546959,58651,83572,24384,0.5432861536181407,0.2936593002950563
5727,0.6548,27,67,27,547026,58584,83599,24357,0.5426655304012746,0.29366658226932396
5728,0.6549,14,70,14,547096,58514,83613,24343,0.5420171180851459,0.29379533412988645
5729,0.655,51,132,51,547228,58382,83664,24292,0.5407943977175886,0.29382877325398554
5730,0.6551,32,60,32,547288,58322,83696,24260,0.5402386157323354,0.29376861785861325
5731,0.6552,16,48,16,547336,58274,83712,24244,0.5397939901441328,0.2938025642890036
5732,0.6553,54,124,54,547460,58150,83766,24190,0.5386453740412761,0.29378188000971583
5733,0.6554,9,36,9,547496,58114,83775,24181,0.5383119048501241,0.2938331611884076
5734,0.6555,28,70,28,547566,58044,83803,24153,0.5376634925339954,0.2938428409795978
5735,0.6556,24,81,24,547647,57963,83827,24129,0.5369131868539034,0.2939263265604444
5736,0.6557,24,63,24,547710,57900,83851,24105,0.5363296157693875,0.2939454911285897
5737,0.6558,33,88,33,547798,57812,83884,24072,0.5355144688576827,0.2939768452933418
5738,0.6559,30,119,30,547917,57693,83914,24042,0.5344121679202638,0.2941457148100569
5739,0.656,16,53,16,547970,57640,83930,24026,0.5339212271666235,0.2941983199862856
5740,0.6561,43,123,43,548093,57517,83973,23983,0.5327818740968543,0.29426993865030676
5741,0.6562,12,45,12,548138,57472,83985,23971,0.5323650376079143,0.29432854880100195
5742,0.6563,43,93,43,548231,57379,84028,23928,0.5315035755307718,0.2942920043784668
5743,0.6564,30,66,30,548297,57313,84058,23898,0.5308922153469933,0.2942704805999187
5744,0.6565,19,70,19,548367,57243,84077,23879,0.5302438030308644,0.29435911343408694
5745,0.6566,50,103,50,548470,57140,84127,23829,0.5292897106228464,0.29429781768331087
5746,0.6567,42,78,42,548548,57062,84169,23787,0.5285671940420171,0.2942151418075672
5747,0.6568,38,90,38,548638,56972,84207,23749,0.5277335210641373,0.2942109240470262
5748,0.6569,8,30,8,548668,56942,84215,23741,0.5274556300715106,0.2942503377415317
5749,0.657,20,70,20,548738,56872,84235,23721,0.5268072177553819,0.2943307731440696
5750,0.6571,21,76,21,548814,56796,84256,23700,0.5261032272407277,0.2944245676803816
5751,0.6572,33,101,33,548915,56695,84289,23667,0.5251676608988848,0.2945048654836863
5752,0.6573,35,134,35,549049,56561,84324,23632,0.5239264144651524,0.2946890626363897
5753,0.6574,26,55,26,549104,56506,84350,23606,0.523416947645337,0.2946624725384462
5754,0.6575,34,75,34,549179,56431,84384,23572,0.5227222201637705,0.294638951039336
5755,0.6576,16,71,16,549250,56360,84400,23556,0.5220645448145541,0.294759497472346
5756,0.6577,22,77,22,549327,56283,84422,23534,0.5213512912668125,0.29484946815841234
5757,0.6578,30,87,30,549414,56196,84452,23504,0.5205454073881952,0.2949058971141782
5758,0.6579,23,120,23,549534,56076,84475,23481,0.5194338434176887,0.29514687582488025
5759,0.658,16,50,16,549584,56026,84491,23465,0.518970691763311,0.29519065051389465
5760,0.6581,32,80,32,549664,55946,84523,23433,0.5182296491163066,0.2952040212146789
5761,0.6582,33,74,33,549738,55872,84556,23400,0.5175441846678276,0.29518619436875565
5762,0.6583,22,71,22,549809,55801,84578,23378,0.5168865093186112,0.2952550550019576
5763,0.6584,16,67,16,549876,55734,84594,23362,0.5162658861017452,0.29536259735005566
5764,0.6585,23,62,23,549938,55672,84617,23339,0.5156915780503168,0.2953892495981572
5765,0.6586,25,65,25,550003,55607,84642,23314,0.5150894808996258,0.2954093333840169
5766,0.6587,39,85,39,550088,55522,84681,23275,0.5143021230871837,0.2953792657080853
5767,0.6588,22,85,22,550173,55437,84703,23253,0.5135147652747416,0.29550133434998094
5768,0.6589,25,60,25,550233,55377,84728,23228,0.5129589832894883,0.2955028306087399
5769,0.659,22,85,22,550318,55292,84750,23206,0.5121716254770462,0.2956253662513695
5770,0.6591,27,73,27,550391,55219,84777,23179,0.5114954240616547,0.2956580525013393
5771,0.6592,37,89,37,550480,55130,84814,23142,0.5106710141168624,0.2956612837285364
5772,0.6593,28,92,28,550572,55038,84842,23114,0.5098188150728075,0.2957569863855052
5773,0.6594,35,110,35,550682,54928,84877,23079,0.5087998814331764,0.2958580640198957
5774,0.6595,29,56,29,550738,54872,84906,23050,0.5082811515802734,0.2958086291419625
5775,0.6596,44,109,44,550847,54763,84950,23006,0.5072714809737301,0.29582481451478093
5776,0.6597,31,94,31,550941,54669,84981,22975,0.5064007558635,0.2959018082530524
5777,0.6598,18,42,18,550983,54627,84999,22957,0.5060117084738227,0.2958986388946174
5778,0.6599,29,106,29,551089,54521,85028,22928,0.505029826966542,0.2960399746930238
5779,0.66,21,89,21,551178,54432,85049,22907,0.5042054170217496,0.2961895033553576
5780,0.6601,39,87,39,551265,54345,85088,22868,0.5033995331431323,0.29616774377371685
5781,0.6602,31,98,31,551363,54247,85119,22837,0.5024917559005521,0.2962612215245706
5782,0.6603,54,160,54,551523,54087,85173,22783,0.5010096706065434,0.2963835046181865
5783,0.6604,14,37,14,551560,54050,85187,22769,0.5006669383823039,0.29639802652989494
5784,0.6605,22,78,22,551638,53972,85209,22747,0.4999444218014747,0.2964976081544337
5785,0.6606,18,51,18,551689,53921,85227,22729,0.4994720071140094,0.2965296803652968
5786,0.6607,17,39,17,551728,53882,85244,22712,0.4991107488235948,0.29652453194767214
5787,0.6608,38,81,38,551809,53801,85282,22674,0.4983604431435029,0.29648904870872833
5788,0.6609,20,89,20,551898,53712,85302,22654,0.4975360331987106,0.29665034177513555
5789,0.661,25,76,25,551974,53636,85327,22629,0.49683204268405645,0.29671540024913134
5790,0.6611,23,46,23,552020,53590,85350,22606,0.49640594316202896,0.29668224053756104
5791,0.6612,25,69,25,552089,53521,85375,22581,0.49576679387898775,0.29672019132217287
5792,0.6613,13,59,13,552148,53462,85388,22568,0.495220274926822,0.2968301986058135
5793,0.6614,31,89,31,552237,53373,85419,22537,0.4943958649820297,0.29689105519694375
5794,0.6615,28,73,28,552310,53300,85447,22509,0.49371966356663827,0.2969172525689562
5795,0.6616,35,73,35,552383,53227,85482,22474,0.4930434621512468,0.29687850887042444
5796,0.6617,37,104,37,552487,53123,85519,22437,0.4920801067101412,0.29694282689253576
5797,0.6618,30,67,30,552554,53056,85549,22407,0.49145948349327506,0.29692697083338854
5798,0.6619,15,61,15,552615,52995,85564,22392,0.49089443847493425,0.29702733893111544
5799,0.662,17,65,17,552680,52930,85581,22375,0.4902923413242432,0.2971250248987451
5800,0.6621,27,85,27,552765,52845,85608,22348,0.4895049835118011,0.2972085167502294
5801,0.6622,26,65,26,552830,52780,85634,22322,0.48890288636111007,0.2972224441426327
5802,0.6623,23,51,23,552881,52729,85657,22299,0.48843047167364484,0.2972090419576691
5803,0.6624,37,81,37,552962,52648,85694,22262,0.4876801659935529,0.2971832866105994
5804,0.6625,31,85,31,553047,52563,85725,22231,0.4868928081811108,0.29722972430943656
5805,0.6626,40,110,40,553157,52453,85765,22191,0.48587387454147984,0.2972911419538074
5806,0.6627,35,89,35,553246,52364,85800,22156,0.4850494645966875,0.29731615673644657
5807,0.6628,33,91,33,553337,52273,85833,22123,0.4842065285857201,0.29736813807193935
5808,0.6629,33,84,33,553421,52189,85866,22090,0.4834284338063656,0.2973922643008118
5809,0.663,37,129,37,553550,52060,85903,22053,0.48223350253807107,0.2975591326757789
5810,0.6631,18,45,18,553595,52015,85921,22035,0.48181666604913115,0.2975692099932478
5811,0.6632,23,70,23,553665,51945,85944,22012,0.4811682537330023,0.297632408020877
5812,0.6633,18,65,18,553730,51880,85962,21994,0.48056615658231133,0.2977231502287679
5813,0.6634,23,76,23,553806,51804,85985,21971,0.4798621660676572,0.29781091155540496
5814,0.6635,17,81,17,553887,51723,86002,21954,0.4791118603875653,0.29797630196669245
5815,0.6636,29,54,29,553941,51669,86031,21925,0.4786116566008374,0.29791830855776286
5816,0.6637,29,81,29,554022,51588,86060,21896,0.4778613509207455,0.29796962604104293
5817,0.6638,42,97,42,554119,51491,86102,21854,0.4769628367112527,0.29796168791328653
5818,0.6639,15,30,15,554149,51461,86117,21839,0.47668494571862613,0.2979399727148704
5819,0.664,32,71,32,554220,51390,86149,21807,0.4760272703694098,0.2979220459854912
5820,0.6641,16,34,16,554254,51356,86165,21791,0.4757123272444329,0.2979069544889059
5821,0.6642,26,67,26,554321,51289,86191,21765,0.4750917040275668,0.2979302981356257
5822,0.6643,45,97,45,554418,51192,86236,21720,0.474193189818074,0.2978933508887426
5823,0.6644,23,66,23,554484,51126,86259,21697,0.47358182963429546,0.29794158438954726
5824,0.6645,61,164,61,554648,50962,86320,21636,0.47206269220793656,0.29802473897352544
5825,0.6646,18,55,18,554703,50907,86338,21618,0.4715532253881211,0.298076525336091
5826,0.6647,25,56,25,554759,50851,86363,21593,0.47103449553521803,0.2980647120534482
5827,0.6648,38,81,38,554840,50770,86401,21555,0.47028418985512616,0.2980297269270653
5828,0.6649,14,54,14,554894,50716,86415,21541,0.4697839860683982,0.2981164454654912
5829,0.665,21,51,21,554945,50665,86436,21520,0.469311571380933,0.29812287871441434
5830,0.6651,44,123,44,555068,50542,86480,21476,0.4681722183111638,0.298203226971035
5831,0.6652,22,75,22,555143,50467,86502,21454,0.4674774908295972,0.2982995230878325
5832,0.6653,31,108,31,555251,50359,86533,21423,0.4664770832561414,0.2984452926917612
5833,0.6654,37,120,37,555371,50239,86570,21386,0.4653655192856349,0.2985828970331588
5834,0.6655,40,75,40,555446,50164,86610,21346,0.46467079180406834,0.298503705775416
5835,0.6656,32,74,32,555520,50090,86642,21314,0.46398532735558934,0.2984986835471402
5836,0.6657,31,99,31,555619,49991,86673,21283,0.4630682870799214,0.29860818811908973
5837,0.6658,35,77,35,555696,49914,86708,21248,0.46235503353217977,0.2985863241617717
5838,0.6659,32,98,32,555794,49816,86740,21216,0.4614472562895995,0.2986822840409956
5839,0.666,29,55,29,555849,49761,86769,21187,0.460937789469784,0.2986271635564075
5840,0.6661,20,72,20,555921,49689,86789,21167,0.46027085108748006,0.29873264084904594
5841,0.6662,25,62,25,555983,49627,86814,21142,0.45969654303605173,0.2987466263476946
5842,0.6663,19,59,19,556042,49568,86833,21123,0.45915002408388605,0.29880748610148394
5843,0.6664,42,109,42,556151,49459,86875,21081,0.4581403534773426,0.2988517153388149
5844,0.6665,18,55,18,556206,49404,86893,21063,0.45763088665752716,0.29890587083315595
5845,0.6666,25,81,25,556287,49323,86918,21038,0.4568805809774352,0.2990008669575475
5846,0.6667,38,65,38,556352,49258,86956,21000,0.45627848382674424,0.2988983460958183
5847,0.6668,15,59,15,556411,49199,86971,20985,0.4557319648745785,0.2989997720278126
5848,0.6669,14,43,14,556454,49156,86985,20971,0.4553336544518137,0.2990431645443267
5849,0.667,24,81,24,556535,49075,87009,20947,0.4545833487717218,0.2991488389363343
5850,0.6671,35,80,35,556615,48995,87044,20912,0.4538423061247175,0.2991402863804769
5851,0.6672,26,65,26,556680,48930,87070,20886,0.45324020897402645,0.2991577861808182
5852,0.6673,20,71,20,556751,48859,87090,20866,0.4525825336248101,0.29926138400860525
5853,0.6674,34,79,34,556830,48780,87124,20832,0.4518507540108933,0.29925874849163936
5854,0.6675,13,47,13,556877,48733,87137,20819,0.4514153914557783,0.2993299976995629
5855,0.6676,36,104,36,556981,48629,87173,20783,0.45045203601467265,0.2994150867285196
5856,0.6677,48,99,48,557080,48530,87221,20735,0.4495349957390048,0.2993575398830578
5857,0.6678,20,55,20,557135,48475,87241,20715,0.4490255289191893,0.2993929758635641
5858,0.6679,27,92,27,557227,48383,87268,20688,0.4481733298751343,0.2995178873912351
5859,0.668,16,57,16,557284,48326,87284,20672,0.4476453369891437,0.29960288704020405
5860,0.6681,15,44,15,557328,48282,87299,20657,0.44723776353329137,0.2996417122383557
5861,0.6682,44,97,44,557425,48185,87343,20613,0.4463392493237986,0.299616267914765
5862,0.6683,36,73,36,557498,48112,87379,20577,0.4456630479084071,0.29956761635778656
5863,0.6684,25,84,25,557582,48028,87404,20552,0.4448849531290526,0.29967920676582094
5864,0.6685,27,52,27,557634,47976,87431,20525,0.4444032754084998,0.2996306623260974
5865,0.6686,25,71,25,557705,47905,87456,20500,0.44374560005928343,0.29968569549009577
5866,0.6687,33,99,33,557804,47806,87489,20467,0.44282855978361557,0.29978175852826155
5867,0.6688,21,83,21,557887,47723,87510,20446,0.44205972803734855,0.29993105370476314
5868,0.6689,30,90,30,557977,47633,87540,20416,0.44122605505946866,0.3000191038810269
5869,0.669,31,78,31,558055,47555,87571,20385,0.44050353847863943,0.3000441566087724
5870,0.6691,14,34,14,558089,47521,87585,20371,0.4401885953536626,0.30005007953808993
5871,0.6692,29,42,29,558131,47479,87614,20342,0.43979954796398535,0.2999365978089382
5872,0.6693,22,51,22,558182,47428,87636,20320,0.43932713327652007,0.29993505343331167
5873,0.6694,20,85,20,558267,47343,87656,20300,0.43853977546407796,0.3001049628195083
5874,0.6695,49,122,49,558389,47221,87705,20251,0.43740968542739633,0.30013931705003555
5875,0.6696,26,50,26,558439,47171,87731,20225,0.4369465337730186,0.30009199359012406
5876,0.6697,39,125,39,558564,47046,87770,20186,0.4357886546370744,0.3002439314612089
5877,0.6698,35,56,35,558620,46990,87805,20151,0.4352699247841713,0.3001295780521589
5878,0.6699,24,72,24,558692,46918,87829,20127,0.43460298640186745,0.3002013572973376
5879,0.67,22,85,22,558777,46833,87851,20105,0.4338156285894253,0.30035256506020497
5880,0.6701,15,50,15,558827,46783,87866,20090,0.43335247693504764,0.30042019948260135
5881,0.6702,22,65,22,558892,46718,87888,20068,0.4327503797843566,0.3004821369748151
5882,0.6703,38,86,38,558978,46632,87926,20030,0.4319537589388269,0.30047103297230804
5883,0.6704,31,64,31,559042,46568,87957,19999,0.43136092482122346,0.300434149052834
5884,0.6705,15,45,15,559087,46523,87972,19984,0.43094408833228354,0.30047964875877725
5885,0.6706,15,36,15,559123,46487,87987,19969,0.4306106191411316,0.30048453111833395
5886,0.6707,17,57,17,559180,46430,88004,19952,0.430082626255141,0.30056340574252055
5887,0.6708,33,121,33,559301,46309,88037,19919,0.4289617992515469,0.3007640272996316
5888,0.6709,12,55,12,559356,46254,88049,19907,0.4284523324317314,0.3008872296367951
5889,0.671,33,78,33,559434,46176,88082,19874,0.4277298158509022,0.30089326267978805
5890,0.6711,12,43,12,559477,46133,88094,19862,0.4273315054281374,0.3009621941056141
5891,0.6712,29,101,29,559578,46032,88123,19833,0.4263959390862944,0.301115918925074
5892,0.6713,27,60,27,559638,45972,88150,19806,0.4258401571010412,0.3011037124874578
5893,0.6714,24,64,24,559702,45908,88174,19782,0.4252473229834377,0.30114172629015074
5894,0.6715,35,95,35,559797,45813,88209,19747,0.42436733484012007,0.30120500305064063
5895,0.6716,26,49,26,559846,45764,88235,19721,0.42391344621882987,0.3011529357868214
5896,0.6717,46,142,46,559988,45622,88281,19675,0.4225980955203972,0.3013155275127494
5897,0.6718,38,97,38,560085,45525,88319,19637,0.42169958131090446,0.3013566188883091
5898,0.6719,22,66,22,560151,45459,88341,19615,0.42108822112712585,0.3014260687832314
5899,0.672,50,100,50,560251,45359,88391,19565,0.4201619178183704,0.30135235044051506
5900,0.6721,7,42,7,560293,45317,88398,19558,0.41977287042869316,0.3014720616570328
5901,0.6722,34,105,34,560398,45212,88432,19524,0.4188002519545,0.30159416707859615
5902,0.6723,37,90,37,560488,45122,88469,19487,0.4179665789766201,0.30161432617746753
5903,0.6724,26,56,26,560544,45066,88495,19461,0.4174478491237171,0.3015946812962016
5904,0.6725,17,48,17,560592,45018,88512,19444,0.41700322353551444,0.3016350718252614
5905,0.6726,40,69,40,560661,44949,88552,19404,0.41636407425247324,0.30152440445666867
5906,0.6727,25,51,25,560712,44898,88577,19379,0.41589165956500795,0.3014919800239588
5907,0.6728,27,74,27,560786,44824,88604,19352,0.41520619511652895,0.30154574918972826
5908,0.6729,22,76,22,560862,44748,88626,19330,0.4145022046018748,0.3016635974905584
5909,0.673,31,79,31,560941,44669,88657,19299,0.4137704249879581,0.30169772386193094
5910,0.6731,24,61,24,561002,44608,88681,19275,0.41320537996961726,0.30172346320617377
5911,0.6732,47,101,47,561103,44507,88728,19228,0.41226981362777426,0.30168667137365657
5912,0.6733,20,59,20,561162,44448,88748,19208,0.4117232946756086,0.30174688953123036
5913,0.6734,31,81,31,561243,44367,88779,19177,0.4109729889955167,0.3017908850560242
5914,0.6735,13,62,13,561305,44305,88792,19164,0.4103986809440883,0.30194268067875657
5915,0.6736,15,45,15,561350,44260,88807,19149,0.4099818444551484,0.3019918308126607
5916,0.6737,19,41,19,561391,44219,88826,19130,0.40960206009855865,0.3019779317747715
5917,0.6738,20,50,20,561441,44169,88846,19110,0.40913890844418094,0.3019959228179965
5918,0.6739,42,147,42,561588,44022,88888,19068,0.4077772425803105,0.30223490252020924
5919,0.674,43,87,43,561675,43935,88931,19025,0.40697135870169326,0.3021759847522236
5920,0.6741,27,54,27,561729,43881,88958,18998,0.4064711549149654,0.30213584821641565
5921,0.6742,34,83,34,561812,43798,88992,18964,0.40570232316869836,0.3021573563621299
5922,0.6743,30,82,30,561894,43716,89022,18934,0.4049427544555189,0.302218675179569
5923,0.6744,18,68,18,561962,43648,89040,18916,0.4043128682055652,0.3023463972891759
5924,0.6745,19,40,19,562002,43608,89059,18897,0.40394234688206304,0.30232781377489804
5925,0.6746,8,39,8,562041,43569,89067,18889,0.40358108859164843,0.30242723109929875
5926,0.6747,19,49,19,562090,43520,89086,18870,0.4031271999703583,0.3024523160762943
5927,0.6748,31,81,31,562171,43439,89117,18839,0.4023768942902664,0.30249847458171425
5928,0.6749,13,35,13,562206,43404,89130,18826,0.402052688132202,0.3025228989233489
5929,0.675,34,103,34,562309,43301,89164,18792,0.40109859572418394,0.3026428099785805
5930,0.6751,32,108,32,562417,43193,89196,18760,0.40009818815072806,0.30281019482510935
5931,0.6752,27,68,27,562485,43125,89223,18733,0.39946830190077437,0.3028387597400498
5932,0.6753,57,110,57,562595,43015,89280,18676,0.3984493682611434,0.30273459661863156
5933,0.6754,21,83,21,562678,42932,89301,18655,0.39768053651487645,0.3029048338123305
5934,0.6755,41,128,41,562806,42804,89342,18614,0.3964948682796695,0.3030707610146863
5935,0.6756,17,55,17,562861,42749,89359,18597,0.395985401459854,0.3031493495908454
5936,0.6757,21,52,21,562913,42697,89380,18576,0.3955037237393012,0.30316779005434696
5937,0.6758,29,68,29,562981,42629,89409,18547,0.3948738374893475,0.30317444749574995
5938,0.6759,33,82,33,563063,42547,89442,18514,0.39411426877616806,0.3032049917295819
5939,0.676,13,31,13,563094,42516,89455,18501,0.3938271147504539,0.30321058065784945
5940,0.6761,15,47,15,563141,42469,89470,18486,0.39339175219533884,0.3032729062423099
5941,0.6762,28,55,28,563196,42414,89498,18458,0.3928822853755234,0.3032264423708766
5942,0.6763,15,73,15,563269,42341,89513,18443,0.3922060839601319,0.3034186628060016
5943,0.6764,20,45,20,563314,42296,89533,18423,0.391789247471192,0.30341408784729657
5944,0.6765,46,87,46,563401,42209,89579,18377,0.39098336359257474,0.30332089921764105
5945,0.6766,14,52,14,563453,42157,89593,18363,0.39050168587202194,0.3034203569068077
5946,0.6767,21,77,21,563530,42080,89614,18342,0.3897884323242803,0.30356492668233426
5947,0.6768,18,58,18,563588,42022,89632,18324,0.3892511764052021,0.3036489576773937
5948,0.6769,13,40,13,563628,41982,89645,18311,0.38888065508169994,0.3037002637122054
5949,0.677,21,71,21,563699,41911,89666,18290,0.3882229797324836,0.3038155512366904
5950,0.6771,35,57,35,563756,41854,89701,18255,0.387694986846493,0.3036982814553561
5951,0.6772,33,66,33,563822,41788,89734,18222,0.38708362666271445,0.3036493917680387
5952,0.6773,23,55,23,563877,41733,89757,18199,0.38657415984289895,0.30366081559100316
5953,0.6774,19,56,19,563933,41677,89776,18180,0.3860554299899959,0.3037238752359791
5954,0.6775,18,51,18,563984,41626,89794,18162,0.38558301530253064,0.30377333244129257
5955,0.6776,22,53,22,564037,41573,89816,18140,0.3850920745488903,0.3037864451626949
5956,0.6777,26,58,26,564095,41515,89842,18114,0.38455481862981217,0.30377836287712356
5957,0.6778,24,80,24,564175,41435,89866,18090,0.3838137759828078,0.30390592188156235
5958,0.6779,27,93,27,564268,41342,89893,18063,0.38295231390566525,0.30406531436747747
5959,0.678,25,77,25,564345,41265,89918,18038,0.3822390603579236,0.30416673692730556
5960,0.6781,21,70,21,564415,41195,89939,18017,0.3815906480417948,0.30427953793150037
5961,0.6782,23,57,23,564472,41138,89962,17994,0.38106265515580423,0.3043022390583779
5962,0.6783,19,58,19,564530,41080,89981,17975,0.38052539923672607,0.3043772754212175
5963,0.6784,27,70,27,564600,41010,90008,17948,0.3798769869205973,0.3044200956613182
5964,0.6785,24,52,24,564652,40958,90032,17924,0.37939530920004444,0.3044054210115146
5965,0.6786,28,95,28,564747,40863,90060,17896,0.3785153210567268,0.3045661090215967
5966,0.6787,30,75,30,564822,40788,90090,17866,0.37782059357516024,0.30459985678726087
5967,0.6788,22,106,22,564928,40682,90112,17844,0.3768387120678795,0.3048901342992858
5968,0.6789,17,50,17,564978,40632,90129,17827,0.3763755604135018,0.30494876751227357
5969,0.679,49,111,49,565089,40521,90178,17778,0.37534736374078326,0.30494519631554573
5970,0.6791,15,44,15,565133,40477,90193,17763,0.3749397902849309,0.30499656593406593
5971,0.6792,54,159,54,565292,40318,90247,17709,0.3734669680240098,0.30518551708687336
5972,0.6793,21,80,21,565372,40238,90268,17688,0.37272592537700544,0.30535510824154954
5973,0.6794,21,113,21,565485,40125,90289,17667,0.3716792026381118,0.3056997508305648
5974,0.6795,28,58,28,565543,40067,90317,17639,0.37114194671903367,0.3056701209579593
5975,0.6796,58,159,58,565702,39908,90375,17581,0.36966912445811256,0.3058150254831359
5976,0.6797,23,62,23,565764,39846,90398,17558,0.3690948164066842,0.3058671869556128
5977,0.6798,42,82,42,565846,39764,90440,17516,0.3683352476935048,0.30579608938547487
5978,0.6799,18,60,18,565906,39704,90458,17498,0.3677794657082515,0.30589839516100836
5979,0.68,16,53,16,565959,39651,90474,17482,0.3672885249546111,0.30598778289254897
5980,0.6801,47,112,47,566071,39539,90521,17435,0.3662510652488051,0.30601677958366974
5981,0.6802,28,104,28,566175,39435,90549,17407,0.3652877098076994,0.3062348263607896
5982,0.6803,22,75,22,566250,39360,90571,17385,0.36459298232613285,0.3063706053396775
5983,0.6804,27,79,27,566329,39281,90598,17358,0.3638612027122161,0.3064672751990678
5984,0.6805,25,66,25,566395,39215,90623,17333,0.3632498425284375,0.30651835608686423
5985,0.6806,19,45,19,566440,39170,90642,17314,0.3628330060394976,0.306529282628709
5986,0.6807,20,37,20,566477,39133,90662,17294,0.36249027381525806,0.306484484378046
5987,0.6808,17,37,17,566514,39096,90679,17277,0.3621475415910186,0.30647650470970145
5988,0.6809,32,83,32,566597,39013,90711,17245,0.36137870984475157,0.3065341818052544
5989,0.681,10,15,10,566612,38998,90721,17235,0.36123976434843824,0.30649262888339585
5990,0.6811,20,33,20,566645,38965,90741,17215,0.36093408425654894,0.3064257742969028
5991,0.6812,28,66,28,566711,38899,90769,17187,0.3603227240727704,0.30644010983133046
5992,0.6813,32,71,32,566782,38828,90801,17155,0.35966504872355404,0.3064323098083347
5993,0.6814,20,63,20,566845,38765,90821,17135,0.35908147763903814,0.30652951699463327
5994,0.6815,33,112,33,566957,38653,90854,17102,0.35804401793323204,0.30673482198905927
5995,0.6816,16,40,16,566997,38613,90870,17086,0.3576734966097299,0.3067559561212948
5996,0.6817,50,130,50,567127,38483,90920,17036,0.35646930230834784,0.3068499072389632
5997,0.6818,26,65,26,567192,38418,90946,17010,0.3558672051576568,0.30688460705780474
5998,0.6819,13,43,13,567235,38375,90959,16997,0.355468894734892,0.3069601964892003
5999,0.682,57,96,57,567331,38279,91016,16940,0.3545796435584868,0.3067784639345153
6000,0.6821,21,44,21,567375,38235,91037,16919,0.3541720701026344,0.3067592559016572
6001,0.6822,24,52,24,567427,38183,91061,16895,0.3536903923820816,0.3067467954537202
6002,0.6823,25,95,25,567522,38088,91086,16870,0.3528104042387639,0.30696167982823247
6003,0.6824,18,62,18,567584,38026,91104,16852,0.3522360961873356,0.3070811618499216
6004,0.6825,32,61,32,567645,37965,91136,16820,0.3516710511689948,0.307018344437346
6005,0.6826,21,47,21,567692,37918,91157,16799,0.3512356886138797,0.3070161010289307
6006,0.6827,37,81,37,567773,37837,91194,16762,0.35048538293378784,0.30700195974285244
6007,0.6828,20,66,20,567839,37771,91214,16742,0.3498740227500093,0.30711940271127985
6008,0.6829,30,72,30,567911,37699,91244,16712,0.34920708436770537,0.3071437760746908
6009,0.683,32,77,32,567988,37622,91276,16680,0.3484938308199637,0.30717100659275903
6010,0.6831,24,56,24,568044,37566,91300,16656,0.34797510096706064,0.307181586809782
6011,0.6832,25,101,25,568145,37465,91325,16631,0.3470395346252177,0.3074349304939367
6012,0.6833,39,117,39,568262,37348,91364,16592,0.34595575975397386,0.30760103819058215
6013,0.6834,12,15,12,568277,37333,91376,16580,0.34581681425766053,0.3075325060746017
6014,0.6835,20,65,20,568342,37268,91396,16560,0.3452147171069695,0.3076465779891506
6015,0.6836,29,70,29,568412,37198,91425,16531,0.3445663047908407,0.3076736957695099
6016,0.6837,16,56,16,568468,37142,91441,16515,0.3440475749379377,0.3077883593939281
6017,0.6838,38,83,38,568551,37059,91479,16477,0.3432787431916707,0.3077742080095637
6018,0.6839,20,46,20,568597,37013,91499,16457,0.3428526436696432,0.3077800635870582
6019,0.684,15,34,15,568631,36979,91514,16442,0.34253770054466637,0.30778158402126504
6020,0.6841,14,44,14,568675,36935,91528,16428,0.34213012708881396,0.3078537563480314
6021,0.6842,44,88,44,568763,36847,91572,16384,0.3413149801771092,0.30779057316225505
6022,0.6843,25,76,25,568839,36771,91597,16359,0.34061098966245507,0.30790513833992095
6023,0.6844,20,60,20,568899,36711,91617,16339,0.3400552076772018,0.3079924599434496
6024,0.6845,19,89,19,568988,36622,91636,16320,0.3392307977324095,0.3082618714819992
6025,0.6846,20,66,20,569054,36556,91656,16300,0.33861943754863094,0.30838504616316026
6026,0.6847,15,81,15,569135,36475,91671,16285,0.337869131868539,0.3086618650492798
6027,0.6848,34,84,34,569219,36391,91705,16251,0.3370910370891845,0.30870787584058357
6028,0.6849,32,63,32,569282,36328,91737,16219,0.3365074660046686,0.3086570118179915
6029,0.685,18,50,18,569332,36278,91755,16201,0.33604431435029086,0.3087139617751863
6030,0.6851,13,53,13,569385,36225,91768,16188,0.3355533735966505,0.3088546734588747
6031,0.6852,18,33,18,569418,36192,91786,16170,0.3352476935047612,0.30881173370001147
6032,0.6853,31,122,31,569540,36070,91817,16139,0.33411760346807956,0.30912294815070196
6033,0.6854,10,33,10,569573,36037,91827,16129,0.3338119233761903,0.3091860598857493
6034,0.6855,10,30,10,569603,36007,91837,16119,0.33353403238356366,0.3092314775735717
6035,0.6856,53,113,53,569716,35894,91890,16066,0.33248730964467005,0.30919938414164744
6036,0.6857,24,45,24,569761,35849,91914,16042,0.33207047315573013,0.30914802181495826
6037,0.6858,25,60,25,569821,35789,91939,16017,0.3315146911704769,0.30917268270084547
6038,0.6859,21,38,21,569859,35751,91960,15996,0.3311626959131498,0.30911936923879646
6039,0.686,27,78,27,569937,35673,91987,15969,0.33044017933232056,0.30922504937841294
6040,0.6861,34,75,34,570012,35598,92021,15935,0.329745451850754,0.3092193351832806
6041,0.6862,20,78,20,570090,35520,92041,15915,0.32902293526992477,0.3094196558763488
6042,0.6863,23,49,23,570139,35471,92064,15892,0.3285690466486346,0.30940560325526156
6043,0.6864,31,75,31,570214,35396,92095,15861,0.32787431916706805,0.30944066176327134
6044,0.6865,23,84,23,570298,35312,92118,15838,0.3270962243877135,0.30963831867057673
6045,0.6866,47,156,47,570454,35156,92165,15791,0.32565119122605507,0.3099495554203388
6046,0.6867,34,107,34,570561,35049,92199,15757,0.32466004668568677,0.3101405345825296
6047,0.6868,20,93,20,570654,34956,92219,15737,0.3237985846085442,0.3104373384885487
6048,0.6869,24,63,24,570717,34893,92243,15713,0.3232150135240283,0.3104967790380587
6049,0.687,5,30,5,570747,34863,92248,15708,0.32293712253140167,0.3106128018034051
6050,0.6871,26,74,26,570821,34789,92274,15682,0.32225165808292267,0.31071308276039705
6051,0.6872,25,45,25,570866,34744,92299,15657,0.32183482159398275,0.3106485982420984
6052,0.6873,17,61,17,570927,34683,92316,15640,0.32126977657564193,0.3107922818591896
6053,0.6874,33,69,33,570996,34614,92349,15607,0.32063062729260067,0.3107664124569403
6054,0.6875,23,67,23,571063,34547,92372,15584,0.32001000407573454,0.31086553230535996
6055,0.6876,20,54,20,571117,34493,92392,15564,0.3195098002890066,0.3109255448788381
6056,0.6877,33,61,33,571178,34432,92425,15531,0.31894475527066585,0.3108500290214759
6057,0.6878,26,44,26,571222,34388,92451,15505,0.31853718181481344,0.3107650371795643
6058,0.6879,36,72,36,571294,34316,92487,15469,0.3178702434325095,0.3107160791403033
6059,0.688,22,64,22,571358,34252,92509,15447,0.31727740931490606,0.31081108271796215
6060,0.6881,29,73,29,571431,34179,92538,15418,0.3166012078995146,0.31086557654696856
6061,0.6882,22,54,22,571485,34125,92560,15396,0.3161010041127867,0.310898406736536
6062,0.6883,10,29,10,571514,34096,92570,15386,0.3158323761532476,0.31094135241097776
6063,0.6884,20,58,20,571572,34038,92590,15366,0.3152951202341695,0.3110274471702696
6064,0.6885,27,84,27,571656,33954,92617,15339,0.3145170254548149,0.3111800864220072
6065,0.6886,20,64,20,571720,33890,92637,15319,0.31392419133721144,0.31130484261009167
6066,0.6887,10,41,10,571761,33849,92647,15309,0.31354440698062175,0.31142438667154887
6067,0.6888,29,116,29,571877,33733,92676,15280,0.3124698951424654,0.31175402444249484
6068,0.6889,24,55,24,571932,33678,92700,15256,0.31196042832265,0.3117668696611763
6069,0.689,30,83,30,572015,33595,92730,15226,0.31119159657638296,0.31187398865242416
6070,0.6891,32,91,32,572106,33504,92762,15194,0.31034866056541555,0.312004599778225
6071,0.6892,29,80,29,572186,33424,92791,15165,0.3096076179184112,0.3121076786927082
6072,0.6893,17,33,17,572219,33391,92808,15148,0.30930193782652193,0.3120789468262634
6073,0.6894,26,88,26,572307,33303,92834,15122,0.3084867909148171,0.3122767165720186
6074,0.6895,28,84,28,572391,33219,92862,15094,0.3077086961354626,0.3124210874919794
6075,0.6896,38,63,38,572454,33156,92900,15056,0.3071251250509467,0.31228739732846594
6076,0.6897,30,51,30,572505,33105,92930,15026,0.3066527103634814,0.31218964908271174
6077,0.6898,24,65,24,572570,33040,92954,15002,0.3060506132127904,0.31226843178885144
6078,0.6899,18,55,18,572625,32985,92972,14984,0.3055411463929749,0.31236840459463405
6079,0.69,15,64,15,572689,32921,92987,14969,0.30494831227537145,0.31257047400292337
6080,0.6901,30,78,30,572767,32843,93017,14939,0.3042257956945422,0.312649114729396
6081,0.6902,34,60,34,572827,32783,93051,14905,0.303670013709289,0.3125524240899178
6082,0.6903,20,51,20,572878,32732,93071,14885,0.3031975990218237,0.3125984417329945
6083,0.6904,30,76,30,572954,32656,93101,14855,0.3024936085071696,0.31266443560438634
6084,0.6905,29,69,29,573023,32587,93130,14826,0.30185445922412835,0.3126990487840888
6085,0.6906,33,72,33,573095,32515,93163,14793,0.30118752084182443,0.312695527183563
6086,0.6907,19,51,19,573146,32464,93182,14774,0.3007151061543592,0.3127566789449172
6087,0.6908,19,68,19,573214,32396,93201,14755,0.3000852199044055,0.31293079680176455
6088,0.6909,7,50,7,573264,32346,93208,14748,0.2996220682500278,0.313160912218117
6089,0.691,16,23,16,573287,32323,93224,14732,0.299409018489014,0.3130804377855701
6090,0.6911,19,53,19,573340,32270,93243,14713,0.29891807773537366,0.31315582231871103
6091,0.6912,14,65,14,573405,32205,93257,14699,0.29831598058468267,0.3133847859457616
6092,0.6913,32,72,32,573477,32133,93289,14667,0.29764904220237876,0.3133974358974359
6093,0.6914,28,71,28,573548,32062,93317,14639,0.2969913668531624,0.31346223849596366
6094,0.6915,23,70,23,573618,31992,93340,14616,0.29634295453703363,0.3135942327497425
6095,0.6916,26,57,26,573675,31935,93366,14590,0.29581496165104304,0.3135948414830736
6096,0.6917,21,58,21,573733,31877,93387,14569,0.2952777057319649,0.31367609697282867
6097,0.6918,21,50,21,573783,31827,93408,14548,0.29481455407758717,0.3137035040431267
6098,0.6919,17,58,17,573841,31769,93425,14531,0.294277298158509,0.31384449244060475
6099,0.692,26,51,26,573892,31718,93451,14505,0.2938048834710438,0.31380481578434977
6100,0.6921,49,117,49,574009,31601,93500,14456,0.29272110859979994,0.31387194129014045
6101,0.6922,42,66,42,574075,31535,93542,14414,0.29210974841602133,0.3136956190559098
6102,0.6923,9,28,9,574103,31507,93551,14405,0.2918503834895698,0.3137523958877853
6103,0.6924,21,50,21,574153,31457,93572,14384,0.2913872318351921,0.31378024039615193
6104,0.6925,35,60,35,574213,31397,93607,14349,0.29083144984993886,0.31366676867922877
6105,0.6926,22,32,22,574245,31365,93629,14327,0.2905350327911371,0.3135559835419767
6106,0.6927,25,53,25,574298,31312,93654,14302,0.29004409203749676,0.31354408734160566
6107,0.6928,16,56,16,574354,31256,93670,14286,0.28952536218459374,0.31368846339642525
6108,0.6929,23,52,23,574406,31204,93693,14263,0.2890436844640409,0.31370004618734465
6109,0.693,49,133,49,574539,31071,93742,14214,0.2878117010633962,0.31387876780390855
6110,0.6931,25,72,25,574611,30999,93767,14189,0.2871447626810923,0.3139992918473931
6111,0.6932,28,106,28,574717,30893,93795,14161,0.28616288117381156,0.3143117148310916
6112,0.6933,18,50,18,574767,30843,93813,14143,0.28569972951943384,0.3143866980838483
6113,0.6934,30,76,30,574843,30767,93843,14113,0.2849957390047797,0.3144607843137255
6114,0.6935,22,67,22,574910,30700,93865,14091,0.2843751157879136,0.31459444977785717
6115,0.6936,23,64,23,574974,30636,93888,14068,0.2837822816703101,0.3146921975662133
6116,0.6937,31,61,31,575035,30575,93919,14037,0.2832172366519693,0.3146462835111629
6117,0.6938,18,23,18,575058,30552,93937,14019,0.2830041868909556,0.3145318704987548
6118,0.6939,17,55,17,575113,30497,93954,14002,0.28249472007114007,0.3146587563765478
6119,0.694,30,88,30,575201,30409,93984,13972,0.2816795731594353,0.3148194047002095
6120,0.6941,12,41,12,575242,30368,93996,13960,0.2812997888028456,0.3149251037718823
6121,0.6942,13,49,13,575291,30319,94009,13947,0.2808459001815555,0.3150725161523517
6122,0.6943,11,42,11,575333,30277,94020,13936,0.28045685279187815,0.31520141134960306
6123,0.6944,17,61,17,575394,30216,94037,13919,0.2798918077735374,0.3153732865073071
6124,0.6945,19,47,19,575441,30169,94056,13900,0.27945644521842233,0.3154144636819533
6125,0.6946,32,54,32,575495,30115,94088,13868,0.2789562414316944,0.3153036400427438
6126,0.6947,22,72,22,575567,30043,94110,13846,0.2782893030493905,0.3154776823349814
6127,0.6948,16,54,16,575621,29989,94126,13830,0.27778909926266254,0.31561651338460484
6128,0.6949,16,27,16,575648,29962,94142,13814,0.2775389973692986,0.3155610380116959
6129,0.695,21,49,21,575697,29913,94163,13793,0.27708510874800846,0.31558596073765616
6130,0.6951,27,74,27,575771,29839,94190,13766,0.27639964429952946,0.31569774108473797
6131,0.6952,13,55,13,575826,29784,94203,13753,0.27589017747971395,0.3158922295978134
6132,0.6953,19,42,19,575868,29742,94222,13734,0.2755011300900367,0.31589842671818935
6133,0.6954,53,117,53,575985,29625,94275,13681,0.27441735521879285,0.31591465385858775
6134,0.6955,23,49,23,576034,29576,94298,13658,0.2739634665975027,0.3159087755007633
6135,0.6956,22,81,22,576115,29495,94320,13636,0.2732131609174108,0.31615311492893744
6136,0.6957,31,71,31,576186,29424,94351,13605,0.2725554855681944,0.3161821097399428
6137,0.6958,15,45,15,576231,29379,94366,13590,0.2721386490792545,0.3162745234936815
6138,0.6959,24,54,24,576285,29325,94390,13566,0.27163844529252656,0.3162901307966706
6139,0.696,8,23,8,576308,29302,94398,13558,0.27142539553151285,0.3163322445170322
6140,0.6961,26,71,26,576379,29231,94424,13532,0.2707677201822965,0.31644178378504784
6141,0.6962,20,73,20,576452,29158,94444,13512,0.270091518766905,0.3166627607218186
6142,0.6963,10,47,10,576499,29111,94454,13502,0.26965615621179,0.3168516649848638
6143,0.6964,33,71,33,576570,29040,94487,13469,0.26899848086257366,0.3168505492954433
6144,0.6965,51,119,51,576689,28921,94538,13418,0.2678961799251547,0.316918207798956
6145,0.6966,25,31,25,576720,28890,94563,13393,0.2676090258994405,0.3167466830641156
6146,0.6967,28,37,28,576757,28853,94591,13365,0.267266293675201,0.31657113079729027
6147,0.6968,23,53,23,576810,28800,94614,13342,0.2667753529215606,0.31659626975463906
6148,0.6969,23,59,23,576869,28741,94637,13319,0.26622883396939495,0.31666666666666665
6149,0.697,20,42,20,576911,28699,94657,13299,0.2658397865797177,0.3166579360921949
6150,0.6971,17,53,17,576964,28646,94674,13282,0.2653488458260773,0.3167811486357565
6151,0.6972,28,68,28,577032,28578,94702,13254,0.2647189595761236,0.31683878370625357
6152,0.6973,33,79,33,577111,28499,94735,13221,0.26398717996220683,0.31689837008628957
6153,0.6974,35,101,35,577212,28398,94770,13186,0.26305161362036383,0.31709311273566754
6154,0.6975,23,63,23,577275,28335,94793,13163,0.26246804253584793,0.3171960094462384
6155,0.6976,30,71,30,577346,28264,94823,13133,0.2618103671866316,0.3172452110056284
6156,0.6977,25,66,25,577412,28198,94848,13108,0.26119900700285303,0.31733888539195276
6157,0.6978,34,57,34,577469,28141,94882,13074,0.26067101411686244,0.31721460633264587
6158,0.6979,15,58,15,577527,28083,94897,13059,0.2601337581977843,0.3174128627679743
6159,0.698,35,96,35,577623,27987,94932,13024,0.2592445070213791,0.3175733339835654
6160,0.6981,50,110,50,577733,27877,94982,12974,0.2582255733817481,0.3175932045727155
6161,0.6982,35,83,35,577816,27794,95017,12939,0.2574567416354811,0.3176539906218545
6162,0.6983,10,63,10,577879,27731,95027,12929,0.2568731705509652,0.3179783571077226
6163,0.6984,11,56,11,577935,27675,95038,12918,0.2563544406980622,0.31823220752346465
6164,0.6985,16,42,16,577977,27633,95054,12902,0.2559653933083849,0.3182928333538917
6165,0.6986,18,37,18,578014,27596,95072,12884,0.2556226610841454,0.3182806324110672
6166,0.6987,12,34,12,578048,27562,95084,12872,0.25530771795916857,0.3183459464806846
6167,0.6988,26,45,26,578093,27517,95110,12846,0.2548908814702286,0.3182617743973441
6168,0.6989,26,52,26,578145,27465,95136,12820,0.2544092037496758,0.31823259277646765
6169,0.699,20,37,20,578182,27428,95156,12800,0.25406647152543627,0.31818633787411754
6170,0.6991,19,48,19,578230,27380,95175,12781,0.2536218459372337,0.3182440676277981
6171,0.6992,23,70,23,578300,27310,95198,12758,0.2529734336211049,0.31840870520115805
6172,0.6993,14,45,14,578345,27265,95212,12744,0.25255659713216494,0.3185283311254968
6173,0.6994,32,73,32,578418,27192,95244,12712,0.2518803957167735,0.3185645549318364
6174,0.6995,17,64,17,578482,27128,95261,12695,0.25128756159917004,0.31878562639680585
6175,0.6996,11,39,11,578521,27089,95272,12684,0.2509263033087554,0.3189098131898524
6176,0.6997,10,54,10,578575,27035,95282,12674,0.2504260995220275,0.319171976126319
6177,0.6998,21,37,21,578612,26998,95303,12653,0.25008336729778796,0.31910922801442587
6178,0.6999,18,45,18,578657,26953,95321,12635,0.24966653080884804,0.31916237243609175
6179,0.7,28,64,28,578721,26889,95349,12607,0.24907369669124457,0.31919688069677943
6180,0.7001,26,45,26,578766,26844,95375,12581,0.24865686020230465,0.3191122384273938
6181,0.7002,18,55,18,578821,26789,95393,12563,0.24814739338248917,0.31924679812970114
6182,0.7003,35,75,35,578896,26714,95428,12528,0.2474526659009226,0.3192497833953417
6183,0.7004,24,71,24,578967,26643,95452,12504,0.24679499055170626,0.3194114491531918
6184,0.7005,19,74,19,579041,26569,95471,12485,0.24610952610322723,0.3196855635786347
6185,0.7006,15,39,15,579080,26530,95486,12470,0.24574826781281262,0.31974358974358974
6186,0.7007,15,27,15,579107,26503,95501,12455,0.24549816591944867,0.31970327018840805
6187,0.7008,9,26,9,579133,26477,95510,12446,0.24525732705917225,0.319759525216453
6188,0.7009,31,77,31,579210,26400,95541,12415,0.2445440735114306,0.31985057323199795
6189,0.701,12,48,12,579258,26352,95553,12403,0.244099447923228,0.3200361243710489
6190,0.7011,17,51,17,579309,26301,95570,12386,0.2436270332357627,0.32015922661359114
6191,0.7012,15,30,15,579339,26271,95585,12371,0.24334914224313609,0.32014388489208634
6192,0.7013,23,82,23,579421,26189,95608,12348,0.24258957352995664,0.3204193372602953
6193,0.7014,8,30,8,579451,26159,95616,12340,0.24231168253733001,0.3205278059170368
6194,0.7015,19,57,19,579508,26102,95635,12321,0.24178368965133942,0.32066730864326054
6195,0.7016,17,52,17,579560,26050,95652,12304,0.24130201193078663,0.32080095948271364
6196,0.7017,28,57,28,579617,25993,95680,12276,0.24077401904479603,0.3207818338603047
6197,0.7018,23,86,23,579703,25907,95703,12253,0.23997739819926636,0.3210953878406709
6198,0.7019,10,25,10,579728,25882,95713,12243,0.2397458223720775,0.32112786885245903
6199,0.702,19,55,19,579783,25827,95732,12224,0.23923635555226203,0.32125305511024677
6200,0.7021,26,61,26,579844,25766,95758,12198,0.23867131053392124,0.32130439363607627
6201,0.7022,37,86,37,579930,25680,95795,12161,0.23787468968839157,0.32137099970931
6202,0.7023,12,30,12,579960,25650,95807,12149,0.23759679869576494,0.3214106193285537
6203,0.7024,13,43,13,580003,25607,95820,12136,0.2371984882730001,0.32154306758869194
6204,0.7025,23,58,23,580061,25549,95843,12113,0.23666123235392197,0.32162391800754075
6205,0.7026,29,65,29,580126,25484,95872,12084,0.23605913520323094,0.3216567291311755
6206,0.7027,15,36,15,580162,25448,95887,12069,0.235725666012079,0.32169416531172534
6207,0.7028,17,36,17,580198,25412,95904,12052,0.23539219682092705,0.32169549434123423
6208,0.7029,38,92,38,580290,25320,95942,12014,0.23453999777687207,0.3217978250388386
6209,0.703,24,56,24,580346,25264,95966,11990,0.23402126792396902,0.32184463413324743
6210,0.7031,10,29,10,580375,25235,95976,11980,0.23375263996442996,0.32191320704017196
6211,0.7032,24,45,24,580420,25190,96000,11956,0.23333580347549002,0.3218650729553653
6212,0.7033,24,58,24,580478,25132,96024,11932,0.23279854755641188,0.3219296352255558
6213,0.7034,13,36,13,580514,25096,96037,11919,0.23246507836525993,0.32200459273267595
6214,0.7035,31,56,31,580570,25040,96068,11888,0.23194634851235688,0.32192374350086655
6215,0.7036,18,48,18,580618,24992,96086,11870,0.23150172292415427,0.322011827898649
6216,0.7037,13,23,13,580641,24969,96099,11857,0.23128867316314053,0.32197360560473576
6217,0.7038,22,50,22,580691,24919,96121,11835,0.23082552150876284,0.3220057680796648
6218,0.7039,17,30,17,580721,24889,96138,11818,0.2305476305161362,0.3219549404745689
6219,0.704,18,56,18,580777,24833,96156,11800,0.23002890066323317,0.32211394098217455
6220,0.7041,25,40,25,580817,24793,96181,11775,0.229658379339731,0.32200284401662654
6221,0.7042,30,69,30,580886,24724,96211,11745,0.22901923005668975,0.3220543475280375
6222,0.7043,31,102,31,580988,24622,96242,11714,0.22807440068175924,0.3223800088066931
6223,0.7044,44,77,44,581065,24545,96286,11670,0.22736114713401756,0.32224216484881957
6224,0.7045,26,52,26,581117,24493,96312,11644,0.22687946941346473,0.3222182250878601
6225,0.7046,19,51,19,581168,24442,96331,11625,0.22640705472599948,0.3223167992902099
6226,0.7047,15,44,15,581212,24398,96346,11610,0.2259994812701471,0.32242834925572095
6227,0.7048,8,27,8,581239,24371,96354,11602,0.22574937937678313,0.3225196675284241
6228,0.7049,5,18,5,581257,24353,96359,11597,0.22558264478120715,0.32258692628650903
6229,0.705,25,107,25,581364,24246,96384,11572,0.22459150024083885,0.3230777821207214
6230,0.7051,24,67,24,581431,24179,96408,11548,0.22397087702397273,0.32322893050074175
6231,0.7052,15,39,15,581470,24140,96423,11533,0.2236096187335581,0.32329773217839824
6232,0.7053,42,127,42,581597,24013,96465,11491,0.22243321353143874,0.3236536728255971
6233,0.7054,29,73,29,581670,23940,96494,11462,0.2217570121160473,0.3237670188124965
6234,0.7055,8,36,8,581706,23904,96502,11454,0.22142354292489533,0.323943661971831
6235,0.7056,26,54,26,581760,23850,96528,11428,0.2209233391381674,0.323941266511707
6236,0.7057,26,57,26,581817,23793,96554,11402,0.2203953462521768,0.32396647251029975
6237,0.7058,15,47,15,581864,23746,96569,11387,0.21995998369706177,0.3241112344519398
6238,0.7059,37,75,37,581939,23671,96606,11350,0.2192652562154952,0.3240912595299963
6239,0.706,23,54,23,581993,23617,96629,11327,0.2187650524287673,0.32414720695970695
6240,0.7061,20,52,20,582045,23565,96649,11307,0.21828337470821446,0.3242429456297316
6241,0.7062,21,43,21,582088,23522,96670,11286,0.21788506428544963,0.324235807860262
6242,0.7063,12,25,12,582113,23497,96682,11274,0.21765348845826077,0.32423571366943715
6243,0.7064,7,15,7,582128,23482,96689,11267,0.21751454296194747,0.32423954646176867
6244,0.7065,25,81,25,582209,23401,96714,11242,0.21676423728185557,0.3245100020206102
6245,0.7066,18,50,18,582259,23351,96732,11224,0.21630108562747785,0.32462762111352134
6246,0.7067,28,47,28,582306,23304,96760,11196,0.21586572307236282,0.3245217391304348
6247,0.7068,36,83,36,582389,23221,96796,11160,0.21509689132609583,0.32459788836857567
6248,0.7069,24,62,24,582451,23159,96820,11136,0.21452258327466744,0.3247120571511882
6249,0.707,19,42,19,582493,23117,96839,11117,0.21413353588499018,0.3247356429280832
6250,0.7071,16,60,16,582553,23057,96855,11101,0.21357775389973693,0.3249897534984484
6251,0.7072,40,89,40,582642,22968,96895,11061,0.2127533439549446,0.32504628405183816
6252,0.7073,17,92,17,582734,22876,96912,11044,0.21190114491088963,0.3255896226415094
6253,0.7074,20,38,20,582772,22838,96932,11024,0.21154914965356256,0.3255566711948497
6254,0.7075,30,53,30,582825,22785,96962,10994,0.2110582088999222,0.3254684863376654
6255,0.7076,19,27,19,582852,22758,96981,10975,0.21080810700655822,0.3253490647140782
6256,0.7077,14,40,14,582892,22718,96995,10961,0.21043758568305607,0.32545503132515813
6257,0.7078,11,28,11,582920,22690,97006,10950,0.21017822075660456,0.3255053507728894
6258,0.7079,9,41,9,582961,22649,97015,10941,0.20979843640001483,0.3257219410538851
6259,0.708,15,31,15,582992,22618,97030,10926,0.20951128237430064,0.3257214404960649
6260,0.7081,16,69,16,583061,22549,97046,10910,0.2088721330912594,0.32607071341044264
6261,0.7082,8,29,8,583090,22520,97054,10902,0.20860350513172032,0.32619232840643886
6262,0.7083,9,29,9,583119,22491,97063,10893,0.20833487717218127,0.326294033069734
6263,0.7084,25,65,25,583184,22426,97088,10868,0.20773278002149023,0.32642518171442303
6264,0.7085,13,24,13,583208,22402,97101,10855,0.20751046722738895,0.3263974501608684
6265,0.7086,31,46,31,583254,22356,97132,10824,0.20708436770536146,0.32622061482820974
6266,0.7087,23,45,23,583299,22311,97155,10801,0.2066675312164215,0.3261959410485625
6267,0.7088,22,53,22,583352,22258,97177,10779,0.20617659046278114,0.32627054514635107
6268,0.7089,26,53,26,583405,22205,97203,10753,0.20568564970914077,0.3262637295952424
6269,0.709,17,41,17,583446,22164,97220,10736,0.20530586535255105,0.326322188449848
6270,0.7091,21,55,21,583501,22109,97241,10715,0.20479639853273557,0.3264379722154521
6271,0.7092,29,88,29,583589,22021,97270,10686,0.20398125162103078,0.3267190509676828
6272,0.7093,47,99,47,583688,21922,97317,10639,0.20306421134536293,0.3267405792205399
6273,0.7094,15,56,15,583744,21866,97332,10624,0.20254548149245988,0.32699292089873805
6274,0.7095,6,11,6,583755,21855,97338,10618,0.2024435881284968,0.32697933667970314
6275,0.7096,12,36,12,583791,21819,97350,10606,0.20211011893734485,0.32709329221279876
6276,0.7097,13,53,13,583844,21766,97363,10593,0.20161917818370448,0.3273586946444575
6277,0.7098,19,43,19,583887,21723,97382,10574,0.20122086776093964,0.32739882961265754
6278,0.7099,18,69,18,583956,21654,97400,10556,0.2005817184778984,0.3277243092207389
6279,0.71,11,41,11,583997,21613,97411,10545,0.20020193412130868,0.32791218359350705
6280,0.7101,30,46,30,584043,21567,97441,10515,0.1997758345992812,0.32775388068075556
6281,0.7102,14,27,14,584070,21540,97455,10501,0.19952573270591722,0.32773633781717176
6282,0.7103,15,42,15,584112,21498,97470,10486,0.19913668531623996,0.3278514257128564
6283,0.7104,28,35,28,584147,21463,97498,10458,0.19881247915817554,0.3276213151217067
6284,0.7105,13,24,13,584171,21439,97511,10445,0.19859016636407426,0.3275937774432317
6285,0.7106,16,20,16,584191,21419,97527,10429,0.19840490570232316,0.3274616930419493
6286,0.7107,26,60,26,584251,21359,97553,10403,0.19784912371706992,0.32752975253447514
6287,0.7108,8,40,8,584291,21319,97561,10395,0.19747860239356774,0.3277732231821908
6288,0.7109,29,31,29,584322,21288,97590,10366,0.19719144836785357,0.3274783597649586
6289,0.711,26,70,26,584392,21218,97616,10340,0.19654303605172477,0.3276506749477153
6290,0.7111,13,31,13,584423,21187,97629,10327,0.1962558820260106,0.3276956273402297
6291,0.7112,13,28,13,584451,21159,97642,10314,0.1959965170995591,0.32770946525593364
6292,0.7113,19,54,19,584505,21105,97661,10295,0.19549631331283115,0.32786624203821657
6293,0.7114,21,53,21,584558,21052,97682,10274,0.1950053725591908,0.3279703760454574
6294,0.7115,15,62,15,584620,20990,97697,10259,0.19443106450776243,0.32829850555217766
6295,0.7116,23,63,23,584683,20927,97720,10236,0.1938474934232465,0.32846645059846613
6296,0.7117,30,43,30,584726,20884,97750,10206,0.19344918300048167,0.32827275651334836
6297,0.7118,23,56,23,584782,20828,97773,10183,0.19293045314757865,0.3283673535197188
6298,0.7119,19,38,19,584820,20790,97792,10164,0.19257845789025158,0.3283582089552239
6299,0.712,33,71,33,584891,20719,97825,10131,0.19192078254103523,0.32839546191247976
6300,0.7121,22,39,22,584930,20680,97847,10109,0.19155952425062062,0.32833154698106465
6301,0.7122,15,33,15,584963,20647,97862,10094,0.19125384415873134,0.3283562668748577
6302,0.7123,19,50,19,585013,20597,97881,10075,0.19079069250435363,0.3284754825247783
6303,0.7124,15,54,15,585067,20543,97896,10060,0.1902904887176257,0.3287259419011208
6304,0.7125,10,28,10,585095,20515,97906,10050,0.19003112379117418,0.32880745951251433
6305,0.7126,16,40,16,585135,20475,97922,10034,0.18966060246767202,0.3288865580648333
6306,0.7127,27,65,27,585200,20410,97949,10007,0.18905850531698098,0.3289936548640563
6307,0.7128,19,33,19,585233,20377,97968,9988,0.1887528252250917,0.328931335419068
6308,0.7129,8,18,8,585251,20359,97976,9980,0.18858609062951573,0.3289495368997001
6309,0.713,17,40,17,585291,20319,97993,9963,0.18821556930601357,0.3290073310877749
6310,0.7131,19,28,19,585319,20291,98012,9944,0.18795620437956204,0.3288903588556309
6311,0.7132,5,33,5,585352,20258,98017,9939,0.18765052428767276,0.3291386561578965
6312,0.7133,21,49,21,585401,20209,98038,9918,0.1871966356663826,0.32920635974375145
6313,0.7134,21,54,21,585455,20155,98059,9897,0.18669643187965468,0.32932916278450686
6314,0.7135,20,40,20,585495,20115,98079,9877,0.1863259105561525,0.32932115230728193
6315,0.7136,10,25,10,585520,20090,98089,9867,0.18609433472896364,0.3293721000100144
6316,0.7137,18,49,18,585569,20041,98107,9849,0.1856404461076735,0.3295081967213115
6317,0.7138,23,53,23,585622,19988,98130,9826,0.18514950535403313,0.32957670892869123
6318,0.7139,27,57,27,585679,19931,98157,9799,0.18462151246804254,0.32959973091153716
6319,0.714,44,62,44,585741,19869,98201,9755,0.18404720441661418,0.3292938158250068
6320,0.7141,26,58,26,585799,19811,98227,9729,0.18350994849753605,0.3293500338524035
6321,0.7142,16,63,16,585862,19748,98243,9713,0.18292637741302012,0.3296900987746512
6322,0.7143,27,59,27,585921,19689,98270,9686,0.18237985846085442,0.32973617021276597
6323,0.7144,13,38,13,585959,19651,98283,9673,0.18202786320352737,0.32986632110216885
6324,0.7145,23,51,23,586010,19600,98306,9650,0.1815554485160621,0.3299145299145299
6325,0.7146,22,53,22,586063,19547,98328,9628,0.18106450776242172,0.33000856898029135
6326,0.7147,8,20,8,586083,19527,98336,9620,0.18087924710067063,0.33005112018389543
6327,0.7148,18,32,18,586115,19495,98354,9602,0.1805828300418689,0.3299996563219576
6328,0.7149,9,22,9,586137,19473,98363,9593,0.18037904331394272,0.3300419734397578
6329,0.715,15,62,15,586199,19411,98378,9578,0.17980473526251436,0.33040118665700785
6330,0.7151,31,46,31,586245,19365,98409,9547,0.17937863574048687,0.33020890979524076
6331,0.7152,12,31,12,586276,19334,98421,9535,0.17909148171477268,0.33028508088260766
6332,0.7153,6,26,6,586302,19308,98427,9529,0.17885064285449628,0.33044352741269895
6333,0.7154,19,41,19,586343,19267,98446,9510,0.17847085849790656,0.3304722521458109
6334,0.7155,24,30,24,586373,19237,98470,9486,0.17819296750527994,0.3302579814086272
6335,0.7156,40,83,40,586456,19154,98510,9446,0.17742413575901292,0.3302797202797203
6336,0.7157,12,29,12,586485,19125,98522,9434,0.17715550779947387,0.33033369515739347
6337,0.7158,10,22,10,586507,19103,98532,9424,0.17695172107154766,0.33035370000350545
6338,0.7159,17,54,17,586561,19049,98549,9407,0.17645151728481975,0.33058054540342985
6339,0.716,15,40,15,586601,19009,98564,9392,0.17608099596131757,0.3306925812471392
6340,0.7161,25,75,25,586676,18934,98589,9367,0.175386268479751,0.33097770396805765
6341,0.7162,27,41,27,586717,18893,98616,9340,0.17500648412316128,0.33081854567350266
6342,0.7163,17,38,17,586755,18855,98633,9323,0.17465448886583423,0.3308609553552417
6343,0.7164,11,45,11,586800,18810,98644,9312,0.1742376523768943,0.33112865372306377
6344,0.7165,16,24,16,586824,18786,98660,9296,0.174015339582793,0.3310305533793889
6345,0.7166,32,67,32,586891,18719,98692,9264,0.17339471636592685,0.33105814244362647
6346,0.7167,12,31,12,586922,18688,98704,9252,0.17310756234021268,0.3311381531853973
6347,0.7168,10,20,10,586942,18668,98714,9242,0.1729223016784616,0.33113579362235757
6348,0.7169,14,24,14,586966,18644,98728,9228,0.1726999888843603,0.3310849598163031
6349,0.717,29,80,29,587046,18564,98757,9199,0.17195894623735597,0.33134027302524943
6350,0.7171,17,46,17,587092,18518,98774,9182,0.17153284671532848,0.33148014440433216
6351,0.7172,17,43,17,587135,18475,98791,9165,0.17113453629256364,0.3315846599131693
6352,0.7173,14,42,14,587177,18433,98805,9151,0.17074548890288635,0.33175029002320183
6353,0.7174,16,55,16,587232,18378,98821,9135,0.17023602208307087,0.33202486097481193
6354,0.7175,23,52,23,587284,18326,98844,9112,0.16975434436251807,0.33209417596034696
6355,0.7176,7,26,7,587310,18300,98851,9105,0.16951350550224165,0.3322386425834702
6356,0.7177,20,35,20,587345,18265,98871,9085,0.16918929934417726,0.33217550274223034
6357,0.7178,30,63,30,587408,18202,98901,9055,0.16860572825966133,0.33220824008511574
6358,0.7179,26,67,26,587475,18135,98927,9029,0.1679851050427952,0.33238845530849653
6359,0.718,22,55,22,587530,18080,98949,9007,0.16747563822297973,0.3325211356001034
6360,0.7181,19,46,19,587576,18034,98968,8988,0.16704953870095224,0.33261786692324774
6361,0.7182,30,50,30,587626,17984,98998,8958,0.16658638704657452,0.3324920198945884
6362,0.7183,16,30,16,587656,17954,99014,8942,0.1663084960539479,0.33246579417013683
6363,0.7184,29,79,29,587735,17875,99043,8913,0.16557671644003114,0.332723607585486
6364,0.7185,20,51,20,587786,17824,99063,8893,0.16510430175256585,0.3328592282067597
6365,0.7186,17,53,17,587839,17771,99080,8876,0.16461336099892548,0.3330956580478103
6366,0.7187,19,40,19,587879,17731,99099,8857,0.16424283967542333,0.33312020460358055
6367,0.7188,12,36,12,587915,17695,99111,8845,0.16390937048427137,0.3332705350414469
6368,0.7189,18,38,18,587953,17657,99129,8827,0.1635573752269443,0.33329557468660326
6369,0.719,15,55,15,588008,17602,99144,8812,0.16304790840712882,0.33361096388278944
6370,0.7191,14,40,14,588048,17562,99158,8798,0.16267738708362667,0.33376327769347497
6371,0.7192,22,37,22,588085,17525,99180,8776,0.16233465485938717,0.3336755256454127
6372,0.7193,27,65,27,588150,17460,99207,8749,0.16173255770869613,0.3338166278759205
6373,0.7194,20,60,20,588210,17400,99227,8729,0.16117677572344288,0.3340732519422864
6374,0.7195,17,56,17,588266,17344,99244,8712,0.16065804587053986,0.3343567700337734
6375,0.7196,20,23,20,588289,17321,99264,8692,0.16044499610952612,0.334140621996694
6376,0.7197,18,76,18,588365,17245,99282,8674,0.15974100559487198,0.33465797291562177
6377,0.7198,10,20,10,588385,17225,99292,8664,0.1595557449331209,0.33465950789910776
6378,0.7199,16,24,16,588409,17201,99308,8648,0.1593334321390196,0.33455839684320476
6379,0.72,14,25,14,588434,17176,99322,8634,0.15910185631183074,0.33452150329329716
6380,0.7201,15,32,15,588466,17144,99337,8619,0.158805439253029,0.3345495478011101
6381,0.7202,32,53,32,588519,17091,99369,8587,0.15831449849938864,0.3344107796557364
6382,0.7203,17,45,17,588564,17046,99386,8570,0.1578976620104487,0.3345565271705184
6383,0.7204,35,67,35,588631,16979,99421,8535,0.15727703879358257,0.33452222309320373
6384,0.7205,20,79,20,588710,16900,99441,8515,0.1565452591796658,0.3350383631713555
6385,0.7206,25,63,25,588773,16837,99466,8490,0.15596168809514988,0.3352153827930667
6386,0.7207,10,44,10,588817,16793,99476,8480,0.1555541146392975,0.33553594745380444
6387,0.7208,9,14,9,588831,16779,99485,8471,0.15542443217607174,0.3354851485148515
6388,0.7209,14,40,14,588871,16739,99499,8457,0.15505391085256956,0.3356485156374028
6389,0.721,15,28,15,588899,16711,99514,8442,0.15479454592611805,0.3356259690692959
6390,0.7211,16,41,16,588940,16670,99530,8426,0.15441476156952832,0.3357507172457762
6391,0.7212,15,26,15,588966,16644,99545,8411,0.15417392270925193,0.33570145679505087
6392,0.7213,11,29,11,588995,16615,99556,8400,0.15390529474971285,0.33579852088746753
6393,0.7214,38,77,38,589072,16538,99594,8362,0.15319204120197116,0.3358232931726908
6394,0.7215,18,44,18,589116,16494,99612,8344,0.15278446774611879,0.3359368709235848
6395,0.7216,4,29,4,589145,16465,99616,8340,0.1525158397865797,0.3362225357790768
6396,0.7217,12,32,12,589177,16433,99628,8328,0.15221942272777797,0.3363353660999152
6397,0.7218,30,47,30,589224,16386,99658,8298,0.15178406017266294,0.33616917841516775
6398,0.7219,26,52,26,589276,16334,99684,8272,0.1513023824521101,0.336178167926522
6399,0.722,19,59,19,589335,16275,99703,8253,0.1507558634999444,0.336472602739726
6400,0.7221,26,45,26,589380,16230,99729,8227,0.1503390270110045,0.33638631066770247
6401,0.7222,18,28,18,589408,16202,99747,8209,0.15007966208455298,0.3362828233173569
6402,0.7223,11,35,11,589443,16167,99758,8198,0.14975545592648856,0.3364662425610507
6403,0.7224,6,22,6,589465,16145,99764,8192,0.1495516691985624,0.3366068126720631
6404,0.7225,12,37,12,589502,16108,99776,8180,0.14920893697432286,0.33679183135704877
6405,0.7226,17,48,17,589550,16060,99793,8163,0.14876431138612028,0.336993766255212
6406,0.7227,21,29,21,589579,16031,99814,8142,0.1484956834265812,0.3368220742150333
6407,0.7228,17,50,17,589629,15981,99831,8125,0.1480325317722035,0.3370530158466772
6408,0.7229,16,36,16,589665,15945,99847,8109,0.14769906258105153,0.33711648790222
6409,0.723,10,36,10,589701,15909,99857,8099,0.1473655933898996,0.3373458847050983
6410,0.7231,24,37,24,589738,15872,99881,8075,0.14702286116566007,0.3372029899361089
6411,0.7232,10,27,10,589765,15845,99891,8065,0.14677275927229613,0.3373065662902551
6412,0.7233,15,40,15,589805,15805,99906,8050,0.14640223794879395,0.33745546007126387
6413,0.7234,7,21,7,589826,15784,99913,8043,0.14620771425395532,0.33755823225752296
6414,0.7235,26,44,26,589870,15740,99939,8017,0.14580014079810294,0.3374584333038683
6415,0.7236,34,74,34,589944,15666,99973,7983,0.1451146763496239,0.3375618419383483
6416,0.7237,20,42,20,589986,15624,99993,7963,0.14472562895994665,0.3376012210115742
6417,0.7238,24,48,24,590034,15576,100017,7939,0.14428100337174404,0.3376142887518605
6418,0.7239,21,28,21,590062,15548,100038,7918,0.14402163844529253,0.33742435864655246
6419,0.724,14,35,14,590097,15513,100052,7904,0.14369743228722812,0.3375325618140667
6420,0.7241,13,41,13,590138,15472,100065,7891,0.14331764793063842,0.33775628129949065
6421,0.7242,8,21,8,590159,15451,100073,7883,0.14312312423579976,0.3378332047655781
6422,0.7243,13,43,13,590202,15408,100086,7870,0.14272481381303495,0.3380874645588109
6423,0.7244,17,40,17,590242,15368,100103,7853,0.14235429248953277,0.33818526333921883
6424,0.7245,11,31,11,590273,15337,100114,7842,0.1420671384638186,0.3383234824625739
6425,0.7246,40,75,40,590348,15262,100154,7802,0.14137241098225203,0.33827610128338537
6426,0.7247,15,26,15,590374,15236,100169,7787,0.1411315721219756,0.3382269904009034
6427,0.7248,14,45,14,590419,15191,100183,7773,0.1407147356330357,0.338486326423968
6428,0.7249,9,20,9,590439,15171,100192,7764,0.1405294749712846,0.33852190974493135
6429,0.725,10,26,10,590465,15145,100202,7754,0.1402886361110082,0.3386174068736626
6430,0.7251,12,18,12,590483,15127,100214,7742,0.14012190151543222,0.33853688399142945
6431,0.7252,18,41,18,590524,15086,100232,7724,0.1397421171588425,0.3386234107847435
6432,0.7253,35,41,35,590565,15045,100267,7689,0.13936233280225277,0.3382158880971233
6433,0.7254,9,18,9,590583,15027,100276,7680,0.1391955982066768,0.3382216937508257
6434,0.7255,13,37,13,590620,14990,100289,7667,0.1388528659824373,0.3383943152226685
6435,0.7256,10,31,10,590651,14959,100299,7657,0.1385657119567231,0.3385656172621153
6436,0.7257,20,47,20,590698,14912,100319,7637,0.13813034940160807,0.3386846423344716
6437,0.7258,4,16,4,590714,14896,100323,7633,0.1379821408722072,0.33880775888854364
6438,0.7259,23,57,23,590771,14839,100346,7610,0.1374541479862166,0.33899060091763555
6439,0.726,33,62,33,590833,14777,100379,7577,0.13687983993478825,0.3389549968685694
6440,0.7261,31,74,31,590907,14703,100410,7546,0.13619437548630925,0.33916131062070204
6441,0.7262,5,22,5,590929,14681,100415,7541,0.13599058875838305,0.33934839348393486
6442,0.7263,18,33,18,590962,14648,100433,7523,0.13568490866649377,0.3393171259753732
6443,0.7264,29,70,29,591032,14578,100462,7494,0.13503649635036497,0.33952519028633565
6444,0.7265,32,60,32,591092,14518,100494,7462,0.13448071436511172,0.3394904458598726
6445,0.7266,20,46,20,591138,14472,100514,7442,0.13405461484308423,0.3396002555444008
6446,0.7267,17,37,17,591175,14435,100531,7425,0.1337118826188447,0.3396614821591949
6447,0.7268,49,74,49,591249,14361,100580,7376,0.1330264181703657,0.3393292542669182
6448,0.7269,14,30,14,591279,14331,100594,7362,0.13274852717773908,0.3393721476974139
6449,0.727,28,81,28,591360,14250,100622,7334,0.1319982214976472,0.3397887323943662
6450,0.7271,10,29,10,591389,14221,100632,7324,0.13172959353810812,0.33993966117428637
6451,0.7272,18,30,18,591419,14191,100650,7306,0.1314517025454815,0.33986137600595434
6452,0.7273,33,43,33,591462,14148,100683,7273,0.13105339212271666,0.33952663274356937
6453,0.7274,26,39,26,591501,14109,100709,7247,0.13069213383230205,0.3393425735156396
6454,0.7275,12,26,12,591527,14083,100721,7235,0.13045129497202565,0.33938455765081155
6455,0.7276,8,29,8,591556,14054,100729,7227,0.13018266701248657,0.33959870306846485
6456,0.7277,6,18,6,591574,14036,100735,7221,0.1300159324169106,0.339699863574352
6457,0.7278,16,37,16,591611,13999,100751,7205,0.1296732001926711,0.3397943784191662
6458,0.7279,25,31,25,591642,13968,100776,7180,0.1293860461669569,0.33951201059201813
6459,0.728,8,9,8,591651,13959,100784,7172,0.1293026788691689,0.3394065590838105
6460,0.7281,9,23,9,591674,13936,100793,7163,0.12908962910815516,0.3394947627849661
6461,0.7282,15,29,15,591703,13907,100808,7148,0.1288210011486161,0.3394918071716932
6462,0.7283,7,25,7,591728,13882,100815,7141,0.12858942532142725,0.33967559339770725
6463,0.7284,17,53,17,591781,13829,100832,7124,0.12809848456778689,0.3399990454827471
6464,0.7285,11,35,11,591816,13794,100843,7113,0.12777427840972247,0.3402209786196011
6465,0.7286,13,39,13,591855,13755,100856,7100,0.12741302011930786,0.34044593622632463
6466,0.7287,33,44,33,591899,13711,100889,7067,0.12700544666345548,0.34011935701222445
6467,0.7288,12,40,12,591939,13671,100901,7055,0.12663492533995332,0.3403937083856026
6468,0.7289,11,28,11,591967,13643,100912,7044,0.1263755604135018,0.3405036979745734
6469,0.729,8,16,8,591983,13627,100920,7036,0.12622735188410092,0.3405120263272516
6470,0.7291,21,52,21,592035,13575,100941,7015,0.12574567416354812,0.3406993686255464
6471,0.7292,12,18,12,592053,13557,100953,7003,0.12557893956797214,0.3406128404669261
6472,0.7293,26,52,26,592105,13505,100979,6977,0.12509726184741932,0.34064056244507374
6473,0.7294,28,69,28,592174,13436,101007,6949,0.12445811256437808,0.340887907775325
6474,0.7295,32,62,32,592236,13374,101039,6917,0.12388380451294972,0.34089004977576265
6475,0.7296,31,64,31,592300,13310,101070,6886,0.12329097039534626,0.340958605664488
6476,0.7297,13,40,13,592340,13270,101083,6873,0.12292044907184409,0.3412103460259147
6477,0.7298,29,55,29,592395,13215,101112,6844,0.12241098225202861,0.34119347923625304
6478,0.7299,30,54,30,592449,13161,101142,6814,0.12191077846530068,0.34112640801001254
6479,0.73,13,18,13,592467,13143,101155,6801,0.1217440438697247,0.34100481347773764
6480,0.7301,20,25,20,592492,13118,101175,6781,0.12151246804253585,0.340770893009699
6481,0.7302,15,26,15,592518,13092,101190,6766,0.12127162918225944,0.3407191056501158
6482,0.7303,19,56,19,592574,13036,101209,6747,0.1207528993293564,0.34105039680533794
6483,0.7304,26,52,26,592626,12984,101235,6721,0.12027122160880359,0.3410809439228622
6484,0.7305,18,29,18,592655,12955,101253,6703,0.12000259364926452,0.34098077118730286
6485,0.7306,12,38,12,592693,12917,101265,6691,0.11965059839193745,0.3412382700938392
6486,0.7307,15,39,15,592732,12878,101280,6676,0.11928934010152284,0.3414135215301217
6487,0.7308,19,33,19,592765,12845,101299,6657,0.11898366000963355,0.34134960516870066
6488,0.7309,2,13,2,592778,12832,101301,6655,0.11886324057949535,0.3415097244316724
6489,0.731,16,28,16,592806,12804,101317,6639,0.11860387565304384,0.3414596512883814
6490,0.7311,19,53,19,592859,12751,101336,6620,0.11811293489940346,0.34174797377523103
6491,0.7312,8,39,8,592898,12712,101344,6612,0.11775167660898885,0.3421651831918857
6492,0.7313,11,24,11,592922,12688,101355,6601,0.11752936381488754,0.34221577064648245
6493,0.7314,25,43,25,592965,12645,101380,6576,0.11713105339212272,0.34212579990635245
6494,0.7315,19,33,19,592998,12612,101399,6557,0.11682537330023343,0.3420627054097762
6495,0.7316,12,28,12,593026,12584,101411,6545,0.1165660083737819,0.3421506612995975
6496,0.7317,12,14,12,593040,12570,101423,6533,0.11643632591055615,0.34198816939747684
6497,0.7318,5,8,5,593048,12562,101428,6528,0.11636222164585572,0.34195914091147195
6498,0.7319,11,38,11,593086,12524,101439,6517,0.11601022638852866,0.3422614358489575
6499,0.732,35,57,35,593143,12467,101474,6482,0.11548223350253807,0.3420760990025859
6500,0.7321,27,46,27,593189,12421,101501,6455,0.11505613398051058,0.3419686374231829
6501,0.7322,18,44,18,593233,12377,101519,6437,0.11464856052465819,0.34213883278409696
6502,0.7323,13,38,13,593271,12339,101532,6424,0.11429656526733113,0.3423759526728135
6503,0.7324,20,48,20,593319,12291,101552,6404,0.11385193967912853,0.3425514843541054
6504,0.7325,14,40,14,593359,12251,101566,6390,0.11348141835562636,0.3427927686282925
6505,0.7326,28,53,28,593412,12198,101594,6362,0.112990477601986,0.3427801724137931
6506,0.7327,8,17,8,593429,12181,101602,6354,0.11283300603949757,0.34281089830051253
6507,0.7328,21,57,21,593486,12124,101623,6333,0.11230501315350698,0.3431218507883188
6508,0.7329,28,44,28,593530,12080,101651,6305,0.1118974396976546,0.3429426162632581
6509,0.733,9,36,9,593566,12044,101660,6296,0.11156397050650264,0.3432933478735005
6510,0.7331,10,20,10,593586,12024,101670,6286,0.11137870984475157,0.34330966684871655
6511,0.7332,10,29,10,593615,11995,101680,6276,0.1111100818852125,0.3434951562585518
6512,0.7333,13,31,13,593646,11964,101693,6263,0.11082292785949831,0.3436111263510177
6513,0.7334,22,54,22,593700,11910,101715,6241,0.11032272407277038,0.3438378050796099
6514,0.7335,15,46,15,593746,11864,101730,6226,0.1098966245507429,0.3441680486456606
6515,0.7336,22,60,22,593806,11804,101752,6204,0.10934084256548965,0.34451354953354063
6516,0.7337,21,25,21,593831,11779,101773,6183,0.10910926673830079,0.3442267008128271
6517,0.7338,7,16,7,593847,11763,101780,6176,0.10896105820889992,0.3442778304253303
6518,0.7339,21,36,21,593883,11727,101801,6155,0.10862758901774797,0.3442008723856392
6519,0.734,5,25,5,593908,11702,101806,6150,0.10839601319055912,0.34449921577414294
6520,0.7341,18,30,18,593938,11672,101824,6132,0.10811812219793249,0.34441698494720285
6521,0.7342,19,27,19,593965,11645,101843,6113,0.10786802030456853,0.34423921612794234
6522,0.7343,18,44,18,594009,11601,101861,6095,0.10746044684871614,0.3444281193490054
6523,0.7344,7,14,7,594023,11587,101868,6088,0.10733076438549038,0.34444130127298445
6524,0.7345,20,28,20,594051,11559,101888,6068,0.10707139945903887,0.34424462472343564
6525,0.7346,14,41,14,594092,11518,101902,6054,0.10669161510244915,0.34452538128841337
6526,0.7347,22,37,22,594129,11481,101924,6032,0.10634888287820964,0.34442985210986127
6527,0.7348,34,52,34,594181,11429,101958,5998,0.10586720515765682,0.3441785734779365
6528,0.7349,11,14,11,594195,11415,101969,5987,0.10573752269443107,0.34404091483737503
6529,0.735,16,56,16,594251,11359,101985,5971,0.10521879284152803,0.3445470282746682
6530,0.7351,7,16,7,594267,11343,101992,5964,0.10507058431212717,0.3446004506846941
6531,0.7352,31,57,31,594324,11286,102023,5933,0.10454259142613657,0.34456124049015624
6532,0.7353,18,44,18,594368,11242,102041,5915,0.1041350179702842,0.3447572419420645
6533,0.7354,18,23,18,594391,11219,102059,5897,0.10392196820927044,0.3445314325777051
6534,0.7355,14,27,14,594418,11192,102073,5883,0.10367186631590648,0.34453879941434845
6535,0.7356,19,47,19,594465,11145,102092,5864,0.10323650376079144,0.3447586571814922
6536,0.7357,24,36,24,594501,11109,102116,5840,0.10290303456963948,0.3445631010679096
6537,0.7358,10,33,10,594534,11076,102126,5830,0.10259735447775019,0.34484798296462793
6538,0.7359,7,11,7,594545,11065,102133,5823,0.1024954611137871,0.3448010421601137
6539,0.736,16,30,16,594575,11035,102149,5807,0.10221757012116048,0.34479277995487473
6540,0.7361,7,30,7,594605,11005,102156,5800,0.10193967912853384,0.34513537637607855
6541,0.7362,18,42,18,594647,10963,102174,5782,0.10155063173885658,0.3452971036130188
6542,0.7363,16,29,16,594676,10934,102190,5766,0.1012820037793175,0.3452694610778443
6543,0.7364,23,31,23,594707,10903,102213,5743,0.10099484975360332,0.3450078096840082
6544,0.7365,12,29,12,594736,10874,102225,5731,0.10072622179406425,0.3451370069256248
6545,0.7366,13,15,13,594751,10859,102238,5718,0.10058727629775094,0.3449357543584485
6546,0.7367,21,40,21,594791,10819,102259,5697,0.10021675497424877,0.3449382417050133
6547,0.7368,11,25,11,594816,10794,102270,5686,0.09998517914705991,0.34502427184466017
6548,0.7369,16,27,16,594843,10767,102286,5670,0.09973507725369594,0.3449534586603395
6549,0.737,7,22,7,594865,10745,102293,5663,0.09953129052576976,0.34513651877133106
6550,0.7371,4,7,4,594872,10738,102297,5659,0.09946644929415688,0.34512410806854915
6551,0.7372,20,45,20,594917,10693,102317,5639,0.09904961280521694,0.3452730835170218
6552,0.7373,11,16,11,594933,10677,102328,5628,0.09890140427581608,0.3451701931922723
6553,0.7374,20,25,20,594958,10652,102348,5608,0.09866982844862722,0.34489544895448954
6554,0.7375,9,18,9,594976,10634,102357,5599,0.09850309385305124,0.3449146799728947
6555,0.7376,14,36,14,595012,10598,102371,5585,0.0981696246618993,0.3451152443922635
6556,0.7377,6,22,6,595034,10576,102377,5579,0.0979658379339731,0.3453419993809966
6557,0.7378,21,39,21,595073,10537,102398,5558,0.09760457964355848,0.3453246349798074
6558,0.7379,11,30,11,595103,10507,102409,5547,0.09732668865093186,0.34552136539180267
6559,0.738,20,42,20,595145,10465,102429,5527,0.09693764126125458,0.3456103051525763
6560,0.7381,4,17,4,595162,10448,102433,5523,0.09678016969876617,0.3458142883977209
6561,0.7382,3,17,3,595179,10431,102436,5520,0.09662269813627775,0.34605980816249765
6562,0.7383,22,18,22,595197,10413,102458,5498,0.09645596354070177,0.3455471057758783
6563,0.7384,19,36,19,595233,10377,102477,5479,0.09612249434954982,0.3455474268415742
6564,0.7385,26,46,26,595279,10331,102503,5453,0.09569639482752232,0.34547643182970095
6565,0.7386,16,31,16,595310,10300,102519,5437,0.09540924080180814,0.34549151680752366
6566,0.7387,20,55,20,595365,10245,102539,5417,0.09489977398199266,0.34586898225003193
6567,0.7388,11,29,11,595394,10216,102550,5406,0.0946311460224536,0.3460504416848035
6568,0.7389,24,45,24,595439,10171,102574,5382,0.09421430953351366,0.3460425641355366
6569,0.739,6,19,6,595458,10152,102580,5376,0.09403831190485012,0.3462132921174652
6570,0.7391,6,8,6,595466,10144,102586,5370,0.09396420764014969,0.34613897125177256
6571,0.7392,13,35,13,595501,10109,102599,5357,0.09364000148208529,0.34637268847795166
6572,0.7393,18,46,18,595547,10063,102617,5339,0.0932139019600578,0.3466432930788209
6573,0.7394,2,8,2,595555,10055,102619,5337,0.09313979769535737,0.34673856548856546
6574,0.7395,5,12,5,595567,10043,102624,5332,0.09302864129830672,0.34679674796747967
6575,0.7396,9,7,9,595574,10036,102633,5323,0.09296380006669384,0.3465720424506804
6576,0.7397,12,27,12,595601,10009,102645,5311,0.09271369817332988,0.3466710182767624
6577,0.7398,17,29,17,595630,9980,102662,5294,0.09244507021379081,0.3466020688752128
6578,0.7399,5,19,5,595649,9961,102667,5289,0.09226907258512727,0.34681967213114756
6579,0.74,4,24,4,595673,9937,102671,5285,0.09204675979102597,0.3471948495598476
6580,0.7401,12,34,12,595707,9903,102683,5273,0.09173181666604913,0.3474565102793885
6581,0.7402,20,50,20,595757,9853,102703,5253,0.09126866501167143,0.3477426188269562
6582,0.7403,14,25,14,595782,9828,102717,5239,0.09103708918448257,0.34771354616048317
6583,0.7404,6,30,6,595812,9798,102723,5233,0.09075919819185595,0.3481471625307697
6584,0.7405,14,13,14,595825,9785,102737,5219,0.09063877876171773,0.34784057584644096
6585,0.7406,10,35,10,595860,9750,102747,5209,0.09031457260365335,0.3482184638010562
6586,0.7407,14,22,14,595882,9728,102761,5195,0.09011078587572714,0.3481203511358306
6587,0.7408,20,38,20,595920,9690,102781,5175,0.08975879061840009,0.3481331987891019
6588,0.7409,13,31,13,595951,9659,102794,5162,0.08947163659268591,0.34828958909655217
6589,0.741,13,19,13,595970,9640,102807,5149,0.08929563896402239,0.3481641760768138
6590,0.7411,13,24,13,595994,9616,102820,5136,0.08907332616992109,0.3481561822125813
6591,0.7412,13,18,13,596012,9598,102833,5123,0.0889065915743451,0.34800624957543647
6592,0.7413,17,23,17,596035,9575,102850,5106,0.08869354181333136,0.34779647162999794
6593,0.7414,13,24,13,596059,9551,102863,5093,0.08847122901923006,0.34778748975689705
6594,0.7415,29,36,29,596095,9515,102892,5064,0.0881377598280781,0.34734892653817134
6595,0.7416,12,23,12,596118,9492,102904,5052,0.08792471006706436,0.34735973597359737
6596,0.7417,7,20,7,596138,9472,102911,5045,0.08773944940531328,0.3475235930288627
6597,0.7418,15,17,15,596155,9455,102926,5030,0.08758197784282486,0.34725578184328615
6598,0.7419,16,21,16,596176,9434,102942,5014,0.08738745414798621,0.3470376522702104
6599,0.742,10,16,10,596192,9418,102952,5004,0.08723924561858534,0.3469699070863958
6600,0.7421,2,11,2,596203,9407,102954,5002,0.08713735225462226,0.3471441460198487
6601,0.7422,13,29,13,596232,9378,102967,4989,0.08686872429508319,0.34725412403424516
6602,0.7423,11,30,11,596262,9348,102978,4978,0.08659083330245655,0.34748010610079577
6603,0.7424,9,45,9,596307,9303,102987,4969,0.08617399681351662,0.34816423766816146
6604,0.7425,13,15,13,596322,9288,103000,4956,0.0860350513172033,0.34793597304128054
6605,0.7426,12,27,12,596349,9261,103012,4944,0.08578494942383934,0.3480464625131996
6606,0.7427,7,25,7,596374,9236,103019,4937,0.08555337359665048,0.3483383898962817
6607,0.7428,7,19,7,596393,9217,103026,4930,0.08537737596798696,0.34848377747932424
6608,0.7429,10,21,10,596414,9196,103036,4920,0.08518285227314831,0.34854066307735904
6609,0.743,7,14,7,596428,9182,103043,4913,0.08505316980992256,0.34856332032635684
6610,0.7431,8,22,8,596450,9160,103051,4905,0.08484938308199637,0.34873800213295414
6611,0.7432,6,23,6,596473,9137,103057,4899,0.08463633332098262,0.34903106298090625
6612,0.7433,11,25,11,596498,9112,103068,4888,0.08440475749379377,0.34914285714285714
6613,0.7434,12,31,12,596529,9081,103080,4876,0.08411760346807959,0.34935874471591316
6614,0.7435,7,20,7,596549,9061,103087,4869,0.08393234280632851,0.34953338119167265
6615,0.7436,12,39,12,596588,9022,103099,4857,0.08357108451591388,0.34995316665465814
6616,0.7437,3,23,3,596611,8999,103102,4854,0.08335803475490014,0.35039341658846457
6617,0.7438,7,11,7,596622,8988,103109,4847,0.08325614139093705,0.3503433321286592
6618,0.7439,19,60,19,596682,8928,103128,4828,0.0827003594056838,0.3509741203838325
6619,0.744,15,35,15,596717,8893,103143,4813,0.0823761532476194,0.351160075879177
6620,0.7441,13,30,13,596747,8863,103156,4800,0.08209826225499277,0.3513137671082486
6621,0.7442,5,23,5,596770,8840,103161,4795,0.08188521249397902,0.35166850018335166
6622,0.7443,3,10,3,596780,8830,103164,4792,0.08179258216310349,0.3517838790192336
6623,0.7444,11,15,11,596795,8815,103175,4781,0.08165363666679018,0.3516475433951162
6624,0.7445,11,38,11,596833,8777,103186,4770,0.08130164140946311,0.3521074776703329
6625,0.7446,14,26,14,596859,8751,103200,4756,0.08106080254918671,0.3521137188124676
6626,0.7447,3,7,3,596866,8744,103203,4753,0.08099596131757382,0.3521523301474402
6627,0.7448,6,4,6,596870,8740,103209,4747,0.08095890918522361,0.35196856231927043
6628,0.7449,3,13,3,596883,8727,103212,4744,0.08083848975508541,0.3521639076534778
6629,0.745,7,29,7,596912,8698,103219,4737,0.08056986179554633,0.35258652772608856
6630,0.7451,17,35,17,596947,8663,103236,4720,0.08024565563748194,0.3526862437420608
6631,0.7452,17,36,17,596983,8627,103253,4703,0.07991218644632998,0.3528132033008252
6632,0.7453,9,27,9,597010,8600,103262,4694,0.07966208455296603,0.3530916202798255
6633,0.7454,9,21,9,597031,8579,103271,4685,0.07946756085812738,0.35321170084439085
6634,0.7455,29,40,29,597071,8539,103300,4656,0.07909703953462521,0.352860932171277
6635,0.7456,13,22,13,597093,8517,103313,4643,0.07889325280669902,0.3528115501519757
6636,0.7457,6,12,6,597105,8505,103319,4637,0.07878209640964838,0.3528382285801248
6637,0.7458,10,13,10,597118,8492,103329,4627,0.07866167697951017,0.3526945651345377
6638,0.7459,14,35,14,597153,8457,103343,4613,0.07833747082144578,0.35294567712318287
6639,0.746,9,15,9,597168,8442,103352,4604,0.07819852532513247,0.3529051050130308
6640,0.7461,9,32,9,597200,8410,103361,4595,0.07790210826633073,0.3533256439830834
6641,0.7462,7,14,7,597214,8396,103368,4588,0.07777242580310496,0.35335797905113986
6642,0.7463,8,14,8,597228,8382,103376,4580,0.07764274333987921,0.3533405338682302
6643,0.7464,13,27,13,597255,8355,103389,4567,0.07739264144651525,0.3534282618789661
6644,0.7465,17,29,17,597284,8326,103406,4550,0.07712401348697617,0.35337061199130165
6645,0.7466,5,12,5,597296,8314,103411,4545,0.07701285708992553,0.3534489462633175
6646,0.7467,20,32,20,597328,8282,103431,4525,0.0767164400311238,0.3533224018115093
6647,0.7468,14,54,14,597382,8228,103445,4511,0.07621623624439587,0.354109427741581
6648,0.7469,8,24,8,597406,8204,103453,4503,0.07599392345029457,0.35437160620130637
6649,0.747,20,14,20,597420,8190,103473,4483,0.0758642409870688,0.3537441805413083
6650,0.7471,17,25,17,597445,8165,103490,4466,0.07563266515987994,0.35357453883302986
6651,0.7472,23,44,23,597489,8121,103513,4443,0.07522509170402757,0.353629417382999
6652,0.7473,15,29,15,597518,8092,103528,4428,0.0749564637444885,0.3536741214057508
6653,0.7474,4,11,4,597529,8081,103532,4424,0.0748545703805254,0.3537784886045582
6654,0.7475,20,27,20,597556,8054,103552,4404,0.07460446848716143,0.35350778616150264
6655,0.7476,10,23,10,597579,8031,103562,4394,0.07439141872614768,0.3536418511066398
6656,0.7477,9,20,9,597599,8011,103571,4385,0.07420615806439661,0.3537431429493385
6657,0.7478,3,4,3,597603,8007,103574,4382,0.07416910593204638,0.35370086366938414
6658,0.7479,8,17,8,597620,7990,103582,4374,0.07401163436955797,0.3537690067939178
6659,0.748,14,26,14,597646,7964,103596,4360,0.07377079550928156,0.35378123985718923
6660,0.7481,9,18,9,597664,7946,103605,4351,0.07360406091370558,0.3538261364560462
6661,0.7482,8,30,8,597694,7916,103613,4343,0.07332616992107896,0.35427033200097885
6662,0.7483,6,14,6,597708,7902,103619,4337,0.0731964874578532,0.35435901625949834
6663,0.7484,15,18,15,597726,7884,103634,4322,0.07302975286227723,0.35408815336719646
6664,0.7485,6,20,6,597746,7864,103640,4316,0.07284449220052613,0.35435139573070606
6665,0.7486,14,13,14,597759,7851,103654,4302,0.07272407277038793,0.35398666995803507
6666,0.7487,5,21,5,597780,7830,103659,4297,0.0725295490755493,0.35433330584645834
6667,0.7488,11,29,11,597809,7801,103670,4286,0.07226092111601022,0.3545958467775296
6668,0.7489,7,13,7,597822,7788,103677,4279,0.07214050168587202,0.35460346399270737
6669,0.749,3,18,3,597840,7770,103680,4276,0.07197376709029604,0.35497260501411254
6670,0.7491,23,49,23,597889,7721,103703,4253,0.07151987846900588,0.35518623684650075
6671,0.7492,12,23,12,597912,7698,103715,4241,0.07130682870799214,0.35522238043387216
6672,0.7493,19,25,19,597937,7673,103734,4222,0.0710752528808033,0.3549390500210172
6673,0.7494,7,14,7,597951,7659,103741,4215,0.07094557041757753,0.35497726124305207
6674,0.7495,2,16,2,597967,7643,103743,4213,0.07079736188817666,0.35534750337381915
6675,0.7496,14,23,14,597990,7620,103757,4199,0.07058431212716292,0.35527540401049157
6676,0.7497,9,32,9,598022,7588,103766,4190,0.07028789506836118,0.35574800475462726
6677,0.7498,12,23,12,598045,7565,103778,4178,0.07007484530734744,0.3557864259558886
6678,0.7499,10,29,10,598074,7536,103788,4168,0.06980621734780837,0.35611756664388244
6679,0.75,23,40,23,598114,7496,103811,4145,0.0694356960243062,0.3560690662314234
6680,0.7501,14,36,14,598150,7460,103825,4131,0.06910222683315424,0.35639720472780606
6681,0.7502,9,14,9,598164,7446,103834,4122,0.06897254436992849,0.35632780082987553
6682,0.7503,14,15,14,598179,7431,103848,4108,0.06883359887361518,0.3560100528641997
6683,0.7504,21,34,21,598213,7397,103869,4087,0.06851865574863833,0.3558864507140369
6684,0.7505,17,37,17,598250,7360,103886,4070,0.06817592352439883,0.3560804899387577
6685,0.7506,10,24,10,598274,7336,103896,4060,0.06795361073029753,0.35626535626535627
6686,0.7507,10,9,10,598283,7327,103906,4050,0.06787024343250954,0.3559813659136855
6687,0.7508,13,22,13,598305,7305,103919,4037,0.06766645670458335,0.35593369776053607
6688,0.7509,14,13,14,598318,7292,103933,4023,0.06754603727444515,0.3555457357490057
6689,0.751,15,19,15,598337,7273,103948,4008,0.06737003964578162,0.3552876518039181
6690,0.7511,7,12,7,598349,7261,103955,4001,0.06725888324873096,0.35526549458355533
6691,0.7512,6,14,6,598363,7247,103961,3995,0.0671292007855052,0.35536381426792385
6692,0.7513,13,40,13,598403,7207,103974,3982,0.06675867946200303,0.35588524443650016
6693,0.7514,9,36,9,598439,7171,103983,3973,0.06642521027085109,0.3565147164393396
6694,0.7515,17,22,17,598461,7149,104000,3956,0.0662214235429249,0.35623592976136875
6695,0.7516,24,35,24,598496,7114,104024,3932,0.0658972173848605,0.35596596052869817
6696,0.7517,16,35,16,598531,7079,104040,3916,0.0655730112267961,0.3561618917689859
6697,0.7518,15,28,15,598559,7051,104055,3901,0.06531364630034459,0.356190650109569
6698,0.7519,19,37,19,598596,7014,104074,3882,0.06497091407610509,0.3562775330396476
6699,0.752,9,16,9,598612,6998,104083,3873,0.06482270554670422,0.35626897249563055
6700,0.7521,12,19,12,598631,6979,104095,3861,0.06464670791804068,0.35618081180811806
6701,0.7522,8,7,8,598638,6972,104103,3853,0.0645818666864278,0.35593533487297924
6702,0.7523,11,34,11,598672,6938,104114,3842,0.06426692356145096,0.3564007421150278
6703,0.7524,5,20,5,598692,6918,104119,3837,0.06408166289969988,0.3567642956764296
6704,0.7525,21,45,21,598737,6873,104140,3816,0.06366482641075993,0.3570025259612686
6705,0.7526,11,25,11,598762,6848,104151,3805,0.06343325058357109,0.3571763822397447
6706,0.7527,16,21,16,598783,6827,104167,3789,0.06323872688873244,0.3569140919366993
6707,0.7528,16,30,16,598813,6797,104183,3773,0.06296083589610582,0.356953642384106
6708,0.7529,3,8,3,598821,6789,104186,3770,0.06288673163140539,0.3570413864949332
6709,0.753,16,25,16,598846,6764,104202,3754,0.06265515580421653,0.3569119604487545
6710,0.7531,8,15,8,598861,6749,104210,3746,0.06251621030790322,0.35693187232015244
6711,0.7532,11,28,11,598889,6721,104221,3735,0.0622568453814517,0.35721117061973984
6712,0.7533,7,22,7,598911,6699,104228,3728,0.06205305865352551,0.3575333269396758
6713,0.7534,8,5,8,598916,6694,104236,3720,0.06200674348808774,0.35721144613020933
6714,0.7535,4,13,4,598929,6681,104240,3716,0.061886324057949534,0.3574107915744926
6715,0.7536,10,17,10,598946,6664,104250,3706,0.06172885249546111,0.35737704918032787
6716,0.7537,11,29,11,598975,6635,104261,3695,0.061460224535922044,0.3576960309777348
6717,0.7538,10,18,10,598993,6617,104271,3685,0.061293489940346065,0.3576975344593283
6718,0.7539,11,21,11,599014,6596,104282,3674,0.06109896624550743,0.3577409931840312
6719,0.754,3,7,3,599021,6589,104285,3671,0.06103412501389455,0.35779727095516567
6720,0.7541,12,19,12,599040,6570,104297,3659,0.06085812738523102,0.3577084759018477
6721,0.7542,8,10,8,599050,6560,104305,3651,0.06076549705435548,0.357555577318578
6722,0.7543,11,17,11,599067,6543,104316,3640,0.06060802549186706,0.35745850928017286
6723,0.7544,16,27,16,599094,6516,104332,3624,0.060357923598503095,0.357396449704142
6724,0.7545,17,32,17,599126,6484,104349,3607,0.06006150653970136,0.3574472302051333
6725,0.7546,34,55,34,599181,6429,104383,3573,0.05955203971988588,0.3572285542891422
6726,0.7547,6,17,6,599198,6412,104389,3567,0.05939456815739746,0.3574506463573504
6727,0.7548,11,22,11,599220,6390,104400,3556,0.05919078142947127,0.3575306655942087
6728,0.7549,12,36,12,599256,6354,104412,3544,0.05885731223831932,0.35805213174378664
6729,0.755,7,21,7,599277,6333,104419,3537,0.05866278854348068,0.35835866261398175
6730,0.7551,14,19,14,599296,6314,104433,3523,0.05848679091481715,0.3581376435905256
6731,0.7552,7,14,7,599310,6300,104440,3516,0.05835710845159139,0.3581907090464548
6732,0.7553,8,29,8,599339,6271,104448,3508,0.05808848049205232,0.3587278862869414
6733,0.7554,16,34,16,599373,6237,104464,3492,0.057773537367075474,0.35892691951896394
6734,0.7555,11,29,11,599402,6208,104475,3481,0.0575049094075364,0.35927340282794923
6735,0.7556,8,16,8,599418,6192,104483,3473,0.05735670087813554,0.35933781686497673
6736,0.7557,4,11,4,599429,6181,104487,3469,0.05725480751417244,0.3594818652849741
6737,0.7558,8,22,8,599451,6159,104495,3461,0.05705102078624625,0.3597713097713098
6738,0.7559,9,23,9,599474,6136,104504,3452,0.056837971025232505,0.3600333750521485
6739,0.756,24,26,24,599500,6110,104528,3428,0.05659713216495609,0.3594044873139023
6740,0.7561,14,24,14,599524,6086,104542,3414,0.05637481937085479,0.35936842105263156
6741,0.7562,16,29,16,599553,6057,104558,3398,0.056106191411315724,0.3593865679534638
6742,0.7563,15,20,15,599573,6037,104573,3383,0.05592093074956464,0.35912951167728235
6743,0.7564,3,20,3,599593,6017,104576,3380,0.055735670087813556,0.35968926253059486
6744,0.7565,8,17,8,599610,6000,104584,3372,0.05557819852532513,0.35979513444302175
6745,0.7566,9,15,9,599625,5985,104593,3363,0.05543925302901182,0.3597560975609756
6746,0.7567,8,12,8,599637,5973,104601,3355,0.05532809663196117,0.3596698113207547
6747,0.7568,12,30,12,599667,5943,104613,3343,0.05505020563933454,0.36000430755976737
6748,0.7569,4,15,4,599682,5928,104617,3339,0.05491126014302123,0.360310780187763
6749,0.757,11,15,11,599697,5913,104628,3328,0.05477231464670792,0.360134184612055
6750,0.7571,4,12,4,599709,5901,104632,3324,0.05466115824965727,0.36032520325203254
6751,0.7572,11,31,11,599740,5870,104643,3313,0.05437400422394309,0.360775345747577
6752,0.7573,6,13,6,599753,5857,104649,3307,0.05425358479380488,0.36086861632474904
6753,0.7574,11,20,11,599773,5837,104660,3296,0.0540683241320538,0.360889083543195
6754,0.7575,8,12,8,599785,5825,104668,3288,0.05395716773500315,0.36080324810709974
6755,0.7576,4,4,4,599789,5821,104672,3284,0.05392011560265293,0.3606809445359693
6756,0.7577,18,45,18,599834,5776,104690,3266,0.05350327911371299,0.36120327361203275
6757,0.7578,10,24,10,599858,5752,104700,3256,0.05328096631961169,0.3614564831261101
6758,0.7579,9,8,9,599866,5744,104709,3247,0.05320686205491126,0.36113891669447223
6759,0.758,6,15,6,599881,5729,104715,3241,0.053067916558597945,0.3613154960981048
6760,0.7581,4,19,4,599900,5710,104719,3237,0.05289191892993442,0.36179725047501954
6761,0.7582,9,13,9,599913,5697,104728,3228,0.05277149949979621,0.36168067226890754
6762,0.7583,8,15,8,599928,5682,104736,3220,0.0526325540034829,0.36171646820939113
6763,0.7584,8,17,8,599945,5665,104744,3212,0.052475082440994476,0.3618339529120198
6764,0.7585,18,32,18,599977,5633,104762,3194,0.05217866538219274,0.3618443412257845
6765,0.7586,6,18,6,599995,5615,104768,3188,0.05201193078661677,0.3621492672952403
6766,0.7587,10,17,10,600012,5598,104778,3178,0.051854459224128346,0.3621239744758432
6767,0.7588,8,9,8,600021,5589,104786,3170,0.051771091926340364,0.36191346044068956
6768,0.7589,6,4,6,600025,5585,104792,3164,0.05173403979399015,0.3616413304377643
6769,0.759,3,22,3,600047,5563,104795,3161,0.05153025306606395,0.36233379183860615
6770,0.7591,10,15,10,600062,5548,104805,3151,0.05139130756975064,0.3622255431658811
6771,0.7592,6,12,6,600074,5536,104811,3145,0.05128015117269999,0.36228545098490955
6772,0.7593,3,14,3,600088,5522,104814,3142,0.05115046870947423,0.3626500461680517
6773,0.7594,18,28,18,600116,5494,104832,3124,0.050891103783022716,0.3624970990949176
6774,0.7595,8,6,8,600122,5488,104840,3116,0.05083552558449739,0.3621571362157136
6775,0.7596,9,29,9,600151,5459,104849,3107,0.050566897624958314,0.36271305159934625
6776,0.7597,2,2,2,600153,5457,104851,3105,0.05054837155878321,0.3626489138051857
6777,0.7598,9,17,9,600170,5440,104860,3096,0.050390899996294786,0.3626991565135895
6778,0.7599,10,18,10,600188,5422,104870,3086,0.05022416540071881,0.3627174424071462
6779,0.76,6,16,6,600204,5406,104876,3080,0.050075956871317946,0.3629507423992458
6780,0.7601,17,18,17,600222,5388,104893,3063,0.04990922227574197,0.36244231451899184
6781,0.7602,2,16,2,600238,5372,104895,3061,0.0497610137463411,0.3629787738645796
6782,0.7603,11,20,11,600258,5352,104906,3050,0.049575753084590016,0.36300880742680314
6783,0.7604,9,19,9,600277,5333,104915,3041,0.04939975545592649,0.3631478385478863
6784,0.7605,2,7,2,600284,5326,104917,3039,0.04933491422431361,0.3632994620442319
6785,0.7606,13,26,13,600310,5300,104930,3026,0.0490940753640372,0.3634398270478021
6786,0.7607,10,6,10,600316,5294,104940,3016,0.049038497165511875,0.36293622141997595
6787,0.7608,17,13,17,600329,5281,104957,2999,0.04891807773537367,0.36219806763285023
6788,0.7609,9,17,9,600346,5264,104966,2990,0.04876060617288525,0.36224860673612796
6789,0.761,10,21,10,600367,5243,104976,2980,0.04856608247804661,0.36239815152620697
6790,0.7611,5,24,5,600391,5219,104981,2975,0.04834376968394531,0.3630705394190871
6791,0.7612,9,7,9,600398,5212,104990,2966,0.048278928452332434,0.36268036194668624
6792,0.7613,25,21,25,600419,5191,105015,2941,0.048084404757493794,0.36165764879488443
6793,0.7614,11,31,11,600450,5160,105026,2930,0.047797250731779616,0.3621755253399258
6794,0.7615,12,22,12,600472,5138,105038,2918,0.04759346400385342,0.36221449851042703
6795,0.7616,3,20,3,600492,5118,105041,2915,0.047408203342102335,0.36287812772314204
6796,0.7617,4,9,4,600501,5109,105045,2911,0.04732483604431435,0.3629675810473815
6797,0.7618,3,2,3,600503,5107,105048,2908,0.04730630997813924,0.36281971303805366
6798,0.7619,7,16,7,600519,5091,105055,2901,0.047158101448738374,0.362987987987988
6799,0.762,12,27,12,600546,5064,105067,2889,0.04690799955537441,0.3632591474915126
6800,0.7621,3,17,3,600563,5047,105070,2886,0.04675052799288599,0.36379679818479765
6801,0.7622,16,39,16,600602,5008,105086,2870,0.04638926970247138,0.3643056613353643
6802,0.7623,3,10,3,600612,4998,105089,2867,0.04629663937159584,0.36452638270820087
6803,0.7624,11,13,11,600625,4985,105100,2856,0.04617621994145763,0.3642392551970412
6804,0.7625,6,14,6,600639,4971,105106,2850,0.04604653747823187,0.364403528960491
6805,0.7626,10,22,10,600661,4949,105116,2840,0.04584275075030568,0.3646167672358454
6806,0.7627,5,15,5,600676,4934,105121,2835,0.04570380525399237,0.36491182906422964
6807,0.7628,3,8,3,600684,4926,105124,2832,0.045629700989291935,0.36504253673627224
6808,0.7629,15,16,15,600700,4910,105139,2817,0.04548149245989107,0.36456580820499546
6809,0.763,6,24,6,600724,4886,105145,2811,0.04525917966578977,0.3652072235936079
6810,0.7631,6,8,6,600732,4878,105151,2805,0.045185075401089334,0.36509176103084734
6811,0.7632,4,10,4,600742,4868,105155,2801,0.04509244507021379,0.36523666710131697
6812,0.7633,16,24,16,600766,4844,105171,2785,0.04487013227611249,0.3650543976930135
6813,0.7634,10,16,10,600782,4828,105181,2775,0.04472192374671162,0.36498750493226356
6814,0.7635,9,14,9,600796,4814,105190,2766,0.044592241283485864,0.3649076517150396
6815,0.7636,10,12,10,600808,4802,105200,2756,0.044481084886435214,0.36464673193966657
6816,0.7637,4,5,4,600813,4797,105204,2752,0.04443476972099744,0.3645515962379123
6817,0.7638,14,22,14,600835,4775,105218,2738,0.04423098299307125,0.3644349793690936
6818,0.7639,2,9,2,600844,4766,105220,2736,0.04414761569528326,0.3647027459344175
6819,0.764,8,10,8,600854,4756,105228,2728,0.044054985364407724,0.364510956707643
6820,0.7641,3,19,3,600873,4737,105231,2725,0.04387898773574419,0.36518359689091395
6821,0.7642,6,14,6,600887,4723,105237,2719,0.043749305272518434,0.3653587745229777
6822,0.7643,3,4,3,600891,4719,105240,2716,0.04371225314016822,0.3652992602555481
6823,0.7644,13,33,13,600924,4686,105253,2703,0.043406573048278926,0.365814047909054
6824,0.7645,10,7,10,600931,4679,105263,2693,0.04334173181666605,0.3653011394465545
6825,0.7646,16,20,16,600951,4659,105279,2677,0.043156471154914965,0.3649127589967285
6826,0.7647,4,11,4,600962,4648,105283,2673,0.04305457779095187,0.3651140554569048
6827,0.7648,12,35,12,600997,4613,105295,2661,0.042730371632887475,0.3658234808908441
6828,0.7649,10,15,10,601012,4598,105305,2651,0.042591426136574156,0.36570561456752654
6829,0.765,10,25,10,601037,4573,105315,2641,0.04235985030938531,0.36609370668145275
6830,0.7651,6,18,6,601055,4555,105321,2635,0.04219311571380933,0.3664812239221141
6831,0.7652,8,21,8,601076,4534,105329,2627,0.041998592018970694,0.366848205557883
6832,0.7653,13,32,13,601108,4502,105342,2614,0.04170217496016896,0.36734120292299044
6833,0.7654,6,8,6,601116,4494,105348,2608,0.041628070695468526,0.36722050126724864
6834,0.7655,5,9,5,601125,4485,105353,2603,0.04154470339768054,0.3672404063205418
6835,0.7656,5,16,5,601141,4469,105358,2598,0.04139649486827967,0.3676241686712891
6836,0.7657,9,12,9,601153,4457,105367,2589,0.04128533847122902,0.36744252057905197
6837,0.7658,18,27,18,601180,4430,105385,2571,0.04103523657786506,0.36723325239251536
6838,0.7659,11,21,11,601201,4409,105396,2560,0.04084071288302642,0.3673410819342804
6839,0.766,5,15,5,601216,4394,105401,2555,0.040701767386713106,0.36767880270542525
6840,0.7661,5,11,5,601227,4383,105406,2550,0.04059987402275001,0.36780614452617916
6841,0.7662,4,8,4,601235,4375,105410,2546,0.04052576975804958,0.3678659153301546
6842,0.7663,4,7,4,601242,4368,105414,2542,0.04046092852643669,0.3678726483357453
6843,0.7664,7,16,7,601258,4352,105421,2535,0.04031271999703583,0.3680847974444606
6844,0.7665,6,13,6,601271,4339,105427,2529,0.040192300566897626,0.3682294700058241
6845,0.7666,13,9,13,601280,4330,105440,2516,0.04010893326910964,0.3675138767163307
6846,0.7667,5,6,5,601286,4324,105445,2511,0.040053355070584315,0.36737381126554497
6847,0.7668,10,14,10,601300,4310,105455,2501,0.03992367260735855,0.3672001174570548
6848,0.7669,4,15,4,601315,4295,105459,2497,0.03978472711104524,0.3676383981154299
6849,0.767,5,14,5,601329,4281,105464,2492,0.03965504464781948,0.36793149269156944
6850,0.7671,7,13,7,601342,4268,105471,2485,0.03953462521768128,0.3679845994372871
6851,0.7672,6,24,6,601366,4244,105477,2479,0.03931231242357998,0.368734196043433
6852,0.7673,11,15,11,601381,4229,105488,2468,0.03917336692726667,0.36852321935194865
6853,0.7674,2,10,2,601391,4219,105490,2466,0.03908073659639112,0.368885564697083
6854,0.7675,5,16,5,601407,4203,105495,2461,0.038932528066990255,0.36929771908763503
6855,0.7676,12,15,12,601422,4188,105507,2449,0.03879358257067694,0.3689920144643664
6856,0.7677,7,7,7,601429,4181,105514,2442,0.038728741339064066,0.3687150837988827
6857,0.7678,15,16,15,601445,4165,105529,2427,0.0385805328096632,0.36817354368932037
6858,0.7679,14,17,14,601462,4148,105543,2413,0.038423061247174775,0.36777930193568054
6859,0.768,5,5,5,601467,4143,105548,2408,0.038376746081737,0.36757746908868877
6860,0.7681,16,29,16,601496,4114,105564,2392,0.038108118122197936,0.3676606209652628
6861,0.7682,3,22,3,601518,4092,105567,2389,0.03790433139427174,0.3686159543280358
6862,0.7683,3,6,3,601524,4086,105570,2386,0.03784875319574642,0.36866501854140915
6863,0.7684,4,12,4,601536,4074,105574,2382,0.03773759679869577,0.36895910780669144
6864,0.7685,9,14,9,601550,4060,105583,2373,0.037607914335470005,0.36887921653971706
6865,0.7686,7,6,7,601556,4054,105590,2366,0.03755233613694468,0.36853582554517134
6866,0.7687,4,13,4,601569,4041,105594,2362,0.03743191670680648,0.36888958300796504
6867,0.7688,4,11,4,601580,4030,105598,2358,0.03733002334284338,0.3691296180338134
6868,0.7689,10,22,10,601602,4008,105608,2348,0.03712623661491719,0.3694147262429201
6869,0.769,8,7,8,601609,4001,105616,2340,0.03706139538330431,0.3690269673553067
6870,0.7691,7,6,7,601615,3995,105623,2333,0.03700581718477899,0.3686788874841972
6871,0.7692,12,21,12,601636,3974,105635,2321,0.03681129348994035,0.3687053216838761
6872,0.7693,12,22,12,601658,3952,105647,2309,0.03660750676201415,0.3687909279667785
6873,0.7694,19,33,19,601691,3919,105666,2290,0.03630182667012487,0.36881945562892576
6874,0.7695,3,5,3,601696,3914,105669,2287,0.036255511504687095,0.3688114820190292
6875,0.7696,10,5,10,601701,3909,105679,2277,0.03620919633924932,0.3680892337536372
6876,0.7697,4,13,4,601714,3896,105683,2273,0.03608877690911112,0.3684551791214135
6877,0.7698,7,9,7,601723,3887,105690,2266,0.03600540961132313,0.3682756379002113
6878,0.7699,5,18,5,601741,3869,105695,2261,0.035838675015747154,0.36884176182707995
6879,0.77,6,5,6,601746,3864,105701,2255,0.03579235985030939,0.3685242686713515
6880,0.7701,0,3,0,601749,3861,105701,2255,0.03576457075104672,0.368705035971223
6881,0.7702,0,5,0,601754,3856,105701,2255,0.035718255585608955,0.3690067092128948
6882,0.7703,2,2,2,601756,3854,105703,2253,0.03569972951943384,0.36892091043065334
6883,0.7704,5,12,5,601768,3842,105708,2248,0.03558857312238319,0.3691297208538588
6884,0.7705,4,12,4,601780,3830,105712,2244,0.03547741672533254,0.3694435297991439
6885,0.7706,2,2,2,601782,3828,105714,2242,0.03545889065915744,0.36935749588138383
6886,0.7707,11,32,11,601814,3796,105725,2231,0.0351624736003557,0.37016757922681265
6887,0.7708,12,26,12,601840,3770,105737,2219,0.03492163474007929,0.37051260644514944
6888,0.7709,8,13,8,601853,3757,105745,2211,0.03480121530994109,0.37047587131367293
6889,0.771,10,14,10,601867,3743,105755,2201,0.03467153284671533,0.3702893674293405
6890,0.7711,10,22,10,601889,3721,105765,2191,0.03446774611878914,0.3706021650879567
6891,0.7712,3,15,3,601904,3706,105768,2188,0.03432880062247582,0.3712249745503902
6892,0.7713,5,10,5,601914,3696,105773,2183,0.03423617029160028,0.3713216533424052
6893,0.7714,5,4,5,601918,3692,105778,2178,0.034199118159250065,0.37103918228279387
6894,0.7715,8,8,8,601926,3684,105786,2170,0.03412501389454963,0.37068670994192005
6895,0.7716,10,20,10,601946,3664,105796,2160,0.03393975323279855,0.3708791208791209
6896,0.7717,4,8,4,601954,3656,105800,2156,0.033865648968098114,0.370956641431521
6897,0.7718,8,15,8,601969,3641,105808,2148,0.0337267034717848,0.3710485403351183
6898,0.7719,7,12,7,601981,3629,105815,2141,0.03361554707473415,0.3710571923743501
6899,0.772,10,15,10,601996,3614,105825,2131,0.03347660157842084,0.37093124456048737
6900,0.7721,8,24,8,602020,3590,105833,2123,0.03325428878431954,0.37160861193768596
6901,0.7722,14,18,14,602038,3572,105847,2109,0.03308755418874356,0.3712374581939799
6902,0.7723,2,5,2,602043,3567,105849,2107,0.03304123902330579,0.37134296792386323
6903,0.7724,15,18,15,602061,3549,105864,2092,0.032874504427729816,0.37085623116468713
6904,0.7725,5,4,5,602065,3545,105869,2087,0.0328374522953796,0.37056107954545453
6905,0.7726,5,9,5,602074,3536,105874,2082,0.03275408499759161,0.3705945176219295
6906,0.7727,10,7,10,602081,3529,105884,2072,0.03268924376597873,0.3699339403677915
6907,0.7728,3,11,3,602092,3518,105887,2069,0.03258735040201564,0.3703239663504564
6908,0.7729,5,11,5,602103,3507,105892,2064,0.03248545703805254,0.37049003769520733
6909,0.773,25,37,25,602140,3470,105917,2039,0.032142724813813035,0.3701216191686331
6910,0.7731,7,7,7,602147,3463,105924,2032,0.03207788358220016,0.36979071883530484
6911,0.7732,5,16,5,602163,3447,105929,2027,0.03192967505279929,0.3702959444647424
6912,0.7733,16,18,16,602181,3429,105945,2011,0.03176294045722331,0.36966911764705884
6913,0.7734,3,4,3,602185,3425,105948,2008,0.031725888324873094,0.36959322657831767
6914,0.7735,5,5,5,602190,3420,105953,2003,0.03167957315943533,0.3693527567766919
6915,0.7736,3,9,3,602199,3411,105956,2000,0.03159620586164734,0.36961744594344853
6916,0.7737,22,29,22,602228,3382,105978,1978,0.031327577902108265,0.36902985074626865
6917,0.7738,13,23,13,602251,3359,105991,1965,0.03111452814109452,0.36908339594290007
6918,0.7739,0,4,0,602255,3355,105991,1965,0.031077476008744304,0.3693609022556391
6919,0.774,4,6,4,602261,3349,105995,1961,0.03102189781021898,0.36930320150659135
6920,0.7741,0,6,0,602267,3343,105995,1961,0.030966319611693653,0.3697209653092006
6921,0.7742,9,11,9,602278,3332,106004,1952,0.030864426247730555,0.36941710825132473
6922,0.7743,10,24,10,602302,3308,106014,1942,0.030642113453629258,0.3699047619047619
6923,0.7744,2,5,2,602307,3303,106016,1940,0.030595798288191485,0.3700171657448026
6924,0.7745,18,17,18,602324,3286,106034,1922,0.030438326725703065,0.36904761904761907
6925,0.7746,5,33,5,602357,3253,106039,1917,0.030132646633813775,0.3707930367504836
6926,0.7747,10,17,10,602374,3236,106049,1907,0.029975175071325355,0.370795255687342
6927,0.7748,4,12,4,602386,3224,106053,1903,0.029864018674274705,0.3711722254729862
6928,0.7749,13,19,13,602405,3205,106066,1890,0.029688021045611176,0.37095191364082436
6929,0.775,11,14,11,602419,3191,106077,1879,0.029558338582385418,0.37061143984220907
6930,0.7751,5,4,5,602423,3187,106082,1874,0.0295212864500352,0.370282552855167
6931,0.7752,6,10,6,602433,3177,106088,1868,0.02942865611915966,0.3702675916749257
6932,0.7753,9,6,9,602439,3171,106097,1859,0.029373077920634334,0.3695825049701789
6933,0.7754,3,8,3,602447,3163,106100,1856,0.0292989736559339,0.36979477983662085
6934,0.7755,15,17,15,602464,3146,106115,1841,0.029141502093445477,0.36915981552035293
6935,0.7756,5,10,5,602474,3136,106120,1836,0.029048871762569935,0.3692679002413516
6936,0.7757,2,9,2,602483,3127,106122,1834,0.02896550446478195,0.36968353154605926
6937,0.7758,7,19,7,602502,3108,106129,1827,0.028789506836118417,0.3702127659574468
6938,0.7759,2,10,2,602512,3098,106131,1825,0.02869687650524288,0.37070891732683325
6939,0.776,7,4,7,602516,3094,106138,1818,0.02865982437289266,0.370114006514658
6940,0.7761,6,6,6,602522,3088,106144,1812,0.028604246174367336,0.36979591836734693
6941,0.7762,1,4,1,602526,3084,106145,1811,0.02856719404201712,0.36996935648621043
6942,0.7763,3,8,3,602534,3076,106148,1808,0.028493089777316686,0.3701883701883702
6943,0.7764,5,9,5,602543,3067,106153,1803,0.028409722479528696,0.3702258726899384
6944,0.7765,3,6,3,602549,3061,106156,1800,0.02835414428100337,0.3702941781526435
6945,0.7766,5,7,5,602556,3054,106161,1795,0.028289303049390493,0.3701794184367911
6946,0.7767,3,3,3,602559,3051,106164,1792,0.02826151395012783,0.37001858352260997
6947,0.7768,8,10,8,602569,3041,106172,1784,0.028168883619252287,0.36974093264248703
6948,0.7769,6,8,6,602577,3033,106178,1778,0.028094779354551853,0.36956973602161713
6949,0.777,1,3,1,602580,3030,106179,1777,0.028066990255289193,0.3696692323694612
6950,0.7771,8,12,8,602592,3018,106187,1769,0.027955833858238542,0.36954251096720286
6951,0.7772,5,14,5,602606,3004,106192,1764,0.027826151395012783,0.3699664429530201
6952,0.7773,3,2,3,602608,3002,106195,1761,0.027807625328837675,0.36972496325845056
6953,0.7774,5,11,5,602619,2991,106200,1756,0.027705731964874577,0.3699178428481146
6954,0.7775,0,2,0,602621,2989,106200,1756,0.02768720589869947,0.3700737618545838
6955,0.7776,2,3,2,602624,2986,106202,1754,0.027659416799436808,0.370042194092827
6956,0.7777,5,10,5,602634,2976,106207,1749,0.027566786468561266,0.37015873015873013
6957,0.7778,4,10,4,602644,2966,106211,1745,0.027474156137685724,0.3704096794735725
6958,0.7779,3,14,3,602658,2952,106214,1742,0.027344473674459965,0.37111205794631447
6959,0.778,4,8,4,602666,2944,106218,1738,0.02727036940975953,0.3712088850918411
6960,0.7781,2,0,2,602666,2944,106220,1736,0.02727036940975953,0.37094017094017095
6961,0.7782,6,11,6,602677,2933,106226,1730,0.027168476045796437,0.37100579026377867
6962,0.7783,5,11,5,602688,2922,106231,1725,0.02706658268183334,0.3712072304712718
6963,0.7784,5,9,5,602697,2913,106236,1720,0.026983215384045352,0.371249730196417
6964,0.7785,9,9,9,602706,2904,106245,1711,0.026899848086257363,0.37074756229685807
6965,0.7786,3,9,3,602715,2895,106248,1708,0.026816480788469377,0.3710623506408864
6966,0.7787,5,15,5,602730,2880,106253,1703,0.026677535292156062,0.3715906611389919
6967,0.7788,10,19,10,602749,2861,106263,1693,0.026501537663492534,0.3717610891523935
6968,0.7789,3,3,3,602752,2858,106266,1690,0.026473748564229873,0.37159190853122254
6969,0.779,2,4,2,602756,2854,106268,1688,0.026436696431879656,0.3716424482606781
6970,0.7791,4,9,4,602765,2845,106272,1684,0.026353329134091667,0.3718260101567675
6971,0.7792,2,7,2,602772,2838,106274,1682,0.02628848790247879,0.37212389380530975
6972,0.7793,5,7,5,602779,2831,106279,1677,0.026223646670865908,0.3720053238686779
6973,0.7794,12,21,12,602800,2810,106291,1665,0.02602912297602727,0.37206703910614525
6974,0.7795,2,2,2,602802,2808,106293,1663,0.026010596909852163,0.3719525833146947
6975,0.7796,7,10,7,602812,2798,106300,1656,0.02591796657897662,0.3718006286484059
6976,0.7797,5,2,5,602814,2796,106305,1651,0.025899440512801512,0.37126152462334155
6977,0.7798,6,12,6,602826,2784,106311,1645,0.025788284115750862,0.3714156694513434
6978,0.7799,6,19,6,602845,2765,106317,1639,0.02561228648708733,0.37216167120799276
6979,0.78,3,11,3,602856,2754,106320,1636,0.025510393123124236,0.3726651480637813
6980,0.7801,3,8,3,602864,2746,106323,1633,0.025436288858423802,0.37291619091116696
6981,0.7802,9,6,9,602870,2740,106332,1624,0.025380710659898477,0.3721356553620532
6982,0.7803,8,8,8,602878,2732,106340,1616,0.025306606395198043,0.3716651333946642
6983,0.7804,2,13,2,602891,2719,106342,1614,0.02518618696505984,0.3724901915531964
6984,0.7805,2,6,2,602897,2713,106344,1612,0.025130608766534515,0.3727167630057803
6985,0.7806,11,12,11,602909,2701,106355,1601,0.025019452369483865,0.37215248721524874
6986,0.7807,11,15,11,602924,2686,106366,1590,0.02488050687317055,0.37184284377923293
6987,0.7808,3,5,3,602929,2681,106369,1587,0.02483419170773278,0.3718369259606373
6988,0.7809,6,11,6,602940,2670,106375,1581,0.024732298343769683,0.37191249117854625
6989,0.781,9,3,9,602943,2667,106384,1572,0.024704509244507022,0.3708421797593772
6990,0.7811,9,20,9,602963,2647,106393,1563,0.024519248582755938,0.37125890736342043
6991,0.7812,7,9,7,602972,2638,106400,1556,0.02443588128496795,0.3710061993323796
6992,0.7813,6,4,6,602976,2634,106406,1550,0.024398829152617735,0.3704588910133843
6993,0.7814,3,4,3,602980,2630,106409,1547,0.024361777020267518,0.37036150347139096
6994,0.7815,0,4,0,602984,2626,106409,1547,0.0243247248879173,0.3707165109034268
6995,0.7816,15,27,15,603011,2599,106424,1532,0.024074622994553336,0.37085451464536434
6996,0.7817,4,6,4,603017,2593,106428,1528,0.02401904479602801,0.37078379034215
6997,0.7818,16,12,16,603029,2581,106444,1512,0.02390788839897736,0.3694111898363059
6998,0.7819,2,11,2,603040,2570,106446,1510,0.023805995035014266,0.3700980392156863
6999,0.782,3,7,3,603047,2563,106449,1507,0.023741153803401385,0.37027027027027026
7000,0.7821,13,22,13,603069,2541,106462,1494,0.023537367075475192,0.3702602230483271
7001,0.7822,6,9,6,603078,2532,106468,1488,0.023453999777687206,0.3701492537313433
7002,0.7823,9,11,9,603089,2521,106477,1479,0.02335210641372411,0.36975
7003,0.7824,3,6,3,603095,2515,106480,1476,0.023296528215198786,0.369832122275119
7004,0.7825,5,16,5,603111,2499,106485,1471,0.02314831968579792,0.37052896725440804
7005,0.7826,2,5,2,603116,2494,106487,1469,0.023102004520360146,0.37067877870300275
7006,0.7827,7,16,7,603132,2478,106494,1462,0.02295379599095928,0.3710659898477157
7007,0.7828,4,7,4,603139,2471,106498,1458,0.0228889547593464,0.371086790531942
7008,0.7829,5,4,5,603143,2467,106503,1453,0.022851902626996184,0.3706632653061224
7009,0.783,4,5,4,603148,2462,106507,1449,0.02280558746155841,0.37049347992840703
7010,0.7831,1,7,1,603155,2455,106508,1448,0.022740746229945534,0.37099666922879837
7011,0.7832,1,3,1,603158,2452,106509,1447,0.02271295713068287,0.3711208002051808
7012,0.7833,6,15,6,603173,2437,106515,1441,0.02257401163436956,0.3715832903558535
7013,0.7834,3,3,3,603176,2434,106518,1438,0.022546222535106894,0.37138429752066116
7014,0.7835,14,8,14,603184,2426,106532,1424,0.02247211827040646,0.36987012987012985
7015,0.7836,5,13,5,603197,2413,106537,1419,0.022351698840268257,0.3703027139874739
7016,0.7837,5,12,5,603209,2401,106542,1414,0.022240542443217607,0.3706422018348624
7017,0.7838,3,5,3,603214,2396,106545,1411,0.022194227277779838,0.37063304439190964
7018,0.7839,12,18,12,603232,2378,106557,1399,0.022027492682203862,0.3703997881916865
7019,0.784,12,23,12,603255,2355,106569,1387,0.021814442921190114,0.3706574024585783
7020,0.7841,3,3,3,603258,2352,106572,1384,0.021786653821927453,0.37044967880085655
7021,0.7842,4,6,4,603264,2346,106576,1380,0.021731075623402128,0.37037037037037035
7022,0.7843,0,3,0,603267,2343,106576,1380,0.021703286524139463,0.370668815471394
7023,0.7844,8,2,8,603269,2341,106584,1372,0.021684760457964355,0.36951252356584974
7024,0.7845,3,5,3,603274,2336,106587,1369,0.021638445292526585,0.36950067476383264
7025,0.7846,2,13,2,603287,2323,106589,1367,0.02151802586238838,0.37046070460704605
7026,0.7847,3,5,3,603292,2318,106592,1364,0.02147171069695061,0.3704508419337317
7027,0.7848,9,10,9,603302,2308,106601,1355,0.021379080366075068,0.36991536991536994
7028,0.7849,7,9,7,603311,2299,106608,1348,0.021295713068287078,0.36961886482040035
7029,0.785,4,6,4,603317,2293,106612,1344,0.021240134869761756,0.36953533131701954
7030,0.7851,13,21,13,603338,2272,106625,1331,0.021045611174923116,0.3694143769081321
7031,0.7852,1,6,1,603344,2266,106626,1330,0.02099003297639779,0.36985539488320357
7032,0.7853,10,13,10,603357,2253,106636,1320,0.02086961354625959,0.3694374475230898
7033,0.7854,12,10,12,603367,2243,106648,1308,0.020776983215384046,0.3683469445226697
7034,0.7855,3,4,3,603371,2239,106651,1305,0.02073993108303383,0.3682279909706546
7035,0.7856,2,3,2,603374,2236,106653,1303,0.020712141983771165,0.36818310257134784
7036,0.7857,6,9,6,603383,2227,106659,1297,0.02062877468598318,0.3680476730987514
7037,0.7858,9,12,9,603395,2215,106668,1288,0.02051761828893253,0.3676848415643734
7038,0.7859,1,5,1,603400,2210,106669,1287,0.020471303123494756,0.3680297397769517
7039,0.786,2,11,2,603411,2199,106671,1285,0.02036940975953166,0.3688289322617681
7040,0.7861,8,13,8,603424,2186,106679,1277,0.020248990329393455,0.36875541438059484
7041,0.7862,3,6,3,603430,2180,106682,1274,0.020193412130868133,0.3688477127967574
7042,0.7863,7,11,7,603441,2169,106689,1267,0.020091518766905035,0.36874272409778813
7043,0.7864,5,12,5,603453,2157,106694,1262,0.019980362369854385,0.3691137759578824
7044,0.7865,3,4,3,603457,2153,106697,1259,0.019943310237504168,0.3689917936694021
7045,0.7866,6,11,6,603468,2142,106703,1253,0.019841416873541073,0.36907216494845363
7046,0.7867,4,5,4,603473,2137,106707,1249,0.0197951017081033,0.36887182516243355
7047,0.7868,4,7,4,603480,2130,106711,1245,0.019730260476490423,0.3688888888888889
7048,0.7869,3,8,3,603488,2122,106714,1242,0.01965615621178999,0.3692033293697979
7049,0.787,0,6,0,603494,2116,106714,1242,0.019600578013264664,0.3698630136986301
7050,0.7871,9,21,9,603515,2095,106723,1233,0.019406054318426024,0.37049278846153844
7051,0.7872,3,8,3,603523,2087,106726,1230,0.01933195005372559,0.3708170033162496
7052,0.7873,6,29,6,603552,2058,106732,1224,0.01906332209418652,0.37294332723948814
7053,0.7874,3,4,3,603556,2054,106735,1221,0.019026269961836303,0.37282442748091604
7054,0.7875,3,3,3,603559,2051,106738,1218,0.018998480862573643,0.37259100642398285
7055,0.7876,7,6,7,603565,2045,106745,1211,0.018942902664048317,0.37192874692874694
7056,0.7877,4,9,4,603574,2036,106749,1207,0.018859535366260328,0.372186247301881
7057,0.7878,5,5,5,603579,2031,106754,1202,0.01881322020082256,0.37179090627899786
7058,0.7879,7,8,7,603587,2023,106761,1195,0.018739115936122125,0.3713486637663145
7059,0.788,4,4,4,603591,2019,106765,1191,0.018702063803771908,0.3710280373831776
7060,0.7881,1,0,1,603591,2019,106766,1190,0.018702063803771908,0.3708320349018386
7061,0.7882,12,22,12,603613,1997,106778,1178,0.018498277075845716,0.3710236220472441
7062,0.7883,5,15,5,603628,1982,106783,1173,0.0183593315795324,0.3717908082408875
7063,0.7884,0,4,0,603632,1978,106783,1173,0.018322279447182184,0.3722627737226277
7064,0.7885,2,3,2,603635,1975,106785,1171,0.018294490347919523,0.3722186904005086
7065,0.7886,1,3,1,603638,1972,106786,1170,0.01826670124865686,0.3723742838956079
7066,0.7887,2,4,2,603642,1968,106788,1168,0.018229649116306642,0.37244897959183676
7067,0.7888,6,19,6,603661,1949,106794,1162,0.018053651487643114,0.37351333976213436
7068,0.7889,3,7,3,603668,1942,106797,1159,0.017988810256030236,0.37375040309577556
7069,0.789,4,5,4,603673,1937,106801,1155,0.017942495090592463,0.37354463130659765
7070,0.7891,7,20,7,603693,1917,106808,1148,0.01775723442884138,0.3745513866231648
7071,0.7892,5,4,5,603697,1913,106813,1143,0.017720182296491162,0.37401832460732987
7072,0.7893,4,4,4,603701,1909,106817,1139,0.017683130164140946,0.37368766404199477
7073,0.7894,2,4,2,603705,1905,106819,1137,0.01764607803179073,0.373767258382643
7074,0.7895,1,4,1,603709,1901,106820,1136,0.017609025899440512,0.3740533421139282
7075,0.7896,1,5,1,603714,1896,106821,1135,0.017562710734002743,0.3744638733091389
7076,0.7897,2,7,2,603721,1889,106823,1133,0.01749786950238986,0.3749172733289212
7077,0.7898,1,8,1,603729,1881,106824,1132,0.017423765237689428,0.37570527713242613
7078,0.7899,6,16,6,603745,1865,106830,1126,0.01727555670828856,0.37646272149782684
7079,0.79,1,7,1,603752,1858,106831,1125,0.017210715476675683,0.3771371102916527
7080,0.7901,1,4,1,603756,1854,106832,1124,0.017173663344325466,0.3774345198119543
7081,0.7902,1,2,1,603758,1852,106833,1123,0.017155137278150358,0.37747899159663867
7082,0.7903,2,7,2,603765,1845,106835,1121,0.017090296046537477,0.377950101146325
7083,0.7904,7,5,7,603770,1840,106842,1114,0.017043980881099707,0.37711577522004064
7084,0.7905,6,6,6,603776,1834,106848,1108,0.016988402682574382,0.37661454792658056
7085,0.7906,10,21,10,603797,1813,106858,1098,0.016793878987735746,0.3771899690827894
7086,0.7907,3,7,3,603804,1806,106861,1095,0.016729037756122864,0.37745604963805585
7087,0.7908,3,5,3,603809,1801,106864,1092,0.016682722590685095,0.37746284134116836
7088,0.7909,7,18,7,603827,1783,106871,1085,0.01651598799510912,0.3783124128312413
7089,0.791,1,1,1,603828,1782,106872,1084,0.016506724962021564,0.3782274947662247
7090,0.7911,11,11,11,603839,1771,106883,1073,0.01640483159805847,0.3772855133614627
7091,0.7912,4,12,4,603851,1759,106887,1069,0.01629367520100782,0.378005657708628
7092,0.7913,8,12,8,603863,1747,106895,1061,0.016182518803957168,0.37784900284900286
7093,0.7914,3,6,3,603869,1741,106898,1058,0.016126940605431843,0.37799214005001786
7094,0.7915,6,11,6,603880,1730,106904,1052,0.016025047241468745,0.37814521926671457
7095,0.7916,7,5,7,603885,1725,106911,1045,0.015978732076030976,0.37725631768953066
7096,0.7917,3,8,3,603893,1717,106914,1042,0.015904627811330542,0.37767306995288147
7097,0.7918,10,12,10,603905,1705,106924,1032,0.01579347141427989,0.3770551698940446
7098,0.7919,2,4,2,603909,1701,106926,1030,0.015756419281929675,0.37715122665690226
7099,0.792,13,8,13,603917,1693,106939,1017,0.01568231501722924,0.3752767527675277
7100,0.7921,7,5,7,603922,1688,106946,1010,0.015635999851791472,0.374351371386212
7101,0.7922,2,10,2,603932,1678,106948,1008,0.015543369520915928,0.37527922561429633
7102,0.7923,4,6,4,603938,1672,106952,1004,0.015487791322390603,0.375186846038864
7103,0.7924,0,1,0,603939,1671,106952,1004,0.015478528289303049,0.3753271028037383
7104,0.7925,6,16,6,603955,1655,106958,998,0.015330319759902183,0.37617791179796456
7105,0.7926,11,12,11,603967,1643,106969,987,0.015219163362851533,0.3752851711026616
7106,0.7927,4,13,4,603980,1630,106973,983,0.015098743932713328,0.37619594336012246
7107,0.7928,6,15,6,603995,1615,106979,977,0.014959798436400015,0.376929012345679
7108,0.7929,4,2,4,603997,1613,106983,973,0.014941272370224907,0.3762567672080433
7109,0.793,4,4,4,604001,1609,106987,969,0.01490422023787469,0.37587276958882854
7110,0.7931,1,2,1,604003,1607,106988,968,0.014885694171699581,0.37592233009708736
7111,0.7932,1,3,1,604006,1604,106989,967,0.014857905072436919,0.37611824192921045
7112,0.7933,2,6,2,604012,1598,106991,965,0.014802326873911593,0.3765119001170503
7113,0.7934,2,8,2,604020,1590,106993,963,0.01472822260921116,0.3772032902467685
7114,0.7935,2,7,2,604027,1583,106995,961,0.01466338137759828,0.37775157232704404
7115,0.7936,2,3,2,604030,1580,106997,959,0.014635592278335618,0.3777077589602206
7116,0.7937,5,6,5,604036,1574,107002,954,0.014580014079810293,0.377373417721519
7117,0.7938,4,3,4,604039,1571,107006,950,0.01455222498054763,0.3768345894486315
7118,0.7939,3,8,3,604047,1563,107009,947,0.014478120715847196,0.3772908366533865
7119,0.794,10,27,10,604074,1536,107019,937,0.014228018822483235,0.3788920339668419
7120,0.7941,6,10,6,604084,1526,107025,931,0.014135388491607693,0.3789173789173789
7121,0.7942,5,7,5,604091,1519,107030,926,0.014070547259994813,0.3787321063394683
7122,0.7943,0,5,0,604096,1514,107030,926,0.014024232094557042,0.3795081967213115
7123,0.7944,0,8,0,604104,1506,107030,926,0.013950127829856608,0.3807565789473684
7124,0.7945,5,10,5,604114,1496,107035,921,0.013857497498981066,0.3810508895324783
7125,0.7947,5,6,5,604120,1490,107040,916,0.013801919300455741,0.38071487946799665
7126,0.7948,10,11,10,604131,1479,107050,906,0.013700025936492645,0.379874213836478
7127,0.7949,6,9,6,604140,1470,107056,900,0.013616658638704657,0.379746835443038
7128,0.795,7,17,7,604157,1453,107063,893,0.013459187076216236,0.38064791133844844
7129,0.7951,0,7,0,604164,1446,107063,893,0.013394345844603356,0.3817870884993587
7130,0.7952,6,5,6,604169,1441,107069,887,0.013348030679165585,0.38101374570446733
7131,0.7953,3,3,3,604172,1438,107072,884,0.013320241579902923,0.3807062876830319
7132,0.7954,0,5,0,604177,1433,107072,884,0.013273926414465153,0.3815278377211912
7133,0.7955,5,7,5,604184,1426,107077,879,0.013209085182852274,0.3813449023861171
7134,0.7956,8,11,8,604195,1415,107085,871,0.013107191818889178,0.3810148731408574
7135,0.7957,1,9,1,604204,1406,107086,870,0.01302382452110119,0.38224956063268895
7136,0.7958,4,6,4,604210,1400,107090,866,0.012968246322575865,0.382171226831421
7137,0.7959,0,1,0,604211,1399,107090,866,0.01295898328948831,0.3823399558498896
7138,0.796,1,4,1,604215,1395,107091,865,0.012921931157138094,0.3827433628318584
7139,0.7961,2,10,2,604225,1385,107093,863,0.012829300826262552,0.38389679715302494
7140,0.7962,7,7,7,604232,1378,107100,856,0.012764459594649672,0.38316920322291853
7141,0.7963,2,6,2,604238,1372,107102,854,0.012708881396124347,0.3836477987421384
7142,0.7964,2,4,2,604242,1368,107104,852,0.01267182926377413,0.3837837837837838
7143,0.7965,0,5,0,604247,1363,107104,852,0.012625514098336359,0.38465011286681716
7144,0.7967,0,1,0,604248,1362,107104,852,0.012616251065248805,0.38482384823848237
7145,0.7968,10,14,10,604262,1348,107114,842,0.012486568602023046,0.38447488584474887
7146,0.7969,2,3,2,604265,1345,107116,840,0.012458779502760383,0.38443935926773454
7147,0.797,3,7,3,604272,1338,107119,837,0.012393938271147504,0.38482758620689655
7148,0.7971,1,6,1,604278,1332,107120,836,0.012338360072622179,0.3856088560885609
7149,0.7972,6,16,6,604294,1316,107126,830,0.012190151543221313,0.38676607642124883
7150,0.7973,11,14,11,604308,1302,107137,819,0.012060469079995554,0.38613861386138615
7151,0.7974,12,8,12,604316,1294,107149,807,0.01198636481529512,0.3841028081865778
7152,0.7975,6,13,6,604329,1281,107155,801,0.011865945385156916,0.38472622478386165
7153,0.7976,2,6,2,604335,1275,107157,799,0.01181036718663159,0.38524590163934425
7154,0.7977,14,10,14,604345,1265,107171,785,0.011717736855756049,0.3829268292682927
7155,0.7978,1,0,1,604345,1265,107172,784,0.011717736855756049,0.3826256710590532
7156,0.7979,6,13,6,604358,1252,107178,778,0.011597317425617844,0.3832512315270936
7157,0.798,1,2,1,604360,1250,107179,777,0.011578791359442736,0.38332511100148003
7158,0.7981,7,2,7,604362,1248,107186,770,0.011560265293267627,0.3815659068384539
7159,0.7982,1,1,1,604363,1247,107187,769,0.011551002260180073,0.3814484126984127
7160,0.7983,11,16,11,604379,1231,107198,758,0.011402793730779206,0.38109602815485166
7161,0.7984,11,5,11,604384,1226,107209,747,0.011356478565341435,0.3786112519006589
7162,0.7985,6,8,6,604392,1218,107215,741,0.011282374300641001,0.3782542113323124
7163,0.7986,1,2,1,604394,1216,107216,740,0.011263848234465893,0.3783231083844581
7164,0.7987,2,8,2,604402,1208,107218,738,0.01118974396976546,0.37923946557040084
7165,0.7988,4,5,4,604407,1203,107222,734,0.01114342880432769,0.3789364997418689
7166,0.7989,5,6,5,604413,1197,107227,729,0.011087850605802365,0.37850467289719625
7167,0.799,2,5,2,604418,1192,107229,727,0.011041535440364594,0.37884314747264203
7168,0.7991,5,12,5,604430,1180,107234,722,0.010930379043313943,0.37960042060988436
7169,0.7993,3,6,3,604436,1174,107237,719,0.010874800844788618,0.3798203909138933
7170,0.7994,5,3,5,604439,1171,107242,714,0.010847011745525955,0.3787798408488064
7171,0.7995,1,8,1,604447,1163,107243,713,0.010772907480825522,0.3800639658848614
7172,0.7996,1,2,1,604449,1161,107244,712,0.010754381414650413,0.3801388147357181
7173,0.7997,2,5,2,604454,1156,107246,710,0.010708066249212642,0.3804930332261522
7174,0.7998,1,0,1,604454,1156,107247,709,0.010708066249212642,0.3801608579088472
7175,0.7999,2,4,2,604458,1152,107249,707,0.010671014116862425,0.38031199569661106
7176,0.8,1,2,1,604460,1150,107250,706,0.010652488050687317,0.38038793103448276
7177,0.8001,0,1,0,604461,1149,107250,706,0.010643225017599763,0.3805929919137466
7178,0.8002,5,6,5,604467,1143,107255,701,0.010587646819074438,0.38015184381778744
7179,0.8003,2,10,2,604477,1133,107257,699,0.010495016488198896,0.38155021834061137
7180,0.8004,2,1,2,604478,1132,107259,697,0.010485753455111341,0.381082558775287
7181,0.8005,1,3,1,604481,1129,107260,696,0.010457964355848679,0.38136986301369863
7182,0.8006,2,0,2,604481,1129,107262,694,0.010457964355848679,0.38069116840373013
7183,0.8007,2,8,2,604489,1121,107264,692,0.010383860091148245,0.3816878102592388
7184,0.8008,2,4,2,604493,1117,107266,690,0.010346807958798028,0.38184836745987827
7185,0.8009,2,6,2,604499,1111,107268,688,0.010291229760272703,0.38243468593663144
7186,0.801,5,2,5,604501,1109,107273,683,0.010272703694097595,0.38113839285714285
7187,0.8011,4,3,4,604504,1106,107277,679,0.010244914594834932,0.3803921568627451
7188,0.8012,4,1,4,604505,1105,107281,675,0.010235651561747378,0.3792134831460674
7189,0.8013,6,8,6,604513,1097,107287,669,0.010161547297046944,0.37882219705549264
7190,0.8014,1,7,1,604520,1090,107288,668,0.010096706065434067,0.3799772468714448
7191,0.8015,3,4,3,604524,1086,107291,665,0.01005965393308385,0.3797829811536265
7192,0.8016,1,3,1,604527,1083,107292,664,0.010031864833821187,0.3800801373783629
7193,0.8017,9,28,9,604555,1055,107301,655,0.00977249990736967,0.3830409356725146
7194,0.8019,1,4,1,604559,1051,107302,654,0.009735447775019453,0.3835777126099707
7195,0.802,11,12,11,604571,1039,107313,643,0.009624291377968802,0.3822829964328181
7196,0.8021,7,11,7,604582,1028,107320,636,0.009522398014005706,0.38221153846153844
7197,0.8022,7,2,7,604584,1026,107327,629,0.009503871947830598,0.38006042296072506
7198,0.8023,0,2,0,604586,1024,107327,629,0.009485345881655489,0.38052026618269813
7199,0.8024,5,7,5,604593,1017,107332,624,0.00942050465004261,0.3802559414990859
7200,0.8025,6,14,6,604607,1003,107338,618,0.00929082218681685,0.3812461443553362
7201,0.8026,1,3,1,604610,1000,107339,617,0.009263033087554188,0.3815708101422387
7202,0.8027,1,5,1,604615,995,107340,616,0.009216717922116417,0.3823711980136561
7203,0.8028,1,0,1,604615,995,107341,615,0.009216717922116417,0.38198757763975155
7204,0.8029,2,5,2,604620,990,107343,613,0.009170402756678646,0.3824079850280724
7205,0.803,1,2,1,604622,988,107344,612,0.009151876690503538,0.3825
7206,0.8031,0,1,0,604623,987,107344,612,0.009142613657415984,0.3827392120075047
7207,0.8032,1,4,1,604627,983,107345,611,0.009105561525065767,0.3833124215809285
7208,0.8033,1,4,1,604631,979,107346,610,0.00906850939271555,0.3838892385147892
7209,0.8034,1,7,1,604638,972,107347,609,0.009003668161102672,0.38519924098671726
7210,0.8035,0,10,0,604648,962,107347,609,0.00891103783022713,0.38765117759388923
7211,0.8036,0,2,0,604650,960,107347,609,0.008892511764052022,0.3881453154875717
7212,0.8037,6,8,6,604658,952,107353,603,0.008818407499351588,0.3877813504823151
7213,0.8038,2,6,2,604664,946,107355,601,0.008762829300826263,0.3884938590820944
7214,0.8039,2,3,2,604667,943,107357,599,0.0087350402015636,0.38845654993514916
7215,0.804,6,7,6,604674,936,107363,593,0.008670198969950721,0.38783518639633746
7216,0.8041,4,13,4,604687,923,107367,589,0.008549779539812516,0.38955026455026454
7217,0.8042,5,4,5,604691,919,107372,584,0.0085127274074623,0.38855622089155023
7218,0.8043,5,6,5,604697,913,107377,579,0.008457149208936974,0.38806970509383376
7219,0.8044,9,14,9,604711,899,107386,570,0.008327466745711215,0.3880190605854323
7220,0.8045,2,1,2,604712,898,107388,568,0.008318203712623661,0.3874488403819918
7221,0.8046,8,11,8,604723,887,107396,560,0.008216310348660565,0.387007601935038
7222,0.8047,0,1,0,604724,886,107396,560,0.00820704731557301,0.3872752420470263
7223,0.8048,1,3,1,604727,883,107397,559,0.008179258216310348,0.38765603328710124
7224,0.8049,2,4,2,604731,879,107399,557,0.008142206083960131,0.387883008356546
7225,0.805,3,0,3,604731,879,107402,554,0.008142206083960131,0.3866015352407537
7226,0.8051,0,7,0,604738,872,107402,554,0.008077364852347252,0.3884992987377279
7227,0.8052,2,9,2,604747,863,107404,552,0.007993997554559264,0.3901060070671378
7228,0.8053,1,3,1,604750,860,107405,551,0.007966208455296603,0.3905031892274982
7229,0.8054,2,3,2,604753,857,107407,549,0.00793841935603394,0.39046941678520625
7230,0.8055,4,13,4,604766,844,107411,545,0.007817999925895736,0.3923686105111591
7231,0.8056,0,2,0,604768,842,107411,545,0.007799473859720627,0.39293439077144915
7232,0.8057,3,5,3,604773,837,107414,542,0.007753158694282856,0.3930384336475707
7233,0.8058,5,7,5,604780,830,107419,537,0.007688317462669977,0.3928310168251646
7234,0.8059,4,1,4,604781,829,107423,533,0.007679054429582423,0.39133627019089573
7235,0.806,2,9,2,604790,820,107425,531,0.007595687131794435,0.3930421909696521
7236,0.8061,3,6,3,604796,814,107428,528,0.00754010893326911,0.39344262295081966
7237,0.8062,1,1,1,604797,813,107429,527,0.007530845900181556,0.3932835820895522
7238,0.8063,6,4,6,604801,809,107435,521,0.007493793767831339,0.39172932330827065
7239,0.8064,8,12,8,604813,797,107443,513,0.007382637370780688,0.3916030534351145
7240,0.8065,1,3,1,604816,794,107444,512,0.007354848271518026,0.39203675344563554
7241,0.8066,1,1,1,604817,793,107445,511,0.0073455852384304715,0.3918711656441718
7242,0.8067,0,1,0,604818,792,107445,511,0.007336322205342917,0.39217191097467385
7243,0.8068,3,1,3,604819,791,107448,508,0.007327059172255363,0.39107005388760585
7244,0.8069,1,0,1,604819,791,107449,507,0.007327059172255363,0.39060092449922956
7245,0.807,2,1,2,604820,790,107451,505,0.007317796139167809,0.38996138996138996
7246,0.8071,5,3,5,604823,787,107456,500,0.007290007039905146,0.3885003885003885
7247,0.8072,2,7,2,604830,780,107458,498,0.007225165808292267,0.38967136150234744
7248,0.8073,2,0,2,604830,780,107460,496,0.007225165808292267,0.3887147335423197
7249,0.8074,2,2,2,604832,778,107462,494,0.0072066397421171585,0.38836477987421386
7250,0.8075,4,3,4,604835,775,107466,490,0.007178850642854497,0.38735177865612647
7251,0.8076,2,4,2,604839,771,107468,488,0.00714179851050428,0.3876092136616362
7252,0.8077,8,9,8,604848,762,107476,480,0.007058431212716292,0.3864734299516908
7253,0.8078,3,1,3,604849,761,107479,477,0.007049168179628738,0.3852988691437803
7254,0.8079,4,2,4,604851,759,107483,473,0.0070306421134536294,0.38392857142857145
7255,0.808,1,2,1,604853,757,107484,472,0.007012116047278521,0.3840520748576078
7256,0.8081,2,2,2,604855,755,107486,470,0.006993589981103413,0.3836734693877551
7257,0.8082,1,3,1,604858,752,107487,469,0.00696580088184075,0.3841113841113841
7258,0.8083,4,2,4,604860,750,107491,465,0.006947274815665642,0.38271604938271603
7259,0.8084,0,5,0,604865,745,107491,465,0.006900959650227871,0.384297520661157
7260,0.8085,2,7,2,604872,738,107493,463,0.006836118418614991,0.3855120732722731
7261,0.8086,0,4,0,604876,734,107493,463,0.006799066286264774,0.3868003341687552
7262,0.8087,1,4,1,604880,730,107494,462,0.0067620141539145575,0.3875838926174497
7263,0.8088,1,0,1,604880,730,107495,461,0.0067620141539145575,0.38706968933669184
7264,0.8089,5,5,5,604885,725,107500,456,0.0067156989884767865,0.3861134631668078
7265,0.809,3,6,3,604891,719,107503,453,0.006660120789951461,0.386518771331058
7266,0.8091,1,2,1,604893,717,107504,452,0.006641594723776354,0.3866552609067579
7267,0.8092,0,1,0,604894,716,107504,452,0.0066323316906887995,0.386986301369863
7268,0.8093,2,5,2,604899,711,107506,450,0.0065860165252510285,0.3875968992248062
7269,0.8094,3,3,3,604902,708,107509,447,0.006558227425988366,0.38701298701298703
7270,0.8095,3,4,3,604906,704,107512,444,0.006521175293638149,0.3867595818815331
7271,0.8096,6,5,6,604911,699,107518,438,0.006474860128200378,0.38522427440633245
7272,0.8097,1,5,1,604916,694,107519,437,0.006428544962762607,0.3863837312113174
7273,0.8098,2,2,2,604918,692,107521,435,0.006410018896587499,0.385980479148181
7274,0.8099,2,6,2,604924,686,107523,433,0.006354440698062173,0.386952636282395
7275,0.81,3,4,3,604928,682,107526,430,0.006317388565711957,0.38669064748201437
7276,0.8101,0,2,0,604930,680,107526,430,0.006298862499536848,0.38738738738738737
7277,0.8102,3,5,3,604935,675,107529,427,0.006252547334099077,0.3874773139745917
7278,0.8103,10,6,10,604941,669,107539,417,0.006196969135573752,0.3839779005524862
7279,0.8104,7,8,7,604949,661,107546,410,0.006122864870873318,0.3828197945845005
7280,0.8105,1,0,1,604949,661,107547,409,0.006122864870873318,0.3822429906542056
7281,0.8106,2,1,2,604950,660,107549,407,0.006113601837785765,0.38144329896907214
7282,0.8107,1,0,1,604950,660,107550,406,0.006113601837785765,0.3808630393996248
7283,0.8108,5,5,5,604955,655,107555,401,0.006067286672347994,0.3797348484848485
7284,0.8109,2,8,2,604963,647,107557,399,0.00599318240764756,0.381453154875717
7285,0.811,5,12,5,604975,635,107562,394,0.00588202601059691,0.38289601554907676
7286,0.8111,0,5,0,604980,630,107562,394,0.005835710845159139,0.384765625
7287,0.8112,0,2,0,604982,628,107562,394,0.0058171847789840305,0.38551859099804303
7288,0.8113,1,2,1,604984,626,107563,393,0.005798658712808922,0.3856722276741904
7289,0.8114,1,2,1,604986,624,107564,392,0.005780132646633814,0.3858267716535433
7290,0.8115,2,4,2,604990,620,107566,390,0.005743080514283597,0.38613861386138615
7291,0.8116,1,0,1,604990,620,107567,389,0.005743080514283597,0.3855302279484638
7292,0.8117,3,7,3,604997,613,107570,386,0.005678239282670717,0.3863863863863864
7293,0.8119,0,2,0,604999,611,107570,386,0.005659713216495609,0.38716148445336007
7294,0.812,1,4,1,605003,607,107571,385,0.005622661084145392,0.38810483870967744
7295,0.8121,0,3,0,605006,604,107571,385,0.00559487198488273,0.38928210313447925
7296,0.8122,4,7,4,605013,597,107575,381,0.005530030753269851,0.3895705521472393
7297,0.8123,1,1,1,605014,596,107576,380,0.005520767720182297,0.38934426229508196
7298,0.8124,1,2,1,605016,594,107577,379,0.005502241654007188,0.3895169578622816
7299,0.8126,0,2,0,605018,592,107577,379,0.00548371558783208,0.3903192584963955
7300,0.8127,0,1,0,605019,591,107577,379,0.005474452554744526,0.3907216494845361
7301,0.8128,1,9,1,605028,582,107578,378,0.005391085256956538,0.39375
7302,0.8129,4,1,4,605029,581,107582,374,0.005381822223868984,0.39162303664921466
7303,0.813,1,3,1,605032,578,107583,373,0.005354033124606321,0.3922187171398528
7304,0.8132,6,6,6,605038,572,107589,367,0.005298454926080996,0.3908413205537806
7305,0.8133,5,5,5,605043,567,107594,362,0.005252139760643225,0.38966630785791173
7306,0.8136,1,2,1,605045,565,107595,361,0.0052336136944681165,0.3898488120950324
7307,0.8137,4,4,4,605049,561,107599,357,0.0051965615621179,0.3888888888888889
7308,0.8138,5,5,5,605054,556,107604,352,0.005150246396680129,0.3876651982378855
7309,0.814,1,3,1,605057,553,107605,351,0.005122457297417466,0.38827433628318586
7310,0.8141,0,1,0,605058,552,107605,351,0.005113194264329912,0.38870431893687707
7311,0.8142,1,4,1,605062,548,107606,350,0.005076142131979695,0.3897550111358575
7312,0.8143,5,6,5,605068,542,107611,345,0.005020563933454371,0.38895152198421645
7313,0.8144,1,2,1,605070,540,107612,344,0.005002037867279262,0.3891402714932127
7314,0.8145,0,3,0,605073,537,107612,344,0.0049742487680166,0.3904653802497162
7315,0.8146,0,1,0,605074,536,107612,344,0.0049649857349290455,0.39090909090909093
7316,0.8147,2,11,2,605085,525,107614,342,0.004863092370965949,0.3944636678200692
7317,0.8148,1,0,1,605085,525,107615,341,0.004863092370965949,0.39376443418013857
7318,0.815,1,2,1,605087,523,107616,340,0.004844566304790841,0.3939745075318656
7319,0.8151,3,2,3,605089,521,107619,337,0.004826040238615732,0.3927738927738928
7320,0.8153,3,2,3,605091,519,107622,334,0.004807514172440624,0.39155920281359907
7321,0.8154,3,3,3,605094,516,107625,331,0.004779725073177961,0.3907910271546635
7322,0.8155,0,1,0,605095,515,107625,331,0.004770462040090407,0.3912529550827423
7323,0.8156,1,3,1,605098,512,107626,330,0.0047426729408277446,0.3919239904988123
7324,0.8157,1,1,1,605099,511,107627,329,0.00473340990774019,0.39166666666666666
7325,0.8158,1,2,1,605101,509,107628,328,0.004714883841565082,0.3918757467144564
7326,0.8159,1,2,1,605103,507,107629,327,0.0046963577753899735,0.3920863309352518
7327,0.816,1,1,1,605104,506,107630,326,0.004687094742302419,0.3918269230769231
7328,0.8161,2,1,2,605105,505,107632,324,0.004677831709214865,0.390832328106152
7329,0.8163,6,8,6,605113,497,107638,318,0.0046037274445144315,0.3901840490797546
7330,0.8164,2,1,2,605114,496,107640,316,0.004594464411426877,0.3891625615763547
7331,0.8165,5,6,5,605120,490,107645,311,0.004538886212901552,0.3882646691635456
7332,0.8166,1,6,1,605126,484,107646,310,0.004483308014376228,0.3904282115869018
7333,0.8167,0,1,0,605127,483,107646,310,0.0044740449812886735,0.39092055485498106
7334,0.8168,2,5,2,605132,478,107648,308,0.0044277298158509025,0.39185750636132316
7335,0.8169,2,1,2,605133,477,107650,306,0.004418466782763348,0.39080459770114945
7336,0.817,0,1,0,605134,476,107650,306,0.004409203749675794,0.391304347826087
7337,0.8171,2,0,2,605134,476,107652,304,0.004409203749675794,0.38974358974358975
7338,0.8172,1,0,1,605134,476,107653,303,0.004409203749675794,0.3889602053915276
7339,0.8173,0,1,0,605135,475,107653,303,0.00439994071658824,0.38946015424164526
7340,0.8174,0,1,0,605136,474,107653,303,0.004390677683500686,0.38996138996138996
7341,0.8176,4,5,4,605141,469,107657,299,0.004344362518062915,0.3893229166666667
7342,0.8177,1,0,1,605141,469,107658,298,0.004344362518062915,0.38852672750977835
7343,0.8178,1,3,1,605144,466,107659,297,0.004316573418800252,0.3892529488859764
7344,0.8179,2,1,2,605145,465,107661,295,0.004307310385712698,0.3881578947368421
7345,0.818,2,1,2,605146,464,107663,293,0.004298047352625144,0.3870541611624835
7346,0.8181,3,1,3,605147,463,107666,290,0.0042887843195375894,0.3851261620185923
7347,0.8182,0,1,0,605148,462,107666,290,0.004279521286450035,0.38563829787234044
7348,0.8184,2,2,2,605150,460,107668,288,0.004260995220274927,0.3850267379679144
7349,0.8185,3,2,3,605152,458,107671,285,0.004242469154099818,0.3835800807537012
7350,0.8186,2,1,2,605153,457,107673,283,0.004233206121012264,0.3824324324324324
7351,0.8188,0,2,0,605155,455,107673,283,0.004214680054837156,0.38346883468834686
7352,0.8189,7,6,7,605161,449,107680,276,0.004159101856311831,0.38068965517241377
7353,0.819,0,4,0,605165,445,107680,276,0.004122049723961614,0.3828016643550624
7354,0.8191,0,5,0,605170,440,107680,276,0.004075734558523843,0.3854748603351955
7355,0.8194,2,2,2,605172,438,107682,274,0.004057208492348734,0.3848314606741573
7356,0.8195,1,0,1,605172,438,107683,273,0.004057208492348734,0.38396624472573837
7357,0.8196,4,0,4,605172,438,107687,269,0.004057208492348734,0.38048090523338046
7358,0.8197,0,1,0,605173,437,107687,269,0.00404794545926118,0.3810198300283286
7359,0.8198,1,1,1,605174,436,107688,268,0.004038682426173626,0.3806818181818182
7360,0.8199,1,3,1,605177,433,107689,267,0.004010893326910963,0.38142857142857145
7361,0.82,0,4,0,605181,429,107689,267,0.003973841194560747,0.38362068965517243
7362,0.8201,3,2,3,605183,427,107692,264,0.003955315128385639,0.38205499276411
7363,0.8202,0,2,0,605185,425,107692,264,0.0039367890622105306,0.38316400580551524
7364,0.8203,0,1,0,605186,424,107692,264,0.003927526029122976,0.38372093023255816
7365,0.8204,1,0,1,605186,424,107693,263,0.003927526029122976,0.38282387190684136
7366,0.8205,0,3,0,605189,421,107693,263,0.0038997369298603133,0.3845029239766082
7367,0.8206,2,4,2,605193,417,107695,261,0.0038626847975100965,0.38495575221238937
7368,0.8208,2,4,2,605197,413,107697,259,0.00382563266515988,0.3854166666666667
7369,0.8209,4,1,4,605198,412,107701,255,0.003816369632072326,0.3823088455772114
7370,0.821,2,1,2,605199,411,107703,253,0.0038071065989847717,0.3810240963855422
7371,0.8211,4,10,4,605209,401,107707,249,0.0037144762681092297,0.3830769230769231
7372,0.8212,4,2,4,605211,399,107711,245,0.0036959502019341213,0.3804347826086957
7373,0.8213,0,4,0,605215,395,107711,245,0.0036588980695839044,0.3828125
7374,0.8214,0,1,0,605216,394,107711,245,0.0036496350364963502,0.38341158059467917
7375,0.8215,2,1,2,605217,393,107713,243,0.003640372003408796,0.38207547169811323
7376,0.8216,1,1,1,605218,392,107714,242,0.003631108970321242,0.38170347003154576
7377,0.8217,2,2,2,605220,390,107716,240,0.0036125829041461334,0.38095238095238093
7378,0.8218,2,2,2,605222,388,107718,238,0.003594056837971025,0.3801916932907348
7379,0.8219,9,8,9,605230,380,107727,229,0.003519952573270592,0.3760262725779967
7380,0.822,4,7,4,605237,373,107731,225,0.0034551113416577124,0.3762541806020067
7381,0.8221,1,4,1,605241,369,107732,224,0.0034180592093074956,0.3777403035413153
7382,0.8222,0,5,0,605246,364,107732,224,0.0033717440438697246,0.38095238095238093
7383,0.8223,1,1,1,605247,363,107733,223,0.0033624810107821704,0.38054607508532423
7384,0.8224,0,2,0,605249,361,107733,223,0.003343954944607062,0.3818493150684932
7385,0.8226,1,0,1,605249,361,107734,222,0.003343954944607062,0.38078902229845624
7386,0.8228,1,1,1,605250,360,107735,221,0.0033346919115195077,0.3803786574870912
7387,0.823,1,2,1,605252,358,107736,220,0.0033161658453443998,0.3806228373702422
7388,0.8231,1,4,1,605256,354,107737,219,0.003279113712994183,0.38219895287958117
7389,0.8233,6,6,6,605262,348,107743,213,0.0032235355144688577,0.37967914438502676
7390,0.8234,2,1,2,605263,347,107745,211,0.0032142724813813035,0.3781362007168459
7391,0.8236,1,3,1,605266,344,107746,210,0.003186483382118641,0.37906137184115524
7392,0.8237,2,2,2,605268,342,107748,208,0.0031679573159435325,0.3781818181818182
7393,0.8238,2,3,2,605271,339,107750,206,0.00314016821668087,0.3779816513761468
7394,0.8241,1,0,1,605271,339,107751,205,0.00314016821668087,0.37683823529411764
7395,0.8243,0,1,0,605272,338,107751,205,0.0031309051835933157,0.3775322283609576
7396,0.8246,3,2,3,605274,336,107754,202,0.0031123791174182073,0.3754646840148699
7397,0.8247,2,1,2,605275,335,107756,200,0.003103116084330653,0.37383177570093457
7398,0.8249,1,1,1,605276,334,107757,199,0.003093853051243099,0.37335834896810505
7399,0.825,1,2,1,605278,332,107758,198,0.0030753269850679905,0.37358490566037733
7400,0.8251,0,1,0,605279,331,107758,198,0.0030660639519804363,0.3742911153119093
7401,0.8253,1,0,1,605279,331,107759,197,0.0030660639519804363,0.3731060606060606
7402,0.8255,0,2,0,605281,329,107759,197,0.0030475378858053283,0.3745247148288973
7403,0.8256,2,3,2,605284,326,107761,195,0.0030197487865426657,0.3742802303262956
7404,0.8258,1,2,1,605286,324,107762,194,0.0030012227203675573,0.3745173745173745
7405,0.8259,0,1,0,605287,323,107762,194,0.002991959687280003,0.37524177949709864
7406,0.8261,1,1,1,605288,322,107763,193,0.002982696654192449,0.37475728155339805
7407,0.8262,8,10,8,605298,312,107771,185,0.002890066323316907,0.3722334004024145
7408,0.8263,4,3,4,605301,309,107775,181,0.0028622772240542442,0.3693877551020408
7409,0.8267,2,3,2,605304,306,107777,179,0.0028344881247915816,0.36907216494845363
7410,0.8268,1,1,1,605305,305,107778,178,0.0028252250917040274,0.36853002070393376
7411,0.8269,6,7,6,605312,298,107784,172,0.0027603838600911484,0.3659574468085106
7412,0.827,1,1,1,605313,297,107785,171,0.002751120827003594,0.36538461538461536
7413,0.8271,0,4,0,605317,293,107785,171,0.0027140686946533774,0.36853448275862066
7414,0.8273,1,1,1,605318,292,107786,170,0.002704805661565823,0.36796536796536794
7415,0.8275,1,3,1,605321,289,107787,169,0.0026770165623031606,0.36899563318777295
7416,0.8276,3,9,3,605330,280,107790,166,0.0025936492645151727,0.3721973094170404
7417,0.8278,0,1,0,605331,279,107790,166,0.0025843862314276185,0.37303370786516854
7418,0.8281,3,4,3,605335,275,107793,163,0.0025473340990774017,0.3721461187214612
7419,0.8282,4,8,4,605343,267,107797,159,0.0024732298343769685,0.3732394366197183
7420,0.8283,0,1,0,605344,266,107797,159,0.0024639668012894143,0.37411764705882355
7421,0.8284,1,1,1,605345,265,107798,158,0.00245470376820186,0.3735224586288416
7422,0.8285,1,0,1,605345,265,107799,157,0.00245470376820186,0.37203791469194314
7423,0.8286,5,5,5,605350,260,107804,152,0.002408388602764089,0.36893203883495146
7424,0.8287,0,2,0,605352,258,107804,152,0.0023898625365889807,0.37073170731707317
7425,0.8288,1,0,1,605352,258,107805,151,0.0023898625365889807,0.3691931540342298
7426,0.829,4,4,4,605356,254,107809,147,0.002352810404238764,0.36658354114713215
7427,0.8292,1,0,1,605356,254,107810,146,0.002352810404238764,0.365
7428,0.8293,1,2,1,605358,252,107811,145,0.0023342843380636555,0.36523929471032746
7429,0.8294,1,4,1,605362,248,107812,144,0.0022972322057134387,0.3673469387755102
7430,0.8295,1,0,1,605362,248,107813,143,0.0022972322057134387,0.3657289002557545
7431,0.8296,1,0,1,605362,248,107814,142,0.0022972322057134387,0.3641025641025641
7432,0.8297,2,8,2,605370,240,107816,140,0.0022231279410130055,0.3684210526315789
7433,0.8299,1,0,1,605370,240,107817,139,0.0022231279410130055,0.36675461741424803
7434,0.8301,2,3,2,605373,237,107819,137,0.002195338841750343,0.3663101604278075
7435,0.8303,1,1,1,605374,236,107820,136,0.0021860758086627886,0.3655913978494624
7436,0.8306,0,1,0,605375,235,107820,136,0.0021768127755752344,0.3665768194070081
7437,0.8308,0,2,0,605377,233,107820,136,0.002158286709400126,0.3685636856368564
7438,0.8309,1,1,1,605378,232,107821,135,0.002149023676312572,0.3678474114441417
7439,0.831,1,0,1,605378,232,107822,134,0.002149023676312572,0.366120218579235
7440,0.8312,0,1,0,605379,231,107822,134,0.0021397606432250176,0.36712328767123287
7441,0.8313,1,2,1,605381,229,107823,133,0.002121234577049909,0.3674033149171271
7442,0.8314,1,2,1,605383,227,107824,132,0.002102708510874801,0.36768802228412256
7443,0.8315,1,0,1,605383,227,107825,131,0.002102708510874801,0.3659217877094972
7444,0.8316,4,0,4,605383,227,107829,127,0.002102708510874801,0.3587570621468927
7445,0.8319,2,1,2,605384,226,107831,125,0.0020934454777872466,0.3561253561253561
7446,0.832,1,2,1,605386,224,107832,124,0.002074919411612138,0.3563218390804598
7447,0.8323,0,3,0,605389,221,107832,124,0.0020471303123494756,0.35942028985507246
7448,0.8324,1,4,1,605393,217,107833,123,0.0020100781799992588,0.36176470588235293
7449,0.8327,1,0,1,605393,217,107834,122,0.0020100781799992588,0.35988200589970504
7450,0.8328,0,2,0,605395,215,107834,122,0.001991552113824151,0.3620178041543027
7451,0.8329,1,5,1,605400,210,107835,121,0.0019452369483863796,0.36555891238670696
7452,0.833,2,3,2,605403,207,107837,119,0.0019174478491237172,0.36503067484662577
7453,0.8331,1,0,1,605403,207,107838,118,0.0019174478491237172,0.3630769230769231
7454,0.8332,1,0,1,605403,207,107839,117,0.0019174478491237172,0.3611111111111111
7455,0.8333,0,1,0,605404,206,107839,117,0.001908184816036163,0.3622291021671827
7456,0.8334,1,0,1,605404,206,107840,116,0.001908184816036163,0.36024844720496896
7457,0.8336,0,1,0,605405,205,107840,116,0.0018989217829486088,0.3613707165109034
7458,0.8337,0,4,0,605409,201,107840,116,0.001861869650598392,0.3659305993690852
7459,0.8341,1,1,1,605410,200,107841,115,0.0018526066175108377,0.36507936507936506
7460,0.8342,1,3,1,605413,197,107842,114,0.0018248175182481751,0.3665594855305466
7461,0.8343,0,1,0,605414,196,107842,114,0.001815554485160621,0.36774193548387096
7462,0.8344,1,0,1,605414,196,107843,113,0.001815554485160621,0.3656957928802589
7463,0.8346,3,4,3,605418,192,107846,110,0.0017785023528104043,0.36423841059602646
7464,0.835,0,1,0,605419,191,107846,110,0.0017692393197228501,0.3654485049833887
7465,0.8351,1,3,1,605422,188,107847,109,0.0017414502204601875,0.367003367003367
7466,0.8353,1,0,1,605422,188,107848,108,0.0017414502204601875,0.36486486486486486
7467,0.8355,2,1,2,605423,187,107850,106,0.0017321871873726333,0.36177474402730375
7468,0.8357,0,3,0,605426,184,107850,106,0.0017043980881099707,0.36551724137931035
7469,0.8358,1,1,1,605427,183,107851,105,0.0016951350550224165,0.3645833333333333
7470,0.8359,1,3,1,605430,180,107852,104,0.0016673459557597539,0.36619718309859156
7471,0.8363,0,1,0,605431,179,107852,104,0.0016580829226721999,0.3674911660777385
7472,0.8364,0,2,0,605433,177,107852,104,0.0016395568564970915,0.3701067615658363
7473,0.8367,1,2,1,605435,175,107853,103,0.001621030790321983,0.37050359712230213
7474,0.8372,0,2,0,605437,173,107853,103,0.0016025047241468747,0.37318840579710144
7475,0.8374,0,2,0,605439,171,107853,103,0.0015839786579717663,0.3759124087591241
7476,0.8375,0,1,0,605440,170,107853,103,0.001574715624884212,0.3772893772893773
7477,0.8376,0,1,0,605441,169,107853,103,0.0015654525917966578,0.3786764705882353
7478,0.8379,0,1,0,605442,168,107853,103,0.0015561895587091036,0.3800738007380074
7479,0.838,1,2,1,605444,166,107854,102,0.0015376634925339952,0.3805970149253731
7480,0.8381,1,0,1,605444,166,107855,101,0.0015376634925339952,0.3782771535580524
7481,0.8384,1,1,1,605445,165,107856,100,0.0015284004594464412,0.37735849056603776
7482,0.8385,0,1,0,605446,164,107856,100,0.001519137426358887,0.3787878787878788
7483,0.8386,1,3,1,605449,161,107857,99,0.0014913483270962244,0.38076923076923075
7484,0.8388,2,1,2,605450,160,107859,97,0.0014820852940086702,0.377431906614786
7485,0.839,6,11,6,605461,149,107865,91,0.0013801919300455742,0.37916666666666665
7486,0.8394,0,1,0,605462,148,107865,91,0.00137092889695802,0.3807531380753138
7487,0.8399,1,0,1,605462,148,107866,90,0.00137092889695802,0.37815126050420167
7488,0.84,0,2,0,605464,146,107866,90,0.0013524028307829116,0.3813559322033898
7489,0.8402,3,5,3,605469,141,107869,87,0.0013060876653451406,0.3815789473684211
7490,0.8404,6,5,6,605474,136,107875,81,0.0012597724999073698,0.37327188940092165
7491,0.8407,0,2,0,605476,134,107875,81,0.0012412464337322614,0.3767441860465116
7492,0.8409,1,2,1,605478,132,107876,80,0.001222720367557153,0.37735849056603776
7493,0.841,0,2,0,605480,130,107876,80,0.0012041943013820445,0.38095238095238093
7494,0.8414,1,2,1,605482,128,107877,79,0.0011856682352069361,0.38164251207729466
7495,0.8418,0,1,0,605483,127,107877,79,0.001176405202119382,0.38349514563106796
7496,0.8419,3,4,3,605487,123,107880,76,0.0011393530697691651,0.38190954773869346
7497,0.842,2,2,2,605489,121,107882,74,0.001120827003594057,0.37948717948717947
7498,0.8422,1,0,1,605489,121,107883,73,0.001120827003594057,0.37628865979381443
7499,0.8423,2,9,2,605498,112,107885,71,0.001037459705806069,0.3879781420765027
7500,0.8427,1,3,1,605501,109,107886,70,0.0010096706065434065,0.39106145251396646
7501,0.8428,1,3,1,605504,106,107887,69,0.000981881507280744,0.3942857142857143
7502,0.8429,0,1,0,605505,105,107887,69,0.0009726184741931898,0.39655172413793105
7503,0.8431,2,2,2,605507,103,107889,67,0.0009540924080180815,0.3941176470588235
7504,0.8432,1,4,1,605511,99,107890,66,0.0009170402756678647,0.4
7505,0.8435,0,1,0,605512,98,107890,66,0.0009077772425803105,0.4024390243902439
7506,0.8436,1,0,1,605512,98,107891,65,0.0009077772425803105,0.3987730061349693
7507,0.8437,1,2,1,605514,96,107892,64,0.0008892511764052022,0.4
7508,0.8444,0,1,0,605515,95,107892,64,0.000879988143317648,0.4025157232704403
7509,0.8446,2,2,2,605517,93,107894,62,0.0008614620771425395,0.4
7510,0.8449,0,2,0,605519,91,107894,62,0.0008429360109674311,0.40522875816993464
7511,0.845,2,1,2,605520,90,107896,60,0.0008336729778798769,0.4
7512,0.8451,1,2,1,605522,88,107897,59,0.0008151469117047686,0.4013605442176871
7513,0.8452,0,3,0,605525,85,107897,59,0.000787357812442106,0.4097222222222222
7514,0.8453,1,3,1,605528,82,107898,58,0.0007595687131794435,0.4142857142857143
7515,0.8456,0,2,0,605530,80,107898,58,0.0007410426470043351,0.42028985507246375
7516,0.8458,1,1,1,605531,79,107899,57,0.0007317796139167809,0.41911764705882354
7517,0.8459,0,1,0,605532,78,107899,57,0.0007225165808292267,0.4222222222222222
7518,0.8462,1,2,1,605534,76,107900,56,0.0007039905146541183,0.42424242424242425
7519,0.8465,2,0,2,605534,76,107902,54,0.0007039905146541183,0.4153846153846154
7520,0.8467,1,1,1,605535,75,107903,53,0.0006947274815665642,0.4140625
7521,0.847,1,0,1,605535,75,107904,52,0.0006947274815665642,0.4094488188976378
7522,0.8473,1,0,1,605535,75,107905,51,0.0006947274815665642,0.40476190476190477
7523,0.8474,3,2,3,605537,73,107908,48,0.0006762014153914558,0.39669421487603307
7524,0.8475,1,0,1,605537,73,107909,47,0.0006762014153914558,0.39166666666666666
7525,0.8476,3,5,3,605542,68,107912,44,0.0006298862499536849,0.39285714285714285
7526,0.8477,0,1,0,605543,67,107912,44,0.0006206232168661307,0.3963963963963964
7527,0.8482,1,1,1,605544,66,107913,43,0.0006113601837785765,0.3944954128440367
7528,0.8483,0,2,0,605546,64,107913,43,0.0005928341176034681,0.40186915887850466
7529,0.8488,0,6,0,605552,58,107913,43,0.000537255919078143,0.42574257425742573
7530,0.8489,1,0,1,605552,58,107914,42,0.000537255919078143,0.42
7531,0.8497,1,1,1,605553,57,107915,41,0.0005279928859905888,0.41836734693877553
7532,0.8498,2,0,2,605553,57,107917,39,0.0005279928859905888,0.40625
7533,0.8501,1,0,1,605553,57,107918,38,0.0005279928859905888,0.4
7534,0.8503,1,0,1,605553,57,107919,37,0.0005279928859905888,0.39361702127659576
7535,0.8504,0,3,0,605556,54,107919,37,0.0005002037867279261,0.4065934065934066
7536,0.8505,0,1,0,605557,53,107919,37,0.000490940753640372,0.4111111111111111
7537,0.8509,0,2,0,605559,51,107919,37,0.00047241468746526364,0.42045454545454547
7538,0.8517,1,1,1,605560,50,107920,36,0.00046315165437770943,0.4186046511627907
7539,0.852,0,1,0,605561,49,107920,36,0.00045388862129015523,0.4235294117647059
7540,0.8522,0,1,0,605562,48,107920,36,0.0004446255882026011,0.42857142857142855
7541,0.8523,0,2,0,605564,46,107920,36,0.00042609952202749267,0.43902439024390244
7542,0.8531,0,1,0,605565,45,107920,36,0.00041683648893993847,0.4444444444444444
7543,0.8532,0,1,0,605566,44,107920,36,0.0004075734558523843,0.45
7544,0.8536,2,0,2,605566,44,107922,34,0.0004075734558523843,0.4358974358974359
7545,0.8537,0,2,0,605568,42,107922,34,0.0003890473896772759,0.4473684210526316
7546,0.8542,1,0,1,605568,42,107923,33,0.0003890473896772759,0.44
7547,0.8544,1,0,1,605568,42,107924,32,0.0003890473896772759,0.43243243243243246
7548,0.8545,1,1,1,605569,41,107925,31,0.00037978435658972176,0.4305555555555556
7549,0.8549,0,2,0,605571,39,107925,31,0.00036125829041461335,0.44285714285714284
7550,0.8553,7,3,7,605574,36,107932,24,0.0003334691911519508,0.4
7551,0.8555,1,2,1,605576,34,107933,23,0.00031494312497684244,0.40350877192982454
7552,0.8558,2,2,2,605578,32,107935,21,0.00029641705880173404,0.39622641509433965
7553,0.8559,0,1,0,605579,31,107935,21,0.00028715402571417983,0.40384615384615385
7554,0.8562,0,1,0,605580,30,107935,21,0.0002778909926266257,0.4117647058823529
7555,0.8563,1,0,1,605580,30,107936,20,0.0002778909926266257,0.4
7556,0.8596,0,2,0,605582,28,107936,20,0.0002593649264515173,0.4166666666666667
7557,0.8603,1,0,1,605582,28,107937,19,0.0002593649264515173,0.40425531914893614
7558,0.8614,1,1,1,605583,27,107938,18,0.00025010189336396307,0.4
7559,0.8619,0,2,0,605585,25,107938,18,0.00023157582718885472,0.4186046511627907
7560,0.8623,1,0,1,605585,25,107939,17,0.00023157582718885472,0.40476190476190477
7561,0.8624,0,2,0,605587,23,107939,17,0.00021304976101374634,0.425
7562,0.8626,1,1,1,605588,22,107940,16,0.00020378672792619216,0.42105263157894735
7563,0.8629,0,1,0,605589,21,107940,16,0.00019452369483863796,0.43243243243243246
7564,0.8631,0,1,0,605590,20,107940,16,0.00018526066175108378,0.4444444444444444
7565,0.8632,0,2,0,605592,18,107940,16,0.0001667345955759754,0.47058823529411764
7566,0.8634,0,1,0,605593,17,107940,16,0.00015747156248842122,0.48484848484848486
7567,0.8646,0,1,0,605594,16,107940,16,0.00014820852940086702,0.5
7568,0.8647,3,1,3,605595,15,107943,13,0.00013894549631331284,0.4642857142857143
7569,0.8648,1,3,1,605598,12,107944,12,0.00011115639705065027,0.5
7570,0.8656,2,0,2,605598,12,107946,10,0.00011115639705065027,0.45454545454545453
7571,0.8657,0,1,0,605599,11,107946,10,0.00010189336396309608,0.47619047619047616
7572,0.8658,1,0,1,605599,11,107947,9,0.00010189336396309608,0.45
7573,0.8667,0,1,0,605600,10,107947,9,9.263033087554189e-05,0.47368421052631576
7574,0.8677,1,0,1,605600,10,107948,8,9.263033087554189e-05,0.4444444444444444
7575,0.868,0,3,0,605603,7,107948,8,6.484123161287932e-05,0.5333333333333333
7576,0.8689,0,1,0,605604,6,107948,8,5.5578198525325135e-05,0.5714285714285714
7577,0.8712,1,0,1,605604,6,107949,7,5.5578198525325135e-05,0.5384615384615384
7578,0.8724,1,1,1,605605,5,107950,6,4.6315165437770945e-05,0.5454545454545454
7579,0.8732,1,1,1,605606,4,107951,5,3.7052132350216754e-05,0.5555555555555556
7580,0.877,0,1,0,605607,3,107951,5,2.7789099262662567e-05,0.625
7581,0.8798,0,1,0,605608,2,107951,5,1.8526066175108377e-05,0.7142857142857143
7582,0.8807,0,1,0,605609,1,107951,5,9.263033087554189e-06,0.8333333333333334
7583,0.8844,2,0,2,605609,1,107953,3,9.263033087554189e-06,0.75
7584,0.8853,1,0,1,605609,1,107954,2,9.263033087554189e-06,0.6666666666666666
7585,0.8905,0,1,0,605610,0,107954,2,0.0,1.0
7586,0.8959,1,0,1,605610,0,107955,1,0.0,1.0
7587,0.8987,1,0,1,605610,0,107956,0,0.0,
