,y_proba,y_test,Neg,Pos,TN,FP,FN,TP,FP/P,Prec
0,0.0036,0,1,0,1,605609,0,107956,5.609776205120605,0.1512910526721462
1,0.0039,0,1,0,2,605608,0,107956,5.609766942087517,0.15129126469384666
2,0.004,0,1,0,3,605607,0,107956,5.60975767905443,0.1512914767161414
3,0.0042,0,2,0,5,605605,0,107956,5.609739152988254,0.15129190076251364
4,0.0046,0,1,0,6,605604,0,107956,5.609729889955167,0.1512921127865912
5,0.0049,0,3,0,9,605601,0,107956,5.6097021008559045,0.15129274886238941
6,0.0051,0,3,0,12,605598,0,107956,5.609674311756642,0.15129338494353617
7,0.0052,0,7,0,19,605591,0,107956,5.609609470525029,0.15129486915367873
8,0.0053,0,3,0,22,605588,0,107956,5.609581681425766,0.15129550525265437
9,0.0055,0,4,0,26,605584,0,107956,5.609544629293416,0.15129635339294223
10,0.0056,0,5,0,31,605579,0,107956,5.609498314127978,0.15129741358167434
11,0.0057,0,4,0,35,605575,0,107956,5.6094612619956274,0.15129826174335803
12,0.0058,1,6,1,41,605569,1,107955,5.609405683797102,0.15129834455463306
13,0.0059,0,6,0,47,605563,1,107955,5.609350105598577,0.15129961682816692
14,0.006,0,4,0,51,605559,1,107955,5.609313053466227,0.1513004650224102
15,0.0061,0,10,0,61,605549,1,107955,5.609220423135351,0.1513025855496255
16,0.0062,0,8,0,69,605541,1,107955,5.609146318870651,0.1513042820141949
17,0.0063,1,6,1,75,605535,2,107954,5.6090907406721255,0.15130436488859675
18,0.0064,0,6,0,81,605529,2,107954,5.6090351624736,0.15130563727516982
19,0.0065,0,10,0,91,605519,2,107954,5.608942532142724,0.15130775796701487
20,0.0066,0,9,0,100,605510,2,107954,5.608859164844937,0.15130966664050324
21,0.0067,0,4,0,104,605506,2,107954,5.608822112712587,0.1513105149552883
22,0.0068,0,14,0,118,605492,2,107954,5.608692430249361,0.1513134841319455
23,0.0069,0,13,0,131,605479,2,107954,5.6085720108192225,0.15131624132889843
24,0.007,0,10,0,141,605469,2,107954,5.6084793804883475,0.1513183623180077
25,0.0071,0,8,0,149,605461,2,107954,5.608405276223647,0.15132005915210642
26,0.0072,1,17,1,166,605444,3,107953,5.608247804661159,0.15132247542392244
27,0.0073,0,18,0,184,605426,3,107953,5.608081070065582,0.15132629359709215
28,0.0074,0,23,0,207,605403,3,107953,5.6078680203045685,0.15133117265432688
29,0.0075,1,9,1,216,605394,4,107952,5.607784653006781,0.15133189223742757
30,0.0076,0,14,0,230,605380,4,107952,5.607654970543555,0.15133486230815385
31,0.0077,0,14,0,244,605366,4,107952,5.607525288080329,0.15133783249546487
32,0.0078,0,16,0,260,605350,4,107952,5.607377079550928,0.15134122713801448
33,0.0079,0,19,0,279,605331,4,107952,5.607201081922264,0.15134525847384558
34,0.008,0,20,0,299,605311,4,107952,5.6070158212605135,0.1513495022172747
35,0.0081,0,15,0,314,605296,4,107952,5.6068768757642005,0.151352685181031
36,0.0082,0,28,0,342,605268,4,107952,5.606617510837749,0.1513586270715908
37,0.0083,0,20,0,362,605248,4,107952,5.606432250175998,0.15136287156477846
38,0.0084,0,29,0,391,605219,4,107952,5.606163622216458,0.1513690265027602
39,0.0085,1,32,1,423,605187,5,107951,5.605867205157657,0.1513746287534811
40,0.0086,0,30,0,453,605157,5,107951,5.60558931416503,0.15138099698783353
41,0.0087,0,29,0,482,605128,5,107951,5.605320686205491,0.15138715345705034
42,0.0088,1,34,1,516,605094,6,107950,5.605005743080515,0.15139318190742787
43,0.0089,1,28,1,544,605066,7,107949,5.604746378154063,0.1513979369297981
44,0.009,0,32,0,576,605034,7,107949,5.604449961095261,0.15140473195013066
45,0.0091,0,31,0,607,605003,7,107949,5.604162807069547,0.15141131520775591
46,0.0092,0,39,0,646,604964,7,107949,5.603801548779132,0.1514195981837896
47,0.0093,1,39,1,685,604925,8,107948,5.6034402904887175,0.15142669171086576
48,0.0094,0,38,0,723,604887,8,107948,5.603088295231391,0.15143476400569555
49,0.0095,1,33,1,756,604854,9,107947,5.6027826151395015,0.1514405843987312
50,0.0096,0,42,0,798,604812,9,107947,5.602393567749824,0.15144950817878133
51,0.0097,0,46,0,844,604766,9,107947,5.601967468227796,0.15145928304941822
52,0.0098,0,48,0,892,604718,9,107947,5.601522842639594,0.15146948425978546
53,0.0099,1,46,1,938,604672,10,107946,5.601096743117567,0.1514780710001712
54,0.01,1,68,1,1006,604604,11,107945,5.600466856867612,0.15149133603443413
55,0.0101,1,35,1,1041,604569,12,107944,5.600142650709548,0.1514975867106986
56,0.0102,0,51,0,1092,604518,12,107944,5.599670236022083,0.15150843132686376
57,0.0103,2,46,2,1138,604472,14,107942,5.599244136500055,0.1515158320863992
58,0.0104,0,50,0,1188,604422,14,107942,5.5987809848456775,0.15152646680629567
59,0.0105,0,60,0,1248,604362,14,107942,5.598225202860425,0.15153923044093534
60,0.0106,0,59,0,1307,604303,14,107942,5.597678683908259,0.15155178344530323
61,0.0107,0,50,0,1357,604253,14,107942,5.597215532253881,0.1515624232127437
62,0.0108,0,49,0,1406,604204,14,107942,5.596761643632591,0.15157285163435588
63,0.0109,0,53,0,1459,604151,14,107942,5.596270702878951,0.15158413297139559
64,0.011,2,72,2,1531,604079,16,107940,5.595603764496647,0.1515970781678579
65,0.0111,0,64,0,1595,604015,16,107940,5.595010930379043,0.15161070573280613
66,0.0112,0,75,0,1670,603940,16,107940,5.594316202897477,0.1516266786537057
67,0.0113,0,56,0,1726,603884,16,107940,5.593797473044574,0.15163860729618558
68,0.0114,1,67,1,1793,603817,17,107939,5.5931768498277075,0.15165168962397227
69,0.0115,0,84,0,1877,603733,17,107939,5.592398755048353,0.15166958936139122
70,0.0116,0,75,0,1952,603658,17,107939,5.591704027566786,0.1516855748408158
71,0.0117,1,75,1,2027,603583,18,107938,5.59100930008522,0.1517003714577644
72,0.0118,1,67,1,2094,603516,19,107937,5.590388676868354,0.1517134652605302
73,0.0119,0,82,0,2176,603434,19,107937,5.589629108155174,0.15173095332815084
74,0.012,1,77,1,2253,603357,20,107936,5.588915854607433,0.1517461861708185
75,0.0121,0,68,0,2321,603289,20,107936,5.588285968357479,0.15176069457625926
76,0.0122,0,67,0,2388,603222,20,107936,5.587665345140612,0.15177499233644282
77,0.0123,0,81,0,2469,603141,20,107936,5.586915039460521,0.15179228128599292
78,0.0124,0,88,0,2557,603053,20,107936,5.586099892548816,0.1518110688069717
79,0.0125,3,86,3,2643,602967,23,107933,5.585303271703286,0.1518258545505697
80,0.0126,3,90,3,2733,602877,26,107930,5.5844695987254065,0.15184149846582828
81,0.0127,1,92,1,2825,602785,27,107929,5.583617399681351,0.1518599605467178
82,0.0128,2,93,2,2918,602692,29,107927,5.582755937604209,0.1518774476899717
83,0.0129,2,103,2,3021,602589,31,107925,5.581801845196191,0.1518970773271181
84,0.013,0,89,0,3110,602500,31,107925,5.580977435251398,0.15191610655593482
85,0.0131,0,91,0,3201,602409,31,107925,5.580134499240431,0.15193556833827468
86,0.0132,0,115,0,3316,602294,31,107925,5.579069250435363,0.15196017003206053
87,0.0133,0,95,0,3411,602199,31,107925,5.578189262292045,0.15198049918042483
88,0.0134,1,99,1,3510,602100,32,107924,5.577272222016377,0.15200049575788988
89,0.0135,1,122,1,3632,601978,33,107923,5.5761421319796955,0.15202542326324375
90,0.0136,1,90,1,3722,601888,34,107922,5.575308459001816,0.1520435045998225
91,0.0137,1,108,1,3830,601780,35,107921,5.57430805142836,0.15206544727991084
92,0.0138,2,111,2,3941,601669,37,107919,5.573279854755641,0.15208684476062165
93,0.0139,2,120,2,4061,601549,39,107917,5.572168290785135,0.15211017864140072
94,0.014,2,117,2,4178,601432,41,107915,5.571084515913891,0.15213287713911527
95,0.0141,1,130,1,4308,601302,42,107914,5.569880321612509,0.15215956774804856
96,0.0142,1,123,1,4431,601179,43,107913,5.568740968542739,0.15218476586959098
97,0.0143,2,138,2,4569,601041,45,107911,5.567462669976657,0.1522119974271883
98,0.0144,1,135,1,4704,600906,46,107910,5.566212160509838,0.15223979142683008
99,0.0145,1,131,1,4835,600775,47,107909,5.564998703175368,0.15226673665554746
100,0.0146,4,132,4,4967,600643,51,107905,5.563775982807811,0.1522903176637292
101,0.0147,3,116,3,5083,600527,54,107902,5.562701470969654,0.1523116642599329
102,0.0148,0,115,0,5198,600412,54,107902,5.561636222164585,0.15233639318155506
103,0.0149,6,125,6,5323,600287,60,107896,5.560478343028641,0.15235610004758657
104,0.015,3,152,3,5475,600135,63,107893,5.559070361999333,0.15238521640387104
105,0.0151,0,125,0,5600,600010,63,107893,5.557912482863388,0.15241212425996217
106,0.0152,0,148,0,5748,599862,63,107893,5.556541553966431,0.15244399545040305
107,0.0153,3,153,3,5901,599709,66,107890,5.555124309904035,0.15247336415116472
108,0.0154,0,162,0,6063,599547,66,107890,5.553623698543851,0.15250827988923396
109,0.0155,0,151,0,6214,599396,66,107890,5.5522249805476305,0.15254083920790176
110,0.0156,2,123,2,6337,599273,68,107888,5.551085627477861,0.15256497459560128
111,0.0157,2,147,2,6484,599126,70,107886,5.549723961613991,0.1525942982580211
112,0.0158,4,165,4,6649,598961,74,107882,5.548195561154545,0.15262512325933764
113,0.0159,3,137,3,6786,598824,77,107879,5.54692652562155,0.15265111369273937
114,0.016,4,145,4,6931,598679,81,107875,5.545583385823854,0.15267764388850674
115,0.0161,1,152,1,7083,598527,82,107874,5.5441754047945455,0.15270929684414378
116,0.0162,1,141,1,7224,598386,83,107873,5.542869317129201,0.15273858457024972
117,0.0163,2,180,2,7404,598206,85,107871,5.541201971173441,0.15277512226003678
118,0.0164,2,187,2,7591,598019,87,107869,5.5394697839860685,0.15281319416111339
119,0.0165,0,159,0,7750,597860,87,107869,5.537996961725147,0.15284762281272274
120,0.0166,2,149,2,7899,597711,89,107867,5.536616769795102,0.15287749901499195
121,0.0167,2,192,2,8091,597519,91,107865,5.534838267442291,0.15291670919669287
122,0.0168,1,152,1,8243,597367,92,107864,5.533430286412983,0.15294846653082464
123,0.0169,2,182,2,8425,597185,94,107862,5.531744414391048,0.15298554564447475
124,0.017,3,177,3,8602,597008,97,107859,5.5301048575345515,0.15302035703189396
125,0.0171,1,183,1,8785,596825,98,107858,5.5284097224795286,0.15305889314769905
126,0.0172,1,173,1,8958,596652,99,107857,5.5268072177553815,0.15309527628461808
127,0.0173,4,197,4,9155,596455,103,107853,5.524982400237134,0.15313328827728778
128,0.0174,5,194,5,9349,596261,108,107848,5.5231853718181485,0.15316946665928144
129,0.0175,1,216,1,9565,596045,109,107847,5.521184556671236,0.15321526597830348
130,0.0176,3,171,3,9736,595874,112,107844,5.519600578013264,0.1532488866278822
131,0.0177,1,172,1,9908,595702,113,107843,5.5180073363222055,0.15328514878223853
132,0.0178,2,198,2,10106,595504,115,107841,5.51617325577087,0.15332589269846233
133,0.0179,2,198,2,10304,595306,117,107839,5.514339175219534,0.15336665979278813
134,0.018,3,194,3,10498,595112,120,107836,5.512542146800548,0.1534053728014021
135,0.0181,1,215,1,10713,594897,121,107835,5.510550594686724,0.15345110226942846
136,0.0182,2,185,2,10898,594712,123,107833,5.508836933565527,0.15348910034232682
137,0.0183,4,195,4,11093,594517,127,107829,5.507030642113453,0.15352689415188525
138,0.0184,4,183,4,11276,594334,131,107825,5.505335507058431,0.15356208494087523
139,0.0185,5,220,5,11496,594114,136,107820,5.503297639779169,0.15360418500884698
140,0.0186,3,194,3,11690,593920,139,107817,5.501500611360184,0.15364303150610556
141,0.0187,1,220,1,11910,593700,140,107816,5.499462744080922,0.15369000849588604
142,0.0188,2,222,2,12132,593478,142,107814,5.497406350735485,0.1537362468130251
143,0.0189,1,201,1,12333,593277,143,107813,5.495544481084886,0.15377911537748362
144,0.019,2,189,2,12522,593088,145,107811,5.493793767831339,0.15381816781019805
145,0.0191,2,191,2,12713,592897,147,107809,5.492024528511616,0.15385768068205496
146,0.0192,2,207,2,12920,592690,149,107807,5.490107080662492,0.15390073048135824
147,0.0193,0,170,0,13090,592520,149,107807,5.488532365037608,0.1539380889213182
148,0.0194,5,168,5,13258,592352,154,107802,5.486976175478898,0.15396898396638453
149,0.0195,8,220,8,13478,592132,162,107794,5.484938308199637,0.15400770938642086
150,0.0196,4,215,4,13693,591917,166,107790,5.482946756085813,0.15405019529603106
151,0.0197,5,208,5,13901,591709,171,107785,5.481020045203602,0.15408995645423693
152,0.0198,2,207,2,14108,591502,173,107783,5.479102597354478,0.154133150289224
153,0.0199,2,219,2,14327,591283,175,107781,5.477073993108303,0.1541790165135095
154,0.02,8,216,8,14543,591067,183,107773,5.4750731779613915,0.1542169881517944
155,0.0201,5,213,5,14756,590854,188,107768,5.4731001519137426,0.15425795351420368
156,0.0202,5,203,5,14959,590651,193,107763,5.4712197561969695,0.15429673517426626
157,0.0203,2,183,2,15142,590468,195,107761,5.469524621141947,0.15433475263846103
158,0.0204,1,228,1,15370,590240,196,107760,5.467412649597985,0.1543839541547278
159,0.0205,4,243,4,15613,589997,200,107756,5.465161732557709,0.15443287237747455
160,0.0206,4,219,4,15832,589778,204,107752,5.463133128311535,0.15447650997089732
161,0.0207,6,220,6,16052,589558,210,107746,5.4610952610322725,0.15451797207530718
162,0.0208,6,239,6,16291,589319,216,107740,5.4588813961243465,0.15456367395012474
163,0.0209,6,272,6,16563,589047,222,107734,5.456361851124532,0.1546167303643469
164,0.021,3,254,3,16817,588793,225,107731,5.454009040720293,0.15466947298298409
165,0.0211,8,265,8,17082,588528,233,107723,5.451554336952092,0.1547186287703716
166,0.0212,6,251,6,17333,588277,239,107717,5.449229315647115,0.15476713879717355
167,0.0213,4,232,4,17565,588045,243,107713,5.447080291970803,0.1548138864375257
168,0.0214,5,256,5,17821,587789,248,107708,5.444708955500389,0.15486479452822946
169,0.0215,4,229,4,18050,587560,252,107704,5.442587720923339,0.15491094030469002
170,0.0216,10,249,10,18299,587311,262,107694,5.440281225684538,0.15495428090445393
171,0.0217,6,275,6,18574,587036,268,107688,5.437733891585461,0.15500831985076088
172,0.0218,4,271,4,18845,586765,272,107684,5.435223609618734,0.15506394278053537
173,0.0219,0,248,0,19093,586517,272,107684,5.43292637741302,0.15511933863535202
174,0.022,4,281,4,19374,586236,276,107680,5.430323465115418,0.15517728370580877
175,0.0221,6,243,6,19617,585993,282,107674,5.428072548075142,0.15522433674947778
176,0.0222,2,246,2,19863,585747,284,107672,5.4257938419356035,0.1552769681822967
177,0.0223,2,258,2,20121,585489,286,107670,5.423403979399015,0.15533232634936572
178,0.0224,3,266,3,20387,585223,289,107667,5.420940012597725,0.15538830117334643
179,0.0225,3,260,3,20647,584963,292,107664,5.418531623994961,0.15544297291327078
180,0.0226,3,272,3,20919,584691,295,107661,5.416012078995146,0.15550038130892957
181,0.0227,5,247,5,21166,584444,300,107656,5.41372410982252,0.15554977604392428
182,0.0228,1,240,1,21406,584204,301,107655,5.411500981881507,0.15560251438515652
183,0.0229,3,255,3,21661,583949,304,107652,5.409138908444181,0.1556562237475076
184,0.023,6,249,6,21910,583700,310,107646,5.40683241320538,0.1557049581540936
185,0.0231,6,250,6,22160,583450,316,107640,5.4045166549334915,0.1557539538989133
186,0.0232,9,254,9,22414,583196,325,107631,5.402163844529253,0.15580022205269917
187,0.0233,5,265,5,22679,582931,330,107626,5.3997091407610505,0.155853897650737
188,0.0234,8,261,8,22940,582670,338,107618,5.397291489125199,0.15590304336740607
189,0.0235,5,254,5,23194,582416,343,107613,5.39493867872096,0.15595431496357398
190,0.0236,6,268,6,23462,582148,349,107607,5.392456185853496,0.1560075679045458
191,0.0237,2,258,2,23720,581890,351,107605,5.390066323316907,0.15606349574688722
192,0.0238,2,278,2,23998,581612,353,107603,5.387491200118567,0.1561239961405367
193,0.0239,4,260,4,24258,581352,357,107599,5.385082811515803,0.1561780155627904
194,0.024,6,271,6,24529,581081,363,107593,5.382572529549075,0.1562321214391715
195,0.0241,8,269,8,24798,580812,371,107585,5.380080773648523,0.15628336555795566
196,0.0242,11,304,11,25102,580508,382,107574,5.377264811589907,0.1563389247211815
197,0.0243,3,263,3,25365,580245,385,107571,5.37482863388788,0.1563950242506717
198,0.0244,3,278,3,25643,579967,388,107568,5.37225351068954,0.15645458049408395
199,0.0245,9,303,9,25946,579664,397,107559,5.3694468116640115,0.1565125148605329
200,0.0246,1,281,1,26227,579383,398,107558,5.366843899366408,0.1565753099611175
201,0.0247,3,297,3,26524,579086,401,107555,5.364092778539405,0.15663935011163038
202,0.0248,4,294,4,26818,578792,405,107551,5.361369446811664,0.1567015326156164
203,0.0249,9,294,9,27112,578498,414,107542,5.358646115083923,0.1567576234621888
204,0.025,2,299,2,27411,578199,416,107540,5.355876468190744,0.15682351448583207
205,0.0251,10,318,10,27729,577881,426,107530,5.352930823668902,0.156883971806697
206,0.0252,7,288,7,28017,577593,433,107523,5.350263070139687,0.1569413062897378
207,0.0253,6,281,6,28298,577312,439,107517,5.347660157842084,0.15699831636802764
208,0.0254,5,295,5,28593,577017,444,107512,5.344927563081256,0.15705981777251218
209,0.0255,6,328,6,28921,576689,450,107506,5.341889288228537,0.1571277194367103
210,0.0256,6,305,6,29226,576384,456,107500,5.339064063136833,0.15719040071123172
211,0.0257,8,307,8,29533,576077,464,107492,5.336220311978955,0.1572511333896066
212,0.0258,8,308,8,29841,575769,472,107484,5.333367297787988,0.1573121523066858
213,0.0259,7,276,7,30117,575493,479,107477,5.330810700655823,0.15736708786623133
214,0.026,6,269,6,30386,575224,485,107471,5.328318944755271,0.1574216890412263
215,0.0261,5,319,5,30705,574905,490,107466,5.325364037200341,0.15748910783137032
216,0.0262,5,324,5,31029,574581,495,107461,5.322362814479973,0.1575577457106747
217,0.0263,7,327,7,31356,574254,502,107454,5.319333802660343,0.15762467214701895
218,0.0264,7,307,7,31663,573947,509,107447,5.316490051502464,0.1576870356944734
219,0.0265,5,321,5,31984,573626,514,107442,5.313516617881359,0.15775517275807996
220,0.0266,6,295,6,32279,573331,520,107436,5.31078402312053,0.15781611035787574
221,0.0267,3,303,3,32582,573028,523,107433,5.307977324095002,0.1578826707188215
222,0.0268,6,305,6,32887,572723,529,107427,5.305152099003298,0.15794604131441595
223,0.0269,6,331,6,33218,572392,535,107421,5.3020860350513175,0.15801551308962905
224,0.027,8,288,8,33506,572104,543,107413,5.299418281522102,0.15807257213579645
225,0.0271,6,311,6,33817,571793,549,107407,5.296537478231873,0.15813751472320378
226,0.0272,6,314,6,34131,571479,555,107401,5.29362888584238,0.15820321706339854
227,0.0273,7,334,7,34465,571145,562,107394,5.290535032791137,0.15827240586023794
228,0.0274,5,337,5,34802,570808,567,107389,5.287413390640632,0.15834484670383384
229,0.0275,11,332,11,35134,570476,578,107378,5.2843380636555635,0.15840874288563614
230,0.0276,5,316,5,35450,570160,583,107373,5.281410945199896,0.1584764136949787
231,0.0277,2,346,2,35796,569814,585,107371,5.278205935751602,0.1585549000642365
232,0.0278,10,330,10,36126,569484,595,107361,5.275149134832709,0.15861977262150123
233,0.0279,4,292,4,36418,569192,599,107357,5.272444329171144,0.1586832587144464
234,0.028,6,322,6,36740,568870,605,107351,5.269461632516951,0.15875135495644174
235,0.0281,6,299,6,37039,568571,611,107345,5.266691985623773,0.15881411299628947
236,0.0282,3,320,3,37359,568251,614,107342,5.263727815035756,0.158885601242168
237,0.0283,5,332,5,37691,567919,619,107337,5.260652488050687,0.15895749167723056
238,0.0284,7,335,7,38026,567584,626,107330,5.257549371966356,0.15902766871038385
239,0.0285,13,321,13,38347,567263,639,107317,5.254575938345252,0.1590871356992499
240,0.0286,4,344,4,38691,566919,643,107313,5.2513894549631335,0.15916331470473072
241,0.0287,9,300,9,38991,566619,652,107304,5.2486105450368665,0.15922293793207828
242,0.0288,8,320,8,39311,566299,660,107296,5.2456463744488495,0.15928859329419012
243,0.0289,12,312,12,39623,565987,672,107284,5.242756308125533,0.15934742473684446
244,0.029,7,361,7,39984,565626,679,107277,5.239412353180925,0.15942416663322945
245,0.0291,7,324,7,40308,565302,686,107270,5.236411130460558,0.15949221793354465
246,0.0292,5,330,5,40638,564972,691,107265,5.233354329541665,0.1595642608187291
247,0.0293,6,318,6,40956,564654,697,107259,5.230408685019823,0.15963227382116435
248,0.0294,8,302,8,41258,564352,705,107251,5.227611249027381,0.15969404544053556
249,0.0295,7,347,7,41605,564005,712,107244,5.224396976546,0.15976783578076095
250,0.0296,9,333,9,41938,563672,721,107235,5.221312386527845,0.15983586398711
251,0.0297,10,367,10,42305,563305,731,107225,5.217912853384712,0.1599108168165481
252,0.0298,7,356,7,42661,562949,738,107218,5.214615213605543,0.1599869883178372
253,0.0299,8,343,8,43004,562606,746,107210,5.211437993256512,0.16005888184217756
254,0.03,7,334,7,43338,562272,753,107203,5.208344140205269,0.16012995257477874
255,0.0301,9,342,9,43680,561930,762,107194,5.205176182889326,0.16020050095348545
256,0.0302,8,318,8,43998,561612,770,107186,5.202230538367483,0.1602666275915897
257,0.0303,9,402,9,44400,561210,779,107177,5.198506799066286,0.16035171240613597
258,0.0304,13,383,13,44783,560827,792,107164,5.194959057393753,0.16042731114640765
259,0.0305,10,356,10,45139,560471,802,107154,5.191661417614584,0.16050028084628346
260,0.0306,6,354,6,45493,560117,808,107148,5.18838230390159,0.16057788135148704
261,0.0307,8,348,8,45841,559769,816,107140,5.1851587683871205,0.1606516031422578
262,0.0308,11,332,11,46173,559437,827,107129,5.182083441402053,0.16071776838302584
263,0.0309,11,365,11,46538,559072,838,107118,5.178702434325095,0.16079196625587294
264,0.031,12,363,12,46901,558709,850,107106,5.175339953314313,0.16086450440437658
265,0.0311,11,369,11,47270,558340,861,107095,5.171921894105005,0.1609398363476523
266,0.0312,10,355,10,47625,557985,871,107085,5.168633517358924,0.16101312643781857
267,0.0313,12,349,12,47974,557636,883,107073,5.165400718811368,0.16108251881650468
268,0.0314,9,359,9,48333,557277,892,107064,5.162075289932936,0.1611582003820327
269,0.0315,11,376,11,48709,556901,903,107053,5.158592389492015,0.1612355675242562
270,0.0316,9,362,9,49071,556539,912,107044,5.155239171514321,0.16131214934680363
271,0.0317,19,373,19,49444,556166,931,107025,5.1517840601726625,0.16137884862731852
272,0.0318,9,335,9,49779,555831,940,107016,5.1486809440883325,0.16144902217253757
273,0.0319,12,304,12,50083,555527,952,107004,5.145864982029716,0.16150791434664943
274,0.032,11,356,11,50439,555171,963,106993,5.142567342250547,0.16158081683691652
275,0.0321,10,350,10,50789,554821,973,106983,5.139325280669903,0.16165360136838097
276,0.0322,8,361,8,51150,554460,981,106975,5.135981325725296,0.1617316894328241
277,0.0323,12,346,12,51496,554114,993,106963,5.132776316277002,0.16180112150324394
278,0.0324,10,395,10,51891,553719,1003,106953,5.129117418207418,0.16188517146178436
279,0.0325,11,337,11,52228,553382,1014,106942,5.125995776056912,0.16195382872650396
280,0.0326,9,365,9,52593,553017,1023,106933,5.122614768979955,0.16203197211909992
281,0.0327,13,342,13,52935,552675,1036,106920,5.1194468116640115,0.16209947012939757
282,0.0328,7,378,7,53313,552297,1043,106913,5.115945385156916,0.16218352270141534
283,0.0329,7,341,7,53654,551956,1050,106906,5.11278669087406,0.1622585609733146
284,0.033,12,355,12,54009,551601,1062,106894,5.109498314127978,0.16233076940599397
285,0.0331,16,367,16,54376,551234,1078,106878,5.106098780984846,0.16240092871730039
286,0.0332,11,365,11,54741,550869,1089,106867,5.102717773907888,0.16247704246080494
287,0.0333,11,388,11,55129,550481,1100,106856,5.099123717069918,0.16255893095931007
288,0.0334,5,381,5,55510,550100,1105,106851,5.095594501463559,0.16264683362990542
289,0.0335,16,354,16,55864,549746,1121,106835,5.092315387750565,0.16271412057308998
290,0.0336,11,376,11,56240,549370,1132,106824,5.088832487309645,0.16279332026809146
291,0.0337,13,366,13,56606,549004,1145,106811,5.0854422171996,0.16286757698436297
292,0.0338,14,371,14,56977,548633,1159,106797,5.082005631924117,0.16294188547976138
293,0.0339,8,358,8,57335,548275,1167,106789,5.078689466078773,0.16302071248000197
294,0.034,6,335,6,57670,547940,1173,106783,5.075586349994442,0.16309645453115287
295,0.0341,9,371,9,58041,547569,1182,106774,5.07214976471896,0.16317741612579334
296,0.0342,13,388,13,58429,547181,1195,106761,5.068555707880988,0.16325759776860946
297,0.0343,9,405,9,58834,546776,1204,106752,5.064804179480529,0.1633472475548102
298,0.0344,8,342,8,59176,546434,1212,106744,5.061636222164585,0.16342252800921037
299,0.0345,10,384,10,59560,546050,1222,106734,5.058079217458965,0.16350584573151303
300,0.0346,15,364,15,59924,545686,1237,106719,5.054707473415095,0.16357783891907635
301,0.0347,11,415,11,60339,545271,1248,106708,5.0508633146837605,0.16366784819756464
302,0.0348,14,357,14,60696,544914,1262,106694,5.047556411871503,0.16373954893125928
303,0.0349,19,368,19,61064,544546,1281,106675,5.044147615695283,0.16380767819219588
304,0.035,15,367,15,61431,544179,1296,106660,5.040748082552151,0.1638807754298682
305,0.0351,7,347,7,61778,543832,1303,106653,5.037533810070769,0.16395919967408934
306,0.0352,8,379,8,62157,543453,1311,106645,5.034023120530587,0.1640444979064695
307,0.0353,8,354,8,62511,543099,1319,106637,5.030744006817592,0.1641235825012005
308,0.0354,14,378,14,62889,542721,1333,106623,5.027242580310497,0.16420110141927854
309,0.0355,12,359,12,63248,542362,1345,106611,5.023917151432065,0.16427647991518907
310,0.0356,16,367,16,63615,541995,1361,106595,5.020517618288933,0.1643488182056461
311,0.0357,14,338,14,63953,541657,1375,106581,5.017386713105339,0.16441646432328866
312,0.0358,11,338,11,64291,541319,1386,106570,5.014255807921746,0.16448805273742878
313,0.0359,10,387,10,64678,540932,1396,106560,5.010671014116863,0.16457346191149852
314,0.036,12,399,12,65077,540533,1408,106548,5.006975063914928,0.1646594475807511
315,0.0361,9,405,9,65482,540128,1417,106539,5.0032235355144685,0.164750946004667
316,0.0362,11,387,11,65869,539741,1428,106528,4.999638741709585,0.16483538588420613
317,0.0363,13,391,13,66260,539350,1441,106515,4.996016895772351,0.1649183652930566
318,0.0364,11,405,11,66665,538945,1452,106504,4.992265367371893,0.1650076148541558
319,0.0365,23,373,23,67038,538572,1475,106481,4.988810256030234,0.16507325754627913
320,0.0366,8,382,8,67420,538190,1483,106473,4.985271777390789,0.1651607118758173
321,0.0367,13,384,13,67804,537806,1496,106460,4.981714772685168,0.1652423067490757
322,0.0368,13,405,13,68209,537401,1509,106447,4.977963244284709,0.1653293945154757
323,0.0369,11,383,11,68592,537018,1520,106436,4.9744155026121755,0.16541353383458646
324,0.037,16,350,16,68942,536668,1536,106420,4.971173441031532,0.16548279551165626
325,0.0371,11,362,11,69304,536306,1547,106409,4.967820223053836,0.16556171864667854
326,0.0372,8,364,8,69668,535942,1555,106401,4.964448479009967,0.16564514597341295
327,0.0373,11,400,11,70068,535542,1566,106390,4.960743265774945,0.1657340652904046
328,0.0374,10,361,10,70429,535181,1576,106380,4.957399310830338,0.16581431851375006
329,0.0375,8,339,8,70768,534842,1584,106372,4.954259142613657,0.16589157441977248
330,0.0376,9,401,9,71169,534441,1593,106363,4.950544666345548,0.16598367051391688
331,0.0377,15,396,15,71565,534045,1608,106348,4.9468765052428765,0.16606677462120917
332,0.0378,12,395,12,71960,533650,1620,106336,4.943217607173293,0.1661536346107571
333,0.0379,16,368,16,72328,533282,1636,106320,4.939808810997073,0.16622837326962706
334,0.038,8,360,8,72688,532922,1644,106312,4.9364741190855534,0.16631155414136295
335,0.0381,17,382,17,73070,532540,1661,106295,4.932935640446107,0.1663888171437069
336,0.0382,16,431,16,73501,532109,1677,106279,4.9289432731853715,0.1664802596540035
337,0.0383,15,386,15,73887,531723,1692,106264,4.9253677424135756,0.16656138761448117
338,0.0384,14,366,14,74253,531357,1706,106250,4.921977472303531,0.16663869750488938
339,0.0385,10,386,10,74639,530971,1716,106240,4.9184019415317355,0.16672656310076253
340,0.0386,10,382,10,75021,530589,1726,106230,4.914863462892289,0.16681349017538735
341,0.0387,13,378,13,75399,530211,1739,106217,4.911362036385194,0.16689554827883124
342,0.0388,13,388,13,75787,529823,1752,106204,4.907767979547223,0.16698033259594325
343,0.0389,15,395,15,76182,529428,1767,106189,4.904109081477639,0.16706444289564312
344,0.039,12,376,12,76558,529052,1779,106177,4.900626181036719,0.1671475955915111
345,0.0391,18,402,18,76960,528650,1797,106159,4.896902441735522,0.16722982818454055
346,0.0392,7,393,7,77353,528257,1804,106152,4.893262069732113,0.16732423405090407
347,0.0393,10,380,10,77733,527877,1814,106142,4.889742117158843,0.1674113867250035
348,0.0394,6,392,6,78125,527485,1820,106136,4.8861110081885215,0.16750707441830368
349,0.0395,24,386,24,78511,527099,1844,106112,4.8825354774167256,0.16757763210051627
350,0.0396,13,401,13,78912,526698,1857,106099,4.878821001148616,0.1676667240837109
351,0.0397,9,376,9,79288,526322,1866,106090,4.875338100707696,0.16775456506201653
352,0.0398,4,400,4,79688,525922,1870,106086,4.871632887472674,0.16785547018392172
353,0.0399,18,419,18,80107,525503,1888,106068,4.8677516766089886,0.1679431132841755
354,0.04,16,397,16,80504,525106,1904,106052,4.864074252473229,0.1680276571001239
355,0.0401,13,398,13,80902,524708,1917,106039,4.860387565304383,0.1681165348388498
356,0.0402,8,369,8,81271,524339,1925,106031,4.8569695060950755,0.16820438789917033
357,0.0403,14,392,14,81663,523947,1939,106017,4.853338397124754,0.16829056898489436
358,0.0404,17,419,17,82082,523528,1956,106000,4.849457186261069,0.16838011970873415
359,0.0405,13,403,13,82485,523125,1969,105987,4.845724183926785,0.1684707969328196
360,0.0406,13,412,13,82897,522713,1982,105974,4.8419078142947125,0.1685640072086746
361,0.0407,9,380,9,83277,522333,1991,105965,4.838387861721442,0.16865404632833464
362,0.0408,15,403,15,83680,521930,2006,105950,4.834654859387157,0.16874243486016435
363,0.0409,16,424,16,84104,521506,2022,105934,4.830727333358035,0.16883526711717456
364,0.041,9,390,9,84494,521116,2031,105925,4.827114750453888,0.16892834758811626
365,0.0411,13,411,13,84905,520705,2044,105912,4.823307643854904,0.16902190652344254
366,0.0412,12,406,12,85311,520299,2056,105900,4.8195468524213565,0.1691155686930193
367,0.0413,16,394,16,85705,519905,2072,105884,4.815897217384861,0.16920080090893255
368,0.0414,13,396,13,86101,519509,2085,105871,4.812229056282189,0.1692906712718667
369,0.0415,20,395,20,86496,519114,2105,105851,4.808570158212605,0.16937108478074772
370,0.0416,16,409,16,86905,518705,2121,105835,4.804781577679796,0.16946072309219587
371,0.0417,9,388,9,87293,518317,2130,105826,4.801187520841824,0.16955409257173437
372,0.0418,12,388,12,87681,517929,2142,105814,4.797593464003853,0.16964358718254152
373,0.0419,14,419,14,88100,517510,2156,105800,4.793712253140169,0.1697389741861995
374,0.042,16,409,16,88509,517101,2172,105784,4.789923672607358,0.16982910168008541
375,0.0421,12,371,12,88880,516730,2184,105772,4.786487087331876,0.16991431352830996
376,0.0422,11,362,11,89242,516368,2195,105761,4.783133869354181,0.16999850513317977
377,0.0423,15,412,15,89654,515956,2210,105746,4.779317499722109,0.1700911369112533
378,0.0424,12,399,12,90053,515557,2222,105734,4.775621549520175,0.17018434195892101
379,0.0425,12,396,12,90449,515161,2234,105722,4.771953388417503,0.17027684765084566
380,0.0426,18,401,18,90850,514760,2252,105704,4.768238912149394,0.1703628252404652
381,0.0427,13,365,13,91215,514395,2265,105691,4.764857905072437,0.17044571236892947
382,0.0428,18,394,18,91609,514001,2283,105673,4.76120827003594,0.17052998834871239
383,0.0429,20,415,20,92024,513586,2303,105653,4.7573641113046055,0.1706174837179183
384,0.043,17,394,17,92418,513192,2320,105636,4.753714476268109,0.17070332951967268
385,0.0431,13,363,13,92781,512829,2333,105623,4.750351995257327,0.1707860917257928
386,0.0432,13,342,13,93123,512487,2346,105610,4.747184037941383,0.17086314931151583
387,0.0433,16,419,16,93542,512068,2362,105594,4.743302827077699,0.17095757874047618
388,0.0434,16,411,16,93953,511657,2378,105578,4.739495720478714,0.17104992425899374
389,0.0435,20,384,20,94337,511273,2398,105558,4.735938715773092,0.17112953142757092
390,0.0436,17,378,17,94715,510895,2415,105541,4.732437289265997,0.17121160996437587
391,0.0437,21,366,21,95081,510529,2436,105520,4.729047019155953,0.17128507634944623
392,0.0438,15,413,15,95494,510116,2451,105505,4.725221386490793,0.17137979373673087
393,0.0439,11,407,11,95901,509709,2462,105494,4.721451332024158,0.17147835755027202
394,0.044,17,427,17,96328,509282,2479,105477,4.7174960168957725,0.17157455197890556
395,0.0441,9,395,9,96723,508887,2488,105468,4.713837118826189,0.17167272993627464
396,0.0442,17,431,17,97154,508456,2505,105451,4.709844751565453,0.1717703170024124
397,0.0443,18,421,18,97575,508035,2523,105433,4.705945014635592,0.171863895101293
398,0.0444,23,436,23,98011,507599,2546,105410,4.701906332209418,0.17195506101868
399,0.0445,16,390,16,98401,507209,2562,105394,4.6982937493052725,0.17204290543794268
400,0.0446,14,397,14,98798,506812,2576,105380,4.694616325169513,0.17213553917725158
401,0.0447,8,387,8,99185,506425,2584,105372,4.69103153136463,0.17223360036090402
402,0.0448,11,389,11,99574,506036,2595,105361,4.687428211493572,0.17232829078323905
403,0.0449,17,393,17,99967,505643,2612,105344,4.683787839490162,0.17241610705301422
404,0.045,11,372,11,100339,505271,2623,105333,4.680341991181592,0.17250623972329038
405,0.0451,19,385,19,100724,504886,2642,105314,4.676775723442884,0.1725893149786955
406,0.0452,14,375,14,101099,504511,2656,105300,4.673302086035052,0.17267645221224281
407,0.0453,13,361,13,101460,504150,2669,105287,4.6699581310904446,0.1727610893332699
408,0.0454,23,364,23,101824,503786,2692,105264,4.666586387046575,0.1728331007306461
409,0.0455,18,403,18,102227,503383,2710,105246,4.662853384712291,0.17292307793417666
410,0.0456,11,414,11,102641,502969,2721,105235,4.659018489014043,0.17302582686072437
411,0.0457,20,441,20,103082,502528,2741,105215,4.654933491422431,0.17312416597147148
412,0.0458,15,412,15,103494,502116,2756,105200,4.651117121790359,0.17322118962780497
413,0.0459,21,388,21,103882,501728,2777,105179,4.647523064952388,0.1733033232439237
414,0.046,20,390,20,104272,501338,2797,105159,4.643910482048242,0.17338750232894803
415,0.0461,16,367,16,104639,500971,2813,105143,4.640510948905109,0.17347066723421667
416,0.0462,18,369,18,105008,500602,2831,105125,4.637092889695802,0.1735517815781697
417,0.0463,15,408,15,105416,500194,2846,105110,4.63331357219608,0.17364828251589284
418,0.0464,19,381,19,105797,499813,2865,105091,4.629784356589722,0.17373169957546983
419,0.0465,12,368,12,106165,499445,2877,105079,4.626375560413502,0.1738210559051419
420,0.0466,12,399,12,106564,499046,2889,105067,4.622679610211567,0.17391944884483532
421,0.0467,16,434,16,106998,498612,2905,105051,4.618659453851569,0.17402259207537982
422,0.0468,17,412,17,107410,498200,2922,105034,4.614843084219497,0.1741181697318122
423,0.0469,13,430,13,107840,497770,2935,105021,4.610859979991848,0.17422456539663
424,0.047,16,379,16,108219,497391,2951,105005,4.6073492904516655,0.17431224642925916
425,0.0471,25,428,25,108647,496963,2976,104980,4.603384712290192,0.17440189519605678
426,0.0472,20,391,20,109038,496572,2996,104960,4.599762866352958,0.1744878077974239
427,0.0473,18,401,18,109439,496171,3014,104942,4.5960483900848494,0.17457948838238402
428,0.0474,20,395,20,109834,495776,3034,104922,4.592389492015266,0.17466680428434922
429,0.0475,11,392,11,110226,495384,3045,104911,4.5887583830449445,0.17476574017774593
430,0.0476,19,374,19,110600,495010,3064,104892,4.585294008670199,0.17484855859790432
431,0.0477,10,394,10,110994,494616,3074,104882,4.5816443736337025,0.174949707922295
432,0.0478,19,417,19,111411,494199,3093,104863,4.577781688836192,0.175045320851598
433,0.0479,13,390,13,111801,493809,3106,104850,4.574169105932047,0.1751414411209052
434,0.048,18,432,18,112233,493377,3124,104832,4.570167475638223,0.17524310065545654
435,0.0481,17,411,17,112644,492966,3141,104815,4.566360369039238,0.17534013292493406
436,0.0482,22,391,22,113035,492575,3163,104793,4.562738523102005,0.17542452893358867
437,0.0483,23,413,23,113448,492162,3186,104770,4.558912890436845,0.17551412891250595
438,0.0484,13,446,13,113894,491716,3199,104757,4.554781577679796,0.17562739637837757
439,0.0485,20,415,20,114309,491301,3219,104737,4.55093741894846,0.1757220177237022
440,0.0486,13,429,13,114738,490872,3232,104724,4.5469635777539,0.17583059657888905
441,0.0487,19,394,19,115132,490478,3251,104705,4.543313942717403,0.1759206832184387
442,0.0488,18,430,18,115562,490048,3269,104687,4.5393308384897555,0.17602293458431065
443,0.0489,16,414,16,115976,489634,3285,104671,4.535495942791508,0.17612337099637393
444,0.049,22,433,22,116409,489201,3307,104649,4.531485049464597,0.17622126799696894
445,0.0491,15,420,15,116829,488781,3322,104634,4.527594575567824,0.17632516872677637
446,0.0492,21,404,21,117233,488377,3343,104613,4.523852310200452,0.17641612843386903
447,0.0493,18,397,18,117630,487980,3361,104595,4.520174886064693,0.17650930261992154
448,0.0494,22,404,22,118034,487576,3383,104573,4.516432620697321,0.1765991329884877
449,0.0495,11,425,11,118459,487151,3394,104562,4.5124958316351105,0.17671066885466433
450,0.0496,20,386,20,118845,486765,3414,104542,4.5089203008633145,0.1767981775964093
451,0.0497,16,367,16,119212,486398,3430,104526,4.505520767720182,0.1768856908841069
452,0.0498,22,393,22,119605,486005,3452,104504,4.501880395716774,0.17697274724009288
453,0.0499,16,393,16,119998,485612,3468,104488,4.498240023713365,0.17706829350957465
454,0.05,19,407,19,120405,485205,3487,104469,4.4944699692467305,0.17716399230761404
455,0.0501,21,394,21,120799,484811,3508,104448,4.490820334210234,0.17725312638415366
456,0.0502,18,410,18,121209,484401,3526,104430,4.487022490644336,0.17735139624102672
457,0.0503,20,400,20,121609,484001,3546,104410,4.483317277409315,0.17744399747795334
458,0.0504,19,408,19,122017,483593,3565,104391,4.479537959909592,0.1775405453209611
459,0.0505,16,390,16,122407,483203,3581,104375,4.475925377005447,0.17763599045573525
460,0.0506,21,443,21,122850,482760,3602,104354,4.47182185334766,0.17774060914916012
461,0.0507,19,404,19,123254,482356,3621,104335,4.468079587980288,0.17783637383222173
462,0.0508,14,396,14,123650,481960,3635,104321,4.464411426877617,0.1779368596287446
463,0.0509,18,441,18,124091,481519,3653,104303,4.460326429286005,0.1780455496720847
464,0.051,15,407,15,124498,481112,3668,104288,4.456556374819371,0.17814827468397676
465,0.0511,13,415,13,124913,480697,3681,104275,4.4527122160880355,0.17825639517788885
466,0.0512,22,374,22,125287,480323,3703,104253,4.449247841713291,0.1783395144514999
467,0.0513,11,365,11,125652,479958,3714,104242,4.445866834636333,0.17843546730571722
468,0.0514,13,406,13,126058,479552,3727,104229,4.442106043202786,0.17854126804400966
469,0.0515,20,403,20,126461,479149,3747,104209,4.438373040868502,0.1786364462302737
470,0.0516,20,395,20,126856,478754,3767,104189,4.434714142798918,0.17872930972667997
471,0.0517,18,378,18,127234,478376,3785,104171,4.431212716291823,0.17881990637665288
472,0.0518,17,399,17,127633,477977,3802,104154,4.427516766089888,0.17891849085515116
473,0.0519,16,426,16,128059,477551,3818,104138,4.42357071399459,0.17902693707462236
474,0.052,16,411,16,128470,477140,3834,104122,4.4197636073956055,0.1791309254690656
475,0.0521,21,378,21,128848,476762,3855,104101,4.41626218088851,0.17921781900379263
476,0.0522,23,403,23,129251,476359,3878,104078,4.412529178554226,0.17930972698156733
477,0.0523,21,362,21,129613,475997,3899,104057,4.4091759605765315,0.17939191868343293
478,0.0524,24,419,24,130032,475578,3923,104033,4.405294749712846,0.1794876218705304
479,0.0525,20,419,20,130451,475159,3943,104013,4.401413538849161,0.17958913759643078
480,0.0526,22,443,22,130894,474716,3965,103991,4.397310015191374,0.1796954244548623
481,0.0527,15,426,15,131320,474290,3980,103976,4.393363963096077,0.17980652502481556
482,0.0528,17,429,17,131749,473861,3997,103959,4.389390121901515,0.17991589076182896
483,0.0529,29,402,29,132151,473459,4026,103930,4.385666382600319,0.17999996536130755
484,0.053,21,364,21,132515,473095,4047,103909,4.3822946385564485,0.18008367359671684
485,0.0531,22,430,22,132945,472665,4069,103887,4.378311534328801,0.18018669608292054
486,0.0532,20,419,20,133364,472246,4089,103867,4.374430323465115,0.18028928352597495
487,0.0533,15,435,15,133799,471811,4104,103852,4.37040090407203,0.1804041600728204
488,0.0534,17,364,17,134163,471447,4121,103835,4.367029160028159,0.18049408811678447
489,0.0535,13,385,13,134548,471062,4134,103822,4.363462892289451,0.18059643336742717
490,0.0536,21,394,21,134942,470668,4155,103801,4.359813257252955,0.1806903418635296
491,0.0537,20,433,20,135375,470235,4175,103781,4.355802363926044,0.18079809622031442
492,0.0538,20,404,20,135779,469831,4195,103761,4.352060098558672,0.18089687443339517
493,0.0539,17,382,17,136161,469449,4212,103744,4.348521619919226,0.1809931384367918
494,0.054,17,417,17,136578,469032,4229,103727,4.344658935121716,0.18110060252217774
495,0.0541,19,402,19,136980,468630,4248,103708,4.34093519582052,0.1812006192145201
496,0.0542,20,397,20,137377,468233,4268,103688,4.337257771684761,0.18129776664958971
497,0.0543,22,393,22,137770,467840,4290,103666,4.333617399681351,0.18139092153013267
498,0.0544,28,428,28,138198,467412,4318,103638,4.329652821519878,0.18148673496191225
499,0.0545,20,369,20,138567,467043,4338,103618,4.326234762310571,0.18157540115760495
500,0.0546,21,417,21,138984,466626,4359,103597,4.3223720775130605,0.1816780452559788
501,0.0547,22,401,22,139385,466225,4381,103575,4.318657601244952,0.18177430677430678
502,0.0548,18,410,18,139795,465815,4399,103557,4.314859757679055,0.18187933372206572
503,0.0549,16,445,16,140240,465370,4415,103541,4.310737707955093,0.18199859028916648
504,0.055,26,398,26,140638,464972,4441,103515,4.307051020786246,0.18208859657300872
505,0.0551,11,387,11,141025,464585,4452,103504,4.303466226981363,0.1821968036698475
506,0.0552,23,411,23,141436,464174,4475,103481,4.299659120382378,0.1822955844659168
507,0.0553,16,392,16,141828,463782,4491,103465,4.296028011412057,0.18239849659848356
508,0.0554,25,442,25,142270,463340,4516,103440,4.291933750787358,0.18250467553548114
509,0.0555,20,418,20,142688,462922,4536,103420,4.2880618029567605,0.1826105074319051
510,0.0556,19,398,19,143086,462524,4555,103401,4.284375115787913,0.18271149003843265
511,0.0557,22,397,22,143483,462127,4577,103379,4.280697691652154,0.18280796313390132
512,0.0558,25,391,25,143874,461736,4602,103354,4.277075845714921,0.18289829938593852
513,0.0559,29,427,29,144301,461309,4631,103325,4.273120530586535,0.18299464786038389
514,0.056,14,392,14,144693,460917,4645,103311,4.269489421616214,0.1831015121546609
515,0.0561,22,392,22,145085,460525,4667,103289,4.265858312645893,0.1831969408350981
516,0.0562,25,401,25,145486,460124,4692,103264,4.262143836377784,0.1832910889120819
517,0.0563,14,407,14,145893,459717,4706,103250,4.258373781911149,0.183403290068512
518,0.0564,27,391,27,146284,459326,4733,103223,4.254751935973915,0.1834915714008913
519,0.0565,15,378,15,146662,458948,4748,103208,4.25125050946682,0.18359316630970762
520,0.0566,18,384,18,147046,458564,4766,103190,4.247693504761199,0.18369250597236514
521,0.0567,24,396,24,147442,458168,4790,103166,4.244025343658527,0.1837871926517902
522,0.0568,19,380,19,147822,457788,4809,103147,4.240505391085257,0.18388405073671638
523,0.0569,25,405,25,148227,457383,4834,103122,4.236753862684798,0.18398051756897799
524,0.057,17,379,17,148606,457004,4851,103105,4.233243173144614,0.18408024152441757
525,0.0571,30,427,30,149033,456577,4881,103075,4.229287858016229,0.18417695282068142
526,0.0572,18,383,18,149416,456194,4899,103057,4.225740116343696,0.184276827399504
527,0.0573,22,430,22,149846,455764,4921,103035,4.221757012116047,0.1843865146501694
528,0.0574,26,369,26,150215,455395,4947,103009,4.218338952906739,0.1844703834499753
529,0.0575,35,405,35,150620,454990,4982,102974,4.214587424506281,0.18455312529123744
530,0.0576,25,374,25,150994,454616,5007,102949,4.211123050131535,0.1846403558329522
531,0.0577,28,365,28,151359,454251,5035,102921,4.207742043054578,0.18472033770541232
532,0.0578,19,424,19,151783,453827,5054,102902,4.203814517025455,0.1848331953248349
533,0.0579,20,390,20,152173,453437,5074,102882,4.200201934121309,0.18493346443317593
534,0.058,21,393,21,152566,453044,5095,102861,4.1965615621179,0.18503341398260495
535,0.0581,30,376,30,152942,452668,5125,102831,4.19307866167698,0.1851146446708275
536,0.0582,20,370,20,153312,452298,5145,102811,4.189651339434585,0.1852086707295324
537,0.0583,20,425,20,153737,451873,5165,102791,4.185714550372374,0.18532120346732436
538,0.0584,26,426,26,154163,451447,5191,102765,4.1817684982770755,0.18542543286684518
539,0.0585,20,383,20,154546,451064,5211,102745,4.178220756604542,0.18552425114073626
540,0.0586,24,429,24,154975,450635,5235,102721,4.174246915409982,0.18563275721235514
541,0.0587,28,419,28,155394,450216,5263,102693,4.170365704546296,0.1857321910115408
542,0.0588,29,363,29,155757,449853,5292,102664,4.167003223535515,0.18581147729391131
543,0.0589,24,370,24,156127,449483,5316,102640,4.163575901293119,0.18590060548102505
544,0.059,23,380,23,156507,449103,5339,102617,4.160055948719849,0.18599470746030594
545,0.0591,23,374,23,156881,448729,5362,102594,4.156591574345104,0.18608692182259765
546,0.0592,16,399,16,157280,448330,5378,102578,4.152895624143169,0.18619805847800358
547,0.0593,24,401,24,157681,447929,5402,102554,4.14918114787506,0.18629821447710465
548,0.0594,27,368,27,158049,447561,5429,102527,4.14577235169884,0.18638290600776602
549,0.0595,20,395,20,158444,447166,5449,102507,4.142113453629256,0.18648723877650894
550,0.0596,27,376,27,158820,446790,5476,102480,4.138630553188336,0.18657490851493802
551,0.0597,20,410,20,159230,446380,5496,102460,4.134832709622438,0.18668464397638657
552,0.0598,27,371,27,159601,446009,5523,102433,4.131396124346956,0.186770889173331
553,0.0599,19,412,19,160013,445597,5542,102414,4.127579754714884,0.18688311001056548
554,0.06,23,398,23,160411,445199,5565,102391,4.123893067546037,0.1869847878887489
555,0.0601,21,394,21,160805,444805,5586,102370,4.1202434325095405,0.18708822588751314
556,0.0602,33,446,33,161251,444359,5619,102337,4.116112119752492,0.18719178483105783
557,0.0603,21,386,21,161637,443973,5640,102316,4.112536588980696,0.1872928065547723
558,0.0604,28,404,28,162041,443569,5668,102288,4.108794323613324,0.18738973760527025
559,0.0605,13,401,13,162442,443168,5681,102275,4.105079847345214,0.18750813558886997
560,0.0606,31,392,31,162834,442776,5712,102244,4.101448738374893,0.18759678543906647
561,0.0607,28,422,28,163256,442354,5740,102216,4.097539738411945,0.187700387461667
562,0.0608,25,386,25,163642,441968,5765,102191,4.09396420764015,0.18779621397422444
563,0.0609,24,390,24,164032,441578,5789,102167,4.0903516247360034,0.18789506110401016
564,0.061,21,401,21,164433,441177,5810,102146,4.0866371484678945,0.1880023485109226
565,0.0611,28,394,28,164827,440783,5838,102118,4.082987513431398,0.18809690901287712
566,0.0612,37,393,37,165220,440390,5875,102081,4.07934714142799,0.18817780120964991
567,0.0613,31,355,31,165575,440035,5906,102050,4.076058764681908,0.18825460951695766
568,0.0614,19,364,19,165939,439671,5925,102031,4.072687020638038,0.18835263668954516
569,0.0615,22,415,22,166354,439256,5947,102009,4.0688428619067025,0.1884640610421882
570,0.0616,19,426,19,166780,438830,5966,101990,4.064896809811405,0.18858400207092932
571,0.0617,27,415,27,167195,438415,5993,101963,4.06105265108007,0.1886882885683725
572,0.0618,29,363,29,167558,438052,6022,101934,4.057690170069288,0.18877156074416745
573,0.0619,29,387,29,167945,437665,6051,101905,4.054105376264404,0.1888633541523806
574,0.062,23,386,23,168331,437279,6074,101882,4.050529845492608,0.18896396438169674
575,0.0621,16,396,16,168727,436883,6090,101866,4.0468616843899365,0.18907877323206168
576,0.0622,21,370,21,169097,436513,6111,101845,4.043434362147542,0.18917709033765637
577,0.0623,18,444,18,169541,436069,6129,101827,4.039321575456667,0.1893061112185255
578,0.0624,16,395,16,169936,435674,6145,101811,4.035662677387084,0.18942110012372437
579,0.0625,32,376,32,170312,435298,6177,101779,4.032179776946164,0.18950541542460392
580,0.0626,26,386,26,170698,434912,6203,101753,4.028604246174368,0.18960245218152852
581,0.0627,23,384,23,171082,434528,6226,101730,4.025047241468746,0.1897034636313118
582,0.0628,25,409,25,171491,434119,6251,101705,4.021258660935937,0.1898104601510944
583,0.0629,24,388,24,171879,433731,6275,101681,4.017664604097966,0.18991169417196477
584,0.063,25,364,25,172243,433367,6300,101656,4.014292860054096,0.19000304659799672
585,0.0631,24,415,24,172658,432952,6324,101632,4.010448701322761,0.190114182242641
586,0.0632,23,369,23,173027,432583,6347,101609,4.007030642113453,0.19021063587623926
587,0.0633,27,402,27,173429,432181,6374,101582,4.003306902812257,0.1903129291464564
588,0.0634,22,406,22,173835,431775,6396,101560,3.99954611137871,0.1904244049237346
589,0.0635,25,357,25,174192,431418,6421,101535,3.996239208566453,0.19051398528575691
590,0.0636,16,390,16,174582,431028,6437,101519,3.992626625662307,0.190629183903017
591,0.0637,25,381,25,174963,430647,6462,101494,3.989097410055949,0.19072764549245408
592,0.0638,21,407,21,175370,430240,6483,101473,3.9853273555893143,0.1908416758664919
593,0.0639,25,396,25,175766,429844,6508,101448,3.981659194486643,0.19094584522258945
594,0.064,25,392,25,176158,429452,6533,101423,3.9780280855163213,0.1910487402872616
595,0.0641,19,415,19,176573,429037,6552,101404,3.9741839267849866,0.19116923465569216
596,0.0642,30,377,30,176950,428660,6582,101374,3.9706917633109784,0.19125942864042683
597,0.0643,21,407,21,177357,428253,6603,101353,3.966921708844344,0.19137434243569748
598,0.0644,25,383,25,177740,427870,6628,101328,3.963373967171811,0.1914746465406143
599,0.0645,34,391,34,178131,427479,6662,101294,3.959752121234577,0.19156424401397196
600,0.0646,32,415,32,178546,427064,6694,101262,3.9559079625032423,0.19166575182747017
601,0.0647,27,364,27,178910,426700,6721,101235,3.952536218459372,0.19175656094026727
602,0.0648,23,371,23,179281,426329,6744,101212,3.9490996331838897,0.1918561780032263
603,0.0649,20,380,20,179661,425949,6764,101192,3.945579680610619,0.19196381992673686
604,0.065,23,369,23,180030,425580,6787,101169,3.9421616214013118,0.19206301293405398
605,0.0651,19,386,19,180416,425194,6806,101150,3.938586090629516,0.19217469943611024
606,0.0652,23,428,23,180844,424766,6829,101127,3.9346215124680426,0.19229577119299934
607,0.0653,15,346,15,181190,424420,6844,101112,3.931416503019749,0.19239932106893587
608,0.0654,18,377,18,181567,424043,6862,101094,3.927924339545741,0.19250976411869664
609,0.0655,14,393,14,181960,423650,6876,101080,3.924283967542332,0.192632401425495
610,0.0656,31,400,31,182360,423250,6907,101049,3.9205787543073103,0.19273162832658464
611,0.0657,34,386,34,182746,422864,6941,101015,3.9170032235355143,0.1928212430733051
612,0.0658,30,383,30,183129,422481,6971,100985,3.9134554818629814,0.19291606331643316
613,0.0659,26,377,26,183506,422104,6997,100959,3.9099633183889733,0.19301499054607188
614,0.066,27,379,27,183885,421725,7024,100932,3.90645262884879,0.19311326548769078
615,0.0661,18,383,18,184268,421342,7042,100914,3.902904887176257,0.19322707637633652
616,0.0662,25,357,25,184625,420985,7067,100889,3.899597984364,0.1933206099556598
617,0.0663,28,401,28,185026,420584,7095,100861,3.895883508095891,0.19342596055192782
618,0.0664,25,401,25,185427,420183,7120,100836,3.8921690318277817,0.19353612824100463
619,0.0665,18,363,18,185790,419820,7138,100818,3.8888065508169993,0.19364318393970475
620,0.0666,18,398,18,186188,419422,7156,100800,3.885119863648153,0.19376343176566926
621,0.0667,23,386,23,186574,419036,7179,100777,3.881544332876357,0.19387164230213558
622,0.0668,26,362,26,186936,418674,7205,100751,3.8781911148986623,0.19396640515955144
623,0.0669,30,378,30,187314,418296,7235,100721,3.874689688391567,0.19406108085091625
624,0.067,28,383,28,187697,417913,7263,100693,3.8711419467190336,0.19416088514209245
625,0.0671,24,325,24,188022,417588,7287,100669,3.8681314609655786,0.19424532616057286
626,0.0672,31,418,31,188440,417170,7318,100638,3.864259513134981,0.19435389179000712
627,0.0673,25,383,25,188823,416787,7343,100613,3.8607117714624475,0.19445883262466176
628,0.0674,24,415,24,189238,416372,7367,100589,3.856867612731113,0.19457754066554345
629,0.0675,22,362,22,189600,416010,7389,100567,3.853514394753418,0.19467959278094069
630,0.0676,25,363,25,189963,415647,7414,100542,3.850151913742636,0.1947774942898822
631,0.0677,37,407,37,190370,415240,7451,100505,3.8463818592760015,0.19487343551561334
632,0.0678,23,376,23,190746,414864,7474,100482,3.842898958835081,0.19497968355240944
633,0.0679,28,364,28,191110,414500,7502,100454,3.8395272147912114,0.19507373474135553
634,0.068,23,370,23,191480,414130,7525,100431,3.836099892548816,0.19517802554021776
635,0.0681,28,391,28,191871,413739,7553,100403,3.8324780466115826,0.19528262620054382
636,0.0682,25,361,25,192232,413378,7578,100378,3.8291340916669756,0.19538068655159258
637,0.0683,23,378,23,192610,413000,7601,100355,3.8256326651598798,0.19548850210867724
638,0.0684,23,377,23,192987,412623,7624,100332,3.822140501685872,0.19559610492148435
639,0.0685,27,411,27,193398,412212,7651,100305,3.818333395086887,0.19571058130754687
640,0.0686,34,370,34,193768,411842,7685,100271,3.8149060728444923,0.1957985835157475
641,0.0687,20,388,20,194156,411454,7705,100251,3.811312016006521,0.19591561544249128
642,0.0688,23,377,23,194533,411077,7728,100228,3.8078198525325133,0.19602389962937972
643,0.0689,22,374,22,194907,410703,7750,100206,3.804355478157768,0.19613277511259344
644,0.069,31,388,31,195295,410315,7781,100175,3.800761421319797,0.19623303100942233
645,0.0691,30,394,30,195689,409921,7811,100145,3.797111786283301,0.19633733673681444
646,0.0692,34,356,34,196045,409565,7845,100111,3.7938141465041313,0.1964208634505058
647,0.0693,28,408,28,196453,409157,7873,100083,3.790034829004409,0.1965340507422826
648,0.0694,28,387,28,196840,408770,7901,100055,3.786450035199526,0.19663931607134083
649,0.0695,27,428,27,197268,408342,7928,100028,3.7824854570380526,0.1967622007592895
650,0.0696,26,354,26,197622,407988,7954,100002,3.7792063433250584,0.19685820587019429
651,0.0697,27,362,27,197984,407626,7981,99975,3.7758531253473637,0.1969558767614721
652,0.0698,28,376,28,198360,407250,8009,99947,3.7723702249064432,0.1970575535738579
653,0.0699,27,386,27,198746,406864,8036,99920,3.7687946941346473,0.19716486708341227
654,0.07,24,389,24,199135,406475,8060,99896,3.7651913742635887,0.19727828015427423
655,0.0701,21,385,21,199520,406090,8081,99875,3.7616251065248805,0.19739507673455675
656,0.0702,23,402,23,199922,405688,8104,99852,3.757901367223684,0.19751552795031055
657,0.0703,27,402,27,200324,405286,8131,99825,3.7541776279224868,0.19762982789921424
658,0.0704,31,377,31,200701,404909,8162,99794,3.750685464448479,0.1977281688438547
659,0.0705,38,354,38,201055,404555,8200,99756,3.747406350735485,0.1978065122513687
660,0.0706,30,355,30,201410,404200,8230,99726,3.744117973989403,0.19789810408671116
661,0.0707,22,404,22,201814,403796,8252,99704,3.740375708622031,0.19802184707050646
662,0.0708,33,387,33,202201,403409,8285,99671,3.736790914817148,0.19812157112188916
663,0.0709,30,406,30,202607,403003,8315,99641,3.7330301233836005,0.19823373998297006
664,0.071,18,372,18,202979,402631,8333,99623,3.7295842750750308,0.1983518299505828
665,0.0711,18,373,18,203352,402258,8351,99605,3.726129163733373,0.19847049892102028
666,0.0712,32,371,32,203723,401887,8383,99573,3.7226925784578904,0.19856618673473458
667,0.0713,28,341,28,204064,401546,8411,99545,3.7195338841750343,0.19865653144837964
668,0.0714,41,376,41,204440,401170,8452,99504,3.716050983734114,0.19874009834742767
669,0.0715,24,374,24,204814,400796,8476,99480,3.7125866093593687,0.1988502346704619
670,0.0716,34,391,34,205205,400405,8510,99446,3.7089647634221348,0.19895128748367014
671,0.0717,26,361,26,205566,400044,8536,99420,3.7056208084775277,0.19905338522896546
672,0.0718,34,367,34,205933,399677,8570,99386,3.7022212753343955,0.19914519810124173
673,0.0719,25,327,25,206260,399350,8595,99361,3.699192263514765,0.19923562945272913
674,0.072,19,374,19,206634,398976,8614,99342,3.69572788914002,0.19935462897186135
675,0.0721,35,337,35,206971,398639,8649,99307,3.6926062469895142,0.1994332718808867
676,0.0722,33,387,33,207358,398252,8682,99274,3.6890214531846306,0.1995353006677038
677,0.0723,35,393,35,207751,397859,8717,99239,3.6853810811812218,0.1996366913566339
678,0.0724,36,369,36,208120,397490,8753,99203,3.6819630219719146,0.1997269943405685
679,0.0725,28,361,28,208481,397129,8781,99175,3.6786190670273076,0.19982712208646314
680,0.0726,26,355,26,208836,396774,8807,99149,3.6753306902812257,0.19992821466235686
681,0.0727,29,362,29,209198,396412,8836,99120,3.671977472303531,0.2000274452507608
682,0.0728,26,408,26,209606,396004,8862,99094,3.668198154803809,0.20015027327922957
683,0.0729,30,387,30,209993,395617,8892,99064,3.6646133609989255,0.2002583483093145
684,0.073,27,377,27,210370,395240,8919,99037,3.6611211975249174,0.2003674053213077
685,0.0731,20,346,20,210716,394894,8939,99017,3.6579161880766238,0.20047538929078315
686,0.0732,31,395,31,211111,394499,8970,98986,3.65425729000704,0.20058563076891903
687,0.0733,27,370,27,211481,394129,8997,98959,3.6508299677646447,0.20069237134142384
688,0.0734,24,373,24,211854,393756,9021,98935,3.6473748564229873,0.2008053729416612
689,0.0735,27,334,27,212188,393422,9048,98908,3.644281003371744,0.2008977718197144
690,0.0736,25,394,25,212582,393028,9073,98883,3.6406313683352476,0.20101807034199276
691,0.0737,22,406,22,212988,392622,9095,98861,3.6368705769017007,0.20114836118441534
692,0.0738,20,362,20,213350,392260,9115,98841,3.633517358924006,0.20126409842374582
693,0.0739,27,349,27,213699,391911,9142,98814,3.6302845603764498,0.20136328901115697
694,0.074,24,385,24,214084,391526,9166,98790,3.6267182926377415,0.20148230936783626
695,0.0741,30,323,30,214407,391203,9196,98760,3.6237263329504614,0.20156624071613571
696,0.0742,37,379,37,214786,390824,9233,98723,3.6202156434102783,0.20166194461410242
697,0.0743,40,360,40,215146,390464,9273,98683,3.6168809514987585,0.20174507867777988
698,0.0744,24,379,24,215525,390085,9297,98659,3.613370261958576,0.20186232465257886
699,0.0745,23,343,23,215868,389742,9320,98636,3.6101930416095445,0.20196650954793213
700,0.0746,30,366,30,216234,389376,9350,98606,3.6068027714995,0.2020689287719629
701,0.0747,27,382,27,216616,388994,9377,98579,3.6032642928600542,0.20218305771648554
702,0.0748,24,385,24,217001,388609,9401,98555,3.5996980251213455,0.20230353638610407
703,0.0749,28,352,28,217353,388257,9429,98527,3.5964374374745267,0.20240394096765713
704,0.075,27,361,27,217714,387896,9456,98500,3.5930934825299197,0.20250988906158768
705,0.0751,27,391,27,218105,387505,9483,98473,3.5894716365926858,0.202628514047961
706,0.0752,28,404,28,218509,387101,9511,98445,3.585729371225314,0.20275112965609848
707,0.0753,26,359,26,218868,386742,9537,98419,3.582403942346882,0.20285843256156202
708,0.0754,31,315,31,219183,386427,9568,98388,3.5794860869243026,0.2029392654930231
709,0.0755,33,396,33,219579,386031,9601,98355,3.575817925821631,0.20305087265115013
710,0.0756,29,364,29,219943,385667,9630,98326,3.5724461817777615,0.20315583076614743
711,0.0757,28,358,28,220301,385309,9658,98298,3.569130015932417,0.20326008515178648
712,0.0758,31,349,31,220650,384960,9689,98267,3.5658972173848604,0.20335577275276423
713,0.0759,23,362,23,221012,384598,9712,98244,3.5625439994071657,0.2034702863462582
714,0.076,30,381,30,221393,384217,9742,98214,3.5590147838008077,0.20358144480765125
715,0.0761,20,360,20,221753,383857,9762,98194,3.5556800918892884,0.20370043833536286
716,0.0762,34,363,34,222116,383494,9796,98160,3.552317610878506,0.20379774693036912
717,0.0763,22,316,22,222432,383178,9818,98138,3.5493904924228388,0.2038951541191234
718,0.0764,30,357,30,222789,382821,9848,98108,3.546083589610582,0.2039968477675499
719,0.0765,32,364,32,223153,382457,9880,98076,3.5427118455667124,0.20409836577300622
720,0.0766,25,357,25,223510,382100,9905,98051,3.5394049427544556,0.2042086760206685
721,0.0767,29,391,29,223901,381709,9934,98022,3.5357830968172217,0.20432700826087954
722,0.0768,27,353,27,224254,381356,9961,97995,3.532513246137315,0.20443265999236468
723,0.0769,29,378,29,224632,380978,9990,97966,3.52901181963022,0.20454583416850405
724,0.077,29,340,29,224972,380638,10019,97937,3.5258623883804514,0.2046429504257431
725,0.0771,16,366,16,225338,380272,10035,97921,3.5224721182704064,0.20477296823667432
726,0.0772,28,342,28,225680,379930,10063,97893,3.519304160954463,0.20487293411995655
727,0.0773,31,335,31,226015,379595,10094,97862,3.516201044870132,0.20496505444469346
728,0.0774,31,331,31,226346,379264,10125,97831,3.513134980918152,0.20505559689370043
729,0.0775,28,363,28,226709,378901,10153,97803,3.5097724999073696,0.20516505001006913
730,0.0776,43,370,43,227079,378531,10196,97760,3.5063451776649748,0.2052526711611179
731,0.0777,25,378,25,227457,378153,10221,97735,3.502843751157879,0.20537395353528562
732,0.0778,26,368,26,227825,377785,10247,97709,3.499434954981659,0.2054894488679142
733,0.0779,20,347,20,228172,377438,10267,97689,3.4962206825002777,0.20560608005859485
734,0.078,22,363,22,228535,377075,10289,97667,3.4928582014894958,0.20572647880322364
735,0.0781,29,332,29,228867,376743,10318,97638,3.489782874504428,0.20582190264787165
736,0.0782,31,316,31,229183,376427,10349,97607,3.4868557560487607,0.20590717121556681
737,0.0783,24,363,24,229546,376064,10373,97583,3.4834932750379783,0.20602473994346
738,0.0784,26,363,26,229909,375701,10399,97557,3.4801307940271964,0.20613914608944803
739,0.0785,33,391,33,230300,375310,10432,97524,3.4765089480899625,0.20625420337792968
740,0.0786,25,325,25,230625,374985,10457,97499,3.4734984623365075,0.20635407759839486
741,0.0787,29,335,29,230960,374650,10486,97470,3.4703953462521766,0.20645174955519782
742,0.0788,22,342,22,231302,374308,10508,97448,3.4672273889362333,0.2065644104155538
743,0.0789,28,409,28,231711,373899,10536,97420,3.4634388084034238,0.2066965261319828
744,0.079,26,342,26,232053,373557,10562,97394,3.46027085108748,0.20680283086775483
745,0.0791,22,368,22,232421,373189,10584,97372,3.45686205491126,0.2069274759276693
746,0.0792,27,357,27,232778,372832,10611,97345,3.4535551520990033,0.2070390512509119
747,0.0793,31,336,31,233114,372496,10642,97314,3.450442772981585,0.20713479917413422
748,0.0794,35,359,35,233473,372137,10677,97279,3.447117344103153,0.20723409513097124
749,0.0795,36,353,36,233826,371784,10713,97243,3.4438474934232466,0.20732921558886802
750,0.0796,15,332,15,234158,371452,10728,97228,3.4407721664381787,0.2074507126397542
751,0.0797,35,369,35,234527,371083,10763,97193,3.437354107228871,0.2075549462282927
752,0.0798,22,376,22,234903,370707,10785,97171,3.4338712067879507,0.20768448185210675
753,0.0799,41,357,41,235260,370350,10826,97130,3.430564303975694,0.20777359459228203
754,0.08,33,344,33,235604,370006,10859,97097,3.427377820593575,0.2078706409507111
755,0.0801,31,386,31,235990,369620,10890,97066,3.4238022898217793,0.20798995470187664
756,0.0802,32,372,32,236362,369248,10922,97034,3.420356441513209,0.2081015351225224
757,0.0803,23,371,23,236733,368877,10945,97011,3.4169198562377265,0.20822815784051102
758,0.0804,42,366,42,237099,368511,10987,96969,3.4135295861276815,0.20832044341325084
759,0.0805,27,317,27,237416,368194,11014,96942,3.410593204638927,0.20841646314196277
760,0.0806,22,352,22,237768,367842,11036,96920,3.407332616992108,0.2085368425129421
761,0.0807,26,326,26,238094,367516,11062,96894,3.4043128682055652,0.20863891819728259
762,0.0808,26,345,26,238439,367171,11088,96868,3.401117121790359,0.20874969560748127
763,0.0809,26,362,26,238801,366809,11114,96842,3.3977639038126646,0.20886830827497407
764,0.081,31,355,31,239156,366454,11145,96811,3.3944755270665827,0.20897542443309985
765,0.0811,34,343,34,239499,366111,11179,96777,3.3912983067175517,0.2090721729662467
766,0.0812,33,384,33,239883,365727,11212,96744,3.3877413020119307,0.20918933295276892
767,0.0813,25,328,25,240211,365399,11237,96719,3.384703027159213,0.2092950285424935
768,0.0814,38,347,38,240558,365052,11275,96681,3.381488754677832,0.20938724327695876
769,0.0815,36,350,36,240908,364702,11311,96645,3.378246693097188,0.2094844011123948
770,0.0816,22,340,22,241248,364362,11333,96623,3.3750972618474195,0.2096011800817814
771,0.0817,30,337,30,241585,364025,11363,96593,3.3719756196969137,0.20970305111828022
772,0.0818,36,370,36,241955,363655,11399,96557,3.3685482974545184,0.20980982677548607
773,0.0819,20,354,20,242309,363301,11419,96537,3.3652691837415243,0.20993697780522705
774,0.082,35,377,35,242686,362924,11454,96502,3.3617770202675166,0.21004906121987002
775,0.0821,34,325,34,243011,362599,11488,96468,3.358766534514061,0.21013926071793443
776,0.0822,25,369,25,243380,362230,11513,96443,3.355348475304754,0.2102652652325295
777,0.0823,34,354,34,243734,361876,11547,96409,3.3520693615917594,0.21036909346803845
778,0.0824,34,341,34,244075,361535,11581,96375,3.3489106673089037,0.21046712236028914
779,0.0825,26,326,26,244401,361209,11607,96349,3.345890918522361,0.21057221161033138
780,0.0826,20,384,20,244785,360825,11627,96329,3.34233391381674,0.21071455133281125
781,0.0827,30,365,30,245150,360460,11657,96299,3.3389529067397827,0.21083109473486017
782,0.0828,32,349,32,245499,360111,11689,96267,3.3357201081922265,0.21093698644544653
783,0.0829,29,328,29,245827,359783,11718,96238,3.3326818333395085,0.21103852673451443
784,0.083,30,312,30,246139,359471,11748,96208,3.3297917670161916,0.21113108130943053
785,0.0831,28,339,28,246478,359132,11776,96180,3.326651598799511,0.21123976525986576
786,0.0832,30,364,30,246842,358768,11806,96150,3.3232798547556412,0.21135677198967726
787,0.0833,29,309,29,247151,358459,11835,96121,3.320417577531587,0.21145012979013594
788,0.0834,46,342,46,247493,358117,11881,96075,3.3172496202156436,0.2115294853277909
789,0.0835,32,325,32,247818,357792,11913,96043,3.314239134462188,0.21162537045401963
790,0.0836,22,366,22,248184,357426,11935,96021,3.3108488643521437,0.21175793422384534
791,0.0837,31,306,31,248490,357120,11966,95990,3.308014376227352,0.21184701286663282
792,0.0838,36,374,36,248864,356746,12002,95954,3.304550001852607,0.21195935498122376
793,0.0839,26,362,26,249226,356384,12028,95928,3.301196783874912,0.21208369444100533
794,0.084,32,341,32,249567,356043,12060,95896,3.298038089592056,0.21218792801683414
795,0.0841,38,335,38,249902,355708,12098,95858,3.2949349735077256,0.21227904669527822
796,0.0842,27,302,27,250204,355406,12125,95831,3.292137537515284,0.21237398528932688
797,0.0843,31,355,31,250559,355051,12156,95800,3.2888491607692023,0.21248705226338635
798,0.0844,38,321,38,250880,354730,12194,95762,3.285875727148097,0.21257203235573552
799,0.0845,37,356,37,251236,354374,12231,95725,3.282578087368928,0.2126754336268243
800,0.0846,33,350,33,251586,354024,12264,95692,3.279336025788284,0.21278317871723487
801,0.0847,28,313,28,251899,353711,12292,95664,3.2764366964318796,0.21288233657858135
802,0.0848,25,332,25,252231,353379,12317,95639,3.2733613694468118,0.21299591553122593
803,0.0849,39,335,39,252566,353044,12356,95600,3.270258253362481,0.21308654523408316
804,0.085,27,346,27,252912,352698,12383,95573,3.2670532439141873,0.2132036201315722
805,0.0851,23,336,23,253248,352362,12406,95550,3.263940864796769,0.21332315276214972
806,0.0852,28,314,28,253562,352048,12434,95522,3.261032272407277,0.21342359854324464
807,0.0853,40,374,40,253936,351674,12474,95482,3.2575678980325318,0.21353174283695175
808,0.0854,35,335,35,254271,351339,12509,95447,3.2544647819482013,0.21363023908537868
809,0.0855,30,371,30,254642,350968,12539,95417,3.2510281966727184,0.21375494248238627
810,0.0856,27,366,27,255008,350602,12566,95390,3.247637926562674,0.21388276022888303
811,0.0857,31,318,31,255326,350284,12597,95359,3.2446922820408313,0.21398069755387158
812,0.0858,28,338,28,255664,349946,12625,95331,3.241561376857238,0.21409369897838873
813,0.0859,32,333,32,255997,349613,12657,95299,3.2384767868390827,0.21419741432013523
814,0.086,26,372,26,256369,349241,12683,95273,3.2350309385305125,0.21433070724431627
815,0.0861,25,345,25,256714,348896,12708,95248,3.231835192115306,0.21445297020786053
816,0.0862,31,345,31,257059,348551,12739,95217,3.2286394457001,0.21456481765246704
817,0.0863,28,328,28,257387,348223,12767,95189,3.225601170847382,0.21467393755694478
818,0.0864,33,306,33,257693,347917,12800,95156,3.2227666827225905,0.21476370710921225
819,0.0865,39,331,39,258024,347586,12839,95117,3.2197006187706103,0.21485510601915958
820,0.0866,38,354,38,258378,347232,12877,95079,3.216421505057616,0.21495960986726534
821,0.0867,25,325,25,258703,346907,12902,95054,3.213411019304161,0.21507327569627185
822,0.0868,23,322,23,259025,346585,12925,95031,3.2104283226499684,0.2151892141589073
823,0.0869,26,327,26,259352,346258,12951,95005,3.2073993108303385,0.21530243868169324
824,0.087,23,343,23,259695,345915,12974,94982,3.204222090481307,0.21542900042413535
825,0.0871,21,339,21,260034,345576,12995,94961,3.2010819222646263,0.215557376565419
826,0.0872,30,323,30,260357,345253,13025,94931,3.1980899625773462,0.21566208676371698
827,0.0873,29,317,29,260674,344936,13054,94902,3.195153581088592,0.21576580468263315
828,0.0874,39,348,39,261022,344588,13093,94863,3.191930045574123,0.2158670705038787
829,0.0875,30,352,30,261374,344236,13123,94833,3.1886694579273036,0.21598655336632738
830,0.0876,34,320,34,261694,343916,13157,94799,3.1857052873392866,0.21608333428307672
831,0.0877,33,336,33,262030,343580,13190,94766,3.182592908221868,0.216189950404475
832,0.0878,34,321,34,262351,343259,13224,94732,3.1796194746007633,0.21628754928754243
833,0.0879,39,321,39,262672,342938,13263,94693,3.176646040979658,0.21637635359469506
834,0.088,34,325,34,262997,342613,13297,94659,3.173635555226203,0.216476243619532
835,0.0881,32,334,32,263331,342279,13329,94627,3.17054170217496,0.21658434537406215
836,0.0882,43,330,43,263661,341949,13372,94584,3.167484901256067,0.21667090460515012
837,0.0883,31,336,31,263997,341613,13403,94553,3.164372522138649,0.21678214257874295
838,0.0884,33,305,33,264302,341308,13436,94520,3.161547297046945,0.2168745468395789
839,0.0885,37,338,37,264640,340970,13473,94483,3.158416391863352,0.2169763441749167
840,0.0886,31,326,31,264966,340644,13504,94452,3.1553966430768092,0.21708312648243147
841,0.0887,36,335,36,265301,340309,13540,94416,3.1522935269924783,0.2171855770889643
842,0.0888,31,335,31,265636,339974,13571,94385,3.149190410908148,0.21729721267430857
843,0.0889,27,336,27,265972,339638,13598,94358,3.1460780317907298,0.2174167503847962
844,0.089,38,320,38,266292,339318,13636,94320,3.1431138612027123,0.21750861317504463
845,0.0891,38,340,38,266632,338978,13674,94282,3.139964429952944,0.2176106725753589
846,0.0892,34,269,34,266901,338709,13708,94248,3.1374726740523915,0.2176844351748557
847,0.0893,41,343,41,267244,338366,13749,94207,3.1342954537033605,0.21778289444787355
848,0.0894,34,305,34,267549,338061,13783,94173,3.1314702286116565,0.21787503990893822
849,0.0895,33,311,33,267860,337750,13816,94140,3.1285894253214273,0.21797216883928777
850,0.0896,29,315,29,268175,337435,13845,94111,3.1256715698988478,0.21807872161947972
851,0.0897,35,350,35,268525,337085,13880,94076,3.122429508318204,0.21819227620308887
852,0.0898,27,346,27,268871,336739,13907,94049,3.11922449886991,0.21831852326434348
853,0.0899,34,322,34,269193,336417,13941,94015,3.1162418022157174,0.21842009887740688
854,0.09,28,332,28,269525,336085,13969,93987,3.1131664752306496,0.21853782622444615
855,0.0901,31,332,31,269857,335753,14000,93956,3.1100911482455817,0.21865029589792162
856,0.0902,31,333,31,270190,335420,14031,93925,3.1070065582274258,0.21876346527850563
857,0.0903,31,333,31,270523,335087,14062,93894,3.1039219682092702,0.218876826712605
858,0.0904,33,309,33,270832,334778,14095,93861,3.1010596909852164,0.21897447502443781
859,0.0905,21,325,21,271157,334453,14116,93840,3.098049205231761,0.21910234348915344
860,0.0906,24,329,24,271486,334124,14140,93816,3.0950016673459557,0.21922699443847268
861,0.0907,24,345,24,271831,333779,14164,93792,3.0918059209307494,0.21936005949889023
862,0.0908,39,323,39,272154,333456,14203,93753,3.0888139612434697,0.21945464632065337
863,0.0909,21,339,21,272493,333117,14224,93732,3.0856737930267886,0.21959053435758313
864,0.091,45,331,45,272824,332786,14269,93687,3.0826077290748084,0.2196786197484952
865,0.0911,35,318,35,273142,332468,14304,93652,3.079662084552966,0.2197784661597672
866,0.0912,28,329,28,273471,332139,14332,93624,3.0766145466671606,0.21989698494232707
867,0.0913,28,336,28,273807,331803,14360,93596,3.0735021675497425,0.22001932303555016
868,0.0914,38,291,38,274098,331512,14398,93558,3.070806624921264,0.22010021878749383
869,0.0915,38,329,38,274427,331183,14436,93520,3.067759087035459,0.22020094042189484
870,0.0916,31,323,31,274750,330860,14467,93489,3.064767127348179,0.22031158315443183
871,0.0917,26,341,26,275091,330519,14493,93463,3.061608433065323,0.22044096211631625
872,0.0918,28,287,28,275378,330232,14521,93435,3.058949942569195,0.22053877219608797
873,0.0919,36,314,36,275692,329918,14557,93399,3.056041350179703,0.22063607178544684
874,0.092,29,314,29,276006,329604,14586,93370,3.0531327577902108,0.2207464288585114
875,0.0921,44,335,44,276341,329269,14630,93326,3.0500296417058803,0.22084028443308606
876,0.0922,35,336,35,276677,328933,14665,93291,3.046917262588462,0.220951438099208
877,0.0923,32,307,32,276984,328626,14697,93259,3.044073511430583,0.22105313059246004
878,0.0924,35,345,35,277329,328281,14732,93224,3.0408777650153764,0.22116938114613113
879,0.0925,36,295,36,277624,327986,14768,93188,3.0381451702545483,0.22125772246150047
880,0.0926,29,317,29,277941,327669,14797,93159,3.0352087887657935,0.2213707262824717
881,0.0927,28,358,28,278299,327311,14825,93131,3.031892622920449,0.22150736605762508
882,0.0928,31,269,31,278568,327042,14856,93100,3.029400867019897,0.22159174755201813
883,0.0929,33,304,33,278872,326738,14889,93067,3.0265849049612807,0.22169102321315848
884,0.093,37,337,37,279209,326401,14926,93030,3.023463262810775,0.22180048685004208
885,0.0931,22,344,22,279553,326057,14948,93008,3.0202767794286562,0.2219417035543412
886,0.0932,23,354,23,279907,325703,14971,92985,3.016997665715662,0.2220866134209722
887,0.0933,45,330,45,280237,325373,15016,92940,3.013940864796769,0.2221781297736384
888,0.0934,28,341,28,280578,325032,15044,92912,3.010782170513913,0.22230729475719235
889,0.0935,26,335,26,280913,324697,15070,92886,3.0076790544295826,0.22243721607440917
890,0.0936,37,306,37,281219,324391,15107,92849,3.004844566304791,0.22253139679800593
891,0.0937,40,317,40,281536,324074,15147,92809,3.001908184816036,0.22262601257427145
892,0.0938,47,292,47,281828,323782,15194,92762,2.9992033791544706,0.22269436121994315
893,0.0939,43,289,43,282117,323493,15237,92719,2.996526362592167,0.22276868518927853
894,0.094,36,314,36,282431,323179,15273,92683,2.993617770202675,0.22286960578268752
895,0.0941,25,306,25,282737,322873,15298,92658,2.9907832820778837,0.22298697329441125
896,0.0942,24,322,24,283059,322551,15322,92634,2.9878005854236913,0.2231149969290798
897,0.0943,32,322,32,283381,322229,15354,92602,2.9848178887694985,0.22322825439757396
898,0.0944,35,310,35,283691,321919,15389,92567,2.981946348512357,0.22332961788817957
899,0.0945,23,280,23,283971,321639,15412,92544,2.979352699247842,0.22343746604761663
900,0.0946,28,314,28,284285,321325,15440,92516,2.9764441068583496,0.22355445690494657
901,0.0947,27,283,27,284568,321042,15467,92489,2.973822668494572,0.22365675124718581
902,0.0948,34,302,34,284870,320740,15501,92455,2.9710252325021305,0.22375633780660462
903,0.0949,48,295,48,285165,320445,15549,92407,2.968292637741302,0.22382597153459352
904,0.095,38,296,38,285461,320149,15587,92369,2.965550779947386,0.2239150776450967
905,0.0951,30,292,30,285753,319857,15617,92339,2.96284597428582,0.22401721511125774
906,0.0952,27,315,27,286068,319542,15644,92312,2.9599281188632407,0.2241376798574252
907,0.0953,28,280,28,286348,319262,15672,92284,2.9573344695987256,0.22423738780112065
908,0.0954,36,321,36,286669,318941,15708,92248,2.9543610359776205,0.224344522834998
909,0.0955,37,282,37,286951,318659,15745,92211,2.9517488606469304,0.2244286513982525
910,0.0956,31,289,31,287240,318370,15776,92180,2.949071844084627,0.22452807209840459
911,0.0957,35,272,35,287512,318098,15811,92145,2.9465522990848125,0.22461077946485375
912,0.0958,30,337,30,287849,317761,15841,92115,2.9434306569343067,0.22473870146092964
913,0.0959,41,313,41,288162,317448,15882,92074,2.940531327577902,0.22483285391261032
914,0.096,26,317,26,288479,317131,15908,92048,2.9375949460891473,0.22495778131331276
915,0.0961,39,322,39,288801,316809,15947,92009,2.934612249434955,0.22506102960241475
916,0.0962,43,337,43,289138,316472,15990,91966,2.931490607284449,0.2251651413433618
917,0.0963,52,331,52,289469,316141,16042,91914,2.928424543332469,0.22524904730979892
918,0.0964,28,310,28,289779,315831,16070,91886,2.925553003075327,0.22536710512438776
919,0.0965,38,324,38,290103,315507,16108,91848,2.922551780354959,0.2254740950767758
920,0.0966,29,270,29,290373,315237,16137,91819,2.9200507614213196,0.22556847215125192
921,0.0967,26,298,26,290671,314939,16163,91793,2.9172903775612284,0.22568423433612306
922,0.0968,27,335,27,291006,314604,16190,91766,2.914187261476898,0.2258188350518001
923,0.0969,34,281,34,291287,314323,16224,91732,2.911584349179295,0.2259102830897292
924,0.097,26,293,26,291580,314030,16250,91706,2.908870280484642,0.22602381844351993
925,0.0971,26,273,26,291853,313757,16276,91680,2.90634147245174,0.22612637721766884
926,0.0972,40,333,40,292186,313424,16316,91640,2.9032568824335843,0.22623585408725536
927,0.0973,38,317,38,292503,313107,16354,91602,2.9003205009448294,0.22634040755209298
928,0.0974,35,328,35,292831,312779,16389,91567,2.8972822260921114,0.22645704421460827
929,0.0975,31,289,31,293120,312490,16420,91536,2.8946052095298085,0.2265596768524798
930,0.0976,37,298,37,293418,312192,16457,91499,2.8918448256697173,0.22665603146961413
931,0.0977,36,307,36,293725,311885,16493,91463,2.889001074511838,0.22675952279421244
932,0.0978,25,302,25,294027,311583,16518,91438,2.886203638519397,0.22688147764012298
933,0.0979,41,318,41,294345,311265,16559,91397,2.8832579939975544,0.22698193522110355
934,0.098,28,269,28,294614,310996,16587,91369,2.8807662380970025,0.22707989014949112
935,0.0981,27,284,27,294898,310712,16614,91342,2.878135536700137,0.2271883876295224
936,0.0982,28,291,28,295189,310421,16642,91314,2.875439994071659,0.22729909019627367
937,0.0983,37,325,37,295514,310096,16679,91277,2.872429508318204,0.22741190862364932
938,0.0984,34,286,34,295800,309810,16713,91243,2.869780280855163,0.22750858365353208
939,0.0985,38,281,38,296081,309529,16751,91205,2.8671773685575603,0.227594863425614
940,0.0986,38,312,38,296393,309217,16789,91167,2.8642873022342434,0.22769890904731457
941,0.0987,32,327,32,296720,308890,16821,91135,2.8612582904146135,0.2278232610461846
942,0.0988,32,297,32,297017,308593,16853,91103,2.8585071695876096,0.22793072735278813
943,0.0989,33,331,33,297348,308262,16886,91070,2.8554411056356295,0.2280558532749692
944,0.099,33,278,33,297626,307984,16919,91037,2.8528659824372893,0.22815089932610064
945,0.0991,40,290,40,297916,307694,16959,90997,2.8501797028418987,0.22823941348061533
946,0.0992,31,309,31,298225,307385,16990,90966,2.8473174256178444,0.22835639925593257
947,0.0993,38,319,38,298544,307066,17028,90928,2.8443625180629146,0.2284657557651623
948,0.0994,37,282,37,298826,306784,17065,90891,2.841750342732224,0.22855598164330168
949,0.0995,27,332,27,299158,306452,17092,90864,2.8386750157471563,0.22869454036585488
950,0.0996,34,300,34,299458,306152,17126,90830,2.83589610582089,0.22880130585265832
951,0.0997,29,290,29,299748,305862,17155,90801,2.833209826225499,0.22891220002873977
952,0.0998,42,270,42,300018,305592,17197,90759,2.8307088072918596,0.22898642869577723
953,0.0999,26,274,26,300292,305318,17223,90733,2.8281707362258697,0.2290942328134508
954,0.1,27,283,27,300575,305035,17250,90706,2.825549297862092,0.2292054651906171
955,0.1001,34,300,34,300875,304735,17284,90672,2.822770387935826,0.22931308752753493
956,0.1002,29,307,29,301182,304428,17313,90643,2.8199266367779465,0.22943470920416836
957,0.1003,26,293,26,301475,304135,17339,90617,2.8172125680832933,0.2295542517833982
958,0.1004,36,302,36,301777,303833,17375,90581,2.814415132090852,0.22965969767807431
959,0.1005,28,300,28,302077,303533,17403,90553,2.8116362221645854,0.2297797942581061
960,0.1006,26,283,26,302360,303250,17429,90527,2.8090147838008077,0.2298940771045541
961,0.1007,37,260,37,302620,302990,17466,90490,2.8066063951980436,0.2299735691775948
962,0.1008,29,294,29,302914,302696,17495,90461,2.8038830634703027,0.2300887431738466
963,0.1009,38,303,38,303217,302393,17533,90423,2.8010763644447736,0.2301917437171602
964,0.101,22,304,22,303521,302089,17555,90401,2.7982604023861573,0.23032688730923082
965,0.1011,26,250,26,303771,301839,17581,90375,2.7959446441142686,0.2304226774159005
966,0.1012,33,307,33,304078,301532,17614,90342,2.7931008929563896,0.23053838733878745
967,0.1013,30,258,30,304336,301274,17644,90312,2.790711030419801,0.23063133002712047
968,0.1014,34,301,34,304637,300973,17678,90278,2.7879228574604467,0.23074190225711882
969,0.1015,43,287,43,304924,300686,17721,90235,2.7852643669643187,0.2308266887683189
970,0.1016,35,313,35,305237,300373,17756,90200,2.7823650376079145,0.2309427430979612
971,0.1017,35,302,35,305539,300071,17791,90165,2.779567601615473,0.23105249131294908
972,0.1018,23,312,23,305851,299759,17814,90142,2.776677535292156,0.23119202053854696
973,0.1019,40,306,40,306157,299453,17854,90102,2.7738430471673645,0.23129468239401368
974,0.102,30,276,30,306433,299177,17884,90072,2.7712864500351997,0.23139943840575056
975,0.1021,32,290,32,306723,298887,17916,90040,2.7686001704398087,0.2315087407148385
976,0.1022,44,314,44,307037,298573,17960,89996,2.765691578050317,0.23160880049617957
977,0.1023,32,286,32,307323,298287,17992,89964,2.763042350587276,0.2317160805767403
978,0.1024,34,278,34,307601,298009,18026,89930,2.7604672273889364,0.2318147956250854
979,0.1025,33,284,33,307885,297725,18059,89897,2.757836525992071,0.23191924090995866
980,0.1026,35,278,35,308163,297447,18094,89862,2.7552614027937308,0.23201629706513405
981,0.1027,33,295,33,308458,297152,18127,89829,2.7525288080329022,0.23212767551895314
982,0.1028,33,284,33,308742,296868,18160,89796,2.749898106636037,0.23223263608714542
983,0.1029,39,266,39,309008,296602,18199,89757,2.7474341398347475,0.23231502307439453
984,0.103,33,289,33,309297,296313,18232,89724,2.744757123272444,0.23242331693594137
985,0.1031,41,288,41,309585,296025,18273,89683,2.742089369743229,0.23251527061922492
986,0.1032,27,272,27,309857,295753,18300,89656,2.739569824743414,0.23262560033626614
987,0.1033,35,273,35,310130,295480,18335,89621,2.7370410167105117,0.23272076675988895
988,0.1034,50,294,50,310424,295186,18385,89571,2.734317684982771,0.2327988834511133
989,0.1035,33,274,33,310698,294912,18418,89538,2.731779613916781,0.2328989465470152
990,0.1036,40,318,40,311016,294594,18458,89498,2.728833969394939,0.233011882569801
991,0.1037,46,270,46,311286,294324,18504,89452,2.726332950461299,0.23308388226465437
992,0.1038,31,294,31,311580,294030,18535,89421,2.7236096187335583,0.23320059147061814
993,0.1039,36,276,36,311856,293754,18571,89385,2.721053021601393,0.23329653206799622
994,0.104,33,286,33,312142,293468,18604,89352,2.7184037941383528,0.23340473329502115
995,0.1041,30,311,30,312453,293157,18634,89322,2.715522990848123,0.23353439012337932
996,0.1042,34,297,34,312750,292860,18668,89288,2.7127718700211196,0.23364769670389482
997,0.1043,29,283,29,313033,292577,18697,89259,2.710150431657342,0.23376266250432123
998,0.1044,31,257,31,313290,292320,18728,89228,2.7077698321538404,0.2338578632308386
999,0.1045,36,287,36,313577,292033,18764,89192,2.7051113416577124,0.23396157125057382
1000,0.1046,43,275,43,313852,291758,18807,89149,2.702564007558635,0.23404400549215426
1001,0.1047,35,269,35,314121,291489,18842,89114,2.700072251658083,0.234138984716358
1002,0.1048,24,250,24,314371,291239,18866,89090,2.697756493386194,0.23424456194505283
1003,0.1049,33,283,33,314654,290956,18899,89057,2.6951350550224165,0.23435250899311338
1004,0.105,41,286,41,314940,290670,18940,89016,2.692485827559376,0.2344463583066007
1005,0.1051,37,319,37,315259,290351,18977,88979,2.6895309200044464,0.23456884506893733
1006,0.1052,42,281,42,315540,290070,19019,88937,2.6869280077068436,0.23465793507771623
1007,0.1053,35,298,35,315838,289772,19054,88902,2.6841676238467524,0.23477186181253532
1008,0.1054,28,252,28,316090,289520,19082,88874,2.681833339508689,0.23487158887297369
1009,0.1055,36,303,36,316393,289217,19118,88838,2.6790266404831597,0.2349869727949637
1010,0.1056,40,271,40,316664,288946,19158,88798,2.6765163585164324,0.2350745478419247
1011,0.1057,43,301,43,316965,288645,19201,88755,2.6737281855570787,0.23517488076311605
1012,0.1058,31,292,31,317257,288353,19232,88724,2.671023379895513,0.23529411764705882
1013,0.1059,28,273,28,317530,288080,19260,88696,2.6684945718626105,0.23540777544217253
1014,0.106,41,266,41,317796,287814,19301,88655,2.666030605061321,0.23549083722696956
1015,0.1061,29,277,29,318073,287537,19330,88626,2.6634647448960687,0.23560530940044608
1016,0.1062,33,270,33,318343,287267,19363,88593,2.660963725962429,0.23570744426116108
1017,0.1063,28,285,28,318628,286982,19391,88565,2.6583237615324764,0.2358293369405161
1018,0.1064,28,258,28,318886,286724,19419,88537,2.655933898995887,0.23593445628509224
1019,0.1065,42,271,42,319157,286453,19461,88495,2.65342361702916,0.23601939468939692
1020,0.1066,35,290,35,319447,286163,19496,88460,2.6507373374337693,0.2361307234206122
1021,0.1067,23,270,23,319717,285893,19519,88437,2.6482363185001296,0.23625410733844468
1022,0.1068,35,280,35,319997,285613,19554,88402,2.6456426692356145,0.23635950429795596
1023,0.1069,38,267,38,320264,285346,19592,88364,2.6431694394012375,0.23645072382328544
1024,0.107,30,295,30,320559,285051,19622,88334,2.640436844640409,0.23657618811682313
1025,0.1071,47,304,47,320863,284747,19669,88287,2.6376208825817926,0.23667279658154486
1026,0.1072,38,308,38,321171,284439,19707,88249,2.634767868390826,0.23679055939552654
1027,0.1073,35,276,35,321447,284163,19742,88214,2.6322112712586607,0.23689433020836412
1028,0.1074,32,299,32,321746,283864,19774,88182,2.6294416243654823,0.2370190782860184
1029,0.1075,38,234,38,321980,283630,19812,88144,2.6272740746229943,0.2370902752747637
1030,0.1076,33,277,33,322257,283353,19845,88111,2.624708214457742,0.23719929791312214
1031,0.1077,30,255,30,322512,283098,19875,88081,2.6223461410204156,0.2373006015965343
1032,0.1078,32,292,32,322804,282806,19907,88049,2.6196413353588497,0.23742163379218292
1033,0.1079,34,272,34,323076,282534,19941,88015,2.617121790359035,0.23752594123854065
1034,0.108,33,262,33,323338,282272,19974,87982,2.614694875690096,0.23762606210871456
1035,0.1081,31,303,31,323641,281969,20005,87951,2.611888176664567,0.23775681228373702
1036,0.1082,43,265,43,323906,281704,20048,87908,2.6094334728963653,0.23783859831390755
1037,0.1083,42,265,42,324171,281439,20090,87866,2.606978769128163,0.23792258431377858
1038,0.1084,32,245,32,324416,281194,20122,87834,2.6047093260217125,0.23801445960740106
1039,0.1085,29,295,29,324711,280899,20151,87805,2.601976731260884,0.2381449618121854
1040,0.1086,35,269,35,324980,280630,20186,87770,2.599484975360332,0.23824647122692724
1041,0.1087,32,247,32,325227,280383,20218,87738,2.597197006187706,0.2383401109961127
1042,0.1088,41,275,41,325502,280108,20259,87697,2.5946496720886287,0.23843340900749038
1043,0.1089,33,309,33,325811,279799,20292,87664,2.5917873948645744,0.2385655154396497
1044,0.109,53,258,53,326069,279541,20345,87611,2.5893975323279856,0.23862324051074216
1045,0.1091,31,303,31,326372,279238,20376,87580,2.5865908333024565,0.23875600434002694
1046,0.1092,36,300,36,326672,278938,20412,87544,2.5838119233761905,0.23887667061410928
1047,0.1093,41,245,41,326917,278693,20453,87503,2.5815424802697393,0.23895127199641722
1048,0.1094,37,263,37,327180,278430,20490,87466,2.5791063025677126,0.23904606773509413
1049,0.1095,37,304,37,327484,278126,20527,87429,2.576290340509096,0.23916784068060895
1050,0.1096,43,282,43,327766,277844,20570,87386,2.573678165178406,0.23926293020836184
1051,0.1097,39,313,39,328079,277531,20609,87347,2.5707788358220016,0.23938686355439354
1052,0.1098,36,279,36,328358,277252,20645,87311,2.5681944495905737,0.2394949569758862
1053,0.1099,31,264,31,328622,276988,20676,87280,2.5657490088554598,0.23960380818518234
1054,0.11,34,262,34,328884,276726,20710,87246,2.5633220941865202,0.23970525205235568
1055,0.1101,26,298,26,329182,276428,20736,87220,2.560561710326429,0.23984732488560367
1056,0.1102,33,266,33,329448,276162,20769,87187,2.5580977435251397,0.23995387354857176
1057,0.1103,38,273,38,329721,275889,20807,87149,2.5555689354922375,0.2400547601077573
1058,0.1104,29,251,29,329972,275638,20836,87120,2.5532439141872616,0.24016010673782523
1059,0.1105,31,308,31,330280,275330,20867,87089,2.550390899996295,0.24029921168592155
1060,0.1106,34,261,34,330541,275069,20901,87055,2.547973248360443,0.24040107808375033
1061,0.1107,35,261,35,330802,274808,20936,87020,2.5455555967245913,0.24050101153034037
1062,0.1108,29,263,29,331065,274545,20965,86991,2.5431194190225646,0.24061504248539564
1063,0.1109,40,268,40,331333,274277,21005,86951,2.5406369261551003,0.2407094688119415
1064,0.111,28,258,28,331591,274019,21033,86923,2.538247063618511,0.2408226252417286
1065,0.1111,38,292,38,331883,273727,21071,86885,2.5355422579569455,0.2409376282541901
1066,0.1112,45,279,45,332162,273448,21116,86840,2.5329578717255177,0.24102939870325962
1067,0.1113,33,263,33,332425,273185,21149,86807,2.530521694023491,0.24113591413142516
1068,0.1114,37,243,37,332668,272942,21186,86770,2.5282707769832156,0.2412207543812828
1069,0.1115,29,265,29,332933,272677,21215,86741,2.5258160732150134,0.241337384326884
1070,0.1116,36,270,36,333203,272407,21251,86705,2.523315054281374,0.24144278108222506
1071,0.1117,32,270,32,333473,272137,21283,86673,2.520814035347734,0.2415568127978596
1072,0.1118,30,269,30,333742,271868,21313,86643,2.5183222794471822,0.2416745929692534
1073,0.1119,23,251,23,333993,271617,21336,86620,2.515997258142206,0.24179523611463918
1074,0.112,39,269,39,334262,271348,21375,86581,2.513505502241654,0.24189434217400657
1075,0.1121,42,262,42,334524,271086,21417,86539,2.511078587572715,0.24198252359314926
1076,0.1122,44,281,44,334805,270805,21461,86495,2.508475675275112,0.2420794850265883
1077,0.1123,31,245,31,335050,270560,21492,86464,2.5062062321686613,0.2421797974365869
1078,0.1124,20,251,20,335301,270309,21512,86444,2.5038812108636854,0.24230770308869162
1079,0.1125,39,223,39,335524,270086,21551,86405,2.5018155544851606,0.24237638537859302
1080,0.1126,40,281,40,335805,269805,21591,86365,2.499212642187558,0.24248252239099308
1081,0.1127,48,285,48,336090,269520,21639,86317,2.496572677757605,0.24257454958309563
1082,0.1128,44,273,44,336363,269247,21683,86273,2.4940438697247025,0.2426670792079208
1083,0.1129,28,273,28,336636,268974,21711,86245,2.4915150616918003,0.24279388208401015
1084,0.113,34,259,34,336895,268715,21745,86211,2.489115936122124,0.24289851969142864
1085,0.1131,45,280,45,337175,268435,21790,86166,2.4865222868576087,0.24299423859492783
1086,0.1132,34,254,34,337429,268181,21824,86132,2.4841694764533697,0.2430957938320073
1087,0.1133,34,279,34,337708,267902,21858,86098,2.4815850902219423,0.24321468926553672
1088,0.1134,33,240,33,337948,267662,21891,86065,2.479361962280929,0.24330910560969335
1089,0.1135,30,272,30,338220,267390,21921,86035,2.4768424172811145,0.24343212845723985
1090,0.1136,33,264,33,338484,267126,21954,86002,2.474396976546,0.24354341768423915
1091,0.1137,38,248,38,338732,266878,21992,85964,2.472099744340287,0.2436331275755154
1092,0.1138,22,255,22,338987,266623,22014,85942,2.4697376709029606,0.24376214315090836
1093,0.1139,33,248,33,339235,266375,22047,85909,2.467440438697247,0.2438629060644253
1094,0.114,35,257,35,339492,266118,22082,85874,2.4650598391937457,0.24396577194936248
1095,0.1141,37,258,37,339750,265860,22119,85837,2.4626699766571565,0.24406520385445427
1096,0.1142,31,280,31,340030,265580,22150,85806,2.4600763273926414,0.24419299573688194
1097,0.1143,31,248,31,340278,265332,22181,85775,2.457779095186928,0.24429874653595626
1098,0.1144,42,256,42,340534,265076,22223,85733,2.455407758716514,0.2443865465253172
1099,0.1145,39,257,39,340791,264819,22262,85694,2.4530271592130126,0.24448165973872582
1100,0.1146,33,223,33,341014,264596,22295,85661,2.450961502834488,0.2445661328681511
1101,0.1147,38,279,38,341293,264317,22333,85623,2.4483771166030603,0.24467908784363035
1102,0.1148,36,263,36,341556,264054,22369,85587,2.4459409389010336,0.2447853655606751
1103,0.1149,32,269,32,341825,263785,22401,85555,2.4434491830004816,0.24490467739165284
1104,0.115,40,251,40,342076,263534,22441,85515,2.4411241616955057,0.244994255820816
1105,0.1151,34,270,34,342346,263264,22475,85481,2.438623142761866,0.2451103241623536
1106,0.1152,40,266,40,342612,262998,22515,85441,2.4361591759605767,0.24521078294909582
1107,0.1153,44,272,44,342884,262726,22559,85397,2.4336396309607617,0.24530697483360767
1108,0.1154,28,265,28,343149,262461,22587,85369,2.43118492719256,0.24543311387746888
1109,0.1155,38,275,38,343424,262186,22625,85331,2.4286375930934825,0.24554482226768762
1110,0.1156,26,286,26,343710,261900,22651,85305,2.425988365630442,0.24569058625307816
1111,0.1157,31,255,31,343965,261645,22682,85274,2.4236262921931155,0.24580377552108706
1112,0.1158,34,218,34,344183,261427,22716,85240,2.421606950980029,0.24588437895732793
1113,0.1159,31,223,31,344406,261204,22747,85209,2.4195412946015042,0.2459751799153034
1114,0.116,36,257,36,344663,260947,22783,85173,2.4171606950980027,0.24607939442967758
1115,0.1161,32,248,32,344911,260699,22815,85141,2.4148634628922894,0.24618609761739532
1116,0.1162,32,244,32,345155,260455,22847,85109,2.4126032828189263,0.246290122813719
1117,0.1163,35,253,35,345408,260202,22882,85074,2.410259735447775,0.2463941889966288
1118,0.1164,36,240,36,345648,259962,22918,85038,2.408036607506762,0.24648695652173913
1119,0.1165,34,266,34,345914,259696,22952,85004,2.4055726407054725,0.24660284305192923
1120,0.1166,43,245,43,346159,259451,22995,84961,2.403303197599022,0.24668420380242267
1121,0.1167,22,225,22,346384,259226,23017,84939,2.401219015154322,0.24679732105240218
1122,0.1168,47,227,47,346611,258999,23064,84892,2.3991163066434473,0.24685728908287802
1123,0.1169,42,233,42,346844,258766,23106,84850,2.396958019934047,0.24693262246228348
1124,0.117,39,231,39,347075,258535,23145,84811,2.394818259290822,0.24701321698811113
1125,0.1171,27,252,27,347327,258283,23172,84784,2.3924839749527584,0.24713539920773495
1126,0.1172,33,259,33,347586,258024,23205,84751,2.390084849383082,0.24724965356283277
1127,0.1173,30,234,30,347820,257790,23235,84721,2.3879172996405944,0.2473526397692337
1128,0.1174,36,251,36,348071,257539,23271,84685,2.385592278335618,0.24745488335125532
1129,0.1175,36,257,36,348328,257282,23307,84649,2.383211678832117,0.24756164255361462
1130,0.1176,37,259,37,348587,257023,23344,84612,2.3808125532624405,0.24766783262838996
1131,0.1177,44,239,44,348826,256784,23388,84568,2.378598688354515,0.2477442639855633
1132,0.1178,31,261,31,349087,256523,23419,84537,2.376181036718663,0.24786547821497684
1133,0.1179,43,252,43,349339,256271,23462,84494,2.3738467523805995,0.2479538685017534
1134,0.118,40,214,40,349553,256057,23502,84454,2.371864463299863,0.24802135613827453
1135,0.1181,50,230,50,349783,255827,23552,84404,2.3697339656897256,0.24807851136433776
1136,0.1182,32,259,32,350042,255568,23584,84372,2.3673348401200487,0.24819674060128258
1137,0.1183,31,215,31,350257,255353,23615,84341,2.365343288006225,0.24828522140514697
1138,0.1184,32,264,32,350521,255089,23647,84309,2.3628978472711104,0.248407474410574
1139,0.1185,38,264,38,350785,254825,23685,84271,2.360452406535996,0.24851664425413453
1140,0.1186,31,219,31,351004,254606,23716,84240,2.358423802289822,0.24860851242157203
1141,0.1187,36,262,36,351266,254344,23752,84204,2.3559968876208828,0.24872100854236326
1142,0.1188,36,270,36,351536,254074,23788,84168,2.353495868687243,0.24883958822381608
1143,0.1189,40,240,40,351776,253834,23828,84128,2.35127274074623,0.2489273942040821
1144,0.119,42,223,42,351999,253611,23870,84086,2.3492070843677055,0.24899836243733287
1145,0.1191,36,290,36,352289,253321,23906,84050,2.3465208047723145,0.24913226092343443
1146,0.1192,34,251,34,352540,253070,23940,84016,2.3441957834673386,0.2492420331903431
1147,0.1193,31,233,31,352773,252837,23971,83985,2.3420374967579383,0.24934535155067067
1148,0.1194,30,263,30,353036,252574,24001,83955,2.3396013190559115,0.2494732994779053
1149,0.1195,33,268,33,353304,252306,24034,83922,2.3371188261884472,0.24959848674113994
1150,0.1196,30,244,30,353548,252062,24064,83892,2.3348586461150838,0.2497127582942903
1151,0.1197,39,244,39,353792,251818,24103,83853,2.3325984660417207,0.24980710278814672
1152,0.1198,52,224,52,354016,251594,24155,83801,2.3305235466301086,0.24985763055501722
1153,0.1199,32,251,32,354267,251343,24187,83769,2.3281985253251323,0.24997314330731218
1154,0.12,29,235,29,354502,251108,24216,83740,2.326021712549557,0.25008362003058104
1155,0.1201,43,233,43,354735,250875,24259,83697,2.323863425840157,0.25016140023672034
1156,0.1202,34,211,34,354946,250664,24293,83663,2.321908925858683,0.2502430255408627
1157,0.1203,29,238,29,355184,250426,24322,83634,2.3197043239838453,0.25035622343291625
1158,0.1204,37,217,37,355401,250209,24359,83597,2.317694245803846,0.2504358819194382
1159,0.1205,43,236,43,355637,249973,24402,83554,2.315508169995183,0.2505164499425834
1160,0.1206,31,275,31,355912,249698,24433,83523,2.312960835896106,0.25065347021946394
1161,0.1207,26,274,26,356186,249424,24459,83497,2.310422764830116,0.25080124113528435
1162,0.1208,29,247,29,356433,249177,24488,83468,2.30813479565749,0.2509221542485232
1163,0.1209,31,269,31,356702,248908,24519,83437,2.305643039756938,0.251055379199326
1164,0.121,33,217,33,356919,248691,24552,83404,2.303632961576939,0.2511450036887035
1165,0.1211,34,220,34,357139,248471,24586,83370,2.3015950942976766,0.2512347781015607
1166,0.1212,36,247,36,357386,248224,24622,83334,2.299307125125051,0.2513406402499713
1167,0.1213,39,224,39,357610,248000,24661,83295,2.297232205713439,0.25142244827117827
1168,0.1214,24,254,24,357864,247746,24685,83271,2.2948793953092,0.2515610980704919
1169,0.1215,34,271,34,358135,247475,24719,83237,2.292369113342473,0.2516902924599047
1170,0.1216,31,246,31,358381,247229,24750,83206,2.2900904072029347,0.25180746591614084
1171,0.1217,35,246,35,358627,246983,24785,83171,2.2878117010633963,0.25191577263943493
1172,0.1218,33,255,33,358882,246728,24818,83138,2.28544962762607,0.25203567509231023
1173,0.1219,25,203,25,359085,246525,24843,83113,2.283569231909296,0.2521341592898877
1174,0.122,41,237,41,359322,246288,24884,83072,2.281373893067546,0.25222249210590236
1175,0.1221,31,224,31,359546,246064,24915,83041,2.279298973655934,0.25232372647027546
1176,0.1222,33,225,33,359771,245839,24948,83008,2.277214791211234,0.25242133879889433
1177,0.1223,26,232,26,360003,245607,24974,82982,2.2750657675349215,0.25254040762167934
1178,0.1224,33,219,33,360222,245388,25007,82949,2.2730371632887474,0.25263372693299874
1179,0.1225,17,243,17,360465,245145,25024,82932,2.2707862462484716,0.2527821212703115
1180,0.1226,38,247,38,360712,244898,25062,82894,2.2684982770758455,0.25288597647288524
1181,0.1227,30,238,30,360950,244660,25092,82864,2.2662936752010077,0.25300130677446536
1182,0.1228,27,252,27,361202,244408,25119,82837,2.263959390862944,0.2531345016730584
1183,0.1229,32,249,32,361451,244159,25151,82805,2.261652895624143,0.25325418088841584
1184,0.123,42,244,42,361695,243915,25193,82763,2.25939271555078,0.2533473328476359
1185,0.1231,36,243,36,361938,243672,25229,82727,2.2571417985105042,0.253453595139691
1186,0.1232,30,264,30,362202,243408,25259,82697,2.25469635777539,0.2535901013477254
1187,0.1233,37,231,37,362433,243177,25296,82660,2.252556597132165,0.25368512477097444
1188,0.1234,28,228,28,362661,242949,25324,82632,2.2504446255882025,0.25379859389829257
1189,0.1235,36,243,36,362904,242706,25360,82596,2.248193708547927,0.2539056015640851
1190,0.1236,35,237,35,363141,242469,25395,82561,2.2459983697061765,0.2540103990400886
1191,0.1237,32,254,32,363395,242215,25427,82529,2.243645559301938,0.25413556524523934
1192,0.1238,45,259,45,363654,241956,25472,82484,2.2412464337322615,0.2542349895204044
1193,0.1239,33,217,33,363871,241739,25505,82451,2.239236355552262,0.25432925136494033
1194,0.124,32,260,32,364131,241479,25537,82419,2.236827966949498,0.25445973732471333
1195,0.1241,44,209,44,364340,241270,25581,82375,2.234891993034199,0.25452270234361724
1196,0.1242,37,207,37,364547,241063,25618,82338,2.2329745451850753,0.25460032591117526
1197,0.1243,32,238,32,364785,240825,25650,82306,2.2307699433102375,0.25471403238934054
1198,0.1244,33,230,33,365015,240595,25683,82273,2.2286394457001,0.25481930696135885
1199,0.1245,35,223,35,365238,240372,25718,82238,2.2265737893215753,0.2549146027711478
1200,0.1246,30,204,30,365442,240168,25748,82208,2.224684130571714,0.25500657617192346
1201,0.1247,31,215,31,365657,239953,25779,82177,2.2226925784578904,0.2551050817992736
1202,0.1248,32,247,32,365904,239706,25811,82145,2.2204046092852643,0.25522679749325
1203,0.1249,28,246,28,366150,239460,25839,82117,2.218125903145726,0.2553571928340646
1204,0.125,45,232,45,366382,239228,25884,82072,2.2159768794694137,0.2554372860255213
1205,0.1251,29,215,29,366597,239013,25913,82043,2.2139853273555894,0.2555410894049636
1206,0.1252,37,208,37,366805,238805,25950,82006,2.212058616473378,0.25562091075430704
1207,0.1253,33,226,33,367031,238579,25983,81973,2.209965170995591,0.25572450023709103
1208,0.1254,32,217,32,367248,238362,26015,81941,2.2079550928155913,0.2558233922254865
1209,0.1255,43,249,43,367497,238113,26058,81898,2.2056485975767903,0.25592245266568964
1210,0.1256,28,230,28,367727,237883,26086,81870,2.203518099966653,0.25604138194168624
1211,0.1257,40,228,40,367955,237655,26126,81830,2.2014061284226907,0.25613096076498115
1212,0.1258,33,228,33,368183,237427,26159,81797,2.1992941568787283,0.2562369997243315
1213,0.1259,34,230,34,368413,237197,26193,81763,2.197163659268591,0.2563424880862804
1214,0.126,41,231,41,368644,236966,26234,81722,2.195023898625366,0.2564326237574054
1215,0.1261,40,214,40,368858,236752,26274,81682,2.1930416095446295,0.2565115534145223
1216,0.1262,24,218,24,369076,236534,26298,81658,2.1910222683315426,0.25663121637250463
1217,0.1263,29,234,29,369310,236300,26327,81629,2.188854718589055,0.2567522937511205
1218,0.1264,32,232,32,369542,236068,26359,81597,2.1867056949127424,0.25686493633229973
1219,0.1265,41,238,41,369780,235830,26400,81556,2.1845010930379045,0.25696155469995524
1220,0.1266,38,227,38,370007,235603,26438,81518,2.1823983845270294,0.25705645479170414
1221,0.1267,23,230,23,370237,235373,26461,81495,2.180267886916892,0.25718911344787104
1222,0.1268,38,205,38,370442,235168,26499,81457,2.1783689651339433,0.2572664824318989
1223,0.1269,30,236,30,370678,234932,26529,81427,2.176182889325281,0.25738796746733933
1224,0.127,31,239,31,370917,234693,26560,81396,2.1739690244173553,0.2575097520002278
1225,0.1271,37,242,37,371159,234451,26597,81359,2.171727370410167,0.25762008802761155
1226,0.1272,51,222,51,371381,234229,26648,81308,2.16967097706473,0.2576813495723164
1227,0.1273,42,223,42,371604,234006,26690,81266,2.1676053206862056,0.2577647237940572
1228,0.1274,26,191,26,371795,233815,26716,81240,2.1658360813664825,0.2578597387757693
1229,0.1275,30,249,30,372044,233566,26746,81210,2.1635295861276815,0.25799298548809313
1230,0.1276,41,264,41,372308,233302,26787,81169,2.1610841453925675,0.2581128307538692
1231,0.1277,39,215,39,372523,233087,26826,81130,2.1590925932787433,0.2581973604228925
1232,0.1278,30,209,30,372732,232878,26856,81100,2.157156619363444,0.2582983521138424
1233,0.1279,30,207,30,372939,232671,26886,81070,2.1552391715143204,0.25839785045626806
1234,0.128,37,242,37,373181,232429,26923,81033,2.1529975175071328,0.2585098034211483
1235,0.1281,42,226,42,373407,232203,26965,80991,2.1509040720293453,0.25859690798674306
1236,0.1282,33,229,33,373636,231974,26998,80958,2.1487828374522953,0.25870796211317476
1237,0.1283,36,226,36,373862,231748,27034,80922,2.1466893919745083,0.25880960757348004
1238,0.1284,31,244,31,374106,231504,27065,80891,2.1444292119011448,0.2589382032362874
1239,0.1285,30,251,30,374357,231253,27095,80861,2.142104190596169,0.2590752096990202
1240,0.1286,27,230,27,374587,231023,27122,80834,2.139973692986031,0.2592021343115595
1241,0.1287,48,236,48,374823,230787,27170,80786,2.1377876171773686,0.2592843410693481
1242,0.1288,21,235,21,375058,230552,27191,80765,2.1356108044017934,0.25943009858118893
1243,0.1289,43,231,43,375289,230321,27234,80722,2.1334710437585684,0.2595203878563414
1244,0.129,32,218,32,375507,230103,27266,80690,2.1314517025454816,0.25962618205686744
1245,0.1291,36,220,36,375727,229883,27302,80654,2.1294138352662197,0.2597242840627687
1246,0.1292,30,228,30,375955,229655,27332,80624,2.1273018637222574,0.2598435601507031
1247,0.1293,33,230,33,376185,229425,27365,80591,2.1251713661121197,0.25995755057803466
1248,0.1294,28,200,28,376385,229225,27393,80563,2.123318759494609,0.26005849161361966
1249,0.1295,34,230,34,376615,228995,27427,80529,2.1211882618844715,0.2601704552797198
1250,0.1296,40,210,40,376825,228785,27467,80489,2.119243024936085,0.26025142753674735
1251,0.1297,37,242,37,377067,228543,27504,80452,2.117001370928897,0.2603666725998803
1252,0.1298,37,198,37,377265,228345,27541,80415,2.115167290377561,0.2604450058297707
1253,0.1299,30,221,30,377486,228124,27571,80385,2.1131201600652116,0.2605596595237092
1254,0.13,27,198,27,377684,227926,27598,80358,2.111286079513876,0.26066224649998054
1255,0.1301,36,243,36,377927,227683,27634,80322,2.1090351624736003,0.26078148082011654
1256,0.1302,34,205,34,378132,227478,27668,80288,2.1071362406906515,0.2608735207917704
1257,0.1303,39,221,39,378353,227257,27707,80249,2.1050891103783025,0.26096726567936884
1258,0.1304,24,199,24,378552,227058,27731,80225,2.103245766793879,0.2610785497407927
1259,0.1305,33,215,33,378767,226843,27764,80192,2.101254214680055,0.26118194994056054
1260,0.1306,26,200,26,378967,226643,27790,80166,2.099401608062544,0.26128959711090616
1261,0.1307,38,234,38,379201,226409,27828,80128,2.097234058320056,0.26139748219627645
1262,0.1308,42,236,42,379437,226173,27870,80086,2.0950479825113937,0.26149762129439463
1263,0.1309,27,241,27,379678,225932,27897,80059,2.092815591537293,0.2616384142017249
1264,0.131,26,217,26,379895,225715,27923,80033,2.0908055133572936,0.26176131977968786
1265,0.1311,34,246,34,380141,225469,27957,79999,2.088526807217755,0.26188995246637947
1266,0.1312,31,212,31,380353,225257,27988,79968,2.086563044203194,0.26199688754197725
1267,0.1313,33,226,33,380579,225031,28021,79935,2.0844695987254065,0.2621111861650151
1268,0.1314,28,221,28,380800,224810,28049,79907,2.082422468413057,0.26223348221464504
1269,0.1315,25,232,25,381032,224578,28074,79882,2.080273444736745,0.2623727254811798
1270,0.1316,30,231,30,381263,224347,28104,79852,2.0781336840935194,0.26249921926107583
1271,0.1317,33,207,33,381470,224140,28137,79819,2.0762162362443957,0.26259791616632505
1272,0.1318,31,198,31,381668,223942,28168,79788,2.07438215569306,0.2626938399236164
1273,0.1319,28,245,28,381913,223697,28196,79760,2.0721127125866095,0.2628378979558883
1274,0.132,45,226,45,382139,223471,28241,79715,2.070019267108822,0.26292440943843054
1275,0.1321,40,245,40,382384,223226,28281,79675,2.0677498240023713,0.26303973905665545
1276,0.1322,42,230,42,382614,222996,28323,79633,2.065619326392234,0.2631373728228293
1277,0.1323,35,220,35,382834,222776,28358,79598,2.0635814591129717,0.2632435328434323
1278,0.1324,40,213,40,383047,222563,28398,79558,2.061608433065323,0.2633315790693133
1279,0.1325,27,199,27,383246,222364,28425,79531,2.0597650894808996,0.2634392752447043
1280,0.1326,33,226,33,383472,222138,28458,79498,2.057671644003112,0.26355607420864885
1281,0.1327,37,230,37,383702,221908,28495,79461,2.055541146392975,0.26366680050038327
1282,0.1328,27,201,27,383903,221707,28522,79434,2.0536792767423764,0.26377676902182035
1283,0.1329,46,217,46,384120,221490,28568,79388,2.051669198562377,0.2638544526352874
1284,0.133,36,219,36,384339,221271,28604,79352,2.049640594316203,0.2639585128217069
1285,0.1331,38,221,38,384560,221050,28642,79314,2.0475934640038536,0.26405960767601977
1286,0.1332,28,255,28,384815,220795,28670,79286,2.045231390566527,0.26421532852796414
1287,0.1333,34,187,34,385002,220608,28704,79252,2.0434992033791546,0.2642966717801641
1288,0.1334,43,236,43,385238,220372,28747,79209,2.0413131275704917,0.26439927765779536
1289,0.1335,37,218,37,385456,220154,28784,79172,2.0392937863574048,0.2645009120490702
1290,0.1336,22,202,22,385658,219952,28806,79150,2.037422653673719,0.26462544550019723
1291,0.1337,39,206,39,385864,219746,28845,79111,2.035514468857683,0.26471188561753617
1292,0.1338,43,211,43,386075,219535,28888,79068,2.033559968876209,0.2647930529833927
1293,0.1339,37,196,37,386271,219339,28925,79031,2.0317444143910484,0.2648758253175587
1294,0.134,30,201,30,386472,219138,28955,79001,2.02988254474045,0.2649804285920326
1295,0.1341,33,227,33,386699,218911,28988,78968,2.027779836229575,0.26510093024348813
1296,0.1342,31,215,31,386914,218696,29019,78937,2.025788284115751,0.26521588667923246
1297,0.1343,40,205,40,387119,218491,29059,78897,2.023889362332802,0.2652998776009792
1298,0.1344,41,232,41,387351,218259,29100,78856,2.02174033865649,0.26540565101055147
1299,0.1345,21,233,21,387584,218026,29121,78835,2.0195820519470895,0.26556199702891253
1300,0.1346,35,224,35,387808,217802,29156,78800,2.0175071325354774,0.26567588890162575
1301,0.1347,41,202,41,388010,217600,29197,78759,2.0156359998517916,0.2657553845167516
1302,0.1348,32,217,32,388227,217383,29229,78727,2.013625921671792,0.26587079126000474
1303,0.1349,32,214,32,388441,217169,29261,78695,2.011643632591056,0.2659836952113133
1304,0.135,40,225,40,388666,216944,29301,78655,2.009559450146356,0.2660868270866952
1305,0.1351,33,182,33,388848,216762,29334,78622,2.0078735781244212,0.266168783684966
1306,0.1352,34,210,34,389058,216552,29368,78588,2.0059283411760345,0.26627363285220573
1307,0.1353,38,212,38,389270,216340,29406,78550,2.003964578161473,0.2663705110380142
1308,0.1354,37,200,37,389470,216140,29443,78513,2.0021119715439624,0.26645919098057713
1309,0.1355,42,195,42,389665,215945,29485,78471,2.0003056800918895,0.2665310309222325
1310,0.1356,41,185,41,389850,215760,29526,78430,1.9985920189706918,0.2665964172813488
1311,0.1357,41,215,41,390065,215545,29567,78389,1.9966004668568675,0.26668912068695694
1312,0.1358,28,198,28,390263,215347,29595,78361,1.9947663863055318,0.26679899764391846
1313,0.1359,27,220,27,390483,215127,29622,78334,1.99272851902627,0.2669315513816146
1314,0.136,46,202,46,390685,214925,29668,78288,1.990857386342584,0.2670004399532081
1315,0.1361,35,196,35,390881,214729,29703,78253,1.9890418318574234,0.2670914936753794
1316,0.1362,36,202,36,391083,214527,29739,78217,1.9871706991737375,0.26718566392479437
1317,0.1363,23,201,23,391284,214326,29762,78194,1.9853088295231391,0.2673116368111582
1318,0.1364,30,232,30,391516,214094,29792,78164,1.9831598058468265,0.2674486241608442
1319,0.1365,34,204,34,391720,213890,29826,78130,1.9812701470969654,0.26755016779672625
1320,0.1366,38,218,38,391938,213672,29864,78092,1.9792508058838787,0.2676546798097092
1321,0.1367,35,202,35,392140,213470,29899,78057,1.9773796732001927,0.26775221506069763
1322,0.1368,38,184,38,392324,213286,29937,78019,1.9756752751120827,0.2678258183004068
1323,0.1369,33,176,33,392500,213110,29970,77986,1.9740449812886731,0.26790474620056615
1324,0.137,31,225,31,392725,212885,30001,77955,1.9719607988439736,0.2680339705680099
1325,0.1371,40,200,40,392925,212685,30041,77915,1.9701081922264627,0.26811768754301446
1326,0.1372,33,231,33,393156,212454,30074,77882,1.9679684315832375,0.2682478232117271
1327,0.1373,29,219,29,393375,212235,30103,77853,1.9659398273370632,0.26837718209646727
1328,0.1374,36,185,36,393560,212050,30139,77817,1.9642261662158658,0.2684576029696378
1329,0.1375,36,200,36,393760,211850,30175,77781,1.962373559598355,0.2685520541654726
1330,0.1376,29,186,29,393946,211664,30204,77752,1.9606506354440698,0.2686513530696299
1331,0.1377,37,210,37,394156,211454,30241,77715,1.9587053984956835,0.2687528746165737
1332,0.1378,34,231,34,394387,211223,30275,77681,1.9565656378524585,0.2688817046492953
1333,0.1379,37,183,37,394570,211040,30312,77644,1.954870502797436,0.2689584459131784
1334,0.138,41,210,41,394780,210830,30353,77603,1.9529252658490497,0.26905035138143
1335,0.1381,37,218,37,394998,210612,30390,77566,1.9509059246359628,0.269160033035138
1336,0.1382,25,208,25,395206,210404,30415,77541,1.9489792137537516,0.2692910104360208
1337,0.1383,31,197,31,395403,210207,30446,77510,1.9471543962355033,0.26939666408310947
1338,0.1384,34,219,34,395622,209988,30480,77476,1.945125791989329,0.26951548715665263
1339,0.1385,37,208,37,395830,209780,30517,77439,1.9431990811071178,0.2696165643637782
1340,0.1386,28,211,28,396041,209569,30545,77411,1.9412445811256438,0.2697435361349223
1341,0.1387,38,198,38,396239,209371,30583,77373,1.939410500574308,0.2698330217894708
1342,0.1388,25,225,25,396464,209146,30608,77348,1.9373263181296083,0.26998122124721635
1343,0.1389,36,207,36,396671,208939,30644,77312,1.9354088702804846,0.2700846459925031
1344,0.139,37,204,37,396875,208735,30681,77275,1.9335192115306237,0.270182860739135
1345,0.1391,35,187,35,397062,208548,30716,77240,1.931787024343251,0.2702702702702703
1346,0.1392,40,198,40,397260,208350,30756,77200,1.9299529437919152,0.2703554543862721
1347,0.1393,34,190,34,397450,208160,30790,77166,1.92819296750528,0.2704485395652692
1348,0.1394,35,204,35,397654,207956,30825,77131,1.9263033087554189,0.2705524980093796
1349,0.1395,26,204,26,397858,207752,30851,77105,1.9244136500055578,0.27067967436292595
1350,0.1396,43,207,43,398065,207545,30894,77062,1.922496202156434,0.2707663550088367
1351,0.1397,32,199,32,398264,207346,30926,77030,1.9206528585720108,0.2708737727515683
1352,0.1398,27,214,27,398478,207132,30953,77003,1.9186705694912742,0.27100849948088057
1353,0.1399,30,212,30,398690,206920,30983,76973,1.9167068064767128,0.2711338426801647
1354,0.14,31,199,31,398889,206721,31014,76942,1.9148634628922894,0.2712443991637965
1355,0.1401,28,220,28,399109,206501,31042,76914,1.9128255956130276,0.27138295432492987
1356,0.1402,26,189,26,399298,206312,31068,76888,1.9110748823594799,0.27149717514124294
1357,0.1403,36,191,36,399489,206121,31104,76852,1.909305643039757,0.2715877486544653
1358,0.1404,39,214,39,399703,205907,31143,76813,1.9073233539590204,0.27169284097340124
1359,0.1405,27,207,27,399910,205700,31170,76786,1.9054059061098967,0.27182232039817905
1360,0.1406,34,186,34,400096,205514,31204,76752,1.9036829819556116,0.27191372676836745
1361,0.1407,37,214,37,400310,205300,31241,76715,1.901700692874875,0.2720245377018953
1362,0.1408,30,196,30,400506,205104,31271,76685,1.8998851383897144,0.2721362437852436
1363,0.1409,31,187,31,400693,204917,31302,76654,1.8981529512023416,0.2722368425725661
1364,0.141,30,201,30,400894,204716,31332,76624,1.8962910815517433,0.272353735693467
1365,0.1411,36,222,36,401116,204494,31368,76588,1.8942346882063064,0.2724756476757672
1366,0.1412,32,223,32,401339,204271,31400,76556,1.8921690318277817,0.2726091152204026
1367,0.1413,34,216,34,401555,204055,31434,76522,1.89016821668087,0.2727308368112853
1368,0.1414,39,197,39,401752,203858,31473,76483,1.8883433991626217,0.27282131404254106
1369,0.1415,34,190,34,401942,203668,31507,76449,1.8865834228759866,0.2729181020787742
1370,0.1416,43,199,43,402141,203469,31550,76406,1.8847400792915632,0.2730004466279589
1371,0.1417,35,193,35,402334,203276,31585,76371,1.8829523139056652,0.2730978698144446
1372,0.1418,30,187,30,402521,203089,31615,76341,1.8812201267182926,0.2732025909887986
1373,0.1419,41,191,41,402712,202898,31656,76300,1.8794508873985698,0.27328275990515694
1374,0.142,35,182,35,402894,202716,31691,76265,1.877765015376635,0.2733698710664884
1375,0.1421,34,166,34,403060,202550,31725,76231,1.8762273518841008,0.27344402954290287
1376,0.1422,34,174,34,403234,202376,31759,76197,1.8746155841268666,0.2735261493396704
1377,0.1423,25,183,25,403417,202193,31784,76172,1.872920449071844,0.2736407235104988
1378,0.1424,22,195,22,403612,201998,31806,76150,1.871114157619771,0.27377511253002
1379,0.1425,26,182,26,403794,201816,31832,76124,1.8694282855978361,0.27388645031301717
1380,0.1426,38,187,38,403981,201629,31870,76086,1.8676960984104636,0.2739715175629692
1381,0.1427,37,175,37,404156,201454,31907,76049,1.8660750676201416,0.27404748777490695
1382,0.1428,36,206,36,404362,201248,31943,76013,1.8641668828041054,0.27415684138771773
1383,0.1429,37,213,37,404575,201035,31980,75976,1.8621938567564564,0.27427069683153377
1384,0.143,40,203,40,404778,200832,32020,75936,1.8603134610396828,0.2743669788414846
1385,0.1431,32,206,32,404984,200626,32052,75904,1.8584052762236467,0.2744873973890717
1386,0.1432,33,179,33,405163,200447,32085,75871,1.8567471933009745,0.2745785652762397
1387,0.1433,30,189,30,405352,200258,32115,75841,1.8549964800474268,0.27468770259942993
1388,0.1434,36,190,36,405542,200068,32151,75805,1.8532365037607914,0.27478223675386865
1389,0.1435,35,177,35,405719,199891,32186,75770,1.8515969469042943,0.27486659338825586
1390,0.1436,34,191,34,405910,199700,32220,75736,1.8498277075845715,0.27496768759348816
1391,0.1437,33,215,33,406125,199485,32253,75703,1.8478361554707474,0.27509557102780646
1392,0.1438,36,213,36,406338,199272,32289,75667,1.8458631294230983,0.2752137746918407
1393,0.1439,27,189,27,406527,199083,32316,75640,1.8441124161695506,0.2753318797479643
1394,0.144,30,192,30,406719,198891,32346,75610,1.84233391381674,0.27544526249449003
1395,0.1441,31,198,31,406917,198693,32377,75579,1.8404998332654043,0.27556221561078054
1396,0.1442,37,193,37,407110,198500,32414,75542,1.8387120678795064,0.27565847570810315
1397,0.1443,33,178,33,407288,198322,32447,75509,1.8370632479899218,0.2757503715795509
1398,0.1444,36,199,36,407487,198123,32483,75473,1.8352199044054984,0.2758556411643445
1399,0.1445,33,194,33,407681,197929,32516,75440,1.833422875986513,0.27596399006471106
1400,0.1446,43,181,43,407862,197748,32559,75397,1.8317462669976656,0.2760328763111168
1401,0.1447,33,175,33,408037,197573,32592,75364,1.8301252362073437,0.27612232859597635
1402,0.1448,34,200,34,408237,197373,32626,75330,1.8282726295898328,0.27623458487805413
1403,0.1449,36,199,36,408436,197174,32662,75294,1.8264292860054097,0.27634070789964327
1404,0.145,43,212,43,408648,196962,32705,75251,1.8244655229908482,0.27644161006270823
1405,0.1451,29,193,29,408841,196769,32734,75222,1.8226777576049502,0.2765606214911523
1406,0.1452,33,173,33,409014,196596,32767,75189,1.8210752528808032,0.2766488216789006
1407,0.1453,34,189,34,409203,196407,32801,75155,1.8193245396272555,0.2767507972396727
1408,0.1454,28,165,28,409368,196242,32829,75127,1.817796139167809,0.2768444442806658
1409,0.1455,40,194,40,409562,196048,32869,75087,1.8159991107488236,0.27693584376786473
1410,0.1456,29,196,29,409758,195852,32898,75058,1.814183556263663,0.27705880181610126
1411,0.1457,30,191,30,409949,195661,32928,75028,1.8124143169439402,0.277174174052141
1412,0.1458,44,215,44,410164,195446,32972,74984,1.8104227648301159,0.27727692933476317
1413,0.1459,39,182,39,410346,195264,33011,74945,1.808736892808181,0.27735937737085
1414,0.146,30,191,30,410537,195073,33041,74915,1.8069676534884582,0.2774752951983051
1415,0.1461,27,212,27,410749,194861,33068,74888,1.8050038904738968,0.2776210477147274
1416,0.1462,27,204,27,410953,194657,33095,74861,1.8031142317240356,0.27775881388256074
1417,0.1463,32,183,32,411136,194474,33127,74829,1.8014190966690133,0.2778617393790637
1418,0.1464,31,171,31,411307,194303,33158,74798,1.7998351180110415,0.27795511722364463
1419,0.1465,24,200,24,411507,194103,33182,74774,1.7979825113935306,0.278097420009893
1420,0.1466,39,202,39,411709,193901,33221,74735,1.7961113787098448,0.27820173022230826
1421,0.1467,40,193,40,411902,193708,33261,74695,1.7943236133239469,0.2782942068456761
1422,0.1468,28,199,28,412101,193509,33289,74667,1.7924802697395235,0.27842536244854127
1423,0.1469,31,179,31,412280,193330,33320,74636,1.7908221868168512,0.2785278729391042
1424,0.147,33,183,33,412463,193147,33353,74603,1.789127051761829,0.2786293183940243
1425,0.1471,40,174,40,412637,192973,33393,74563,1.7875152840045945,0.27870267926559417
1426,0.1472,33,200,33,412837,192773,33426,74530,1.7856626773870836,0.2788221606192224
1427,0.1473,38,176,38,413013,192597,33464,74492,1.784032383563674,0.2789032869193415
1428,0.1474,38,171,38,413184,192426,33502,74454,1.7824484049057023,0.2789793165467626
1429,0.1475,38,181,38,413365,192245,33540,74416,1.780771795916855,0.2790659301510157
1430,0.1476,40,200,40,413565,192045,33580,74376,1.7789191892993441,0.2791671827671242
1431,0.1477,28,207,28,413772,191838,33608,74348,1.7770017414502204,0.27930845348741107
1432,0.1478,44,168,44,413940,191670,33652,74304,1.7754455518915113,0.279365652281802
1433,0.1479,37,182,37,414122,191488,33689,74267,1.7737596798695765,0.279456642396192
1434,0.148,36,186,36,414308,191302,33725,74231,1.7720367557152914,0.2795547069479123
1435,0.1481,28,181,28,414489,191121,33753,74203,1.770360146726444,0.27966938535526376
1436,0.1482,43,192,43,414681,190929,33796,74160,1.7685816443736337,0.2797551011169834
1437,0.1483,33,185,33,414866,190744,33829,74127,1.766867983252436,0.27986076240887076
1438,0.1484,38,191,38,415057,190553,33867,74089,1.7650987439327133,0.2799593412988112
1439,0.1485,31,179,31,415236,190374,33898,74058,1.763440661010041,0.28006444000726083
1440,0.1486,27,176,27,415412,190198,33925,74031,1.7618103671866316,0.2801774218575554
1441,0.1487,32,173,32,415585,190025,33957,73999,1.7602078624624846,0.28027376299124324
1442,0.1488,35,187,35,415772,189838,33992,73964,1.758475675275112,0.28037694937870067
1443,0.1489,25,176,25,415948,189662,34017,73939,1.7568453814517024,0.28049590100189303
1444,0.149,25,182,25,416130,189480,34042,73914,1.7551595094297676,0.2806214264561835
1445,0.1491,26,159,26,416289,189321,34068,73888,1.7536866871688466,0.28071988419848865
1446,0.1492,32,182,32,416471,189139,34100,73856,1.7520008151469117,0.28082663168501304
1447,0.1493,27,170,27,416641,188969,34127,73829,1.7504260995220275,0.28093440589349994
1448,0.1494,31,187,31,416828,188782,34158,73798,1.7486939123346548,0.28104958488841497
1449,0.1495,35,168,35,416996,188614,34193,73763,1.7471377227759457,0.28113363595132196
1450,0.1496,39,176,39,417172,188438,34232,73724,1.7455074289525363,0.28121543167964846
1451,0.1497,28,178,28,417350,188260,34260,73696,1.7438586090629515,0.2813296889553971
1452,0.1498,23,197,23,417547,188063,34283,73673,1.7420337915447035,0.2814782834611975
1453,0.1499,25,183,25,417730,187880,34308,73648,1.740338656489681,0.2816065583799823
1454,0.15,28,201,28,417931,187679,34336,73620,1.7384767868390827,0.2817461987990769
1455,0.1501,26,172,26,418103,187507,34362,73594,1.7368835451480233,0.28186027629155
1456,0.1502,43,208,43,418311,187299,34405,73551,1.734956834265812,0.2819666474985624
1457,0.1503,41,185,41,418496,187114,34446,73510,1.7332431731446145,0.2820538400147339
1458,0.1504,28,165,28,418661,186949,34474,73482,1.731714772685168,0.28215535016952664
1459,0.1505,27,172,27,418833,186777,34501,73455,1.7301215309941087,0.2822673614313382
1460,0.1506,24,191,24,419024,186586,34525,73431,1.7283522916743859,0.28240845790852137
1461,0.1507,26,182,26,419206,186404,34551,73405,1.726666419652451,0.2825344772505956
1462,0.1508,35,171,35,419377,186233,34586,73370,1.7250824409944792,0.2826238525748932
1463,0.1509,26,163,26,419540,186070,34612,73344,1.7235725666012078,0.2827295365708867
1464,0.151,31,150,31,419690,185920,34643,73313,1.7221831116380748,0.2828073586310385
1465,0.1511,39,206,39,419896,185714,34682,73274,1.7202749268220385,0.28292430537322194
1466,0.1512,34,196,34,420092,185518,34716,73240,1.718459372336878,0.2830443889657518
1467,0.1513,30,159,30,420251,185359,34746,73210,1.716986550075957,0.2831352559664925
1468,0.1514,47,167,47,420418,185192,34793,73163,1.7154396235503353,0.28318786166321536
1469,0.1515,26,194,26,420612,184998,34819,73137,1.7136425951313499,0.2833284909059213
1470,0.1516,29,162,29,420774,184836,34848,73108,1.712141983771166,0.2834258598765624
1471,0.1517,30,185,30,420959,184651,34878,73078,1.7104283226499686,0.28354589510687583
1472,0.1518,33,170,33,421129,184481,34911,73045,1.7088536070250844,0.2836412634064133
1473,0.1519,24,208,24,421337,184273,34935,73021,1.706926896142873,0.2838037420227444
1474,0.152,34,164,34,421501,184109,34969,72987,1.7054077587165142,0.28389006441173725
1475,0.1521,31,166,31,421667,183943,35000,72956,1.70387009522398,0.28398709220355084
1476,0.1522,27,199,27,421866,183744,35027,72929,1.7020267516395569,0.2841319499908444
1477,0.1523,29,176,29,422042,183568,35056,72900,1.7003964578161472,0.28424598780354665
1478,0.1524,39,162,39,422204,183406,35095,72861,1.6988958464559636,0.2843167477669774
1479,0.1525,29,171,29,422375,183235,35124,72832,1.6973118677979917,0.28442556049783846
1480,0.1526,34,168,34,422543,183067,35158,72798,1.6957556782392826,0.2845172258808356
1481,0.1527,37,159,37,422702,182908,35195,72761,1.6942828559783616,0.28459062303212357
1482,0.1528,38,166,38,422868,182742,35233,72723,1.6927451924858277,0.28466913275791206
1483,0.1529,25,196,25,423064,182546,35258,72698,1.6909296380006669,0.2848176646659667
1484,0.153,30,185,30,423249,182361,35288,72668,1.6892159768794694,0.2849401440620479
1485,0.1531,36,181,36,423430,182180,35324,72632,1.687539367890622,0.2850415208074973
1486,0.1532,43,179,43,423609,182001,35367,72589,1.6858812849679499,0.2851211752229074
1487,0.1533,39,182,39,423791,181819,35406,72550,1.684195412946015,0.28521557265232794
1488,0.1534,32,161,32,423952,181658,35438,72518,1.6827040646189189,0.28530624449200553
1489,0.1535,36,186,36,424138,181472,35474,72482,1.6809811404646338,0.2854138938547926
1490,0.1536,43,184,43,424322,181288,35517,72439,1.6792767423765238,0.28549976943722977
1491,0.1537,35,171,35,424493,181117,35552,72404,1.677692763718552,0.2855936983524047
1492,0.1538,23,190,23,424683,180927,35575,72381,1.6759327874319168,0.2857430479890094
1493,0.1539,29,170,29,424853,180757,35604,72352,1.6743580718070326,0.2858531304694815
1494,0.154,44,181,44,425034,180576,35648,72308,1.6726814628181852,0.28593347147308645
1495,0.1541,36,174,36,425208,180402,35684,72272,1.6710696950609507,0.28602863769125436
1496,0.1542,29,168,29,425376,180234,35713,72243,1.6695135055022416,0.2861369550493708
1497,0.1543,41,157,41,425533,180077,35754,72202,1.6680592093074957,0.2861990098264223
1498,0.1544,37,163,37,425696,179914,35791,72165,1.6665493349142244,0.28627930133013857
1499,0.1545,34,181,34,425877,179733,35825,72131,1.664872725925377,0.2863886859575009
1500,0.1546,30,152,30,426029,179581,35855,72101,1.6634647448960687,0.2864765855325371
1501,0.1547,31,181,31,426210,179400,35886,72070,1.6617881359072215,0.2865948224440291
1502,0.1548,25,160,25,426370,179240,35911,72045,1.6603060506132128,0.28670632946654195
1503,0.1549,31,184,31,426554,179056,35942,72014,1.6586016525251028,0.28682837455689647
1504,0.155,39,148,39,426702,178908,35981,71975,1.6572307236281447,0.28688671611866884
1505,0.1551,36,179,36,426881,178729,36017,71939,1.6555726407054725,0.28698916495125026
1506,0.1552,30,168,30,427049,178561,36047,71909,1.6540164511467634,0.28709625903301794
1507,0.1553,44,160,44,427209,178401,36091,71865,1.652534365852755,0.2871544676464242
1508,0.1554,33,191,33,427400,178210,36124,71832,1.6507651265330319,0.2872797370041833
1509,0.1555,46,172,46,427572,178038,36170,71786,1.6491718848419727,0.2873462917894197
1510,0.1556,29,194,29,427766,177844,36199,71757,1.647374856422987,0.2874868289790506
1511,0.1557,26,167,26,427933,177677,36225,71731,1.6458279298973655,0.2876050487554529
1512,0.1558,31,186,31,428119,177491,36256,71700,1.6441050057430806,0.28773109783258627
1513,0.1559,30,170,30,428289,177321,36286,71670,1.6425302901181964,0.28784172921912843
1514,0.156,31,174,31,428463,177147,36317,71639,1.640918522360962,0.28795430611047246
1515,0.1561,28,148,28,428611,176999,36345,71611,1.6395475934640038,0.288045533164394
1516,0.1562,23,186,23,428797,176813,36368,71588,1.6378246693097187,0.28819529712038194
1517,0.1563,38,171,38,428968,176642,36406,71550,1.636240690651747,0.28828487622485816
1518,0.1564,31,164,31,429132,176478,36437,71519,1.634721553225388,0.28838655306314187
1519,0.1565,36,187,36,429319,176291,36473,71483,1.6329893660380155,0.28850081122313076
1520,0.1566,40,187,40,429506,176104,36513,71443,1.631257178850643,0.28860378029222733
1521,0.1567,21,166,21,429672,175938,36534,71422,1.6297195153581088,0.288737063389392
1522,0.1568,34,157,34,429829,175781,36568,71388,1.6282652191633629,0.28882262743305187
1523,0.1569,44,165,44,429994,175616,36612,71344,1.6267368187039164,0.28888888888888886
1524,0.157,29,149,29,430143,175467,36641,71315,1.6253566267738708,0.2889797473073401
1525,0.1571,32,160,32,430303,175307,36673,71283,1.623874541479862,0.28907498276491345
1526,0.1572,29,165,29,430468,175142,36702,71254,1.6223461410204156,0.28918488936508707
1527,0.1573,31,146,31,430614,174996,36733,71223,1.6209937381896329,0.28926687217477126
1528,0.1574,35,155,35,430769,174841,36768,71188,1.619557968061062,0.28934800369062186
1529,0.1575,34,177,34,430946,174664,36802,71154,1.6179184112045648,0.2894580543328804
1530,0.1576,32,169,32,431115,174495,36834,71122,1.616352958612768,0.289564647398185
1531,0.1577,30,165,30,431280,174330,36864,71092,1.6148245581533218,0.2896724824995314
1532,0.1578,37,174,37,431454,174156,36901,71055,1.6132127903960873,0.2897708504104628
1533,0.1579,36,175,36,431629,173981,36937,71019,1.6115917596057654,0.2898734693877551
1534,0.158,31,168,31,431797,173813,36968,70988,1.610035570047056,0.28998247556178286
1535,0.1581,22,162,22,431959,173651,36990,70966,1.6085349586868725,0.29011066279122055
1536,0.1582,33,149,33,432108,173502,37023,70933,1.607154766756827,0.29019166649620554
1537,0.1583,40,169,40,432277,173333,37063,70893,1.6055893141650301,0.29027621956712224
1538,0.1584,32,165,32,432442,173168,37095,70861,1.6040609137055837,0.29037942211786305
1539,0.1585,30,177,30,432619,172991,37125,70831,1.6024213568490866,0.2905029078590119
1540,0.1586,35,169,35,432788,172822,37160,70796,1.60085590425729,0.290602500636242
1541,0.1587,31,147,31,432935,172675,37191,70765,1.5994942383934196,0.2906876437725928
1542,0.1588,29,161,29,433096,172514,37220,70736,1.5980028900663232,0.29079547790339155
1543,0.1589,38,178,38,433274,172336,37258,70698,1.5963540701767387,0.2908975698873409
1544,0.159,43,158,43,433432,172178,37301,70655,1.594890510948905,0.2909612779152751
1545,0.1591,38,181,38,433613,171997,37339,70617,1.5932139019600577,0.2910672920771266
1546,0.1592,28,145,28,433758,171852,37367,70589,1.5918707621623625,0.2911594985996593
1547,0.1593,34,156,34,433914,171696,37401,70555,1.590425729000704,0.291247507750226
1548,0.1594,29,176,29,434090,171520,37430,70526,1.5887954351772944,0.2913743668558869
1549,0.1595,41,145,41,434235,171375,37471,70485,1.587452295379599,0.29142892582485735
1550,0.1596,29,173,29,434408,171202,37500,70456,1.5858497906554523,0.29155252464226306
1551,0.1597,45,169,45,434577,171033,37545,70411,1.5842843380636555,0.291624558903928
1552,0.1598,33,148,33,434725,170885,37578,70378,1.5829134091666976,0.29170656088998315
1553,0.1599,30,164,30,434889,170721,37608,70348,1.5813942717403386,0.29181686571064713
1554,0.16,44,144,44,435033,170577,37652,70304,1.5800603949757308,0.2918619567338229
1555,0.1601,31,183,31,435216,170394,37683,70273,1.5783652599207085,0.29199267037026266
1556,0.1602,34,152,34,435368,170242,37717,70239,1.5769572788914001,0.29207712875445463
1557,0.1603,34,163,34,435531,170079,37751,70205,1.5754474044981288,0.2921750928068452
1558,0.1604,38,157,38,435688,169922,37789,70167,1.573993108303383,0.29225412242959903
1559,0.1605,31,178,31,435866,169744,37820,70136,1.5723442884137981,0.2923795230948808
1560,0.1606,33,183,33,436049,169561,37853,70103,1.5706491533587759,0.292505340810468
1561,0.1607,36,142,36,436191,169419,37889,70067,1.5693338026603432,0.29257242594556676
1562,0.1608,32,181,32,436372,169238,37921,70035,1.5676571936714958,0.2926991344614729
1563,0.1609,45,181,45,436553,169057,37966,69990,1.5659805846826484,0.29278761080456983
1564,0.161,27,143,27,436696,168914,37993,69963,1.5646559709511283,0.29288294812811616
1565,0.1611,41,155,41,436851,168759,38034,69922,1.5632202008225573,0.2929516802761845
1566,0.1612,24,159,24,437010,168600,38058,69898,1.5617473785616363,0.2930758329210308
1567,0.1613,29,168,29,437178,168432,38087,69869,1.5601911890029272,0.2931964196541349
1568,0.1614,44,176,44,437354,168256,38131,69825,1.5585608951795176,0.2932825382957901
1569,0.1615,26,156,26,437510,168100,38157,69799,1.5571158620178591,0.2933976183170169
1570,0.1616,27,167,27,437677,167933,38184,69772,1.5555689354922375,0.29352348499190173
1571,0.1617,33,173,33,437850,167760,38217,69739,1.5539664307680907,0.293639131112131
1572,0.1618,30,154,30,438004,167606,38247,69709,1.5525399236726074,0.293740387249015
1573,0.1619,29,148,29,438152,167458,38276,69680,1.5511689947756493,0.2938373436564363
1574,0.162,26,151,26,438303,167307,38302,69654,1.5497702767794286,0.2939471052198463
1575,0.1621,33,153,33,438456,167154,38335,69621,1.548353032717033,0.2940386442825467
1576,0.1622,31,132,31,438588,167022,38366,69590,1.5471303123494757,0.29411018883235
1577,0.1623,27,157,27,438745,166865,38393,69563,1.5456760161547296,0.2942248803018255
1578,0.1624,29,167,29,438912,166698,38422,69534,1.5441290896291082,0.2943462359036879
1579,0.1625,42,163,42,439075,166535,38464,69492,1.542619215235837,0.29442394302346764
1580,0.1626,41,155,41,439230,166380,38505,69451,1.541183445107266,0.29449478652085603
1581,0.1627,39,156,39,439386,166224,38544,69412,1.5397384119456075,0.29457298545213806
1582,0.1628,24,173,24,439559,166051,38568,69388,1.5381359072214607,0.2947175276823296
1583,0.1629,31,162,31,439721,165889,38599,69357,1.5366352958612768,0.2948275422323865
1584,0.163,40,144,40,439865,165745,38639,69317,1.535301419096669,0.2948881571670453
1585,0.1631,36,182,36,440047,165563,38675,69281,1.5336155470747341,0.29500860145458263
1586,0.1632,46,154,46,440201,165409,38721,69235,1.5321890399792508,0.29506401186478237
1587,0.1633,28,161,28,440362,165248,38749,69207,1.5306976916521546,0.2951824443923141
1588,0.1634,43,173,43,440535,165075,38792,69164,1.5290951869280076,0.29527106929247476
1589,0.1635,32,162,32,440697,164913,38824,69132,1.527594575567824,0.2953790937640197
1590,0.1636,42,170,42,440867,164743,38866,69090,1.5260198599429398,0.29546727792912036
1591,0.1637,33,158,33,441025,164585,38899,69057,1.5245563007151062,0.29556757774715164
1592,0.1638,29,165,29,441190,164420,38928,69028,1.5230279002556597,0.2956889757033686
1593,0.1639,30,161,30,441351,164259,38958,68998,1.5215365519285635,0.29580248395546543
1594,0.164,37,140,37,441491,164119,38995,68961,1.520239727296306,0.29586837137463534
1595,0.1641,37,144,37,441635,163975,39032,68924,1.5189058505316981,0.2959394415605048
1596,0.1642,44,138,44,441773,163837,39076,68880,1.5176275519656157,0.2959818148222949
1597,0.1643,30,143,30,441916,163694,39106,68850,1.5163029382340953,0.2960730012384753
1598,0.1644,27,155,27,442071,163539,39133,68823,1.5148671681055246,0.29618870555426446
1599,0.1645,33,149,33,442220,163390,39166,68790,1.513486976175479,0.29627874924627445
1600,0.1646,38,155,38,442375,163235,39204,68752,1.512051206046908,0.2963614340458733
1601,0.1647,28,167,28,442542,163068,39232,68724,1.5105042795212864,0.2964899565127356
1602,0.1648,26,134,26,442676,162934,39258,68698,1.5092630330875543,0.29658251018857495
1603,0.1649,28,153,28,442829,162781,39286,68670,1.5078457890251584,0.2966934685959447
1604,0.165,36,152,36,442981,162629,39322,68634,1.5064378079958503,0.2967789918836995
1605,0.1651,23,162,23,443143,162467,39345,68611,1.5049371966356664,0.2969170583093155
1606,0.1652,47,157,47,443300,162310,39392,68564,1.5034829004409205,0.29697583963547214
1607,0.1653,41,146,41,443446,162164,39433,68523,1.5021304976101375,0.29703884484171195
1608,0.1654,30,174,30,443620,161990,39463,68493,1.500518729852903,0.2971715918310678
1609,0.1655,37,149,37,443769,161841,39500,68456,1.4991385379228575,0.29725094117595974
1610,0.1656,26,149,26,443918,161692,39526,68430,1.4977583459928119,0.2973640069180695
1611,0.1657,40,178,40,444096,161514,39566,68390,1.4961095261032273,0.2974719883081634
1612,0.1658,38,153,38,444249,161361,39604,68352,1.4946922820408315,0.2975539042196132
1613,0.1659,28,121,28,444370,161240,39632,68324,1.4935714550372374,0.29762506316321374
1614,0.166,35,157,35,444527,161083,39667,68289,1.4921171588424913,0.29772160507821355
1615,0.1661,27,141,27,444668,160942,39694,68262,1.4908110711771463,0.2978220275387864
1616,0.1662,49,140,49,444808,160802,39743,68213,1.4895142465448887,0.29785385236774886
1617,0.1663,39,167,39,444975,160635,39782,68174,1.4879673200192671,0.297951566590475
1618,0.1664,33,137,33,445112,160498,39815,68141,1.4866982844862722,0.2980287702447964
1619,0.1665,44,152,44,445264,160346,39859,68097,1.485290303456964,0.298091865366853
1620,0.1666,27,148,27,445412,160198,39886,68070,1.4839193745600059,0.2982021133054129
1621,0.1667,28,164,28,445576,160034,39914,68042,1.482400237133647,0.2983303811010365
1622,0.1668,39,165,39,445741,159869,39953,68003,1.4808718366742006,0.2984263095070917
1623,0.1669,32,153,32,445894,159716,39985,67971,1.4794545926118048,0.2985282427191715
1624,0.167,20,148,20,446042,159568,40005,67951,1.478083663714847,0.29866077118834033
1625,0.1671,33,164,33,446206,159404,40038,67918,1.4765645262884879,0.29877442570450724
1626,0.1672,20,163,20,446369,159241,40058,67898,1.4750546518952166,0.2989270886989905
1627,0.1673,28,156,28,446525,159085,40086,67870,1.4736096187335581,0.29904606640082837
1628,0.1674,27,133,27,446658,158952,40113,67843,1.4723776353329134,0.29913798805088293
1629,0.1675,30,149,30,446807,158803,40143,67813,1.4709974434028679,0.29924188936350476
1630,0.1676,31,150,31,446957,158653,40174,67782,1.4696079884397346,0.2993441826572747
1631,0.1677,27,143,27,447100,158510,40201,67755,1.4682833747082145,0.29944976023689035
1632,0.1678,35,150,35,447250,158360,40236,67720,1.4668939197450814,0.29953998584571834
1633,0.1679,46,148,46,447398,158212,40282,67674,1.4655229908481233,0.29959360031166166
1634,0.168,35,138,35,447536,158074,40317,67639,1.464244692282041,0.2996681626667494
1635,0.1681,29,135,29,447671,157939,40346,67610,1.462994182815221,0.2997574806361367
1636,0.1682,32,135,32,447806,157804,40378,67578,1.4617436733484013,0.29983760903710144
1637,0.1683,39,166,39,447972,157638,40417,67539,1.4602060098558671,0.2999373825923607
1638,0.1684,38,164,38,448136,157474,40455,67501,1.4586868724295083,0.3000377819757751
1639,0.1685,33,124,33,448260,157350,40488,67468,1.4575382563266517,0.3001005257586136
1640,0.1686,31,131,31,448391,157219,40519,67437,1.456324798992182,0.3001789402464212
1641,0.1687,32,145,32,448536,157074,40551,67405,1.4549816591944866,0.3002730767688737
1642,0.1688,25,160,25,448696,156914,40576,67380,1.453499573900478,0.3004092842430025
1643,0.1689,31,149,31,448845,156765,40607,67349,1.4521193819704323,0.3005122393067814
1644,0.169,31,150,31,448995,156615,40638,67318,1.4507299270072993,0.30061670231721094
1645,0.1691,44,149,44,449144,156466,40682,67274,1.4493497350772537,0.3006793599713954
1646,0.1692,34,158,34,449302,156308,40716,67240,1.4478861758494201,0.30078551362570904
1647,0.1693,33,129,33,449431,156179,40749,67207,1.4466912445811257,0.3008559175597396
1648,0.1694,39,156,39,449587,156023,40788,67168,1.4452462114194673,0.3009440344816771
1649,0.1695,29,153,29,449740,155870,40817,67139,1.4438289673570714,0.3010595984915407
1650,0.1696,35,146,35,449886,155724,40852,67104,1.4424765645262885,0.30114707307878724
1651,0.1697,30,156,30,450042,155568,40882,67074,1.44103153136463,0.3012639124693454
1652,0.1698,33,171,33,450213,155397,40915,67041,1.4394475527066584,0.3013918485150918
1653,0.1699,32,164,32,450377,155233,40947,67009,1.4379284152802994,0.30151366528378976
1654,0.17,32,160,32,450537,155073,40979,66977,1.4364463299862906,0.301630263454177
1655,0.1701,24,142,24,450679,154931,41003,66953,1.435130979287858,0.3017477600908583
1656,0.1702,34,125,34,450804,154806,41037,66919,1.4339731001519138,0.3018108016687338
1657,0.1703,36,150,36,450954,154656,41073,66883,1.4325836451887806,0.30190169676670925
1658,0.1704,34,172,34,451126,154484,41107,66849,1.4309904034977212,0.3020290693208875
1659,0.1705,25,150,25,451276,154334,41132,66824,1.4296009485345882,0.30215502039266046
1660,0.1706,37,129,37,451405,154205,41169,66787,1.4284060172662936,0.30221455980306977
1661,0.1707,32,147,32,451552,154058,41201,66755,1.4270443514024231,0.3023146282148243
1662,0.1708,30,153,30,451705,153905,41231,66725,1.4256271073400275,0.3024294066989983
1663,0.1709,30,149,30,451854,153756,41261,66695,1.424246915409982,0.3025388861923965
1664,0.171,31,162,31,452016,153594,41292,66664,1.422746304049798,0.30266324038173414
1665,0.1711,30,144,30,452160,153450,41322,66634,1.4214124272851902,0.3027662165355046
1666,0.1712,33,137,33,452297,153313,41355,66601,1.4201433917521953,0.3028502050801677
1667,0.1713,25,131,25,452428,153182,41380,66576,1.4189299344177257,0.3029514283894102
1668,0.1714,32,132,32,452560,153050,41412,66544,1.4177072140501685,0.3030319589788428
1669,0.1715,26,146,26,452706,152904,41438,66518,1.4163548112193858,0.3031510058243932
1670,0.1716,32,136,32,452842,152768,41470,66486,1.4150950387194783,0.30323734116595363
1671,0.1717,25,166,25,453008,152602,41495,66461,1.4135573752269444,0.303387609956953
1672,0.1718,35,153,35,453161,152449,41530,66426,1.4121401311645485,0.3034882924043404
1673,0.1719,34,131,34,453292,152318,41564,66392,1.410926673830079,0.3035617941566458
1674,0.172,25,153,25,453445,152165,41589,66367,1.4095094297676831,0.3036946534146029
1675,0.1721,32,138,32,453583,152027,41621,66335,1.4082311312016007,0.3037845412663375
1676,0.1722,37,135,37,453718,151892,41658,66298,1.406980621734781,0.3038544387918786
1677,0.1723,41,174,41,453892,151718,41699,66257,1.4053688539775464,0.3039660511526551
1678,0.1724,29,151,29,454043,151567,41728,66228,1.4039701359813257,0.30408411579696504
1679,0.1725,25,145,25,454188,151422,41753,66203,1.4026269961836304,0.3042067777139575
1680,0.1726,35,148,35,454336,151274,41788,66168,1.4012560672866723,0.3043018368116555
1681,0.1727,29,141,29,454477,151133,41817,66139,1.3999499796213273,0.30440645826429547
1682,0.1728,34,152,34,454629,150981,41851,66105,1.3985419985920189,0.30451065476354994
1683,0.1729,42,150,42,454779,150831,41893,66063,1.3971525436288859,0.30458657224266233
1684,0.173,21,122,21,454901,150709,41914,66042,1.3960224535922043,0.30469063579868144
1685,0.1731,36,148,36,455049,150561,41950,66006,1.3946515246952462,0.304783277230603
1686,0.1732,30,171,30,455220,150390,41980,65976,1.3930675460372743,0.304927761293364
1687,0.1733,27,124,27,455344,150266,42007,65949,1.3919189299344177,0.30501584071410404
1688,0.1734,24,144,24,455488,150122,42031,65925,1.3905850531698098,0.30514193670821627
1689,0.1735,30,151,30,455639,149971,42061,65895,1.3891863351735891,0.30525881797040755
1690,0.1736,31,134,31,455773,149837,42092,65864,1.387945088739857,0.3053486075632473
1691,0.1737,23,164,23,455937,149673,42115,65841,1.386425951313498,0.3055068348227957
1692,0.1738,30,148,30,456085,149525,42145,65811,1.38505502241654,0.30562005424081434
1693,0.1739,34,125,34,456210,149400,42179,65777,1.3838971432805958,0.30568787556290866
1694,0.174,24,148,24,456358,149252,42203,65753,1.3825262143836379,0.30582079486523567
1695,0.1741,31,135,31,456493,149117,42234,65722,1.381275704916818,0.3059127998175378
1696,0.1742,22,131,22,456624,148986,42256,65700,1.3800622475823483,0.306028339062631
1697,0.1743,36,142,36,456766,148844,42292,65664,1.3787468968839156,0.3061144572696589
1698,0.1744,35,156,35,456922,148688,42327,65629,1.3773018637222572,0.3062239579688032
1699,0.1745,29,144,29,457066,148544,42356,65600,1.3759679869576493,0.3063359234907352
1700,0.1746,43,138,43,457204,148406,42399,65557,1.374689688391567,0.306394096175507
1701,0.1747,36,149,36,457353,148257,42435,65521,1.3733094964615213,0.3064908456436116
1702,0.1748,30,116,30,457469,148141,42465,65491,1.372234984623365,0.3065598786698622
1703,0.1749,38,153,38,457622,147988,42503,65453,1.3708177405609694,0.3066561719632123
1704,0.175,31,138,31,457760,147850,42534,65422,1.3695394419948868,0.30675381672230767
1705,0.1751,32,116,32,457876,147734,42566,65390,1.3684649301567304,0.30681668887595953
1706,0.1752,30,145,30,458021,147589,42596,65360,1.3671217903590351,0.30692794988471417
1707,0.1753,40,147,40,458168,147442,42636,65320,1.3657601244951647,0.3070097103806131
1708,0.1754,32,114,32,458282,147328,42668,65288,1.3647041387231835,0.30707002295217667
1709,0.1755,23,118,23,458400,147210,42691,65265,1.363611100818852,0.3071655488881045
1710,0.1756,30,122,30,458522,147088,42721,65235,1.3624810107821705,0.3072441515992144
1711,0.1757,40,132,40,458654,146956,42761,65195,1.3612582904146133,0.30730470278245214
1712,0.1758,26,136,26,458790,146820,42787,65169,1.359998517914706,0.30741689427281604
1713,0.1759,24,124,24,458914,146696,42811,65145,1.3588499018118492,0.3075183746300291
1714,0.176,24,143,24,459057,146553,42835,65121,1.357525288080329,0.3076476090592137
1715,0.1761,30,149,30,459206,146404,42865,65091,1.3561450961502834,0.3077661410435235
1716,0.1762,36,140,36,459346,146264,42901,65055,1.354848271518026,0.3078521098434121
1717,0.1763,37,134,37,459480,146130,42938,65018,1.3536070250842935,0.3079261939492678
1718,0.1764,38,139,38,459619,145991,42976,64980,1.3523194634851237,0.3080044176687791
1719,0.1765,25,175,25,459794,145816,43001,64955,1.3506984326948015,0.3081780700380982
1720,0.1766,43,118,43,459912,145698,43044,64912,1.3496053947904703,0.3082094867290252
1721,0.1767,32,148,32,460060,145550,43076,64880,1.3482344658935121,0.30832105688352424
1722,0.1768,36,150,36,460210,145400,43112,64844,1.3468450109303791,0.308422594699492
1723,0.1769,35,134,35,460344,145266,43147,64809,1.3456037644966468,0.30850410567654407
1724,0.177,26,138,26,460482,145128,43173,64783,1.3443254659305643,0.30862127282514973
1725,0.1771,26,139,26,460621,144989,43199,64757,1.3430379043313942,0.3087400951627206
1726,0.1772,30,125,30,460746,144864,43229,64727,1.34188002519545,0.3088252835283958
1727,0.1773,36,136,36,460882,144728,43265,64691,1.3406202526955426,0.3089070237180008
1728,0.1774,33,147,33,461029,144581,43298,64658,1.3392585868316722,0.30901504977561545
1729,0.1775,30,152,30,461181,144429,43328,64628,1.337850605802364,0.30914056931841555
1730,0.1776,34,136,34,461317,144293,43362,64594,1.3365908333024565,0.3092293919679061
1731,0.1777,30,145,30,461462,144148,43392,64564,1.3352476935047612,0.30934493464678603
1732,0.1778,32,133,32,461595,144015,43424,64532,1.3340157101041166,0.3094362421900099
1733,0.1779,29,119,29,461714,143896,43453,64503,1.3329134091666976,0.30951684029194
1734,0.178,36,130,36,461844,143766,43489,64467,1.3317092148653156,0.3095906988805809
1735,0.1781,20,132,20,461976,143634,43509,64447,1.3304864944977584,0.3097207337527213
1736,0.1782,30,112,30,462088,143522,43539,64417,1.3294490347919523,0.3097879666633003
1737,0.1783,34,120,34,462208,143402,43573,64383,1.3283374708214457,0.3098539355583897
1738,0.1784,21,138,21,462346,143264,43594,64362,1.3270591722553633,0.3099900783138913
1739,0.1785,27,133,27,462479,143131,43621,64335,1.3258271888547186,0.31009900417417796
1740,0.1786,28,125,28,462604,143006,43649,64307,1.3246693097187743,0.31019280025854623
1741,0.1787,30,138,30,462742,142868,43679,64277,1.3233910111526919,0.310299548625359
1742,0.1788,36,129,36,462871,142739,43715,64241,1.3221960798843972,0.31037298289689824
1743,0.1789,30,116,30,462987,142623,43745,64211,1.3211215680462411,0.31044702515060385
1744,0.179,31,135,31,463122,142488,43776,64180,1.3198710585794213,0.3105463835717189
1745,0.1791,38,136,38,463258,142352,43814,64142,1.3186112860795138,0.31062403750230033
1746,0.1792,32,124,32,463382,142228,43846,64110,1.3174626699766572,0.31070379668311215
1747,0.1793,37,126,37,463508,142102,43883,64073,1.3162955278076254,0.31076997696131925
1748,0.1794,29,144,29,463652,141958,43912,64044,1.3149616510430175,0.3108901855321793
1749,0.1795,39,141,39,463793,141817,43951,64005,1.3136555633776723,0.31097258796435756
1750,0.1796,26,133,26,463926,141684,43977,63979,1.3124235799770276,0.31108658339127604
1751,0.1797,27,136,27,464062,141548,44004,63952,1.3111638074771204,0.3112019464720195
1752,0.1798,21,135,21,464197,141413,44025,63931,1.3099132980103005,0.31133609942340656
1753,0.1799,27,145,27,464342,141268,44052,63904,1.308570158212605,0.3114655021152984
1754,0.18,33,121,33,464463,141147,44085,63871,1.307449331209011,0.31153849905861924
1755,0.1801,29,135,29,464598,141012,44114,63842,1.3061988217421914,0.31164634324933854
1756,0.1802,22,158,22,464756,140854,44136,63820,1.3047352625143578,0.31181293178420316
1757,0.1803,24,142,24,464898,140712,44160,63796,1.303419911815925,0.3119486768243785
1758,0.1804,19,116,19,465014,140596,44179,63777,1.3023453999777688,0.31206176941181074
1759,0.1805,33,148,33,465162,140448,44212,63744,1.3009744710808107,0.3121767748001881
1760,0.1806,27,133,27,465295,140315,44239,63717,1.299742487680166,0.31228924874529485
1761,0.1807,35,141,35,465436,140174,44274,63682,1.2984364000148207,0.31238717526096854
1762,0.1808,20,117,20,465553,140057,44294,63662,1.297352625143577,0.31249907961456713
1763,0.1809,29,128,29,465681,139929,44323,63633,1.29616695690837,0.31259763610104047
1764,0.181,35,131,35,465812,139798,44358,63598,1.2949534995739005,0.3126806820193121
1765,0.1811,38,127,38,465939,139671,44396,63560,1.293777094371781,0.3127475631178314
1766,0.1812,37,130,37,466069,139541,44433,63523,1.2925729000703992,0.3128225584052318
1767,0.1813,25,128,25,466197,139413,44458,63498,1.2913872318351922,0.31293522775995386
1768,0.1814,27,136,27,466333,139277,44485,63471,1.2901274593352847,0.313053642945923
1769,0.1815,37,119,37,466452,139158,44522,63434,1.2890251583978658,0.31311206760385407
1770,0.1816,32,133,32,466585,139025,44554,63402,1.2877931749972211,0.31320920628177074
1771,0.1817,28,129,28,466714,138896,44582,63374,1.2865982437289265,0.3133138873782568
1772,0.1818,32,135,32,466849,138761,44614,63342,1.2853477342621067,0.3134144470888606
1773,0.1819,31,119,31,466968,138642,44645,63311,1.2842454333246878,0.31349373369051214
1774,0.182,27,127,27,467095,138515,44672,63284,1.2830690281225685,0.31359917541712296
1775,0.1821,27,123,27,467218,138392,44699,63257,1.2819296750527993,0.3136985554106393
1776,0.1822,34,119,34,467337,138273,44733,63223,1.2808273741153804,0.3137680152459602
1777,0.1823,28,133,28,467470,138140,44761,63195,1.2795953907147357,0.31387985198798024
1778,0.1824,28,129,28,467599,138011,44789,63167,1.278400459446441,0.31398562467068963
1779,0.1825,27,139,27,467738,137872,44816,63140,1.277112897847271,0.3141106003621674
1780,0.1826,28,124,28,467862,137748,44844,63112,1.2759642817444143,0.31420890172259286
1781,0.1827,34,121,34,467983,137627,44878,63078,1.2748434547408203,0.3142821554022072
1782,0.1828,25,134,25,468117,137493,44903,63053,1.2736022083070881,0.3144066697914693
1783,0.1829,32,126,32,468243,137367,44935,63021,1.2724350661380563,0.3144948799329301
1784,0.183,46,135,46,468378,137232,44981,62975,1.2711845566712365,0.31454944132822527
1785,0.1831,34,127,34,468505,137105,45015,62941,1.270008151469117,0.31463263449406637
1786,0.1832,33,135,33,468640,136970,45048,62908,1.2687576420022972,0.3147319865117722
1787,0.1833,29,135,29,468775,136835,45077,62879,1.2675071325354774,0.31484522867700815
1788,0.1834,35,118,35,468893,136717,45112,62844,1.266414094631146,0.31491123015017963
1789,0.1835,26,119,26,469012,136598,45138,62818,1.265311793693727,0.31500982869980343
1790,0.1836,33,116,33,469128,136482,45171,62785,1.2642372818555707,0.31507976734732795
1791,0.1837,31,129,31,469257,136353,45202,62754,1.2630423505872763,0.31517726649489974
1792,0.1838,42,130,42,469387,136223,45244,62712,1.2618381562858942,0.3152386457888255
1793,0.1839,29,122,29,469509,136101,45273,62683,1.2607080662492127,0.3153322198969736
1794,0.184,26,134,26,469643,135967,45299,62657,1.2594668198154804,0.31545533268889964
1795,0.1841,36,132,36,469775,135835,45335,62621,1.2582440994479231,0.31554097633732414
1796,0.1842,33,111,33,469886,135724,45368,62588,1.2572159027752048,0.3156036951873815
1797,0.1843,29,148,29,470034,135576,45397,62559,1.2558449738782467,0.31573926868044516
1798,0.1844,23,125,23,470159,135451,45420,62536,1.2546870947423023,0.3158591220635698
1799,0.1845,38,141,38,470300,135310,45458,62498,1.2533810070769573,0.31595284316104505
1800,0.1846,27,133,27,470433,135177,45485,62471,1.2521490236763126,0.3160720067999676
1801,0.1847,29,134,29,470567,135043,45514,62442,1.2509077772425803,0.31618603944603385
1802,0.1848,45,123,45,470690,134920,45559,62397,1.249768424172811,0.31622718772330816
1803,0.1849,27,148,27,470838,134772,45586,62370,1.2483974952758532,0.31637094074322064
1804,0.185,25,144,25,470982,134628,45611,62345,1.2470636185112454,0.31651546150995313
1805,0.1851,40,102,40,471084,134526,45651,62305,1.2461187891363148,0.3165405855784912
1806,0.1852,26,126,26,471210,134400,45677,62279,1.244951646967283,0.31665302345446134
1807,0.1853,25,127,25,471337,134273,45702,62254,1.2437752417651635,0.3167707236155846
1808,0.1854,28,108,28,471445,134165,45730,62226,1.2427748341917078,0.31684751337892264
1809,0.1855,30,141,30,471586,134024,45760,62196,1.2414687465263625,0.31697074712057893
1810,0.1856,21,113,21,471699,133911,45781,62175,1.240422023787469,0.3170802607019369
1811,0.1857,29,120,29,471819,133791,45810,62146,1.2393104598169624,0.3171733771569433
1812,0.1858,34,110,34,471929,133681,45844,62112,1.2382915261773315,0.3172329960723826
1813,0.1859,31,124,31,472053,133557,45875,62081,1.2371429100744749,0.31732587738578394
1814,0.186,27,130,27,472183,133427,45902,62054,1.2359387157730928,0.3174426159064052
1815,0.1861,28,141,28,472324,133286,45930,62026,1.2346326281077475,0.31757393298926845
1816,0.1862,30,132,30,472456,133154,45960,61996,1.2334099077401905,0.3176838329490136
1817,0.1863,23,119,23,472575,133035,45983,61973,1.2323076068027714,0.3177972185756482
1818,0.1864,33,119,33,472694,132916,46016,61940,1.2312053058653525,0.31787576466724143
1819,0.1865,41,107,41,472801,132809,46057,61899,1.2302141613249842,0.3179068143065513
1820,0.1866,30,137,30,472938,132672,46087,61869,1.2289451257919892,0.3180255061914969
1821,0.1867,26,110,26,473048,132562,46113,61843,1.2279261921523583,0.31811424603276667
1822,0.1868,35,137,35,473185,132425,46148,61808,1.2266571566193634,0.31821575118543194
1823,0.1869,17,133,17,473318,132292,46165,61791,1.2254251732187187,0.31837409767985864
1824,0.187,33,135,33,473453,132157,46198,61758,1.2241746637518989,0.31847974628058684
1825,0.1871,35,129,35,473582,132028,46233,61723,1.2229797324836045,0.31856867835520847
1826,0.1872,38,110,38,473692,131918,46271,61685,1.2219607988439736,0.3186159305382665
1827,0.1873,33,117,33,473809,131801,46304,61652,1.2208770239727296,0.31869239556894957
1828,0.1874,31,101,31,473910,131700,46335,61621,1.2199414576308867,0.3187496443738652
1829,0.1875,39,110,39,474020,131590,46374,61582,1.2189225239912558,0.31879361398132233
1830,0.1876,32,128,32,474148,131462,46406,61550,1.2177368557560488,0.3188920896110086
1831,0.1877,26,128,26,474276,131334,46432,61524,1.216551187520842,0.3190119155025978
1832,0.1878,27,114,27,474390,131220,46459,61497,1.2154952017488607,0.3191052164572923
1833,0.1879,18,108,18,474498,131112,46477,61479,1.2144947941754047,0.3192205243235665
1834,0.188,37,120,37,474618,130992,46514,61442,1.2133832302048984,0.319288691187628
1835,0.1881,34,117,34,474735,130875,46548,61408,1.2122994553336544,0.31936260615863077
1836,0.1882,41,123,41,474858,130752,46589,61367,1.2111601022638854,0.3194218166865328
1837,0.1883,33,104,33,474962,130648,46622,61334,1.2101967468227797,0.3194778677167651
1838,0.1884,28,129,28,475091,130519,46650,61306,1.2090018155544853,0.31959337938224947
1839,0.1885,34,119,34,475210,130400,46684,61272,1.2078995146170661,0.31967110480404026
1840,0.1886,20,127,20,475337,130273,46704,61252,1.2067231094149469,0.31981203498237826
1841,0.1887,33,114,33,475451,130159,46737,61219,1.2056671236429657,0.3198852532684008
1842,0.1888,21,121,21,475572,130038,46758,61198,1.2045462966393716,0.32001296826957265
1843,0.1889,37,115,37,475687,129923,46795,61161,1.2034810478343028,0.32007389420359633
1844,0.189,24,142,24,475829,129781,46819,61137,1.20216569713587,0.3202264846688107
1845,0.1891,24,134,24,475963,129647,46843,61113,1.200924450702138,0.32036590480184524
1846,0.1892,31,137,31,476100,129510,46874,61082,1.199655415169143,0.3204856447280054
1847,0.1893,20,124,20,476224,129386,46894,61062,1.1985067990662863,0.32062295219692516
1848,0.1894,29,132,29,476356,129254,46923,61033,1.197284078698729,0.32074182681948843
1849,0.1895,28,132,28,476488,129122,46951,61005,1.1960613583311719,0.3208644747984242
1850,0.1896,18,114,18,476602,129008,46969,60987,1.1950053725591907,0.32099265770151847
1851,0.1897,43,120,43,476722,128888,47012,60944,1.1938938085886843,0.3210417632432888
1852,0.1898,31,117,31,476839,128771,47043,60913,1.1928100337174405,0.32112882478226945
1853,0.1899,30,118,30,476957,128653,47073,60883,1.191716995813109,0.32122129832854973
1854,0.19,32,121,32,477078,128532,47105,60851,1.190596168809515,0.32131183897181903
1855,0.1901,34,111,34,477189,128421,47139,60817,1.1895679721367964,0.32137837009480125
1856,0.1902,32,120,32,477309,128301,47171,60785,1.18845640816629,0.3214674804057413
1857,0.1903,35,116,35,477425,128185,47206,60750,1.1873818963281337,0.32153915367719055
1858,0.1904,35,111,35,477536,128074,47241,60715,1.1863536996554152,0.3216024238700348
1859,0.1905,30,119,30,477655,127955,47271,60685,1.1852513987179962,0.3216974130619169
1860,0.1906,36,115,36,477770,127840,47307,60649,1.1841861499129276,0.32176413477709576
1861,0.1907,33,110,33,477880,127730,47340,60616,1.1831672162732965,0.32183322183640745
1862,0.1908,21,120,21,478000,127610,47361,60595,1.18205565230279,0.3219627533806222
1863,0.1909,19,112,19,478112,127498,47380,60576,1.181018192596984,0.3220859874304795
1864,0.191,26,120,26,478232,127378,47406,60550,1.1799066286264774,0.32219786301136605
1865,0.1911,24,123,24,478355,127255,47430,60526,1.1787672755567082,0.3223222796768576
1866,0.1912,38,133,38,478488,127122,47468,60488,1.1775352921560636,0.3224135174031235
1867,0.1913,37,129,37,478617,126993,47505,60451,1.1763403608877692,0.3225016538272764
1868,0.1914,28,109,28,478726,126884,47533,60423,1.1753306902812257,0.32258805063345203
1869,0.1915,31,117,31,478843,126767,47564,60392,1.174246915409982,0.32267750949727236
1870,0.1916,38,123,38,478966,126644,47602,60354,1.1731075623402127,0.3227521149958823
1871,0.1917,19,130,19,479096,126514,47621,60335,1.1719033680388307,0.3229078025571451
1872,0.1918,32,112,32,479208,126402,47653,60303,1.1708659083330246,0.3229854583433759
1873,0.1919,32,116,32,479324,126286,47685,60271,1.1697913964948683,0.3230701608623638
1874,0.192,27,125,27,479449,126161,47712,60244,1.168633517358924,0.32318875566642524
1875,0.1921,27,109,27,479558,126052,47739,60217,1.1676238467523805,0.3232797728017008
1876,0.1922,37,130,37,479688,125922,47776,60180,1.1664196524509987,0.3233710545829706
1877,0.1923,28,121,28,479809,125801,47804,60152,1.1652988254474046,0.32347958892838513
1878,0.1924,36,95,36,479904,125706,47840,60116,1.164418837304087,0.3235139003993069
1879,0.1925,28,127,28,480031,125579,47868,60088,1.1632424321019674,0.32363317121513246
1880,0.1926,27,124,27,480155,125455,47895,60061,1.1620938159991108,0.32375105112227515
1881,0.1927,32,111,32,480266,125344,47927,60029,1.1610656193263922,0.3238281734664703
1882,0.1928,26,121,26,480387,125223,47953,60003,1.1599447923227981,0.32394480256551456
1883,0.1929,34,104,34,480491,125119,47987,59969,1.1589814368816926,0.3240026365836791
1884,0.193,25,141,25,480632,124978,48012,59944,1.1576753492163474,0.3241582937671018
1885,0.1931,32,116,32,480748,124862,48044,59912,1.156600837378191,0.3242447530496715
1886,0.1932,27,92,27,480840,124770,48071,59885,1.1557486383341362,0.32430749235059975
1887,0.1933,32,136,32,480976,124634,48103,59853,1.1544888658342287,0.3244293635865942
1888,0.1934,38,103,38,481079,124531,48141,59815,1.1535347734262107,0.32447137448059626
1889,0.1935,29,110,29,481189,124421,48170,59786,1.1525158397865798,0.3245587844110159
1890,0.1936,27,120,27,481309,124301,48197,59759,1.1514042758160732,0.32467130283603174
1891,0.1937,26,127,26,481436,124174,48223,59733,1.150227870613954,0.3248000348001979
1892,0.1938,27,112,27,481548,124062,48250,59706,1.1491904109081477,0.3248987854251012
1893,0.1939,27,98,27,481646,123964,48277,59679,1.1482826336655674,0.3249729093948585
1894,0.194,18,101,18,481747,123863,48295,59661,1.1473470673237245,0.32508554739434625
1895,0.1941,33,101,33,481848,123762,48328,59628,1.1464115009818816,0.32514313757565844
1896,0.1942,28,124,28,481972,123638,48356,59600,1.1452628848790247,0.32526004431395233
1897,0.1943,30,118,30,482090,123520,48386,59570,1.1441698469746935,0.3253591130045333
1898,0.1944,32,112,32,482202,123408,48418,59538,1.1431323872688872,0.32544029385720374
1899,0.1945,40,107,40,482309,123301,48458,59498,1.1421412427285191,0.3254831809802023
1900,0.1946,33,121,33,482430,123180,48491,59465,1.141020415724925,0.32557693887048644
1901,0.1947,26,96,26,482526,123084,48517,59439,1.1401311645485197,0.3256521095971467
1902,0.1948,34,128,34,482654,122956,48551,59405,1.1389454963133128,0.32575495857118575
1903,0.1949,28,111,28,482765,122845,48579,59377,1.1379172996405944,0.3258497876216922
1904,0.195,26,109,26,482874,122736,48605,59351,1.136907629034051,0.32594858501705226
1905,0.1951,37,116,37,482990,122620,48642,59314,1.1358331171958946,0.3260193256895358
1906,0.1952,32,105,32,483095,122515,48674,59282,1.1348604987217015,0.3260889893672613
1907,0.1953,23,107,23,483202,122408,48697,59259,1.1338693541813332,0.3261957317509509
1908,0.1954,26,101,26,483303,122307,48723,59233,1.13293378783949,0.32628070948551285
1909,0.1955,33,106,33,483409,122201,48756,59200,1.1319519063322094,0.326348807338438
1910,0.1956,27,126,27,483535,122075,48783,59173,1.1307847641631776,0.3264753266242938
1911,0.1957,27,114,27,483649,121961,48810,59146,1.1297287783911965,0.3265804193101316
1912,0.1958,30,119,30,483768,121842,48840,59116,1.1286264774537775,0.32668353982692117
1913,0.1959,29,111,29,483879,121731,48869,59087,1.127598280781059,0.32677609530024665
1914,0.196,29,124,29,484003,121607,48898,59058,1.1264496646782023,0.3268923145047464
1915,0.1961,37,113,37,484116,121494,48935,59021,1.1254029419393086,0.3269589784782428
1916,0.1962,23,113,23,484229,121381,48958,58998,1.124356219200415,0.32707798579657277
1917,0.1963,26,130,26,484359,121251,48984,58972,1.123152024899033,0.3272168369187063
1918,0.1964,29,102,29,484461,121149,49013,58943,1.1222071955241024,0.32729382759922704
1919,0.1965,29,111,29,484572,121038,49042,58914,1.1211789988513838,0.3273873032808749
1920,0.1966,39,109,39,484681,120929,49081,58875,1.1201693282448404,0.3274398789793331
1921,0.1967,36,107,36,484788,120822,49117,58839,1.119178183704472,0.32750012523586086
1922,0.1968,33,114,33,484902,120708,49150,58806,1.1181221979324911,0.3275844780908453
1923,0.1969,44,120,44,485022,120588,49194,58762,1.1170106339619845,0.32763869528854195
1924,0.197,29,114,29,485136,120474,49223,58733,1.1159546481900033,0.327738313793546
1925,0.1971,22,111,22,485247,120363,49245,58711,1.1149264515172848,0.3278588739850565
1926,0.1972,28,116,28,485363,120247,49273,58683,1.1138519396791284,0.3279662437824848
1927,0.1973,30,124,30,485487,120123,49303,58653,1.1127033235762718,0.3280809504631494
1928,0.1974,34,110,34,485597,120013,49337,58619,1.1116843899366409,0.328155089793542
1929,0.1975,26,120,26,485717,119893,49363,58593,1.1105728259661343,0.32827784812254185
1930,0.1976,32,139,32,485856,119754,49395,58561,1.1092852643669644,0.32841320135714885
1931,0.1977,37,106,37,485962,119648,49432,58524,1.1083033828596836,0.3284691197270054
1932,0.1978,37,96,37,486058,119552,49469,58487,1.1074141316832784,0.3285066755036818
1933,0.1979,36,118,36,486176,119434,49505,58451,1.106321093778947,0.3285886949433623
1934,0.198,30,118,30,486294,119316,49535,58421,1.1052280558746155,0.328693519075938
1935,0.1981,27,101,27,486395,119215,49562,58394,1.1042924895327726,0.3287783839782894
1936,0.1982,29,110,29,486505,119105,49591,58365,1.1032735558931417,0.32887248549050546
1937,0.1983,38,123,38,486628,118982,49629,58327,1.1021342028233725,0.3289567929433926
1938,0.1984,26,111,26,486739,118871,49655,58301,1.101106006150654,0.3290644119838349
1939,0.1985,40,115,40,486854,118756,49695,58261,1.1000407573455853,0.32912658106283577
1940,0.1986,34,119,34,486973,118637,49729,58227,1.0989384564081663,0.3292190609734033
1941,0.1987,23,125,23,487098,118512,49752,58204,1.097780577272222,0.32936463025419316
1942,0.1988,32,113,32,487211,118399,49784,58172,1.0967338545333285,0.3294538740789824
1943,0.1989,28,111,28,487322,118288,49812,58144,1.09570565786061,0.3295547293008071
1944,0.199,20,120,20,487442,118168,49832,58124,1.0945940938901033,0.3297029927620085
1945,0.1991,30,115,30,487557,118053,49862,58094,1.0935288450850347,0.3298040840888576
1946,0.1992,30,106,30,487663,117947,49892,58064,1.0925469635777538,0.32988847287953593
1947,0.1993,30,109,30,487772,117838,49922,58034,1.0915372929712104,0.3299786208151383
1948,0.1994,25,103,25,487875,117735,49947,58009,1.0905832005631924,0.3300767024763292
1949,0.1995,35,107,35,487982,117628,49982,57974,1.089592056022824,0.330144303595631
1950,0.1996,34,115,34,488097,117513,50016,57940,1.0885268072177554,0.33023088804409156
1951,0.1997,20,125,20,488222,117388,50036,57920,1.087368928081811,0.33038994227302804
1952,0.1998,25,113,25,488335,117275,50061,57895,1.0863222053429176,0.3305075069932066
1953,0.1999,27,112,27,488447,117163,50088,57868,1.0852847456371115,0.33061571950111696
1954,0.2,26,107,26,488554,117056,50114,57842,1.0842936010967432,0.33071847591167425
1955,0.2001,30,104,30,488658,116952,50144,57812,1.0833302456556375,0.3308003936737543
1956,0.2002,28,110,28,488768,116842,50172,57784,1.0823113120160066,0.3309014694260878
1957,0.2003,31,116,31,488884,116726,50203,57753,1.0812368001778503,0.33100258483829
1958,0.2004,23,122,23,489006,116604,50226,57730,1.0801067101411685,0.33114596120091316
1959,0.2005,32,111,32,489117,116493,50258,57698,1.0790785134684502,0.33123410509153745
1960,0.2006,35,105,35,489222,116388,50293,57663,1.078105894994257,0.3312994467138942
1961,0.2007,23,115,23,489337,116273,50316,57640,1.0770406461891882,0.33143008285752074
1962,0.2008,27,115,27,489452,116158,50343,57613,1.0759753973841195,0.3315455398196477
1963,0.2009,42,119,42,489571,116039,50385,57571,1.0748730964467006,0.3316110823109268
1964,0.201,31,129,31,489700,115910,50416,57540,1.073678165178406,0.3317382530988758
1965,0.2011,27,102,27,489802,115808,50443,57513,1.0727333358034754,0.331829380167435
1966,0.2012,26,108,26,489910,115700,50469,57487,1.0717329282300196,0.33193599981522864
1967,0.2013,27,99,27,490009,115601,50496,57460,1.0708158879543517,0.3320216571035646
1968,0.2014,34,110,34,490119,115491,50530,57426,1.0697969543147208,0.3321015284789812
1969,0.2015,29,96,29,490215,115395,50559,57397,1.0689077031383156,0.3321739432381129
1970,0.2016,34,106,34,490321,115289,50593,57363,1.0679258216310348,0.3322463684173945
1971,0.2017,20,136,20,490457,115153,50613,57343,1.0666660491311275,0.33243089694833505
1972,0.2018,34,110,34,490567,115043,50647,57309,1.0656471154914966,0.33251137207575193
1973,0.2019,35,103,35,490670,114940,50682,57274,1.0646930230834784,0.3325745874319161
1974,0.202,32,113,32,490783,114827,50714,57242,1.0636463003445848,0.332668871208643
1975,0.2021,16,89,16,490872,114738,50730,57226,1.0628218903997926,0.33277895373450256
1976,0.2022,34,113,34,490985,114625,50764,57192,1.0617751676608989,0.33286578161648733
1977,0.2023,22,103,22,491088,114522,50786,57170,1.0608210752528808,0.33297998741933227
1978,0.2024,23,109,23,491197,114413,50809,57147,1.0598114046463374,0.3331021217066915
1979,0.2025,30,103,30,491300,114310,50839,57117,1.0588573122383194,0.3331855542009135
1980,0.2026,34,116,34,491416,114194,50873,57083,1.057782800400163,0.33327884070832625
1981,0.2027,29,87,29,491503,114107,50902,57054,1.056976916521546,0.33333528081747593
1982,0.2028,17,110,17,491613,113997,50919,57037,1.0559579828819148,0.3334834009612124
1983,0.2029,23,104,23,491717,113893,50942,57014,1.0549946274408093,0.33359663442691057
1984,0.203,22,115,22,491832,113778,50964,56992,1.0539293786357404,0.33373543362417285
1985,0.2031,29,129,29,491961,113649,50993,56963,1.052734447367446,0.33387452230792675
1986,0.2032,29,92,29,492053,113557,51022,56934,1.051882248323391,0.3339413810699685
1987,0.2033,31,106,31,492159,113451,51053,56903,1.0509003668161103,0.3340279652957958
1988,0.2034,26,114,26,492273,113337,51079,56877,1.0498443810441291,0.334149952412845
1989,0.2035,32,95,32,492368,113242,51111,56845,1.0489643929008114,0.33421131538565557
1990,0.2036,31,104,31,492472,113138,51142,56814,1.0480010374597057,0.3342943890039541
1991,0.2037,28,106,28,492578,113032,51170,56786,1.0470191559524251,0.3343932916416399
1992,0.2038,25,97,25,492675,112935,51195,56761,1.0461206417429323,0.3344863756364322
1993,0.2039,32,103,32,492778,112832,51227,56729,1.0451665493349143,0.3345639622318812
1994,0.204,31,112,31,492890,112720,51258,56698,1.0441290896291082,0.33466337697293086
1995,0.2041,37,98,37,492988,112622,51295,56661,1.043221312386528,0.33471169579934196
1996,0.2042,32,94,32,493082,112528,51327,56629,1.0423505872762977,0.33477183917898756
1997,0.2043,28,107,28,493189,112421,51355,56601,1.0413594427359294,0.33487356675462365
1998,0.2044,29,102,29,493291,112319,51384,56572,1.0404146133609988,0.33496160245365353
1999,0.2045,28,99,28,493390,112220,51412,56544,1.039497573085331,0.33504775900073475
2000,0.2046,23,105,23,493495,112115,51435,56521,1.038524954611138,0.3351656822979672
2001,0.2047,31,103,31,493598,112012,51466,56490,1.03757086220312,0.3352482463116165
2002,0.2048,25,96,25,493694,111916,51491,56465,1.0366816110267145,0.33534068570681963
2003,0.2049,29,101,29,493795,111815,51520,56436,1.0357460446848716,0.335427426880078
2004,0.205,20,110,20,493905,111705,51540,56416,1.0347271110452407,0.335567835071169
2005,0.2051,26,109,26,494014,111596,51566,56390,1.0337174404386973,0.33568273546605076
2006,0.2052,25,121,25,494135,111475,51591,56365,1.0325966134351032,0.33582578646329836
2007,0.2053,25,103,25,494238,111372,51616,56340,1.0316425210270852,0.33593302804808245
2008,0.2054,27,92,27,494330,111280,51643,56313,1.0307903219830301,0.33601045389723916
2009,0.2055,22,120,22,494450,111160,51665,56291,1.0296787580125237,0.3361640121587808
2010,0.2056,22,81,22,494531,111079,51687,56269,1.0289284523324318,0.33623945311566317
2011,0.2057,28,102,28,494633,110977,51715,56241,1.0279836229575012,0.3363334090827543
2012,0.2058,22,91,22,494724,110886,51737,56219,1.0271406869465338,0.3364291912270728
2013,0.2059,27,92,27,494816,110794,51764,56192,1.0262884879024787,0.3365072521049669
2014,0.206,28,106,28,494922,110688,51792,56164,1.025306606395198,0.33660969002469254
2015,0.2061,32,102,32,495024,110586,51824,56132,1.0243617770202675,0.3366883000035989
2016,0.2062,28,88,28,495112,110498,51852,56104,1.0235466301085627,0.33675466080839367
2017,0.2063,35,110,35,495222,110388,51887,56069,1.0225276964689318,0.3368377418792841
2018,0.2064,18,94,18,495316,110294,51905,56051,1.0216569713587016,0.3369563257086176
2019,0.2065,28,97,28,495413,110197,51933,56023,1.020758457149209,0.337041270605222
2020,0.2066,32,87,32,495500,110110,51965,55991,1.0199525732705916,0.3370900837442279
2021,0.2067,31,88,31,495588,110022,51996,55960,1.019137426358887,0.33714499162559797
2022,0.2068,29,99,29,495687,109923,52025,55931,1.018220386083219,0.33723033511401596
2023,0.2069,21,105,21,495792,109818,52046,55910,1.017247767609026,0.33736001158524814
2024,0.207,23,87,23,495879,109731,52069,55887,1.0164418837304088,0.33744520523131544
2025,0.2071,38,99,38,495978,109632,52107,55849,1.0155248434547408,0.3374949389960177
2026,0.2072,31,96,31,496074,109536,52138,55818,1.0146355922783357,0.33756667513335026
2027,0.2073,30,98,30,496172,109438,52168,55788,1.0137278150357554,0.33764661736046386
2028,0.2074,28,103,28,496275,109335,52196,55760,1.0127737226277371,0.33774493473454675
2029,0.2075,28,88,28,496363,109247,52224,55732,1.0119585757160325,0.33781269131222763
2030,0.2076,21,87,21,496450,109160,52245,55711,1.0111526918374152,0.33790660577057213
2031,0.2077,34,84,34,496534,109076,52279,55677,1.0103745970580607,0.337942252948353
2032,0.2078,29,95,29,496629,108981,52308,55648,1.009494608914743,0.3380206403489057
2033,0.2079,31,98,31,496727,108883,52339,55617,1.0085868316721627,0.33809726443768995
2034,0.208,21,102,21,496829,108781,52360,55596,1.007642002297232,0.3382225007148202
2035,0.2081,27,117,27,496946,108664,52387,55569,1.0065582274259883,0.3383546546674542
2036,0.2082,25,113,25,497059,108551,52412,55544,1.0055115046870948,0.3384868521283403
2037,0.2083,21,105,21,497164,108446,52433,55523,1.0045388862129017,0.33861888527709505
2038,0.2084,27,100,27,497264,108346,52460,55496,1.0036125829041462,0.33871656840126463
2039,0.2085,26,124,26,497388,108222,52486,55470,1.0024639668012894,0.3388681181731545
2040,0.2086,26,89,26,497477,108133,52512,55444,1.001639556856497,0.3389474070315509
2041,0.2087,24,95,24,497572,108038,52536,55420,1.0007595687131794,0.3390473393776995
2042,0.2088,23,92,23,497664,107946,52559,55397,0.9999073696691244,0.3391452342616457
2043,0.2089,37,92,37,497756,107854,52596,55360,0.9990551706250694,0.33918658938571444
2044,0.209,25,107,25,497863,107747,52621,55335,0.9980640260847011,0.33930783286935406
2045,0.2091,31,110,31,497973,107637,52652,55304,0.9970450924450702,0.3394111979182649
2046,0.2092,37,88,37,498061,107549,52689,55267,0.9962299455333654,0.339444526336478
2047,0.2093,30,91,30,498152,107458,52719,55237,0.995387009522398,0.33951258489812225
2048,0.2094,25,103,25,498255,107355,52744,55212,0.99443291711438,0.33962612338297443
2049,0.2095,35,118,35,498373,107237,52779,55177,0.9933398792100485,0.3397305650990678
2050,0.2096,24,88,24,498461,107149,52803,55153,0.9925247322983438,0.33981713102734407
2051,0.2097,30,105,30,498566,107044,52833,55123,0.9915521138241505,0.33991502586839495
2052,0.2098,29,97,29,498663,106947,52862,55094,0.9906535996146578,0.34000037027665836
2053,0.2099,22,102,22,498765,106845,52884,55072,0.9897087702397273,0.3401248787959263
2054,0.21,25,98,25,498863,106747,52909,55047,0.988800992997147,0.34022893308775354
2055,0.2101,31,103,31,498966,106644,52940,55016,0.9878469005891289,0.34031918842014103
2056,0.2102,27,104,27,499070,106540,52967,54989,0.9868835451480232,0.3404280345944072
2057,0.2103,18,116,18,499186,106424,52985,54971,0.985809033309867,0.34059915115090306
2058,0.2104,15,86,15,499272,106338,53000,54956,0.9850124124643374,0.3407194315969596
2059,0.2105,32,103,32,499375,106235,53032,54924,0.9840583200563192,0.34080628447682104
2060,0.2106,23,98,23,499473,106137,53055,54901,0.9831505428137389,0.3409195345198028
2061,0.2107,29,96,29,499569,106041,53084,54872,0.9822612916373338,0.34100414509704
2062,0.2108,31,119,31,499688,105922,53115,54841,0.9811589906999147,0.34112948875052096
2063,0.2109,35,126,35,499814,105796,53150,54806,0.979991848530883,0.3412535335799056
2064,0.211,29,102,29,499916,105694,53179,54777,0.9790470191559524,0.3413513968255947
2065,0.2111,20,77,20,499993,105617,53199,54757,0.9783337656082107,0.3414331500118473
2066,0.2112,29,104,29,500097,105513,53228,54728,0.9773704101671051,0.34153556205964763
2067,0.2113,45,70,45,500167,105443,53273,54683,0.9767219978509764,0.34149981889262204
2068,0.2114,40,87,40,500254,105356,53313,54643,0.9759161139723591,0.34152088450552814
2069,0.2115,28,87,28,500341,105269,53341,54615,0.9751102300937419,0.3415914037677316
2070,0.2116,29,103,29,500444,105166,53370,54586,0.9741561376857238,0.341692122790325
2071,0.2117,33,105,33,500549,105061,53403,54553,0.9731835192115307,0.34178079617076196
2072,0.2118,28,103,28,500652,104958,53431,54525,0.9722294268035125,0.3418859690374523
2073,0.2119,21,85,21,500737,104873,53452,54504,0.9714420689910704,0.34198159081925245
2074,0.212,17,110,17,500847,104763,53469,54487,0.9704231353514394,0.34214756671899527
2075,0.2121,31,94,31,500941,104669,53500,54456,0.9695524102412094,0.3422215239591516
2076,0.2122,31,102,31,501043,104567,53531,54425,0.9686075808662788,0.3423128207708564
2077,0.2123,36,80,36,501123,104487,53567,54389,0.9678665382192745,0.34233616153478186
2078,0.2124,26,94,26,501217,104393,53593,54363,0.9669958131090445,0.34243115220842046
2079,0.2125,24,87,24,501304,104306,53617,54339,0.9661899292304272,0.34251946169119735
2080,0.2126,28,94,28,501398,104212,53645,54311,0.9653192041201971,0.3426064356591788
2081,0.2127,14,100,14,501498,104112,53659,54297,0.9643929008114417,0.34276461564683824
2082,0.2128,21,107,21,501605,104005,53680,54276,0.9634017562710734,0.3429091299650621
2083,0.2129,26,96,26,501701,103909,53706,54250,0.9625125050946682,0.3430092501849405
2084,0.213,35,86,35,501787,103823,53741,54215,0.9617158842491386,0.34305040559865346
2085,0.2131,36,98,36,501885,103725,53777,54179,0.9608081070065583,0.3431135373391428
2086,0.2132,33,99,33,501984,103626,53810,54146,0.9598910667308903,0.34319144081332553
2087,0.2133,27,95,27,502079,103531,53837,54119,0.9590110785875727,0.3432857595940374
2088,0.2134,22,98,22,502177,103433,53859,54097,0.9581033013449924,0.34340760490065386
2089,0.2135,32,98,32,502275,103335,53891,54065,0.957195524102412,0.34348792884371027
2090,0.2136,26,106,26,502381,103229,53917,54039,0.9562136425951313,0.3436109062237709
2091,0.2137,32,97,32,502478,103132,53949,54007,0.9553151283856386,0.343689345102107
2092,0.2138,35,92,35,502570,103040,53984,53972,0.9544629293415836,0.34374442717754056
2093,0.2139,31,93,31,502663,102947,54015,53941,0.9536014672644411,0.3438185202182449
2094,0.214,26,101,26,502764,102846,54041,53915,0.9526659009225981,0.3439312073793864
2095,0.2141,35,105,35,502869,102741,54076,53880,0.9516932824484049,0.344015170379451
2096,0.2142,14,98,14,502967,102643,54090,53866,0.9507855052058246,0.34417190065747016
2097,0.2143,25,92,25,503059,102551,54115,53841,0.9499333061617696,0.3442695278530871
2098,0.2144,24,86,24,503145,102465,54139,53817,0.94913668531624,0.34435827542519293
2099,0.2145,21,91,21,503236,102374,54160,53796,0.9482937493052725,0.3444707690337453
2100,0.2146,17,95,17,503331,102279,54177,53779,0.9474137611619549,0.3446090556075305
2101,0.2147,31,96,31,503427,102183,54208,53748,0.9465245099855497,0.3446909209842815
2102,0.2148,23,90,23,503517,102093,54231,53725,0.9456908370076698,0.3447932844729107
2103,0.2149,22,87,22,503604,102006,54253,53703,0.9448849531290526,0.3448933587653893
2104,0.215,31,94,31,503698,101912,54284,53672,0.9440142280188225,0.34497120526532293
2105,0.2151,31,113,31,503811,101799,54315,53641,0.9429675052799289,0.34509135357694287
2106,0.2152,30,85,30,503896,101714,54345,53611,0.9421801474674868,0.34515370996298084
2107,0.2153,24,78,24,503974,101636,54369,53587,0.9414576308866576,0.3452259008007834
2108,0.2154,24,120,24,504094,101516,54393,53563,0.9403460669161511,0.34539170358333493
2109,0.2155,27,107,27,504201,101409,54420,53536,0.9393549223757828,0.34551615089225207
2110,0.2156,26,110,26,504311,101299,54446,53510,0.9383359887361518,0.3456517385940094
2111,0.2157,28,89,28,504400,101210,54474,53482,0.9375115787913595,0.3457321645592532
2112,0.2158,23,92,23,504492,101118,54497,53459,0.9366593797473045,0.3458405843042626
2113,0.2159,31,85,31,504577,101033,54528,53428,0.9358720219348623,0.34589961219984333
2114,0.216,37,84,37,504661,100949,54565,53391,0.9350939271555078,0.3459310612932487
2115,0.2161,23,104,23,504765,100845,54588,53368,0.9341305717144022,0.3460668037065617
2116,0.2162,39,82,39,504847,100763,54627,53329,0.9333710030012227,0.34608545544220337
2117,0.2163,24,106,24,504953,100657,54651,53305,0.9323891214939419,0.34622179498837374
2118,0.2164,26,87,26,505040,100570,54677,53279,0.9315832376153248,0.34630709331877363
2119,0.2165,35,91,35,505131,100479,54712,53244,0.9307403016043573,0.346363263792666
2120,0.2166,30,91,30,505222,100388,54742,53214,0.9298973655933899,0.34644080155206314
2121,0.2167,15,81,15,505303,100307,54757,53199,0.929147059913298,0.34655974359308434
2122,0.2168,29,100,29,505403,100207,54786,53170,0.9282207566045426,0.3466621462148823
2123,0.2169,28,93,28,505496,100114,54814,53142,0.9273592945274001,0.3467531450644673
2124,0.217,24,98,24,505594,100016,54838,53118,0.9264515172848198,0.34687267360612273
2125,0.2171,28,83,28,505677,99933,54866,53090,0.9256826855385527,0.3469413094763532
2126,0.2172,30,86,30,505763,99847,54896,53060,0.924886064693023,0.3470083122420818
2127,0.2173,23,84,23,505847,99763,54919,53037,0.9241079699136685,0.34710078534031413
2128,0.2174,24,75,24,505922,99688,54943,53013,0.923413242432102,0.3471686498451222
2129,0.2175,28,82,28,506004,99606,54971,52985,0.9226536737189225,0.34723542017550185
2130,0.2176,24,101,24,506105,99505,54995,52961,0.9217181073770796,0.34736269069825404
2131,0.2177,28,95,28,506200,99410,55023,52933,0.9208381192337619,0.34745935159475655
2132,0.2178,24,73,24,506273,99337,55047,52909,0.9201619178183704,0.3475230876344863
2133,0.2179,28,95,28,506368,99242,55075,52881,0.9192819296750528,0.3476200180117405
2134,0.218,28,82,28,506450,99160,55103,52853,0.9185223609618733,0.3476873688434542
2135,0.2181,29,84,29,506534,99076,55132,52824,0.9177442661825188,0.34775510204081633
2136,0.2182,29,105,29,506639,98971,55161,52795,0.9167716477083256,0.34787106466534007
2137,0.2183,27,103,27,506742,98868,55188,52768,0.9158175553003075,0.3479912421852331
2138,0.2184,18,93,18,506835,98775,55206,52750,0.914956093223165,0.34812737172083813
2139,0.2185,36,90,36,506925,98685,55242,52714,0.9141224202452851,0.34817931426231347
2140,0.2186,25,97,25,507022,98588,55267,52689,0.9132239060357924,0.3482948498449864
2141,0.2187,32,90,32,507112,98498,55299,52657,0.9123902330579124,0.34836426185041847
2142,0.2188,19,102,19,507214,98396,55318,52638,0.911445403682982,0.3485175523392084
2143,0.2189,21,91,21,507305,98305,55339,52617,0.9106024676720145,0.34863704430102965
2144,0.219,24,89,24,507394,98216,55363,52593,0.9097780577272222,0.3487391336060845
2145,0.2191,30,84,30,507478,98132,55393,52563,0.9089999629478677,0.34880387537741797
2146,0.2192,20,77,20,507555,98055,55413,52543,0.908286709400126,0.3488957356671403
2147,0.2193,29,97,29,507652,97958,55442,52514,0.9073881951906332,0.34899516189058427
2148,0.2194,27,96,27,507748,97862,55469,52487,0.906498944014228,0.34910109146053514
2149,0.2195,16,87,16,507835,97775,55485,52471,0.9056930601356108,0.34923392303289275
2150,0.2196,30,90,30,507925,97685,55515,52441,0.904859387157731,0.3493132435420913
2151,0.2197,27,80,27,508005,97605,55542,52414,0.9041183445107266,0.34938241156120226
2152,0.2198,33,79,33,508084,97526,55575,52381,0.9033865648968098,0.34942330911832004
2153,0.2199,29,100,29,508184,97426,55604,52352,0.9024602615880544,0.34953063867857764
2154,0.22,20,86,20,508270,97340,55624,52332,0.9016636407425247,0.3496445560959966
2155,0.2201,27,99,27,508369,97241,55651,52305,0.9007466004668568,0.3497586027041847
2156,0.2202,19,77,19,508446,97164,55670,52286,0.9000333469191152,0.3498561391769823
2157,0.2203,30,88,30,508534,97076,55700,52256,0.8992182000074104,0.34993169581871264
2158,0.2204,21,81,21,508615,96995,55721,52235,0.8984678943273186,0.35003015479461236
2159,0.2205,28,78,28,508693,96917,55749,52207,0.8977453777464893,0.35009119927040583
2160,0.2206,24,99,24,508792,96818,55773,52183,0.8968283374708215,0.3502191260461339
2161,0.2207,24,101,24,508893,96717,55797,52159,0.8958927711289785,0.3503519707676187
2162,0.2208,27,112,27,509005,96605,55824,52132,0.8948553114231724,0.35049785863638505
2163,0.2209,32,79,32,509084,96526,55856,52100,0.8941235318092556,0.350544319298104
2164,0.221,19,96,19,509180,96430,55875,52081,0.8932342806328504,0.3506878278376686
2165,0.2211,34,77,34,509257,96353,55909,52047,0.8925210270851087,0.3507210242587601
2166,0.2212,30,95,30,509352,96258,55939,52017,0.8916410389417911,0.3508143651997977
2167,0.2213,25,67,25,509419,96191,55964,51992,0.891020415724925,0.3508634593711829
2168,0.2214,23,92,23,509511,96099,55987,51969,0.89016821668087,0.35098063052111195
2169,0.2215,25,73,25,509584,96026,56012,51944,0.8894920152654785,0.35104413056700684
2170,0.2216,25,90,25,509674,95936,56037,51919,0.8886583422875987,0.35114808427175276
2171,0.2217,26,88,26,509762,95848,56063,51893,0.8878431953758938,0.35124305372239256
2172,0.2218,31,109,31,509871,95739,56094,51862,0.8868335247693505,0.3513661831559407
2173,0.2219,28,110,28,509981,95629,56122,51834,0.8858145911297195,0.35150512331906986
2174,0.222,30,87,30,510068,95542,56152,51804,0.8850087072511023,0.3515806333392152
2175,0.2221,25,82,25,510150,95460,56177,51779,0.8842491385379229,0.35166633840218964
2176,0.2222,25,95,25,510245,95365,56202,51754,0.8833691503946052,0.3517832502939797
2177,0.2223,22,93,22,510338,95272,56224,51732,0.8825076883174626,0.35190879159750754
2178,0.2224,21,86,21,510424,95186,56245,51711,0.8817110674719331,0.3520221651905757
2179,0.2225,22,93,22,510517,95093,56267,51689,0.8808496053947905,0.3521480835524792
2180,0.2226,20,69,20,510586,95024,56287,51669,0.8802104561117492,0.352225395894828
2181,0.2227,23,70,23,510656,94954,56310,51646,0.8795620437956204,0.35229195088676674
2182,0.2228,27,66,27,510722,94888,56337,51619,0.8789506836118418,0.35233128792480906
2183,0.2229,24,92,24,510814,94796,56361,51595,0.8780984845677868,0.3524465301828664
2184,0.223,33,74,33,510888,94722,56394,51562,0.8774130201193079,0.3524787399852342
2185,0.2231,20,93,20,510981,94629,56414,51542,0.8765515580421653,0.3526144036778841
2186,0.2232,22,77,22,511058,94552,56436,51520,0.8758383044944237,0.35270277671285394
2187,0.2233,31,79,31,511137,94473,56467,51489,0.8751065248805069,0.35275619681834997
2188,0.2234,30,79,30,511216,94394,56497,51459,0.8743747452665901,0.3528141347795383
2189,0.2235,29,82,29,511298,94312,56526,51430,0.8736151765534107,0.3528838632652221
2190,0.2236,32,71,32,511369,94241,56558,51398,0.8729575012041944,0.3529137112998579
2191,0.2237,25,90,25,511459,94151,56583,51373,0.8721238282263144,0.35302080756438803
2192,0.2238,42,85,42,511544,94066,56625,51331,0.8713364704138723,0.35304029656732944
2193,0.2239,28,85,28,511629,93981,56653,51303,0.8705491126014302,0.35312216073346
2194,0.224,20,85,20,511714,93896,56673,51283,0.8697617547889881,0.35323979363406555
2195,0.2241,23,86,23,511800,93810,56696,51260,0.8689651339434584,0.353346660232991
2196,0.2242,23,79,23,511879,93731,56719,51237,0.8682333543295416,0.35343662049555763
2197,0.2243,32,78,32,511957,93653,56751,51205,0.8675108377487124,0.35348410167198224
2198,0.2244,27,81,27,512038,93572,56778,51178,0.8667605320686206,0.3535613126079447
2199,0.2245,31,83,31,512121,93489,56809,51147,0.8659917003223535,0.3536256533643076
2200,0.2246,39,77,39,512198,93412,56848,51108,0.8652784467746119,0.35363963465264325
2201,0.2247,17,80,17,512278,93332,56865,51091,0.8645374041276075,0.3537594427480387
2202,0.2248,30,83,30,512361,93249,56895,51061,0.8637685723813405,0.35382856350911235
2203,0.2249,25,95,25,512456,93154,56920,51036,0.862888584238023,0.3539496497676677
2204,0.225,26,89,26,512545,93065,56946,51010,0.8620641742932306,0.35405170917924694
2205,0.2251,28,70,28,512615,92995,56974,50982,0.8614157619771018,0.3540982240218924
2206,0.2252,25,75,25,512690,92920,56999,50957,0.8607210344955352,0.35417057625610765
2207,0.2253,17,83,17,512773,92837,57016,50940,0.8599522027492682,0.3542986708583431
2208,0.2254,39,73,39,512846,92764,57055,50901,0.8592760013338767,0.35430341419274003
2209,0.2255,30,60,30,512906,92704,57085,50871,0.8587202193486235,0.3543165592895699
2210,0.2256,27,82,27,512988,92622,57112,50844,0.857960650635444,0.35439755760946845
2211,0.2257,27,82,27,513070,92540,57139,50817,0.8572010819222646,0.35447867910182274
2212,0.2258,11,66,11,513136,92474,57150,50806,0.856589721738486,0.3545924064768286
2213,0.2259,21,82,21,513218,92392,57171,50785,0.8558301530253066,0.3547008248531538
2214,0.226,35,94,35,513312,92298,57206,50750,0.8549594279150765,0.35477601923829766
2215,0.2261,20,87,20,513399,92211,57226,50730,0.8541535440364593,0.35490167271811446
2216,0.2262,23,90,23,513489,92121,57249,50707,0.8533198710585794,0.3550214243705716
2217,0.2263,26,82,26,513571,92039,57275,50681,0.8525603023453999,0.35510790358744393
2218,0.2264,23,96,23,513667,91943,57298,50658,0.8516710511689948,0.35524295061044453
2219,0.2265,27,92,27,513759,91851,57325,50631,0.8508188521249398,0.3553501494925675
2220,0.2266,26,100,26,513859,91751,57351,50605,0.8498925488161844,0.3554820309646239
2221,0.2267,29,102,29,513961,91649,57380,50576,0.8489477194412538,0.3556055545790121
2222,0.2268,26,81,26,514042,91568,57406,50550,0.848197413761162,0.3556903418286213
2223,0.2269,31,82,31,514124,91486,57437,50519,0.8474378450479825,0.35575507904651243
2224,0.227,18,64,18,514188,91422,57455,50501,0.846845010930379,0.35583379719989006
2225,0.2271,28,90,28,514278,91332,57483,50473,0.8460113379524992,0.35593244243856
2226,0.2272,30,85,30,514363,91247,57513,50443,0.8452239801400571,0.3560095984190839
2227,0.2273,19,82,19,514445,91165,57532,50424,0.8444644114268777,0.3561293603316642
2228,0.2274,25,88,25,514533,91077,57557,50399,0.8436492645151729,0.3562371002855608
2229,0.2275,18,84,18,514617,90993,57575,50381,0.8428711697358183,0.3563668001188337
2230,0.2276,17,79,17,514696,90914,57592,50364,0.8421393901219015,0.35648862526366454
2231,0.2277,25,98,25,514794,90816,57617,50339,0.8412316128793212,0.35662215295242816
2232,0.2278,17,77,17,514871,90739,57634,50322,0.8405183593315795,0.35673928300522467
2233,0.2279,23,91,23,514962,90648,57657,50299,0.8396754233206121,0.3568646370621581
2234,0.228,21,80,21,515042,90568,57678,50278,0.8389343806736078,0.3569714439884697
2235,0.2281,24,68,24,515110,90500,57702,50254,0.8383044944236541,0.35703425835145003
2236,0.2282,31,88,31,515198,90412,57733,50223,0.8374893475119494,0.35711593842215666
2237,0.2283,25,85,25,515283,90327,57758,50198,0.8367019896995072,0.35721757694360434
2238,0.2284,43,74,43,515357,90253,57801,50155,0.8360165252510282,0.35720899094068714
2239,0.2285,32,77,32,515434,90176,57833,50123,0.8353032717032866,0.35725842664594903
2240,0.2286,33,78,33,515512,90098,57866,50090,0.8345807551224573,0.35730590350101293
2241,0.2287,21,80,21,515592,90018,57887,50069,0.833839712475453,0.3574136072583466
2242,0.2288,32,93,32,515685,89925,57919,50037,0.8329782503983104,0.3575041797059202
2243,0.2289,18,71,18,515756,89854,57937,50019,0.8323205750490941,0.35760296840705497
2244,0.229,24,93,24,515849,89761,57961,49995,0.8314591129719515,0.35773061621683505
2245,0.2291,24,89,24,515938,89672,57985,49971,0.8306347030271592,0.3578482272652406
2246,0.2292,14,80,14,516018,89592,57999,49957,0.8298936603801549,0.35798895011787973
2247,0.2293,27,72,27,516090,89520,58026,49930,0.829226721997851,0.3580494801003944
2248,0.2294,32,98,32,516188,89422,58058,49898,0.8283189447552707,0.35815389032443296
2249,0.2295,22,82,22,516270,89340,58080,49876,0.8275593760420912,0.35826341799793127
2250,0.2296,34,80,34,516350,89260,58114,49842,0.8268183333950869,0.35831260513867524
2251,0.2297,18,78,18,516428,89182,58132,49824,0.8260958168142577,0.3584305713422442
2252,0.2298,27,62,27,516490,89120,58159,49797,0.8255215087628293,0.35846584651266583
2253,0.2299,29,82,29,516572,89038,58188,49768,0.8247619400496499,0.3585435788078325
2254,0.23,33,85,33,516657,88953,58221,49735,0.8239745822372078,0.35861069450853716
2255,0.2301,31,96,31,516753,88857,58252,49704,0.8230853310608025,0.3587156559204971
2256,0.2302,19,73,19,516826,88784,58271,49685,0.8224091296454111,0.3588167748737985
2257,0.2303,30,79,30,516905,88705,58301,49655,0.8216773500314943,0.3588826250361376
2258,0.2304,21,80,21,516985,88625,58322,49634,0.82093630738449,0.35899290462103733
2259,0.2305,22,74,22,517059,88551,58344,49612,0.8202508429360109,0.3590831119764336
2260,0.2306,23,61,23,517120,88490,58367,49589,0.8196857979176702,0.3591349879416856
2261,0.2307,26,80,26,517200,88410,58393,49563,0.8189447552706658,0.35922245656758933
2262,0.2308,24,92,24,517292,88318,58417,49539,0.8180925562266108,0.35935063145143153
2263,0.2309,22,93,22,517385,88225,58439,49517,0.8172310941494683,0.3594909323227483
2264,0.231,21,87,21,517472,88138,58460,49496,0.8164252102708511,0.35962044262318904
2265,0.2311,28,88,28,517560,88050,58488,49468,0.8156100633591463,0.3597201820852543
2266,0.2312,19,73,19,517633,87977,58507,49449,0.8149338619437548,0.35982274096604716
2267,0.2313,29,62,29,517695,87915,58536,49420,0.8143595538923265,0.35985000182036625
2268,0.2314,28,98,28,517793,87817,58564,49392,0.8134517766497462,0.359976386388648
2269,0.2315,24,70,24,517863,87747,58588,49368,0.8128033643336174,0.3600481347773766
2270,0.2316,25,77,25,517940,87670,58613,49343,0.8120901107858757,0.3601337099399327
2271,0.2317,19,82,19,518022,87588,58632,49324,0.8113305420726963,0.3602606053523431
2272,0.2318,33,82,33,518104,87506,58665,49291,0.8105709733595169,0.360322229288654
2273,0.2319,17,70,17,518174,87436,58682,49274,0.809922561043388,0.3604271816253383
2274,0.232,22,76,22,518250,87360,58704,49252,0.8092185705287339,0.3605246976839516
2275,0.2321,11,78,11,518328,87282,58715,49241,0.8084960539479047,0.36067915296323694
2276,0.2322,21,78,21,518406,87204,58736,49220,0.8077735373670755,0.36078695830645635
2277,0.2323,26,71,26,518477,87133,58762,49194,0.8071158620178591,0.3608529491590074
2278,0.2324,38,97,38,518574,87036,58800,49156,0.8062173478083664,0.3609316259398496
2279,0.2325,24,84,24,518658,86952,58824,49132,0.8054392530290119,0.36104170953234765
2280,0.2326,31,68,31,518726,86884,58855,49101,0.8048093667790581,0.3610765893297055
2281,0.2327,29,81,29,518807,86803,58884,49072,0.8040590610989663,0.36115547378104873
2282,0.2328,29,71,29,518878,86732,58913,49043,0.80340138574975,0.36120788068495674
2283,0.2329,29,90,29,518968,86642,58942,49014,0.80256771277187,0.36131096302411986
2284,0.233,27,89,27,519057,86553,58969,48987,0.8017433028270777,0.36142098273572376
2285,0.2331,18,74,18,519131,86479,58987,48969,0.8010578383785987,0.3615335774614612
2286,0.2332,31,75,31,519206,86404,59018,48938,0.8003631108970322,0.36158768157704185
2287,0.2333,18,95,18,519301,86309,59036,48920,0.7994831227537145,0.36175672377966267
2288,0.2334,26,81,26,519382,86228,59062,48894,0.7987328170736225,0.3618507718950282
2289,0.2335,24,73,24,519455,86155,59086,48870,0.7980566156582312,0.3619329753749306
2290,0.2336,24,89,24,519544,86066,59110,48846,0.7972322057134388,0.36205823055028463
2291,0.2337,24,84,24,519628,85982,59134,48822,0.7964541109340842,0.3621702620100294
2292,0.2338,29,88,29,519716,85894,59163,48793,0.7956389640223794,0.36226955830926516
2293,0.2339,20,92,20,519808,85802,59183,48773,0.7947867649783245,0.3624224410180197
2294,0.234,33,72,33,519880,85730,59216,48740,0.7941198265960207,0.36246002825909124
2295,0.2341,34,75,34,519955,85655,59250,48706,0.793425099114454,0.36250102336243406
2296,0.2342,17,73,17,520028,85582,59267,48689,0.7927488976990625,0.36261739318244446
2297,0.2343,20,68,20,520096,85514,59287,48669,0.7921190114491089,0.36270615502708986
2298,0.2344,28,82,28,520178,85432,59315,48641,0.7913594427359295,0.3627948953182222
2299,0.2345,22,80,22,520258,85352,59337,48619,0.7906184000889251,0.36290689776145585
2300,0.2346,26,80,26,520338,85272,59363,48593,0.7898773574419208,0.3630000373510626
2301,0.2347,18,88,18,520426,85184,59381,48575,0.789062210530216,0.3631531336209152
2302,0.2348,26,76,26,520502,85108,59407,48549,0.7883582200155619,0.3632357452284579
2303,0.2349,22,59,22,520561,85049,59429,48527,0.7878117010633962,0.3632913098161346
2304,0.235,24,69,24,520630,84980,59453,48503,0.787172551780355,0.36336462321044627
2305,0.2351,24,70,24,520700,84910,59477,48479,0.7865241394642262,0.3634407634812466
2306,0.2352,29,73,29,520773,84837,59506,48450,0.7858479380488347,0.36350131670755587
2307,0.2353,28,76,28,520849,84761,59534,48422,0.7851439475341806,0.36357493073440306
2308,0.2354,26,68,26,520917,84693,59560,48396,0.784514061284227,0.36363636363636365
2309,0.2355,26,69,26,520986,84624,59586,48370,0.7838749120011856,0.36370061807299575
2310,0.2356,13,69,13,521055,84555,59599,48357,0.7832357627181444,0.36382719393282775
2311,0.2357,19,86,19,521141,84469,59618,48338,0.7824391418726148,0.36397177859600777
2312,0.2358,17,71,17,521212,84398,59635,48321,0.7817814665233984,0.3640850217376563
2313,0.2359,29,82,29,521294,84316,59664,48292,0.781021897810219,0.3641710907335907
2314,0.236,24,97,24,521391,84219,59688,48268,0.7801233836007262,0.364322537305547
2315,0.2361,25,69,25,521460,84150,59713,48243,0.779484234317685,0.36439237724048856
2316,0.2362,27,81,27,521541,84069,59740,48216,0.778733928637593,0.36448576936160565
2317,0.2363,20,66,20,521607,84003,59760,48196,0.7781225684538146,0.3645715928259669
2318,0.2364,21,80,21,521687,83923,59781,48175,0.7773815258068102,0.3646913655013702
2319,0.2365,24,65,24,521752,83858,59805,48151,0.7767794286561192,0.3647554333416661
2320,0.2366,23,77,23,521829,83781,59828,48128,0.7760661751083775,0.3648575912181883
2321,0.2367,21,82,21,521911,83699,59849,48107,0.775306606395198,0.364983384671411
2322,0.2368,23,82,23,521993,83617,59872,48084,0.7745470376820186,0.36509973348721725
2323,0.2369,25,73,25,522066,83544,59897,48059,0.7738708362666271,0.36518164479533144
2324,0.237,21,78,21,522144,83466,59918,48038,0.7731483196857979,0.3652968730989171
2325,0.2371,30,78,30,522222,83388,59948,48008,0.7724258031049687,0.36536880879174405
2326,0.2372,21,70,21,522292,83318,59969,47987,0.7717773907888399,0.36546209207570163
2327,0.2373,27,72,27,522364,83246,59996,47960,0.771110452406536,0.36553206408243527
2328,0.2374,32,59,32,522423,83187,60028,47928,0.7705639334543704,0.365541700034321
2329,0.2375,22,86,22,522509,83101,60050,47906,0.7697673126088407,0.36567511659682306
2330,0.2376,20,71,20,522580,83030,60070,47886,0.7691096372596243,0.3657765284609979
2331,0.2377,23,82,23,522662,82948,60093,47863,0.7683500685464448,0.36589430552476476
2332,0.2378,17,66,17,522728,82882,60110,47846,0.7677387083626662,0.36599657303714583
2333,0.2379,31,78,31,522806,82804,60141,47815,0.767016191781837,0.3660646613432961
2334,0.238,22,64,22,522870,82740,60163,47793,0.7664233576642335,0.36613729861414357
2335,0.2381,23,54,23,522924,82686,60186,47770,0.7659231538775056,0.36617710185809776
2336,0.2382,28,61,28,522985,82625,60214,47742,0.7653581088591649,0.3662123083295619
2337,0.2383,15,68,15,523053,82557,60229,47727,0.7647282226092111,0.3663304780326057
2338,0.2384,28,75,28,523128,82482,60257,47699,0.7640334951276446,0.36640523578709644
2339,0.2385,19,84,19,523212,82398,60276,47680,0.7632554003482901,0.36654930118851764
2340,0.2386,19,75,19,523287,82323,60295,47661,0.7625606728667235,0.36666820531757754
2341,0.2387,25,77,25,523364,82246,60320,47636,0.7618474193189818,0.3667636777998491
2342,0.2388,19,70,19,523434,82176,60339,47617,0.761199007002853,0.3668687833704437
2343,0.2389,23,86,23,523520,82090,60362,47594,0.7604023861573234,0.3669997840905586
2344,0.239,19,78,19,523598,82012,60381,47575,0.7596798695764941,0.36712787548133685
2345,0.2391,26,69,26,523667,81943,60407,47549,0.7590407202934529,0.36719642912303463
2346,0.2392,23,77,23,523744,81866,60430,47526,0.7583274667457112,0.3673024607394584
2347,0.2393,19,61,19,523805,81805,60449,47507,0.7577624217273704,0.3673827641672853
2348,0.2394,26,105,26,523910,81700,60475,47481,0.7567898032531772,0.36755405206648034
2349,0.2395,21,73,21,523983,81627,60496,47460,0.7561136018377858,0.3676590206604848
2350,0.2396,23,67,23,524050,81560,60519,47437,0.7554929786209197,0.3677372341992449
2351,0.2397,23,79,23,524129,81481,60542,47414,0.7547611990070029,0.3678498002249893
2352,0.2398,16,79,16,524208,81402,60558,47398,0.7540294193930861,0.3679968944099379
2353,0.2399,17,71,17,524279,81331,60575,47381,0.7533717440438698,0.36811641494188574
2354,0.24,28,71,28,524350,81260,60603,47353,0.7527140686946534,0.3681820655765747
2355,0.2401,27,82,27,524432,81178,60630,47326,0.7519544999814739,0.3682842557430119
2356,0.2402,18,75,18,524507,81103,60648,47308,0.7512597724999074,0.3684108059278411
2357,0.2403,26,74,26,524581,81029,60674,47282,0.7505743080514283,0.36849529658408087
2358,0.2404,30,87,30,524668,80942,60704,47252,0.7497684241728112,0.3685975942711827
2359,0.2405,18,78,18,524746,80864,60722,47234,0.7490459075919819,0.36873331355680805
2360,0.2406,25,76,25,524822,80788,60747,47209,0.7483419170773278,0.368828956928678
2361,0.2407,27,55,27,524877,80733,60774,47182,0.7478324502575123,0.3688543173200954
2362,0.2408,29,76,29,524953,80657,60803,47153,0.7471284597428582,0.3689304436272592
2363,0.2409,25,74,25,525027,80583,60828,47128,0.7464429952943792,0.3690206795029402
2364,0.241,24,67,24,525094,80516,60852,47104,0.745822372077513,0.36909575301676856
2365,0.2411,25,81,25,525175,80435,60877,47079,0.7450720663974212,0.3692065184999294
2366,0.2412,24,60,24,525235,80375,60901,47055,0.7445162844121679,0.3692615553637291
2367,0.2413,30,65,30,525300,80310,60931,47025,0.7439141872614768,0.3693014489339145
2368,0.2414,28,66,28,525366,80244,60959,46997,0.7433028270776983,0.3693542175870985
2369,0.2415,25,79,25,525445,80165,60984,46972,0.7425710474637816,0.3694597166835776
2370,0.2416,27,81,27,525526,80084,61011,46945,0.7418207417836896,0.36956128128222687
2371,0.2417,16,95,16,525621,79989,61027,46929,0.740940753640372,0.3697584267007044
2372,0.2418,26,80,26,525701,79909,61053,46903,0.7401997109933677,0.36986247358294166
2373,0.2419,16,86,16,525787,79823,61069,46887,0.739403090147838,0.3700339357588194
2374,0.242,20,64,20,525851,79759,61089,46867,0.7388102560302345,0.3701214600476995
2375,0.2421,20,64,20,525915,79695,61109,46847,0.7382174219126311,0.3702091005357905
2376,0.2422,15,69,15,525984,79626,61124,46832,0.7375782726295899,0.37033639627386167
2377,0.2423,22,70,22,526054,79556,61146,46810,0.7369298603134611,0.37043191997847524
2378,0.2424,31,82,31,526136,79474,61177,46779,0.7361702916002816,0.3705179282868526
2379,0.2425,24,78,24,526214,79396,61201,46755,0.7354477750194524,0.3706272641516912
2380,0.2426,29,73,29,526287,79323,61230,46726,0.7347715736040609,0.37069710985410437
2381,0.2427,21,74,21,526361,79249,61251,46705,0.7340861091555819,0.37080997824602635
2382,0.2428,22,64,22,526425,79185,61273,46683,0.7334932750379785,0.37088854990942893
2383,0.2429,24,76,24,526501,79109,61297,46659,0.7327892845233244,0.3709926213345207
2384,0.243,30,80,30,526581,79029,61327,46629,0.73204824187632,0.3710786420283627
2385,0.2431,24,68,24,526649,78961,61351,46605,0.7314183556263663,0.3711593902808085
2386,0.2432,26,71,26,526720,78890,61377,46579,0.7307606802771499,0.37123911085606803
2387,0.2433,23,80,23,526800,78810,61400,46556,0.7300196376301457,0.37136065599923423
2388,0.2434,19,56,19,526856,78754,61419,46537,0.7295009077772426,0.3714313079151735
2389,0.2435,24,76,24,526932,78678,61443,46513,0.7287969172625884,0.37153629254499126
2390,0.2436,24,64,24,526996,78614,61467,46489,0.728204083144985,0.3716057968234175
2391,0.2437,28,68,28,527064,78546,61495,46461,0.7275741968950313,0.3716671866375483
2392,0.2438,29,73,29,527137,78473,61524,46432,0.7268979954796398,0.3717385212761699
2393,0.2439,19,67,19,527204,78406,61543,46413,0.7262773722627737,0.3718424278355058
2394,0.244,33,77,33,527281,78329,61576,46380,0.725564118715032,0.37190579669470525
2395,0.2441,24,69,24,527350,78260,61600,46356,0.7249249694319908,0.3719907556012069
2396,0.2442,20,70,20,527420,78190,61620,46336,0.724276557115862,0.3720989994057466
2397,0.2443,19,66,19,527486,78124,61639,46317,0.7236651969320834,0.3722004805490152
2398,0.2444,24,84,24,527570,78040,61663,46293,0.7228871021527289,0.37233075691891937
2399,0.2445,29,81,29,527651,77959,61692,46264,0.722136796472637,0.3724270062709804
2400,0.2446,25,61,25,527712,77898,61717,46239,0.7215717514542962,0.37248362696053555
2401,0.2447,38,55,38,527767,77843,61755,46201,0.7210622846344807,0.3724565476766309
2402,0.2448,13,53,13,527820,77790,61768,46188,0.7205713438808403,0.372549968542806
2403,0.2449,22,90,22,527910,77700,61790,46166,0.7197376709029605,0.37270921802593127
2404,0.245,19,55,19,527965,77645,61809,46147,0.719228204083145,0.37277853173064496
2405,0.2451,21,74,21,528039,77571,61830,46126,0.718542739634666,0.37289505808548307
2406,0.2452,16,67,16,528106,77504,61846,46110,0.7179221164177998,0.37301600142378694
2407,0.2453,28,67,28,528173,77437,61874,46082,0.7173014932009337,0.3730762068993434
2408,0.2454,22,69,22,528242,77368,61896,46060,0.7166623439178925,0.37317302394918495
2409,0.2455,28,66,28,528308,77302,61924,46032,0.7160509837341139,0.3732304149707299
2410,0.2456,20,71,20,528379,77231,61944,46012,0.7153933083848976,0.37334371931874427
2411,0.2457,22,59,22,528438,77172,61966,45990,0.7148467894327318,0.3734106299020802
2412,0.2458,25,65,25,528503,77107,61991,45965,0.7142446922820408,0.3734805642225689
2413,0.2459,23,57,23,528560,77050,62014,45942,0.7137166993960502,0.373536490178223
2414,0.246,22,60,22,528620,76990,62036,45920,0.713160917410797,0.37360670409242536
2415,0.2461,33,68,33,528688,76922,62069,45887,0.7125310311608433,0.37364525401232807
2416,0.2462,28,64,28,528752,76858,62097,45859,0.7119381970432398,0.37369720576611226
2417,0.2463,17,66,17,528818,76792,62114,45842,0.7113268368594613,0.37381150415056186
2418,0.2464,21,64,21,528882,76728,62135,45821,0.7107340027418578,0.3738994198239072
2419,0.2465,22,60,22,528942,76668,62157,45799,0.7101782207566045,0.37397013072909435
2420,0.2466,21,76,21,529018,76592,62178,45778,0.7094742302419504,0.3740949579145215
2421,0.2467,24,70,24,529088,76522,62202,45754,0.7088258179258217,0.3741862671333704
2422,0.2468,21,69,21,529157,76453,62223,45733,0.7081866686427803,0.374290016859542
2423,0.2469,20,70,20,529227,76383,62243,45713,0.7075382563266516,0.37440210981522737
2424,0.247,13,88,13,529315,76295,62256,45700,0.7067231094149469,0.37460551661953356
2425,0.2471,20,62,20,529377,76233,62276,45680,0.7061488013635184,0.37469342892062374
2426,0.2472,28,67,28,529444,76166,62304,45652,0.7055281781466524,0.3747557832175869
2427,0.2473,28,68,28,529512,76098,62332,45624,0.7048982918966986,0.37482131414206143
2428,0.2474,26,74,26,529586,76024,62358,45598,0.7042128274482197,0.37491572248441896
2429,0.2475,30,57,30,529643,75967,62388,45568,0.7036848345622291,0.37493726087135393
2430,0.2476,33,63,33,529706,75904,62421,45535,0.7031012634777132,0.3749619150355322
2431,0.2477,23,64,23,529770,75840,62444,45512,0.7025084293601097,0.37504120245237
2432,0.2478,34,66,34,529836,75774,62478,45478,0.7018970691763311,0.3750701019364629
2433,0.2479,22,56,22,529892,75718,62500,45456,0.7013783393234281,0.37512997837819995
2434,0.248,27,63,27,529955,75655,62527,45429,0.7007947682389122,0.3751858214132338
2435,0.2481,21,60,21,530015,75595,62548,45408,0.7002389862536589,0.3752634232209119
2436,0.2482,24,69,24,530084,75526,62572,45384,0.6995998369706177,0.37535356877015963
2437,0.2483,36,55,36,530139,75471,62608,45348,0.6990903701508022,0.37533831599334544
2438,0.2484,23,73,23,530212,75398,62631,45325,0.6984141687354107,0.37544626955923893
2439,0.2485,23,72,23,530284,75326,62654,45302,0.6977472303531068,0.3755512816261565
2440,0.2486,33,68,33,530352,75258,62687,45269,0.6971173441031532,0.37559219096136137
2441,0.2487,26,78,26,530430,75180,62713,45243,0.696394827522324,0.37570065519045365
2442,0.2488,25,69,25,530499,75111,62738,45218,0.6957556782392826,0.3757863856593174
2443,0.2489,21,65,21,530564,75046,62759,45197,0.6951535810885916,0.3758805086366774
2444,0.249,20,66,20,530630,74980,62779,45177,0.6945422209048131,0.3759830887921636
2445,0.2491,36,69,36,530699,74911,62815,45141,0.6939030716217718,0.3760120614400426
2446,0.2492,18,65,18,530764,74846,62833,45123,0.6933009744710809,0.37612216489259725
2447,0.2493,22,70,22,530834,74776,62855,45101,0.692652562154952,0.3762272996488067
2448,0.2494,26,62,26,530896,74714,62881,45075,0.6920782541035236,0.3762866373373181
2449,0.2495,26,63,26,530959,74651,62907,45049,0.6914946830190077,0.3763492063492063
2450,0.2496,20,66,20,531025,74585,62927,45029,0.6908833228352291,0.3764525891618038
2451,0.2497,22,63,22,531088,74522,62949,45007,0.6902997517507132,0.3765362380677493
2452,0.2498,23,69,23,531157,74453,62972,44984,0.689660602467672,0.37663370647286853
2453,0.2499,23,70,23,531227,74383,62995,44961,0.6890121901515432,0.376734481834026
2454,0.25,31,77,31,531304,74306,63026,44930,0.6882989366038016,0.3768157267939213
2455,0.2501,21,65,21,531369,74241,63047,44909,0.6876968394531106,0.376911456147713
2456,0.2502,23,73,23,531442,74168,63070,44886,0.6870206380377191,0.3770221916105297
2457,0.2503,27,58,27,531500,74110,63097,44859,0.6864833821186409,0.37706461347073605
2458,0.2504,16,57,16,531557,74053,63113,44843,0.6859553892326503,0.377161552953842
2459,0.2505,28,70,28,531627,73983,63141,44815,0.6853069769165215,0.37723699052172593
2460,0.2506,25,68,25,531695,73915,63166,44790,0.6846770906665679,0.37732193252179774
2461,0.2507,26,59,26,531754,73856,63192,44764,0.6841305717144022,0.37737312426235037
2462,0.2508,22,90,22,531844,73766,63214,44742,0.6832968987365223,0.3775441320417187
2463,0.2509,25,68,25,531912,73698,63239,44717,0.6826670124865686,0.37762952328674576
2464,0.251,24,70,24,531982,73628,63263,44693,0.6820186001704398,0.37772669264120484
2465,0.2511,19,65,19,532047,73563,63282,44674,0.6814165030197488,0.3778343496536617
2466,0.2512,22,54,22,532101,73509,63304,44652,0.6809162992330209,0.37789118236981745
2467,0.2513,17,78,17,532179,73431,63321,44635,0.6801937826521917,0.378051259465045
2468,0.2514,24,75,24,532254,73356,63345,44611,0.679499055170625,0.37816508006476385
2469,0.2515,23,74,23,532328,73282,63368,44588,0.6788135907221461,0.37828115720709254
2470,0.2516,20,57,20,532385,73225,63388,44568,0.6782855978361555,0.37835864609951353
2471,0.2517,24,68,24,532453,73157,63412,44544,0.6776557115862017,0.3784504804547115
2472,0.2518,27,59,27,532512,73098,63439,44517,0.6771091926340361,0.3784976406070654
2473,0.2519,20,64,20,532576,73034,63459,44497,0.6765163585164327,0.37859798691409075
2474,0.252,19,76,19,532652,72958,63478,44478,0.6758123680017785,0.3787424639803808
2475,0.2521,20,65,20,532717,72893,63498,44458,0.6752102708510875,0.3788463668822592
2476,0.2522,20,55,20,532772,72838,63518,44438,0.674700804031272,0.3789181077117228
2477,0.2523,23,52,23,532824,72786,63541,44415,0.6742191263107192,0.37896434330765094
2478,0.2524,26,67,26,532891,72719,63567,44389,0.673598503093853,0.3790432762919698
2479,0.2525,13,50,13,532941,72669,63580,44376,0.6731353514394753,0.3791362296552608
2480,0.2526,23,58,23,532999,72611,63603,44353,0.6725980955203972,0.37920214766936833
2481,0.2527,29,61,29,533060,72550,63632,44324,0.6720330505020564,0.37924602563444393
2482,0.2528,28,68,28,533128,72482,63660,44296,0.6714031642521027,0.3793180222302146
2483,0.2529,25,52,25,533180,72430,63685,44271,0.6709214865315499,0.37935407580055014
2484,0.253,25,68,25,533248,72362,63710,44246,0.6702916002815962,0.3794422338090011
2485,0.2531,23,62,23,533310,72300,63733,44223,0.6697172922301678,0.3795216395046471
2486,0.2532,14,71,14,533381,72229,63747,44209,0.6690596168809515,0.3796784554870403
2487,0.2533,31,68,31,533449,72161,63778,44178,0.6684297306309979,0.37973508453742943
2488,0.2534,26,59,26,533508,72102,63804,44152,0.6678832116788321,0.37978908252619265
2489,0.2535,24,72,24,533580,72030,63828,44128,0.6672162732965282,0.3798963480776184
2490,0.2536,27,64,27,533644,71966,63855,44101,0.6666234391789247,0.3799615739185126
2491,0.2537,27,66,27,533710,71900,63882,44074,0.6660120789951461,0.38003345577457015
2492,0.2538,31,76,31,533786,71824,63913,44043,0.665308088480492,0.38011685812181206
2493,0.2539,31,66,31,533852,71758,63944,44012,0.6646967282967134,0.38016757363738446
2494,0.254,14,61,14,533913,71697,63958,43998,0.6641316832783727,0.3802930117982627
2495,0.2541,19,71,19,533984,71626,63977,43979,0.6634740079291563,0.3804247221140954
2496,0.2542,27,61,27,534045,71565,64004,43952,0.6629089629108155,0.3804807950344971
2497,0.2543,25,59,25,534104,71506,64029,43927,0.6623624439586498,0.38054109310162604
2498,0.2544,22,60,22,534164,71446,64051,43905,0.6618066619733965,0.38062088755190676
2499,0.2545,23,61,23,534225,71385,64074,43882,0.6612416169550558,0.3806987255675952
2500,0.2546,27,73,27,534298,71312,64101,43855,0.6605654155396643,0.3807948457457431
2501,0.2547,22,72,22,534370,71240,64123,43833,0.6598984771573604,0.38091472369713136
2502,0.2548,21,66,21,534436,71174,64144,43812,0.6592871169735818,0.3810202981232498
2503,0.2549,16,67,16,534503,71107,64160,43796,0.6586664937567157,0.3811562796445698
2504,0.255,24,66,24,534569,71041,64184,43772,0.6580551335729371,0.3812460261468649
2505,0.2551,25,58,25,534627,70983,64209,43747,0.6575178776538589,0.3813039309683605
2506,0.2552,20,52,20,534679,70931,64229,43727,0.6570361999333062,0.3813689406757487
2507,0.2553,28,51,28,534730,70880,64257,43699,0.6565637852458409,0.38138751429144957
2508,0.2554,22,55,22,534785,70825,64279,43677,0.6560543184260255,0.38145185236939094
2509,0.2555,26,60,26,534845,70765,64305,43651,0.6554985364407722,0.38151132708712066
2510,0.2556,26,73,26,534918,70692,64331,43625,0.6548223350253807,0.3816142830900041
2511,0.2557,31,56,31,534974,70636,64362,43594,0.6543036051724777,0.3816335463538475
2512,0.2558,19,57,19,535031,70579,64381,43575,0.6537756122864871,0.38172118366417296
2513,0.2559,20,63,20,535094,70516,64401,43555,0.6531920412019712,0.38182360109054886
2514,0.256,22,69,22,535163,70447,64423,43533,0.65255289191893,0.3819354272679417
2515,0.2561,29,67,29,535230,70380,64452,43504,0.6519322687020638,0.38200273962979875
2516,0.2562,24,50,24,535280,70330,64476,43480,0.6514691170476861,0.38204024250944557
2517,0.2563,24,62,24,535342,70268,64500,43456,0.6508948089962577,0.38211811051317224
2518,0.2564,24,76,24,535418,70192,64524,43432,0.6501908184816036,0.3822431880588608
2519,0.2565,24,62,24,535480,70130,64548,43408,0.6496165104301752,0.3823213373496098
2520,0.2566,21,39,21,535519,70091,64569,43387,0.6492552521397607,0.38233842683163255
2521,0.2567,23,54,23,535573,70037,64592,43364,0.6487550483530328,0.3823952169733953
2522,0.2568,29,62,29,535635,69975,64621,43335,0.6481807403016043,0.3824463860206513
2523,0.2569,23,69,23,535704,69906,64644,43312,0.6475415910185631,0.38255401084633184
2524,0.257,22,65,22,535769,69841,64666,43290,0.6469394938678721,0.3826537377023097
2525,0.2571,22,69,22,535838,69772,64688,43268,0.6463003445848309,0.3827671620665251
2526,0.2572,26,66,26,535904,69706,64714,43242,0.6456889844010523,0.38284874455501644
2527,0.2573,23,59,23,535963,69647,64737,43219,0.6451424654488865,0.3829231123633335
2528,0.2574,17,73,17,536036,69574,64754,43202,0.6444662640334952,0.3830779598496134
2529,0.2575,24,52,24,536088,69522,64778,43178,0.6439845863129423,0.3831233362910382
2530,0.2576,22,61,22,536149,69461,64800,43156,0.6434195412946015,0.3832103501247591
2531,0.2577,30,72,30,536221,69389,64830,43126,0.6427526029122976,0.3832911167399902
2532,0.2578,29,50,29,536271,69339,64859,43097,0.6422894512579199,0.38330250097833435
2533,0.2579,23,57,23,536328,69282,64882,43074,0.6417614583719293,0.38337071451457866
2534,0.258,16,67,16,536395,69215,64898,43058,0.6411408351550631,0.38351161900011577
2535,0.2581,24,77,24,536472,69138,64922,43034,0.6404275816073215,0.38364297685696963
2536,0.2582,17,57,17,536529,69081,64939,43017,0.6398995887213309,0.3837445806348017
2537,0.2583,18,61,18,536590,69020,64957,42999,0.6393345437029901,0.3838545246788491
2538,0.2584,20,66,20,536656,68954,64977,42979,0.6387231835192115,0.38397076822742177
2539,0.2585,29,83,29,536739,68871,65006,42950,0.6379543517729446,0.384096010588351
2540,0.2586,25,58,25,536797,68813,65031,42925,0.6374170958538664,0.3841575829171813
2541,0.2587,29,60,29,536857,68753,65060,42896,0.6368613138686131,0.3842040681062974
2542,0.2588,32,70,32,536927,68683,65092,42864,0.6362129015524843,0.3842685146171569
2543,0.2589,11,52,11,536979,68631,65103,42853,0.6357312238319315,0.3843869972372717
2544,0.259,23,62,23,537041,68569,65126,42830,0.6351569157805032,0.3844738283108466
2545,0.2591,23,63,23,537104,68506,65149,42807,0.6345733446959873,0.3845642467636305
2546,0.2592,20,55,20,537159,68451,65169,42787,0.6340638778761718,0.3846437368525144
2547,0.2593,26,69,26,537228,68382,65195,42761,0.6334247285931305,0.3847385800275321
2548,0.2594,21,57,21,537285,68325,65216,42740,0.63289673570714,0.3848197001755729
2549,0.2595,27,55,27,537340,68270,65243,42713,0.6323872688873244,0.3848607444383374
2550,0.2596,25,44,25,537384,68226,65268,42688,0.631979695431472,0.3848747678381449
2551,0.2597,21,60,21,537444,68166,65289,42667,0.6314239134462188,0.3849665713280341
2552,0.2598,30,55,30,537499,68111,65319,42637,0.6309144466264034,0.3849911510817351
2553,0.2599,25,63,25,537562,68048,65344,42612,0.6303308755418874,0.3850713898427616
2554,0.26,20,66,20,537628,67982,65364,42592,0.6297195153581089,0.3851900085010943
2555,0.2601,21,67,21,537695,67915,65385,42571,0.6290988921412427,0.38530673569502016
2556,0.2602,21,53,21,537748,67862,65406,42550,0.6286079513876024,0.3853747781038293
2557,0.2603,20,65,20,537813,67797,65426,42530,0.6280058542369114,0.38549040579368604
2558,0.2604,21,55,21,537868,67742,65447,42509,0.6274963874170959,0.38556566380350293
2559,0.2605,24,56,24,537924,67686,65471,42485,0.6269776575641928,0.3856277967886286
2560,0.2606,28,73,28,537997,67613,65499,42457,0.6263014561488014,0.38572726446806577
2561,0.2607,30,62,30,538059,67551,65529,42427,0.625727148097373,0.3857771554310862
2562,0.2608,18,57,18,538116,67494,65547,42409,0.6251991552113824,0.3858766366705185
2563,0.2609,19,53,19,538169,67441,65566,42390,0.624708214457742,0.3859566060583988
2564,0.261,19,62,19,538231,67379,65585,42371,0.6241339064063137,0.38606833712984057
2565,0.2611,24,55,24,538286,67324,65609,42347,0.6236244395864982,0.38612759982128364
2566,0.2612,18,69,18,538355,67255,65627,42329,0.622985290303457,0.3862698934150971
2567,0.2613,18,82,18,538437,67173,65645,42311,0.6222257215902776,0.38645829527602205
2568,0.2614,28,98,28,538535,67075,65673,42283,0.6213179443476972,0.38664752464383034
2569,0.2615,28,72,28,538607,67003,65701,42255,0.6206510059653934,0.38674513536766186
2570,0.2616,22,62,22,538669,66941,65723,42233,0.6200766979139649,0.3868411892941543
2571,0.2617,21,48,21,538717,66893,65744,42212,0.6196320723257623,0.3868933596077173
2572,0.2618,20,62,20,538779,66831,65764,42192,0.619057764274334,0.38700090806527065
2573,0.2619,15,63,15,538842,66768,65779,42177,0.6184741931898181,0.38714030015145257
2574,0.262,21,53,21,538895,66715,65800,42156,0.6179832524361777,0.3872105519376142
2575,0.2621,28,58,28,538953,66657,65828,42128,0.6174459965170995,0.3872592728776945
2576,0.2622,27,53,27,539006,66604,65855,42101,0.6169550557634592,0.38729589255324043
2577,0.2623,22,60,22,539066,66544,65877,42079,0.6163992737782059,0.3873857286210103
2578,0.2624,18,65,18,539131,66479,65895,42061,0.6157971766275149,0.3875161230882624
2579,0.2625,21,59,21,539190,66420,65916,42040,0.6152506576753493,0.3876083348699982
2580,0.2626,21,56,21,539246,66364,65937,42019,0.6147319278224462,0.3876899513761383
2581,0.2627,26,62,26,539308,66302,65963,41993,0.6141576197710178,0.38776490142665865
2582,0.2628,21,55,21,539363,66247,65984,41972,0.6136481529512023,0.38784316986850736
2583,0.2629,24,53,24,539416,66194,66008,41948,0.6131572121975619,0.38789739416692864
2584,0.263,25,60,25,539476,66134,66033,41923,0.6126014302123087,0.387971163367482
2585,0.2631,31,61,31,539537,66073,66064,41892,0.6120363851939679,0.38801463437225026
2586,0.2632,18,83,18,539620,65990,66082,41874,0.6112675534477009,0.38821108062004006
2587,0.2633,22,56,22,539676,65934,66104,41852,0.6107488235947979,0.3882879038094001
2588,0.2634,26,70,26,539746,65864,66130,41826,0.6101004112786691,0.3883926084130374
2589,0.2635,21,54,21,539800,65810,66151,41805,0.6096002074919412,0.3884681503507875
2590,0.2636,25,71,25,539871,65739,66176,41780,0.6089425321427249,0.38858248309601096
2591,0.2637,16,67,16,539938,65672,66192,41764,0.6083219089258587,0.388733757772069
2592,0.2638,30,47,30,539985,65625,66222,41734,0.6078865463707437,0.38873312903436136
2593,0.2639,20,64,20,540049,65561,66242,41714,0.6072937122531402,0.3888510836634817
2594,0.264,22,60,22,540109,65501,66264,41692,0.6067379302678869,0.3889433078652524
2595,0.2641,11,48,11,540157,65453,66275,41681,0.6062933046796843,0.389054828532492
2596,0.2642,19,47,19,540204,65406,66294,41662,0.6058579421245692,0.3891171965479882
2597,0.2643,21,55,21,540259,65351,66315,41641,0.6053484753047538,0.38919732316434874
2598,0.2644,21,58,21,540317,65293,66336,41620,0.6048112193856756,0.389288486900564
2599,0.2645,23,60,23,540377,65233,66359,41597,0.6042554374004224,0.38937564354582044
2600,0.2646,25,53,25,540430,65180,66384,41572,0.603764496646782,0.3894259592326139
2601,0.2647,27,66,27,540496,65114,66411,41545,0.6031531364630034,0.38951237120168014
2602,0.2648,26,72,26,540568,65042,66437,41519,0.6024861980806996,0.38962659884948525
2603,0.2649,22,53,22,540621,64989,66459,41497,0.6019952573270592,0.38969441992374587
2604,0.265,19,62,19,540683,64927,66478,41478,0.6014209492756308,0.3898125088106762
2605,0.2651,17,62,17,540745,64865,66495,41461,0.6008466412242025,0.3899422530707447
2606,0.2652,28,47,28,540792,64818,66523,41433,0.6004112786690874,0.3899539769037468
2607,0.2653,12,59,12,540851,64759,66535,41421,0.5998647597169217,0.3901017140704464
2608,0.2654,21,47,21,540898,64712,66556,41400,0.5994293971618067,0.3901537997587455
2609,0.2655,17,58,17,540956,64654,66573,41383,0.5988921412427285,0.3902694342540811
2610,0.2656,19,48,19,541004,64606,66592,41364,0.5984475156545259,0.3903368877984335
2611,0.2657,22,56,22,541060,64550,66614,41342,0.5979287858016229,0.39041665092735994
2612,0.2658,21,59,21,541119,64491,66635,41321,0.5973822668494572,0.39051336332363057
2613,0.2659,21,64,21,541183,64427,66656,41300,0.5967894327318537,0.39062869465699396
2614,0.266,19,62,19,541245,64365,66675,41281,0.5962151246804254,0.39074834825738786
2615,0.2661,25,56,25,541301,64309,66700,41256,0.5956963948275223,0.39081134845829585
2616,0.2662,19,57,19,541358,64252,66719,41237,0.5951684019415318,0.39091279659490563
2617,0.2663,16,56,16,541414,64196,66735,41221,0.5946496720886287,0.3910280125596441
2618,0.2664,19,87,19,541501,64109,66754,41202,0.5938437882100115,0.3912411808832885
2619,0.2665,20,62,20,541563,64047,66774,41182,0.5932694801585832,0.3913559950203841
2620,0.2666,25,61,25,541624,63986,66799,41157,0.5927044351402423,0.3914383268500994
2621,0.2667,24,52,24,541676,63934,66823,41133,0.5922227574196895,0.39149304729363166
2622,0.2668,20,60,20,541736,63874,66843,41113,0.5916669754344362,0.39160086486898377
2623,0.2669,14,54,14,541790,63820,66857,41099,0.5911667716477084,0.3917212325698872
2624,0.267,15,60,15,541850,63760,66872,41084,0.5906109896624551,0.3918583800694365
2625,0.2671,22,62,22,541912,63698,66894,41062,0.5900366816110267,0.3919625811378389
2626,0.2672,23,42,23,541954,63656,66917,41039,0.5896476342213495,0.3919862457614977
2627,0.2673,19,60,19,542014,63596,66936,41020,0.5890918522360962,0.3921006347021488
2628,0.2674,31,58,31,542072,63538,66967,40989,0.588554596317018,0.39213791651917684
2629,0.2675,20,50,20,542122,63488,66987,40969,0.5880914446626403,0.3922092344218195
2630,0.2676,26,51,26,542173,63437,67013,40943,0.5876190299751751,0.39224947307913394
2631,0.2677,31,59,31,542232,63378,67044,40912,0.5870725110230094,0.3922907277783105
2632,0.2678,21,54,21,542286,63324,67065,40891,0.5865723072362814,0.392371539605623
2633,0.2679,23,78,23,542364,63246,67088,40868,0.5858497906554522,0.39253126380698083
2634,0.268,18,60,18,542424,63186,67106,40850,0.585294008670199,0.3926525433503787
2635,0.2681,27,45,27,542469,63141,67133,40823,0.584877172181259,0.39266476857373706
2636,0.2682,21,61,21,542530,63080,67154,40802,0.5843121271629182,0.39277256887622497
2637,0.2683,23,60,23,542590,63020,67177,40779,0.583756345177665,0.3928650565034345
2638,0.2684,18,54,18,542644,62966,67195,40761,0.5832561413909371,0.3929642233941018
2639,0.2685,24,57,24,542701,62909,67219,40737,0.5827281485049465,0.3930397699862995
2640,0.2686,21,59,21,542760,62850,67240,40716,0.5821816295527807,0.3931406059903829
2641,0.2687,18,55,18,542815,62795,67258,40698,0.5816721627329653,0.3932439875160639
2642,0.2688,18,51,18,542866,62744,67276,40680,0.5811997480455,0.39333230198019803
2643,0.2689,29,46,29,542912,62698,67305,40651,0.5807736485234726,0.39333713920792657
2644,0.269,11,51,11,542963,62647,67316,40640,0.5803012338360073,0.39346674799345516
2645,0.2691,14,58,14,543021,62589,67330,40626,0.5797639779169291,0.3936055805842174
2646,0.2692,23,58,23,543079,62531,67353,40603,0.579226721997851,0.3936917020575174
2647,0.2693,26,61,26,543140,62470,67379,40577,0.5786616769795102,0.3937717740448533
2648,0.2694,15,59,15,543199,62411,67394,40562,0.5781151580273445,0.3939090829634953
2649,0.2695,20,56,20,543255,62355,67414,40542,0.5775964281744415,0.39400565614157845
2650,0.2696,23,54,23,543309,62301,67437,40519,0.5770962243877135,0.39407702781560006
2651,0.2697,14,50,14,543359,62251,67451,40505,0.5766330727333357,0.39418622756821986
2652,0.2698,31,62,31,543421,62189,67482,40474,0.5760587646819074,0.39424135277558614
2653,0.2699,17,53,17,543474,62136,67499,40457,0.5755678239282671,0.394344643396723
2654,0.27,23,61,23,543535,62075,67522,40434,0.5750027789099262,0.3944434147245608
2655,0.2701,13,72,13,543607,62003,67535,40421,0.5743358405276223,0.3946438334765289
2656,0.2702,29,47,29,543654,61956,67564,40392,0.5739004779725073,0.3946535349982413
2657,0.2703,16,63,16,543717,61893,67580,40376,0.5733169068879914,0.39480194389306633
2658,0.2704,20,63,20,543780,61830,67600,40356,0.5727333358034755,0.3949268980095121
2659,0.2705,20,59,20,543839,61771,67620,40336,0.5721868168513098,0.39503657927468244
2660,0.2706,18,46,18,543885,61725,67638,40318,0.5717607173292824,0.3951079446899836
2661,0.2707,25,57,25,543942,61668,67663,40293,0.5712327244432918,0.3951805101950746
2662,0.2708,19,55,19,543997,61613,67682,40274,0.5707232576234762,0.3952810466497198
2663,0.2709,22,47,22,544044,61566,67704,40252,0.5702878950683612,0.3953328488086586
2664,0.271,22,63,22,544107,61503,67726,40230,0.5697043239838453,0.3954469051340273
2665,0.2711,14,64,14,544171,61439,67740,40216,0.5691114898662418,0.39561261128326203
2666,0.2712,24,51,24,544222,61388,67764,40192,0.5686390751787765,0.39566843866902934
2667,0.2713,18,69,18,544291,61319,67782,40174,0.5679999258957353,0.3958302543032524
2668,0.2714,16,63,16,544354,61256,67798,40158,0.5674163548112194,0.3959808310489676
2669,0.2715,31,62,31,544416,61194,67829,40127,0.566842046759791,0.39603833361297264
2670,0.2716,25,49,25,544465,61145,67854,40102,0.5663881581385009,0.396080871531996
2671,0.2717,20,48,20,544513,61097,67874,40082,0.5659435325502983,0.39614939859061665
2672,0.2718,21,51,21,544564,61046,67895,40061,0.565471117862833,0.3962238025062558
2673,0.2719,20,57,20,544621,60989,67915,40041,0.5649431249768424,0.3963278234187865
2674,0.272,20,49,20,544670,60940,67935,40021,0.5644892363555523,0.39640059032695796
2675,0.2721,22,50,22,544720,60890,67957,39999,0.5640260847011745,0.3964654223949093
2676,0.2722,23,53,23,544773,60837,67980,39976,0.5635351439475342,0.3965361610109807
2677,0.2723,20,74,20,544847,60763,68000,39956,0.5628496794990552,0.3967076718394742
2678,0.2724,29,54,29,544901,60709,68029,39927,0.5623494757123273,0.3967466910449541
2679,0.2725,11,41,11,544942,60668,68040,39916,0.5619696913557375,0.39684244014952674
2680,0.2726,25,46,25,544988,60622,68065,39891,0.56154359183371,0.3968740361943231
2681,0.2727,24,60,24,545048,60562,68089,39867,0.5609878098484568,0.39696701152057673
2682,0.2728,20,48,20,545096,60514,68109,39847,0.5605431842602542,0.39703669752194576
2683,0.2729,25,47,25,545143,60467,68134,39822,0.5601078217051392,0.39707246058889806
2684,0.273,31,45,31,545188,60422,68165,39791,0.5596909852161992,0.39706425314081006
2685,0.2731,27,46,27,545234,60376,68192,39764,0.5592648856941717,0.3970840822848013
2686,0.2732,20,71,20,545305,60305,68212,39744,0.5586072103449553,0.3972453497786085
2687,0.2733,21,40,21,545345,60265,68233,39723,0.5582366890214532,0.3972776733207985
2688,0.2734,16,53,16,545398,60212,68249,39707,0.5577457482678128,0.39739188742881737
2689,0.2735,18,57,18,545455,60155,68267,39689,0.5572177553818223,0.3975101157806178
2690,0.2736,18,63,18,545518,60092,68285,39671,0.5566341842973063,0.3976524362739693
2691,0.2737,14,55,14,545573,60037,68299,39657,0.5561247174774908,0.3977872289204967
2692,0.2738,21,49,21,545622,59988,68320,39636,0.5556708288562007,0.3978559383281137
2693,0.2739,22,39,22,545661,59949,68342,39614,0.5553095705657861,0.3978787300503199
2694,0.274,19,47,19,545708,59902,68361,39595,0.554874208010671,0.39795169703609157
2695,0.2741,16,51,16,545759,59851,68377,39579,0.5544017933232057,0.3980589359348285
2696,0.2742,21,52,21,545811,59799,68398,39558,0.553920115602653,0.39814004046015883
2697,0.2743,26,67,26,545878,59732,68424,39532,0.5532994923857868,0.3982511283043198
2698,0.2744,24,49,24,545927,59683,68448,39508,0.5528456037644967,0.3983022653264913
2699,0.2745,19,68,19,545995,59615,68467,39489,0.552215717514543,0.3984602034226671
2700,0.2746,20,61,20,546056,59554,68487,39469,0.5516506724962021,0.3985841673146643
2701,0.2747,21,47,21,546103,59507,68508,39448,0.5512153099410871,0.3986458491233389
2702,0.2748,29,50,29,546153,59457,68537,39419,0.5507521582867094,0.3986710627452567
2703,0.2749,21,54,21,546207,59403,68558,39398,0.5502519544999814,0.3987611461422455
2704,0.275,21,41,21,546248,59362,68579,39377,0.5498721701433917,0.3987988535431795
2705,0.2751,35,59,35,546307,59303,68614,39342,0.549325651191226,0.39882406609559534
2706,0.2752,18,44,18,546351,59259,68632,39324,0.5489180777353737,0.398892303946928
2707,0.2753,27,50,27,546401,59209,68659,39297,0.548454926080996,0.3989300144153656
2708,0.2754,14,57,14,546458,59152,68673,39283,0.5479269331950054,0.39907553207700514
2709,0.2755,17,49,17,546507,59103,68690,39266,0.5474730445737153,0.39917047037176345
2710,0.2756,19,50,19,546557,59053,68709,39247,0.5470098929193375,0.39925737538148526
2711,0.2757,19,61,19,546618,58992,68728,39228,0.5464448479009967,0.3993891264508247
2712,0.2758,26,50,26,546668,58942,68754,39202,0.545981696246619,0.3994334854907075
2713,0.2759,26,45,26,546713,58897,68780,39176,0.5455648597576791,0.39945754692932817
2714,0.276,23,44,23,546757,58853,68803,39153,0.5451572863018267,0.3994959492275983
2715,0.2761,13,47,13,546804,58806,68816,39140,0.5447219237467116,0.3996079472362322
2716,0.2762,22,53,22,546857,58753,68838,39118,0.5442309829930713,0.3996893870503009
2717,0.2763,21,49,21,546906,58704,68859,39097,0.5437770943717811,0.3997607386427542
2718,0.2764,19,50,19,546956,58654,68878,39078,0.5433139427174034,0.3998485654647403
2719,0.2765,24,51,24,547007,58603,68902,39054,0.5428415280299381,0.39990988869205485
2720,0.2766,19,57,19,547064,58546,68921,39035,0.5423135351439475,0.40002664453120995
2721,0.2767,26,64,26,547128,58482,68947,39009,0.5417207010263441,0.4001292426993261
2722,0.2768,15,64,15,547192,58418,68962,38994,0.5411278669087406,0.4002997577300538
2723,0.2769,21,58,21,547250,58360,68983,38973,0.5405906109896624,0.4004089055099504
2724,0.277,17,60,17,547310,58300,69000,38956,0.5400348290044092,0.40055112280990374
2725,0.2771,18,40,18,547350,58260,69018,38938,0.539664307680907,0.4006049507191506
2726,0.2772,21,62,21,547412,58198,69039,38917,0.5390899996294787,0.4007310920043248
2727,0.2773,16,46,16,547458,58152,69055,38901,0.5386639001074511,0.40082223115205096
2728,0.2774,31,59,31,547517,58093,69086,38870,0.5381173811552855,0.40087456039932756
2729,0.2775,27,55,27,547572,58038,69113,38843,0.5376079143354701,0.40093516788637606
2730,0.2776,23,57,23,547629,57981,69136,38820,0.5370799214494795,0.4010289149905476
2731,0.2777,19,54,19,547683,57927,69155,38801,0.5365797176627515,0.40113514184103877
2732,0.2778,29,51,29,547734,57876,69184,38772,0.5361073029752862,0.4011671219269928
2733,0.2779,20,57,20,547791,57819,69204,38752,0.5355793100892956,0.4012798873367781
2734,0.278,22,52,22,547843,57767,69226,38730,0.5350976323687429,0.40135962776044853
2735,0.2781,11,43,11,547886,57724,69237,38719,0.534699321945978,0.4014702985182958
2736,0.2782,22,47,22,547933,57677,69259,38697,0.5342639593908629,0.40152945815261376
2737,0.2783,23,60,23,547993,57617,69282,38674,0.5337081774056097,0.40163670540341256
2738,0.2784,20,51,20,548044,57566,69302,38654,0.5332357627181444,0.40172521305341924
2739,0.2785,18,65,18,548109,57501,69320,38636,0.5326336655674534,0.40188481021875033
2740,0.2786,20,62,20,548171,57439,69340,38616,0.5320593575160251,0.4020196762271615
2741,0.2787,23,36,23,548207,57403,69363,38593,0.5317258883248731,0.40202716779865827
2742,0.2788,22,53,22,548260,57350,69385,38571,0.5312349475712327,0.40211215479404927
2743,0.2789,28,56,28,548316,57294,69413,38543,0.5307162177183297,0.4021724386197398
2744,0.279,21,47,21,548363,57247,69434,38522,0.5302808551632147,0.40223872025394436
2745,0.2791,19,52,19,548415,57195,69453,38503,0.5297991774426618,0.40233860686743717
2746,0.2792,23,40,23,548455,57155,69476,38480,0.5294286561191597,0.40236315156584934
2747,0.2793,19,58,19,548513,57097,69495,38461,0.5288914002000815,0.4024885409908119
2748,0.2794,23,55,23,548568,57042,69518,38438,0.5283819333802661,0.40257645580226226
2749,0.2795,14,49,14,548617,56993,69532,38424,0.5279280447589759,0.4026955364348072
2750,0.2796,25,57,25,548674,56936,69557,38399,0.5274000518729853,0.4027796716840615
2751,0.2797,20,51,20,548725,56885,69577,38379,0.52692763718552,0.4028699193819281
2752,0.2798,22,45,22,548770,56840,69599,38357,0.5265108006965801,0.402922360998771
2753,0.2799,17,47,17,548817,56793,69616,38340,0.5260754381414651,0.4030147267509697
2754,0.28,21,44,21,548861,56749,69637,38319,0.5256678646856127,0.40306938191610214
2755,0.2801,21,58,21,548919,56691,69658,38298,0.5251306087665345,0.4031835265135963
2756,0.2802,21,52,21,548971,56639,69679,38277,0.5246489310459816,0.4032723671456867
2757,0.2803,15,52,15,549023,56587,69694,38262,0.5241672533254289,0.4033990869698152
2758,0.2804,24,43,24,549066,56544,69718,38238,0.5237689429026641,0.4034310312084573
2759,0.2805,15,38,15,549104,56506,69733,38223,0.523416947645337,0.4034984007009469
2760,0.2806,20,39,20,549143,56467,69753,38203,0.5230556893549224,0.40353860779550016
2761,0.2807,24,53,24,549196,56414,69777,38179,0.522564748601282,0.40361337519689616
2762,0.2808,24,48,24,549244,56366,69801,38155,0.5221201230130794,0.40366690999883625
2763,0.2809,25,52,25,549296,56314,69826,38130,0.5216384452925266,0.40373131167676085
2764,0.281,18,50,18,549346,56264,69844,38112,0.5211752936381489,0.40383148258031704
2765,0.2811,17,55,17,549401,56209,69861,38095,0.5206658268183334,0.4039595351204615
2766,0.2812,21,45,21,549446,56164,69882,38074,0.5202489903293934,0.4040196099238099
2767,0.2813,21,52,21,549498,56112,69903,38053,0.5197673126088407,0.4041098072532257
2768,0.2814,25,49,25,549547,56063,69928,38028,0.5193134239875505,0.40416192834596293
2769,0.2815,16,54,16,549601,56009,69944,38012,0.5188132202008225,0.4042926580232076
2770,0.2816,23,47,23,549648,55962,69967,37989,0.5183778576457075,0.4043490755819523
2771,0.2817,22,47,22,549695,55915,69989,37967,0.5179424950905924,0.40441192134807524
2772,0.2818,18,47,18,549742,55868,70007,37949,0.5175071325354774,0.4045002504876515
2773,0.2819,25,46,25,549788,55822,70032,37924,0.5170810330134499,0.4045399270368869
2774,0.282,24,47,24,549835,55775,70056,37900,0.5166456704583349,0.40459033893781693
2775,0.2821,16,44,16,549879,55731,70072,37884,0.5162380970024825,0.40467873738182986
2776,0.2822,21,43,21,549922,55688,70093,37863,0.5158397865797176,0.40473110923453515
2777,0.2823,23,56,23,549978,55632,70116,37840,0.5153210567268146,0.40482711400205407
2778,0.2824,16,49,16,550027,55583,70132,37824,0.5148671681055245,0.4049375314483925
2779,0.2825,21,46,21,550073,55537,70153,37803,0.514441068583497,0.40500321405613887
2780,0.2826,28,60,28,550133,55477,70181,37775,0.5138852865982437,0.40508514562690345
2781,0.2827,22,41,22,550174,55436,70203,37753,0.513505502241654,0.4051229222333108
2782,0.2828,14,47,14,550221,55389,70217,37739,0.5130701396865389,0.40523795206597374
2783,0.2829,16,51,16,550272,55338,70233,37723,0.5125977249990737,0.40535777608235457
2784,0.283,13,50,13,550322,55288,70246,37710,0.512134573344696,0.40549259123852127
2785,0.2831,25,53,25,550375,55235,70271,37685,0.5116436325910556,0.40556392595781315
2786,0.2832,17,55,17,550430,55180,70288,37668,0.5111341657712402,0.40569533000172325
2787,0.2833,21,35,21,550465,55145,70309,37647,0.5108099596131758,0.4057138546426416
2788,0.2834,18,52,18,550517,55093,70327,37629,0.5103282818926229,0.40582601755786113
2789,0.2835,16,59,16,550576,55034,70343,37613,0.5097817629404572,0.40598184506783813
2790,0.2836,10,54,10,550630,54980,70353,37603,0.5092815591537293,0.40615447760387974
2791,0.2837,21,45,21,550675,54935,70374,37582,0.5088647226647893,0.40621723575126734
2792,0.2838,25,45,25,550720,54890,70399,37557,0.5084478861758495,0.4062543944097699
2793,0.2839,19,41,19,550761,54849,70418,37538,0.5080681018192597,0.4063125764447379
2794,0.284,19,40,19,550801,54809,70437,37519,0.5076975804957575,0.40636643271813533
2795,0.2841,20,39,20,550840,54770,70457,37499,0.507336322205343,0.40640951999046265
2796,0.2842,20,43,20,550883,54727,70477,37479,0.5069380117825781,0.4064702947747435
2797,0.2843,19,48,19,550931,54679,70496,37460,0.5064933861943755,0.4065596544351469
2798,0.2844,15,54,15,550985,54625,70511,37445,0.5059931824076476,0.4067014228304551
2799,0.2845,13,52,13,551037,54573,70524,37432,0.5055115046870947,0.4068474539427205
2800,0.2846,16,40,16,551077,54533,70540,37416,0.5051409833635926,0.4069212280720834
2801,0.2847,21,50,21,551127,54483,70561,37395,0.5046778317092149,0.407007118134918
2802,0.2848,26,58,26,551185,54425,70587,37369,0.5041405757901367,0.4070963243784997
2803,0.2849,21,44,21,551229,54381,70608,37348,0.5037330023342843,0.40715586128705206
2804,0.285,23,49,23,551278,54332,70631,37325,0.5032791137129942,0.4072247618839805
2805,0.2851,22,52,22,551330,54280,70653,37303,0.5027974359924413,0.4073135843988513
2806,0.2852,27,43,27,551373,54237,70680,37276,0.5023991255696766,0.40733010610514353
2807,0.2853,23,40,23,551413,54197,70703,37253,0.5020286042461743,0.40735921268452707
2808,0.2854,25,42,25,551455,54155,70728,37228,0.5016395568564971,0.4073843056148299
2809,0.2855,19,47,19,551502,54108,70747,37209,0.5012041943013821,0.40747067906304413
2810,0.2856,17,34,17,551536,54074,70764,37192,0.5008892511764051,0.4075121074660881
2811,0.2857,18,54,18,551590,54020,70782,37174,0.5003890473896773,0.4076364673114459
2812,0.2858,22,52,22,551642,53968,70804,37152,0.49990736966912447,0.4077260755048288
2813,0.2859,25,41,25,551683,53927,70829,37127,0.4995275853125347,0.40774705120038657
2814,0.286,21,49,21,551732,53878,70850,37106,0.4990736966912446,0.40782994812274687
2815,0.2861,22,42,22,551774,53836,70872,37084,0.4986846493015673,0.40787505499340077
2816,0.2862,22,46,22,551820,53790,70894,37062,0.4982585497795398,0.40793818518029323
2817,0.2863,25,55,25,551875,53735,70919,37037,0.4977490829597243,0.40802229762481823
2818,0.2864,25,51,25,551926,53684,70944,37012,0.4972766682722591,0.40808855958366413
2819,0.2865,27,48,27,551974,53636,70971,36985,0.49683204268405645,0.40812835876893877
2820,0.2866,27,35,27,552009,53601,70998,36958,0.49650783652599206,0.4081096301858457
2821,0.2867,20,41,20,552050,53560,71018,36938,0.49612805216940237,0.40816371632522264
2822,0.2868,14,45,14,552095,53515,71032,36924,0.4957112156804624,0.4082751910127268
2823,0.2869,13,44,13,552139,53471,71045,36911,0.49530364222461004,0.40838883848553914
2824,0.287,21,50,21,552189,53421,71066,36890,0.4948404905702323,0.4084773726345628
2825,0.2871,21,58,21,552247,53363,71087,36869,0.49430323465115417,0.40860226970476105
2826,0.2872,13,44,13,552291,53319,71100,36856,0.4938956611953018,0.4087163848073191
2827,0.2873,23,48,23,552339,53271,71123,36833,0.4934510356070992,0.4087831838764095
2828,0.2874,20,39,20,552378,53232,71143,36813,0.4930897773166846,0.4088289188738964
2829,0.2875,18,57,18,552435,53175,71161,36795,0.492561784430694,0.40896965655218404
2830,0.2876,17,43,17,552478,53132,71178,36778,0.49216347400792915,0.4090534979423868
2831,0.2877,12,51,12,552529,53081,71190,36766,0.4916910593204639,0.40920676260754396
2832,0.2878,19,35,19,552564,53046,71209,36747,0.4913668531623995,0.40924125488623836
2833,0.2879,23,47,23,552611,52999,71232,36724,0.49093149060728447,0.4093041917902879
2834,0.288,16,50,16,552661,52949,71248,36708,0.49046833895290676,0.40942703860267465
2835,0.2881,17,51,17,552712,52898,71265,36691,0.4899959242654415,0.4095480471932938
2836,0.2882,18,38,18,552750,52860,71283,36673,0.48964392900811443,0.4096031630795349
2837,0.2883,16,45,16,552795,52815,71299,36657,0.48922709251917446,0.40970359442060084
2838,0.2884,27,53,27,552848,52762,71326,36630,0.4887361517655341,0.4097682119205298
2839,0.2885,15,47,15,552895,52715,71341,36615,0.4883007892104191,0.40988469719019366
2840,0.2886,18,34,18,552929,52681,71359,36597,0.4879858460854422,0.40992181724501
2841,0.2887,25,36,25,552965,52645,71384,36572,0.48765237689429025,0.4099218758756739
2842,0.2888,20,49,20,553014,52596,71404,36552,0.4871984882730001,0.410014806838067
2843,0.2889,24,58,24,553072,52538,71428,36528,0.48666123235392195,0.41012283026070556
2844,0.289,16,50,16,553122,52488,71444,36512,0.48619808069954423,0.41024719101123597
2845,0.2891,19,47,19,553169,52441,71463,36493,0.48576271814442923,0.4103380034632424
2846,0.2892,18,47,18,553216,52394,71481,36475,0.48532735558931417,0.4104355849621353
2847,0.2893,19,44,19,553260,52350,71500,36456,0.48491978213346176,0.4105128031889737
2848,0.2894,11,58,11,553318,52292,71511,36445,0.48438252621438366,0.4107080473759537
2849,0.2895,13,44,13,553362,52248,71524,36432,0.48397495275853125,0.41082543978349123
2850,0.2896,20,47,20,553409,52201,71544,36412,0.4835395902034162,0.4109103630392832
2851,0.2897,20,50,20,553459,52151,71564,36392,0.4830764385490385,0.4110093400946433
2852,0.2898,20,55,20,553514,52096,71584,36372,0.482566971729223,0.4111317086404124
2853,0.2899,24,38,24,553552,52058,71608,36348,0.482214976471896,0.4111485645770649
2854,0.29,17,35,17,553587,52023,71625,36331,0.48189077031383154,0.4111981347760147
2855,0.2901,16,37,16,553624,51986,71641,36315,0.48154803808959207,0.4112637455974451
2856,0.2902,20,46,20,553670,51940,71661,36295,0.4811219385675646,0.4113447044823483
2857,0.2903,14,45,14,553715,51895,71675,36281,0.4807051020786246,0.41146116857194703
2858,0.2904,15,50,15,553765,51845,71690,36266,0.4802419504242469,0.41159446607120564
2859,0.2905,14,38,14,553803,51807,71704,36252,0.47988995516691985,0.4116785337103533
2860,0.2906,17,57,17,553860,51750,71721,36235,0.47936196228092925,0.41183156219810196
2861,0.2907,15,32,15,553892,51718,71736,36220,0.4790655452221275,0.4118810980463508
2862,0.2908,15,44,15,553936,51674,71751,36205,0.47865797176627517,0.4119869365832565
2863,0.2909,24,32,24,553968,51642,71775,36181,0.47836155470747344,0.41197636154538103
2864,0.291,10,57,10,554025,51585,71785,36171,0.47783356182148284,0.4121769451661425
2865,0.2911,27,39,27,554064,51546,71812,36144,0.47747230353106823,0.41217926787547043
2866,0.2912,19,40,19,554104,51506,71831,36125,0.47710178220756605,0.4122399607444854
2867,0.2913,16,42,16,554146,51464,71847,36109,0.4767127348178888,0.41233028444840303
2868,0.2914,16,46,16,554192,51418,71863,36093,0.4762866352958613,0.41243957902435124
2869,0.2915,12,45,12,554237,51373,71875,36081,0.4758697988069213,0.4125711802776317
2870,0.2916,20,47,20,554284,51326,71895,36061,0.4754344362518063,0.41265863343517917
2871,0.2917,11,47,11,554331,51279,71906,36050,0.47499907369669125,0.4128067423192754
2872,0.2918,19,57,19,554388,51222,71925,36031,0.47447108081070066,0.41294855191225516
2873,0.2919,16,44,16,554432,51178,71941,36015,0.47406350735484826,0.4130492126661544
2874,0.292,14,48,14,554480,51130,71955,36001,0.4736188817666457,0.4131824494152483
2875,0.2921,11,52,11,554532,51078,71966,35990,0.47313720404609283,0.4133550787889925
2876,0.2922,19,50,19,554582,51028,71985,35971,0.4726740523917151,0.4134645225807193
2877,0.2923,17,37,17,554619,50991,72002,35954,0.47233132016747564,0.4135257921674622
2878,0.2924,22,44,22,554663,50947,72024,35932,0.47192374671162324,0.4135867125542421
2879,0.2925,15,48,15,554711,50899,72039,35917,0.47147912112342066,0.4137140619240693
2880,0.2926,14,40,14,554751,50859,72053,35903,0.4711085997999185,0.4138101934026417
2881,0.2927,13,45,13,554796,50814,72066,35890,0.47069176331097856,0.4139370732607492
2882,0.2928,17,52,17,554848,50762,72083,35873,0.4702100855904257,0.414070525769031
2883,0.2929,21,41,21,554889,50721,72104,35852,0.469830301233836,0.41412449609000496
2884,0.293,20,37,20,554926,50684,72124,35832,0.4694875690095965,0.41416616579592214
2885,0.2931,16,49,16,554975,50635,72140,35816,0.46903368038830634,0.4142924893870516
2886,0.2932,15,46,15,555021,50589,72155,35801,0.46860758086627885,0.4144113902071999
2887,0.2933,17,34,17,555055,50555,72172,35784,0.46829263774130203,0.41445928259535086
2888,0.2934,15,51,15,555106,50504,72187,35769,0.46782022305383675,0.41460248281617657
2889,0.2935,16,47,16,555153,50457,72203,35753,0.4673848604987217,0.414719870084677
2890,0.2936,18,43,18,555196,50414,72221,35735,0.46698655007595685,0.41480458275778015
2891,0.2937,13,49,13,555245,50365,72234,35722,0.4665326614546667,0.41495231568064866
2892,0.2938,20,51,20,555296,50314,72254,35702,0.4660602467672014,0.41506231398809523
2893,0.2939,13,48,13,555344,50266,72267,35689,0.46561562117899885,0.4152056308533535
2894,0.294,21,38,21,555382,50228,72288,35668,0.4652636259216718,0.41524634441650365
2895,0.2941,18,46,18,555428,50182,72306,35650,0.4648375263996443,0.4153462578059465
2896,0.2942,12,37,12,555465,50145,72318,35638,0.4644947941754048,0.4154436193651423
2897,0.2943,25,39,25,555504,50106,72343,35613,0.4641335358849902,0.415462149581773
2898,0.2944,17,47,17,555551,50059,72360,35596,0.4636981733298751,0.4155741054229175
2899,0.2945,21,38,21,555589,50021,72381,35575,0.4633461780725481,0.4156152156642834
2900,0.2946,19,40,19,555629,49981,72400,35556,0.4629756567490459,0.41567976431251974
2901,0.2947,11,55,11,555684,49926,72411,35545,0.46246618992923044,0.4158720501690632
2902,0.2948,19,42,19,555726,49884,72430,35526,0.4620771425395532,0.4159466104671584
2903,0.2949,10,54,10,555780,49830,72440,35516,0.46157693875282524,0.416141354017763
2904,0.295,16,39,16,555819,49791,72456,35500,0.4612156804624106,0.4162221101874758
2905,0.2951,11,46,11,555865,49745,72467,35489,0.46078958094038314,0.41637140108407444
2906,0.2952,23,47,23,555912,49698,72490,35466,0.4603542183852681,0.41644356770466395
2907,0.2953,25,42,25,555954,49656,72515,35441,0.4599651709955908,0.41647766666274955
2908,0.2954,20,47,20,556001,49609,72535,35421,0.45952980844047575,0.4165706221333647
2909,0.2955,26,44,26,556045,49565,72561,35395,0.45912223498462335,0.4166078154425612
2910,0.2956,29,39,29,556084,49526,72590,35366,0.45876097669420873,0.4165999151863544
2911,0.2957,18,57,18,556141,49469,72608,35348,0.45823298380821814,0.4167560748434866
2912,0.2958,19,42,19,556183,49427,72627,35329,0.4578439364185409,0.41683184671291706
2913,0.2959,10,36,10,556219,49391,72637,35319,0.4575104672273889,0.41694014874276947
2914,0.296,12,42,12,556261,49349,72649,35307,0.45712141983771165,0.4170643545643546
2915,0.2961,12,43,12,556304,49306,72661,35295,0.4567231094149468,0.4171936501932601
2916,0.2962,17,50,17,556354,49256,72678,35278,0.4562599577605691,0.41732320723022687
2917,0.2963,31,50,31,556404,49206,72709,35247,0.4557968061061914,0.41735639941742747
2918,0.2964,26,51,26,556455,49155,72735,35221,0.45532439141872616,0.417429126765905
2919,0.2965,20,35,20,556490,49120,72755,35201,0.45500018526066177,0.41746421413408286
2920,0.2966,14,39,14,556529,49081,72769,35187,0.45463892697024716,0.4175606398632933
2921,0.2967,16,50,16,556579,49031,72785,35171,0.45417577531586945,0.41769791691408753
2922,0.2968,19,44,19,556623,48987,72804,35152,0.45376820186001704,0.41778485601207527
2923,0.2969,23,50,23,556673,48937,72827,35129,0.4533050502056393,0.41787405134061334
2924,0.297,12,45,12,556718,48892,72839,35117,0.4528882137166994,0.41801473651632565
2925,0.2971,13,51,13,556769,48841,72852,35104,0.4524157990292341,0.41817856930132824
2926,0.2972,20,39,20,556808,48802,72872,35084,0.4520545407388195,0.41823427031924276
2927,0.2973,15,46,15,556854,48756,72887,35069,0.451628441216792,0.4183596779003877
2928,0.2974,25,38,25,556892,48718,72912,35044,0.451276445959465,0.41837587450156394
2929,0.2975,19,53,19,556945,48665,72931,35025,0.4507855052058246,0.4185087824112797
2930,0.2976,15,37,15,556982,48628,72946,35010,0.4504427729815851,0.4185896362897248
2931,0.2977,18,52,18,557034,48576,72964,34992,0.4499610952610323,0.4187248707639288
2932,0.2978,18,43,18,557077,48533,72982,34974,0.44956278483826745,0.4188151891458201
2933,0.2979,17,40,17,557117,48493,72999,34957,0.44919226351476527,0.4188975434391851
2934,0.298,20,51,20,557168,48442,73019,34937,0.44871984882730004,0.4190143801196944
2935,0.2981,21,40,21,557208,48402,73040,34916,0.44834932750379786,0.4190691087160037
2936,0.2982,24,36,24,557244,48366,73064,34892,0.4480158583126459,0.4190828508972111
2937,0.2983,17,52,17,557296,48314,73081,34875,0.4475341805920931,0.419226099604515
2938,0.2984,15,39,15,557335,48275,73096,34860,0.4471729223016785,0.4193179767847477
2939,0.2985,18,46,18,557381,48229,73114,34842,0.44674682277965094,0.4194243478470224
2940,0.2986,18,42,18,557423,48187,73132,34824,0.4463577753899737,0.4195106672609654
2941,0.2987,20,39,20,557462,48148,73152,34804,0.44599651709955906,0.41956794290674126
2942,0.2988,24,37,24,557499,48111,73176,34780,0.4456537848753196,0.41958716869141405
2943,0.2989,17,35,17,557534,48076,73193,34763,0.4453295787172552,0.41964533613394656
2944,0.299,16,55,16,557589,48021,73209,34747,0.4448201118974397,0.4198120046394742
2945,0.2991,19,43,19,557632,47978,73228,34728,0.44442180147467486,0.4198969844993108
2946,0.2992,12,33,12,557665,47945,73240,34716,0.44411612138278556,0.4199804018823871
2947,0.2993,15,42,15,557707,47903,73255,34701,0.4437270739931083,0.420088615563411
2948,0.2994,12,43,12,557750,47860,73267,34689,0.44332876357034345,0.42022314019552026
2949,0.2995,17,32,17,557782,47828,73284,34672,0.4430323465115417,0.4202666666666667
2950,0.2996,16,32,16,557814,47796,73300,34656,0.44273592945274,0.4203172755057488
2951,0.2997,20,39,20,557853,47757,73320,34636,0.4423746711623254,0.4203755173376379
2952,0.2998,18,40,18,557893,47717,73338,34618,0.44200414983882325,0.4204530272666545
2953,0.2999,20,44,20,557937,47673,73358,34598,0.44159657638297084,0.420537005749292
2954,0.3,20,46,20,557983,47627,73378,34578,0.44117047686094335,0.420631348458123
2955,0.3001,30,30,30,558013,47597,73408,34548,0.4408925858683167,0.420573376346704
2956,0.3002,20,39,20,558052,47558,73428,34528,0.4405313275779021,0.42063202007650513
2957,0.3003,10,37,10,558089,47521,73438,34518,0.4401885953536626,0.4207511061812065
2958,0.3004,18,33,18,558122,47488,73456,34500,0.4398829152617733,0.4207932868224618
2959,0.3005,14,35,14,558157,47453,73470,34486,0.4395587091037089,0.42087406485312245
2960,0.3006,20,46,20,558203,47407,73490,34466,0.43913260958168143,0.4209690618396785
2961,0.3007,21,36,21,558239,47371,73511,34445,0.4387991403905295,0.4210056712623448
2962,0.3008,21,34,21,558273,47337,73532,34424,0.43848419726555266,0.4210320323870794
2963,0.3009,14,46,14,558319,47291,73546,34410,0.43805809774352517,0.4211698755217194
2964,0.301,14,51,14,558370,47240,73560,34396,0.4375856830560599,0.421333725317262
2965,0.3011,19,46,19,558416,47194,73579,34377,0.4371595835340324,0.4214365399467948
2966,0.3012,13,35,13,558451,47159,73592,34364,0.436835377375968,0.42152521374336077
2967,0.3013,18,29,18,558480,47130,73610,34346,0.4365667494164289,0.4215474495556974
2968,0.3014,24,39,24,558519,47091,73634,34322,0.4362054911260143,0.42157886332649575
2969,0.3015,15,30,15,558549,47061,73649,34307,0.43592760013338766,0.42162766689607706
2970,0.3016,18,32,18,558581,47029,73667,34289,0.4356311830745859,0.42166555990063703
2971,0.3017,19,43,19,558624,46986,73686,34270,0.4352328726518211,0.42175347051294676
2972,0.3018,23,34,23,558658,46952,73709,34247,0.43491792952684427,0.42176627790982646
2973,0.3019,17,39,17,558697,46913,73726,34230,0.43455667123642966,0.421847848859421
2974,0.302,17,37,17,558734,46876,73743,34213,0.43421393901219013,0.4219191258987039
2975,0.3021,20,46,20,558780,46830,73763,34193,0.43378783949016264,0.42201597077373093
2976,0.3022,19,42,19,558822,46788,73782,34174,0.4333987921004854,0.4220992564412934
2977,0.3023,24,42,24,558864,46746,73806,34150,0.4330097447108081,0.42214695411392406
2978,0.3024,25,42,25,558906,46704,73831,34125,0.43262069732113084,0.42218758118991945
2979,0.3025,16,40,16,558946,46664,73847,34109,0.43225017599762866,0.42228219825931934
2980,0.3026,17,29,17,558975,46635,73864,34092,0.4319815480380896,0.42231223754134306
2981,0.3027,17,38,17,559013,46597,73881,34075,0.43162955278076254,0.422389428798096
2982,0.3028,16,37,16,559050,46560,73897,34059,0.431286820556523,0.4224686488296803
2983,0.3029,14,47,14,559097,46513,73911,34045,0.430851458001408,0.42261476203480725
2984,0.303,21,32,21,559129,46481,73932,34024,0.43055504094260627,0.42263213465002175
2985,0.3031,13,49,13,559178,46432,73945,34011,0.43010115232131607,0.42279626567880363
2986,0.3032,16,43,16,559221,46389,73961,33995,0.42970284189855124,0.42290754378980894
2987,0.3033,17,30,17,559251,46359,73978,33978,0.42942495090592464,0.42294335113335074
2988,0.3034,17,35,17,559286,46324,73995,33961,0.42910074474786025,0.4230055427539391
2989,0.3035,16,38,16,559324,46286,74011,33945,0.42874874949053315,0.4230908252421134
2990,0.3036,16,39,16,559363,46247,74027,33929,0.42838749120011854,0.4231815006984634
2991,0.3037,21,61,21,559424,46186,74048,33908,0.4278224461817778,0.42335256074112915
2992,0.3038,17,43,17,559467,46143,74065,33891,0.42742413575901295,0.42345753054951646
2993,0.3039,18,36,18,559503,46107,74083,33873,0.427090666567861,0.42351837959489874
2994,0.304,18,39,18,559542,46068,74101,33855,0.4267294082774464,0.42359521039000037
2995,0.3041,10,50,10,559592,46018,74111,33845,0.42626625662306866,0.423788237356473
2996,0.3042,19,50,19,559642,45968,74130,33826,0.42580310496869095,0.4239165852069078
2997,0.3043,15,31,15,559673,45937,74145,33811,0.4255159509429768,0.4239730149972413
2998,0.3044,12,38,12,559711,45899,74157,33799,0.4251639556856497,0.4240884338377375
2999,0.3045,19,41,19,559752,45858,74176,33780,0.42478417132906,0.42416936638288255
3000,0.3046,20,34,20,559786,45824,74196,33760,0.42446922820408317,0.424205870526739
3001,0.3047,22,49,22,559835,45775,74218,33738,0.42401533958279297,0.42430797479657417
3002,0.3048,16,42,16,559877,45733,74234,33722,0.4236262921931157,0.4244163362909823
3003,0.3049,22,40,22,559917,45693,74256,33700,0.4232557708696135,0.4244706712178656
3004,0.305,17,41,17,559958,45652,74273,33683,0.4228759865130238,0.4245667107833869
3005,0.3051,24,42,24,560000,45610,74297,33659,0.42248693912334656,0.42461744187513406
3006,0.3052,21,31,21,560031,45579,74318,33638,0.4221997850976324,0.4246310766628375
3007,0.3053,11,40,11,560071,45539,74329,33627,0.4218292637741302,0.4247656822373241
3008,0.3054,17,39,17,560110,45500,74346,33610,0.4214680054837156,0.4248514726330426
3009,0.3055,14,32,14,560142,45468,74360,33596,0.42117158842491387,0.42492158251543055
3010,0.3056,20,53,20,560195,45415,74380,33576,0.4206806476712735,0.4250610829081794
3011,0.3057,19,37,19,560232,45378,74399,33557,0.42033791544703397,0.4251219357699373
3012,0.3058,20,32,20,560264,45346,74419,33537,0.42004149838823224,0.4251486378560653
3013,0.3059,16,37,16,560301,45309,74435,33521,0.41969876616399276,0.4252315108461246
3014,0.306,21,36,21,560337,45273,74456,33500,0.4193652969728408,0.4252726187907024
3015,0.3061,25,47,25,560384,45226,74481,33475,0.41892993441772575,0.4253440235829278
3016,0.3062,21,44,21,560428,45182,74502,33454,0.41852236096187334,0.42542855689506076
3017,0.3063,21,43,21,560471,45139,74523,33433,0.4181240505391085,0.4255078144886219
3018,0.3064,7,36,7,560507,45103,74530,33426,0.4177905813479566,0.42565167008366334
3019,0.3065,23,30,23,560537,45073,74553,33403,0.41751269035532995,0.4256460573933432
3020,0.3066,12,43,12,560580,45030,74565,33391,0.4171143799325651,0.4257915609339335
3021,0.3067,22,43,22,560623,44987,74587,33369,0.4167160695098003,0.42586400530910207
3022,0.3068,23,36,23,560659,44951,74610,33346,0.4163826003186483,0.42589115802648886
3023,0.3069,12,41,12,560700,44910,74622,33334,0.4160028159620586,0.426026276775216
3024,0.307,19,36,19,560736,44874,74641,33315,0.41566934677090667,0.42608295284502934
3025,0.3071,21,36,21,560772,44838,74662,33294,0.4153358775797547,0.42612501919827983
3026,0.3072,18,36,18,560808,44802,74680,33276,0.41500240838860275,0.42618919541996464
3027,0.3073,10,46,10,560854,44756,74690,33266,0.41457630886657526,0.42636692215016275
3028,0.3074,21,38,21,560892,44718,74711,33245,0.4142243136092482,0.42642022497851545
3029,0.3075,22,31,22,560923,44687,74733,33223,0.41393715958353405,0.42642792966243104
3030,0.3076,24,32,24,560955,44655,74757,33199,0.4136407425247323,0.4264263878541886
3031,0.3077,20,30,20,560985,44625,74777,33179,0.41336285153210567,0.42644337052079584
3032,0.3078,20,51,20,561036,44574,74797,33159,0.4128904368446404,0.4265755856586006
3033,0.3079,12,41,12,561077,44533,74809,33147,0.4125106524880507,0.4267121524201854
3034,0.308,18,41,18,561118,44492,74827,33129,0.412130868131461,0.4268046018474382
3035,0.3081,16,31,16,561149,44461,74843,33113,0.41184371410574677,0.4268569366024699
3036,0.3082,21,43,21,561192,44418,74864,33092,0.41144540368298194,0.426938459553606
3037,0.3083,19,35,19,561227,44383,74883,33073,0.41112119752491755,0.42699080768436276
3038,0.3084,13,44,13,561271,44339,74896,33060,0.4107136240690652,0.4271373015155235
3039,0.3085,12,35,12,561306,44304,74908,33048,0.41038941791100075,0.42724170027924296
3040,0.3086,16,34,16,561340,44270,74924,33032,0.41007447478602393,0.42731106569040905
3041,0.3087,16,39,16,561379,44231,74940,33016,0.4097132164956093,0.42740818413660076
3042,0.3088,21,48,21,561427,44183,74961,32995,0.40926859090740675,0.4275182046697245
3043,0.3089,15,47,15,561474,44136,74976,32980,0.4088332283522917,0.42766741013538045
3044,0.309,21,42,21,561516,44094,74997,32959,0.4084441809626144,0.42774453947283037
3045,0.3091,23,27,23,561543,44067,75020,32936,0.4081940790692504,0.4277235951846032
3046,0.3092,27,36,27,561579,44031,75047,32909,0.40786060987809847,0.4277229009617884
3047,0.3093,20,36,20,561615,43995,75067,32889,0.4075271406869465,0.4277743093491494
3048,0.3094,15,33,15,561648,43962,75082,32874,0.40722146059505726,0.4278463220365454
3049,0.3095,22,45,22,561693,43917,75104,32852,0.4068046241061173,0.4279331500996496
3050,0.3096,17,39,17,561732,43878,75121,32835,0.4064433658157027,0.42802393336201167
3051,0.3097,19,33,19,561765,43845,75140,32816,0.4061376857238134,0.42806642230077874
3052,0.3098,13,41,13,561806,43804,75153,32803,0.4057579013672237,0.4281984675029697
3053,0.3099,17,38,17,561844,43766,75170,32786,0.40540590610989663,0.4282840422196677
3054,0.31,14,26,14,561870,43740,75184,32772,0.4051650672496202,0.4283249686323714
3055,0.3101,20,24,20,561894,43716,75204,32752,0.4049427544555189,0.4283098812575195
3056,0.3102,12,42,12,561936,43674,75216,32740,0.40455370706584165,0.428455518622242
3057,0.3103,18,43,18,561979,43631,75234,32722,0.4041553966430768,0.4285620735269079
3058,0.3104,18,42,18,562021,43589,75252,32704,0.40376634925339955,0.4286631801082668
3059,0.3105,12,41,12,562062,43548,75264,32692,0.4033865648968098,0.42880377754459603
3060,0.3106,19,32,19,562094,43516,75283,32673,0.40309014783800806,0.42884143380277995
3061,0.3107,26,27,26,562121,43489,75309,32647,0.4028400459446441,0.4287984659031207
3062,0.3108,23,29,23,562150,43460,75332,32624,0.40257141798510504,0.4287892329530519
3063,0.3109,22,33,22,562183,43427,75354,32602,0.40226573789321574,0.4288100593194702
3064,0.311,16,40,16,562223,43387,75370,32586,0.4018952165697136,0.428915535782449
3065,0.3111,16,49,16,562272,43338,75386,32570,0.4014413279484234,0.42907203456816145
3066,0.3112,21,40,21,562312,43298,75407,32549,0.4010708066249213,0.4291402428573312
3067,0.3113,15,37,15,562349,43261,75422,32534,0.40072807440068176,0.42923675704202124
3068,0.3114,18,42,18,562391,43219,75440,32516,0.4003390270110045,0.4293391430646333
3069,0.3115,24,29,24,562420,43190,75464,32492,0.4000703990514654,0.4293226923178563
3070,0.3116,18,37,18,562457,43153,75482,32474,0.3997276668272259,0.42939690851151047
3071,0.3117,21,36,21,562493,43117,75503,32453,0.399394197636074,0.4294429006219399
3072,0.3118,18,33,18,562526,43084,75521,32435,0.3990885175441847,0.42949456428183636
3073,0.3119,14,44,14,562570,43040,75535,32421,0.39868094408833227,0.4296391513497038
3074,0.312,9,25,9,562595,43015,75544,32412,0.3984493682611434,0.42971349781908336
3075,0.3121,16,39,16,562634,42976,75560,32396,0.3980881099707288,0.4298147853314228
3076,0.3122,20,35,20,562669,42941,75580,32376,0.3977639038126644,0.429863111913645
3077,0.3123,11,31,11,562700,42910,75591,32365,0.39747674978695025,0.42995682497509136
3078,0.3124,15,44,15,562744,42866,75606,32350,0.39706917633109784,0.43009466071048713
3079,0.3125,21,33,21,562777,42833,75627,32329,0.3967634962392086,0.4301242649211037
3080,0.3126,20,35,20,562812,42798,75647,32309,0.39643929008114415,0.4301729532533585
3081,0.3127,19,36,19,562848,42762,75666,32290,0.39610582088999224,0.4302350370409849
3082,0.3128,14,27,14,562875,42735,75680,32276,0.39585571899662825,0.430283558411433
3083,0.3129,13,36,13,562911,42699,75693,32263,0.3955222498054763,0.4303913983084763
3084,0.313,21,36,21,562947,42663,75714,32242,0.39518878061432433,0.43043855550363797
3085,0.3131,19,25,19,562972,42638,75733,32223,0.3949572047871355,0.4304377446200291
3086,0.3132,19,30,19,563002,42608,75752,32204,0.3946793137945089,0.43046570068972895
3087,0.3133,23,36,23,563038,42572,75775,32181,0.3943458446033569,0.43049777266464223
3088,0.3134,13,32,13,563070,42540,75788,32168,0.3940494275445552,0.4305830700862023
3089,0.3135,17,46,17,563116,42494,75805,32151,0.3936233280225277,0.4307187353473106
3090,0.3136,15,36,15,563152,42458,75820,32136,0.39328985883137574,0.4308121296619031
3091,0.3137,18,36,18,563188,42422,75838,32118,0.3929563896402238,0.43088274751811106
3092,0.3138,20,32,20,563220,42390,75858,32098,0.39265997258142205,0.4309150467189346
3093,0.3139,19,37,19,563257,42353,75877,32079,0.3923172403571826,0.4309839853826311
3094,0.314,17,34,17,563291,42319,75894,32062,0.3920022972322057,0.4310509404283352
3095,0.3141,22,42,22,563333,42277,75916,32040,0.39161324984252843,0.43112612188328375
3096,0.3142,16,27,16,563360,42250,75932,32024,0.3913631479491645,0.43116029835474057
3097,0.3143,15,38,15,563398,42212,75947,32009,0.3910111526918374,0.43126608372293557
3098,0.3144,14,40,14,563438,42172,75961,31995,0.39064063136833527,0.4313913195895749
3099,0.3145,13,36,13,563474,42136,75974,31982,0.3903071621771833,0.4315011198359373
3100,0.3146,16,35,16,563509,42101,75990,31966,0.3899829560191189,0.4315822161016377
3101,0.3147,20,48,20,563557,42053,76010,31946,0.3895383304309163,0.431708536601846
3102,0.3148,13,33,13,563590,42020,76023,31933,0.389232650339027,0.43180127919083744
3103,0.3149,15,43,15,563633,41977,76038,31918,0.3888343399162622,0.4319372082008255
3104,0.315,14,46,14,563679,41931,76052,31904,0.38840824039423466,0.4320985982257737
3105,0.3151,14,37,14,563716,41894,76066,31890,0.3880655081699952,0.4322075246665944
3106,0.3152,22,45,22,563761,41849,76088,31868,0.38764867168105527,0.43230191136372886
3107,0.3153,20,38,20,563799,41811,76108,31848,0.38729667642372817,0.4323707897201971
3108,0.3154,23,24,23,563823,41787,76131,31825,0.3870743636296269,0.432334401999674
3109,0.3155,16,33,16,563856,41754,76147,31809,0.3867686835377376,0.4324048774519799
3110,0.3156,11,30,11,563886,41724,76158,31798,0.386490792545111,0.4324963956366802
3111,0.3157,13,28,13,563914,41696,76171,31785,0.3862314276186595,0.43256079802942254
3112,0.3158,22,25,22,563939,41671,76193,31763,0.3859998517914706,0.4325380613884577
3113,0.3159,14,34,14,563973,41637,76207,31749,0.38568490866649374,0.43263020194587526
3114,0.316,24,45,24,564018,41592,76231,31725,0.3852680721775538,0.4327100126846434
3115,0.3161,19,33,19,564051,41559,76250,31706,0.3849623920856645,0.4327577970381492
3116,0.3162,23,39,23,564090,41520,76273,31683,0.3846011337952499,0.43281013073234703
3117,0.3163,19,25,19,564115,41495,76292,31664,0.38436955796806105,0.43281072731994696
3118,0.3164,20,29,20,564144,41466,76312,31644,0.38410093000852197,0.4328272466146902
3119,0.3165,19,35,19,564179,41431,76331,31625,0.3837767238504576,0.4328871003066141
3120,0.3166,19,30,19,564209,41401,76350,31606,0.383498832857831,0.43291739148300845
3121,0.3167,17,41,17,564250,41360,76367,31589,0.38311904850124123,0.43302855419539676
3122,0.3168,17,32,17,564282,41328,76384,31572,0.3828226314424395,0.4330864197530864
3123,0.3169,15,34,15,564316,41294,76399,31557,0.3825076883174627,0.4331718164472691
3124,0.317,15,43,15,564359,41251,76414,31542,0.38210937789469784,0.43331089527839217
3125,0.3171,19,37,19,564396,41214,76433,31523,0.3817666456704583,0.43338328498563317
3126,0.3172,26,38,26,564434,41176,76459,31497,0.3814146504131313,0.4334071801081557
3127,0.3173,22,32,22,564466,41144,76481,31475,0.38111823335432954,0.43342651372230406
3128,0.3174,14,39,14,564505,41105,76495,31461,0.3807569750639149,0.43355014745197473
3129,0.3175,24,34,24,564539,41071,76519,31437,0.3804420319389381,0.43356595134330006
3130,0.3176,13,34,13,564573,41037,76532,31424,0.38012708881396123,0.43366776610866536
3131,0.3177,22,36,22,564609,41001,76554,31402,0.3797936196228093,0.43371131030482163
3132,0.3178,18,50,18,564659,40951,76572,31384,0.37933046796843156,0.43387018732287275
3133,0.3179,13,48,13,564707,40903,76585,31371,0.378885842380229,0.43405650718100564
3134,0.318,18,25,18,564732,40878,76603,31353,0.37865426655304013,0.43406570586036464
3135,0.3181,11,29,11,564761,40849,76614,31342,0.37838563859350105,0.4341538418916485
3136,0.3182,19,40,19,564801,40809,76633,31323,0.37801511726999887,0.43424554982532027
3137,0.3183,9,34,9,564835,40775,76642,31314,0.37770017414502205,0.43437972506207606
3138,0.3184,12,36,12,564871,40739,76654,31302,0.3773667049538701,0.4345025749226135
3139,0.3185,19,35,19,564906,40704,76673,31283,0.3770424987958057,0.43456457415922317
3140,0.3186,21,33,21,564939,40671,76694,31262,0.3767368187039164,0.43459886283068966
3141,0.3187,26,42,26,564981,40629,76720,31236,0.37634777131423913,0.4346482988937591
3142,0.3188,34,32,34,565013,40597,76754,31202,0.3760513542554374,0.43457429769216843
3143,0.3189,10,42,10,565055,40555,76764,31192,0.37566230686576013,0.43474988501261375
3144,0.319,13,39,13,565094,40516,76777,31179,0.3753010485753455,0.4348838831159774
3145,0.3191,13,28,13,565122,40488,76790,31166,0.375041683648894,0.43495129371702906
3146,0.3192,11,35,11,565157,40453,76801,31155,0.3747174774908296,0.435077086359066
3147,0.3193,19,28,19,565185,40425,76820,31136,0.37445811256437805,0.43509732955101244
3148,0.3194,25,34,25,565219,40391,76845,31111,0.37414316943940124,0.43510671030180975
3149,0.3195,17,41,17,565260,40350,76862,31094,0.37376338508281154,0.4352219920497173
3150,0.3196,12,32,12,565292,40318,76874,31082,0.3734669680240098,0.4353221288515406
3151,0.3197,26,26,26,565318,40292,76900,31056,0.3732261291637334,0.4352749901889331
3152,0.3198,20,34,20,565352,40258,76920,31036,0.3729111860387565,0.43532415069991864
3153,0.3199,12,37,12,565389,40221,76932,31024,0.37256845381451703,0.4354551196575198
3154,0.32,11,19,11,565408,40202,76943,31013,0.3723924561858535,0.4354840974513796
3155,0.3201,16,25,16,565433,40177,76959,30997,0.3721608803586646,0.4355101582038385
3156,0.3202,18,25,18,565458,40152,76977,30979,0.37192930453147577,0.4355203778943077
3157,0.3203,18,28,18,565486,40124,76995,30961,0.37166993960502426,0.43554899064500247
3158,0.3204,16,24,16,565510,40100,77011,30945,0.37144762681092297,0.43556900555985645
3159,0.3205,17,29,17,565539,40071,77028,30928,0.3711789988513839,0.4356117691798476
3160,0.3206,16,37,16,565576,40034,77044,30912,0.3708362666271444,0.4357116680292053
3161,0.3207,14,38,14,565614,39996,77058,30898,0.3704842713698173,0.4358337800095918
3162,0.3208,10,49,10,565663,39947,77068,30888,0.3700303827485272,0.43605562222065364
3163,0.3209,25,40,25,565703,39907,77093,30863,0.369659861425025,0.43610286844708207
3164,0.321,13,29,13,565732,39878,77106,30850,0.3693912334654859,0.4361780341590318
3165,0.3211,19,21,19,565753,39857,77125,30831,0.3691967097706473,0.43615606609325486
3166,0.3212,14,31,14,565784,39826,77139,30817,0.3689095557449331,0.43623572045354814
3167,0.3213,19,27,19,565811,39799,77158,30798,0.3686594538515692,0.4362508321883366
3168,0.3214,15,28,15,565839,39771,77173,30783,0.36840008892511766,0.43630410749213366
3169,0.3215,19,31,19,565870,39740,77192,30764,0.36811293489940344,0.4363440372177465
3170,0.3216,9,29,9,565899,39711,77201,30755,0.36784430693986436,0.4364516220588653
3171,0.3217,15,37,15,565936,39674,77216,30740,0.3675015747156249,0.4365609111824353
3172,0.3218,15,29,15,565965,39645,77231,30725,0.3672329467560858,0.4366207190564161
3173,0.3219,22,32,22,565997,39613,77253,30703,0.3669365296972841,0.43664315376301266
3174,0.322,11,26,11,566023,39587,77264,30692,0.36669569083700765,0.4367165156021002
3175,0.3221,22,25,22,566048,39562,77286,30670,0.3664641150098188,0.43669552340813306
3176,0.3222,16,36,16,566084,39526,77302,30654,0.3661306458186669,0.43679110857794246
3177,0.3223,12,30,12,566114,39496,77314,30642,0.36585275482604024,0.43688157632096725
3178,0.3224,18,37,18,566151,39459,77332,30624,0.3655100226018007,0.4369675955652583
3179,0.3225,15,31,15,566182,39428,77347,30609,0.36522286857608655,0.43704042149149736
3180,0.3226,17,36,17,566218,39392,77364,30592,0.3648893993849346,0.43712848651120256
3181,0.3227,17,31,17,566249,39361,77381,30575,0.3646022453592204,0.4371854266758179
3182,0.3228,12,32,12,566281,39329,77393,30563,0.3643058283004187,0.43728896010988383
3183,0.3229,18,28,18,566309,39301,77411,30545,0.3640464633739672,0.43731924519657533
3184,0.323,16,29,16,566338,39272,77427,30529,0.3637778354144281,0.43737195742181345
3185,0.3231,20,37,20,566375,39235,77447,30509,0.36343510319018857,0.43744264739619176
3186,0.3232,19,50,19,566425,39185,77466,30490,0.3629719515358109,0.43760315751704343
3187,0.3233,12,36,12,566461,39149,77478,30478,0.36263848234465895,0.43773248883335486
3188,0.3234,24,31,24,566492,39118,77502,30454,0.36235132831894473,0.43773357097682974
3189,0.3235,19,31,19,566523,39087,77521,30435,0.36206417429323057,0.4377750927763873
3190,0.3236,15,46,15,566569,39041,77536,30420,0.3616380747712031,0.4379435942471315
3191,0.3237,18,38,18,566607,39003,77554,30402,0.36128607951387604,0.4380376053598444
3192,0.3238,17,30,17,566637,38973,77571,30385,0.3610081885212494,0.4380893336024684
3193,0.3239,14,36,14,566673,38937,77585,30371,0.3606747193300974,0.43820338200496334
3194,0.324,20,34,20,566707,38903,77605,30351,0.3603597762051206,0.4382562740058336
3195,0.3241,14,35,14,566742,38868,77619,30337,0.3600355700470562,0.43836428003756955
3196,0.3242,12,35,12,566777,38833,77631,30325,0.35971136388899183,0.4384886780994245
3197,0.3243,19,29,19,566806,38804,77650,30306,0.35944273592945275,0.4385183041527999
3198,0.3244,18,37,18,566843,38767,77668,30288,0.3591000037052132,0.4386069075374701
3199,0.3245,12,32,12,566875,38735,77680,30276,0.3588035866464115,0.43871266899479794
3200,0.3246,13,41,13,566916,38694,77693,30263,0.3584238022898218,0.4388677001609699
3201,0.3247,19,33,19,566949,38661,77712,30244,0.3581181221979325,0.43892315506857266
3202,0.3248,13,40,13,566989,38621,77725,30231,0.3577476008744303,0.43907221286237147
3203,0.3249,16,39,16,567028,38582,77741,30215,0.3573863425840157,0.43919066238353416
3204,0.325,13,32,13,567060,38550,77754,30202,0.35708992552521396,0.43928903886432397
3205,0.3251,19,42,19,567102,38508,77773,30183,0.3567008781355367,0.4394025418177054
3206,0.3252,19,32,19,567134,38476,77792,30164,0.35640446107673496,0.43945221445221444
3207,0.3253,25,39,25,567173,38437,77817,30139,0.35604320278632035,0.43949778348110125
3208,0.3254,11,35,11,567208,38402,77828,30128,0.35571899662825596,0.439632277834525
3209,0.3255,16,34,16,567242,38368,77844,30112,0.35540405350327914,0.4397196261682243
3210,0.3256,23,39,23,567281,38329,77867,30089,0.3550427952128645,0.43978192873220495
3211,0.3257,24,31,24,567312,38298,77891,30065,0.3547556411871503,0.4397846788467446
3212,0.3258,12,46,12,567358,38252,77903,30053,0.3543295416651228,0.43998243173998974
3213,0.3259,15,23,15,567381,38229,77918,30038,0.3541164919041091,0.4400076171503069
3214,0.326,27,27,27,567408,38202,77945,30011,0.3538663900107451,0.4399601249028777
3215,0.3261,13,20,13,567428,38182,77958,29998,0.35368112934899404,0.43998239953065416
3216,0.3262,20,35,20,567463,38147,77978,29978,0.35335692319092965,0.44004403669724773
3217,0.3263,20,33,20,567496,38114,77998,29958,0.35305124309904035,0.4400928428722529
3218,0.3264,13,27,13,567523,38087,78011,29945,0.3528011412056764,0.4401605126999059
3219,0.3265,15,33,15,567556,38054,78026,29930,0.3524954611137871,0.4402506472111085
3220,0.3266,20,34,20,567590,38020,78046,29910,0.3521805179888103,0.44030619755630795
3221,0.3267,15,36,15,567626,37984,78061,29895,0.3518470487976583,0.44041603441417815
3222,0.3268,22,34,22,567660,37950,78083,29873,0.35153210567268145,0.44045530277339545
3223,0.3269,20,24,20,567684,37926,78103,29853,0.35130979287858016,0.44044615588899216
3224,0.327,14,34,14,567718,37892,78117,29839,0.35099484975360334,0.4405515938049047
3225,0.3271,8,22,8,567740,37870,78125,29831,0.35079106302567714,0.44062864654879547
3226,0.3272,19,37,19,567777,37833,78144,29812,0.3504483308014376,0.4407125434252347
3227,0.3273,14,29,14,567806,37804,78158,29798,0.35017970284189853,0.44078577556877013
3228,0.3274,12,30,12,567836,37774,78170,29786,0.34990181184927194,0.440882178804026
3229,0.3275,14,32,14,567868,37742,78184,29772,0.3496053947904702,0.4409752051426371
3230,0.3276,18,38,18,567906,37704,78202,29754,0.3492533995331431,0.44107444632215603
3231,0.3277,21,32,21,567938,37672,78223,29733,0.34895698247434137,0.44110970996216897
3232,0.3278,16,26,16,567964,37646,78239,29717,0.348716143614065,0.44114721731514334
3233,0.3279,21,45,21,568009,37601,78260,29696,0.348299307125125,0.44126781282969524
3234,0.328,17,33,17,568042,37568,78277,29679,0.3479936270332358,0.44134310824274686
3235,0.3281,14,26,14,568068,37542,78291,29665,0.34775278817295935,0.44139747347746516
3236,0.3282,16,30,16,568098,37512,78307,29649,0.34747489718033275,0.441461562513959
3237,0.3283,18,31,18,568129,37481,78325,29631,0.34718774315461853,0.44151567528906904
3238,0.3284,17,38,17,568167,37443,78342,29614,0.3468357478972915,0.4416242897833187
3239,0.3285,17,32,17,568199,37411,78359,29597,0.34653933083848976,0.44169352913085
3240,0.3286,15,26,15,568225,37385,78374,29582,0.34629849197821333,0.4417399614735616
3241,0.3287,16,22,16,568247,37363,78390,29566,0.3460947052502871,0.44175170703282585
3242,0.3288,24,30,24,568277,37333,78414,29542,0.34581681425766053,0.4417495327102804
3243,0.3289,14,23,14,568300,37310,78428,29528,0.34560376449664676,0.441784613543194
3244,0.329,18,37,18,568337,37273,78446,29510,0.3452610322724073,0.4418789212823623
3245,0.3291,20,33,20,568370,37240,78466,29490,0.344955352180518,0.44193016634197513
3246,0.3292,22,40,22,568410,37200,78488,29468,0.3445848308570158,0.44201115977680444
3247,0.3293,22,39,22,568449,37161,78510,29446,0.3442235725666012,0.44208566667167115
3248,0.3294,19,25,19,568474,37136,78529,29427,0.34399199673941233,0.4420924537656055
3249,0.3295,24,41,24,568515,37095,78553,29403,0.34361221238282263,0.44216367409546153
3250,0.3296,13,23,13,568538,37072,78566,29390,0.34339916262180886,0.44220757726219495
3251,0.3297,17,23,17,568561,37049,78583,29373,0.34318611286079514,0.4422179398392099
3252,0.3298,11,33,11,568594,37016,78594,29362,0.34288043276890584,0.4423453553888336
3253,0.3299,18,34,18,568628,36982,78612,29344,0.342565489643929,0.4424207701353918
3254,0.33,13,33,13,568661,36949,78625,29331,0.3422598095520397,0.4425316837658419
3255,0.3301,6,42,6,568703,36907,78631,29325,0.34187076216236245,0.4427618069815195
3256,0.3302,20,44,20,568747,36863,78651,29305,0.34146318870651005,0.44288780074960704
3257,0.3303,18,25,18,568772,36838,78669,29287,0.3412316128793212,0.44290359168241966
3258,0.3304,11,30,11,568802,36808,78680,29276,0.3409537218866946,0.4430119242176624
3259,0.3305,16,39,16,568841,36769,78696,29260,0.34059246359628,0.44313862090899453
3260,0.3306,16,26,16,568867,36743,78712,29244,0.34035162473600356,0.4431782017670147
3261,0.3307,11,35,11,568902,36708,78723,29233,0.34002741857793917,0.44332054412277644
3262,0.3308,21,37,21,568939,36671,78744,29212,0.33968468635369964,0.44339207382784634
3263,0.3309,24,30,24,568969,36641,78768,29188,0.33940679536107304,0.44339121056069514
3264,0.331,11,27,11,568996,36614,78779,29177,0.33915669346770905,0.44348011126141873
3265,0.3311,15,28,15,569024,36586,78794,29162,0.33889732854125754,0.4435420088823995
3266,0.3312,15,33,15,569057,36553,78809,29147,0.3385916484493683,0.44363774733637745
3267,0.3313,21,40,21,569097,36513,78830,29126,0.3382211271258661,0.44373009948353875
3268,0.3314,23,46,23,569143,36467,78853,29103,0.3377950276038386,0.4438462711605917
3269,0.3315,18,34,18,569177,36433,78871,29085,0.33748008447886174,0.44392380719802194
3270,0.3316,11,32,11,569209,36401,78882,29074,0.33718366742006,0.44404734631538756
3271,0.3317,23,24,23,569233,36377,78905,29051,0.3369613546259587,0.44401479488903833
3272,0.3318,18,28,18,569261,36349,78923,29033,0.3367019896995072,0.4440518797222477
3273,0.3319,23,29,23,569290,36320,78946,29010,0.33643336173996813,0.4440532680238788
3274,0.332,13,30,13,569320,36290,78959,28997,0.33615547074734153,0.4441466141804647
3275,0.3321,21,23,21,569343,36267,78980,28976,0.33594242098632776,0.444124273868461
3276,0.3322,11,30,11,569373,36237,78991,28965,0.3356645299937011,0.4442348394221036
3277,0.3323,12,28,12,569401,36209,79003,28953,0.3354051650672496,0.4443233786562721
3278,0.3324,21,25,21,569426,36184,79024,28932,0.33517358924006074,0.4443147613489772
3279,0.3325,12,30,12,569456,36154,79036,28920,0.33489569824743415,0.4444171251190952
3280,0.3326,15,28,15,569484,36126,79051,28905,0.33463633332098264,0.4444803247681875
3281,0.3327,17,27,17,569511,36099,79068,28888,0.33438623142761864,0.4445196731654023
3282,0.3328,16,36,16,569547,36063,79084,28872,0.3340527622364667,0.44462924462924464
3283,0.3329,17,31,17,569578,36032,79101,28855,0.3337656082107525,0.4446961641006673
3284,0.333,12,29,12,569607,36003,79113,28843,0.33349698025121344,0.4447922770872529
3285,0.3331,21,27,21,569634,35976,79134,28822,0.3332468783578495,0.44479767894070804
3286,0.3332,13,29,13,569663,35947,79147,28809,0.3329782503983104,0.4448854160232256
3287,0.3333,18,22,18,569685,35925,79165,28791,0.3327744636703842,0.44488225477470794
3288,0.3334,17,32,17,569717,35893,79182,28774,0.3324780466115825,0.44495646929655003
3289,0.3335,17,28,17,569745,35865,79199,28757,0.33221868168513097,0.445003249667296
3290,0.3336,10,21,10,569766,35844,79209,28747,0.33202415799029233,0.44506200554256786
3291,0.3337,14,26,14,569792,35818,79223,28733,0.3317833191300159,0.44512091214698457
3292,0.3338,21,27,21,569819,35791,79244,28712,0.33153321723665197,0.44512658325969334
3293,0.3339,16,38,16,569857,35753,79260,28696,0.3311812219793249,0.44525128396096136
3294,0.334,24,19,24,569876,35734,79284,28672,0.3310052243506614,0.4451759152873956
3295,0.3341,11,22,11,569898,35712,79295,28661,0.3308014376227352,0.4452332499650475
3296,0.3342,17,35,17,569933,35677,79312,28644,0.3304772314646708,0.4453288972497318
3297,0.3343,12,28,12,569961,35649,79324,28632,0.3302178665382193,0.4454193307509217
3298,0.3344,15,32,15,569993,35617,79339,28617,0.32992144947941754,0.4455117227636454
3299,0.3345,14,24,14,570017,35593,79353,28603,0.32969913668531625,0.44555735559847964
3300,0.3346,18,28,18,570045,35565,79371,28585,0.32943977175886474,0.4455962587685113
3301,0.3347,16,28,16,570073,35537,79387,28569,0.32918040683241323,0.44565251302530184
3302,0.3348,17,26,17,570099,35511,79404,28552,0.3289395679721368,0.44568627757051654
3303,0.3349,14,31,14,570130,35480,79418,28538,0.32865241394642264,0.4457808741291512
3304,0.335,17,26,17,570156,35454,79435,28521,0.3284115750861462,0.4458147713950762
3305,0.3351,15,39,15,570195,35415,79450,28506,0.3280503167957316,0.44595672783592244
3306,0.3352,23,28,23,570223,35387,79473,28483,0.3277909518692801,0.4459527164552998
3307,0.3353,12,20,12,570243,35367,79485,28471,0.32760569120752897,0.4459882828409411
3308,0.3354,19,31,19,570274,35336,79504,28452,0.3273185371818148,0.44604000752492634
3309,0.3355,12,28,12,570302,35308,79516,28440,0.3270591722553633,0.44613164334567357
3310,0.3356,18,30,18,570332,35278,79534,28422,0.32678128126273664,0.44618524332810044
3311,0.3357,17,28,17,570360,35250,79551,28405,0.32652191633628513,0.44623360301625953
3312,0.3358,24,36,24,570396,35214,79575,28381,0.3261884471451332,0.44627722305212675
3313,0.3359,17,29,17,570425,35185,79592,28364,0.32591981918559415,0.4463327511054462
3314,0.336,17,36,17,570461,35149,79609,28347,0.3255863499944422,0.44643757087060604
3315,0.3361,18,30,18,570491,35119,79627,28329,0.32530845900181554,0.44649161518093555
3316,0.3362,13,27,13,570518,35092,79640,28316,0.3250583571084516,0.44656825637143577
3317,0.3363,16,37,16,570555,35055,79656,28300,0.3247156248842121,0.4466892905058796
3318,0.3364,13,40,13,570595,35015,79669,28287,0.32434510356070995,0.44685791918106854
3319,0.3365,10,30,10,570625,34985,79679,28277,0.3240672125680833,0.4469823906926749
3320,0.3366,20,27,20,570652,34958,79699,28257,0.32381711067471936,0.4469983390018192
3321,0.3367,19,27,19,570679,34931,79718,28238,0.32356700878135536,0.44702306511105133
3322,0.3368,16,18,16,570697,34913,79734,28222,0.3234002741857794,0.4470103745941237
3323,0.3369,19,23,19,570720,34890,79753,28203,0.32318722442476566,0.4470067994864724
3324,0.337,13,38,13,570758,34852,79766,28190,0.32283522916743856,0.4471622093207703
3325,0.3371,14,25,14,570783,34827,79780,28176,0.3226036533402497,0.4472167992000381
3326,0.3372,12,30,12,570813,34797,79792,28164,0.3223257623476231,0.44732453423547913
3327,0.3373,22,31,22,570844,34766,79814,28142,0.32203860832190895,0.44735168817956383
3328,0.3374,17,34,17,570878,34732,79831,28125,0.3217236651969321,0.4474441987368153
3329,0.3375,11,32,11,570910,34700,79842,28114,0.32142724813813034,0.44757538128442703
3330,0.3376,16,31,16,570941,34669,79858,28098,0.3211400941124162,0.4476556152118151
3331,0.3377,16,20,16,570961,34649,79874,28082,0.3209548334506651,0.44765745803510226
3332,0.3378,14,30,14,570991,34619,79888,28068,0.32067694245803846,0.4477483369757685
3333,0.3379,13,25,13,571016,34594,79901,28055,0.3204453666308496,0.44781241520215803
3334,0.338,13,42,13,571058,34552,79914,28042,0.32005631924117234,0.44799821069112056
3335,0.3381,12,18,12,571076,34534,79926,28030,0.31988958464559636,0.44802122626430535
3336,0.3382,16,25,16,571101,34509,79942,28014,0.3196580088184075,0.4480591142459575
3337,0.3383,16,39,16,571140,34470,79958,27998,0.3192967505279929,0.44819747710827945
3338,0.3384,18,29,18,571169,34441,79976,27980,0.3190281225684538,0.4482465836817738
3339,0.3385,16,30,16,571199,34411,79992,27964,0.3187502315758272,0.44832064128256516
3340,0.3386,14,24,14,571223,34387,80006,27950,0.31852791878172587,0.44836934725764793
3341,0.3387,17,32,17,571255,34355,80023,27933,0.31823150172292414,0.44844913948112
3342,0.3388,15,16,15,571271,34339,80038,27918,0.3180832931935233,0.44843150167852613
3343,0.3389,12,30,12,571301,34309,80050,27906,0.31780540220089665,0.4485413485493852
3344,0.339,19,28,19,571329,34281,80069,27887,0.31754603727444514,0.4485748294942736
3345,0.3391,15,29,15,571358,34252,80084,27872,0.31727740931490606,0.44865108492692035
3346,0.3392,12,36,12,571394,34216,80096,27860,0.3169439401237541,0.4488046910239062
3347,0.3393,13,30,13,571424,34186,80109,27847,0.3166660491311275,0.44890622733061436
3348,0.3394,19,29,19,571453,34157,80128,27828,0.3163974211715884,0.4489473259659595
3349,0.3395,14,31,14,571484,34126,80142,27814,0.31611026714587426,0.44904746528898937
3350,0.3396,19,25,19,571509,34101,80161,27795,0.3158786913186854,0.44905971306708026
3351,0.3397,10,24,10,571533,34077,80171,27785,0.3156563785245841,0.4491448708415505
3352,0.3398,16,30,16,571563,34047,80187,27769,0.31537848753195746,0.44922026659764464
3353,0.3399,19,27,19,571590,34020,80206,27750,0.3151283856385935,0.4492472073822244
3354,0.34,16,30,16,571620,33990,80222,27734,0.31485049464596687,0.44932279178277496
3355,0.3401,21,19,21,571639,33971,80243,27713,0.3146744970173033,0.44927371765773944
3356,0.3402,11,23,11,571662,33948,80254,27702,0.3144614472562896,0.44934306569343063
3357,0.3403,16,26,16,571688,33922,80270,27686,0.3142206083960132,0.4493896896506947
3358,0.3404,21,28,21,571716,33894,80291,27665,0.31396124346956167,0.44940626066050454
3359,0.3405,13,32,13,571748,33862,80304,27652,0.31366482641075993,0.44952368566505185
3360,0.3406,9,26,9,571774,33836,80313,27643,0.3134239875504835,0.4496332080873144
3361,0.3407,12,37,12,571811,33799,80325,27631,0.31308125532624403,0.44979651636008466
3362,0.3408,13,31,13,571842,33768,80338,27618,0.31279410130052987,0.44990714495161765
3363,0.3409,15,24,15,571866,33744,80353,27603,0.3125717885064285,0.44994865274585555
3364,0.341,10,26,10,571892,33718,80363,27593,0.31233094964615216,0.45004974637503875
3365,0.3411,15,24,15,571916,33694,80378,27578,0.3121086368520508,0.45009139574356966
3366,0.3412,14,24,14,571940,33670,80392,27564,0.3118863240579495,0.45014207793056144
3367,0.3413,20,24,20,571964,33646,80412,27544,0.31166401126384824,0.4501389115868606
3368,0.3414,16,30,16,571994,33616,80428,27528,0.3113861202712216,0.4502158838152558
3369,0.3415,20,22,20,572016,33594,80448,27508,0.31118233354329544,0.4501980295244018
3370,0.3416,15,30,15,572046,33564,80463,27493,0.3109044425506688,0.4502841607022946
3371,0.3417,18,32,18,572078,33532,80481,27475,0.31060802549186706,0.45035815562148607
3372,0.3418,12,24,12,572102,33508,80493,27463,0.31038571269776577,0.4504272523002739
3373,0.3419,13,33,13,572135,33475,80506,27450,0.31008003260587647,0.4505539597866229
3374,0.342,16,20,16,572155,33455,80522,27434,0.3098947719441254,0.4505575719752336
3375,0.3421,13,21,13,572176,33434,80535,27421,0.30970024824928677,0.45059567825158164
3376,0.3422,16,27,16,572203,33407,80551,27405,0.3094501463559228,0.45065118726567127
3377,0.3423,13,31,13,572234,33376,80564,27392,0.3091629923302086,0.4507635597682991
3378,0.3424,14,23,14,572257,33353,80578,27378,0.30894994256919484,0.45080766000889166
3379,0.3425,15,41,15,572298,33312,80593,27363,0.30857015821260514,0.45097651421508034
3380,0.3426,11,30,11,572328,33282,80604,27352,0.3082922672199785,0.4511000428802322
3381,0.3427,12,28,12,572356,33254,80616,27340,0.308032902293527,0.45119978875796285
3382,0.3428,9,27,9,572383,33227,80625,27331,0.30778280040016304,0.451319396281251
3383,0.3429,14,27,14,572410,33200,80639,27317,0.30753269850679904,0.4513938232232265
3384,0.343,16,30,16,572440,33170,80655,27301,0.30725480751417245,0.45147260670403994
3385,0.3431,8,25,8,572465,33145,80663,27293,0.3070232316869836,0.4515867500579106
3386,0.3432,16,30,16,572495,33115,80679,27277,0.30674534069435694,0.4516657835474897
3387,0.3433,16,25,16,572520,33090,80695,27261,0.3065137648671681,0.4517075110602973
3388,0.3434,12,31,12,572551,33059,80707,27249,0.3062266108414539,0.4518306029050872
3389,0.3435,21,22,21,572573,33037,80728,27228,0.3060228241135277,0.45180452999253295
3390,0.3436,14,24,14,572597,33013,80742,27214,0.3058005113194264,0.45185714048516445
3391,0.3437,6,29,6,572626,32984,80748,27208,0.30553188335988735,0.45202020202020204
3392,0.3438,17,46,17,572672,32938,80765,27191,0.30510578383785986,0.4522110795123817
3393,0.3439,25,27,25,572699,32911,80790,27166,0.3048556819444959,0.4521863608369259
3394,0.344,17,22,17,572721,32889,80807,27149,0.3046518952165697,0.4521969419367734
3395,0.3441,18,35,18,572756,32854,80825,27131,0.3043276890585053,0.4522964074351921
3396,0.3442,13,39,13,572795,32815,80838,27118,0.3039664307680907,0.4524719269851334
3397,0.3443,13,31,13,572826,32784,80851,27105,0.30367927674237655,0.45258728647998797
3398,0.3444,13,27,13,572853,32757,80864,27092,0.30342917484901255,0.4526725592741733
3399,0.3445,15,26,15,572879,32731,80879,27077,0.3031883359887362,0.452732075976458
3400,0.3446,11,27,11,572906,32704,80890,27066,0.3029382340953722,0.45283587083821314
3401,0.3447,13,21,13,572927,32683,80903,27053,0.30274371040053355,0.45287598767912146
3402,0.3448,17,30,17,572957,32653,80920,27036,0.3024658194079069,0.4529477793228233
3403,0.3449,13,34,13,572991,32619,80933,27023,0.3021508762829301,0.453086750947319
3404,0.345,11,30,11,573021,32589,80944,27012,0.30187298529030343,0.4532138722504656
3405,0.3451,18,29,18,573050,32560,80962,26994,0.3016043573307644,0.4532693018101219
3406,0.3452,14,22,14,573072,32538,80976,26980,0.3014005706028382,0.45330824288450555
3407,0.3453,13,25,13,573097,32513,80989,26967,0.30116899477564935,0.4533792871553463
3408,0.3454,16,31,16,573128,32482,81005,26951,0.3008818407499352,0.4534686117140309
3409,0.3455,13,38,13,573166,32444,81018,26938,0.3005298454926081,0.4536391499107474
3410,0.3456,17,29,17,573195,32415,81035,26921,0.300261217533069,0.4537043278953755
3411,0.3457,20,37,20,573232,32378,81055,26901,0.29991848530882953,0.45380320180839756
3412,0.3458,24,31,24,573263,32347,81079,26877,0.29963133128311537,0.4538193975415372
3413,0.3459,16,19,16,573282,32328,81095,26861,0.2994553336544518,0.45381743229316257
3414,0.346,14,28,14,573310,32300,81109,26847,0.2991959687280003,0.45390298747189206
3415,0.3461,15,25,15,573335,32275,81124,26832,0.29896439290081145,0.45395638418461437
3416,0.3462,15,31,15,573366,32244,81139,26817,0.2986772388750973,0.4540559760247879
3417,0.3463,17,26,17,573392,32218,81156,26800,0.29843640001482086,0.45409874953404045
3418,0.3464,15,28,15,573420,32190,81171,26785,0.29817703508836935,0.45417549809241203
3419,0.3465,12,25,12,573445,32165,81183,26773,0.2979454592611805,0.45425701584716144
3420,0.3466,17,23,17,573468,32142,81200,26756,0.2977324095001667,0.4542768854630038
3421,0.3467,15,38,15,573506,32104,81215,26741,0.2973804142428397,0.45443113263658763
3422,0.3468,12,23,12,573529,32081,81227,26729,0.2971673644818259,0.45449753443291957
3423,0.3469,9,30,9,573559,32051,81236,26720,0.2968894734891993,0.45464599887699714
3424,0.347,15,20,15,573579,32031,81251,26705,0.29670421282744824,0.4546615363661128
3425,0.3471,22,20,22,573599,32011,81273,26683,0.2965189521656971,0.45461205574675434
3426,0.3472,16,33,16,573632,31978,81289,26667,0.2962132720738078,0.4547190723846875
3427,0.3473,13,32,13,573664,31946,81302,26654,0.2959168550150061,0.45484641638225254
3428,0.3474,24,21,24,573685,31925,81326,26630,0.29572233132016745,0.45478609853983437
3429,0.3475,11,13,11,573698,31912,81337,26619,0.29560191189002927,0.45478464403478497
3430,0.3476,9,25,9,573723,31887,81346,26610,0.2953703360628404,0.4548951228268116
3431,0.3477,17,24,17,573747,31863,81363,26593,0.2951480232687391,0.454923361160531
3432,0.3478,11,33,11,573780,31830,81374,26582,0.2948423431768498,0.45507772375539274
3433,0.3479,9,23,9,573803,31807,81383,26573,0.2946292934158361,0.45517300445358
3434,0.348,12,31,12,573834,31776,81395,26561,0.2943421393901219,0.4553028095376862
3435,0.3481,10,21,10,573855,31755,81405,26551,0.29414761569528325,0.45537337495283503
3436,0.3482,15,31,15,573886,31724,81420,26536,0.2938604616695691,0.4554754548575352
3437,0.3483,14,34,14,573920,31690,81434,26522,0.29354551854459227,0.4556105270390985
3438,0.3484,18,26,18,573946,31664,81452,26504,0.29330467968431584,0.4556457158575162
3439,0.3485,14,35,14,573981,31629,81466,26490,0.29298047352625145,0.4557889846693852
3440,0.3486,26,16,26,573997,31613,81492,26464,0.29283226499685056,0.455670919641166
3441,0.3487,23,22,23,574019,31591,81515,26441,0.29262847826892435,0.455627929418252
3442,0.3488,21,33,21,574052,31558,81536,26420,0.2923227981770351,0.455690089344234
3443,0.3489,10,25,10,574077,31533,81546,26410,0.29209122234984625,0.45579276185216505
3444,0.349,9,26,9,574103,31507,81555,26401,0.2918503834895698,0.45591282724321336
3445,0.3491,19,24,19,574127,31483,81574,26382,0.29162807069546853,0.45592326967942626
3446,0.3492,11,27,11,574154,31456,81585,26371,0.29137796880210454,0.4560326491085479
3447,0.3493,19,20,19,574174,31436,81604,26352,0.2911927081403535,0.4560116287118433
3448,0.3494,9,28,9,574202,31408,81613,26343,0.29093334321390196,0.4561479454901214
3449,0.3495,14,33,14,574235,31375,81627,26329,0.29062766312201266,0.4562768612227922
3450,0.3496,9,29,9,574264,31346,81636,26320,0.2903590351624736,0.45642146151978635
3451,0.3497,17,24,17,574288,31322,81653,26303,0.2901367223683723,0.45645119305856835
3452,0.3498,10,25,10,574313,31297,81663,26293,0.28990514654118343,0.456554957457892
3453,0.3499,22,26,22,574339,31271,81685,26271,0.28966430768090706,0.45655347398422025
3454,0.35,7,21,7,574360,31250,81692,26264,0.2894697839860684,0.45665403206175886
3455,0.3501,22,22,22,574382,31228,81714,26242,0.2892659972581422,0.4566208456586045
3456,0.3502,25,35,25,574417,31193,81739,26217,0.2889417911000778,0.4566626023340881
3457,0.3503,18,19,18,574436,31174,81757,26199,0.2887657934714143,0.456643368832029
3458,0.3504,17,28,17,574464,31146,81774,26182,0.2885064285449628,0.4567052749092939
3459,0.3505,10,24,10,574488,31122,81784,26172,0.28828411575086144,0.45680175934652845
3460,0.3506,8,32,8,574520,31090,81792,26164,0.2879876986920597,0.4569811716211968
3461,0.3507,13,29,13,574549,31061,81805,26151,0.2877190707325207,0.4570894217996225
3462,0.3508,12,26,12,574575,31035,81817,26139,0.28747823187224425,0.4571833350823801
3463,0.3509,15,30,15,574605,31005,81832,26124,0.2872003408796176,0.4572808906159744
3464,0.351,13,31,13,574636,30974,81845,26111,0.28691318685390343,0.4574056231934834
3465,0.3511,19,29,19,574665,30945,81864,26092,0.28664455889436435,0.4574574399074285
3466,0.3512,11,38,11,574703,30907,81875,26081,0.2862925636370373,0.4576577525093002
3467,0.3513,22,19,22,574722,30888,81897,26059,0.28611656600837376,0.45760092717790224
3468,0.3514,15,22,15,574744,30866,81912,26044,0.2859127792804476,0.4576348620629063
3469,0.3515,10,31,10,574775,30835,81922,26034,0.2856256252547334,0.457788953559936
3470,0.3516,12,23,12,574798,30812,81934,26022,0.2854125754937197,0.45785973185065276
3471,0.3517,13,25,13,574823,30787,81947,26009,0.2851809996665308,0.4579371786745545
3472,0.3518,9,29,9,574852,30758,81956,26000,0.28491237170699174,0.45808520384791573
3473,0.3519,7,18,7,574870,30740,81963,25993,0.28474563711141576,0.4581636789875381
3474,0.352,15,19,15,574889,30721,81978,25978,0.2845696394827522,0.4581738655002734
3475,0.3521,19,26,19,574915,30695,81997,25959,0.28432880062247584,0.45820242171779574
3476,0.3522,9,28,9,574943,30667,82006,25950,0.28406943569602433,0.45834290054224
3477,0.3523,18,26,18,574969,30641,82024,25932,0.2838285968357479,0.4583812065826454
3478,0.3524,13,22,13,574991,30619,82037,25919,0.2836248101078217,0.45843503484382186
3479,0.3525,13,28,13,575019,30591,82050,25906,0.2833654451813702,0.4585376214666265
3480,0.3526,12,29,12,575048,30562,82062,25894,0.2830968172218311,0.458658070001417
3481,0.3527,13,23,13,575071,30539,82075,25881,0.2828837674608174,0.4587203119461184
3482,0.3528,10,18,10,575089,30521,82085,25871,0.2827170328652414,0.4587707476237764
3483,0.3529,13,23,13,575112,30498,82098,25858,0.28250398310422764,0.45883313223081834
3484,0.353,9,20,9,575132,30478,82107,25849,0.2823187224424766,0.45890958155058853
3485,0.3531,13,37,13,575169,30441,82120,25836,0.28197599021823705,0.45908630524015137
3486,0.3532,18,33,18,575202,30408,82138,25818,0.28167031012634774,0.4591825845694163
3487,0.3533,15,33,15,575235,30375,82153,25803,0.2813646300344585,0.45930791413008654
3488,0.3534,17,21,17,575256,30354,82170,25786,0.28117010633961986,0.4593159957249733
3489,0.3535,10,33,10,575289,30321,82180,25776,0.28086442624773056,0.45948981228942726
3490,0.3536,15,25,15,575314,30296,82195,25761,0.2806328504205417,0.45955010079026704
3491,0.3537,10,31,10,575345,30265,82205,25751,0.28034569639482754,0.4597079405884033
3492,0.3538,15,25,15,575370,30240,82220,25736,0.2801141205676387,0.45976847220237244
3493,0.3539,13,21,13,575391,30219,82233,25723,0.27991959687280005,0.45981552322047836
3494,0.354,14,19,14,575410,30200,82247,25709,0.2797435992441365,0.4598365200593822
3495,0.3541,17,29,17,575439,30171,82264,25692,0.2794749712845974,0.45991085333762954
3496,0.3542,16,25,16,575464,30146,82280,25676,0.27924339545740856,0.45996202214180787
3497,0.3543,17,21,17,575485,30125,82297,25659,0.27904887176256993,0.4599706008891438
3498,0.3544,15,29,15,575514,30096,82312,25644,0.27878024380303085,0.46006458557588803
3499,0.3545,14,25,14,575539,30071,82326,25630,0.278548667975842,0.46013536561282564
3500,0.3546,13,34,13,575573,30037,82339,25617,0.27823372485086517,0.46029036547238295
3501,0.3547,13,24,13,575597,30013,82352,25604,0.2780114120567639,0.46036283870039735
3502,0.3548,17,25,17,575622,29988,82369,25587,0.27777983622957503,0.46040485829959515
3503,0.3549,15,22,15,575644,29966,82384,25572,0.2775760495016488,0.4604414995138464
3504,0.355,16,31,16,575675,29935,82400,25556,0.27728889547593466,0.4605431511416266
3505,0.3551,12,35,12,575710,29900,82412,25544,0.2769646893178702,0.46071711997691367
3506,0.3552,20,18,20,575728,29882,82432,25524,0.2767979547222943,0.46067212937227014
3507,0.3553,19,31,19,575759,29851,82451,25505,0.2765108006965801,0.4607449960257244
3508,0.3554,14,20,14,575779,29831,82465,25491,0.276325540034829,0.4607750985141535
3509,0.3555,11,26,11,575805,29805,82476,25480,0.2760847011745526,0.4608845075517772
3510,0.3556,12,18,12,575823,29787,82488,25468,0.2759179665789766,0.46091756402135553
3511,0.3557,18,24,18,575847,29763,82506,25450,0.2756956537848753,0.4609421694166229
3512,0.3558,12,17,12,575864,29746,82518,25438,0.2755381822223869,0.4609669469411424
3513,0.3559,5,23,5,575887,29723,82523,25433,0.27532513246137313,0.46111030531583147
3514,0.356,23,21,23,575908,29702,82546,25410,0.2751306087665345,0.4610611119175497
3515,0.3561,16,22,16,575930,29680,82562,25394,0.2749268220386083,0.4610887169989469
3516,0.3562,11,26,11,575956,29654,82573,25383,0.2746859831783319,0.46119882987808203
3517,0.3563,16,24,16,575980,29630,82589,25367,0.27446367038423064,0.461243340545848
3518,0.3564,14,24,14,576004,29606,82603,25353,0.2742413575901293,0.4613075201513856
3519,0.3565,16,23,16,576027,29583,82619,25337,0.2740283078291156,0.46134377276037875
3520,0.3566,16,28,16,576055,29555,82635,25321,0.27376894290266407,0.4614221153145273
3521,0.3567,17,20,17,576075,29535,82652,25304,0.27358368224091295,0.4614234395229672
3522,0.3568,14,23,14,576098,29512,82666,25290,0.27337063247989923,0.46147950804715154
3523,0.3569,18,22,18,576120,29490,82684,25272,0.27316684575197303,0.4614878930645338
3524,0.357,15,18,15,576138,29472,82699,25257,0.27300011115639705,0.461492079153648
3525,0.3571,23,15,23,576153,29457,82722,25234,0.2728611656600837,0.4613921851858624
3526,0.3572,20,19,20,576172,29438,82742,25214,0.27268516803142023,0.46135548561809264
3527,0.3573,19,25,19,576197,29413,82761,25195,0.2724535922042314,0.4613792850864342
3528,0.3574,13,39,13,576236,29374,82774,25182,0.27209233391381676,0.4615807610528631
3529,0.3575,11,27,11,576263,29347,82785,25171,0.27184223202045277,0.4617007226970909
3530,0.3576,19,32,19,576295,29315,82804,25152,0.27154581496165103,0.46178419960710154
3531,0.3577,15,24,15,576319,29291,82819,25137,0.27132350216754975,0.46183949437789373
3532,0.3578,6,36,6,576355,29255,82825,25131,0.2709900329763978,0.46208583091236716
3533,0.3579,8,22,8,576377,29233,82833,25123,0.2707862462484716,0.46219368606961514
3534,0.358,15,24,15,576401,29209,82848,25108,0.2705639334543703,0.46224938785279013
3535,0.3581,21,32,21,576433,29177,82869,25087,0.27026751639556856,0.4623138729175881
3536,0.3582,9,26,9,576459,29151,82878,25078,0.27002667753529214,0.462446292574084
3537,0.3583,11,21,11,576480,29130,82889,25067,0.2698321538404535,0.46251637544513535
3538,0.3584,10,25,10,576505,29105,82899,25057,0.26960057801326465,0.4626306266386027
3539,0.3585,14,25,14,576530,29080,82913,25043,0.2693690021860758,0.46270531936514975
3540,0.3586,13,20,13,576550,29060,82926,25030,0.2691837415243247,0.46274727306341285
3541,0.3587,13,16,13,576566,29044,82939,25017,0.26903553299492383,0.4627550359778768
3542,0.3588,8,35,8,576601,29009,82947,25009,0.26871132683685944,0.46297530452812025
3543,0.3589,9,26,9,576627,28983,82956,25000,0.26847048797658307,0.46310875646036714
3544,0.359,18,29,18,576656,28954,82974,24982,0.268201860017044,0.46317858202313855
3545,0.3591,16,23,16,576679,28931,82990,24966,0.2679888102560302,0.46321687663506317
3546,0.3592,10,35,10,576714,28896,83000,24956,0.26766460409796583,0.4634182574463344
3547,0.3593,8,24,8,576738,28872,83008,24948,0.26744229130386454,0.4635451505016722
3548,0.3594,11,23,11,576761,28849,83019,24937,0.26722924154285077,0.46363365931655076
3549,0.3595,20,25,20,576786,28824,83039,24917,0.2669976657156619,0.4636497273962152
3550,0.3596,11,25,11,576811,28799,83050,24906,0.26676608988847306,0.46375570244856157
3551,0.3597,15,29,15,576840,28770,83065,24891,0.26649746192893403,0.4638564320456197
3552,0.3598,8,26,8,576866,28744,83073,24883,0.2662566230686576,0.4640013426072687
3553,0.3599,18,17,18,576883,28727,83091,24865,0.2660991515061692,0.4639685027616062
3554,0.36,13,20,13,576903,28707,83104,24852,0.2659138908444181,0.4640116507029631
3555,0.3601,14,23,14,576926,28684,83118,24838,0.26570084108340436,0.46407084937035237
3556,0.3602,20,35,20,576961,28649,83138,24818,0.26537663492533997,0.4641741635027213
3557,0.3603,20,31,20,576992,28618,83158,24798,0.26508948089962575,0.4642429234686236
3558,0.3604,18,21,18,577013,28597,83176,24780,0.2648949572047871,0.46424489948854375
3559,0.3605,15,19,15,577032,28578,83191,24765,0.2647189595761236,0.4642596029469659
3560,0.3606,16,17,16,577049,28561,83207,24749,0.26456148801363516,0.4642468580003752
3561,0.3607,11,30,11,577079,28531,83218,24738,0.26428359702100856,0.4643976797011395
3562,0.3608,16,24,16,577103,28507,83234,24722,0.2640612842269073,0.4644460726295816
3563,0.3609,17,31,17,577134,28476,83251,24705,0.26377413020119306,0.4645456083939753
3564,0.361,10,24,10,577158,28452,83261,24695,0.26355181740709177,0.46465463713850264
3565,0.3611,13,24,13,577182,28428,83274,24682,0.2633295046129905,0.4647335718320467
3566,0.3612,9,30,9,577212,28398,83283,24673,0.26305161362036383,0.464905503947542
3567,0.3613,15,23,15,577235,28375,83298,24658,0.2628385638593501,0.4649557822487885
3568,0.3614,14,20,14,577255,28355,83312,24644,0.262653303197599,0.46498990546991453
3569,0.3615,15,30,15,577285,28325,83327,24629,0.2623754122049724,0.4651017864561695
3570,0.3616,15,16,15,577301,28309,83342,24614,0.2622272036755715,0.46509079228312833
3571,0.3617,9,34,9,577335,28275,83351,24605,0.2619122605505947,0.4652987897125567
3572,0.3618,18,31,18,577366,28244,83369,24587,0.2616251065248805,0.4653896386591206
3573,0.3619,16,27,16,577393,28217,83385,24571,0.2613750046315165,0.4654656361294234
3574,0.362,12,23,12,577416,28194,83397,24559,0.2611619548705028,0.4655469831099653
3575,0.3621,14,19,14,577435,28175,83411,24545,0.26098595724183926,0.46557283763277696
3576,0.3622,20,36,20,577471,28139,83431,24525,0.2606524880506873,0.4656881361081574
3577,0.3623,16,25,16,577496,28114,83447,24509,0.26042091222349845,0.46574691674742985
3578,0.3624,13,30,13,577526,28084,83460,24496,0.26014302123087185,0.46588056295169267
3579,0.3625,15,21,15,577547,28063,83475,24481,0.2599484975360332,0.46591428136419
3580,0.3626,6,24,6,577571,28039,83481,24475,0.2597261847419319,0.4660661918726435
3581,0.3627,16,25,16,577596,28014,83497,24459,0.259494608914743,0.46612543593848266
3582,0.3628,18,25,18,577621,27989,83515,24441,0.25926303308755416,0.46616440968910927
3583,0.3629,21,26,21,577647,27963,83536,24420,0.2590221942272778,0.4661817765305538
3584,0.363,15,23,15,577670,27940,83551,24405,0.258809144466264,0.46623364218167923
3585,0.3631,12,22,12,577692,27918,83563,24393,0.2586053577383378,0.46630727762803237
3586,0.3632,18,33,18,577725,27885,83581,24375,0.25829967764644857,0.4664179104477612
3587,0.3633,18,23,18,577748,27862,83599,24357,0.2580866278854348,0.4664394186024244
3588,0.3634,12,31,12,577779,27831,83611,24345,0.25779947385972063,0.46659383624655015
3589,0.3635,11,20,11,577799,27811,83622,24334,0.25761421319796957,0.4666602742353054
3590,0.3636,18,22,18,577821,27789,83640,24316,0.25741042647004336,0.4666730640053738
3591,0.3637,14,20,14,577841,27769,83654,24302,0.25722516580829224,0.4667089166714678
3592,0.3638,11,22,11,577863,27747,83665,24291,0.2570213790803661,0.4667934970598409
3593,0.3639,8,18,8,577881,27729,83673,24283,0.2568546444847901,0.46687302930093055
3594,0.364,19,18,19,577899,27711,83692,24264,0.25668790988921414,0.46683982683982683
3595,0.3641,18,27,18,577926,27684,83710,24246,0.25643780799585014,0.46689774696707104
3596,0.3642,15,19,15,577945,27665,83725,24231,0.25626181036718665,0.4669145984276245
3597,0.3643,8,26,8,577971,27639,83733,24223,0.2560209715069102,0.4670664455670819
3598,0.3644,17,17,17,577988,27622,83750,24206,0.2558634999444218,0.4670448406266883
3599,0.3645,14,15,14,578003,27607,83764,24192,0.2557245544481085,0.4670360431668565
3600,0.3646,19,29,19,578032,27578,83783,24173,0.2554559264885694,0.4671020849838651
3601,0.3647,18,25,18,578057,27553,83801,24155,0.25522435066138055,0.4671424151001779
3602,0.3648,13,22,13,578079,27531,83814,24142,0.25502056393345435,0.46720724556344706
3603,0.3649,18,17,18,578096,27514,83832,24124,0.25486309237096594,0.4671753359928735
3604,0.365,14,23,14,578119,27491,83846,24110,0.2546500426099522,0.46723900699598847
3605,0.3651,14,25,14,578144,27466,83860,24096,0.25441846678276336,0.46732089523292347
3606,0.3652,10,33,10,578177,27433,83870,24086,0.25411278669087406,0.4675168384479512
3607,0.3653,12,30,12,578207,27403,83882,24074,0.2538348956982474,0.4676651708530023
3608,0.3654,11,20,11,578227,27383,83893,24063,0.25364963503649635,0.46773315709676166
3609,0.3655,15,18,15,578245,27365,83908,24048,0.25348290044092037,0.46774162176881334
3610,0.3656,9,19,9,578264,27346,83917,24039,0.2533069028122568,0.4678213486426
3611,0.3657,19,17,19,578281,27329,83936,24020,0.2531494312497684,0.46777931410543533
3612,0.3658,13,25,13,578306,27304,83949,24007,0.25291785542257955,0.4678723860380815
3613,0.3659,10,26,10,578332,27278,83959,23997,0.2526770165623032,0.4680058508044856
3614,0.366,14,18,14,578350,27260,83973,23983,0.2525102819667272,0.4680249009620826
3615,0.3661,17,19,17,578369,27241,83990,23966,0.25233428433806365,0.4680219501240065
3616,0.3662,12,20,12,578389,27221,84002,23954,0.2521490236763126,0.4680801172447484
3617,0.3663,10,18,10,578407,27203,84012,23944,0.2519822890807366,0.46814084892564567
3618,0.3664,12,20,12,578427,27183,84024,23932,0.2517970284189855,0.4681991587596596
3619,0.3665,10,17,10,578444,27166,84034,23922,0.2516395568564971,0.46825086125900406
3620,0.3666,12,24,12,578468,27142,84046,23910,0.2514172440623958,0.46834600015670297
3621,0.3667,12,23,12,578491,27119,84058,23898,0.251204194301382,0.4684320912636964
3622,0.3668,15,18,15,578509,27101,84073,23883,0.25103745970580604,0.46844107955437
3623,0.3669,17,20,17,578529,27081,84090,23866,0.250852199044055,0.468447602410348
3624,0.367,13,18,13,578547,27063,84103,23853,0.250685464448479,0.46847749234032526
3625,0.3671,12,22,12,578569,27041,84115,23841,0.2504816777205528,0.4685546951770764
3626,0.3672,13,37,13,578606,27004,84128,23828,0.2501389454963133,0.4687598363235757
3627,0.3673,11,20,11,578626,26984,84139,23817,0.24995368483456223,0.4688293537528789
3628,0.3674,21,24,21,578650,26960,84160,23796,0.24973137204046092,0.468831271179762
3629,0.3675,9,29,9,578679,26931,84169,23787,0.24946274408092187,0.4690050869513782
3630,0.3676,9,22,9,578701,26909,84178,23778,0.24925895735299566,0.46911436857576894
3631,0.3677,14,16,14,578717,26893,84192,23764,0.2491107488235948,0.46911581814951536
3632,0.3678,7,17,7,578734,26876,84199,23757,0.2489532772611064,0.4691999289001244
3633,0.3679,15,16,15,578750,26860,84214,23742,0.24880506873170552,0.46919094106952297
3634,0.368,19,23,19,578773,26837,84233,23723,0.24859201897069177,0.46920490506329116
3635,0.3681,21,21,21,578794,26816,84254,23702,0.24839749527585311,0.46917930242685774
3636,0.3682,12,32,12,578826,26784,84266,23690,0.24810107821705138,0.4693505567222728
3637,0.3683,12,28,12,578854,26756,84278,23678,0.24784171329059987,0.4694848713169687
3638,0.3684,11,24,11,578878,26732,84289,23667,0.24761940049649858,0.4695926506478303
3639,0.3685,14,28,14,578906,26704,84303,23653,0.24736003557004704,0.4697062970391405
3640,0.3686,16,18,16,578924,26686,84319,23637,0.2471933009744711,0.46970570117043897
3641,0.3687,13,16,13,578940,26670,84332,23624,0.24704509244507022,0.4697180578200183
3642,0.3688,6,23,6,578963,26647,84338,23618,0.24683204268405648,0.4698696906396101
3643,0.3689,13,21,13,578984,26626,84351,23605,0.24663751898921782,0.4699289283510183
3644,0.369,19,22,19,579006,26604,84370,23586,0.24643373226129164,0.46993424985056786
3645,0.3691,12,28,12,579034,26576,84382,23574,0.24617436733484013,0.47006979062811566
3646,0.3692,12,25,12,579059,26551,84394,23562,0.24594279150765128,0.47017739907808354
3647,0.3693,13,15,13,579074,26536,84407,23549,0.24580384601133795,0.47018069282220226
3648,0.3694,13,25,13,579099,26511,84420,23536,0.2455722701841491,0.47027793873758666
3649,0.3695,11,22,11,579121,26489,84431,23525,0.24536848345622292,0.4703682968768745
3650,0.3696,19,25,19,579146,26464,84450,23506,0.24513690762903406,0.4704022413448069
3651,0.3697,15,32,15,579178,26432,84465,23491,0.24484049057023233,0.47054463874366526
3652,0.3698,8,25,8,579203,26407,84473,23483,0.24460891474304347,0.470695530166366
3653,0.3699,11,22,11,579225,26385,84484,23472,0.24440512801511727,0.47078644924484025
3654,0.37,12,22,12,579247,26363,84496,23460,0.24420134128719106,0.470866868715252
3655,0.3701,16,20,16,579267,26343,84512,23444,0.24401608062544,0.4708859742503063
3656,0.3702,14,30,14,579297,26313,84526,23430,0.24373818963281338,0.4710210481876847
3657,0.3703,14,25,14,579322,26288,84540,23416,0.24350661380562452,0.4711089650732335
3658,0.3704,13,24,13,579346,26264,84553,23403,0.2432843010115232,0.4711981798779874
3659,0.3705,10,16,10,579362,26248,84563,23393,0.24313609248212234,0.47124352853488044
3660,0.3706,11,29,11,579391,26219,84574,23382,0.2428674645225833,0.4714017862543094
3661,0.3707,14,19,14,579410,26200,84588,23368,0.24269146689391974,0.4714331826985152
3662,0.3708,9,27,9,579437,26173,84597,23359,0.24244136500055577,0.47159412097230075
3663,0.3709,10,23,10,579460,26150,84607,23349,0.24222831523954202,0.4717064991211944
3664,0.371,18,16,18,579476,26134,84625,23331,0.24208010671014116,0.4716668351359547
3665,0.3711,10,21,10,579497,26113,84635,23321,0.24188558301530252,0.47176032690051384
3666,0.3712,14,17,14,579514,26096,84649,23307,0.24172811145281412,0.47177296925287937
3667,0.3713,14,13,14,579527,26083,84663,23293,0.2416076920226759,0.47174740764744005
3668,0.3714,9,18,9,579545,26065,84672,23284,0.24144095742709992,0.47182313724695535
3669,0.3715,14,27,14,579572,26038,84686,23270,0.24119085553373595,0.47193153240853414
3670,0.3716,17,23,17,579595,26015,84703,23253,0.2409778057727222,0.471969635463181
3671,0.3717,8,23,8,579618,25992,84711,23245,0.24076475601170846,0.4721043117980381
3672,0.3718,8,18,8,579636,25974,84719,23237,0.24059802141613248,0.47219117676942146
3673,0.3719,15,24,15,579660,25950,84734,23222,0.2403757086220312,0.4722606361343854
3674,0.372,11,22,11,579682,25928,84745,23211,0.240171921894105,0.47235393475650705
3675,0.3721,15,25,15,579707,25903,84760,23196,0.23994034606691614,0.47243324711297585
3676,0.3722,10,22,10,579729,25881,84770,23186,0.23973655933898996,0.47253755069598713
3677,0.3723,11,19,11,579748,25862,84781,23175,0.23956056171032644,0.47260232069661684
3678,0.3724,17,30,17,579778,25832,84798,23158,0.2392826707176998,0.472708716064503
3679,0.3725,14,16,14,579794,25816,84812,23144,0.23913446218829892,0.4727124183006536
3680,0.3726,18,15,18,579809,25801,84830,23126,0.23899551669198563,0.4726633556114211
3681,0.3727,10,22,10,579831,25779,84840,23116,0.23879172996405942,0.47276817670518456
3682,0.3728,13,26,13,579857,25753,84853,23103,0.23855089110378302,0.4728794825609956
3683,0.3729,13,19,13,579876,25734,84866,23090,0.2383748934751195,0.4729231525479273
3684,0.373,16,23,16,579899,25711,84882,23074,0.23816184371410576,0.4729732499743774
3685,0.3731,22,24,22,579923,25687,84904,23052,0.23793953092000444,0.4729682595047088
3686,0.3732,15,25,15,579948,25662,84919,23037,0.2377079550928156,0.4730487278999569
3687,0.3733,20,26,20,579974,25636,84939,23017,0.2374671162325392,0.4730849074055043
3688,0.3734,10,27,10,580001,25609,84949,23007,0.23721701433917522,0.47323926279414186
3689,0.3735,12,14,12,580015,25595,84961,22995,0.23708733187594946,0.4732455237703231
3690,0.3736,14,25,14,580040,25570,84975,22981,0.2368557560487606,0.4733373154003007
3691,0.3737,12,14,12,580054,25556,84987,22969,0.23672607358553485,0.47334363730036066
3692,0.3738,16,21,16,580075,25535,85003,22953,0.23653154989069622,0.47337485563438375
3693,0.3739,14,22,14,580097,25513,85017,22939,0.23632776316277002,0.47343762899364317
3694,0.374,15,19,15,580116,25494,85032,22924,0.2361517655341065,0.47346028336569046
3695,0.3741,11,26,11,580142,25468,85043,22913,0.23591092667383007,0.47359500630412765
3696,0.3742,7,25,7,580167,25443,85050,22906,0.2356793508466412,0.47376367660137747
3697,0.3743,10,31,10,580198,25412,85060,22896,0.23539219682092705,0.4739587645938561
3698,0.3744,15,24,15,580222,25388,85075,22881,0.23516988402682573,0.4740309515423978
3699,0.3745,12,20,12,580242,25368,85087,22869,0.23498462336507467,0.4740966478014802
3700,0.3746,12,14,12,580256,25354,85099,22857,0.2348549409018489,0.4741034203812408
3701,0.3747,18,16,18,580272,25338,85117,22839,0.23470673237244805,0.4740643875708326
3702,0.3748,5,25,5,580297,25313,85122,22834,0.2344751565452592,0.474255924564355
3703,0.3749,10,22,10,580319,25291,85132,22824,0.234271369817333,0.47436350410474903
3704,0.375,9,27,9,580346,25264,85141,22815,0.23402126792396902,0.47453150023918966
3705,0.3751,7,29,7,580375,25235,85148,22808,0.23375263996442996,0.4747413775159753
3706,0.3752,15,21,15,580396,25214,85163,22793,0.2335581162695913,0.47478492719811694
3707,0.3753,23,21,23,580417,25193,85186,22770,0.23336359257475267,0.47474094614598755
3708,0.3754,18,25,18,580442,25168,85204,22752,0.2331320167475638,0.4747913188647746
3709,0.3755,9,29,9,580471,25139,85213,22743,0.23286338878802476,0.47498015955891565
3710,0.3756,11,24,11,580495,25115,85224,22732,0.23264107599392345,0.4750977072752733
3711,0.3757,12,27,12,580522,25088,85236,22720,0.23239097410055948,0.47523427041499333
3712,0.3758,15,20,15,580542,25068,85251,22705,0.23220571343880841,0.475268457078266
3713,0.3759,11,22,11,580564,25046,85262,22694,0.2320019267108822,0.475366568914956
3714,0.376,20,23,20,580587,25023,85282,22674,0.23178887694986847,0.47537580979935845
3715,0.3761,13,22,13,580609,25001,85295,22661,0.23158509022194226,0.47545214216776466
3716,0.3762,20,19,20,580628,24982,85315,22641,0.23140909259327874,0.475421540012179
3717,0.3763,8,16,8,580644,24966,85323,22633,0.23126088406387788,0.47549318262988716
3718,0.3764,15,23,15,580667,24943,85338,22618,0.23104783430286413,0.47555770484220267
3719,0.3765,13,25,13,580692,24918,85351,22605,0.23081625847567527,0.47566441512530777
3720,0.3766,7,25,7,580717,24893,85358,22598,0.23058468264848642,0.47583752711039984
3721,0.3767,12,23,12,580740,24870,85370,22586,0.23037163288747267,0.47593560350640596
3722,0.3768,11,18,11,580758,24852,85381,22575,0.2302048982918967,0.47599468657094063
3723,0.3769,17,17,17,580775,24835,85398,22558,0.23004742672940828,0.4759774650264807
3724,0.377,11,28,11,580803,24807,85409,22547,0.22978806180295677,0.476137179541327
3725,0.3771,12,26,12,580829,24781,85421,22535,0.22954722294268035,0.47626595654746806
3726,0.3772,17,24,17,580853,24757,85438,22518,0.22932491014857906,0.47631940772078263
3727,0.3773,16,20,16,580873,24737,85454,22502,0.22913964948682797,0.4763436990622155
3728,0.3774,14,29,14,580902,24708,85468,22488,0.2288710215272889,0.47648105771675564
3729,0.3775,13,18,13,580920,24690,85481,22475,0.2287042869317129,0.47651860489769954
3730,0.3776,12,21,12,580941,24669,85493,22463,0.22850976323687427,0.4765976406687601
3731,0.3777,18,30,18,580971,24639,85511,22445,0.22823187224424765,0.47670121485005523
3732,0.3778,12,25,12,580996,24614,85523,22433,0.2280002964170588,0.4768210512891364
3733,0.3779,11,16,11,581012,24598,85534,22422,0.22785208788765793,0.47686091025095706
3734,0.378,10,20,10,581032,24578,85544,22412,0.22766682722590684,0.47695254309427537
3735,0.3781,15,14,15,581046,24564,85559,22397,0.22753714476268108,0.4769276633802517
3736,0.3782,16,22,16,581068,24542,85575,22381,0.2273333580347549,0.4769729130703493
3737,0.3783,16,19,16,581087,24523,85591,22365,0.22715736040609136,0.47698771540692714
3738,0.3784,12,20,12,581107,24503,85603,22353,0.2269720997443403,0.4770573672528598
3739,0.3785,12,27,12,581134,24476,85615,22341,0.22672199785097633,0.4771984535531965
3740,0.3786,7,20,7,581154,24456,85622,22334,0.22653673718922523,0.47732421457576407
3741,0.3787,10,15,10,581169,24441,85632,22324,0.22639779169291194,0.4773655511600556
3742,0.3788,21,19,21,581188,24422,85653,22303,0.2262217940642484,0.47732477260567147
3743,0.3789,8,20,8,581208,24402,85661,22295,0.22603653340249732,0.4774396642182581
3744,0.379,21,16,21,581224,24386,85682,22274,0.22588832487309646,0.4773681954564938
3745,0.3791,13,19,13,581243,24367,85695,22261,0.2257123272444329,0.47741700265934633
3746,0.3792,6,20,6,581263,24347,85701,22255,0.22552706658268185,0.4775546113900691
3747,0.3793,12,15,12,581278,24332,85713,22243,0.22538812108636852,0.4775738056897477
3748,0.3794,14,19,14,581297,24313,85727,22229,0.225212123457705,0.4776116196123931
3749,0.3795,18,30,18,581327,24283,85745,22211,0.22493423246507838,0.4777175549533273
3750,0.3796,15,19,15,581346,24264,85760,22196,0.22475823483641483,0.4777442961687473
3751,0.3797,13,21,13,581367,24243,85773,22183,0.2245637111415762,0.47781415586094
3752,0.3798,14,14,14,581381,24229,85787,22169,0.22443402867835044,0.4778007672744515
3753,0.3799,10,22,10,581403,24207,85797,22159,0.22423024195042424,0.47791485139973255
3754,0.38,20,18,20,581421,24189,85817,22139,0.22406350735484828,0.4778751510965291
3755,0.3801,14,21,14,581442,24168,85831,22125,0.22386898366000962,0.4779340289028579
3756,0.3802,20,29,20,581471,24139,85851,22105,0.22360035570047057,0.4780079577891186
3757,0.3803,12,11,12,581482,24128,85863,22093,0.22349846233650747,0.47798619675039483
3758,0.3804,17,17,17,581499,24111,85880,22076,0.22334099077401903,0.47796999155606557
3759,0.3805,12,27,12,581526,24084,85892,22064,0.2230908888806551,0.4781138944266274
3760,0.3806,15,22,15,581548,24062,85907,22049,0.2228871021527289,0.47817223655960617
3761,0.3807,9,27,9,581575,24035,85916,22040,0.22263700025936492,0.47835051546391755
3762,0.3808,12,14,12,581589,24021,85928,22028,0.22250731779613916,0.47836000781775934
3763,0.3809,16,16,16,581605,24005,85944,22012,0.2223591092667383,0.4783449594714997
3764,0.381,14,20,14,581625,23985,85958,21998,0.2221738486049872,0.4783941891568623
3765,0.3811,20,24,20,581649,23961,85978,21978,0.22195153581088592,0.47841703128061125
3766,0.3812,13,22,13,581671,23939,85991,21965,0.22174774908295972,0.47849860578598813
3767,0.3813,13,21,13,581692,23918,86004,21952,0.22155322538812108,0.4785698713756268
3768,0.3814,9,27,9,581719,23891,86013,21943,0.22130312349475711,0.4787494000087271
3769,0.3815,17,10,17,581729,23881,86030,21926,0.22121049316388158,0.47866046674089113
3770,0.3816,9,23,9,581752,23858,86039,21917,0.22099744340286784,0.47879847078099397
3771,0.3817,10,22,10,581774,23836,86049,21907,0.22079365667494164,0.4789148066370811
3772,0.3818,8,18,8,581792,23818,86057,21899,0.22062692207936566,0.4790121836515957
3773,0.3819,11,22,11,581814,23796,86068,21888,0.22042313535143948,0.4791174152876281
3774,0.382,13,19,13,581833,23777,86081,21875,0.22024713772277593,0.479168492070446
3775,0.3821,21,15,21,581848,23762,86102,21854,0.22010819222646263,0.4790862855138548
3776,0.3822,10,23,10,581871,23739,86112,21844,0.2198951424654489,0.47921374196520633
3777,0.3823,7,12,7,581883,23727,86119,21837,0.21978398606839825,0.47925994205952066
3778,0.3824,12,20,12,581903,23707,86131,21825,0.21959872540664716,0.4793332161995959
3779,0.3825,14,15,14,581918,23692,86145,21811,0.21945977991033383,0.47933103311869546
3780,0.3826,9,14,9,581932,23678,86154,21802,0.21933009744710807,0.4793755496921724
3781,0.3827,14,15,14,581947,23663,86168,21788,0.21919115195079478,0.4793733911245077
3782,0.3828,8,13,8,581960,23650,86176,21780,0.21907073252065656,0.4794188861985472
3783,0.3829,17,18,17,581978,23632,86193,21763,0.21890399792508058,0.479414032382421
3784,0.383,10,16,10,581994,23616,86203,21753,0.21875578939567972,0.4794683594524896
3785,0.3831,14,18,14,582012,23598,86217,21739,0.21858905480010374,0.4794979817808854
3786,0.3832,11,24,11,582036,23574,86228,21728,0.21836674200600245,0.4796256235927774
3787,0.3833,14,23,14,582059,23551,86242,21714,0.2181536922449887,0.47970838396111787
3788,0.3834,13,22,13,582081,23529,86255,21701,0.2179499055170625,0.4797921733362812
3789,0.3835,14,29,14,582110,23500,86269,21687,0.21768127755752342,0.47993892048598047
3790,0.3836,14,27,14,582137,23473,86283,21673,0.21743117566415948,0.48006467904133254
3791,0.3837,11,13,11,582150,23460,86294,21662,0.21731075623402127,0.48007623775541863
3792,0.3838,15,14,15,582164,23446,86309,21647,0.2171810737707955,0.4800523362827933
3793,0.3839,4,22,4,582186,23424,86313,21643,0.2169772870428693,0.480240530765305
3794,0.384,8,20,8,582206,23404,86321,21635,0.21679202638111825,0.48036146450853706
3795,0.3841,10,15,10,582221,23389,86331,21625,0.21665308088480492,0.48040609588128136
3796,0.3842,10,21,10,582242,23368,86341,21615,0.2164585571899663,0.48051486116977526
3797,0.3843,11,15,11,582257,23353,86352,21604,0.21631961169365296,0.4805480792757524
3798,0.3844,8,21,8,582278,23332,86360,21596,0.21612508799881433,0.4806801994301994
3799,0.3845,12,19,12,582297,23313,86372,21584,0.2159490903701508,0.4807448159119763
3800,0.3846,14,27,14,582324,23286,86386,21570,0.21569898847678684,0.4808721241305511
3801,0.3847,14,30,14,582354,23256,86400,21556,0.21542109748416022,0.48103186646433993
3802,0.3848,8,20,8,582374,23236,86408,21548,0.21523583682240913,0.4811539835655591
3803,0.3849,21,25,21,582399,23211,86429,21527,0.21500426099522027,0.481179310653136
3804,0.385,12,18,12,582417,23193,86441,21515,0.2148375263996443,0.4812337836628791
3805,0.3851,22,21,22,582438,23172,86463,21493,0.21464300270480566,0.48120452255681184
3806,0.3852,13,23,13,582461,23149,86476,21480,0.2144299529437919,0.4813013959533039
3807,0.3853,14,20,14,582481,23129,86490,21466,0.21424469228204082,0.4813544119295885
3808,0.3854,11,20,11,582501,23109,86501,21455,0.21405943162028976,0.4814424198904946
3809,0.3855,15,24,15,582525,23085,86516,21440,0.21383711882618844,0.4815272318921954
3810,0.3856,16,22,16,582547,23063,86532,21424,0.21363333209826227,0.4815788882145346
3811,0.3857,12,18,12,582565,23045,86544,21412,0.2134665975026863,0.4816339384123985
3812,0.3858,14,27,14,582592,23018,86558,21398,0.21321649560932232,0.4817633285302594
3813,0.3859,12,18,12,582610,23000,86570,21386,0.21304976101374634,0.4818185914477538
3814,0.386,11,25,11,582635,22975,86581,21375,0.21281818518655748,0.4819616685456595
3815,0.3861,9,17,9,582652,22958,86590,21366,0.21266071362406908,0.4820413320097464
3816,0.3862,11,20,11,582672,22938,86601,21355,0.21247545296231798,0.4821303591989705
3817,0.3863,14,22,14,582694,22916,86615,21341,0.21227166623439178,0.4822062046681881
3818,0.3864,7,25,7,582719,22891,86622,21334,0.21204009040720292,0.4823968343697004
3819,0.3865,16,15,16,582734,22876,86638,21318,0.21190114491088963,0.4823731728288908
3820,0.3866,10,16,10,582750,22860,86648,21308,0.21175293638148876,0.4824307190726318
3821,0.3867,14,19,14,582769,22841,86662,21294,0.21157693875282524,0.4824742268041237
3822,0.3868,14,31,14,582800,22810,86676,21280,0.21128978472711105,0.4826491267861193
3823,0.3869,17,17,17,582817,22793,86693,21263,0.21113231316462264,0.4826357363355729
3824,0.387,9,17,9,582834,22776,86702,21254,0.2109748416021342,0.48271632977515333
3825,0.3871,12,24,12,582858,22752,86714,21242,0.2107525288080329,0.4828385688957585
3826,0.3872,10,15,10,582873,22737,86724,21232,0.2106135833117196,0.4828856694489299
3827,0.3873,17,15,17,582888,22722,86741,21215,0.2104746378154063,0.48285044495527685
3828,0.3874,13,18,13,582906,22704,86754,21202,0.2103079032198303,0.4828952762720357
3829,0.3875,7,15,7,582921,22689,86761,21195,0.21016895772351699,0.4829778506972929
3830,0.3876,16,36,16,582957,22653,86777,21179,0.20983548853236503,0.4831858003285271
3831,0.3877,12,18,12,582975,22635,86789,21167,0.20966875393678905,0.48324277430254325
3832,0.3878,7,18,7,582993,22617,86796,21160,0.2095020193412131,0.48335884140073554
3833,0.3879,12,18,12,583011,22599,86808,21148,0.20933528474563712,0.48341600566896015
3834,0.388,10,27,10,583038,22572,86818,21138,0.20908518285227315,0.48359643102264926
3835,0.3881,10,22,10,583060,22550,86828,21128,0.20888139612434695,0.48372178213288153
3836,0.3882,11,24,11,583084,22526,86839,21117,0.20865908333024566,0.4838576633137044
3837,0.3883,10,18,10,583102,22508,86849,21107,0.20849234873466968,0.48393901180786425
3838,0.3884,11,18,11,583120,22490,86860,21096,0.2083256141390937,0.48400862662322763
3839,0.3885,16,23,16,583143,22467,86876,21080,0.20811256437807996,0.48407467793418607
3840,0.3886,10,19,10,583162,22448,86886,21070,0.20793656674941643,0.48416747093156853
3841,0.3887,22,14,22,583176,22434,86908,21048,0.20780688428619068,0.4840623706361253
3842,0.3888,14,20,14,583196,22414,86922,21034,0.2076216236244396,0.4841189467869637
3843,0.3889,9,23,9,583219,22391,86931,21025,0.20740857386342584,0.48426847245255206
3844,0.389,15,23,15,583242,22368,86946,21010,0.2071955241024121,0.484346903960533
3845,0.3891,14,18,14,583260,22350,86960,20996,0.20702878950683612,0.48438148848798046
3846,0.3892,18,15,18,583275,22335,86978,20978,0.2068898440105228,0.4843349571722116
3847,0.3893,14,22,14,583297,22313,86992,20964,0.20668605728259662,0.4844143540448737
3848,0.3894,10,18,10,583315,22295,87002,20954,0.20651932268702064,0.4844967513699739
3849,0.3895,6,18,6,583333,22277,87008,20948,0.20635258809144466,0.48462695199537303
3850,0.3896,8,15,8,583348,22262,87016,20940,0.20621364259513136,0.4846997824174807
3851,0.3897,8,19,8,583367,22243,87024,20932,0.20603764496646781,0.48481760277938624
3852,0.3898,13,17,13,583384,22226,87037,20919,0.2058801734039794,0.4848534013211264
3853,0.3899,11,11,11,583395,22215,87048,20908,0.2057782800400163,0.4848456740022726
3854,0.39,11,30,11,583425,22185,87059,20897,0.20550038904738968,0.4850517617566501
3855,0.3901,12,13,12,583438,22172,87071,20885,0.20537996961725147,0.48505469493926656
3856,0.3902,10,23,10,583461,22149,87081,20875,0.20516691985623772,0.48519431015247305
3857,0.3903,13,19,13,583480,22130,87094,20862,0.2049909222275742,0.48525307033866766
3858,0.3904,10,17,10,583497,22113,87104,20852,0.20483345066508576,0.48532526475037824
3859,0.3905,14,17,14,583514,22096,87118,20838,0.20467597910259736,0.48534960637257185
3860,0.3906,13,15,13,583529,22081,87131,20825,0.20453703360628403,0.4853633524448795
3861,0.3907,14,15,14,583544,22066,87145,20811,0.20439808810997073,0.48536511416377076
3862,0.3908,15,20,15,583564,22046,87160,20796,0.20421282744821964,0.4854115120675972
3863,0.3909,9,24,9,583588,22022,87169,20787,0.20399051465411835,0.485575463103553
3864,0.391,16,16,16,583604,22006,87185,20771,0.2038423061247175,0.485564672604437
3865,0.3911,9,16,9,583620,21990,87194,20762,0.20369409759531662,0.4856380988023952
3866,0.3912,13,18,13,583638,21972,87207,20749,0.20352736299974064,0.4856861964841647
3867,0.3913,15,15,15,583653,21957,87222,20734,0.20338841750342732,0.4856761378276452
3868,0.3914,13,24,13,583677,21933,87235,20721,0.20316610470932603,0.4857926571951048
3869,0.3915,12,20,12,583697,21913,87247,20709,0.20298084404757494,0.485875838768711
3870,0.3916,14,17,14,583714,21896,87261,20695,0.20282337248508653,0.4859007771594938
3871,0.3917,18,17,18,583731,21879,87279,20677,0.2026659009225981,0.4858774320894821
3872,0.3918,12,16,12,583747,21863,87291,20665,0.20251769239319722,0.48591516177577126
3873,0.3919,10,12,10,583759,21851,87301,20655,0.20240653599614658,0.4859313979202936
3874,0.392,8,22,8,583781,21829,87309,20647,0.20220274926822038,0.4860862604765044
3875,0.3921,10,32,10,583813,21797,87319,20637,0.20190633220941864,0.48633171513409057
3876,0.3922,13,22,13,583835,21775,87332,20624,0.20170254548149247,0.4864265666643081
3877,0.3923,9,9,9,583844,21766,87341,20615,0.20161917818370448,0.48642080177438
3878,0.3924,8,23,8,583867,21743,87349,20607,0.20140612842269073,0.4865879574970484
3879,0.3925,14,21,14,583888,21722,87363,20593,0.2012116047278521,0.4866595769821576
3880,0.3926,16,28,16,583916,21694,87379,20577,0.20095223980140056,0.4867876321828204
3881,0.3927,15,13,15,583929,21681,87394,20562,0.20083182037126238,0.48675520204530925
3882,0.3928,13,31,13,583960,21650,87407,20549,0.20054466634554818,0.48695466717220787
3883,0.3929,13,15,13,583975,21635,87420,20536,0.2004057208492349,0.4869697185269498
3884,0.393,9,28,9,584003,21607,87429,20527,0.20014635592278335,0.4871837470926093
3885,0.3931,17,22,17,584025,21585,87446,20510,0.19994256919485717,0.48723126262026367
3886,0.3932,8,16,8,584041,21569,87454,20502,0.1997943606654563,0.48731905588172375
3887,0.3933,9,12,9,584053,21557,87463,20493,0.19968320426840563,0.4873483947681332
3888,0.3934,11,20,11,584073,21537,87474,20482,0.19949794360665457,0.4874461553106928
3889,0.3935,23,11,23,584084,21526,87497,20459,0.19939605024269147,0.4872930808622127
3890,0.3936,12,15,12,584099,21511,87509,20447,0.19925710474637814,0.48732065398732066
3891,0.3937,9,24,9,584123,21487,87518,20438,0.19903479195227686,0.487489564698867
3892,0.3938,15,16,15,584139,21471,87533,20423,0.198886583422876,0.4874922423258701
3893,0.3939,11,19,11,584158,21452,87544,20412,0.19871058579421247,0.4875788266768584
3894,0.394,22,11,22,584169,21441,87566,20390,0.19860869243024937,0.4874375463173245
3895,0.3941,15,17,15,584186,21424,87581,20375,0.19845122086776093,0.48745185291514154
3896,0.3942,15,18,15,584204,21406,87596,20360,0.19828448627218495,0.48747785279892736
3897,0.3943,6,20,6,584224,21386,87602,20354,0.1980992256104339,0.4876377575467178
3898,0.3944,11,22,11,584246,21364,87613,20343,0.19789543888250768,0.48775984846668424
3899,0.3945,14,14,14,584260,21350,87627,20329,0.19776575641928193,0.48775162551884643
3900,0.3946,11,24,11,584284,21326,87638,20318,0.19754344362518064,0.48789741619440974
3901,0.3947,10,21,10,584305,21305,87648,20308,0.19734891993034198,0.4880205704947973
3902,0.3948,20,19,20,584324,21286,87668,20288,0.19717292230167846,0.48799730600856306
3903,0.3949,7,22,7,584346,21264,87675,20281,0.19696913557375226,0.48816945480803947
3904,0.395,12,19,12,584365,21245,87687,20269,0.19679313794508874,0.4882449294214
3905,0.3951,11,30,11,584395,21215,87698,20258,0.1965152469524621,0.4884623731102163
3906,0.3952,6,18,6,584413,21197,87704,20252,0.19634851235688613,0.4886004487442399
3907,0.3953,14,23,14,584436,21174,87718,20238,0.1961354625958724,0.48869892784700086
3908,0.3954,16,21,16,584457,21153,87734,20222,0.19594093890103376,0.4887492447129909
3909,0.3955,13,15,13,584472,21138,87747,20209,0.19580199340472043,0.4887658113043268
3910,0.3956,21,21,21,584493,21117,87768,20188,0.1956074697098818,0.4887543880886091
3911,0.3957,12,18,12,584511,21099,87780,20176,0.19544073511430582,0.4888188976377953
3912,0.3958,13,15,13,584526,21084,87793,20163,0.19530178961799252,0.48883555167648557
3913,0.3959,9,18,9,584544,21066,87802,20154,0.19513505502241654,0.48893740902474525
3914,0.396,10,24,10,584568,21042,87812,20144,0.19491274222831523,0.48909823726509005
3915,0.3961,14,19,14,584587,21023,87826,20130,0.1947367445996517,0.48915024421062864
3916,0.3962,12,24,12,584611,20999,87838,20118,0.19451443180555042,0.48928666974730645
3917,0.3963,10,14,10,584625,20985,87848,20108,0.19438474934232466,0.4893290828121578
3918,0.3964,12,22,12,584647,20963,87860,20096,0.19418096261439846,0.4894420224554909
3919,0.3965,13,14,13,584661,20949,87873,20083,0.1940512801511727,0.48944726067459543
3920,0.3966,15,20,15,584681,20929,87888,20068,0.19386601948942161,0.48949923165109643
3921,0.3967,26,19,26,584700,20910,87914,20042,0.1936900218607581,0.48940222699746044
3922,0.3968,25,16,25,584716,20894,87939,20017,0.19354181333135723,0.48928161130258363
3923,0.3969,12,19,12,584735,20875,87951,20005,0.19336581570269368,0.4893590998043053
3924,0.397,12,18,12,584753,20857,87963,19993,0.19319908110711773,0.4894247246022032
3925,0.3971,15,13,15,584766,20844,87978,19978,0.1930786616769795,0.48939297437656165
3926,0.3972,13,13,13,584779,20831,87991,19965,0.1929582422468413,0.4893862143347387
3927,0.3973,10,24,10,584803,20807,88001,19955,0.19273592945274,0.48954908983857515
3928,0.3974,15,12,15,584815,20795,88016,19940,0.19262477305568934,0.48950533938873203
3929,0.3975,8,14,8,584829,20781,88024,19932,0.19249509059246359,0.489573354948051
3930,0.3976,9,26,9,584855,20755,88033,19923,0.1922542517321872,0.48977334185554844
3931,0.3977,7,18,7,584873,20737,88040,19916,0.1920875171366112,0.4899023442304381
3932,0.3978,11,18,11,584891,20719,88051,19905,0.19192078254103523,0.4899812918471839
3933,0.3979,12,17,12,584908,20702,88063,19893,0.19176331097854682,0.4900357186845671
3934,0.398,15,16,15,584924,20686,88078,19878,0.19161510244914595,0.49004042993787594
3935,0.3981,23,19,23,584943,20667,88101,19855,0.19143910482048243,0.4899807511968807
3936,0.3982,12,15,12,584958,20652,88113,19843,0.1913001593241691,0.4900111124830226
3937,0.3983,9,22,9,584980,20630,88122,19834,0.1910963725962429,0.4901640964808225
3938,0.3984,15,24,15,585004,20606,88137,19819,0.19087405980214162,0.4902659245516388
3939,0.3985,15,19,15,585023,20587,88152,19804,0.1906980621734781,0.4903072466638608
3940,0.3986,14,15,14,585038,20572,88166,19790,0.19055911667716477,0.49031267033348197
3941,0.3987,12,13,12,585051,20559,88178,19778,0.19043869724702656,0.4903190619034633
3942,0.3988,7,19,7,585070,20540,88185,19771,0.19026269961836303,0.49046166058892116
3943,0.3989,16,17,16,585087,20523,88201,19755,0.19010522805587463,0.49046625949649936
3944,0.399,11,22,11,585109,20501,88212,19744,0.18990144132794842,0.49059510498198533
3945,0.3991,9,26,9,585135,20475,88221,19735,0.18966060246767202,0.49079830887838843
3946,0.3992,18,25,18,585160,20450,88239,19717,0.18942902664048317,0.4908755943934075
3947,0.3993,17,18,17,585178,20432,88256,19700,0.1892622920449072,0.490880095684242
3948,0.3994,3,21,3,585199,20411,88259,19697,0.18906776835006855,0.49109903261194776
3949,0.3995,11,15,11,585214,20396,88270,19686,0.18892882285375523,0.49114315652911533
3950,0.3996,13,17,13,585231,20379,88283,19673,0.18877135129126682,0.49118645760511337
3951,0.3997,8,18,8,585249,20361,88291,19665,0.18860461669569084,0.49130565132663767
3952,0.3998,14,18,14,585267,20343,88305,19651,0.18843788210011486,0.4913487023053458
3953,0.3999,17,17,17,585284,20326,88322,19634,0.18828041053762645,0.49134134134134133
3954,0.4,11,13,11,585297,20313,88333,19623,0.18815999110748824,0.49136117788461536
3955,0.4001,17,18,17,585315,20295,88350,19606,0.18799325651191226,0.4913661311746573
3956,0.4002,12,16,12,585331,20279,88362,19594,0.1878450479825114,0.4914102274722243
3957,0.4003,10,16,10,585347,20263,88372,19584,0.18769683945311053,0.49147991065826785
3958,0.4004,16,10,16,585357,20253,88388,19568,0.187604209122235,0.4913990105723111
3959,0.4005,16,15,16,585372,20238,88404,19552,0.18746526362592167,0.49137974365418446
3960,0.4006,13,11,13,585383,20227,88417,19539,0.18736337026195857,0.4913493939546346
3961,0.4007,14,15,14,585398,20212,88431,19525,0.18722442476564527,0.4913556634874299
3962,0.4008,11,17,11,585415,20195,88442,19514,0.18706695320315683,0.49142511773149666
3963,0.4009,13,17,13,585432,20178,88455,19501,0.18690948164066842,0.4914690390382822
3964,0.401,15,20,15,585452,20158,88470,19486,0.18672422097891733,0.4915245686610836
3965,0.4011,9,21,9,585473,20137,88479,19477,0.1865296972840787,0.4916696117534205
3966,0.4012,7,14,7,585487,20123,88486,19470,0.18640001482085294,0.4917535928068093
3967,0.4013,8,17,8,585504,20106,88494,19462,0.1862425432583645,0.4918621107966033
3968,0.4014,7,16,7,585520,20090,88501,19455,0.18609433472896364,0.49197117208243774
3969,0.4015,13,26,13,585546,20064,88514,19442,0.18585349586868724,0.492127778059029
3970,0.4016,11,17,11,585563,20047,88525,19431,0.18569602430619883,0.49219818633162776
3971,0.4017,10,13,10,585576,20034,88535,19421,0.18557560487606062,0.4922316563173235
3972,0.4018,8,7,8,585583,20027,88543,19413,0.18551076364444774,0.4922160243407708
3973,0.4019,11,23,11,585606,20004,88554,19402,0.185297713883434,0.49236156930416686
3974,0.402,8,27,8,585633,19977,88562,19394,0.18504761199007003,0.4925960732518859
3975,0.4021,14,10,14,585643,19967,88576,19380,0.1849549816591945,0.49254072737438687
3976,0.4022,15,7,15,585650,19960,88591,19365,0.18489014042758162,0.49243483788938336
3977,0.4023,10,14,10,585664,19946,88601,19355,0.18476045796435586,0.492481107350958
3978,0.4024,6,19,6,585683,19927,88607,19349,0.1845844603356923,0.4926418168856299
3979,0.4025,14,20,14,585703,19907,88621,19335,0.18439919967394122,0.49271189032159424
3980,0.4026,14,19,14,585722,19888,88635,19321,0.1842232020452777,0.4927695172026831
3981,0.4027,10,22,10,585744,19866,88645,19311,0.18401941531735153,0.4929167623860939
3982,0.4028,10,28,10,585772,19838,88655,19301,0.1837600503909,0.49313983494723934
3983,0.4029,8,19,8,585791,19819,88663,19293,0.18358405276223647,0.49327572100634076
3984,0.403,13,16,13,585807,19803,88676,19280,0.1834358442328356,0.49330911137834865
3985,0.4031,6,15,6,585822,19788,88682,19274,0.18329689873652227,0.49342071578516206
3986,0.4032,11,20,11,585842,19768,88693,19263,0.1831116380747712,0.4935307832235915
3987,0.4033,13,20,13,585862,19748,88706,19250,0.18292637741302012,0.4936150571824196
3988,0.4034,9,15,9,585877,19733,88715,19241,0.1827874319167068,0.49368809975881356
3989,0.4035,17,20,17,585897,19713,88732,19224,0.18260217125495573,0.49372062562601127
3990,0.4036,14,16,14,585913,19697,88746,19210,0.18245396272555486,0.4937414861078983
3991,0.4037,15,13,15,585926,19684,88761,19195,0.18233354329541665,0.49371125800560717
3992,0.4038,12,23,12,585949,19661,88773,19183,0.1821204935344029,0.49384718360621976
3993,0.4039,12,17,12,585966,19644,88785,19171,0.1819630219719145,0.49390699471853666
3994,0.404,14,10,14,585976,19634,88799,19157,0.18187039164103894,0.4938516666237014
3995,0.4041,11,12,11,585988,19622,88810,19146,0.1817592352439883,0.4938609162195625
3996,0.4042,12,22,12,586010,19600,88822,19134,0.1815554485160621,0.4939846130014974
3997,0.4043,13,23,13,586033,19577,88835,19121,0.18134239875504835,0.49410822264716525
3998,0.4044,18,15,18,586048,19562,88853,19103,0.18120345325873505,0.49406439932755725
3999,0.4045,14,15,14,586063,19547,88867,19089,0.18106450776242172,0.4940728853918625
4000,0.4046,10,25,10,586088,19522,88877,19079,0.18083293193523287,0.49426180668894587
4001,0.4047,6,12,6,586100,19510,88883,19073,0.18072177553818222,0.4943368841199492
4002,0.4048,15,19,15,586119,19491,88898,19058,0.1805457779095187,0.4943837713040546
4003,0.4049,12,14,12,586133,19477,88910,19046,0.18041609544629295,0.49440593930898424
4004,0.405,16,24,16,586157,19453,88926,19030,0.18019378265219163,0.49450406673076425
4005,0.4051,9,17,9,586174,19436,88935,19021,0.18003631108970322,0.4946043633148712
4006,0.4052,11,21,11,586195,19415,88946,19010,0.17984178739486456,0.49472999349381913
4007,0.4053,14,20,14,586215,19395,88960,18996,0.1796565267331135,0.4948034695631789
4008,0.4054,15,16,15,586231,19379,88975,18981,0.17950831820371263,0.49481230448383734
4009,0.4055,12,10,12,586241,19369,88987,18969,0.17941568787283707,0.4947832437790182
4010,0.4056,10,23,10,586264,19346,88997,18959,0.17920263811182333,0.49494844015141626
4011,0.4057,9,12,9,586276,19334,89006,18950,0.17909148171477268,0.4949848500679135
4012,0.4058,15,13,15,586289,19321,89021,18935,0.17897106228463447,0.49495503973232957
4013,0.4059,6,17,6,586306,19304,89027,18929,0.17881359072214606,0.4950958595977297
4014,0.406,18,15,18,586321,19289,89045,18911,0.17867464522583273,0.4950523560209424
4015,0.4061,11,16,11,586337,19273,89056,18900,0.17852643669643187,0.49511434783747676
4016,0.4062,4,23,4,586360,19250,89060,18896,0.17831338693541812,0.4953599328894248
4017,0.4063,21,20,21,586380,19230,89081,18875,0.17812812627366706,0.49534181865896865
4018,0.4064,7,17,7,586397,19213,89088,18868,0.17797065471117862,0.49547018198051523
4019,0.4065,15,16,15,586413,19197,89103,18853,0.17782244618177775,0.4954796320630749
4020,0.4066,14,25,14,586438,19172,89117,18839,0.1775908703545889,0.4956196890373839
4021,0.4067,11,18,11,586456,19154,89128,18828,0.17742413575901292,0.4957084934969196
4022,0.4068,6,16,6,586472,19138,89134,18822,0.17727592722961205,0.4958377239199157
4023,0.4069,12,13,12,586485,19125,89146,18810,0.17715550779947387,0.4958481613285884
4024,0.407,16,18,16,586503,19107,89162,18794,0.1769887732038979,0.49587082135036015
4025,0.4071,14,16,14,586519,19091,89176,18780,0.17684056467449702,0.49589395579731194
4026,0.4072,11,16,11,586535,19075,89187,18769,0.17669235614509615,0.4959570869886904
4027,0.4073,19,19,19,586554,19056,89206,18750,0.17651635851643263,0.4959530233296302
4028,0.4074,14,16,14,586570,19040,89220,18736,0.17636814998703176,0.49597628123676407
4029,0.4075,14,18,14,586588,19022,89234,18722,0.17620141539145578,0.49602585841458247
4030,0.4076,4,24,4,586612,18998,89238,18718,0.17597910259735447,0.4962880475129918
4031,0.4077,9,15,9,586627,18983,89247,18709,0.17584015710104117,0.49636527645123635
4032,0.4078,10,17,10,586644,18966,89257,18699,0.17568268553855274,0.4964555953803266
4033,0.4079,10,14,10,586658,18952,89267,18689,0.17555300307532698,0.4965064690098563
4034,0.408,9,15,9,586673,18937,89276,18680,0.17541405757901368,0.49658399128053804
4035,0.4081,8,15,8,586688,18922,89284,18672,0.17527511208270036,0.4966750013299995
4036,0.4082,8,11,8,586699,18911,89292,18664,0.17517321871873726,0.4967132401862941
4037,0.4083,7,17,7,586716,18894,89299,18657,0.17501574715624885,0.49684429176320205
4038,0.4084,15,16,15,586732,18878,89314,18642,0.17486753862684798,0.4968550106609808
4039,0.4085,10,16,10,586748,18862,89324,18632,0.1747193300974471,0.49693284258814746
4040,0.4086,15,18,15,586766,18844,89339,18617,0.17455259550187113,0.4969701823229492
4041,0.4087,12,15,12,586781,18829,89351,18605,0.1744136500055578,0.49700806753219
4042,0.4088,18,14,18,586795,18815,89369,18587,0.17428396754233205,0.49695203465055343
4043,0.4089,7,15,7,586810,18800,89376,18580,0.17414502204601875,0.4970572498662386
4044,0.409,9,14,9,586824,18786,89385,18571,0.174015339582793,0.4971223599325428
4045,0.4091,12,15,12,586839,18771,89397,18559,0.17387639408647967,0.4971604607554246
4046,0.4092,14,16,14,586855,18755,89411,18545,0.1737281855570788,0.49718498659517424
4047,0.4093,14,19,14,586874,18736,89425,18531,0.17355218792841529,0.4972495773740843
4048,0.4094,8,21,8,586895,18715,89433,18523,0.17335766423357665,0.49742198829153017
4049,0.4095,13,17,13,586912,18698,89446,18510,0.17320019267108822,0.49747366157815526
4050,0.4096,16,19,16,586931,18679,89462,18494,0.1730241950424247,0.4975116347886907
4051,0.4097,10,19,10,586950,18660,89472,18484,0.17284819741376117,0.4976308421279345
4052,0.4098,13,12,13,586962,18648,89485,18471,0.1727370410167105,0.4976157762870767
4053,0.4099,15,15,15,586977,18633,89500,18456,0.1725980955203972,0.49761384777157647
4054,0.41,14,19,14,586996,18614,89514,18442,0.17242209789173366,0.49767918825561314
4055,0.4101,9,23,9,587019,18591,89523,18433,0.1722090481307199,0.4978662489196197
4056,0.4102,12,15,12,587034,18576,89535,18421,0.1720701026344066,0.49790523555963995
4057,0.4103,10,19,10,587053,18557,89545,18411,0.1718941050057431,0.49802531919497944
4058,0.4104,10,22,10,587075,18535,89555,18401,0.1716903182778169,0.49818605154862466
4059,0.4105,10,13,10,587088,18522,89565,18391,0.17156989884767868,0.4982255573917048
4060,0.4106,15,13,15,587101,18509,89580,18376,0.1714494794175405,0.49819709909177173
4061,0.4107,12,15,12,587116,18494,89592,18364,0.17131053392122716,0.4982364751207336
4062,0.4108,11,14,11,587130,18480,89603,18353,0.1711808514580014,0.49827600249776016
4063,0.4109,18,13,18,587143,18467,89621,18335,0.1710604320278632,0.498206619205478
4064,0.411,9,14,9,587157,18453,89630,18326,0.17093074956463744,0.49827347127436855
4065,0.4111,7,15,7,587172,18438,89637,18319,0.17079180406832414,0.4983812607122453
4066,0.4112,9,17,9,587189,18421,89646,18310,0.1706343325058357,0.4984890147287033
4067,0.4113,13,12,13,587201,18409,89659,18297,0.17052317610878506,0.4984743638642184
4068,0.4114,12,19,12,587220,18390,89671,18285,0.17034717848012154,0.4985685071574642
4069,0.4115,12,14,12,587234,18376,89683,18273,0.17021749601689576,0.4985947774836967
4070,0.4116,12,18,12,587252,18358,89695,18261,0.1700507614213198,0.4986755509434993
4071,0.4117,14,14,14,587266,18344,89709,18247,0.16992107895809405,0.4986745374545653
4072,0.4118,9,13,9,587279,18331,89718,18238,0.16980065952795584,0.49872843118488336
4073,0.4119,8,20,8,587299,18311,89726,18230,0.16961539886620475,0.4988916559481131
4074,0.412,15,21,15,587320,18290,89741,18215,0.16942087517136611,0.4989727434598
4075,0.4121,5,14,5,587334,18276,89746,18210,0.16929119270814036,0.4990955434961355
4076,0.4122,12,12,12,587346,18264,89758,18198,0.16918003631108972,0.4990949481652131
4077,0.4123,11,7,11,587353,18257,89769,18187,0.16911519507947684,0.4990396224344199
4078,0.4124,16,12,16,587365,18245,89785,18171,0.16900403868242617,0.49898396309314585
4079,0.4125,10,22,10,587387,18223,89795,18161,0.1688002519545,0.4991479771328056
4080,0.4126,10,10,10,587397,18213,89805,18151,0.16870762162362443,0.49914750852491474
4081,0.4127,10,18,10,587415,18195,89815,18141,0.16854088702804845,0.49925693527080584
4082,0.4128,11,21,11,587436,18174,89826,18130,0.16834636333320982,0.499394006170119
4083,0.4129,16,17,16,587453,18157,89842,18114,0.1681888917707214,0.49940723994375674
4084,0.413,10,20,10,587473,18137,89852,18104,0.16800363110897032,0.49954471454981925
4085,0.4131,8,16,8,587489,18121,89860,18096,0.16785542257956945,0.499654858215755
4086,0.4132,17,10,17,587499,18111,89877,18079,0.16776279224869392,0.499557888919591
4087,0.4133,4,11,4,587510,18100,89881,18075,0.16766089888473082,0.4996544574982723
4088,0.4134,15,10,15,587520,18090,89896,18060,0.1675682685538553,0.4995850622406639
4089,0.4135,10,19,10,587539,18071,89906,18050,0.16739227092519174,0.49970931037346694
4090,0.4136,4,22,4,587561,18049,89910,18046,0.16718848419726556,0.4999584429976451
4091,0.4137,7,16,7,587577,18033,89917,18039,0.1670402756678647,0.5000831669993346
4092,0.4138,16,21,16,587598,18012,89933,18023,0.16684575197302604,0.5001526293880949
4093,0.4139,7,11,7,587609,18001,89940,18016,0.16674385860906296,0.5002082350001388
4094,0.414,13,19,13,587628,17982,89953,18003,0.1665678609803994,0.5002917882451021
4095,0.4141,12,13,12,587641,17969,89965,17991,0.16644744155026123,0.5003058954393771
4096,0.4142,17,9,17,587650,17960,89982,17974,0.16636407425247324,0.5001948015806756
4097,0.4143,13,21,13,587671,17939,89995,17961,0.1661695505576346,0.5003064066852367
4098,0.4144,6,24,6,587695,17915,90001,17955,0.1659472377635333,0.5005575689991636
4099,0.4145,10,17,10,587712,17898,90011,17945,0.16578976620104488,0.5006556370839494
4100,0.4146,13,14,13,587726,17884,90024,17932,0.16566008373781912,0.5006700915791825
4101,0.4147,10,25,10,587751,17859,90034,17922,0.16542850791063027,0.5008803554959336
4102,0.4148,11,15,11,587766,17844,90045,17911,0.16528956241431694,0.5009369318976367
4103,0.4149,9,11,9,587777,17833,90054,17902,0.16518766905035384,0.5009654400447741
4104,0.415,15,14,15,587791,17819,90069,17887,0.16505798658712809,0.5009522209152524
4105,0.4151,7,14,7,587805,17805,90076,17880,0.16492830412390233,0.5010508617065994
4106,0.4152,8,20,8,587825,17785,90084,17872,0.16474304346215124,0.5012199568107244
4107,0.4153,8,18,8,587843,17767,90092,17864,0.16457630886657526,0.5013611742583706
4108,0.4154,15,15,15,587858,17752,90107,17849,0.16443736337026196,0.50136232128311
4109,0.4155,15,13,15,587871,17739,90122,17834,0.16431694394012375,0.5013352823770837
4110,0.4156,12,15,12,587886,17724,90134,17822,0.16417799844381045,0.5013784954706577
4111,0.4157,12,16,12,587902,17708,90146,17810,0.16402978991440959,0.5014358916605665
4112,0.4158,8,11,8,587913,17697,90154,17802,0.16392789655044648,0.5014789148990112
4113,0.4159,5,19,5,587932,17678,90159,17797,0.16375189892178296,0.501677237491191
4114,0.416,5,14,5,587946,17664,90164,17792,0.16362221645855718,0.5018050541516246
4115,0.4161,16,8,16,587954,17656,90180,17776,0.16354811219385676,0.5016933845111763
4116,0.4162,8,13,8,587967,17643,90188,17768,0.16342769276371855,0.5017649882804778
4117,0.4163,15,15,15,587982,17628,90203,17753,0.16328874726740525,0.5017664848364941
4118,0.4164,13,16,13,587998,17612,90216,17740,0.16314053873800438,0.5018103643358226
4119,0.4165,10,14,10,588012,17598,90226,17730,0.16301085627477863,0.5018682065217391
4120,0.4166,15,10,15,588022,17588,90241,17715,0.16291822594390307,0.5017987139903124
4121,0.4167,12,12,12,588034,17576,90253,17703,0.16280706954685242,0.5017999376399558
4122,0.4168,14,15,14,588049,17561,90267,17689,0.1626681240505391,0.5018156028368794
4123,0.4169,12,18,12,588067,17543,90279,17677,0.16250138945496315,0.5019023282226008
4124,0.417,7,13,7,588080,17530,90286,17670,0.16238097002482493,0.5019886363636363
4125,0.4171,14,19,14,588099,17511,90300,17656,0.1622049723961614,0.5020615918332527
4126,0.4172,14,9,14,588108,17502,90314,17642,0.16212160509837342,0.5019918051445481
4127,0.4173,13,15,13,588123,17487,90327,17629,0.1619826596020601,0.5020218703724798
4128,0.4174,15,7,15,588130,17480,90342,17614,0.16191781837044722,0.5019091582606714
4129,0.4175,16,16,16,588146,17464,90358,17598,0.16176960984104635,0.5019109006902059
4130,0.4176,11,16,11,588162,17448,90369,17587,0.16162140131164549,0.5019837305551591
4131,0.4177,14,15,14,588177,17433,90383,17573,0.16148245581533216,0.5019996572016225
4132,0.4178,12,12,12,588189,17421,90395,17561,0.16137129941828152,0.5020010291006803
4133,0.4179,9,15,9,588204,17406,90404,17552,0.16123235392196822,0.5020882201498942
4134,0.418,9,9,9,588213,17397,90413,17543,0.16114898662418023,0.5020892959358901
4135,0.4181,9,16,9,588229,17381,90422,17534,0.16100077809477936,0.5021910353716168
4136,0.4182,14,17,14,588246,17364,90436,17520,0.16084330653229093,0.5022359821121432
4137,0.4183,15,14,15,588260,17350,90451,17505,0.16071362406906517,0.5022234973461484
4138,0.4184,7,13,7,588273,17337,90458,17498,0.16059320463892698,0.5023108942155877
4139,0.4185,16,9,16,588282,17328,90474,17482,0.160509837341139,0.5022120080436656
4140,0.4186,10,16,10,588298,17312,90484,17472,0.16036162881173813,0.5022999080036799
4141,0.4187,10,20,10,588318,17292,90494,17462,0.16017636814998704,0.502445761638948
4142,0.4188,7,16,7,588334,17276,90501,17455,0.16002815962058617,0.5025769485474072
4143,0.4189,7,16,7,588350,17260,90508,17448,0.1598799510911853,0.5027083093234989
4144,0.419,11,13,11,588363,17247,90519,17437,0.1597595316610471,0.5027390151078307
4145,0.4191,13,16,13,588379,17231,90532,17424,0.15961132313164622,0.5027845909681142
4146,0.4192,12,10,12,588389,17221,90544,17412,0.1595186928007707,0.5027574856350879
4147,0.4193,13,11,13,588400,17210,90557,17399,0.1594167994368076,0.5027305036262244
4148,0.4194,13,14,13,588414,17196,90570,17386,0.15928711697358183,0.5027470938638599
4149,0.4195,6,22,6,588436,17174,90576,17380,0.15908333024565563,0.5029808415812931
4150,0.4196,12,12,12,588448,17162,90588,17368,0.158972173848605,0.5029829134086302
4151,0.4197,10,12,10,588460,17150,90598,17358,0.15886101745155434,0.503013793902863
4152,0.4198,14,14,14,588474,17136,90612,17344,0.1587313349883286,0.5030162412993039
4153,0.4199,16,16,16,588490,17120,90628,17328,0.15858312645892772,0.5030190431955411
4154,0.42,16,11,16,588501,17109,90644,17312,0.15848123309496462,0.5029487812672496
4155,0.4201,10,12,10,588513,17097,90654,17302,0.15837007669791398,0.5029797377830751
4156,0.4202,8,12,8,588525,17085,90662,17294,0.1582589203008633,0.5030396462957037
4157,0.4203,11,20,11,588545,17065,90673,17283,0.15807365963911224,0.5031734016536625
4158,0.4204,8,18,8,588563,17047,90681,17275,0.15790692504353626,0.5033214847619603
4159,0.4205,12,14,12,588577,17033,90693,17263,0.1577772425803105,0.5033531607184512
4160,0.4206,12,12,12,588589,17021,90705,17251,0.15766608618325983,0.5033555088702147
4161,0.4207,12,7,12,588596,17014,90717,17239,0.15760124495164696,0.5032843838495898
4162,0.4208,14,14,14,588610,17000,90731,17225,0.1574715624884212,0.5032870708546384
4163,0.4209,9,7,9,588617,16993,90740,17216,0.15740672125680832,0.503259376187553
4164,0.421,11,13,11,588630,16980,90751,17205,0.15728630182667014,0.5032909170688898
4165,0.4211,15,20,15,588650,16960,90766,17190,0.15710104116491905,0.5033674963396779
4166,0.4212,10,13,10,588663,16947,90776,17180,0.15698062173478083,0.5034137193424562
4167,0.4213,10,13,10,588676,16934,90786,17170,0.15686020230464262,0.5034600046915317
4168,0.4214,8,13,8,588689,16921,90794,17162,0.15673978287450444,0.5035354868996273
4169,0.4215,17,16,17,588705,16905,90811,17145,0.15659157434510357,0.5035242290748899
4170,0.4216,11,10,11,588715,16895,90822,17134,0.156498944014228,0.5035117105997825
4171,0.4217,10,15,10,588730,16880,90832,17124,0.1563599985179147,0.5035878131984473
4172,0.4218,17,10,17,588740,16870,90849,17107,0.15626736818703915,0.5034876534126026
4173,0.4219,13,11,13,588751,16859,90862,17094,0.15616547482307608,0.503460666215062
4174,0.422,8,27,8,588778,16832,90870,17086,0.1559153729297121,0.5037443245474379
4175,0.4221,9,12,9,588790,16820,90879,17077,0.15580421653266147,0.5037908959494941
4176,0.4222,15,17,15,588807,16803,90894,17062,0.15564674497017303,0.503824007086963
4177,0.4223,17,17,17,588824,16786,90911,17045,0.15548927340768462,0.5038278501965653
4178,0.4224,12,15,12,588839,16771,90923,17033,0.1553503279113713,0.5038752810318305
4179,0.4225,13,14,13,588853,16757,90936,17020,0.15522064544814554,0.5038931817508956
4180,0.4226,11,19,11,588872,16738,90947,17009,0.15504464781948202,0.5040151717189676
4181,0.4227,18,12,18,588884,16726,90965,16991,0.15493349142243137,0.5039297683661061
4182,0.4228,12,16,12,588900,16710,90977,16979,0.1547852828930305,0.5039924010804714
4183,0.4229,14,13,14,588913,16697,90991,16965,0.1546648634628923,0.5039807498069039
4184,0.423,8,20,8,588933,16677,90999,16957,0.1544796028011412,0.504162454658976
4185,0.4231,16,12,16,588945,16665,91015,16941,0.15436844640409056,0.5041064095697196
4186,0.4232,8,13,8,588958,16652,91023,16933,0.15424802697395235,0.5041834152151258
4187,0.4233,9,16,9,588974,16636,91032,16924,0.15409981844455148,0.5042908224076281
4188,0.4234,7,10,7,588984,16626,91039,16917,0.15400718811367595,0.5043377157678204
4189,0.4235,8,12,8,588996,16614,91047,16909,0.1538960317166253,0.504399964203681
4190,0.4236,7,10,7,589006,16604,91054,16902,0.15380340138574974,0.5044469647227362
4191,0.4237,4,17,4,589023,16587,91058,16898,0.15364592982326133,0.5046438703897267
4192,0.4238,9,5,9,589028,16582,91067,16889,0.15359961465782357,0.5045860595739595
4193,0.4239,7,12,7,589040,16570,91074,16882,0.1534884582607729,0.5046633983020448
4194,0.424,8,12,8,589052,16558,91082,16874,0.15337730186372225,0.5047260110074181
4195,0.4241,10,15,10,589067,16543,91092,16864,0.15323835636740896,0.5048043823150836
4196,0.4242,9,14,9,589081,16529,91101,16855,0.15310867390418317,0.5048825784807093
4197,0.4243,16,15,16,589096,16514,91117,16839,0.15296972840786988,0.5048721254459869
4198,0.4244,15,11,15,589107,16503,91132,16824,0.15286783504390677,0.5048159150238545
4199,0.4245,8,13,8,589120,16490,91140,16816,0.15274741561376856,0.5048940130907345
4200,0.4246,11,16,11,589136,16474,91151,16805,0.1525992070843677,0.5049731061630458
4201,0.4247,11,13,11,589149,16461,91162,16794,0.1524787876542295,0.5050067658998647
4202,0.4248,6,14,6,589163,16447,91168,16788,0.15234910519100375,0.5051301338949902
4203,0.4249,9,20,9,589183,16427,91177,16779,0.15216384452925266,0.5053002469433235
4204,0.425,10,13,10,589196,16414,91187,16769,0.15204342509911445,0.5053491245517283
4205,0.4251,8,17,8,589213,16397,91195,16761,0.15188595353662604,0.5054888714639001
4206,0.4252,7,10,7,589223,16387,91202,16754,0.15179332320575048,0.5055369481910624
4207,0.4253,16,9,16,589232,16378,91218,16738,0.1517099559079625,0.5054354390626887
4208,0.4254,13,16,13,589248,16362,91231,16725,0.15156174737856162,0.5054855381267568
4209,0.4255,16,16,16,589264,16346,91247,16709,0.15141353884916076,0.5054908485856905
4210,0.4256,11,12,11,589276,16334,91258,16698,0.1513023824521101,0.5055098086703802
4211,0.4257,17,20,17,589296,16314,91275,16681,0.15111712179035902,0.5055614487043492
4212,0.4258,12,15,12,589311,16299,91287,16669,0.15097817629404572,0.5056115020626062
4213,0.4259,13,19,13,589330,16280,91300,16656,0.1508021786653822,0.5057080398348311
4214,0.426,13,18,13,589348,16262,91313,16643,0.15063544406980622,0.5057893937091628
4215,0.4261,12,12,12,589360,16250,91325,16631,0.15052428767275558,0.5057936194154679
4216,0.4262,9,9,9,589369,16241,91334,16622,0.1504409203749676,0.505796792745641
4217,0.4263,11,16,11,589385,16225,91345,16611,0.15029271184556672,0.5058776952125715
4218,0.4264,7,12,7,589397,16213,91352,16604,0.15018155544851605,0.5059572782399366
4219,0.4265,12,20,12,589417,16193,91364,16592,0.149996294786765,0.5060850998932439
4220,0.4266,7,7,7,589424,16186,91371,16585,0.1499314535551521,0.5060876994904031
4221,0.4267,9,14,9,589438,16172,91380,16576,0.14980177109192633,0.5061683156223281
4222,0.4268,9,9,9,589447,16163,91389,16567,0.14971840379413837,0.5061717079132294
4223,0.4269,11,14,11,589461,16149,91400,16556,0.14958872133091258,0.5062222901696988
4224,0.427,12,7,12,589468,16142,91412,16544,0.1495238800992997,0.5061494217707887
4225,0.4271,9,13,9,589481,16129,91421,16535,0.14940346066916152,0.5062147930443301
4226,0.4272,13,14,13,589495,16115,91434,16522,0.14927377820593576,0.5062352544657903
4227,0.4273,5,13,5,589508,16102,91439,16517,0.14915335877579755,0.5063613231552163
4228,0.4274,10,11,10,589519,16091,91449,16507,0.14905146541183445,0.506380759555801
4229,0.4275,9,17,9,589536,16074,91458,16498,0.14889399384934604,0.5065086577428466
4230,0.4276,14,12,14,589548,16062,91472,16484,0.14878283745229537,0.5064831315676274
4231,0.4277,7,11,7,589559,16051,91479,16477,0.1486809440883323,0.5065482046237088
4232,0.4278,12,15,12,589574,16036,91491,16465,0.14854199859201897,0.5065997969293252
4233,0.4279,10,12,10,589586,16024,91501,16455,0.14843084219496833,0.5066350564980449
4234,0.428,8,13,8,589599,16011,91509,16447,0.1483104227648301,0.5067163719267977
4235,0.4281,5,9,5,589608,16002,91514,16442,0.14822705546704212,0.5067809148070521
4236,0.4282,9,15,9,589623,15987,91523,16433,0.14808810997072883,0.5068784700801974
4237,0.4283,9,16,9,589639,15971,91532,16424,0.14793990144132796,0.5069918197252662
4238,0.4284,10,12,10,589651,15959,91542,16414,0.1478287450442773,0.5070274611559015
4239,0.4285,7,13,7,589664,15946,91549,16407,0.1477083256141391,0.50712453250085
4240,0.4286,14,15,14,589679,15931,91563,16393,0.14756938011782578,0.5071463927731716
4241,0.4287,5,11,5,589690,15920,91568,16388,0.14746748675386268,0.5072427881639222
4242,0.4288,13,10,13,589700,15910,91581,16375,0.14737485642298714,0.5072014867585566
4243,0.4289,12,19,12,589719,15891,91593,16363,0.14719885879432362,0.5073169219321635
4244,0.429,17,10,17,589729,15881,91610,16346,0.14710622846344806,0.507214447512955
4245,0.4291,10,16,10,589745,15865,91620,16336,0.1469580199340472,0.507313437470886
4246,0.4292,7,18,7,589763,15847,91627,16329,0.14679128533847122,0.5074900546991546
4247,0.4293,7,14,7,589777,15833,91634,16322,0.14666160287524546,0.5076037941222205
4248,0.4294,7,21,7,589798,15812,91641,16315,0.14646707918040683,0.5078283064089395
4249,0.4295,7,10,7,589808,15802,91648,16308,0.1463744488495313,0.5078791653690439
4250,0.4296,9,8,9,589816,15794,91657,16299,0.14630034458483085,0.5078677593244633
4251,0.4297,4,21,4,589837,15773,91661,16295,0.14610582088999222,0.5081389547212174
4252,0.4298,7,11,7,589848,15762,91668,16288,0.14600392752602911,0.5082059282371295
4253,0.4299,14,15,14,589863,15747,91682,16274,0.14586498202971582,0.5082289747353299
4254,0.43,14,18,14,589881,15729,91696,16260,0.14569824743413984,0.5082997280315108
4255,0.4301,13,17,13,589898,15712,91709,16247,0.1455407758716514,0.5083700991895866
4256,0.4302,6,12,6,589910,15700,91715,16241,0.14542961947460076,0.50846873923797
4257,0.4303,8,16,8,589926,15684,91723,16233,0.1452814109451999,0.5086004323714635
4258,0.4304,10,15,10,589941,15669,91733,16223,0.1451424654488866,0.5086855637777499
4259,0.4305,9,23,9,589964,15646,91742,16214,0.14492941568787285,0.5089139987445073
4260,0.4306,14,8,14,589972,15638,91756,16200,0.1448553114231724,0.5088259312770903
4261,0.4307,12,11,12,589983,15627,91768,16188,0.1447534180592093,0.5088165959453088
4262,0.4308,16,12,16,589995,15615,91784,16172,0.14464226166215866,0.5087614433573473
4263,0.4309,14,11,14,590006,15604,91798,16158,0.14454036829819555,0.5087211132800201
4264,0.431,8,19,8,590025,15585,91806,16150,0.14436437066953203,0.5089018433905782
4265,0.4311,4,17,4,590042,15568,91810,16146,0.14420689910704362,0.5091126947089614
4266,0.4312,15,11,15,590053,15557,91825,16131,0.14410500574308052,0.5090570562989144
4267,0.4313,10,12,10,590065,15545,91835,16121,0.14399384934602985,0.5090949283142803
4268,0.4314,9,8,9,590073,15537,91844,16112,0.14391974508132943,0.5090840152927423
4269,0.4315,10,16,10,590089,15521,91854,16102,0.14377153655192856,0.5091863517060368
4270,0.4316,15,11,15,590100,15510,91869,16087,0.14366964318796546,0.5091306136658543
4271,0.4317,9,10,9,590110,15500,91878,16078,0.14357701285708993,0.5091519412249034
4272,0.4318,11,18,11,590128,15482,91889,16067,0.14341027826151395,0.5092712922755079
4273,0.4319,11,7,11,590135,15475,91900,16056,0.14334543702990107,0.5092131553074751
4274,0.432,8,13,8,590148,15462,91908,16048,0.14322501759976286,0.5092986353538559
4275,0.4321,11,10,11,590158,15452,91919,16037,0.14313238726888733,0.5092889580488424
4276,0.4322,10,17,10,590175,15435,91929,16027,0.1429749157063989,0.5094081749411989
4277,0.4323,12,14,12,590189,15421,91941,16015,0.14284523324317314,0.509447766891462
4278,0.4324,8,8,8,590197,15413,91949,16007,0.14277112897847272,0.5094525779758116
4279,0.4325,10,8,10,590205,15405,91959,15997,0.14269702471377227,0.5094261512005605
4280,0.4326,8,22,8,590227,15383,91967,15989,0.1424932379858461,0.5096582940201454
4281,0.4327,14,15,14,590242,15368,91981,15975,0.14235429248953277,0.5096831828478449
4282,0.4328,11,12,11,590254,15356,91992,15964,0.14224313609248213,0.5097062579821201
4283,0.4329,4,12,4,590266,15344,91996,15960,0.14213197969543148,0.5098389982110912
4284,0.433,7,13,7,590279,15331,92003,15953,0.14201156026529327,0.5099411839918169
4285,0.4331,13,10,13,590289,15321,92016,15940,0.14191892993441774,0.5099005150187134
4286,0.4332,9,6,9,590295,15315,92025,15931,0.1418633517358924,0.5098572617295014
4287,0.4333,10,12,10,590307,15303,92035,15921,0.14175219533884176,0.5098962336664105
4288,0.4334,6,10,6,590317,15293,92041,15915,0.1416595650079662,0.5099653934888491
4289,0.4335,14,19,14,590336,15274,92055,15901,0.14148356737930268,0.510056134723336
4290,0.4336,8,7,8,590343,15267,92063,15893,0.1414187261476898,0.5100449293966623
4291,0.4337,9,10,9,590353,15257,92072,15884,0.14132609581681427,0.5100671140939598
4292,0.4338,10,18,10,590371,15239,92082,15874,0.1411593612212383,0.5102047375695047
4293,0.4339,10,10,10,590381,15229,92092,15864,0.14106673089036273,0.5102113015791335
4294,0.434,8,16,8,590397,15213,92100,15856,0.14091852236096186,0.5103479352409154
4295,0.4341,9,11,9,590408,15202,92109,15847,0.1408166289969988,0.5103868079487263
4296,0.4342,10,12,10,590420,15190,92119,15837,0.14070547259994812,0.5104264028104554
4297,0.4343,12,18,12,590438,15172,92131,15825,0.14053873800437214,0.5105332774139433
4298,0.4344,9,8,9,590446,15164,92140,15816,0.14046463373967172,0.5105229180116204
4299,0.4345,12,14,12,590460,15150,92152,15804,0.14033495127644596,0.5105640628028688
4300,0.4346,8,18,8,590478,15132,92160,15796,0.14016821668086998,0.5107346094154165
4301,0.4347,5,14,5,590492,15118,92165,15791,0.14003853421764423,0.5108867967258727
4302,0.4348,16,18,16,590510,15100,92181,15775,0.13987179962206825,0.5109311740890689
4303,0.4349,9,12,9,590522,15088,92190,15766,0.1397606432250176,0.5109872301808518
4304,0.435,5,15,5,590537,15073,92195,15761,0.13962169772870428,0.5111565155347992
4305,0.4351,10,20,10,590557,15053,92205,15751,0.1394364370669532,0.5113296974418907
4306,0.4352,12,17,12,590574,15036,92217,15739,0.13927896550446478,0.5114216084484159
4307,0.4353,9,11,9,590585,15025,92226,15730,0.13917707214050168,0.5114615509673224
4308,0.4354,14,8,14,590593,15017,92240,15716,0.13910296787580126,0.5113721406956692
4309,0.4355,11,11,11,590604,15006,92251,15705,0.13900107451183816,0.5113802871935137
4310,0.4356,12,14,12,590618,14992,92263,15693,0.1388713920486124,0.5114225191461627
4311,0.4357,6,14,6,590632,14978,92269,15687,0.13874170958538665,0.5115604108918963
4312,0.4358,11,11,11,590643,14967,92280,15676,0.13863981622142355,0.5115687106353817
4313,0.4359,10,8,10,590651,14959,92290,15666,0.1385657119567231,0.5115428571428572
4314,0.436,11,11,11,590662,14948,92301,15655,0.13846381859276002,0.5115511551155115
4315,0.4361,11,18,11,590680,14930,92312,15644,0.13829708399718404,0.5116765879505463
4316,0.4362,8,16,8,590696,14914,92320,15636,0.13814887546778318,0.5118166939443535
4317,0.4363,8,17,8,590713,14897,92328,15628,0.13799140390529474,0.511973791973792
4318,0.4364,11,7,11,590720,14890,92339,15617,0.13792656267368186,0.5119152981282984
4319,0.4365,10,12,10,590732,14878,92349,15607,0.13781540627663122,0.5119567000164015
4320,0.4366,13,13,13,590745,14865,92362,15594,0.137694986846493,0.5119669063331035
4321,0.4367,6,9,6,590754,14856,92368,15588,0.13761161954870502,0.5120220733149389
4322,0.4368,8,18,8,590772,14838,92376,15580,0.13744488495312907,0.5121967256229863
4323,0.4369,8,20,8,590792,14818,92384,15572,0.13725962429137797,0.5124053965120106
4324,0.437,6,17,6,590809,14801,92390,15566,0.13710215272888954,0.5125959100339184
4325,0.4371,6,12,6,590821,14789,92396,15560,0.1369909963318389,0.5127022307160038
4326,0.4372,12,11,12,590832,14778,92408,15548,0.1368891029678758,0.5126953769043066
4327,0.4373,11,18,11,590850,14760,92419,15537,0.1367223683722998,0.5128230517873057
4328,0.4374,11,8,11,590858,14752,92430,15526,0.1366482641075994,0.51278155756655
4329,0.4375,8,13,8,590871,14739,92438,15518,0.13652784467746118,0.5128730541692832
4330,0.4376,9,13,9,590884,14726,92447,15509,0.136407425247323,0.5129485695386142
4331,0.4377,11,18,11,590902,14708,92458,15498,0.13624069065174702,0.5130768721446071
4332,0.4378,7,15,7,590917,14693,92465,15491,0.1361017451554337,0.5132189239332097
4333,0.4379,8,13,8,590930,14680,92473,15483,0.1359813257252955,0.5133110101780327
4334,0.438,17,10,17,590940,14670,92490,15466,0.13588869539441994,0.5132067958587736
4335,0.4381,5,15,5,590955,14655,92495,15461,0.13574974989810665,0.5133815911807676
4336,0.4382,12,12,12,590967,14643,92507,15449,0.13563859350105598,0.5133922637245779
4337,0.4383,5,13,5,590980,14630,92512,15444,0.1355181740709178,0.5135332845647403
4338,0.4384,12,11,12,590991,14619,92524,15432,0.1354162807069547,0.5135270040930419
4339,0.4385,17,11,17,591002,14608,92541,15415,0.1353143873429916,0.5134396962328881
4340,0.4386,14,11,14,591013,14597,92555,15401,0.1352124939790285,0.5134008933928929
4341,0.4387,3,8,3,591021,14589,92558,15398,0.13513838971432807,0.5134891786440791
4342,0.4388,10,15,10,591036,14574,92568,15388,0.13499944421801474,0.5135838729056805
4343,0.4389,9,10,9,591046,14564,92577,15379,0.1349068138871392,0.5136091907958454
4344,0.439,6,17,6,591063,14547,92583,15373,0.13474934232465077,0.5138034759358289
4345,0.4391,15,11,15,591074,14536,92598,15358,0.1346474489606877,0.5137485783100287
4346,0.4392,17,14,17,591088,14522,92615,15341,0.13451776649746192,0.5137126209690922
4347,0.4393,7,17,7,591105,14505,92622,15334,0.1343602949349735,0.5138912161935721
4348,0.4394,13,16,13,591121,14489,92635,15321,0.13421208640557264,0.5139550486413955
4349,0.4395,10,13,10,591134,14476,92645,15311,0.13409166697543443,0.5140161815557123
4350,0.4396,10,20,10,591154,14456,92655,15301,0.13390640631368336,0.5141983398864133
4351,0.4397,12,15,12,591169,14441,92667,15289,0.13376746081737004,0.5142616885301042
4352,0.4398,8,13,8,591182,14428,92675,15281,0.13364704138723182,0.5143559190817597
4353,0.4399,10,13,10,591195,14415,92685,15271,0.13352662195709364,0.5144175705719868
4354,0.44,7,9,7,591204,14406,92692,15264,0.13344325465930565,0.514459049544995
4355,0.4401,12,15,12,591219,14391,92704,15252,0.13330430916299232,0.5145228215767634
4356,0.4402,7,8,7,591227,14383,92711,15245,0.1332302048982919,0.5145470500877548
4357,0.4403,9,9,9,591236,14374,92720,15236,0.13314683760050391,0.5145558932792975
4358,0.4404,14,12,14,591248,14362,92734,15222,0.13303568120345327,0.5145348837209303
4359,0.4405,10,10,10,591258,14352,92744,15212,0.1329430508725777,0.514544716547152
4360,0.4406,12,16,12,591274,14336,92756,15200,0.13279484234317684,0.514626218851571
4361,0.4407,4,16,4,591290,14320,92760,15196,0.13264663381377598,0.514839409134029
4362,0.4408,8,12,8,591302,14308,92768,15188,0.13253547741672533,0.5149172769189042
4363,0.4409,9,17,9,591319,14291,92777,15179,0.13237800585423692,0.5150661689854089
4364,0.441,9,16,9,591335,14275,92786,15170,0.13222979732483606,0.5151978264561046
4365,0.4411,10,12,10,591347,14263,92796,15160,0.13211864092778539,0.5152431771063454
4366,0.4412,9,12,9,591359,14251,92805,15151,0.13200748453073474,0.5153050812869873
4367,0.4413,12,14,12,591373,14237,92817,15139,0.131877802067509,0.5153526688453159
4368,0.4414,11,13,11,591386,14224,92828,15128,0.13175738263737077,0.5153992913600436
4369,0.4415,14,17,14,591403,14207,92842,15114,0.13159991107488236,0.5154667303297977
4370,0.4416,6,13,6,591416,14194,92848,15108,0.13147949164474415,0.5155962050371988
4371,0.4417,6,17,6,591433,14177,92854,15102,0.13132202008225574,0.5157963045185969
4372,0.4418,7,15,7,591448,14162,92861,15095,0.13118307458594242,0.5159449020747172
4373,0.4419,13,7,13,591455,14155,92874,15082,0.13111823335432954,0.5158531997126928
4374,0.442,9,18,9,591473,14137,92883,15073,0.13095149875875356,0.5160219103046901
4375,0.4421,14,9,14,591482,14128,92897,15059,0.13086813146096557,0.5159488813512866
4376,0.4422,8,12,8,591494,14116,92905,15051,0.13075697506391493,0.5160283882469915
4377,0.4423,5,8,5,591502,14108,92910,15046,0.1306828707992145,0.516086986348357
4378,0.4424,12,11,12,591513,14097,92922,15034,0.1305809774352514,0.5160825237719268
4379,0.4425,6,12,6,591525,14085,92928,15028,0.13046982103820076,0.5161955140315323
4380,0.4426,14,7,14,591532,14078,92942,15014,0.13040497980658786,0.5160868967413722
4381,0.4427,18,7,18,591539,14071,92960,14996,0.13034013857497498,0.5159115147762067
4382,0.4428,5,13,5,591552,14058,92965,14991,0.1302197191448368,0.5160590726014664
4383,0.4429,10,12,10,591564,14046,92975,14981,0.13010856274778612,0.5161056946980398
4384,0.443,7,13,7,591577,14033,92982,14974,0.12998814331764794,0.5162202227048643
4385,0.4431,8,12,8,591589,14021,92990,14966,0.1298769869205973,0.5163004105288578
4386,0.4432,13,13,13,591602,14008,93003,14953,0.12975656749045908,0.5163150443700149
4387,0.4433,12,6,12,591608,14002,93015,14941,0.12970098929193374,0.5162215388867775
4388,0.4434,9,10,9,591618,13992,93024,14932,0.1296083589610582,0.5162494813995298
4389,0.4435,9,12,9,591630,13980,93033,14923,0.12949720256400757,0.5163131854824758
4390,0.4436,13,10,13,591640,13970,93046,14910,0.129404572233132,0.5162742382271468
4391,0.4437,10,8,10,591648,13962,93056,14900,0.1293304679684316,0.5162497401427483
4392,0.4438,9,17,9,591665,13945,93065,14891,0.12917299640594315,0.5164031072270773
4393,0.4439,13,17,13,591682,13928,93078,14878,0.12901552484345474,0.5164896202180101
4394,0.444,9,11,9,591693,13917,93087,14869,0.12891363147949164,0.5165358160216772
4395,0.4441,16,15,16,591708,13902,93103,14853,0.12877468598317834,0.5165362545644235
4396,0.4442,6,19,6,591727,13883,93109,14847,0.1285986883545148,0.5167768882701009
4397,0.4443,7,9,7,591736,13874,93116,14840,0.1285153210567268,0.5168210628961483
4398,0.4444,11,13,11,591749,13861,93127,14829,0.12839490162658862,0.5168699895433949
4399,0.4445,9,20,9,591769,13841,93136,14820,0.12820964096483753,0.5170789574683368
4400,0.4446,9,10,9,591779,13831,93145,14811,0.128117010633962,0.5171077438726346
4401,0.4447,10,12,10,591791,13819,93155,14801,0.12800585423691133,0.5171558350803633
4402,0.4448,14,16,14,591807,13803,93169,14787,0.12785764570751046,0.5172088142707241
4403,0.4449,10,11,10,591818,13792,93179,14777,0.12775575234354736,0.5172389653120515
4404,0.445,15,15,15,591833,13777,93194,14762,0.12761680684723406,0.5172570867935107
4405,0.4451,9,14,9,591847,13763,93203,14753,0.1274871243840083,0.5173586758311124
4406,0.4452,11,7,11,591854,13756,93214,14742,0.12742228315239543,0.5172994596112008
4407,0.4453,12,7,12,591861,13749,93226,14730,0.12735744192078255,0.5172232171073422
4408,0.4454,9,10,9,591871,13739,93235,14721,0.127264811589907,0.5172522839072382
4409,0.4455,11,14,11,591885,13725,93246,14710,0.12713512912668123,0.5173202039739757
4410,0.4456,7,7,7,591892,13718,93253,14703,0.12707028789506836,0.5173287357939552
4411,0.4457,16,7,16,591899,13711,93269,14687,0.12700544666345548,0.5171843087541376
4412,0.4458,8,16,8,591915,13695,93277,14679,0.1268572381340546,0.5173398181433707
4413,0.4459,11,10,11,591925,13685,93288,14668,0.12676460780317908,0.5173350262758791
4414,0.446,5,9,5,591934,13676,93293,14663,0.1266812405053911,0.5174141642259783
4415,0.4461,6,10,6,591944,13666,93299,14657,0.12658861017451553,0.5174946156833669
4416,0.4462,11,12,11,591956,13654,93310,14646,0.1264774537774649,0.5175265017667845
4417,0.4463,12,14,12,591970,13640,93322,14634,0.12634777131423913,0.517577986843036
4418,0.4464,11,14,11,591984,13626,93333,14623,0.12621808885101338,0.5176466423590216
4419,0.4465,9,15,9,591999,13611,93342,14614,0.12607914335470005,0.5177679362267493
4420,0.4466,17,17,17,592016,13594,93359,14597,0.12592167179221164,0.5177893654003051
4421,0.4467,12,16,12,592032,13578,93371,14585,0.12577346326281078,0.5178780669672975
4422,0.4468,11,9,11,592041,13569,93382,14574,0.12569009596502279,0.5178552393135061
4423,0.4469,9,11,9,592052,13558,93391,14565,0.12558820260105968,0.5179034953596701
4424,0.447,13,8,13,592060,13550,93404,14552,0.12551409833635926,0.5178279126040851
4425,0.4471,8,18,8,592078,13532,93412,14544,0.12534736374078329,0.5180225103291067
4426,0.4472,11,13,11,592091,13519,93423,14533,0.12522694431064507,0.5180735776415228
4427,0.4473,9,9,9,592100,13510,93432,14524,0.12514357701285708,0.5180851822786616
4428,0.4474,9,11,9,592111,13499,93441,14515,0.12504168364889398,0.5181337902477333
4429,0.4475,8,15,8,592126,13484,93449,14507,0.12490273815258068,0.5182737308420564
4430,0.4476,7,10,7,592136,13474,93456,14500,0.12481010782170514,0.5183384571387717
4431,0.4477,12,10,12,592146,13464,93468,14488,0.12471747749082959,0.5183171150543789
4432,0.4478,10,18,10,592164,13446,93478,14478,0.12455074289525363,0.5184787279759346
4433,0.4479,5,9,5,592173,13437,93483,14473,0.12446737559746564,0.5185596560372626
4434,0.448,12,13,12,592186,13424,93495,14461,0.12434695616732742,0.518594226286534
4435,0.4481,8,9,8,592195,13415,93503,14453,0.12426358886953945,0.518623510836802
4436,0.4482,8,14,8,592209,13401,93511,14445,0.12413390640631368,0.5187459599224306
4437,0.4483,5,7,5,592216,13394,93516,14440,0.1240690651747008,0.5187899691025365
4438,0.4484,3,12,3,592228,13382,93519,14437,0.12395790877765016,0.5189618605988713
4439,0.4485,10,14,10,592242,13368,93529,14427,0.12382822631442439,0.5190501888828926
4440,0.4486,13,7,13,592249,13361,93542,14414,0.12376338508281151,0.5189558955895589
4441,0.4487,11,15,11,592264,13346,93553,14403,0.1236244395864982,0.5190457313777073
4442,0.4488,7,10,7,592274,13336,93560,14396,0.12353180925562265,0.5191114957449877
4443,0.4489,18,5,18,592279,13331,93578,14378,0.12348549409018489,0.5188927785196146
4444,0.449,8,10,8,592289,13321,93586,14370,0.12339286375930934,0.5189411722220216
4445,0.4491,16,16,16,592305,13305,93602,14354,0.12324465522990848,0.5189630861564047
4446,0.4492,12,16,12,592321,13289,93614,14342,0.12309644670050761,0.5190546849553038
4447,0.4493,12,11,12,592332,13278,93626,14330,0.12299455333654452,0.5190524485656332
4448,0.4494,11,15,11,592347,13263,93637,14319,0.12285560784023121,0.5191429192951925
4449,0.4495,8,11,8,592358,13252,93645,14311,0.12275371447626811,0.519210535863295
4450,0.4496,10,15,10,592373,13237,93655,14301,0.1226147689799548,0.5193187595322827
4451,0.4497,8,15,8,592388,13222,93663,14293,0.12247582348364149,0.5194621115755043
4452,0.4498,9,8,9,592396,13214,93672,14284,0.12240171921894105,0.5194559604334861
4453,0.4499,11,7,11,592403,13207,93683,14273,0.12233687798732817,0.519395924308588
4454,0.45,7,10,7,592413,13197,93690,14266,0.12224424765645263,0.5194625496122055
4455,0.4501,9,13,9,592426,13184,93699,14257,0.12212382822631443,0.519551036769797
4456,0.4502,12,8,12,592434,13176,93711,14245,0.122049723961614,0.5194923598701725
4457,0.4503,6,11,6,592445,13165,93717,14239,0.1219478305976509,0.5195956794628521
4458,0.4504,9,14,9,592459,13151,93726,14230,0.12181814813442514,0.5197034439940105
4459,0.4505,10,16,10,592475,13135,93736,14220,0.12166993960502427,0.5198318406141473
4460,0.4506,4,18,4,592493,13117,93740,14216,0.12150320500944829,0.5201039037061428
4461,0.4507,10,12,10,592505,13105,93750,14206,0.12139204861239765,0.5201567134121783
4462,0.4508,5,15,5,592520,13090,93755,14201,0.12125310311608434,0.5203546956872229
4463,0.4509,9,5,9,592525,13085,93764,14192,0.12120678795064656,0.5202918209480515
4464,0.451,6,14,6,592539,13071,93770,14186,0.1210771054874208,0.5204534614961295
4465,0.4511,11,11,11,592550,13060,93781,14175,0.1209752121234577,0.5204699834771433
4466,0.4512,15,10,15,592560,13050,93796,14160,0.12088258179258217,0.5203969128996693
4467,0.4513,4,11,4,592571,13039,93800,14156,0.12078068842861907,0.5205368633940063
4468,0.4514,19,12,19,592583,13027,93819,14137,0.12066953203156841,0.5204314533941982
4469,0.4515,14,5,14,592588,13022,93833,14123,0.12062321686613064,0.5202799778964818
4470,0.4516,7,14,7,592602,13008,93840,14116,0.12049353440290489,0.5204247161185666
4471,0.4517,14,8,14,592610,13000,93854,14102,0.12041943013820446,0.5203306029075345
4472,0.4518,11,19,11,592629,12981,93865,14091,0.12024343250954092,0.5205008865248227
4473,0.4519,7,8,7,592637,12973,93872,14084,0.12016932824484049,0.5205307314188565
4474,0.452,4,11,4,592648,12962,93876,14080,0.1200674348808774,0.5206715479624288
4475,0.4521,6,16,6,592664,12946,93882,14074,0.11991922635147653,0.5208734270910437
4476,0.4522,5,11,5,592675,12935,93887,14069,0.11981733298751343,0.520996889349726
4477,0.4523,9,5,9,592680,12930,93896,14060,0.11977101782207566,0.5209336791404223
4478,0.4524,8,14,8,592694,12916,93904,14052,0.1196413353588499,0.5210619994067043
4479,0.4525,9,14,9,592708,12902,93913,14043,0.11951165289562414,0.52117275932455
4480,0.4526,7,7,7,592715,12895,93920,14036,0.11944681166401126,0.5211837659203149
4481,0.4527,11,12,11,592727,12883,93931,14025,0.11933565526696062,0.521220454883306
4482,0.4528,6,9,6,592736,12874,93937,14019,0.11925228796917263,0.5212880675268657
4483,0.4529,6,9,6,592745,12865,93943,14013,0.11916892067138464,0.5213557556365801
4484,0.453,9,17,9,592762,12848,93952,14004,0.11901144910889622,0.5215253984805601
4485,0.4531,4,7,4,592769,12841,93956,14000,0.11894660787728334,0.5215901046905853
4486,0.4532,4,9,4,592778,12832,93960,13996,0.11886324057949535,0.5216937527955867
4487,0.4533,16,9,16,592787,12823,93976,13980,0.11877987328170736,0.5215834048427415
4488,0.4534,12,10,12,592797,12813,93988,13968,0.11868724295083181,0.5215637952279601
4489,0.4535,12,13,12,592810,12800,94000,13956,0.11856682352069361,0.5216026311855285
4490,0.4536,7,8,7,592818,12792,94007,13949,0.11849271925599318,0.5216334467671366
4491,0.4537,10,12,10,592830,12780,94017,13939,0.11838156285894254,0.5216886859538157
4492,0.4538,11,16,11,592846,12764,94028,13928,0.11823335432954167,0.521804285928368
4493,0.4539,10,12,10,592858,12752,94038,13918,0.11812219793249101,0.5218597675290588
4494,0.454,13,14,13,592872,12738,94051,13905,0.11799251546926526,0.5219006868595879
4495,0.4541,11,5,11,592877,12733,94062,13894,0.11794620030382749,0.5218011792541405
4496,0.4542,8,11,8,592888,12722,94070,13886,0.11784430693986439,0.521873120865905
4497,0.4543,13,9,13,592897,12713,94083,13873,0.1177609396420764,0.5218159933799744
4498,0.4544,10,14,10,592911,12699,94093,13863,0.11763125717885065,0.5219110006776598
4499,0.4545,15,12,15,592923,12687,94108,13848,0.11752010078179999,0.5218767665347654
4500,0.4546,10,10,10,592933,12677,94118,13838,0.11742747045092446,0.5218932679615312
4501,0.4547,10,11,10,592944,12666,94128,13828,0.11732557708696136,0.5219294934702197
4502,0.4548,7,12,7,592956,12654,94135,13821,0.1172144206899107,0.5220396600566573
4503,0.4549,8,15,8,592971,12639,94143,13813,0.11707547519359739,0.5221911386662634
4504,0.455,6,16,6,592987,12623,94149,13807,0.11692726666419652,0.5223987892546349
4505,0.4551,8,7,8,592994,12616,94157,13799,0.11686242543258364,0.5223925799734999
4506,0.4552,6,9,6,593003,12607,94163,13793,0.11677905813479565,0.5224621212121212
4507,0.4553,14,9,14,593012,12598,94177,13779,0.11669569083700768,0.5223869280054593
4508,0.4554,11,11,11,593023,12587,94188,13768,0.11659379747304457,0.5224056156327073
4509,0.4555,6,13,6,593036,12574,94194,13762,0.11647337804290638,0.5225546780072904
4510,0.4556,7,13,7,593049,12561,94201,13755,0.11635295861276816,0.5226858185134519
4511,0.4557,4,10,4,593059,12551,94205,13751,0.11626032828189262,0.522811953463615
4512,0.4558,5,16,5,593075,12535,94210,13746,0.11611211975249175,0.5230394581636924
4513,0.4559,7,7,7,593082,12528,94217,13739,0.11604727852087887,0.5230517379221076
4514,0.456,11,8,11,593090,12520,94228,13728,0.11597317425617844,0.52301127704968
4515,0.4561,5,16,5,593106,12504,94233,13723,0.11582496572677757,0.5232394097685591
4516,0.4562,3,11,3,593117,12493,94236,13720,0.11572307236281448,0.5234044176553618
4517,0.4563,12,9,12,593126,12484,94248,13708,0.1156397050650265,0.523365913255956
4518,0.4564,6,11,6,593137,12473,94254,13702,0.11553781170106339,0.523476599808978
4519,0.4565,8,16,8,593153,12457,94262,13694,0.11538960317166252,0.5236511032082903
4520,0.4566,17,12,17,593165,12445,94279,13677,0.11527844677461188,0.5235816553097007
4521,0.4567,10,7,10,593172,12438,94289,13667,0.115213605542999,0.5235395518099981
4522,0.4568,7,13,7,593185,12425,94296,13660,0.11509318611286079,0.5236726087789918
4523,0.4569,8,9,8,593194,12416,94304,13652,0.1150098188150728,0.523707227251803
4524,0.457,14,10,14,593204,12406,94318,13638,0.11491718848419727,0.5236522807556443
4525,0.4571,7,9,7,593213,12397,94325,13631,0.11483382118640928,0.5237052405102197
4526,0.4572,9,9,9,593222,12388,94334,13622,0.11475045388862129,0.5237216455209535
4527,0.4573,8,11,8,593233,12377,94342,13614,0.11464856052465819,0.5237966988572967
4528,0.4574,4,9,4,593242,12368,94346,13610,0.11456519322687021,0.5239048425590884
4529,0.4575,13,5,13,593247,12363,94359,13597,0.11451887806143243,0.5237673343605547
4530,0.4576,6,10,6,593257,12353,94365,13591,0.11442624773055689,0.523859081097749
4531,0.4577,10,13,10,593270,12340,94375,13581,0.11430582830041869,0.523938119671309
4532,0.4578,13,8,13,593278,12332,94388,13568,0.11423172403571825,0.5238610038610039
4533,0.4579,5,8,5,593286,12324,94393,13563,0.11415761977101782,0.5239309305829181
4534,0.458,8,11,8,593297,12313,94401,13555,0.11405572640705472,0.5240064945105922
4535,0.4581,4,5,4,593302,12308,94405,13551,0.11400941124161695,0.5240341853899996
4536,0.4582,8,13,8,593315,12295,94413,13543,0.11388899181147875,0.5241504760430374
4537,0.4583,9,15,9,593330,12280,94422,13534,0.11375004631516544,0.5242891454249632
4538,0.4584,5,8,5,593338,12272,94427,13529,0.11367594205046501,0.5243595209488005
4539,0.4585,7,16,7,593354,12256,94434,13522,0.11352773352106414,0.5245558227946311
4540,0.4586,9,9,9,593363,12247,94443,13513,0.11344436622327615,0.5245729813664596
4541,0.4587,7,10,7,593373,12237,94450,13506,0.1133517358924006,0.5246474769840345
4542,0.4588,6,14,6,593387,12223,94456,13500,0.11322205342917485,0.5248221436068887
4543,0.4589,8,13,8,593400,12210,94464,13492,0.11310163399903664,0.5249396934090732
4544,0.459,11,9,11,593409,12201,94475,13481,0.11301826670124866,0.5249201775562651
4545,0.4591,8,10,8,593419,12191,94483,13473,0.11292563637037312,0.5249766209476309
4546,0.4592,15,7,15,593426,12184,94498,13458,0.11286079513876024,0.524842056001872
4547,0.4593,11,12,11,593438,12172,94509,13447,0.11274963874170958,0.5248838752488387
4548,0.4594,10,11,10,593449,12161,94519,13437,0.1126477453777465,0.5249238221736073
4549,0.4595,5,6,5,593455,12155,94524,13432,0.11259216717922116,0.5249540782428577
4550,0.4596,6,11,6,593466,12144,94530,13426,0.11249027381525807,0.52506843957763
4551,0.4597,13,16,13,593482,12128,94543,13413,0.1123420652858572,0.5251556321209037
4552,0.4598,12,8,12,593490,12120,94555,13401,0.11226796102115677,0.5250969789585047
4553,0.4599,7,10,7,593500,12110,94562,13394,0.11217533069028122,0.52517252195734
4554,0.46,6,17,6,593517,12093,94568,13388,0.1120178591277928,0.5254110906165378
4555,0.4601,3,4,3,593521,12089,94571,13385,0.11198080699544259,0.5254377011855225
4556,0.4602,9,21,9,593542,12068,94580,13376,0.11178628330060394,0.5257035057380915
4557,0.4603,5,10,5,593552,12058,94585,13371,0.11169365296972841,0.5258169806126863
4558,0.4604,13,6,13,593558,12052,94598,13358,0.11163807477120308,0.5256985438803621
4559,0.4605,11,8,11,593566,12044,94609,13347,0.11156397050650264,0.5256586979638455
4560,0.4606,9,11,9,593577,12033,94618,13338,0.11146207714253956,0.5257183398368216
4561,0.4607,12,4,12,593581,12029,94630,13326,0.11142502501018933,0.5255768093078288
4562,0.4608,5,9,5,593590,12020,94635,13321,0.11134165771240134,0.5256698630677558
4563,0.4609,10,7,10,593597,12013,94645,13311,0.11127681648078847,0.5256278628968567
4564,0.461,9,14,9,593611,11999,94654,13302,0.11114713401756271,0.5257499703569029
4565,0.4611,8,8,8,593619,11991,94662,13294,0.11107302975286228,0.5257662645837453
4566,0.4612,0,5,0,593624,11986,94662,13294,0.11102671458742451,0.5258702531645569
4567,0.4613,8,7,8,593631,11979,94670,13286,0.11096187335581163,0.5258658222837919
4568,0.4614,11,6,11,593637,11973,94681,13275,0.1109062951572863,0.5257842205323194
4569,0.4615,12,13,12,593650,11960,94693,13263,0.1107858757271481,0.5258295999682829
4570,0.4616,9,8,9,593658,11952,94702,13254,0.11071177146244766,0.5258271840038086
4571,0.4617,4,11,4,593669,11941,94706,13250,0.11060987809848456,0.52598150132984
4572,0.4618,12,10,12,593679,11931,94718,13238,0.11051724776760903,0.5259644801144264
4573,0.4619,9,7,9,593686,11924,94727,13229,0.11045240653599615,0.525941239613565
4574,0.462,10,10,10,593696,11914,94737,13219,0.11035977620512061,0.5259618827835912
4575,0.4621,12,11,12,593707,11903,94749,13207,0.1102578828411575,0.5259657506969335
4576,0.4622,8,10,8,593717,11893,94757,13199,0.11016525251028196,0.5260242308305436
4577,0.4623,10,9,10,593726,11884,94767,13189,0.11008188521249399,0.526024009891118
4578,0.4624,11,12,11,593738,11872,94778,13178,0.10997072881544333,0.5260678642714571
4579,0.4625,10,6,10,593744,11866,94788,13168,0.109915150616918,0.5260046336981705
4580,0.4626,11,8,11,593752,11858,94799,13157,0.10984104635221757,0.5259644213471917
4581,0.4627,8,5,8,593757,11853,94807,13149,0.10979473118677979,0.5259179265658748
4582,0.4628,8,13,8,593770,11840,94815,13141,0.1096743117566416,0.5260397902405829
4583,0.4629,10,5,10,593775,11835,94825,13131,0.10962799659120383,0.5259552992069214
4584,0.463,4,9,4,593784,11826,94829,13127,0.10954462929341584,0.5260690097383081
4585,0.4631,6,14,6,593798,11812,94835,13121,0.10941494683019008,0.5262503509405206
4586,0.4632,6,3,6,593801,11809,94841,13115,0.10938715773092741,0.526199646926657
4587,0.4633,14,13,14,593814,11796,94855,13101,0.10926673830078922,0.5262079768646825
4588,0.4634,9,16,9,593830,11780,94864,13092,0.10911852977138835,0.526375040205854
4589,0.4635,4,8,4,593838,11772,94868,13088,0.10904442550668791,0.5264682220434432
4590,0.4636,12,10,12,593848,11762,94880,13076,0.10895179517581237,0.5264514051050809
4591,0.4637,12,11,12,593859,11751,94892,13064,0.10884990181184927,0.5264557727181141
4592,0.4638,8,16,8,593875,11735,94900,13056,0.1087016932824484,0.5266427332499698
4593,0.4639,9,10,9,593885,11725,94909,13047,0.10860906295157287,0.5266833521718068
4594,0.464,8,11,8,593896,11714,94917,13039,0.10850716958760977,0.526764432594029
4595,0.4641,6,10,6,593906,11704,94923,13033,0.10841453925673422,0.5268625944940777
4596,0.4642,11,7,11,593913,11697,94934,13022,0.10834969802512134,0.5268012460050973
4597,0.4643,10,10,10,593923,11687,94944,13012,0.1082570676942458,0.5268229482975019
4598,0.4644,15,19,15,593942,11668,94959,12997,0.10808107006558228,0.5269410095276708
4599,0.4645,7,12,7,593954,11656,94966,12990,0.10796991366853162,0.5270632151261868
4600,0.4646,8,12,8,593966,11644,94974,12982,0.10785875727148098,0.5271664094859092
4601,0.4647,10,4,10,593970,11640,94984,12972,0.10782170513913075,0.5270599707459775
4602,0.4648,8,10,8,593980,11630,94992,12964,0.10772907480825522,0.5271204358786696
4603,0.4649,6,12,6,593992,11618,94998,12958,0.10761791841120456,0.5272623697916666
4604,0.465,3,11,3,594003,11607,95001,12955,0.10751602504724146,0.5274407621529191
4605,0.4651,5,9,5,594012,11598,95006,12950,0.10743265774945349,0.5275378849600783
4606,0.4652,12,9,12,594021,11589,95018,12938,0.1073492904516655,0.5275003057854609
4607,0.4653,7,6,7,594027,11583,95025,12931,0.10729371225314017,0.5274944929428081
4608,0.4654,6,16,6,594043,11567,95031,12925,0.10714550372373931,0.5277233382328924
4609,0.4655,9,13,9,594056,11554,95040,12916,0.1070250842936011,0.5278299959133633
4610,0.4656,6,15,6,594071,11539,95046,12910,0.10688613879728778,0.5280379565626406
4611,0.4657,3,15,3,594086,11524,95049,12907,0.10674719330097447,0.528304203675658
4612,0.4658,16,10,16,594096,11514,95065,12891,0.10665456297009893,0.5282114320835894
4613,0.4659,14,7,14,594103,11507,95079,12877,0.10658972173848605,0.5280921916010499
4614,0.466,9,9,9,594112,11498,95088,12868,0.10650635444069806,0.528112944266601
4615,0.4661,9,10,9,594122,11488,95097,12859,0.10641372410982251,0.5281554195588779
4616,0.4662,5,12,5,594134,11476,95102,12854,0.10630256771277187,0.5283189478010687
4617,0.4663,7,10,7,594144,11466,95109,12847,0.10620993738189632,0.528400444206803
4618,0.4664,10,7,10,594151,11459,95119,12837,0.10614509615028345,0.5283585775436286
4619,0.4665,13,9,13,594160,11450,95132,12824,0.10606172885249546,0.5283018867924528
4620,0.4666,6,10,6,594170,11440,95138,12818,0.10596909852161993,0.5284030010718114
4621,0.4667,5,15,5,594185,11425,95143,12813,0.1058301530253066,0.5286327254723987
4622,0.4668,10,8,10,594193,11417,95153,12803,0.10575604876060617,0.5286127167630058
4623,0.4669,6,11,6,594204,11406,95159,12797,0.10565415539664308,0.5287361070941619
4624,0.467,9,11,9,594215,11395,95168,12788,0.10555226203267998,0.5288012240003308
4625,0.4671,11,8,11,594223,11387,95179,12777,0.10547815776797954,0.5287617944048999
4626,0.4672,12,16,12,594239,11371,95191,12765,0.10532994923857868,0.5288780245276765
4627,0.4673,6,11,6,594250,11360,95197,12759,0.10522805587461559,0.5290020315933497
4628,0.4674,8,2,8,594252,11358,95205,12751,0.10520952980844048,0.5288896262806421
4629,0.4675,12,5,12,594257,11353,95217,12739,0.10516321464300271,0.5287647351818031
4630,0.4676,12,10,12,594267,11343,95229,12727,0.10507058431212717,0.5287494806813461
4631,0.4677,6,9,6,594276,11334,95235,12721,0.10498721701433918,0.5288297651215963
4632,0.4678,6,11,6,594287,11323,95241,12715,0.10488532365037607,0.5289541559197937
4633,0.4679,10,7,10,594294,11316,95251,12705,0.1048204824187632,0.5289122018234045
4634,0.468,15,19,15,594313,11297,95266,12690,0.10464448479009968,0.5290365614707967
4635,0.4681,6,10,6,594323,11287,95272,12684,0.10455185445922413,0.5291393767469025
4636,0.4682,9,13,9,594336,11274,95281,12675,0.10443143502908592,0.5292496555179756
4637,0.4683,6,6,6,594342,11268,95287,12669,0.1043758568305606,0.529264318836947
4638,0.4684,9,10,9,594352,11258,95296,12660,0.10428322649968505,0.5293084706079103
4639,0.4685,8,9,8,594361,11249,95304,12652,0.10419985920189707,0.5293502363917828
4640,0.4686,8,12,8,594373,11237,95312,12644,0.10408870280484642,0.5294585653867091
4641,0.4687,9,9,9,594382,11228,95321,12635,0.10400533550705843,0.5294807861542975
4642,0.4688,3,7,3,594389,11221,95324,12632,0.10394049427544555,0.529576992411856
4643,0.4689,6,7,6,594396,11214,95330,12626,0.10387565304383267,0.5296140939597316
4644,0.469,6,8,6,594404,11206,95336,12620,0.10380154877913224,0.5296734659615546
4645,0.4691,8,10,8,594414,11196,95344,12612,0.10370891844825669,0.5297379032258065
4646,0.4692,11,9,11,594423,11187,95355,12601,0.1036255511504687,0.5297208676643685
4647,0.4693,12,8,12,594431,11179,95367,12589,0.10355144688576827,0.5296617300572198
4648,0.4694,10,7,10,594438,11172,95377,12579,0.10348660565415539,0.5296198054818745
4649,0.4695,6,8,6,594446,11164,95383,12573,0.10341250138945496,0.5296794034629482
4650,0.4696,2,13,2,594459,11151,95385,12571,0.10329208195931676,0.5299300227636793
4651,0.4697,10,15,10,594474,11136,95395,12561,0.10315313646300345,0.5300670971008988
4652,0.4698,7,8,7,594482,11128,95402,12554,0.10307903219830301,0.5301072544548602
4653,0.4699,10,11,10,594493,11117,95412,12544,0.10297713883433991,0.5301551075609653
4654,0.47,9,4,9,594497,11113,95421,12535,0.1029400867019897,0.5300659675236806
4655,0.4701,10,11,10,594508,11102,95431,12525,0.1028381933380266,0.5301138527955306
4656,0.4702,11,10,11,594518,11092,95442,12514,0.10274556300715106,0.5301194611539439
4657,0.4703,10,11,10,594529,11081,95452,12504,0.10264366964318797,0.5301674793300827
4658,0.4704,6,17,6,594546,11064,95458,12498,0.10248619808069954,0.5304303539597657
4659,0.4705,8,9,8,594555,11055,95466,12490,0.10240283078291156,0.5304735612656615
4660,0.4706,5,10,5,594565,11045,95471,12485,0.10231020045203601,0.5305992350191245
4661,0.4707,8,7,8,594572,11038,95479,12477,0.10224535922042313,0.530597490963215
4662,0.4708,7,11,7,594583,11027,95486,12470,0.10214346585646004,0.5307060475805422
4663,0.4709,11,7,11,594590,11020,95497,12459,0.10207862462484717,0.5306444056390818
4664,0.471,5,8,5,594598,11012,95502,12454,0.10200452036014673,0.5307253046961561
4665,0.4711,8,4,8,594602,11008,95510,12446,0.10196746822779651,0.5306557516841477
4666,0.4712,12,7,12,594609,11001,95522,12434,0.10190262699618363,0.5305739278856412
4667,0.4713,4,10,4,594619,10991,95526,12430,0.10180999666530809,0.5307202937534691
4668,0.4714,13,12,13,594631,10979,95539,12417,0.10169884026825744,0.530731749016926
4669,0.4715,9,12,9,594643,10967,95548,12408,0.10158768387120679,0.5308235294117647
4670,0.4716,7,6,7,594649,10961,95555,12401,0.10153210567268146,0.5308192791713038
4671,0.4717,10,17,10,594666,10944,95565,12391,0.10137463411019304,0.5310049282194129
4672,0.4718,6,8,6,594674,10936,95571,12385,0.1013005298454926,0.5310664208224347
4673,0.4719,8,10,8,594684,10926,95579,12377,0.10120789951461706,0.5311333304724714
4674,0.472,5,7,5,594691,10919,95584,12372,0.10114305828300418,0.53119230604096
4675,0.4721,8,13,8,594704,10906,95592,12364,0.10102263885286598,0.5313278899871079
4676,0.4722,5,10,5,594714,10896,95597,12359,0.10093000852199044,0.5314556009460331
4677,0.4723,10,7,10,594721,10889,95607,12349,0.10086516729037756,0.53141406317239
4678,0.4724,14,8,14,594729,10881,95621,12335,0.10079106302567713,0.53131461061337
4679,0.4725,9,11,9,594740,10870,95630,12326,0.10068916966171403,0.5313847215037075
4680,0.4726,8,8,8,594748,10862,95638,12318,0.10061506539701359,0.5314063848144952
4681,0.4727,5,12,5,594760,10850,95643,12313,0.10050390899996295,0.5315805379268661
4682,0.4728,9,5,9,594765,10845,95652,12304,0.10045759383452518,0.5315132403127565
4683,0.4729,6,13,6,594778,10832,95658,12298,0.10033717440438697,0.5316904453091224
4684,0.473,11,12,11,594790,10820,95669,12287,0.10022601800733633,0.5317436274721946
4685,0.4731,11,10,11,594800,10810,95680,12276,0.10013338767646078,0.531750844667764
4686,0.4732,5,8,5,594808,10802,95685,12271,0.10005928341176035,0.5318337450699953
4687,0.4733,7,9,7,594817,10793,95692,12264,0.09997591611397236,0.531899206314785
4688,0.4734,8,12,8,594829,10781,95700,12256,0.09986475971692171,0.5320137170638538
4689,0.4735,10,8,10,594837,10773,95710,12246,0.09979065545222128,0.5319953082236414
4690,0.4736,7,10,7,594847,10763,95717,12239,0.09969802512134573,0.5320841665942092
4691,0.4737,8,7,8,594854,10756,95725,12231,0.09963318388973286,0.5320833514595206
4692,0.4738,6,11,6,594865,10745,95731,12225,0.09953129052576976,0.5322159338267305
4693,0.4739,7,11,7,594876,10734,95738,12218,0.09942939716180667,0.5323283373997909
4694,0.474,4,14,4,594890,10720,95742,12214,0.0992997146985809,0.5325717275660591
4695,0.4741,6,8,6,594898,10712,95748,12208,0.09922561043388047,0.5326352530541012
4696,0.4742,12,18,12,594916,10694,95760,12196,0.0990588758383045,0.5328090869375273
4697,0.4743,7,8,7,594924,10686,95767,12189,0.09898477157360407,0.5328524590163934
4698,0.4744,10,8,10,594932,10678,95777,12179,0.09891066730890363,0.5328345802161264
4699,0.4745,8,11,8,594943,10667,95785,12171,0.09880877394494053,0.5329275768456082
4700,0.4746,6,13,6,594956,10654,95791,12165,0.09868835451480233,0.533108374600114
4701,0.4747,6,13,6,594969,10641,95797,12159,0.09856793508466412,0.5332894736842105
4702,0.4748,8,8,8,594977,10633,95805,12151,0.09849383081996368,0.5333128511235955
4703,0.4749,10,4,10,594981,10629,95815,12141,0.09845677868761347,0.533201581027668
4704,0.475,8,10,8,594991,10619,95823,12133,0.09836414835673793,0.533271800281294
4705,0.4751,7,8,7,594999,10611,95830,12126,0.0982900440920375,0.5333157408629107
4706,0.4752,8,6,8,595005,10605,95838,12118,0.09823446589351217,0.5332922589446816
4707,0.4753,7,10,7,595015,10595,95845,12111,0.09814183556263663,0.5333832467189289
4708,0.4754,6,14,6,595029,10581,95851,12105,0.09801215309941087,0.5335889976196774
4709,0.4755,12,5,12,595034,10576,95863,12093,0.0979658379339731,0.5334597909038775
4710,0.4756,15,17,15,595051,10559,95878,12078,0.09780836637148468,0.5335512656270707
4711,0.4757,5,6,5,595057,10553,95883,12073,0.09775278817295935,0.5335896755944488
4712,0.4758,7,6,7,595063,10547,95890,12066,0.09769720997443403,0.5335868748065272
4713,0.4759,7,12,7,595075,10535,95897,12059,0.09758605357738338,0.5337257679029831
4714,0.476,11,15,11,595090,10520,95908,12048,0.09744710808107007,0.5338532435306629
4715,0.4761,6,5,6,595095,10515,95914,12042,0.09740079291563229,0.5338475861151749
4716,0.4762,9,13,9,595108,10502,95923,12033,0.09728037348549409,0.5339693809629465
4717,0.4763,11,5,11,595113,10497,95934,12022,0.09723405832005631,0.5338602957502553
4718,0.4764,4,7,4,595120,10490,95938,12018,0.09716921708844344,0.533943486760263
4719,0.4765,4,7,4,595127,10483,95942,12014,0.09710437585683056,0.5340267591234387
4720,0.4766,8,6,8,595133,10477,95950,12006,0.09704879765830524,0.5340034692879064
4721,0.4767,8,5,8,595138,10472,95958,11998,0.09700248249286747,0.5339563862928349
4722,0.4768,11,11,11,595149,10461,95969,11987,0.09690058912890437,0.5339896650035638
4723,0.4769,5,14,5,595163,10447,95974,11982,0.09677090666567861,0.5342190913549423
4724,0.477,5,9,5,595172,10438,95979,11977,0.09668753936789062,0.5343296899397725
4725,0.4771,6,11,6,595183,10427,95985,11971,0.09658564600392752,0.5344673631574248
4726,0.4772,7,8,7,595191,10419,95992,11964,0.09651154173922709,0.5345127998927758
4727,0.4773,5,11,5,595202,10408,95997,11959,0.096409648375264,0.5346716144319756
4728,0.4774,9,8,9,595210,10400,96006,11950,0.09633554411056357,0.5346756152125279
4729,0.4775,11,8,11,595218,10392,96017,11939,0.09626143984586313,0.53463794724822
4730,0.4776,6,7,6,595225,10385,96023,11933,0.09619659861425026,0.5346805269289363
4731,0.4777,6,11,6,595236,10374,96029,11927,0.09609470525028715,0.534819066409578
4732,0.4778,8,4,8,595240,10370,96037,11919,0.09605765311793693,0.5347480820135493
4733,0.4779,5,12,5,595252,10358,96042,11914,0.09594649672088629,0.5349317528735632
4734,0.478,9,6,9,595258,10352,96051,11905,0.09589091852236097,0.5348879004358179
4735,0.4781,9,12,9,595270,10340,96060,11896,0.09577976212531031,0.5349883072495053
4736,0.4782,10,2,10,595272,10338,96070,11886,0.0957612360591352,0.5348272138228942
4737,0.4783,5,9,5,595281,10329,96075,11881,0.09567786876134722,0.534939216569113
4738,0.4784,7,6,7,595287,10323,96082,11874,0.09562229056282188,0.5349371536694147
4739,0.4785,4,10,4,595297,10313,96086,11870,0.09552966023194635,0.5350944416895821
4740,0.4786,6,7,6,595304,10306,96092,11864,0.09546481900033348,0.5351375732972485
4741,0.4787,10,10,10,595314,10296,96102,11854,0.09537218866945793,0.5351693002257336
4742,0.4788,4,12,4,595326,10284,96106,11850,0.09526103227240727,0.5353754404987802
4743,0.4789,12,9,12,595335,10275,96118,11838,0.09517766497461928,0.5353412020078687
4744,0.479,13,9,13,595344,10266,96131,11825,0.09509429767683131,0.5352858630211398
4745,0.4791,10,16,10,595360,10250,96141,11815,0.09494608914743044,0.5354634035803308
4746,0.4792,6,14,6,595374,10236,96147,11809,0.09481640668420467,0.5356770242685416
4747,0.4793,7,5,7,595379,10231,96154,11802,0.0947700915187669,0.5356510688512686
4748,0.4794,10,10,10,595389,10221,96164,11792,0.09467746118789136,0.5356834597737701
4749,0.4795,3,8,3,595397,10213,96167,11789,0.09460335692319093,0.5358149259158258
4750,0.4796,10,8,10,595405,10205,96177,11779,0.09452925265849049,0.5357987627365357
4751,0.4797,10,8,10,595413,10197,96187,11769,0.09445514839379006,0.5357825730674679
4752,0.4798,7,5,7,595418,10192,96194,11762,0.09440883322835229,0.5357565819440648
4753,0.4799,12,6,12,595424,10186,96206,11750,0.09435325502982697,0.5356491611962072
4754,0.48,6,10,6,595434,10176,96212,11744,0.09426062469895143,0.5357664233576642
4755,0.4801,8,8,8,595442,10168,96220,11736,0.09418652043425099,0.5357925493060628
4756,0.4802,4,17,4,595459,10151,96224,11732,0.09402904887176257,0.5361239318192204
4757,0.4803,8,10,8,595469,10141,96232,11724,0.09393641854088702,0.536199405442488
4758,0.4804,2,10,2,595479,10131,96234,11722,0.09384378821001149,0.5364023246236215
4759,0.4805,6,14,6,595493,10117,96240,11716,0.09371410574678572,0.5366188796775523
4760,0.4806,5,10,5,595503,10107,96245,11711,0.09362147541591019,0.5367586396553304
4761,0.4807,6,5,6,595508,10102,96251,11705,0.09357516025047241,0.5367542532214427
4762,0.4808,8,6,8,595514,10096,96259,11697,0.09351958205194709,0.5367319781581241
4763,0.4809,5,8,5,595522,10088,96264,11692,0.09344547778724666,0.5368227731864096
4764,0.481,7,3,7,595525,10085,96271,11685,0.09341768868798399,0.5367478180983004
4765,0.4811,8,8,8,595533,10077,96279,11677,0.09334358442328355,0.5367748460053323
4766,0.4812,10,9,10,595542,10068,96289,11667,0.09326021712549558,0.536783988957902
4767,0.4813,8,8,8,595550,10060,96297,11659,0.09318611286079514,0.5368110870666237
4768,0.4814,7,9,7,595559,10051,96304,11652,0.09310274556300716,0.5368843017094411
4769,0.4815,10,10,10,595569,10041,96314,11642,0.09301011523213161,0.5369183231102708
4770,0.4816,9,7,9,595576,10034,96323,11633,0.09294527400051873,0.5368994323164259
4771,0.4817,13,11,13,595587,10023,96336,11620,0.09284338063655563,0.5368941459132283
4772,0.4818,13,10,13,595597,10013,96349,11607,0.09275075030568009,0.5368640148011101
4773,0.4819,6,13,6,595610,10000,96355,11601,0.09263033087554189,0.5370584695153002
4774,0.482,16,9,16,595619,9991,96371,11585,0.0925469635777539,0.5369391916944753
4775,0.4821,12,15,12,595634,9976,96383,11573,0.09240801808144058,0.5370550837625876
4776,0.4822,4,9,4,595643,9967,96387,11569,0.0923246507836526,0.5371935364041605
4777,0.4823,4,5,4,595648,9962,96391,11565,0.09227833561821483,0.5372323129093697
4778,0.4824,8,11,8,595659,9951,96399,11557,0.09217644225425173,0.5373349451366933
4779,0.4825,6,5,6,595664,9946,96405,11551,0.09213012708881396,0.5373307903428385
4780,0.4826,6,4,6,595668,9942,96411,11545,0.09209307495646374,0.5373016242379113
4781,0.4827,10,3,10,595671,9939,96421,11535,0.09206528585720108,0.5371612182173792
4782,0.4828,11,8,11,595679,9931,96432,11524,0.09199118159250065,0.5371242134700536
4783,0.4829,17,8,17,595687,9923,96449,11507,0.09191707732780022,0.5369575361642557
4784,0.483,5,11,5,595698,9912,96454,11502,0.09181518396383712,0.5371252451667133
4785,0.4831,11,8,11,595706,9904,96465,11491,0.09174107969913668,0.5370881046973592
4786,0.4832,7,9,7,595715,9895,96472,11484,0.09165771240134869,0.5371626362318163
4787,0.4833,4,6,4,595721,9889,96476,11480,0.09160213420282337,0.5372268239037858
4788,0.4834,11,4,11,595725,9885,96487,11469,0.09156508207047316,0.5370890699634728
4789,0.4835,8,7,8,595732,9878,96495,11461,0.09150024083886027,0.5370917100145274
4790,0.4836,9,10,9,595742,9868,96504,11452,0.09140761050798474,0.5371482176360225
4791,0.4837,7,5,7,595747,9863,96511,11445,0.09136129534254696,0.5371222076215506
4792,0.4838,7,6,7,595753,9857,96518,11438,0.09130571714402164,0.537121389997652
4793,0.4839,10,8,10,595761,9849,96528,11428,0.0912316128793212,0.5371057949898952
4794,0.484,9,8,9,595769,9841,96537,11419,0.09115750861462077,0.5371119473189088
4795,0.4841,10,10,10,595779,9831,96547,11409,0.09106487828374522,0.5371468926553672
4796,0.4842,6,15,6,595794,9816,96553,11403,0.09092593278743191,0.5373957302417645
4797,0.4843,5,7,5,595801,9809,96558,11398,0.09086109155581903,0.5374640448908379
4798,0.4844,10,10,10,595811,9799,96568,11388,0.09076846122494349,0.5374994100155756
4799,0.4845,2,9,2,595820,9790,96570,11386,0.09068509392715551,0.5376841707593502
4800,0.4846,4,10,4,595830,9780,96574,11382,0.09059246359627997,0.5378508647575844
4801,0.4847,8,7,8,595837,9773,96582,11374,0.09052762236466709,0.5378540691351019
4802,0.4848,16,7,16,595844,9766,96598,11358,0.09046278113305421,0.5376822571482673
4803,0.4849,7,10,7,595854,9756,96605,11351,0.09037015080217867,0.5377836736627659
4804,0.485,5,6,5,595860,9750,96610,11346,0.09031457260365335,0.5378270762229806
4805,0.4851,5,8,5,595868,9742,96615,11341,0.09024046833895291,0.5379215481667694
4806,0.4852,7,9,7,595877,9733,96622,11334,0.09015710104116492,0.5379978164902454
4807,0.4853,12,6,12,595883,9727,96634,11322,0.0901015228426396,0.5378877856430234
4808,0.4854,7,13,7,595896,9714,96641,11315,0.08998110341250139,0.5380664796233773
4809,0.4855,11,9,11,595905,9705,96652,11304,0.0898977361147134,0.5380551192346137
4810,0.4856,6,10,6,595915,9695,96658,11298,0.08980510578383787,0.5381793931310437
4811,0.4857,3,12,3,595927,9683,96661,11295,0.08969394938678721,0.5384212031652207
4812,0.4858,9,14,9,595941,9669,96670,11286,0.08956426692356145,0.5385826771653544
4813,0.4859,15,10,15,595951,9659,96685,11271,0.08947163659268591,0.5385093167701863
4814,0.486,4,5,4,595956,9654,96689,11267,0.08942532142724814,0.5385497825151762
4815,0.4861,6,7,6,595963,9647,96695,11261,0.08936048019563526,0.5385976659651808
4816,0.4862,8,7,8,595970,9640,96703,11253,0.08929563896402239,0.5386014454602019
4817,0.4863,10,12,10,595982,9628,96713,11243,0.08918448256697173,0.5386900483925063
4818,0.4864,5,2,5,595984,9626,96718,11238,0.08916595650079662,0.5386311349693251
4819,0.4865,4,10,4,595994,9616,96722,11234,0.08907332616992109,0.538800959232614
4820,0.4866,10,9,10,596003,9607,96732,11224,0.0889899588721331,0.5388123469828621
4821,0.4867,8,8,8,596011,9599,96740,11216,0.08891585460743266,0.5388421811193851
4822,0.4868,7,12,7,596023,9587,96747,11209,0.088804698210382,0.5389978842085016
4823,0.4869,4,4,4,596027,9583,96751,11205,0.0887676460780318,0.5390128920531075
4824,0.487,10,14,10,596041,9569,96761,11195,0.08863796361480603,0.5391543055287998
4825,0.4871,8,8,8,596049,9561,96769,11187,0.08856385935010559,0.5391844997108155
4826,0.4872,7,8,7,596057,9553,96776,11180,0.08848975508540516,0.5392369652245212
4827,0.4873,9,11,9,596068,9542,96785,11171,0.08838786172144207,0.5393231304011973
4828,0.4874,7,10,7,596078,9532,96792,11164,0.08829523139056653,0.5394279087746424
4829,0.4875,9,3,9,596081,9529,96801,11155,0.08826744229130387,0.5393057435699091
4830,0.4876,9,11,9,596092,9518,96810,11146,0.08816554892734077,0.5393921796360821
4831,0.4877,6,11,6,596103,9507,96816,11140,0.08806365556337767,0.5395456967113866
4832,0.4878,8,11,8,596114,9496,96824,11132,0.08796176219941458,0.5396548380841575
4833,0.4879,4,5,4,596119,9491,96828,11128,0.0879154470339768,0.5396963965274747
4834,0.488,10,11,10,596130,9480,96838,11118,0.08781355367001371,0.5397611418584328
4835,0.4881,5,8,5,596138,9472,96843,11113,0.08773944940531328,0.5398591207189701
4836,0.4882,7,6,7,596144,9466,96850,11106,0.08768387120678794,0.5398600038887809
4837,0.4883,9,10,9,596154,9456,96859,11097,0.08759124087591241,0.53992117938987
4838,0.4884,6,4,6,596158,9452,96865,11091,0.08755418874356219,0.5398919339921141
4839,0.4885,11,12,11,596170,9440,96876,11080,0.08744303234651155,0.5399610136452242
4840,0.4886,13,10,13,596180,9430,96889,11067,0.087350402015636,0.5399326730741084
4841,0.4887,10,4,10,596184,9426,96899,11057,0.08731334988328578,0.5398135038812674
4842,0.4888,11,9,11,596193,9417,96910,11046,0.0872299825854978,0.5398035478668817
4843,0.4889,7,11,7,596204,9406,96917,11039,0.0871280892215347,0.5399364147713377
4844,0.489,8,10,8,596214,9396,96925,11031,0.08703545889065915,0.5400205610221765
4845,0.4891,7,13,7,596227,9383,96932,11024,0.08691503946052095,0.5402067917871318
4846,0.4892,9,8,9,596235,9375,96941,11015,0.08684093519582052,0.5402157920549289
4847,0.4893,8,10,8,596245,9365,96949,11007,0.08674830486494498,0.54030041233065
4848,0.4894,12,10,12,596255,9355,96961,10995,0.08665567453406943,0.5402948402948403
4849,0.4895,5,6,5,596261,9349,96966,10990,0.08660009633554411,0.5403412163823197
4850,0.4896,10,8,10,596269,9341,96976,10980,0.08652599207084367,0.5403277397765858
4851,0.4897,9,8,9,596277,9333,96985,10971,0.08645188780614324,0.5403368794326241
4852,0.4898,10,13,10,596290,9320,96995,10961,0.08633146837600504,0.5404565849810167
4853,0.4899,4,10,4,596300,9310,96999,10957,0.0862388380451295,0.5406325553856022
4854,0.49,10,3,10,596303,9307,97009,10947,0.08621104894586683,0.5404858299595142
4855,0.4901,9,9,9,596312,9298,97018,10938,0.08612768164807885,0.5405218422613165
4856,0.4902,7,16,7,596328,9282,97025,10931,0.08597947311867798,0.5407905803195963
4857,0.4903,10,16,10,596344,9266,97035,10921,0.08583126458927712,0.5409917273492842
4858,0.4904,7,7,7,596351,9259,97042,10914,0.08576642335766424,0.54102017548208
4859,0.4905,9,11,9,596362,9248,97051,10905,0.08566452999370114,0.5411105046395077
4860,0.4906,7,7,7,596369,9241,97058,10898,0.08559968876208826,0.5411390833705745
4861,0.4907,5,4,5,596373,9237,97063,10893,0.08556263662973804,0.5411326378539494
4862,0.4908,6,7,6,596380,9230,97069,10887,0.08549779539812516,0.5411840731719442
4863,0.4909,16,8,16,596388,9222,97085,10871,0.08542369113342473,0.5410341910117952
4864,0.491,7,8,7,596396,9214,97092,10864,0.08534958686872429,0.5410897499750971
4865,0.4911,10,11,10,596407,9203,97102,10854,0.0852476935047612,0.5411577005534227
4866,0.4912,2,12,2,596419,9191,97104,10852,0.08513653710771055,0.5414359127875069
4867,0.4913,7,8,7,596427,9183,97111,10845,0.08506243284301011,0.5414919113241462
4868,0.4914,5,7,5,596434,9176,97116,10840,0.08499759161139724,0.5415667466027179
4869,0.4915,7,9,7,596443,9167,97123,10833,0.08491422431360925,0.54165
4870,0.4916,9,6,9,596449,9161,97132,10824,0.08485864611508392,0.5416062046534901
4871,0.4917,6,13,6,596462,9148,97138,10818,0.08473822668494572,0.541821095862967
4872,0.4918,13,9,13,596471,9139,97151,10805,0.08465485938715774,0.541766947452868
4873,0.4919,8,8,8,596479,9131,97159,10797,0.0845807551224573,0.5418004817342432
4874,0.492,4,8,4,596487,9123,97163,10793,0.08450665085775687,0.5419260895762201
4875,0.4921,10,4,10,596491,9119,97173,10783,0.08446959872540664,0.541804843734298
4876,0.4922,10,8,10,596499,9111,97183,10773,0.08439549446070621,0.541792395896198
4877,0.4923,11,6,11,596505,9105,97194,10762,0.08433991626218089,0.5417023204308653
4878,0.4924,5,14,5,596519,9091,97199,10757,0.08421023379895513,0.541968964127368
4879,0.4925,5,9,5,596528,9082,97204,10752,0.08412686650116714,0.542099425229404
4880,0.4926,11,7,11,596535,9075,97215,10741,0.08406202526955427,0.5420367379895035
4881,0.4927,5,8,5,596543,9067,97220,10736,0.08398792100485383,0.5421400797858911
4882,0.4928,5,9,5,596552,9058,97225,10731,0.08390455370706584,0.542270958613371
4883,0.4929,9,7,9,596559,9051,97234,10722,0.08383971247545297,0.5422545895918677
4884,0.493,8,4,8,596563,9047,97242,10714,0.08380266034310274,0.5421790395222914
4885,0.4931,10,7,10,596570,9040,97252,10704,0.08373781911148986,0.5421393841166937
4886,0.4932,6,9,6,596579,9031,97258,10698,0.08365445181370187,0.5422474529879873
4887,0.4933,4,12,4,596591,9019,97262,10694,0.08354329541665123,0.5424846547963273
4888,0.4934,6,2,6,596593,9017,97268,10688,0.08352476935047612,0.5424004059883278
4889,0.4935,7,12,7,596605,9005,97275,10681,0.08341361295342548,0.5425683226658539
4890,0.4936,4,6,4,596611,8999,97279,10677,0.08335803475490014,0.5426407806464728
4891,0.4937,6,8,6,596619,8991,97285,10671,0.0832839304901997,0.542722001830943
4892,0.4938,5,13,5,596632,8978,97290,10666,0.0831635110600615,0.5429647729586642
4893,0.4939,6,9,6,596641,8969,97296,10660,0.08308014376227352,0.5430740231290437
4894,0.494,7,8,7,596649,8961,97303,10653,0.08300603949757308,0.5431324564086877
4895,0.4941,11,10,11,596659,8951,97314,10642,0.08291340916669754,0.5431531669473791
4896,0.4942,5,5,5,596664,8946,97319,10637,0.08286709400125977,0.5431752029821785
4897,0.4943,5,8,5,596672,8938,97324,10632,0.08279298973655934,0.5432805314256515
4898,0.4944,6,10,6,596682,8928,97330,10626,0.0827003594056838,0.5434182264498313
4899,0.4945,6,11,6,596693,8917,97336,10620,0.0825984660417207,0.5435839688795618
4900,0.4946,4,11,4,596704,8906,97340,10616,0.0824965726777576,0.5437967421370761
4901,0.4947,6,4,6,596708,8902,97346,10610,0.0824595205454074,0.5437679376793768
4902,0.4948,10,14,10,596722,8888,97356,10600,0.08232983808218163,0.5439244663382594
4903,0.4949,7,6,7,596728,8882,97363,10593,0.0822742598836563,0.5439281129653402
4904,0.495,6,8,6,596736,8874,97369,10587,0.08220015561895587,0.5440110991213195
4905,0.4951,3,7,3,596743,8867,97372,10584,0.08213531438734299,0.5441365482494473
4906,0.4952,4,14,4,596757,8853,97376,10580,0.08200563192411724,0.5444347244378119
4907,0.4953,6,12,6,596769,8841,97382,10574,0.08189447552706658,0.5446304403811486
4908,0.4954,10,8,10,596777,8833,97392,10564,0.08182037126236615,0.5446203021085735
4909,0.4955,8,13,8,596790,8820,97400,10556,0.08169995183222795,0.5447976878612717
4910,0.4956,7,3,7,596793,8817,97407,10549,0.08167216273296528,0.544717546215016
4911,0.4957,9,6,9,596799,8811,97416,10540,0.08161658453443996,0.5446746938142731
4912,0.4958,2,4,2,596803,8807,97418,10538,0.08157953240208975,0.5447402429568364
4913,0.4959,14,5,14,596808,8802,97432,10524,0.08153321723665197,0.5445513815585222
4914,0.496,6,8,6,596816,8794,97438,10518,0.08145911297195153,0.5446354598177299
4915,0.4961,12,9,12,596825,8785,97450,10506,0.08137574567416354,0.5446062930900419
4916,0.4962,6,14,6,596839,8771,97456,10500,0.08124606321093779,0.5448601525608427
4917,0.4963,6,6,6,596845,8765,97462,10494,0.08119048501241247,0.544888104262942
4918,0.4964,5,12,5,596857,8753,97467,10489,0.08107932861536181,0.5451096559609189
4919,0.4965,3,11,3,596868,8742,97470,10486,0.08097743525139872,0.5453505304763886
4920,0.4966,7,5,7,596873,8737,97477,10479,0.08093112008596094,0.545326810990841
4921,0.4967,8,11,8,596884,8726,97485,10471,0.08082922672199785,0.5454498098661249
4922,0.4968,9,9,9,596893,8717,97494,10462,0.08074585942420986,0.545492465717712
4923,0.4969,4,11,4,596904,8706,97498,10458,0.08064396606024676,0.5457107075767064
4924,0.497,6,5,6,596909,8701,97504,10452,0.080597650894809,0.5457108546963922
4925,0.4971,17,7,17,596916,8694,97521,10435,0.08053280966319612,0.5455068221025667
4926,0.4972,4,6,4,596922,8688,97525,10431,0.0804772314646708,0.5455829279774047
4927,0.4973,5,15,5,596937,8673,97530,10426,0.08033828596835747,0.5458924551023614
4928,0.4974,16,9,16,596946,8664,97546,10410,0.0802549186705695,0.5457691097829506
4929,0.4975,10,7,10,596953,8657,97556,10400,0.0801900774389566,0.54573122737052
4930,0.4976,2,9,2,596962,8648,97558,10398,0.08010671014116863,0.5459414050194267
4931,0.4977,11,5,11,596967,8643,97569,10387,0.08006039497573085,0.5458223857067788
4932,0.4978,3,6,3,596973,8637,97572,10384,0.08000481677720553,0.545922927290889
4933,0.4979,8,6,8,596979,8631,97580,10376,0.0799492385786802,0.5459041405797864
4934,0.498,4,10,4,596989,8621,97584,10372,0.07985660824780466,0.546095930079503
4935,0.4981,4,5,4,596994,8616,97588,10368,0.0798102930823669,0.5461441213653603
4936,0.4982,15,7,15,597001,8609,97603,10353,0.07974545185075402,0.5459867102626306
4937,0.4983,5,9,5,597010,8600,97608,10348,0.07966208455296603,0.5461262402364365
4938,0.4984,11,9,11,597019,8591,97619,10337,0.07957871725517804,0.5461221470836856
4939,0.4985,9,4,9,597023,8587,97628,10328,0.07954166512282781,0.5460216759185831
4940,0.4986,8,6,8,597029,8581,97636,10320,0.0794860869243025,0.5460028569916936
4941,0.4987,3,7,3,597036,8574,97639,10317,0.07942124569268962,0.5461330792440845
4942,0.4988,10,6,10,597042,8568,97649,10307,0.0793656674941643,0.5460662251655629
4943,0.4989,5,9,5,597051,8559,97654,10302,0.0792823001963763,0.5462064577700015
4944,0.499,2,7,2,597058,8552,97656,10300,0.07921745896476343,0.546361128792701
4945,0.4991,8,14,8,597072,8538,97664,10292,0.07908777650153766,0.5465746149761019
4946,0.4992,8,1,8,597073,8537,97672,10284,0.07907851346845012,0.5464109239679081
4947,0.4993,5,5,5,597078,8532,97677,10279,0.07903219830301234,0.5464355961937164
4948,0.4994,3,9,3,597087,8523,97680,10276,0.07894883100522435,0.5466248204691739
4949,0.4995,7,7,7,597094,8516,97687,10269,0.07888398977361147,0.5466595688048975
4950,0.4996,18,6,18,597100,8510,97705,10251,0.07882841157508615,0.546399445658547
4951,0.4997,8,7,8,597107,8503,97713,10243,0.07876357034347327,0.5464099007788328
4952,0.4998,12,6,12,597113,8497,97725,10231,0.07870799214494795,0.5462943186672362
4953,0.4999,3,6,3,597119,8491,97728,10228,0.07865241394642261,0.5463967092259202
4954,0.5,10,5,10,597124,8486,97738,10218,0.07860609878098485,0.5463002566295979
4955,0.5001,4,6,4,597130,8480,97742,10214,0.07855052058245952,0.5463785171712849
4956,0.5002,4,10,4,597140,8470,97746,10210,0.07845789025158398,0.5465738758029979
4957,0.5003,5,9,5,597149,8461,97751,10205,0.07837452295379599,0.5467159541412193
4958,0.5004,8,6,8,597155,8455,97759,10197,0.07831894475527067,0.5466974051040103
4959,0.5005,7,10,7,597165,8445,97766,10190,0.07822631442439512,0.5468204990609069
4960,0.5006,8,11,8,597176,8434,97774,10182,0.07812442106043203,0.5469488611946712
4961,0.5007,8,11,8,597187,8423,97782,10174,0.07802252769646893,0.5470774856159596
4962,0.5008,5,2,5,597189,8421,97787,10169,0.07800400163029382,0.5470145239376009
4963,0.5009,3,8,3,597197,8413,97790,10166,0.07792989736559339,0.5471769201786963
4964,0.501,10,7,10,597204,8406,97800,10156,0.07786505613398051,0.5471393168839565
4965,0.5011,8,8,8,597212,8398,97808,10148,0.07779095186928008,0.5471799849024048
4966,0.5012,5,8,5,597220,8390,97813,10143,0.07771684760457964,0.5472940160794258
4967,0.5013,5,7,5,597227,8383,97818,10138,0.07765200637296676,0.547378651260731
4968,0.5014,13,9,13,597236,8374,97831,10125,0.07756863907517877,0.547326882534191
4969,0.5015,5,5,5,597241,8369,97836,10120,0.07752232390974101,0.5473524798528855
4970,0.5016,2,3,2,597244,8366,97838,10118,0.07749453481047834,0.5473923393204934
4971,0.5017,4,4,4,597248,8362,97842,10114,0.07745748267812813,0.547412859926391
4972,0.5018,8,9,8,597257,8353,97850,10106,0.07737411538034014,0.5474836123300287
4973,0.5019,4,7,4,597264,8346,97854,10102,0.07730927414872726,0.5475932350390286
4974,0.502,9,7,9,597271,8339,97863,10093,0.07724443291711439,0.5475802951388888
4975,0.5021,5,5,5,597276,8334,97868,10088,0.0771981177516766,0.5476061231136684
4976,0.5022,5,1,5,597277,8333,97873,10083,0.07718885471858905,0.54751303214596
4977,0.5023,7,10,7,597287,8323,97880,10076,0.07709622438771352,0.5476384586118811
4978,0.5024,3,11,3,597298,8312,97883,10073,0.07699433102375042,0.5478923035082948
4979,0.5025,10,5,10,597303,8307,97893,10063,0.07694801585831265,0.5477953184540011
4980,0.5026,7,7,7,597310,8300,97900,10056,0.07688317462669976,0.5478317716278056
4981,0.5027,8,7,8,597317,8293,97908,10048,0.07681833339508688,0.5478436290278611
4982,0.5028,2,5,2,597322,8288,97910,10046,0.07677201822964912,0.5479437111377768
4983,0.5029,7,8,7,597330,8280,97917,10039,0.07669791396494868,0.5480102625689175
4984,0.503,6,4,6,597334,8276,97923,10033,0.07666086183259846,0.5479818668414441
4985,0.5031,7,10,7,597344,8266,97930,10026,0.07656823150172293,0.5481084627159414
4986,0.5032,8,7,8,597351,8259,97938,10018,0.07650339027011005,0.5481205887180609
4987,0.5033,9,3,9,597354,8256,97947,10009,0.07647560117084738,0.5479879551053928
4988,0.5034,5,2,5,597356,8254,97952,10004,0.07645707510467227,0.5479241976120057
4989,0.5035,12,2,12,597358,8252,97964,9992,0.07643854903849717,0.547686910765183
4990,0.5036,11,10,11,597368,8242,97975,9981,0.07634591870762163,0.5477144268232453
4991,0.5037,10,9,10,597377,8233,97985,9971,0.07626255140983364,0.5477367611513952
4992,0.5038,11,7,11,597384,8226,97996,9960,0.07619771017822076,0.5476740349719564
4993,0.5039,5,5,5,597389,8221,98001,9955,0.07615139501278298,0.547700264084507
4994,0.504,11,15,11,597404,8206,98012,9944,0.07601244951646967,0.5478787878787879
4995,0.5041,12,7,12,597411,8199,98024,9932,0.07594760828485679,0.5477910760575809
4996,0.5042,5,7,5,597418,8192,98029,9927,0.07588276705324391,0.5478779182074066
4997,0.5043,5,10,5,597428,8182,98034,9922,0.07579013672236837,0.5480556783031374
4998,0.5044,5,6,5,597434,8176,98039,9917,0.07573455852384305,0.5481125297076217
4999,0.5045,9,7,9,597441,8169,98048,9908,0.07566971729223017,0.54809979532002
5000,0.5046,15,7,15,597448,8162,98063,9893,0.07560487606061729,0.5479368595956798
5001,0.5047,8,13,8,597461,8149,98071,9885,0.07548445663047909,0.5481313075302207
5002,0.5048,3,9,3,597470,8140,98074,9882,0.0754010893326911,0.5483298191099767
5003,0.5049,5,9,5,597479,8131,98079,9877,0.07531772203490311,0.5484784540204354
5004,0.505,4,2,4,597481,8129,98083,9873,0.075299195968728,0.5484390623264082
5005,0.5051,3,5,3,597486,8124,98086,9870,0.07525288080329023,0.5485161720573525
5006,0.5052,8,8,8,597494,8116,98094,9862,0.0751787765385898,0.5485593503170542
5007,0.5053,6,7,6,597501,8109,98100,9856,0.07511393530697692,0.5486223211800724
5008,0.5054,12,9,12,597510,8100,98112,9844,0.07503056800918893,0.5485956308515382
5009,0.5055,7,7,7,597517,8093,98119,9837,0.07496572677757606,0.5486335750139432
5010,0.5056,5,6,5,597523,8087,98124,9832,0.07491014857905072,0.5486913332217199
5011,0.5057,8,7,8,597530,8080,98132,9824,0.07484530734743784,0.548704200178731
5012,0.5058,2,14,2,597544,8066,98134,9822,0.07471562488421209,0.5490831842576028
5013,0.5059,7,9,7,597553,8057,98141,9815,0.0746322575864241,0.5491830796777082
5014,0.506,7,5,7,597558,8052,98148,9808,0.07458594242098633,0.5491601343784994
5015,0.5061,7,9,7,597567,8043,98155,9801,0.07450257512319834,0.5492602555480834
5016,0.5062,5,15,5,597582,8028,98160,9796,0.07436362962688503,0.5495960502692998
5017,0.5063,7,8,7,597590,8020,98167,9789,0.0742895253621846,0.5496658992644169
5018,0.5064,8,9,8,597599,8011,98175,9781,0.07420615806439661,0.5497414568345323
5019,0.5065,4,4,4,597603,8007,98179,9777,0.07416910593204638,0.5497638326585695
5020,0.5066,9,4,9,597607,8003,98188,9768,0.07413205379969617,0.5496595577063755
5021,0.5067,4,5,4,597612,7998,98192,9764,0.07408573863425841,0.5497128701722779
5022,0.5068,9,2,9,597614,7996,98201,9755,0.0740672125680833,0.549546504422286
5023,0.5069,2,4,2,597618,7992,98203,9753,0.07403016043573307,0.5496196111580727
5024,0.507,8,4,8,597622,7988,98211,9745,0.07399310830338286,0.5495404048948288
5025,0.5071,10,5,10,597627,7983,98221,9735,0.07394679313794508,0.549441246190315
5026,0.5072,8,9,8,597636,7974,98229,9727,0.07386342584015711,0.5495169764420089
5027,0.5073,2,9,2,597645,7965,98231,9725,0.07378005854236912,0.5497456189937818
5028,0.5074,5,8,5,597653,7957,98236,9720,0.07370595427766868,0.5498670588900831
5029,0.5075,8,6,8,597659,7951,98244,9712,0.07365037607914335,0.5498499688614618
5030,0.5076,3,5,3,597664,7946,98247,9709,0.07360406091370558,0.5499291985273294
5031,0.5077,8,7,8,597671,7939,98255,9701,0.0735392196820927,0.5499433106575964
5032,0.5078,4,8,4,597679,7931,98259,9697,0.07346511541739227,0.5500907646925346
5033,0.5079,13,6,13,597685,7925,98272,9684,0.07340953721886695,0.5499460503151797
5034,0.508,5,10,5,597695,7915,98277,9679,0.0733169068879914,0.5501307263839945
5035,0.5081,10,5,10,597700,7910,98287,9669,0.07327059172255364,0.5500312873314751
5036,0.5082,9,7,9,597707,7903,98296,9660,0.07320575049094076,0.5500199282582702
5037,0.5083,10,10,10,597717,7893,98306,9650,0.07311312016006521,0.5500769537707347
5038,0.5084,9,3,9,597720,7890,98315,9641,0.07308533106080255,0.5499401060977697
5039,0.5085,6,5,6,597725,7885,98321,9635,0.07303901589536478,0.5499429223744292
5040,0.5086,5,3,5,597728,7882,98326,9630,0.07301122679610211,0.5499086340794883
5041,0.5087,6,12,6,597740,7870,98332,9624,0.07290007039905147,0.5501314736481079
5042,0.5088,6,8,6,597748,7862,98338,9618,0.07282596613435104,0.5502288329519451
5043,0.5089,8,6,8,597754,7856,98346,9610,0.0727703879358257,0.5502118401465704
5044,0.509,5,7,5,597761,7849,98351,9605,0.07270554670421282,0.5503036553225622
5045,0.5091,8,14,8,597775,7835,98359,9597,0.07257586424098707,0.5505392381826526
5046,0.5092,7,7,7,597782,7828,98366,9590,0.07251102300937419,0.5505798599150304
5047,0.5093,8,12,8,597794,7816,98374,9582,0.07239986661232353,0.5507529601103575
5048,0.5094,8,7,8,597801,7809,98382,9574,0.07233502538071065,0.5507679917160444
5049,0.5095,7,4,7,597805,7805,98389,9567,0.07229797324836044,0.5507137923094635
5050,0.5096,8,5,8,597810,7800,98397,9559,0.07225165808292268,0.5506653609078864
5051,0.5097,2,6,2,597816,7794,98399,9557,0.07219607988439734,0.5508039882427526
5052,0.5098,7,6,7,597822,7788,98406,9550,0.07214050168587202,0.5508132425885338
5053,0.5099,4,9,4,597831,7779,98410,9546,0.07205713438808403,0.550995670995671
5054,0.51,4,8,4,597839,7771,98414,9542,0.0719830301233836,0.5511465372841218
5055,0.5101,9,4,9,597843,7767,98423,9533,0.07194597799103339,0.5510404624277456
5056,0.5102,7,8,7,597851,7759,98430,9526,0.07187187372633295,0.5511136823835696
5057,0.5103,9,7,9,597858,7752,98439,9517,0.07180703249472008,0.5511031327812844
5058,0.5104,6,9,6,597867,7743,98445,9511,0.07172366519693209,0.5512344963486727
5059,0.5105,5,9,5,597876,7734,98450,9506,0.0716402978991441,0.5513921113689095
5060,0.5106,6,7,6,597883,7727,98456,9500,0.07157545666753122,0.5514599175712545
5061,0.5107,5,12,5,597895,7715,98461,9495,0.07146430027048056,0.5517141196978501
5062,0.5108,6,2,6,597897,7713,98467,9489,0.07144577420430545,0.5516219044297175
5063,0.5109,5,8,5,597905,7705,98472,9484,0.07137166993960502,0.5517482110652161
5064,0.511,6,3,6,597908,7702,98478,9478,0.07134388084034236,0.5516880093131549
5065,0.5111,6,6,6,597914,7696,98484,9472,0.07128830264181704,0.5517241379310345
5066,0.5112,3,9,3,597923,7687,98487,9469,0.07120493534402905,0.5519351830263465
5067,0.5113,9,9,9,597932,7678,98496,9460,0.07112156804624106,0.55198973042362
5068,0.5114,8,8,8,597940,7670,98504,9452,0.07104746378154063,0.5520383132811587
5069,0.5115,9,5,9,597945,7665,98513,9443,0.07100114861610286,0.5519639934533551
5070,0.5116,11,2,11,597947,7663,98524,9432,0.07098262254992775,0.5517402749341913
5071,0.5117,7,7,7,597954,7656,98531,9425,0.07091778131831487,0.5517826825127334
5072,0.5118,6,7,6,597961,7649,98537,9419,0.070852940086702,0.5518514178579799
5073,0.5119,4,4,4,597965,7645,98541,9415,0.07081588795435177,0.5518757327080891
5074,0.512,13,6,13,597971,7639,98554,9402,0.07076030975582645,0.551728184965671
5075,0.5121,8,4,8,597975,7635,98562,9394,0.07072325762347623,0.5516471900874979
5076,0.5122,8,9,8,597984,7626,98570,9386,0.07063989032568824,0.5517281918645662
5077,0.5123,4,10,4,597994,7616,98574,9382,0.0705472599948127,0.5519472879162255
5078,0.5124,5,12,5,598006,7604,98579,9377,0.07043610359776205,0.552205406042047
5079,0.5125,6,12,6,598018,7592,98585,9371,0.0703249472007114,0.5524376584330601
5080,0.5126,8,9,8,598027,7583,98593,9363,0.07024157990292342,0.5525197686769739
5081,0.5127,4,3,4,598030,7580,98597,9359,0.07021379080366075,0.5525119546608418
5082,0.5128,10,5,10,598035,7575,98607,9349,0.07016747563822298,0.5524107775939494
5083,0.5129,5,8,5,598043,7567,98612,9344,0.07009337137352255,0.552539767015552
5084,0.513,9,11,9,598054,7556,98621,9335,0.06999147800955945,0.552661180510331
5085,0.5131,5,10,5,598064,7546,98626,9330,0.06989884767868391,0.5528561270443233
5086,0.5132,5,7,5,598071,7539,98631,9325,0.06983400644707102,0.552953036053131
5087,0.5133,7,4,7,598075,7535,98638,9318,0.06979695431472081,0.552898593722186
5088,0.5134,9,7,9,598082,7528,98647,9309,0.06973211308310794,0.5528894696204787
5089,0.5135,3,12,3,598094,7516,98650,9306,0.06962095668605728,0.5532041374390679
5090,0.5136,5,9,5,598103,7507,98655,9301,0.06953758938826929,0.5533674440742503
5091,0.5137,6,4,6,598107,7503,98661,9295,0.06950053725591908,0.5533396832956304
5092,0.5138,6,12,6,598119,7491,98667,9289,0.06938938085886842,0.5535756853396901
5093,0.5139,6,8,6,598127,7483,98673,9283,0.06931527659416799,0.5536800668018609
5094,0.514,12,10,12,598137,7473,98685,9271,0.06922264626329246,0.5536908743430483
5095,0.5141,3,3,3,598140,7470,98688,9268,0.06919485716402979,0.5537101206834747
5096,0.5142,3,4,3,598144,7466,98691,9265,0.06915780503167958,0.5537624768393999
5097,0.5143,6,8,6,598152,7458,98697,9259,0.06908370076697914,0.5538673206915117
5098,0.5144,6,10,6,598162,7448,98703,9253,0.0689910704361036,0.5540386803185438
5099,0.5145,8,9,8,598171,7439,98711,9245,0.06890770313831561,0.5541237113402062
5100,0.5146,5,9,5,598180,7430,98716,9240,0.06882433584052762,0.5542891421715657
5101,0.5147,6,9,6,598189,7421,98722,9234,0.06874096854273963,0.5544280996697688
5102,0.5148,2,7,2,598196,7414,98724,9232,0.06867612731112675,0.5546077135648204
5103,0.5149,9,1,9,598197,7413,98733,9223,0.0686668642780392,0.5544000961769656
5104,0.515,6,5,6,598202,7408,98739,9217,0.06862054911260143,0.554406015037594
5105,0.5151,8,8,8,598210,7400,98747,9209,0.068546444847901,0.5544584261544946
5106,0.5152,6,5,6,598215,7395,98753,9203,0.06850012968246323,0.5544643933003977
5107,0.5153,4,9,4,598224,7386,98757,9199,0.06841676238467524,0.5546578233343382
5108,0.5154,5,7,5,598231,7379,98762,9194,0.06835192115306236,0.5547577384903156
5109,0.5155,5,1,5,598232,7378,98767,9189,0.06834265811997481,0.5546568479507454
5110,0.5156,8,14,8,598246,7364,98775,9181,0.06821297565674904,0.5549108491991538
5111,0.5157,10,5,10,598251,7359,98785,9171,0.06816666049131127,0.5548094373865698
5112,0.5158,4,9,4,598260,7350,98789,9167,0.06808329319352328,0.5550039353393473
5113,0.5159,4,7,4,598267,7343,98793,9163,0.0680184519619104,0.5551314673452078
5114,0.516,7,9,7,598276,7334,98800,9156,0.06793508466412242,0.5552456033959976
5115,0.5161,9,10,9,598286,7324,98809,9147,0.06784245433324688,0.555339687936373
5116,0.5162,5,11,5,598297,7313,98814,9142,0.06774056096928378,0.5555758128228502
5117,0.5163,7,7,7,598304,7306,98821,9135,0.0676757197376709,0.5556231372787543
5118,0.5164,7,6,7,598310,7300,98828,9128,0.06762014153914558,0.5556367177988799
5119,0.5165,9,3,9,598313,7297,98837,9119,0.06759235243988292,0.5554946393762183
5120,0.5166,4,8,4,598321,7289,98841,9115,0.06751824817518248,0.5556571567910266
5121,0.5167,11,11,11,598332,7278,98852,9104,0.06741635481121938,0.555731900866805
5122,0.5168,5,7,5,598339,7271,98857,9099,0.0673515135796065,0.5558338423946243
5123,0.5169,4,11,4,598350,7260,98861,9095,0.06724962021564342,0.5560990522775909
5124,0.517,10,8,10,598358,7252,98871,9085,0.06717551595094298,0.5560996510987329
5125,0.5171,5,4,5,598362,7248,98876,9080,0.06713846381859276,0.5560999510044096
5126,0.5172,10,7,10,598369,7241,98886,9070,0.06707362258697988,0.5560664582183802
5127,0.5173,5,9,5,598378,7232,98891,9065,0.06699025528919189,0.5562373442964963
5128,0.5174,11,9,11,598387,7223,98902,9054,0.0669068879914039,0.5562450082939117
5129,0.5175,2,8,2,598395,7215,98904,9052,0.06683278372670347,0.5564640068851048
5130,0.5176,4,3,4,598398,7212,98908,9048,0.06680499462744081,0.5564575645756458
5131,0.5177,8,5,8,598403,7207,98916,9040,0.06675867946200303,0.5564104142303195
5132,0.5178,8,8,8,598411,7199,98924,9032,0.0666845751973026,0.5564660218101164
5133,0.5179,4,4,4,598415,7195,98928,9028,0.06664752306495239,0.556493866732417
5134,0.518,5,7,5,598422,7188,98933,9023,0.06658268183333951,0.5565973721547097
5135,0.5181,3,8,3,598430,7180,98936,9020,0.06650857756863908,0.5567901234567901
5136,0.5182,7,8,7,598438,7172,98943,9013,0.06643447330393865,0.5568736484399135
5137,0.5183,4,7,4,598445,7165,98947,9009,0.06636963207232577,0.5570050698652158
5138,0.5184,7,6,7,598451,7159,98954,9002,0.06631405387380043,0.557019986386981
5139,0.5185,8,6,8,598457,7153,98962,8994,0.06625847567527511,0.5570074936520716
5140,0.5186,6,5,6,598462,7148,98968,8988,0.06621216050983735,0.5570153693604363
5141,0.5187,12,5,12,598467,7143,98980,8976,0.06616584534439957,0.5568583659035921
5142,0.5188,5,10,5,598477,7133,98985,8971,0.06607321501352403,0.557066567312469
5143,0.5189,7,8,7,598485,7125,98992,8964,0.0659991107488236,0.557150848405743
5144,0.519,3,7,3,598492,7118,98995,8961,0.06593426951721072,0.5573107780334597
5145,0.5191,8,5,8,598497,7113,99003,8953,0.06588795435177294,0.5572637868791236
5146,0.5192,7,8,7,598505,7105,99010,8946,0.06581385008707251,0.557348451809856
5147,0.5193,4,5,4,598510,7100,99014,8942,0.06576753492163474,0.5574117940406433
5148,0.5194,7,9,7,598519,7091,99021,8935,0.06568416762384675,0.557531511294147
5149,0.5195,11,6,11,598525,7085,99032,8924,0.06562858942532143,0.5574364420013742
5150,0.5196,7,7,7,598532,7078,99039,8917,0.06556374819370855,0.557486714598312
5151,0.5197,6,9,6,598541,7069,99045,8911,0.06548038089592056,0.5576345431789738
5152,0.5198,8,3,8,598544,7066,99053,8903,0.0654525917966579,0.5575176905253929
5153,0.5199,2,6,2,598550,7060,99055,8901,0.06539701359813258,0.5576718250736169
5154,0.52,7,4,7,598554,7056,99062,8894,0.06535996146578235,0.5576175548589342
5155,0.5201,9,6,9,598560,7050,99071,8885,0.06530438326725703,0.5575776592406652
5156,0.5202,6,8,6,598568,7042,99077,8879,0.0652302790025566,0.5576910998052886
5157,0.5203,9,8,9,598576,7034,99086,8870,0.06515617473785616,0.5577213279678068
5158,0.5204,9,8,9,598584,7026,99095,8861,0.06508207047315573,0.5577516208220558
5159,0.5205,9,4,9,598588,7022,99104,8852,0.06504501834080552,0.5576414262315736
5160,0.5206,14,5,14,598593,7017,99118,8838,0.06499870317536774,0.5574266792809839
5161,0.5207,6,5,6,598598,7012,99124,8832,0.06495238800992997,0.5574349911638475
5162,0.5208,7,3,7,598601,7009,99131,8825,0.0649245989106673,0.557344953896678
5163,0.5209,4,8,4,598609,7001,99135,8821,0.06485049464596687,0.5575148527366958
5164,0.521,7,14,7,598623,6987,99142,8814,0.06472081218274112,0.5578127966584393
5165,0.5211,7,6,7,598629,6981,99149,8807,0.0646652339842158,0.5578287306815303
5166,0.5212,6,5,6,598634,6976,99155,8801,0.06461891881877802,0.5578373581796285
5167,0.5213,3,2,3,598636,6974,99158,8798,0.06460039275260292,0.557823991884352
5168,0.5214,7,5,7,598641,6969,99165,8791,0.06455407758716514,0.5578045685279188
5169,0.5215,5,5,5,598646,6964,99170,8786,0.06450776242172737,0.5578412698412698
5170,0.5216,8,4,8,598650,6960,99178,8778,0.06447071028937715,0.5577582920320244
5171,0.5217,7,7,7,598657,6953,99185,8771,0.06440586905776427,0.557809717629102
5172,0.5218,7,6,7,598663,6947,99192,8764,0.06435029085923895,0.5578257271975049
5173,0.5219,7,9,7,598672,6938,99199,8757,0.06426692356145096,0.5579483912073909
5174,0.522,9,9,9,598681,6929,99208,8748,0.06418355626366297,0.5580149263251898
5175,0.5221,5,5,5,598686,6924,99213,8743,0.0641372410982252,0.5580519563413544
5176,0.5222,8,5,8,598691,6919,99221,8735,0.06409092593278744,0.5580043439376517
5177,0.5223,7,10,7,598701,6909,99228,8728,0.06399829560191189,0.5581633305621283
5178,0.5224,5,2,5,598703,6907,99233,8723,0.06397976953573678,0.5580934101087652
5179,0.5225,6,4,6,598707,6903,99239,8717,0.06394271740338657,0.5580665813060179
5180,0.5226,5,6,5,598713,6897,99244,8712,0.06388713920486123,0.5581395348837209
5181,0.5227,6,10,6,598723,6887,99250,8706,0.0637945088739857,0.5583274546270762
5182,0.5228,7,3,7,598726,6884,99257,8699,0.06376671977472304,0.5582365398190335
5183,0.5229,4,4,4,598730,6880,99261,8695,0.06372966764237283,0.5582664526484751
5184,0.523,6,2,6,598732,6878,99267,8689,0.06371114157619771,0.5581679193165029
5185,0.5231,6,11,6,598743,6867,99273,8683,0.06360924821223461,0.5583922829581993
5186,0.5232,6,4,6,598747,6863,99279,8677,0.0635721960798844,0.5583655083655084
5187,0.5233,8,3,8,598750,6860,99287,8669,0.06354440698062173,0.5582458625796897
5188,0.5234,6,5,6,598755,6855,99293,8663,0.06349809181518397,0.5582549297589896
5189,0.5235,6,8,6,598763,6847,99299,8657,0.06342398755048353,0.5583720330237358
5190,0.5236,3,4,3,598767,6843,99302,8654,0.06338693541813331,0.5584306639994838
5191,0.5237,5,6,5,598773,6837,99307,8649,0.06333135721960799,0.5585044556373499
5192,0.5238,6,2,6,598775,6835,99313,8643,0.06331283115343288,0.5584054787440238
5193,0.5239,5,5,5,598780,6830,99318,8638,0.06326651598799511,0.5584432376519266
5194,0.524,2,5,2,598785,6825,99320,8636,0.06322020082255733,0.5585667162537998
5195,0.5241,11,4,11,598789,6821,99331,8625,0.06318314869020712,0.5583969959860158
5196,0.5242,2,3,2,598792,6818,99333,8623,0.06315535959094445,0.5584482870280423
5197,0.5243,8,4,8,598796,6814,99341,8615,0.06311830745859424,0.5583641195151986
5198,0.5244,6,8,6,598804,6806,99347,8609,0.06304420319389381,0.5584819980538437
5199,0.5245,8,9,8,598813,6797,99355,8601,0.06296083589610582,0.5585790362384725
5200,0.5246,4,10,4,598823,6787,99359,8597,0.06286820556523028,0.5588273530941238
5201,0.5247,3,7,3,598830,6780,99362,8594,0.0628033643336174,0.5589957070378562
5202,0.5248,5,10,5,598840,6770,99367,8589,0.06271073400274185,0.5592160947978384
5203,0.5249,9,7,9,598847,6763,99376,8580,0.06264589277112897,0.5592126702730887
5204,0.525,6,7,6,598854,6756,99382,8574,0.0625810515395161,0.5592954990215264
5205,0.5251,5,9,5,598863,6747,99387,8569,0.062497684241728114,0.5594802820579786
5206,0.5252,8,4,8,598867,6743,99395,8561,0.0624606321093779,0.5593962362780972
5207,0.5253,9,8,9,598875,6735,99404,8552,0.062386527844677464,0.5594295806894747
5208,0.5254,6,3,6,598878,6732,99410,8546,0.062358738745414796,0.559366409215866
5209,0.5255,10,6,10,598884,6726,99420,8536,0.062303160546889474,0.5592976018870397
5210,0.5256,10,6,10,598890,6720,99430,8526,0.062247582348364146,0.559228650137741
5211,0.5257,10,9,10,598899,6711,99440,8516,0.06216421505057616,0.5592697182636107
5212,0.5258,7,9,7,598908,6702,99447,8509,0.062080847752788174,0.5593978042206298
5213,0.5259,7,4,7,598912,6698,99454,8502,0.06204379562043796,0.5593421052631579
5214,0.526,4,6,4,598918,6692,99458,8498,0.06198821742191263,0.5594470046082949
5215,0.5261,8,9,8,598927,6683,99466,8490,0.061904850124124645,0.5595465629737033
5216,0.5262,10,4,10,598931,6679,99476,8480,0.06186779799177443,0.5594036545946303
5217,0.5263,1,5,1,598936,6674,99477,8479,0.061821482826336656,0.5595591632020062
5218,0.5264,3,5,3,598941,6669,99480,8476,0.06177516766089888,0.559656652360515
5219,0.5265,4,7,4,598948,6662,99484,8472,0.061710326429286005,0.5597991277917272
5220,0.5266,8,13,8,598961,6649,99492,8464,0.0615899069991478,0.5600476411036855
5221,0.5267,4,11,4,598972,6638,99496,8460,0.061488013635184705,0.5603391177639423
5222,0.5268,5,4,5,598976,6634,99501,8455,0.06145096150283449,0.5603419709722314
5223,0.5269,2,3,2,598979,6631,99503,8453,0.06142317240357183,0.5603951206576505
5224,0.527,4,5,4,598984,6626,99507,8449,0.061376857238134054,0.5604643449419568
5225,0.5271,5,6,5,598990,6620,99512,8444,0.06132127903960873,0.5605416887944769
5226,0.5272,8,10,8,599000,6610,99520,8436,0.06122864870873319,0.5606805795560282
5227,0.5273,10,3,10,599003,6607,99530,8426,0.061200859609470526,0.5605002328211268
5228,0.5274,6,8,6,599011,6599,99536,8420,0.06112675534477009,0.5606232105999068
5229,0.5275,8,7,8,599018,6592,99544,8412,0.061061914113157215,0.5606504932018128
5230,0.5276,5,5,5,599023,6587,99549,8407,0.06101559894771944,0.5606909430438842
5231,0.5277,7,8,7,599031,6579,99556,8400,0.06094149468301901,0.5607850991387943
5232,0.5278,2,10,2,599041,6569,99558,8398,0.06084886435214346,0.5611010890626044
5233,0.5279,6,5,6,599046,6564,99564,8392,0.0608025491867057,0.5611125969510564
5234,0.528,3,11,3,599057,6553,99567,8389,0.060700655822742595,0.5614375585597644
5235,0.5281,4,8,4,599065,6545,99571,8385,0.06062655155804217,0.5616208975217682
5236,0.5282,1,5,1,599070,6540,99572,8384,0.060580236392604396,0.5617796837309033
5237,0.5283,10,7,10,599077,6533,99582,8374,0.06051539516099152,0.5617495136513048
5238,0.5284,6,7,6,599084,6526,99588,8368,0.060450553929378634,0.5618369813347657
5239,0.5285,4,5,4,599089,6521,99592,8364,0.06040423876394087,0.5619079610345986
5240,0.5286,4,5,4,599094,6516,99596,8360,0.060357923598503095,0.5619790266200592
5241,0.5287,7,7,7,599101,6509,99603,8353,0.06029308236689022,0.5620374108464541
5242,0.5288,3,0,3,599101,6509,99606,8350,0.06029308236689022,0.5619489871458375
5243,0.5289,6,8,6,599109,6501,99612,8344,0.060218978102189784,0.5620747726507241
5244,0.529,7,3,7,599112,6498,99619,8337,0.060191189002927116,0.5619817997977755
5245,0.5291,6,6,6,599118,6492,99625,8331,0.060135610804401794,0.5620319773325237
5246,0.5292,10,10,10,599128,6482,99635,8321,0.06004298047352625,0.562115787340404
5247,0.5293,8,11,8,599139,6471,99643,8313,0.059941087109563154,0.562297077922078
5248,0.5294,5,3,5,599142,6468,99648,8308,0.05991329801030049,0.5622631293990255
5249,0.5295,6,7,6,599149,6461,99654,8302,0.059848456778687616,0.5623518255097203
5250,0.5296,5,7,5,599156,6454,99659,8297,0.05978361554707473,0.562470340993831
5251,0.5297,6,6,6,599162,6448,99665,8291,0.05972803734854941,0.5625212022525273
5252,0.5298,5,7,5,599169,6441,99670,8286,0.05966319611693653,0.5626400488897942
5253,0.5299,3,5,3,599174,6436,99673,8283,0.05961688095149876,0.5627420341055778
5254,0.53,4,4,4,599178,6432,99677,8279,0.05957982881914854,0.5627761538984434
5255,0.5301,6,4,6,599182,6428,99683,8273,0.059542776686798325,0.5627508332766479
5256,0.5302,4,6,4,599188,6422,99687,8269,0.059487198488273,0.5628616159553468
5257,0.5303,7,5,7,599193,6417,99694,8262,0.05944088332283523,0.562844880441447
5258,0.5304,17,9,17,599202,6408,99711,8245,0.05935751602504724,0.5626834095407084
5259,0.5305,2,9,2,599211,6399,99713,8243,0.05927414872725925,0.5629695396803716
5260,0.5306,7,9,7,599220,6390,99720,8236,0.05919078142947127,0.5631067961165048
5261,0.5307,4,7,4,599227,6383,99724,8232,0.059125940197858384,0.5632569278138898
5262,0.5308,13,4,13,599231,6379,99737,8219,0.05908888806550817,0.5630223318262776
5263,0.5309,8,6,8,599237,6373,99745,8211,0.059033309866982846,0.5630142622051564
5264,0.531,5,5,5,599242,6368,99750,8206,0.05898699470154507,0.5630574996569233
5265,0.5311,2,6,2,599248,6362,99752,8204,0.05893141650301975,0.5632294384182343
5266,0.5312,5,6,5,599254,6356,99757,8199,0.05887583830449442,0.5633115767777396
5267,0.5313,5,9,5,599263,6347,99762,8194,0.05879247100670643,0.5635100749604567
5268,0.5314,10,5,10,599268,6342,99772,8184,0.05874615584126867,0.5634035522511359
5269,0.5315,7,6,7,599274,6336,99779,8177,0.05869057764274334,0.5634258940260456
5270,0.5316,8,4,8,599278,6332,99787,8169,0.05865352551039312,0.5633404592786705
5271,0.5317,6,7,6,599285,6325,99793,8163,0.058588684278780244,0.5634318056322474
5272,0.5318,6,8,6,599293,6317,99799,8157,0.05851458001407981,0.5635622495509189
5273,0.5319,4,6,4,599299,6311,99803,8153,0.05845900181555449,0.5636753318584071
5274,0.532,6,5,6,599304,6306,99809,8147,0.058412686650116716,0.5636891994741576
5275,0.5321,8,6,8,599310,6300,99817,8139,0.05835710845159139,0.5636816954082693
5276,0.5322,9,7,9,599317,6293,99826,8130,0.05829226721997851,0.563683006309367
5277,0.5323,3,2,3,599319,6291,99829,8127,0.058273741153803404,0.5636704119850188
5278,0.5324,6,3,6,599322,6288,99835,8121,0.05824595205454074,0.5636060795336248
5279,0.5325,6,5,6,599327,6283,99841,8115,0.05819963688910297,0.563619947214891
5280,0.5326,7,3,7,599330,6280,99848,8108,0.0581718477898403,0.563525159855435
5281,0.5327,8,1,8,599331,6279,99856,8100,0.058162584756752754,0.5633215105361986
5282,0.5328,9,1,9,599332,6278,99865,8091,0.0581533217236652,0.5630872016145869
5283,0.5329,9,3,9,599335,6275,99874,8082,0.05812553262440254,0.5629309744375566
5284,0.533,9,4,9,599339,6271,99883,8073,0.05808848049205232,0.562813720022309
5285,0.5331,5,7,5,599346,6264,99888,8068,0.058023639260439436,0.5629360870778677
5286,0.5332,8,3,8,599349,6261,99896,8060,0.057995850161176775,0.5628098596466727
5287,0.5333,6,13,6,599362,6248,99902,8054,0.05787543073103857,0.5631380226541742
5288,0.5334,4,8,4,599370,6240,99906,8050,0.057801326466338135,0.56333100069979
5289,0.5335,6,7,6,599377,6233,99912,8044,0.05773648523472526,0.5634236884499545
5290,0.5336,6,7,6,599384,6226,99918,8038,0.05767164400311238,0.5635165451486259
5291,0.5337,3,8,3,599392,6218,99921,8035,0.057597539738411946,0.5637409668140041
5292,0.5338,2,6,2,599398,6212,99923,8033,0.05754196153988662,0.563917163917164
5293,0.5339,2,7,2,599405,6205,99925,8031,0.05747712030827374,0.5641331834785052
5294,0.534,4,7,4,599412,6198,99929,8027,0.05741227907666086,0.5642882249560632
5295,0.5341,2,9,2,599421,6189,99931,8025,0.05732891177887287,0.564584212747995
5296,0.5342,6,11,6,599432,6178,99937,8019,0.05722701841490978,0.5648376417553004
5297,0.5343,5,4,5,599436,6174,99942,8014,0.05718996628255956,0.5648435297434452
5298,0.5344,4,10,4,599446,6164,99946,8010,0.05709733595168402,0.5651192323973473
5299,0.5345,10,5,10,599451,6159,99956,8000,0.05705102078624625,0.5650116533653506
5300,0.5346,3,11,3,599462,6148,99959,7997,0.056949127422283155,0.5653587840226229
5301,0.5347,4,4,4,599466,6144,99963,7993,0.05691207528993294,0.5653957699653391
5302,0.5348,2,6,2,599472,6138,99965,7991,0.05685649709140761,0.5655743506263713
5303,0.5349,2,6,2,599478,6132,99967,7989,0.05680091889288229,0.5657531336307627
5304,0.535,4,7,4,599485,6125,99971,7985,0.0567360776612694,0.5659107016300496
5305,0.5351,5,7,5,599492,6118,99976,7980,0.056671236429656525,0.5660377358490566
5306,0.5352,4,6,4,599498,6112,99980,7976,0.056615658231131204,0.5661555934128336
5307,0.5353,5,13,5,599511,6099,99985,7971,0.056495238800993,0.5665245202558635
5308,0.5354,12,11,12,599522,6088,99997,7959,0.0563933454370299,0.566597850074749
5309,0.5355,4,3,4,599525,6085,100001,7955,0.05636555633776724,0.5665954415954416
5310,0.5356,11,4,11,599529,6081,100012,7944,0.056328504205417025,0.5664171122994652
5311,0.5357,5,2,5,599531,6079,100017,7939,0.05630997813924191,0.5663432729347981
5312,0.5358,7,4,7,599535,6075,100024,7932,0.056272926006891696,0.566288284429214
5313,0.5359,10,3,10,599538,6072,100034,7922,0.056245136907629036,0.5660997570387308
5314,0.536,5,4,5,599542,6068,100039,7917,0.05620808477527882,0.5661065427243475
5315,0.5361,5,8,5,599550,6060,100044,7912,0.056133980510578385,0.5662754079587747
5316,0.5362,5,3,5,599553,6057,100049,7907,0.056106191411315724,0.5662417645373818
5317,0.5363,5,7,5,599560,6050,100054,7902,0.05604135017970284,0.5663704128440367
5318,0.5364,4,7,4,599567,6043,100058,7898,0.05597650894808996,0.5665303780216627
5319,0.5365,8,8,8,599575,6035,100066,7890,0.05590240468338953,0.5666068222621184
5320,0.5366,3,3,3,599578,6032,100069,7887,0.05587461558412687,0.5666355341619369
5321,0.5367,6,7,6,599585,6025,100075,7881,0.05580977435251399,0.5667337839781389
5322,0.5368,6,9,6,599594,6016,100081,7875,0.055726407054726,0.5669138290979772
5323,0.5369,3,4,3,599598,6012,100084,7872,0.05568935492237578,0.5669835782195333
5324,0.537,3,5,3,599603,6007,100087,7869,0.05564303975693801,0.5670942634765062
5325,0.5371,4,4,4,599607,6003,100091,7865,0.055605987624587794,0.5671329679838477
5326,0.5372,6,6,6,599613,5997,100097,7859,0.05555040942606247,0.5671911085450346
5327,0.5373,6,4,6,599617,5993,100103,7853,0.055513357293712255,0.5671674129712553
5328,0.5374,9,7,9,599624,5986,100112,7844,0.05544851606209937,0.5671728127259581
5329,0.5375,5,6,5,599630,5980,100117,7839,0.05539293786357405,0.5672624647224835
5330,0.5376,6,9,6,599639,5971,100123,7833,0.05530957056578606,0.5674442190669371
5331,0.5377,5,4,5,599643,5967,100128,7828,0.05527251843343584,0.5674519753533889
5332,0.5378,2,3,2,599646,5964,100130,7826,0.05524472933417318,0.5675126903553299
5333,0.5379,2,7,2,599653,5957,100132,7824,0.055179888102560304,0.5677381902619548
5334,0.538,13,10,13,599663,5947,100145,7811,0.05508725777168476,0.567742404419247
5335,0.5381,11,9,11,599672,5938,100156,7800,0.055003890473896776,0.5677682340952104
5336,0.5382,3,7,3,599679,5931,100159,7797,0.05493904924228389,0.5679632867132867
5337,0.5383,4,3,4,599682,5928,100163,7793,0.05491126014302123,0.5679615188397347
5338,0.5384,2,5,2,599687,5923,100165,7791,0.05486494497758346,0.5681055855330319
5339,0.5385,6,6,6,599693,5917,100171,7785,0.054809366779058136,0.5681652313530872
5340,0.5386,9,8,9,599701,5909,100180,7776,0.0547352625143577,0.5682133723054439
5341,0.5387,8,5,8,599706,5904,100188,7768,0.05468894734891993,0.5681685196021065
5342,0.5388,9,5,9,599711,5899,100197,7759,0.05464263218348216,0.5680919607556011
5343,0.5389,11,8,11,599719,5891,100208,7748,0.05456852791878172,0.5680768384778943
5344,0.539,3,4,3,599723,5887,100211,7745,0.054531475786431506,0.5681484741784038
5345,0.5391,9,8,9,599731,5879,100220,7736,0.05445737152173107,0.5681968417186927
5346,0.5392,3,8,3,599739,5871,100223,7733,0.05438326725703064,0.5684357541899442
5347,0.5393,7,8,7,599747,5863,100230,7726,0.054309162992330205,0.5685480903672088
5348,0.5394,9,6,9,599753,5857,100239,7717,0.05425358479380488,0.5685133343156034
5349,0.5395,6,6,6,599759,5851,100245,7711,0.05419800659527956,0.5685739566435629
5350,0.5396,8,11,8,599770,5840,100253,7703,0.05409611323131646,0.5687809200324891
5351,0.5397,8,6,8,599776,5834,100261,7695,0.05404053503279114,0.5687781802054845
5352,0.5398,5,3,5,599779,5831,100266,7690,0.05401274593352848,0.5687449153169144
5353,0.5399,3,3,3,599782,5828,100269,7687,0.05398495683426581,0.5687754347021827
5354,0.54,6,5,6,599787,5823,100275,7681,0.053938641668828044,0.5687944312796208
5355,0.5401,4,7,4,599794,5816,100279,7677,0.05387380043721516,0.5689616838360632
5356,0.5402,5,4,5,599798,5812,100284,7672,0.05383674830486494,0.5689706318599822
5357,0.5403,8,12,8,599810,5800,100292,7664,0.05372559190781429,0.5692216280451574
5358,0.5404,6,6,6,599816,5794,100298,7658,0.05367001370928897,0.5692833779363663
5359,0.5405,2,4,2,599820,5790,100300,7656,0.053632961576938754,0.569388665774208
5360,0.5406,7,3,7,599823,5787,100307,7649,0.05360517247767609,0.5692914557904138
5361,0.5407,7,4,7,599827,5783,100314,7642,0.053568120345325876,0.5692364990689013
5362,0.5408,2,7,2,599834,5776,100316,7640,0.05350327911371299,0.569469290399523
5363,0.5409,6,3,6,599837,5773,100322,7634,0.05347549001445033,0.5694040426642799
5364,0.541,2,7,2,599844,5766,100324,7632,0.05341064878283745,0.5696372592924317
5365,0.5411,8,7,8,599851,5759,100332,7624,0.053345807551224575,0.5696779496376
5366,0.5412,8,8,8,599859,5751,100340,7616,0.05327170328652414,0.5697613525847236
5367,0.5413,8,6,8,599865,5745,100348,7608,0.05321612508799881,0.5697596045832397
5368,0.5414,3,0,3,599865,5745,100351,7605,0.05321612508799881,0.5696629213483146
5369,0.5415,8,7,8,599872,5738,100359,7597,0.053151283856385935,0.5697037870266217
5370,0.5416,0,2,0,599874,5736,100359,7597,0.05313275779021083,0.5697892447311182
5371,0.5417,9,6,9,599880,5730,100368,7588,0.0530771795916855,0.5697552185012764
5372,0.5418,4,5,4,599885,5725,100372,7584,0.05303086442624773,0.5698399579232098
5373,0.5419,5,8,5,599893,5717,100377,7579,0.052956760161547295,0.5700210589651022
5374,0.542,6,6,6,599899,5711,100383,7573,0.05290118196302197,0.5700843119542307
5375,0.5421,4,8,4,599907,5703,100387,7569,0.05282707769832154,0.5702983725135624
5376,0.5422,6,4,6,599911,5699,100393,7563,0.05279002556597132,0.5702759764741366
5377,0.5423,8,6,8,599917,5693,100401,7555,0.052734447367445994,0.5702747584541062
5378,0.5424,9,7,9,599924,5686,100410,7546,0.052669606135833116,0.5702841596130592
5379,0.5425,5,8,5,599932,5678,100415,7541,0.05259550187113268,0.5704667524018459
5380,0.5426,5,4,5,599936,5674,100420,7536,0.052558449738782466,0.5704769114307343
5381,0.5427,5,8,5,599944,5666,100425,7531,0.05248434547408203,0.5706599984845041
5382,0.5428,10,6,10,599950,5660,100435,7521,0.05242876727555671,0.5705940368712541
5383,0.5429,6,6,6,599956,5654,100441,7515,0.05237318907703138,0.5706583643404967
5384,0.543,7,7,7,599963,5647,100448,7508,0.052308347845418504,0.5707335613835044
5385,0.5431,8,6,8,599969,5641,100456,7500,0.052252769646893175,0.5707328209420897
5386,0.5432,4,5,4,599974,5636,100460,7496,0.05220645448145541,0.5708193725251295
5387,0.5433,5,6,5,599980,5630,100465,7491,0.05215087628293008,0.5709168508497828
5388,0.5434,4,0,4,599980,5630,100469,7487,0.05215087628293008,0.5707860028970039
5389,0.5435,7,4,7,599984,5626,100476,7480,0.052113824150579864,0.5707309629177476
5390,0.5436,4,6,4,599990,5620,100480,7476,0.05205824595205454,0.5708613317043372
5391,0.5437,9,5,9,599995,5615,100489,7467,0.05201193078661677,0.5707842837486623
5392,0.5438,5,6,5,600001,5609,100494,7462,0.05195635258809145,0.5708821054242216
5393,0.5439,7,12,7,600013,5597,100501,7455,0.0518451961910408,0.5711768311369905
5394,0.544,7,1,7,600014,5596,100508,7448,0.05183593315795324,0.5709904937135848
5395,0.5441,7,8,7,600022,5588,100515,7441,0.05176182889325281,0.5711105994320362
5396,0.5442,6,6,6,600028,5582,100521,7435,0.05170625069472748,0.571176154259814
5397,0.5443,6,5,6,600033,5577,100527,7429,0.05165993552928971,0.5711979086575427
5398,0.5444,4,3,4,600036,5574,100531,7425,0.051632146430027046,0.5711977844449573
5399,0.5445,5,9,5,600045,5565,100536,7420,0.05154877913223906,0.5714285714285714
5400,0.5446,6,6,6,600051,5559,100542,7414,0.051493200933713734,0.5714946427194944
5401,0.5447,7,3,7,600054,5556,100549,7407,0.05146541183445107,0.571395510298542
5402,0.5448,1,5,1,600059,5551,100550,7406,0.0514190966690133,0.5715829281469476
5403,0.5449,3,5,3,600064,5546,100553,7403,0.05137278150357553,0.5717043787165033
5404,0.545,7,1,7,600065,5545,100560,7396,0.05136351847048798,0.5715168843211499
5405,0.5451,3,7,3,600072,5538,100563,7393,0.051298677238875094,0.5717268579382878
5406,0.5452,4,4,4,600076,5534,100567,7389,0.05126162510652488,0.5717712605432175
5407,0.5453,4,6,4,600082,5528,100571,7385,0.051206046907999556,0.5719042825060017
5408,0.5454,5,4,5,600086,5524,100576,7380,0.05116899477564934,0.5719156850588965
5409,0.5455,9,9,9,600095,5515,100585,7371,0.05108562747786135,0.5720161415489678
5410,0.5456,5,5,5,600100,5510,100590,7366,0.05103931231242358,0.5720720720720721
5411,0.5457,3,3,3,600103,5507,100593,7363,0.051011523213160916,0.5721056721056721
5412,0.5458,4,3,4,600106,5504,100597,7359,0.050983734113898255,0.5721060405815128
5413,0.5459,6,3,6,600109,5501,100603,7353,0.050955945014635594,0.5720398319589233
5414,0.546,10,6,10,600115,5495,100613,7343,0.050900366816110265,0.5719738276990185
5415,0.5461,6,10,6,600125,5485,100619,7337,0.05080773648523473,0.5722196225237872
5416,0.5462,5,6,5,600131,5479,100624,7332,0.0507521582867094,0.5723206619311529
5417,0.5463,9,2,9,600133,5477,100633,7323,0.05073363222053429,0.572109375
5418,0.5464,4,11,4,600144,5466,100637,7319,0.0506317388565712,0.5724677356276887
5419,0.5465,6,4,6,600148,5462,100643,7313,0.05059468672422098,0.5724461839530333
5420,0.5466,8,7,8,600155,5455,100651,7305,0.0505298454926081,0.5724921630094044
5421,0.5467,8,3,8,600158,5452,100659,7297,0.050502056393345436,0.5723586163620676
5422,0.5468,7,2,7,600160,5450,100666,7290,0.05048353032717033,0.5722135007849294
5423,0.5469,8,3,8,600163,5447,100674,7282,0.05045574122790766,0.5720795034959542
5424,0.547,8,5,8,600168,5442,100682,7274,0.0504094260624699,0.5720352312047814
5425,0.5471,6,4,6,600172,5438,100688,7268,0.05037237393011968,0.5720132220997953
5426,0.5472,5,10,5,600182,5428,100693,7263,0.050279743599244135,0.5722953273973682
5427,0.5473,5,7,5,600189,5421,100698,7258,0.05021490236763126,0.5724426216578594
5428,0.5474,3,9,3,600198,5412,100701,7255,0.05013153506984327,0.5727480855766953
5429,0.5475,6,7,6,600205,5405,100707,7249,0.05006669383823039,0.5728623360202307
5430,0.5476,7,6,7,600211,5399,100714,7242,0.05001111563970506,0.5728977137884661
5431,0.5477,8,4,8,600215,5395,100722,7234,0.04997406350735485,0.572808615092248
5432,0.5478,1,3,1,600218,5392,100723,7233,0.049946274408092184,0.5729108910891089
5433,0.5479,6,8,6,600226,5384,100729,7227,0.04987217014339175,0.5730711283799858
5434,0.548,6,5,6,600231,5379,100735,7221,0.049825854977953984,0.5730952380952381
5435,0.5481,3,3,3,600234,5376,100738,7218,0.04979806587869132,0.5731300619342544
5436,0.5482,5,2,5,600236,5374,100743,7213,0.04977953981251621,0.5730515611345038
5437,0.5483,9,7,9,600243,5367,100752,7204,0.049714698580903334,0.5730649908519608
5438,0.5484,5,5,5,600248,5362,100757,7199,0.04966838341546556,0.5731231589841573
5439,0.5485,2,3,2,600251,5359,100759,7197,0.0496405943162029,0.5731920993947117
5440,0.5486,3,4,3,600255,5355,100762,7194,0.049603542183852684,0.5732727707387043
5441,0.5487,4,4,4,600259,5351,100766,7190,0.04956649005150247,0.5733195120006379
5442,0.5488,7,10,7,600269,5341,100773,7183,0.04947385972062692,0.5735388054934526
5443,0.5489,8,2,8,600271,5339,100781,7175,0.049455333654451816,0.5733578392200736
5444,0.549,4,6,4,600277,5333,100785,7171,0.04939975545592649,0.5734964811260397
5445,0.5491,3,4,3,600281,5329,100788,7168,0.04936270332357627,0.5735776586380731
5446,0.5492,5,6,5,600287,5323,100793,7163,0.04930712512505095,0.5736825244273587
5447,0.5493,8,7,8,600294,5316,100801,7155,0.049242283893438064,0.573731056050036
5448,0.5494,7,1,7,600295,5315,100808,7148,0.049233020860350515,0.5735376715076627
5449,0.5495,6,4,6,600299,5311,100814,7142,0.0491959687280003,0.5735164217457641
5450,0.5496,6,8,6,600307,5303,100820,7136,0.049121864463299865,0.573679556234424
5451,0.5497,7,11,7,600318,5292,100827,7129,0.049019971099336763,0.5739473472345222
5452,0.5498,4,5,4,600323,5287,100831,7125,0.048973655933899,0.5740412504028359
5453,0.5499,5,5,5,600328,5282,100836,7120,0.048927340768461225,0.5741009514594421
5454,0.55,4,4,4,600332,5278,100840,7116,0.04889028863611101,0.5741487816685493
5455,0.5501,4,2,4,600334,5276,100844,7112,0.0488717625699359,0.5741039715854053
5456,0.5502,7,4,7,600338,5272,100851,7105,0.048834710437585686,0.574048638603862
5457,0.5503,6,6,6,600344,5266,100857,7099,0.04877913223906036,0.574120501415285
5458,0.5504,7,5,7,600349,5261,100864,7092,0.048732817073622585,0.574111551849753
5459,0.5505,7,10,7,600359,5251,100871,7085,0.048640186742747046,0.5743352788586251
5460,0.5506,4,5,4,600364,5246,100875,7081,0.048593871577309274,0.5744301127606068
5461,0.5507,7,4,7,600368,5242,100882,7074,0.04855681944495906,0.5743747970120169
5462,0.5508,6,4,6,600372,5238,100888,7068,0.04851976731260884,0.5743539736713799
5463,0.5509,5,4,5,600376,5234,100893,7063,0.04848271518025862,0.5743677319671464
5464,0.551,7,1,7,600377,5233,100900,7056,0.04847345214717107,0.5741720237610871
5465,0.5511,7,2,7,600379,5231,100907,7049,0.04845492608099596,0.5740228013029316
5466,0.5512,3,3,3,600382,5228,100910,7046,0.0484271369817333,0.5740589864754766
5467,0.5513,4,3,4,600385,5225,100914,7042,0.048399347882470634,0.5740604874867531
5468,0.5514,8,6,8,600391,5219,100922,7034,0.04834376968394531,0.5740634946543703
5469,0.5515,5,3,5,600394,5216,100927,7029,0.04831598058468265,0.5740302164148632
5470,0.5516,5,10,5,600404,5206,100932,7024,0.048223350253807105,0.5743254292722813
5471,0.5517,10,7,10,600411,5199,100942,7014,0.04815850902219423,0.5743060673053304
5472,0.5518,4,5,4,600416,5194,100946,7010,0.048112193856756455,0.5744018354637823
5473,0.5519,3,9,3,600425,5185,100949,7007,0.048028826558968465,0.5747211286089239
5474,0.552,5,6,5,600431,5179,100954,7002,0.047973248360443144,0.5748296527378705
5475,0.5521,1,2,1,600433,5177,100955,7001,0.04795472229426803,0.5748891443586795
5476,0.5522,2,3,2,600436,5174,100957,6999,0.04792693319500537,0.5749609792162984
5477,0.5523,8,5,8,600441,5169,100965,6991,0.0478806180295676,0.5749177631578948
5478,0.5524,3,2,3,600443,5167,100968,6988,0.04786209196339249,0.5749074454956807
5479,0.5525,4,6,4,600449,5161,100972,6984,0.04780651376486717,0.5750514615067929
5480,0.5526,5,3,5,600452,5158,100977,6979,0.047778724665604504,0.5750185383537941
5481,0.5527,5,3,5,600455,5155,100982,6974,0.04775093556634184,0.5749855717701376
5482,0.5528,5,4,5,600459,5151,100987,6969,0.047713883433991626,0.575
5483,0.5529,8,1,8,600460,5150,100995,6961,0.04770462040090407,0.574766740979275
5484,0.553,4,9,4,600469,5141,100999,6957,0.04762125310311609,0.5750537278889073
5485,0.5531,5,4,5,600473,5137,101004,6952,0.04758420097076587,0.5750682438580528
5486,0.5532,5,5,5,600478,5132,101009,6947,0.0475378858053281,0.5751303915887077
5487,0.5533,8,1,8,600479,5131,101017,6939,0.04752862277224054,0.5748964374482187
5488,0.5534,8,4,8,600483,5127,101025,6931,0.047491570639890325,0.5748051086415658
5489,0.5535,4,6,4,600489,5121,101029,6927,0.047435992441365,0.5749501992031872
5490,0.5536,7,6,7,600495,5115,101036,6920,0.047380414242839675,0.5749896136269215
5491,0.5537,5,4,5,600499,5111,101041,6915,0.04734336211048946,0.5750041576584067
5492,0.5538,6,3,6,600502,5108,101047,6909,0.0473155730112268,0.5749355080302905
5493,0.5539,3,3,3,600505,5105,101050,6906,0.047287783911964136,0.5749729414703189
5494,0.554,6,9,6,600514,5096,101056,6900,0.047204416614176146,0.5751917305768589
5495,0.5541,6,1,6,600515,5095,101062,6894,0.04719515358108859,0.5750271081825006
5496,0.5542,5,5,5,600520,5090,101067,6889,0.04714883841565082,0.5750897403789966
5497,0.5543,3,4,3,600524,5086,101070,6886,0.0471117862833006,0.5751754092883394
5498,0.5544,10,11,10,600535,5075,101080,6876,0.047009892919337506,0.5753493431512008
5499,0.5545,8,7,8,600542,5068,101088,6868,0.04694505168772463,0.5754021447721179
5500,0.5546,3,5,3,600547,5063,101091,6865,0.046898736522286856,0.5755365526492288
5501,0.5547,6,5,6,600552,5058,101097,6859,0.04685242135684908,0.5755643198791642
5502,0.5548,3,2,3,600554,5056,101100,6856,0.04683389529067398,0.5755540631296172
5503,0.5549,8,6,8,600560,5050,101108,6848,0.04677831709214866,0.5755589174651202
5504,0.555,7,2,7,600562,5048,101115,6841,0.046759791025973545,0.575405837328623
5505,0.5551,5,8,5,600570,5040,101120,6836,0.04668568676127311,0.5756146850791513
5506,0.5552,7,2,7,600572,5038,101127,6829,0.046667160695098006,0.5754613634448471
5507,0.5553,8,5,8,600577,5033,101135,6821,0.04662084552966023,0.5754175805635229
5508,0.5554,5,6,5,600583,5027,101140,6816,0.046565267331134905,0.5755298488558642
5509,0.5555,8,9,8,600592,5018,101148,6808,0.04648190003334692,0.5756807035345848
5510,0.5556,7,13,7,600605,5005,101155,6801,0.046361480603208716,0.576063018803998
5511,0.5557,6,7,6,600612,4998,101161,6795,0.04629663937159584,0.5761892648181124
5512,0.5558,10,5,10,600617,4993,101171,6785,0.046250324206158065,0.5760740363389371
5513,0.5559,4,6,4,600623,4987,101175,6781,0.046194746007632737,0.5762236573759347
5514,0.556,2,6,2,600629,4981,101177,6779,0.046139167809107415,0.5764455782312925
5515,0.5561,4,3,4,600632,4978,101181,6775,0.046111378709844754,0.5764485663234918
5516,0.5562,8,5,8,600637,4973,101189,6767,0.04606506354440698,0.5764054514480409
5517,0.5563,6,2,6,600639,4971,101195,6761,0.04604653747823187,0.5762870780770543
5518,0.5564,4,6,4,600645,4965,101199,6757,0.04599095927970655,0.5764374680088722
5519,0.5565,3,2,3,600647,4963,101202,6754,0.045972433213531436,0.5764274131603653
5520,0.5566,6,7,6,600654,4956,101208,6748,0.04590759198191856,0.5765550239234449
5521,0.5567,5,3,5,600657,4953,101213,6743,0.0458798028826559,0.5765218878248974
5522,0.5568,4,2,4,600659,4951,101217,6739,0.045861276816480785,0.5764756201881951
5523,0.5569,4,3,4,600662,4948,101221,6735,0.045833487717218124,0.5764786441838569
5524,0.557,5,8,5,600670,4940,101226,6730,0.04575938345251769,0.5766923736075407
5525,0.5571,8,6,8,600676,4934,101234,6722,0.04570380525399237,0.5766986959505834
5526,0.5572,3,7,3,600683,4927,101237,6719,0.04563896402237949,0.5769362871372145
5527,0.5573,7,3,7,600686,4924,101244,6712,0.04561117492311682,0.576830525953936
5528,0.5574,4,6,4,600692,4918,101248,6708,0.0455555967245915,0.5769826251505247
5529,0.5575,8,3,8,600695,4915,101256,6700,0.04552780762532884,0.5768402927249247
5530,0.5576,5,5,5,600700,4910,101261,6695,0.04548149245989107,0.5769065058164584
5531,0.5577,7,8,7,600708,4902,101268,6688,0.045407388195190634,0.5770491803278689
5532,0.5578,5,3,5,600711,4899,101273,6683,0.045379599095927974,0.5770160594025212
5533,0.5579,1,7,1,600718,4892,101274,6682,0.04531475786431509,0.5773284949023674
5534,0.558,2,9,2,600727,4883,101276,6680,0.045231390566527106,0.5777047479027934
5535,0.5581,2,7,2,600734,4876,101278,6678,0.04516654933491422,0.5779816513761468
5536,0.5582,3,9,3,600743,4867,101281,6675,0.04508318203712624,0.5783226477213654
5537,0.5583,4,1,4,600744,4866,101285,6671,0.04507391900403868,0.578226575366213
5538,0.5584,6,6,6,600750,4860,101291,6665,0.045018340805513354,0.5783080260303688
5539,0.5585,4,2,4,600752,4858,101295,6661,0.04499981473933825,0.578262001909888
5540,0.5586,4,6,4,600758,4852,101299,6657,0.04494423654081292,0.5784168911286819
5541,0.5587,4,7,4,600765,4845,101303,6653,0.04487939530920004,0.578622369107671
5542,0.5588,1,5,1,600770,4840,101304,6652,0.04483308014376227,0.5788374521406195
5543,0.5589,7,6,7,600776,4834,101311,6645,0.04477750194523695,0.5788831779771757
5544,0.559,4,9,4,600785,4825,101315,6641,0.04469413464744896,0.579190650619222
5545,0.5591,4,7,4,600792,4818,101319,6637,0.04462929341583608,0.5793976429506765
5546,0.5592,5,3,5,600795,4815,101324,6632,0.04460150431657342,0.5793657726915349
5547,0.5593,7,6,7,600801,4809,101331,6625,0.04454592611804809,0.5794122791673955
5548,0.5594,7,4,7,600805,4805,101338,6618,0.044508873985697875,0.5793574367504158
5549,0.5595,5,6,5,600811,4799,101343,6613,0.04445329578717255,0.5794777427269541
5550,0.5596,5,2,5,600813,4797,101348,6608,0.04443476972099744,0.579395002192021
5551,0.5597,4,5,4,600818,4792,101352,6604,0.044388454555559675,0.5795015795015795
5552,0.5598,9,2,9,600820,4790,101361,6595,0.044369928489384564,0.5792709705753184
5553,0.5599,3,3,3,600823,4787,101364,6592,0.0443421393901219,0.579312769136128
5554,0.56,4,2,4,600825,4785,101368,6588,0.04432361332394679,0.5792666842521762
5555,0.5601,3,5,3,600830,4780,101371,6585,0.044277298158509025,0.5794104707435108
5556,0.5602,2,3,2,600833,4777,101373,6583,0.04424950905924636,0.5794894366197183
5557,0.5603,4,4,4,600837,4773,101377,6579,0.04421245692689614,0.5795454545454546
5558,0.5604,6,5,6,600842,4768,101383,6573,0.044166141761458375,0.579578520412662
5559,0.5605,3,3,3,600845,4765,101386,6570,0.04413835266219571,0.5796206440229378
5560,0.5606,2,4,2,600849,4761,101388,6568,0.04410130052984549,0.5797510812957896
5561,0.5607,6,5,6,600854,4756,101394,6562,0.044054985364407724,0.5797844142074572
5562,0.5608,8,2,8,600856,4754,101402,6554,0.04403645929823261,0.5795896710293598
5563,0.5609,4,5,4,600861,4749,101406,6550,0.04399014413279484,0.5796973183467563
5564,0.561,6,2,6,600863,4747,101412,6544,0.043971618066619735,0.5795766539721903
5565,0.5611,2,8,2,600871,4739,101414,6542,0.0438975138019193,0.5799131282687705
5566,0.5612,8,7,8,600878,4732,101422,6534,0.04383267257030642,0.5799751464583703
5567,0.5613,3,8,3,600886,4724,101425,6531,0.04375856830560599,0.5802754331408263
5568,0.5614,4,3,4,600889,4721,101429,6527,0.04373077920634332,0.5802809388335705
5569,0.5615,7,2,7,600891,4719,101436,6520,0.04371225314016822,0.5801227867247976
5570,0.5616,5,5,5,600896,4714,101441,6515,0.043665937974730444,0.5801941401727669
5571,0.5617,5,1,5,600897,4713,101446,6510,0.04365667494164289,0.5800588078053996
5572,0.5618,6,6,6,600903,4707,101452,6504,0.043601096743117566,0.5801445009365801
5573,0.5619,5,2,5,600905,4705,101457,6499,0.04358257067694246,0.5800606926097822
5574,0.562,3,6,3,600911,4699,101460,6496,0.04352699247841713,0.5802590442161679
5575,0.5621,9,3,9,600914,4696,101469,6487,0.04349920337915447,0.5800769024412054
5576,0.5622,4,6,4,600920,4690,101473,6483,0.04344362518062914,0.5802380739282198
5577,0.5623,2,8,2,600928,4682,101475,6481,0.04336952091592871,0.5805786974827555
5578,0.5624,6,4,6,600932,4678,101481,6475,0.04333246878357849,0.5805612839594728
5579,0.5625,2,5,2,600937,4673,101483,6473,0.04328615361814073,0.5807464561277589
5580,0.5626,7,10,7,600947,4663,101490,6466,0.04319352328726518,0.5810045826219786
5581,0.5627,7,2,7,600949,4661,101497,6459,0.043174997221090076,0.5808453237410072
5582,0.5628,3,1,3,600950,4660,101500,6456,0.04316573418800252,0.5807844548398705
5583,0.5629,7,5,7,600955,4655,101507,6449,0.04311941902256475,0.5807817002881844
5584,0.563,5,4,5,600959,4651,101512,6444,0.04308236689021453,0.580802163136548
5585,0.5631,6,4,6,600963,4647,101518,6438,0.043045314757864314,0.5807848443843031
5586,0.5632,3,2,3,600965,4645,101521,6435,0.04302678869168921,0.5807761732851986
5587,0.5633,7,4,7,600969,4641,101528,6428,0.04298973655933899,0.5807209323335442
5588,0.5634,6,1,6,600970,4640,101534,6422,0.042980473526251436,0.5805460133791358
5589,0.5635,9,6,9,600976,4634,101543,6413,0.04292489532772611,0.5805195980809269
5590,0.5636,9,6,9,600982,4628,101552,6404,0.042869317129200786,0.5804931109499637
5591,0.5637,8,9,8,600991,4619,101560,6396,0.042785949831412796,0.5806627326373127
5592,0.5638,7,8,7,600999,4611,101567,6389,0.04271184556671236,0.5808181818181818
5593,0.5639,8,8,8,601007,4603,101575,6381,0.04263774130201193,0.5809359067734887
5594,0.564,5,9,5,601016,4594,101580,6376,0.04255437400422394,0.5812215132178669
5595,0.5641,7,5,7,601021,4589,101587,6369,0.042508058838786174,0.5812192005840482
5596,0.5642,5,3,5,601024,4586,101592,6364,0.04248026973952351,0.5811872146118722
5597,0.5643,3,0,3,601024,4586,101595,6361,0.04248026973952351,0.5810724399378825
5598,0.5644,4,6,4,601030,4580,101599,6357,0.042424691540998184,0.5812379994514035
5599,0.5645,7,4,7,601034,4576,101606,6350,0.04238763940864797,0.581182500457624
5600,0.5646,4,7,4,601041,4569,101610,6346,0.04232279817703509,0.5814017407237746
5601,0.5647,8,7,8,601048,4562,101618,6338,0.04225795694542221,0.5814678899082569
5602,0.5648,1,4,1,601052,4558,101619,6337,0.042220904813071995,0.581642955484167
5603,0.5649,6,3,6,601055,4555,101625,6331,0.04219311571380933,0.5815726621348521
5604,0.565,8,4,8,601059,4551,101633,6323,0.04215606358145911,0.5814787566672798
5605,0.5651,3,10,3,601069,4541,101636,6320,0.04206343325058357,0.5818985360464045
5606,0.5652,1,3,1,601072,4538,101637,6319,0.04203564415132091,0.5820208160633693
5607,0.5653,3,6,3,601078,4532,101640,6316,0.04198006595279558,0.5822271386430679
5608,0.5654,5,1,5,601079,4531,101645,6311,0.041970802919708027,0.5820881756133555
5609,0.5655,4,8,4,601087,4523,101649,6307,0.04189669865500759,0.5823638042474607
5610,0.5656,1,5,1,601092,4518,101650,6306,0.04185038348956983,0.5825942350332595
5611,0.5657,5,4,5,601096,4514,101655,6301,0.04181333135721961,0.5826167360147942
5612,0.5658,8,6,8,601102,4508,101663,6293,0.04175775315869428,0.5826312378483474
5613,0.5659,6,2,6,601104,4506,101669,6287,0.04173922709251918,0.5825071805800056
5614,0.566,4,8,4,601112,4498,101673,6283,0.04166512282781874,0.582784528336889
5615,0.5661,5,6,5,601118,4492,101678,6278,0.041609544629293414,0.5829155060352832
5616,0.5662,4,4,4,601122,4488,101682,6274,0.0415724924969432,0.5829771417952053
5617,0.5663,6,10,6,601132,4478,101688,6268,0.04147986216606766,0.583286804392332
5618,0.5664,4,4,4,601136,4474,101692,6264,0.04144281003371744,0.5833488545352952
5619,0.5665,3,4,3,601140,4470,101695,6261,0.041405757901367225,0.5834498182834778
5620,0.5666,4,5,4,601145,4465,101699,6257,0.04135944273592945,0.5835664987875396
5621,0.5667,5,3,5,601148,4462,101704,6252,0.04133165363666679,0.583535560948292
5622,0.5668,2,3,2,601151,4459,101706,6250,0.04130386453740413,0.5836212531515548
5623,0.5669,4,5,4,601156,4454,101710,6246,0.04125754937196636,0.5837383177570094
5624,0.567,6,4,6,601160,4450,101716,6240,0.04122049723961614,0.5837231057062675
5625,0.5671,5,7,5,601167,4443,101721,6235,0.041155656008003264,0.583910844727477
5626,0.5672,2,8,2,601175,4435,101723,6233,0.04108155174330283,0.58427071616048
5627,0.5673,7,6,7,601181,4429,101730,6226,0.0410259735447775,0.5843266072266542
5628,0.5674,5,3,5,601184,4426,101735,6221,0.04099818444551484,0.5842960458345073
5629,0.5675,5,4,5,601188,4422,101740,6216,0.040961132313164623,0.5843203609701072
5630,0.5676,6,3,6,601191,4419,101746,6210,0.04093334321390196,0.584250635055038
5631,0.5677,2,1,2,601192,4418,101748,6208,0.04092408018081441,0.5842273668360625
5632,0.5678,3,4,3,601196,4414,101751,6205,0.04088702804846419,0.584329974573877
5633,0.5679,3,4,3,601200,4410,101754,6202,0.04084997591611397,0.5844327176781002
5634,0.568,4,3,4,601203,4407,101758,6198,0.04082218681685131,0.5844413012729844
5635,0.5681,2,2,2,601205,4405,101760,6196,0.0408036607506762,0.5844731629091595
5636,0.5682,3,1,3,601206,4404,101763,6193,0.040794397717588644,0.5844106822685666
5637,0.5683,4,3,4,601209,4401,101767,6189,0.040766608618325983,0.5844192634560906
5638,0.5684,4,2,4,601211,4399,101771,6185,0.04074808255215088,0.5843726379440665
5639,0.5685,4,4,4,601215,4395,101775,6181,0.04071103041980066,0.5844364599092284
5640,0.5686,4,1,4,601216,4394,101779,6177,0.040701767386713106,0.5843345000472993
5641,0.5687,6,2,6,601218,4392,101785,6171,0.040683241320537994,0.5842090315251349
5642,0.5688,5,4,5,601222,4388,101790,6166,0.04064618918818778,0.5842334659844609
5643,0.5689,10,4,10,601226,4384,101800,6156,0.04060913705583756,0.5840607210626186
5644,0.569,5,6,5,601232,4378,101805,6151,0.04055355885731224,0.5841960300123469
5645,0.5691,6,4,6,601236,4374,101811,6145,0.04051650672496202,0.5841810057990303
5646,0.5692,2,2,2,601238,4372,101813,6143,0.04049798065878691,0.5842130290061817
5647,0.5693,3,2,3,601240,4370,101816,6140,0.040479454592611805,0.5842055185537584
5648,0.5694,4,5,4,601245,4365,101820,6136,0.04043313942717403,0.584325302352157
5649,0.5695,4,3,4,601248,4362,101824,6132,0.04040535032791137,0.584333905088622
5650,0.5696,5,6,5,601254,4356,101829,6127,0.04034977212938605,0.5844700944386149
5651,0.5697,6,7,6,601261,4349,101835,6121,0.040284930897773165,0.5846227316141356
5652,0.5698,3,1,3,601262,4348,101838,6118,0.040275667864685616,0.5845595260844639
5653,0.5699,5,4,5,601266,4344,101843,6113,0.0402386157323354,0.5845844888591374
5654,0.57,5,3,5,601269,4341,101848,6108,0.04021082663307273,0.5845535457938559
5655,0.5701,6,8,6,601277,4333,101854,6102,0.0401367223683723,0.5847628174413033
5656,0.5702,2,3,2,601280,4330,101856,6100,0.04010893326910964,0.5848513902205177
5657,0.5703,4,4,4,601284,4326,101860,6096,0.04007188113675942,0.584916522740357
5658,0.5704,10,4,10,601288,4322,101870,6086,0.0400348290044092,0.5847425057647964
5659,0.5705,5,8,5,601296,4314,101875,6081,0.03996072473970877,0.584992784992785
5660,0.5706,8,5,8,601301,4309,101883,6073,0.039914409574271,0.584954729339241
5661,0.5707,4,3,4,601304,4306,101887,6069,0.039886620475008336,0.5849638554216867
5662,0.5708,4,4,4,601308,4302,101891,6065,0.03984956834265812,0.5850294202758753
5663,0.5709,6,7,6,601315,4295,101897,6059,0.03978472711104524,0.5851844697701372
5664,0.571,3,8,3,601323,4287,101900,6056,0.03971062284634481,0.5855167746301847
5665,0.5711,6,4,6,601327,4283,101906,6050,0.03967357071399459,0.5855027581534888
5666,0.5712,9,4,9,601331,4279,101915,6041,0.039636518581644374,0.5853682170542636
5667,0.5713,4,4,4,601335,4275,101919,6037,0.03959946644929416,0.5854344453064391
5668,0.5714,0,5,0,601340,4270,101919,6037,0.039553151283856385,0.5857184437760745
5669,0.5715,1,8,1,601348,4262,101920,6036,0.03947904701915595,0.5861332297533501
5670,0.5716,5,2,5,601350,4260,101925,6031,0.039460520952980846,0.5860460596637839
5671,0.5717,6,5,6,601355,4255,101931,6025,0.03941420578754307,0.5860894941634242
5672,0.5718,2,3,2,601358,4252,101933,6023,0.03938641668828041,0.5861800486618005
5673,0.5719,3,5,3,601363,4247,101936,6020,0.03934010152284264,0.5863445992013246
5674,0.572,4,2,4,601365,4245,101940,6016,0.039321575456667535,0.5862976318097651
5675,0.5721,3,2,3,601367,4243,101943,6013,0.03930304939049242,0.5862909516380655
5676,0.5722,2,3,2,601370,4240,101945,6011,0.03927526029122976,0.5863818164081553
5677,0.5723,3,5,3,601375,4235,101948,6008,0.03922894512579199,0.5865469100849361
5678,0.5724,4,7,4,601382,4228,101952,6004,0.03916410389417911,0.5867865519937451
5679,0.5725,4,4,4,601386,4224,101956,6000,0.039127051761828895,0.5868544600938967
5680,0.5726,2,4,2,601390,4220,101958,5998,0.03908999962947868,0.5870033274613428
5681,0.5727,7,3,7,601393,4217,101965,5991,0.03906221053021602,0.5868926332288401
5682,0.5728,3,4,3,601397,4213,101968,5988,0.0390251583978658,0.5870012743848643
5683,0.5729,4,2,4,601399,4211,101972,5984,0.03900663233169069,0.5869543894065719
5684,0.573,1,3,1,601402,4208,101973,5983,0.03897884323242803,0.5870866450789912
5685,0.5731,8,2,8,601404,4206,101981,5975,0.038960317166252915,0.5868775169433258
5686,0.5732,6,5,6,601409,4201,101987,5969,0.03891400200081515,0.5869223205506391
5687,0.5733,0,4,0,601413,4197,101987,5969,0.03887694986846493,0.5871532559512099
5688,0.5734,9,0,9,601413,4197,101996,5960,0.03887694986846493,0.5867874372354042
5689,0.5735,6,3,6,601416,4194,102002,5954,0.038849160769202265,0.586716594402838
5690,0.5736,5,1,5,601417,4193,102007,5949,0.038839897736114716,0.5865706961151647
5691,0.5737,4,3,4,601420,4190,102011,5945,0.03881210863685205,0.5865811544153922
5692,0.5738,8,3,8,601423,4187,102019,5937,0.03878431953758939,0.5864282892137495
5693,0.5739,6,5,6,601428,4182,102025,5931,0.038738004372151615,0.5864728567190745
5694,0.574,4,4,4,601432,4178,102029,5927,0.0387009522398014,0.5865413161801089
5695,0.5741,5,2,5,601434,4176,102034,5922,0.03868242617362629,0.5864527629233511
5696,0.5742,6,5,6,601439,4171,102040,5916,0.03863611100818852,0.5864974719936552
5697,0.5743,5,5,5,601444,4166,102045,5911,0.03858979584275075,0.5865833085243624
5698,0.5744,6,6,6,601450,4160,102051,5905,0.038534217644225426,0.5866865375062096
5699,0.5745,5,5,5,601455,4155,102056,5900,0.03848790247878765,0.5867727498756837
5700,0.5746,4,1,4,601456,4154,102060,5896,0.0384786394457001,0.5866666666666667
5701,0.5747,5,5,5,601461,4149,102065,5891,0.03843232428026233,0.5867529880478087
5702,0.5748,1,2,1,601463,4147,102066,5890,0.03841379821408722,0.5868287336853641
5703,0.5749,6,2,6,601465,4145,102072,5884,0.038395272147912114,0.5866985741350085
5704,0.575,4,4,4,601469,4141,102076,5880,0.0383582200155619,0.5867677876459435
5705,0.5751,4,3,4,601472,4138,102080,5876,0.03833043091629923,0.5867785100858798
5706,0.5752,7,5,7,601477,4133,102087,5869,0.038284115750861464,0.5867826434713057
5707,0.5753,2,4,2,601481,4129,102089,5867,0.03824706361851125,0.5869347739095638
5708,0.5754,7,2,7,601483,4127,102096,5860,0.038228537552336135,0.5867627916291178
5709,0.5755,7,8,7,601491,4119,102103,5853,0.0381544332876357,0.5869434416365824
5710,0.5756,5,2,5,601493,4117,102108,5848,0.038135907221460597,0.5868539889613648
5711,0.5757,3,2,3,601495,4115,102111,5845,0.038117381155285485,0.5868473895582329
5712,0.5758,7,3,7,601498,4112,102118,5838,0.038089592056022824,0.5867336683417086
5713,0.5759,3,2,3,601500,4110,102121,5835,0.03807106598984772,0.5867269984917044
5714,0.576,4,5,4,601505,4105,102125,5831,0.038024750824409946,0.5868558776167472
5715,0.5761,7,6,7,601511,4099,102132,5824,0.03796917262588462,0.5869192784440189
5716,0.5762,9,5,9,601516,4094,102141,5815,0.03792285746044685,0.5868402462407912
5717,0.5763,5,3,5,601519,4091,102146,5810,0.037895068361184184,0.5868094131905868
5718,0.5764,3,5,3,601524,4086,102149,5807,0.03784875319574642,0.5869806934195896
5719,0.5765,7,5,7,601529,4081,102156,5800,0.037802438030308645,0.5869851229632628
5720,0.5766,4,3,4,601532,4078,102160,5796,0.037774648931045984,0.5869961515090135
5721,0.5767,4,5,4,601537,4073,102164,5792,0.03772833376560821,0.5871262037506335
5722,0.5768,4,6,4,601543,4067,102168,5788,0.03767275556708288,0.5873160832064942
5723,0.5769,5,2,5,601545,4065,102173,5783,0.03765422950090778,0.587225832656377
5724,0.577,5,3,5,601548,4062,102178,5778,0.03762644040164512,0.5871951219512195
5725,0.5771,5,5,5,601553,4057,102183,5773,0.037580125236207344,0.5872838250254323
5726,0.5772,4,4,4,601557,4053,102187,5769,0.03754307310385713,0.5873549175320708
5727,0.5773,4,2,4,601559,4051,102191,5765,0.037524547037682016,0.5873064384678076
5728,0.5774,5,3,5,601562,4048,102196,5760,0.037496757938419355,0.5872756933115824
5729,0.5775,4,4,4,601566,4044,102200,5756,0.03745970580606914,0.5873469387755103
5730,0.5776,3,6,3,601572,4038,102203,5753,0.037404127607543816,0.5875804310080687
5731,0.5777,7,1,7,601573,4037,102210,5746,0.03739486457445626,0.5873453950730859
5732,0.5778,5,1,5,601574,4036,102215,5741,0.037385601541368704,0.5871944359210391
5733,0.5779,2,2,2,601576,4034,102217,5739,0.0373670754751936,0.5872301238104983
5734,0.578,4,3,4,601579,4031,102221,5735,0.03733928637593093,0.5872414499283227
5735,0.5781,2,3,2,601582,4028,102223,5733,0.03731149727666827,0.587337362975105
5736,0.5782,1,8,1,601590,4020,102224,5732,0.03723739301196784,0.5877768662838392
5737,0.5783,3,1,3,601591,4019,102227,5729,0.03722812997888029,0.5877102995486254
5738,0.5784,2,2,2,601593,4017,102229,5727,0.037209603912705176,0.5877463054187192
5739,0.5785,5,3,5,601596,4014,102234,5722,0.037181814813442515,0.5877156943303204
5740,0.5786,6,4,6,601600,4010,102240,5716,0.0371447626810923,0.5877030639522928
5741,0.5787,9,6,9,601606,4004,102249,5707,0.03708918448256697,0.5876840696117804
5742,0.5788,4,1,4,601607,4003,102253,5703,0.03707992144947942,0.5875746960642901
5743,0.5789,3,3,3,601610,4000,102256,5700,0.03705213235021675,0.5876288659793815
5744,0.579,7,3,7,601613,3997,102263,5693,0.03702434325095409,0.5875128998968008
5745,0.5791,7,3,7,601616,3994,102270,5686,0.03699655415169143,0.5873966942148761
5746,0.5792,7,4,7,601620,3990,102277,5679,0.036959502019341214,0.5873409866583928
5747,0.5793,6,3,6,601623,3987,102283,5673,0.036931712920078553,0.5872670807453416
5748,0.5794,2,4,2,601627,3983,102285,5671,0.03689466078772834,0.5874249015951937
5749,0.5795,4,2,4,601629,3981,102289,5667,0.036876134721553225,0.5873756218905473
5750,0.5796,6,5,6,601634,3976,102295,5661,0.03682981955611545,0.5874234720348657
5751,0.5797,6,6,6,601640,3970,102301,5655,0.03677424135759013,0.5875324675324676
5752,0.5798,6,8,6,601648,3962,102307,5649,0.0367001370928897,0.5877640203932993
5753,0.5799,7,6,7,601654,3956,102314,5642,0.03664455889436437,0.5878307980829339
5754,0.58,3,1,3,601655,3955,102317,5639,0.03663529586127682,0.5877631853241609
5755,0.5801,4,4,4,601659,3951,102321,5635,0.0365982437289266,0.587836428124348
5756,0.5802,3,3,3,601662,3948,102324,5632,0.036570454629663934,0.5878914405010438
5757,0.5803,1,5,1,601667,3943,102325,5631,0.03652413946422617,0.58815542093169
5758,0.5804,4,3,4,601670,3940,102329,5627,0.0364963503649635,0.5881676596634263
5759,0.5805,3,6,3,601676,3934,102332,5624,0.03644077216643818,0.5884076166562042
5760,0.5806,5,5,5,601681,3929,102337,5619,0.036394457001000406,0.5885002094679515
5761,0.5807,6,2,6,601683,3927,102343,5613,0.0363759309348253,0.5883647798742139
5762,0.5808,7,5,7,601688,3922,102350,5606,0.03632961576938753,0.5883711167086482
5763,0.5809,2,7,2,601695,3915,102352,5604,0.03626477453777465,0.58871730223763
5764,0.581,7,4,7,601699,3911,102359,5597,0.036227722405424434,0.5886621792175011
5765,0.5811,7,1,7,601700,3910,102366,5590,0.03621845937233688,0.588421052631579
5766,0.5812,6,2,6,601702,3908,102372,5584,0.036199933306161766,0.5882848714707122
5767,0.5813,2,7,2,601709,3901,102374,5582,0.03613509207454889,0.5886322893599072
5768,0.5814,4,2,4,601711,3899,102378,5578,0.036116566008373784,0.5885828848791812
5769,0.5815,3,4,3,601715,3895,102381,5575,0.03607951387602357,0.58870116156283
5770,0.5816,3,6,3,601721,3889,102384,5572,0.03602393567749824,0.5889440862488109
5771,0.5817,5,2,5,601723,3887,102389,5567,0.03600540961132313,0.5888512798815316
5772,0.5818,1,8,1,601731,3879,102390,5566,0.0359313053466227,0.5893065113816834
5773,0.5819,5,2,5,601733,3877,102395,5561,0.03591277928044759,0.5892138164865438
5774,0.582,2,4,2,601737,3873,102397,5559,0.03587572714809737,0.5893765903307888
5775,0.5821,4,3,4,601740,3870,102401,5555,0.03584793804883471,0.5893899204244032
5776,0.5822,5,5,5,601745,3865,102406,5550,0.03580162288339694,0.5894848645778014
5777,0.5823,6,4,6,601749,3861,102412,5544,0.03576457075104672,0.5894736842105263
5778,0.5824,2,3,2,601752,3858,102414,5542,0.03573678165178406,0.5895744680851064
5779,0.5825,2,6,2,601758,3852,102416,5540,0.03568120345325874,0.5898637137989778
5780,0.5826,6,2,6,601760,3850,102422,5534,0.035662677387083626,0.5897271952259164
5781,0.5827,7,2,7,601762,3848,102429,5527,0.03564415132090852,0.5895466666666667
5782,0.5828,1,4,1,601766,3844,102430,5526,0.035607099188558304,0.5897545357524013
5783,0.5829,6,5,6,601771,3839,102436,5520,0.03556078402312053,0.5898066032695801
5784,0.583,4,7,4,601778,3832,102440,5516,0.035495942791507654,0.5900727428326915
5785,0.5831,3,3,3,601781,3829,102443,5513,0.035468153692244986,0.5901305930207664
5786,0.5832,5,4,5,601785,3825,102448,5508,0.03543110155989477,0.5901639344262295
5787,0.5833,6,3,6,601788,3822,102454,5502,0.03540331246063211,0.5900900900900901
5788,0.5834,6,7,6,601795,3815,102460,5496,0.03533847122901923,0.5902695736225969
5789,0.5835,1,5,1,601800,3810,102461,5495,0.03529215606358146,0.5905427189682966
5790,0.5836,3,3,3,601803,3807,102464,5492,0.0352643669643188,0.590601139907517
5791,0.5837,1,4,1,601807,3803,102465,5491,0.03522731483196858,0.5908112760921024
5792,0.5838,1,2,1,601809,3801,102466,5490,0.03520878876579347,0.5908944139489829
5793,0.5839,2,4,2,601813,3797,102468,5488,0.03517173663344325,0.5910608508346796
5794,0.584,3,4,3,601817,3793,102471,5485,0.035134684501093034,0.5911834447079112
5795,0.5841,6,4,6,601821,3789,102477,5479,0.035097632368742825,0.5911739318083729
5796,0.5842,0,2,0,601823,3787,102477,5479,0.03507910630256771,0.5913015324843514
5797,0.5843,1,3,1,601826,3784,102478,5478,0.03505131720330505,0.5914489311163895
5798,0.5844,7,4,7,601830,3780,102485,5471,0.035014265070954835,0.5913955248081288
5799,0.5845,6,4,6,601834,3776,102491,5465,0.03497721293860462,0.5913862136132453
5800,0.5846,2,2,2,601836,3774,102493,5463,0.034958686872429506,0.5914257875933745
5801,0.5847,5,9,5,601845,3765,102498,5458,0.034875319574641524,0.5917814160251545
5802,0.5848,7,7,7,601852,3758,102505,5451,0.03481047834302864,0.5919209468997719
5803,0.5849,4,7,4,601859,3751,102509,5447,0.03474563711141576,0.5921939552076538
5804,0.585,2,1,2,601860,3750,102511,5445,0.034736374078328205,0.5921696574225123
5805,0.5851,5,2,5,601862,3748,102516,5440,0.0347178480121531,0.5920766216804527
5806,0.5852,4,8,4,601870,3740,102520,5436,0.03464374374745267,0.5924149956408021
5807,0.5853,6,6,6,601876,3734,102526,5430,0.03458816554892734,0.5925360104757748
5808,0.5854,2,3,2,601879,3731,102528,5428,0.03456037644966468,0.5926411180259854
5809,0.5855,8,6,8,601885,3725,102536,5420,0.034504798251139356,0.5926735921268452
5810,0.5856,4,4,4,601889,3721,102540,5416,0.03446774611878914,0.5927547335011492
5811,0.5857,5,3,5,601892,3718,102545,5411,0.03443995701952647,0.5927264760652865
5812,0.5858,6,5,6,601897,3713,102551,5405,0.034393641854088705,0.5927835051546392
5813,0.5859,5,5,5,601902,3708,102556,5400,0.03434732668865093,0.5928853754940712
5814,0.586,7,4,7,601906,3704,102563,5393,0.034310274556300716,0.5928328020226449
5815,0.5861,1,5,1,601911,3699,102564,5392,0.03426395939086294,0.5931140688593114
5816,0.5862,3,4,3,601915,3695,102567,5389,0.034226907258512726,0.5932408630559225
5817,0.5863,5,4,5,601919,3691,102572,5384,0.03418985512616251,0.5932782369146006
5818,0.5864,4,3,4,601922,3688,102576,5380,0.03416206602689985,0.5932951036612263
5819,0.5865,3,3,3,601925,3685,102579,5377,0.03413427692763719,0.5933568748620613
5820,0.5866,7,5,7,601930,3680,102586,5370,0.034087961762199415,0.5933701657458563
5821,0.5867,4,3,4,601933,3677,102590,5366,0.034060172662936754,0.5933871502819861
5822,0.5868,8,0,8,601933,3677,102598,5358,0.034060172662936754,0.5930271167681239
5823,0.5869,3,1,3,601934,3676,102601,5355,0.0340509096298492,0.592957590521537
5824,0.587,1,6,1,601940,3670,102602,5354,0.033995331431323876,0.5933067375886525
5825,0.5871,5,3,5,601943,3667,102607,5349,0.03396754233206121,0.5932786157941438
5826,0.5872,3,3,3,601946,3664,102610,5346,0.03393975323279855,0.5933407325194229
5827,0.5873,2,3,2,601949,3661,102612,5344,0.033911964133535887,0.5934480843975569
5828,0.5874,5,8,5,601957,3653,102617,5339,0.03383785986883545,0.59375
5829,0.5875,3,2,3,601959,3651,102620,5336,0.03381933380266034,0.5937465227550907
5830,0.5876,3,3,3,601962,3648,102623,5333,0.03379154470339768,0.5938091526556063
5831,0.5877,3,2,3,601964,3646,102626,5330,0.033773018637222575,0.5938057040998217
5832,0.5878,2,4,2,601968,3642,102628,5328,0.03373596650487236,0.5939799331103679
5833,0.5879,2,2,2,601970,3640,102630,5326,0.033717440438697246,0.5940218603613652
5834,0.588,4,4,4,601974,3636,102634,5322,0.03368038830634703,0.59410582719357
5835,0.5881,9,3,9,601977,3633,102643,5313,0.03365259920708437,0.5938967136150235
5836,0.5882,4,7,4,601984,3626,102647,5309,0.03358775797547149,0.5941801902630106
5837,0.5883,5,5,5,601989,3621,102652,5304,0.03354144281003372,0.5942857142857143
5838,0.5884,0,2,0,601991,3619,102652,5304,0.033522916743858606,0.5944189174044604
5839,0.5885,5,7,5,601998,3612,102657,5299,0.03345807551224573,0.5946582875098193
5840,0.5886,8,4,8,602002,3608,102665,5291,0.03342102337989551,0.5945611866501854
5841,0.5887,5,2,5,602004,3606,102670,5286,0.03340249731372041,0.5944669365721997
5842,0.5888,5,5,5,602009,3601,102675,5281,0.033356182148282634,0.5945732943030849
5843,0.5889,3,9,3,602018,3592,102678,5278,0.033272814850494645,0.5950394588500564
5844,0.589,2,1,2,602019,3591,102680,5276,0.03326355181740709,0.5950152249915417
5845,0.5891,3,4,3,602023,3587,102683,5273,0.03322649968505687,0.5951467268623025
5846,0.5892,2,3,2,602026,3584,102685,5271,0.03319871058579421,0.5952569169960474
5847,0.5893,1,3,1,602029,3581,102686,5270,0.03317092148653155,0.5954129476895266
5848,0.5894,4,2,4,602031,3579,102690,5266,0.03315239542035644,0.5953646127755794
5849,0.5895,3,6,3,602037,3573,102693,5263,0.03309681722183112,0.5956315074694432
5850,0.5896,5,3,5,602040,3570,102698,5258,0.033069028122568456,0.5956048935206162
5851,0.5897,4,7,4,602047,3563,102702,5254,0.03300418689095557,0.595894295111716
5852,0.5898,4,4,4,602051,3559,102706,5250,0.03296713475860536,0.5959813826768078
5853,0.5899,1,2,1,602053,3557,102707,5249,0.03294860869243025,0.5960708607767431
5854,0.59,5,2,5,602055,3555,102712,5244,0.032930082626255144,0.5959768155472213
5855,0.5901,3,5,3,602060,3550,102715,5241,0.03288376746081737,0.5961779092253441
5856,0.5902,4,7,4,602067,3543,102719,5237,0.032818926229204494,0.5964692482915718
5857,0.5903,4,1,4,602068,3542,102723,5233,0.03280966319611694,0.5963532763532764
5858,0.5904,5,2,5,602070,3540,102728,5228,0.032791137129941826,0.5962591240875912
5859,0.5905,3,5,3,602075,3535,102731,5225,0.03274482196450406,0.5964611872146118
5860,0.5906,1,2,1,602077,3533,102732,5224,0.03272629589832895,0.59655133036428
5861,0.5907,3,7,3,602084,3526,102735,5221,0.03266145466671607,0.5968903624099692
5862,0.5908,3,4,3,602088,3522,102738,5218,0.032624402534365854,0.5970251716247139
5863,0.5909,5,2,5,602090,3520,102743,5213,0.03260587646819074,0.5969311805794114
5864,0.591,3,0,3,602090,3520,102746,5210,0.03260587646819074,0.5967926689576174
5865,0.5911,3,4,3,602094,3516,102749,5207,0.032568824335840525,0.596927662501433
5866,0.5912,4,6,4,602100,3510,102753,5203,0.0325132461373152,0.597153678411569
5867,0.5913,2,5,2,602105,3505,102755,5201,0.03246693097187743,0.5974040891339306
5868,0.5914,5,4,5,602109,3501,102760,5196,0.032429878839527214,0.5974473956536737
5869,0.5915,4,3,4,602112,3498,102764,5192,0.03240208974026455,0.5974683544303797
5870,0.5916,4,1,4,602113,3497,102768,5188,0.032392826707177,0.5973517559009787
5871,0.5917,6,5,6,602118,3492,102774,5182,0.032346511541739224,0.5974175697486742
5872,0.5918,5,3,5,602121,3489,102779,5177,0.03231872244247656,0.5973921070851604
5873,0.5919,3,5,3,602126,3484,102782,5174,0.03227240727703879,0.5975975975975976
5874,0.592,4,8,4,602134,3476,102786,5170,0.03219830301233836,0.5979643765903307
5875,0.5921,2,4,2,602138,3472,102788,5168,0.03216125087998814,0.5981481481481481
5876,0.5922,4,4,4,602142,3468,102792,5164,0.03212419874763792,0.598239110287303
5877,0.5923,3,3,3,602145,3465,102795,5161,0.03209640964837526,0.598307442615349
5878,0.5924,2,2,2,602147,3463,102797,5159,0.03207788358220016,0.5983530503363489
5879,0.5925,4,3,4,602150,3460,102801,5155,0.03205009448293749,0.5983749274521184
5880,0.5926,1,2,1,602152,3458,102802,5154,0.032031568416762385,0.598467254993033
5881,0.5927,4,5,4,602157,3453,102806,5150,0.03198525325132461,0.5986283854469371
5882,0.5928,3,6,3,602163,3447,102809,5147,0.03192967505279929,0.5989062136374215
5883,0.5929,5,3,5,602166,3444,102814,5142,0.03190188595353663,0.5988819007686932
5884,0.593,3,2,3,602168,3442,102817,5139,0.03188335988736152,0.5988812492716467
5885,0.5931,6,2,6,602170,3440,102823,5133,0.03186483382118641,0.5987402309576577
5886,0.5932,5,7,5,602177,3433,102828,5128,0.03179999258957353,0.5989954444574231
5887,0.5933,3,3,3,602180,3430,102831,5125,0.03177220349031087,0.5990648743424898
5888,0.5934,5,4,5,602184,3426,102836,5120,0.03173515135796065,0.5991106950620173
5889,0.5935,1,3,1,602187,3423,102837,5119,0.03170736225869799,0.5992741746663545
5890,0.5936,9,7,9,602194,3416,102846,5110,0.03164252102708511,0.5993431855500821
5891,0.5937,4,4,4,602198,3412,102850,5106,0.031605468894734895,0.5994364874383659
5892,0.5938,1,2,1,602200,3410,102851,5105,0.03158694282855978,0.5995302407516148
5893,0.5939,0,5,0,602205,3405,102851,5105,0.03154062766312201,0.599882491186839
5894,0.594,7,4,7,602209,3401,102858,5098,0.031503575530771794,0.5998352747382045
5895,0.5941,3,3,3,602212,3398,102861,5095,0.03147578643150913,0.5999058047804074
5896,0.5942,5,6,5,602218,3392,102866,5090,0.03142020823298381,0.6000943173779769
5897,0.5943,2,5,2,602223,3387,102868,5088,0.03137389306754604,0.600353982300885
5898,0.5944,6,3,6,602226,3384,102874,5082,0.03134610396828338,0.6002834868887313
5899,0.5945,1,5,1,602231,3379,102875,5081,0.031299788802845604,0.6005910165484634
5900,0.5946,4,6,4,602237,3373,102879,5077,0.03124421060432028,0.6008284023668639
5901,0.5947,3,4,3,602241,3369,102882,5074,0.031207158471970062,0.6009712187611038
5902,0.5948,5,4,5,602245,3365,102887,5069,0.031170106339619846,0.6010196822385582
5903,0.5949,6,7,6,602252,3358,102893,5063,0.031105265108006964,0.6012350077187982
5904,0.595,4,7,4,602259,3351,102897,5059,0.031040423876394087,0.6015457788347206
5905,0.5951,3,5,3,602264,3346,102900,5056,0.030994108710956314,0.6017614853606285
5906,0.5952,7,5,7,602269,3341,102907,5049,0.030947793545518545,0.6017878426698451
5907,0.5953,3,5,3,602274,3336,102910,5046,0.030901478380080772,0.6020042949176807
5908,0.5954,2,2,2,602276,3334,102912,5044,0.030882952313905664,0.6020529959417522
5909,0.5955,5,4,5,602280,3330,102917,5039,0.03084590018155545,0.6021029991635799
5910,0.5956,5,4,5,602284,3326,102922,5034,0.030808848049205233,0.6021531100478469
5911,0.5957,1,5,1,602289,3321,102923,5033,0.03076253288376746,0.6024658846061767
5912,0.5958,3,5,3,602294,3316,102926,5030,0.03071621771832969,0.6026839204409298
5913,0.5959,1,4,1,602298,3312,102927,5029,0.030679165585979475,0.6029253087159813
5914,0.596,8,1,8,602299,3311,102935,5021,0.03066990255289192,0.6026164186269803
5915,0.5961,5,1,5,602300,3310,102940,5016,0.030660639519804366,0.6024501561374009
5916,0.5962,6,2,6,602302,3308,102946,5010,0.030642113453629258,0.6023082471748016
5917,0.5963,3,4,3,602306,3304,102949,5007,0.03060506132127904,0.602454578269763
5918,0.5964,3,5,3,602311,3299,102952,5004,0.030558746155841268,0.6026737323858846
5919,0.5965,5,2,5,602313,3297,102957,4999,0.03054022008966616,0.602579556412729
5920,0.5966,5,5,5,602318,3292,102962,4994,0.03049390492422839,0.6027033550567222
5921,0.5967,4,6,4,602324,3286,102966,4990,0.030438326725703065,0.6029482841952634
5922,0.5968,4,2,4,602326,3284,102970,4986,0.030419800659527957,0.6029020556227328
5923,0.5969,5,6,5,602332,3278,102975,4981,0.03036422246100263,0.6030996488679017
5924,0.597,4,6,4,602338,3272,102979,4977,0.030308644262477306,0.6033458601042551
5925,0.5971,7,1,7,602339,3271,102986,4970,0.03029938122938975,0.6030821502244873
5926,0.5972,3,4,3,602343,3267,102989,4967,0.030262329097039534,0.6032305076512023
5927,0.5973,4,0,4,602343,3267,102993,4963,0.030262329097039534,0.6030376670716889
5928,0.5974,6,3,6,602346,3264,102999,4957,0.030234539997776873,0.6029680087580587
5929,0.5975,4,1,4,602347,3263,103003,4953,0.030225276964689317,0.6028481012658228
5930,0.5976,5,6,5,602353,3257,103008,4948,0.03016969876616399,0.6030469226081657
5931,0.5977,4,2,4,602355,3255,103012,4944,0.030151172699988883,0.6030003658982803
5932,0.5978,4,4,4,602359,3251,103016,4940,0.030114120567638666,0.6031009644732023
5933,0.5979,5,3,5,602362,3248,103021,4935,0.030086331468376006,0.6030795551753636
5934,0.598,5,4,5,602366,3244,103026,4930,0.03004927933602579,0.603131881575728
5935,0.5981,5,4,5,602370,3240,103031,4925,0.030012227203675572,0.6031843233312921
5936,0.5982,5,1,5,602371,3239,103036,4920,0.030002964170588016,0.6030150753768844
5937,0.5983,3,3,3,602374,3236,103039,4917,0.029975175071325355,0.6030908867901386
5938,0.5984,2,2,2,602376,3234,103041,4915,0.029956649005150247,0.6031414897533439
5939,0.5985,2,3,2,602379,3231,103043,4913,0.029928859905887582,0.6032662082514735
5940,0.5986,4,3,4,602382,3228,103047,4909,0.02990107080662492,0.6032935971488264
5941,0.5987,2,1,2,602383,3227,103049,4907,0.029891807773537366,0.6032702237521514
5942,0.5988,1,8,1,602391,3219,103050,4906,0.029817703508836932,0.6038153846153846
5943,0.5989,7,2,7,602393,3217,103057,4899,0.029799177442661823,0.6036224741251848
5944,0.599,5,5,5,602398,3212,103062,4894,0.029752862277224054,0.6037503084135208
5945,0.5991,6,3,6,602401,3209,103068,4888,0.029725073177961393,0.6036803754476967
5946,0.5992,2,1,2,602402,3208,103070,4886,0.029715810144873837,0.6036570298986904
5947,0.5993,4,3,4,602405,3205,103074,4882,0.029688021045611176,0.6036849264251267
5948,0.5994,3,1,3,602406,3204,103077,4879,0.02967875801252362,0.6036125201039219
5949,0.5995,1,4,1,602410,3200,103078,4878,0.029641705880173404,0.603862342163902
5950,0.5996,3,2,3,602412,3198,103081,4875,0.029623179813998295,0.6038647342995169
5951,0.5997,4,0,4,602412,3198,103085,4871,0.029623179813998295,0.6036683603916223
5952,0.5998,4,2,4,602414,3196,103089,4867,0.029604653747823187,0.6036214808383976
5953,0.5999,4,1,4,602415,3195,103093,4863,0.029595390714735634,0.603499627699181
5954,0.6,1,3,1,602418,3192,103094,4862,0.02956760161547297,0.603675192450956
5955,0.6001,7,5,7,602423,3187,103101,4855,0.0295212864500352,0.6037055458841084
5956,0.6002,3,4,3,602427,3183,103104,4852,0.029484234317684984,0.603858120721842
5957,0.6003,7,3,7,602430,3180,103111,4845,0.02945644521842232,0.6037383177570094
5958,0.6004,4,3,4,602433,3177,103115,4841,0.02942865611915966,0.6037665253180344
5959,0.6005,4,3,4,602436,3174,103119,4837,0.029400867019896994,0.6037947821745101
5960,0.6006,6,5,6,602441,3169,103125,4831,0.029354551854459225,0.603875
5961,0.6007,3,2,3,602443,3167,103128,4828,0.029336025788284117,0.6038774233896185
5962,0.6008,1,3,1,602446,3164,103129,4827,0.029308236689021452,0.6040545613815542
5963,0.6009,3,5,3,602451,3159,103132,4824,0.029261921523583683,0.6042841037204059
5964,0.601,2,1,2,602452,3158,103134,4822,0.029252658490496127,0.6042606516290727
5965,0.6011,5,3,5,602455,3155,103139,4817,0.029224869391233466,0.6042398394380332
5966,0.6012,3,3,3,602458,3152,103142,4814,0.029197080291970802,0.604318353000251
5967,0.6013,3,3,3,602461,3149,103145,4811,0.02916929119270814,0.6043969849246231
5968,0.6014,3,5,3,602466,3144,103148,4808,0.02912297602727037,0.6046277665995976
5969,0.6015,4,5,4,602471,3139,103152,4804,0.0290766608618326,0.6048092660203953
5970,0.6016,3,2,3,602473,3137,103155,4801,0.02905813479565749,0.6048122952884858
5971,0.6017,6,7,6,602480,3130,103161,4795,0.02899329356404461,0.6050473186119874
5972,0.6018,2,2,2,602482,3128,103163,4793,0.0289747674978695,0.6051003661153894
5973,0.6019,6,8,6,602490,3120,103169,4787,0.028900663233169067,0.6054129252561022
5974,0.602,5,6,5,602496,3114,103174,4782,0.028845085034643742,0.6056231003039514
5975,0.6021,1,3,1,602499,3111,103175,4781,0.02881729593538108,0.6058033451596554
5976,0.6022,3,3,3,602502,3108,103178,4778,0.028789506836118417,0.6058838447882323
5977,0.6023,2,5,2,602507,3103,103180,4776,0.028743191670680648,0.6061682954689681
5978,0.6024,3,2,3,602509,3101,103183,4773,0.02872466560450554,0.6061722123444246
5979,0.6025,3,2,3,602511,3099,103186,4770,0.02870613953833043,0.6061761341974838
5980,0.6026,5,4,5,602515,3095,103191,4765,0.028669087405980214,0.6062340966921119
5981,0.6027,4,0,4,602515,3095,103195,4761,0.028669087405980214,0.6060336048879837
5982,0.6028,5,0,5,602515,3095,103200,4756,0.028669087405980214,0.6057827028404025
5983,0.6029,7,4,7,602519,3091,103207,4749,0.028632035273629997,0.6057397959183674
5984,0.603,5,4,5,602523,3087,103212,4744,0.02859498314127978,0.6057974715872814
5985,0.6031,1,6,1,602529,3081,103213,4743,0.028539404942754455,0.6062116564417178
5986,0.6032,4,3,4,602532,3078,103217,4739,0.028511615843491794,0.6062428041448126
5987,0.6033,3,4,3,602536,3074,103220,4736,0.028474563711141578,0.6064020486555698
5988,0.6034,5,1,5,602537,3073,103225,4731,0.02846530067805402,0.6062275756022553
5989,0.6035,2,2,2,602539,3071,103227,4729,0.028446774611878913,0.6062820512820513
5990,0.6036,4,3,4,602542,3068,103231,4725,0.028418985512616252,0.6063133581419222
5991,0.6037,5,3,5,602545,3065,103236,4720,0.028391196413353588,0.6062941554271034
5992,0.6038,3,2,3,602547,3063,103239,4717,0.02837267034717848,0.6062982005141389
5993,0.6039,6,3,6,602550,3060,103245,4711,0.02834488124791582,0.6062282846480505
5994,0.604,6,2,6,602552,3058,103251,4705,0.02832635518174071,0.6060801236635321
5995,0.6041,3,3,3,602555,3055,103254,4702,0.028298566082478046,0.6061621760990074
5996,0.6042,3,1,3,602556,3054,103257,4699,0.028289303049390493,0.606087965948665
5997,0.6043,1,2,1,602558,3052,103258,4698,0.028270776983215385,0.6061935483870968
5998,0.6044,4,1,4,602559,3051,103262,4694,0.02826151395012783,0.6060684312459651
5999,0.6045,3,1,3,602560,3050,103265,4691,0.028252250917040277,0.6059940576152952
6000,0.6046,4,5,4,602565,3045,103269,4687,0.028205935751602504,0.6061821003621314
6001,0.6047,1,4,1,602569,3041,103270,4686,0.028168883619252287,0.6064449333505888
6002,0.6048,4,3,4,602572,3038,103274,4682,0.028141094519989626,0.6064766839378238
6003,0.6049,3,2,3,602574,3036,103277,4679,0.028122568453814518,0.6064808813998703
6004,0.605,5,4,5,602578,3032,103282,4674,0.0280855163214643,0.6065403581624708
6005,0.6051,2,4,2,602582,3028,103284,4672,0.028048464189114084,0.6067532467532467
6006,0.6052,5,2,5,602584,3026,103289,4667,0.028029938122938976,0.6066554010139088
6007,0.6053,4,5,4,602589,3021,103293,4663,0.027983622957501203,0.6068453930244664
6008,0.6054,3,5,3,602594,3016,103296,4660,0.027937307792063434,0.6070870244919229
6009,0.6055,7,1,7,602595,3015,103303,4653,0.027928044758975878,0.6068075117370892
6010,0.6056,2,7,2,602602,3008,103305,4651,0.027863203527363,0.6072594333463899
6011,0.6057,2,2,2,602604,3006,103307,4649,0.02784467746118789,0.6073154800783801
6012,0.6058,3,6,3,602610,3000,103310,4646,0.027789099262662566,0.6076379806434737
6013,0.6059,0,7,0,602617,2993,103310,4646,0.027724258031049685,0.6081947898939651
6014,0.606,2,7,2,602624,2986,103312,4644,0.027659416799436808,0.6086500655307995
6015,0.6061,2,3,2,602627,2983,103314,4642,0.027631627700174147,0.6087868852459016
6016,0.6062,4,1,4,602628,2982,103318,4638,0.02762236466708659,0.6086614173228346
6017,0.6063,4,0,4,602628,2982,103322,4634,0.02762236466708659,0.6084558823529411
6018,0.6064,3,1,3,602629,2981,103325,4631,0.02761310163399904,0.6083815028901735
6019,0.6065,5,3,5,602632,2978,103330,4626,0.027585312534736374,0.6083640189374013
6020,0.6066,7,1,7,602633,2977,103337,4619,0.02757604950164882,0.6080832016850974
6021,0.6067,4,4,4,602637,2973,103341,4615,0.027538997369298605,0.6081971534001054
6022,0.6068,2,2,2,602639,2971,103343,4613,0.027520471303123496,0.6082542194092827
6023,0.6069,5,2,5,602641,2969,103348,4608,0.027501945236948388,0.6081562623729708
6024,0.607,4,1,4,602642,2968,103352,4604,0.027492682203860832,0.6080295826730058
6025,0.6071,2,1,2,602643,2967,103354,4602,0.02748341917077328,0.6080063416567578
6026,0.6072,6,3,6,602646,2964,103360,4596,0.027455630071510615,0.6079365079365079
6027,0.6073,3,4,3,602650,2960,103363,4593,0.0274185779391604,0.6081027406328611
6028,0.6074,3,3,3,602653,2957,103366,4590,0.027390788839897737,0.6081886842453955
6029,0.6075,5,3,5,602656,2954,103371,4585,0.027362999740635073,0.6081708449396471
6030,0.6076,3,3,3,602659,2951,103374,4582,0.027335210641372412,0.6082570025222355
6031,0.6077,2,2,2,602661,2949,103376,4580,0.027316684575197304,0.6083145172001594
6032,0.6078,4,2,4,602663,2947,103380,4576,0.027298158509022195,0.6082679782001861
6033,0.6079,3,2,3,602665,2945,103383,4573,0.027279632442847087,0.6082734769885608
6034,0.608,6,2,6,602667,2943,103389,4567,0.02726110637667198,0.6081225033288948
6035,0.6081,2,3,2,602670,2940,103391,4565,0.027233317277409314,0.6082611592271818
6036,0.6082,6,2,6,602672,2938,103397,4559,0.027214791211234206,0.608109910630919
6037,0.6083,3,3,3,602675,2935,103400,4556,0.027187002111971545,0.6081965024696302
6038,0.6084,2,2,2,602677,2933,103402,4554,0.027168476045796437,0.6082543074662748
6039,0.6085,8,4,8,602681,2929,103410,4546,0.02713142391344622,0.6081605351170568
6040,0.6086,4,3,4,602684,2926,103414,4542,0.027103634814183555,0.6081949651847884
6041,0.6087,3,1,3,602685,2925,103417,4539,0.027094371781096003,0.6081189710610932
6042,0.6088,4,3,4,602688,2922,103421,4535,0.02706658268183334,0.6081534129006303
6043,0.6089,4,2,4,602690,2920,103425,4531,0.02704805661565823,0.6081062944571198
6044,0.609,3,0,3,602690,2920,103428,4528,0.02704805661565823,0.6079484425349087
6045,0.6091,5,6,5,602696,2914,103433,4523,0.026992478417132905,0.6081753395186231
6046,0.6092,3,6,3,602702,2908,103436,4520,0.02693690021860758,0.6085083467959074
6047,0.6093,1,4,1,602706,2904,103437,4519,0.026899848086257363,0.6087835107099555
6048,0.6094,4,3,4,602709,2901,103441,4515,0.026872058986994702,0.6088187702265372
6049,0.6095,2,3,2,602712,2898,103443,4513,0.026844269887732038,0.6089596545675348
6050,0.6096,4,0,4,602712,2898,103447,4509,0.026844269887732038,0.6087484811664642
6051,0.6097,3,0,3,602712,2898,103450,4506,0.026844269887732038,0.6085899513776337
6052,0.6098,5,5,5,602717,2893,103455,4501,0.02679795472229427,0.6087368136326752
6053,0.6099,5,1,5,602718,2892,103460,4496,0.026788691689206712,0.6085544125609096
6054,0.61,1,2,1,602720,2890,103461,4495,0.026770165623031604,0.6086662153012864
6055,0.6101,5,0,5,602720,2890,103466,4490,0.026770165623031604,0.6084010840108401
6056,0.6102,5,4,5,602724,2886,103471,4485,0.026733113490681387,0.6084656084656085
6057,0.6103,3,3,3,602727,2883,103474,4482,0.026705324391418726,0.6085539714867617
6058,0.6104,1,3,1,602730,2880,103475,4481,0.026677535292156062,0.6087488113028121
6059,0.6105,5,2,5,602732,2878,103480,4476,0.026659009225980954,0.6086483546369322
6060,0.6106,4,3,4,602735,2875,103484,4472,0.026631220126718293,0.6086838165237511
6061,0.6107,2,2,2,602737,2873,103486,4470,0.026612694060543184,0.6087430205638023
6062,0.6108,0,3,0,602740,2870,103486,4470,0.026584904961280523,0.6089918256130791
6063,0.6109,3,6,3,602746,2864,103489,4467,0.026529326762755198,0.6093302414404583
6064,0.611,6,2,6,602748,2862,103495,4461,0.02651080069658009,0.6091765669807456
6065,0.6111,3,3,3,602751,2859,103498,4458,0.026483011597317425,0.6092660926609266
6066,0.6112,1,5,1,602756,2854,103499,4457,0.026436696431879656,0.6096293256736425
6067,0.6113,3,2,3,602758,2852,103502,4454,0.026418170365704548,0.6096359156857377
6068,0.6114,3,3,3,602761,2849,103505,4451,0.026390381266441883,0.6097260273972602
6069,0.6115,1,6,1,602767,2843,103506,4450,0.026334803067916558,0.6101741395859043
6070,0.6116,2,3,2,602770,2840,103508,4448,0.026307013968653897,0.610318331503842
6071,0.6117,3,2,3,602772,2838,103511,4445,0.02628848790247879,0.610325415350817
6072,0.6118,5,6,5,602778,2832,103516,4440,0.026232909703953464,0.6105610561056105
6073,0.6119,6,0,6,602778,2832,103522,4434,0.026232909703953464,0.6102394715111478
6074,0.612,5,3,5,602781,2829,103527,4429,0.0262051206046908,0.6102232019840176
6075,0.6121,1,3,1,602784,2826,103528,4428,0.02617733150542814,0.6104218362282878
6076,0.6122,4,3,4,602787,2823,103532,4424,0.026149542406165474,0.6104595004829585
6077,0.6123,6,1,6,602788,2822,103538,4418,0.02614027937307792,0.6102209944751381
6078,0.6124,6,1,6,602789,2821,103544,4412,0.026131016339990366,0.6099820268215125
6079,0.6125,4,4,4,602793,2817,103548,4408,0.02609396420764015,0.6101038062283737
6080,0.6126,1,4,1,602797,2813,103549,4407,0.026056912075289932,0.6103878116343491
6081,0.6127,3,3,3,602800,2810,103552,4404,0.02602912297602727,0.6104796229553646
6082,0.6128,2,3,2,602803,2807,103554,4402,0.026001333876764607,0.6106256068802886
6083,0.6129,2,2,2,602805,2805,103556,4400,0.0259828078105895,0.6106870229007634
6084,0.613,3,3,3,602808,2802,103559,4397,0.025955018711326838,0.6107792748992915
6085,0.6131,3,3,3,602811,2799,103562,4394,0.025927229612064173,0.6108716808007786
6086,0.6132,2,5,2,602816,2794,103564,4392,0.025880914446626404,0.6111884219315336
6087,0.6133,3,3,3,602819,2791,103567,4389,0.02585312534736374,0.6112813370473538
6088,0.6134,3,4,3,602823,2787,103570,4386,0.025816073215013523,0.6114596403178586
6089,0.6135,6,4,6,602827,2783,103576,4380,0.025779021082663306,0.6114756386988692
6090,0.6136,2,4,2,602831,2779,103578,4378,0.02574196895031309,0.6117088165432444
6091,0.6137,3,5,3,602836,2774,103581,4375,0.02569565378487532,0.6119737026157505
6092,0.6138,3,2,3,602838,2772,103584,4372,0.02567712771870021,0.6119820828667413
6093,0.6139,1,1,1,602839,2771,103585,4371,0.025667864685612655,0.6120134416129935
6094,0.614,7,1,7,602840,2770,103592,4364,0.025658601652525103,0.6117185309784132
6095,0.6141,2,4,2,602844,2766,103594,4362,0.025621549520174886,0.6119528619528619
6096,0.6142,6,3,6,602847,2763,103600,4356,0.025593760420912222,0.6118836915297092
6097,0.6143,2,2,2,602849,2761,103602,4354,0.025575234354737113,0.6119465917076599
6098,0.6144,3,4,3,602853,2757,103605,4351,0.025538182222386897,0.6121271806415307
6099,0.6145,2,5,2,602858,2752,103607,4349,0.025491867056949127,0.6124489508519927
6100,0.6146,3,4,3,602862,2748,103610,4346,0.02545481492459891,0.6126303918804623
6101,0.6147,4,4,4,602866,2744,103614,4342,0.025417762792248694,0.6127575500987863
6102,0.6148,3,2,3,602868,2742,103617,4339,0.025399236726073585,0.6127665583957068
6103,0.6149,3,5,3,602873,2737,103620,4336,0.025352921560635816,0.6130354870634809
6104,0.615,4,1,4,602874,2736,103624,4332,0.02534365852754826,0.6129032258064516
6105,0.6151,6,3,6,602877,2733,103630,4326,0.0253158694282856,0.6128346791330217
6106,0.6152,5,3,5,602880,2730,103635,4321,0.025288080329022935,0.6128208764714225
6107,0.6153,4,6,4,602886,2724,103639,4317,0.02523250213049761,0.6131231359181935
6108,0.6154,4,1,4,602887,2723,103643,4313,0.025223239097410057,0.6129903354178511
6109,0.6155,0,4,0,602891,2719,103643,4313,0.02518618696505984,0.6133390216154722
6110,0.6156,2,3,2,602894,2716,103645,4311,0.025158397865797176,0.6134908211185428
6111,0.6157,3,5,3,602899,2711,103648,4308,0.025112082700359407,0.6137626442513179
6112,0.6158,4,8,4,602907,2703,103652,4304,0.025037978435658973,0.6142428999571856
6113,0.6159,4,4,4,602911,2699,103656,4300,0.025000926303308756,0.6143734819259894
6114,0.616,2,1,2,602912,2698,103658,4298,0.0249916632702212,0.6143510577472842
6115,0.6161,5,2,5,602914,2696,103663,4293,0.024973137204046092,0.6142509658034053
6116,0.6162,2,2,2,602916,2694,103665,4291,0.024954611137870984,0.6143163922691481
6117,0.6163,1,1,1,602917,2693,103666,4290,0.02494534810478343,0.6143491336101962
6118,0.6164,4,1,4,602918,2692,103670,4286,0.024936085071695875,0.6142161077672685
6119,0.6165,2,6,2,602924,2686,103672,4284,0.02488050687317055,0.6146341463414634
6120,0.6166,8,0,8,602924,2686,103680,4276,0.02488050687317055,0.6141913243320885
6121,0.6167,5,2,5,602926,2684,103685,4271,0.02486198080699544,0.6140905823148813
6122,0.6168,2,4,2,602930,2680,103687,4269,0.024824928674645225,0.6143329975536048
6123,0.6169,3,1,3,602931,2679,103690,4266,0.024815665641557672,0.614254859611231
6124,0.617,2,3,2,602934,2676,103692,4264,0.024787876542295008,0.6144092219020173
6125,0.6171,4,4,4,602938,2672,103696,4260,0.02475082440994479,0.6145412579342181
6126,0.6172,3,5,3,602943,2667,103699,4257,0.024704509244507022,0.6148180242634316
6127,0.6173,5,7,5,602950,2660,103704,4252,0.02463966801289414,0.6151620370370371
6128,0.6174,3,1,3,602951,2659,103707,4249,0.024630404979806588,0.6150839606253619
6129,0.6175,9,4,9,602955,2655,103716,4240,0.02459335284745637,0.6149383611312546
6130,0.6176,4,3,4,602958,2652,103720,4236,0.024565563748193707,0.6149825783972126
6131,0.6177,5,2,5,602960,2650,103725,4231,0.0245470376820186,0.6148815579130941
6132,0.6178,3,4,3,602964,2646,103728,4228,0.024509985549668382,0.615071283095723
6133,0.6179,3,2,3,602966,2644,103731,4225,0.024491459483493273,0.6150822536031446
6134,0.618,6,7,6,602973,2637,103737,4219,0.024426618251880396,0.6153733955659276
6135,0.6181,5,2,5,602975,2635,103742,4214,0.024408092185705287,0.6152723025259161
6136,0.6182,2,2,2,602977,2633,103744,4212,0.02438956611953018,0.6153396639883126
6137,0.6183,1,3,1,602980,2630,103745,4211,0.024361777020267518,0.6155532816839643
6138,0.6184,4,3,4,602983,2627,103749,4207,0.024333987921004854,0.615598478197249
6139,0.6185,1,6,1,602989,2621,103750,4206,0.02427840972247953,0.6160831990625458
6140,0.6186,2,4,2,602993,2617,103752,4204,0.02424135759012931,0.6163319161413282
6141,0.6187,4,6,4,602999,2611,103756,4200,0.024185779391603986,0.6166495375128469
6142,0.6188,4,4,4,603003,2607,103760,4196,0.02414872725925377,0.6167867117448185
6143,0.6189,1,3,1,603006,2604,103761,4195,0.02412093815999111,0.6170025003677011
6144,0.619,5,1,5,603007,2603,103766,4190,0.024111675126903553,0.6168114235242161
6145,0.6191,2,2,2,603009,2601,103768,4188,0.024093149060728444,0.6168802474591251
6146,0.6192,2,2,2,603011,2599,103770,4186,0.024074622994553336,0.6169491525423729
6147,0.6193,3,3,3,603014,2596,103773,4183,0.024046833895290675,0.6170526626346069
6148,0.6194,9,1,9,603015,2595,103782,4174,0.02403757086220312,0.6166346579997045
6149,0.6195,3,1,3,603016,2594,103785,4171,0.024028307829115567,0.6165558019216556
6150,0.6196,2,3,2,603019,2591,103787,4169,0.024000518729852902,0.616715976331361
6151,0.6197,0,4,0,603023,2587,103787,4169,0.023963466597502685,0.6170811130846655
6152,0.6198,3,1,3,603024,2586,103790,4166,0.023954203564415133,0.6170023696682464
6153,0.6199,5,3,5,603027,2583,103795,4161,0.02392641446515247,0.6169928825622776
6154,0.62,1,3,1,603030,2580,103796,4160,0.023898625365889808,0.6172106824925816
6155,0.6201,5,0,5,603030,2580,103801,4155,0.023898625365889808,0.6169265033407573
6156,0.6202,3,3,3,603033,2577,103804,4152,0.023870836266627143,0.6170307623718234
6157,0.6203,4,6,4,603039,2571,103808,4148,0.023815258068101818,0.6173537728828695
6158,0.6204,2,3,2,603042,2568,103810,4146,0.023787468968839157,0.6175156389633601
6159,0.6205,4,3,4,603045,2565,103814,4142,0.023759679869576493,0.6175637393767706
6160,0.6206,4,1,4,603046,2564,103818,4138,0.02375041683648894,0.6174276335422262
6161,0.6207,2,5,2,603051,2559,103820,4136,0.023704101671051168,0.6177744585511575
6162,0.6208,4,1,4,603052,2558,103824,4132,0.023694838637963615,0.6176382660687594
6163,0.6209,1,4,1,603056,2554,103825,4131,0.0236577865056134,0.6179506357516829
6164,0.621,3,3,3,603059,2551,103828,4128,0.023629997406350734,0.6180565952986974
6165,0.6211,2,2,2,603061,2549,103830,4126,0.023611471340175626,0.61812734082397
6166,0.6212,5,4,5,603065,2545,103835,4121,0.02357441920782541,0.6182118211821183
6167,0.6213,2,4,2,603069,2541,103837,4119,0.023537367075475192,0.6184684684684685
6168,0.6214,2,2,2,603071,2539,103839,4117,0.023518841009300084,0.6185396634615384
6169,0.6215,2,2,2,603073,2537,103841,4115,0.023500314943124975,0.6186109440769694
6170,0.6216,3,3,3,603076,2534,103844,4112,0.023472525843862314,0.6187180258802287
6171,0.6217,5,2,5,603078,2532,103849,4107,0.023453999777687206,0.6186172616357886
6172,0.6218,5,2,5,603080,2530,103854,4102,0.023435473711512098,0.6185162846803377
6173,0.6219,2,3,2,603083,2527,103856,4100,0.023407684612249433,0.6186811528595141
6174,0.622,5,1,5,603084,2526,103861,4095,0.02339842157916188,0.6184866334390575
6175,0.6221,4,2,4,603086,2524,103865,4091,0.023379895512986772,0.618442932728647
6176,0.6222,1,0,1,603086,2524,103866,4090,0.023379895512986772,0.618385243423042
6177,0.6223,6,2,6,603088,2522,103872,4084,0.023361369446811664,0.6182258552830759
6178,0.6224,2,0,2,603088,2522,103874,4082,0.023361369446811664,0.6181102362204725
6179,0.6225,3,5,3,603093,2517,103877,4079,0.023315054281373895,0.6184050939963615
6180,0.6226,3,1,3,603094,2516,103880,4076,0.02330579124828634,0.6183252427184466
6181,0.6227,4,2,4,603096,2514,103884,4072,0.02328726518211123,0.6182812025508655
6182,0.6228,3,4,3,603100,2510,103887,4069,0.023250213049761013,0.618483052135583
6183,0.6229,2,6,2,603106,2504,103889,4067,0.02319463485123569,0.6189316694567037
6184,0.623,2,3,2,603109,2501,103891,4065,0.023166845751973027,0.6190983856229059
6185,0.6231,5,2,5,603111,2499,103896,4060,0.02314831968579792,0.6189967982924226
6186,0.6232,4,6,4,603117,2493,103900,4056,0.023092741487272594,0.619331195602382
6187,0.6233,3,2,3,603119,2491,103903,4053,0.023074215421097485,0.6193459657701712
6188,0.6234,2,4,2,603123,2487,103905,4051,0.02303716328874727,0.619608442948914
6189,0.6235,4,5,4,603128,2482,103909,4047,0.022990848123309496,0.6198499004441722
6190,0.6236,0,2,0,603130,2480,103909,4047,0.022972322057134387,0.6200398345334763
6191,0.6237,3,2,3,603132,2478,103912,4044,0.02295379599095928,0.6200551977920883
6192,0.6238,3,1,3,603133,2477,103915,4041,0.022944532957871727,0.6199754525928198
6193,0.6239,4,2,4,603135,2475,103919,4037,0.022926006891696618,0.6199324324324325
6194,0.624,3,2,3,603137,2473,103922,4034,0.02290748082552151,0.619947748578454
6195,0.6241,5,0,5,603137,2473,103927,4029,0.02290748082552151,0.6196554906182713
6196,0.6242,10,3,10,603140,2470,103937,4019,0.022879691726258845,0.619355832948066
6197,0.6243,3,1,3,603141,2469,103940,4016,0.022870428693171293,0.6192752505782575
6198,0.6244,3,7,3,603148,2462,103943,4013,0.02280558746155841,0.6197683397683398
6199,0.6245,5,3,5,603151,2459,103948,4008,0.02277779836229575,0.6197618679449513
6200,0.6246,5,4,5,603155,2455,103953,4003,0.022740746229945534,0.6198513471663054
6201,0.6247,3,3,3,603158,2452,103956,4000,0.02271295713068287,0.6199628022318661
6202,0.6248,5,2,5,603160,2450,103961,3995,0.02269443106450776,0.6198603568657874
6203,0.6249,0,3,0,603163,2447,103961,3995,0.0226666419652451,0.6201490220428438
6204,0.625,5,2,5,603165,2445,103966,3990,0.022648115899069992,0.62004662004662
6205,0.6251,3,4,3,603169,2441,103969,3987,0.022611063766719775,0.6202551337896702
6206,0.6252,3,3,3,603172,2438,103972,3984,0.02258327466745711,0.6203674867642479
6207,0.6253,3,2,3,603174,2436,103975,3981,0.022564748601282002,0.6203833567087425
6208,0.6254,3,6,3,603180,2430,103978,3978,0.022509170402756677,0.6207865168539326
6209,0.6255,2,3,2,603183,2427,103980,3976,0.022481381303494016,0.6209589255036702
6210,0.6256,4,3,4,603186,2424,103984,3972,0.022453592204231352,0.6210131332082551
6211,0.6257,3,7,3,603193,2417,103987,3969,0.022388750972618474,0.6215158158471656
6212,0.6258,3,2,3,603195,2415,103990,3966,0.022370224906443366,0.6215326751292901
6213,0.6259,2,2,2,603197,2413,103992,3964,0.022351698840268257,0.6216089070095656
6214,0.626,6,1,6,603198,2412,103998,3958,0.0223424358071807,0.6213500784929357
6215,0.6261,2,1,2,603199,2411,104000,3956,0.02233317277409315,0.6213287262446993
6216,0.6262,2,3,2,603202,2408,104002,3954,0.022305383674830488,0.6215026721156869
6217,0.6263,4,2,4,603204,2406,104006,3950,0.02228685760865538,0.6214600377595972
6218,0.6264,2,6,2,603210,2400,104008,3948,0.022231279410130055,0.6219281663516069
6219,0.6265,3,1,3,603211,2399,104011,3945,0.0222220163770425,0.6218474148802018
6220,0.6266,2,2,2,603213,2397,104013,3943,0.02220349031086739,0.6219242902208202
6221,0.6267,4,6,4,603219,2391,104017,3939,0.022147912112342065,0.6222748815165877
6222,0.6268,4,1,4,603220,2390,104021,3935,0.022138649079254513,0.6221343873517786
6223,0.6269,2,1,2,603221,2389,104023,3933,0.022129386046166957,0.622113255298956
6224,0.627,4,1,4,603222,2388,104027,3929,0.022120123013079404,0.6219724552794048
6225,0.6271,4,3,4,603225,2385,104031,3925,0.02209233391381674,0.6220285261489699
6226,0.6272,7,4,7,603229,2381,104038,3918,0.022055281781466523,0.6220034926178759
6227,0.6273,1,1,1,603230,2380,104039,3917,0.02204601874837897,0.6220422423376211
6228,0.6274,3,1,3,603231,2379,104042,3914,0.022036755715291415,0.6219609089464484
6229,0.6275,1,1,1,603232,2378,104043,3913,0.022027492682203862,0.621999682085519
6230,0.6276,4,4,4,603236,2374,104047,3909,0.021990440549853645,0.622155021486551
6231,0.6277,2,6,2,603242,2368,104049,3907,0.02193486235132832,0.6226294820717132
6232,0.6278,2,2,2,603244,2366,104051,3905,0.02191633628515321,0.6227077021208739
6233,0.6279,4,7,4,603251,2359,104055,3901,0.02185149505354033,0.6231629392971246
6234,0.628,5,4,5,603255,2355,104060,3896,0.021814442921190114,0.6232602783554632
6235,0.6281,3,2,3,603257,2353,104063,3893,0.021795916855015005,0.6232788984950368
6236,0.6282,1,6,1,603263,2347,104064,3892,0.02174033865648968,0.6238179195383876
6237,0.6283,3,4,3,603267,2343,104067,3889,0.021703286524139463,0.6240372272143774
6238,0.6284,3,2,3,603269,2341,104070,3886,0.021684760457964355,0.6240565280231251
6239,0.6285,1,3,1,603272,2338,104071,3885,0.021656971358701694,0.6242969628796401
6240,0.6286,5,2,5,603274,2336,104076,3880,0.021638445292526585,0.6241956241956242
6241,0.6287,3,3,3,603277,2333,104079,3877,0.02161065619326392,0.6243156199677938
6242,0.6288,5,2,5,603279,2331,104084,3872,0.021592130127088813,0.6242140899564727
6243,0.6289,0,2,0,603281,2329,104084,3872,0.021573604060913704,0.6244154168682471
6244,0.629,2,3,2,603284,2326,104086,3870,0.021545814961651043,0.6245965138799225
6245,0.6291,4,1,4,603285,2325,104090,3866,0.021536551928563488,0.6244548538200614
6246,0.6292,5,3,5,603288,2322,104095,3861,0.021508762829300827,0.6244541484716157
6247,0.6293,4,3,4,603291,2319,104099,3857,0.021480973730038162,0.6245142487046632
6248,0.6294,2,2,2,603293,2317,104101,3855,0.021462447663863054,0.6245949449125081
6249,0.6295,2,2,2,603295,2315,104103,3853,0.021443921597687945,0.6246757457846952
6250,0.6296,2,3,2,603298,2312,104105,3851,0.021416132498425285,0.6248580236897615
6251,0.6297,3,5,3,603303,2307,104108,3848,0.021369817332987512,0.6251827782290821
6252,0.6298,0,1,0,603304,2306,104108,3848,0.02136055429989996,0.6252843678908028
6253,0.6299,7,6,7,603310,2300,104115,3841,0.021304976101374634,0.6254681647940075
6254,0.63,3,1,3,603311,2299,104118,3838,0.021295713068287078,0.6253869969040248
6255,0.6301,2,0,2,603311,2299,104120,3836,0.021295713068287078,0.6252648736756317
6256,0.6302,2,0,2,603311,2299,104122,3834,0.021295713068287078,0.625142670797326
6257,0.6303,1,4,1,603315,2295,104123,3833,0.021258660935936865,0.6254895561357703
6258,0.6304,2,2,2,603317,2293,104125,3831,0.021240134869761756,0.6255715218811234
6259,0.6305,2,2,2,603319,2291,104127,3829,0.021221608803586648,0.6256535947712418
6260,0.6306,3,6,3,603325,2285,104130,3826,0.021166030605061323,0.6260841106201931
6261,0.6307,1,0,1,603325,2285,104131,3825,0.021166030605061323,0.6260229132569558
6262,0.6308,7,4,7,603329,2281,104138,3818,0.021128978472711106,0.6260042629939334
6263,0.6309,5,1,5,603330,2280,104143,3813,0.02111971543962355,0.6258000984736583
6264,0.631,5,2,5,603332,2278,104148,3808,0.02110118937344844,0.6256983240223464
6265,0.6311,2,4,2,603336,2274,104150,3806,0.021064137241098225,0.6259868421052631
6266,0.6312,10,6,10,603342,2268,104160,3796,0.0210085590425729,0.6259894459102903
6267,0.6313,0,3,0,603345,2265,104160,3796,0.02098076994331024,0.6262992905461146
6268,0.6314,3,3,3,603348,2262,104163,3793,0.020952980844047574,0.6264244426094137
6269,0.6315,5,4,5,603352,2258,104168,3788,0.020915928711697358,0.626529937148528
6270,0.6316,2,5,2,603357,2253,104170,3786,0.02086961354625959,0.6269249875807252
6271,0.6317,2,4,2,603361,2249,104172,3784,0.02083256141390937,0.6272169733134427
6272,0.6318,3,3,3,603364,2246,104175,3781,0.020804772314646707,0.6273436203749793
6273,0.6319,3,5,3,603369,2241,104178,3778,0.020758457149208938,0.6276790164479149
6274,0.632,1,2,1,603371,2239,104179,3777,0.02073993108303383,0.6278257978723404
6275,0.6321,2,2,2,603373,2237,104181,3775,0.02072140501685872,0.6279108449767132
6276,0.6322,8,5,8,603378,2232,104189,3767,0.02067508985142095,0.6279379896649442
6277,0.6323,6,5,6,603383,2227,104195,3761,0.02062877468598318,0.6280895123580494
6278,0.6324,3,0,3,603383,2227,104198,3758,0.02062877468598318,0.6279030910609859
6279,0.6325,6,7,6,603390,2220,104204,3752,0.020563933454370298,0.6282652377762894
6280,0.6326,4,2,4,603392,2218,104208,3748,0.02054540738819519,0.6282266174991619
6281,0.6327,2,4,2,603396,2214,104210,3746,0.020508355255844973,0.6285234899328859
6282,0.6328,2,1,2,603397,2213,104212,3744,0.02049909222275742,0.6285042806781937
6283,0.6329,2,2,2,603399,2211,104214,3742,0.020480566156582312,0.6285906265748362
6284,0.633,6,3,6,603402,2208,104220,3736,0.020452777057319647,0.6285329744279946
6285,0.6331,3,3,3,603405,2205,104223,3733,0.020424987958056987,0.6286628494442573
6286,0.6332,6,2,6,603407,2203,104229,3727,0.020406461891881878,0.6284991568296796
6287,0.6333,1,6,1,603413,2197,104230,3726,0.020350883693356553,0.6290731048455175
6288,0.6334,2,1,2,603414,2196,104232,3724,0.020341620660268997,0.629054054054054
6289,0.6335,2,1,2,603415,2195,104234,3722,0.020332357627181444,0.6290349839445665
6290,0.6336,6,5,6,603420,2190,104240,3716,0.02028604246174367,0.629190653572638
6291,0.6337,5,1,5,603421,2189,104245,3711,0.02027677942865612,0.6289830508474576
6292,0.6338,3,1,3,603422,2188,104248,3708,0.020267516395568563,0.6289009497964722
6293,0.6339,4,2,4,603424,2186,104252,3704,0.020248990329393455,0.6288624787775892
6294,0.634,3,2,3,603426,2184,104255,3701,0.020230464263218347,0.6288870008496177
6295,0.6341,1,1,1,603427,2183,104256,3700,0.020221201230130794,0.6289308176100629
6296,0.6342,1,4,1,603431,2179,104257,3699,0.020184149097780577,0.6292956788023137
6297,0.6343,2,6,2,603437,2173,104259,3697,0.020128570899255252,0.6298126064735945
6298,0.6344,1,6,1,603443,2167,104260,3696,0.020072992700729927,0.6303939962476548
6299,0.6345,1,2,1,603445,2165,104261,3695,0.02005446663455482,0.6305460750853242
6300,0.6346,4,1,4,603446,2164,104265,3691,0.020045203601467266,0.6304013663535439
6301,0.6347,8,2,8,603448,2162,104273,3683,0.020026677535292157,0.6301112061591103
6302,0.6348,1,1,1,603449,2161,104274,3682,0.0200174145022046,0.6301557419134006
6303,0.6349,1,2,1,603451,2159,104275,3681,0.019998888436029493,0.6303082191780822
6304,0.635,3,2,3,603453,2157,104278,3678,0.019980362369854385,0.6303341902313625
6305,0.6351,5,4,5,603457,2153,104283,3673,0.019943310237504168,0.6304497082046001
6306,0.6352,1,5,1,603462,2148,104284,3672,0.0198969950720664,0.6309278350515464
6307,0.6353,4,4,4,603466,2144,104288,3668,0.019859942939716182,0.6311080523055747
6308,0.6354,2,0,2,603466,2144,104290,3666,0.019859942939716182,0.6309810671256454
6309,0.6355,2,2,2,603468,2142,104292,3664,0.019841416873541073,0.6310713055459869
6310,0.6356,3,1,3,603469,2141,104295,3661,0.019832153840453517,0.630989314029645
6311,0.6357,2,4,2,603473,2137,104297,3659,0.0197951017081033,0.6312974465148378
6312,0.6358,1,3,1,603476,2134,104298,3658,0.01976731260884064,0.631560773480663
6313,0.6359,0,1,0,603477,2133,104298,3658,0.019758049575753084,0.6316698324987049
6314,0.636,4,4,4,603481,2129,104302,3654,0.019720997443402867,0.631851979941207
6315,0.6361,5,0,5,603481,2129,104307,3649,0.019720997443402867,0.63153340256144
6316,0.6362,2,3,2,603484,2126,104309,3647,0.019693208344140206,0.6317339338298978
6317,0.6363,2,1,2,603485,2125,104311,3645,0.01968394531105265,0.6317157712305026
6318,0.6364,2,2,2,603487,2123,104313,3643,0.019665419244877542,0.6318071453347208
6319,0.6365,8,3,8,603490,2120,104321,3635,0.01963763014561488,0.631624674196351
6320,0.6366,3,0,3,603490,2120,104324,3632,0.01963763014561488,0.631432545201669
6321,0.6367,2,1,2,603491,2119,104326,3630,0.019628367112527325,0.6314141589841712
6322,0.6368,4,2,4,603493,2117,104330,3626,0.019609841046352217,0.6313773289221661
6323,0.6369,3,2,3,603495,2115,104333,3623,0.019591314980177108,0.6314046706169397
6324,0.637,1,1,1,603496,2114,104334,3622,0.019582051947089556,0.6314504881450488
6325,0.6371,5,1,5,603497,2113,104339,3617,0.019572788914002,0.631239092495637
6326,0.6372,3,3,3,603500,2110,104342,3614,0.01954499981473934,0.6313766596785465
6327,0.6373,3,3,3,603503,2107,104345,3611,0.019517210715476675,0.6315145155648828
6328,0.6374,6,2,6,603505,2105,104351,3605,0.019498684649301566,0.6313485113835376
6329,0.6375,2,4,2,603509,2101,104353,3603,0.01946163251695135,0.6316619915848527
6330,0.6376,1,2,1,603511,2099,104354,3602,0.01944310645077624,0.631818979126469
6331,0.6377,3,1,3,603512,2098,104357,3599,0.01943384341768869,0.6317360014042479
6332,0.6379,4,1,4,603513,2097,104361,3595,0.019424580384601133,0.6315881939564301
6333,0.638,2,2,2,603515,2095,104363,3593,0.019406054318426024,0.6316807313642757
6334,0.6381,4,3,4,603518,2092,104367,3589,0.019378265219163363,0.6317549727160711
6335,0.6382,1,4,1,603522,2088,104368,3588,0.019341213086813146,0.6321353065539113
6336,0.6383,4,3,4,603525,2085,104372,3584,0.019313423987550482,0.6322102663609103
6337,0.6384,1,2,1,603527,2083,104373,3583,0.019294897921375374,0.6323685139428168
6338,0.6385,3,1,3,603528,2082,104376,3580,0.01928563488828782,0.6322854115153655
6339,0.6386,4,2,4,603530,2080,104380,3576,0.019267108822112713,0.6322489391796322
6340,0.6387,5,2,5,603532,2078,104385,3571,0.019248582755937604,0.6321472827049035
6341,0.6388,5,1,5,603533,2077,104390,3566,0.01923931972285005,0.631933368775474
6342,0.6389,2,2,2,603535,2075,104392,3564,0.01922079365667494,0.632026955133889
6343,0.639,1,4,1,603539,2071,104393,3563,0.019183741524324723,0.6324103656372027
6344,0.6391,3,0,3,603539,2071,104396,3560,0.019183741524324723,0.6322145267270467
6345,0.6392,1,2,1,603541,2069,104397,3559,0.019165215458149615,0.6323738450604123
6346,0.6393,4,2,4,603543,2067,104401,3555,0.01914668939197451,0.6323372465314835
6347,0.6394,2,3,2,603546,2064,104403,3553,0.019118900292711846,0.632544062666904
6348,0.6395,4,1,4,603547,2063,104407,3549,0.019109637259624293,0.6323948681397007
6349,0.6396,2,4,2,603551,2059,104409,3547,0.019072585127274076,0.632714948269711
6350,0.6397,2,2,2,603553,2057,104411,3545,0.019054059061098968,0.6328097108175652
6351,0.6398,2,2,2,603555,2055,104413,3543,0.01903553299492386,0.6329046087888531
6352,0.6399,4,4,4,603559,2051,104417,3539,0.018998480862573643,0.6330948121645796
6353,0.64,2,1,2,603560,2050,104419,3537,0.018989217829486087,0.6330767853946662
6354,0.6401,2,2,2,603562,2048,104421,3535,0.018970691763310978,0.6331721296793839
6355,0.6402,4,1,4,603563,2047,104425,3531,0.018961428730223426,0.6330225887414844
6356,0.6403,3,2,3,603565,2045,104428,3528,0.018942902664048317,0.6330522160416293
6357,0.6404,4,1,4,603566,2044,104432,3524,0.01893363963096076,0.6329022988505747
6358,0.6405,2,2,2,603568,2042,104434,3522,0.018915113564785653,0.6329978432782171
6359,0.6406,1,1,1,603569,2041,104435,3521,0.0189058505316981,0.6330456670262495
6360,0.6407,2,3,2,603572,2038,104437,3519,0.018878061432435436,0.633255353608062
6361,0.6408,4,3,4,603575,2035,104441,3515,0.018850272333172775,0.6333333333333333
6362,0.6409,4,2,4,603577,2033,104445,3511,0.018831746266997667,0.6332972582972582
6363,0.641,3,5,3,603582,2028,104448,3508,0.018785431101559894,0.6336705202312138
6364,0.6411,2,0,2,603582,2028,104450,3506,0.018785431101559894,0.6335381279363932
6365,0.6412,2,0,2,603582,2028,104452,3504,0.018785431101559894,0.6334056399132321
6366,0.6413,0,2,0,603584,2026,104452,3504,0.018766905035384786,0.6336347197106691
6367,0.6414,3,4,3,603588,2022,104455,3501,0.01872985290303457,0.6338946224877784
6368,0.6415,4,3,4,603591,2019,104459,3497,0.018702063803771908,0.6339738941261784
6369,0.6416,2,1,2,603592,2018,104461,3495,0.018692800770684352,0.6339561037547615
6370,0.6417,7,1,7,603593,2017,104468,3488,0.0186835377375968,0.6336058128973661
6371,0.6418,3,2,3,603595,2015,104471,3485,0.01866501167142169,0.6336363636363637
6372,0.6419,3,1,3,603596,2014,104474,3482,0.018655748638334135,0.633551673944687
6373,0.642,2,3,2,603599,2011,104476,3480,0.018627959539071474,0.6337643416499726
6374,0.6421,4,4,4,603603,2007,104480,3476,0.018590907406721258,0.6339595112164873
6375,0.6422,5,1,5,603604,2006,104485,3471,0.0185816443736337,0.6337410991418659
6376,0.6423,9,5,9,603609,2001,104494,3462,0.018535329208195932,0.6337177375068643
6377,0.6424,4,1,4,603610,2000,104498,3458,0.018526066175108376,0.6335654085745694
6378,0.6425,1,3,1,603613,1997,104499,3457,0.018498277075845716,0.6338467180051338
6379,0.6426,2,3,2,603616,1994,104501,3455,0.01847048797658305,0.6340612956505781
6380,0.6427,2,2,2,603618,1992,104503,3453,0.018451961910407943,0.634159779614325
6381,0.6428,1,2,1,603620,1990,104504,3452,0.018433435844232834,0.6343256155825064
6382,0.6429,2,4,2,603624,1986,104506,3450,0.018396383711882618,0.6346578366445916
6383,0.643,3,0,3,603624,1986,104509,3447,0.018396383711882618,0.6344561016013253
6384,0.6431,3,1,3,603625,1985,104512,3444,0.018387120678795065,0.6343709707128384
6385,0.6432,3,2,3,603627,1983,104515,3441,0.018368594612619957,0.6344026548672567
6386,0.6433,6,2,6,603629,1981,104521,3435,0.01835006854644485,0.6342319054652881
6387,0.6434,1,2,1,603631,1979,104522,3434,0.01833154248026974,0.6343986698688343
6388,0.6435,2,1,2,603632,1978,104524,3432,0.018322279447182184,0.6343807763401109
6389,0.6436,5,2,5,603634,1976,104529,3427,0.018303753381007076,0.6342772533777531
6390,0.6437,4,1,4,603635,1975,104533,3423,0.018294490347919523,0.6341237495368655
6391,0.6438,3,5,3,603640,1970,104536,3420,0.01824817518248175,0.634508348794063
6392,0.6439,6,2,6,603642,1968,104542,3414,0.018229649116306642,0.6343366778149386
6393,0.644,3,3,3,603645,1965,104545,3411,0.01820186001704398,0.6344866071428571
6394,0.6441,2,2,2,603647,1963,104547,3409,0.018183333950868873,0.6345867460908414
6395,0.6442,3,4,3,603651,1959,104550,3406,0.018146281818518656,0.6348555452003728
6396,0.6443,8,5,8,603656,1954,104558,3398,0.018099966653080883,0.6349028400597907
6397,0.6444,3,4,3,603660,1950,104561,3395,0.01806291452073067,0.6351730589335828
6398,0.6445,2,1,2,603661,1949,104563,3393,0.018053651487643114,0.6351553725196556
6399,0.6446,2,3,2,603664,1946,104565,3391,0.018025862388380453,0.6353756792205358
6400,0.6447,1,3,1,603667,1943,104566,3390,0.01799807328911779,0.6356647290455654
6401,0.6448,1,0,1,603667,1943,104567,3389,0.01799807328911779,0.635596399099775
6402,0.6449,1,1,1,603668,1942,104568,3388,0.017988810256030236,0.6356472795497186
6403,0.645,4,3,4,603671,1939,104572,3384,0.017961021156767572,0.6357317302273154
6404,0.6451,5,3,5,603674,1936,104577,3379,0.01793323205750491,0.6357478833490122
6405,0.6452,4,1,4,603675,1935,104581,3375,0.017923969024417355,0.635593220338983
6406,0.6453,3,1,3,603676,1934,104584,3372,0.017914705991329802,0.635506973237844
6407,0.6454,3,4,3,603680,1930,104587,3369,0.017877653858979586,0.6357803359124363
6408,0.6455,1,2,1,603682,1928,104588,3368,0.017859127792804477,0.6359516616314199
6409,0.6456,2,1,2,603683,1927,104590,3366,0.01784986475971692,0.6359342527866995
6410,0.6457,8,0,8,603683,1927,104598,3358,0.01784986475971692,0.6353831598864711
6411,0.6458,1,1,1,603684,1926,104599,3357,0.01784060172662937,0.6354344122657581
6412,0.6459,5,2,5,603686,1924,104604,3352,0.01782207566045426,0.6353297952994693
6413,0.646,2,3,2,603689,1921,104606,3350,0.017794286561191596,0.6355530259912731
6414,0.6461,5,2,5,603691,1919,104611,3345,0.017775760495016488,0.6354483282674772
6415,0.6462,3,3,3,603694,1916,104614,3342,0.017747971395753827,0.6356028908330164
6416,0.6463,4,1,4,603695,1915,104618,3338,0.01773870836266627,0.6354464115743385
6417,0.6464,1,4,1,603699,1911,104619,3337,0.017701656230316054,0.6358612804878049
6418,0.6465,4,0,4,603699,1911,104623,3333,0.017701656230316054,0.63558352402746
6419,0.6466,2,0,2,603699,1911,104625,3331,0.017701656230316054,0.6354444868370851
6420,0.6467,2,1,2,603700,1910,104627,3329,0.0176923931972285,0.6354266081313228
6421,0.6468,4,2,4,603702,1908,104631,3325,0.017673867131053393,0.6353907892222435
6422,0.6469,3,1,3,603703,1907,104634,3322,0.017664604097965837,0.6353031172308281
6423,0.647,3,1,3,603704,1906,104637,3319,0.017655341064878285,0.6352153110047847
6424,0.6471,6,2,6,603706,1904,104643,3313,0.017636814998703176,0.6350392946137627
6425,0.6472,2,0,2,603706,1904,104645,3311,0.017636814998703176,0.6348993288590604
6426,0.6473,2,1,2,603707,1903,104647,3309,0.01762755196561562,0.6348810437452034
6427,0.6474,2,2,2,603709,1901,104649,3307,0.017609025899440512,0.6349846390168971
6428,0.6475,3,3,3,603712,1898,104652,3304,0.01758123680017785,0.6351403306420608
6429,0.6476,3,5,3,603717,1893,104655,3301,0.01753492163474008,0.6355410088563728
6430,0.6477,5,1,5,603718,1892,104660,3296,0.017525658601652526,0.6353122590593677
6431,0.6478,3,2,3,603720,1890,104663,3293,0.017507132535477418,0.6353463245224773
6432,0.6479,1,2,1,603722,1888,104664,3292,0.01748860646930231,0.6355212355212355
6433,0.648,4,5,4,603727,1883,104668,3288,0.017442291303864536,0.6358538000386772
6434,0.6481,5,2,5,603729,1881,104673,3283,0.017423765237689428,0.6357474825716499
6435,0.6482,2,2,2,603731,1879,104675,3281,0.01740523917151432,0.6358527131782946
6436,0.6483,3,3,3,603734,1876,104678,3278,0.01737745007225166,0.6360108653473031
6437,0.6484,1,3,1,603737,1873,104679,3277,0.017349660972988994,0.6363106796116504
6438,0.6485,4,1,4,603738,1872,104683,3273,0.017340397939901442,0.6361516034985423
6439,0.6486,4,3,4,603741,1869,104687,3269,0.017312608840638778,0.6362397820163488
6440,0.6487,1,1,1,603742,1868,104688,3268,0.017303345807551225,0.6362928348909658
6441,0.6488,1,3,1,603745,1865,104689,3267,0.01727555670828856,0.6365939204988309
6442,0.6489,2,2,2,603747,1863,104691,3265,0.017257030642113452,0.6367004680187207
6443,0.649,2,6,2,603753,1857,104693,3263,0.017201452443588127,0.6373046875
6444,0.6491,6,3,6,603756,1854,104699,3257,0.017173663344325466,0.6372529837605165
6445,0.6492,4,4,4,603760,1850,104703,3253,0.01713661121197525,0.6374681559866745
6446,0.6493,5,1,5,603761,1849,104708,3248,0.017127348178887693,0.6372375907396508
6447,0.6494,4,1,4,603762,1848,104712,3244,0.01711808514580014,0.6370777690494894
6448,0.6495,0,3,0,603765,1845,104712,3244,0.017090296046537477,0.6374533307133032
6449,0.6496,3,2,3,603767,1843,104715,3241,0.017071769980362368,0.6374901652242329
6450,0.6497,3,4,3,603771,1839,104718,3238,0.01703471784801215,0.6377782154815836
6451,0.6498,3,5,3,603776,1834,104721,3235,0.016988402682574382,0.6381929374630104
6452,0.6499,3,2,3,603778,1832,104724,3232,0.016969876616399274,0.6382306477093207
6453,0.65,4,5,4,603783,1827,104728,3228,0.016923561450961504,0.6385756676557863
6454,0.6501,4,4,4,603787,1823,104732,3224,0.016886509318611288,0.6387953239548246
6455,0.6502,1,1,1,603788,1822,104733,3223,0.01687724628552373,0.6388503468780972
6456,0.6503,6,1,6,603789,1821,104739,3217,0.01686798325243618,0.6385470424771735
6457,0.6504,2,2,2,603791,1819,104741,3215,0.01684945718626107,0.6386571315057609
6458,0.6505,4,1,4,603792,1818,104745,3211,0.016840194153173515,0.6384967190296281
6459,0.6506,1,2,1,603794,1816,104746,3210,0.016821668086998406,0.6386788698766415
6460,0.6507,4,3,4,603797,1813,104750,3206,0.016793878987735746,0.6387726638772664
6461,0.6508,7,4,7,603801,1809,104757,3199,0.01675682685538553,0.6387779552715654
6462,0.6509,4,0,4,603801,1809,104761,3195,0.01675682685538553,0.6384892086330936
6463,0.651,3,3,3,603804,1806,104764,3192,0.016729037756122864,0.6386554621848739
6464,0.6511,1,2,1,603806,1804,104765,3191,0.016710511689947756,0.6388388388388389
6465,0.6512,3,2,3,603808,1802,104768,3188,0.016691985623772648,0.638877755511022
6466,0.6513,0,1,0,603809,1801,104768,3188,0.016682722590685095,0.6390058127881338
6467,0.6514,5,1,5,603810,1800,104773,3183,0.01667345955759754,0.6387718242022877
6468,0.6515,1,5,1,603815,1795,104774,3182,0.01662714439215977,0.6393409684548925
6469,0.6516,3,4,3,603819,1791,104777,3179,0.016590092259809553,0.6396378269617706
6470,0.6517,2,0,2,603819,1791,104779,3177,0.016590092259809553,0.6394927536231884
6471,0.6518,0,2,0,603821,1789,104779,3177,0.016571566193634445,0.639750302053967
6472,0.6519,6,3,6,603824,1786,104785,3171,0.01654377709437178,0.6397014323179342
6473,0.652,0,2,0,603826,1784,104785,3171,0.016525251028196672,0.6399596367305752
6474,0.6521,1,0,1,603826,1784,104786,3170,0.016525251028196672,0.6398869600322972
6475,0.6522,4,3,4,603829,1781,104790,3166,0.01649746192893401,0.6399838285829795
6476,0.6523,1,2,1,603831,1779,104791,3165,0.016478935862758903,0.6401699029126213
6477,0.6524,3,0,3,603831,1779,104794,3162,0.016478935862758903,0.6399514268366727
6478,0.6525,9,2,9,603833,1777,104803,3153,0.016460409796583794,0.639553752535497
6479,0.6526,0,1,0,603834,1776,104803,3153,0.01645114676349624,0.6396835057821059
6480,0.6527,2,1,2,603835,1775,104805,3151,0.016441883730408686,0.6396670726755989
6481,0.6528,2,1,2,603836,1774,104807,3149,0.01643262069732113,0.6396506195409303
6482,0.6529,3,3,3,603839,1771,104810,3146,0.01640483159805847,0.639821029082774
6483,0.653,1,2,1,603841,1769,104811,3145,0.01638630553188336,0.64000814000814
6484,0.6531,2,1,2,603842,1768,104813,3143,0.016377042498795805,0.6399918550193443
6485,0.6532,3,1,3,603843,1767,104816,3140,0.016367779465708252,0.639902180558386
6486,0.6533,2,0,2,603843,1767,104818,3138,0.016367779465708252,0.6397553516819572
6487,0.6534,2,1,2,603844,1766,104820,3136,0.016358516432620696,0.6397388820889433
6488,0.6535,2,2,2,603846,1764,104822,3134,0.016339990366445588,0.6398530012249898
6489,0.6536,2,2,2,603848,1762,104824,3132,0.01632146430027048,0.639967306906416
6490,0.6537,6,0,6,603848,1762,104830,3126,0.01632146430027048,0.6395253682487725
6491,0.6538,5,0,5,603848,1762,104835,3121,0.01632146430027048,0.6391562563997543
6492,0.6539,2,1,2,603849,1761,104837,3119,0.016312201267182927,0.6391393442622951
6493,0.654,3,2,3,603851,1759,104840,3116,0.01629367520100782,0.6391794871794871
6494,0.6541,4,1,4,603852,1758,104844,3112,0.016284412167920263,0.6390143737166324
6495,0.6542,1,1,1,603853,1757,104845,3111,0.01627514913483271,0.6390714872637634
6496,0.6543,1,2,1,603855,1755,104846,3110,0.0162566230686576,0.6392600205549845
6497,0.6544,2,1,2,603856,1754,104848,3108,0.016247360035570046,0.6392431098313451
6498,0.6545,1,3,1,603859,1751,104849,3107,0.016219570936307385,0.6395636064223961
6499,0.6546,4,4,4,603863,1747,104853,3103,0.016182518803957168,0.6397938144329897
6500,0.6547,3,2,3,603865,1745,104856,3100,0.01616399273778206,0.6398348813209495
6501,0.6548,4,3,4,603868,1742,104860,3096,0.016136203638519395,0.6399338569656883
6502,0.6549,5,2,5,603870,1740,104865,3091,0.016117677572344287,0.6398261229559098
6503,0.655,1,0,1,603870,1740,104866,3090,0.016117677572344287,0.639751552795031
6504,0.6551,1,1,1,603871,1739,104867,3089,0.016108414539256734,0.6398094449047225
6505,0.6552,2,3,2,603874,1736,104869,3087,0.01608062543999407,0.6400580551523948
6506,0.6553,5,2,5,603876,1734,104874,3082,0.01606209937381896,0.6399501661129569
6507,0.6554,4,1,4,603877,1733,104878,3078,0.01605283634073141,0.6397838287258366
6508,0.6555,0,2,0,603879,1731,104878,3078,0.0160343102745563,0.6400499064254522
6509,0.6556,2,5,2,603884,1726,104880,3076,0.015987995109118528,0.6405664306538942
6510,0.6557,2,1,2,603885,1725,104882,3074,0.015978732076030976,0.6405501146072098
6511,0.6558,1,0,1,603885,1725,104883,3073,0.015978732076030976,0.6404751979991663
6512,0.6559,2,3,2,603888,1722,104885,3071,0.015950942976768315,0.6407260588358022
6513,0.656,5,2,5,603890,1720,104890,3066,0.015932416910593206,0.6406184705390723
6514,0.6561,4,4,4,603894,1716,104894,3062,0.01589536477824299,0.6408539137714525
6515,0.6562,1,0,1,603894,1716,104895,3061,0.01589536477824299,0.6407787314213942
6516,0.6563,5,2,5,603896,1714,104900,3056,0.01587683871206788,0.6406708595387841
6517,0.6564,2,1,2,603897,1713,104902,3054,0.015867575678980325,0.6406544996853367
6518,0.6565,3,2,3,603899,1711,104905,3051,0.015849049612805217,0.6406971860562789
6519,0.6566,3,2,3,603901,1709,104908,3048,0.01583052354663011,0.6407399621610259
6520,0.6567,4,1,4,603902,1708,104912,3044,0.015821260513542556,0.6405723905723906
6521,0.6568,4,1,4,603903,1707,104916,3040,0.015811997480455,0.6404044659785127
6522,0.6569,4,1,4,603904,1706,104920,3036,0.015802734447367447,0.6402361872627583
6523,0.657,1,3,1,603907,1703,104921,3035,0.015774945348104783,0.640565639510342
6524,0.6571,2,3,2,603910,1700,104923,3033,0.015747156248842122,0.6408197760405663
6525,0.6572,6,2,6,603912,1698,104929,3027,0.015728630182667014,0.6406349206349207
6526,0.6573,2,2,2,603914,1696,104931,3025,0.015710104116491905,0.6407540775259479
6527,0.6574,4,2,4,603916,1694,104935,3021,0.015691578050316797,0.6407211028632025
6528,0.6575,1,3,1,603919,1691,104936,3020,0.015663788951054133,0.6410528550201656
6529,0.6576,3,0,3,603919,1691,104939,3017,0.015663788951054133,0.6408241291418861
6530,0.6577,3,1,3,603920,1690,104942,3014,0.01565452591796658,0.6407312925170068
6531,0.6578,2,4,2,603924,1686,104944,3012,0.015617473785616362,0.6411238825031929
6532,0.6579,1,3,1,603927,1683,104945,3011,0.015589684686353699,0.6414571793779292
6533,0.658,0,1,0,603928,1682,104945,3011,0.015580421653266145,0.6415938632005114
6534,0.6581,0,1,0,603929,1681,104945,3011,0.01557115862017859,0.6417306052855924
6535,0.6582,3,1,3,603930,1680,104948,3008,0.015561895587091036,0.6416382252559727
6536,0.6583,3,1,3,603931,1679,104951,3005,0.015552632554003482,0.6415456874466268
6537,0.6584,3,3,3,603934,1676,104954,3002,0.01552484345474082,0.6417272338606242
6538,0.6585,1,4,1,603938,1672,104955,3001,0.015487791322390603,0.6421998716028248
6539,0.6586,2,4,2,603942,1668,104957,2999,0.015450739190040386,0.6425969573601885
6540,0.6587,1,7,1,603949,1661,104958,2998,0.015385897958427508,0.643485726550762
6541,0.6588,5,2,5,603951,1659,104963,2993,0.0153673718922524,0.6433791917454859
6542,0.6589,4,1,4,603952,1658,104967,2989,0.015358108859164846,0.6432106735528298
6543,0.659,3,3,3,603955,1655,104970,2986,0.015330319759902183,0.6433958198664081
6544,0.6591,4,3,4,603958,1652,104974,2982,0.01530253066063952,0.6435045317220544
6545,0.6592,1,1,1,603959,1651,104975,2981,0.015293267627551966,0.643566493955095
6546,0.6593,4,2,4,603961,1649,104979,2977,0.015274741561376858,0.643536532641591
6547,0.6594,2,2,2,603963,1647,104981,2975,0.01525621549520175,0.6436607529208135
6548,0.6595,0,2,0,603965,1645,104981,2975,0.015237689429026641,0.6439393939393939
6549,0.6597,6,0,6,603965,1645,104987,2969,0.015237689429026641,0.6434763762462072
6550,0.6598,2,0,2,603965,1645,104989,2967,0.015237689429026641,0.6433217692974849
6551,0.6599,3,3,3,603968,1642,104992,2964,0.015209900329763978,0.6435084672166739
6552,0.6601,3,0,3,603968,1642,104995,2961,0.015209900329763978,0.6432761242667825
6553,0.6602,1,3,1,603971,1639,104996,2960,0.015182111230501316,0.6436181778647532
6554,0.6603,5,3,5,603974,1636,105001,2955,0.015154322131238653,0.6436506207797865
6555,0.6604,3,1,3,603975,1635,105004,2952,0.015145059098151099,0.6435578809679529
6556,0.6605,2,3,2,603978,1632,105006,2950,0.015117269998888436,0.6438236577913575
6557,0.6607,3,2,3,603980,1630,105009,2947,0.015098743932713328,0.6438715315708979
6558,0.6608,3,0,3,603980,1630,105012,2944,0.015098743932713328,0.6436379536510712
6559,0.6609,4,3,4,603983,1627,105016,2940,0.015070954833450665,0.6437486314867528
6560,0.661,2,1,2,603984,1626,105018,2938,0.015061691800363111,0.6437335670464505
6561,0.6611,5,3,5,603987,1623,105023,2933,0.015033902701100449,0.6437664618086041
6562,0.6612,4,4,4,603991,1619,105027,2929,0.014996850568750232,0.6440193491644679
6563,0.6613,1,3,1,603994,1616,105028,2928,0.014969061469487569,0.6443661971830986
6564,0.6614,3,3,3,603997,1613,105031,2925,0.014941272370224907,0.6445570736007051
6565,0.6615,1,2,1,603999,1611,105032,2924,0.014922746304049798,0.6447629547960309
6566,0.6616,3,3,3,604002,1608,105035,2921,0.014894957204787136,0.6449547361448443
6567,0.6617,2,2,2,604004,1606,105037,2919,0.014876431138612027,0.6450828729281768
6568,0.6618,1,5,1,604009,1601,105038,2918,0.014830115973174256,0.6457180792210666
6569,0.6619,1,3,1,604012,1598,105039,2917,0.014802326873911593,0.6460686600221484
6570,0.662,1,3,1,604015,1595,105040,2916,0.01477453777464893,0.6464198625581911
6571,0.6621,4,3,4,604018,1592,105044,2912,0.014746748675386268,0.6465364120781527
6572,0.6622,7,0,7,604018,1592,105051,2905,0.014746748675386268,0.6459862130309095
6573,0.6623,1,0,1,604018,1592,105052,2904,0.014746748675386268,0.6459074733096085
6574,0.6624,4,1,4,604019,1591,105056,2900,0.014737485642298714,0.6457359162769984
6575,0.6625,4,1,4,604020,1590,105060,2896,0.01472822260921116,0.6455639768167633
6576,0.6626,0,1,0,604021,1589,105060,2896,0.014718959576123606,0.6457079152731326
6577,0.6627,0,2,0,604023,1587,105060,2896,0.014700433509948497,0.645995984831586
6578,0.6628,3,0,3,604023,1587,105063,2893,0.014700433509948497,0.6457589285714286
6579,0.6629,2,1,2,604024,1586,105065,2891,0.014691170476860943,0.6457449184721912
6580,0.663,1,3,1,604027,1583,105066,2890,0.01466338137759828,0.6460988151128996
6581,0.6631,4,0,4,604027,1583,105070,2886,0.01466338137759828,0.6457820541508167
6582,0.6632,5,1,5,604028,1582,105075,2881,0.014654118344510726,0.6455299126148331
6583,0.6633,3,1,3,604029,1581,105078,2878,0.014644855311423172,0.6454361964566047
6584,0.6634,4,0,4,604029,1581,105082,2874,0.014644855311423172,0.6451178451178451
6585,0.6635,4,2,4,604031,1579,105086,2870,0.014626329245248064,0.6450887839964037
6586,0.6636,1,4,1,604035,1575,105087,2869,0.014589277112897847,0.6455895589558955
6587,0.6637,1,1,1,604036,1574,105088,2868,0.014580014079810293,0.6456551103106709
6588,0.6638,3,3,3,604039,1571,105091,2865,0.01455222498054763,0.6458521190261497
6589,0.6639,7,2,7,604041,1569,105098,2858,0.014533698914372522,0.6455839168737294
6590,0.664,1,4,1,604045,1565,105099,2857,0.014496646782022305,0.6460877431026685
6591,0.6641,1,0,1,604045,1565,105100,2856,0.014496646782022305,0.6460076905677449
6592,0.6642,1,4,1,604049,1561,105101,2855,0.014459594649672088,0.6465126811594203
6593,0.6643,5,1,5,604050,1560,105106,2850,0.014450331616584534,0.6462585034013606
6594,0.6644,5,0,5,604050,1560,105111,2845,0.014450331616584534,0.6458569807037458
6595,0.6645,4,2,4,604052,1558,105115,2841,0.014431805550409425,0.645828597408502
6596,0.6646,4,4,4,604056,1554,105119,2837,0.014394753418059208,0.646094283762241
6597,0.6647,7,1,7,604057,1553,105126,2830,0.014385490384971654,0.6456764772986539
6598,0.6648,3,2,3,604059,1551,105129,2827,0.014366964318796546,0.6457286432160804
6599,0.6649,2,2,2,604061,1549,105131,2825,0.01434843825262144,0.64586191129401
6600,0.665,3,2,3,604063,1547,105134,2822,0.01432991218644633,0.6459143968871596
6601,0.6651,4,2,4,604065,1545,105138,2818,0.014311386120271222,0.6458858583543433
6602,0.6652,2,1,2,604066,1544,105140,2816,0.014302123087183668,0.6458715596330276
6603,0.6653,1,2,1,604068,1542,105141,2815,0.01428359702100856,0.6460867569428506
6604,0.6654,1,3,1,604071,1539,105142,2814,0.014255807921745897,0.6464507236388698
6605,0.6655,4,4,4,604075,1535,105146,2810,0.01421875578939568,0.6467203682393556
6606,0.6656,9,1,9,604076,1534,105155,2801,0.014209492756308126,0.6461361014994232
6607,0.6657,4,1,4,604077,1533,105159,2797,0.014200229723220572,0.645958429561201
6608,0.6658,2,0,2,604077,1533,105161,2795,0.014200229723220572,0.6457948243992606
6609,0.6659,1,1,1,604078,1532,105162,2794,0.014190966690133018,0.6458622283865002
6610,0.666,4,3,4,604081,1529,105166,2790,0.014163177590870355,0.6459828664042603
6611,0.6661,2,2,2,604083,1527,105168,2788,0.014144651524695247,0.6461181923522595
6612,0.6662,0,1,0,604084,1526,105168,2788,0.014135388491607693,0.6462679647658786
6613,0.6663,1,1,1,604085,1525,105169,2787,0.014126125458520138,0.6463358070500927
6614,0.6664,2,2,2,604087,1523,105171,2785,0.01410759939234503,0.6464716805942433
6615,0.6665,4,3,4,604090,1520,105175,2781,0.014079810293082367,0.6465938153917694
6616,0.6666,3,1,3,604091,1519,105178,2778,0.014070547259994813,0.646497556434722
6617,0.6667,2,2,2,604093,1517,105180,2776,0.014052021193819705,0.6466340554390869
6618,0.6668,1,2,1,604095,1515,105181,2775,0.014033495127644596,0.6468531468531469
6619,0.6669,3,4,3,604099,1511,105184,2772,0.01399644299529438,0.647209899603082
6620,0.667,2,3,2,604102,1508,105186,2770,0.013968653896031717,0.6474988312295465
6621,0.6671,2,1,2,604103,1507,105188,2768,0.013959390862944163,0.6474853801169591
6622,0.6672,2,3,2,604106,1504,105190,2766,0.0139316017636815,0.6477751756440281
6623,0.6673,1,3,1,604109,1501,105191,2765,0.013903812664418837,0.6481481481481481
6624,0.6674,1,2,1,604111,1499,105192,2764,0.013885286598243729,0.648369692704668
6625,0.6675,0,3,0,604114,1496,105192,2764,0.013857497498981066,0.6488262910798122
6626,0.6676,1,3,1,604117,1493,105193,2763,0.013829708399718404,0.6492011278195489
6627,0.6677,3,2,3,604119,1491,105196,2760,0.013811182333543295,0.6492589978828511
6628,0.6678,4,1,4,604120,1490,105200,2756,0.013801919300455741,0.6490814884597268
6629,0.6679,3,3,3,604123,1487,105203,2753,0.013774130201193079,0.6492924528301887
6630,0.668,2,1,2,604124,1486,105205,2751,0.013764867168105524,0.6492801510502714
6631,0.6681,2,2,2,604126,1484,105207,2749,0.013746341101930416,0.64942121426884
6632,0.6682,2,5,2,604131,1479,105209,2747,0.013700025936492645,0.6500236630383341
6633,0.6683,2,3,2,604134,1476,105211,2745,0.013672236837229982,0.650319829424307
6634,0.6684,3,2,3,604136,1474,105214,2742,0.013653710771054874,0.6503795066413662
6635,0.6685,0,3,0,604139,1471,105214,2742,0.013625921671792211,0.6508426299549015
6636,0.6686,1,1,1,604140,1470,105215,2741,0.013616658638704657,0.6509142721443838
6637,0.6687,1,3,1,604143,1467,105216,2740,0.013588869539441994,0.6512954599477062
6638,0.6688,3,0,3,604143,1467,105219,2737,0.013588869539441994,0.65104662226451
6639,0.6689,1,2,1,604145,1465,105220,2736,0.013570343473266886,0.6512735063080219
6640,0.669,2,1,2,604146,1464,105222,2734,0.013561080440179332,0.6512625059552167
6641,0.6691,1,2,1,604148,1462,105223,2733,0.013542554374004223,0.6514898688915376
6642,0.6693,2,1,2,604149,1461,105225,2731,0.01353329134091667,0.6514790076335878
6643,0.6694,4,0,4,604149,1461,105229,2727,0.01353329134091667,0.6511461318051576
6644,0.6695,1,3,1,604152,1458,105230,2726,0.013505502241654007,0.6515296367112811
6645,0.6696,1,3,1,604155,1455,105231,2725,0.013477713142391344,0.6519138755980861
6646,0.6697,1,1,1,604156,1454,105232,2724,0.01346845010930379,0.6519865964576352
6647,0.6698,6,3,6,604159,1451,105238,2718,0.013440661010041127,0.6519549052530583
6648,0.6699,3,1,3,604160,1450,105241,2715,0.013431397976953573,0.6518607442977191
6649,0.67,0,3,0,604163,1447,105241,2715,0.01340360887769091,0.6523306102835176
6650,0.6701,2,4,2,604167,1443,105243,2713,0.013366556745340694,0.6527911453320501
6651,0.6702,2,2,2,604169,1441,105245,2711,0.013348030679165585,0.6529383429672447
6652,0.6703,1,2,1,604171,1439,105246,2710,0.013329504612990477,0.6531694384188961
6653,0.6704,0,2,0,604173,1437,105246,2710,0.013310978546815368,0.6534844465878948
6654,0.6705,3,2,3,604175,1435,105249,2707,0.013292452480640262,0.653549010140029
6655,0.6706,1,2,1,604177,1433,105250,2706,0.013273926414465153,0.6537811065474752
6656,0.6707,2,0,2,604177,1433,105252,2704,0.013273926414465153,0.6536137297558617
6657,0.6708,3,3,3,604180,1430,105255,2701,0.01324613731520249,0.653836843379327
6658,0.6709,1,2,1,604182,1428,105256,2700,0.013227611249027382,0.6540697674418605
6659,0.671,2,0,2,604182,1428,105258,2698,0.013227611249027382,0.6539020843431895
6660,0.6711,2,1,2,604183,1427,105260,2696,0.013218348215939828,0.6538927965073975
6661,0.6712,1,1,1,604184,1426,105261,2695,0.013209085182852274,0.6539674836204805
6662,0.6713,1,1,1,604185,1425,105262,2694,0.01319982214976472,0.6540422432629279
6663,0.6714,1,2,1,604187,1423,105263,2693,0.013181296083589611,0.6542759961127308
6664,0.6715,2,2,2,604189,1421,105265,2691,0.013162770017414503,0.6544260700389105
6665,0.6716,5,1,5,604190,1420,105270,2686,0.013153506984326949,0.654164637116415
6666,0.6717,2,2,2,604192,1418,105272,2684,0.01313498091815184,0.6543149683081424
6667,0.6718,4,2,4,604194,1416,105276,2680,0.013116454851976732,0.654296875
6668,0.6719,3,1,3,604195,1415,105279,2677,0.013107191818889178,0.6542033235581622
6669,0.672,2,1,2,604196,1414,105281,2675,0.013097928785801623,0.6541941795059917
6670,0.6721,4,1,4,604197,1413,105285,2671,0.01308866575271407,0.6540156709108716
6671,0.6722,2,5,2,604202,1408,105287,2669,0.013042350587276298,0.6546480255089526
6672,0.6723,5,4,5,604206,1404,105292,2664,0.013005298454926081,0.6548672566371682
6673,0.6724,6,1,6,604207,1403,105298,2658,0.012996035421838527,0.6545185914799311
6674,0.6725,0,1,0,604208,1402,105298,2658,0.012986772388750973,0.6546798029556651
6675,0.6726,3,2,3,604210,1400,105301,2655,0.012968246322575865,0.654747225647349
6676,0.6727,2,2,2,604212,1398,105303,2653,0.012949720256400756,0.6549000246852629
6677,0.6728,3,3,3,604215,1395,105306,2650,0.012921931157138094,0.6551297898640297
6678,0.6729,0,2,0,604217,1393,105306,2650,0.012903405090962985,0.6554538708879545
6679,0.673,3,3,3,604220,1390,105309,2647,0.012875615991700323,0.6556849145405004
6680,0.6731,2,2,2,604222,1388,105311,2645,0.012857089925525214,0.6558393255640962
6681,0.6732,3,1,3,604223,1387,105314,2642,0.01284782689243766,0.6557458426408538
6682,0.6733,4,2,4,604225,1385,105318,2638,0.012829300826262552,0.6557295550584141
6683,0.6734,4,2,4,604227,1383,105322,2634,0.012810774760087443,0.655713218820015
6684,0.6735,3,1,3,604228,1382,105325,2631,0.012801511726999889,0.6556192374781958
6685,0.6736,6,3,6,604231,1379,105331,2625,0.012773722627737226,0.6555944055944056
6686,0.6737,1,0,1,604231,1379,105332,2624,0.012773722627737226,0.6555083687234574
6687,0.6738,3,0,3,604231,1379,105335,2621,0.012773722627737226,0.65525
6688,0.6739,4,0,4,604231,1379,105339,2617,0.012773722627737226,0.6549049049049049
6689,0.674,5,4,5,604235,1375,105344,2612,0.01273667049538701,0.655129169801856
6690,0.6741,0,4,0,604239,1371,105344,2612,0.012699618363036793,0.6557870951544063
6691,0.6742,2,2,2,604241,1369,105346,2610,0.012681092296861684,0.6559437044483538
6692,0.6743,1,2,1,604243,1367,105347,2609,0.012662566230686576,0.6561871227364185
6693,0.6744,1,2,1,604245,1365,105348,2608,0.012644040164511467,0.6564309086332746
6694,0.6745,1,1,1,604246,1364,105349,2607,0.012634777131423913,0.6565096952908587
6695,0.6746,2,3,2,604249,1361,105351,2605,0.01260698803216125,0.656833081190116
6696,0.6747,2,2,2,604251,1359,105353,2603,0.012588461965986142,0.6569914184755175
6697,0.6748,3,4,3,604255,1355,105356,2600,0.012551409833635925,0.6573957016434893
6698,0.6749,1,3,1,604258,1352,105357,2599,0.012523620734373263,0.6578081498354846
6699,0.675,1,0,1,604258,1352,105358,2598,0.012523620734373263,0.6577215189873418
6700,0.6751,1,1,1,604259,1351,105359,2597,0.012514357701285709,0.6578014184397163
6701,0.6752,1,2,1,604261,1349,105360,2596,0.0124958316351106,0.6580481622306718
6702,0.6753,3,0,3,604261,1349,105363,2593,0.0124958316351106,0.6577879249112126
6703,0.6754,1,2,1,604263,1347,105364,2592,0.012477305568935492,0.6580350342726581
6704,0.6755,2,2,2,604265,1345,105366,2590,0.012458779502760383,0.6581956797966964
6705,0.6756,0,2,0,604267,1343,105366,2590,0.012440253436585275,0.6585303839308416
6706,0.6757,3,2,3,604269,1341,105369,2587,0.012421727370410167,0.6586048879837068
6707,0.6758,2,1,2,604270,1340,105371,2585,0.012412464337322612,0.6585987261146496
6708,0.6759,3,3,3,604273,1337,105374,2582,0.01238467523805995,0.6588415412094922
6709,0.676,3,2,3,604275,1335,105377,2579,0.012366149171884841,0.6589167092488503
6710,0.6761,3,2,3,604277,1333,105380,2576,0.012347623105709733,0.6589920695830136
6711,0.6762,5,3,5,604280,1330,105385,2571,0.01231983400644707,0.6590617790310177
6712,0.6763,0,2,0,604282,1328,105385,2571,0.012301307940271962,0.6593998461143883
6713,0.6764,7,2,7,604284,1326,105392,2564,0.012282781874096853,0.6591259640102828
6714,0.6765,1,0,1,604284,1326,105393,2563,0.012282781874096853,0.6590383131910517
6715,0.6766,2,0,2,604284,1326,105395,2561,0.012282781874096853,0.6588628762541806
6716,0.6767,5,2,5,604286,1324,105400,2556,0.012264255807921745,0.6587628865979381
6717,0.6768,2,1,2,604287,1323,105402,2554,0.012254992774834191,0.6587567706989941
6718,0.6769,4,1,4,604288,1322,105406,2550,0.012245729741746637,0.6585743801652892
6719,0.677,0,3,0,604291,1319,105406,2550,0.012217940642483976,0.6590850348927372
6720,0.6771,1,1,1,604292,1318,105407,2549,0.012208677609396422,0.6591673131626584
6721,0.6772,2,2,2,604294,1316,105409,2547,0.012190151543221313,0.6593321252912244
6722,0.6773,1,0,1,604294,1316,105410,2546,0.012190151543221313,0.659243915069912
6723,0.6774,0,3,0,604297,1313,105410,2546,0.01216236244395865,0.6597564135786473
6724,0.6775,2,0,2,604297,1313,105412,2544,0.01216236244395865,0.6595799844438683
6725,0.6776,1,1,1,604298,1312,105413,2543,0.012153099410871096,0.659662775616083
6726,0.6777,3,1,3,604299,1311,105416,2540,0.012143836377783542,0.6595689431316542
6727,0.6778,3,4,3,604303,1307,105419,2537,0.012106784245433325,0.6599895941727367
6728,0.6779,0,2,0,604305,1305,105419,2537,0.012088258179258217,0.6603331598125977
6729,0.678,0,4,0,604309,1301,105419,2537,0.012051206046908,0.6610213652944242
6730,0.6781,3,0,3,604309,1301,105422,2534,0.012051206046908,0.6607561929595828
6731,0.6782,3,0,3,604309,1301,105425,2531,0.012051206046908,0.660490605427975
6732,0.6783,1,3,1,604312,1298,105426,2530,0.012023416947645338,0.6609195402298851
6733,0.6784,3,2,3,604314,1296,105429,2527,0.012004890881470229,0.6609992152759613
6734,0.6786,3,1,3,604315,1295,105432,2524,0.011995627848382675,0.6609059963341188
6735,0.6787,2,2,2,604317,1293,105434,2522,0.011977101782207566,0.6610747051114023
6736,0.6788,4,0,4,604317,1293,105438,2518,0.011977101782207566,0.660718971398583
6737,0.6789,1,3,1,604320,1290,105439,2517,0.011949312682944904,0.661150512214342
6738,0.679,2,3,2,604323,1287,105441,2515,0.011921523583682241,0.6614939505523408
6739,0.6791,2,1,2,604324,1286,105443,2513,0.011912260550594687,0.6614898657541458
6740,0.6792,1,1,1,604325,1285,105444,2512,0.011902997517507133,0.6615749275744008
6741,0.6793,4,1,4,604326,1284,105448,2508,0.011893734484419579,0.6613924050632911
6742,0.6794,5,0,5,604326,1284,105453,2503,0.011893734484419579,0.6609453393187219
6743,0.6795,2,0,2,604326,1284,105455,2501,0.011893734484419579,0.6607661822985469
6744,0.6796,3,4,3,604330,1280,105458,2498,0.011856682352069362,0.6611964002117523
6745,0.6797,1,1,1,604331,1279,105459,2497,0.011847419318981808,0.661281779661017
6746,0.6798,1,0,1,604331,1279,105460,2496,0.011847419318981808,0.6611920529801325
6747,0.6799,1,1,1,604332,1278,105461,2495,0.011838156285894253,0.6612774980121919
6748,0.6801,5,0,5,604332,1278,105466,2490,0.011838156285894253,0.660828025477707
6749,0.6802,6,4,6,604336,1274,105472,2484,0.011801104153544037,0.6609898882384246
6750,0.6803,6,1,6,604337,1273,105478,2478,0.011791841120456482,0.6606238336443615
6751,0.6804,2,0,2,604337,1273,105480,2476,0.011791841120456482,0.660442784742598
6752,0.6805,1,0,1,604337,1273,105481,2475,0.011791841120456482,0.6603521878335112
6753,0.6806,5,2,5,604339,1271,105486,2470,0.011773315054281374,0.6602512697139802
6754,0.6807,0,3,0,604342,1268,105486,2470,0.011745525955018711,0.660781166399144
6755,0.6808,3,1,3,604343,1267,105489,2467,0.011736262921931157,0.6606855918585967
6756,0.6809,5,1,5,604344,1266,105494,2462,0.011726999888843603,0.6604077253218884
6757,0.681,0,3,0,604347,1263,105494,2462,0.01169921078958094,0.6609395973154363
6758,0.6811,3,0,3,604347,1263,105497,2459,0.01169921078958094,0.6606663084363246
6759,0.6812,1,2,1,604349,1261,105498,2458,0.011680684723405832,0.660930357623017
6760,0.6813,6,1,6,604350,1260,105504,2452,0.011671421690318278,0.6605603448275862
6761,0.6814,4,3,4,604353,1257,105508,2448,0.011643632591055615,0.6607287449392713
6762,0.6815,4,2,4,604355,1255,105512,2444,0.011625106524880507,0.6607191132738578
6763,0.6816,2,0,2,604355,1255,105514,2442,0.011625106524880507,0.6605355693805789
6764,0.6817,2,1,2,604356,1254,105516,2440,0.011615843491792953,0.660530590146183
6765,0.6818,2,1,2,604357,1253,105518,2438,0.011606580458705398,0.6605256028176646
6766,0.6819,2,1,2,604358,1252,105520,2436,0.011597317425617844,0.6605206073752712
6767,0.682,3,1,3,604359,1251,105523,2433,0.01158805439253029,0.6604234527687296
6768,0.6821,2,2,2,604361,1249,105525,2431,0.011569528326355182,0.6605978260869565
6769,0.6822,3,1,3,604362,1248,105528,2428,0.011560265293267627,0.6605005440696409
6770,0.6823,3,2,3,604364,1246,105531,2425,0.011541739227092519,0.6605829474257695
6771,0.6824,4,2,4,604366,1244,105535,2421,0.01152321316091741,0.6605729877216917
6772,0.6825,2,1,2,604367,1243,105537,2419,0.011513950127829856,0.6605679956308028
6773,0.6826,5,4,5,604371,1239,105542,2414,0.01147689799547964,0.6608267177662196
6774,0.6827,2,2,2,604373,1237,105544,2412,0.011458371929304531,0.6610030145245273
6775,0.6828,1,0,1,604373,1237,105545,2411,0.011458371929304531,0.6609100877192983
6776,0.6829,3,1,3,604374,1236,105548,2408,0.011449108896216977,0.6608122941822173
6777,0.683,0,2,0,604376,1234,105548,2408,0.011430582830041868,0.6611751784733663
6778,0.6831,3,2,3,604378,1232,105551,2405,0.01141205676386676,0.6612592796260655
6779,0.6832,2,0,2,604378,1232,105553,2403,0.01141205676386676,0.6610729023383769
6780,0.6833,2,2,2,604380,1230,105555,2401,0.011393530697691652,0.6612503442577802
6781,0.6834,0,3,0,604383,1227,105555,2401,0.011365741598428989,0.6617971334068358
6782,0.6835,2,2,2,604385,1225,105557,2399,0.01134721553225388,0.6619757174392936
6783,0.6836,2,2,2,604387,1223,105559,2397,0.011328689466078772,0.6621546961325967
6784,0.6837,4,2,4,604389,1221,105563,2393,0.011310163399903664,0.6621472053126729
6785,0.6838,0,3,0,604392,1218,105563,2393,0.011282374300641001,0.6626973137635004
6786,0.6839,4,0,4,604392,1218,105567,2389,0.011282374300641001,0.6623232603271416
6787,0.684,2,0,2,604392,1218,105569,2387,0.011282374300641001,0.6621359223300971
6788,0.6841,2,0,2,604392,1218,105571,2385,0.011282374300641001,0.6619483763530392
6789,0.6842,1,2,1,604394,1216,105572,2384,0.011263848234465893,0.6622222222222223
6790,0.6843,4,1,4,604395,1215,105576,2380,0.011254585201378339,0.6620305980528511
6791,0.6844,4,2,4,604397,1213,105580,2376,0.01123605913520323,0.6620228475898579
6792,0.6845,2,1,2,604398,1212,105582,2374,0.011226796102115676,0.6620189626324595
6793,0.6846,2,0,2,604398,1212,105584,2372,0.011226796102115676,0.6618303571428571
6794,0.6847,3,3,3,604401,1209,105587,2369,0.011199007002853013,0.6621017328116267
6795,0.6848,1,5,1,604406,1204,105588,2368,0.011152691837415244,0.6629339305711086
6796,0.6849,0,4,0,604410,1200,105588,2368,0.011115639705065027,0.6636771300448431
6797,0.685,2,0,2,604410,1200,105590,2366,0.011115639705065027,0.6634885025238362
6798,0.6851,2,1,2,604411,1199,105592,2364,0.011106376671977473,0.6634858265506596
6799,0.6852,3,2,3,604413,1197,105595,2361,0.011087850605802365,0.663575042158516
6800,0.6853,2,1,2,604414,1196,105597,2359,0.01107858757271481,0.6635724331926863
6801,0.6854,3,2,3,604416,1194,105600,2356,0.011060061506539702,0.663661971830986
6802,0.6855,2,0,2,604416,1194,105602,2354,0.011060061506539702,0.6634723788049606
6803,0.6856,2,1,2,604417,1193,105604,2352,0.011050798473452148,0.6634696755994358
6804,0.6857,1,1,1,604418,1192,105605,2351,0.011041535440364594,0.6635619531470506
6805,0.6858,2,0,2,604418,1192,105607,2349,0.011041535440364594,0.6633719288336628
6806,0.6859,2,0,2,604418,1192,105609,2347,0.011041535440364594,0.6631816897428652
6807,0.686,2,2,2,604420,1190,105611,2345,0.011023009374189485,0.6633663366336634
6808,0.6861,1,0,1,604420,1190,105612,2344,0.011023009374189485,0.6632710809281268
6809,0.6862,0,2,0,604422,1188,105612,2344,0.011004483308014377,0.6636466591166478
6810,0.6863,1,0,1,604422,1188,105613,2343,0.011004483308014377,0.6635514018691588
6811,0.6864,3,0,3,604422,1188,105616,2340,0.011004483308014377,0.6632653061224489
6812,0.6865,0,4,0,604426,1184,105616,2340,0.01096743117566416,0.6640181611804767
6813,0.6866,2,2,2,604428,1182,105618,2338,0.010948905109489052,0.6642045454545454
6814,0.6867,0,1,0,604429,1181,105618,2338,0.010939642076401497,0.6643932935493038
6815,0.6868,4,0,4,604429,1181,105622,2334,0.010939642076401497,0.6640113798008535
6816,0.6869,0,1,0,604430,1180,105622,2334,0.010930379043313943,0.6642003414911781
6817,0.687,1,1,1,604431,1179,105623,2333,0.010921116010226389,0.6642938496583144
6818,0.6871,3,1,3,604432,1178,105626,2330,0.010911852977138835,0.6641961231470923
6819,0.6872,2,2,2,604434,1176,105628,2328,0.010893326910963726,0.6643835616438356
6820,0.6873,2,2,2,604436,1174,105630,2326,0.010874800844788618,0.6645714285714286
6821,0.6874,0,3,0,604439,1171,105630,2326,0.010847011745525955,0.6651415498999143
6822,0.6875,0,2,0,604441,1169,105630,2326,0.010828485679350847,0.66552217453505
6823,0.6876,3,4,3,604445,1165,105633,2323,0.01079143354700063,0.6659977064220184
6824,0.6877,2,1,2,604446,1164,105635,2321,0.010782170513913076,0.6659971305595409
6825,0.6878,1,1,1,604447,1163,105636,2320,0.010772907480825522,0.6660924490381854
6826,0.6879,1,1,1,604448,1162,105637,2319,0.010763644447737968,0.6661878770468256
6827,0.688,2,0,2,604448,1162,105639,2317,0.010763644447737968,0.6659959758551308
6828,0.6881,3,1,3,604449,1161,105642,2314,0.010754381414650413,0.6658992805755396
6829,0.6882,3,1,3,604450,1160,105645,2311,0.010745118381562859,0.6658023624315759
6830,0.6883,3,0,3,604450,1160,105648,2308,0.010745118381562859,0.6655132641291811
6831,0.6884,1,1,1,604451,1159,105649,2307,0.010735855348475305,0.6656087709174842
6832,0.6885,2,3,2,604454,1156,105651,2305,0.010708066249212642,0.665992487720312
6833,0.6886,4,3,4,604457,1153,105655,2301,0.01068027714994998,0.6661841343370006
6834,0.6887,1,2,1,604459,1151,105656,2300,0.010661751083774871,0.6664734859461026
6835,0.6888,3,2,3,604461,1149,105659,2297,0.010643225017599763,0.6665699361578642
6836,0.6889,4,1,4,604462,1148,105663,2293,0.010633961984512209,0.6663760534728277
6837,0.689,2,1,2,604463,1147,105665,2291,0.010624698951424654,0.6663757998836533
6838,0.6891,2,1,2,604464,1146,105667,2289,0.0106154359183371,0.6663755458515284
6839,0.6892,3,3,3,604467,1143,105670,2286,0.010587646819074438,0.6666666666666666
6840,0.6893,1,1,1,604468,1142,105671,2285,0.010578383785986883,0.6667639334695069
6841,0.6894,4,0,4,604468,1142,105675,2281,0.010578383785986883,0.6663745252702308
6842,0.6895,2,1,2,604469,1141,105677,2279,0.01056912075289933,0.666374269005848
6843,0.6896,0,1,0,604470,1140,105677,2279,0.010559857719811775,0.6665691722725944
6844,0.6897,1,1,1,604471,1139,105678,2278,0.01055059468672422,0.6666666666666666
6845,0.6898,1,0,1,604471,1139,105679,2277,0.01055059468672422,0.6665690866510539
6846,0.6899,1,2,1,604473,1137,105680,2276,0.010532068620549112,0.6668619982420159
6847,0.69,4,1,4,604474,1136,105684,2272,0.010522805587461558,0.6666666666666666
6848,0.6901,3,0,3,604474,1136,105687,2269,0.010522805587461558,0.6663729809104258
6849,0.6902,3,4,3,604478,1132,105690,2266,0.010485753455111341,0.6668628605061802
6850,0.6903,2,1,2,604479,1131,105692,2264,0.010476490422023787,0.6668630338733431
6851,0.6904,4,1,4,604480,1130,105696,2260,0.010467227388936233,0.6666666666666666
6852,0.6905,3,4,3,604484,1126,105699,2257,0.010430175256586016,0.6671593260419746
6853,0.6906,4,2,4,604486,1124,105703,2253,0.010411649190410908,0.6671602013621558
6854,0.6907,1,0,1,604486,1124,105704,2252,0.010411649190410908,0.6670616113744076
6855,0.6908,2,0,2,604486,1124,105706,2250,0.010411649190410908,0.6668642560758743
6856,0.6909,2,1,2,604487,1123,105708,2248,0.010402386157323354,0.6668644319193118
6857,0.691,3,3,3,604490,1120,105711,2245,0.010374597058060691,0.6671619613670133
6858,0.6911,3,4,3,604494,1116,105714,2242,0.010337544925710474,0.6676593210244193
6859,0.6912,0,1,0,604495,1115,105714,2242,0.01032828189262292,0.6678582067322014
6860,0.6913,2,0,2,604495,1115,105716,2240,0.01032828189262292,0.6676602086438153
6861,0.6914,2,2,2,604497,1113,105718,2238,0.010309755826447812,0.6678603401969562
6862,0.6915,3,4,3,604501,1109,105721,2235,0.010272703694097595,0.6683612440191388
6863,0.6916,0,2,0,604503,1107,105721,2235,0.010254177627922486,0.6687612208258528
6864,0.6917,2,0,2,604503,1107,105723,2233,0.010254177627922486,0.668562874251497
6865,0.6918,2,0,2,604503,1107,105725,2231,0.010254177627922486,0.6683642899940084
6866,0.6919,2,2,2,604505,1105,105727,2229,0.010235651561747378,0.6685662867426515
6867,0.692,3,3,3,604508,1102,105730,2226,0.010207862462484715,0.6688701923076923
6868,0.6921,2,0,2,604508,1102,105732,2224,0.010207862462484715,0.6686710763680096
6869,0.6922,1,1,1,604509,1101,105733,2223,0.010198599429397161,0.6687725631768953
6870,0.6923,0,1,0,604510,1100,105733,2223,0.010189336396309607,0.668973818838399
6871,0.6924,2,0,2,604510,1100,105735,2221,0.010189336396309607,0.668774465522433
6872,0.6925,1,2,1,604512,1098,105736,2220,0.010170810330134498,0.6690777576853526
6873,0.6926,2,2,2,604514,1096,105738,2218,0.01015228426395939,0.6692818346409173
6874,0.6927,2,0,2,604514,1096,105740,2216,0.01015228426395939,0.6690821256038647
6875,0.6928,3,0,3,604514,1096,105743,2213,0.01015228426395939,0.6687821093986098
6876,0.6929,2,0,2,604514,1096,105745,2211,0.01015228426395939,0.6685817961899002
6877,0.693,4,0,4,604514,1096,105749,2207,0.01015228426395939,0.6681804420224039
6878,0.6931,5,3,5,604517,1093,105754,2202,0.010124495164696727,0.6682852807283763
6879,0.6932,3,3,3,604520,1090,105757,2199,0.010096706065434067,0.6685922772879295
6880,0.6933,2,6,2,604526,1084,105759,2197,0.010041127866908741,0.669612922889363
6881,0.6934,0,2,0,604528,1082,105759,2197,0.010022601800733633,0.6700213479719427
6882,0.6935,2,3,2,604531,1079,105761,2195,0.00999481270147097,0.6704337202199144
6883,0.6936,2,2,2,604533,1077,105763,2193,0.009976286635295862,0.6706422018348623
6884,0.6937,1,2,1,604535,1075,105764,2192,0.009957760569120754,0.6709519436792164
6885,0.6938,3,1,3,604536,1074,105767,2189,0.0099484975360332,0.6708550413729697
6886,0.6939,3,1,3,604537,1073,105770,2186,0.009939234502945645,0.6707579011966861
6887,0.694,2,3,2,604540,1070,105772,2184,0.009911445403682983,0.6711739397664414
6888,0.6941,4,1,4,604541,1069,105776,2180,0.009902182370595428,0.6709756848261004
6889,0.6942,2,1,2,604542,1068,105778,2178,0.009892919337507874,0.6709796672828097
6890,0.6943,1,1,1,604543,1067,105779,2177,0.00988365630442032,0.6710850801479655
6891,0.6944,3,1,3,604544,1066,105782,2174,0.009874393271332766,0.6709876543209876
6892,0.6945,3,1,3,604545,1065,105785,2171,0.009865130238245211,0.6708899876390606
6893,0.6946,1,0,1,604545,1065,105786,2170,0.009865130238245211,0.6707882534775889
6894,0.6947,3,3,3,604548,1062,105789,2167,0.009837341138982549,0.6711056054506039
6895,0.6948,2,0,2,604548,1062,105791,2165,0.009837341138982549,0.6709017663464518
6896,0.6949,3,2,3,604550,1060,105794,2162,0.00981881507280744,0.6710117939168219
6897,0.695,1,1,1,604551,1059,105795,2161,0.009809552039719886,0.6711180124223602
6898,0.6951,1,1,1,604552,1058,105796,2160,0.009800289006632332,0.6712243629583592
6899,0.6952,0,1,0,604553,1057,105796,2160,0.009791025973544778,0.671433012123096
6900,0.6953,1,1,1,604554,1056,105797,2159,0.009781762940457224,0.6715396578538103
6901,0.6954,1,0,1,604554,1056,105798,2158,0.009781762940457224,0.671437461107654
6902,0.6955,1,0,1,604554,1056,105799,2157,0.009781762940457224,0.6713352007469654
6903,0.6956,3,2,3,604556,1054,105802,2154,0.009763236874282115,0.6714463840399002
6904,0.6957,6,2,6,604558,1052,105808,2148,0.009744710808107007,0.67125
6905,0.6958,1,3,1,604561,1049,105809,2147,0.009716921708844344,0.6717772215269087
6906,0.6959,4,1,4,604562,1048,105813,2143,0.00970765867575679,0.671576308367283
6907,0.696,2,2,2,604564,1046,105815,2141,0.009689132609581682,0.6717916535927204
6908,0.6961,0,2,0,604566,1044,105815,2141,0.009670606543406573,0.6722135007849294
6909,0.6962,2,2,2,604568,1042,105817,2139,0.009652080477231465,0.6724300534423138
6910,0.6963,3,2,3,604570,1040,105820,2136,0.009633554411056356,0.672544080604534
6911,0.6964,3,1,3,604571,1039,105823,2133,0.009624291377968802,0.6724464060529635
6912,0.6965,3,3,3,604574,1036,105826,2130,0.00959650227870614,0.6727732154137713
6913,0.6966,2,1,2,604575,1035,105828,2128,0.009587239245618585,0.6727790072715776
6914,0.6967,3,1,3,604576,1034,105831,2125,0.009577976212531031,0.6726812282367838
6915,0.6968,4,0,4,604576,1034,105835,2121,0.009577976212531031,0.6722662440570523
6916,0.6969,2,2,2,604578,1032,105837,2119,0.009559450146355923,0.6724849254205014
6917,0.697,4,0,4,604578,1032,105841,2115,0.009559450146355923,0.6720686367969495
6918,0.6971,4,1,4,604579,1031,105845,2111,0.009550187113268369,0.6718650541056652
6919,0.6972,4,1,4,604580,1030,105849,2107,0.009540924080180814,0.6716608224418233
6920,0.6973,4,2,4,604582,1028,105853,2103,0.009522398014005706,0.6716703928457362
6921,0.6974,1,0,1,604582,1028,105854,2102,0.009522398014005706,0.6715654952076677
6922,0.6975,2,0,2,604582,1028,105856,2100,0.009522398014005706,0.6713554987212276
6923,0.6976,1,1,1,604583,1027,105857,2099,0.009513134980918152,0.6714651311580294
6924,0.6977,3,3,3,604586,1024,105860,2096,0.009485345881655489,0.6717948717948717
6925,0.6978,2,2,2,604588,1022,105862,2094,0.00946681981548038,0.67201540436457
6926,0.6979,1,2,1,604590,1020,105863,2093,0.009448293749305272,0.6723417924831352
6927,0.698,2,1,2,604591,1019,105865,2091,0.009439030716217718,0.672347266881029
6928,0.6982,1,1,1,604592,1018,105866,2090,0.009429767683130164,0.6724581724581724
6929,0.6983,2,2,2,604594,1016,105868,2088,0.009411241616955055,0.6726804123711341
6930,0.6984,1,1,1,604595,1015,105869,2087,0.009401978583867501,0.6727917472598324
6931,0.6985,3,1,3,604596,1014,105872,2084,0.009392715550779947,0.6726920593931569
6932,0.6986,1,0,1,604596,1014,105873,2083,0.009392715550779947,0.6725863739102357
6933,0.6987,0,1,0,604597,1013,105873,2083,0.009383452517692393,0.6728036175710594
6934,0.6988,3,1,3,604598,1012,105876,2080,0.009374189484604839,0.6727037516170763
6935,0.6989,0,3,0,604601,1009,105876,2080,0.009346400385342176,0.6733570734865653
6936,0.699,2,4,2,604605,1005,105878,2078,0.00930934825299196,0.6740188128446318
6937,0.6991,1,1,1,604606,1004,105879,2077,0.009300085219904405,0.6741317753975982
6938,0.6992,0,1,0,604607,1003,105879,2077,0.00929082218681685,0.6743506493506494
6939,0.6993,1,1,1,604608,1002,105880,2076,0.009281559153729297,0.6744639376218323
6940,0.6994,1,0,1,604608,1002,105881,2075,0.009281559153729297,0.6743581410464738
6941,0.6995,2,2,2,604610,1000,105883,2073,0.009263033087554188,0.6745850959973967
6942,0.6996,2,0,2,604610,1000,105885,2071,0.009263033087554188,0.674373168349072
6943,0.6997,1,1,1,604611,999,105886,2070,0.009253770054466634,0.6744868035190615
6944,0.6998,4,5,4,604616,994,105890,2066,0.009207454889028863,0.6751633986928105
6945,0.6999,1,0,1,604616,994,105891,2065,0.009207454889028863,0.6750572082379863
6946,0.7,3,1,3,604617,993,105894,2062,0.009198191855941309,0.6749590834697218
6947,0.7001,1,4,1,604621,989,105895,2061,0.009161139723591092,0.6757377049180328
6948,0.7002,1,1,1,604622,988,105896,2060,0.009151876690503538,0.6758530183727034
6949,0.7003,0,1,0,604623,987,105896,2060,0.009142613657415984,0.6760748276993764
6950,0.7004,1,1,1,604624,986,105897,2059,0.00913335062432843,0.6761904761904762
6951,0.7005,3,1,3,604625,985,105900,2056,0.009124087591240875,0.6760933903321276
6952,0.7006,3,3,3,604628,982,105903,2053,0.009096298491978213,0.6764415156507414
6953,0.7007,3,1,3,604629,981,105906,2050,0.009087035458890658,0.6763444407786209
6954,0.7008,2,1,2,604630,980,105908,2048,0.009077772425803104,0.6763540290620872
6955,0.7009,0,3,0,604633,977,105908,2048,0.009049983326540442,0.6770247933884298
6956,0.701,2,1,2,604634,976,105910,2046,0.009040720293452889,0.6770350761085374
6957,0.7011,3,2,3,604636,974,105913,2043,0.00902219422727778,0.6771627444481273
6958,0.7012,2,2,2,604638,972,105915,2041,0.009003668161102672,0.677397942250249
6959,0.7013,5,4,5,604642,968,105920,2036,0.008966616028752455,0.677762982689747
6960,0.7014,1,0,1,604642,968,105921,2035,0.008966616028752455,0.6776556776556777
6961,0.7015,2,1,2,604643,967,105923,2033,0.008957352995664901,0.6776666666666666
6962,0.7016,3,0,3,604643,967,105926,2030,0.008957352995664901,0.6773440106773441
6963,0.7017,5,1,5,604644,966,105931,2025,0.008948089962577347,0.6770310932798396
6964,0.7018,1,0,1,604644,966,105932,2024,0.008948089962577347,0.676923076923077
6965,0.7019,2,0,2,604644,966,105934,2022,0.008948089962577347,0.6767068273092369
6966,0.702,1,2,1,604646,964,105935,2021,0.008929563896402239,0.6770519262981575
6967,0.7021,3,1,3,604647,963,105938,2018,0.008920300863314684,0.6769540422676954
6968,0.7022,1,2,1,604649,961,105939,2017,0.008901774797139576,0.6773002014775017
6969,0.7023,5,2,5,604651,959,105944,2012,0.008883248730964468,0.6772130595759004
6970,0.7024,0,2,0,604653,957,105944,2012,0.00886472266478936,0.6776692489053553
6971,0.7025,1,2,1,604655,955,105945,2011,0.00884619659861425,0.6780175320296696
6972,0.7026,1,1,1,604656,954,105946,2010,0.008836933565526697,0.6781376518218624
6973,0.7027,1,4,1,604660,950,105947,2009,0.00879988143317648,0.6789455897262588
6974,0.7028,2,0,2,604660,950,105949,2007,0.00879988143317648,0.6787284409874873
6975,0.7029,2,1,2,604661,949,105951,2005,0.008790618400088926,0.6787406905890319
6976,0.703,0,1,0,604662,948,105951,2005,0.008781355367001371,0.6789705384354894
6977,0.7031,3,0,3,604662,948,105954,2002,0.008781355367001371,0.6786440677966101
6978,0.7032,1,1,1,604663,947,105955,2001,0.008772092333913817,0.6787652645861602
6979,0.7033,2,0,2,604663,947,105957,1999,0.008772092333913817,0.6785471826205024
6980,0.7034,2,3,2,604666,944,105959,1997,0.008744303234651155,0.6790207412444746
6981,0.7035,3,0,3,604666,944,105962,1994,0.008744303234651155,0.6786929884275017
6982,0.7036,0,1,0,604667,943,105962,1994,0.0087350402015636,0.6789240721824992
6983,0.7037,3,0,3,604667,943,105965,1991,0.0087350402015636,0.6785957736877982
6984,0.7038,1,0,1,604667,943,105966,1990,0.0087350402015636,0.6784861916126833
6985,0.7039,3,0,3,604667,943,105969,1987,0.0087350402015636,0.6781569965870308
6986,0.704,2,0,2,604667,943,105971,1985,0.0087350402015636,0.6779371584699454
6987,0.7041,1,5,1,604672,938,105972,1984,0.00868872503612583,0.6789869952087612
6988,0.7042,3,3,3,604675,935,105975,1981,0.008660935936863167,0.6793552812071331
6989,0.7043,1,0,1,604675,935,105976,1980,0.008660935936863167,0.6792452830188679
6990,0.7044,1,2,1,604677,933,105977,1979,0.008642409870688058,0.6796016483516484
6991,0.7045,2,1,2,604678,932,105979,1977,0.008633146837600504,0.679614987968374
6992,0.7046,1,1,1,604679,931,105980,1976,0.00862388380451295,0.6797385620915033
6993,0.7047,2,1,2,604680,930,105982,1974,0.008614620771425396,0.6797520661157025
6994,0.7048,4,3,4,604683,927,105986,1970,0.008586831672162733,0.680013807386952
6995,0.7049,5,2,5,604685,925,105991,1965,0.008568305605987625,0.6799307958477508
6996,0.705,1,0,1,604685,925,105992,1964,0.008568305605987625,0.6798200069228106
6997,0.7051,4,2,4,604687,923,105996,1960,0.008549779539812516,0.6798473812001388
6998,0.7052,2,2,2,604689,921,105998,1958,0.008531253473637408,0.6800972559916638
6999,0.7054,3,1,3,604690,920,106001,1955,0.008521990440549854,0.68
7000,0.7055,2,2,2,604692,918,106003,1953,0.008503464374374745,0.6802507836990596
7001,0.7056,2,1,2,604693,917,106005,1951,0.008494201341287191,0.6802649930264993
7002,0.7057,2,0,2,604693,917,106007,1949,0.008494201341287191,0.6800418702023726
7003,0.7058,1,0,1,604693,917,106008,1948,0.008494201341287191,0.6799301919720768
7004,0.7059,3,1,3,604694,916,106011,1945,0.008484938308199637,0.6798322264942328
7005,0.706,3,0,3,604694,916,106014,1942,0.008484938308199637,0.6794961511546536
7006,0.7061,1,2,1,604696,914,106015,1941,0.008466412242024528,0.6798598949211909
7007,0.7062,0,2,0,604698,912,106015,1941,0.00844788617584942,0.6803364879074658
7008,0.7063,0,1,0,604699,911,106015,1941,0.008438623142761866,0.6805750350631136
7009,0.7064,1,1,1,604700,910,106016,1940,0.008429360109674312,0.6807017543859649
7010,0.7065,1,0,1,604700,910,106017,1939,0.008429360109674312,0.6805896805896806
7011,0.7066,5,3,5,604703,907,106022,1934,0.008401571010411649,0.6807462161210841
7012,0.7067,5,1,5,604704,906,106027,1929,0.008392307977324095,0.6804232804232804
7013,0.7069,5,1,5,604705,905,106032,1924,0.00838304494423654,0.6800989749027925
7014,0.707,2,1,2,604706,904,106034,1922,0.008373781911148986,0.6801132342533617
7015,0.7071,2,2,2,604708,902,106036,1920,0.008355255844973878,0.6803685329553508
7016,0.7072,1,1,1,604709,901,106037,1919,0.008345992811886324,0.6804964539007092
7017,0.7073,1,5,1,604714,896,106038,1918,0.008299677646448553,0.681592039800995
7018,0.7074,1,2,1,604716,894,106039,1917,0.008281151580273444,0.6819637139807898
7019,0.7075,4,1,4,604717,893,106043,1913,0.00827188854718589,0.6817533856022808
7020,0.7077,0,3,0,604720,890,106043,1913,0.008244099447923228,0.6824830538708526
7021,0.7078,2,1,2,604721,889,106045,1911,0.008234836414835673,0.6825
7022,0.7079,1,1,1,604722,888,106046,1910,0.00822557338174812,0.6826304503216584
7023,0.708,7,1,7,604723,887,106053,1903,0.008216310348660565,0.682078853046595
7024,0.7081,3,0,3,604723,887,106056,1900,0.008216310348660565,0.6817366343738788
7025,0.7082,6,2,6,604725,885,106062,1894,0.008197784282485457,0.6815401223461677
7026,0.7083,1,2,1,604727,883,106063,1893,0.008179258216310348,0.6819164265129684
7027,0.7084,2,0,2,604727,883,106065,1891,0.008179258216310348,0.6816870944484499
7028,0.7086,1,1,1,604728,882,106066,1890,0.008169995183222794,0.6818181818181818
7029,0.7087,3,1,3,604729,881,106069,1887,0.00816073215013524,0.6817196531791907
7030,0.7088,1,0,1,604729,881,106070,1886,0.00816073215013524,0.6816046259486809
7031,0.7089,3,2,3,604731,879,106073,1883,0.008142206083960131,0.6817523533671253
7032,0.709,1,0,1,604731,879,106074,1882,0.008142206083960131,0.68163708801159
7033,0.7091,1,0,1,604731,879,106075,1881,0.008142206083960131,0.6815217391304348
7034,0.7092,0,1,0,604732,878,106075,1881,0.008132943050872577,0.6817687567959405
7035,0.7093,2,2,2,604734,876,106077,1879,0.008114416984697469,0.682032667876588
7036,0.7094,3,1,3,604735,875,106080,1876,0.008105153951609914,0.6819338422391857
7037,0.7095,2,2,2,604737,873,106082,1874,0.008086627885434806,0.6821987622861303
7038,0.7096,2,1,2,604738,872,106084,1872,0.008077364852347252,0.6822157434402333
7039,0.7097,0,1,0,604739,871,106084,1872,0.008068101819259698,0.6824644549763034
7040,0.7098,3,3,3,604742,868,106087,1869,0.008040312719997035,0.6828644501278772
7041,0.7099,3,3,3,604745,865,106090,1866,0.008012523620734372,0.6832662028560966
7042,0.7101,1,0,1,604745,865,106091,1865,0.008012523620734372,0.6831501831501832
7043,0.7102,3,1,3,604746,864,106094,1862,0.008003260587646818,0.6830520909757887
7044,0.7103,5,1,5,604747,863,106099,1857,0.007993997554559264,0.6827205882352941
7045,0.7104,0,5,0,604752,858,106099,1857,0.007947682389121495,0.6839779005524862
7046,0.7105,1,2,1,604754,856,106100,1856,0.007929156322946386,0.6843657817109144
7047,0.7106,2,1,2,604755,855,106102,1854,0.007919893289858832,0.6843853820598007
7048,0.7107,1,2,1,604757,853,106103,1853,0.007901367223683724,0.6847745750184775
7049,0.7108,5,0,5,604757,853,106108,1848,0.007901367223683724,0.6841910403554239
7050,0.7109,2,2,2,604759,851,106110,1846,0.007882841157508615,0.6844642195031516
7051,0.711,1,0,1,604759,851,106111,1845,0.007882841157508615,0.6843471810089021
7052,0.7111,1,3,1,604762,848,106112,1844,0.007855052058245953,0.6849925705794948
7053,0.7112,2,2,2,604764,846,106114,1842,0.007836525992070844,0.6852678571428571
7054,0.7113,2,1,2,604765,845,106116,1840,0.00782726295898329,0.6852886405959032
7055,0.7114,3,1,3,604766,844,106119,1837,0.007817999925895736,0.6851920925027974
7056,0.7115,1,1,1,604767,843,106120,1836,0.007808736892808181,0.6853303471444568
7057,0.7116,2,0,2,604767,843,106122,1834,0.007808736892808181,0.6850952558834517
7058,0.7117,3,3,3,604770,840,106125,1831,0.007780947793545518,0.685511044552602
7059,0.7118,3,1,3,604771,839,106128,1828,0.007771684760457964,0.6854143232095988
7060,0.712,2,0,2,604771,839,106130,1826,0.007771684760457964,0.6851782363977486
7061,0.7121,2,0,2,604771,839,106132,1824,0.007771684760457964,0.6849417949680812
7062,0.7122,2,3,2,604774,836,106134,1822,0.007743895661195301,0.6854778028592927
7063,0.7123,3,1,3,604775,835,106137,1819,0.007734632628107747,0.685380557648832
7064,0.7124,3,1,3,604776,834,106140,1816,0.007725369595020193,0.6852830188679245
7065,0.7125,2,0,2,604776,834,106142,1814,0.007725369595020193,0.6850453172205438
7066,0.7126,1,0,1,604776,834,106143,1813,0.007725369595020193,0.6849263316962599
7067,0.7127,1,0,1,604776,834,106144,1812,0.007725369595020193,0.6848072562358276
7068,0.7128,2,2,2,604778,832,106146,1810,0.0077068435288450855,0.6850870552611658
7069,0.7129,1,0,1,604778,832,106147,1809,0.0077068435288450855,0.684967815221507
7070,0.7131,1,0,1,604778,832,106148,1808,0.0077068435288450855,0.6848484848484848
7071,0.7132,1,1,1,604779,831,106149,1807,0.007697580495757531,0.6849886277482942
7072,0.7133,1,1,1,604780,830,106150,1806,0.007688317462669977,0.6851289833080425
7073,0.7134,1,0,1,604780,830,106151,1805,0.007688317462669977,0.6850094876660342
7074,0.7135,2,2,2,604782,828,106153,1803,0.007669791396494869,0.685290763968073
7075,0.7136,1,1,1,604783,827,106154,1802,0.0076605283634073144,0.6854317230886269
7076,0.7137,3,1,3,604784,826,106157,1799,0.00765126533031976,0.6853333333333333
7077,0.7138,3,1,3,604785,825,106160,1796,0.007642002297232206,0.6852346432659291
7078,0.7139,2,0,2,604785,825,106162,1794,0.007642002297232206,0.6849942726231386
7079,0.714,6,2,6,604787,823,106168,1788,0.007623476231057098,0.6847950976637304
7080,0.7141,3,0,3,604787,823,106171,1785,0.007623476231057098,0.6844325153374233
7081,0.7142,1,0,1,604787,823,106172,1784,0.007623476231057098,0.6843114691215957
7082,0.7143,2,2,2,604789,821,106174,1782,0.007604950164881989,0.6845946984248944
7083,0.7144,1,2,1,604791,819,106175,1781,0.007586424098706881,0.685
7084,0.7145,2,0,2,604791,819,106177,1779,0.007586424098706881,0.684757505773672
7085,0.7146,1,2,1,604793,817,106178,1778,0.007567898032531772,0.6851637764932562
7086,0.7147,2,1,2,604794,816,106180,1776,0.007558634999444218,0.6851851851851852
7087,0.7148,2,0,2,604794,816,106182,1774,0.007558634999444218,0.684942084942085
7088,0.7149,1,3,1,604797,813,106183,1773,0.007530845900181556,0.685614849187935
7089,0.715,2,1,2,604798,812,106185,1771,0.007521582867094001,0.6856368563685636
7090,0.7151,2,0,2,604798,812,106187,1769,0.007521582867094001,0.6853932584269663
7091,0.7152,3,0,3,604798,812,106190,1766,0.007521582867094001,0.6850271528316525
7092,0.7153,3,1,3,604799,811,106193,1763,0.007512319834006447,0.684926184926185
7093,0.7154,1,0,1,604799,811,106194,1762,0.007512319834006447,0.6848037310532452
7094,0.7155,1,2,1,604801,809,106195,1761,0.007493793767831339,0.6852140077821012
7095,0.7156,1,0,1,604801,809,106196,1760,0.007493793767831339,0.6850914752822109
7096,0.7157,1,0,1,604801,809,106197,1759,0.007493793767831339,0.6849688473520249
7097,0.7158,4,2,4,604803,807,106201,1755,0.00747526770165623,0.6850117096018735
7098,0.7159,2,1,2,604804,806,106203,1753,0.007466004668568676,0.6850332161000391
7099,0.716,0,2,0,604806,804,106203,1753,0.007447478602393568,0.6855690262025812
7100,0.7161,1,2,1,604808,802,106204,1752,0.007428952536218459,0.6859827721221613
7101,0.7162,2,3,2,604811,799,106206,1750,0.007401163436955797,0.6865437426441742
7102,0.7163,5,0,5,604811,799,106211,1745,0.007401163436955797,0.6859276729559748
7103,0.7164,0,3,0,604814,796,106211,1745,0.007373374337693134,0.6867375049193231
7104,0.7165,1,3,1,604817,793,106212,1744,0.0073455852384304715,0.6874260938115885
7105,0.7166,3,1,3,604818,792,106215,1741,0.007336322205342917,0.6873272799052507
7106,0.7167,3,2,3,604820,790,106218,1738,0.007317796139167809,0.6875
7107,0.7168,4,0,4,604820,790,106222,1734,0.007317796139167809,0.6870047543581617
7108,0.7169,0,1,0,604821,789,106222,1734,0.007308533106080255,0.6872770511296076
7109,0.717,2,0,2,604821,789,106224,1732,0.007308533106080255,0.6870289567631892
7110,0.7171,3,1,3,604822,788,106227,1729,0.0072992700729927005,0.6869288835915772
7111,0.7172,1,1,1,604823,787,106228,1728,0.007290007039905146,0.6870775347912524
7112,0.7173,3,0,3,604823,787,106231,1725,0.007290007039905146,0.6867038216560509
7113,0.7174,3,1,3,604824,786,106234,1722,0.007280744006817592,0.6866028708133971
7114,0.7175,2,2,2,604826,784,106236,1720,0.007262217940642484,0.6869009584664537
7115,0.7176,3,1,3,604827,783,106239,1717,0.0072529549075549295,0.6868
7116,0.7177,2,3,2,604830,780,106241,1715,0.007225165808292267,0.687374749498998
7117,0.7178,2,4,2,604834,776,106243,1713,0.00718811367594205,0.6882282040980313
7118,0.7179,1,2,1,604836,774,106244,1712,0.0071695876097669425,0.6886564762670957
7119,0.718,1,0,1,604836,774,106245,1711,0.0071695876097669425,0.6885311871227364
7120,0.7181,2,0,2,604836,774,106247,1709,0.0071695876097669425,0.6882803060813532
7121,0.7182,1,1,1,604837,773,106248,1708,0.007160324576679388,0.6884320838371625
7122,0.7183,1,0,1,604837,773,106249,1707,0.007160324576679388,0.6883064516129033
7123,0.7185,1,0,1,604837,773,106250,1706,0.007160324576679388,0.6881807180314643
7124,0.7186,3,0,3,604837,773,106253,1703,0.007160324576679388,0.6878029079159935
7125,0.7187,2,1,2,604838,772,106255,1701,0.007151061543591834,0.6878285483218762
7126,0.7188,3,0,3,604838,772,106258,1698,0.007151061543591834,0.6874493927125506
7127,0.7189,1,0,1,604838,772,106259,1697,0.007151061543591834,0.6873228027541515
7128,0.719,2,2,2,604840,770,106261,1695,0.007132535477416726,0.6876267748478702
7129,0.7191,1,0,1,604840,770,106262,1694,0.007132535477416726,0.6875
7130,0.7192,1,3,1,604843,767,106263,1693,0.007104746378154063,0.6882113821138212
7131,0.7193,2,1,2,604844,766,106265,1691,0.007095483345066509,0.6882376882376883
7132,0.7194,2,0,2,604844,766,106267,1689,0.007095483345066509,0.6879837067209776
7133,0.7196,1,2,1,604846,764,106268,1688,0.0070769572788914005,0.6884176182707994
7134,0.7197,3,0,3,604846,764,106271,1685,0.0070769572788914005,0.6880359330338914
7135,0.7198,0,3,0,604849,761,106271,1685,0.007049168179628738,0.6888798037612428
7136,0.7199,4,2,4,604851,759,106275,1681,0.0070306421134536294,0.6889344262295082
7137,0.72,2,1,2,604852,758,106277,1679,0.007021379080366075,0.6889618383258104
7138,0.7201,0,4,0,604856,754,106277,1679,0.006984326948015858,0.6900945334977394
7139,0.7202,1,0,1,604856,754,106278,1678,0.006984326948015858,0.6899671052631579
7140,0.7203,1,1,1,604857,753,106279,1677,0.006975063914928304,0.6901234567901234
7141,0.7204,1,0,1,604857,753,106280,1676,0.006975063914928304,0.6899958830794566
7142,0.7205,3,3,3,604860,750,106283,1673,0.006947274815665642,0.6904663640115559
7143,0.7206,2,0,2,604860,750,106285,1671,0.006947274815665642,0.6902106567534076
7144,0.7207,4,1,4,604861,749,106289,1667,0.006938011782578087,0.6899834437086093
7145,0.7208,4,1,4,604862,748,106293,1663,0.006928748749490533,0.689755288262132
7146,0.7209,2,1,2,604863,747,106295,1661,0.006919485716402979,0.6897840531561462
7147,0.721,2,0,2,604863,747,106297,1659,0.006919485716402979,0.6895261845386533
7148,0.7211,3,2,3,604865,745,106300,1656,0.006900959650227871,0.6897126197417742
7149,0.7212,1,1,1,604866,744,106301,1655,0.006891696617140316,0.6898707794914548
7150,0.7213,2,2,2,604868,742,106303,1653,0.006873170550965208,0.6901878914405011
7151,0.7214,2,2,2,604870,740,106305,1651,0.0068546444847901,0.6905060644081974
7152,0.7215,2,1,2,604871,739,106307,1649,0.006845381451702545,0.690536013400335
7153,0.7216,1,0,1,604871,739,106308,1648,0.006845381451702545,0.6904063678257226
7154,0.7217,4,0,4,604871,739,106312,1644,0.006845381451702545,0.6898866974402015
7155,0.7218,2,2,2,604873,737,106314,1642,0.006826855385527437,0.6902059688944935
7156,0.7219,3,0,3,604873,737,106317,1639,0.006826855385527437,0.6898148148148148
7157,0.722,1,0,1,604873,737,106318,1638,0.006826855385527437,0.6896842105263158
7158,0.7221,3,0,3,604873,737,106321,1635,0.006826855385527437,0.68929173693086
7159,0.7222,2,3,2,604876,734,106323,1633,0.006799066286264774,0.6899028305872412
7160,0.7223,2,1,2,604877,733,106325,1631,0.00678980325317722,0.689932318104907
7161,0.7224,1,1,1,604878,732,106326,1630,0.006780540220089666,0.6900931414055885
7162,0.7225,2,1,2,604879,731,106328,1628,0.006771277187002112,0.6901229334463755
7163,0.7226,1,0,1,604879,731,106329,1627,0.006771277187002112,0.6899915182357931
7164,0.7227,2,1,2,604880,730,106331,1625,0.0067620141539145575,0.6900212314225053
7165,0.7228,2,1,2,604881,729,106333,1623,0.006752751120827003,0.6900510204081632
7166,0.7229,1,2,1,604883,727,106334,1622,0.006734225054651895,0.6905065985525756
7167,0.723,1,0,1,604883,727,106335,1621,0.006734225054651895,0.6903747870528109
7168,0.7231,4,0,4,604883,727,106339,1617,0.006734225054651895,0.6898464163822525
7169,0.7232,1,0,1,604883,727,106340,1616,0.006734225054651895,0.6897140418267179
7170,0.7233,1,0,1,604883,727,106341,1615,0.006734225054651895,0.6895815542271563
7171,0.7234,3,0,3,604883,727,106344,1612,0.006734225054651895,0.6891834117144079
7172,0.7235,1,0,1,604883,727,106345,1611,0.006734225054651895,0.6890504704875963
7173,0.7236,3,4,3,604887,723,106348,1608,0.006697172922301678,0.6898326898326899
7174,0.7238,2,1,2,604888,722,106350,1606,0.006687909889214124,0.6898625429553265
7175,0.7239,0,2,0,604890,720,106350,1606,0.0066693838230390155,0.6904557179707652
7176,0.724,1,0,1,604890,720,106351,1605,0.0066693838230390155,0.6903225806451613
7177,0.7242,3,1,3,604891,719,106354,1602,0.006660120789951461,0.6902197328737613
7178,0.7243,2,1,2,604892,718,106356,1600,0.006650857756863907,0.6902502157031924
7179,0.7244,2,4,2,604896,714,106358,1598,0.006613805624513691,0.6911764705882353
7180,0.7245,0,1,0,604897,713,106358,1598,0.006604542591426137,0.6914755517092168
7181,0.7246,2,1,2,604898,712,106360,1596,0.006595279558338583,0.6915077989601387
7182,0.7247,3,2,3,604900,710,106363,1593,0.006576753492163474,0.6917064698219714
7183,0.7248,3,0,3,604900,710,106366,1590,0.006576753492163474,0.691304347826087
7184,0.7249,1,1,1,604901,709,106367,1589,0.00656749045907592,0.6914708442123586
7185,0.725,2,0,2,604901,709,106369,1587,0.00656749045907592,0.6912020905923345
7186,0.7251,2,2,2,604903,707,106371,1585,0.006548964392900812,0.6915357766143106
7187,0.7252,2,1,2,604904,706,106373,1583,0.0065397013598132575,0.691568370467453
7188,0.7253,3,1,3,604905,705,106376,1580,0.006530438326725703,0.6914660831509847
7189,0.7254,4,1,4,604906,704,106380,1576,0.006521175293638149,0.6912280701754386
7190,0.7255,3,1,3,604907,703,106383,1573,0.006511912260550595,0.6911247803163445
7191,0.7256,4,2,4,604909,701,106387,1569,0.0064933861943754865,0.6911894273127753
7192,0.7257,2,0,2,604909,701,106389,1567,0.0064933861943754865,0.6909171075837742
7193,0.7258,1,1,1,604910,700,106390,1566,0.006484123161287932,0.6910856134157105
7194,0.7259,0,2,0,604912,698,106390,1566,0.006465597095112824,0.691696113074205
7195,0.726,2,2,2,604914,696,106392,1564,0.0064470710289377155,0.6920353982300885
7196,0.7261,1,1,1,604915,695,106393,1563,0.006437807995850161,0.6922054915854738
7197,0.7262,2,2,2,604917,693,106395,1561,0.006419281929675053,0.6925465838509317
7198,0.7263,2,1,2,604918,692,106397,1559,0.006410018896587499,0.6925810750777432
7199,0.7264,1,0,1,604918,692,106398,1558,0.006410018896587499,0.6924444444444444
7200,0.7265,1,0,1,604918,692,106399,1557,0.006410018896587499,0.6923076923076923
7201,0.7266,1,2,1,604920,690,106400,1556,0.00639149283041239,0.692787177203918
7202,0.7267,1,0,1,604920,690,106401,1555,0.00639149283041239,0.6926503340757239
7203,0.7268,2,2,2,604922,688,106403,1553,0.006372966764237282,0.6929941990182954
7204,0.7269,0,1,0,604923,687,106403,1553,0.006363703731149728,0.6933035714285715
7205,0.727,3,1,3,604924,686,106406,1550,0.006354440698062173,0.6932021466905188
7206,0.7271,2,0,2,604924,686,106408,1548,0.006354440698062173,0.6929274843330349
7207,0.7272,4,1,4,604925,685,106412,1544,0.006345177664974619,0.6926873037236428
7208,0.7273,0,3,0,604928,682,106412,1544,0.006317388565711957,0.6936208445642408
7209,0.7274,1,0,1,604928,682,106413,1543,0.006317388565711957,0.6934831460674157
7210,0.7275,2,0,2,604928,682,106415,1541,0.006317388565711957,0.6932073774179037
7211,0.7276,2,1,2,604929,681,106417,1539,0.006308125532624402,0.6932432432432433
7212,0.7277,3,1,3,604930,680,106420,1536,0.006298862499536848,0.6931407942238267
7213,0.7278,4,1,4,604931,679,106424,1532,0.006289599466449294,0.6928991406603346
7214,0.7279,1,1,1,604932,678,106425,1531,0.00628033643336174,0.6930737890448166
7215,0.728,1,2,1,604934,676,106426,1530,0.006261810367186631,0.6935630099728014
7216,0.7281,2,0,2,604934,676,106428,1528,0.006261810367186631,0.6932849364791288
7217,0.7282,3,0,3,604934,676,106431,1525,0.006261810367186631,0.6928668786915039
7218,0.7283,1,0,1,604934,676,106432,1524,0.006261810367186631,0.6927272727272727
7219,0.7284,2,0,2,604934,676,106434,1522,0.006261810367186631,0.6924476797088263
7220,0.7285,2,0,2,604934,676,106436,1520,0.006261810367186631,0.692167577413479
7221,0.7286,1,0,1,604934,676,106437,1519,0.006261810367186631,0.6920273348519362
7222,0.7287,1,2,1,604936,674,106438,1518,0.006243284301011523,0.6925182481751825
7223,0.7288,1,1,1,604937,673,106439,1517,0.006234021267923969,0.6926940639269407
7224,0.7289,4,0,4,604937,673,106443,1513,0.006234021267923969,0.692131747483989
7225,0.729,3,0,3,604937,673,106446,1510,0.006234021267923969,0.6917086578103527
7226,0.7292,1,0,1,604937,673,106447,1509,0.006234021267923969,0.6915673693858845
7227,0.7294,2,1,2,604938,672,106449,1507,0.006224758234836415,0.6916016521340064
7228,0.7295,1,1,1,604939,671,106450,1506,0.00621549520174886,0.6917776757005053
7229,0.7296,0,1,0,604940,670,106450,1506,0.006206232168661306,0.6920955882352942
7230,0.7298,5,2,5,604942,668,106455,1501,0.006187706102486198,0.6920239741816505
7231,0.7299,3,1,3,604943,667,106458,1498,0.0061784430693986436,0.6919168591224019
7232,0.73,2,1,2,604944,666,106460,1496,0.006169180036311089,0.6919518963922294
7233,0.7301,1,1,1,604945,665,106461,1495,0.006159917003223535,0.6921296296296297
7234,0.7302,5,1,5,604946,664,106466,1490,0.006150653970135981,0.691736304549675
7235,0.7303,1,0,1,604946,664,106467,1489,0.006150653970135981,0.6915931258708778
7236,0.7304,0,1,0,604947,663,106467,1489,0.006141390937048427,0.6919144981412639
7237,0.7305,1,1,1,604948,662,106468,1488,0.0061321279039608725,0.6920930232558139
7238,0.7306,2,0,2,604948,662,106470,1486,0.0061321279039608725,0.6918063314711359
7239,0.7307,5,1,5,604949,661,106475,1481,0.006122864870873318,0.6914098972922502
7240,0.7308,5,0,5,604949,661,106480,1476,0.006122864870873318,0.6906878802058961
7241,0.7309,3,1,3,604950,660,106483,1473,0.006113601837785765,0.6905766526019691
7242,0.731,2,1,2,604951,659,106485,1471,0.006104338804698211,0.6906103286384977
7243,0.7311,0,1,0,604952,658,106485,1471,0.006095075771610657,0.6909347111319869
7244,0.7312,3,0,3,604952,658,106488,1468,0.006095075771610657,0.6904985888993415
7245,0.7313,2,1,2,604953,657,106490,1466,0.006085812738523102,0.6905322656617994
7246,0.7314,0,1,0,604954,656,106490,1466,0.006076549705435548,0.6908576814326107
7247,0.7315,0,3,0,604957,653,106490,1466,0.006048760606172886,0.6918357715903728
7248,0.7316,1,1,1,604958,652,106491,1465,0.006039497573085331,0.6920170051960322
7249,0.7317,2,0,2,604958,652,106493,1463,0.006039497573085331,0.691725768321513
7250,0.7318,1,0,1,604958,652,106494,1462,0.006039497573085331,0.6915799432355724
7251,0.7319,1,1,1,604959,651,106495,1461,0.006030234539997777,0.6917613636363636
7252,0.732,3,1,3,604960,650,106498,1458,0.006020971506910223,0.6916508538899431
7253,0.7321,0,4,0,604964,646,106498,1458,0.005983919374560006,0.6929657794676806
7254,0.7322,2,1,2,604965,645,106500,1456,0.005974656341472452,0.6930033317467873
7255,0.7324,2,0,2,604965,645,106502,1454,0.005974656341472452,0.6927108146736541
7256,0.7325,3,1,3,604966,644,106505,1451,0.005965393308384898,0.692601431980907
7257,0.7326,1,1,1,604967,643,106506,1450,0.0059561302752973435,0.692785475394171
7258,0.7329,5,1,5,604968,642,106511,1445,0.005946867242209789,0.6923814087206517
7259,0.733,2,2,2,604970,640,106513,1443,0.005928341176034681,0.6927508401344215
7260,0.7331,2,0,2,604970,640,106515,1441,0.005928341176034681,0.6924555502162422
7261,0.7332,1,1,1,604971,639,106516,1440,0.005919078142947127,0.6926406926406926
7262,0.7333,1,1,1,604972,638,106517,1439,0.0059098151098595725,0.6928261916225325
7263,0.7334,2,0,2,604972,638,106519,1437,0.0059098151098595725,0.6925301204819277
7264,0.7336,1,0,1,604972,638,106520,1436,0.0059098151098595725,0.6923818707810994
7265,0.7337,6,1,6,604973,637,106526,1430,0.005900552076772018,0.6918238993710691
7266,0.7338,5,0,5,604973,637,106531,1425,0.005900552076772018,0.6910766246362755
7267,0.7339,3,1,3,604974,636,106534,1422,0.005891289043684464,0.6909620991253644
7268,0.734,2,1,2,604975,635,106536,1420,0.00588202601059691,0.6909975669099757
7269,0.7341,1,1,1,604976,634,106537,1419,0.005872762977509356,0.6911836337067706
7270,0.7342,3,0,3,604976,634,106540,1416,0.005872762977509356,0.6907317073170731
7271,0.7343,1,1,1,604977,633,106541,1415,0.0058634999444218015,0.69091796875
7272,0.7344,2,1,2,604978,632,106543,1413,0.005854236911334247,0.6909535452322738
7273,0.7345,2,1,2,604979,631,106545,1411,0.005844973878246693,0.6909892262487757
7274,0.7346,1,2,1,604981,629,106546,1410,0.005826447812071585,0.691515448749387
7275,0.7347,1,3,1,604984,626,106547,1409,0.005798658712808922,0.6923832923832924
7276,0.7348,2,2,2,604986,624,106549,1407,0.005780132646633814,0.6927621861152142
7277,0.7349,2,3,2,604989,621,106551,1405,0.005752343547371151,0.6934846989141165
7278,0.735,2,4,2,604993,617,106553,1403,0.005715291415020934,0.6945544554455445
7279,0.7352,0,2,0,604995,615,106553,1403,0.005696765348845826,0.6952428146679881
7280,0.7353,1,1,1,604996,614,106554,1402,0.005687502315758272,0.6954365079365079
7281,0.7354,5,2,5,604998,612,106559,1397,0.005668976249583163,0.695370831259333
7282,0.7355,1,0,1,604998,612,106560,1396,0.005668976249583163,0.6952191235059761
7283,0.7357,1,1,1,604999,611,106561,1395,0.005659713216495609,0.6954137587238285
7284,0.7359,3,0,3,604999,611,106564,1392,0.005659713216495609,0.6949575636545182
7285,0.736,2,0,2,604999,611,106566,1390,0.005659713216495609,0.6946526736631684
7286,0.7361,2,1,2,605000,610,106568,1388,0.005650450183408055,0.6946946946946947
7287,0.7362,2,0,2,605000,610,106570,1386,0.005650450183408055,0.6943887775551102
7288,0.7363,2,0,2,605000,610,106572,1384,0.005650450183408055,0.6940822467402207
7289,0.7364,2,2,2,605002,608,106574,1382,0.005631924117232946,0.6944723618090453
7290,0.7365,2,2,2,605004,606,106576,1380,0.005613398051057838,0.6948640483383686
7291,0.7366,2,1,2,605005,605,106578,1378,0.005604135017970284,0.6949067070095815
7292,0.7367,1,1,1,605006,604,106579,1377,0.00559487198488273,0.6951034830893488
7293,0.7368,1,3,1,605009,601,106580,1376,0.005567082885620068,0.6960040465351542
7294,0.7369,2,1,2,605010,600,106582,1374,0.005557819852532514,0.6960486322188449
7295,0.737,1,1,1,605011,599,106583,1373,0.005548556819444959,0.6962474645030426
7296,0.7371,1,1,1,605012,598,106584,1372,0.005539293786357405,0.6964467005076143
7297,0.7372,2,0,2,605012,598,106586,1370,0.005539293786357405,0.6961382113821138
7298,0.7373,2,2,2,605014,596,106588,1368,0.005520767720182297,0.6965376782077393
7299,0.7374,7,1,7,605015,595,106595,1361,0.005511504687094743,0.6958077709611452
7300,0.7375,1,1,1,605016,594,106596,1360,0.005502241654007188,0.6960081883316275
7301,0.7376,2,3,2,605019,591,106598,1358,0.005474452554744526,0.6967675731144176
7302,0.7377,1,0,1,605019,591,106599,1357,0.005474452554744526,0.696611909650924
7303,0.7378,3,2,3,605021,589,106602,1354,0.005455926488569417,0.6968605249613999
7304,0.7379,1,1,1,605022,588,106603,1353,0.005446663455481863,0.6970633693972179
7305,0.738,5,0,5,605022,588,106608,1348,0.005446663455481863,0.6962809917355371
7306,0.7381,1,0,1,605022,588,106609,1347,0.005446663455481863,0.6961240310077519
7307,0.7382,4,0,4,605022,588,106613,1343,0.005446663455481863,0.6954945624029001
7308,0.7383,3,2,3,605024,586,106616,1340,0.005428137389306755,0.6957424714434061
7309,0.7384,2,0,2,605024,586,106618,1338,0.005428137389306755,0.6954261954261954
7310,0.7385,1,2,1,605026,584,106619,1337,0.005409611323131646,0.6959916710046851
7311,0.7386,2,0,2,605026,584,106621,1335,0.005409611323131646,0.6956748306409588
7312,0.7387,2,2,2,605028,582,106623,1333,0.005391085256956538,0.6960835509138381
7313,0.7388,1,0,1,605028,582,106624,1332,0.005391085256956538,0.6959247648902821
7314,0.7389,2,0,2,605028,582,106626,1330,0.005391085256956538,0.6956066945606695
7315,0.739,3,2,3,605030,580,106629,1327,0.0053725591907814296,0.6958573675930781
7316,0.7391,4,1,4,605031,579,106633,1323,0.005363296157693875,0.695583596214511
7317,0.7392,1,1,1,605032,578,106634,1322,0.005354033124606321,0.6957894736842105
7318,0.7393,1,1,1,605033,577,106635,1321,0.005344770091518767,0.695995785036881
7319,0.7394,1,0,1,605033,577,106636,1320,0.005344770091518767,0.6958355297838693
7320,0.7395,2,1,2,605034,576,106638,1318,0.005335507058431213,0.6958817317845829
7321,0.7396,2,0,2,605034,576,106640,1316,0.005335507058431213,0.6955602536997886
7322,0.7397,3,2,3,605036,574,106643,1313,0.005316980992256104,0.6958134605193429
7323,0.7399,2,1,2,605037,573,106645,1311,0.00530771795916855,0.695859872611465
7324,0.74,0,2,0,605039,571,106645,1311,0.005289191892993442,0.6965993623804463
7325,0.7401,1,0,1,605039,571,106646,1310,0.005289191892993442,0.6964380648591175
7326,0.7403,1,0,1,605039,571,106647,1309,0.005289191892993442,0.6962765957446808
7327,0.7404,0,1,0,605040,570,106647,1309,0.0052799288599058875,0.6966471527408196
7328,0.7405,2,0,2,605040,570,106649,1307,0.0052799288599058875,0.6963239211507725
7329,0.7406,2,0,2,605040,570,106651,1305,0.0052799288599058875,0.696
7330,0.7407,2,2,2,605042,568,106653,1303,0.005261402793730779,0.6964190272581507
7331,0.7408,4,0,4,605042,568,106657,1299,0.005261402793730779,0.6957686127477236
7332,0.7409,3,0,3,605042,568,106660,1296,0.005261402793730779,0.6952789699570815
7333,0.741,2,0,2,605042,568,106662,1294,0.005261402793730779,0.6949516648764769
7334,0.7411,4,3,4,605045,565,106666,1290,0.0052336136944681165,0.6954177897574124
7335,0.7412,2,1,2,605046,564,106668,1288,0.005224350661380562,0.6954643628509719
7336,0.7413,3,0,3,605046,564,106671,1285,0.005224350661380562,0.6949702541914549
7337,0.7414,2,0,2,605046,564,106673,1283,0.005224350661380562,0.6946399566865187
7338,0.7415,0,1,0,605047,563,106673,1283,0.005215087628293008,0.6950162513542795
7339,0.7416,1,1,1,605048,562,106674,1282,0.005205824595205454,0.6952277657266811
7340,0.7417,1,2,1,605050,560,106675,1281,0.0051872985290303455,0.6958174904942965
7341,0.7418,0,3,0,605053,557,106675,1281,0.005159509429767683,0.6969532100108814
7342,0.7419,1,1,1,605054,556,106676,1280,0.005150246396680129,0.6971677559912854
7343,0.742,1,0,1,605054,556,106677,1279,0.005150246396680129,0.6970027247956403
7344,0.7421,2,1,2,605055,555,106679,1277,0.0051409833635925745,0.6970524017467249
7345,0.7422,1,2,1,605057,553,106680,1276,0.005122457297417466,0.697648988518316
7346,0.7423,2,3,2,605060,550,106682,1274,0.0050946681981548034,0.6984649122807017
7347,0.7424,2,1,2,605061,549,106684,1272,0.005085405165067249,0.6985172981878089
7348,0.7425,2,2,2,605063,547,106686,1270,0.005066879098892141,0.6989543203082004
7349,0.7426,1,1,1,605064,546,106687,1269,0.005057616065804587,0.6991735537190082
7350,0.7427,2,1,2,605065,545,106689,1267,0.005048353032717033,0.6992273730684326
7351,0.7428,1,1,1,605066,544,106690,1266,0.005039089999629479,0.6994475138121546
7352,0.743,3,1,3,605067,543,106693,1263,0.005029826966541925,0.6993355481727574
7353,0.7431,1,2,1,605069,541,106694,1262,0.0050113009003668165,0.6999445368829729
7354,0.7432,2,0,2,605069,541,106696,1260,0.0050113009003668165,0.6996113270405331
7355,0.7433,4,1,4,605070,540,106700,1256,0.005002037867279262,0.6993318485523385
7356,0.7434,1,0,1,605070,540,106701,1255,0.005002037867279262,0.6991643454038997
7357,0.7436,1,0,1,605070,540,106702,1254,0.005002037867279262,0.6989966555183946
7358,0.7437,3,2,3,605072,538,106705,1251,0.004983511801104154,0.69927333705981
7359,0.7438,1,1,1,605073,537,106706,1250,0.0049742487680166,0.6994963626189143
7360,0.7439,3,1,3,605074,536,106709,1247,0.0049649857349290455,0.699383062254627
7361,0.744,1,1,1,605075,535,106710,1246,0.004955722701841491,0.699606962380685
7362,0.7441,8,1,8,605076,534,106718,1238,0.004946459668753937,0.698645598194131
7363,0.7442,3,2,3,605078,532,106721,1235,0.004927933602578829,0.6989247311827957
7364,0.7443,1,0,1,605078,532,106722,1234,0.004927933602578829,0.6987542468856173
7365,0.7444,4,0,4,605078,532,106726,1230,0.004927933602578829,0.6980703745743473
7366,0.7445,2,4,2,605082,528,106728,1228,0.004890881470228612,0.6993166287015945
7367,0.7446,2,1,2,605083,527,106730,1226,0.004881618437141058,0.6993725042783799
7368,0.7447,3,1,3,605084,526,106733,1223,0.004872355404053503,0.6992567181246426
7369,0.7448,3,0,3,605084,526,106736,1220,0.004872355404053503,0.6987399770904925
7370,0.745,2,1,2,605085,525,106738,1218,0.004863092370965949,0.6987951807228916
7371,0.7451,1,0,1,605085,525,106739,1217,0.004863092370965949,0.698622273249139
7372,0.7452,5,0,5,605085,525,106744,1212,0.004863092370965949,0.697754749568221
7373,0.7453,2,1,2,605086,524,106746,1210,0.004853829337878395,0.6978085351787774
7374,0.7454,2,2,2,605088,522,106748,1208,0.004835303271703287,0.6982658959537572
7375,0.7455,0,2,0,605090,520,106748,1208,0.004816777205528178,0.6990740740740741
7376,0.7456,2,1,2,605091,519,106750,1206,0.004807514172440624,0.6991304347826087
7377,0.7457,0,2,0,605093,517,106750,1206,0.004788988106265516,0.6999419616947186
7378,0.7458,3,0,3,605093,517,106753,1203,0.004788988106265516,0.6994186046511628
7379,0.7459,3,3,3,605096,514,106756,1200,0.004761199007002853,0.7001166861143524
7380,0.746,2,1,2,605097,513,106758,1198,0.004751935973915299,0.7001753360607832
7381,0.7461,1,2,1,605099,511,106759,1197,0.00473340990774019,0.7008196721311475
7382,0.7463,0,1,0,605100,510,106759,1197,0.004724146874652636,0.7012302284710018
7383,0.7464,1,1,1,605101,509,106760,1196,0.004714883841565082,0.701466275659824
7384,0.7465,4,2,4,605103,507,106764,1192,0.0046963577753899735,0.7015891701000588
7385,0.7466,2,3,2,605106,504,106766,1190,0.004668568676127311,0.7024793388429752
7386,0.7467,3,3,3,605109,501,106769,1187,0.004640779576864648,0.7031990521327014
7387,0.7468,0,1,0,605110,500,106769,1187,0.004631516543777094,0.7036158861885004
7388,0.7469,1,1,1,605111,499,106770,1186,0.00462225351068954,0.7038575667655786
7389,0.747,3,1,3,605112,498,106773,1183,0.004612990477601986,0.7037477691850089
7390,0.7471,1,1,1,605113,497,106774,1182,0.0046037274445144315,0.7039904705181655
7391,0.7472,2,1,2,605114,496,106776,1180,0.004594464411426877,0.7040572792362768
7392,0.7474,1,1,1,605115,495,106777,1179,0.004585201378339323,0.7043010752688172
7393,0.7475,1,1,1,605116,494,106778,1178,0.004575938345251769,0.7045454545454546
7394,0.7476,0,2,0,605118,492,106778,1178,0.0045574122790766605,0.7053892215568862
7395,0.7477,2,0,2,605118,492,106780,1176,0.0045574122790766605,0.7050359712230215
7396,0.7478,0,1,0,605119,491,106780,1176,0.004548149245989106,0.7054589082183563
7397,0.7479,3,2,3,605121,489,106783,1173,0.004529623179813998,0.7057761732851986
7398,0.748,2,1,2,605122,488,106785,1171,0.0045203601467264445,0.7058468957203134
7399,0.7481,1,1,1,605123,487,106786,1170,0.00451109711363889,0.7060953530476766
7400,0.7482,3,1,3,605124,486,106789,1167,0.004501834080551336,0.705989110707804
7401,0.7483,1,1,1,605125,485,106790,1166,0.004492571047463782,0.7062386432465173
7402,0.7485,1,0,1,605125,485,106791,1165,0.004492571047463782,0.706060606060606
7403,0.7488,1,1,1,605126,484,106792,1164,0.004483308014376228,0.7063106796116505
7404,0.7489,1,2,1,605128,482,106793,1163,0.004464781948201119,0.7069908814589666
7405,0.749,1,1,1,605129,481,106794,1162,0.004455518915113565,0.707242848447961
7406,0.7491,1,1,1,605130,480,106795,1161,0.004446255882026011,0.7074954296160878
7407,0.7493,1,1,1,605131,479,106796,1160,0.004436992848938457,0.7077486272117145
7408,0.7494,4,1,4,605132,478,106800,1156,0.0044277298158509025,0.7074663402692778
7409,0.7495,1,0,1,605132,478,106801,1155,0.0044277298158509025,0.7072872014696877
7410,0.7496,2,1,2,605133,477,106803,1153,0.004418466782763348,0.7073619631901841
7411,0.7497,2,0,2,605133,477,106805,1151,0.004418466782763348,0.707002457002457
7412,0.7498,1,1,1,605134,476,106806,1150,0.004409203749675794,0.7072570725707257
7413,0.7499,1,1,1,605135,475,106807,1149,0.00439994071658824,0.7075123152709359
7414,0.75,1,1,1,605136,474,106808,1148,0.004390677683500686,0.7077681874229347
7415,0.7501,1,0,1,605136,474,106809,1147,0.004390677683500686,0.7075879086983343
7416,0.7502,1,0,1,605136,474,106810,1146,0.004390677683500686,0.7074074074074074
7417,0.7503,4,0,4,605136,474,106814,1142,0.004390677683500686,0.7066831683168316
7418,0.7504,2,0,2,605136,474,106816,1140,0.004390677683500686,0.7063197026022305
7419,0.7505,1,3,1,605139,471,106817,1139,0.004362888584238023,0.7074534161490683
7420,0.7506,1,3,1,605142,468,106818,1138,0.0043350994849753605,0.7085927770859277
7421,0.7507,2,2,2,605144,466,106820,1136,0.004316573418800252,0.7091136079900124
7422,0.7508,2,0,2,605144,466,106822,1134,0.004316573418800252,0.70875
7423,0.7509,2,1,2,605145,465,106824,1132,0.004307310385712698,0.7088290544771446
7424,0.751,3,0,3,605145,465,106827,1129,0.004307310385712698,0.7082810539523212
7425,0.7511,1,0,1,605145,465,106828,1128,0.004307310385712698,0.7080979284369114
7426,0.7512,1,1,1,605146,464,106829,1127,0.004298047352625144,0.7083595223130107
7427,0.7513,4,1,4,605147,463,106833,1123,0.0042887843195375894,0.7080706179066835
7428,0.7514,0,2,0,605149,461,106833,1123,0.004270258253362481,0.7089646464646465
7429,0.7515,3,1,3,605150,460,106836,1120,0.004260995220274927,0.7088607594936709
7430,0.7516,2,0,2,605150,460,106838,1118,0.004260995220274927,0.7084917617237009
7431,0.7518,1,1,1,605151,459,106839,1117,0.004251732187187373,0.708756345177665
7432,0.752,2,2,2,605153,457,106841,1115,0.004233206121012264,0.7092875318066157
7433,0.7521,3,2,3,605155,455,106844,1112,0.004214680054837156,0.7096362476068921
7434,0.7522,1,0,1,605155,455,106845,1111,0.004214680054837156,0.7094508301404853
7435,0.7523,1,0,1,605155,455,106846,1110,0.004214680054837156,0.7092651757188498
7436,0.7524,0,2,0,605157,453,106846,1110,0.004196153988662047,0.710172744721689
7437,0.7525,3,0,3,605157,453,106849,1107,0.004196153988662047,0.7096153846153846
7438,0.7526,3,0,3,605157,453,106852,1104,0.004196153988662047,0.7090558766859345
7439,0.7527,2,1,2,605158,452,106854,1102,0.004186890955574493,0.7091377091377091
7440,0.7528,0,2,0,605160,450,106854,1102,0.004168364889399385,0.7100515463917526
7441,0.7529,2,1,2,605161,449,106856,1100,0.004159101856311831,0.7101355713363461
7442,0.753,1,3,1,605164,446,106857,1099,0.004131312757049168,0.7113268608414239
7443,0.7531,0,1,0,605165,445,106857,1099,0.004122049723961614,0.7117875647668394
7444,0.7533,2,1,2,605166,444,106859,1097,0.00411278669087406,0.7118754055807917
7445,0.7534,6,1,6,605167,443,106865,1091,0.004103523657786505,0.711212516297262
7446,0.7535,2,0,2,605167,443,106867,1089,0.004103523657786505,0.7108355091383812
7447,0.7536,1,0,1,605167,443,106868,1088,0.004103523657786505,0.7106466361854997
7448,0.7537,3,0,3,605167,443,106871,1085,0.004103523657786505,0.7100785340314136
7449,0.7538,2,2,2,605169,441,106873,1083,0.004084997591611397,0.7106299212598425
7450,0.7539,1,2,1,605171,439,106874,1082,0.0040664715254362886,0.7113740959894806
7451,0.754,2,4,2,605175,435,106876,1080,0.004029419393086072,0.7128712871287128
7452,0.7541,4,2,4,605177,433,106880,1076,0.004010893326910963,0.7130550033134526
7453,0.7542,1,1,1,605178,432,106881,1075,0.004001630293823409,0.7133377571333775
7454,0.7543,2,1,2,605179,431,106883,1073,0.003992367260735855,0.7134308510638298
7455,0.7544,4,0,4,605179,431,106887,1069,0.003992367260735855,0.7126666666666667
7456,0.7545,2,1,2,605180,430,106889,1067,0.003983104227648302,0.7127588510354042
7457,0.7546,1,1,1,605181,429,106890,1066,0.003973841194560747,0.7130434782608696
7458,0.7547,1,0,1,605181,429,106891,1065,0.003973841194560747,0.7128514056224899
7459,0.7549,1,1,1,605182,428,106892,1064,0.003964578161473193,0.7131367292225201
7460,0.755,4,1,4,605183,427,106896,1060,0.003955315128385639,0.7128446536650975
7461,0.7551,0,2,0,605185,425,106896,1060,0.0039367890622105306,0.7138047138047138
7462,0.7552,1,0,1,605185,425,106897,1059,0.0039367890622105306,0.7136118598382749
7463,0.7553,2,0,2,605185,425,106899,1057,0.0039367890622105306,0.713225371120108
7464,0.7555,1,0,1,605185,425,106900,1056,0.0039367890622105306,0.713031735313977
7465,0.7556,2,2,2,605187,423,106902,1054,0.003918262996035422,0.7136086662153013
7466,0.7557,3,0,3,605187,423,106905,1051,0.003918262996035422,0.7130257801899593
7467,0.7558,1,1,1,605188,422,106906,1050,0.003908999962947868,0.7133152173913043
7468,0.7559,1,2,1,605190,420,106907,1049,0.003890473896772759,0.7140912185159973
7469,0.756,1,1,1,605191,419,106908,1048,0.003881210863685205,0.7143830947511929
7470,0.7561,2,0,2,605191,419,106910,1046,0.003881210863685205,0.7139931740614335
7471,0.7562,1,4,1,605195,415,106911,1045,0.0038441587313349885,0.7157534246575342
7472,0.7563,1,1,1,605196,414,106912,1044,0.0038348956982474343,0.7160493827160493
7473,0.7564,4,1,4,605197,413,106916,1040,0.00382563266515988,0.7157604955264969
7474,0.7565,1,1,1,605198,412,106917,1039,0.003816369632072326,0.7160578911095796
7475,0.7566,1,1,1,605199,411,106918,1038,0.0038071065989847717,0.7163561076604554
7476,0.7568,1,0,1,605199,411,106919,1037,0.0038071065989847717,0.7161602209944752
7477,0.7569,2,0,2,605199,411,106921,1035,0.0038071065989847717,0.7157676348547718
7478,0.757,1,1,1,605200,410,106922,1034,0.0037978435658972175,0.7160664819944599
7479,0.7571,1,0,1,605200,410,106923,1033,0.0037978435658972175,0.7158697158697158
7480,0.7572,2,1,2,605201,409,106925,1031,0.0037885805328096633,0.7159722222222222
7481,0.7573,3,1,3,605202,408,106928,1028,0.003779317499722109,0.7158774373259053
7482,0.7574,1,0,1,605202,408,106929,1027,0.003779317499722109,0.7156794425087109
7483,0.7575,2,1,2,605203,407,106931,1025,0.003770054466634555,0.715782122905028
7484,0.7576,1,0,1,605203,407,106932,1024,0.003770054466634555,0.7155835080363382
7485,0.7577,1,0,1,605203,407,106933,1023,0.003770054466634555,0.7153846153846154
7486,0.7578,1,0,1,605203,407,106934,1022,0.003770054466634555,0.71518544436669
7487,0.7579,2,2,2,605205,405,106936,1020,0.0037515284004594465,0.7157894736842105
7488,0.758,1,0,1,605205,405,106937,1019,0.0037515284004594465,0.7155898876404494
7489,0.7581,1,1,1,605206,404,106938,1018,0.0037422653673718923,0.7158931082981715
7490,0.7582,2,2,2,605208,402,106940,1016,0.003723739301196784,0.7165021156558533
7491,0.7583,2,0,2,605208,402,106942,1014,0.003723739301196784,0.7161016949152542
7492,0.7584,1,2,1,605210,400,106943,1013,0.0037052132350216755,0.7169143665958952
7493,0.7585,5,0,5,605210,400,106948,1008,0.0037052132350216755,0.7159090909090909
7494,0.7586,2,1,2,605211,399,106950,1006,0.0036959502019341213,0.7160142348754448
7495,0.7587,0,1,0,605212,398,106950,1006,0.003686687168846567,0.7165242165242165
7496,0.7588,3,0,3,605212,398,106953,1003,0.003686687168846567,0.7159172019985724
7497,0.7589,1,1,1,605213,397,106954,1002,0.003677424135759013,0.7162258756254467
7498,0.759,4,0,4,605213,397,106958,998,0.003677424135759013,0.7154121863799283
7499,0.7592,1,2,1,605215,395,106959,997,0.0036588980695839044,0.7162356321839081
7500,0.7594,2,0,2,605215,395,106961,995,0.0036588980695839044,0.7158273381294964
7501,0.7595,0,1,0,605216,394,106961,995,0.0036496350364963502,0.7163426925845933
7502,0.7596,1,0,1,605216,394,106962,994,0.0036496350364963502,0.7161383285302594
7503,0.7597,2,0,2,605216,394,106964,992,0.0036496350364963502,0.7157287157287158
7504,0.7598,5,0,5,605216,394,106969,987,0.0036496350364963502,0.7146994931209268
7505,0.7599,3,0,3,605216,394,106972,984,0.0036496350364963502,0.714078374455733
7506,0.76,3,1,3,605217,393,106975,981,0.003640372003408796,0.7139737991266376
7507,0.7601,2,0,2,605217,393,106977,979,0.003640372003408796,0.7135568513119533
7508,0.7602,3,0,3,605217,393,106980,976,0.003640372003408796,0.7129291453615778
7509,0.7603,2,1,2,605218,392,106982,974,0.003631108970321242,0.7130307467057101
7510,0.7604,2,1,2,605219,391,106984,972,0.0036218459372336876,0.7131327953044754
7511,0.7605,3,1,3,605220,390,106987,969,0.0036125829041461334,0.7130242825607064
7512,0.7607,3,1,3,605221,389,106990,966,0.0036033198710585792,0.7129151291512915
7513,0.7609,3,1,3,605222,388,106993,963,0.003594056837971025,0.7128053293856402
7514,0.761,1,0,1,605222,388,106994,962,0.003594056837971025,0.7125925925925926
7515,0.7611,0,1,0,605223,387,106994,962,0.0035847938048834713,0.7131208302446257
7516,0.7613,0,2,0,605225,385,106994,962,0.003566267738708363,0.7141796585003712
7517,0.7614,4,0,4,605225,385,106998,958,0.003566267738708363,0.7133283693224125
7518,0.7615,0,1,0,605226,384,106998,958,0.0035570047056208086,0.713859910581222
7519,0.7616,1,0,1,605226,384,106999,957,0.0035570047056208086,0.7136465324384788
7520,0.7617,2,0,2,605226,384,107001,955,0.0035570047056208086,0.7132188200149365
7521,0.7618,1,0,1,605226,384,107002,954,0.0035570047056208086,0.7130044843049327
7522,0.7619,1,0,1,605226,384,107003,953,0.0035570047056208086,0.712789827973074
7523,0.762,2,2,2,605228,382,107005,951,0.0035384786394457002,0.7134283570892723
7524,0.7621,2,1,2,605229,381,107007,949,0.003529215606358146,0.7135338345864661
7525,0.7622,3,1,3,605230,380,107010,946,0.003519952573270592,0.7134238310708899
7526,0.7623,1,2,1,605232,378,107011,945,0.0035014265070954834,0.7142857142857143
7527,0.7624,2,1,2,605233,377,107013,943,0.003492163474007929,0.7143939393939394
7528,0.7625,2,1,2,605234,376,107015,941,0.003482900440920375,0.7145026575550494
7529,0.7626,1,0,1,605234,376,107016,940,0.003482900440920375,0.7142857142857143
7530,0.7627,5,1,5,605235,375,107021,935,0.003473637407832821,0.7137404580152672
7531,0.7628,6,0,6,605235,375,107027,929,0.003473637407832821,0.7124233128834356
7532,0.7629,2,0,2,605235,375,107029,927,0.003473637407832821,0.7119815668202765
7533,0.763,0,1,0,605236,374,107029,927,0.0034643743747452666,0.7125288239815527
7534,0.7631,0,1,0,605237,373,107029,927,0.0034551113416577124,0.713076923076923
7535,0.7632,2,2,2,605239,371,107031,925,0.003436585275482604,0.7137345679012346
7536,0.7633,0,2,0,605241,369,107031,925,0.0034180592093074956,0.7148377125193199
7537,0.7635,1,0,1,605241,369,107032,924,0.0034180592093074956,0.7146171693735499
7538,0.7636,1,1,1,605242,368,107033,923,0.0034087961762199414,0.7149496514329977
7539,0.7637,2,0,2,605242,368,107035,921,0.0034087961762199414,0.7145073700543056
7540,0.7638,2,6,2,605248,362,107037,919,0.003353217977694616,0.717408274785324
7541,0.7639,3,1,3,605249,361,107040,916,0.003343954944607062,0.7173061863743148
7542,0.764,1,0,1,605249,361,107041,915,0.003343954944607062,0.7170846394984326
7543,0.7641,2,1,2,605250,360,107043,913,0.0033346919115195077,0.7172034564021995
7544,0.7643,1,1,1,605251,359,107044,912,0.0033254288784319535,0.7175452399685287
7545,0.7644,1,1,1,605252,358,107045,911,0.0033161658453443998,0.7178881008668243
7546,0.7645,2,0,2,605252,358,107047,909,0.0033161658453443998,0.7174427782162589
7547,0.7646,1,0,1,605252,358,107048,908,0.0033161658453443998,0.717219589257504
7548,0.7647,5,0,5,605252,358,107053,903,0.0033161658453443998,0.7160983346550357
7549,0.7648,2,1,2,605253,357,107055,901,0.0033069028122568456,0.7162162162162162
7550,0.7649,3,1,3,605254,356,107058,898,0.0032976397791692914,0.7161084529505582
7551,0.7651,3,2,3,605256,354,107061,895,0.003279113712994183,0.7165732586068855
7552,0.7652,1,0,1,605256,354,107062,894,0.003279113712994183,0.7163461538461539
7553,0.7653,1,0,1,605256,354,107063,893,0.003279113712994183,0.7161186848436247
7554,0.7654,2,0,2,605256,354,107065,891,0.003279113712994183,0.7156626506024096
7555,0.7658,2,0,2,605256,354,107067,889,0.003279113712994183,0.7152051488334674
7556,0.7659,2,0,2,605256,354,107069,887,0.003279113712994183,0.7147461724415793
7557,0.766,3,0,3,605256,354,107072,884,0.003279113712994183,0.7140549273021002
7558,0.7661,0,2,0,605258,352,107072,884,0.0032605876468190746,0.7152103559870551
7559,0.7662,2,0,2,605258,352,107074,882,0.0032605876468190746,0.7147487844408428
7560,0.7664,4,0,4,605258,352,107078,878,0.0032605876468190746,0.7138211382113822
7561,0.7665,0,1,0,605259,351,107078,878,0.0032513246137315203,0.7144019528071603
7562,0.7666,1,0,1,605259,351,107079,877,0.0032513246137315203,0.7141693811074918
7563,0.7667,0,1,0,605260,350,107079,877,0.003242061580643966,0.7147514262428688
7564,0.7668,4,1,4,605261,349,107083,873,0.003232798547556412,0.7144026186579379
7565,0.7669,2,1,2,605262,348,107085,871,0.0032235355144688577,0.7145200984413453
7566,0.767,2,1,2,605263,347,107087,869,0.0032142724813813035,0.7146381578947368
7567,0.7671,3,1,3,605264,346,107090,866,0.0032050094482937493,0.7145214521452146
7568,0.7672,0,2,0,605266,344,107090,866,0.003186483382118641,0.715702479338843
7569,0.7673,1,0,1,605266,344,107091,865,0.003186483382118641,0.7154673283705542
7570,0.7675,1,0,1,605266,344,107092,864,0.003186483382118641,0.7152317880794702
7571,0.7676,1,3,1,605269,341,107093,863,0.0031586942828559783,0.7167774086378738
7572,0.7677,0,2,0,605271,339,107093,863,0.00314016821668087,0.7179700499168054
7573,0.7678,3,2,3,605273,337,107096,860,0.0031216421505057615,0.7184628237259816
7574,0.7679,4,1,4,605274,336,107100,856,0.0031123791174182073,0.7181208053691275
7575,0.768,2,1,2,605275,335,107102,854,0.003103116084330653,0.7182506307821699
7576,0.7682,1,0,1,605275,335,107103,853,0.003103116084330653,0.718013468013468
7577,0.7683,1,0,1,605275,335,107104,852,0.003103116084330653,0.7177759056444819
7578,0.7684,2,0,2,605275,335,107106,850,0.003103116084330653,0.7172995780590717
7579,0.7685,0,1,0,605276,334,107106,850,0.003093853051243099,0.7179054054054054
7580,0.7687,1,0,1,605276,334,107107,849,0.003093853051243099,0.7176669484361792
7581,0.7688,1,0,1,605276,334,107108,848,0.003093853051243099,0.7174280879864636
7582,0.7689,3,2,3,605278,332,107111,845,0.0030753269850679905,0.7179269328802039
7583,0.769,1,1,1,605279,331,107112,844,0.0030660639519804363,0.7182978723404255
7584,0.7691,2,1,2,605280,330,107114,842,0.0030568009188928825,0.7184300341296929
7585,0.7692,1,0,1,605280,330,107115,841,0.0030568009188928825,0.7181895815542272
7586,0.7693,1,0,1,605280,330,107116,840,0.0030568009188928825,0.717948717948718
7587,0.7694,0,2,0,605282,328,107116,840,0.003038274852717774,0.7191780821917808
7588,0.7695,1,2,1,605284,326,107117,839,0.0030197487865426657,0.7201716738197425
7589,0.7696,2,1,2,605285,325,107119,837,0.0030104857534551115,0.7203098106712564
7590,0.7697,1,0,1,605285,325,107120,836,0.0030104857534551115,0.7200689061154177
7591,0.7698,1,1,1,605286,324,107121,835,0.0030012227203675573,0.7204486626402071
7592,0.7699,1,0,1,605286,324,107122,834,0.0030012227203675573,0.7202072538860104
7593,0.77,1,0,1,605286,324,107123,833,0.0030012227203675573,0.7199654278305964
7594,0.7702,1,1,1,605287,323,107124,832,0.002991959687280003,0.7203463203463204
7595,0.7703,1,3,1,605290,320,107125,831,0.0029641705880173405,0.7219808861859253
7596,0.7704,1,0,1,605290,320,107126,830,0.0029641705880173405,0.7217391304347827
7597,0.7705,2,1,2,605291,319,107128,828,0.0029549075549297863,0.7218831734960767
7598,0.7706,2,1,2,605292,318,107130,826,0.002945644521842232,0.722027972027972
7599,0.7707,2,0,2,605292,318,107132,824,0.002945644521842232,0.7215411558669002
7600,0.7708,2,1,2,605293,317,107134,822,0.002936381488754678,0.7216856892010536
7601,0.7709,0,1,0,605294,316,107134,822,0.0029271184556671236,0.7223198594024605
7602,0.7711,2,0,2,605294,316,107136,820,0.0029271184556671236,0.721830985915493
7603,0.7712,2,0,2,605294,316,107138,818,0.0029271184556671236,0.7213403880070547
7604,0.7715,1,1,1,605295,315,107139,817,0.0029178554225795694,0.7217314487632509
7605,0.7717,1,1,1,605296,314,107140,816,0.0029085923894920152,0.7221238938053097
7606,0.7718,0,1,0,605297,313,107140,816,0.002899329356404461,0.7227635075287865
7607,0.7719,2,0,2,605297,313,107142,814,0.002899329356404461,0.7222715173025732
7608,0.772,1,0,1,605297,313,107143,813,0.002899329356404461,0.7220248667850799
7609,0.7721,1,0,1,605297,313,107144,812,0.002899329356404461,0.7217777777777777
7610,0.7722,1,0,1,605297,313,107145,811,0.002899329356404461,0.7215302491103203
7611,0.7723,1,1,1,605298,312,107146,810,0.002890066323316907,0.7219251336898396
7612,0.7724,2,1,2,605299,311,107148,808,0.0028808032902293526,0.7220732797140303
7613,0.7725,1,1,1,605300,310,107149,807,0.0028715402571417984,0.7224709042076992
7614,0.7726,1,1,1,605301,309,107150,806,0.0028622772240542442,0.7228699551569506
7615,0.7727,2,1,2,605302,308,107152,804,0.00285301419096669,0.7230215827338129
7616,0.7728,2,0,2,605302,308,107154,802,0.00285301419096669,0.7225225225225225
7617,0.7729,2,3,2,605305,305,107156,800,0.0028252250917040274,0.7239819004524887
7618,0.773,0,1,0,605306,304,107156,800,0.002815962058616473,0.7246376811594203
7619,0.7731,2,1,2,605307,303,107158,798,0.002806699025528919,0.7247956403269755
7620,0.7732,3,0,3,605307,303,107161,795,0.002806699025528919,0.7240437158469946
7621,0.7733,1,0,1,605307,303,107162,794,0.002806699025528919,0.723792160437557
7622,0.7734,1,0,1,605307,303,107163,793,0.002806699025528919,0.7235401459854015
7623,0.7735,3,0,3,605307,303,107166,790,0.002806699025528919,0.7227813357731016
7624,0.7736,1,3,1,605310,300,107167,789,0.002778909926266257,0.7245179063360881
7625,0.7737,2,0,2,605310,300,107169,787,0.002778909926266257,0.7240110395584176
7626,0.7738,1,0,1,605310,300,107170,786,0.002778909926266257,0.7237569060773481
7627,0.7739,1,0,1,605310,300,107171,785,0.002778909926266257,0.7235023041474654
7628,0.774,1,2,1,605312,298,107172,784,0.0027603838600911484,0.7245841035120147
7629,0.7741,1,0,1,605312,298,107173,783,0.0027603838600911484,0.7243293246993524
7630,0.7742,1,0,1,605312,298,107174,782,0.0027603838600911484,0.7240740740740741
7631,0.7743,3,0,3,605312,298,107177,779,0.0027603838600911484,0.72330547818013
7632,0.7744,1,1,1,605313,297,107178,778,0.002751120827003594,0.7237209302325581
7633,0.7745,3,0,3,605313,297,107181,775,0.002751120827003594,0.7229477611940298
7634,0.7746,2,0,2,605313,297,107183,773,0.002751120827003594,0.7224299065420561
7635,0.7748,1,1,1,605314,296,107184,772,0.00274185779391604,0.7228464419475655
7636,0.7749,1,0,1,605314,296,107185,771,0.00274185779391604,0.7225866916588566
7637,0.775,1,0,1,605314,296,107186,770,0.00274185779391604,0.7223264540337712
7638,0.7751,3,1,3,605315,295,107189,767,0.002732594760828486,0.7222222222222222
7639,0.7754,4,1,4,605316,294,107193,763,0.0027233317277409316,0.7218543046357616
7640,0.7755,1,0,1,605316,294,107194,762,0.0027233317277409316,0.7215909090909091
7641,0.7756,1,0,1,605316,294,107195,761,0.0027233317277409316,0.7213270142180095
7642,0.7757,3,0,3,605316,294,107198,758,0.0027233317277409316,0.720532319391635
7643,0.7758,0,1,0,605317,293,107198,758,0.0027140686946533774,0.7212178877259753
7644,0.7759,1,0,1,605317,293,107199,757,0.0027140686946533774,0.7209523809523809
7645,0.776,1,0,1,605317,293,107200,756,0.0027140686946533774,0.7206863679694948
7646,0.7761,2,2,2,605319,291,107202,754,0.002695542628478269,0.7215311004784689
7647,0.7762,1,1,1,605320,290,107203,753,0.0026862795953907148,0.7219558964525408
7648,0.7763,1,1,1,605321,289,107204,752,0.0026770165623031606,0.7223823246878002
7649,0.7765,2,0,2,605321,289,107206,750,0.0026770165623031606,0.7218479307025987
7650,0.7766,2,1,2,605322,288,107208,748,0.0026677535292156064,0.722007722007722
7651,0.7767,1,2,1,605324,286,107209,747,0.002649227463040498,0.723136495643756
7652,0.7768,4,0,4,605324,286,107213,743,0.002649227463040498,0.7220602526724975
7653,0.7769,3,0,3,605324,286,107216,740,0.002649227463040498,0.7212475633528265
7654,0.777,2,0,2,605324,286,107218,738,0.002649227463040498,0.720703125
7655,0.7771,2,1,2,605325,285,107220,736,0.0026399644299529438,0.7208619000979432
7656,0.7773,2,1,2,605326,284,107222,734,0.0026307013968653896,0.7210216110019646
7657,0.7775,2,3,2,605329,281,107224,732,0.002602912297602727,0.7226061204343535
7658,0.7777,0,1,0,605330,280,107224,732,0.0025936492645151727,0.7233201581027668
7659,0.7778,1,1,1,605331,279,107225,731,0.0025843862314276185,0.7237623762376237
7660,0.7779,1,0,1,605331,279,107226,730,0.0025843862314276185,0.7234886025768087
7661,0.778,2,1,2,605332,278,107228,728,0.0025751231983400643,0.7236580516898609
7662,0.7781,1,1,1,605333,277,107229,727,0.00256586016525251,0.7241035856573705
7663,0.7782,2,0,2,605333,277,107231,725,0.00256586016525251,0.7235528942115769
7664,0.7783,2,0,2,605333,277,107233,723,0.00256586016525251,0.723
7665,0.7784,1,0,1,605333,277,107234,722,0.00256586016525251,0.7227227227227228
7666,0.7785,0,1,0,605334,276,107234,722,0.002556597132164956,0.7234468937875751
7667,0.7786,3,0,3,605334,276,107237,719,0.002556597132164956,0.7226130653266332
7668,0.7787,1,1,1,605335,275,107238,718,0.0025473340990774017,0.7230614300100705
7669,0.7788,1,0,1,605335,275,107239,717,0.0025473340990774017,0.7227822580645161
7670,0.7789,2,0,2,605335,275,107241,715,0.0025473340990774017,0.7222222222222222
7671,0.779,2,1,2,605336,274,107243,713,0.0025380710659898475,0.7223910840932117
7672,0.7791,2,1,2,605337,273,107245,711,0.0025288080329022933,0.7225609756097561
7673,0.7792,1,1,1,605338,272,107246,710,0.0025195449998147395,0.7230142566191446
7674,0.7794,1,1,1,605339,271,107247,709,0.0025102819667271853,0.7234693877551021
7675,0.7795,2,0,2,605339,271,107249,707,0.0025102819667271853,0.7229038854805726
7676,0.7796,2,0,2,605339,271,107251,705,0.0025102819667271853,0.7223360655737705
7677,0.7797,1,1,1,605340,270,107252,704,0.002501018933639631,0.7227926078028748
7678,0.7798,1,1,1,605341,269,107253,703,0.002491755900552077,0.7232510288065843
7679,0.7799,0,1,0,605342,268,107253,703,0.0024824928674645227,0.7239958805355304
7680,0.78,2,0,2,605342,268,107255,701,0.0024824928674645227,0.7234262125902993
7681,0.7801,3,0,3,605342,268,107258,698,0.0024824928674645227,0.722567287784679
7682,0.7802,3,0,3,605342,268,107261,695,0.0024824928674645227,0.7217030114226376
7683,0.7803,3,0,3,605342,268,107264,692,0.0024824928674645227,0.7208333333333333
7684,0.7804,2,0,2,605342,268,107266,690,0.0024824928674645227,0.7202505219206681
7685,0.7805,3,2,3,605344,266,107269,687,0.0024639668012894143,0.720881427072403
7686,0.7806,1,0,1,605344,266,107270,686,0.0024639668012894143,0.7205882352941176
7687,0.7807,3,1,3,605345,265,107273,683,0.00245470376820186,0.7204641350210971
7688,0.7808,1,0,1,605345,265,107274,682,0.00245470376820186,0.720168954593453
7689,0.7809,1,0,1,605345,265,107275,681,0.00245470376820186,0.7198731501057083
7690,0.781,1,1,1,605346,264,107276,680,0.002445440735114306,0.7203389830508474
7691,0.7811,1,0,1,605346,264,107277,679,0.002445440735114306,0.7200424178154825
7692,0.7812,1,1,1,605347,263,107278,678,0.0024361777020267517,0.720510095642933
7693,0.7813,3,1,3,605348,262,107281,675,0.0024269146689391975,0.7203842049092849
7694,0.7814,1,1,1,605349,261,107282,674,0.0024176516358516433,0.720855614973262
7695,0.7816,3,2,3,605351,259,107285,671,0.002399125569676535,0.7215053763440861
7696,0.7818,2,0,2,605351,259,107287,669,0.002399125569676535,0.7209051724137931
7697,0.782,1,0,1,605351,259,107288,668,0.002399125569676535,0.7206040992448759
7698,0.7821,1,0,1,605351,259,107289,667,0.002399125569676535,0.7203023758099352
7699,0.7822,1,1,1,605352,258,107290,666,0.0023898625365889807,0.7207792207792207
7700,0.7823,2,0,2,605352,258,107292,664,0.0023898625365889807,0.720173535791757
7701,0.7824,0,1,0,605353,257,107292,664,0.0023805995035014265,0.7209554831704669
7702,0.7826,3,1,3,605354,256,107295,661,0.0023713364704138723,0.7208287895310797
7703,0.7827,1,2,1,605356,254,107296,660,0.002352810404238764,0.7221006564551422
7704,0.7828,0,1,0,605357,253,107296,660,0.0023435473711512097,0.7228915662650602
7705,0.7829,0,1,0,605358,252,107296,660,0.0023342843380636555,0.7236842105263158
7706,0.7831,1,1,1,605359,251,107297,659,0.0023250213049761013,0.7241758241758242
7707,0.7832,1,0,1,605359,251,107298,658,0.0023250213049761013,0.7238723872387238
7708,0.7833,3,0,3,605359,251,107301,655,0.0023250213049761013,0.7229580573951435
7709,0.7834,1,0,1,605359,251,107302,654,0.0023250213049761013,0.7226519337016575
7710,0.7835,1,0,1,605359,251,107303,653,0.0023250213049761013,0.7223451327433629
7711,0.7836,1,0,1,605359,251,107304,652,0.0023250213049761013,0.7220376522702104
7712,0.7838,3,0,3,605359,251,107307,649,0.0023250213049761013,0.7211111111111111
7713,0.7839,2,0,2,605359,251,107309,647,0.0023250213049761013,0.720489977728285
7714,0.7841,0,1,0,605360,250,107309,647,0.002315758271888547,0.7212931995540691
7715,0.7842,1,1,1,605361,249,107310,646,0.002306495238800993,0.7217877094972067
7716,0.7843,4,1,4,605362,248,107314,642,0.0022972322057134387,0.7213483146067415
7717,0.7844,0,1,0,605363,247,107314,642,0.0022879691726258844,0.7221597300337458
7718,0.7845,0,1,0,605364,246,107314,642,0.0022787061395383302,0.722972972972973
7719,0.7846,4,1,4,605365,245,107318,638,0.002269443106450776,0.7225368063420159
7720,0.7847,1,0,1,605365,245,107319,637,0.002269443106450776,0.7222222222222222
7721,0.7848,1,0,1,605365,245,107320,636,0.002269443106450776,0.7219069239500567
7722,0.7849,0,1,0,605366,244,107320,636,0.0022601800733632223,0.7227272727272728
7723,0.785,0,1,0,605367,243,107320,636,0.002250917040275668,0.7235494880546075
7724,0.7851,1,2,1,605369,241,107321,635,0.0022323909741005597,0.7248858447488584
7725,0.7852,2,0,2,605369,241,107323,633,0.0022323909741005597,0.7242562929061785
7726,0.7853,2,0,2,605369,241,107325,631,0.0022323909741005597,0.7236238532110092
7727,0.7854,1,2,1,605371,239,107326,630,0.0022138649079254513,0.7249712313003452
7728,0.7855,2,0,2,605371,239,107328,628,0.0022138649079254513,0.7243367935409458
7729,0.7856,1,0,1,605371,239,107329,627,0.0022138649079254513,0.7240184757505773
7730,0.7859,2,1,2,605372,238,107331,625,0.002204601874837897,0.7242178447276941
7731,0.7862,0,2,0,605374,236,107331,625,0.0021860758086627886,0.7259001161440186
7732,0.7863,0,2,0,605376,234,107331,625,0.0021675497424876802,0.7275902211874272
7733,0.7864,3,1,3,605377,233,107334,622,0.002158286709400126,0.7274853801169591
7734,0.7869,1,1,1,605378,232,107335,621,0.002149023676312572,0.7280187573270809
7735,0.787,2,0,2,605378,232,107337,619,0.002149023676312572,0.72737955346651
7736,0.7871,1,0,1,605378,232,107338,618,0.002149023676312572,0.7270588235294118
7737,0.7872,2,1,2,605379,231,107340,616,0.0021397606432250176,0.7272727272727273
7738,0.7873,2,0,2,605379,231,107342,614,0.0021397606432250176,0.7266272189349112
7739,0.7875,1,2,1,605381,229,107343,613,0.002121234577049909,0.7280285035629454
7740,0.7878,1,0,1,605381,229,107344,612,0.002121234577049909,0.727705112960761
7741,0.7881,1,0,1,605381,229,107345,611,0.002121234577049909,0.7273809523809524
7742,0.7882,3,0,3,605381,229,107348,608,0.002121234577049909,0.7264038231780168
7743,0.7883,2,0,2,605381,229,107350,606,0.002121234577049909,0.725748502994012
7744,0.7884,0,2,0,605383,227,107350,606,0.002102708510874801,0.7274909963985594
7745,0.7885,4,0,4,605383,227,107354,602,0.002102708510874801,0.7261761158021713
7746,0.7886,2,0,2,605383,227,107356,600,0.002102708510874801,0.7255139056831923
7747,0.7887,2,0,2,605383,227,107358,598,0.002102708510874801,0.7248484848484849
7748,0.7888,1,0,1,605383,227,107359,597,0.002102708510874801,0.7245145631067961
7749,0.7889,2,0,2,605383,227,107361,595,0.002102708510874801,0.7238442822384428
7750,0.789,2,0,2,605383,227,107363,593,0.002102708510874801,0.723170731707317
7751,0.7891,1,0,1,605383,227,107364,592,0.002102708510874801,0.7228327228327228
7752,0.7892,2,0,2,605383,227,107366,590,0.002102708510874801,0.7221542227662179
7753,0.7894,1,0,1,605383,227,107367,589,0.002102708510874801,0.7218137254901961
7754,0.7895,1,0,1,605383,227,107368,588,0.002102708510874801,0.7214723926380369
7755,0.7896,1,1,1,605384,226,107369,587,0.0020934454777872466,0.7220172201722017
7756,0.7897,2,1,2,605385,225,107371,585,0.0020841824446996924,0.7222222222222222
7757,0.7898,3,3,3,605388,222,107374,582,0.00205639334543703,0.7238805970149254
7758,0.7899,2,0,2,605388,222,107376,580,0.00205639334543703,0.7231920199501247
7759,0.79,1,0,1,605388,222,107377,579,0.00205639334543703,0.7228464419475655
7760,0.7902,0,1,0,605389,221,107377,579,0.0020471303123494756,0.72375
7761,0.7903,1,0,1,605389,221,107378,578,0.0020471303123494756,0.723404255319149
7762,0.7904,1,0,1,605389,221,107379,577,0.0020471303123494756,0.7230576441102757
7763,0.7906,0,1,0,605390,220,107379,577,0.0020378672792619214,0.7239648682559598
7764,0.7907,1,0,1,605390,220,107380,576,0.0020378672792619214,0.7236180904522613
7765,0.7908,1,0,1,605390,220,107381,575,0.0020378672792619214,0.7232704402515723
7766,0.7909,2,1,2,605391,219,107383,573,0.002028604246174367,0.7234848484848485
7767,0.791,1,0,1,605391,219,107384,572,0.002028604246174367,0.7231352718078382
7768,0.7911,2,1,2,605392,218,107386,570,0.002019341213086813,0.7233502538071066
7769,0.7913,0,1,0,605393,217,107386,570,0.0020100781799992588,0.7242693773824651
7770,0.7914,1,0,1,605393,217,107387,569,0.0020100781799992588,0.7239185750636132
7771,0.7916,2,0,2,605393,217,107389,567,0.0020100781799992588,0.7232142857142857
7772,0.7917,2,0,2,605393,217,107391,565,0.0020100781799992588,0.7225063938618926
7773,0.7919,1,0,1,605393,217,107392,564,0.0020100781799992588,0.7221510883482715
7774,0.792,1,0,1,605393,217,107393,563,0.0020100781799992588,0.7217948717948718
7775,0.7921,1,1,1,605394,216,107394,562,0.0020008151469117046,0.7223650385604113
7776,0.7922,1,0,1,605394,216,107395,561,0.0020008151469117046,0.722007722007722
7777,0.7924,2,1,2,605395,215,107397,559,0.001991552113824151,0.7222222222222222
7778,0.7926,2,0,2,605395,215,107399,557,0.001991552113824151,0.7215025906735751
7779,0.7927,1,1,1,605396,214,107400,556,0.0019822890807365966,0.7220779220779221
7780,0.7928,1,2,1,605398,212,107401,555,0.001963763014561488,0.7235984354628422
7781,0.7929,0,1,0,605399,211,107401,555,0.001954499981473934,0.7245430809399478
7782,0.7931,1,0,1,605399,211,107402,554,0.001954499981473934,0.7241830065359477
7783,0.7932,2,1,2,605400,210,107404,552,0.0019452369483863796,0.7244094488188977
7784,0.7936,1,1,1,605401,209,107405,551,0.0019359739152988254,0.725
7785,0.7937,2,2,2,605403,207,107407,549,0.0019174478491237172,0.7261904761904762
7786,0.7938,2,0,2,605403,207,107409,547,0.0019174478491237172,0.7254641909814323
7787,0.7939,1,0,1,605403,207,107410,546,0.0019174478491237172,0.7250996015936255
7788,0.794,2,1,2,605404,206,107412,544,0.001908184816036163,0.7253333333333334
7789,0.7941,1,1,1,605405,205,107413,543,0.0018989217829486088,0.7259358288770054
7790,0.7942,3,1,3,605406,204,107416,540,0.0018896587498610545,0.7258064516129032
7791,0.7944,1,0,1,605406,204,107417,539,0.0018896587498610545,0.7254374158815612
7792,0.7946,1,0,1,605406,204,107418,538,0.0018896587498610545,0.7250673854447439
7793,0.7947,1,0,1,605406,204,107419,537,0.0018896587498610545,0.7246963562753036
7794,0.7948,1,0,1,605406,204,107420,536,0.0018896587498610545,0.7243243243243244
7795,0.7949,2,0,2,605406,204,107422,534,0.0018896587498610545,0.7235772357723578
7796,0.795,2,0,2,605406,204,107424,532,0.0018896587498610545,0.7228260869565217
7797,0.7951,1,2,1,605408,202,107425,531,0.0018711326836859461,0.7244201909959073
7798,0.7952,4,1,4,605409,201,107429,527,0.001861869650598392,0.7239010989010989
7799,0.7953,2,0,2,605409,201,107431,525,0.001861869650598392,0.7231404958677686
7800,0.7954,2,0,2,605409,201,107433,523,0.001861869650598392,0.7223756906077348
7801,0.7955,1,0,1,605409,201,107434,522,0.001861869650598392,0.7219917012448133
7802,0.7956,1,0,1,605409,201,107435,521,0.001861869650598392,0.721606648199446
7803,0.7957,2,0,2,605409,201,107437,519,0.001861869650598392,0.7208333333333333
7804,0.7959,1,0,1,605409,201,107438,518,0.001861869650598392,0.7204450625869263
7805,0.796,1,0,1,605409,201,107439,517,0.001861869650598392,0.7200557103064067
7806,0.7961,1,1,1,605410,200,107440,516,0.0018526066175108377,0.7206703910614525
7807,0.7962,1,1,1,605411,199,107441,515,0.0018433435844232835,0.7212885154061625
7808,0.7963,5,3,5,605414,196,107446,510,0.001815554485160621,0.7223796033994334
7809,0.7964,1,0,1,605414,196,107447,509,0.001815554485160621,0.7219858156028369
7810,0.7965,1,0,1,605414,196,107448,508,0.001815554485160621,0.7215909090909091
7811,0.7966,1,0,1,605414,196,107449,507,0.001815554485160621,0.7211948790896159
7812,0.7969,1,1,1,605415,195,107450,506,0.0018062914520730667,0.7218259629101283
7813,0.797,3,0,3,605415,195,107453,503,0.0018062914520730667,0.7206303724928367
7814,0.7971,1,1,1,605416,194,107454,502,0.0017970284189855125,0.7212643678160919
7815,0.7972,1,2,1,605418,192,107455,501,0.0017785023528104043,0.7229437229437229
7816,0.7973,2,1,2,605419,191,107457,499,0.0017692393197228501,0.7231884057971014
7817,0.7975,1,0,1,605419,191,107458,498,0.0017692393197228501,0.7227866473149492
7818,0.7978,1,0,1,605419,191,107459,497,0.0017692393197228501,0.7223837209302325
7819,0.798,1,0,1,605419,191,107460,496,0.0017692393197228501,0.7219796215429404
7820,0.7981,1,0,1,605419,191,107461,495,0.0017692393197228501,0.7215743440233237
7821,0.7982,1,2,1,605421,189,107462,494,0.0017507132535477417,0.7232796486090776
7822,0.7983,0,1,0,605422,188,107462,494,0.0017414502204601875,0.7243401759530792
7823,0.7984,1,0,1,605422,188,107463,493,0.0017414502204601875,0.723935389133627
7824,0.7985,1,0,1,605422,188,107464,492,0.0017414502204601875,0.7235294117647059
7825,0.7986,0,1,0,605423,187,107464,492,0.0017321871873726333,0.7245949926362297
7826,0.7987,2,2,2,605425,185,107466,490,0.001713661121197525,0.725925925925926
7827,0.7989,1,0,1,605425,185,107467,489,0.001713661121197525,0.7255192878338279
7828,0.799,1,1,1,605426,184,107468,488,0.0017043980881099707,0.7261904761904762
7829,0.7991,1,0,1,605426,184,107469,487,0.0017043980881099707,0.7257824143070045
7830,0.7992,2,0,2,605426,184,107471,485,0.0017043980881099707,0.7249626307922272
7831,0.7993,1,0,1,605426,184,107472,484,0.0017043980881099707,0.7245508982035929
7832,0.7994,1,2,1,605428,182,107473,483,0.0016858720219348623,0.7263157894736842
7833,0.7996,1,0,1,605428,182,107474,482,0.0016858720219348623,0.7259036144578314
7834,0.7997,3,3,3,605431,179,107477,479,0.0016580829226721999,0.7279635258358662
7835,0.7998,2,1,2,605432,178,107479,477,0.0016488198895846457,0.7282442748091603
7836,0.7999,1,0,1,605432,178,107480,476,0.0016488198895846457,0.72782874617737
7837,0.8,1,0,1,605432,178,107481,475,0.0016488198895846457,0.7274119448698315
7838,0.8001,1,0,1,605432,178,107482,474,0.0016488198895846457,0.7269938650306749
7839,0.8002,1,0,1,605432,178,107483,473,0.0016488198895846457,0.7265745007680492
7840,0.8005,0,1,0,605433,177,107483,473,0.0016395568564970915,0.7276923076923076
7841,0.8006,2,2,2,605435,175,107485,471,0.001621030790321983,0.7291021671826625
7842,0.8007,1,0,1,605435,175,107486,470,0.001621030790321983,0.7286821705426356
7843,0.8009,2,1,2,605436,174,107488,468,0.0016117677572344289,0.7289719626168224
7844,0.801,2,0,2,605436,174,107490,466,0.0016117677572344289,0.728125
7845,0.8011,0,1,0,605437,173,107490,466,0.0016025047241468747,0.729264475743349
7846,0.8012,1,0,1,605437,173,107491,465,0.0016025047241468747,0.7288401253918495
7847,0.8013,1,0,1,605437,173,107492,464,0.0016025047241468747,0.728414442700157
7848,0.8014,5,0,5,605437,173,107497,459,0.0016025047241468747,0.7262658227848101
7849,0.8015,0,1,0,605438,172,107497,459,0.0015932416910593205,0.7274167987321711
7850,0.8016,2,0,2,605438,172,107499,457,0.0015932416910593205,0.7265500794912559
7851,0.8017,2,2,2,605440,170,107501,455,0.001574715624884212,0.728
7852,0.8019,2,0,2,605440,170,107503,453,0.001574715624884212,0.7271268057784912
7853,0.802,0,1,0,605441,169,107503,453,0.0015654525917966578,0.7282958199356914
7854,0.8023,2,1,2,605442,168,107505,451,0.0015561895587091036,0.72859450726979
7855,0.8024,3,0,3,605442,168,107508,448,0.0015561895587091036,0.7272727272727273
7856,0.8025,0,1,0,605443,167,107508,448,0.0015469265256215494,0.7284552845528456
7857,0.8026,1,0,1,605443,167,107509,447,0.0015469265256215494,0.7280130293159609
7858,0.8027,0,2,0,605445,165,107509,447,0.0015284004594464412,0.7303921568627451
7859,0.8028,3,0,3,605445,165,107512,444,0.0015284004594464412,0.729064039408867
7860,0.8029,1,1,1,605446,164,107513,443,0.001519137426358887,0.729818780889621
7861,0.803,2,1,2,605447,163,107515,441,0.0015098743932713328,0.7301324503311258
7862,0.8031,1,0,1,605447,163,107516,440,0.0015098743932713328,0.7296849087893864
7863,0.8032,1,0,1,605447,163,107517,439,0.0015098743932713328,0.729235880398671
7864,0.8033,2,0,2,605447,163,107519,437,0.0015098743932713328,0.7283333333333334
7865,0.8035,1,0,1,605447,163,107520,436,0.0015098743932713328,0.7278797996661102
7866,0.8036,1,0,1,605447,163,107521,435,0.0015098743932713328,0.7274247491638796
7867,0.8037,1,0,1,605447,163,107522,434,0.0015098743932713328,0.7269681742043551
7868,0.8038,0,1,0,605448,162,107522,434,0.0015006113601837786,0.7281879194630873
7869,0.8039,1,0,1,605448,162,107523,433,0.0015006113601837786,0.7277310924369748
7870,0.804,1,0,1,605448,162,107524,432,0.0015006113601837786,0.7272727272727273
7871,0.8041,1,1,1,605449,161,107525,431,0.0014913483270962244,0.7280405405405406
7872,0.8042,1,1,1,605450,160,107526,430,0.0014820852940086702,0.7288135593220338
7873,0.8043,1,0,1,605450,160,107527,429,0.0014820852940086702,0.7283531409168081
7874,0.8044,2,0,2,605450,160,107529,427,0.0014820852940086702,0.727427597955707
7875,0.8045,2,1,2,605451,159,107531,425,0.001472822260921116,0.7277397260273972
7876,0.8046,2,2,2,605453,157,107533,423,0.0014542961947460076,0.7293103448275862
7877,0.8047,1,0,1,605453,157,107534,422,0.0014542961947460076,0.7288428324697754
7878,0.8049,0,1,0,605454,156,107534,422,0.0014450331616584534,0.7301038062283737
7879,0.805,2,0,2,605454,156,107536,420,0.0014450331616584534,0.7291666666666666
7880,0.8051,1,1,1,605455,155,107537,419,0.0014357701285708992,0.7299651567944251
7881,0.8056,0,1,0,605456,154,107537,419,0.001426507095483345,0.731239092495637
7882,0.806,1,1,1,605457,153,107538,418,0.0014172440623957908,0.7320490367775832
7883,0.8061,1,1,1,605458,152,107539,417,0.0014079810293082366,0.7328646748681898
7884,0.8062,2,0,2,605458,152,107541,415,0.0014079810293082366,0.7319223985890653
7885,0.8063,1,0,1,605458,152,107542,414,0.0014079810293082366,0.7314487632508834
7886,0.8064,1,0,1,605458,152,107543,413,0.0014079810293082366,0.7309734513274336
7887,0.8065,1,0,1,605458,152,107544,412,0.0014079810293082366,0.7304964539007093
7888,0.8066,1,0,1,605458,152,107545,411,0.0014079810293082366,0.7300177619893428
7889,0.807,1,0,1,605458,152,107546,410,0.0014079810293082366,0.7295373665480427
7890,0.8071,1,0,1,605458,152,107547,409,0.0014079810293082366,0.7290552584670231
7891,0.8072,1,1,1,605459,151,107548,408,0.0013987179962206824,0.7298747763864043
7892,0.8074,1,0,1,605459,151,107549,407,0.0013987179962206824,0.7293906810035843
7893,0.8076,0,1,0,605460,150,107549,407,0.0013894549631331284,0.7307001795332136
7894,0.8077,1,0,1,605460,150,107550,406,0.0013894549631331284,0.7302158273381295
7895,0.808,0,1,0,605461,149,107550,406,0.0013801919300455742,0.7315315315315315
7896,0.8081,2,1,2,605462,148,107552,404,0.00137092889695802,0.7318840579710145
7897,0.8082,1,0,1,605462,148,107553,403,0.00137092889695802,0.7313974591651543
7898,0.8083,1,0,1,605462,148,107554,402,0.00137092889695802,0.730909090909091
7899,0.8084,0,1,0,605463,147,107554,402,0.0013616658638704658,0.73224043715847
7900,0.809,1,0,1,605463,147,107555,401,0.0013616658638704658,0.7317518248175182
7901,0.8091,4,0,4,605463,147,107559,397,0.0013616658638704658,0.7297794117647058
7902,0.8093,2,0,2,605463,147,107561,395,0.0013616658638704658,0.7287822878228782
7903,0.8094,4,0,4,605463,147,107565,391,0.0013616658638704658,0.7267657992565055
7904,0.8096,1,0,1,605463,147,107566,390,0.0013616658638704658,0.7262569832402235
7905,0.8098,1,0,1,605463,147,107567,389,0.0013616658638704658,0.7257462686567164
7906,0.8099,0,1,0,605464,146,107567,389,0.0013524028307829116,0.7271028037383177
7907,0.81,1,2,1,605466,144,107568,388,0.0013338767646078032,0.7293233082706767
7908,0.8101,3,0,3,605466,144,107571,385,0.0013338767646078032,0.7277882797731569
7909,0.8104,1,0,1,605466,144,107572,384,0.0013338767646078032,0.7272727272727273
7910,0.8106,1,1,1,605467,143,107573,383,0.001324613731520249,0.7281368821292775
7911,0.8107,1,1,1,605468,142,107574,382,0.0013153506984326948,0.7290076335877863
7912,0.8108,1,0,1,605468,142,107575,381,0.0013153506984326948,0.7284894837476099
7913,0.8109,1,1,1,605469,141,107576,380,0.0013060876653451406,0.7293666026871402
7914,0.811,1,0,1,605469,141,107577,379,0.0013060876653451406,0.7288461538461538
7915,0.8111,1,0,1,605469,141,107578,378,0.0013060876653451406,0.7283236994219653
7916,0.8112,2,1,2,605470,140,107580,376,0.0012968246322575864,0.7286821705426356
7917,0.8114,1,1,1,605471,139,107581,375,0.0012875615991700322,0.7295719844357976
7918,0.8115,1,3,1,605474,136,107582,374,0.0012597724999073698,0.7333333333333333
7919,0.8118,2,0,2,605474,136,107584,372,0.0012597724999073698,0.7322834645669292
7920,0.812,0,2,0,605476,134,107584,372,0.0012412464337322614,0.7351778656126482
7921,0.8121,1,1,1,605477,133,107585,371,0.0012319834006447072,0.7361111111111112
7922,0.8123,1,0,1,605477,133,107586,370,0.0012319834006447072,0.73558648111332
7923,0.8124,1,2,1,605479,131,107587,369,0.0012134573344695988,0.738
7924,0.8125,1,0,1,605479,131,107588,368,0.0012134573344695988,0.7374749498997996
7925,0.8127,1,0,1,605479,131,107589,367,0.0012134573344695988,0.7369477911646586
7926,0.8128,1,1,1,605480,130,107590,366,0.0012041943013820445,0.7379032258064516
7927,0.813,1,0,1,605480,130,107591,365,0.0012041943013820445,0.7373737373737373
7928,0.8131,1,0,1,605480,130,107592,364,0.0012041943013820445,0.7368421052631579
7929,0.8132,1,0,1,605480,130,107593,363,0.0012041943013820445,0.7363083164300203
7930,0.8135,0,1,0,605481,129,107593,363,0.0011949312682944903,0.7378048780487805
7931,0.8136,1,1,1,605482,128,107594,362,0.0011856682352069361,0.7387755102040816
7932,0.8138,1,0,1,605482,128,107595,361,0.0011856682352069361,0.7382413087934561
7933,0.8139,0,2,0,605484,126,107595,361,0.0011671421690318277,0.7412731006160165
7934,0.8141,1,1,1,605485,125,107596,360,0.0011578791359442735,0.7422680412371134
7935,0.8142,3,0,3,605485,125,107599,357,0.0011578791359442735,0.7406639004149378
7936,0.8143,0,1,0,605486,124,107599,357,0.0011486161028567193,0.7422037422037422
7937,0.8144,1,1,1,605487,123,107600,356,0.0011393530697691651,0.7432150313152401
7938,0.8145,0,1,0,605488,122,107600,356,0.0011300900366816111,0.7447698744769874
7939,0.8146,1,1,1,605489,121,107601,355,0.001120827003594057,0.7457983193277311
7940,0.8148,0,1,0,605490,120,107601,355,0.0011115639705065027,0.7473684210526316
7941,0.8149,0,2,0,605492,118,107601,355,0.0010930379043313943,0.7505285412262156
7942,0.815,2,1,2,605493,117,107603,353,0.0010837748712438401,0.7510638297872341
7943,0.8152,4,1,4,605494,116,107607,349,0.001074511838156286,0.7505376344086021
7944,0.8153,1,0,1,605494,116,107608,348,0.001074511838156286,0.75
7945,0.8154,2,0,2,605494,116,107610,346,0.001074511838156286,0.7489177489177489
7946,0.8155,0,1,0,605495,115,107610,346,0.0010652488050687317,0.7505422993492408
7947,0.8157,0,1,0,605496,114,107610,346,0.0010559857719811775,0.7521739130434782
7948,0.8158,0,1,0,605497,113,107610,346,0.0010467227388936233,0.7538126361655774
7949,0.8159,3,0,3,605497,113,107613,343,0.0010467227388936233,0.7521929824561403
7950,0.816,0,1,0,605498,112,107613,343,0.001037459705806069,0.7538461538461538
7951,0.8161,1,0,1,605498,112,107614,342,0.001037459705806069,0.7533039647577092
7952,0.8162,1,0,1,605498,112,107615,341,0.001037459705806069,0.7527593818984547
7953,0.8163,1,0,1,605498,112,107616,340,0.001037459705806069,0.7522123893805309
7954,0.8164,0,1,0,605499,111,107616,340,0.001028196672718515,0.753880266075388
7955,0.8165,1,1,1,605500,110,107617,339,0.0010189336396309607,0.755011135857461
7956,0.8166,4,1,4,605501,109,107621,335,0.0010096706065434065,0.7545045045045045
7957,0.8167,1,0,1,605501,109,107622,334,0.0010096706065434065,0.7539503386004515
7958,0.8169,1,1,1,605502,108,107623,333,0.0010004075734558523,0.7551020408163265
7959,0.817,1,0,1,605502,108,107624,332,0.0010004075734558523,0.7545454545454545
7960,0.8171,2,2,2,605504,106,107626,330,0.000981881507280744,0.7568807339449541
7961,0.8172,1,0,1,605504,106,107627,329,0.000981881507280744,0.7563218390804598
7962,0.8173,1,1,1,605505,105,107628,328,0.0009726184741931898,0.7575057736720554
7963,0.8176,0,3,0,605508,102,107628,328,0.0009448293749305273,0.7627906976744186
7964,0.8177,1,0,1,605508,102,107629,327,0.0009448293749305273,0.7622377622377622
7965,0.8179,0,1,0,605509,101,107629,327,0.0009355663418429731,0.764018691588785
7966,0.818,1,1,1,605510,100,107630,326,0.0009263033087554189,0.7652582159624414
7967,0.8181,1,0,1,605510,100,107631,325,0.0009263033087554189,0.7647058823529411
7968,0.8185,3,0,3,605510,100,107634,322,0.0009263033087554189,0.7630331753554502
7969,0.8186,0,1,0,605511,99,107634,322,0.0009170402756678647,0.7648456057007126
7970,0.8187,1,0,1,605511,99,107635,321,0.0009170402756678647,0.7642857142857142
7971,0.8189,2,0,2,605511,99,107637,319,0.0009170402756678647,0.7631578947368421
7972,0.8191,2,0,2,605511,99,107639,317,0.0009170402756678647,0.7620192307692307
7973,0.8192,1,0,1,605511,99,107640,316,0.0009170402756678647,0.7614457831325301
7974,0.8193,2,1,2,605512,98,107642,314,0.0009077772425803105,0.7621359223300971
7975,0.8194,1,0,1,605512,98,107643,313,0.0009077772425803105,0.7615571776155717
7976,0.8195,1,0,1,605512,98,107644,312,0.0009077772425803105,0.7609756097560976
7977,0.8196,1,0,1,605512,98,107645,311,0.0009077772425803105,0.7603911980440098
7978,0.8197,1,1,1,605513,97,107646,310,0.0008985142094927563,0.7616707616707616
7979,0.8201,1,0,1,605513,97,107647,309,0.0008985142094927563,0.7610837438423645
7980,0.8202,1,0,1,605513,97,107648,308,0.0008985142094927563,0.7604938271604939
7981,0.8203,2,1,2,605514,96,107650,306,0.0008892511764052022,0.7611940298507462
7982,0.8204,1,1,1,605515,95,107651,305,0.000879988143317648,0.7625
7983,0.8205,1,0,1,605515,95,107652,304,0.000879988143317648,0.7619047619047619
7984,0.8206,1,0,1,605515,95,107653,303,0.000879988143317648,0.7613065326633166
7985,0.8207,4,0,4,605515,95,107657,299,0.000879988143317648,0.7588832487309645
7986,0.821,0,1,0,605516,94,107657,299,0.0008707251102300938,0.7608142493638677
7987,0.8212,0,1,0,605517,93,107657,299,0.0008614620771425395,0.7627551020408163
7988,0.8213,0,1,0,605518,92,107657,299,0.0008521990440549853,0.7647058823529411
7989,0.8214,0,1,0,605519,91,107657,299,0.0008429360109674311,0.7666666666666667
7990,0.8215,0,2,0,605521,89,107657,299,0.0008244099447923228,0.770618556701031
7991,0.8216,0,1,0,605522,88,107657,299,0.0008151469117047686,0.772609819121447
7992,0.8217,1,0,1,605522,88,107658,298,0.0008151469117047686,0.772020725388601
7993,0.8219,1,0,1,605522,88,107659,297,0.0008151469117047686,0.7714285714285715
7994,0.8221,1,1,1,605523,87,107660,296,0.0008058838786172144,0.7728459530026109
7995,0.8222,2,0,2,605523,87,107662,294,0.0008058838786172144,0.7716535433070866
7996,0.8225,1,0,1,605523,87,107663,293,0.0008058838786172144,0.7710526315789473
7997,0.8226,2,0,2,605523,87,107665,291,0.0008058838786172144,0.7698412698412699
7998,0.8227,1,0,1,605523,87,107666,290,0.0008058838786172144,0.7692307692307693
7999,0.8228,1,0,1,605523,87,107667,289,0.0008058838786172144,0.7686170212765957
8000,0.8229,1,0,1,605523,87,107668,288,0.0008058838786172144,0.768
8001,0.823,3,1,3,605524,86,107671,285,0.0007966208455296602,0.7681940700808625
8002,0.8231,1,2,1,605526,84,107672,284,0.0007780947793545518,0.7717391304347826
8003,0.8232,1,1,1,605527,83,107673,283,0.0007688317462669976,0.773224043715847
8004,0.8234,1,0,1,605527,83,107674,282,0.0007688317462669976,0.7726027397260274
8005,0.8235,2,1,2,605528,82,107676,280,0.0007595687131794435,0.7734806629834254
8006,0.8236,1,0,1,605528,82,107677,279,0.0007595687131794435,0.7728531855955678
8007,0.8239,1,0,1,605528,82,107678,278,0.0007595687131794435,0.7722222222222223
8008,0.8242,0,1,0,605529,81,107678,278,0.0007503056800918893,0.7743732590529248
8009,0.8249,2,0,2,605529,81,107680,276,0.0007503056800918893,0.773109243697479
8010,0.825,0,1,0,605530,80,107680,276,0.0007410426470043351,0.7752808988764045
8011,0.8251,1,1,1,605531,79,107681,275,0.0007317796139167809,0.7768361581920904
8012,0.8252,0,1,0,605532,78,107681,275,0.0007225165808292267,0.7790368271954674
8013,0.8254,1,1,1,605533,77,107682,274,0.0007132535477416725,0.7806267806267806
8014,0.8255,2,0,2,605533,77,107684,272,0.0007132535477416725,0.7793696275071633
8015,0.8256,1,1,1,605534,76,107685,271,0.0007039905146541183,0.7809798270893372
8016,0.8257,1,0,1,605534,76,107686,270,0.0007039905146541183,0.7803468208092486
8017,0.8258,2,0,2,605534,76,107688,268,0.0007039905146541183,0.7790697674418605
8018,0.826,1,0,1,605534,76,107689,267,0.0007039905146541183,0.7784256559766763
8019,0.8261,1,0,1,605534,76,107690,266,0.0007039905146541183,0.7777777777777778
8020,0.8262,1,1,1,605535,75,107691,265,0.0006947274815665642,0.7794117647058824
8021,0.8263,1,1,1,605536,74,107692,264,0.00068546444847901,0.7810650887573964
8022,0.8264,0,1,0,605537,73,107692,264,0.0006762014153914558,0.7833827893175074
8023,0.8265,2,0,2,605537,73,107694,262,0.0006762014153914558,0.7820895522388059
8024,0.8266,0,1,0,605538,72,107694,262,0.0006669383823039016,0.7844311377245509
8025,0.8268,0,1,0,605539,71,107694,262,0.0006576753492163474,0.7867867867867868
8026,0.8269,0,1,0,605540,70,107694,262,0.0006484123161287932,0.7891566265060241
8027,0.827,1,0,1,605540,70,107695,261,0.0006484123161287932,0.7885196374622356
8028,0.8271,1,0,1,605540,70,107696,260,0.0006484123161287932,0.7878787878787878
8029,0.8272,1,1,1,605541,69,107697,259,0.000639149283041239,0.7896341463414634
8030,0.8274,1,1,1,605542,68,107698,258,0.0006298862499536849,0.7914110429447853
8031,0.8275,0,1,0,605543,67,107698,258,0.0006206232168661307,0.7938461538461539
8032,0.8276,2,0,2,605543,67,107700,256,0.0006206232168661307,0.7925696594427245
8033,0.8277,1,0,1,605543,67,107701,255,0.0006206232168661307,0.7919254658385093
8034,0.8278,3,0,3,605543,67,107704,252,0.0006206232168661307,0.7899686520376176
8035,0.8279,1,0,1,605543,67,107705,251,0.0006206232168661307,0.789308176100629
8036,0.828,1,1,1,605544,66,107706,250,0.0006113601837785765,0.7911392405063291
8037,0.8282,1,0,1,605544,66,107707,249,0.0006113601837785765,0.7904761904761904
8038,0.8283,1,0,1,605544,66,107708,248,0.0006113601837785765,0.7898089171974523
8039,0.8286,2,1,2,605545,65,107710,246,0.0006020971506910223,0.7909967845659164
8040,0.8287,0,1,0,605546,64,107710,246,0.0005928341176034681,0.7935483870967742
8041,0.8288,2,1,2,605547,63,107712,244,0.0005835710845159139,0.7947882736156352
8042,0.8291,1,0,1,605547,63,107713,243,0.0005835710845159139,0.7941176470588235
8043,0.8292,2,1,2,605548,62,107715,241,0.0005743080514283597,0.7953795379537953
8044,0.8296,0,2,0,605550,60,107715,241,0.0005557819852532514,0.8006644518272426
8045,0.8297,2,0,2,605550,60,107717,239,0.0005557819852532514,0.7993311036789298
8046,0.8299,0,2,0,605552,58,107717,239,0.000537255919078143,0.8047138047138047
8047,0.8303,1,0,1,605552,58,107718,238,0.000537255919078143,0.8040540540540541
8048,0.8306,1,1,1,605553,57,107719,237,0.0005279928859905888,0.8061224489795918
8049,0.8308,1,0,1,605553,57,107720,236,0.0005279928859905888,0.8054607508532423
8050,0.8309,0,1,0,605554,56,107720,236,0.0005187298529030345,0.8082191780821918
8051,0.831,2,0,2,605554,56,107722,234,0.0005187298529030345,0.8068965517241379
8052,0.8312,1,0,1,605554,56,107723,233,0.0005187298529030345,0.8062283737024222
8053,0.8313,0,2,0,605556,54,107723,233,0.0005002037867279261,0.8118466898954704
8054,0.8316,1,1,1,605557,53,107724,232,0.000490940753640372,0.8140350877192982
8055,0.8317,2,0,2,605557,53,107726,230,0.000490940753640372,0.8127208480565371
8056,0.8318,3,0,3,605557,53,107729,227,0.000490940753640372,0.8107142857142857
8057,0.8319,1,0,1,605557,53,107730,226,0.000490940753640372,0.8100358422939068
8058,0.832,1,0,1,605557,53,107731,225,0.000490940753640372,0.8093525179856115
8059,0.8321,1,0,1,605557,53,107732,224,0.000490940753640372,0.8086642599277978
8060,0.8323,1,0,1,605557,53,107733,223,0.000490940753640372,0.8079710144927537
8061,0.8324,1,0,1,605557,53,107734,222,0.000490940753640372,0.8072727272727273
8062,0.8327,1,0,1,605557,53,107735,221,0.000490940753640372,0.8065693430656934
8063,0.8328,3,1,3,605558,52,107738,218,0.00048167772055281784,0.8074074074074075
8064,0.833,2,0,2,605558,52,107740,216,0.00048167772055281784,0.8059701492537313
8065,0.8335,1,0,1,605558,52,107741,215,0.00048167772055281784,0.8052434456928839
8066,0.8337,2,0,2,605558,52,107743,213,0.00048167772055281784,0.8037735849056604
8067,0.8338,2,0,2,605558,52,107745,211,0.00048167772055281784,0.8022813688212928
8068,0.8339,1,0,1,605558,52,107746,210,0.00048167772055281784,0.8015267175572519
8069,0.834,2,0,2,605558,52,107748,208,0.00048167772055281784,0.8
8070,0.8341,1,0,1,605558,52,107749,207,0.00048167772055281784,0.7992277992277992
8071,0.8342,2,0,2,605558,52,107751,205,0.00048167772055281784,0.7976653696498055
8072,0.8343,1,0,1,605558,52,107752,204,0.00048167772055281784,0.796875
8073,0.8346,1,0,1,605558,52,107753,203,0.00048167772055281784,0.796078431372549
8074,0.8347,1,0,1,605558,52,107754,202,0.00048167772055281784,0.7952755905511811
8075,0.8348,1,0,1,605558,52,107755,201,0.00048167772055281784,0.7944664031620553
8076,0.8351,2,0,2,605558,52,107757,199,0.00048167772055281784,0.7928286852589641
8077,0.8352,1,0,1,605558,52,107758,198,0.00048167772055281784,0.792
8078,0.8355,2,1,2,605559,51,107760,196,0.00047241468746526364,0.7935222672064778
8079,0.8359,1,0,1,605559,51,107761,195,0.00047241468746526364,0.7926829268292683
8080,0.836,1,1,1,605560,50,107762,194,0.00046315165437770943,0.7950819672131147
8081,0.8361,2,0,2,605560,50,107764,192,0.00046315165437770943,0.7933884297520661
8082,0.8363,1,0,1,605560,50,107765,191,0.00046315165437770943,0.7925311203319502
8083,0.8364,1,1,1,605561,49,107766,190,0.00045388862129015523,0.7949790794979079
8084,0.8365,0,1,0,605562,48,107766,190,0.0004446255882026011,0.7983193277310925
8085,0.8366,3,0,3,605562,48,107769,187,0.0004446255882026011,0.7957446808510639
8086,0.8367,1,0,1,605562,48,107770,186,0.0004446255882026011,0.7948717948717948
8087,0.8372,1,0,1,605562,48,107771,185,0.0004446255882026011,0.7939914163090128
8088,0.8373,1,0,1,605562,48,107772,184,0.0004446255882026011,0.7931034482758621
8089,0.8374,0,2,0,605564,46,107772,184,0.00042609952202749267,0.8
8090,0.8375,1,1,1,605565,45,107773,183,0.00041683648893993847,0.8026315789473685
8091,0.8376,1,0,1,605565,45,107774,182,0.00041683648893993847,0.801762114537445
8092,0.8383,2,0,2,605565,45,107776,180,0.00041683648893993847,0.8
8093,0.8384,1,0,1,605565,45,107777,179,0.00041683648893993847,0.7991071428571429
8094,0.8389,0,1,0,605566,44,107777,179,0.0004075734558523843,0.8026905829596412
8095,0.8391,0,1,0,605567,43,107777,179,0.0003983104227648301,0.8063063063063063
8096,0.8392,1,0,1,605567,43,107778,178,0.0003983104227648301,0.8054298642533937
8097,0.8393,2,1,2,605568,42,107780,176,0.0003890473896772759,0.8073394495412844
8098,0.8395,1,0,1,605568,42,107781,175,0.0003890473896772759,0.8064516129032258
8099,0.8396,0,1,0,605569,41,107781,175,0.00037978435658972176,0.8101851851851852
8100,0.8398,2,1,2,605570,40,107783,173,0.00037052132350216756,0.812206572769953
8101,0.84,0,1,0,605571,39,107783,173,0.00036125829041461335,0.8160377358490566
8102,0.8401,1,1,1,605572,38,107784,172,0.00035199525732705915,0.819047619047619
8103,0.8402,1,1,1,605573,37,107785,171,0.000342732224239505,0.8221153846153846
8104,0.8405,2,0,2,605573,37,107787,169,0.000342732224239505,0.8203883495145631
8105,0.8407,1,0,1,605573,37,107788,168,0.000342732224239505,0.8195121951219512
8106,0.8409,1,0,1,605573,37,107789,167,0.000342732224239505,0.8186274509803921
8107,0.8411,0,1,0,605574,36,107789,167,0.0003334691911519508,0.8226600985221675
8108,0.8412,1,1,1,605575,35,107790,166,0.0003242061580643966,0.8258706467661692
8109,0.8413,2,0,2,605575,35,107792,164,0.0003242061580643966,0.8241206030150754
8110,0.8414,1,0,1,605575,35,107793,163,0.0003242061580643966,0.8232323232323232
8111,0.8415,1,0,1,605575,35,107794,162,0.0003242061580643966,0.8223350253807107
8112,0.842,2,0,2,605575,35,107796,160,0.0003242061580643966,0.8205128205128205
8113,0.8421,0,1,0,605576,34,107796,160,0.00031494312497684244,0.8247422680412371
8114,0.8422,2,1,2,605577,33,107798,158,0.00030568009188928824,0.8272251308900523
8115,0.8424,2,0,2,605577,33,107800,156,0.00030568009188928824,0.8253968253968254
8116,0.8425,1,0,1,605577,33,107801,155,0.00030568009188928824,0.824468085106383
8117,0.8426,1,1,1,605578,32,107802,154,0.00029641705880173404,0.8279569892473119
8118,0.8427,2,0,2,605578,32,107804,152,0.00029641705880173404,0.8260869565217391
8119,0.8428,1,0,1,605578,32,107805,151,0.00029641705880173404,0.825136612021858
8120,0.8431,1,0,1,605578,32,107806,150,0.00029641705880173404,0.8241758241758241
8121,0.8432,1,0,1,605578,32,107807,149,0.00029641705880173404,0.8232044198895028
8122,0.8434,1,0,1,605578,32,107808,148,0.00029641705880173404,0.8222222222222222
8123,0.8435,1,1,1,605579,31,107809,147,0.00028715402571417983,0.8258426966292135
8124,0.8437,1,0,1,605579,31,107810,146,0.00028715402571417983,0.8248587570621468
8125,0.8438,2,0,2,605579,31,107812,144,0.00028715402571417983,0.8228571428571428
8126,0.844,0,1,0,605580,30,107812,144,0.0002778909926266257,0.8275862068965517
8127,0.8442,1,0,1,605580,30,107813,143,0.0002778909926266257,0.8265895953757225
8128,0.8443,1,0,1,605580,30,107814,142,0.0002778909926266257,0.8255813953488372
8129,0.8444,1,0,1,605580,30,107815,141,0.0002778909926266257,0.8245614035087719
8130,0.8445,1,0,1,605580,30,107816,140,0.0002778909926266257,0.8235294117647058
8131,0.8447,2,0,2,605580,30,107818,138,0.0002778909926266257,0.8214285714285714
8132,0.8449,1,0,1,605580,30,107819,137,0.0002778909926266257,0.8203592814371258
8133,0.8451,1,0,1,605580,30,107820,136,0.0002778909926266257,0.8192771084337349
8134,0.8456,1,0,1,605580,30,107821,135,0.0002778909926266257,0.8181818181818182
8135,0.846,0,1,0,605581,29,107821,135,0.0002686279595390715,0.823170731707317
8136,0.8463,1,0,1,605581,29,107822,134,0.0002686279595390715,0.8220858895705522
8137,0.8465,2,0,2,605581,29,107824,132,0.0002686279595390715,0.8198757763975155
8138,0.8467,2,0,2,605581,29,107826,130,0.0002686279595390715,0.8176100628930818
8139,0.8468,1,0,1,605581,29,107827,129,0.0002686279595390715,0.8164556962025317
8140,0.8469,1,0,1,605581,29,107828,128,0.0002686279595390715,0.8152866242038217
8141,0.847,1,0,1,605581,29,107829,127,0.0002686279595390715,0.8141025641025641
8142,0.8472,1,0,1,605581,29,107830,126,0.0002686279595390715,0.8129032258064516
8143,0.8473,0,1,0,605582,28,107830,126,0.0002593649264515173,0.8181818181818182
8144,0.8474,1,0,1,605582,28,107831,125,0.0002593649264515173,0.8169934640522876
8145,0.8479,1,0,1,605582,28,107832,124,0.0002593649264515173,0.8157894736842105
8146,0.848,2,0,2,605582,28,107834,122,0.0002593649264515173,0.8133333333333334
8147,0.8481,0,1,0,605583,27,107834,122,0.00025010189336396307,0.8187919463087249
8148,0.8482,1,0,1,605583,27,107835,121,0.00025010189336396307,0.8175675675675675
8149,0.8484,2,0,2,605583,27,107837,119,0.00025010189336396307,0.815068493150685
8150,0.8491,2,0,2,605583,27,107839,117,0.00025010189336396307,0.8125
8151,0.8495,2,0,2,605583,27,107841,115,0.00025010189336396307,0.8098591549295775
8152,0.8496,1,0,1,605583,27,107842,114,0.00025010189336396307,0.8085106382978723
8153,0.8497,1,0,1,605583,27,107843,113,0.00025010189336396307,0.8071428571428572
8154,0.8499,1,0,1,605583,27,107844,112,0.00025010189336396307,0.8057553956834532
8155,0.8501,1,0,1,605583,27,107845,111,0.00025010189336396307,0.8043478260869565
8156,0.8502,1,0,1,605583,27,107846,110,0.00025010189336396307,0.8029197080291971
8157,0.8507,1,1,1,605584,26,107847,109,0.00024083886027640892,0.8074074074074075
8158,0.8509,1,0,1,605584,26,107848,108,0.00024083886027640892,0.8059701492537313
8159,0.851,0,1,0,605585,25,107848,108,0.00023157582718885472,0.8120300751879699
8160,0.8516,0,1,0,605586,24,107848,108,0.00022231279410130054,0.8181818181818182
8161,0.8517,3,0,3,605586,24,107851,105,0.00022231279410130054,0.813953488372093
8162,0.8518,1,0,1,605586,24,107852,104,0.00022231279410130054,0.8125
8163,0.852,0,1,0,605587,23,107852,104,0.00021304976101374634,0.8188976377952756
8164,0.8522,1,0,1,605587,23,107853,103,0.00021304976101374634,0.8174603174603174
8165,0.8523,2,0,2,605587,23,107855,101,0.00021304976101374634,0.8145161290322581
8166,0.8529,2,0,2,605587,23,107857,99,0.00021304976101374634,0.8114754098360656
8167,0.8534,2,0,2,605587,23,107859,97,0.00021304976101374634,0.8083333333333333
8168,0.8535,3,0,3,605587,23,107862,94,0.00021304976101374634,0.8034188034188035
8169,0.8537,0,1,0,605588,22,107862,94,0.00020378672792619216,0.8103448275862069
8170,0.8538,1,0,1,605588,22,107863,93,0.00020378672792619216,0.808695652173913
8171,0.854,2,0,2,605588,22,107865,91,0.00020378672792619216,0.8053097345132744
8172,0.8541,1,0,1,605588,22,107866,90,0.00020378672792619216,0.8035714285714286
8173,0.8546,0,1,0,605589,21,107866,90,0.00019452369483863796,0.8108108108108109
8174,0.8547,0,1,0,605590,20,107866,90,0.00018526066175108378,0.8181818181818182
8175,0.8548,2,0,2,605590,20,107868,88,0.00018526066175108378,0.8148148148148148
8176,0.8549,1,0,1,605590,20,107869,87,0.00018526066175108378,0.8130841121495327
8177,0.8553,1,0,1,605590,20,107870,86,0.00018526066175108378,0.8113207547169812
8178,0.8558,0,1,0,605591,19,107870,86,0.00017599762866352957,0.819047619047619
8179,0.8559,1,0,1,605591,19,107871,85,0.00017599762866352957,0.8173076923076923
8180,0.8561,1,0,1,605591,19,107872,84,0.00017599762866352957,0.8155339805825242
8181,0.8564,1,1,1,605592,18,107873,83,0.0001667345955759754,0.8217821782178217
8182,0.8571,1,0,1,605592,18,107874,82,0.0001667345955759754,0.82
8183,0.8573,1,1,1,605593,17,107875,81,0.00015747156248842122,0.826530612244898
8184,0.8577,1,0,1,605593,17,107876,80,0.00015747156248842122,0.8247422680412371
8185,0.8583,2,1,2,605594,16,107878,78,0.00014820852940086702,0.8297872340425532
8186,0.8584,1,0,1,605594,16,107879,77,0.00014820852940086702,0.8279569892473119
8187,0.8586,1,0,1,605594,16,107880,76,0.00014820852940086702,0.8260869565217391
8188,0.8588,2,0,2,605594,16,107882,74,0.00014820852940086702,0.8222222222222222
8189,0.859,1,0,1,605594,16,107883,73,0.00014820852940086702,0.8202247191011236
8190,0.8594,0,1,0,605595,15,107883,73,0.00013894549631331284,0.8295454545454546
8191,0.8595,1,0,1,605595,15,107884,72,0.00013894549631331284,0.8275862068965517
8192,0.8598,1,0,1,605595,15,107885,71,0.00013894549631331284,0.8255813953488372
8193,0.86,1,0,1,605595,15,107886,70,0.00013894549631331284,0.8235294117647058
8194,0.8607,1,0,1,605595,15,107887,69,0.00013894549631331284,0.8214285714285714
8195,0.8608,1,0,1,605595,15,107888,68,0.00013894549631331284,0.8192771084337349
8196,0.8614,1,0,1,605595,15,107889,67,0.00013894549631331284,0.8170731707317073
8197,0.8615,1,0,1,605595,15,107890,66,0.00013894549631331284,0.8148148148148148
8198,0.8617,1,0,1,605595,15,107891,65,0.00013894549631331284,0.8125
8199,0.8619,0,1,0,605596,14,107891,65,0.00012968246322575864,0.8227848101265823
8200,0.8621,1,0,1,605596,14,107892,64,0.00012968246322575864,0.8205128205128205
8201,0.8624,2,0,2,605596,14,107894,62,0.00012968246322575864,0.8157894736842105
8202,0.8626,1,0,1,605596,14,107895,61,0.00012968246322575864,0.8133333333333334
8203,0.8628,1,0,1,605596,14,107896,60,0.00012968246322575864,0.8108108108108109
8204,0.8629,1,0,1,605596,14,107897,59,0.00012968246322575864,0.8082191780821918
8205,0.863,3,0,3,605596,14,107900,56,0.00012968246322575864,0.8
8206,0.8631,1,0,1,605596,14,107901,55,0.00012968246322575864,0.7971014492753623
8207,0.8634,1,0,1,605596,14,107902,54,0.00012968246322575864,0.7941176470588235
8208,0.8636,1,0,1,605596,14,107903,53,0.00012968246322575864,0.7910447761194029
8209,0.864,0,1,0,605597,13,107903,53,0.00012041943013820446,0.803030303030303
8210,0.8642,0,2,0,605599,11,107903,53,0.00010189336396309608,0.828125
8211,0.8643,1,0,1,605599,11,107904,52,0.00010189336396309608,0.8253968253968254
8212,0.8646,1,0,1,605599,11,107905,51,0.00010189336396309608,0.8225806451612904
8213,0.8648,0,1,0,605600,10,107905,51,9.263033087554189e-05,0.8360655737704918
8214,0.8653,1,0,1,605600,10,107906,50,9.263033087554189e-05,0.8333333333333334
8215,0.8656,1,0,1,605600,10,107907,49,9.263033087554189e-05,0.8305084745762712
8216,0.8664,1,0,1,605600,10,107908,48,9.263033087554189e-05,0.8275862068965517
8217,0.8668,0,1,0,605601,9,107908,48,8.33672977879877e-05,0.8421052631578947
8218,0.8671,1,0,1,605601,9,107909,47,8.33672977879877e-05,0.8392857142857143
8219,0.8676,1,0,1,605601,9,107910,46,8.33672977879877e-05,0.8363636363636363
8220,0.8678,1,0,1,605601,9,107911,45,8.33672977879877e-05,0.8333333333333334
8221,0.8683,1,0,1,605601,9,107912,44,8.33672977879877e-05,0.8301886792452831
8222,0.8687,1,0,1,605601,9,107913,43,8.33672977879877e-05,0.8269230769230769
8223,0.8688,1,0,1,605601,9,107914,42,8.33672977879877e-05,0.8235294117647058
8224,0.8694,1,0,1,605601,9,107915,41,8.33672977879877e-05,0.82
8225,0.8695,1,0,1,605601,9,107916,40,8.33672977879877e-05,0.8163265306122449
8226,0.8698,1,0,1,605601,9,107917,39,8.33672977879877e-05,0.8125
8227,0.87,1,0,1,605601,9,107918,38,8.33672977879877e-05,0.8085106382978723
8228,0.8702,1,0,1,605601,9,107919,37,8.33672977879877e-05,0.8043478260869565
8229,0.8707,1,0,1,605601,9,107920,36,8.33672977879877e-05,0.8
8230,0.871,1,0,1,605601,9,107921,35,8.33672977879877e-05,0.7954545454545454
8231,0.8712,1,0,1,605601,9,107922,34,8.33672977879877e-05,0.7906976744186046
8232,0.8715,1,0,1,605601,9,107923,33,8.33672977879877e-05,0.7857142857142857
8233,0.8716,0,1,0,605602,8,107923,33,7.410426470043351e-05,0.8048780487804879
8234,0.8723,1,0,1,605602,8,107924,32,7.410426470043351e-05,0.8
8235,0.8725,1,0,1,605602,8,107925,31,7.410426470043351e-05,0.7948717948717948
8236,0.8727,0,1,0,605603,7,107925,31,6.484123161287932e-05,0.8157894736842105
8237,0.8738,1,0,1,605603,7,107926,30,6.484123161287932e-05,0.8108108108108109
8238,0.875,1,0,1,605603,7,107927,29,6.484123161287932e-05,0.8055555555555556
8239,0.8773,1,0,1,605603,7,107928,28,6.484123161287932e-05,0.8
8240,0.8774,0,1,0,605604,6,107928,28,5.5578198525325135e-05,0.8235294117647058
8241,0.8775,1,0,1,605604,6,107929,27,5.5578198525325135e-05,0.8181818181818182
8242,0.8786,1,0,1,605604,6,107930,26,5.5578198525325135e-05,0.8125
8243,0.8793,1,0,1,605604,6,107931,25,5.5578198525325135e-05,0.8064516129032258
8244,0.8798,1,0,1,605604,6,107932,24,5.5578198525325135e-05,0.8
8245,0.8801,1,0,1,605604,6,107933,23,5.5578198525325135e-05,0.7931034482758621
8246,0.8803,1,0,1,605604,6,107934,22,5.5578198525325135e-05,0.7857142857142857
8247,0.8808,1,0,1,605604,6,107935,21,5.5578198525325135e-05,0.7777777777777778
8248,0.8822,1,0,1,605604,6,107936,20,5.5578198525325135e-05,0.7692307692307693
8249,0.8829,1,0,1,605604,6,107937,19,5.5578198525325135e-05,0.76
8250,0.8835,0,1,0,605605,5,107937,19,4.6315165437770945e-05,0.7916666666666666
8251,0.8838,1,0,1,605605,5,107938,18,4.6315165437770945e-05,0.782608695652174
8252,0.8844,1,0,1,605605,5,107939,17,4.6315165437770945e-05,0.7727272727272727
8253,0.8861,1,0,1,605605,5,107940,16,4.6315165437770945e-05,0.7619047619047619
8254,0.8866,0,1,0,605606,4,107940,16,3.7052132350216754e-05,0.8
8255,0.8878,1,0,1,605606,4,107941,15,3.7052132350216754e-05,0.7894736842105263
8256,0.8895,1,0,1,605606,4,107942,14,3.7052132350216754e-05,0.7777777777777778
8257,0.8922,1,0,1,605606,4,107943,13,3.7052132350216754e-05,0.7647058823529411
8258,0.8927,1,0,1,605606,4,107944,12,3.7052132350216754e-05,0.75
8259,0.8932,1,0,1,605606,4,107945,11,3.7052132350216754e-05,0.7333333333333333
8260,0.8937,1,0,1,605606,4,107946,10,3.7052132350216754e-05,0.7142857142857143
8261,0.8957,1,0,1,605606,4,107947,9,3.7052132350216754e-05,0.6923076923076923
8262,0.8959,1,0,1,605606,4,107948,8,3.7052132350216754e-05,0.6666666666666666
8263,0.897,0,2,0,605608,2,107948,8,1.8526066175108377e-05,0.8
8264,0.8972,1,0,1,605608,2,107949,7,1.8526066175108377e-05,0.7777777777777778
8265,0.8989,0,1,0,605609,1,107949,7,9.263033087554189e-06,0.875
8266,0.9035,1,0,1,605609,1,107950,6,9.263033087554189e-06,0.8571428571428571
8267,0.905,1,0,1,605609,1,107951,5,9.263033087554189e-06,0.8333333333333334
8268,0.9058,1,0,1,605609,1,107952,4,9.263033087554189e-06,0.8
8269,0.9074,1,0,1,605609,1,107953,3,9.263033087554189e-06,0.75
8270,0.9088,0,1,0,605610,0,107953,3,0.0,1.0
8271,0.9089,1,0,1,605610,0,107954,2,0.0,1.0
8272,0.9123,1,0,1,605610,0,107955,1,0.0,1.0
8273,0.914,1,0,1,605610,0,107956,0,0.0,
