,y_proba,y_test,Neg,Pos,TN,FP,FN,TP,FP/P,Prec
0,0.0361,0,1,0,1,605609,0,107956,5.609776205120605,0.1512910526721462
1,0.0366,0,2,0,3,605607,0,107956,5.60975767905443,0.1512914767161414
2,0.0372,0,2,0,5,605605,0,107956,5.609739152988254,0.15129190076251364
3,0.0374,0,1,0,6,605604,0,107956,5.609729889955167,0.1512921127865912
4,0.0375,0,1,0,7,605603,0,107956,5.609720626922079,0.15129232481126298
5,0.0376,0,5,0,12,605598,0,107956,5.609674311756642,0.15129338494353617
6,0.0377,0,1,0,13,605597,0,107956,5.609665048723554,0.15129359697177364
7,0.0379,0,1,0,14,605596,0,107956,5.6096557856904665,0.15129380900060543
8,0.038,0,1,0,15,605595,0,107956,5.609646522657379,0.15129402103003148
9,0.0383,0,4,0,19,605591,0,107956,5.609609470525029,0.15129486915367873
10,0.0385,0,4,0,23,605587,0,107956,5.609572418392679,0.15129571728683486
11,0.0387,0,2,0,25,605585,0,107956,5.609553892326503,0.15129614135697877
12,0.0388,0,4,0,29,605581,0,107956,5.6095168401941535,0.15129698950439852
13,0.039,0,3,0,32,605578,0,107956,5.609489051094891,0.15129762562120375
14,0.0391,0,8,0,40,605570,0,107956,5.60941494683019,0.15129932195883541
15,0.0392,0,1,0,41,605569,0,107956,5.609405683797102,0.15129953400371396
16,0.0393,0,2,0,43,605567,0,107956,5.609387157730928,0.15129995809525412
17,0.0394,0,6,0,49,605561,0,107956,5.609331579532402,0.15130123038413942
18,0.0395,0,1,0,50,605560,0,107956,5.6093223164993145,0.15130144243436727
19,0.0396,0,7,0,57,605553,0,107956,5.609257475267702,0.15130292680260515
20,0.0397,0,6,0,63,605547,0,107956,5.609201897069176,0.15130419914141915
21,0.0398,0,1,0,64,605546,0,107956,5.609192634036089,0.1513044111999686
22,0.0399,0,7,0,71,605539,0,107956,5.609127792804476,0.1513058956264585
23,0.04,0,5,0,76,605534,0,107956,5.609081477639038,0.1513069559489271
24,0.0401,0,4,0,80,605530,0,107956,5.609044425506688,0.15130780421760204
25,0.0403,0,4,0,84,605526,0,107956,5.609007373374338,0.15130865249578826
26,0.0404,0,7,0,91,605519,0,107956,5.608942532142724,0.15131013700550125
27,0.0405,1,9,1,100,605510,1,107955,5.608859164844937,0.15131085617374362
28,0.0406,0,1,0,101,605509,1,107955,5.608849901811849,0.15131106825291815
29,0.0407,0,8,0,109,605501,1,107955,5.608775797547149,0.1513127649077168
30,0.0408,0,2,0,111,605499,1,107955,5.6087572714809735,0.1513131890773617
31,0.0409,0,8,0,119,605491,1,107955,5.608683167216273,0.15131488577972263
32,0.041,0,5,0,124,605486,1,107955,5.608636852050836,0.15131594623802108
33,0.0411,0,10,0,134,605476,1,107955,5.60854422171996,0.15131806719921057
34,0.0412,0,10,0,144,605466,1,107955,5.608451591389084,0.15132018821985896
35,0.0413,0,2,0,146,605464,1,107955,5.6084330653229095,0.15132061243112394
36,0.0414,0,6,0,152,605458,1,107955,5.608377487124384,0.15132188507918976
37,0.0415,0,15,0,167,605443,1,107955,5.6082385416280705,0.15132506679301036
38,0.0416,0,12,0,179,605431,1,107955,5.60812738523102,0.1513276122604032
39,0.0417,0,16,0,195,605415,1,107955,5.607979176701619,0.15133100635014088
40,0.0418,0,17,0,212,605398,1,107955,5.607821705139131,0.15133461273731239
41,0.0419,2,7,2,219,605391,3,107953,5.607756863907518,0.15133371837430468
42,0.042,1,7,1,226,605384,4,107952,5.607692022675905,0.15133401370462166
43,0.0421,2,15,2,241,605369,6,107950,5.607553077179592,0.15133481654070619
44,0.0422,0,5,0,246,605364,6,107950,5.607506762014154,0.15133587732751635
45,0.0423,2,12,2,258,605352,8,107948,5.6073956056171035,0.1513360437403617
46,0.0424,0,16,0,274,605336,8,107948,5.607247397087702,0.15133943842845207
47,0.0425,1,7,1,281,605329,9,107947,5.60718255585609,0.1513397338477672
48,0.0426,0,12,0,293,605317,9,107947,5.607071399459039,0.15134227999730815
49,0.0427,1,15,1,308,605302,10,107946,5.606932453962726,0.15134427295975594
50,0.0428,0,8,0,316,605294,10,107946,5.606858349698025,0.1513459705008132
51,0.0429,0,12,0,328,605282,10,107946,5.606747193300975,0.15134851688380152
52,0.043,0,12,0,340,605270,10,107946,5.606636036903923,0.15135106335247667
53,0.0431,1,14,1,354,605256,11,107945,5.606506354440698,0.15135284442955071
54,0.0432,0,20,0,374,605236,11,107945,5.606321093778947,0.15135708887365198
55,0.0433,1,16,1,390,605220,12,107944,5.6061728852495465,0.15135929463629685
56,0.0434,2,8,2,398,605212,14,107942,5.606098780984846,0.1513586125857809
57,0.0435,0,16,0,414,605196,14,107942,5.605950572455445,0.15136200847521797
58,0.0436,1,18,1,432,605178,15,107941,5.605783837859869,0.1513646390013448
59,0.0437,0,19,0,451,605159,15,107941,5.6056078402312055,0.15136867199551254
60,0.0438,2,26,2,477,605133,17,107939,5.6053670013709285,0.1513718109812193
61,0.0439,2,23,2,500,605110,19,107937,5.605153951609915,0.15137431333418414
62,0.044,1,17,1,517,605093,20,107936,5.604996480047427,0.15137673222267256
63,0.0441,0,11,0,528,605082,20,107936,5.604894586683463,0.15137906756912167
64,0.0442,2,13,2,541,605069,22,107934,5.604774167253326,0.15137944721130206
65,0.0443,0,19,0,560,605050,22,107934,5.604598169624662,0.15138348125624138
66,0.0444,0,23,0,583,605027,22,107934,5.6043851198636485,0.15138836486147209
67,0.0445,0,15,0,598,605012,22,107934,5.604246174367335,0.15139154999116342
68,0.0446,4,82,4,680,604930,26,107930,5.6034866056541555,0.15140420278876637
69,0.0447,2,70,2,750,604860,28,107928,5.602838193338027,0.15141669051667536
70,0.0448,3,32,3,782,604828,31,107925,5.6025417762792245,0.151419916857593
71,0.0449,0,21,0,803,604807,31,107925,5.602347252584386,0.1514243783076949
72,0.045,10,148,10,951,604659,41,107915,5.600976323687428,0.15144392021039219
73,0.0451,1,16,1,967,604643,42,107914,5.600828115158027,0.1514461299236412
74,0.0452,6,89,6,1056,604554,48,107908,5.600003705213235,0.15145790231619372
75,0.0453,0,14,0,1070,604540,48,107908,5.59987402275001,0.15146087854832915
76,0.0454,4,141,4,1211,604399,52,107904,5.598567935084664,0.15148609510278632
77,0.0455,3,90,3,1301,604309,55,107901,5.597734262106784,0.15150166383510483
78,0.0456,0,19,0,1320,604290,55,107901,5.5975582644781205,0.1515057056323374
79,0.0457,3,88,3,1408,604202,58,107898,5.596743117566416,0.15152085381266675
80,0.0458,2,22,2,1430,604180,60,107896,5.59653933083849,0.15152315202309866
81,0.0459,1,45,1,1475,604135,61,107895,5.59612249434955,0.1515315365925593
82,0.046,4,75,4,1550,604060,65,107891,5.595427766867983,0.15154273257569692
83,0.0461,0,20,0,1570,604040,65,107891,5.595242506206232,0.15154698980659642
84,0.0462,7,65,7,1635,603975,72,107884,5.5946404090555415,0.15155248441053637
85,0.0463,5,89,5,1724,603886,77,107879,5.593815999110749,0.15156547455972125
86,0.0464,3,28,3,1752,603858,80,107876,5.5935566341842975,0.1515678610267319
87,0.0465,4,116,4,1868,603742,84,107872,5.592482122346141,0.15158779900339228
88,0.0466,4,93,4,1961,603649,88,107868,5.591620660268998,0.15160284293980328
89,0.0467,3,46,3,2007,603603,91,107865,5.591194560746971,0.15160906744927388
90,0.0468,5,91,5,2098,603512,96,107860,5.5903516247360034,0.15162249849586432
91,0.0469,3,50,3,2148,603462,99,107857,5.589888473081626,0.15162957829047163
92,0.047,11,158,11,2306,603304,110,107846,5.5884249138537925,0.15165014413274275
93,0.0471,4,126,4,2432,603178,114,107842,5.587257771684761,0.15167224550645553
94,0.0472,2,158,2,2590,603020,116,107840,5.585794212456927,0.1517035703232704
95,0.0473,7,109,7,2699,602911,123,107833,5.584784541850383,0.15171848091577278
96,0.0474,1,79,1,2778,602832,124,107832,5.584052762236467,0.15173415284860356
97,0.0475,4,83,4,2861,602749,128,107828,5.583283930490199,0.15174710129936658
98,0.0476,6,99,6,2960,602650,134,107822,5.582366890214532,0.15176108277314238
99,0.0477,3,81,3,3041,602569,137,107819,5.58161658453444,0.15177480475458482
100,0.0478,0,40,0,3081,602529,137,107819,5.581246063210938,0.15178335125881962
101,0.0479,9,176,9,3257,602353,146,107810,5.579615769387528,0.15181021821750781
102,0.048,0,43,0,3300,602310,146,107810,5.579217458964764,0.1518194108038078
103,0.0481,0,45,0,3345,602265,146,107810,5.578800622475823,0.15182903214449178
104,0.0482,2,43,2,3388,602222,148,107808,5.578402312053059,0.15183583792234132
105,0.0483,1,65,1,3453,602157,149,107807,5.577800214902368,0.15184854443323886
106,0.0484,10,197,10,3650,601960,159,107797,5.575975397384119,0.15187874159747633
107,0.0485,6,128,6,3778,601832,165,107791,5.574789729148913,0.15189896607071643
108,0.0486,5,111,5,3889,601721,170,107786,5.573761532476194,0.15191675346402503
109,0.0487,8,54,8,3943,601667,178,107778,5.573261328689466,0.1519187533917358
110,0.0488,7,149,7,4092,601518,185,107771,5.57188113675942,0.1519422971454513
111,0.0489,10,195,10,4287,601323,195,107761,5.570074845307348,0.1519721217796481
112,0.049,5,142,5,4429,601181,200,107756,5.568759494608915,0.151996580796319
113,0.0491,14,168,14,4597,601013,214,107742,5.567203305050206,0.15201585879464696
114,0.0492,5,196,5,4793,600817,219,107737,5.565387750565045,0.15205192547074747
115,0.0493,18,230,18,5023,600587,237,107719,5.563257252954908,0.15207975084215014
116,0.0494,6,209,6,5232,600378,243,107713,5.561321279039609,0.15211745383008682
117,0.0495,1,166,1,5398,600212,244,107712,5.559783615547075,0.1521519259129511
118,0.0496,7,170,7,5568,600042,251,107705,5.558208899922191,0.15218008695197577
119,0.0497,8,231,8,5799,599811,259,107697,5.556069139278965,0.1522201869095473
120,0.0498,11,303,11,6102,599508,270,107686,5.5532624402534365,0.15227221950412476
121,0.0499,4,70,4,6172,599438,274,107682,5.552614027937308,0.15228249802013802
122,0.05,8,346,8,6518,599092,282,107674,5.549409018489014,0.1523474530466944
123,0.0501,15,252,15,6770,598840,297,107659,5.54707473415095,0.15238379672158064
124,0.0502,11,251,11,7021,598589,308,107648,5.544749712845975,0.15242475259721594
125,0.0503,15,258,15,7279,598331,323,107633,5.542359850309385,0.15246244851012233
126,0.0504,14,273,14,7552,598058,337,107619,5.539831042276483,0.15250461613457716
127,0.0505,22,453,22,8005,597605,359,107597,5.535634888287821,0.1525761413041937
128,0.0506,9,126,9,8131,597479,368,107588,5.534467746118789,0.15259259049140012
129,0.0507,5,386,5,8517,597093,373,107583,5.530892215346993,0.15267016330909525
130,0.0508,14,392,14,8909,596701,387,107569,5.527261106376672,0.15273829639200875
131,0.0509,20,400,20,9309,596301,407,107549,5.52355589314165,0.15280102294522982
132,0.051,11,253,11,9562,596048,418,107538,5.521212345770499,0.15284272285122216
133,0.0511,11,254,11,9816,595794,429,107527,5.518859535366261,0.15288467143736645
134,0.0512,21,466,21,10282,595328,450,107506,5.51454296194746,0.152960727568672
135,0.0513,21,298,21,10580,595030,471,107485,5.511782578087369,0.15300029180871583
136,0.0514,11,254,11,10834,594776,482,107474,5.50942976768313,0.15304236383054468
137,0.0515,21,329,21,11163,594447,503,107453,5.506382229797325,0.1530887590824904
138,0.0516,16,364,16,11527,594083,519,107437,5.503010485753455,0.1531488767248261
139,0.0517,12,217,12,11744,593866,531,107425,5.501000407573456,0.15318177475541536
140,0.0518,2,104,2,11848,593762,533,107423,5.50003705213235,0.15320207933712215
141,0.0519,13,192,13,12040,593570,546,107410,5.49825854977954,0.15322833747039857
142,0.052,20,380,20,12420,593190,566,107390,5.494738597206269,0.1532872762568158
143,0.0521,10,261,10,12681,592929,576,107380,5.492320945570418,0.15333231473535253
144,0.0522,17,325,17,13006,592604,593,107363,5.489310459816963,0.1533829451959878
145,0.0523,8,269,8,13275,592335,601,107355,5.48681870391641,0.15343223427517902
146,0.0524,30,376,30,13651,591959,631,107325,5.48333580347549,0.15347841506455173
147,0.0525,23,405,23,14056,591554,654,107302,5.47958427507503,0.1535394988381011
148,0.0526,19,262,19,14318,591292,673,107283,5.477157360406092,0.15357406148230326
149,0.0527,32,448,32,14766,590844,705,107251,5.4730075215828675,0.15363381774686827
150,0.0528,16,261,16,15027,590583,721,107235,5.470589869947015,0.15367187432826324
151,0.0529,26,465,26,15492,590118,747,107209,5.466282559561303,0.15374279211904887
152,0.053,27,451,27,15943,589667,774,107182,5.462104931638816,0.15380950535912372
153,0.0531,12,317,12,16260,589350,786,107170,5.4591685501500615,0.15386492850169414
154,0.0532,21,477,21,16737,588873,807,107149,5.454750083367298,0.15394484657094173
155,0.0533,33,567,33,17304,588306,840,107116,5.449497943606654,0.15403021474730452
156,0.0534,12,236,12,17540,588070,852,107104,5.447311867797992,0.154067902424429
157,0.0535,26,438,26,17978,587632,878,107078,5.4432546593056435,0.15413337939571908
158,0.0536,20,376,20,18354,587256,898,107058,5.4397717588647225,0.15419248351610365
159,0.0537,22,322,22,18676,586934,920,107036,5.43678906221053,0.1542372148651959
160,0.0538,19,301,19,18977,586633,939,107017,5.434000889251176,0.15428097743818928
161,0.0539,10,335,10,19312,586298,949,107007,5.430897773166846,0.15434332653017072
162,0.054,19,387,19,19699,585911,968,106988,5.427312979361962,0.15440634204985143
163,0.0541,19,370,19,20069,585541,987,106969,5.423885657119567,0.1544656394853504
164,0.0542,18,371,18,20440,585170,1005,106951,5.420449071844085,0.15452644841003235
165,0.0543,18,293,18,20733,584877,1023,106933,5.417735003149431,0.15456989635882684
166,0.0544,19,308,19,21041,584569,1042,106914,5.414881988958465,0.1546155147704282
167,0.0545,26,338,26,21379,584231,1068,106888,5.411751083774871,0.15465932784368538
168,0.0546,32,490,32,21869,583741,1100,106856,5.40721219756197,0.15472989312145868
169,0.0547,36,694,36,22563,583047,1136,106820,5.400783652599207,0.1548414404515653
170,0.0548,17,399,17,22962,582648,1153,106803,5.397087702397273,0.1549102111680163
171,0.0549,17,406,17,23368,582242,1170,106786,5.393326910963726,0.1549806393934644
172,0.055,41,622,41,23990,581620,1211,106745,5.387565304383267,0.15507034785324647
173,0.0551,43,612,43,24602,581008,1254,106702,5.381896328133684,0.15515551613325385
174,0.0552,23,415,23,25017,580593,1277,106679,5.378052169402349,0.1552209314507211
175,0.0553,35,612,35,25629,579981,1312,106644,5.372383193152766,0.15531622064445658
176,0.0554,30,554,30,26183,579427,1342,106614,5.367251472822261,0.15540470613272384
177,0.0555,27,613,27,26796,578814,1369,106587,5.36157323353959,0.155510423824885
178,0.0556,34,603,34,27399,578211,1403,106553,5.355987624587795,0.15560543486515063
179,0.0557,18,385,18,27784,577826,1421,106535,5.352421356849087,0.15567076440650476
180,0.0558,26,317,26,28101,577509,1447,106509,5.349484975360332,0.15571081462768524
181,0.0559,29,637,29,28738,576872,1476,106480,5.34358442328356,0.15582013369390885
182,0.056,41,731,41,29469,576141,1517,106439,5.336813146096558,0.1559363005069003
183,0.0561,16,312,16,29781,575829,1533,106423,5.333923079773241,0.155987816818419
184,0.0562,17,430,17,30211,575399,1550,106406,5.329939975545592,0.15606515059291146
185,0.0563,37,660,37,30871,574739,1587,106369,5.323826373707807,0.15617053389477145
186,0.0564,37,693,37,31564,574046,1624,106332,5.317407091778132,0.15628371287725354
187,0.0565,26,528,26,32092,573518,1650,106306,5.312516210307903,0.15637282590788204
188,0.0566,30,554,30,32646,572964,1680,106276,5.307384489977398,0.1564631058241564
189,0.0567,28,462,28,33108,572502,1708,106248,5.303104968690948,0.15653480662983427
190,0.0568,57,850,57,33958,571652,1765,106191,5.295231390566527,0.15666017057047132
191,0.0569,28,614,28,34572,571038,1793,106163,5.289543888250769,0.15676734086334781
192,0.057,36,686,36,35258,570352,1829,106127,5.283189447552707,0.15688144051773964
193,0.0571,43,611,43,35869,569741,1872,106084,5.277529734336211,0.15696962971183367
194,0.0572,33,690,33,36559,569051,1905,106051,5.271138241505799,0.1570888547212125
195,0.0573,36,679,36,37238,568372,1941,106015,5.264848642039349,0.15720202198440955
196,0.0574,45,609,45,37847,567763,1986,105970,5.259207454889029,0.15728782767060542
197,0.0575,35,751,35,38598,567012,2021,105935,5.252250917040276,0.15741952932400322
198,0.0576,43,651,43,39249,566361,2064,105892,5.246220682500278,0.15751807727150344
199,0.0577,31,650,31,39899,565711,2095,105861,5.240199710993368,0.15763164634618476
200,0.0578,20,511,20,40410,565200,2115,105841,5.235466301085627,0.1577265770645907
201,0.0579,26,532,26,40942,564668,2141,105815,5.230538367483049,0.15781906476375987
202,0.058,35,498,35,41440,564170,2176,105780,5.225925377005447,0.1578923800283603
203,0.0581,24,505,24,41945,563665,2200,105756,5.221247545296232,0.15798130025798413
204,0.0582,32,500,32,42445,563165,2232,105724,5.216616028752455,0.1580591099569585
205,0.0583,35,631,35,43076,562534,2267,105689,5.210771054874208,0.15816426552213858
206,0.0584,23,347,23,43423,562187,2290,105666,5.207556782392826,0.15821745204408755
207,0.0585,34,477,34,43900,561710,2324,105632,5.2031383156100635,0.15828765460588423
208,0.0586,33,686,33,44586,561024,2357,105599,5.1967838749120014,0.15840887578136367
209,0.0587,29,449,29,45035,560575,2386,105570,5.192624773055689,0.1584790098251882
210,0.0588,26,536,26,45571,560039,2412,105544,5.187659787320761,0.15857376164956136
211,0.0589,18,521,18,46092,559518,2430,105526,5.182833747082144,0.15867521547446484
212,0.059,36,460,36,46552,559058,2466,105490,5.17857275186187,0.15873947404852623
213,0.0591,33,632,33,47184,558426,2499,105457,5.172718514950535,0.1588487730518781
214,0.0592,33,648,33,47832,557778,2532,105424,5.166716069509801,0.15896212616970395
215,0.0593,30,487,30,48319,557291,2562,105394,5.162204972396162,0.15904087160566482
216,0.0594,36,755,36,49074,556536,2598,105358,5.155211382415058,0.1591765448848305
217,0.0595,31,511,31,49585,556025,2629,105327,5.150477972507318,0.15926012169011358
218,0.0596,35,504,35,50089,555521,2664,105292,5.145809403831191,0.15933705904696185
219,0.0597,58,750,58,50839,554771,2722,105234,5.138862129015525,0.1594442466344952
220,0.0598,20,431,20,51270,554340,2742,105214,5.134869761754789,0.1595229503573627
221,0.0599,38,698,38,51968,553642,2780,105176,5.128404164659676,0.15964348272208714
222,0.06,57,892,57,52860,552750,2837,105119,5.120141539145578,0.15978713087255975
223,0.0601,23,398,23,53258,552352,2860,105096,5.116454851976731,0.15985446757766394
224,0.0602,26,750,26,54008,551602,2886,105070,5.109507577161065,0.16000377661907314
225,0.0603,26,541,26,54549,551061,2912,105044,5.104496276260699,0.16010242263052407
226,0.0604,24,385,24,54934,550676,2936,105020,5.10093000852199,0.1601656865376638
227,0.0605,43,563,43,55497,550113,2979,104977,5.095714920893697,0.160248210169595
228,0.0606,34,758,34,56255,549355,3013,104943,5.088693541813331,0.16039021974696546
229,0.0607,38,654,38,56909,548701,3051,104905,5.0826355181740706,0.1605018925774855
230,0.0608,27,392,27,57301,548309,3078,104878,5.079004409203749,0.1605635139707312
231,0.0609,39,718,39,58019,547591,3117,104839,5.072353551446886,0.1606900357126435
232,0.061,31,567,31,58586,547024,3148,104808,5.0671014116862425,0.16078989678322023
233,0.0611,59,873,59,59459,546151,3207,104749,5.059014783800808,0.16092948225533876
234,0.0612,44,552,44,60011,545599,3251,104705,5.053901589536478,0.16100931256766066
235,0.0613,35,543,35,60554,545056,3286,104670,5.048871762569936,0.16109867851986837
236,0.0614,40,611,40,61165,544445,3326,104630,5.04321204935344,0.1611986288179332
237,0.0615,58,827,58,61992,543618,3384,104572,5.035551520990033,0.16132923988336753
238,0.0616,32,535,32,62527,543083,3416,104540,5.030595798288192,0.1614210736802121
239,0.0617,60,814,60,63341,542269,3476,104480,5.023055689354923,0.161546442282864
240,0.0618,50,856,50,64197,541413,3526,104430,5.015126533031976,0.1616956442974531
241,0.0619,40,644,40,64841,540769,3566,104390,5.009161139723591,0.16180507440801414
242,0.062,41,627,41,65468,540142,3607,104349,5.003353217977694,0.16190916552752482
243,0.0621,20,396,20,65864,539746,3627,104329,4.999685056875023,0.16198268835151186
244,0.0622,51,772,51,66636,538974,3678,104278,4.992533995331431,0.16211065025837462
245,0.0623,36,556,36,67192,538418,3714,104242,4.987383748934751,0.1622039647714188
246,0.0624,33,411,33,67603,538007,3747,104209,4.983576642335766,0.16226472090387034
247,0.0625,39,551,39,68154,537456,3786,104170,4.978472711104524,0.16235314653707925
248,0.0626,56,620,56,68774,536836,3842,104114,4.972729630590241,0.1624370075668929
249,0.0627,31,268,31,69042,536568,3873,104083,4.970247137722776,0.16246443071188527
250,0.0628,37,517,37,69559,536051,3910,104046,4.96545814961651,0.16254723893409906
251,0.0629,34,447,34,70006,535604,3944,104012,4.961317573826373,0.16261631979187513
252,0.063,51,676,51,70682,534928,3995,103961,4.955055763459187,0.16272153691799357
253,0.0631,18,408,18,71090,534520,4013,103943,4.951276445959465,0.16280191647754058
254,0.0632,49,643,49,71733,533877,4062,103894,4.945320315684167,0.162901731185645
255,0.0633,39,571,39,72304,533306,4101,103855,4.940031123791174,0.16299647969665437
256,0.0634,41,694,41,72998,532612,4142,103814,4.9336025788284115,0.16312029992489308
257,0.0635,29,420,29,73418,532192,4171,103785,4.929712104931639,0.16318986378438213
258,0.0636,46,524,46,73942,531668,4217,103739,4.924858275593761,0.1632638608010299
259,0.0637,26,455,26,74397,531213,4243,103713,4.920643595538923,0.1633465947212746
260,0.0638,49,765,49,75162,530448,4292,103664,4.913557375226945,0.1634790068631409
261,0.0639,44,575,44,75737,529873,4336,103620,4.9082311312016005,0.163569289636981
262,0.064,40,603,40,76340,529270,4376,103580,4.902645522249806,0.16367227621079244
263,0.0641,45,750,45,77090,528520,4421,103535,4.89569824743414,0.16380694718022956
264,0.0642,38,656,38,77746,527864,4459,103497,4.889621697728704,0.16392681841292067
265,0.0643,30,470,30,78216,527394,4489,103467,4.885268072177554,0.16400918744382678
266,0.0644,35,604,35,78820,526790,4524,103432,4.879673200192671,0.16411994503524155
267,0.0645,33,606,33,79426,526184,4557,103399,4.8740598021416135,0.16423410416100817
268,0.0646,22,436,22,79862,525748,4579,103377,4.87002111971544,0.164318696602424
269,0.0647,27,521,27,80383,525227,4606,103350,4.865195079476824,0.16441899719525213
270,0.0648,26,444,26,80827,524783,4632,103324,4.86108229278595,0.16450063444604185
271,0.0649,19,343,19,81170,524440,4651,103305,4.857905072436918,0.16456522951198338
272,0.065,26,468,26,81638,523972,4677,103279,4.853569972951943,0.16465338437084995
273,0.0651,43,604,43,82242,523368,4720,103236,4.84797510096706,0.1647547733496754
274,0.0652,33,510,33,82752,522858,4753,103203,4.843250954092408,0.16484495919726672
275,0.0653,33,500,33,83252,522358,4786,103170,4.838619437548631,0.1649326648847054
276,0.0654,46,569,46,83821,521789,4832,103124,4.833348771721813,0.1650213709748397
277,0.0655,28,373,28,84194,521416,4860,103096,4.829893660380155,0.16508249641319941
278,0.0656,31,461,31,84655,520955,4891,103065,4.8256234021267925,0.1651629755456556
279,0.0657,22,365,22,85020,520590,4913,103043,4.822242395049835,0.16523019147479368
280,0.0658,25,429,25,85449,520161,4938,103018,4.818268553855274,0.16531044852281607
281,0.0659,35,355,35,85804,519806,4973,102983,4.8149801771091925,0.16535776964589932
282,0.066,23,405,23,86209,519401,4996,102960,4.811228648708733,0.1654345307626924
283,0.0661,35,485,35,86694,518916,5031,102925,4.806736077661269,0.16551658703752245
284,0.0662,27,548,27,87242,518368,5058,102898,4.8016599355292895,0.16562631787350346
285,0.0663,25,330,25,87572,518038,5083,102873,4.798603134610397,0.16568074973707986
286,0.0664,33,435,33,88007,517603,5116,102840,4.794573715217311,0.16575253488233407
287,0.0665,25,345,25,88352,517258,5141,102815,4.791377968802105,0.16581112223883318
288,0.0666,18,392,18,88744,516866,5159,102797,4.787746859831783,0.16589178311437022
289,0.0667,28,340,28,89084,516526,5187,102769,4.784597428582015,0.16594514730459636
290,0.0668,28,331,28,89415,516195,5215,102741,4.781531364630035,0.1659961611539804
291,0.0669,20,264,20,89679,515931,5235,102721,4.77908592389492,0.16604003543187446
292,0.067,32,417,32,90096,515514,5267,102689,4.77522323909741,0.166108867152052
293,0.0671,26,375,26,90471,515139,5293,102663,4.771749601689577,0.16617459962900735
294,0.0672,25,313,25,90784,514826,5318,102638,4.7688502723331725,0.1662250754699869
295,0.0673,22,288,22,91072,514538,5340,102616,4.766182518803957,0.1662729237759133
296,0.0674,16,267,16,91339,514271,5356,102600,4.76370928896958,0.16632326693911692
297,0.0675,32,355,32,91694,513916,5388,102568,4.760420912223498,0.16637576968745335
298,0.0676,22,366,22,92060,513550,5410,102546,4.757030642113453,0.1664448397652314
299,0.0677,10,161,10,92221,513389,5420,102536,4.755539293786358,0.16647481430368957
300,0.0678,41,565,41,92786,512824,5461,102495,4.7503056800918895,0.16657213575397475
301,0.0679,16,241,16,93027,512583,5477,102479,4.748073289117789,0.16661572329293634
302,0.068,19,259,19,93286,512324,5496,102460,4.745674163548112,0.16666016031646888
303,0.0681,29,466,29,93752,511858,5525,102431,4.741357590129312,0.16674724763100104
304,0.0682,22,280,22,94032,511578,5547,102409,4.738763940864796,0.16679343373719638
305,0.0683,38,519,38,94551,511059,5585,102371,4.733956426692356,0.16688293692841888
306,0.0684,20,363,20,94914,510696,5605,102351,4.730593945681574,0.16695457281415618
307,0.0685,36,509,36,95423,510187,5641,102315,4.725879061840009,0.1670443525082367
308,0.0686,21,311,21,95734,509876,5662,102294,4.722998258549779,0.16710064197853539
309,0.0687,28,422,28,96156,509454,5690,102266,4.719089258586831,0.16717779376185182
310,0.0688,23,313,23,96469,509141,5713,102243,4.716189929230427,0.16723205056069507
311,0.0689,23,386,23,96855,508755,5736,102220,4.712614398458632,0.16730635459716028
312,0.069,25,401,25,97256,508354,5761,102195,4.708899922190522,0.16738214295658496
313,0.0691,22,241,22,97497,508113,5783,102173,4.7066675312164215,0.167418226864126
314,0.0692,36,471,36,97968,507642,5819,102137,4.702304642632184,0.16749838876051815
315,0.0693,16,344,16,98312,507298,5835,102121,4.699118159250065,0.1675710799958649
316,0.0694,22,240,22,98552,507058,5857,102099,4.696895031309052,0.16760703726625484
317,0.0695,32,389,32,98941,506669,5889,102067,4.693291711437993,0.16767038584870947
318,0.0696,25,293,25,99234,506376,5914,102042,4.69057764274334,0.1677169314517322
319,0.0697,20,222,20,99456,506154,5934,102022,4.688521249397903,0.167750782668175
320,0.0698,8,185,8,99641,505969,5942,102014,4.6868075882767055,0.16779087573172277
321,0.0699,30,413,30,100054,505556,5972,101984,4.682981955611545,0.1678638443559272
322,0.07,18,174,18,100228,505382,5990,101966,4.681370187854311,0.1678872738528817
323,0.0701,25,297,25,100525,505085,6015,101941,4.678619067027308,0.16793514610576812
324,0.0702,21,317,21,100842,504768,6036,101920,4.675682685538553,0.16799409251542802
325,0.0703,25,339,25,101181,504429,6061,101895,4.6725425173218715,0.16805371385595821
326,0.0704,24,231,24,101412,504198,6085,101871,4.670402756678647,0.16808482202521496
327,0.0705,28,193,28,101605,504005,6113,101843,4.668614991292749,0.16809991945174368
328,0.0706,20,271,20,101876,503734,6133,101823,4.666104709326022,0.16814767230830457
329,0.0707,18,312,18,102188,503422,6151,101805,4.663214643002704,0.16820961391345726
330,0.0708,21,180,21,102368,503242,6172,101784,4.661547297046945,0.16823078677610548
331,0.0709,24,380,24,102748,502862,6196,101760,4.658027344473674,0.1683035020227514
332,0.071,19,275,19,103023,502587,6215,101741,4.655480010374597,0.16835394024437061
333,0.0711,16,236,16,103259,502351,6231,101725,4.6532939345659345,0.16839768505949582
334,0.0712,19,310,19,103569,502041,6250,101706,4.650422394308793,0.16845797991542816
335,0.0713,22,322,22,103891,501719,6272,101684,4.6474396976546,0.16851755791734546
336,0.0714,18,224,18,104115,501495,6290,101666,4.645364778242988,0.16855532768199535
337,0.0715,18,215,18,104330,501280,6308,101648,4.643373226129164,0.16859061115091686
338,0.0716,21,198,21,104528,501082,6329,101627,4.641539145577828,0.16861702745437682
339,0.0717,17,247,17,104775,500835,6346,101610,4.639251176405202,0.16866269949953938
340,0.0718,22,230,22,105005,500605,6368,101588,4.637120678795065,0.1686967467240569
341,0.0719,22,219,22,105224,500386,6390,101566,4.63509207454889,0.168727739088831
342,0.072,15,173,15,105397,500213,6405,101551,4.633489569824744,0.1687555254219262
343,0.0721,19,253,19,105650,499960,6424,101532,4.631146022453592,0.16880025004488838
344,0.0722,15,180,15,105830,499780,6439,101517,4.629478676497833,0.16883004571783994
345,0.0723,25,211,25,106041,499569,6464,101492,4.627524176516358,0.1688547418648024
346,0.0724,7,224,7,106265,499345,6471,101485,4.625449257104746,0.16890801058535693
347,0.0725,10,174,10,106439,499171,6481,101475,4.623837489347512,0.16894310459072398
348,0.0726,15,186,15,106625,498985,6496,101460,4.622114565193227,0.16897467711447342
349,0.0727,26,279,26,106904,498706,6522,101434,4.619530178961799,0.16901722931316027
350,0.0728,21,272,21,107176,498434,6543,101413,4.617010633961985,0.16906477818510388
351,0.0729,15,242,15,107418,498192,6558,101398,4.614768979954796,0.16911222668823697
352,0.073,12,211,12,107629,497981,6570,101386,4.612814479973323,0.16915512532388335
353,0.0731,28,318,28,107947,497663,6598,101358,4.60986883545148,0.16920608793347813
354,0.0732,16,233,16,108180,497430,6614,101342,4.60771054874208,0.16924973111635147
355,0.0733,21,293,21,108473,497137,6635,101321,4.604996480047427,0.16930344318231189
356,0.0734,21,292,21,108765,496845,6656,101300,4.602291674385861,0.16935692850395806
357,0.0735,23,261,23,109026,496584,6679,101277,4.59987402275001,0.16939890710382513
358,0.0736,23,291,23,109317,496293,6702,101254,4.597178480121531,0.16944943242958294
359,0.0737,12,173,12,109490,496120,6714,101242,4.595575975397384,0.16948182174292975
360,0.0738,26,299,26,109789,495821,6740,101216,4.592806328504206,0.16953053160859377
361,0.0739,7,137,7,109926,495684,6747,101209,4.591537292971211,0.16955970333041265
362,0.074,11,126,11,110052,495558,6758,101198,4.590370150802179,0.16958019693140916
363,0.0741,18,233,18,110285,495325,6776,101180,4.588211864092779,0.16962137785936413
364,0.0742,18,218,18,110503,495107,6794,101162,4.586192522879692,0.16965832535315437
365,0.0743,11,201,11,110704,494906,6805,101151,4.5843306532290935,0.16970021323464032
366,0.0744,15,123,15,110827,494783,6820,101136,4.583191300159324,0.16971434037176195
367,0.0745,14,145,14,110972,494638,6834,101122,4.581848160361629,0.1697361353565194
368,0.0746,14,154,14,111126,494484,6848,101108,4.5804216532661455,0.1697605071928434
369,0.0747,12,225,12,111351,494259,6860,101096,4.578337470821446,0.16980792972260247
370,0.0748,12,201,12,111552,494058,6872,101084,4.576475601170848,0.16984854034835384
371,0.0749,12,169,12,111721,493889,6884,101072,4.57491014857905,0.16988004255741132
372,0.075,4,113,4,111834,493776,6888,101068,4.573863425840157,0.1699067318490226
373,0.0751,12,165,12,111999,493611,6900,101056,4.572335025380711,0.16993712447470602
374,0.0752,13,121,13,112120,493490,6913,101043,4.571214198377117,0.16995356018925778
375,0.0753,13,235,13,112355,493255,6926,101030,4.569037385601542,0.17000260817621174
376,0.0754,8,145,8,112500,493110,6934,101022,4.567694245803846,0.17003292197693443
377,0.0755,12,239,12,112739,492871,6946,101010,4.56548038089592,0.17008457923388692
378,0.0756,8,202,8,112941,492669,6954,101002,4.563609248212234,0.17013126799186756
379,0.0757,13,157,13,113098,492512,6967,100989,4.562154952017488,0.17015809577405935
380,0.0758,22,208,22,113306,492304,6989,100967,4.5602282411352775,0.17018698031759516
381,0.0759,10,114,10,113420,492190,6999,100957,4.559172255363296,0.1702056994303267
382,0.076,25,286,25,113706,491904,7024,100932,4.556523027900256,0.17025281865473757
383,0.0761,15,289,15,113995,491615,7039,100917,4.553846011337953,0.1703148521936368
384,0.0762,9,174,9,114169,491441,7048,100908,4.552234243580718,0.17035227543221987
385,0.0763,4,102,4,114271,491339,7052,100904,4.551289414205788,0.1703760111981062
386,0.0764,21,165,21,114436,491174,7073,100883,4.549761013746341,0.17039406678748836
387,0.0765,21,144,21,114580,491030,7094,100862,4.548427136981734,0.17040608759706163
388,0.0766,16,195,16,114775,490835,7110,100846,4.54662084552966,0.17043981469744676
389,0.0767,6,104,6,114879,490731,7116,100840,4.545657490088555,0.1704613647389747
390,0.0768,14,145,14,115024,490586,7130,100826,4.544314350290859,0.17048352079430246
391,0.0769,7,143,7,115167,490443,7137,100819,4.542989736559339,0.17051493246648694
392,0.077,12,152,12,115319,490291,7149,100807,4.54158175553003,0.17054194059191538
393,0.0771,10,78,10,115397,490213,7159,100797,4.540859238949202,0.17055041369858379
394,0.0772,13,144,13,115541,490069,7172,100784,4.539525362184594,0.17057372984481758
395,0.0773,16,136,16,115677,489933,7188,100768,4.538265589684686,0.17059053565170873
396,0.0774,5,104,5,115781,489829,7193,100763,4.5373022342435805,0.170613553857824
397,0.0775,6,87,6,115868,489742,7199,100757,4.536496350364963,0.17063026355675454
398,0.0776,18,192,18,116060,489550,7217,100739,4.5347178480121535,0.17066047309029983
399,0.0777,7,112,7,116172,489438,7224,100732,4.5336803883063475,0.17068302353559145
400,0.0778,4,90,4,116262,489348,7228,100728,4.532846715328467,0.17070343481178696
401,0.0779,10,207,10,116469,489141,7238,100718,4.530929267479343,0.17074928076031728
402,0.078,12,98,12,116567,489043,7250,100706,4.530021490236763,0.17076078128152825
403,0.0781,15,178,15,116745,488865,7265,100691,4.528372670347179,0.17079123950905428
404,0.0782,11,108,11,116853,488757,7276,100680,4.5273722627737225,0.17080705826067927
405,0.0783,14,167,14,117020,488590,7290,100666,4.525825336248101,0.1708357657792199
406,0.0784,14,218,14,117238,488372,7304,100652,4.523805995035015,0.1708792850545988
407,0.0785,11,134,11,117372,488238,7315,100641,4.522564748601282,0.17090268119596724
408,0.0786,25,201,25,117573,488037,7340,100616,4.520702878950684,0.17092582557126185
409,0.0787,12,163,12,117736,487874,7352,100604,4.519193004557413,0.1709562634457023
410,0.0788,12,185,12,117921,487689,7364,100592,4.517479343436214,0.17099311383505503
411,0.0789,10,136,10,118057,487553,7374,100582,4.5162195709363075,0.17101855866425225
412,0.079,14,201,14,118258,487352,7388,100568,4.514357701285709,0.17105728670567424
413,0.0791,21,113,21,118371,487239,7409,100547,4.513310978546816,0.17106055605271306
414,0.0792,24,255,24,118626,486984,7433,100523,4.510948905109489,0.1711009400739055
415,0.0793,11,145,11,118771,486839,7444,100512,4.509605765311794,0.17112765620557385
416,0.0794,35,223,35,118994,486616,7479,100477,4.507540108933269,0.1711432430637054
417,0.0795,23,215,23,119209,486401,7502,100454,4.505548556819445,0.17117345852041815
418,0.0796,22,138,22,119347,486263,7524,100432,4.504270258253363,0.1711826417474156
419,0.0797,27,210,27,119557,486053,7551,100405,4.502325021304976,0.17120578114715804
420,0.0798,21,110,21,119667,485943,7572,100384,4.501306087665345,0.17120821657539223
421,0.0799,14,117,14,119784,485826,7586,100370,4.500222312794102,0.17122259449057994
422,0.08,16,176,16,119960,485650,7602,100354,4.498592018970692,0.1712513907754896
423,0.0801,15,173,15,120133,485477,7617,100339,4.496989514246545,0.17128074344162672
424,0.0802,22,241,22,120374,485236,7639,100317,4.494757123272445,0.17132010253555185
425,0.0803,17,173,17,120547,485063,7656,100300,4.493154618548298,0.171346668648343
426,0.0804,8,176,8,120723,484887,7664,100292,4.491524324724888,0.1713868747853221
427,0.0805,16,180,16,120903,484707,7680,100276,4.4898569787691285,0.1714169471591482
428,0.0806,18,158,18,121061,484549,7698,100258,4.4883934195412944,0.17143775638800493
429,0.0807,8,141,8,121202,484408,7706,100250,4.48708733187595,0.17146776406035666
430,0.0808,12,187,12,121389,484221,7718,100238,4.485355144688577,0.17150561459400915
431,0.0809,18,157,18,121546,484064,7736,100220,4.483900848493831,0.17152617562692116
432,0.081,24,228,24,121774,483836,7760,100196,4.481788876949868,0.1715590926524574
433,0.0811,25,240,25,122014,483596,7785,100171,4.479565749008856,0.17159414629466893
434,0.0812,10,168,10,122182,483428,7795,100161,4.478009559450147,0.1716293487368679
435,0.0813,20,162,20,122344,483266,7815,100141,4.476508948089963,0.17164860894709869
436,0.0814,6,107,6,122451,483159,7821,100135,4.475517803549594,0.1716715755690955
437,0.0815,10,166,10,122617,482993,7831,100125,4.47398014005706,0.17170624127535078
438,0.0816,16,125,16,122742,482868,7847,100109,4.472822260921116,0.17172032515862548
439,0.0817,14,206,14,122948,482662,7861,100095,4.47091407610508,0.17176112856645223
440,0.0818,18,200,18,123148,482462,7879,100077,4.469061469487569,0.17179450646222827
441,0.0819,12,137,12,123285,482325,7891,100065,4.467792433954574,0.17181785401535055
442,0.082,17,182,17,123467,482143,7908,100048,4.466106561932639,0.17184738341884365
443,0.0821,15,185,15,123652,481958,7923,100033,4.464392900811442,0.1718806648212773
444,0.0822,13,157,13,123809,481801,7936,100020,4.462938604616696,0.17190854231799815
445,0.0823,19,199,19,124008,481602,7955,100001,4.4610952610322725,0.1719403097989522
446,0.0824,29,275,29,124283,481327,7984,99972,4.458547926933195,0.17198034058204126
447,0.0825,20,147,20,124430,481180,8004,99952,4.4571862610693245,0.17199534701238273
448,0.0826,14,114,14,124544,481066,8018,99938,4.456130275297343,0.17200914279419763
449,0.0827,12,119,12,124663,480947,8030,99926,4.455027974359925,0.17202727618601657
450,0.0828,12,165,12,124828,480782,8042,99914,4.453499573900478,0.17205904638571645
451,0.0829,22,234,22,125062,480548,8064,99892,4.45133202415799,0.17209702983943215
452,0.083,23,223,23,125285,480325,8087,99869,4.449266367779465,0.17213035639803237
453,0.0831,8,113,8,125398,480212,8095,99861,4.448219645040572,0.17215247046492424
454,0.0832,9,160,9,125558,480052,8104,99852,4.4467375597465635,0.17218712062686237
455,0.0833,19,172,19,125730,479880,8123,99833,4.445144318055504,0.17221107686044645
456,0.0834,18,171,18,125901,479709,8141,99815,4.443560339397532,0.17223618003741
457,0.0835,11,157,11,126058,479552,8152,99804,4.442106043202786,0.1722671379946009
458,0.0836,20,172,20,126230,479380,8172,99784,4.440512801511727,0.172289714139691
459,0.0837,10,136,10,126366,479244,8182,99774,4.4392530290118195,0.17231588655274965
460,0.0838,9,140,9,126506,479104,8191,99765,4.437956204379562,0.17234469284069454
461,0.0839,9,132,9,126638,478972,8200,99756,4.436733484012005,0.17237113117042893
462,0.084,13,143,13,126781,478829,8213,99743,4.435408870280485,0.17239513837517198
463,0.0841,16,176,16,126957,478653,8229,99727,4.433778576457075,0.17242470348213976
464,0.0842,15,181,15,127138,478472,8244,99712,4.432101967468228,0.17245721085329238
465,0.0843,27,244,27,127382,478228,8271,99685,4.429841787394865,0.17249136115643704
466,0.0844,22,292,22,127674,477936,8293,99663,4.427136981733299,0.17254704388338624
467,0.0845,16,156,16,127830,477780,8309,99647,4.42569194857164,0.17257073188472308
468,0.0846,22,112,22,127942,477668,8331,99625,4.424654488865834,0.17257267973108975
469,0.0847,27,252,27,128194,477416,8358,99598,4.422320204527771,0.1726093301029091
470,0.0848,12,158,12,128352,477258,8370,99586,4.420856645299937,0.1726393964399387
471,0.0849,14,256,14,128608,477002,8384,99572,4.418485308829523,0.17269595923506784
472,0.085,16,182,16,128790,476820,8400,99556,4.4167994368075885,0.1727275250877899
473,0.0851,26,252,26,129042,476568,8426,99530,4.414465152469525,0.17276574471704467
474,0.0852,31,238,31,129280,476330,8457,99499,4.412260550594687,0.17279261725269135
475,0.0853,21,211,21,129491,476119,8478,99478,4.410306050613213,0.1728257791475633
476,0.0854,13,152,13,129643,475967,8491,99465,4.408898069583905,0.17285274367779338
477,0.0855,20,167,20,129810,475800,8511,99445,4.407351143058283,0.17287416665942337
478,0.0856,28,249,28,130059,475551,8539,99417,4.405044647819482,0.1729087531827858
479,0.0857,25,270,25,130329,475281,8564,99392,4.402543628885843,0.17295401036763516
480,0.0858,11,111,11,130440,475170,8575,99381,4.401515432213124,0.17297158998940043
481,0.0859,20,221,20,130661,474949,8595,99361,4.399468301900774,0.17300935035085582
482,0.086,20,157,20,130818,474792,8615,99341,4.398014005706028,0.17302785243140525
483,0.0861,15,154,15,130972,474638,8630,99326,4.396587498610545,0.1730526653239576
484,0.0862,23,182,23,131154,474456,8653,99303,4.39490162658861,0.1730744092903118
485,0.0863,15,182,15,131336,474274,8668,99288,4.3932157545666755,0.1731077023931153
486,0.0864,3,87,3,131423,474187,8671,99285,4.392409870688058,0.173129638413035
487,0.0865,27,251,27,131674,473936,8698,99258,4.390084849383082,0.1731665020917874
488,0.0866,13,173,13,131847,473763,8711,99245,4.388482344658935,0.1732000251305392
489,0.0867,11,119,11,131966,473644,8722,99234,4.3873800437215165,0.17322012714749038
490,0.0868,9,139,9,132105,473505,8731,99225,4.386092482122346,0.17324917500392856
491,0.0869,12,168,12,132273,473337,8743,99213,4.384536292563637,0.1732826827351323
492,0.087,25,213,25,132486,473124,8768,99188,4.382563266515988,0.17331106109954011
493,0.0871,26,150,26,132636,472974,8794,99162,4.381173811552855,0.17331893116321995
494,0.0872,28,247,28,132883,472727,8822,99134,4.378885842380229,0.17335331487896535
495,0.0873,22,219,22,133102,472508,8844,99112,4.376857238134055,0.17338791504845877
496,0.0874,23,203,23,133305,472305,8867,99089,4.374976842417281,0.1734162416826218
497,0.0875,23,244,23,133549,472061,8890,99066,4.372716662343918,0.17345704195389117
498,0.0876,16,138,16,133687,471923,8906,99050,4.371438363777836,0.17347580358440767
499,0.0877,22,199,22,133886,471724,8928,99028,4.369595020193412,0.17350442924422516
500,0.0878,26,292,26,134178,471432,8954,99002,4.366890214531846,0.17355557347563433
501,0.0879,18,187,18,134365,471245,8972,98984,4.3651580273444734,0.17358640125283
502,0.088,19,252,19,134617,470993,8991,98965,4.36282374300641,0.173635601219739
503,0.0881,22,204,22,134821,470789,9013,98943,4.360934084256549,0.17366586395006775
504,0.0882,38,284,38,135105,470505,9051,98905,4.358303382859684,0.17369733583885075
505,0.0883,24,289,24,135394,470216,9075,98881,4.35562636629738,0.1737506962784903
506,0.0884,33,244,33,135638,469972,9108,98848,4.353366186224017,0.1737772933441159
507,0.0885,24,221,24,135859,469751,9132,98824,4.3513190559116675,0.17380996350525435
508,0.0886,33,307,33,136166,469444,9165,98791,4.348475304753789,0.17385588708896849
509,0.0887,16,195,16,136361,469249,9181,98775,4.346669013301716,0.17389230032533837
510,0.0888,35,267,35,136628,468982,9216,98740,4.344195783467338,0.17392315252887858
511,0.0889,29,199,29,136827,468783,9245,98711,4.342352439882915,0.17394192713931778
512,0.089,27,266,27,137093,468517,9272,98684,4.339888473081626,0.17398417844820444
513,0.0891,31,282,31,137375,468235,9303,98653,4.337276297750935,0.1740255570765301
514,0.0892,15,178,15,137553,468057,9318,98638,4.335627477861351,0.17405835590573412
515,0.0893,22,190,22,137743,467867,9340,98616,4.333867501574716,0.17408465920424795
516,0.0894,27,231,27,137974,467636,9367,98589,4.33172774093149,0.1741162965252329
517,0.0895,20,238,20,138212,467398,9387,98569,4.329523139056652,0.17416033090268515
518,0.0896,28,231,28,138443,467167,9415,98541,4.327383378413428,0.17419057181443431
519,0.0897,29,239,29,138682,466928,9444,98512,4.325169513505502,0.17422184493491794
520,0.0898,36,348,36,139030,466580,9480,98476,4.321945977991033,0.1742765318835655
521,0.0899,18,143,18,139173,466437,9498,98458,4.320621364259513,0.1742943378858018
522,0.09,25,187,25,139360,466250,9523,98433,4.3188891770721405,0.17431550090935977
523,0.0901,19,211,19,139571,466039,9542,98414,4.316934677090667,0.17435286906084296
524,0.0902,18,175,18,139746,465864,9560,98396,4.3153136463003445,0.17438060468578315
525,0.0903,23,211,23,139957,465653,9583,98373,4.313359146318871,0.1744121724885023
526,0.0904,39,291,39,140248,465362,9622,98334,4.310663603690393,0.17444509097101984
527,0.0905,38,303,38,140551,465059,9660,98296,4.307856904664863,0.17448322993494333
528,0.0906,26,274,26,140825,464785,9686,98270,4.305318833598873,0.17453001926987594
529,0.0907,20,274,20,141099,464511,9706,98250,4.302780762532883,0.17458565892092737
530,0.0908,23,193,23,141292,464318,9729,98227,4.300992997146986,0.17461180883307112
531,0.0909,15,244,15,141536,464074,9744,98212,4.298732817073622,0.17466556165367803
532,0.091,48,340,48,141876,463734,9792,98164,4.295583385823854,0.17470074639881258
533,0.0911,16,167,16,142043,463567,9808,98148,4.2940364592982325,0.17472917760786164
534,0.0912,40,382,40,142425,463185,9848,98108,4.290497980658787,0.17478928117756679
535,0.0913,24,223,24,142648,462962,9872,98084,4.288432324280262,0.17482345476128516
536,0.0914,18,213,18,142861,462749,9890,98066,4.2864592982326135,0.17486336849050044
537,0.0915,39,311,39,143172,462438,9929,98027,4.283578494942384,0.17490298234501708
538,0.0916,37,351,37,143523,462087,9966,97990,4.280327170328652,0.1749580861203013
539,0.0917,13,199,13,143722,461888,9979,97977,4.278483826744229,0.17500111634054638
540,0.0918,43,271,43,143993,461617,10022,97934,4.275973544777502,0.17502247337597465
541,0.0919,20,279,20,144272,461338,10042,97914,4.273389158546074,0.17508028581033236
542,0.092,35,347,35,144619,460991,10077,97879,4.270174886064693,0.1751373306851325
543,0.0921,30,234,30,144853,460757,10107,97849,4.2680073363222055,0.17516639635091638
544,0.0922,27,263,27,145116,460494,10134,97822,4.265571158620179,0.17520902141439615
545,0.0923,29,378,29,145494,460116,10163,97793,4.262069732113083,0.17528485828334012
546,0.0924,33,267,33,145761,459849,10196,97760,4.259596502278706,0.17531998228149115
547,0.0925,34,285,34,146046,459564,10230,97726,4.256956537848753,0.17535932817743005
548,0.0926,25,274,25,146320,459290,10255,97701,4.254418466782763,0.17540857931277165
549,0.0927,43,365,43,146685,458925,10298,97658,4.251037459705806,0.17545990445270518
550,0.0928,37,400,37,147085,458525,10335,97621,4.247332246470784,0.17553124539239695
551,0.0929,27,240,27,147325,458285,10362,97594,4.245109118529771,0.17556698490139042
552,0.093,22,328,22,147653,457957,10384,97572,4.242070843677054,0.17563799549618472
553,0.0931,22,250,22,147903,457707,10406,97550,4.239755085405165,0.17568441280344058
554,0.0932,46,325,46,148228,457382,10452,97504,4.23674459965171,0.17571897651049045
555,0.0933,29,250,29,148478,457132,10481,97475,4.234428841379821,0.1757550842308157
556,0.0934,31,334,31,148812,456798,10512,97444,4.2313349883285785,0.17581489674185644
557,0.0935,29,304,29,149116,456494,10541,97415,4.228519026269962,0.17586823828462797
558,0.0936,19,214,19,149330,456280,10560,97396,4.2265367371892255,0.17590793171457675
559,0.0937,33,402,33,149732,455878,10593,97363,4.222812997888028,0.175986595353562
560,0.0938,28,268,28,150000,455610,10621,97335,4.220330505020564,0.17603016574885386
561,0.0939,30,190,30,150190,455420,10651,97305,4.218570528733928,0.17604595413632457
562,0.094,27,284,27,150474,455136,10678,97278,4.215939827337063,0.17609618872801922
563,0.0941,27,189,27,150663,454947,10705,97251,4.214189114083515,0.17611617571957885
564,0.0942,43,359,43,151022,454588,10748,97208,4.210863685205084,0.1761665543063016
565,0.0943,29,232,29,151254,454356,10777,97179,4.208714661528771,0.1761973401506704
566,0.0944,25,275,25,151529,454081,10802,97154,4.206167327429694,0.17624787976090053
567,0.0945,52,344,52,151873,453737,10854,97102,4.202980844047575,0.1762801835018944
568,0.0946,35,371,35,152244,453366,10889,97067,4.199544258772092,0.1763466216596752
569,0.0947,17,211,17,152455,453155,10906,97050,4.197589758790619,0.1763888005379813
570,0.0948,36,346,36,152801,452809,10942,97014,4.1943847493423245,0.1764458743995795
571,0.0949,33,323,33,153124,452486,10975,96981,4.191392789655045,0.17650013558594055
572,0.095,25,281,25,153405,452205,11000,96956,4.188789877357442,0.17655295987879693
573,0.0951,19,277,19,153682,451928,11019,96937,4.186224017192189,0.17661355706776713
574,0.0952,38,322,38,154004,451606,11057,96899,4.183241320537997,0.17666019452876455
575,0.0953,40,403,40,154407,451203,11097,96859,4.1795083182037125,0.17673000499943436
576,0.0954,37,309,37,154716,450894,11134,96822,4.176646040979659,0.17677409460377275
577,0.0955,38,311,38,155027,450583,11172,96784,4.173765237689429,0.17681738212204973
578,0.0956,35,319,35,155346,450264,11207,96749,4.1708103301345,0.1768678258103555
579,0.0957,45,369,45,155715,449895,11252,96704,4.167392270925192,0.17691946015268964
580,0.0958,38,325,38,156040,449570,11290,96666,4.164381785171737,0.17696746461236534
581,0.0959,36,365,36,156405,449205,11326,96630,4.161000778094779,0.17703152051444118
582,0.096,39,343,39,156748,448862,11365,96591,4.157823557745748,0.17708400173800493
583,0.0961,33,273,33,157021,448589,11398,96558,4.155294749712846,0.17712286777694825
584,0.0962,35,349,35,157370,448240,11433,96523,4.152061951165289,0.1771834724458159
585,0.0963,26,256,26,157626,447984,11459,96497,4.149690614694876,0.17722748819518036
586,0.0964,27,326,27,157952,447658,11486,96470,4.146670865908333,0.17729284286050342
587,0.0965,33,285,33,158237,447373,11519,96437,4.14403090147838,0.17733583420680016
588,0.0966,27,273,27,158510,447100,11546,96410,4.141502093445478,0.1773840407720189
589,0.0967,40,358,40,158868,446742,11586,96370,4.138185927600134,0.17744038062130832
590,0.0968,42,312,42,159180,446430,11628,96328,4.135295861276816,0.17747872900998235
591,0.0969,37,381,37,159561,446049,11665,96291,4.131766645670458,0.1775472950547627
592,0.097,46,314,46,159875,445735,11711,96245,4.1288580532809664,0.17758035351858
593,0.0971,27,320,27,160195,445415,11738,96218,4.1258938826929485,0.1776442720439855
594,0.0972,38,290,38,160485,445125,11776,96180,4.123207603097558,0.1776817136364896
595,0.0973,44,318,44,160803,444807,11820,96136,4.120261958575716,0.1777192791107381
596,0.0974,34,394,34,161197,444413,11854,96102,4.116612323539219,0.17779710091301815
597,0.0975,20,229,20,161426,444184,11874,96082,4.11449108896217,0.1778420259649876
598,0.0976,48,425,48,161851,443759,11922,96034,4.11055429989996,0.1779089391674216
599,0.0977,40,333,40,162184,443426,11962,95994,4.107469709881804,0.1779578065329428
600,0.0978,35,333,35,162517,443093,11997,95959,4.1043851198636485,0.17801436596098336
601,0.0979,30,288,30,162805,442805,12027,95929,4.101717366334433,0.17806375688187492
602,0.098,22,255,22,163060,442550,12049,95907,4.099355292897107,0.17811450125079625
603,0.0981,38,267,38,163327,442283,12087,95869,4.096882063062729,0.178144836403098
604,0.0982,37,437,37,163764,441846,12124,95832,4.092834117603468,0.1782330688627766
605,0.0983,42,354,42,164118,441492,12166,95790,4.0895550038904736,0.1782862630797235
606,0.0984,48,476,48,164594,441016,12214,95742,4.085145800140798,0.17837088594860254
607,0.0985,36,306,36,164900,440710,12250,95706,4.082311312016007,0.17841749686810238
608,0.0986,35,364,35,165264,440346,12285,95671,4.078939567972137,0.17848501073659978
609,0.0987,37,446,37,165710,439900,12322,95634,4.074808255215087,0.17857689707843014
610,0.0988,37,481,37,166191,439419,12359,95597,4.070352736299974,0.17868063758840858
611,0.0989,26,287,26,166478,439132,12385,95571,4.067694245803846,0.1787366070510171
612,0.099,42,406,42,166884,438726,12427,95529,4.063933454370299,0.17880787264508521
613,0.0991,39,371,39,167255,438355,12466,95490,4.060496869094816,0.17887214453633546
614,0.0992,32,391,32,167646,437964,12498,95458,4.056875023157582,0.17895399889768326
615,0.0993,32,314,32,167960,437650,12530,95426,4.0539664307680905,0.1790101223840503
616,0.0994,44,351,44,168311,437299,12574,95382,4.050715106154359,0.17906026308428497
617,0.0995,29,341,29,168652,436958,12603,95353,4.047556411871503,0.17913024528893823
618,0.0996,37,348,37,169000,436610,12640,95316,4.044332876357035,0.179190338505732
619,0.0997,27,349,27,169349,436261,12667,95289,4.041100077809478,0.17926629667952215
620,0.0998,30,274,30,169623,435987,12697,95259,4.038562006743488,0.17931240894049086
621,0.0999,32,217,32,169840,435770,12729,95227,4.0365519285634885,0.17933622977154295
622,0.1,43,383,43,170223,435387,12772,95184,4.033004186890955,0.17939917560514992
623,0.1001,44,328,44,170551,435059,12816,95140,4.029965912038238,0.17944205854782827
624,0.1002,28,322,28,170873,434737,12844,95112,4.026983215384045,0.17950774654665763
625,0.1003,61,435,61,171308,434302,12905,95051,4.02295379599096,0.1795607090164786
626,0.1004,32,390,32,171698,433912,12937,95019,4.019341213086813,0.17964346956408303
627,0.1005,24,268,24,171966,433644,12961,94995,4.016858720219348,0.1796972981562087
628,0.1006,32,314,32,172280,433330,12993,94963,4.013950127829856,0.1797544165832218
629,0.1007,58,340,58,172620,432990,13051,94905,4.010800696580088,0.17978006990026427
630,0.1008,26,238,26,172858,432752,13077,94879,4.008596094705251,0.1798207459379756
631,0.1009,23,268,23,173126,432484,13100,94856,4.006113601837786,0.179876360602268
632,0.101,34,404,34,173530,432080,13134,94822,4.002371336470413,0.17996135903830313
633,0.1011,47,402,47,173932,431678,13181,94775,3.9986475971692172,0.18002556733459588
634,0.1012,41,357,41,174289,431321,13222,94734,3.99534069435696,0.18008383153852733
635,0.1013,42,308,42,174597,431013,13264,94692,3.9924876801659934,0.18012383370901933
636,0.1014,46,494,46,175091,430519,13310,94646,3.9879117418207417,0.18022145420962934
637,0.1015,32,283,32,175374,430236,13342,94614,3.985290303456964,0.18026864818519578
638,0.1016,41,311,41,175685,429925,13383,94573,3.982409500166735,0.1803114597195795
639,0.1017,28,348,28,176033,429577,13411,94545,3.979185964652266,0.18038739072200746
640,0.1018,30,300,30,176333,429277,13441,94515,3.9764070547259993,0.1804437639368299
641,0.1019,52,396,52,176729,428881,13493,94463,3.972738893623328,0.18049886881286495
642,0.102,40,432,40,177161,428449,13533,94423,3.968737263329505,0.18058530577273213
643,0.1021,35,414,35,177575,428035,13568,94388,3.9649023676312574,0.18067351552286173
644,0.1022,34,325,34,177900,427710,13602,94354,3.961891881877802,0.1807326304820865
645,0.1023,54,436,54,178336,427274,13656,94300,3.9578531994516286,0.18079888951519824
646,0.1024,45,312,45,178648,426962,13701,94255,3.9549631331283117,0.18083638868264082
647,0.1025,44,485,44,179133,426477,13745,94211,3.950470562080848,0.18093560827213226
648,0.1026,49,472,49,179605,426005,13794,94162,3.9460984104635224,0.18102263311590316
649,0.1027,35,379,35,179984,425626,13829,94127,3.9425877209233393,0.18109948379326335
650,0.1028,35,314,35,180298,425312,13864,94092,3.939679128533847,0.1811537839523762
651,0.1029,39,347,39,180645,424965,13903,94053,3.9364648560524658,0.1812133683224859
652,0.103,53,366,53,181011,424599,13956,94000,3.9330745859424208,0.1812575805198236
653,0.1031,38,323,38,181334,424276,13994,93962,3.930082626255141,0.1813105175614293
654,0.1032,62,497,62,181831,423779,14056,93900,3.9254788988106264,0.18138653489903975
655,0.1033,36,305,36,182136,423474,14092,93864,3.9226536737189224,0.18143650766036903
656,0.1034,33,305,33,182441,423169,14125,93831,3.9198284486272184,0.18149129593810445
657,0.1035,35,323,35,182764,422846,14160,93796,3.9168364889399383,0.18154931267686328
658,0.1036,36,338,36,183102,422508,14196,93760,3.9137055837563453,0.18161110121099894
659,0.1037,53,442,53,183544,422066,14249,93707,3.9096113231316463,0.18168263945572954
660,0.1038,47,436,47,183980,421630,14296,93660,3.9055726407054725,0.18176172640648955
661,0.1039,38,330,38,184310,421300,14334,93622,3.9025158397865796,0.18181782871968957
662,0.104,73,461,73,184771,420839,14407,93549,3.8982455815332173,0.18186466247268598
663,0.1041,38,272,38,185043,420567,14445,93511,3.8957260365334023,0.18190041199973545
664,0.1042,20,201,20,185244,420366,14465,93491,3.8938641668828042,0.1819397225298089
665,0.1043,52,390,52,185634,419976,14517,93439,3.890251583978658,0.1819950722125376
666,0.1044,39,366,39,186000,419610,14556,93400,3.886861313868613,0.18206272782206975
667,0.1045,51,359,51,186359,419251,14607,93349,3.8835358849901813,0.18210885680842762
668,0.1046,54,360,54,186719,418891,14661,93295,3.8802011930786615,0.18215062496827325
669,0.1047,46,459,46,187178,418432,14707,93249,3.875949460891474,0.18224049749746424
670,0.1048,36,310,36,187488,418122,14743,93213,3.8730779206343326,0.18229340843087213
671,0.1049,49,346,49,187834,417776,14792,93164,3.8698729111860386,0.18233843504129643
672,0.105,49,404,49,188238,417372,14841,93115,3.866130645818667,0.18240425319351913
673,0.1051,40,360,40,188598,417012,14881,93075,3.8627959539071473,0.18246887295696618
674,0.1052,43,364,43,188962,416648,14924,93032,3.8594242098632776,0.18253021503688588
675,0.1053,55,346,55,189308,416302,14979,92977,3.856219200414984,0.18256594126205872
676,0.1054,53,346,53,189654,415956,15032,92924,3.85301419096669,0.1826049363307656
677,0.1055,32,316,32,189970,415640,15064,92892,3.8500870725110232,0.1826669708100965
678,0.1056,53,375,53,190345,415265,15117,92839,3.84661343510319,0.18271653047407618
679,0.1057,45,318,45,190663,414947,15162,92794,3.843667790581348,0.1827585324013621
680,0.1058,34,230,34,190893,414717,15196,92760,3.8415372929712106,0.18278660904829183
681,0.1059,59,442,59,191335,414275,15255,92701,3.8374430323465116,0.18285086473521428
682,0.106,48,346,48,191681,413929,15303,92653,3.8342380228982176,0.1828983264308641
683,0.1061,37,376,37,192057,413553,15340,92616,3.8307551224572975,0.182974461098961
684,0.1062,40,270,40,192327,413283,15380,92576,3.828254103523658,0.18300751790518702
685,0.1063,25,282,25,192609,413001,15405,92551,3.8256419281929674,0.1830691996075577
686,0.1064,42,395,42,193004,412606,15447,92509,3.8219830301233837,0.18314443245597536
687,0.1065,55,393,55,193397,412213,15502,92454,3.818342658119975,0.18319802959179024
688,0.1066,45,377,45,193774,411836,15547,92409,3.8148504946459667,0.1832621047308352
689,0.1067,45,399,45,194173,411437,15592,92364,3.8111545444440327,0.1833342927068426
690,0.1068,43,334,43,194507,411103,15635,92321,3.8080606913927895,0.18338617149758454
691,0.1069,33,309,33,194816,410794,15668,92288,3.8051984141687356,0.1834452435189492
692,0.107,31,297,31,195113,410497,15699,92257,3.8024472933417317,0.18350326402176811
693,0.1071,47,475,47,195588,410022,15746,92210,3.7980473526251437,0.18360040777967154
694,0.1072,42,435,42,196023,409587,15788,92168,3.7940179332320576,0.18369124373449194
695,0.1073,50,433,50,196456,409154,15838,92118,3.7900070399051464,0.18376849295392522
696,0.1074,52,397,52,196853,408757,15890,92066,3.7863296157693873,0.18382941677998016
697,0.1075,50,404,50,197257,408353,15940,92016,3.7825873504020158,0.183896284542008
698,0.1076,37,414,37,197671,407939,15977,91979,3.7787524547037683,0.18398817406054593
699,0.1077,30,287,30,197958,407652,16007,91949,3.7760939642076403,0.184044867804508
700,0.1078,32,349,32,198307,407303,16039,91917,3.7728611656600837,0.18412122911742318
701,0.1079,39,402,39,198709,406901,16078,91878,3.769137426358887,0.18420583063841903
702,0.108,35,337,35,199046,406564,16113,91843,3.7660157842083812,0.18427309407773165
703,0.1081,46,386,46,199432,406178,16159,91797,3.7624402534365853,0.18434057934635273
704,0.1082,53,441,53,199873,405737,16212,91744,3.758355255844974,0.18441709331612666
705,0.1083,46,373,46,200246,405364,16258,91698,3.754900144503316,0.18448000450648008
706,0.1084,34,332,34,200578,405032,16292,91664,3.7518248175182483,0.1845474898126822
707,0.1085,47,362,47,200940,404670,16339,91617,3.7484715995405535,0.18460487580774834
708,0.1086,44,391,44,201331,404279,16383,91573,3.74484975360332,0.18467808942991054
709,0.1087,45,430,45,201761,403849,16428,91528,3.7408666493756715,0.1847643310044673
710,0.1088,34,289,34,202050,403560,16462,91494,3.7381896328133686,0.18481620186888703
711,0.1089,33,300,33,202350,403260,16495,91461,3.735410722887102,0.18487389862164735
712,0.109,38,256,38,202606,403004,16533,91423,3.733039386416688,0.18490697312242252
713,0.1091,40,280,40,202886,402724,16573,91383,3.730445737152173,0.18494577085530056
714,0.1092,37,338,37,203224,402386,16610,91346,3.7273148319685796,0.1850113016778333
715,0.1093,71,511,71,203735,401875,16681,91275,3.7225814220608395,0.1850856737301024
716,0.1094,41,369,41,204104,401506,16722,91234,3.719163362851532,0.18515647197304866
717,0.1095,34,284,34,204388,401222,16756,91200,3.7165326614546665,0.18520699725032594
718,0.1096,59,377,59,204765,400845,16815,91141,3.713040497980659,0.1852512063351396
719,0.1097,39,302,39,205067,400543,16854,91102,3.7102430619882174,0.18530036916881082
720,0.1098,42,364,42,205431,400179,16896,91060,3.7068713179443478,0.18536801841873304
721,0.1099,52,501,52,205932,399678,16948,91008,3.702230538367483,0.1854709529108228
722,0.11,39,279,39,206211,399399,16987,90969,3.6996461521360553,0.1855116973375098
723,0.1101,34,337,34,206548,399062,17021,90935,3.6965245099855495,0.18558276887409514
724,0.1102,42,318,42,206866,398744,17063,90893,3.6935788654637074,0.18563343864944848
725,0.1103,46,403,46,207269,398341,17109,90847,3.689845863129423,0.18570978846578412
726,0.1104,37,239,37,207508,398102,17146,90810,3.6876319982214976,0.1857389468861472
727,0.1105,43,350,43,207858,397752,17189,90767,3.6843899366408537,0.18580034758115857
728,0.1106,47,424,47,208282,397328,17236,90720,3.6804624106117307,0.18588335573550144
729,0.1107,54,325,54,208607,397003,17290,90666,3.6774519248582758,0.18591708720464084
730,0.1108,40,327,40,208934,396676,17330,90626,3.6744229130386454,0.1859750216498188
731,0.1109,35,346,35,209280,396330,17365,90591,3.671217903590352,0.18604866087106534
732,0.111,43,355,43,209635,395975,17408,90548,3.66792952684427,0.18611247566918726
733,0.1111,30,300,30,209935,395675,17438,90518,3.6651506169180035,0.18617709428148904
734,0.1112,55,395,55,210330,395280,17493,90463,3.6614917188484197,0.18623634308677633
735,0.1113,40,339,40,210669,394941,17533,90423,3.658351550631739,0.18629935471110343
736,0.1114,51,297,51,210966,394644,17584,90372,3.655600429804735,0.18632787371962986
737,0.1115,34,335,34,211301,394309,17618,90338,3.6524973137204046,0.18639958567782325
738,0.1116,60,458,60,211759,393851,17678,90278,3.648254844566305,0.1864750923824022
739,0.1117,32,431,32,212190,393420,17710,90246,3.6442624773055687,0.18658743843892273
740,0.1118,61,457,61,212647,392963,17771,90185,3.6400292711845568,0.18666123009926566
741,0.1119,52,387,52,213034,392576,17823,90133,3.636444477379673,0.18672326391262645
742,0.112,63,310,63,213344,392266,17886,90070,3.6335729371225316,0.18673704637431168
743,0.1121,55,448,55,213792,391818,17941,90015,3.629423098299307,0.18681783937588334
744,0.1122,36,380,36,214172,391438,17977,89979,3.6259031457260367,0.18690449236316956
745,0.1123,54,351,54,214523,391087,18031,89925,3.622651821112305,0.18694959793102875
746,0.1124,39,372,39,214895,390715,18070,89886,3.619205972803735,0.187028324951467
747,0.1125,76,424,76,215319,390291,18146,89810,3.615278446774612,0.18706480511392395
748,0.1126,52,368,52,215687,389923,18198,89758,3.611869650598392,0.18712019029313232
749,0.1127,54,365,54,216052,389558,18252,89704,3.6084886435214347,0.1871711089132875
750,0.1128,53,381,53,216433,389177,18305,89651,3.6049594279150767,0.1872300700877977
751,0.1129,56,455,56,216888,388722,18361,89595,3.6007447478602392,0.1873130162632731
752,0.113,58,440,58,217328,388282,18419,89537,3.5966690133017156,0.1873868556922182
753,0.1131,46,330,46,217658,387952,18465,89491,3.5936122123828227,0.18743808161393088
754,0.1132,59,445,59,218103,387507,18524,89432,3.589490162658861,0.1875124491811322
755,0.1133,49,361,49,218464,387146,18573,89383,3.586146207714254,0.18757095580751643
756,0.1134,39,330,39,218794,386816,18612,89344,3.583089406795361,0.18763440860215053
757,0.1135,62,430,62,219224,386386,18674,89282,3.5791063025677126,0.1876981424018433
758,0.1136,42,307,42,219531,386079,18716,89240,3.5762625514098336,0.18774759687704468
759,0.1137,32,340,32,219871,385739,18748,89208,3.573113120160065,0.18782727335892216
760,0.1138,43,331,43,220202,385408,18791,89165,3.5700470562080846,0.187884687919456
761,0.1139,55,379,55,220581,385029,18846,89110,3.5665363666679015,0.18794066718831398
762,0.114,48,365,48,220946,384664,18894,89062,3.5631553595909446,0.1880031917184195
763,0.1141,65,595,65,221541,384069,18959,88997,3.5576438549038496,0.1881280836077841
764,0.1142,47,438,47,221979,383631,19006,88950,3.553586646411501,0.18822170167653798
765,0.1143,44,352,44,222331,383279,19050,88906,3.550326058764682,0.18828637080805194
766,0.1144,31,189,31,222520,383090,19081,88875,3.548575345511134,0.18830845507611793
767,0.1145,38,335,38,222855,382755,19119,88837,3.5454722294268035,0.18837681724880828
768,0.1146,57,425,57,223280,382330,19176,88780,3.541535440364593,0.1884485576616926
769,0.1147,71,512,71,223792,381818,19247,88709,3.536792767423765,0.1885311576168849
770,0.1148,38,301,38,224093,381517,19285,88671,3.5340045944644114,0.18858626762061134
771,0.1149,34,370,34,224463,381147,19319,88637,3.5305772722220166,0.18867607240774484
772,0.115,37,232,37,224695,380915,19356,88600,3.528428248545704,0.18870536617573452
773,0.1151,52,503,52,225198,380412,19408,88548,3.523768942902664,0.18881780962128966
774,0.1152,50,363,50,225561,380049,19458,88498,3.520406461891882,0.18887752989561346
775,0.1153,25,310,25,225871,379739,19483,88473,3.51753492163474,0.18895927485839747
776,0.1154,58,373,58,226244,379366,19541,88415,3.5140798102930826,0.18900938687120683
777,0.1155,54,516,54,226760,378850,19595,88361,3.5093000852199046,0.18912439989640656
778,0.1156,44,280,44,227040,378570,19639,88317,3.5067064359553894,0.18916140308040275
779,0.1157,61,444,61,227484,378126,19700,88256,3.502593649264515,0.18923543361450484
780,0.1158,33,290,33,227774,377836,19733,88223,3.4999073696691245,0.18929577585670485
781,0.1159,35,300,35,228074,377536,19768,88188,3.497128459742858,0.18935678642285989
782,0.116,34,343,34,228417,377193,19802,88154,3.493951239393827,0.18943712971180646
783,0.1161,66,423,66,228840,376770,19868,88088,3.4900329763977918,0.18949442625489935
784,0.1162,51,397,51,229237,376373,19919,88037,3.4863555522620326,0.18956740810921385
785,0.1163,53,322,53,229559,376051,19972,87984,3.4833728556078403,0.1896063874492226
786,0.1164,74,423,74,229982,375628,20046,87910,3.479454592611805,0.18965003947896397
787,0.1165,47,427,47,230409,375201,20093,87863,3.475499277483419,0.18974267055957708
788,0.1166,52,296,52,230705,374905,20145,87811,3.4727574196895032,0.18977299250512195
789,0.1167,34,307,34,231012,374598,20179,87777,3.469913668531624,0.18983941605839416
790,0.1168,63,543,63,231555,374055,20242,87714,3.464883841565082,0.18995211891660116
791,0.1169,62,419,62,231974,373636,20304,87652,3.461002630701397,0.19001578189764312
792,0.117,53,457,53,232431,373179,20357,87599,3.4567694245803846,0.1901110730112983
793,0.1171,55,393,55,232824,372786,20412,87544,3.4531290525769758,0.1901766124302131
794,0.1172,46,374,46,233198,372412,20458,87498,3.4496646782022307,0.19025026635646106
795,0.1173,50,479,50,233677,371933,20508,87448,3.445227685353292,0.19036050685596487
796,0.1174,43,331,43,234008,371602,20551,87405,3.4421616214013118,0.19042193256311996
797,0.1175,45,408,45,234416,371194,20596,87360,3.4383823039015895,0.19051191353690078
798,0.1176,41,310,41,234726,370884,20637,87319,3.4355107636444475,0.19056837253357137
799,0.1177,65,437,65,235163,370447,20702,87254,3.4314628181851865,0.19063537112656517
800,0.1178,64,370,64,235533,370077,20766,87190,3.4280354959427917,0.1906763444552089
801,0.1179,60,413,60,235946,369664,20826,87130,3.4242098632776314,0.1907424353209543
802,0.118,59,432,59,236378,369232,20885,87071,3.4202082329838084,0.1908183816455294
803,0.1181,56,344,56,236722,368888,20941,87015,3.4170217496016897,0.1908629686578066
804,0.1182,56,403,56,237125,368485,20997,86959,3.4132887472674054,0.19093236490106358
805,0.1183,54,402,54,237527,368083,21051,86905,3.4095650079662083,0.19100503749549438
806,0.1184,57,361,57,237888,367722,21108,86848,3.4062210530216013,0.1910552830147172
807,0.1185,63,547,63,238435,367175,21171,86785,3.401154173922709,0.19117323112168472
808,0.1186,41,295,41,238730,366880,21212,86744,3.3984215791618806,0.1912244502054565
809,0.1187,56,393,56,239123,366487,21268,86688,3.3947812071584718,0.19129034037623435
810,0.1188,40,414,40,239537,366073,21308,86648,3.3909463114602247,0.1913938165006704
811,0.1189,63,452,63,239989,365621,21371,86585,3.38675942050465,0.19147247051122718
812,0.119,54,525,54,240514,365096,21425,86531,3.381896328133684,0.19159837653638953
813,0.1191,72,402,72,240916,364694,21497,86459,3.3781725888324874,0.19164008662249835
814,0.1192,39,406,39,241322,364288,21536,86420,3.3744117973989405,0.19174276915430832
815,0.1193,37,290,37,241612,363998,21573,86383,3.3717255178035495,0.1917998316980512
816,0.1194,51,316,51,241928,363682,21624,86332,3.3687983993478823,0.1918429204424751
817,0.1195,57,371,57,242299,363311,21681,86275,3.3653618140723998,0.19189876908978482
818,0.1196,26,302,26,242601,363009,21707,86249,3.3625643780799583,0.19198099978186253
819,0.1197,27,261,27,242862,362748,21734,86222,3.360146726444107,0.19204401184934405
820,0.1198,66,487,66,243349,362261,21800,86156,3.355635629330468,0.19213366130186857
821,0.1199,64,360,64,243709,361901,21864,86092,3.3523009374189483,0.19217264555472965
822,0.12,56,345,56,244054,361556,21920,86036,3.3491051910037424,0.19221970008400507
823,0.1201,65,359,65,244413,361197,21985,85971,3.3457797621253103,0.19225660154572777
824,0.1202,64,407,64,244820,360790,22049,85907,3.3420097076586757,0.19231604420893805
825,0.1203,59,416,59,245236,360374,22108,85848,3.3381562858942533,0.19238854202616634
826,0.1204,46,270,46,245506,360104,22154,85802,3.3356552669606137,0.19242172116993267
827,0.1205,44,376,44,245882,359728,22198,85758,3.332172366519693,0.19250436601823626
828,0.1206,61,503,61,246385,359225,22259,85697,3.3275130608766537,0.19261128916978706
829,0.1207,58,373,58,246758,358852,22317,85639,3.324057949534996,0.19266756807224444
830,0.1208,41,320,41,247078,358532,22358,85598,3.3210937789469783,0.19273185778938598
831,0.1209,77,468,77,247546,358064,22435,85521,3.316758679462003,0.19279506746170408
832,0.121,56,419,56,247965,357645,22491,85465,3.3128774685983178,0.19287535826318522
833,0.1211,56,367,56,248332,357278,22547,85409,3.3094779354551855,0.1929331559318435
834,0.1212,45,337,45,248669,356941,22592,85364,3.3063562933046797,0.19299804433592205
835,0.1213,59,328,59,248997,356613,22651,85305,3.3033180184519617,0.19303354921048702
836,0.1214,80,503,80,249500,356110,22731,85225,3.298658712808922,0.1931072767852085
837,0.1215,42,424,42,249924,355686,22773,85183,3.2947311867797993,0.19321612542501287
838,0.1216,48,343,48,250267,355343,22821,85135,3.2915539664307683,0.1932786654498068
839,0.1217,50,346,50,250613,354997,22871,85085,3.288348956982474,0.1933389686467522
840,0.1218,73,416,73,251029,354581,22944,85012,3.284495535218052,0.19338797478576775
841,0.1219,64,336,64,251365,354245,23008,84948,3.2813831561006337,0.19341838326202831
842,0.122,65,454,65,251819,353791,23073,84883,3.277177739078884,0.19349904484879432
843,0.1221,47,474,47,252293,353317,23120,84836,3.272787061395383,0.1936218626826702
844,0.1222,69,469,69,252762,352848,23189,84767,3.2684426988773203,0.19370222684322977
845,0.1223,63,450,63,253212,352398,23252,84704,3.264274333987921,0.19378543223320874
846,0.1224,60,373,60,253585,352025,23312,84644,3.2608192226462633,0.19384018558679458
847,0.1225,29,273,29,253858,351752,23341,84615,3.258290414613361,0.19390788029342274
848,0.1226,82,542,82,254400,351210,23423,84533,3.2532698506799065,0.19399737918910917
849,0.1227,51,285,51,254685,350925,23474,84482,3.250629886249954,0.19402995358365852
850,0.1228,52,287,52,254972,350638,23526,84430,3.2479713957538254,0.194061617953975
851,0.1229,50,369,50,255341,350269,23576,84380,3.2445533365445183,0.19413365727287996
852,0.123,69,404,69,255745,349865,23645,84311,3.2408110711771463,0.19418622862617924
853,0.1231,68,427,68,256172,349438,23713,84243,3.2368557560487607,0.19425107394605712
854,0.1232,41,344,41,256516,349094,23754,84202,3.233669272666642,0.1943290498873749
855,0.1233,46,346,46,256862,348748,23800,84156,3.230464263218348,0.1943987581542328
856,0.1234,69,479,69,257341,348269,23869,84087,3.2260272703694097,0.194485562823229
857,0.1235,51,353,51,257694,347916,23920,84036,3.2227574196895032,0.19454939437715302
858,0.1236,34,237,34,257931,347679,23954,84002,3.2205620808477526,0.19459276641779463
859,0.1237,52,393,52,258324,347286,24006,83950,3.216921708844344,0.19467298648535836
860,0.1238,73,434,73,258758,346852,24079,83877,3.2129015524843454,0.19473265092436312
861,0.1239,60,441,60,259199,346411,24139,83817,3.208816554892734,0.1948199559303439
862,0.124,37,292,37,259491,346119,24176,83780,3.206111749231168,0.194882984142787
863,0.1241,80,442,80,259933,345677,24256,83700,3.202017488606469,0.1949335898289848
864,0.1242,75,454,75,260387,345223,24331,83625,3.19781207158472,0.19499916054173042
865,0.1243,65,432,65,260819,344791,24396,83560,3.1938104412908963,0.19507366622232702
866,0.1244,87,392,87,261211,344399,24483,83473,3.190179332320575,0.19508871812130732
867,0.1245,42,250,42,261461,344149,24525,83431,3.1878635740486865,0.19512371953786425
868,0.1246,54,450,54,261911,343699,24579,83377,3.183695209159287,0.19522754732178815
869,0.1247,78,478,78,262389,343221,24657,83299,3.1792674793434363,0.19529916533808497
870,0.1248,68,412,68,262801,342809,24725,83231,3.175451109711364,0.19535959064876537
871,0.1249,73,468,73,263269,342341,24798,83158,3.1711160102263887,0.1954364170068555
872,0.125,82,551,82,263820,341790,24880,83076,3.1660120789951463,0.1955345920831509
873,0.1251,71,438,71,264258,341352,24951,83005,3.1619548705027976,0.19560181639515786
874,0.1252,64,434,64,264692,340918,25015,82941,3.157934714142799,0.19568063908044891
875,0.1253,56,495,56,265187,340423,25071,82885,3.1533495127644597,0.1958030559309061
876,0.1254,67,574,67,265761,339849,25138,82818,3.1480325317722033,0.1959414858505632
877,0.1255,45,375,45,266136,339474,25183,82773,3.1445588943643705,0.19602981193472066
878,0.1256,62,401,62,266537,339073,25245,82711,3.1408444180962616,0.19609800276918993
879,0.1257,55,426,55,266963,338647,25300,82656,3.1368983660009633,0.19619133972461625
880,0.1258,29,267,29,267230,338380,25329,82627,3.1344251361665862,0.19626039472027781
881,0.1259,48,342,48,267572,338038,25377,82579,3.131257178850643,0.19632825111681174
882,0.126,61,470,61,268042,337568,25438,82518,3.1269035532994924,0.19643120694334018
883,0.1261,79,435,79,268477,337133,25517,82439,3.1228741339064063,0.19648355943675935
884,0.1262,66,519,66,268996,336614,25583,82373,3.1180666197339657,0.19660037184924592
885,0.1263,56,442,56,269438,336172,25639,82317,3.1139723591092667,0.19670051064663588
886,0.1264,49,343,49,269781,335829,25688,82268,3.1107951387602357,0.19676773571683126
887,0.1265,87,418,87,270199,335411,25775,82181,3.106923190929638,0.19679735243970192
888,0.1266,74,504,74,270703,334907,25849,82107,3.102254622253511,0.19689267027006288
889,0.1267,79,456,79,271159,334451,25928,82028,3.098030679165586,0.1969559089413872
890,0.1268,39,298,39,271457,334153,25967,81989,3.095270295305495,0.19702168971168496
891,0.1269,44,309,44,271766,333844,26011,81945,3.0924080180814406,0.19708313591749663
892,0.127,51,357,51,272123,333487,26062,81894,3.089101115269184,0.19715393819168425
893,0.1271,57,350,57,272473,333137,26119,81837,3.08585905368854,0.19720994568334402
894,0.1272,70,442,70,272915,332695,26189,81767,3.081764793063841,0.19728467265997848
895,0.1273,65,613,65,273528,332082,26254,81702,3.07608655378117,0.1974508439185662
896,0.1274,64,452,64,273980,331630,26318,81638,3.0718996628255955,0.19754251478459497
897,0.1275,39,313,39,274293,331317,26357,81599,3.0690003334691913,0.19761646436563368
898,0.1276,59,364,59,274657,330953,26416,81540,3.0656285894253212,0.19767608177593315
899,0.1277,76,523,76,275180,330430,26492,81464,3.0607840231205308,0.19777904023850795
900,0.1278,48,356,48,275536,330074,26540,81416,3.0574863833413612,0.19785657002600307
901,0.1279,51,382,51,275918,329692,26591,81365,3.0539479047019156,0.1979409181694996
902,0.128,74,482,74,276400,329210,26665,81291,3.0494831227537147,0.19802875023446959
903,0.1281,74,519,74,276919,328691,26739,81217,3.044675608581274,0.1981347033968598
904,0.1282,68,496,68,277415,328195,26807,81149,3.040081144169847,0.1982415767667292
905,0.1283,74,480,74,277895,327715,26881,81075,3.035634888287821,0.19832921548961568
906,0.1284,42,284,42,278179,327431,26923,81033,3.0330041868909556,0.19838468016765248
907,0.1285,44,259,44,278438,327172,26967,80989,3.030605061321279,0.19842415125403945
908,0.1286,55,482,55,278920,326690,27022,80934,3.026140279373078,0.19855062508586344
909,0.1287,79,491,79,279411,326199,27101,80855,3.0215921301270887,0.19863457919588065
910,0.1288,27,247,27,279658,325952,27128,80828,3.019304160954463,0.19870200108166577
911,0.1289,50,285,50,279943,325667,27178,80778,3.01666419652451,0.198742757322639
912,0.129,54,321,54,280264,325346,27232,80724,3.013690762903405,0.19879331149801757
913,0.1291,36,296,36,280560,325050,27268,80688,3.010948905109489,0.19886724930866717
914,0.1292,55,293,55,280853,324757,27323,80633,3.0082348364148355,0.19890229162041492
915,0.1293,50,387,50,281240,324370,27373,80583,3.0046500426099523,0.19899346343896698
916,0.1294,50,378,50,281618,323992,27423,80533,3.001148616102857,0.19908040294172177
917,0.1295,71,423,71,282041,323569,27494,80462,2.997230353106821,0.19914808517168237
918,0.1296,60,257,60,282298,323312,27554,80402,2.99484975360332,0.19915583804376366
919,0.1297,85,588,85,282886,322724,27639,80317,2.989403090147838,0.19927749286052784
920,0.1298,65,380,65,283266,322344,27704,80252,2.9858831375745676,0.19933630736519986
921,0.1299,46,304,46,283570,322040,27750,80206,2.983067175515951,0.19939539485787305
922,0.13,41,247,41,283817,321793,27791,80165,2.980779206343325,0.1994362595097
923,0.1301,67,437,67,284254,321356,27858,80098,2.9767312608840637,0.1995197457242922
924,0.1302,68,462,68,284716,320894,27926,80030,2.9724517395976138,0.19961389190968862
925,0.1303,68,460,68,285176,320434,27994,79962,2.9681907443773388,0.19970728978311472
926,0.1304,91,534,91,285710,319900,28085,79871,2.963244284708585,0.19979188085178765
927,0.1305,52,350,52,286060,319550,28137,79819,2.960002223127941,0.19986278354103598
928,0.1306,53,356,53,286416,319194,28190,79766,2.9567045833487717,0.19993483055945457
929,0.1307,58,348,58,286764,318846,28248,79708,2.9534810478343028,0.19999297460319054
930,0.1308,74,412,74,287176,318434,28322,79634,2.9496646782022307,0.2000512475255484
931,0.1309,45,290,45,287466,318144,28367,79589,2.9469783986068396,0.20010660417918552
932,0.131,75,509,75,287975,317635,28442,79514,2.942263514765275,0.2002120111091807
933,0.1311,88,541,88,288516,317094,28530,79426,2.937252213864908,0.20030767678805608
934,0.1312,51,355,51,288871,316739,28581,79375,2.933963837118826,0.2003842328218644
935,0.1313,49,337,49,289208,316402,28630,79326,2.9308421949683203,0.20045586867747545
936,0.1314,63,367,63,289575,316035,28693,79263,2.927442661825188,0.20051454851782705
937,0.1315,51,433,51,290008,315602,28744,79212,2.923431768498277,0.20063118329137264
938,0.1316,59,387,59,290395,315215,28803,79153,2.9198469746933937,0.20070847533268418
939,0.1317,76,446,76,290841,314769,28879,79077,2.9157156619363445,0.2007815237427827
940,0.1318,52,351,52,291192,314418,28931,79025,2.912464337322613,0.20085501584727647
941,0.1319,42,425,42,291617,313993,28973,78983,2.9085275482604023,0.20098682871218598
942,0.132,69,437,69,292054,313556,29042,78914,2.9044796028011413,0.20107014548882718
943,0.1321,83,371,83,292425,313185,29125,78831,2.9010430175256587,0.20109128198849027
944,0.1322,55,363,55,292788,312822,29180,78776,2.8976805365148763,0.20116548092686887
945,0.1323,57,470,57,293258,312352,29237,78719,2.893326910963726,0.20129081419997905
946,0.1324,50,352,50,293610,312000,29287,78669,2.890066323316907,0.20136995768796603
947,0.1325,53,338,53,293948,311662,29340,78616,2.8869354181333136,0.20143589953827784
948,0.1326,46,340,46,294288,311322,29386,78570,2.883785986883545,0.20151734326428858
949,0.1327,51,407,51,294695,310915,29437,78519,2.8800159324169106,0.2016233816256413
950,0.1328,71,344,71,295039,310571,29508,78448,2.876829449034792,0.2016559602487282
951,0.1329,51,337,51,295376,310234,29559,78397,2.873707806884286,0.20172605890935102
952,0.133,54,377,54,295753,309857,29613,78343,2.8702156434102783,0.20181092220504895
953,0.1331,55,425,55,296178,309432,29668,78288,2.8662788543480677,0.20191891055400804
954,0.1332,56,417,56,296595,309015,29724,78232,2.8624161695505577,0.20202093237649354
955,0.1333,58,380,58,296975,308635,29782,78174,2.858896216977287,0.20209974431825525
956,0.1334,37,254,37,297229,308381,29819,78137,2.8565434065730484,0.202156173839252
957,0.1335,77,501,77,297730,307880,29896,78060,2.851902626996184,0.20225941856247084
958,0.1336,73,437,73,298167,307443,29969,77987,2.8478546815369223,0.2023376488597151
959,0.1337,66,411,66,298578,307032,30035,77921,2.8440475749379375,0.20241691842900303
960,0.1338,38,391,38,298969,306641,30073,77883,2.840425729000704,0.2025439244364461
961,0.1339,44,236,44,299205,306405,30117,77839,2.838239653192041,0.20257700835927173
962,0.134,95,624,95,299829,305781,30212,77744,2.8324595205454073,0.20270908024248746
963,0.1341,88,582,88,300411,305199,30300,77656,2.8270684352884508,0.20283397108565906
964,0.1342,55,390,55,300801,304809,30355,77601,2.8234558523843045,0.20292617870871577
965,0.1343,59,410,59,301211,304399,30414,77542,2.8196580088184073,0.2030208854247122
966,0.1344,41,212,41,301423,304187,30455,77501,2.817694245803846,0.20304803923623482
967,0.1345,46,383,46,301806,303804,30501,77455,2.8141465041313127,0.20315585992724106
968,0.1346,53,413,53,302219,303391,30554,77402,2.810320871466153,0.20326529111617073
969,0.1347,46,280,46,302499,303111,30600,77356,2.807727222201638,0.20331855325166176
970,0.1348,80,544,80,303043,302567,30680,77276,2.8026881322020083,0.2034419483839376
971,0.1349,61,399,61,303442,302168,30741,77215,2.7989921820000743,0.20352783335046642
972,0.135,46,281,46,303723,301887,30787,77169,2.7963892697024715,0.20358205647714323
973,0.1351,43,343,43,304066,301544,30830,77126,2.7932120493534405,0.20367602397866216
974,0.1352,66,387,66,304453,301157,30896,77060,2.789627255548557,0.20374546887104492
975,0.1353,75,480,75,304933,300677,30971,76985,2.785180999666531,0.20384629642378635
976,0.1354,74,422,74,305355,300255,31045,76911,2.781271999703583,0.20391816865783235
977,0.1355,47,303,47,305658,299952,31092,76864,2.778465300678054,0.20398284573903444
978,0.1356,66,407,66,306065,299545,31158,76798,2.7746952462114196,0.20406384601281277
979,0.1357,91,489,91,306554,299056,31249,76707,2.7701656230316054,0.20413664996287553
980,0.1358,74,359,74,306913,298697,31323,76633,2.7668401941531737,0.20417499267311431
981,0.1359,64,426,64,307339,298271,31387,76569,2.7628941420578754,0.20427115569309573
982,0.136,57,390,57,307729,297881,31444,76512,2.759281559153729,0.2043627952445692
983,0.1361,70,403,70,308132,297478,31514,76442,2.755548556819445,0.20443410355156183
984,0.1362,61,405,61,308537,297073,31575,76381,2.7517970284189857,0.2045258586064147
985,0.1363,55,295,55,308832,296778,31630,76326,2.749064433658157,0.20457030747459154
986,0.1364,46,308,46,309140,296470,31676,76280,2.7462114194671905,0.2046411804158283
987,0.1365,56,357,56,309497,296113,31732,76224,2.7429045166549333,0.2047177691177616
988,0.1366,76,586,76,310083,295527,31808,76148,2.737476379265627,0.20487791753548126
989,0.1367,66,403,66,310486,295124,31874,76082,2.7337433769313426,0.2049589715683475
990,0.1368,71,364,71,310850,294760,31945,76011,2.7303716328874725,0.20500794290815624
991,0.1369,33,331,33,311181,294429,31978,75978,2.7273055689354924,0.20512031360098487
992,0.137,45,242,45,311423,294187,32023,75933,2.7250639149283042,0.20515778666378473
993,0.1371,65,502,65,311925,293685,32088,75868,2.720413872318352,0.20529666921930007
994,0.1372,46,291,46,312216,293394,32134,75822,2.7177183296898737,0.20535946437857514
995,0.1373,67,276,67,312492,293118,32201,75755,2.715161732557709,0.20536878546274734
996,0.1374,80,429,80,312921,292689,32281,75675,2.711187891363148,0.20543538456526697
997,0.1375,43,389,43,313310,292300,32324,75632,2.7075845714920894,0.20555972299229205
998,0.1376,46,310,46,313620,291990,32370,75586,2.7047130312349474,0.205633664874747
999,0.1377,88,427,88,314047,291563,32458,75498,2.700757716106562,0.20568243425479688
1000,0.1378,58,334,58,314381,291229,32516,75440,2.6976638630553187,0.20574414526453014
1001,0.1379,60,406,60,314787,290823,32576,75380,2.693903071621772,0.2058421148925596
1002,0.138,55,349,55,315136,290474,32631,75325,2.6906702730742156,0.20591909764652172
1003,0.1381,44,271,44,315407,290203,32675,75281,2.6881599911074883,0.2059761850039947
1004,0.1382,82,419,82,315826,289784,32757,75199,2.684278780243803,0.20603425365017
1005,0.1383,77,459,77,316285,289325,32834,75122,2.6800270480566155,0.2061259936287032
1006,0.1384,54,299,54,316584,289026,32888,75068,2.677257401163437,0.20617752558405247
1007,0.1385,86,467,86,317051,288559,32974,74982,2.6729315647115492,0.20625459026629733
1008,0.1386,35,286,35,317337,288273,33009,74947,2.6702823372485085,0.20634050988381697
1009,0.1387,36,282,36,317619,287991,33045,74911,2.6676701619178185,0.2064221194702702
1010,0.1388,55,395,55,318014,287596,33100,74856,2.6640112638482343,0.20652665732290068
1011,0.1389,46,234,46,318248,287362,33146,74810,2.6618437141057467,0.20655931435892338
1012,0.139,44,279,44,318527,287083,33190,74766,2.6592593278743193,0.20662209927345385
1013,0.1391,65,373,65,318900,286710,33255,74701,2.6558042165326614,0.20669265739006284
1014,0.1392,84,546,84,319446,286164,33339,74617,2.650746600466857,0.20682075829935612
1015,0.1393,38,360,38,319806,285804,33377,74579,2.647411908555337,0.20694372376055475
1016,0.1394,53,355,53,320161,285449,33430,74526,2.6441235318092557,0.20703104382248766
1017,0.1395,52,313,52,320474,285136,33482,74474,2.641224202452851,0.20709657684713995
1018,0.1396,66,366,66,320840,284770,33548,74408,2.637833932342806,0.20716190858014688
1019,0.1397,67,480,67,321320,284290,33615,74341,2.63338767646078,0.20729105961280536
1020,0.1398,52,291,52,321611,283999,33667,74289,2.630692133832302,0.20734437100879738
1021,0.1399,64,402,64,322013,283597,33731,74225,2.6269683945311053,0.2074355405760406
1022,0.14,51,295,51,322308,283302,33782,74174,2.6242357997702768,0.2074936499233515
1023,0.1401,42,243,42,322551,283059,33824,74132,2.621984882730001,0.20754162338916715
1024,0.1402,55,353,55,322904,282706,33879,74077,2.6187150320500945,0.20762480275125217
1025,0.1403,62,408,62,323312,282298,33941,74015,2.614935714550372,0.20772466904098363
1026,0.1404,64,427,64,323739,281871,34005,73951,2.6109803994219867,0.20783144381179353
1027,0.1405,54,427,54,324166,281444,34059,73897,2.607025084293601,0.20796080384757176
1028,0.1406,40,254,40,324420,281190,34099,73857,2.604672273889362,0.20802034660199917
1029,0.1407,59,402,59,324822,280788,34158,73798,2.6009485345881656,0.20812440423479778
1030,0.1408,66,368,66,325190,280420,34224,73732,2.5975397384119456,0.20819309223158416
1031,0.1409,39,200,39,325390,280220,34263,73693,2.5956871317944348,0.2082234899537457
1032,0.141,71,422,71,325812,279798,34334,73622,2.5917781318314868,0.2083130552883255
1033,0.1411,45,245,45,326057,279553,34379,73577,2.589508688725036,0.20835669583439526
1034,0.1412,58,391,58,326448,279162,34437,73519,2.5858868427878026,0.2084575012546749
1035,0.1413,72,455,72,326903,278707,34509,73447,2.581672162732965,0.20856500281127008
1036,0.1414,64,299,64,327202,278408,34573,73383,2.5789025158397867,0.2085982870511184
1037,0.1415,46,300,46,327502,278108,34619,73337,2.57612360591352,0.20867276529755724
1038,0.1416,47,380,47,327882,277728,34666,73290,2.57260365334025,0.20879271148488113
1039,0.1417,43,228,43,328110,277500,34709,73247,2.5704916817962875,0.20883143690466346
1040,0.1418,72,415,72,328525,277085,34781,73175,2.5666475230649524,0.20891623365499914
1041,0.1419,84,512,84,329037,276573,34865,73091,2.5619048501241246,0.20903209938683995
1042,0.142,64,457,64,329494,276116,34929,73027,2.557671644003112,0.2091607163826856
1043,0.1421,46,359,46,329853,275757,34975,72981,2.5543462151246805,0.2092717168762796
1044,0.1422,55,312,55,330165,275445,35030,72926,2.5514561488013636,0.20933430164967806
1045,0.1423,61,334,61,330499,275111,35091,72865,2.5483622957501204,0.20939662505460147
1046,0.1424,64,302,64,330801,274809,35155,72801,2.545564859757679,0.20943298524208165
1047,0.1425,55,340,55,331141,274469,35210,72746,2.5424154285079106,0.20951283786702762
1048,0.1426,65,431,65,331572,274038,35275,72681,2.5384230612471748,0.20962508544383204
1049,0.1427,77,419,77,331991,273619,35352,72604,2.53454185038349,0.2097029948905763
1050,0.1428,53,330,53,332321,273289,35405,72551,2.531485049464597,0.20978198010640758
1051,0.1429,54,261,54,332582,273028,35459,72497,2.529067397828745,0.20981694522827582
1052,0.143,61,313,61,332895,272715,35520,72436,2.5261680684723404,0.209867565210589
1053,0.1431,69,367,69,333262,272348,35589,72367,2.522768535329208,0.20993284307326343
1054,0.1432,48,336,48,333598,272012,35637,72319,2.51965615621179,0.21002756069014988
1055,0.1433,65,397,65,333995,271615,35702,72254,2.515978732076031,0.2101207145744455
1056,0.1434,67,347,67,334342,271268,35769,72187,2.5127644595946497,0.21017891717983433
1057,0.1435,66,350,66,334692,270918,35835,72121,2.509522398014006,0.2102414011234874
1058,0.1436,62,385,62,335077,270533,35897,72059,2.5059561302752975,0.21033474220063517
1059,0.1437,66,389,66,335466,270144,35963,71993,2.502352810404239,0.21042155627716383
1060,0.1438,42,284,42,335750,269860,36005,71951,2.4997221090073736,0.21049936953462586
1061,0.1439,70,409,70,336159,269451,36075,71881,2.4959335284745636,0.21058968980347578
1062,0.144,68,329,68,336488,269122,36143,71813,2.4928859905887584,0.2106354583718304
1063,0.1441,64,376,64,336864,268746,36207,71749,2.489403090147838,0.2107196875137667
1064,0.1442,47,274,47,337138,268472,36254,71702,2.486865019081848,0.2107803653424424
1065,0.1443,47,372,47,337510,268100,36301,71655,2.483419170773278,0.21090197348089065
1066,0.1444,61,301,61,337811,267799,36362,71594,2.480630997813924,0.21094719101454656
1067,0.1445,41,328,41,338139,267471,36403,71553,2.4775927229612065,0.2110558544527821
1068,0.1446,49,313,49,338452,267158,36452,71504,2.474693393604802,0.21113676763262487
1069,0.1447,85,404,85,338856,266754,36537,71419,2.47095112823743,0.2111907219086089
1070,0.1448,38,281,38,339137,266473,36575,71381,2.468348215939827,0.2112776524771055
1071,0.1449,53,279,53,339416,266194,36628,71328,2.4657638297083997,0.21132844673828668
1072,0.145,62,295,62,339711,265899,36690,71266,2.463031234947571,0.21136832114839915
1073,0.1451,75,402,75,340113,265497,36765,71191,2.4593074956463745,0.21144501734543553
1074,0.1452,61,361,61,340474,265136,36826,71130,2.4559635407017675,0.21152896813831906
1075,0.1453,58,276,58,340750,264860,36884,71072,2.4534069435696026,0.21156662657918865
1076,0.1454,26,155,26,340905,264705,36910,71046,2.4519711734410317,0.21160324168803668
1077,0.1455,66,489,66,341394,264216,36976,70980,2.4474415502612175,0.21175670354061504
1078,0.1456,59,399,59,341793,263817,37035,70921,2.4437456000592834,0.21187017906541833
1079,0.1457,59,385,59,342178,263432,37094,70862,2.440179332320575,0.21197508779696914
1080,0.1458,49,327,49,342505,263105,37143,70813,2.437150320500945,0.21206703442162447
1081,0.1459,55,324,55,342829,262781,37198,70758,2.434149097780577,0.21214310770254752
1082,0.146,50,264,50,343093,262517,37248,70708,2.431703657045463,0.21219296271288168
1083,0.1461,62,314,62,343407,262203,37310,70646,2.428795064655971,0.21224639401049725
1084,0.1462,64,326,64,343733,261877,37374,70582,2.425775315869428,0.21230287042913562
1085,0.1463,66,393,66,344126,261484,37440,70516,2.4221349438660194,0.2123975903614458
1086,0.1464,40,277,40,344403,261207,37480,70476,2.419569083700767,0.2124799884226807
1087,0.1465,71,391,71,344794,260816,37551,70405,2.4159472377635334,0.21256200542839976
1088,0.1466,51,309,51,345103,260507,37602,70354,2.413084960539479,0.21263914453501623
1089,0.1467,67,323,67,345426,260184,37669,70287,2.410093000852199,0.2126873462421816
1090,0.1468,58,352,58,345778,259832,37727,70229,2.4068324132053798,0.21277582022717012
1091,0.1469,63,369,63,346147,259463,37790,70166,2.4034143539960726,0.21286355266071857
1092,0.147,83,409,83,346556,259054,37873,70083,2.3996257734632627,0.21292957036127813
1093,0.1471,69,376,69,346932,258678,37942,70014,2.3961428730223426,0.2130079223102479
1094,0.1472,48,225,48,347157,258453,37990,69966,2.394058690577643,0.21303883149269684
1095,0.1473,65,347,65,347504,258106,38055,69901,2.3908444180962616,0.21310825683598217
1096,0.1474,54,384,54,347888,257722,38109,69847,2.3872874133906405,0.21322835799480414
1097,0.1475,73,445,73,348333,257277,38182,69774,2.383165363666679,0.21334287312987882
1098,0.1476,64,434,64,348767,256843,38246,69710,2.3791452073066806,0.21347223880962662
1099,0.1477,70,303,70,349070,256540,38316,69640,2.3763385082811515,0.2135017475013796
1100,0.1478,41,277,41,349347,256263,38357,69599,2.373772648115899,0.2135842780072546
1101,0.1479,80,372,80,349719,255891,38437,69519,2.3703267998073287,0.21363510648105466
1102,0.148,31,261,31,349980,255630,38468,69488,2.3679091481714774,0.2137316297467381
1103,0.1481,44,214,44,350194,255416,38512,69444,2.3659268590907407,0.21376592993905066
1104,0.1482,59,328,59,350522,255088,38571,69385,2.3628885842380227,0.21383905594610336
1105,0.1483,65,474,65,350996,254614,38636,69320,2.3584979065545224,0.2139942086968333
1106,0.1484,67,440,67,351436,254174,38703,69253,2.3544221719959983,0.21412250677896402
1107,0.1485,63,373,63,351809,253801,38766,69190,2.3509670606543405,0.21421649519646058
1108,0.1486,75,465,75,352274,253336,38841,69115,2.346659750268628,0.2143426443087477
1109,0.1487,35,202,35,352476,253134,38876,69080,2.344788617584942,0.21439167758073827
1110,0.1488,65,400,65,352876,252734,38941,69015,2.3410834043499205,0.21449950116395078
1111,0.1489,72,406,72,353282,252328,39013,68943,2.3373226129163736,0.2145945323418547
1112,0.149,80,391,80,353673,251937,39093,68863,2.3337007669791396,0.21466022443890273
1113,0.1491,58,344,58,354017,251593,39151,68805,2.330514283597021,0.21474853151392956
1114,0.1492,86,421,86,354438,251172,39237,68719,2.3266145466671606,0.21482004807887686
1115,0.1493,44,308,44,354746,250864,39281,68675,2.323761532476194,0.21491899267382072
1116,0.1494,60,309,60,355055,250555,39341,68615,2.3208992552521397,0.21497947802111728
1117,0.1495,66,389,66,355444,250166,39407,68549,2.317295935381081,0.21507930282540827
1118,0.1496,60,356,60,355800,249810,39467,68489,2.313998295601912,0.21517189812094917
1119,0.1497,53,295,53,356095,249515,39520,68436,2.3112657008410835,0.21524071319165533
1120,0.1498,54,308,54,356403,249207,39574,68382,2.308412686650117,0.2153160216506239
1121,0.1499,82,406,82,356809,248801,39656,68300,2.3046518952165695,0.21538878779947082
1122,0.15,41,305,41,357114,248496,39697,68259,2.3018266701248655,0.21549462518350143
1123,0.1501,74,449,74,357563,248047,39771,68185,2.2976675682685537,0.2156170153558147
1124,0.1502,70,401,70,357964,247646,39841,68115,2.2939530920004447,0.21571695047836814
1125,0.1503,71,478,71,358442,247168,39912,68044,2.2895253621845937,0.2158674162151187
1126,0.1504,69,295,69,358737,246873,39981,67975,2.286792767423765,0.2158978300640309
1127,0.1505,84,516,84,359253,246357,40065,67891,2.282013042350587,0.2160427433110155
1128,0.1506,47,244,47,359497,246113,40112,67844,2.279752862277224,0.21609328666027514
1129,0.1507,58,382,58,359879,245731,40170,67786,2.2762143836377784,0.21621156109557058
1130,0.1508,78,537,78,360416,245194,40248,67708,2.2712401348697617,0.2163872394551649
1131,0.1509,56,384,56,360800,244810,40304,67652,2.267683130164141,0.21651272794771845
1132,0.151,55,312,55,361112,244498,40359,67597,2.2647930638408242,0.2165911020682805
1133,0.1511,40,241,40,361353,244257,40399,67557,2.2625606728667234,0.21665800765841176
1134,0.1512,94,424,94,361777,243833,40493,67463,2.2586331468376004,0.21671656558388158
1135,0.1513,56,297,56,362074,243536,40549,67407,2.255882026010597,0.21678249711361888
1136,0.1514,81,446,81,362520,243090,40630,67326,2.2517507132535477,0.21688959331993196
1137,0.1515,49,349,49,362869,242741,40679,67277,2.2485179147059915,0.2170099800656736
1138,0.1516,71,381,71,363250,242360,40750,67206,2.244988699099633,0.21709748486590905
1139,0.1517,75,381,75,363631,241979,40825,67131,2.241459483493275,0.21717511565462133
1140,0.1518,41,233,41,363864,241746,40866,67090,2.2393011967838747,0.21723503736611016
1141,0.1519,51,366,51,364230,241380,40917,67039,2.23591092667383,0.21736339200892293
1142,0.152,103,512,103,364742,240868,41020,66936,2.2311682537330024,0.21746306090889006
1143,0.1521,55,352,55,365094,240516,41075,66881,2.227907666086183,0.21757206478918142
1144,0.1522,72,447,72,365541,240069,41147,66809,2.2237670902960467,0.21770540736057978
1145,0.1523,72,379,72,365920,239690,41219,66737,2.2202564007558636,0.2177908604659511
1146,0.1524,55,304,55,366224,239386,41274,66682,2.217440438697247,0.21786661787576617
1147,0.1525,58,277,58,366501,239109,41332,66624,2.2148745785319943,0.21791563226737054
1148,0.1526,63,363,63,366864,238746,41395,66561,2.2115120975212124,0.2180133439456023
1149,0.1527,70,365,70,367229,238381,41465,66491,2.208131090444255,0.2180948070009709
1150,0.1528,39,253,39,367482,238128,41504,66452,2.2057875430731038,0.2181758487096986
1151,0.1529,62,364,62,367846,237764,41566,66390,2.202415799029234,0.2182775830664729
1152,0.153,53,350,53,368196,237414,41619,66337,2.1991737374485902,0.21839269664955835
1153,0.1531,60,324,60,368520,237090,41679,66277,2.1961725147282225,0.21847135647581972
1154,0.1532,40,283,40,368803,236807,41719,66237,2.193551076364445,0.2185722205356318
1155,0.1533,52,251,52,369054,236556,41771,66185,2.191226055059469,0.21861921576529111
1156,0.1534,62,321,62,369375,236235,41833,66123,2.1882526214383637,0.21869108804794316
1157,0.1535,59,297,59,369672,235938,41892,66064,2.1855015006113603,0.21875351818862127
1158,0.1536,50,266,50,369938,235672,41942,66014,2.183037533810071,0.21881691560098912
1159,0.1537,55,397,55,370335,235275,41997,65959,2.179360109674312,0.21896266689683103
1160,0.1538,47,264,47,370599,235011,42044,65912,2.1769146689391974,0.21903277582637418
1161,0.1539,51,308,51,370907,234703,42095,65861,2.1740616547482308,0.21912471220771615
1162,0.154,77,410,77,371317,234293,42172,65784,2.1702638111823336,0.21922373257530567
1163,0.1541,72,424,72,371741,233869,42244,65712,2.1663362851532106,0.21934635374072456
1164,0.1542,55,228,55,371969,233641,42299,65657,2.1642243136092483,0.21936999244899733
1165,0.1543,37,238,37,372207,233403,42336,65620,2.1620197117344104,0.21944800232758016
1166,0.1544,65,380,65,372587,233023,42401,65555,2.1584997591611397,0.2195573685938013
1167,0.1545,54,231,54,372818,232792,42455,65501,2.1563599985179147,0.21958611164190914
1168,0.1546,67,404,67,373222,232388,42522,65434,2.1526177331505427,0.2197084164366635
1169,0.1547,61,352,61,373574,232036,42583,65373,2.149357145503724,0.2198084119848424
1170,0.1548,50,306,50,373880,231730,42633,65323,2.146522657378932,0.21990351890066756
1171,0.1549,60,327,60,374207,231403,42693,65263,2.143493645559302,0.21998813480479731
1172,0.155,49,285,49,374492,231118,42742,65214,2.140853681129349,0.22007073147685705
1173,0.1551,53,295,53,374787,230823,42795,65161,2.1381210863685207,0.2201504135358668
1174,0.1552,67,316,67,375103,230507,42862,65094,2.1351939679128535,0.22020899793979046
1175,0.1553,53,293,53,375396,230214,42915,65041,2.1324798992182,0.22028754805168413
1176,0.1554,49,299,49,375695,229915,42964,64992,2.129710252325021,0.22038134055820988
1177,0.1555,73,422,73,376117,229493,43037,64919,2.1258012523620735,0.22050391967718708
1178,0.1556,33,242,33,376359,229251,43070,64886,2.1235595983548854,0.22059788465918942
1179,0.1557,52,246,52,376605,229005,43122,64834,2.121280892215347,0.2206446387307335
1180,0.1558,37,259,37,376864,228746,43159,64797,2.1188817666456705,0.220741083929782
1181,0.1559,48,328,48,377192,228418,43207,64749,2.1158434917929525,0.22086046519560523
1182,0.156,78,402,78,377594,228016,43285,64671,2.112119752491756,0.2209561750265642
1183,0.1561,66,297,66,377891,227719,43351,64605,2.1093686316647524,0.22100477552304976
1184,0.1562,54,297,54,378188,227422,43405,64551,2.1066175108377485,0.22108551133152723
1185,0.1563,60,346,60,378534,227076,43465,64491,2.103412501389455,0.22118758295691898
1186,0.1564,41,223,41,378757,226853,43506,64450,2.1013468450109305,0.22124729233821827
1187,0.1565,58,343,58,379100,226510,43564,64392,2.0981696246618995,0.22135289547682724
1188,0.1566,53,329,53,379429,226181,43617,64339,2.095122086776094,0.22146151727936114
1189,0.1567,63,336,63,379765,225845,43680,64276,2.0920097076586757,0.22154893992506575
1190,0.1568,72,544,72,380309,225301,43752,64204,2.086970617659046,0.22177164470389113
1191,0.1569,40,330,40,380639,224971,43792,64164,2.083913816740153,0.22191709754958755
1192,0.157,53,356,53,380995,224615,43845,64111,2.080616176960984,0.2220478931582192
1193,0.1571,61,293,61,381288,224322,43906,64050,2.077902108266331,0.22210894261578795
1194,0.1572,57,280,57,381568,224042,43963,63993,2.0753084590018154,0.22217091672886977
1195,0.1573,62,300,62,381868,223742,44025,63931,2.0725295490755493,0.22223496817567168
1196,0.1574,56,302,56,382170,223440,44081,63875,2.069732113083108,0.2223169691801681
1197,0.1575,97,451,97,382621,222989,44178,63778,2.065554485160621,0.22240355410490048
1198,0.1576,53,279,53,382900,222710,44231,63725,2.0629700989291933,0.2224763035243598
1199,0.1577,56,353,56,383253,222357,44287,63669,2.0597002482492868,0.2225986448784376
1200,0.1578,64,315,64,383568,222042,44351,63605,2.0567823928267073,0.22266993877058047
1201,0.1579,60,297,60,383865,221745,44411,63545,2.0540312719997034,0.22273826632549334
1202,0.158,63,407,63,384272,221338,44474,63482,2.0502612175330692,0.22288462888842075
1203,0.1581,61,346,61,384618,220992,44535,63421,2.047056208084775,0.22298910387359228
1204,0.1582,88,466,88,385084,220526,44623,63333,2.042739634665975,0.2231142926593837
1205,0.1583,91,511,91,385595,220015,44714,63242,2.038006224758235,0.22326720963647853
1206,0.1584,49,273,49,385868,219742,44763,63193,2.0354774167253327,0.22334811882587874
1207,0.1585,80,327,80,386195,219415,44843,63113,2.0324484049057023,0.22338670857401743
1208,0.1586,71,389,71,386584,219026,44914,63042,2.028845085034644,0.22349929804160698
1209,0.1587,67,333,67,386917,218693,44981,62975,2.0257604950164882,0.22357882329551101
1210,0.1588,78,445,78,387362,218248,45059,62897,2.0216384452925267,0.22371729890270145
1211,0.1589,59,292,59,387654,217956,45118,62838,2.0189336396309607,0.2237868330519883
1212,0.159,88,488,88,388142,217468,45206,62750,2.014413279484234,0.22393279518089487
1213,0.1591,60,316,60,388458,217152,45266,62690,2.011486161028567,0.22401926801552305
1214,0.1592,40,263,40,388721,216889,45306,62650,2.0090499833265403,0.22411899591827975
1215,0.1593,126,528,126,389249,216361,45432,62524,2.004159101856312,0.22419276762823387
1216,0.1594,54,308,54,389557,216053,45486,62470,2.0013060876653452,0.22429027405277122
1217,0.1595,65,329,65,389886,215724,45551,62405,1.9982585497795398,0.22437430113364662
1218,0.1596,45,188,45,390074,215536,45596,62360,1.9965170995590795,0.22440049514926447
1219,0.1597,54,326,54,390400,215210,45650,62306,1.9934973507725369,0.2245131812219836
1220,0.1598,51,376,51,390776,214834,45701,62255,1.9900144503316166,0.22467510438884258
1221,0.1599,106,504,106,391280,214330,45807,62149,1.9853458816554892,0.22478741604244806
1222,0.16,49,294,49,391574,214036,45856,62100,1.9826225499277483,0.224889185039256
1223,0.1601,73,449,73,392023,213587,45929,62027,1.9784634480714365,0.22505025143860616
1224,0.1602,59,325,59,392348,213262,45988,61968,1.9754529623179815,0.2251498746502925
1225,0.1603,77,427,77,392775,212835,46065,61891,1.9714976471895957,0.22528264525381653
1226,0.1604,42,221,42,392996,212614,46107,61849,1.9694505168772463,0.2253454928350998
1227,0.1605,70,447,70,393443,212167,46177,61779,1.9653099410871095,0.2255152475305352
1228,0.1606,53,386,53,393829,211781,46230,61726,1.9617344103153136,0.22568343771823024
1229,0.1607,86,472,86,394301,211309,46316,61640,1.957362258697988,0.22582973375978663
1230,0.1608,53,313,53,394614,210996,46369,61587,1.9544629293415836,0.22593852147786178
1231,0.1609,91,407,91,395021,210589,46460,61496,1.950692874874949,0.22601760479261995
1232,0.161,52,245,52,395266,210344,46512,61444,1.9484234317684983,0.22607326298438488
1233,0.1611,60,337,60,395603,210007,46572,61384,1.9453017896179925,0.22618288742073245
1234,0.1612,35,248,35,395851,209759,46607,61349,1.9430045574122792,0.22628989185121798
1235,0.1613,59,370,59,396221,209389,46666,61290,1.9395772351698841,0.22643056905042505
1236,0.1614,73,328,73,396549,209061,46739,61217,1.9365389603171663,0.22649642220232502
1237,0.1615,81,354,81,396903,208707,46820,61136,1.9332598466041722,0.22656137087121028
1238,0.1616,37,214,37,397117,208493,46857,61099,1.9312775575234356,0.2266350633549957
1239,0.1617,72,379,72,397496,208114,46929,61027,1.9277668679832525,0.22674731832013703
1240,0.1618,65,298,65,397794,207816,46994,60962,1.9250064841231613,0.22681171822098534
1241,0.1619,43,193,43,397987,207623,47037,60919,1.9232187187372634,0.22685092089877934
1242,0.162,88,443,88,398430,207180,47125,60831,1.919115195079477,0.2269720272675375
1243,0.1621,93,623,93,399053,206557,47218,60738,1.9133443254659306,0.22723208440112982
1244,0.1622,64,260,64,399313,206297,47282,60674,1.9109359368631664,0.22726813024635634
1245,0.1623,68,352,68,399665,205945,47350,60606,1.9076753492163474,0.22737112222426478
1246,0.1624,105,508,105,400173,205437,47455,60501,1.90296972840787,0.22750039482886988
1247,0.1625,35,189,35,400362,205248,47490,60466,1.9012190151543222,0.22756045974242983
1248,0.1626,60,244,60,400606,205004,47550,60406,1.898958835080959,0.2275950416336988
1249,0.1627,49,225,49,400831,204779,47599,60357,1.8968746526362592,0.22764543479572746
1250,0.1628,50,240,50,401071,204539,47649,60307,1.8946515246952462,0.22770591211496494
1251,0.1629,71,365,71,401436,204174,47720,60236,1.891270517618289,0.2278128663817556
1252,0.163,54,301,54,401737,203873,47774,60182,1.8884823446589352,0.22791463899566378
1253,0.1631,66,359,66,402096,203514,47840,60116,1.8851569157805033,0.22803171111026818
1254,0.1632,57,316,57,402412,203198,47897,60059,1.882229797324836,0.22813828312257603
1255,0.1633,69,287,69,402699,202911,47966,59990,1.879571306828708,0.22818475395681265
1256,0.1634,74,363,74,403062,202548,48040,59916,1.876208825817926,0.22828273591806877
1257,0.1635,73,325,73,403387,202223,48113,59843,1.8731983400644707,0.22835087344409424
1258,0.1636,52,276,52,403663,201947,48165,59791,1.8706417429323057,0.22843836202614828
1259,0.1637,65,326,65,403989,201621,48230,59726,1.867621994145763,0.22853141608665872
1260,0.1638,63,278,63,404267,201343,48293,59663,1.865046870947423,0.22858861482111523
1261,0.1639,82,311,82,404578,201032,48375,59581,1.8621660676571936,0.22861867980492148
1262,0.164,78,346,78,404924,200686,48453,59503,1.8589610582089,0.2286914512143096
1263,0.1641,66,397,66,405321,200289,48519,59437,1.855283634073141,0.22884501359124615
1264,0.1642,71,311,71,405632,199978,48590,59366,1.8524028307829115,0.22890832253686225
1265,0.1643,63,280,63,405912,199698,48653,59303,1.8498091815183964,0.22896822792189991
1266,0.1644,40,231,40,406143,199467,48693,59263,1.8476694208751714,0.22905345340702662
1267,0.1645,68,332,68,406475,199135,48761,59195,1.8445940938901033,0.2291448921921573
1268,0.1646,68,278,68,406753,198857,48829,59127,1.8420189706917633,0.22918863185313817
1269,0.1647,78,310,78,407063,198547,48907,59049,1.8391474304346216,0.22923104396030994
1270,0.1648,39,237,39,407300,198310,48946,59010,1.8369520915928712,0.2293253536452666
1271,0.1649,51,227,51,407527,198083,48997,58959,1.8348493830819963,0.22937496595887052
1272,0.165,76,295,76,407822,197788,49073,58883,1.832116788321168,0.2294104125514764
1273,0.1651,63,287,63,408109,197501,49136,58820,1.8294582978250398,0.22947788125046328
1274,0.1652,39,193,39,408302,197308,49175,58781,1.8276705324391418,0.22953348250022454
1275,0.1653,67,310,67,408612,196998,49242,58714,1.824798992182,0.2296098736078088
1276,0.1654,47,312,47,408924,196686,49289,58667,1.8219089258586831,0.2297486224951342
1277,0.1655,40,212,40,409136,196474,49329,58627,1.8199451628441217,0.22981877766061284
1278,0.1656,56,264,56,409400,196210,49385,58571,1.8174997221090075,0.22988762898332293
1279,0.1657,54,274,54,409674,195936,49439,58517,1.8149616510430175,0.22997174330819445
1280,0.1658,46,263,46,409937,195673,49485,58471,1.8125254733409908,0.23007035381515992
1281,0.1659,36,199,36,410136,195474,49521,58435,1.8106821297565674,0.23014150739044303
1282,0.166,86,355,86,410491,195119,49607,58349,1.8073937530104858,0.2302026291287263
1283,0.1661,67,329,67,410820,194790,49674,58282,1.8043462151246805,0.23029809698425743
1284,0.1662,60,261,60,411081,194529,49734,58222,1.8019285634888287,0.23035319345917524
1285,0.1663,39,240,39,411321,194289,49773,58183,1.7997054355478157,0.23045327798726195
1286,0.1664,53,252,53,411573,194037,49826,58130,1.797371151209752,0.23052183671931695
1287,0.1665,43,258,43,411831,193779,49869,58087,1.794981288673163,0.23062660303494714
1288,0.1666,37,235,37,412066,193544,49906,58050,1.7928044758975878,0.23072887270761624
1289,0.1667,45,211,45,412277,193333,49951,58005,1.790849975916114,0.2307848395387884
1290,0.1668,42,219,42,412496,193114,49993,57963,1.7888213716699397,0.23085746603631555
1291,0.1669,39,239,39,412735,192875,50032,57924,1.7866075067620142,0.23095785868364707
1292,0.167,66,386,66,413121,192489,50098,57858,1.7830319759902182,0.23111121762992964
1293,0.1671,74,356,74,413477,192133,50172,57784,1.779734336211049,0.23121276263719556
1294,0.1672,60,317,60,413794,191816,50232,57724,1.7767979547222943,0.23132163180251664
1295,0.1673,38,234,38,414028,191582,50270,57686,1.7746304049798065,0.2314216024519794
1296,0.1674,35,188,35,414216,191394,50305,57651,1.7728889547593465,0.23148828524965367
1297,0.1675,59,297,59,414513,191097,50364,57592,1.7701378339323428,0.23158241820104628
1298,0.1676,35,190,35,414703,190907,50399,57557,1.7683778576457074,0.23165126537446068
1299,0.1677,77,273,77,414976,190634,50476,57480,1.7658490496128052,0.2316677011373804
1300,0.1678,58,313,58,415289,190321,50534,57422,1.7629497202564008,0.2317805144847685
1301,0.1679,68,295,68,415584,190026,50602,57354,1.7602171254955723,0.2318457433907349
1302,0.168,78,320,78,415904,189706,50680,57276,1.7572529549075548,0.23190353952919646
1303,0.1681,70,387,70,416291,189319,50750,57206,1.7536681611026714,0.2320494878815536
1304,0.1682,57,254,57,416545,189065,50807,57149,1.7513153506984327,0.23211109035229516
1305,0.1683,66,261,66,416806,188804,50873,57083,1.748897699062581,0.2321513540772794
1306,0.1684,96,305,96,417111,188499,50969,56987,1.746072473970877,0.2321395110108112
1307,0.1685,36,238,36,417349,188261,51005,56951,1.7438678720960392,0.2322520920672724
1308,0.1686,67,373,67,417722,187888,51072,56884,1.7404127607543813,0.23239586227182848
1309,0.1687,103,374,103,418096,187514,51175,56781,1.7369483863796362,0.23242800712253628
1310,0.1688,63,317,63,418413,187197,51238,56718,1.7340120048908814,0.23253182461103253
1311,0.1689,32,193,32,418606,187004,51270,56686,1.7322242395049836,0.2326152078460339
1312,0.169,79,345,79,418951,186659,51349,56607,1.7290284930897772,0.23269589667277796
1313,0.1691,65,302,65,419253,186357,51414,56542,1.726231057097336,0.23277987970308647
1314,0.1692,53,239,53,419492,186118,51467,56489,1.7240171921894105,0.2328415915451739
1315,0.1693,47,294,47,419786,185824,51514,56442,1.7212938604616697,0.2329753246431608
1316,0.1694,43,150,43,419936,185674,51557,56399,1.7199044054985364,0.23298343888000728
1317,0.1695,75,352,75,420288,185322,51632,56324,1.7166438178517174,0.23308476035191975
1318,0.1696,71,335,71,420623,184987,51703,56253,1.7135407017673867,0.23318272259990053
1319,0.1697,71,335,71,420958,184652,51774,56182,1.710437585683056,0.23328101513905844
1320,0.1698,48,192,48,421150,184460,51822,56134,1.7086590833302457,0.2333142139870487
1321,0.1699,56,248,56,421398,184212,51878,56078,1.7063618511245322,0.23337633692621415
1322,0.17,54,243,54,421641,183969,51932,56024,1.7041109340842566,0.2334401420041418
1323,0.1701,75,424,75,422065,183545,52007,55949,1.7001834080551337,0.23361336818458917
1324,0.1702,51,220,51,422285,183325,52058,55898,1.6981455407758717,0.2336648231984383
1325,0.1703,41,194,41,422479,183131,52099,55857,1.6963485123568862,0.23372303211876747
1326,0.1704,61,380,61,422859,182751,52160,55796,1.6928285597836155,0.2338993992798065
1327,0.1705,50,172,50,423031,182579,52210,55746,1.6912353180925561,0.2339074792824924
1328,0.1706,52,242,52,423273,182337,52262,55694,1.6889936640853682,0.23397792724477065
1329,0.1707,52,217,52,423490,182120,52314,55642,1.6869835859053688,0.23402393990629286
1330,0.1708,57,273,57,423763,181847,52371,55585,1.6844547778724666,0.234109134404798
1331,0.1709,38,210,38,423973,181637,52409,55547,1.6825095409240802,0.23419370615218565
1332,0.171,68,293,68,424266,181344,52477,55479,1.6797954722294268,0.23426356392749015
1333,0.1711,61,280,61,424546,181064,52538,55418,1.6772018229649117,0.2343434172579731
1334,0.1712,47,357,47,424903,180707,52585,55371,1.6738949201526547,0.23454536212607696
1335,0.1713,59,315,59,425218,180392,52644,55312,1.6709770647300752,0.2346672097206666
1336,0.1714,60,249,60,425467,180143,52704,55252,1.6686705694912742,0.2347203636440876
1337,0.1715,67,257,67,425724,179886,52771,55185,1.666289969987773,0.23475886008907948
1338,0.1716,54,276,54,426000,179610,52825,55131,1.6637333728556079,0.23485884442854038
1339,0.1717,55,245,55,426245,179365,52880,55076,1.6614639297491571,0.23492477851570331
1340,0.1718,82,383,82,426628,178982,52962,54994,1.6579161880766238,0.23504120080692037
1341,0.1719,39,260,39,426888,178722,53001,54955,1.6555077994738596,0.23517504932021552
1342,0.172,50,220,50,427108,178502,53051,54905,1.6534699321945978,0.2352328764775692
1343,0.1721,62,263,62,427371,178239,53113,54843,1.651033754492571,0.23529487476510413
1344,0.1722,29,136,29,427507,178103,53142,54814,1.6497739819926638,0.23533705139599084
1345,0.1723,61,269,61,427776,177834,53203,54753,1.6472822260921116,0.23540868578209445
1346,0.1724,56,268,56,428044,177566,53259,54697,1.6447997332246471,0.23549596793290364
1347,0.1725,29,167,29,428211,177399,53288,54668,1.6432528066990255,0.23556990007196196
1348,0.1726,49,203,49,428414,177196,53337,54619,1.641372410982252,0.23561460647499083
1349,0.1727,63,434,63,428848,176762,53400,54556,1.6373522546222534,0.2358484856344945
1350,0.1728,75,344,75,429192,176418,53475,54481,1.634165771240135,0.23595164985556455
1351,0.1729,66,267,66,429459,176151,53541,54415,1.631692541405758,0.23600617610575714
1352,0.173,40,203,40,429662,175948,53581,54375,1.6298121456889845,0.2360815029328378
1353,0.1731,69,275,69,429937,175673,53650,54306,1.627264811589907,0.2361346035942412
1354,0.1732,69,300,69,430237,175373,53719,54237,1.6244859016636408,0.2362135795479291
1355,0.1733,76,307,76,430544,175066,53795,54161,1.6216421505057617,0.23627670387868793
1356,0.1734,59,255,59,430799,174811,53854,54102,1.6192800770684352,0.23634306483249096
1357,0.1735,49,258,49,431057,174553,53903,54053,1.6168902145318462,0.23644611252548053
1358,0.1736,42,240,42,431297,174313,53945,54011,1.6146670865908332,0.23655419491599658
1359,0.1737,43,243,43,431540,174070,53988,53968,1.6124161695505577,0.23666231066752033
1360,0.1738,67,364,67,431904,173706,54055,53901,1.6090444255066878,0.23681609089351383
1361,0.1739,59,308,59,432212,173398,54114,53842,1.6061914113157212,0.23693891920436544
1362,0.174,59,317,59,432529,173081,54173,53783,1.6032550298269665,0.23707154947457507
1363,0.1741,40,188,40,432717,172893,54213,53743,1.6015135796065063,0.23713355336310207
1364,0.1742,42,198,42,432915,172695,54255,53701,1.5996794990551706,0.23719942048446085
1365,0.1743,42,280,42,433195,172415,54297,53659,1.5970858497906555,0.23735148668135211
1366,0.1744,57,259,57,433454,172156,54354,53602,1.594686724220979,0.23743123167285324
1367,0.1745,37,206,37,433660,171950,54391,53565,1.5927785394049427,0.23752300290446313
1368,0.1746,48,221,48,433881,171729,54439,53517,1.5907314090925933,0.23759356436962253
1369,0.1747,39,299,39,434180,171430,54478,53478,1.5879617621994147,0.23777722446511462
1370,0.1748,59,266,59,434446,171164,54537,53419,1.585497795398125,0.23785860906658118
1371,0.1749,49,302,49,434748,170862,54586,53370,1.5827003594056839,0.23801241571229798
1372,0.175,62,274,62,435022,170588,54648,53308,1.580162288339694,0.23809268588987745
1373,0.1751,51,229,51,435251,170359,54699,53257,1.5780410537626441,0.23816274327418432
1374,0.1752,24,107,24,435358,170252,54723,53233,1.5770499092222758,0.23819495715596126
1375,0.1753,61,377,61,435735,169875,54784,53172,1.573557745748268,0.23838921841584956
1376,0.1754,50,188,50,435923,169687,54834,53122,1.5718162955278077,0.2384194534332096
1377,0.1755,51,243,51,436166,169444,54885,53071,1.5695653784875319,0.23850526930768712
1378,0.1756,41,174,41,436340,169270,54926,53030,1.5679536107302976,0.2385515069725596
1379,0.1757,45,201,45,436541,169069,54971,52985,1.566091741079699,0.2386131301395156
1380,0.1758,52,235,52,436776,168834,55023,52933,1.5639149283041238,0.23868745124387308
1381,0.1759,60,246,60,437022,168588,55083,52873,1.5616362221645856,0.23874632553813085
1382,0.176,51,220,51,437242,168368,55134,52822,1.5595983548853236,0.23880826438808264
1383,0.1761,39,183,39,437425,168185,55173,52783,1.5579032198303013,0.23887169182868107
1384,0.1762,46,290,46,437715,167895,55219,52737,1.5552169402349105,0.23902697704775372
1385,0.1763,39,192,39,437907,167703,55258,52698,1.5534384378821,0.2391005485456055
1386,0.1764,47,262,47,438169,167441,55305,52651,1.551011523213161,0.23922268869381894
1387,0.1765,46,168,46,438337,167273,55351,52605,1.5494553336544519,0.23924630931698487
1388,0.1766,46,217,46,438554,167056,55397,52559,1.5474452554744527,0.239323361336885
1389,0.1767,30,161,30,438715,166895,55427,52529,1.5459539071473563,0.23939496135336152
1390,0.1768,38,190,38,438905,166705,55465,52491,1.544193930860721,0.23947061077756893
1391,0.1769,38,226,38,439131,166479,55503,52453,1.5421004853829339,0.2395858074653317
1392,0.177,69,348,69,439479,166131,55572,52384,1.538876949868465,0.23972724984554836
1393,0.1771,69,326,69,439805,165805,55641,52315,1.5358572010819223,0.23984503942783789
1394,0.1772,40,174,40,439979,165631,55681,52275,1.5342454333246878,0.2398970198158839
1395,0.1773,44,177,44,440156,165454,55725,52231,1.5326058764681907,0.2399384431632864
1396,0.1774,37,188,37,440344,165266,55762,52194,1.5308644262477304,0.2400165547686931
1397,0.1775,40,201,40,440545,165065,55802,52154,1.5290025565971321,0.2400987022313886
1398,0.1776,35,203,35,440748,164862,55837,52119,1.5271221608803587,0.24020075490480733
1399,0.1777,40,134,40,440882,164728,55877,52079,1.5258809144466263,0.24020903384115827
1400,0.1778,43,289,43,441171,164439,55920,52036,1.5232038978843232,0.2403787966277861
1401,0.1779,51,254,51,441425,164185,55971,51985,1.5208510874800845,0.24048202803349217
1402,0.178,38,184,38,441609,164001,56009,51947,1.5191466893919745,0.2405532813455091
1403,0.1781,56,269,56,441878,163732,56065,51891,1.5166549334914223,0.2406561452164194
1404,0.1782,38,191,38,442069,163541,56103,51853,1.5148856941716995,0.24073558223534547
1405,0.1783,21,125,21,442194,163416,56124,51832,1.5137278150357554,0.24080130825838103
1406,0.1784,45,154,45,442348,163262,56169,51787,1.512301307940272,0.2408148840496817
1407,0.1785,68,275,68,442623,162987,56237,51719,1.5097539738411945,0.24088288170801003
1408,0.1786,58,233,58,442856,162754,56295,51661,1.5075956871317944,0.2409392999556934
1409,0.1787,60,250,60,443106,162504,56355,51601,1.505279928859906,0.2410079166763971
1410,0.1788,47,244,47,443350,162260,56402,51554,1.5030197487865427,0.2411161102640613
1411,0.1789,64,319,64,443669,161941,56466,51490,1.5000648412316129,0.24124892822504698
1412,0.179,29,152,29,443821,161789,56495,51461,1.4986568602023047,0.2413177022274326
1413,0.1791,67,243,67,444064,161546,56562,51394,1.496405943162029,0.2413543721236029
1414,0.1792,37,172,37,444236,161374,56599,51357,1.4948127014709696,0.24141756490591404
1415,0.1793,39,197,39,444433,161177,56638,51318,1.4929878839527215,0.2415021529918351
1416,0.1794,58,196,58,444629,160981,56696,51260,1.491172329467561,0.2415178971075334
1417,0.1795,66,317,66,444946,160664,56762,51194,1.488235947978806,0.24164298728393546
1418,0.1796,64,336,64,445282,160328,56826,51130,1.485123568861388,0.2417974254934786
1419,0.1797,57,276,57,445558,160052,56883,51073,1.482566971729223,0.24190882178804027
1420,0.1798,41,170,41,445728,159882,56924,51032,1.4809922561043387,0.2419564372208578
1421,0.1799,41,197,41,445925,159685,56965,50991,1.4791674385860907,0.24203516299910763
1422,0.18,36,188,36,446113,159497,57001,50955,1.4774259883656304,0.24212171896679527
1423,0.1801,27,140,27,446253,159357,57028,50928,1.4761291637333729,0.24218560525001784
1424,0.1802,62,267,62,446520,159090,57090,50866,1.4736559338989959,0.24226980891234354
1425,0.1803,31,189,31,446709,158901,57121,50835,1.4719052206454482,0.24237612999198993
1426,0.1804,61,246,61,446955,158655,57182,50774,1.4696265145059098,0.24244015871727412
1427,0.1805,52,253,52,447208,158402,57234,50722,1.4672829671347587,0.2425450928635642
1428,0.1806,27,113,27,447321,158289,57261,50695,1.466236244395865,0.24257837920606362
1429,0.1807,67,270,67,447591,158019,57328,50628,1.4637352254622253,0.24264906756387583
1430,0.1808,33,201,33,447792,157818,57361,50595,1.461873355811627,0.2427631673647997
1431,0.1809,27,174,27,447966,157644,57388,50568,1.4602615880543925,0.2428678462336465
1432,0.181,61,281,61,448247,157363,57449,50507,1.4576586757567898,0.2429739741184394
1433,0.1811,41,185,41,448432,157178,57490,50466,1.4559450146355923,0.24304097397468744
1434,0.1812,55,300,55,448732,156878,57545,50411,1.453166104709326,0.24319187221704963
1435,0.1813,59,204,59,448936,156674,57604,50352,1.451276445959465,0.24321582796363742
1436,0.1814,34,156,34,449092,156518,57638,50318,1.4498314127978065,0.24327486511052235
1437,0.1815,36,167,36,449259,156351,57674,50282,1.4482844862721849,0.24333964081245493
1438,0.1816,43,205,43,449464,156146,57717,50239,1.4463855644892363,0.24342369842769582
1439,0.1817,61,264,61,449728,155882,57778,50178,1.443940123754122,0.2435115985635252
1440,0.1818,27,182,27,449910,155700,57805,50151,1.4422542517321872,0.24362767244268912
1441,0.1819,67,295,67,450205,155405,57872,50084,1.4395216569713587,0.24373080797512275
1442,0.182,40,198,40,450403,155207,57912,50044,1.437687576420023,0.24381854412402376
1443,0.1821,22,147,22,450550,155060,57934,50022,1.4363259105561526,0.24391219122107255
1444,0.1822,34,137,34,450687,154923,57968,49988,1.4350568750231576,0.2439498123575601
1445,0.1823,26,106,26,450793,154817,57994,49962,1.4340749935158768,0.24398009561527306
1446,0.1824,35,191,35,450984,154626,58029,49927,1.432305754196154,0.2440785517689792
1447,0.1825,43,199,43,451183,154427,58072,49884,1.4304624106117307,0.24415719173221218
1448,0.1826,35,185,35,451368,154242,58107,49849,1.428748749490533,0.244248888975996
1449,0.1827,61,245,61,451613,153997,58168,49788,1.4264793063840824,0.24431631376205315
1450,0.1828,46,252,46,451865,153745,58214,49742,1.4241450220460188,0.24444804827826838
1451,0.1829,56,246,56,452111,153499,58270,49686,1.4218663159064804,0.24453576789625217
1452,0.183,52,168,52,452279,153331,58322,49634,1.4203101263477713,0.24454462592072526
1453,0.1831,21,145,21,452424,153186,58343,49613,1.418966986550076,0.24464124576551166
1454,0.1832,45,144,45,452568,153042,58388,49568,1.4176331097854682,0.24464735205567345
1455,0.1833,32,171,32,452739,152871,58420,49536,1.4160491311274963,0.24473461886199588
1456,0.1834,56,160,56,452899,152711,58476,49480,1.4145670458334878,0.24471910223501542
1457,0.1835,32,199,32,453098,152512,58508,49448,1.4127237022490644,0.24484056248762132
1458,0.1836,50,200,50,453298,152312,58558,49398,1.4108710956315536,0.2448961380199296
1459,0.1837,33,155,33,453453,152157,58591,49365,1.4094353255029828,0.2449608479471224
1460,0.1838,26,130,26,453583,152027,58617,49339,1.4082311312016007,0.24502150313359752
1461,0.1839,51,181,51,453764,151846,58668,49288,1.4065545222127533,0.24505056330605468
1462,0.184,41,163,41,453927,151683,58709,49247,1.405044647819482,0.2450953068232718
1463,0.1841,30,136,30,454063,151547,58739,49217,1.4037848753195747,0.2451485326054472
1464,0.1842,29,124,29,454187,151423,58768,49188,1.4026362592167179,0.24519094167318842
1465,0.1843,39,183,39,454370,151240,58807,49149,1.4009411241616956,0.24526795382980104
1466,0.1844,49,199,49,454569,151041,58856,49100,1.3990977805772722,0.24532704443367426
1467,0.1845,32,210,32,454779,150831,58888,49068,1.3971525436288859,0.24546395929944623
1468,0.1846,34,147,34,454926,150684,58922,49034,1.3957908777650154,0.2455161778107131
1469,0.1847,36,192,36,455118,150492,58958,48998,1.394012375412205,0.24561632162013133
1470,0.1848,25,104,25,455222,150388,58983,48973,1.3930490199710994,0.24564985127482306
1471,0.1849,31,118,31,455340,150270,59014,48942,1.391955982066768,0.24567797120655382
1472,0.185,36,145,36,455485,150125,59050,48906,1.3906128422690727,0.24572051589953323
1473,0.1851,49,203,49,455688,149922,59099,48857,1.388732446552299,0.24578552060328304
1474,0.1852,23,137,23,455825,149785,59122,48834,1.3874634110193043,0.24586771658300566
1475,0.1853,41,158,41,455983,149627,59163,48793,1.3859998517914707,0.245907670597722
1476,0.1854,52,218,52,456201,149409,59215,48741,1.3839805105783838,0.24598031794095382
1477,0.1855,38,172,38,456373,149237,59253,48703,1.3823872688873244,0.24604930787107204
1478,0.1856,26,93,26,456466,149144,59279,48677,1.3815258068101819,0.2460658878481051
1479,0.1857,23,125,23,456591,149019,59302,48654,1.3803679276742375,0.24613376637173515
1480,0.1858,35,171,35,456762,148848,59337,48619,1.3787839490162659,0.24621329133475467
1481,0.1859,35,191,35,456953,148657,59372,48584,1.377014709696543,0.24631795620585983
1482,0.186,40,135,40,457088,148522,59412,48544,1.3757642002297232,0.2463337156079689
1483,0.1861,20,117,20,457205,148405,59432,48524,1.3746804253584795,0.2464035261439402
1484,0.1862,31,139,31,457344,148266,59463,48493,1.3733928637593094,0.2464588659222704
1485,0.1863,45,184,45,457528,148082,59508,48448,1.3716884656711994,0.2465170711850608
1486,0.1864,25,143,25,457671,147939,59533,48423,1.370363851939679,0.2466006661166621
1487,0.1865,34,123,34,457794,147816,59567,48389,1.36922449886991,0.24662470375372697
1488,0.1866,43,166,43,457960,147650,59610,48346,1.367686835377376,0.24666829935304802
1489,0.1867,21,119,21,458079,147531,59631,48325,1.366584534439957,0.2467373989053182
1490,0.1868,44,244,44,458323,147287,59675,48281,1.3643243543665937,0.24687576699664568
1491,0.1869,45,187,45,458510,147100,59720,48236,1.3625921671792212,0.24693860834664375
1492,0.187,27,111,27,458621,146989,59747,48209,1.3615639705065026,0.24697486654576378
1493,0.1871,13,49,13,458670,146940,59760,48196,1.3611100818852124,0.24698671695637914
1494,0.1872,34,151,34,458821,146789,59794,48162,1.3597113638889917,0.24704669378459201
1495,0.1873,39,119,39,458940,146670,59833,48123,1.3586090629515728,0.24704686513375737
1496,0.1874,34,162,34,459102,146508,59867,48089,1.3571084515913892,0.24712097308797154
1497,0.1875,25,111,25,459213,146397,59892,48064,1.3560802549186706,0.24716524135944998
1498,0.1876,37,183,37,459396,146214,59929,48027,1.354385119863648,0.24725469905941588
1499,0.1877,38,139,38,459535,146075,59967,47989,1.3530975582644782,0.24728440102234314
1500,0.1878,32,192,32,459727,145883,59999,47957,1.3513190559116677,0.2474050763516302
1501,0.1879,39,160,39,459887,145723,60038,47918,1.349836970617659,0.24745792471635655
1502,0.188,16,92,16,459979,145631,60054,47902,1.348984771573604,0.24751334397751287
1503,0.1881,28,87,28,460066,145544,60082,47874,1.348178887694987,0.24751574310560548
1504,0.1882,22,113,22,460179,145431,60104,47852,1.3471321649560932,0.24757479964611476
1505,0.1883,37,135,37,460314,145296,60141,47815,1.3458816554892734,0.2476037097834924
1506,0.1884,51,189,51,460503,145107,60192,47764,1.3441309422357257,0.24764739126151677
1507,0.1885,22,141,22,460644,144966,60214,47742,1.3428248545703805,0.2477426987981817
1508,0.1886,69,225,69,460869,144741,60283,47673,1.340740672125681,0.24776263681436902
1509,0.1887,50,181,50,461050,144560,60333,47623,1.3390640631368336,0.24780027369746543
1510,0.1888,27,83,27,461133,144477,60360,47596,1.3382952313905665,0.2478016170935009
1511,0.1889,49,214,49,461347,144263,60409,47547,1.3363129423098299,0.2478859287836922
1512,0.189,42,218,42,461565,144045,60451,47505,1.3342936010967432,0.2480031323414252
1513,0.1891,28,99,28,461664,143946,60479,47477,1.3333765608210753,0.24802139763769243
1514,0.1892,36,165,36,461829,143781,60515,47441,1.3318481603616288,0.24809383857505934
1515,0.1893,70,239,70,462068,143542,60585,47371,1.3296342954537033,0.24812872879269615
1516,0.1894,34,113,34,462181,143429,60619,47337,1.3285875727148098,0.2481417023997987
1517,0.1895,37,197,37,462378,143232,60656,47300,1.3267627551965615,0.24825226208720844
1518,0.1896,22,102,22,462480,143130,60678,47278,1.325817925821631,0.24829839082391497
1519,0.1897,67,197,67,462677,142933,60745,47211,1.323993108303383,0.2482907691013127
1520,0.1898,57,178,57,462855,142755,60802,47154,1.3223442884137981,0.24829786897935327
1521,0.1899,38,159,38,463014,142596,60840,47116,1.320871466152877,0.24835540187231173
1522,0.19,63,327,63,463341,142269,60903,47053,1.317842454333247,0.24853424324695492
1523,0.1901,35,181,35,463522,142088,60938,47018,1.3161658453443996,0.24863304178608822
1524,0.1902,80,253,80,463775,141835,61018,46938,1.3138222979732483,0.2486478468848829
1525,0.1903,49,223,49,463998,141612,61067,46889,1.3117566415947237,0.24874669099898675
1526,0.1904,46,200,46,464198,141412,61113,46843,1.3099040349772129,0.24882738838277868
1527,0.1905,41,187,41,464385,141225,61154,46802,1.3081718477898403,0.24891106064554558
1528,0.1906,34,137,34,464522,141088,61188,46768,1.3069028122568453,0.2489566476450047
1529,0.1907,48,155,48,464677,140933,61236,46720,1.3054670421282746,0.2489701736716173
1530,0.1908,24,112,24,464789,140821,61260,46696,1.3044295824224683,0.24902275527018883
1531,0.1909,31,155,31,464944,140666,61291,46665,1.3029938122938975,0.24910452621295995
1532,0.191,66,247,66,465191,140419,61357,46599,1.3007058431212717,0.24916852923248028
1533,0.1911,50,172,50,465363,140247,61407,46549,1.2991126014302123,0.24919698494614445
1534,0.1912,41,196,41,465559,140051,61448,46508,1.2972970469450518,0.24929378909621086
1535,0.1913,29,141,29,465700,139910,61477,46479,1.2959909592797065,0.24936557414868904
1536,0.1914,49,265,49,465965,139645,61526,46430,1.2935362555115046,0.2495230417842268
1537,0.1915,55,236,55,466201,139409,61581,46375,1.291350179702842,0.2496178357662662
1538,0.1916,49,187,49,466388,139222,61630,46326,1.2896179925154692,0.2496712440985621
1539,0.1917,14,136,14,466524,139086,61644,46312,1.2883582200155619,0.2497977324458732
1540,0.1918,40,192,40,466716,138894,61684,46272,1.2865797176627516,0.2498946890897897
1541,0.1919,41,156,41,466872,138738,61725,46231,1.2851346845010931,0.24993917899756177
1542,0.192,21,100,21,466972,138638,61746,46210,1.2842083811923377,0.2499891802994893
1543,0.1921,45,185,45,467157,138453,61791,46165,1.28249472007114,0.25005687419428224
1544,0.1922,33,122,33,467279,138331,61824,46132,1.2813646300344586,0.25008809354721545
1545,0.1923,33,154,33,467433,138177,61857,46099,1.2799381229389752,0.2501627992793419
1546,0.1924,46,177,46,467610,138000,61903,46053,1.278298566082478,0.25021597039983046
1547,0.1925,47,228,47,467838,137772,61950,46006,1.2761865945385158,0.2503346428843496
1548,0.1926,31,130,31,467968,137642,61981,45975,1.2749824002371337,0.250385312906757
1549,0.1927,37,133,37,468101,137509,62018,45938,1.273750416836489,0.25041565138704913
1550,0.1928,38,156,38,468257,137353,62056,45900,1.2723053836748306,0.2504733892487435
1551,0.1929,26,143,26,468400,137210,62082,45874,1.2709807699433102,0.2505625832950995
1552,0.193,17,103,17,468503,137107,62099,45857,1.2700266775352922,0.2506340045036182
1553,0.1931,29,112,29,468615,136995,62128,45828,1.2689892178294861,0.2506686795425083
1554,0.1932,23,68,23,468683,136927,62151,45805,1.2683593315795325,0.25066764441914935
1555,0.1933,31,164,31,468847,136763,62182,45774,1.2668401941531735,0.25076559820748673
1556,0.1934,40,161,40,469008,136602,62222,45734,1.2653488458260773,0.25082265707265705
1557,0.1935,29,125,29,469133,136477,62251,45705,1.264190966690133,0.2508754981282454
1558,0.1936,38,171,38,469304,136306,62289,45667,1.2626069880321613,0.25095481197760106
1559,0.1937,26,139,26,469443,136167,62315,45641,1.2613194264329912,0.25103955821526003
1560,0.1938,35,116,35,469559,136051,62350,45606,1.260244914594835,0.25105556075460894
1561,0.1939,41,150,41,469709,135901,62391,45565,1.2588554596317019,0.25109386882391194
1562,0.194,39,155,39,469864,135746,62430,45526,1.2574196895031309,0.25114744693057944
1563,0.1941,25,135,25,469999,135611,62455,45501,1.256169180036311,0.251231282300455
1564,0.1942,33,136,33,470135,135475,62488,45468,1.2549094075364038,0.25128355338421493
1565,0.1943,20,87,20,470222,135388,62508,45448,1.2541035236577864,0.25132163949656044
1566,0.1944,30,135,30,470357,135253,62538,45418,1.2528530141909666,0.25138511437917543
1567,0.1945,51,139,51,470496,135114,62589,45367,1.2515654525917967,0.2513671799247566
1568,0.1946,50,233,50,470729,134881,62639,45317,1.2494071658823966,0.2514844781851075
1569,0.1947,21,76,21,470805,134805,62660,45296,1.2487031753677424,0.25150332313535184
1570,0.1948,27,109,27,470914,134696,62687,45269,1.247693504761199,0.251543355652488
1571,0.1949,26,101,26,471015,134595,62713,45243,1.2467579384193561,0.25157641877689924
1572,0.195,23,150,23,471165,134445,62736,45220,1.2453684834562229,0.25169064648095063
1573,0.1951,29,173,29,471338,134272,62765,45191,1.243765978732076,0.251812351292467
1574,0.1952,32,116,32,471454,134156,62797,45159,1.2426914668939197,0.2518417310319828
1575,0.1953,38,184,38,471638,133972,62835,45121,1.2409870688058098,0.25194172859910774
1576,0.1954,39,142,39,471780,133830,62874,45082,1.239671718107377,0.251978626363799
1577,0.1955,29,78,29,471858,133752,62903,45053,1.2389492015265477,0.25196722686725764
1578,0.1956,13,100,13,471958,133652,62916,45040,1.2380228982177925,0.25205381326528326
1579,0.1957,26,131,26,472089,133521,62942,45014,1.2368094408833228,0.2521298344862352
1580,0.1958,30,142,30,472231,133379,62972,44984,1.23549409018489,0.2522047734115259
1581,0.1959,31,143,31,472374,133236,63003,44953,1.23416947645337,0.2522770765872192
1582,0.196,37,186,37,472560,133050,63040,44916,1.2324465522990848,0.2523852870773069
1583,0.1961,38,145,38,472705,132905,63078,44878,1.2311034125013895,0.2524313348295394
1584,0.1962,32,119,32,472824,132786,63110,44846,1.2300011115639704,0.25246577193298503
1585,0.1963,45,193,45,473017,132593,63155,44801,1.2282133461780727,0.25255081908069044
1586,0.1964,16,125,16,473142,132468,63171,44785,1.2270554670421283,0.2526614500177712
1587,0.1965,29,179,29,473321,132289,63200,44756,1.225397384119456,0.2527944872772459
1588,0.1966,25,115,25,473436,132174,63225,44731,1.2243321353143874,0.25285322630790535
1589,0.1967,34,123,34,473559,132051,63259,44697,1.2231927822446182,0.2528854640505126
1590,0.1968,23,112,23,473671,131939,63282,44674,1.2221553225388122,0.25294853719714855
1591,0.1969,27,107,27,473778,131832,63309,44647,1.221164177998444,0.2529876075907048
1592,0.197,53,162,53,473940,131670,63362,44594,1.21966356663826,0.2529955067398902
1593,0.1971,29,163,29,474103,131507,63391,44565,1.2181536922449887,0.25310668362942434
1594,0.1972,38,189,38,474292,131318,63429,44527,1.216402978991441,0.2532173220734169
1595,0.1973,34,180,34,474472,131138,63463,44493,1.214735633035681,0.2533322704989438
1596,0.1974,27,154,27,474626,130984,63490,44466,1.2133091259401978,0.25343972641778284
1597,0.1975,52,191,52,474817,130793,63542,44414,1.211539886620475,0.25349443800761384
1598,0.1976,27,127,27,474944,130666,63569,44387,1.2103634814183557,0.253563206571724
1599,0.1977,16,73,16,475017,130593,63585,44371,1.209687280002964,0.25360074072380606
1600,0.1978,36,164,36,475181,130429,63621,44335,1.2081681425766053,0.253684969444508
1601,0.1979,38,160,38,475341,130269,63659,44297,1.2066860572825966,0.2537550267520594
1602,0.198,19,132,19,475473,130137,63678,44278,1.2054633369150394,0.25386577989278447
1603,0.1981,24,97,24,475570,130040,63702,44254,1.2045648227055468,0.25390432258138546
1604,0.1982,52,163,52,475733,129877,63754,44202,1.2030549483122754,0.25391919760568477
1605,0.1983,23,119,23,475852,129758,63777,44179,1.2019526473748565,0.2539942622903695
1606,0.1984,23,98,23,475950,129660,63800,44156,1.201044870132276,0.2540387536245225
1607,0.1985,28,139,28,476089,129521,63828,44128,1.1997573085331061,0.25412182045390413
1608,0.1986,25,162,25,476251,129359,63853,44103,1.1982566971729223,0.2542516516585765
1609,0.1987,43,184,43,476435,129175,63896,44060,1.1965522990848123,0.25433659479897247
1610,0.1988,35,149,35,476584,129026,63931,44025,1.1951721071547667,0.2544047708479003
1611,0.1989,37,108,37,476692,128918,63968,43988,1.194171699581311,0.25440412709796073
1612,0.199,46,186,46,476878,128732,64014,43942,1.1924487754270259,0.25447953947901825
1613,0.1991,19,85,19,476963,128647,64033,43923,1.1916614176145837,0.254522802341079
1614,0.1992,16,96,16,477059,128551,64049,43907,1.1907721664381785,0.25459532175950084
1615,0.1993,52,231,52,477290,128320,64101,43855,1.1886324057949536,0.25471177580949617
1616,0.1994,29,107,29,477397,128213,64130,43826,1.1876412612545852,0.25474456373264204
1617,0.1995,38,156,38,477553,128057,64168,43788,1.1861962280929268,0.25481102156012686
1618,0.1996,20,77,20,477630,127980,64188,43768,1.1854829745451851,0.25483848429093786
1619,0.1997,58,213,58,477843,127767,64246,43710,1.183509948497536,0.25490298990535176
1620,0.1998,38,161,38,478004,127606,64284,43672,1.1820186001704398,0.2549772883849648
1621,0.1999,42,148,42,478152,127458,64326,43630,1.1806476712734817,0.25501496305994575
1622,0.2,42,168,42,478320,127290,64368,43588,1.1790914817147726,0.2550825735319936
1623,0.2001,42,174,42,478494,127116,64410,43546,1.1774797139575384,0.2551593207626771
1624,0.2002,41,191,41,478685,126925,64451,43505,1.1757104746378153,0.255266091650531
1625,0.2003,33,128,33,478813,126797,64484,43472,1.1745248064026084,0.2553136507526326
1626,0.2004,16,156,16,478969,126641,64500,43456,1.17307977324095,0.25547775680935
1627,0.2005,24,145,24,479114,126496,64524,43432,1.1717366334432546,0.2555906030789511
1628,0.2006,31,96,31,479210,126400,64555,43401,1.1708473822668495,0.25559920141813064
1629,0.2007,35,140,35,479350,126260,64590,43366,1.169550557634592,0.25565656208364285
1630,0.2008,23,139,23,479489,126121,64613,43343,1.1682629960354218,0.255765236274371
1631,0.2009,33,100,33,479589,126021,64646,43310,1.1673366927266664,0.2557712409422965
1632,0.201,31,117,31,479706,125904,64677,43279,1.1662529178554226,0.25581175413605384
1633,0.2011,31,81,31,479787,125823,64708,43248,1.1655026121753307,0.2557978600706212
1634,0.2012,69,223,69,480010,125600,64777,43179,1.163436955796806,0.25583159042297915
1635,0.2013,33,143,33,480153,125457,64810,43146,1.162112342065286,0.2559029198768705
1636,0.2014,30,112,30,480265,125345,64840,43116,1.1610748823594799,0.25594054410219574
1637,0.2015,27,139,27,480404,125206,64867,43089,1.1597873207603098,0.256032561870525
1638,0.2016,24,108,24,480512,125098,64891,43065,1.158786913186854,0.25609081664813305
1639,0.2017,50,164,50,480676,124934,64941,43015,1.157267775760495,0.2561194172040322
1640,0.2018,43,180,43,480856,124754,64984,42972,1.1556004298047353,0.25620357010839107
1641,0.2019,35,114,35,480970,124640,65019,42937,1.1545444440327541,0.2562225126359823
1642,0.202,49,149,49,481119,124491,65068,42888,1.1531642521027086,0.25623286075314106
1643,0.2021,46,152,46,481271,124339,65114,42842,1.1517562710734002,0.25626117800467757
1644,0.2022,30,138,30,481409,124201,65144,42812,1.1504779725073178,0.25633932687874594
1645,0.2023,55,173,55,481582,124028,65199,42757,1.148875467783171,0.25635998441106816
1646,0.2024,30,112,30,481694,123916,65229,42727,1.147838008077365,0.2563984085740175
1647,0.2025,28,131,28,481825,123785,65257,42699,1.1466245507428952,0.2564750967059898
1648,0.2026,43,151,43,481976,123634,65300,42656,1.1452258327466747,0.25651572553971974
1649,0.2027,36,111,36,482087,123523,65336,42620,1.144197636073956,0.2565260047067887
1650,0.2028,37,138,37,482225,123385,65373,42583,1.1429193375078737,0.2565735563482117
1651,0.2029,44,186,44,482411,123199,65417,42539,1.1411964133535886,0.25666413254654935
1652,0.203,32,135,32,482546,123064,65449,42507,1.1399459038867688,0.25672974131943394
1653,0.2031,25,121,25,482667,122943,65474,42482,1.1388250768831747,0.2568051987305425
1654,0.2032,38,166,38,482833,122777,65512,42444,1.1372874133906405,0.25689228366854094
1655,0.2033,18,117,18,482950,122660,65530,42426,1.1362036385193968,0.256993324691373
1656,0.2034,33,128,33,483078,122532,65563,42393,1.1350179702841898,0.25704411095952706
1657,0.2035,46,178,46,483256,122354,65609,42347,1.1333691503946053,0.2571144073199313
1658,0.2036,25,103,25,483359,122251,65634,42322,1.132415057986587,0.2571624750110893
1659,0.2037,30,118,30,483477,122133,65664,42292,1.1313220200822558,0.25721149460240234
1660,0.2038,38,196,38,483673,121937,65702,42254,1.1295064655970952,0.25734662679440407
1661,0.2039,39,151,39,483824,121786,65741,42215,1.1281077476008745,0.2574069670306888
1662,0.204,24,92,24,483916,121694,65765,42191,1.1272555485568194,0.2574427189797724
1663,0.2041,19,115,19,484031,121579,65784,42172,1.1261902997517508,0.25753735855048215
1664,0.2042,28,94,28,484125,121485,65812,42144,1.1253195746415205,0.25755825678822214
1665,0.2043,57,186,57,484311,121299,65869,42087,1.1235966504872354,0.25759244978149903
1666,0.2044,39,155,39,484466,121144,65908,42048,1.1221608803586647,0.257659689200451
1667,0.2045,44,148,44,484614,120996,65952,42004,1.1207899514617066,0.25769325153374234
1668,0.2046,22,115,22,484729,120881,65974,41982,1.119724702656638,0.2577749396732223
1669,0.2047,39,166,39,484895,120715,66013,41943,1.118187039164104,0.2578600499206925
1670,0.2048,65,220,65,485115,120495,66078,41878,1.116149171884842,0.257912337642342
1671,0.2049,35,128,35,485243,120367,66113,41843,1.114963503649635,0.257955736391098
1672,0.205,36,171,36,485414,120196,66149,41807,1.1133795249916634,0.2580631222878589
1673,0.2051,30,142,30,485556,120054,66179,41777,1.1120641742932307,0.258152022789206
1674,0.2052,59,198,59,485754,119856,66238,41718,1.1102300937418947,0.25819748226818673
1675,0.2053,61,183,61,485937,119673,66299,41657,1.1085349586868725,0.2582098803694291
1676,0.2054,53,158,53,486095,119515,66352,41604,1.1070713994590389,0.2582190803071022
1677,0.2055,29,120,29,486215,119395,66381,41575,1.1059598354885323,0.2582779399888178
1678,0.2056,36,131,36,486346,119264,66417,41539,1.1047463781540627,0.2583222949820588
1679,0.2057,31,127,31,486473,119137,66448,41508,1.1035699729519435,0.25838339195119675
1680,0.2058,50,248,50,486721,118889,66498,41458,1.10127274074623,0.2585517658577959
1681,0.2059,50,181,50,486902,118708,66548,41408,1.0995961317573826,0.25861250593319846
1682,0.206,25,93,25,486995,118615,66573,41383,1.09873466968024,0.2586469830872886
1683,0.2061,31,110,31,487105,118505,66604,41352,1.0977157360406091,0.25868119631921027
1684,0.2062,27,88,27,487193,118417,66631,41325,1.0969005891289043,0.2586984011718897
1685,0.2063,49,175,49,487368,118242,66680,41276,1.0952795583385824,0.25875449792499905
1686,0.2064,48,197,48,487565,118045,66728,41228,1.0934547408203341,0.25885115493523697
1687,0.2065,46,221,46,487786,117824,66774,41182,1.0914076105079846,0.25899651585474764
1688,0.2066,29,102,29,487888,117722,66803,41153,1.0904627811330543,0.2590275373721479
1689,0.2067,48,188,48,488076,117534,66851,41105,1.088721330912594,0.25911030704933846
1690,0.2068,71,205,71,488281,117329,66922,41034,1.0868224091296455,0.2591135555653783
1691,0.2069,51,155,51,488436,117174,66973,40983,1.0853866390010745,0.2591285874163015
1692,0.207,18,104,18,488540,117070,66991,40965,1.084423283559969,0.259214730914038
1693,0.2071,60,194,60,488734,116876,67051,40905,1.0826262551409833,0.25925174767557563
1694,0.2072,49,180,49,488914,116696,67100,40856,1.0809589091852236,0.25931755864730377
1695,0.2073,43,147,43,489061,116549,67143,40813,1.0795972433213532,0.25935740521854067
1696,0.2074,58,224,58,489285,116325,67201,40755,1.077522323909741,0.25945378151260506
1697,0.2075,51,194,51,489479,116131,67252,40704,1.0757252954907555,0.2595339050594574
1698,0.2076,52,146,52,489625,115985,67304,40652,1.0743728926599725,0.25952999610564553
1699,0.2077,22,91,22,489716,115894,67326,40630,1.073529956649005,0.2595768061128006
1700,0.2078,37,151,37,489867,115743,67363,40593,1.0721312386527844,0.25965228738102547
1701,0.2079,35,159,35,490026,115584,67398,40558,1.0706584163918633,0.2597507397112884
1702,0.208,51,123,51,490149,115461,67449,40507,1.0695190633220941,0.259713530980714
1703,0.2081,36,98,36,490247,115363,67485,40471,1.0686112860795138,0.2597058408306275
1704,0.2082,32,118,32,490365,115245,67517,40439,1.0675182481751824,0.2597505202846792
1705,0.2083,34,135,34,490500,115110,67551,40405,1.0662677387083626,0.25981416583609296
1706,0.2084,60,200,60,490700,114910,67611,40345,1.064415132090852,0.2598628063508422
1707,0.2085,52,189,52,490889,114721,67663,40293,1.062664418837304,0.25993136103835784
1708,0.2086,65,258,65,491147,114463,67728,40228,1.0602745563007152,0.2600539139316444
1709,0.2087,47,136,47,491283,114327,67775,40181,1.0590147838008077,0.2600577316384912
1710,0.2088,45,155,45,491438,114172,67820,40136,1.057579013672237,0.260103170282811
1711,0.2089,50,216,50,491654,113956,67870,40086,1.0555781985253252,0.2602277300995832
1712,0.209,29,115,29,491769,113841,67899,40057,1.0545129497202563,0.2602827847015556
1713,0.2091,25,134,25,491903,113707,67924,40032,1.0532717032865242,0.2603893611900689
1714,0.2092,61,204,61,492107,113503,67985,39971,1.051382044536663,0.260441508007871
1715,0.2093,46,159,46,492266,113344,68031,39925,1.049909222275742,0.26048972721163444
1716,0.2094,41,156,41,492422,113188,68072,39884,1.0484641891140836,0.2605571234451761
1717,0.2095,61,204,61,492626,112984,68133,39823,1.0465745303642224,0.26060978881857505
1718,0.2096,61,208,61,492834,112776,68194,39762,1.0446478194820112,0.26066947252487904
1719,0.2097,34,114,34,492948,112662,68228,39728,1.04359183371003,0.2606995209659426
1720,0.2098,49,144,49,493092,112518,68277,39679,1.0422579569454222,0.26070816113326806
1721,0.2099,15,79,15,493171,112439,68292,39664,1.0415261773315054,0.26077066198562815
1722,0.21,46,143,46,493314,112296,68338,39618,1.0402015635999853,0.2607922903748173
1723,0.2101,37,118,37,493432,112178,68375,39581,1.0391085256956538,0.2608148445891183
1724,0.2102,54,189,54,493621,111989,68429,39527,1.0373578124421061,0.2608767390902611
1725,0.2103,31,127,31,493748,111862,68460,39496,1.0361814072399866,0.26094425137752875
1726,0.2104,29,176,29,493924,111686,68489,39467,1.034551113416577,0.261106296269343
1727,0.2105,70,207,70,494131,111479,68559,39397,1.0326336655674535,0.2611217158461253
1728,0.2106,27,108,27,494239,111371,68586,39370,1.0316332579939975,0.26117645497907005
1729,0.2107,35,143,35,494382,111228,68621,39335,1.0303086442624774,0.26125276462344665
1730,0.2108,65,249,65,494631,110979,68686,39270,1.0280021490236764,0.26136613222051397
1731,0.2109,19,107,19,494738,110872,68705,39251,1.027011004483308,0.26145893700498923
1732,0.211,32,123,32,494861,110749,68737,39219,1.0258716514135389,0.26151579003520753
1733,0.2111,48,193,48,495054,110556,68785,39171,1.0240838860276409,0.2616161413773067
1734,0.2112,48,187,48,495241,110369,68833,39123,1.0223516988402683,0.26170631204345385
1735,0.2113,41,149,41,495390,110220,68874,39082,1.0209715069102228,0.261764745281376
1736,0.2114,52,170,52,495560,110050,68926,39030,1.0193967912853386,0.26180574188355243
1737,0.2115,28,119,28,495679,109931,68954,39002,1.0182944903479194,0.26187614564938594
1738,0.2116,66,147,66,495826,109784,69020,38936,1.016932824484049,0.26180742334588486
1739,0.2117,74,210,74,496036,109574,69094,38862,1.0149875875356626,0.261809803551699
1740,0.2118,50,115,50,496151,109459,69144,38812,1.013922338730594,0.2617639322591741
1741,0.2119,52,192,52,496343,109267,69196,38760,1.0121438363777835,0.2618441230316091
1742,0.212,53,144,53,496487,109123,69249,38707,1.0108099596131757,0.2618345396739498
1743,0.2121,49,152,49,496639,108971,69298,38658,1.0094019785838675,0.2618591198206314
1744,0.2122,22,118,22,496757,108853,69320,38636,1.008308940679536,0.26195851894039557
1745,0.2123,55,146,55,496903,108707,69375,38581,1.0069565378487533,0.26194258866981696
1746,0.2124,43,139,43,497042,108568,69418,38538,1.0056689762495832,0.26197435862575286
1747,0.2125,71,223,71,497265,108345,69489,38467,1.0036033198710586,0.2620153665912868
1748,0.2126,56,150,56,497415,108195,69545,38411,1.0022138649079255,0.26200155518873713
1749,0.2127,40,89,40,497504,108106,69585,38371,1.001389454963133,0.2619592154399667
1750,0.2128,52,183,52,497687,107923,69637,38319,0.9996943199081108,0.2620245893792481
1751,0.2129,56,229,56,497916,107694,69693,38263,0.9975730853310608,0.2621525517789486
1752,0.213,39,147,39,498063,107547,69732,38224,0.9962114194671904,0.26221950868142496
1753,0.2131,69,205,69,498268,107342,69801,38155,0.9943124976842417,0.262239083967367
1754,0.2132,21,71,21,498339,107271,69822,38134,0.9936548223350253,0.2622605825109178
1755,0.2133,25,120,25,498459,107151,69847,38109,0.9925432583645188,0.2623502684840975
1756,0.2134,50,130,50,498589,107021,69897,38059,0.9913390640631369,0.2623311276537083
1757,0.2135,54,155,54,498744,106866,69951,38005,0.9899032939345659,0.26233683760034787
1758,0.2136,32,101,32,498845,106765,69983,37973,0.988967727592723,0.2623568102364272
1759,0.2137,36,129,36,498974,106636,70019,37937,0.9877727963244285,0.2624072267989182
1760,0.2138,72,226,72,499200,106410,70091,37865,0.9856793508466413,0.2624501819442038
1761,0.2139,50,212,50,499412,106198,70141,37815,0.9837155878320797,0.26258046148611586
1762,0.214,44,153,44,499565,106045,70185,37771,0.982298343769684,0.26263419925460313
1763,0.2141,32,125,32,499690,105920,70217,37739,0.9811404646337397,0.26269847346842173
1764,0.2142,37,155,37,499845,105765,70254,37702,0.9797046945051687,0.26279214035283377
1765,0.2143,35,138,35,499983,105627,70289,37667,0.9784263959390863,0.2628651583457786
1766,0.2144,51,211,51,500194,105416,70340,37616,0.9764718959576124,0.2629901001174562
1767,0.2145,30,124,30,500318,105292,70370,37586,0.9753232798547556,0.26306359271546353
1768,0.2146,53,158,53,500476,105134,70423,37533,0.973859720626922,0.2630811610253247
1769,0.2147,36,143,36,500619,104991,70459,37497,0.9725351068954018,0.26315900286339905
1770,0.2148,45,146,45,500765,104845,70504,37452,0.9711827040646189,0.2631959914826033
1771,0.2149,30,141,30,500906,104704,70534,37422,0.9698766163992738,0.2633015774735094
1772,0.215,36,178,36,501084,104526,70570,37386,0.9682277965096892,0.2634449518011162
1773,0.2151,39,130,39,501214,104396,70609,37347,0.9670236022083071,0.26348391102206103
1774,0.2152,56,243,56,501457,104153,70665,37291,0.9647726851680314,0.263644976103617
1775,0.2153,42,186,42,501643,103967,70707,37249,0.9630497610137463,0.26377322682982096
1776,0.2154,65,138,65,501781,103829,70772,37184,0.9617714624476639,0.2636920000283662
1777,0.2155,52,176,52,501957,103653,70824,37132,0.9601411686242544,0.2637496892424619
1778,0.2156,33,141,33,502098,103512,70857,37099,0.9588350809589092,0.26384137798607504
1779,0.2157,52,162,52,502260,103350,70909,37047,0.9573344695987254,0.2638731596828992
1780,0.2158,43,155,43,502415,103195,70952,37004,0.9558986994701545,0.2639391151149438
1781,0.2159,43,125,43,502540,103070,70995,36961,0.9547408203342103,0.2639486970742193
1782,0.216,61,207,61,502747,102863,71056,36900,0.9528233724850865,0.2640183739616351
1783,0.2161,50,183,50,502930,102680,71106,36850,0.9511282374300641,0.2641009101985236
1784,0.2162,39,208,39,503138,102472,71145,36811,0.9492015265478528,0.26428925281620874
1785,0.2163,32,153,32,503291,102319,71177,36779,0.947784282485457,0.26441070324519406
1786,0.2164,38,148,38,503439,102171,71215,36741,0.946413353588499,0.26449118866620597
1787,0.2165,35,107,35,503546,102064,71250,36706,0.9454222090481307,0.2645096202349211
1788,0.2166,50,183,50,503729,101881,71300,36656,0.9437270739931083,0.2645935742797953
1789,0.2167,50,198,50,503927,101683,71350,36606,0.9418929934417726,0.2647065204029243
1790,0.2168,47,217,47,504144,101466,71397,36559,0.9398829152617734,0.26487230574171344
1791,0.2169,44,120,44,504264,101346,71441,36515,0.9387713512912668,0.2648682368472592
1792,0.217,46,173,46,504437,101173,71487,36469,0.93716884656712,0.26495546417517907
1793,0.2171,29,113,29,504550,101060,71516,36440,0.9361221238282263,0.2650181818181818
1794,0.2172,53,221,53,504771,100839,71569,36387,0.9340749935158769,0.2651611210703511
1795,0.2173,46,148,46,504919,100691,71615,36341,0.9327040646189189,0.26520082900344444
1796,0.2174,54,156,54,505075,100535,71669,36287,0.9312590314572604,0.26521319670813176
1797,0.2175,40,164,40,505239,100371,71709,36247,0.9297398940309015,0.265316429753034
1798,0.2176,59,248,59,505487,100123,71768,36188,0.9274426618251881,0.26548114238762827
1799,0.2177,23,129,23,505616,99994,71791,36165,0.9262477305568936,0.2656085899573293
1800,0.2178,67,221,67,505837,99773,71858,36098,0.9242006002445441,0.26567847443530995
1801,0.2179,70,219,70,506056,99554,71928,36028,0.9221719959983697,0.26572848903246743
1802,0.218,31,150,31,506206,99404,71959,35997,0.9207825410352366,0.2658547573503888
1803,0.2181,37,119,37,506325,99285,71996,35960,0.9196802400978177,0.26588783319161524
1804,0.2182,38,111,38,506436,99174,72034,35922,0.9186520434250991,0.26589980458340734
1805,0.2183,56,210,56,506646,98964,72090,35866,0.9167068064767128,0.26600904843135803
1806,0.2184,48,163,48,506809,98801,72138,35818,0.9151969320834414,0.26606942556399915
1807,0.2185,71,289,71,507098,98512,72209,35747,0.9125199155211382,0.2662540313870951
1808,0.2186,37,129,37,507227,98383,72246,35710,0.9113249842528438,0.2663077118119514
1809,0.2187,24,134,24,507361,98249,72270,35686,0.9100837378191114,0.2664426774181506
1810,0.2188,56,174,56,507535,98075,72326,35630,0.9084719700618771,0.2664821809206836
1811,0.2189,41,171,41,507706,97904,72367,35589,0.9068879914039053,0.26659824859730474
1812,0.219,49,186,49,507892,97718,72416,35540,0.9051650672496202,0.26670068588752643
1813,0.2191,73,242,73,508134,97476,72489,35467,0.9029234132424321,0.266783508721783
1814,0.2192,40,189,40,508323,97287,72529,35427,0.9011726999888844,0.2669424476694245
1815,0.2193,45,137,45,508460,97150,72574,35382,0.8999036644558894,0.26696948661455344
1816,0.2194,53,177,53,508637,96973,72627,35329,0.8982641075993923,0.2670330002569878
1817,0.2195,38,153,38,508790,96820,72665,35291,0.8968468635369966,0.2671314273603258
1818,0.2196,40,157,40,508947,96663,72705,35251,0.8953925673422506,0.2672271328289643
1819,0.2197,45,146,45,509093,96517,72750,35206,0.8940401645114676,0.2672729895310614
1820,0.2198,61,193,61,509286,96324,72811,35145,0.8922523991255696,0.2673253770850923
1821,0.2199,64,190,64,509476,96134,72875,35081,0.8904924228389344,0.26735510421826775
1822,0.22,45,157,45,509633,95977,72920,35036,0.8890381266441884,0.2674238434353843
1823,0.2201,48,147,48,509780,95830,72968,34988,0.8876764607803179,0.2674555489305753
1824,0.2202,37,141,37,509921,95689,73005,34951,0.8863703731149728,0.2675367421922841
1825,0.2203,52,209,52,510130,95480,73057,34899,0.8844343991996739,0.2676734750228181
1826,0.2204,38,137,38,510267,95343,73095,34861,0.883165363666679,0.2677413904334736
1827,0.2205,53,165,53,510432,95178,73148,34808,0.8816369632072326,0.2677826842890773
1828,0.2206,44,140,44,510572,95038,73192,34764,0.880340138574975,0.26782330010323413
1829,0.2207,45,156,45,510728,94882,73237,34719,0.8788951054133165,0.2678914514548499
1830,0.2208,35,93,35,510821,94789,73272,34684,0.878033643336174,0.2678859685030856
1831,0.2209,29,147,29,510968,94642,73301,34655,0.8766719774723035,0.2680263269836114
1832,0.221,77,257,77,511225,94385,73378,34578,0.8742913779688021,0.26812341524313177
1833,0.2211,41,184,41,511409,94201,73419,34537,0.8725869798806921,0.26827354782581675
1834,0.2212,33,119,33,511528,94082,73452,34504,0.8714846789432732,0.268334033254009
1835,0.2213,60,230,60,511758,93852,73512,34444,0.8693541813331357,0.2684729064039409
1836,0.2214,50,177,50,511935,93675,73562,34394,0.8677146244766386,0.2685583552616168
1837,0.2215,37,178,37,512113,93497,73599,34357,0.866065804587054,0.26872057190232607
1838,0.2216,63,148,63,512261,93349,73662,34294,0.864694875690096,0.268671215812853
1839,0.2217,58,226,58,512487,93123,73720,34236,0.8626014302123087,0.26881492474030105
1840,0.2218,47,131,47,512618,92992,73767,34189,0.8613879728778391,0.26882160071079797
1841,0.2219,71,250,71,512868,92742,73838,34118,0.8590722146059506,0.2689421409427716
1842,0.222,39,170,39,513038,92572,73877,34079,0.8574974989810663,0.26907801754427524
1843,0.2221,46,194,46,513232,92378,73923,34033,0.8557004705620809,0.26922498833171166
1844,0.2222,29,124,29,513356,92254,73952,34004,0.8545518544592241,0.2693215479415166
1845,0.2223,86,225,86,513581,92029,74038,33918,0.8524676720145244,0.2693037547539838
1846,0.2224,47,151,47,513732,91878,74085,33871,0.8510689540183037,0.26935403064835506
1847,0.2225,61,216,61,513948,91662,74146,33810,0.8490681388713921,0.2694625095638868
1848,0.2226,42,111,42,514059,91551,74188,33768,0.8480399421986735,0.26945634740143154
1849,0.2227,49,148,49,514207,91403,74237,33719,0.8466690133017155,0.26948897875673344
1850,0.2228,53,132,53,514339,91271,74290,33666,0.8454462929341584,0.2694638097601191
1851,0.2229,65,160,65,514499,91111,74355,33601,0.8439642076401497,0.269428763871961
1852,0.223,46,176,46,514675,90935,74401,33555,0.8423339138167402,0.2695397220660294
1853,0.2231,34,143,34,514818,90792,74435,33521,0.8410093000852199,0.26964999638010506
1854,0.2232,50,170,50,514988,90622,74485,33471,0.8394345844603357,0.26972512551070565
1855,0.2233,62,134,62,515122,90488,74547,33409,0.8381933380266035,0.26965140398879717
1856,0.2234,61,226,61,515348,90262,74608,33348,0.8360998925488162,0.2697839980584095
1857,0.2235,99,296,99,515644,89966,74707,33249,0.8333580347549001,0.2698453922006249
1858,0.2236,46,210,46,515854,89756,74753,33203,0.8314127978065138,0.27003310046438245
1859,0.2237,49,121,49,515975,89635,74802,33154,0.8302919708029197,0.2700078997304319
1860,0.2238,39,117,39,516092,89518,74841,33115,0.8292081959316758,0.27003335154485336
1861,0.2239,61,208,61,516300,89310,74902,33054,0.8272814850494646,0.27012846915759536
1862,0.224,62,211,62,516511,89099,74964,32992,0.8253269850679906,0.2702246684849825
1863,0.2241,45,179,45,516690,88920,75009,32947,0.8236689021453185,0.27035210516382613
1864,0.2242,63,211,63,516901,88709,75072,32884,0.8217144021638445,0.27044319985525483
1865,0.2243,39,160,39,517061,88549,75111,32845,0.8202323168698359,0.2705652668171409
1866,0.2244,50,174,50,517235,88375,75161,32795,0.8186205491126014,0.2706528018486424
1867,0.2245,70,247,70,517482,88128,75231,32725,0.8163325799399755,0.2707835138556759
1868,0.2246,65,228,65,517710,87900,75296,32660,0.8142206083960132,0.27090245520902456
1869,0.2247,24,84,24,517794,87816,75320,32636,0.8134425136166586,0.2709461030119882
1870,0.2248,63,208,63,518002,87608,75383,32573,0.8115158027344473,0.2710328587713532
1871,0.2249,36,195,36,518197,87413,75419,32537,0.8097095112823743,0.27125468945393916
1872,0.225,51,150,51,518347,87263,75470,32486,0.8083200563192412,0.2712841025812324
1873,0.2251,69,216,69,518563,87047,75539,32417,0.8063192411723294,0.27135371325252794
1874,0.2252,50,184,50,518747,86863,75589,32367,0.8046148430842195,0.2714669126897593
1875,0.2253,46,148,46,518895,86715,75635,32321,0.8032439141872615,0.271522900635102
1876,0.2254,55,161,55,519056,86554,75690,32266,0.8017525658601653,0.27155361050328225
1877,0.2255,47,146,47,519202,86408,75737,32219,0.8004001630293823,0.27159921434412065
1878,0.2256,62,152,62,519354,86256,75799,32157,0.7989921820000742,0.2715664665197233
1879,0.2257,51,173,51,519527,86083,75850,32106,0.7973896772759272,0.2716496459061334
1880,0.2258,70,254,70,519781,85829,75920,32036,0.7950368668716885,0.2718024858948797
1881,0.2259,50,136,50,519917,85693,75970,31986,0.7937770943717811,0.2718072043440206
1882,0.226,43,124,43,520041,85569,76013,31943,0.7926284782689244,0.27182755803662606
1883,0.2261,45,133,45,520174,85436,76058,31898,0.7913964948682797,0.2718564099067619
1884,0.2262,73,282,73,520456,85154,76131,31825,0.7887843195375894,0.2720573778199506
1885,0.2263,52,141,52,520597,85013,76183,31773,0.7874782318722442,0.2720617197266796
1886,0.2264,52,169,52,520766,84844,76235,31721,0.7859127792804476,0.2721314288165401
1887,0.2265,83,185,83,520951,84659,76318,31638,0.78419911815925,0.2720448506840245
1888,0.2266,58,147,58,521098,84512,76376,31580,0.7828374522953796,0.27202563484133274
1889,0.2267,59,212,59,521310,84300,76435,31521,0.7808736892808181,0.27215271841893957
1890,0.2268,54,142,54,521452,84158,76489,31467,0.7795583385823854,0.27214702702702703
1891,0.2269,48,146,48,521598,84012,76537,31419,0.7782059357516025,0.2721885801907633
1892,0.227,43,189,43,521787,83823,76580,31376,0.7764552224980548,0.2723634753773904
1893,0.2271,45,140,45,521927,83683,76625,31331,0.7751583978657972,0.2724103152659676
1894,0.2272,60,188,60,522115,83495,76685,31271,0.773416947645337,0.27247616890019694
1895,0.2273,57,136,57,522251,83359,76742,31214,0.7721571751454296,0.2724376598325958
1896,0.2274,66,234,66,522485,83125,76808,31148,0.7699896254029419,0.27257532400479556
1897,0.2275,79,209,79,522694,82916,76887,31069,0.7680536514876432,0.2725709523182875
1898,0.2276,45,145,45,522839,82771,76932,31024,0.7667105116899477,0.27263060767169034
1899,0.2277,63,151,63,522990,82620,76995,30961,0.765311793693727,0.27258960565587553
1900,0.2278,49,247,49,523237,82373,77044,30912,0.7630238245211012,0.27286931191243324
1901,0.2279,49,111,49,523348,82262,77093,30863,0.7619956278483827,0.2728220994475138
1902,0.228,68,184,68,523532,82078,77161,30795,0.7602912297602727,0.2728287544408317
1903,0.2281,56,207,56,523739,81871,77217,30739,0.758373781911149,0.27296865287274663
1904,0.2282,51,148,51,523887,81723,77268,30688,0.757002853014191,0.2729981941269093
1905,0.2283,34,149,34,524036,81574,77302,30654,0.7556226610841454,0.2731403927718573
1906,0.2284,43,162,43,524198,81412,77345,30611,0.7541220497239616,0.27325638484953985
1907,0.2285,45,177,45,524375,81235,77390,30566,0.7524824928674645,0.2733964812479316
1908,0.2286,47,179,47,524554,81056,77437,30519,0.7508244099447923,0.27352901635671073
1909,0.2287,41,164,41,524718,80892,77478,30478,0.7493052725184335,0.27366436203645506
1910,0.2288,39,120,39,524838,80772,77517,30439,0.7481937085479269,0.2737049392596056
1911,0.2289,46,174,46,525012,80598,77563,30393,0.7465819407906925,0.2738330134875801
1912,0.229,37,116,37,525128,80482,77600,30356,0.7455074289525362,0.27387719013334777
1913,0.2291,55,141,55,525269,80341,77655,30301,0.7442013412871911,0.2738652591240216
1914,0.2292,43,152,43,525421,80189,77698,30258,0.7427933602578829,0.2739594556665188
1915,0.2293,67,170,67,525591,80019,77765,30191,0.7412186446329986,0.27394065874240087
1916,0.2294,59,215,59,525806,79804,77824,30132,0.7392270925191745,0.27408674137680106
1917,0.2295,41,168,41,525974,79636,77865,30091,0.7376709029604653,0.27423514722903203
1918,0.2296,43,131,43,526105,79505,77908,30048,0.7364574456259958,0.2742782032440919
1919,0.2297,68,183,68,526288,79322,77976,29980,0.7347623105709734,0.27428592340487823
1920,0.2298,61,181,61,526469,79141,78037,29919,0.733085701582126,0.27433522831468915
1921,0.2299,64,213,64,526682,78928,78101,29855,0.731112675534477,0.27444545563185424
1922,0.23,42,149,42,526831,78779,78143,29813,0.7297324836044314,0.27454140268159716
1923,0.2301,51,179,51,527010,78600,78194,29762,0.7280744006817592,0.2746534763108839
1924,0.2302,47,118,47,527128,78482,78241,29715,0.7269813627774279,0.2746379289629102
1925,0.2303,23,95,23,527223,78387,78264,29692,0.7261013746341102,0.27472496969809124
1926,0.2304,74,209,74,527432,78178,78338,29618,0.7241654007188114,0.27475973134439124
1927,0.2305,93,216,93,527648,77962,78431,29525,0.7221645855718997,0.27468438043670396
1928,0.2306,46,166,46,527814,77796,78477,29479,0.7206269220793656,0.2747984152878117
1929,0.2307,80,253,80,528067,77543,78557,29399,0.7182833747082145,0.27490602382599916
1930,0.2308,64,233,64,528300,77310,78621,29335,0.7161250879988144,0.2750714988982137
1931,0.2309,41,149,41,528449,77161,78662,29294,0.7147448960687688,0.275177304964539
1932,0.231,72,217,72,528666,76944,78734,29222,0.7127348178887695,0.2752481962210124
1933,0.2311,55,206,55,528872,76738,78789,29167,0.7108266330727333,0.2754072045701336
1934,0.2312,33,102,33,528974,76636,78822,29134,0.7098818036978028,0.2754467240238253
1935,0.2313,39,128,39,529102,76508,78861,29095,0.7086961354625959,0.27551300625929187
1936,0.2314,60,163,60,529265,76345,78921,29035,0.7071862610693246,0.2755266654014044
1937,0.2315,63,214,63,529479,76131,78984,28972,0.705203971988588,0.2756534066582305
1938,0.2316,55,183,55,529662,75948,79039,28917,0.7035088369335655,0.2757545415534258
1939,0.2317,54,145,54,529807,75803,79093,28863,0.7021656971358702,0.2757629029484264
1940,0.2318,38,132,38,529939,75671,79131,28825,0.700942976768313,0.2758478793446639
1941,0.2319,44,145,44,530084,75526,79175,28781,0.6995998369706177,0.2759258726643466
1942,0.232,49,164,49,530248,75362,79224,28732,0.6980806995442588,0.27601975137856166
1943,0.2321,49,113,49,530361,75249,79273,28683,0.6970339768053652,0.27597852441981297
1944,0.2322,64,201,64,530562,75048,79337,28619,0.6951721071547667,0.27606663644168344
1945,0.2323,27,137,27,530699,74911,79364,28592,0.6939030716217718,0.2762432006801735
1946,0.2324,41,134,41,530833,74777,79405,28551,0.6926618251880395,0.2763142613812326
1947,0.2325,63,219,63,531052,74558,79468,28488,0.6906332209418652,0.2764590571201211
1948,0.2326,44,134,44,531186,74424,79512,28444,0.6893919745081329,0.27650970175370376
1949,0.2327,48,154,48,531340,74270,79560,28396,0.6879654674126496,0.2765862115987766
1950,0.2328,36,140,36,531480,74130,79596,28360,0.686668642780392,0.2767099229193092
1951,0.2329,59,159,59,531639,73971,79655,28301,0.6851958205194709,0.2767228566958698
1952,0.233,48,146,48,531785,73825,79703,28253,0.683843417688688,0.2767785418993319
1953,0.2331,46,111,46,531896,73714,79749,28207,0.6828152210159695,0.27675356403488977
1954,0.2332,28,121,28,532017,73593,79777,28179,0.6816943940123754,0.2768836222143615
1955,0.2333,59,180,59,532197,73413,79836,28120,0.6800270480566156,0.27695429072321315
1956,0.2334,53,191,53,532388,73222,79889,28067,0.6782578087368928,0.2770982041485255
1957,0.2335,59,189,59,532577,73033,79948,28008,0.6765070954833451,0.2771944062311339
1958,0.2336,50,140,50,532717,72893,79998,27958,0.6752102708510875,0.27722085056171974
1959,0.2337,46,151,46,532868,72742,80044,27912,0.6738115528548668,0.2773064160391043
1960,0.2338,62,152,62,533020,72590,80106,27850,0.6724035718255585,0.2772799681401832
1961,0.2339,48,130,48,533150,72460,80154,27802,0.6711993775241765,0.27729349105344
1962,0.234,34,130,34,533280,72330,80188,27768,0.6699951832227945,0.2774081400227777
1963,0.2341,49,128,49,533408,72202,80237,27719,0.6688095149875876,0.27740915323105253
1964,0.2342,76,194,76,533602,72008,80313,27643,0.667012486568602,0.27739811943683457
1965,0.2343,54,150,54,533752,71858,80367,27589,0.6656230316054689,0.2774241555803594
1966,0.2344,61,175,61,533927,71683,80428,27528,0.6640020008151469,0.27746923224239245
1967,0.2345,65,157,65,534084,71526,80493,27463,0.6625477046204009,0.27743486650031823
1968,0.2346,36,116,36,534200,71410,80529,27427,0.6614731927822446,0.2774972935236804
1969,0.2347,56,158,56,534358,71252,80585,27371,0.660009633554411,0.2775316102734656
1970,0.2348,54,132,54,534490,71120,80639,27317,0.6587869131868539,0.2775074413076384
1971,0.2349,55,155,55,534645,70965,80694,27262,0.657351143058283,0.27754079835483114
1972,0.235,35,159,35,534804,70806,80729,27227,0.6558783207973619,0.2777330082727245
1973,0.2351,64,233,64,535037,70573,80793,27163,0.6537200340879618,0.2779221576491774
1974,0.2352,65,195,65,535232,70378,80858,27098,0.6519137426358887,0.27799663506914524
1975,0.2353,27,105,27,535337,70273,80885,27071,0.6509411241616955,0.27809623602892836
1976,0.2354,40,116,40,535453,70157,80925,27031,0.6498666123235393,0.2781310449849776
1977,0.2355,68,198,68,535651,69959,80993,26963,0.6480325317722034,0.2781927735705
1978,0.2356,52,141,52,535792,69818,81045,26911,0.6467264441068583,0.27821025752359685
1979,0.2357,51,150,51,535942,69668,81096,26860,0.6453369891437252,0.27826122990220453
1980,0.2358,36,137,36,536079,69531,81132,26824,0.6440679536107303,0.2783872139484199
1981,0.2359,63,139,63,536218,69392,81195,26761,0.6427803920115602,0.2783168491882729
1982,0.236,59,128,59,536346,69264,81254,26702,0.6415947237763533,0.2782443782172853
1983,0.2361,53,160,53,536506,69104,81307,26649,0.6401126384823447,0.2783098179691498
1984,0.2362,39,111,39,536617,68993,81346,26610,0.6390844418096261,0.27833854586153156
1985,0.2363,63,181,63,536798,68812,81409,26547,0.6374078328207788,0.27839008378863034
1986,0.2364,54,144,54,536942,68668,81463,26493,0.636073956056171,0.27840186631077857
1987,0.2365,41,132,41,537074,68536,81504,26452,0.6348512356886139,0.27847728134080096
1988,0.2366,67,211,67,537285,68325,81571,26385,0.63289673570714,0.27858726639214443
1989,0.2367,49,144,49,537429,68181,81620,26336,0.6315628589425322,0.2786377053863326
1990,0.2368,94,241,94,537670,67940,81714,26242,0.6293304679684316,0.27863073623409995
1991,0.2369,39,154,39,537824,67786,81753,26203,0.6279039608729482,0.27878794326995715
1992,0.237,34,99,34,537923,67687,81787,26169,0.6269869205972803,0.2788207466757586
1993,0.2371,40,114,40,538037,67573,81827,26129,0.6259309348252992,0.2788521056114064
1994,0.2372,43,118,43,538155,67455,81870,26086,0.6248378969209678,0.27887236612822186
1995,0.2373,70,178,70,538333,67277,81940,26016,0.6231890770313832,0.27886336595457323
1996,0.2374,52,174,52,538507,67103,81992,25964,0.6215773092741488,0.2789818088044097
1997,0.2375,56,130,56,538637,66973,82048,25908,0.6203731149727667,0.2789375652716917
1998,0.2376,43,147,43,538784,66826,82091,25865,0.6190114491088963,0.27904543051644715
1999,0.2377,28,133,28,538917,66693,82119,25837,0.6177794657082515,0.2792283583702583
2000,0.2378,39,130,39,539047,66563,82158,25798,0.6165752714068695,0.2793170277498078
2001,0.2379,43,163,43,539210,66400,82201,25755,0.6150653970135981,0.2794747978948511
2002,0.238,52,223,52,539433,66177,82253,25703,0.6129997406350736,0.279745319982586
2003,0.2381,42,122,42,539555,66055,82295,25661,0.6118696505983919,0.27978760521610185
2004,0.2382,36,100,36,539655,65955,82331,25625,0.6109433472896365,0.27981000218388297
2005,0.2383,37,122,37,539777,65833,82368,25588,0.6098132572529549,0.27989192855033307
2006,0.2384,87,192,87,539969,65641,82455,25501,0.6080347549001445,0.27979416734326656
2007,0.2385,39,126,39,540095,65515,82494,25462,0.6068676127311127,0.27987293491761656
2008,0.2386,53,159,53,540254,65356,82547,25409,0.6053947904701915,0.2799427091940726
2009,0.2387,47,109,47,540363,65247,82594,25362,0.6043851198636482,0.2799059696056683
2010,0.2388,47,130,47,540493,65117,82641,25315,0.6031809255622661,0.2799340941259731
2011,0.2389,32,107,32,540600,65010,82673,25283,0.6021897810218978,0.2800106320534261
2012,0.239,63,231,63,540831,64779,82736,25220,0.6000500203786728,0.2802253358370649
2013,0.2391,55,191,55,541022,64588,82791,25165,0.59828078105895,0.28038060009136184
2014,0.2392,38,152,38,541174,64436,82829,25127,0.5968728000296417,0.2805511204403604
2015,0.2393,53,124,53,541298,64312,82882,25074,0.595724183926785,0.280513726981854
2016,0.2394,37,144,37,541442,64168,82919,25037,0.5943903071621772,0.2806681239840816
2017,0.2395,84,251,84,541693,63917,83003,24953,0.5920652858572011,0.2807809159446382
2018,0.2396,43,132,43,541825,63785,83046,24910,0.590842565489644,0.2808501042899825
2019,0.2397,38,115,38,541940,63670,83084,24872,0.5897773166845752,0.2809062365882858
2020,0.2398,49,147,49,542087,63523,83133,24823,0.5884156508207047,0.2809748036130668
2021,0.2399,29,85,29,542172,63438,83162,24794,0.5876282930082626,0.2810091576752199
2022,0.24,26,103,26,542275,63335,83188,24768,0.5866742006002446,0.2811255008342508
2023,0.2401,34,96,34,542371,63239,83222,24734,0.5857849494238393,0.28115444511384174
2024,0.2402,72,223,72,542594,63016,83294,24662,0.5837192930453148,0.28127922625972307
2025,0.2403,54,173,54,542767,62843,83348,24608,0.5821167883211679,0.2813918651587746
2026,0.2404,40,91,40,542858,62752,83388,24568,0.5812738523102005,0.28135593220338984
2027,0.2405,29,126,29,542984,62626,83417,24539,0.5801067101411687,0.2815235472953594
2028,0.2406,29,121,29,543105,62505,83446,24510,0.5789858831375746,0.28167557317703845
2029,0.2407,37,125,37,543230,62380,83483,24473,0.5778280040016303,0.2817749530816437
2030,0.2408,47,181,47,543411,62199,83530,24426,0.576151395012783,0.281974025974026
2031,0.2409,78,174,78,543585,62025,83608,24348,0.5745396272555485,0.28189364732034317
2032,0.241,47,138,47,543723,61887,83655,24301,0.5732613286894661,0.28195340418619763
2033,0.2411,47,86,47,543809,61801,83702,24254,0.5724647078439364,0.2818430073790018
2034,0.2412,55,186,55,543995,61615,83757,24199,0.5707417836896513,0.28199361409560214
2035,0.2413,28,75,28,544070,61540,83785,24171,0.5700470562080848,0.2820058102227252
2036,0.2414,68,170,68,544240,61370,83853,24103,0.5684723405832005,0.28199548395399715
2037,0.2415,43,106,43,544346,61264,83896,24060,0.5674904590759198,0.2819839669963902
2038,0.2416,26,104,26,544450,61160,83922,24034,0.5665271036348142,0.2821090687137592
2039,0.2417,57,149,57,544599,61011,83979,23977,0.5651469117047686,0.2821221819550995
2040,0.2418,43,166,43,544765,60845,84022,23934,0.5636092482122346,0.2823104778305948
2041,0.2419,39,122,39,544887,60723,84061,23895,0.562479158175553,0.282386726228462
2042,0.242,50,161,50,545048,60562,84111,23845,0.5609878098484568,0.2825002665655692
2043,0.2421,80,189,80,545237,60373,84191,23765,0.5592370965949091,0.2824526373339038
2044,0.2422,66,174,66,545411,60199,84257,23699,0.5576253288376746,0.2824739564709528
2045,0.2423,41,130,41,545541,60069,84298,23658,0.5564211345362926,0.28256118098104555
2046,0.2424,40,113,40,545654,59956,84338,23618,0.555374411797399,0.2825998516284969
2047,0.2425,43,147,43,545801,59809,84381,23575,0.5540127459335284,0.28272810131440085
2048,0.2426,49,170,49,545971,59639,84430,23526,0.5524380303086442,0.2828834245175254
2049,0.2427,45,142,45,546113,59497,84475,23481,0.5511226796102116,0.2829786208392586
2050,0.2428,39,101,39,546214,59396,84514,23442,0.5501871132683686,0.28298606919529684
2051,0.2429,40,126,40,546340,59270,84554,23402,0.5490199710993368,0.2830704470679311
2052,0.243,49,161,49,546501,59109,84603,23353,0.5475286227722406,0.283197108971405
2053,0.2431,60,162,60,546663,58947,84663,23293,0.5460280114120568,0.2832320038910506
2054,0.2432,30,96,30,546759,58851,84693,23263,0.5451387602356516,0.28330126409625644
2055,0.2433,63,151,63,546910,58700,84756,23200,0.5437400422394308,0.28327228327228327
2056,0.2434,53,179,53,547089,58521,84809,23147,0.5420819593167587,0.2834280256648871
2057,0.2435,62,219,62,547308,58302,84871,23085,0.5400533550705843,0.283644808138892
2058,0.2436,64,174,64,547482,58128,84935,23021,0.5384415873133499,0.28368803065965076
2059,0.2437,53,137,53,547619,57991,84988,22968,0.537172551780355,0.2836991563630974
2060,0.2438,43,121,43,547740,57870,85031,22925,0.5360517247767609,0.2837428058666997
2061,0.2439,48,116,48,547856,57754,85079,22877,0.5349772129386046,0.28372462204363086
2062,0.244,26,80,26,547936,57674,85105,22851,0.5342361702916003,0.2837752250853772
2063,0.2441,44,146,44,548082,57528,85149,22807,0.5328837674608173,0.28389867430136306
2064,0.2442,60,179,60,548261,57349,85209,22747,0.5312256845381451,0.28399670395525367
2065,0.2443,57,179,57,548440,57170,85266,22690,0.529567601615473,0.28412221387428
2066,0.2444,42,124,42,548564,57046,85308,22648,0.5284189855126162,0.2841870153336512
2067,0.2445,49,148,49,548712,56898,85357,22599,0.5270480566156582,0.28427487829729425
2068,0.2446,40,102,40,548814,56796,85397,22559,0.5261032272407277,0.2842795034969441
2069,0.2447,46,100,46,548914,56696,85443,22513,0.5251769239319722,0.2842227524649977
2070,0.2448,52,187,52,549101,56509,85495,22461,0.5234447367445997,0.2844244649867038
2071,0.2449,66,174,66,549275,56335,85561,22395,0.5218329689873652,0.2844531944620856
2072,0.245,26,82,26,549357,56253,85587,22369,0.5210734002741858,0.28451324056879757
2073,0.2451,55,170,55,549527,56083,85642,22314,0.5194986846493016,0.28462823832544615
2074,0.2452,42,149,42,549676,55934,85684,22272,0.518118492719256,0.2847863335293967
2075,0.2453,55,176,55,549852,55758,85739,22217,0.5164881988958464,0.28492465533824946
2076,0.2454,15,63,15,549915,55695,85754,22202,0.5159046278113305,0.2850173947648818
2077,0.2455,52,109,52,550024,55586,85806,22150,0.5148949572047872,0.2849387671091901
2078,0.2456,71,174,71,550198,55412,85877,22079,0.5132831894475527,0.2849234104605696
2079,0.2457,28,107,28,550305,55305,85905,22051,0.5122920449071844,0.2850586896943999
2080,0.2458,32,110,32,550415,55195,85937,22019,0.5112731112675535,0.28516849276038025
2081,0.2459,30,106,30,550521,55089,85967,21989,0.5102912297602727,0.2852824411634967
2082,0.246,28,117,28,550638,54972,85995,21961,0.5092074548890289,0.28545617615327623
2083,0.2461,51,165,51,550803,54807,86046,21910,0.5076790544295824,0.28559510929780885
2084,0.2462,47,135,47,550938,54672,86093,21863,0.5064285449627626,0.2856601554844189
2085,0.2463,89,235,89,551173,54437,86182,21774,0.5042517321871873,0.2857067877340541
2086,0.2464,54,163,54,551336,54274,86236,21720,0.502741857793916,0.2858120377924573
2087,0.2465,47,191,47,551527,54083,86283,21673,0.5009726184741932,0.2860895506626538
2088,0.2466,57,93,57,551620,53990,86340,21616,0.5001111563970506,0.2859032351929741
2089,0.2467,27,99,27,551719,53891,86367,21589,0.49919411612138276,0.28602278749337573
2090,0.2468,62,149,62,551868,53742,86429,21527,0.4978139241913372,0.28600087685501335
2091,0.2469,83,213,83,552081,53529,86512,21444,0.49584089814368815,0.2860229682685767
2092,0.247,38,149,38,552230,53380,86550,21406,0.4944607062136426,0.286230043056187
2093,0.2471,43,127,43,552357,53253,86593,21363,0.4932843010115232,0.28630588613702157
2094,0.2472,54,129,54,552486,53124,86647,21309,0.4920893697432287,0.28628430937890453
2095,0.2473,30,105,30,552591,53019,86677,21279,0.49111675126903553,0.2864007106516999
2096,0.2474,47,142,47,552733,52877,86724,21232,0.48980140057060284,0.2864969167037742
2097,0.2475,23,146,23,552879,52731,86747,21209,0.4884489977398199,0.2868406816337571
2098,0.2476,46,136,46,553015,52595,86793,21163,0.48718922523991254,0.28692480815640337
2099,0.2477,26,108,26,553123,52487,86819,21137,0.4861888176664567,0.2870938824296425
2100,0.2478,33,133,33,553256,52354,86852,21104,0.484956834265812,0.2872934193688911
2101,0.2479,40,133,40,553389,52221,86892,21064,0.4837248508651673,0.28742580337040324
2102,0.248,67,186,67,553575,52035,86959,20997,0.4820019267108822,0.28750410778836677
2103,0.2481,34,95,34,553670,51940,86993,20963,0.4811219385675646,0.28754646585188537
2104,0.2482,59,149,59,553819,51791,87052,20904,0.479741746637519,0.28755760368663597
2105,0.2483,52,137,52,553956,51654,87104,20852,0.47847271110452405,0.2875899925523405
2106,0.2484,31,78,31,554034,51576,87135,20821,0.4777501945236948,0.287594789839358
2107,0.2485,49,109,49,554143,51467,87184,20772,0.47674052391715144,0.2875455086587577
2108,0.2486,31,132,31,554275,51335,87215,20741,0.4755178035495943,0.28776569176979855
2109,0.2487,34,66,34,554341,51269,87249,20707,0.4749064433658157,0.2876931199288652
2110,0.2488,44,145,44,554486,51124,87293,20663,0.4735633035681203,0.28783763076880214
2111,0.2489,31,98,31,554584,51026,87324,20632,0.47265552632554003,0.28792319071143485
2112,0.249,49,134,49,554718,50892,87373,20583,0.4714142798918078,0.2879748163693599
2113,0.2491,46,149,46,554867,50743,87419,20537,0.4700340879617622,0.2881172839506173
2114,0.2492,52,134,52,555001,50609,87471,20485,0.4687928415280299,0.2881396461023434
2115,0.2493,32,101,32,555102,50508,87503,20453,0.46785727518618697,0.2882287453671735
2116,0.2494,68,207,68,555309,50301,87571,20385,0.46593982733706324,0.28838808250572956
2117,0.2495,55,134,55,555443,50167,87626,20330,0.464698580903331,0.28838106586095863
2118,0.2496,50,124,50,555567,50043,87676,20280,0.4635499648004743,0.2883836013821936
2119,0.2497,26,66,26,555633,49977,87702,20254,0.46293860461669567,0.2883911662940867
2120,0.2498,37,85,37,555718,49892,87739,20217,0.46215124680425357,0.2883652598097249
2121,0.2499,41,122,41,555840,49770,87780,20176,0.461021156767572,0.28845109084150633
2122,0.25,30,84,30,555924,49686,87810,20146,0.4602430619882174,0.2884923817161187
2123,0.2501,38,101,38,556025,49585,87848,20108,0.45930749564637446,0.2885225201957155
2124,0.2502,32,143,32,556168,49442,87880,20076,0.4579828819148542,0.2887885152046952
2125,0.2503,21,106,21,556274,49336,87901,20055,0.45700100040757347,0.28901442550186623
2126,0.2504,51,139,51,556413,49197,87952,20004,0.4557134388084034,0.28907096718255515
2127,0.2505,33,88,33,556501,49109,87985,19971,0.45489829189669867,0.2890995946728431
2128,0.2506,31,103,31,556604,49006,88016,19940,0.4539441994886806,0.2892118469526876
2129,0.2507,47,150,47,556754,48856,88063,19893,0.45255474452554745,0.28935693610088875
2130,0.2508,31,68,31,556822,48788,88094,19862,0.45192485827559375,0.2893226511289148
2131,0.2509,22,113,22,556935,48675,88116,19840,0.45087813553670014,0.2895716266510983
2132,0.251,31,107,31,557042,48568,88147,19809,0.44988699099633184,0.28970267780101494
2133,0.2511,45,138,45,557180,48430,88192,19764,0.44860869243024937,0.28982021878757663
2134,0.2512,22,79,22,557259,48351,88214,19742,0.4478769128163326,0.2899270115870941
2135,0.2513,30,136,30,557395,48215,88244,19712,0.4466171403164252,0.2901938846114211
2136,0.2514,46,107,46,557502,48108,88290,19666,0.44562599577605694,0.29017027178564053
2137,0.2515,12,28,12,557530,48080,88302,19654,0.44536663084960537,0.29016446688516845
2138,0.2516,53,137,53,557667,47943,88355,19601,0.44409759531661047,0.2901960203719057
2139,0.2517,56,145,56,557812,47798,88411,19545,0.4427544555189151,0.2902306104569146
2140,0.2518,26,70,26,557882,47728,88437,19519,0.44210604320278635,0.29025830148556814
2141,0.2519,47,105,47,557987,47623,88484,19472,0.4411334247285931,0.2902153662717043
2142,0.252,29,92,29,558079,47531,88513,19443,0.44028122568453815,0.2903066861767253
2143,0.2521,35,154,35,558233,47377,88548,19408,0.4388547185890548,0.290604177584787
2144,0.2522,33,92,33,558325,47285,88581,19375,0.4380025195449998,0.29065406540654065
2145,0.2523,49,141,49,558466,47144,88630,19326,0.4366964318796547,0.2907477057319091
2146,0.2524,44,153,44,558619,46991,88674,19282,0.4352791878172589,0.2909480482247673
2147,0.2525,27,71,27,558690,46920,88701,19255,0.43462151246804254,0.290970910464677
2148,0.2526,34,93,34,558783,46827,88735,19221,0.4337600503909,0.291015625
2149,0.2527,25,90,25,558873,46737,88760,19196,0.43292637741302015,0.29114404016198264
2150,0.2528,44,71,44,558944,46666,88804,19152,0.43226870206380374,0.29098422923820233
2151,0.2529,35,109,35,559053,46557,88839,19117,0.43125903145726036,0.2910893199744191
2152,0.253,44,138,44,559191,46419,88883,19073,0.4299807328911779,0.29122640933243754
2153,0.2531,45,120,45,559311,46299,88928,19028,0.4288691689206714,0.2912731336200958
2154,0.2532,38,72,38,559383,46227,88966,18990,0.4282022305383675,0.29118174709048256
2155,0.2533,42,111,42,559494,46116,89008,18948,0.42717403386564895,0.2912209516783475
2156,0.2534,29,75,29,559569,46041,89037,18919,0.4264793063840824,0.291240763546798
2157,0.2535,75,133,75,559702,45908,89112,18844,0.4252473229834377,0.2910180380528787
2158,0.2536,46,129,46,559831,45779,89158,18798,0.4240523917151432,0.29109435247843657
2159,0.2537,29,89,29,559920,45690,89187,18769,0.42322798177035087,0.29117733753238495
2160,0.2538,34,110,34,560030,45580,89221,18735,0.4222090481307199,0.2913006297131307
2161,0.2539,49,122,49,560152,45458,89270,18686,0.42107895809403834,0.29131329508605636
2162,0.254,35,108,35,560260,45350,89305,18651,0.42007855052058246,0.2914173216043499
2163,0.2541,40,97,40,560357,45253,89345,18611,0.4191800363110897,0.2914161342853564
2164,0.2542,34,79,34,560436,45174,89379,18577,0.41844825669717295,0.291399350598422
2165,0.2543,59,125,59,560561,45049,89438,18518,0.41729037756122866,0.29131467585382353
2166,0.2544,38,114,38,560675,44935,89476,18480,0.4162343917892475,0.29141370338248046
2167,0.2545,35,86,35,560761,44849,89511,18445,0.4154377709437178,0.2914178279141783
2168,0.2546,53,144,53,560905,44705,89564,18392,0.41410389417911003,0.291487709399813
2169,0.2547,29,93,29,560998,44612,89593,18363,0.4132424321019675,0.29159190154823345
2170,0.2548,36,78,36,561076,44534,89629,18327,0.41251991552113826,0.29154801864431046
2171,0.2549,46,138,46,561214,44396,89675,18281,0.4112416169550558,0.2916699905866586
2172,0.255,46,122,46,561336,44274,89721,18235,0.41011152691837416,0.2917179926090643
2173,0.2551,28,127,28,561463,44147,89749,18207,0.4089351217162548,0.2919940982134266
2174,0.2552,34,79,34,561542,44068,89783,18173,0.408203342102338,0.2919779566523674
2175,0.2553,42,130,42,561672,43938,89825,18131,0.4069991478009559,0.2921103932720037
2176,0.2554,40,95,40,561767,43843,89865,18091,0.4061191596576383,0.29210126909290535
2177,0.2555,32,68,32,561835,43775,89897,18059,0.4054892734076846,0.29205615033800175
2178,0.2556,31,71,31,561906,43704,89928,18028,0.40483159805846824,0.29203654506576815
2179,0.2557,33,109,33,562015,43595,89961,17995,0.40382192745192486,0.2921740542295827
2180,0.2558,45,125,45,562140,43470,90006,17950,0.40266404831598057,0.29225008140670794
2181,0.2559,31,78,31,562218,43392,90037,17919,0.40194153173515135,0.292264030924304
2182,0.256,36,59,36,562277,43333,90073,17883,0.40139501278298567,0.29212950862519604
2183,0.2561,47,128,47,562405,43205,90120,17836,0.40020934454777873,0.2921970478858472
2184,0.2562,35,84,35,562489,43121,90155,17801,0.39943124976842415,0.29219329634614755
2185,0.2563,31,78,31,562567,43043,90186,17770,0.3987087331875949,0.29220725831647837
2186,0.2564,39,118,39,562685,42925,90225,17731,0.39761569528326357,0.2923206278026906
2187,0.2565,27,91,27,562776,42834,90252,17704,0.3967727592722961,0.29244441507813274
2188,0.2566,45,131,45,562907,42703,90297,17659,0.3955593019378265,0.2925516053146019
2189,0.2567,43,97,43,563004,42606,90340,17616,0.39466078772833374,0.2925176845671017
2190,0.2568,31,74,31,563078,42532,90371,17585,0.39397532327985474,0.2925129331137615
2191,0.2569,47,116,47,563194,42416,90418,17538,0.39290081144169847,0.2925242686059312
2192,0.257,30,76,30,563270,42340,90448,17508,0.39219682092704433,0.29254110413046386
2193,0.2571,48,107,48,563377,42233,90496,17460,0.391205676386676,0.2924966076424371
2194,0.2572,45,133,45,563510,42100,90541,17415,0.38997369298603135,0.2926153070654457
2195,0.2573,41,118,41,563628,41982,90582,17374,0.38888065508169994,0.2927084035312353
2196,0.2574,53,111,53,563739,41871,90635,17321,0.3878524584089814,0.2926240032436816
2197,0.2575,16,64,16,563803,41807,90651,17305,0.38725962429137795,0.29274935715252404
2198,0.2576,39,136,39,563939,41671,90690,17266,0.3859998517914706,0.29295688616658466
2199,0.2577,25,83,25,564022,41588,90715,17241,0.3852310200452036,0.2930697445137602
2200,0.2578,43,110,43,564132,41478,90758,17198,0.38421208640557264,0.29310109755266206
2201,0.2579,40,118,40,564250,41360,90798,17158,0.38311904850124123,0.2932089271677091
2202,0.258,45,130,45,564380,41230,90843,17113,0.3819148541998592,0.2933171074507653
2203,0.2581,40,97,40,564477,41133,90883,17073,0.38101633999036644,0.29332027626017937
2204,0.2582,22,65,22,564542,41068,90905,17051,0.3804142428396754,0.29338082210636796
2205,0.2583,22,108,22,564650,40960,90927,17029,0.3794138352662196,0.2936591422511166
2206,0.2584,47,121,47,564771,40839,90974,16982,0.3782930082626255,0.29369952093530033
2207,0.2585,49,154,49,564925,40685,91023,16933,0.37686650116714215,0.29388385573952586
2208,0.2586,64,171,64,565096,40514,91087,16869,0.3752825225091704,0.29397208232403327
2209,0.2587,25,59,25,565155,40455,91112,16844,0.3747360035570047,0.29396673589416916
2210,0.2588,45,121,45,565276,40334,91157,16799,0.37361517655341064,0.29403322073057603
2211,0.2589,21,48,21,565324,40286,91178,16778,0.37317055096520807,0.29402074863311367
2212,0.259,28,121,28,565445,40165,91206,16750,0.372049723961614,0.2942985153298779
2213,0.2591,38,105,38,565550,40060,91244,16712,0.3710771054874208,0.2943704643133939
2214,0.2592,21,41,21,565591,40019,91265,16691,0.3706973211308311,0.29432198906718393
2215,0.2593,39,128,39,565719,39891,91304,16652,0.36951165289562415,0.29450152980917177
2216,0.2594,31,96,31,565815,39795,91335,16621,0.36862240171921895,0.2946150028360749
2217,0.2595,30,87,30,565902,39708,91365,16591,0.3678165178406017,0.294694399545285
2218,0.2596,30,100,30,566002,39608,91395,16561,0.3668902145318463,0.2948423507628763
2219,0.2597,51,132,51,566134,39476,91446,16510,0.3656674941642892,0.29489515235951846
2220,0.2598,18,62,18,566196,39414,91464,16492,0.3650931861128608,0.29499517046470863
2221,0.2599,40,101,40,566297,39313,91504,16452,0.36415761977101785,0.2950237604232045
2222,0.26,35,85,35,566382,39228,91539,16417,0.3633702619585757,0.29503100008985533
2223,0.2601,17,32,17,566414,39196,91556,16400,0.36307384489977396,0.2949852507374631
2224,0.2602,42,126,42,566540,39070,91598,16358,0.36190670273074216,0.29512159919174424
2225,0.2603,19,75,19,566615,38995,91617,16339,0.3612119752491756,0.29527957494488016
2226,0.2604,49,117,49,566732,38878,91666,16290,0.36012820037793175,0.2952798723897912
2227,0.2605,35,102,35,566834,38776,91701,16255,0.35918337100300124,0.29537896821791354
2228,0.2606,18,70,18,566904,38706,91719,16237,0.3585349586868724,0.2955244526145278
2229,0.2607,57,160,57,567064,38546,91776,16180,0.35705287339286373,0.2956547162226364
2230,0.2608,34,68,34,567132,38478,91810,16146,0.3564229871429101,0.29558435852372583
2231,0.2609,16,47,16,567179,38431,91826,16130,0.35598762458779504,0.29563241142940927
2232,0.261,30,103,30,567282,38328,91856,16100,0.35503353217977696,0.2958036304843095
2233,0.2611,36,74,36,567356,38254,91892,16064,0.35434806773129796,0.29573990205824957
2234,0.2612,18,80,18,567436,38174,91910,16046,0.3536070250842936,0.29594245665805974
2235,0.2613,41,118,41,567554,38056,91951,16005,0.3525139871799622,0.29605445700227523
2236,0.2614,55,122,55,567676,37934,92006,15950,0.3513838971432806,0.29600623561725187
2237,0.2615,42,91,42,567767,37843,92048,15908,0.35054096113231314,0.2959572845156369
2238,0.2616,30,70,30,567837,37773,92078,15878,0.34989254881618437,0.29594974930569795
2239,0.2617,35,74,35,567911,37699,92113,15843,0.34920708436770537,0.29589854693511636
2240,0.2618,47,88,47,567999,37611,92160,15796,0.3483919374560006,0.2957664725597768
2241,0.2619,20,49,20,568048,37562,92180,15776,0.3479380488347104,0.2957741197645206
2242,0.262,27,75,27,568123,37487,92207,15749,0.3472433213531439,0.29583364640468857
2243,0.2621,21,71,21,568194,37416,92228,15728,0.34658564600392755,0.295950624717748
2244,0.2622,27,80,27,568274,37336,92255,15701,0.3458446033569232,0.2960386145521051
2245,0.2623,14,54,14,568328,37282,92269,15687,0.34534439957019525,0.2961543544337254
2246,0.2624,37,79,37,568407,37203,92306,15650,0.3446126199562785,0.2961042892551038
2247,0.2625,32,111,32,568518,37092,92338,15618,0.34358442328356,0.29630051223676723
2248,0.2626,27,75,27,568593,37017,92365,15591,0.3428896958019934,0.2963617700729927
2249,0.2627,22,75,22,568668,36942,92387,15569,0.34219496832042684,0.2964902591837901
2250,0.2628,19,68,19,568736,36874,92406,15550,0.34156508207047315,0.2966198687623989
2251,0.2629,51,104,51,568840,36770,92457,15499,0.3406017266293675,0.29652375212841264
2252,0.263,26,80,26,568920,36690,92483,15473,0.3398606839823632,0.29662787799781454
2253,0.2631,22,54,22,568974,36636,92505,15451,0.33936048019563525,0.29663831666250695
2254,0.2632,22,71,22,569045,36565,92527,15429,0.3387028048464189,0.2967457783590414
2255,0.2633,16,68,16,569113,36497,92543,15413,0.3380729185964652,0.2969177422461953
2256,0.2634,45,102,45,569215,36395,92588,15368,0.3371280892215347,0.29689160210961496
2257,0.2635,37,73,37,569288,36322,92625,15331,0.33645188780614327,0.2968075426403113
2258,0.2636,31,67,31,569355,36255,92656,15300,0.3358312645892771,0.2967704393366308
2259,0.2637,30,63,30,569418,36192,92686,15270,0.3352476935047612,0.29672379619913725
2260,0.2638,25,89,25,569507,36103,92711,15245,0.33442328355996886,0.2968956921399081
2261,0.2639,33,66,33,569573,36037,92744,15212,0.3338119233761903,0.2968253039083689
2262,0.264,37,98,37,569671,35939,92781,15175,0.33290414613360997,0.29688539343428416
2263,0.2641,33,103,33,569774,35836,92814,15142,0.3319500537255919,0.2970300914119816
2264,0.2642,32,79,32,569853,35757,92846,15110,0.33121827411167515,0.2970491674366485
2265,0.2643,36,86,36,569939,35671,92882,15074,0.3304216532661455,0.2970538969356587
2266,0.2644,17,53,17,569992,35618,92899,15057,0.3299307125125051,0.2971287617168229
2267,0.2645,14,65,14,570057,35553,92913,15043,0.32932861536181407,0.2973159933591588
2268,0.2646,20,46,20,570103,35507,92933,15023,0.3289025158397866,0.2973085295863843
2269,0.2647,29,98,29,570201,35409,92962,14994,0.3279947385972063,0.2974822927206714
2270,0.2648,39,83,39,570284,35326,93001,14955,0.3272259068509393,0.2974284520992025
2271,0.2649,16,68,16,570352,35258,93017,14939,0.3265960206009856,0.2976074267386497
2272,0.265,27,45,27,570397,35213,93044,14912,0.32617918411204566,0.29749625935162094
2273,0.2651,44,104,44,570501,35109,93088,14868,0.32521582867094,0.29749684855033315
2274,0.2652,16,50,16,570551,35059,93104,14852,0.3247526770165623,0.29756967401975515
2275,0.2653,30,63,30,570614,34996,93134,14822,0.3241691059320464,0.2975229836605243
2276,0.2654,27,62,27,570676,34934,93161,14795,0.323594797880618,0.2975125178467293
2277,0.2655,27,65,27,570741,34869,93188,14768,0.32299270072992703,0.29751999516489713
2278,0.2656,23,73,23,570814,34796,93211,14745,0.32231649931453554,0.2976322641852203
2279,0.2657,32,88,32,570902,34708,93243,14713,0.3215013524028308,0.29770745229760626
2280,0.2658,20,71,20,570973,34637,93263,14693,0.32084367705361444,0.29785120616257854
2281,0.2659,45,124,45,571097,34513,93308,14648,0.3196950609507577,0.2979597648542544
2282,0.266,24,84,24,571181,34429,93332,14624,0.31891696617140314,0.29812651621715286
2283,0.2661,42,121,42,571302,34308,93374,14582,0.31779613916780913,0.2982614031499284
2284,0.2662,37,112,37,571414,34196,93411,14545,0.31675867946200303,0.298414066186578
2285,0.2663,37,82,37,571496,34114,93448,14508,0.3159991107488236,0.29838344782197357
2286,0.2664,18,47,18,571543,34067,93466,14490,0.3155637481937085,0.2984121753815104
2287,0.2665,17,40,17,571583,34027,93483,14473,0.3151932268702064,0.29841237113402064
2288,0.2666,31,65,31,571648,33962,93514,14442,0.31459112971951536,0.29836377158912486
2289,0.2667,18,68,18,571716,33894,93532,14424,0.31396124346956167,0.29852228982987705
2290,0.2668,29,60,29,571776,33834,93561,14395,0.3134054614843084,0.2984718737688942
2291,0.2669,24,52,24,571828,33782,93585,14371,0.3129237837637556,0.2984445413577555
2292,0.267,49,128,49,571956,33654,93634,14322,0.3117381155285487,0.29852426213106553
2293,0.2671,43,110,43,572066,33544,93677,14279,0.31071918188891773,0.2985801810844155
2294,0.2672,22,52,22,572118,33492,93699,14257,0.3102375041683649,0.29858216926008924
2295,0.2673,44,105,44,572223,33387,93743,14213,0.3092648856941717,0.29859243697478993
2296,0.2674,29,79,29,572302,33308,93772,14184,0.3085331060802549,0.29866082708666725
2297,0.2675,44,103,44,572405,33205,93816,14140,0.30757901367223683,0.2986587812863027
2298,0.2676,26,75,26,572480,33130,93842,14114,0.30688428619067026,0.298746930827195
2299,0.2677,21,58,21,572538,33072,93863,14093,0.30634703027159216,0.2988020778119368
2300,0.2678,22,76,22,572614,32996,93885,14071,0.305643039756938,0.2989568062549132
2301,0.2679,37,106,37,572720,32890,93922,14034,0.3046611582496573,0.2990793623731992
2302,0.268,32,86,32,572806,32804,93954,14002,0.3038645374041276,0.2991496816647438
2303,0.2681,25,84,25,572890,32720,93979,13977,0.3030864426247731,0.2993125896738549
2304,0.2682,22,47,22,572937,32673,94001,13955,0.302651080069658,0.2992836922021103
2305,0.2683,49,145,49,573082,32528,94050,13906,0.30130794027196267,0.2994788301675496
2306,0.2684,24,69,24,573151,32459,94074,13882,0.3006687909889214,0.29956194298785094
2307,0.2685,35,75,35,573226,32384,94109,13847,0.29997406350735484,0.29951763967900324
2308,0.2686,22,87,22,573313,32297,94131,13825,0.29916817962873765,0.29974849312692425
2309,0.2687,17,64,17,573377,32233,94148,13808,0.2985753455111342,0.2999066049825156
2310,0.2688,18,36,18,573413,32197,94166,13790,0.2982418763199822,0.29986735381738316
2311,0.2689,25,54,25,573467,32143,94191,13765,0.2977416725332543,0.29983880805088436
2312,0.269,23,119,23,573586,32024,94214,13742,0.29663937159583537,0.30026657343879737
2313,0.2691,22,94,22,573680,31930,94236,13720,0.29576864648560525,0.3005476451259584
2314,0.2692,18,44,18,573724,31886,94254,13702,0.29536107302975284,0.300561551285426
2315,0.2693,34,86,34,573810,31800,94288,13668,0.2945644521842232,0.3006070203219847
2316,0.2694,23,69,23,573879,31731,94311,13645,0.29392530290118196,0.30070962623413255
2317,0.2695,23,46,23,573925,31685,94334,13622,0.29349920337915447,0.30065994217229125
2318,0.2696,15,31,15,573956,31654,94349,13607,0.2932120493534403,0.3006340999977906
2319,0.2697,45,81,45,574037,31573,94394,13562,0.29246174367334843,0.300476348731583
2320,0.2698,28,86,28,574123,31487,94422,13534,0.29166512282781876,0.3006152684302881
2321,0.2699,19,60,19,574183,31427,94441,13515,0.2911093408425655,0.3007209291976325
2322,0.27,25,61,25,574244,31366,94466,13490,0.2905442958242247,0.30074014624576423
2323,0.2701,22,80,22,574324,31286,94488,13468,0.28980325317722033,0.3009339947267283
2324,0.2702,13,41,13,574365,31245,94501,13455,0.28942346882063064,0.301006711409396
2325,0.2703,24,79,24,574444,31166,94525,13431,0.28869168920671384,0.3011637554095567
2326,0.2704,41,107,41,574551,31059,94566,13390,0.28770054466634554,0.3012441224774461
2327,0.2705,22,74,22,574625,30985,94588,13368,0.28701508021786654,0.30140013076905736
2328,0.2706,40,108,40,574733,30877,94628,13328,0.28601467264441066,0.30150435471100556
2329,0.2707,18,56,18,574789,30821,94646,13310,0.28549594279150764,0.30160204844667016
2330,0.2708,26,83,26,574872,30738,94672,13284,0.2847271110452407,0.3017582118031893
2331,0.2709,16,41,16,574913,30697,94688,13268,0.2843473266886509,0.30178551120209257
2332,0.271,20,62,20,574975,30635,94708,13248,0.2837730186372226,0.3018936718091288
2333,0.2711,39,70,39,575045,30565,94747,13209,0.28312460632109376,0.30175446612144197
2334,0.2712,33,78,33,575123,30487,94780,13176,0.28240208974026454,0.3017657971280031
2335,0.2713,35,77,35,575200,30410,94815,13141,0.2816888361925229,0.30173819200477603
2336,0.2714,43,84,43,575284,30326,94858,13098,0.28091074141316835,0.3016304347826087
2337,0.2715,11,20,11,575304,30306,94869,13087,0.28072548075141723,0.30159242274099507
2338,0.2716,23,65,23,575369,30241,94892,13064,0.2801233836007262,0.3016741715737213
2339,0.2717,32,66,32,575435,30175,94924,13032,0.27951202341694764,0.30161779341310435
2340,0.2718,23,64,23,575499,30111,94947,13009,0.2789191892993442,0.3016929499072356
2341,0.2719,24,41,24,575540,30070,94971,12985,0.2785394049427545,0.3015909882708164
2342,0.272,22,68,22,575608,30002,94993,12963,0.2779095186928008,0.30171069475154194
2343,0.2721,26,110,26,575718,29892,95019,12937,0.2768905850531698,0.302061687174578
2344,0.2722,25,67,25,575785,29825,95044,12912,0.2762699618363037,0.3021269625851136
2345,0.2723,20,45,20,575830,29780,95064,12892,0.2758531253473637,0.3021184851893513
2346,0.2724,39,81,39,575911,29699,95103,12853,0.27510281966727185,0.3020539575108103
2347,0.2725,27,57,27,575968,29642,95130,12826,0.27457482678128126,0.30201563530187436
2348,0.2726,25,94,25,576062,29548,95155,12801,0.2737041016710512,0.30227396160476044
2349,0.2727,13,46,13,576108,29502,95168,12788,0.2732780021490237,0.30238827145897373
2350,0.2728,21,59,21,576167,29443,95189,12767,0.27273148319685797,0.30246387112058754
2351,0.2729,28,46,28,576213,29397,95217,12739,0.2723053836748305,0.3023305486994494
2352,0.273,30,65,30,576278,29332,95247,12709,0.27170328652413944,0.3023001355819319
2353,0.2731,29,73,29,576351,29259,95276,12680,0.271027085108748,0.3023438803977205
2354,0.2732,28,80,28,576431,29179,95304,12652,0.27028604246174365,0.3024551170184791
2355,0.2733,11,32,11,576463,29147,95315,12641,0.2699896254029419,0.30250311094093996
2356,0.2734,36,58,36,576521,29089,95351,12605,0.2694523694838638,0.3023216769799012
2357,0.2735,28,64,28,576585,29025,95379,12577,0.26885953536626034,0.30231719628863996
2358,0.2736,24,95,24,576680,28930,95403,12553,0.2679795472229427,0.30260588674878863
2359,0.2737,20,61,20,576741,28869,95423,12533,0.2674145022046019,0.3027148446934931
2360,0.2738,26,56,26,576797,28813,95449,12507,0.26689577235169887,0.3026863504356244
2361,0.2739,27,81,27,576878,28732,95476,12480,0.26614546667160693,0.30282442007182375
2362,0.274,21,33,21,576911,28699,95497,12459,0.2658397865797177,0.3027115020166189
2363,0.2741,35,111,35,577022,28588,95532,12424,0.26481158990699916,0.3029357261289379
2364,0.2742,26,41,26,577063,28547,95558,12398,0.2644318055504094,0.30279643424105507
2365,0.2743,27,91,27,577154,28456,95585,12371,0.263588869539442,0.3030102628162735
2366,0.2744,35,100,35,577254,28356,95620,12336,0.26266256623068657,0.30315541138307284
2367,0.2745,35,83,35,577337,28273,95655,12301,0.2618937344844196,0.30317444668999854
2368,0.2746,24,41,24,577378,28232,95679,12277,0.26151395012782985,0.3030684539238194
2369,0.2747,29,44,29,577422,28188,95708,12248,0.26110637667197745,0.3028984073597784
2370,0.2748,30,86,30,577508,28102,95738,12218,0.26030975582644783,0.30302579365079363
2371,0.2749,18,46,18,577554,28056,95756,12200,0.25988365630442034,0.303060413354531
2372,0.275,31,70,31,577624,27986,95787,12169,0.2592352439882915,0.3030506786203462
2373,0.2751,13,50,13,577674,27936,95800,12156,0.2587720923339138,0.30320263394193353
2374,0.2752,23,49,23,577723,27887,95823,12133,0.25831820371262365,0.30317341329335334
2375,0.2753,30,93,30,577816,27794,95853,12103,0.2574567416354811,0.3033561420658195
2376,0.2754,35,77,35,577893,27717,95888,12068,0.25674348808773945,0.30333040090486363
2377,0.2755,30,58,30,577951,27659,95918,12038,0.2562062321686613,0.3032470967579414
2378,0.2756,25,52,25,578003,27607,95943,12013,0.2557245544481085,0.30320545179202424
2379,0.2757,34,86,34,578089,27521,95977,11979,0.2549279336025788,0.3032658227848101
2380,0.2758,23,42,23,578131,27479,96000,11956,0.25453888621290155,0.303182452136427
2381,0.2759,24,59,24,578190,27420,96024,11932,0.2539923672607359,0.3032120349664566
2382,0.276,14,37,14,578227,27383,96038,11918,0.25364963503649635,0.3032492811887738
2383,0.2761,18,52,18,578279,27331,96056,11900,0.25316795731594355,0.30333154903010373
2384,0.2762,6,67,6,578346,27264,96062,11894,0.2525473340990774,0.3037438071403034
2385,0.2763,50,136,50,578482,27128,96112,11844,0.25128756159917004,0.3039104998460433
2386,0.2764,45,101,45,578583,27027,96157,11799,0.25035199525732704,0.303894297635605
2387,0.2765,22,67,22,578650,26960,96179,11777,0.24973137204046092,0.3040245759867827
2388,0.2766,25,62,25,578712,26898,96204,11752,0.24915706398903256,0.3040620957309185
2389,0.2767,34,53,34,578765,26845,96238,11718,0.2486661232353922,0.3038664004356508
2390,0.2768,23,57,23,578822,26788,96261,11695,0.2481381303494016,0.3039004235636515
2391,0.2769,20,36,20,578858,26752,96281,11675,0.24780466115824965,0.30382283290394774
2392,0.277,28,70,28,578928,26682,96309,11647,0.24715624884212087,0.30386913303242974
2393,0.2771,26,84,26,579012,26598,96335,11621,0.2463781540627663,0.30406342395143776
2394,0.2772,11,30,11,579042,26568,96346,11610,0.24610026307013969,0.3041018387553041
2395,0.2773,22,66,22,579108,26502,96368,11588,0.2454889028863611,0.3042268311892885
2396,0.2774,30,37,30,579145,26465,96398,11558,0.2451461706621216,0.3039739105278384
2397,0.2775,20,69,20,579214,26396,96418,11538,0.24450702137908037,0.30415985659303
2398,0.2776,16,52,16,579266,26344,96434,11522,0.24402534365852754,0.3042835261184176
2399,0.2777,18,40,18,579306,26304,96452,11504,0.2436548223350254,0.30427422767668216
2400,0.2778,35,77,35,579383,26227,96487,11469,0.2429415687872837,0.30424978777589134
2401,0.2779,17,65,17,579448,26162,96504,11452,0.2423394716365927,0.30446110490774714
2402,0.278,39,84,39,579532,26078,96543,11413,0.24156137685723814,0.30441972740124296
2403,0.2781,37,64,37,579596,26014,96580,11376,0.24096854273963467,0.30425247392350896
2404,0.2782,17,42,17,579638,25972,96597,11359,0.2405794953499574,0.30427794594305
2405,0.2783,13,45,13,579683,25927,96610,11346,0.24016265886101745,0.3044026507123119
2406,0.2784,16,35,16,579718,25892,96626,11330,0.23983845270295306,0.30438987695448927
2407,0.2785,16,38,16,579756,25854,96642,11314,0.239486457445626,0.30440163581575547
2408,0.2786,17,51,17,579807,25803,96659,11297,0.23901404275816074,0.30450134770889487
2409,0.2787,27,55,27,579862,25748,96686,11270,0.23850457593834526,0.3044464854935437
2410,0.2788,14,21,14,579883,25727,96700,11256,0.23831005224350663,0.30435605548495254
2411,0.2789,17,69,17,579952,25658,96717,11239,0.23767090296046536,0.30460471041006043
2412,0.279,18,42,18,579994,25616,96735,11221,0.2372818555707881,0.3046122105491761
2413,0.2791,34,71,34,580065,25545,96769,11187,0.23662418022157175,0.3045573342045083
2414,0.2792,14,41,14,580106,25504,96783,11173,0.23624439586498203,0.3046323308885678
2415,0.2793,23,63,23,580169,25441,96806,11150,0.23566082478046613,0.30471973982673334
2416,0.2794,24,78,24,580247,25363,96830,11126,0.2349383081996369,0.30491380964126175
2417,0.2795,10,43,10,580290,25320,96840,11116,0.23453999777687207,0.3050828850587331
2418,0.2796,28,52,28,580342,25268,96868,11088,0.23405832005631924,0.30498404664979645
2419,0.2797,27,59,27,580401,25209,96895,11061,0.23351180110415354,0.3049627791563275
2420,0.2798,9,54,9,580455,25155,96904,11052,0.23301159731742563,0.30524484215759384
2421,0.2799,22,54,22,580509,25101,96926,11030,0.2325113935306977,0.3052780161080513
2422,0.28,15,78,15,580587,25023,96941,11015,0.23178887694986847,0.3056495920972307
2423,0.2801,34,71,34,580658,24952,96975,10981,0.23113120160065212,0.3055965268694515
2424,0.2802,35,68,35,580726,24884,97010,10946,0.23050131535069843,0.30549818587775607
2425,0.2803,19,40,19,580766,24844,97029,10927,0.23013079402719627,0.30547091219144
2426,0.2804,21,61,21,580827,24783,97050,10906,0.22956574900885546,0.3055843537224355
2427,0.2805,21,64,21,580891,24719,97071,10885,0.228972914891252,0.30572407594652284
2428,0.2806,13,34,13,580925,24685,97084,10872,0.22865797176627514,0.30576257839525267
2429,0.2807,13,40,13,580965,24645,97097,10859,0.228287450442773,0.3058528616493916
2430,0.2808,30,59,30,581024,24586,97127,10829,0.22774093149060728,0.3057743893830298
2431,0.2809,29,70,29,581094,24516,97156,10800,0.22709251917447848,0.3058103975535168
2432,0.281,31,60,31,581154,24456,97187,10769,0.22653673718922523,0.30572036905606814
2433,0.2811,39,96,39,581250,24360,97226,10730,0.22564748601282003,0.30578512396694213
2434,0.2812,27,48,27,581298,24312,97253,10703,0.22520286042461743,0.3056689990004284
2435,0.2813,16,39,16,581337,24273,97269,10687,0.22484160213420282,0.3056922196796339
2436,0.2814,36,82,36,581419,24191,97305,10651,0.22408203342102337,0.305694277021985
2437,0.2815,13,37,13,581456,24154,97318,10638,0.22373930119678387,0.3057599448149
2438,0.2816,17,47,17,581503,24107,97335,10621,0.22330393864166884,0.30583390923750287
2439,0.2817,16,44,16,581547,24063,97351,10605,0.22289636518581643,0.30590169608861195
2440,0.2818,34,60,34,581607,24003,97385,10571,0.22234058320056319,0.30574998553826577
2441,0.2819,21,48,21,581655,23955,97406,10550,0.22189595761236058,0.30575278945080425
2442,0.282,17,37,17,581692,23918,97423,10533,0.22155322538812108,0.30573858523700326
2443,0.2821,17,31,17,581723,23887,97440,10516,0.22126607136240692,0.30567101706246547
2444,0.2822,33,95,33,581818,23792,97473,10483,0.22038608321908926,0.30584974471188914
2445,0.2823,32,75,32,581893,23717,97505,10451,0.2196913557375227,0.30587099040037463
2446,0.2824,19,61,19,581954,23656,97524,10432,0.2191263107191819,0.30603144801689747
2447,0.2825,26,69,26,582023,23587,97550,10406,0.21848716143614064,0.30612184861589153
2448,0.2826,22,59,22,582082,23528,97572,10384,0.21794064248397496,0.30620429346544
2449,0.2827,22,58,22,582140,23470,97594,10362,0.2174033865648968,0.306278079924332
2450,0.2828,26,58,26,582198,23412,97620,10336,0.21686613064581867,0.30627000118525544
2451,0.2829,20,43,20,582241,23369,97640,10316,0.21646782022305383,0.30624907228736825
2452,0.283,24,61,24,582302,23308,97664,10292,0.21590277520471304,0.3063095238095238
2453,0.2831,15,51,15,582353,23257,97679,10277,0.21543036051724776,0.3064650802170931
2454,0.2832,16,56,16,582409,23201,97695,10261,0.21491163066434474,0.3066463451078836
2455,0.2833,22,30,22,582439,23171,97717,10239,0.21463373967171812,0.3064651302005388
2456,0.2834,26,52,26,582491,23119,97743,10213,0.2141520619511653,0.30640225609024363
2457,0.2835,26,70,26,582561,23049,97769,10187,0.21350364963503649,0.30650499458418584
2458,0.2836,28,78,28,582639,22971,97797,10159,0.21278113305420726,0.30664050709326895
2459,0.2837,17,68,17,582707,22903,97814,10142,0.2121512468042536,0.3069148131336057
2460,0.2838,12,58,12,582765,22845,97826,10130,0.21161399088517543,0.3072024260803639
2461,0.2839,20,56,20,582821,22789,97846,10110,0.2110952610322724,0.3073041733791301
2462,0.284,17,40,17,582861,22749,97863,10093,0.21072473970877023,0.30731989525607456
2463,0.2841,17,38,17,582899,22711,97880,10076,0.2103727444514432,0.30731692439076463
2464,0.2842,19,72,19,582971,22639,97899,10057,0.20970580606913927,0.30759114264741866
2465,0.2843,17,56,17,583027,22583,97916,10040,0.20918707621623625,0.3077583300125678
2466,0.2844,31,74,31,583101,22509,97947,10009,0.20850161176775722,0.3077987576111692
2467,0.2845,15,59,15,583160,22450,97962,9994,0.20795509281559155,0.30803846628036
2468,0.2846,15,42,15,583202,22408,97977,9979,0.20756604542591425,0.3081174545342267
2469,0.2847,29,55,29,583257,22353,98006,9950,0.20705657860609877,0.3080209268488995
2470,0.2848,16,32,16,583289,22321,98022,9934,0.20676016154729704,0.30798325840954893
2471,0.2849,7,24,7,583313,22297,98029,9927,0.20653784875319575,0.30806231380337634
2472,0.285,37,88,37,583401,22209,98066,9890,0.20572270184149097,0.3081092868936727
2473,0.2851,15,62,15,583463,22147,98081,9875,0.2051483937900626,0.30838173755543064
2474,0.2852,10,47,10,583510,22100,98091,9865,0.20471303123494758,0.3086188018144846
2475,0.2853,19,38,19,583548,22062,98110,9846,0.2043610359776205,0.30857465212485896
2476,0.2854,9,67,9,583615,21995,98119,9837,0.20374041276075439,0.30902865041467703
2477,0.2855,16,28,16,583643,21967,98135,9821,0.20348104783430288,0.30895306404932676
2478,0.2856,13,39,13,583682,21928,98148,9808,0.20311978954388826,0.30904965969246284
2479,0.2857,21,58,21,583740,21870,98169,9787,0.2025825336248101,0.30915753229933346
2480,0.2858,16,37,16,583777,21833,98185,9771,0.2022398014005706,0.3091697253512214
2481,0.2859,14,37,14,583814,21796,98199,9757,0.2018970691763311,0.3092257471555795
2482,0.286,17,42,17,583856,21754,98216,9740,0.20150802178665383,0.30926525687432527
2483,0.2861,32,55,32,583911,21699,98248,9708,0.20099855496683836,0.30910306619543415
2484,0.2862,22,35,22,583946,21664,98270,9686,0.20067434880877394,0.30896331738437
2485,0.2863,10,18,10,583964,21646,98280,9676,0.20050761421319796,0.30892024774918586
2486,0.2864,10,40,10,584004,21606,98290,9666,0.2001370928896958,0.30909439754412893
2487,0.2865,13,19,13,584023,21587,98303,9653,0.19996109526103228,0.30899487836107553
2488,0.2866,16,67,16,584090,21520,98319,9637,0.19934047204416613,0.30930449016272427
2489,0.2867,20,48,20,584138,21472,98339,9617,0.19889584645596353,0.30933770787095116
2490,0.2868,26,54,26,584192,21418,98365,9591,0.19839564266923562,0.3092973007836435
2491,0.2869,22,95,22,584287,21323,98387,9569,0.19751565452591796,0.3097565712805904
2492,0.287,19,62,19,584349,21261,98406,9550,0.1969413464744896,0.3099542371231054
2493,0.2871,11,37,11,584386,21224,98417,9539,0.1965986142502501,0.31008029125897996
2494,0.2872,11,40,11,584426,21184,98428,9528,0.19622809292674792,0.3102370408960667
2495,0.2873,15,67,15,584493,21117,98443,9513,0.1956074697098818,0.3105778648383937
2496,0.2874,21,63,21,584556,21054,98464,9492,0.1950238986253659,0.3107444509919466
2497,0.2875,9,37,9,584593,21017,98473,9483,0.19468116640112637,0.31091803278688523
2498,0.2876,15,30,15,584623,20987,98488,9468,0.19440327540849975,0.3108849121654901
2499,0.2877,14,26,14,584649,20961,98502,9454,0.19416243654822335,0.3108334703271412
2500,0.2878,15,40,15,584689,20921,98517,9439,0.1937919152247212,0.31090250329380764
2501,0.2879,17,43,17,584732,20878,98534,9422,0.19339360480195636,0.310957095709571
2502,0.288,37,61,37,584793,20817,98571,9385,0.19282855978361554,0.310741010529104
2503,0.2881,31,72,31,584865,20745,98602,9354,0.19216162140131166,0.3107744443336988
2504,0.2882,17,64,17,584929,20681,98619,9337,0.1915687872837082,0.3110467053101472
2505,0.2883,10,21,10,584950,20660,98629,9327,0.19137426358886955,0.3110347817387535
2506,0.2884,20,65,20,585015,20595,98649,9307,0.19077216643817851,0.31125008360644774
2507,0.2885,17,50,17,585065,20545,98666,9290,0.1903090147838008,0.31137925255572313
2508,0.2886,24,28,24,585093,20517,98690,9266,0.1900496498573493,0.3111170802135446
2509,0.2887,11,36,11,585129,20481,98701,9255,0.18971618066619733,0.31123890234059726
2510,0.2888,18,58,18,585187,20423,98719,9237,0.1891789247471192,0.31142953472690493
2511,0.2889,9,28,9,585215,20395,98728,9228,0.1889195598206677,0.3115147014144415
2512,0.289,13,28,13,585243,20367,98741,9215,0.18866019489421615,0.3115069974984788
2513,0.2891,13,34,13,585277,20333,98754,9202,0.18834525176923933,0.311562552903335
2514,0.2892,17,47,17,585324,20286,98771,9185,0.18790988921412427,0.3116623121034237
2515,0.2893,10,28,10,585352,20258,98781,9175,0.18765052428767276,0.3117249345972208
2516,0.2894,10,35,10,585387,20223,98791,9165,0.18732631812960837,0.31186198448346264
2517,0.2895,20,46,20,585433,20177,98811,9145,0.18690021860758085,0.311881863447241
2518,0.2896,32,73,32,585506,20104,98843,9113,0.18622401719218942,0.31190745114145874
2519,0.2897,14,25,14,585531,20079,98857,9099,0.18599244136500057,0.3118445404071561
2520,0.2898,21,46,21,585577,20033,98878,9078,0.18556634184297308,0.3118408848888736
2521,0.2899,19,38,19,585615,19995,98897,9059,0.185214346585646,0.3117987196255249
2522,0.29,1,18,1,585633,19977,98898,9058,0.18504761199007003,0.311968314103668
2523,0.2901,7,26,7,585659,19951,98905,9051,0.18480677312979363,0.3120819253844562
2524,0.2902,22,52,22,585711,19899,98927,9029,0.1843250954092408,0.31211974557522126
2525,0.2903,19,54,19,585765,19845,98946,9010,0.18382489162251286,0.3122509097210189
2526,0.2904,16,35,16,585800,19810,98962,8994,0.18350068546444848,0.3122482988473823
2527,0.2905,16,33,16,585833,19777,98978,8978,0.1831950053725592,0.31222396105025213
2528,0.2906,28,79,28,585912,19698,99006,8950,0.1824632257586424,0.3124127338732198
2529,0.2907,16,77,16,585989,19621,99022,8934,0.18174997221090075,0.31286990019261074
2530,0.2908,37,74,37,586063,19547,99059,8897,0.18106450776242172,0.3127900435944312
2531,0.2909,30,50,30,586113,19497,99089,8867,0.180601356108044,0.31261458186433505
2532,0.291,9,23,9,586136,19474,99098,8858,0.18038830634703026,0.31265000705915574
2533,0.2911,24,40,24,586176,19434,99122,8834,0.1800177850235281,0.3125088439224565
2534,0.2912,20,20,20,586196,19414,99142,8814,0.17983252436177702,0.31224316281706105
2535,0.2913,11,40,11,586236,19374,99153,8803,0.17946200303827486,0.31241792951698194
2536,0.2914,5,14,5,586250,19360,99158,8798,0.17933232057504908,0.31245116840684706
2537,0.2915,8,32,8,586282,19328,99166,8790,0.17903590351624735,0.31261113877231667
2538,0.2916,8,15,8,586297,19313,99174,8782,0.17889695801993405,0.3125823100195764
2539,0.2917,5,35,5,586332,19278,99179,8777,0.17857275186186966,0.31284975940117626
2540,0.2918,26,52,26,586384,19226,99205,8751,0.17809107414131684,0.31279265110626586
2541,0.2919,13,22,13,586406,19204,99218,8738,0.17788728741339063,0.31271920406556436
2542,0.292,15,54,15,586460,19150,99233,8723,0.17738708362666272,0.31295518961001684
2543,0.2921,13,41,13,586501,19109,99246,8710,0.177007299270073,0.3130953664761494
2544,0.2922,17,46,17,586547,19063,99263,8693,0.1765811997480455,0.31319354373829084
2545,0.2923,19,31,19,586578,19032,99282,8674,0.17629404572233132,0.3130729805818234
2546,0.2924,14,37,14,586615,18995,99296,8660,0.17595131349809182,0.31314409690833483
2547,0.2925,16,46,16,586661,18949,99312,8644,0.17552521397606433,0.3132678577900192
2548,0.2926,10,54,10,586715,18895,99322,8634,0.1750250101893364,0.3136328962185332
2549,0.2927,11,36,11,586751,18859,99333,8623,0.17469154099818446,0.3137690124445091
2550,0.2928,9,46,9,586797,18813,99342,8614,0.17426544147615694,0.31407007693149086
2551,0.2929,15,48,15,586845,18765,99357,8599,0.17382081588795434,0.31424499342201434
2552,0.293,9,27,9,586872,18738,99366,8590,0.1735707139945904,0.31432962529274006
2553,0.2931,14,30,14,586902,18708,99380,8576,0.17329282300196377,0.3143234129892978
2554,0.2932,24,52,24,586954,18656,99404,8552,0.17281114528141095,0.31431931784769185
2555,0.2933,10,31,10,586985,18625,99414,8542,0.17252399125569676,0.31442558987006297
2556,0.2934,10,30,10,587015,18595,99424,8532,0.17224610026307013,0.3145205883437166
2557,0.2935,5,22,5,587037,18573,99429,8527,0.17204231353514396,0.31464944649446497
2558,0.2936,13,52,13,587089,18521,99442,8514,0.17156063581459113,0.3149250970963566
2559,0.2937,24,49,24,587138,18472,99466,8490,0.17110674719330096,0.3148876196127884
2560,0.2938,8,25,8,587163,18447,99474,8482,0.17087517136611213,0.31497641947343014
2561,0.2939,17,29,17,587192,18418,99491,8465,0.17060654340657305,0.31488301156864934
2562,0.294,7,14,7,587206,18404,99498,8458,0.1704768609433473,0.31486858759586034
2563,0.2941,14,27,14,587233,18377,99512,8444,0.17022675904998333,0.31482793333581893
2564,0.2942,8,21,8,587254,18356,99520,8436,0.1700322353551447,0.31487011048074054
2565,0.2943,9,52,9,587306,18304,99529,8427,0.16955055763459187,0.3152519546593842
2566,0.2944,9,11,9,587317,18293,99538,8418,0.16944866427062877,0.3151510613604882
2567,0.2945,24,60,24,587377,18233,99562,8394,0.16889288228537552,0.3152439253389417
2568,0.2946,13,40,13,587417,18193,99575,8381,0.16852236096187337,0.31538345751486413
2569,0.2947,9,42,9,587459,18151,99584,8372,0.16813331357219607,0.3156505674320401
2570,0.2948,3,6,3,587465,18145,99587,8369,0.16807773537367077,0.3156445651354002
2571,0.2949,15,37,15,587502,18108,99602,8354,0.16773500314943124,0.31569798201194166
2572,0.295,18,29,18,587531,18079,99620,8336,0.16746637518989219,0.3155782699223926
2573,0.2951,9,9,9,587540,18070,99629,8327,0.1673830078921042,0.3154525135432057
2574,0.2952,14,23,14,587563,18047,99643,8313,0.16716995813109045,0.3153641881638847
2575,0.2953,8,34,8,587597,18013,99651,8305,0.1668550150061136,0.315563492666616
2576,0.2954,12,35,12,587632,17978,99663,8293,0.16653080884804922,0.3156712725058049
2577,0.2955,10,40,10,587672,17938,99673,8283,0.16616028752454703,0.3158918424163838
2578,0.2956,19,41,19,587713,17897,99692,8264,0.1657805031679573,0.31589006536447384
2579,0.2957,10,39,10,587752,17858,99702,8254,0.1654192448775427,0.3160998774509804
2580,0.2958,22,43,22,587795,17815,99724,8232,0.16502093445477786,0.31604407417360925
2581,0.2959,14,31,14,587826,17784,99738,8218,0.1647337804290637,0.31605261133758944
2582,0.296,6,20,6,587846,17764,99744,8212,0.1645485197673126,0.31613797351401296
2583,0.2961,10,25,10,587871,17739,99754,8202,0.16431694394012375,0.3161790216259975
2584,0.2962,30,58,30,587929,17681,99784,8172,0.16377968802104562,0.3160948439252698
2585,0.2963,15,19,15,587948,17662,99799,8157,0.1636036903923821,0.315930128974786
2586,0.2964,13,48,13,587996,17614,99812,8144,0.1631590648041795,0.31617361596397237
2587,0.2965,22,61,22,588057,17553,99834,8122,0.16259401978583868,0.31633885102239534
2588,0.2966,13,40,13,588097,17513,99847,8109,0.1622234984623365,0.3164858324877059
2589,0.2967,21,45,21,588142,17468,99868,8088,0.16180666197339658,0.3164814524964783
2590,0.2968,24,46,24,588188,17422,99892,8064,0.1613805624513691,0.3164090088676136
2591,0.2969,20,42,20,588230,17380,99912,8044,0.1609915150616918,0.31639395846444307
2592,0.297,14,33,14,588263,17347,99926,8030,0.16068583496980252,0.3164282618118769
2593,0.2971,21,56,21,588319,17291,99947,8009,0.16016710511689947,0.31656126482213437
2594,0.2972,20,36,20,588355,17255,99967,7989,0.15983363592574754,0.31647124069085725
2595,0.2973,14,27,14,588382,17228,99981,7975,0.15958353403238357,0.31643058366067534
2596,0.2974,17,39,17,588421,17189,99998,7958,0.15922227574196895,0.3164592197876486
2597,0.2975,21,51,21,588472,17138,100019,7937,0.1587498610545037,0.31653040877367894
2598,0.2976,25,46,25,588518,17092,100044,7912,0.15832376153247618,0.3164293713005919
2599,0.2977,16,42,16,588560,17050,100060,7896,0.15793471414279892,0.31652369117293355
2600,0.2978,20,49,20,588609,17001,100080,7876,0.15748082552150877,0.31659766048960886
2601,0.2979,11,40,11,588649,16961,100091,7865,0.1571103041980066,0.3168049625392733
2602,0.298,16,52,16,588701,16909,100107,7849,0.15662862647745376,0.3170288391630988
2603,0.2981,8,22,8,588723,16887,100115,7841,0.1564248397495276,0.3170899385312197
2604,0.2982,15,31,15,588754,16856,100130,7826,0.1561376857238134,0.3170731707317073
2605,0.2983,35,77,35,588831,16779,100165,7791,0.15542443217607174,0.3170940170940171
2606,0.2984,7,27,7,588858,16752,100172,7784,0.15517433028270777,0.3172481252037822
2607,0.2985,15,54,15,588912,16698,100187,7769,0.15467412649597984,0.3175297339273307
2608,0.2986,6,37,6,588949,16661,100193,7763,0.15433139427174034,0.3178431051424828
2609,0.2987,21,34,21,588983,16627,100214,7742,0.1540164511467635,0.3176987155812713
2610,0.2988,15,51,15,589034,16576,100229,7727,0.15354403645929823,0.31794428671357444
2611,0.2989,24,58,24,589092,16518,100253,7703,0.1530067805402201,0.3180298088435655
2612,0.299,11,37,11,589129,16481,100264,7692,0.15266404831598057,0.3182062631861995
2613,0.2991,27,84,27,589213,16397,100291,7665,0.15188595353662604,0.31855207380932593
2614,0.2992,16,37,16,589250,16360,100307,7649,0.15154322131238654,0.3185888625098921
2615,0.2993,5,3,5,589253,16357,100312,7644,0.15151543221312386,0.318486729719595
2616,0.2994,4,32,4,589285,16325,100316,7640,0.15121901515432212,0.31879824744418944
2617,0.2995,15,48,15,589333,16277,100331,7625,0.15077438956611952,0.3190109614258221
2618,0.2996,9,58,9,589391,16219,100340,7616,0.1502371336470414,0.3195301027900147
2619,0.2997,8,35,8,589426,16184,100348,7608,0.149912927488977,0.31977135171486215
2620,0.2998,7,21,7,589447,16163,100355,7601,0.14971840379413837,0.3198535600067329
2621,0.2999,14,34,14,589481,16129,100369,7587,0.14940346066916152,0.31991060887164785
2622,0.3,13,21,13,589502,16108,100382,7574,0.14920893697432286,0.3198209610674774
2623,0.3001,18,45,18,589547,16063,100400,7556,0.14879210048538294,0.31991193530632117
2624,0.3002,39,91,39,589638,15972,100439,7517,0.1479491644744155,0.32002213802205287
2625,0.3003,11,40,11,589678,15932,100450,7506,0.14757864315091335,0.32024916801774894
2626,0.3004,21,44,21,589722,15888,100471,7485,0.14717106969506094,0.3202413040687973
2627,0.3005,8,27,8,589749,15861,100479,7477,0.146920967801697,0.3203787813865798
2628,0.3006,8,22,8,589771,15839,100487,7469,0.1467171810737708,0.3204479148790115
2629,0.3007,18,38,18,589809,15801,100505,7451,0.14636518581644373,0.3204455530707036
2630,0.3008,22,33,22,589842,15768,100527,7429,0.14605950572455445,0.320256929775402
2631,0.3009,5,14,5,589856,15754,100532,7424,0.1459298232613287,0.32030373630166536
2632,0.301,9,24,9,589880,15730,100541,7415,0.14570751046722738,0.32037157053359255
2633,0.3011,10,33,10,589913,15697,100551,7405,0.1454018303753381,0.32053501861310707
2634,0.3012,6,25,6,589938,15672,100557,7399,0.14517025454814925,0.3207056477829309
2635,0.3013,5,22,5,589960,15650,100562,7394,0.14496646782022304,0.3208644332581149
2636,0.3014,16,26,16,589986,15624,100578,7378,0.14472562895994665,0.32075471698113206
2637,0.3015,13,23,13,590009,15601,100591,7365,0.1445125791989329,0.32069145693634066
2638,0.3016,6,19,6,590028,15582,100597,7359,0.14433658157026938,0.320779390610697
2639,0.3017,11,34,11,590062,15548,100608,7348,0.14402163844529253,0.32092941998602376
2640,0.3018,15,47,15,590109,15501,100623,7333,0.14358627589017747,0.3211439082070596
2641,0.3019,12,34,12,590143,15467,100635,7321,0.14327133276520063,0.32126557837458314
2642,0.302,3,12,3,590155,15455,100638,7318,0.14316017636814998,0.3213454529486673
2643,0.3021,16,35,16,590190,15420,100654,7302,0.1428359702100856,0.3213625561130182
2644,0.3022,13,22,13,590212,15398,100667,7289,0.1426321834821594,0.32128531758275664
2645,0.3023,12,27,12,590239,15371,100679,7277,0.14238208158879542,0.3213087248322148
2646,0.3024,15,31,15,590270,15340,100694,7262,0.14209492756308126,0.3212990000884877
2647,0.3025,10,26,10,590296,15314,100704,7252,0.14185408870280486,0.3213684303819906
2648,0.3026,14,40,14,590336,15274,100718,7238,0.14148356737930268,0.3215174129353234
2649,0.3027,6,23,6,590359,15251,100724,7232,0.14127051761828893,0.32166525819508074
2650,0.3028,8,24,8,590383,15227,100732,7224,0.14104820482418765,0.32176740456995234
2651,0.3029,11,25,11,590408,15202,100743,7213,0.1408166289969988,0.3217934418915904
2652,0.303,16,45,16,590453,15157,100759,7197,0.14039979250805884,0.32195580209358504
2653,0.3031,10,36,10,590489,15121,100769,7187,0.14006632331690688,0.32217141832526447
2654,0.3032,9,35,9,590524,15086,100778,7178,0.1397421171588425,0.32240388070427595
2655,0.3033,20,36,20,590560,15050,100798,7158,0.13940864796769054,0.3223162824207493
2656,0.3034,16,34,16,590594,15016,100814,7142,0.1390937048427137,0.32232150916147667
2657,0.3035,8,12,8,590606,15004,100822,7134,0.13898254844566305,0.32225133255036587
2658,0.3036,10,26,10,590632,14978,100832,7124,0.13874170958538665,0.3223237716043797
2659,0.3037,19,52,19,590684,14926,100851,7105,0.13826003186483382,0.32250011347646496
2660,0.3038,10,33,10,590717,14893,100861,7095,0.13795435177294454,0.3226760050936875
2661,0.3039,15,37,15,590754,14856,100876,7080,0.13761161954870502,0.3227571115973742
2662,0.304,18,61,18,590815,14795,100894,7062,0.13704657453036423,0.32310015098137895
2663,0.3041,8,25,8,590840,14770,100902,7054,0.13681499870317537,0.32322214076246336
2664,0.3042,16,34,16,590874,14736,100918,7038,0.13650005557819853,0.32322953981813174
2665,0.3043,8,28,8,590902,14708,100926,7030,0.13624069065174702,0.323396816634465
2666,0.3044,24,47,24,590949,14661,100950,7006,0.13580532809663196,0.3233488715558222
2667,0.3045,18,25,18,590974,14636,100968,6988,0.1355737522694431,0.32315945246022937
2668,0.3046,11,39,11,591013,14597,100979,6977,0.1352124939790285,0.32339853527394086
2669,0.3047,19,27,19,591040,14570,100998,6958,0.13496239208566452,0.3232069862504645
2670,0.3048,12,22,12,591062,14548,101010,6946,0.13475860535773834,0.32315995161440403
2671,0.3049,13,27,13,591089,14521,101023,6933,0.13450850346437437,0.32315652092849817
2672,0.305,10,12,10,591101,14509,101033,6923,0.13439734706732373,0.3230216498693542
2673,0.3051,26,39,26,591140,14470,101059,6897,0.13403608877690912,0.32278747601441476
2674,0.3052,16,29,16,591169,14441,101075,6881,0.13376746081737004,0.3227183191070256
2675,0.3053,11,19,11,591188,14422,101086,6870,0.13359146318870652,0.3226563967687394
2676,0.3054,12,50,12,591238,14372,101098,6858,0.1331283115343288,0.3230334432406971
2677,0.3055,28,65,28,591303,14307,101126,6830,0.1325262143836378,0.32313005629938024
2678,0.3056,7,26,7,591329,14281,101133,6823,0.13228537552336136,0.3233036391205459
2679,0.3057,12,28,12,591357,14253,101145,6811,0.13202601059690985,0.32334789213824533
2680,0.3058,11,25,11,591382,14228,101156,6800,0.131794434769721,0.323378352672627
2681,0.3059,25,19,25,591401,14209,101181,6775,0.13161843714105748,0.32286504003049943
2682,0.306,5,19,5,591420,14190,101186,6770,0.13144243951239393,0.32299618320610685
2683,0.3061,27,48,27,591468,14142,101213,6743,0.13099781392419133,0.3228632990184343
2684,0.3062,17,34,17,591502,14108,101230,6726,0.1306828707992145,0.3228376691945858
2685,0.3063,7,23,7,591525,14085,101237,6719,0.13046982103820076,0.3229667371659296
2686,0.3064,3,7,3,591532,14078,101240,6716,0.13040497980658786,0.32297778205251515
2687,0.3065,14,21,14,591553,14057,101254,6702,0.13021045611174922,0.32284792138349633
2688,0.3066,22,39,22,591592,14018,101276,6680,0.1298491978213346,0.3227364962798338
2689,0.3067,24,51,24,591643,13967,101300,6656,0.12937678313386936,0.32274644814042575
2690,0.3068,17,23,17,591666,13944,101317,6639,0.1291637333728556,0.3225477335665355
2691,0.3069,11,26,11,591692,13918,101328,6628,0.1289228945125792,0.3225932054901197
2692,0.307,28,57,28,591749,13861,101356,6600,0.12839490162658862,0.3225648795269048
2693,0.3071,6,15,6,591764,13846,101362,6594,0.1282559561302753,0.3226027397260274
2694,0.3072,13,40,13,591804,13806,101375,6581,0.12788543480677314,0.32280374748614316
2695,0.3073,18,39,18,591843,13767,101393,6563,0.12752417651635853,0.32282341367437284
2696,0.3074,6,21,6,591864,13746,101399,6557,0.12732965282151987,0.3229571984435798
2697,0.3075,24,61,24,591925,13685,101423,6533,0.12676460780317908,0.32312790582649126
2698,0.3076,12,31,12,591956,13654,101435,6521,0.1264774537774649,0.32322180916976456
2699,0.3077,13,42,13,591998,13612,101448,6508,0.12608840638778762,0.32345924453280317
2700,0.3078,6,16,6,592014,13596,101454,6502,0.12594019785838675,0.32351477758980995
2701,0.3079,9,23,9,592037,13573,101463,6493,0.125727148097373,0.32358217880992723
2702,0.308,6,18,6,592055,13555,101469,6487,0.12556041350179703,0.32367029238598943
2703,0.3081,13,37,13,592092,13518,101482,6474,0.12521768127755753,0.3238295318127251
2704,0.3082,10,17,10,592109,13501,101492,6464,0.1250602097150691,0.32376659153518655
2705,0.3083,13,26,13,592135,13475,101505,6451,0.1248193708547927,0.3237478671083007
2706,0.3084,13,20,13,592155,13455,101518,6438,0.1246341101930416,0.32363142814055196
2707,0.3085,12,25,12,592180,13430,101530,6426,0.12440253436585276,0.3236301369863014
2708,0.3086,15,27,15,592207,13403,101545,6411,0.12415243247248879,0.3235590996265267
2709,0.3087,14,27,14,592234,13376,101559,6397,0.12390233057912482,0.3235219744095484
2710,0.3088,13,37,13,592271,13339,101572,6384,0.12355959835488532,0.3236830096841251
2711,0.3089,13,14,13,592285,13325,101585,6371,0.12342991589165957,0.3234666937449228
2712,0.309,13,27,13,592312,13298,101598,6358,0.1231798139982956,0.32346357346357346
2713,0.3091,12,12,12,592324,13286,101610,6346,0.12306865760124495,0.3232477587612062
2714,0.3092,19,25,19,592349,13261,101629,6327,0.1228370817740561,0.3230038799264856
2715,0.3093,9,21,9,592370,13240,101638,6318,0.12264255807921746,0.3230391655588506
2716,0.3094,10,30,10,592400,13210,101648,6308,0.12236466708659083,0.32318885131673325
2717,0.3095,7,10,7,592410,13200,101655,6301,0.1222720367557153,0.3231116353007538
2718,0.3096,7,29,7,592439,13171,101662,6294,0.12200340879617622,0.3233496018494734
2719,0.3097,12,17,12,592456,13154,101674,6282,0.12184593723368779,0.3232146532208273
2720,0.3098,6,13,6,592469,13141,101680,6276,0.1217255178035496,0.32322191893701396
2721,0.3099,8,32,8,592501,13109,101688,6268,0.12142910074474786,0.32347628631883163
2722,0.31,11,26,11,592527,13083,101699,6257,0.12118826188447145,0.3235263702171665
2723,0.3101,13,39,13,592566,13044,101712,6244,0.12082700359405683,0.32372459560348404
2724,0.3102,16,27,16,592593,13017,101728,6228,0.12057690170069288,0.3236165237724084
2725,0.3103,8,23,8,592616,12994,101736,6220,0.12036385193967913,0.3237222858332466
2726,0.3104,9,20,9,592636,12974,101745,6211,0.12017859127792804,0.3237425071670576
2727,0.3105,5,11,5,592647,12963,101750,6206,0.12007669791396496,0.3237518910741301
2728,0.3106,26,48,26,592695,12915,101776,6180,0.11963207232576235,0.3236449332285939
2729,0.3107,6,7,6,592702,12908,101782,6174,0.11956723109414946,0.3235509904622157
2730,0.3108,16,42,16,592744,12866,101798,6158,0.1191781837044722,0.3236963835155593
2731,0.3109,9,14,9,592758,12852,101807,6149,0.11904850124124644,0.32361454660281036
2732,0.311,6,18,6,592776,12834,101813,6143,0.11888176664567046,0.323707646097908
2733,0.3111,3,14,3,592790,12820,101816,6140,0.1187520841824447,0.32383966244725737
2734,0.3112,3,8,3,592798,12812,101819,6137,0.11867797991774427,0.32386933347406194
2735,0.3113,18,30,18,592828,12782,101837,6119,0.11840008892511764,0.32373948468335007
2736,0.3114,8,15,8,592843,12767,101845,6111,0.11826114342880432,0.32371013878588834
2737,0.3115,10,29,10,592872,12738,101855,6101,0.11799251546926526,0.3238494612240565
2738,0.3116,16,35,16,592907,12703,101871,6085,0.11766830931120086,0.32387694272940176
2739,0.3117,14,19,14,592926,12684,101885,6071,0.11749231168253733,0.32370034657424684
2740,0.3118,25,23,25,592949,12661,101910,6046,0.11727926192152359,0.32319452611321964
2741,0.3119,17,29,17,592978,12632,101927,6029,0.11701063396198451,0.3230802207813086
2742,0.312,13,23,13,593001,12609,101940,6016,0.11679758420097076,0.32300671140939596
2743,0.3121,13,22,13,593023,12587,101953,6003,0.11659379747304457,0.3229155459924691
2744,0.3122,17,46,17,593069,12541,101970,5986,0.11616769795101708,0.32309602202191395
2745,0.3123,7,30,7,593099,12511,101977,5979,0.11588980695839046,0.32336398053001625
2746,0.3124,5,19,5,593118,12492,101982,5974,0.11571380932972693,0.3235134842413083
2747,0.3125,7,21,7,593139,12471,101989,5967,0.1155192856348883,0.323625122030589
2748,0.3126,10,16,10,593155,12455,101999,5957,0.11537107710548743,0.3235389963067565
2749,0.3127,8,13,8,593168,12442,102007,5949,0.11525065767534921,0.32347343809472023
2750,0.3128,15,53,15,593221,12389,102022,5934,0.11475971692170885,0.32385526387600283
2751,0.3129,9,25,9,593246,12364,102031,5925,0.11452814109451999,0.32396522499863306
2752,0.313,12,33,12,593279,12331,102043,5913,0.1142224610026307,0.3241065555799167
2753,0.3131,8,22,8,593301,12309,102051,5905,0.11401867427470451,0.3242011639398265
2754,0.3132,10,16,10,593317,12293,102061,5895,0.11387046574530364,0.324114800967671
2755,0.3133,15,28,15,593345,12265,102076,5880,0.11361110081885213,0.32405621383301186
2756,0.3134,21,44,21,593389,12221,102097,5859,0.11320352736299974,0.32405973451327436
2757,0.3135,18,35,18,593424,12186,102115,5841,0.11287932120493534,0.32401397903145285
2758,0.3136,11,18,11,593442,12168,102126,5830,0.11271258660935937,0.32392488054228247
2759,0.3137,16,31,16,593473,12137,102142,5814,0.1124254325836452,0.32388167790095257
2760,0.3138,12,17,12,593490,12120,102154,5802,0.11226796102115677,0.3237361901573485
2761,0.3139,11,43,11,593533,12077,102165,5791,0.11186965059839193,0.32409894783971344
2762,0.314,5,14,5,593547,12063,102170,5786,0.11173996813516618,0.3241638187013278
2763,0.3141,19,36,19,593583,12027,102189,5767,0.11140649894401423,0.3240980105653591
2764,0.3142,20,36,20,593619,11991,102209,5747,0.11107302975286228,0.3239936858721389
2765,0.3143,7,14,7,593633,11977,102216,5740,0.11094334728963652,0.32398261556696956
2766,0.3144,23,37,23,593670,11940,102239,5717,0.11060061506539702,0.3237809367389704
2767,0.3145,16,17,16,593687,11923,102255,5701,0.1104431435029086,0.323479346345892
2768,0.3146,12,24,12,593711,11899,102267,5689,0.1102208307088073,0.3234591767113941
2769,0.3147,9,21,9,593732,11878,102276,5680,0.11002630701396865,0.323499259596765
2770,0.3148,16,39,16,593771,11839,102292,5664,0.10966504872355404,0.3236016682854368
2771,0.3149,16,27,16,593798,11812,102308,5648,0.10941494683019008,0.3234822451317297
2772,0.315,2,19,2,593817,11793,102310,5646,0.10923894920152655,0.32375709616377085
2773,0.3151,9,23,9,593840,11770,102319,5637,0.1090258994405128,0.32383523869707587
2774,0.3152,2,11,2,593851,11759,102321,5635,0.1089240060765497,0.3239622858456939
2775,0.3153,5,12,5,593863,11747,102326,5630,0.10881284967949906,0.3239914829947632
2776,0.3154,12,16,12,593879,11731,102338,5618,0.10866464115009819,0.3238226987146233
2777,0.3155,5,17,5,593896,11714,102343,5613,0.10850716958760977,0.32394528770127545
2778,0.3156,12,22,12,593918,11692,102355,5601,0.10830338285968358,0.3238882784941884
2779,0.3157,5,15,5,593933,11677,102360,5596,0.10816443736337027,0.3239738319921264
2780,0.3158,8,24,8,593957,11653,102368,5588,0.10794212456926897,0.3241111304448698
2781,0.3159,8,11,8,593968,11642,102376,5580,0.10784023120530586,0.3240041806991058
2782,0.316,6,15,6,593983,11627,102382,5574,0.10770128570899255,0.32405092727167023
2783,0.3161,5,12,5,593995,11615,102387,5569,0.1075901293119419,0.32408054003724396
2784,0.3162,15,25,15,594020,11590,102402,5554,0.10735855348475305,0.3239617358842744
2785,0.3163,4,35,4,594055,11555,102406,5550,0.10703434732668865,0.3244665302543116
2786,0.3164,10,12,10,594067,11543,102416,5540,0.106923190929638,0.32429901071240413
2787,0.3165,3,16,3,594083,11527,102419,5537,0.10677498240023714,0.3244842944210033
2788,0.3166,9,12,9,594095,11515,102428,5528,0.10666382600318648,0.3243560406031802
2789,0.3167,4,10,4,594105,11505,102432,5524,0.10657119567231094,0.3243878090316519
2790,0.3168,4,4,4,594109,11501,102436,5520,0.10653414353996073,0.32430526996063685
2791,0.3169,7,16,7,594125,11485,102443,5513,0.10638593501055986,0.3243322743852218
2792,0.317,7,22,7,594147,11463,102450,5506,0.10618214828263367,0.32447404089810833
2793,0.3171,7,21,7,594168,11442,102457,5499,0.10598762458779502,0.32459713122011685
2794,0.3172,2,8,2,594176,11434,102459,5497,0.10591352032309459,0.32467072234363004
2795,0.3173,2,19,2,594195,11415,102461,5495,0.10573752269443107,0.3249556475458309
2796,0.3174,7,15,7,594210,11400,102468,5488,0.10559857719811776,0.324964471814306
2797,0.3175,12,27,12,594237,11373,102480,5476,0.10534847530475379,0.3250044513027479
2798,0.3176,5,10,5,594247,11363,102485,5471,0.10525584497387824,0.3249970298206012
2799,0.3177,6,15,6,594262,11348,102491,5465,0.10511689947756493,0.32504609528341166
2800,0.3178,15,21,15,594283,11327,102506,5450,0.1049223757827263,0.32484949633426713
2801,0.3179,9,28,9,594311,11299,102515,5441,0.10466301085627477,0.32502986857825567
2802,0.318,9,18,9,594329,11281,102524,5432,0.10449627626069881,0.3250164542571651
2803,0.3181,6,19,6,594348,11262,102530,5426,0.10432027863203527,0.325143815915628
2804,0.3182,5,6,5,594354,11256,102535,5421,0.10426470043350995,0.3250584637524735
2805,0.3183,0,7,0,594361,11249,102535,5421,0.10419985920189707,0.32519496100779843
2806,0.3184,2,13,2,594374,11236,102537,5419,0.10407943977175886,0.32536775743020113
2807,0.3185,10,21,10,594395,11215,102547,5409,0.10388491607692023,0.32537295476419636
2808,0.3186,14,22,14,594417,11193,102561,5395,0.10368112934899404,0.32523510971786834
2809,0.3187,12,29,12,594446,11164,102573,5383,0.10341250138945496,0.3253157672085574
2810,0.3188,9,12,9,594458,11152,102582,5374,0.10330134499240431,0.325184557666707
2811,0.3189,5,25,5,594483,11127,102587,5369,0.10306976916521546,0.3254728419010669
2812,0.319,14,22,14,594505,11105,102601,5355,0.10286598243728927,0.3253341433778858
2813,0.3191,6,10,6,594515,11095,102607,5349,0.10277335210641372,0.3252858185356361
2814,0.3192,13,21,13,594536,11074,102620,5336,0.10257882841157509,0.3251675807434491
2815,0.3193,11,29,11,594565,11045,102631,5325,0.10231020045203601,0.3252901649358583
2816,0.3194,11,19,11,594584,11026,102642,5314,0.10213420282337249,0.32521419828641374
2817,0.3195,6,16,6,594600,11010,102648,5308,0.10198599429397162,0.3252849613923275
2818,0.3196,11,29,11,594629,10981,102659,5297,0.10171736633443254,0.3254085268460499
2819,0.3197,12,17,12,594646,10964,102671,5285,0.10155989477194413,0.32525078466367163
2820,0.3198,9,17,9,594663,10947,102680,5276,0.10140242320945571,0.325217284102817
2821,0.3199,8,34,8,594697,10913,102688,5268,0.10108748008447886,0.32556702305172736
2822,0.32,8,33,8,594730,10880,102696,5260,0.10078179999258957,0.32589838909541513
2823,0.3201,1,0,1,594730,10880,102697,5259,0.10078179999258957,0.325856620608464
2824,0.3202,5,17,5,594747,10863,102702,5254,0.10062432843010115,0.32599118942731276
2825,0.3203,9,15,9,594762,10848,102711,5245,0.10048538293378784,0.3259181010377183
2826,0.3204,8,17,8,594779,10831,102719,5237,0.10032791137129941,0.32592730893701766
2827,0.3205,11,20,11,594799,10811,102730,5226,0.10014265070954834,0.32587142233584837
2828,0.3206,7,34,7,594833,10777,102737,5219,0.09982770758457149,0.3262690672668167
2829,0.3207,2,8,2,594841,10769,102739,5217,0.09975360331987106,0.32634805454772925
2830,0.3208,7,16,7,594857,10753,102746,5210,0.09960539479047019,0.32637975317922696
2831,0.3209,23,28,23,594885,10725,102769,5187,0.09934602986401868,0.32598039215686275
2832,0.321,6,22,6,594907,10703,102775,5181,0.09914224313609248,0.32617728531855955
2833,0.3211,13,23,13,594930,10680,102788,5168,0.09892919337507873,0.32609793033821305
2834,0.3212,7,19,7,594949,10661,102795,5161,0.09875319574641521,0.326191379092403
2835,0.3213,7,18,7,594967,10643,102802,5154,0.09858646115083923,0.32626448059758184
2836,0.3214,6,10,6,594977,10633,102808,5148,0.09849383081996368,0.32621506875356443
2837,0.3215,8,5,8,594982,10628,102816,5140,0.09844751565452592,0.32597666159309996
2838,0.3216,12,42,12,595024,10586,102828,5128,0.09805846826484864,0.32633320605829197
2839,0.3217,3,14,3,595038,10572,102831,5125,0.09792878580162288,0.32649550869592914
2840,0.3218,16,42,16,595080,10530,102847,5109,0.0975397384119456,0.3266832917705736
2841,0.3219,7,12,7,595092,10518,102854,5102,0.09742858201489496,0.3266325224071703
2842,0.322,5,14,5,595106,10504,102859,5097,0.0972988995516692,0.32670982629318635
2843,0.3221,9,22,9,595128,10482,102868,5088,0.097095112823743,0.3267822736030829
2844,0.3222,12,13,12,595141,10469,102880,5076,0.0969746933936048,0.3265358636217433
2845,0.3223,7,12,7,595153,10457,102887,5069,0.09686353699655414,0.3264846064665722
2846,0.3224,12,18,12,595171,10439,102899,5057,0.09669680240097818,0.3263422818791946
2847,0.3225,4,21,4,595192,10418,102903,5053,0.09650227870613953,0.32661107879257967
2848,0.3226,24,28,24,595220,10390,102927,5029,0.09624291377968802,0.32615604124781117
2849,0.3227,21,37,21,595257,10353,102948,5008,0.09590018155544852,0.32602044137751446
2850,0.3228,9,35,9,595292,10318,102957,4999,0.09557597539738412,0.3263693934843638
2851,0.3229,5,20,5,595312,10298,102962,4994,0.09539071473563304,0.3265759874444154
2852,0.323,9,22,9,595334,10276,102971,4985,0.09518692800770684,0.3266496297752441
2853,0.3231,7,8,7,595342,10268,102978,4978,0.0951128237430064,0.3265118719664174
2854,0.3232,5,15,5,595357,10253,102983,4973,0.0949738782466931,0.3266123735715224
2855,0.3233,13,29,13,595386,10224,102996,4960,0.09470525028715403,0.3266596417281349
2856,0.3234,9,11,9,595397,10213,103005,4951,0.09460335692319093,0.3264969664996043
2857,0.3235,15,11,15,595408,10202,103020,4936,0.09450146355922784,0.32606685163165544
2858,0.3236,16,27,16,595435,10175,103036,4920,0.09425136166586387,0.32593574031136135
2859,0.3237,11,19,11,595454,10156,103047,4909,0.09407536403720033,0.3258546299369399
2860,0.3238,3,10,3,595464,10146,103050,4906,0.0939827337063248,0.3259367525910178
2861,0.3239,14,23,14,595487,10123,103064,4892,0.09376968394531106,0.3258075258075258
2862,0.324,15,24,15,595511,10099,103079,4877,0.09354737115120976,0.3256543803418803
2863,0.3241,13,25,13,595536,10074,103092,4864,0.0933157953240209,0.3256125317980988
2864,0.3242,8,29,8,595565,10045,103100,4856,0.09304716736448182,0.32588416884772836
2865,0.3243,17,43,17,595608,10002,103117,4839,0.092648856941717,0.32605619567414595
2866,0.3244,5,4,5,595612,9998,103122,4834,0.09261180480936677,0.32591693635382957
2867,0.3245,6,30,6,595642,9968,103128,4828,0.09233391381674015,0.3263044065963774
2868,0.3246,13,24,13,595666,9944,103141,4815,0.09211160102263885,0.3262416152855885
2869,0.3247,4,6,4,595672,9938,103145,4811,0.09205602282411353,0.32619160621059057
2870,0.3248,2,17,2,595689,9921,103147,4809,0.0918985512616251,0.3264765784114053
2871,0.3249,10,15,10,595704,9906,103157,4799,0.0917596057653118,0.3263515810948657
2872,0.325,15,26,15,595730,9880,103172,4784,0.09151876690503538,0.3262411347517731
2873,0.3251,22,37,22,595767,9843,103194,4762,0.09117603468079588,0.32605272167066074
2874,0.3252,2,7,2,595774,9836,103196,4760,0.091111193449183,0.32611674431351056
2875,0.3253,3,13,3,595787,9823,103199,4757,0.09099077401904479,0.32626886145404665
2876,0.3254,22,27,22,595814,9796,103221,4735,0.09074067212568084,0.32585506847429635
2877,0.3255,15,31,15,595845,9765,103236,4720,0.09045351809996666,0.3258543320676562
2878,0.3256,3,11,3,595856,9754,103239,4717,0.09035162473600356,0.32596226936631884
2879,0.3257,12,50,12,595906,9704,103251,4705,0.08988847308162584,0.3265320285932403
2880,0.3258,7,31,7,595937,9673,103258,4698,0.08960131905591166,0.3269083571080649
2881,0.3259,3,2,3,595939,9671,103261,4695,0.08958279298973656,0.3268133092022832
2882,0.326,10,18,10,595957,9653,103271,4685,0.08941605839416059,0.32675408006695494
2883,0.3261,20,32,20,595989,9621,103291,4665,0.08911964133535885,0.3265434691306174
2884,0.3262,11,28,11,596017,9593,103302,4654,0.08886027640890733,0.326665262862357
2885,0.3263,7,12,7,596029,9581,103309,4647,0.08874912001185668,0.3266095023896542
2886,0.3264,8,20,8,596049,9561,103317,4639,0.08856385935010559,0.3266901408450704
2887,0.3265,3,17,3,596066,9544,103320,4636,0.08840638778761718,0.32693935119887163
2888,0.3266,6,11,6,596077,9533,103326,4630,0.08830449442365408,0.3269081409305938
2889,0.3267,8,24,8,596101,9509,103334,4622,0.08808218162955278,0.32708230132333166
2890,0.3268,7,10,7,596111,9499,103341,4615,0.08798955129867723,0.32698030324500493
2891,0.3269,1,8,1,596119,9491,103342,4614,0.0879154470339768,0.3271180432470755
2892,0.327,3,14,3,596133,9477,103345,4611,0.08778576457075105,0.32729982964224874
2893,0.3271,10,23,10,596156,9454,103355,4601,0.0875727148097373,0.3273568125222341
2894,0.3272,4,5,4,596161,9449,103359,4597,0.08752639964429954,0.3272817884095116
2895,0.3273,10,16,10,596177,9433,103369,4587,0.08737819111489867,0.32717546362339517
2896,0.3274,13,19,13,596196,9414,103382,4574,0.08720219348623513,0.32699456677151845
2897,0.3275,0,9,0,596205,9405,103382,4574,0.08711882618844714,0.3272050933543172
2898,0.3276,8,19,8,596224,9386,103390,4566,0.08694282855978362,0.32726490825688076
2899,0.3277,14,26,14,596250,9360,103404,4552,0.08670198969950721,0.3271995399654974
2900,0.3278,5,10,5,596260,9350,103409,4547,0.08660935936863166,0.3271929193351083
2901,0.3279,15,19,15,596279,9331,103424,4532,0.08643336173996813,0.3269133665151843
2902,0.328,3,7,3,596286,9324,103427,4529,0.08636852050835525,0.32693279434057604
2903,0.3281,3,8,3,596294,9316,103430,4526,0.08629441624365482,0.32697587053893945
2904,0.3282,2,16,2,596310,9300,103432,4524,0.08614620771425395,0.3272569444444444
2905,0.3283,16,23,16,596333,9277,103448,4508,0.0859331579532402,0.3270221254987305
2906,0.3284,3,16,3,596349,9261,103451,4505,0.08578494942383934,0.32725555716983873
2907,0.3285,0,6,0,596355,9255,103451,4505,0.08572937122531402,0.3273982558139535
2908,0.3286,8,22,8,596377,9233,103459,4497,0.08552558449738783,0.3275309541150765
2909,0.3287,7,8,7,596385,9225,103466,4490,0.0854514802326874,0.32737878235508566
2910,0.3288,2,7,2,596392,9218,103468,4488,0.08538663900107452,0.3274478330658106
2911,0.3289,11,25,11,596417,9193,103479,4477,0.08515506317388566,0.32750548646671546
2912,0.329,11,35,11,596452,9158,103490,4466,0.08483085701582126,0.3278038755137992
2913,0.3291,21,41,21,596493,9117,103511,4445,0.08445107265923153,0.3277540185813302
2914,0.3292,6,10,6,596503,9107,103517,4439,0.084358442328356,0.3276982134947586
2915,0.3293,7,17,7,596520,9090,103524,4432,0.08420097076586758,0.32776216536015385
2916,0.3294,6,8,6,596528,9082,103530,4426,0.08412686650116714,0.32765768433520875
2917,0.3295,3,16,3,596544,9066,103533,4423,0.08397865797176628,0.3278968048039143
2918,0.3296,5,8,5,596552,9058,103538,4418,0.08390455370706584,0.327842089640843
2919,0.3297,5,16,5,596568,9042,103543,4413,0.08375634517766498,0.32798216276477143
2920,0.3298,17,48,17,596616,8994,103560,4396,0.08331171958946237,0.32830470500373415
2921,0.3299,7,20,7,596636,8974,103567,4389,0.08312645892771128,0.3284442116291252
2922,0.33,3,10,3,596646,8964,103570,4386,0.08303382859683575,0.32853932584269663
2923,0.3301,7,11,7,596657,8953,103577,4379,0.08293193523287265,0.3284578457845785
2924,0.3302,6,18,6,596675,8935,103583,4373,0.08276520063729667,0.32859933874361286
2925,0.3303,8,26,8,596701,8909,103591,4365,0.08252436177702027,0.3288383305710411
2926,0.3304,7,11,7,596712,8898,103598,4358,0.08242246841305717,0.3287567893783947
2927,0.3305,5,9,5,596721,8889,103603,4353,0.08233910111526918,0.328726778432261
2928,0.3306,10,23,10,596744,8866,103613,4343,0.08212605135425544,0.3287909758497994
2929,0.3307,1,4,1,596748,8862,103614,4342,0.08208899922190523,0.32883974553165707
2930,0.3308,6,8,6,596756,8854,103620,4336,0.08201489495720479,0.3287338893100834
2931,0.3309,7,35,7,596791,8819,103627,4329,0.08169068879914039,0.3292515972010952
2932,0.331,8,15,8,596806,8804,103635,4321,0.08155174330282708,0.32921904761904763
2933,0.3311,8,18,8,596824,8786,103643,4313,0.0813850087072511,0.3292617757080693
2934,0.3312,6,12,6,596836,8774,103649,4307,0.08127385231020046,0.32925617307545296
2935,0.3313,11,10,11,596846,8764,103660,4296,0.08118122197932491,0.32894333843797857
2936,0.3314,6,14,6,596860,8750,103666,4290,0.08105153951609916,0.3289877300613497
2937,0.3315,8,12,8,596872,8738,103674,4282,0.0809403831190485,0.32887864823348695
2938,0.3316,10,23,10,596895,8715,103684,4272,0.08072733335803475,0.32894432894432896
2939,0.3317,1,9,1,596904,8706,103685,4271,0.08064396606024676,0.329120752099869
2940,0.3318,19,37,19,596941,8669,103704,4252,0.08030123383600726,0.329076696850089
2941,0.3319,4,14,4,596955,8655,103708,4248,0.08017155137278151,0.3292257614508254
2942,0.332,6,9,6,596964,8646,103714,4242,0.08008818407499352,0.3291433891992551
2943,0.3321,8,9,8,596973,8637,103722,4234,0.08000481677720553,0.32895656903115533
2944,0.3322,5,16,5,596989,8621,103727,4229,0.07985660824780466,0.32910505836575876
2945,0.3323,2,2,2,596991,8619,103729,4227,0.07983808218162955,0.32905184493227463
2946,0.3324,11,16,11,597007,8603,103740,4216,0.07968987365222868,0.3288868086434199
2947,0.3325,1,7,1,597014,8596,103741,4215,0.0796250324206158,0.3290141284833346
2948,0.3326,5,7,5,597021,8589,103746,4210,0.07956019118900293,0.32893194780842255
2949,0.3327,0,7,0,597028,8582,103746,4210,0.07949534995739005,0.3291119449656035
2950,0.3328,4,13,4,597041,8569,103750,4206,0.07937493052725185,0.3292367906066536
2951,0.3329,14,32,14,597073,8537,103764,4192,0.07907851346845012,0.32932673422892605
2952,0.333,7,4,7,597077,8533,103771,4185,0.07904146133609989,0.3290611731404309
2953,0.3331,10,16,10,597093,8517,103781,4175,0.07889325280669902,0.32894736842105265
2954,0.3332,7,10,7,597103,8507,103788,4168,0.07880062247582348,0.328836291913215
2955,0.3333,13,22,13,597125,8485,103801,4155,0.07859683574789729,0.3287183544303797
2956,0.3334,7,12,7,597137,8473,103808,4148,0.07848567935084665,0.32865858489818556
2957,0.3335,18,40,18,597177,8433,103826,4130,0.07811515802734448,0.3287431346016079
2958,0.3336,6,3,6,597180,8430,103832,4124,0.07808736892808181,0.32850087621475227
2959,0.3337,4,15,4,597195,8415,103836,4120,0.0779484234317685,0.3286796968488233
2960,0.3338,4,8,4,597203,8407,103840,4116,0.07787431916706807,0.3286752375628843
2961,0.3339,3,10,3,597213,8397,103843,4113,0.07778168883619252,0.32877697841726616
2962,0.334,5,16,5,597229,8381,103848,4108,0.07763348030679165,0.32892945792297223
2963,0.3341,1,12,1,597241,8369,103849,4107,0.07752232390974101,0.32919204873356844
2964,0.3342,3,15,3,597256,8354,103852,4104,0.0773833784134277,0.32942687429764006
2965,0.3343,11,25,11,597281,8329,103863,4093,0.07715180258623884,0.32949605538560617
2966,0.3344,2,9,2,597290,8320,103865,4091,0.07706843528845085,0.3296269438401418
2967,0.3345,8,18,8,597308,8302,103873,4083,0.07690170069287487,0.3296729915220024
2968,0.3346,3,14,3,597322,8288,103876,4080,0.07677201822964912,0.3298835705045278
2969,0.3347,4,11,4,597333,8277,103880,4076,0.07667012486568602,0.3299603335222213
2970,0.3348,10,31,10,597364,8246,103890,4066,0.07638297083997184,0.33024691358024694
2971,0.3349,14,32,14,597396,8214,103904,4052,0.0760865537811701,0.3303440404369803
2972,0.335,8,14,8,597410,8200,103912,4044,0.07595687131794435,0.3302842208428618
2973,0.3351,2,8,2,597418,8192,103914,4042,0.07588276705324391,0.33039071440248485
2974,0.3352,3,1,3,597419,8191,103917,4039,0.07587350402015636,0.33025347506132463
2975,0.3353,7,14,7,597433,8177,103924,4032,0.0757438215569306,0.3302481775739209
2976,0.3354,4,9,4,597442,8168,103928,4028,0.07566045425914261,0.3302722204001312
2977,0.3355,23,37,23,597479,8131,103951,4005,0.07531772203490311,0.3300098879367172
2978,0.3356,11,42,11,597521,8089,103962,3994,0.07492867464522583,0.33054704957378134
2979,0.3357,4,4,4,597525,8085,103966,3990,0.07489162251287562,0.33043478260869563
2980,0.3358,12,31,12,597556,8054,103978,3978,0.07460446848716143,0.3306183510638298
2981,0.3359,1,12,1,597568,8042,103979,3977,0.07449331209011079,0.3308927531408603
2982,0.336,17,19,17,597587,8023,103996,3960,0.07431731446144725,0.3304681632312443
2983,0.3361,10,9,10,597596,8014,104006,3950,0.07423394716365928,0.3301571380809094
2984,0.3362,14,22,14,597618,7992,104020,3936,0.07403016043573307,0.3299798792756539
2985,0.3363,8,20,8,597638,7972,104028,3928,0.073844899773982,0.3300840336134454
2986,0.3364,23,33,23,597671,7939,104051,3905,0.0735392196820927,0.3297028031070584
2987,0.3365,12,27,12,597698,7912,104063,3893,0.07328911778872874,0.32977551884794576
2988,0.3366,3,12,3,597710,7900,104066,3890,0.07317796139167809,0.3299406276505513
2989,0.3367,16,22,16,597732,7878,104082,3874,0.0729741746637519,0.32964601769911506
2990,0.3368,9,6,9,597738,7872,104091,3865,0.07291859646522657,0.3293005026838204
2991,0.3369,6,13,6,597751,7859,104097,3859,0.07279817703508837,0.3293224099675713
2992,0.337,8,35,8,597786,7824,104105,3851,0.07247397087702397,0.3298501070663812
2993,0.3371,11,12,11,597798,7812,104116,3840,0.07236281447997332,0.329557157569516
2994,0.3372,16,37,16,597835,7775,104132,3824,0.07202008225573382,0.3296835934132253
2995,0.3373,2,11,2,597846,7764,104134,3822,0.07191818889177072,0.3298808907301916
2996,0.3374,6,14,6,597860,7750,104140,3816,0.07178850642854497,0.3299325609545219
2997,0.3375,10,15,10,597875,7735,104150,3806,0.07164956093223165,0.32978078156138985
2998,0.3376,11,26,11,597901,7709,104161,3795,0.07140872207195524,0.32988525730180807
2999,0.3377,5,27,5,597928,7682,104166,3790,0.07115862017859127,0.33036959553695955
3000,0.3378,10,16,10,597944,7666,104176,3780,0.0710104116491904,0.3302463742792242
3001,0.3379,10,19,10,597963,7647,104186,3770,0.07083441402052688,0.3302093369536656
3002,0.338,6,20,6,597983,7627,104192,3764,0.07064915335877579,0.33043630936704416
3003,0.3381,14,42,14,598025,7585,104206,3750,0.07026010596909853,0.33083370092633435
3004,0.3382,11,33,11,598058,7552,104217,3739,0.06995442587720924,0.33114870250642103
3005,0.3383,3,11,3,598069,7541,104220,3736,0.06985253251324613,0.33129378380775026
3006,0.3384,13,31,13,598100,7510,104233,3723,0.06956537848753196,0.3314341671859699
3007,0.3385,3,9,3,598109,7501,104236,3720,0.06948201118974397,0.3315212547901257
3008,0.3386,19,21,19,598130,7480,104255,3701,0.06928748749490533,0.33100795993202753
3009,0.3387,9,19,9,598149,7461,104264,3692,0.0691114898662418,0.33103200932484533
3010,0.3388,7,16,7,598165,7445,104271,3685,0.06896328133684093,0.3310871518418688
3011,0.3389,1,9,1,598174,7436,104272,3684,0.06887991403905294,0.331294964028777
3012,0.339,3,22,3,598196,7414,104275,3681,0.06867612731112675,0.33177106804867057
3013,0.3391,11,35,11,598231,7379,104286,3670,0.06835192115306236,0.33215675626753555
3014,0.3392,6,12,6,598243,7367,104292,3664,0.06824076475601171,0.33215483637022936
3015,0.3393,4,15,4,598258,7352,104296,3660,0.0681018192596984,0.3323646930621141
3016,0.3394,5,8,5,598266,7344,104301,3655,0.06802771499499796,0.3323029366306028
3017,0.3395,2,11,2,598277,7333,104303,3653,0.06792582163103486,0.3325141088658292
3018,0.3396,3,13,3,598290,7320,104306,3650,0.06780540220089666,0.33272561531449407
3019,0.3397,11,10,11,598300,7310,104317,3639,0.06771277187002112,0.3323591195542972
3020,0.3398,6,4,6,598304,7306,104323,3633,0.0676757197376709,0.33211445287503427
3021,0.3399,10,22,10,598326,7284,104333,3623,0.06747193300974472,0.33217199963326305
3022,0.34,5,20,5,598346,7264,104338,3618,0.06728667234799363,0.3324756478588495
3023,0.3401,5,12,5,598358,7252,104343,3613,0.06717551595094298,0.3325356649792913
3024,0.3402,5,12,5,598370,7240,104348,3608,0.06706435955389232,0.3325958702064897
3025,0.3403,3,9,3,598379,7231,104351,3605,0.06698099225610434,0.332687338501292
3026,0.3404,3,8,3,598387,7223,104354,3602,0.0669068879914039,0.33274826789838335
3027,0.3405,1,9,1,598396,7214,104355,3601,0.06682352069361591,0.332963476652797
3028,0.3406,10,16,10,598412,7198,104365,3591,0.06667531216421504,0.3328390026879229
3029,0.3407,7,24,7,598436,7174,104372,3584,0.06645299937011374,0.33314742517196505
3030,0.3408,1,12,1,598448,7162,104373,3583,0.0663418429730631,0.3334574220567706
3031,0.3409,15,27,15,598475,7135,104388,3568,0.06609174107969913,0.33336447724936935
3032,0.341,7,11,7,598486,7124,104395,3561,0.06598984771573604,0.3332709405708938
3033,0.3411,11,28,11,598514,7096,104406,3550,0.06573048278928452,0.33345857599098255
3034,0.3412,7,23,7,598537,7073,104413,3543,0.06551743302827077,0.33374152223059533
3035,0.3413,12,26,12,598563,7047,104425,3531,0.06527659416799436,0.33380601247872943
3036,0.3414,14,23,14,598586,7024,104439,3517,0.06506354440698062,0.3336495588653828
3037,0.3415,13,38,13,598624,6986,104452,3504,0.06471154914965356,0.3340324118207817
3038,0.3416,8,21,8,598645,6965,104460,3496,0.06451702545481493,0.33419367173310394
3039,0.3417,9,17,9,598662,6948,104469,3487,0.0643595538923265,0.33416387158600863
3040,0.3418,9,17,9,598679,6931,104478,3478,0.06420208232983808,0.3341339225670093
3041,0.3419,5,8,5,598687,6923,104483,3473,0.06412797806513765,0.334070796460177
3042,0.342,6,5,6,598692,6918,104489,3467,0.06408166289969988,0.33384689455946076
3043,0.3421,6,12,6,598704,6906,104495,3461,0.06397050650264922,0.33384778624481526
3044,0.3422,6,19,6,598723,6887,104501,3455,0.0637945088739857,0.3340746470701992
3045,0.3423,14,20,14,598743,6867,104515,3441,0.06360924821223461,0.3338183934807916
3046,0.3424,9,18,9,598761,6849,104524,3432,0.06344251361665863,0.33381966734753427
3047,0.3425,0,3,0,598764,6846,104524,3432,0.06341472451739598,0.3339171044950379
3048,0.3426,2,4,2,598768,6842,104526,3430,0.06337767238504576,0.33391744548286606
3049,0.3427,3,15,3,598783,6827,104529,3427,0.06323872688873244,0.33421103959430465
3050,0.3428,8,30,8,598813,6797,104537,3419,0.06296083589610582,0.3346711041503524
3051,0.3429,4,16,4,598829,6781,104541,3415,0.06281262736670495,0.3349352687328364
3052,0.343,2,3,2,598832,6778,104543,3413,0.06278483826744229,0.33490334608968697
3053,0.3431,10,16,10,598848,6762,104553,3403,0.06263662973804142,0.33477619281849486
3054,0.3432,9,27,9,598875,6735,104562,3394,0.062386527844677464,0.3350775002468161
3055,0.3433,3,7,3,598882,6728,104565,3391,0.06232168661306458,0.33511216523371873
3056,0.3434,2,8,2,598890,6720,104567,3389,0.062247582348364146,0.33524582055594027
3057,0.3435,11,11,11,598901,6709,104578,3378,0.06214568898440105,0.3348864875582433
3058,0.3436,7,15,7,598916,6694,104585,3371,0.06200674348808774,0.334923000496771
3059,0.3437,6,5,6,598921,6689,104591,3365,0.06196042832264997,0.334692659637955
3060,0.3438,4,10,4,598931,6679,104595,3361,0.06186779799177443,0.33476095617529883
3061,0.3439,15,23,15,598954,6656,104610,3346,0.061654748230760684,0.33453309338132375
3062,0.344,8,17,8,598971,6639,104618,3338,0.06149727666827226,0.3345695098727072
3063,0.3441,3,4,3,598975,6635,104621,3335,0.061460224535922044,0.33450351053159477
3064,0.3442,4,12,4,598987,6623,104625,3331,0.06134906813887139,0.3346393409684549
3065,0.3443,0,4,0,598991,6619,104625,3331,0.061312016006521176,0.33477386934673364
3066,0.3444,3,14,3,599005,6605,104628,3328,0.061182333543295414,0.33504480016107924
3067,0.3445,11,21,11,599026,6584,104639,3317,0.06098780984845678,0.33501666498333504
3068,0.3446,4,6,4,599032,6578,104643,3313,0.06093223164993145,0.33495096552421394
3069,0.3447,1,6,1,599038,6572,104644,3312,0.06087665345140613,0.33508700930797247
3070,0.3448,2,9,2,599047,6563,104646,3310,0.06079328615361814,0.3352577737263243
3071,0.3449,4,6,4,599053,6557,104650,3306,0.06073770795509281,0.33519213221129474
3072,0.345,12,23,12,599076,6534,104662,3294,0.06052465819407907,0.33516483516483514
3073,0.3451,3,14,3,599090,6520,104665,3291,0.06039497573085331,0.3354398124554072
3074,0.3452,9,18,9,599108,6502,104674,3282,0.06022824113527733,0.3354456255110384
3075,0.3453,7,7,7,599115,6495,104681,3275,0.060163399903664455,0.3352098259979529
3076,0.3454,0,4,0,599119,6491,104681,3275,0.06012634777131424,0.33534712267048944
3077,0.3455,25,64,25,599183,6427,104706,3250,0.05953351365371077,0.3358478867417588
3078,0.3456,10,24,10,599207,6403,104716,3240,0.05931120085960947,0.335995022295966
3079,0.3457,4,10,4,599217,6393,104720,3236,0.05921857052873393,0.3360681275314155
3080,0.3458,7,11,7,599228,6382,104727,3229,0.059116677164770835,0.335969201956092
3081,0.3459,11,5,11,599233,6377,104738,3218,0.05907036199933306,0.33538301198540904
3082,0.346,3,16,3,599249,6361,104741,3215,0.058922153469932195,0.33573517126148705
3083,0.3461,4,13,4,599262,6348,104745,3211,0.05880173403979399,0.33591379851448894
3084,0.3462,4,14,4,599276,6334,104749,3207,0.058672051576568233,0.33612828843936693
3085,0.3463,4,0,4,599276,6334,104753,3203,0.058672051576568233,0.3358498479605746
3086,0.3464,2,13,2,599289,6321,104755,3201,0.05855163214643003,0.3361688720856963
3087,0.3465,3,11,3,599300,6310,104758,3198,0.05844973878246693,0.33634833824148086
3088,0.3466,12,16,12,599316,6294,104770,3186,0.058301530253066065,0.3360759493670886
3089,0.3467,7,18,7,599334,6276,104777,3179,0.058134795657490086,0.3362242199894236
3090,0.3468,5,3,5,599337,6273,104782,3174,0.058107006558227425,0.3359796760876469
3091,0.3469,3,16,3,599353,6257,104785,3171,0.05795879802882656,0.3363385659736954
3092,0.347,9,18,9,599371,6239,104794,3162,0.057792063433250586,0.33634719710669075
3093,0.3471,5,10,5,599381,6229,104799,3157,0.05769943310237504,0.3363520136373322
3094,0.3472,10,10,10,599391,6219,104809,3147,0.0576068027714995,0.3360025624599616
3095,0.3473,5,9,5,599400,6210,104814,3142,0.05752343547371151,0.33597091531223267
3096,0.3474,4,12,4,599412,6198,104818,3138,0.05741227907666086,0.3361182519280206
3097,0.3475,4,13,4,599425,6185,104822,3134,0.057291859646522655,0.336302178345316
3098,0.3476,8,6,8,599431,6179,104830,3126,0.057236281447997334,0.3359484148307362
3099,0.3477,2,3,2,599434,6176,104832,3124,0.05720849234873467,0.3359139784946237
3100,0.3478,5,5,5,599439,6171,104837,3119,0.0571621771832969,0.3357373519913886
3101,0.3479,1,2,1,599441,6169,104838,3118,0.05714365111712179,0.33573812856681384
3102,0.348,7,36,7,599477,6133,104845,3111,0.05681018192596984,0.3365426222414539
3103,0.3481,9,31,9,599508,6102,104854,3102,0.05652302790025566,0.33702737940026073
3104,0.3482,5,18,5,599526,6084,104859,3097,0.056356293304679686,0.33732708855244525
3105,0.3483,5,8,5,599534,6076,104864,3092,0.05628218903997925,0.33726003490401396
3106,0.3484,3,2,3,599536,6074,104867,3089,0.05626366297380414,0.33711666484775726
3107,0.3485,5,9,5,599545,6065,104872,3084,0.05618029567601616,0.3370860203300907
3108,0.3486,8,9,8,599554,6056,104880,3076,0.05609692837822817,0.33683749452474815
3109,0.3487,9,12,9,599566,6044,104889,3067,0.05598577198117752,0.3366260564153221
3110,0.3488,1,9,1,599575,6035,104890,3066,0.05590240468338953,0.3368860564773102
3111,0.3489,1,4,1,599579,6031,104891,3065,0.05586535255103931,0.3369613016710642
3112,0.349,4,4,4,599583,6027,104895,3061,0.055828300418689095,0.33681778169014087
3113,0.3491,8,17,8,599600,6010,104903,3053,0.05567082885620067,0.3368641730111442
3114,0.3492,2,0,2,599600,6010,104905,3051,0.05567082885620067,0.3367178015671559
3115,0.3493,2,6,2,599606,6004,104907,3049,0.05561525065767535,0.33679443278471227
3116,0.3494,12,19,12,599625,5985,104919,3037,0.05543925302901182,0.3366215916648193
3117,0.3495,2,10,2,599635,5975,104921,3035,0.055346622698136276,0.33684794672586016
3118,0.3496,11,15,11,599650,5960,104932,3024,0.055207677201822965,0.3365983971504898
3119,0.3497,9,13,9,599663,5947,104941,3015,0.05508725777168476,0.336420441865655
3120,0.3498,8,17,8,599680,5930,104949,3007,0.05492978620919634,0.3364663757413002
3121,0.3499,6,17,6,599697,5913,104955,3001,0.05477231464670792,0.3366614314561364
3122,0.35,5,11,5,599708,5902,104960,2996,0.054670421282744824,0.33670487750056194
3123,0.3501,5,4,5,599712,5898,104965,2991,0.05463336915039461,0.33648329395882554
3124,0.3502,9,11,9,599723,5887,104974,2982,0.054531475786431506,0.3362273086029992
3125,0.3503,4,22,4,599745,5865,104978,2978,0.05432768905850532,0.3367635417844623
3126,0.3504,6,4,6,599749,5861,104984,2972,0.0542906369261551,0.3364655270010189
3127,0.3505,4,15,4,599764,5846,104988,2968,0.05415169142984179,0.33673700930338096
3128,0.3506,3,10,3,599774,5836,104991,2965,0.05405906109896624,0.336893534825588
3129,0.3507,5,8,5,599782,5828,104996,2960,0.05398495683426581,0.33682294037323623
3130,0.3508,5,21,5,599803,5807,105001,2955,0.05379043313942718,0.33725176900251086
3131,0.3509,1,3,1,599806,5804,105002,2954,0.05376264404016451,0.3372916190911167
3132,0.351,3,15,3,599821,5789,105005,2951,0.0536236985438512,0.33764302059496565
3133,0.3511,3,17,3,599838,5772,105008,2948,0.053466226981362774,0.33807339449541285
3134,0.3512,13,22,13,599860,5750,105021,2935,0.053262440253436585,0.3379389752446747
3135,0.3513,20,42,20,599902,5708,105041,2915,0.05287339286375931,0.3380494027600603
3136,0.3514,3,12,3,599914,5696,105044,2912,0.05276223646670866,0.3382899628252788
3137,0.3515,7,11,7,599925,5685,105051,2905,0.05266034310274556,0.3381839348079162
3138,0.3516,4,5,4,599930,5680,105055,2901,0.052614027937307795,0.33807248572427456
3139,0.3517,4,6,4,599936,5674,105059,2897,0.052558449738782466,0.33800023334500057
3140,0.3518,12,19,12,599955,5655,105071,2885,0.05238245211011894,0.33782201405152223
3141,0.3519,6,9,6,599964,5646,105077,2879,0.05229908481233095,0.3377126099706745
3142,0.352,5,13,5,599977,5633,105082,2874,0.05217866538219274,0.33783942635476666
3143,0.3521,4,4,4,599981,5629,105086,2870,0.052141613249842525,0.337686786680786
3144,0.3522,15,28,15,600009,5601,105101,2855,0.051882248323391014,0.33763008514664145
3145,0.3523,3,7,3,600016,5594,105104,2852,0.05181740709177813,0.33767463888231114
3146,0.3524,16,24,16,600040,5570,105120,2836,0.05159509429767683,0.3373780632881275
3147,0.3525,15,28,15,600068,5542,105135,2821,0.05133572937122531,0.33731914384790146
3148,0.3526,4,21,4,600089,5521,105139,2817,0.05114120567638668,0.337850803550012
3149,0.3527,9,10,9,600099,5511,105148,2808,0.05104857534551113,0.3375405697800216
3150,0.3528,3,24,3,600123,5487,105151,2805,0.05082626255140983,0.3382778581765557
3151,0.3529,6,5,6,600128,5482,105157,2799,0.050779947385972066,0.3380026566839754
3152,0.353,11,11,11,600139,5471,105168,2788,0.050678054022008964,0.33757113451991766
3153,0.3531,3,4,3,600143,5467,105171,2785,0.05064100188965875,0.33749394086282114
3154,0.3532,0,5,0,600148,5462,105171,2785,0.05059468672422098,0.33769855705104884
3155,0.3533,7,16,7,600164,5446,105178,2778,0.050446478194820114,0.33779182879377434
3156,0.3534,0,2,0,600166,5444,105178,2778,0.050427952128645,0.33787399659450257
3157,0.3535,7,3,7,600169,5441,105185,2771,0.05040016302938234,0.3374330248416951
3158,0.3536,2,3,2,600172,5438,105187,2769,0.05037237393011968,0.3373949067868892
3159,0.3537,4,3,4,600175,5435,105191,2765,0.05034458483085701,0.33719512195121953
3160,0.3538,2,7,2,600182,5428,105193,2763,0.050279743599244135,0.3373214503723599
3161,0.3539,9,22,9,600204,5406,105202,2754,0.050075956871317946,0.3375
3162,0.354,16,38,16,600242,5368,105218,2738,0.04972396161399088,0.33777448803355536
3163,0.3541,10,16,10,600258,5352,105228,2728,0.049575753084590016,0.33762376237623765
3164,0.3542,2,6,2,600264,5346,105230,2726,0.049520174886064694,0.3377106045589693
3165,0.3543,2,4,2,600268,5342,105232,2724,0.04948312275371448,0.3377138606496405
3166,0.3544,1,2,1,600270,5340,105233,2723,0.049464596687539365,0.3377154905122163
3167,0.3545,15,29,15,600299,5311,105248,2708,0.0491959687280003,0.33769796732759694
3168,0.3546,6,12,6,600311,5299,105254,2702,0.04908481233094965,0.33770778652668415
3169,0.3547,0,4,0,600315,5295,105254,2702,0.04904776019859943,0.3378767037639115
3170,0.3548,4,11,4,600326,5284,105258,2698,0.04894586683463633,0.3380105236782761
3171,0.3549,4,2,4,600328,5282,105262,2694,0.048927340768461225,0.33776328986960885
3172,0.355,4,9,4,600337,5273,105266,2690,0.048843973470673235,0.33781238226798943
3173,0.3551,1,3,1,600340,5270,105267,2689,0.048816184371410574,0.33785651463751726
3174,0.3552,1,10,1,600350,5260,105268,2688,0.048723554040535036,0.3381982888777051
3175,0.3553,8,6,8,600356,5254,105276,2680,0.04866797584200971,0.3377867406100328
3176,0.3554,4,4,4,600360,5250,105280,2676,0.04863092370965949,0.3376230128690386
3177,0.3555,6,12,6,600372,5238,105286,2670,0.04851976731260884,0.33763277693474963
3178,0.3556,6,13,6,600385,5225,105292,2664,0.048399347882470634,0.3376853847128914
3179,0.3557,1,3,1,600388,5222,105293,2663,0.04837155878320797,0.3377298668357641
3180,0.3558,11,25,11,600413,5197,105304,2652,0.048139982956019116,0.33787743661612946
3181,0.3559,0,3,0,600416,5194,105304,2652,0.048112193856756455,0.338006627580933
3182,0.356,5,3,5,600419,5191,105309,2647,0.048084404757493794,0.3377137024751212
3183,0.3561,21,49,21,600468,5142,105330,2626,0.047630516136203636,0.338053553038105
3184,0.3562,6,9,6,600477,5133,105336,2620,0.047547148838415654,0.33793370308267767
3185,0.3563,3,6,3,600483,5127,105339,2617,0.047491570639890325,0.33793904958677684
3186,0.3564,3,8,3,600491,5119,105342,2614,0.04741746637518989,0.33803181171602226
3187,0.3565,9,24,9,600515,5095,105351,2605,0.04719515358108859,0.3383116883116883
3188,0.3566,7,12,7,600527,5083,105358,2598,0.04708399718403794,0.33823720869678425
3189,0.3567,3,7,3,600534,5076,105361,2595,0.04701915595242506,0.33828705514274543
3190,0.3568,18,34,18,600568,5042,105379,2577,0.04670421282744822,0.3382333639585247
3191,0.3569,2,13,2,600581,5029,105381,2575,0.04658379339731002,0.33863755917937927
3192,0.357,5,18,5,600599,5011,105386,2570,0.04641705880173404,0.3390054082574858
3193,0.3571,4,17,4,600616,4994,105390,2566,0.04625958723924562,0.3394179894179894
3194,0.3572,7,15,7,600631,4979,105397,2559,0.0461206417429323,0.339479968161316
3195,0.3573,7,10,7,600641,4969,105404,2552,0.046028011412056764,0.3393165802419891
3196,0.3574,7,15,7,600656,4954,105411,2545,0.04588906591574345,0.3393785838111748
3197,0.3575,3,8,3,600664,4946,105414,2542,0.04581496165104302,0.33947649572649574
3198,0.3576,4,7,4,600671,4939,105418,2538,0.045750120419430135,0.3394409522535776
3199,0.3577,7,9,7,600680,4930,105425,2531,0.04566675312164215,0.3392306661305455
3200,0.3578,10,22,10,600702,4908,105435,2521,0.045462966393715956,0.33934580697267464
3201,0.3579,2,7,2,600709,4901,105437,2519,0.04539812516210308,0.3394878706199461
3202,0.358,5,13,5,600722,4888,105442,2514,0.04527770573196487,0.33963793569305595
3203,0.3581,14,32,14,600754,4856,105456,2500,0.04498128867316314,0.33985861881457313
3204,0.3582,0,3,0,600757,4853,105456,2500,0.04495349957390048,0.33999728002175983
3205,0.3583,20,24,20,600781,4829,105476,2480,0.044731186779799176,0.3393077028321248
3206,0.3584,5,10,5,600791,4819,105481,2475,0.04463855644892364,0.33931998903208116
3207,0.3585,6,13,6,600804,4806,105487,2469,0.04451813701878543,0.3393814432989691
3208,0.3586,1,4,1,600808,4802,105488,2468,0.044481084886435214,0.3394773039889959
3209,0.3587,7,12,7,600820,4790,105495,2461,0.044369928489384564,0.33940146186732867
3210,0.3588,3,24,3,600844,4766,105498,2458,0.04414761569528326,0.3402547065337763
3211,0.3589,11,20,11,600864,4746,105509,2447,0.04396235503353218,0.34019185319060197
3212,0.359,4,11,4,600875,4735,105513,2443,0.043860461669569084,0.3403455001393146
3213,0.3591,0,6,0,600881,4729,105513,2443,0.043804883471043755,0.34063022866703846
3214,0.3592,4,10,4,600891,4719,105517,2439,0.04371225314016822,0.3407376362112322
3215,0.3593,12,23,12,600914,4696,105529,2427,0.04349920337915447,0.34072722167626
3216,0.3594,8,21,8,600935,4675,105537,2419,0.04330467968431583,0.3409923879334649
3217,0.3595,3,14,3,600949,4661,105540,2416,0.043174997221090076,0.3413875936131129
3218,0.3596,4,6,4,600955,4655,105544,2412,0.04311941902256475,0.3413046554407811
3219,0.3597,6,10,6,600965,4645,105550,2406,0.04302678869168921,0.3412281945823287
3220,0.3598,4,31,4,600996,4614,105554,2402,0.042739634665975024,0.34236031927023947
3221,0.3599,11,22,11,601018,4592,105565,2391,0.042535847938048835,0.342402978662466
3222,0.36,5,5,5,601023,4587,105570,2386,0.04248953277261106,0.3421769683063244
3223,0.3601,5,13,5,601036,4574,105575,2381,0.04236911334247286,0.3423436376707405
3224,0.3602,1,3,1,601039,4571,105576,2380,0.042341324243210195,0.3423967774420947
3225,0.3603,2,8,2,601047,4563,105578,2378,0.04226721997850976,0.34260193055755656
3226,0.3604,6,9,6,601056,4554,105584,2372,0.04218385268072178,0.3424776205602079
3227,0.3605,1,5,1,601061,4549,105585,2371,0.042137537515284006,0.3426300578034682
3228,0.3606,4,7,4,601068,4542,105589,2367,0.04207269628367113,0.34259661311333045
3229,0.3607,3,10,3,601078,4532,105592,2364,0.04198006595279558,0.3428074245939675
3230,0.3608,3,7,3,601085,4525,105595,2361,0.041915224721182705,0.34286959047342436
3231,0.3609,8,23,8,601108,4502,105603,2353,0.04170217496016896,0.34325309992706055
3232,0.361,8,20,8,601128,4482,105611,2345,0.041516914298417876,0.343489087446902
3233,0.3611,6,30,6,601158,4452,105617,2339,0.041239023305791246,0.3444264467677809
3234,0.3612,8,14,8,601172,4438,105625,2331,0.04110934084256549,0.344364012409514
3235,0.3613,4,18,4,601190,4420,105629,2327,0.04094260624698951,0.3448940269749518
3236,0.3614,17,28,17,601218,4392,105646,2310,0.040683241320537994,0.3446732318710833
3237,0.3615,15,27,15,601245,4365,105661,2295,0.04043313942717403,0.34459459459459457
3238,0.3616,4,19,4,601264,4346,105665,2291,0.040257141798510504,0.34518607804731055
3239,0.3617,2,11,2,601275,4335,105667,2289,0.04015524843454741,0.34556159420289856
3240,0.3618,3,10,3,601285,4325,105670,2286,0.040062618103671864,0.34578732415670854
3241,0.3619,7,12,7,601297,4313,105677,2279,0.039951461706621214,0.3457220873786408
3242,0.362,7,28,7,601325,4285,105684,2272,0.039692096780169696,0.3464999237456154
3243,0.3621,0,4,0,601329,4281,105684,2272,0.03965504464781948,0.34671142987944453
3244,0.3622,15,31,15,601360,4250,105699,2257,0.0393678906221053,0.34685723067465807
3245,0.3623,2,0,2,601360,4250,105701,2255,0.0393678906221053,0.3466564181398924
3246,0.3624,8,14,8,601374,4236,105709,2247,0.039238208158879545,0.34659879685330863
3247,0.3625,10,8,10,601382,4228,105719,2237,0.03916410389417911,0.3460170146945089
3248,0.3626,1,6,1,601388,4222,105720,2236,0.03910852569565378,0.34623722514710437
3249,0.3627,7,10,7,601398,4212,105727,2229,0.039015895364778244,0.3460642757335817
3250,0.3628,11,17,11,601415,4195,105738,2218,0.03885842380228982,0.3458599719320131
3251,0.3629,7,30,7,601445,4165,105745,2211,0.0385805328096632,0.34676913425345046
3252,0.363,5,18,5,601463,4147,105750,2206,0.03841379821408722,0.3472375255784669
3253,0.3631,5,14,5,601477,4133,105755,2201,0.038284115750861464,0.34748973792232396
3254,0.3632,7,17,7,601494,4116,105762,2194,0.03812664418837304,0.34770206022187006
3255,0.3633,6,15,6,601509,4101,105768,2188,0.03798769869205973,0.34790904754332963
3256,0.3634,0,2,0,601511,4099,105768,2188,0.03796917262588462,0.3480197232384285
3257,0.3635,2,2,2,601513,4097,105770,2186,0.03795064655970951,0.34792296673563583
3258,0.3636,6,14,6,601527,4083,105776,2180,0.03782096409648375,0.3480760019160147
3259,0.3637,6,9,6,601536,4074,105782,2174,0.03773759679869577,0.3479513444302177
3260,0.3638,2,3,2,601539,4071,105784,2172,0.0377098076994331,0.347909658817876
3261,0.3639,0,8,0,601547,4063,105784,2172,0.037635703434732666,0.3483560545308741
3262,0.364,3,7,3,601554,4056,105787,2169,0.03757086220311979,0.34843373493975904
3263,0.3641,7,7,7,601561,4049,105794,2162,0.03750602097150691,0.3480920946707455
3264,0.3642,8,6,8,601567,4043,105802,2154,0.03745044277298158,0.3475875423592061
3265,0.3643,5,5,5,601572,4038,105807,2149,0.037404127607543816,0.34734119928883145
3266,0.3644,11,24,11,601596,4014,105818,2138,0.037181814813442515,0.3475292587776333
3267,0.3645,9,25,9,601621,3989,105827,2129,0.03695023898625366,0.3479895390650539
3268,0.3646,1,6,1,601627,3983,105828,2128,0.03689466078772834,0.34822451317296677
3269,0.3647,2,15,2,601642,3968,105830,2126,0.03675571529141502,0.3488677387594355
3270,0.3648,3,5,3,601647,3963,105833,2123,0.03670940012597725,0.3488333881038449
3271,0.3649,0,1,0,601648,3962,105833,2123,0.0367001370928897,0.3488907148726376
3272,0.365,7,16,7,601664,3946,105840,2116,0.03655192856348883,0.349059716265259
3273,0.3651,7,8,7,601672,3938,105847,2109,0.036477824298788396,0.34876798412435916
3274,0.3652,6,28,6,601700,3910,105853,2103,0.03621845937233688,0.3497422251787793
3275,0.3653,8,24,8,601724,3886,105861,2095,0.03599614657823558,0.3502758735997325
3276,0.3654,6,13,6,601737,3873,105867,2089,0.03587572714809737,0.35038577658503856
3277,0.3655,10,18,10,601755,3855,105877,2079,0.0357089925525214,0.35035389282103135
3278,0.3656,1,1,1,601756,3854,105878,2078,0.03569972951943384,0.35030343897505056
3279,0.3657,7,8,7,601764,3846,105885,2071,0.03562562525473341,0.3500084502281562
3280,0.3658,4,3,4,601767,3843,105889,2067,0.03559783615547075,0.34974619289340103
3281,0.3659,2,7,2,601774,3836,105891,2065,0.03553299492385787,0.3499406880189798
3282,0.366,2,17,2,601791,3819,105893,2063,0.03537552336136945,0.35073104386263176
3283,0.3661,13,7,13,601798,3812,105906,2050,0.03531068212975657,0.3497099965881952
3284,0.3662,2,4,2,601802,3808,105908,2048,0.03527362999740635,0.34972677595628415
3285,0.3663,6,3,6,601805,3805,105914,2042,0.035245840898143685,0.349238925944929
3286,0.3664,2,5,2,601810,3800,105916,2040,0.03519952573270592,0.3493150684931507
3287,0.3665,8,4,8,601814,3796,105924,2032,0.0351624736003557,0.34866163349347973
3288,0.3666,11,21,11,601835,3775,105935,2021,0.03496794990551706,0.34868875086266393
3289,0.3667,2,10,2,601845,3765,105937,2019,0.034875319574641524,0.34906639004149376
3290,0.3668,13,18,13,601863,3747,105950,2006,0.034708584979065545,0.34868764123066226
3291,0.3669,5,9,5,601872,3738,105955,2001,0.034625217681277555,0.34866701515943543
3292,0.367,2,10,2,601882,3728,105957,1999,0.034532587350402016,0.3490483673825738
3293,0.3671,1,2,1,601884,3726,105958,1998,0.034514061284226905,0.3490566037735849
3294,0.3672,1,9,1,601893,3717,105959,1997,0.03443069398643892,0.3494924746237312
3295,0.3673,15,28,15,601921,3689,105974,1982,0.034171329059987404,0.3494974431317228
3296,0.3674,9,23,9,601944,3666,105983,1973,0.03395827929897366,0.34988473133534315
3297,0.3675,11,16,11,601960,3650,105994,1962,0.03381007076957279,0.349607982893799
3298,0.3676,7,10,7,601970,3640,106001,1955,0.033717440438697246,0.3494191242180518
3299,0.3677,2,6,2,601976,3634,106003,1953,0.033661862240171925,0.34956148201181314
3300,0.3678,5,16,5,601992,3618,106008,1948,0.03351365371077106,0.34998203377650017
3301,0.3679,4,13,4,602005,3605,106012,1944,0.03339323428063285,0.350333393404217
3302,0.368,4,9,4,602014,3596,106016,1940,0.03330986698284486,0.3504335260115607
3303,0.3681,2,13,2,602027,3583,106018,1938,0.033189447552706655,0.35102336533236733
3304,0.3682,5,10,5,602037,3573,106023,1933,0.03309681722183112,0.35107155830003633
3305,0.3683,10,24,10,602061,3549,106033,1923,0.032874504427729816,0.3514254385964912
3306,0.3684,5,11,5,602072,3538,106038,1918,0.03277261106376672,0.35153958944281527
3307,0.3685,0,7,0,602079,3531,106038,1918,0.032707769832153843,0.3519911910442283
3308,0.3686,8,12,8,602091,3519,106046,1910,0.03259661343510319,0.35181433044759625
3309,0.3687,2,12,2,602103,3507,106048,1908,0.03248545703805254,0.3523545706371191
3310,0.3688,5,13,5,602116,3494,106053,1903,0.032365037607914336,0.35260329812859
3311,0.3689,8,9,8,602125,3485,106061,1895,0.03228167031012635,0.35223048327137546
3312,0.369,0,1,0,602126,3484,106061,1895,0.03227240727703879,0.3522959657928983
3313,0.3691,11,16,11,602142,3468,106072,1884,0.03212419874763792,0.35201793721973096
3314,0.3692,5,7,5,602149,3461,106077,1879,0.032059357516025046,0.35187265917602994
3315,0.3693,4,10,4,602159,3451,106081,1875,0.03196672718514951,0.35204656402553514
3316,0.3694,2,8,2,602167,3443,106083,1873,0.031892622920449074,0.3523325808878856
3317,0.3695,5,10,5,602177,3433,106088,1868,0.03179999258957353,0.352386342199585
3318,0.3696,12,22,12,602199,3411,106100,1856,0.03159620586164734,0.35238276058477314
3319,0.3697,10,21,10,602220,3390,106110,1846,0.0314016821668087,0.35255920550038194
3320,0.3698,2,11,2,602231,3379,106112,1844,0.031299788802845604,0.3530538004977982
3321,0.3699,5,13,5,602244,3366,106117,1839,0.031179369372707398,0.35331412103746396
3322,0.37,12,23,12,602267,3343,106129,1827,0.030966319611693653,0.35338491295938107
3323,0.3701,7,20,7,602287,3323,106136,1820,0.03078105894994257,0.35387905891503013
3324,0.3702,3,10,3,602297,3313,106139,1817,0.030688428619067027,0.35419103313840156
3325,0.3703,0,12,0,602309,3301,106139,1817,0.030577272222016377,0.3550214927706135
3326,0.3704,14,26,14,602335,3275,106153,1803,0.030336433361739967,0.3550610476565577
3327,0.3705,4,8,4,602343,3267,106157,1799,0.030262329097039534,0.35511251480457956
3328,0.3706,10,14,10,602357,3253,106167,1789,0.030132646633813775,0.3548195160650536
3329,0.3707,2,8,2,602365,3245,106169,1787,0.03005854236911334,0.35512718600953896
3330,0.3708,11,16,11,602381,3229,106180,1776,0.029910333839712474,0.35484515484515483
3331,0.3709,2,11,2,602392,3218,106182,1774,0.02980844047574938,0.35536858974358976
3332,0.371,10,19,10,602411,3199,106192,1764,0.02963244284708585,0.3554301833568406
3333,0.3711,5,3,5,602414,3196,106197,1759,0.029604653747823187,0.3549949545913219
3334,0.3712,7,9,7,602423,3187,106204,1752,0.0295212864500352,0.35472767766754404
3335,0.3713,1,7,1,602430,3180,106205,1751,0.02945644521842232,0.35510038531737986
3336,0.3714,12,8,12,602438,3172,106217,1739,0.029382340953721886,0.35410303400529425
3337,0.3715,1,2,1,602440,3170,106218,1738,0.029363814887546778,0.3541157294213529
3338,0.3716,0,1,0,602441,3169,106218,1738,0.029354551854459225,0.35418789484410024
3339,0.3717,13,19,13,602460,3150,106231,1725,0.029178554225795694,0.35384615384615387
3340,0.3718,5,10,5,602470,3140,106236,1720,0.02908592389492015,0.35390946502057613
3341,0.3719,4,12,4,602482,3128,106240,1716,0.0289747674978695,0.3542526837324525
3342,0.372,7,10,7,602492,3118,106247,1709,0.02888213716699396,0.3540501346592086
3343,0.3721,4,13,4,602505,3105,106251,1705,0.028761717736855756,0.35446985446985446
3344,0.3722,17,31,17,602536,3074,106268,1688,0.028474563711141578,0.35447291054178914
3345,0.3723,7,13,7,602549,3061,106275,1681,0.02835414428100337,0.3544917756221004
3346,0.3724,4,4,4,602553,3057,106279,1677,0.028317092148653154,0.35424588086185044
3347,0.3725,9,26,9,602579,3031,106288,1668,0.028076253288376745,0.3549691423707172
3348,0.3726,3,3,3,602582,3028,106291,1665,0.028048464189114084,0.35478372043469
3349,0.3727,7,20,7,602602,3008,106298,1658,0.027863203527363,0.35533647663951995
3350,0.3728,6,16,6,602618,2992,106304,1652,0.027714994997962133,0.35572782084409993
3351,0.3729,3,3,3,602621,2989,106307,1649,0.02768720589869947,0.35554118154376885
3352,0.373,7,14,7,602635,2975,106314,1642,0.027557523435473713,0.35564219189950186
3353,0.3731,5,6,5,602641,2969,106319,1637,0.027501945236948388,0.3554059921841077
3354,0.3732,1,9,1,602650,2960,106320,1636,0.0274185779391604,0.35596170583115755
3355,0.3733,4,5,4,602655,2955,106324,1632,0.02737226277372263,0.35578809679529105
3356,0.3734,1,3,1,602658,2952,106325,1631,0.027344473674459965,0.35588042766746675
3357,0.3735,7,9,7,602667,2943,106332,1624,0.02726110637667198,0.3555944821545873
3358,0.3736,14,14,14,602681,2929,106346,1610,0.02713142391344622,0.3547036792244988
3359,0.3737,11,22,11,602703,2907,106357,1599,0.026927637185520027,0.3548601864181092
3360,0.3738,6,5,6,602708,2902,106363,1593,0.026881322020082254,0.35439377085650725
3361,0.3739,6,27,6,602735,2875,106369,1587,0.026631220126718293,0.3556701030927835
3362,0.374,3,10,3,602745,2865,106372,1584,0.02653858979584275,0.35603506405933916
3363,0.3741,6,16,6,602761,2849,106378,1578,0.026390381266441883,0.35644906257058956
3364,0.3742,8,30,8,602791,2819,106386,1570,0.026112490273815257,0.35771246297562087
3365,0.3743,2,7,2,602798,2812,106388,1568,0.02604764904220238,0.35799086757990867
3366,0.3744,0,1,0,602799,2811,106388,1568,0.026038386009114824,0.3580726193194793
3367,0.3745,10,12,10,602811,2799,106398,1558,0.025927229612064173,0.35758549460638056
3368,0.3746,11,15,11,602826,2784,106409,1547,0.025788284115750862,0.3571923343338721
3369,0.3747,2,4,2,602830,2780,106411,1545,0.025751231983400645,0.35722543352601155
3370,0.3748,11,15,11,602845,2765,106422,1534,0.02561228648708733,0.3568271691090951
3371,0.3749,4,3,4,602848,2762,106426,1530,0.02558449738782467,0.35647716682199443
3372,0.375,6,8,6,602856,2754,106432,1524,0.025510393123124236,0.35624123422159887
3373,0.3751,3,23,3,602879,2731,106435,1521,0.02529734336211049,0.3577140169332079
3374,0.3752,12,11,12,602890,2720,106447,1509,0.025195449998147393,0.35682194372192005
3375,0.3753,8,13,8,602903,2707,106455,1501,0.02507503056800919,0.35670152091254753
3376,0.3754,5,5,5,602908,2702,106460,1496,0.025028715402571417,0.35636017151024296
3377,0.3755,3,7,3,602915,2695,106463,1493,0.02496387417095854,0.35649474689589306
3378,0.3756,10,19,10,602934,2676,106473,1483,0.024787876542295008,0.3565761000240442
3379,0.3757,1,4,1,602938,2672,106474,1482,0.02475082440994479,0.3567645642753972
3380,0.3758,11,15,11,602953,2657,106485,1471,0.02461187891363148,0.3563468992248062
3381,0.3759,6,16,6,602969,2641,106491,1465,0.024463670384230612,0.35679493424257186
3382,0.376,7,31,7,603000,2610,106498,1458,0.024176516358516434,0.3584070796460177
3383,0.3761,8,24,8,603024,2586,106506,1450,0.023954203564415133,0.35926660059464816
3384,0.3762,2,3,2,603027,2583,106508,1448,0.02392641446515247,0.35921607541552963
3385,0.3764,6,9,6,603036,2574,106514,1442,0.023843047167364483,0.35906374501992033
3386,0.3765,8,11,8,603047,2563,106522,1434,0.023741153803401385,0.3587690768076057
3387,0.3766,1,6,1,603053,2557,106523,1433,0.02368557560487606,0.35914786967418544
3388,0.3767,6,10,6,603063,2547,106529,1427,0.023592945274000517,0.3590840463009562
3389,0.3768,3,2,3,603065,2545,106532,1424,0.02357441920782541,0.35878054925673974
3390,0.3769,1,2,1,603067,2543,106533,1423,0.0235558931416503,0.35879979828542613
3391,0.377,6,15,6,603082,2528,106539,1417,0.02341694764533699,0.3591888466413181
3392,0.3771,7,13,7,603095,2515,106546,1410,0.023296528215198786,0.3592356687898089
3393,0.3772,3,5,3,603100,2510,106549,1407,0.023250213049761013,0.35920347204493236
3394,0.3773,15,43,15,603143,2467,106564,1392,0.022851902626996184,0.36071521119461
3395,0.3774,8,15,8,603158,2452,106572,1384,0.02271295713068287,0.3607924921793535
3396,0.3775,1,8,1,603166,2444,106573,1383,0.022638852865982436,0.36137967076038674
3397,0.3776,6,11,6,603177,2433,106579,1377,0.02253695950201934,0.36141732283464567
3398,0.3777,12,20,12,603197,2413,106591,1365,0.022351698840268257,0.3613022763366861
3399,0.3778,8,6,8,603203,2407,106599,1357,0.022296120641742932,0.3605207226354942
3400,0.3779,3,1,3,603204,2406,106602,1354,0.02228685760865538,0.3601063829787234
3401,0.378,5,2,5,603206,2404,106607,1349,0.02226833154248027,0.35944577671196376
3402,0.3781,0,4,0,603210,2400,106607,1349,0.022231279410130055,0.35982928781008267
3403,0.3782,0,10,0,603220,2390,106607,1349,0.022138649079254513,0.36079165552286707
3404,0.3783,2,19,2,603239,2371,106609,1347,0.02196265145059098,0.3622915545992469
3405,0.3784,2,2,2,603241,2369,106611,1345,0.021944125384415872,0.3621432417878298
3406,0.3785,1,7,1,603248,2362,106612,1344,0.021879284152802995,0.36265515380464114
3407,0.3786,5,10,5,603258,2352,106617,1339,0.021786653821927453,0.3627743159035492
3408,0.3787,8,16,8,603274,2336,106625,1331,0.021638445292526585,0.3629670029997273
3409,0.3788,16,16,16,603290,2320,106641,1315,0.021490236763125718,0.36176066024759285
3410,0.3789,1,3,1,603293,2317,106642,1314,0.021462447663863054,0.36188377857339576
3411,0.379,8,12,8,603305,2305,106650,1306,0.021351291266812403,0.36167266685128774
3412,0.3791,1,3,1,603308,2302,106651,1305,0.021323502167549743,0.3617965067923482
3413,0.3792,13,13,13,603321,2289,106664,1292,0.02120308273741154,0.36079307456017873
3414,0.3793,0,2,0,603323,2287,106664,1292,0.02118455667123643,0.36099469125454037
3415,0.3794,2,11,2,603334,2276,106666,1290,0.021082663307273333,0.36174985978687607
3416,0.3795,2,8,2,603342,2268,106668,1288,0.0210085590425729,0.36220472440944884
3417,0.3796,3,6,3,603348,2262,106671,1285,0.020952980844047574,0.36227798139272627
3418,0.3797,2,5,2,603353,2257,106673,1283,0.020906665678609805,0.36242937853107343
3419,0.3798,5,2,5,603355,2255,106678,1278,0.020888139612434697,0.36173223889046136
3420,0.3799,8,11,8,603366,2244,106686,1270,0.0207862462484716,0.3614114968696642
3421,0.38,5,14,5,603380,2230,106691,1265,0.02065656378524584,0.36194563662374823
3422,0.3801,5,7,5,603387,2223,106696,1260,0.020591722553632962,0.36175710594315247
3423,0.3802,4,9,4,603396,2214,106700,1256,0.020508355255844973,0.3619596541786744
3424,0.3803,2,6,2,603402,2208,106702,1254,0.020452777057319647,0.36221837088388215
3425,0.3804,5,6,5,603408,2202,106707,1249,0.020397198858794322,0.3619240799768183
3426,0.3805,1,6,1,603414,2196,106708,1248,0.020341620660268997,0.3623693379790941
3427,0.3806,3,2,3,603416,2194,106711,1245,0.02032309459409389,0.36202384414073857
3428,0.3807,2,6,2,603422,2188,106713,1243,0.020267516395568563,0.3622850480909356
3429,0.3808,1,0,1,603422,2188,106714,1242,0.020267516395568563,0.3620991253644315
3430,0.3809,5,7,5,603429,2181,106719,1237,0.020202675163955686,0.36190754827384436
3431,0.381,3,3,3,603432,2178,106722,1234,0.020174886064693025,0.3616647127784291
3432,0.3811,6,5,6,603437,2173,106728,1228,0.020128570899255252,0.36107027344898557
3433,0.3812,7,12,7,603449,2161,106735,1221,0.0200174145022046,0.3610289769367238
3434,0.3813,3,3,3,603452,2158,106738,1218,0.01998962540294194,0.36078199052132703
3435,0.3814,1,5,1,603457,2153,106739,1217,0.019943310237504168,0.36112759643916914
3436,0.3815,3,4,3,603461,2149,106742,1214,0.01990625810515395,0.3609872137972049
3437,0.3816,2,7,2,603468,2142,106744,1212,0.019841416873541073,0.3613595706618962
3438,0.3817,2,3,2,603471,2139,106746,1210,0.01981362777427841,0.36130188115855477
3439,0.3818,4,5,4,603476,2134,106750,1206,0.01976731260884064,0.36107784431137724
3440,0.3819,4,5,4,603481,2129,106754,1202,0.019720997443402867,0.36085259681777243
3441,0.382,0,6,0,603487,2123,106754,1202,0.019665419244877542,0.3615037593984962
3442,0.3821,6,3,6,603490,2120,106760,1196,0.01963763014561488,0.3606755126658625
3443,0.3822,2,8,2,603498,2112,106762,1194,0.019563525880914447,0.36116152450090744
3444,0.3823,1,5,1,603503,2107,106763,1193,0.019517210715476675,0.3615151515151515
3445,0.3824,6,7,6,603510,2100,106769,1187,0.019452369483863797,0.3611195619105567
3446,0.3825,4,9,4,603519,2091,106773,1183,0.019369002186075807,0.3613317043372022
3447,0.3826,3,4,3,603523,2087,106776,1180,0.01933195005372559,0.36118763391490666
3448,0.3827,9,21,9,603544,2066,106785,1171,0.019137426358886954,0.3617547111523015
3449,0.3828,3,6,3,603550,2060,106788,1168,0.01908184816036163,0.3618339529120198
3450,0.3829,1,2,1,603552,2058,106789,1167,0.01906332209418652,0.36186046511627906
3451,0.383,2,4,2,603556,2054,106791,1165,0.019026269961836303,0.36191363777570673
3452,0.3831,4,8,4,603564,2046,106795,1161,0.01895216569713587,0.36202057998129095
3453,0.3832,7,19,7,603583,2027,106802,1154,0.01877616806847234,0.36277900031436655
3454,0.3833,2,8,2,603591,2019,106804,1152,0.018702063803771908,0.3632923368022706
3455,0.3834,9,10,9,603601,2009,106813,1143,0.018609433472896366,0.3626269035532995
3456,0.3835,3,6,3,603607,2003,106816,1140,0.01855385527437104,0.3627107858733694
3457,0.3836,1,3,1,603610,2000,106817,1139,0.018526066175108376,0.3628544122331953
3458,0.3837,6,11,6,603621,1989,106823,1133,0.018424172811145282,0.3629083920563741
3459,0.3838,1,0,1,603621,1989,106824,1132,0.018424172811145282,0.36270426145466195
3460,0.3839,2,2,2,603623,1987,106826,1130,0.018405646744970174,0.3625280718639718
3461,0.384,1,4,1,603627,1983,106827,1129,0.018368594612619957,0.3627892030848329
3462,0.3841,6,6,6,603633,1977,106833,1123,0.01831301641409463,0.362258064516129
3463,0.3842,9,6,9,603639,1971,106842,1114,0.018257438215569306,0.36110210696920586
3464,0.3843,9,20,9,603659,1951,106851,1105,0.018072177553818222,0.36158376963350786
3465,0.3844,7,34,7,603693,1917,106858,1098,0.01775723442884138,0.3641791044776119
3466,0.3845,1,1,1,603694,1916,106859,1097,0.017747971395753827,0.364088947892466
3467,0.3846,4,11,4,603705,1905,106863,1093,0.01764607803179073,0.3645763842561708
3468,0.3847,4,7,4,603712,1898,106867,1089,0.01758123680017785,0.3645798459993304
3469,0.3848,1,6,1,603718,1892,106868,1088,0.017525658601652526,0.3651006711409396
3470,0.3849,0,3,0,603721,1889,106868,1088,0.01749786950238986,0.3654685925428284
3471,0.385,3,7,3,603728,1882,106871,1085,0.017433028270776984,0.3656892483990563
3472,0.3851,5,8,5,603736,1874,106876,1080,0.01735892400607655,0.36560595802301965
3473,0.3852,2,2,2,603738,1872,106878,1078,0.017340397939901442,0.36542372881355933
3474,0.3853,10,27,10,603765,1845,106888,1068,0.017090296046537477,0.3666323377960865
3475,0.3854,1,2,1,603767,1843,106889,1067,0.017071769980362368,0.36666666666666664
3476,0.3855,8,18,8,603785,1825,106897,1059,0.016905035384786396,0.3671983356449376
3477,0.3856,2,1,2,603786,1824,106899,1057,0.01689577235169884,0.36688649774383897
3478,0.3857,6,18,6,603804,1806,106905,1051,0.016729037756122864,0.367868393419671
3479,0.3858,5,11,5,603815,1795,106910,1046,0.01662714439215977,0.36818021823301655
3480,0.3859,13,15,13,603830,1780,106923,1033,0.016488198895846455,0.3672236046924991
3481,0.386,1,16,1,603846,1764,106924,1032,0.016339990366445588,0.36909871244635195
3482,0.3861,5,9,5,603855,1755,106929,1027,0.0162566230686576,0.3691588785046729
3483,0.3863,2,3,2,603858,1752,106931,1025,0.016228833969394937,0.3691033489377026
3484,0.3864,7,15,7,603873,1737,106938,1018,0.016089888473081626,0.36950998185117967
3485,0.3865,3,7,3,603880,1730,106941,1015,0.016025047241468745,0.3697632058287796
3486,0.3866,5,7,5,603887,1723,106946,1010,0.015960206009855867,0.3695572630808635
3487,0.3867,2,2,2,603889,1721,106948,1008,0.01594167994368076,0.369366068156834
3488,0.3868,3,4,3,603893,1717,106951,1005,0.015904627811330542,0.3692138133725202
3489,0.3869,5,13,5,603906,1704,106956,1000,0.01578420838119234,0.3698224852071006
3490,0.387,6,2,6,603908,1702,106962,994,0.01576568231501723,0.36869436201780414
3491,0.3871,9,15,9,603923,1687,106971,985,0.015626736818703916,0.3686377245508982
3492,0.3872,1,2,1,603925,1685,106972,984,0.015608210752528807,0.36867740726863996
3493,0.3873,18,14,18,603939,1671,106990,966,0.015478528289303049,0.366325369738339
3494,0.3874,4,6,4,603945,1665,106994,962,0.015422950090777725,0.36619718309859156
3495,0.3875,4,7,4,603952,1658,106998,958,0.015358108859164846,0.3662079510703364
3496,0.3876,0,10,0,603962,1648,106998,958,0.015265478528289304,0.36761320030698386
3497,0.3877,1,4,1,603966,1644,106999,957,0.015228426395939087,0.3679354094579008
3498,0.3878,3,4,3,603970,1640,107002,954,0.01519137426358887,0.36777178103315344
3499,0.3879,9,9,9,603979,1631,107011,945,0.015108006965800882,0.36684782608695654
3500,0.388,4,5,4,603984,1626,107015,941,0.015061691800363111,0.36657576938059994
3501,0.3881,8,7,8,603991,1619,107023,933,0.014996850568750232,0.36559561128526646
3502,0.3882,2,0,2,603991,1619,107025,931,0.014996850568750232,0.3650980392156863
3503,0.3883,0,3,0,603994,1616,107025,931,0.014969061469487569,0.3655280722418532
3504,0.3884,3,4,3,603998,1612,107028,928,0.014932009337137352,0.3653543307086614
3505,0.3885,2,0,2,603998,1612,107030,926,0.014932009337137352,0.36485421591804573
3506,0.3886,0,5,0,604003,1607,107030,926,0.014885694171699581,0.3655744176865377
3507,0.3887,6,9,6,604012,1598,107036,920,0.014802326873911593,0.3653693407466243
3508,0.3888,1,5,1,604017,1593,107037,919,0.014756011708473822,0.365843949044586
3509,0.3889,4,12,4,604029,1581,107041,915,0.014644855311423172,0.36658653846153844
3510,0.389,4,5,4,604034,1576,107045,911,0.014598540145985401,0.3663047848813832
3511,0.3891,5,6,5,604040,1570,107050,906,0.014542961947460076,0.36591276252019383
3512,0.3892,1,1,1,604041,1569,107051,905,0.014533698914372522,0.3658043654001617
3513,0.3893,13,13,13,604054,1556,107064,892,0.014413279484234317,0.36437908496732024
3514,0.3894,0,5,0,604059,1551,107064,892,0.014366964318796546,0.36512484650020466
3515,0.3895,2,6,2,604065,1545,107066,890,0.014311386120271222,0.3655030800821355
3516,0.3896,0,1,0,604066,1544,107066,890,0.014302123087183668,0.3656532456861134
3517,0.3897,1,8,1,604074,1536,107067,889,0.014228018822483235,0.3665979381443299
3518,0.3898,2,3,2,604077,1533,107069,887,0.014200229723220572,0.3665289256198347
3519,0.3899,7,4,7,604081,1529,107076,880,0.014163177590870355,0.365296803652968
3520,0.39,1,2,1,604083,1527,107077,879,0.014144651524695247,0.3653366583541147
3521,0.3901,0,2,0,604085,1525,107077,879,0.014126125458520138,0.3656405990016639
3522,0.3902,4,6,4,604091,1519,107081,875,0.014070547259994813,0.3654970760233918
3523,0.3903,4,7,4,604098,1512,107085,871,0.014005706028381934,0.36550566512798993
3524,0.3904,2,3,2,604101,1509,107087,869,0.013977916929119271,0.3654331370899916
3525,0.3905,1,4,1,604105,1505,107088,868,0.013940864796769054,0.36578171091445427
3526,0.3907,8,20,8,604125,1485,107096,860,0.01375560413501797,0.36673773987206826
3527,0.3908,0,6,0,604131,1479,107096,860,0.013700025936492645,0.367678495083369
3528,0.3909,6,10,6,604141,1469,107102,854,0.013607395605617103,0.36762806715454155
3529,0.391,1,6,1,604147,1463,107103,853,0.013551817407091778,0.36830742659758203
3530,0.3911,4,8,4,604155,1455,107107,849,0.013477713142391344,0.3684895833333333
3531,0.3912,5,9,5,604164,1446,107112,844,0.013394345844603356,0.3685589519650655
3532,0.3913,7,15,7,604179,1431,107119,837,0.013255400348290045,0.36904761904761907
3533,0.3914,2,3,2,604182,1428,107121,835,0.013227611249027382,0.36897923110914715
3534,0.3915,5,3,5,604185,1425,107126,830,0.01319982214976472,0.36807095343680707
3535,0.3916,1,4,1,604189,1421,107127,829,0.013162770017414503,0.36844444444444446
3536,0.3917,3,14,3,604203,1407,107130,826,0.013033087554188744,0.36990595611285265
3537,0.3918,2,3,2,604206,1404,107132,824,0.013005298454926081,0.36983842010771995
3538,0.3919,2,11,2,604217,1393,107134,822,0.012903405090962985,0.3711060948081264
3539,0.392,9,13,9,604230,1380,107143,813,0.01278298566082478,0.3707250341997264
3540,0.3921,12,20,12,604250,1360,107155,801,0.012597724999073696,0.3706617306802406
3541,0.3922,2,1,2,604251,1359,107157,799,0.012588461965986142,0.37025023169601484
3542,0.3923,5,8,5,604259,1351,107162,794,0.012514357701285709,0.3701631701631702
3543,0.3924,3,5,3,604264,1346,107165,791,0.012468042535847938,0.370145063172672
3544,0.3925,3,4,3,604268,1342,107168,788,0.01243099040349772,0.3699530516431925
3545,0.3926,1,3,1,604271,1339,107169,787,0.012403201304235058,0.37017873941674506
3546,0.3927,1,2,1,604273,1337,107170,786,0.01238467523805995,0.3702308054639661
3547,0.3928,1,3,1,604276,1334,107171,785,0.012356886138797287,0.3704577630957999
3548,0.3929,0,1,0,604277,1333,107171,785,0.012347623105709733,0.37063267233238906
3549,0.393,5,25,5,604302,1308,107176,780,0.01211604727852088,0.3735632183908046
3550,0.3931,3,15,3,604317,1293,107179,777,0.011977101782207566,0.3753623188405797
3551,0.3932,5,4,5,604321,1289,107184,772,0.01194004964985735,0.37457544881125665
3552,0.3933,5,17,5,604338,1272,107189,767,0.011782578087368928,0.37616478666012754
3553,0.3934,3,5,3,604343,1267,107192,764,0.011736262921931157,0.3761693746922698
3554,0.3935,1,7,1,604350,1260,107193,763,0.011671421690318278,0.3771626297577855
3555,0.3936,6,14,6,604364,1246,107199,757,0.011541739227092519,0.3779331003494758
3556,0.3937,5,4,5,604368,1242,107204,752,0.011504687094742302,0.37713139418254765
3557,0.3938,0,2,0,604370,1240,107204,752,0.011486161028567194,0.37751004016064255
3558,0.3939,0,1,0,604371,1239,107204,752,0.01147689799547964,0.37769964841788045
3559,0.394,1,1,1,604372,1238,107205,751,0.011467634962392085,0.37757667169431874
3560,0.3941,0,3,0,604375,1235,107205,751,0.011439845863129423,0.378147029204431
3561,0.3942,2,0,2,604375,1235,107207,749,0.011439845863129423,0.37752016129032256
3562,0.3943,2,3,2,604378,1232,107209,747,0.01141205676386676,0.3774633653360283
3563,0.3944,2,1,2,604379,1231,107211,745,0.011402793730779206,0.3770242914979757
3564,0.3945,7,8,7,604387,1223,107218,738,0.011328689466078772,0.37633860275369707
3565,0.3946,3,0,3,604387,1223,107221,735,0.011328689466078772,0.37538304392236976
3566,0.3947,0,4,0,604391,1219,107221,735,0.011291637333728555,0.37615148413510746
3567,0.3948,8,9,8,604400,1210,107229,727,0.011208270035940568,0.37532266391326796
3568,0.3949,11,11,11,604411,1199,107240,716,0.011106376671977473,0.37389033942558747
3569,0.395,3,1,3,604412,1198,107243,713,0.011097113638889919,0.37310308738880166
3570,0.3951,1,5,1,604417,1193,107244,712,0.011050798473452148,0.373753280839895
3571,0.3952,5,10,5,604427,1183,107249,707,0.010958168142576606,0.37407407407407406
3572,0.3953,2,1,2,604428,1182,107251,705,0.010948905109489052,0.37360890302066774
3573,0.3954,1,2,1,604430,1180,107252,704,0.010930379043313943,0.37367303609341823
3574,0.3955,7,8,7,604438,1172,107259,697,0.01085627477861351,0.3729266987693954
3575,0.3956,3,9,3,604447,1163,107262,694,0.010772907480825522,0.3737210554658051
3576,0.3957,0,1,0,604448,1162,107262,694,0.010763644447737968,0.3739224137931034
3577,0.3958,14,19,14,604467,1143,107276,680,0.010587646819074438,0.3730115194733955
3578,0.3959,5,19,5,604486,1124,107281,675,0.010411649190410908,0.3752084491384102
3579,0.396,0,1,0,604487,1123,107281,675,0.010402386157323354,0.3754171301446051
3580,0.3961,1,3,1,604490,1120,107282,674,0.010374597058060691,0.3756967670011148
3581,0.3962,5,11,5,604501,1109,107287,669,0.010272703694097595,0.3762654668166479
3582,0.3963,3,5,3,604506,1104,107290,666,0.010226388528659824,0.376271186440678
3583,0.3964,7,7,7,604513,1097,107297,659,0.010161547297046944,0.37528473804100226
3584,0.3965,4,8,4,604521,1089,107301,655,0.010087443032346512,0.3755733944954128
3585,0.3966,5,15,5,604536,1074,107306,650,0.0099484975360332,0.37703016241299303
3586,0.3967,1,0,1,604536,1074,107307,649,0.0099484975360332,0.3766686012768427
3587,0.3968,9,3,9,604539,1071,107316,640,0.009920708436770537,0.37405026300409117
3588,0.397,2,2,2,604541,1069,107318,638,0.009902182370595428,0.37375512595196253
3589,0.3971,3,1,3,604542,1068,107321,635,0.009892919337507874,0.37287140340575453
3590,0.3972,2,11,2,604553,1057,107323,633,0.009791025973544778,0.3745562130177515
3591,0.3973,2,16,2,604569,1041,107325,631,0.00964281744414391,0.37739234449760767
3592,0.3974,0,2,0,604571,1039,107325,631,0.009624291377968802,0.3778443113772455
3593,0.3975,4,3,4,604574,1036,107329,627,0.00959650227870614,0.37702946482260974
3594,0.3976,0,3,0,604577,1033,107329,627,0.009568713179443477,0.377710843373494
3595,0.3977,2,9,2,604586,1024,107331,625,0.009485345881655489,0.3790175864160097
3596,0.3978,12,9,12,604595,1015,107343,613,0.009401978583867501,0.37653562653562656
3597,0.3979,4,3,4,604598,1012,107347,609,0.009374189484604839,0.3756940160394818
3598,0.398,1,4,1,604602,1008,107348,608,0.009337137352254622,0.37623762376237624
3599,0.3981,6,4,6,604606,1004,107354,602,0.009300085219904405,0.37484433374844334
3600,0.3982,4,9,4,604615,995,107358,598,0.009216717922116417,0.3753923414940364
3601,0.3983,1,4,1,604619,991,107359,597,0.0091796657897662,0.37594458438287154
3602,0.3984,5,2,5,604621,989,107364,592,0.009161139723591092,0.37444655281467426
3603,0.3985,2,2,2,604623,987,107366,590,0.009142613657415984,0.37412809131261887
3604,0.3986,2,1,2,604624,986,107368,588,0.00913335062432843,0.3735705209656925
3605,0.3987,9,18,9,604642,968,107377,579,0.008966616028752455,0.3742727860374919
3606,0.3989,1,1,1,604643,967,107378,578,0.008957352995664901,0.37411003236245954
3607,0.399,2,0,2,604643,967,107380,576,0.008957352995664901,0.37329876863253403
3608,0.3991,3,3,3,604646,964,107383,573,0.008929563896402239,0.372804163955758
3609,0.3992,2,3,2,604649,961,107385,571,0.008901774797139576,0.3727154046997389
3610,0.3993,3,9,3,604658,952,107388,568,0.008818407499351588,0.3736842105263158
3611,0.3994,1,2,1,604660,950,107389,567,0.00879988143317648,0.37376400791034936
3612,0.3995,1,5,1,604665,945,107390,566,0.008753566267738709,0.3745863666446062
3613,0.3996,2,3,2,604668,942,107392,564,0.008725777168476046,0.3745019920318725
3614,0.3997,4,6,4,604674,936,107396,560,0.008670198969950721,0.37433155080213903
3615,0.3998,1,1,1,604675,935,107397,559,0.008660935936863167,0.37416331994645247
3616,0.3999,4,13,4,604688,922,107401,555,0.008540516506724962,0.37576167907921465
3617,0.4,3,7,3,604695,915,107404,552,0.008475675275112083,0.37627811860940696
3618,0.4001,1,6,1,604701,909,107405,551,0.008420097076586757,0.3773972602739726
3619,0.4002,0,1,0,604702,908,107405,551,0.008410834043499203,0.3776559287183002
3620,0.4003,8,8,8,604710,900,107413,543,0.00833672977879877,0.3762993762993763
3621,0.4004,6,5,6,604715,895,107419,537,0.008290414613360999,0.375
3622,0.4005,13,17,13,604732,878,107432,524,0.008132943050872577,0.37375178316690444
3623,0.4006,3,5,3,604737,873,107435,521,0.008086627885434806,0.37374461979913914
3624,0.4007,0,2,0,604739,871,107435,521,0.008068101819259698,0.3742816091954023
3625,0.4008,1,1,1,604740,870,107436,520,0.008058838786172143,0.37410071942446044
3626,0.4009,5,14,5,604754,856,107441,515,0.007929156322946386,0.37563822027717
3627,0.4011,1,0,1,604754,856,107442,514,0.007929156322946386,0.37518248175182484
3628,0.4012,0,1,0,604755,855,107442,514,0.007919893289858832,0.3754565376186998
3629,0.4013,0,5,0,604760,850,107442,514,0.007873578124421061,0.37683284457478006
3630,0.4014,0,5,0,604765,845,107442,514,0.00782726295898329,0.37821927888153056
3631,0.4015,1,4,1,604769,841,107443,513,0.007790210826633072,0.378877400295421
3632,0.4016,3,5,3,604774,836,107446,510,0.007743895661195301,0.3789004457652303
3633,0.4017,0,1,0,604775,835,107446,510,0.007734632628107747,0.379182156133829
3634,0.4018,6,7,6,604782,828,107452,504,0.007669791396494869,0.3783783783783784
3635,0.4019,2,1,2,604783,827,107454,502,0.0076605283634073144,0.37772761474793076
3636,0.402,13,26,13,604809,801,107467,489,0.007419689503130905,0.37906976744186044
3637,0.4021,4,10,4,604819,791,107471,485,0.007327059172255363,0.38009404388714735
3638,0.4022,4,9,4,604828,782,107475,481,0.007243691874467375,0.3808392715756136
3639,0.4023,1,1,1,604829,781,107476,480,0.007234428841379821,0.38065027755749403
3640,0.4024,2,5,2,604834,776,107478,478,0.00718811367594205,0.38118022328548645
3641,0.4026,1,12,1,604846,764,107479,477,0.0070769572788914005,0.3843674456083803
3642,0.4027,2,9,2,604855,755,107481,475,0.006993589981103413,0.3861788617886179
3643,0.4028,4,5,4,604860,750,107485,471,0.006947274815665642,0.3857493857493858
3644,0.4029,16,19,16,604879,731,107501,455,0.006771277187002112,0.3836424957841484
3645,0.403,0,4,0,604883,727,107501,455,0.006734225054651895,0.3849407783417936
3646,0.4031,0,3,0,604886,724,107501,455,0.006706435955389232,0.38592027141645463
3647,0.4032,1,1,1,604887,723,107502,454,0.006697172922301678,0.3857264231096007
3648,0.4033,5,15,5,604902,708,107507,449,0.006558227425988366,0.38807260155574763
3649,0.4034,1,6,1,604908,702,107508,448,0.006502649227463041,0.38956521739130434
3650,0.4037,5,11,5,604919,691,107513,443,0.0064007558634999445,0.390652557319224
3651,0.4038,12,9,12,604928,682,107525,431,0.006317388565711957,0.38724168912848156
3652,0.4039,0,1,0,604929,681,107525,431,0.006308125532624402,0.38758992805755393
3653,0.404,8,10,8,604939,671,107533,423,0.00621549520174886,0.386654478976234
3654,0.4041,11,11,11,604950,660,107544,412,0.006113601837785765,0.3843283582089552
3655,0.4042,3,2,3,604952,658,107547,409,0.006095075771610657,0.38331771321462044
3656,0.4043,2,8,2,604960,650,107549,407,0.006020971506910223,0.38505203405865657
3657,0.4044,5,8,5,604968,642,107554,402,0.005946867242209789,0.3850574712643678
3658,0.4045,1,0,1,604968,642,107555,401,0.005946867242209789,0.3844678811121764
3659,0.4046,3,0,3,604968,642,107558,398,0.005946867242209789,0.38269230769230766
3660,0.4047,3,8,3,604976,634,107561,395,0.005872762977509356,0.3838678328474247
3661,0.4048,5,16,5,604992,618,107566,390,0.0057245544481084884,0.3869047619047619
3662,0.4049,5,1,5,604993,617,107571,385,0.005715291415020934,0.3842315369261477
3663,0.4051,4,11,4,605004,606,107575,381,0.005613398051057838,0.3860182370820669
3664,0.4052,2,7,2,605011,599,107577,379,0.005548556819444959,0.38752556237218816
3665,0.4053,0,1,0,605012,598,107577,379,0.005539293786357405,0.38792221084953943
3666,0.4054,3,5,3,605017,593,107580,376,0.005492978620919634,0.38802889576883387
3667,0.4055,2,6,2,605023,587,107582,374,0.005437400422394309,0.3891779396462019
3668,0.4056,11,17,11,605040,570,107593,363,0.0052799288599058875,0.3890675241157556
3669,0.4057,2,6,2,605046,564,107595,361,0.005224350661380562,0.3902702702702703
3670,0.4058,2,1,2,605047,563,107597,359,0.005215087628293008,0.3893709327548807
3671,0.4059,1,2,1,605049,561,107598,358,0.0051965615621179,0.3895538628944505
3672,0.406,6,14,6,605063,547,107604,352,0.005066879098892141,0.39154616240266965
3673,0.4061,1,4,1,605067,543,107605,351,0.005029826966541925,0.3926174496644295
3674,0.4062,5,11,5,605078,532,107610,346,0.004927933602578829,0.3940774487471526
3675,0.4063,0,1,0,605079,531,107610,346,0.0049186705694912744,0.3945267958950969
3676,0.4064,1,0,1,605079,531,107611,345,0.0049186705694912744,0.3938356164383562
3677,0.4065,1,7,1,605086,524,107612,344,0.004853829337878395,0.39631336405529954
3678,0.4066,1,0,1,605086,524,107613,343,0.004853829337878395,0.3956170703575548
3679,0.4067,2,0,2,605086,524,107615,341,0.004853829337878395,0.3942196531791908
3680,0.4068,1,2,1,605088,522,107616,340,0.004835303271703287,0.39443155452436196
3681,0.4069,6,8,6,605096,514,107622,334,0.004761199007002853,0.3938679245283019
3682,0.407,4,7,4,605103,507,107626,330,0.0046963577753899735,0.3942652329749104
3683,0.4071,5,6,5,605109,501,107631,325,0.004640779576864648,0.3934624697336562
3684,0.4072,0,2,0,605111,499,107631,325,0.00462225351068954,0.39441747572815533
3685,0.4074,4,1,4,605112,498,107635,321,0.004612990477601986,0.39194139194139194
3686,0.4075,0,1,0,605113,497,107635,321,0.0046037274445144315,0.3924205378973105
3687,0.4076,1,2,1,605115,495,107636,320,0.004585201378339323,0.39263803680981596
3688,0.4077,4,5,4,605120,490,107640,316,0.004538886212901552,0.3920595533498759
3689,0.4078,4,2,4,605122,488,107644,312,0.0045203601467264445,0.39
3690,0.4079,5,6,5,605128,482,107649,307,0.004464781948201119,0.38910012674271227
3691,0.4081,5,4,5,605132,478,107654,302,0.0044277298158509025,0.3871794871794872
3692,0.4082,0,2,0,605134,476,107654,302,0.004409203749675794,0.38817480719794345
3693,0.4083,1,1,1,605135,475,107655,301,0.00439994071658824,0.38788659793814434
3694,0.4084,2,0,2,605135,475,107657,299,0.00439994071658824,0.3863049095607235
3695,0.4085,1,0,1,605135,475,107658,298,0.00439994071658824,0.3855109961190168
3696,0.4086,2,0,2,605135,475,107660,296,0.00439994071658824,0.383916990920882
3697,0.4087,3,14,3,605149,461,107663,293,0.004270258253362481,0.3885941644562334
3698,0.4088,0,2,0,605151,459,107663,293,0.004251732187187373,0.3896276595744681
3699,0.4089,7,9,7,605160,450,107670,286,0.004168364889399385,0.38858695652173914
3700,0.409,1,2,1,605162,448,107671,285,0.004149838823224276,0.3888130968622101
3701,0.4091,1,2,1,605164,446,107672,284,0.004131312757049168,0.38904109589041097
3702,0.4093,3,12,3,605176,434,107675,281,0.0040201563599985175,0.393006993006993
3703,0.4095,3,5,3,605181,429,107678,278,0.003973841194560747,0.3932107496463932
3704,0.4097,1,1,1,605182,428,107679,277,0.003964578161473193,0.39290780141843973
3705,0.4098,3,3,3,605185,425,107682,274,0.0039367890622105306,0.39198855507868385
3706,0.4099,0,1,0,605186,424,107682,274,0.003927526029122976,0.39255014326647564
3707,0.41,0,1,0,605187,423,107682,274,0.003918262996035422,0.3931133428981349
3708,0.4101,5,4,5,605191,419,107687,269,0.003881210863685205,0.39098837209302323
3709,0.4103,1,3,1,605194,416,107688,268,0.0038534217644225427,0.391812865497076
3710,0.4104,1,6,1,605200,410,107689,267,0.0037978435658972175,0.39438700147710487
3711,0.4105,0,3,0,605203,407,107689,267,0.003770054466634555,0.3961424332344214
3712,0.4106,2,0,2,605203,407,107691,265,0.003770054466634555,0.3943452380952381
3713,0.4107,2,3,2,605206,404,107693,263,0.0037422653673718923,0.39430284857571213
3714,0.4109,2,4,2,605210,400,107695,261,0.0037052132350216755,0.394856278366112
3715,0.411,2,0,2,605210,400,107697,259,0.0037052132350216755,0.3930197268588771
3716,0.4111,5,4,5,605214,396,107702,254,0.0036681611026714587,0.39076923076923076
3717,0.4112,1,6,1,605220,390,107703,253,0.0036125829041461334,0.39346811819595645
3718,0.4113,2,2,2,605222,388,107705,251,0.003594056837971025,0.39280125195618154
3719,0.4114,1,4,1,605226,384,107706,250,0.0035570047056208086,0.3943217665615142
3720,0.4116,3,1,3,605227,383,107709,247,0.0035477416725332544,0.39206349206349206
3721,0.4117,0,1,0,605228,382,107709,247,0.0035384786394457002,0.39268680445151033
3722,0.4119,0,1,0,605229,381,107709,247,0.003529215606358146,0.39331210191082805
3723,0.412,1,0,1,605229,381,107710,246,0.003529215606358146,0.3923444976076555
3724,0.4121,1,1,1,605230,380,107711,245,0.003519952573270592,0.392
3725,0.4123,4,4,4,605234,376,107715,241,0.003482900440920375,0.3905996758508914
3726,0.4124,1,5,1,605239,371,107716,240,0.003436585275482604,0.39279869067103107
3727,0.4125,1,2,1,605241,369,107717,239,0.0034180592093074956,0.3930921052631579
3728,0.4126,6,6,6,605247,363,107723,233,0.0033624810107821704,0.39093959731543626
3729,0.4127,1,4,1,605251,359,107724,232,0.0033254288784319535,0.3925549915397631
3730,0.4129,6,11,6,605262,348,107730,226,0.0032235355144688577,0.39372822299651566
3731,0.4131,3,1,3,605263,347,107733,223,0.0032142724813813035,0.3912280701754386
3732,0.4132,1,1,1,605264,346,107734,222,0.0032050094482937493,0.3908450704225352
3733,0.4133,2,0,2,605264,346,107736,220,0.0032050094482937493,0.38869257950530034
3734,0.4134,0,1,0,605265,345,107736,220,0.003195746415206195,0.3893805309734513
3735,0.4135,1,4,1,605269,341,107737,219,0.0031586942828559783,0.39107142857142857
3736,0.4138,4,1,4,605270,340,107741,215,0.003149431249768424,0.38738738738738737
3737,0.414,1,1,1,605271,339,107742,214,0.00314016821668087,0.38698010849909587
3738,0.4141,0,1,0,605272,338,107742,214,0.0031309051835933157,0.38768115942028986
3739,0.4144,1,4,1,605276,334,107743,213,0.003093853051243099,0.38939670932358317
3740,0.4145,3,3,3,605279,331,107746,210,0.0030660639519804363,0.38817005545286504
3741,0.4146,1,2,1,605281,329,107747,209,0.0030475378858053283,0.38847583643122674
3742,0.4147,1,0,1,605281,329,107748,208,0.0030475378858053283,0.38733705772811916
3743,0.4148,0,1,0,605282,328,107748,208,0.003038274852717774,0.3880597014925373
3744,0.4151,9,9,9,605291,319,107757,199,0.0029549075549297863,0.3841698841698842
3745,0.4152,1,2,1,605293,317,107758,198,0.002936381488754678,0.3844660194174757
3746,0.4154,1,0,1,605293,317,107759,197,0.002936381488754678,0.3832684824902724
3747,0.4155,1,1,1,605294,316,107760,196,0.0029271184556671236,0.3828125
3748,0.4156,3,4,3,605298,312,107763,193,0.002890066323316907,0.3821782178217822
3749,0.4158,1,0,1,605298,312,107764,192,0.002890066323316907,0.38095238095238093
3750,0.416,4,3,4,605301,309,107768,188,0.0028622772240542442,0.3782696177062374
3751,0.4161,2,2,2,605303,307,107770,186,0.002843751157879136,0.3772819472616633
3752,0.4162,1,3,1,605306,304,107771,185,0.002815962058616473,0.3783231083844581
3753,0.4163,5,3,5,605309,301,107776,180,0.002788172959353811,0.37422037422037424
3754,0.4164,2,3,2,605312,298,107778,178,0.0027603838600911484,0.3739495798319328
3755,0.4165,0,1,0,605313,297,107778,178,0.002751120827003594,0.37473684210526315
3756,0.4168,2,2,2,605315,295,107780,176,0.002732594760828486,0.37367303609341823
3757,0.4169,1,2,1,605317,293,107781,175,0.0027140686946533774,0.37393162393162394
3758,0.4172,1,3,1,605320,290,107782,174,0.0026862795953907148,0.375
3759,0.4174,1,1,1,605321,289,107783,173,0.0026770165623031606,0.37445887445887444
3760,0.4175,0,1,0,605322,288,107783,173,0.0026677535292156064,0.3752711496746204
3761,0.4176,2,6,2,605328,282,107785,171,0.002612175330690281,0.37748344370860926
3762,0.4177,2,3,2,605331,279,107787,169,0.0025843862314276185,0.37723214285714285
3763,0.4178,1,1,1,605332,278,107788,168,0.0025751231983400643,0.37668161434977576
3764,0.4181,3,7,3,605339,271,107791,165,0.0025102819667271853,0.37844036697247707
3765,0.4182,7,6,7,605345,265,107798,158,0.00245470376820186,0.3735224586288416
3766,0.4183,3,5,3,605350,260,107801,155,0.002408388602764089,0.37349397590361444
3767,0.4186,4,8,4,605358,252,107805,151,0.0023342843380636555,0.3746898263027295
3768,0.4187,1,1,1,605359,251,107806,150,0.0023250213049761013,0.3740648379052369
3769,0.4188,1,0,1,605359,251,107807,149,0.0023250213049761013,0.3725
3770,0.4189,2,2,2,605361,249,107809,147,0.002306495238800993,0.3712121212121212
3771,0.419,0,1,0,605362,248,107809,147,0.0022972322057134387,0.3721518987341772
3772,0.4191,1,4,1,605366,244,107810,146,0.0022601800733632223,0.37435897435897436
3773,0.4194,0,1,0,605367,243,107810,146,0.002250917040275668,0.37532133676092544
3774,0.4195,2,4,2,605371,239,107812,144,0.0022138649079254513,0.37597911227154046
3775,0.4196,1,0,1,605371,239,107813,143,0.0022138649079254513,0.3743455497382199
3776,0.4197,1,6,1,605377,233,107814,142,0.002158286709400126,0.37866666666666665
3777,0.4198,3,3,3,605380,230,107817,139,0.0021304976101374634,0.37669376693766937
3778,0.42,0,2,0,605382,228,107817,139,0.002111971543962355,0.3787465940054496
3779,0.4203,1,0,1,605382,228,107818,138,0.002111971543962355,0.3770491803278688
3780,0.4204,2,0,2,605382,228,107820,136,0.002111971543962355,0.37362637362637363
3781,0.4205,0,2,0,605384,226,107820,136,0.0020934454777872466,0.3756906077348066
3782,0.4207,2,2,2,605386,224,107822,134,0.002074919411612138,0.3743016759776536
3783,0.4208,6,5,6,605391,219,107828,128,0.002028604246174367,0.3688760806916426
3784,0.4209,5,6,5,605397,213,107833,123,0.0019730260476490424,0.36607142857142855
3785,0.4211,3,5,3,605402,208,107836,120,0.0019267108822112714,0.36585365853658536
3786,0.4212,4,1,4,605403,207,107840,116,0.0019174478491237172,0.3591331269349845
3787,0.4213,2,0,2,605403,207,107842,114,0.0019174478491237172,0.35514018691588783
3788,0.4216,0,1,0,605404,206,107842,114,0.001908184816036163,0.35625
3789,0.4217,1,2,1,605406,204,107843,113,0.0018896587498610545,0.35646687697160884
3790,0.422,3,4,3,605410,200,107846,110,0.0018526066175108377,0.3548387096774194
3791,0.4221,3,8,3,605418,192,107849,107,0.0017785023528104043,0.35785953177257523
3792,0.4225,3,4,3,605422,188,107852,104,0.0017414502204601875,0.3561643835616438
3793,0.4226,2,10,2,605432,178,107854,102,0.0016488198895846457,0.36428571428571427
3794,0.4227,0,1,0,605433,177,107854,102,0.0016395568564970915,0.3655913978494624
3795,0.4228,2,2,2,605435,175,107856,100,0.001621030790321983,0.36363636363636365
3796,0.4229,0,2,0,605437,173,107856,100,0.0016025047241468747,0.3663003663003663
3797,0.423,2,2,2,605439,171,107858,98,0.0015839786579717663,0.3643122676579926
3798,0.4231,0,3,0,605442,168,107858,98,0.0015561895587091036,0.3684210526315789
3799,0.4232,0,2,0,605444,166,107858,98,0.0015376634925339952,0.3712121212121212
3800,0.4233,1,1,1,605445,165,107859,97,0.0015284004594464412,0.3702290076335878
3801,0.4234,1,1,1,605446,164,107860,96,0.001519137426358887,0.36923076923076925
3802,0.4235,2,2,2,605448,162,107862,94,0.0015006113601837786,0.3671875
3803,0.4239,4,11,4,605459,151,107866,90,0.0013987179962206824,0.37344398340248963
3804,0.4242,0,1,0,605460,150,107866,90,0.0013894549631331284,0.375
3805,0.4244,2,1,2,605461,149,107868,88,0.0013801919300455742,0.37130801687763715
3806,0.4245,5,5,5,605466,144,107873,83,0.0013338767646078032,0.3656387665198238
3807,0.4247,3,1,3,605467,143,107876,80,0.001324613731520249,0.35874439461883406
3808,0.425,2,2,2,605469,141,107878,78,0.0013060876653451406,0.3561643835616438
3809,0.4251,2,5,2,605474,136,107880,76,0.0012597724999073698,0.3584905660377358
3810,0.4252,0,2,0,605476,134,107880,76,0.0012412464337322614,0.3619047619047619
3811,0.4253,1,0,1,605476,134,107881,75,0.0012412464337322614,0.3588516746411483
3812,0.4254,1,1,1,605477,133,107882,74,0.0012319834006447072,0.357487922705314
3813,0.4256,0,2,0,605479,131,107882,74,0.0012134573344695988,0.36097560975609755
3814,0.4259,2,1,2,605480,130,107884,72,0.0012041943013820445,0.3564356435643564
3815,0.426,0,2,0,605482,128,107884,72,0.0011856682352069361,0.36
3816,0.4262,0,1,0,605483,127,107884,72,0.001176405202119382,0.36180904522613067
3817,0.4263,0,1,0,605484,126,107884,72,0.0011671421690318277,0.36363636363636365
3818,0.4267,2,0,2,605484,126,107886,70,0.0011671421690318277,0.35714285714285715
3819,0.4269,0,1,0,605485,125,107886,70,0.0011578791359442735,0.358974358974359
3820,0.4273,1,0,1,605485,125,107887,69,0.0011578791359442735,0.3556701030927835
3821,0.4274,1,5,1,605490,120,107888,68,0.0011115639705065027,0.3617021276595745
3822,0.4275,1,6,1,605496,114,107889,67,0.0010559857719811775,0.3701657458563536
3823,0.4277,6,9,6,605505,105,107895,61,0.0009726184741931898,0.3674698795180723
3824,0.4278,1,2,1,605507,103,107896,60,0.0009540924080180815,0.36809815950920244
3825,0.4279,0,3,0,605510,100,107896,60,0.0009263033087554189,0.375
3826,0.4281,1,1,1,605511,99,107897,59,0.0009170402756678647,0.37341772151898733
3827,0.4286,0,5,0,605516,94,107897,59,0.0008707251102300938,0.38562091503267976
3828,0.4287,2,2,2,605518,92,107899,57,0.0008521990440549853,0.3825503355704698
3829,0.4288,0,4,0,605522,88,107899,57,0.0008151469117047686,0.3931034482758621
3830,0.4289,0,1,0,605523,87,107899,57,0.0008058838786172144,0.3958333333333333
3831,0.4291,0,1,0,605524,86,107899,57,0.0007966208455296602,0.3986013986013986
3832,0.4292,1,1,1,605525,85,107900,56,0.000787357812442106,0.3971631205673759
3833,0.4293,0,2,0,605527,83,107900,56,0.0007688317462669976,0.4028776978417266
3834,0.4294,3,2,3,605529,81,107903,53,0.0007503056800918893,0.39552238805970147
3835,0.4295,2,3,2,605532,78,107905,51,0.0007225165808292267,0.3953488372093023
3836,0.4296,1,1,1,605533,77,107906,50,0.0007132535477416725,0.3937007874015748
3837,0.4297,1,0,1,605533,77,107907,49,0.0007132535477416725,0.3888888888888889
3838,0.4299,2,0,2,605533,77,107909,47,0.0007132535477416725,0.3790322580645161
3839,0.4301,1,0,1,605533,77,107910,46,0.0007132535477416725,0.37398373983739835
3840,0.4303,0,1,0,605534,76,107910,46,0.0007039905146541183,0.3770491803278688
3841,0.4306,1,2,1,605536,74,107911,45,0.00068546444847901,0.37815126050420167
3842,0.4311,5,2,5,605538,72,107916,40,0.0006669383823039016,0.35714285714285715
3843,0.4322,3,1,3,605539,71,107919,37,0.0006576753492163474,0.3425925925925926
3844,0.4324,2,1,2,605540,70,107921,35,0.0006484123161287932,0.3333333333333333
3845,0.4326,1,2,1,605542,68,107922,34,0.0006298862499536849,0.3333333333333333
3846,0.4331,1,6,1,605548,62,107923,33,0.0005743080514283597,0.3473684210526316
3847,0.4334,0,2,0,605550,60,107923,33,0.0005557819852532514,0.3548387096774194
3848,0.4337,0,2,0,605552,58,107923,33,0.000537255919078143,0.3626373626373626
3849,0.434,0,1,0,605553,57,107923,33,0.0005279928859905888,0.36666666666666664
3850,0.4341,1,1,1,605554,56,107924,32,0.0005187298529030345,0.36363636363636365
3851,0.4343,1,4,1,605558,52,107925,31,0.00048167772055281784,0.37349397590361444
3852,0.4347,3,7,3,605565,45,107928,28,0.00041683648893993847,0.3835616438356164
3853,0.435,1,1,1,605566,44,107929,27,0.0004075734558523843,0.38028169014084506
3854,0.4353,0,4,0,605570,40,107929,27,0.00037052132350216756,0.40298507462686567
3855,0.4354,1,3,1,605573,37,107930,26,0.000342732224239505,0.4126984126984127
3856,0.4356,0,1,0,605574,36,107930,26,0.0003334691911519508,0.41935483870967744
3857,0.4359,0,2,0,605576,34,107930,26,0.00031494312497684244,0.43333333333333335
3858,0.4363,3,2,3,605578,32,107933,23,0.00029641705880173404,0.41818181818181815
3859,0.4364,0,4,0,605582,28,107933,23,0.0002593649264515173,0.45098039215686275
3860,0.4365,1,0,1,605582,28,107934,22,0.0002593649264515173,0.44
3861,0.4378,0,1,0,605583,27,107934,22,0.00025010189336396307,0.4489795918367347
3862,0.438,3,3,3,605586,24,107937,19,0.00022231279410130054,0.4418604651162791
3863,0.4381,0,1,0,605587,23,107937,19,0.00021304976101374634,0.4523809523809524
3864,0.4383,3,3,3,605590,20,107940,16,0.00018526066175108378,0.4444444444444444
3865,0.4387,0,1,0,605591,19,107940,16,0.00017599762866352957,0.45714285714285713
3866,0.4393,1,3,1,605594,16,107941,15,0.00014820852940086702,0.4838709677419355
3867,0.4394,1,0,1,605594,16,107942,14,0.00014820852940086702,0.4666666666666667
3868,0.4395,1,0,1,605594,16,107943,13,0.00014820852940086702,0.4482758620689655
3869,0.4401,0,1,0,605595,15,107943,13,0.00013894549631331284,0.4642857142857143
3870,0.4402,1,1,1,605596,14,107944,12,0.00012968246322575864,0.46153846153846156
3871,0.4406,0,2,0,605598,12,107944,12,0.00011115639705065027,0.5
3872,0.4407,1,0,1,605598,12,107945,11,0.00011115639705065027,0.4782608695652174
3873,0.4411,1,0,1,605598,12,107946,10,0.00011115639705065027,0.45454545454545453
3874,0.4418,0,2,0,605600,10,107946,10,9.263033087554189e-05,0.5
3875,0.4423,1,0,1,605600,10,107947,9,9.263033087554189e-05,0.47368421052631576
3876,0.4425,0,1,0,605601,9,107947,9,8.33672977879877e-05,0.5
3877,0.4433,0,1,0,605602,8,107947,9,7.410426470043351e-05,0.5294117647058824
3878,0.4438,1,0,1,605602,8,107948,8,7.410426470043351e-05,0.5
3879,0.4444,0,1,0,605603,7,107948,8,6.484123161287932e-05,0.5333333333333333
3880,0.4461,1,0,1,605603,7,107949,7,6.484123161287932e-05,0.5
3881,0.4473,0,1,0,605604,6,107949,7,5.5578198525325135e-05,0.5384615384615384
3882,0.4528,1,0,1,605604,6,107950,6,5.5578198525325135e-05,0.5
3883,0.4532,0,1,0,605605,5,107950,6,4.6315165437770945e-05,0.5454545454545454
3884,0.4574,1,0,1,605605,5,107951,5,4.6315165437770945e-05,0.5
3885,0.458,0,1,0,605606,4,107951,5,3.7052132350216754e-05,0.5555555555555556
3886,0.461,1,0,1,605606,4,107952,4,3.7052132350216754e-05,0.5
3887,0.4626,0,1,0,605607,3,107952,4,2.7789099262662567e-05,0.5714285714285714
3888,0.4639,1,0,1,605607,3,107953,3,2.7789099262662567e-05,0.5
3889,0.4645,0,1,0,605608,2,107953,3,1.8526066175108377e-05,0.6
3890,0.4689,1,0,1,605608,2,107954,2,1.8526066175108377e-05,0.5
3891,0.4708,0,1,0,605609,1,107954,2,9.263033087554189e-06,0.6666666666666666
3892,0.474,0,1,0,605610,0,107954,2,0.0,1.0
3893,0.476,1,0,1,605610,0,107955,1,0.0,1.0
3894,0.4763,1,0,1,605610,0,107956,0,0.0,
