,y_proba,y_test,Neg,Pos,TN,FP,FN,TP,FP/P,Prec
0,0.0036,0,1,0,1,676443,0,126256,5.357709732606767,0.15728934507206313
1,0.0037,0,2,0,3,676441,0,126256,5.35769389177544,0.15728973697422563
2,0.0038,0,2,0,5,676439,0,126256,5.357678050944114,0.1572901288783411
3,0.0042,0,2,0,7,676437,0,126256,5.357662210112787,0.15729052078440947
4,0.0043,0,3,0,10,676434,0,126256,5.357638448865797,0.15729110864717388
5,0.0044,0,1,0,11,676433,0,126256,5.357630528450133,0.15729130460240517
6,0.0045,1,0,1,11,676433,1,126255,5.357630528450133,0.15729025474405997
7,0.0046,0,2,0,13,676431,1,126255,5.357614687618806,0.15729064665385967
8,0.0047,0,1,0,14,676430,1,126255,5.357606767203142,0.1572908426094919
9,0.0048,0,3,0,17,676427,1,126255,5.357583005956153,0.1572914304793181
10,0.005,0,3,0,20,676424,1,126255,5.3575592447091624,0.1572920183535386
11,0.0051,0,1,0,21,676423,1,126255,5.357551324293499,0.1572922143125886
12,0.0052,0,1,0,22,676422,1,126255,5.357543403877836,0.1572924102721269
13,0.0053,0,2,0,24,676420,1,126255,5.357527563046509,0.15729280219266825
14,0.0054,0,2,0,26,676418,1,126255,5.357511722215182,0.1572931941151627
15,0.0056,0,2,0,28,676416,1,126255,5.357495881383855,0.15729358603961024
16,0.0057,0,4,0,32,676412,1,126255,5.357464199721202,0.15729436989436466
17,0.0058,0,3,0,35,676409,1,126255,5.357440438474211,0.15729495779055744
18,0.0059,0,1,0,36,676408,1,126255,5.357432518058547,0.15729515375693162
19,0.006,0,5,0,41,676403,1,126255,5.35739291598023,0.15729613359612687
20,0.0061,0,5,0,46,676398,1,126255,5.357353313901913,0.15729711344752964
21,0.0062,1,2,1,48,676396,2,126254,5.3573374730705865,0.15729645549118546
22,0.0063,2,10,2,58,676386,4,126252,5.357258268913952,0.1572963153999686
23,0.0064,1,3,1,61,676383,5,126251,5.357234507666963,0.15729585340267171
24,0.0065,0,7,0,68,676376,5,126251,5.357179064757318,0.15729722523662923
25,0.0066,0,8,0,76,676368,5,126251,5.357115701432011,0.1572987930761669
26,0.0067,0,7,0,83,676361,5,126251,5.357060258522368,0.15730016496140103
27,0.0068,0,5,0,88,676356,5,126251,5.357020656444051,0.15730114489407643
28,0.0069,0,6,0,94,676350,5,126251,5.35697313395007,0.1573023208294034
29,0.007,0,6,0,100,676344,5,126251,5.356925611456089,0.15730349678231237
30,0.0071,0,11,0,111,676333,5,126251,5.356838486883792,0.15730565274164449
31,0.0072,0,6,0,117,676327,5,126251,5.356790964389811,0.15730682874437127
32,0.0073,0,7,0,124,676320,5,126251,5.356735521480167,0.15730820076977614
33,0.0074,0,7,0,131,676313,5,126251,5.356680078570523,0.15730957281911473
34,0.0075,1,13,1,144,676300,6,126250,5.356577113166899,0.15731107096131083
35,0.0076,0,8,0,152,676292,6,126250,5.356513749841592,0.15731263908929377
36,0.0077,0,7,0,159,676285,6,126250,5.356458306931947,0.15731401122692468
37,0.0078,0,5,0,164,676280,6,126250,5.356418704853631,0.1573149913398876
38,0.0079,0,13,0,177,676267,6,126250,5.3563157394500065,0.157317539690748
39,0.008,0,11,0,188,676256,6,126250,5.3562286148777085,0.15731969605211674
40,0.0081,0,13,0,201,676243,6,126250,5.356125649474085,0.15732224455540422
41,0.0082,0,7,0,208,676236,6,126250,5.35607020656444,0.15732361686060567
42,0.0083,0,17,0,225,676219,6,126250,5.355935559498162,0.1573269497014838
43,0.0084,0,14,0,239,676205,6,126250,5.355824673678875,0.15732969450000311
44,0.0085,0,14,0,253,676191,6,126250,5.355713787859587,0.15733243939429814
45,0.0086,1,9,1,262,676182,7,126249,5.355642504118616,0.15733315387865124
46,0.0087,0,17,0,279,676165,7,126249,5.355507857052338,0.1573364871500248
47,0.0088,0,15,0,294,676150,7,126249,5.3553890508173865,0.15733942838911813
48,0.0089,0,20,0,314,676130,7,126249,5.355230642504119,0.15734335021230617
49,0.009,0,11,0,325,676119,7,126249,5.355143517931821,0.15734550729839675
50,0.0091,0,20,0,345,676099,7,126249,5.354985109618553,0.1573494294246387
51,0.0092,0,19,0,364,676080,7,126249,5.354834621720948,0.15735315562568472
52,0.0093,0,19,0,383,676061,7,126249,5.354684133823343,0.1573568820032157
53,0.0094,0,17,0,400,676044,7,126249,5.354549486757065,0.1573602162800872
54,0.0095,0,12,0,412,676032,7,126249,5.3544544417691045,0.15736256997236628
55,0.0096,0,14,0,426,676018,7,126249,5.354343555949816,0.15736531603568388
56,0.0097,1,21,1,447,675997,8,126248,5.354177227220885,0.15736838496967884
57,0.0098,0,13,0,460,675984,8,126248,5.35407426181726,0.15737093509109584
58,0.0099,0,27,0,487,675957,8,126248,5.353860410594348,0.15737623176120816
59,0.01,0,37,0,524,675920,8,126248,5.3535673552148015,0.15738349074009433
60,0.0101,0,16,0,540,675904,8,126248,5.353440628564187,0.1573866299653931
61,0.0102,1,19,1,559,675885,9,126247,5.353290140666582,0.15738930749552443
62,0.0103,0,30,0,589,675855,9,126247,5.35305252819668,0.15739519412743017
63,0.0104,1,21,1,610,675834,10,126246,5.352886199467748,0.1573982645122681
64,0.0105,2,32,2,642,675802,12,126244,5.352632746166519,0.15740244325138458
65,0.0106,0,23,0,665,675779,12,126244,5.352450576606261,0.15740695715708902
66,0.0107,0,24,0,689,675755,12,126244,5.352260486630338,0.1574116675955955
67,0.0108,0,34,0,723,675721,12,126244,5.351991192497782,0.1574183411994289
68,0.0109,0,22,0,745,675699,12,126244,5.351816943353187,0.15742265971521666
69,0.011,0,37,0,782,675662,12,126244,5.351523887973641,0.15742992320795704
70,0.0111,0,32,0,814,675630,12,126244,5.351270434672411,0.15743620568817546
71,0.0112,0,34,0,848,675596,12,126244,5.351001140539855,0.15744288137284246
72,0.0113,0,35,0,883,675561,12,126244,5.350723925991636,0.1574497539925543
73,0.0114,0,30,0,913,675531,12,126244,5.350486313521734,0.1574556452870194
74,0.0115,1,39,1,952,675492,13,126243,5.35017741731086,0.15746225373720743
75,0.0116,0,35,0,987,675457,13,126243,5.349900202762641,0.1574691281027816
76,0.0117,0,38,0,1025,675419,13,126243,5.349599226967431,0.15747659237933193
77,0.0118,1,44,1,1069,675375,14,126242,5.349250728678241,0.15748418509088505
78,0.0119,2,41,2,1110,675334,16,126240,5.348925991636041,0.1574901381531836
79,0.012,1,44,1,1154,675290,17,126239,5.348577493346851,0.15749773245883805
80,0.0121,0,39,0,1193,675251,17,126239,5.348268597135978,0.1575053961995783
81,0.0122,2,30,2,1223,675221,19,126237,5.348030984666075,0.15750918950213236
82,0.0123,1,41,1,1264,675180,20,126236,5.347706247623876,0.1575161963324915
83,0.0124,4,45,4,1309,675135,24,126232,5.347349828919022,0.1575208362710219
84,0.0125,1,45,1,1354,675090,25,126231,5.346993410214168,0.15752863084831173
85,0.0126,2,38,2,1392,675052,27,126229,5.346692434418959,0.15753399868460627
86,0.0127,1,40,1,1432,675012,28,126228,5.346375617792422,0.1575408117418002
87,0.0128,2,46,2,1478,674966,30,126226,5.346011278671905,0.1575477538467683
88,0.0129,0,53,0,1531,674913,30,126226,5.3455914966417435,0.15755817654614243
89,0.013,1,33,1,1564,674880,31,126225,5.345330122924851,0.15756361525642706
90,0.0131,2,49,2,1613,674831,33,126223,5.344942022557344,0.157571150009862
91,0.0132,1,55,1,1668,674776,34,126222,5.344506399695856,0.15758091780503822
92,0.0133,0,52,0,1720,674724,34,126222,5.344094538081358,0.15759114846693784
93,0.0134,2,54,2,1774,674670,36,126220,5.343666835635534,0.15759967036671702
94,0.0135,1,54,1,1828,674616,37,126219,5.3432391331897096,0.15760924535016577
95,0.0136,0,49,0,1877,674567,37,126219,5.342851032822202,0.1576188894411241
96,0.0137,0,53,0,1930,674514,37,126219,5.342431250792042,0.1576293221335951
97,0.0138,1,55,1,1985,674459,38,126218,5.341995627930554,0.15763909791339079
98,0.0139,0,57,0,2042,674402,38,126218,5.341544164237739,0.15765032100122406
99,0.014,3,53,3,2095,674349,41,126215,5.341124382207578,0.15765760139101934
100,0.0141,1,66,1,2161,674283,42,126214,5.340601634773793,0.15766954779343334
101,0.0142,0,57,0,2218,674226,42,126214,5.340150171080978,0.1576807755734346
102,0.0143,2,57,2,2275,674169,44,126212,5.339698707388163,0.15768990018503687
103,0.0144,0,56,0,2331,674113,44,126212,5.339255164111012,0.1577009339955643
104,0.0145,2,57,2,2388,674056,46,126210,5.338803700418198,0.15771006140458296
105,0.0146,0,64,0,2452,673992,46,126210,5.338296793815739,0.1577226750245563
106,0.0147,3,73,3,2525,673919,49,126207,5.33771860347231,0.15773390690966174
107,0.0148,1,64,1,2589,673855,50,126206,5.3372116968698515,0.15774547190776703
108,0.0149,0,71,0,2660,673784,50,126206,5.336649347357749,0.15775947199339993
109,0.015,3,61,3,2721,673723,53,126203,5.336166202002281,0.15776834357178038
110,0.0151,0,77,0,2798,673646,53,126203,5.335556329996198,0.15778353164159736
111,0.0152,0,62,0,2860,673584,53,126203,5.335065264225067,0.15779576312193122
112,0.0153,1,75,1,2935,673509,54,126202,5.33447123305031,0.15780950868501245
113,0.0154,2,52,2,2987,673457,56,126200,5.334059371435813,0.15781766432357874
114,0.0155,3,63,3,3050,673394,59,126197,5.333560385249018,0.1578269390225753
115,0.0156,2,64,2,3114,673330,61,126195,5.333053478646559,0.1578374659954348
116,0.0157,1,62,1,3176,673268,62,126194,5.332562412875427,0.15784865321928998
117,0.0158,3,70,3,3246,673198,65,126191,5.332007983778989,0.15785931505187087
118,0.0159,4,77,4,3323,673121,69,126187,5.331398111772906,0.15787030781626107
119,0.016,1,90,1,3413,673031,70,126186,5.330685274363199,0.15788703193250395
120,0.0161,2,86,2,3499,672945,72,126184,5.330004118616145,0.15790191571073006
121,0.0162,1,81,1,3580,672864,73,126183,5.329362564947409,0.15791686846956438
122,0.0163,2,72,2,3652,672792,75,126181,5.3287922950196425,0.1579289913426361
123,0.0164,1,81,1,3733,672711,76,126180,5.328150741350906,0.15794394980041082
124,0.0165,3,90,3,3823,672621,79,126177,5.327437903941199,0.15795858277061284
125,0.0166,1,96,1,3919,672525,80,126176,5.326677544037511,0.1579765143652005
126,0.0167,2,91,2,4010,672434,82,126174,5.32595678621214,0.1579924067878108
127,0.0168,0,95,0,4105,672339,82,126174,5.325204346724116,0.1580112033241788
128,0.0169,4,91,4,4196,672248,86,126170,5.324483588898746,0.15802499442647835
129,0.017,3,86,3,4282,672162,89,126167,5.323802433151692,0.15803885365557307
130,0.0171,3,91,3,4373,672071,92,126164,5.323081675326321,0.15805370598883786
131,0.0172,2,113,2,4486,671958,94,126162,5.3221866683563555,0.1580739738385205
132,0.0173,1,93,1,4579,671865,95,126161,5.321450069699658,0.15809134038239356
133,0.0174,1,97,1,4676,671768,96,126160,5.3206817893803064,0.15810950361436119
134,0.0175,2,79,2,4755,671689,98,126158,5.320056076542897,0.15812304865469193
135,0.0176,6,95,6,4850,671594,104,126152,5.3193036370548725,0.15813554690340034
136,0.0177,1,94,1,4944,671500,105,126151,5.318559117982511,0.15815312711950463
137,0.0178,1,87,1,5031,671413,106,126150,5.317870041819795,0.158169323301106
138,0.0179,0,101,0,5132,671312,106,126150,5.31707007983779,0.15818935573105677
139,0.018,1,75,1,5207,671237,107,126149,5.316476048663034,0.15820317888701332
140,0.0181,0,98,0,5305,671139,107,126149,5.315699847928019,0.1582226246977253
141,0.0182,2,88,2,5393,671051,109,126147,5.315002851349639,0.15823797851976548
142,0.0183,3,91,3,5484,670960,112,126144,5.314282093524268,0.1582528754089805
143,0.0184,2,101,2,5585,670859,114,126142,5.313482131542263,0.15827081772795767
144,0.0185,5,95,5,5680,670764,119,126137,5.312729692054239,0.15828440421081164
145,0.0186,2,110,2,5790,670654,121,126135,5.3118584463312635,0.1583041432549897
146,0.0187,4,97,4,5887,670557,125,126131,5.311090166011912,0.15831919145261383
147,0.0188,1,91,1,5978,670466,126,126130,5.310369408186542,0.1583362206187327
148,0.0189,1,95,1,6073,670371,127,126129,5.309616968698517,0.15835404896421845
149,0.019,2,88,2,6161,670283,129,126127,5.308919972120137,0.15836943282982383
150,0.0191,6,110,6,6271,670173,135,126121,5.308048726397161,0.15838496836595528
151,0.0192,4,101,4,6372,670072,139,126117,5.3072487644151565,0.15840083196326502
152,0.0193,2,91,2,6463,669981,141,126115,5.306528006589786,0.1584168241016159
153,0.0194,4,117,4,6580,669864,145,126111,5.305601317957167,0.1584358805238858
154,0.0195,0,112,0,6692,669752,145,126111,5.304714231402864,0.15845817684702015
155,0.0196,2,101,2,6793,669651,147,126109,5.30391426942086,0.15847617372071982
156,0.0197,3,119,3,6912,669532,150,126106,5.302971739956913,0.15849670327460477
157,0.0198,2,93,2,7005,669439,152,126104,5.302235141300216,0.15851311619862157
158,0.0199,2,118,2,7123,669321,154,126102,5.301300532251933,0.1585345155973614
159,0.02,1,111,1,7234,669210,155,126101,5.3004213661132935,0.158555583916229
160,0.0201,1,118,1,7352,669092,156,126100,5.299486757065011,0.1585780541051721
161,0.0202,3,104,3,7456,668988,159,126097,5.298663033836016,0.1585956218517517
162,0.0203,1,113,1,7569,668875,160,126096,5.29776802686605,0.1586171067875432
163,0.0204,5,130,5,7699,668745,165,126091,5.2967383728298065,0.15863775671962518
164,0.0205,2,115,2,7814,668630,167,126089,5.295827525028513,0.15865859505057764
165,0.0206,4,132,4,7946,668498,171,126085,5.294782030160943,0.15868071680365675
166,0.0207,2,124,2,8070,668374,173,126083,5.29379989861868,0.15870336594680393
167,0.0208,1,108,1,8178,668266,174,126082,5.292944493727031,0.15872388424217093
168,0.0209,5,132,5,8310,668134,179,126077,5.29189899885946,0.1587449682766922
169,0.021,3,129,3,8439,668005,182,126074,5.29087726523888,0.15876757854067416
170,0.0211,4,119,4,8558,667886,186,126070,5.289934735774933,0.15878713681866502
171,0.0212,5,142,5,8700,667744,191,126065,5.2888100367507285,0.15881024276620698
172,0.0213,1,142,1,8842,667602,192,126064,5.287685337726524,0.15883759667164776
173,0.0214,2,134,2,8976,667468,194,126062,5.286624002027627,0.15886229884188374
174,0.0215,3,121,3,9097,667347,197,126059,5.285665631732353,0.15888334597923384
175,0.0216,4,126,4,9223,667221,201,126055,5.284667659358763,0.1589043409859872
176,0.0217,6,119,6,9342,667102,207,126049,5.283725129894817,0.1589218194265657
177,0.0218,0,132,0,9474,666970,207,126049,5.282679635027246,0.15894827236169626
178,0.0219,1,124,1,9598,666846,208,126048,5.281697503484983,0.15897206940650327
179,0.022,4,124,4,9722,666722,212,126044,5.280715371942719,0.15899269141209385
180,0.0221,4,138,4,9860,666584,216,126040,5.279622354581169,0.15901612870667556
181,0.0222,3,141,3,10001,666443,219,126037,5.278505575972627,0.15904123763375733
182,0.0223,1,156,1,10157,666287,220,126036,5.277269991129135,0.15907148978383814
183,0.0224,4,147,4,10304,666140,224,126032,5.276105690026613,0.15909676181435345
184,0.0225,7,150,7,10454,665990,231,126025,5.274917627677101,0.15911946112131714
185,0.0226,3,144,3,10598,665846,234,126022,5.273777087821569,0.15914521107053195
186,0.0227,5,151,5,10749,665695,239,126017,5.2725811050563935,0.15917025382967545
187,0.0228,5,149,5,10898,665546,244,126012,5.271400963122544,0.15919490422685387
188,0.0229,5,132,5,11030,665414,249,126007,5.270355468254974,0.15921614412556653
189,0.023,5,139,5,11169,665275,254,126002,5.26925453047776,0.15923880006622207
190,0.0231,3,164,3,11333,665111,257,125999,5.26795558230896,0.15926862256829014
191,0.0232,2,138,2,11471,664973,259,125997,5.266862564947409,0.15929428423328318
192,0.0233,5,131,5,11602,664842,264,125992,5.265824990495501,0.1593153556877929
193,0.0234,2,131,2,11733,664711,266,125990,5.264787416043594,0.15933962395393456
194,0.0235,5,162,5,11895,664549,271,125985,5.263504308706121,0.1593669595488619
195,0.0236,4,148,4,12043,664401,275,125981,5.262332087187936,0.1593925468950457
196,0.0237,3,156,3,12199,664245,278,125978,5.261096502344443,0.15942082171741395
197,0.0238,5,144,5,12343,664101,283,125973,5.259955962488911,0.1594445583578247
198,0.0239,6,163,6,12506,663938,289,125967,5.258664934735775,0.1594710756356777
199,0.024,8,149,8,12655,663789,297,125959,5.257484792801926,0.15949264828780826
200,0.0241,5,149,5,12804,663640,302,125954,5.256304650868078,0.1595174228780867
201,0.0242,6,155,6,12959,663485,308,125948,5.2550769864402485,0.1595423550826986
202,0.0243,3,170,3,13129,663315,311,125945,5.253730515777468,0.15957352456731622
203,0.0244,1,144,1,13273,663171,312,125944,5.2525899759219365,0.15960157898405175
204,0.0245,5,152,5,13425,663019,317,125939,5.251386072741098,0.1596270016908378
205,0.0246,7,150,7,13575,662869,324,125932,5.2501980103915855,0.15964989902396168
206,0.0247,5,160,5,13735,662709,329,125927,5.248930743885439,0.1596769612343337
207,0.0248,7,193,7,13928,662516,336,125920,5.247402103662401,0.15970858763425314
208,0.0249,4,181,4,14109,662335,340,125916,5.245968508427322,0.15974099620552337
209,0.025,6,156,6,14265,662179,346,125910,5.24473292358383,0.15976621929756665
210,0.0251,11,170,11,14435,662009,357,125899,5.243386452921049,0.15978896013240124
211,0.0252,6,193,6,14628,661816,363,125893,5.241857812698011,0.15982171080944868
212,0.0253,6,146,6,14774,661670,369,125887,5.240701432011152,0.1598449382076472
213,0.0254,7,177,7,14951,661493,376,125880,5.239299518438727,0.15987340180575152
214,0.0255,5,173,5,15124,661320,381,125875,5.237929286528957,0.15990320060467864
215,0.0256,7,162,7,15286,661158,388,125868,5.236646179191484,0.15992864276402557
216,0.0257,2,165,2,15451,660993,390,125866,5.235339310607021,0.15996004366728983
217,0.0258,6,163,6,15614,660830,396,125860,5.234048282853884,0.15998678005313402
218,0.0259,11,181,11,15795,660649,407,125849,5.232614687618806,0.1600118499983471
219,0.026,6,190,6,15985,660459,413,125843,5.231109808642757,0.1600441051911352
220,0.0261,3,194,3,16179,660265,416,125840,5.229573248004055,0.1600803963847069
221,0.0262,6,174,6,16353,660091,422,125834,5.228195095678621,0.16010942519960555
222,0.0263,4,186,4,16539,659905,426,125830,5.226721898365226,0.16014305077411595
223,0.0264,4,153,4,16692,659752,430,125826,5.2255100747687235,0.1601699640264875
224,0.0265,4,169,4,16861,659583,434,125822,5.224171524521607,0.16020015151418696
225,0.0266,4,210,4,17071,659373,438,125818,5.22250823723229,0.16023871898684525
226,0.0267,5,169,5,17240,659204,443,125813,5.221169686985173,0.16026786681052768
227,0.0268,6,192,6,17432,659012,449,125807,5.219648967177798,0.1603006553103327
228,0.0269,2,194,2,17626,658818,451,125805,5.218112406539095,0.16033814965913565
229,0.027,5,190,5,17816,658628,456,125800,5.216607527563046,0.16037163385294761
230,0.0271,5,192,5,18008,658436,461,125795,5.215086807755671,0.16040554377472965
231,0.0272,7,180,7,18188,658256,468,125788,5.213661132936257,0.1604348735530149
232,0.0273,6,191,6,18379,658065,474,125782,5.212148333544544,0.1604675402214973
233,0.0274,8,153,8,18532,657912,482,125774,5.210936509948042,0.16049029841033272
234,0.0275,3,178,3,18710,657734,485,125771,5.209526675959954,0.1605235448401733
235,0.0276,6,174,6,18884,657560,491,125765,5.20814852363452,0.16055277183799826
236,0.0277,6,211,6,19095,657349,497,125759,5.20647731592954,0.160589599391144
237,0.0278,5,216,5,19311,657133,502,125754,5.2047665061462425,0.16062854537117105
238,0.0279,2,183,2,19494,656950,504,125752,5.203317070079838,0.1606639563971984
239,0.028,7,182,7,19676,656768,511,125745,5.201875554429097,0.1606938159493836
240,0.0281,5,196,5,19872,656572,516,125740,5.200323152959068,0.16072871181830267
241,0.0282,9,194,9,20066,656378,525,125731,5.198786592320365,0.16075892234969805
242,0.0283,3,193,3,20259,656185,528,125728,5.197257952097326,0.1607953826065048
243,0.0284,6,218,6,20477,655967,534,125722,5.195531301482702,0.16083378427993741
244,0.0285,4,222,4,20699,655745,538,125718,5.1937729692054235,0.16087517899119985
245,0.0286,10,200,10,20899,655545,548,125708,5.192188886072741,0.16090562212241105
246,0.0287,6,224,6,21123,655321,554,125702,5.190414712964136,0.1609453242734209
247,0.0288,8,185,8,21308,655136,562,125694,5.188949436066404,0.16097486008478157
248,0.0289,6,183,6,21491,654953,568,125688,5.1875,0.16100614751210865
249,0.029,7,216,7,21707,654737,575,125681,5.185789190216703,0.16104318454981817
250,0.0291,8,199,8,21906,654538,583,125673,5.184213027499683,0.1610756577387399
251,0.0292,7,203,7,22109,654335,590,125666,5.18260518312001,0.16111004985891045
252,0.0293,6,199,6,22308,654136,596,125660,5.181029020402991,0.16114470964200894
253,0.0294,6,212,6,22520,653924,602,125654,5.179349892282347,0.16118207543055346
254,0.0295,9,211,9,22731,653713,611,125645,5.177678684577367,0.16121602652439573
255,0.0296,4,230,4,22961,653483,615,125641,5.175856988974782,0.16125931173985142
256,0.0297,9,204,9,23165,653279,624,125632,5.174241224179445,0.1612918549102529
257,0.0298,7,207,7,23372,653072,631,125625,5.172601698137118,0.1613271914493057
258,0.0299,11,193,11,23565,652879,642,125614,5.17107305791408,0.16135533652839523
259,0.03,12,191,12,23756,652688,654,125602,5.169560258522368,0.1613820041372753
260,0.0301,9,209,9,23965,652479,663,125593,5.167904891648714,0.16141565305010333
261,0.0302,7,214,7,24179,652265,670,125586,5.166209922696743,0.16145251468468896
262,0.0303,13,216,13,24395,652049,683,125573,5.164499112913446,0.16148334280665927
263,0.0304,3,229,3,24624,651820,686,125570,5.162685337726524,0.16152767594129072
264,0.0305,9,226,9,24850,651594,695,125561,5.160895323786592,0.16156493878312564
265,0.0306,9,200,9,25050,651394,704,125552,5.15931124065391,0.16159681625235217
266,0.0307,8,244,8,25294,651150,712,125544,5.1573786592320365,0.1616389466121793
267,0.0308,13,229,13,25523,650921,725,125531,5.1555648840451145,0.16167258246485294
268,0.0309,10,213,10,25736,650708,735,125521,5.1538778355088075,0.16170614599557606
269,0.031,9,220,9,25956,650488,744,125512,5.152135344062857,0.16174226804123712
270,0.0311,6,232,6,26188,650256,750,125506,5.150297807628944,0.16178415544973845
271,0.0312,5,226,5,26414,650030,755,125501,5.148507793689013,0.16182589735291045
272,0.0313,6,210,6,26624,649820,761,125495,5.146844506399696,0.16186324268200666
273,0.0314,6,200,6,26824,649620,767,125489,5.145260423267013,0.16189852007911146
274,0.0315,10,217,10,27041,649403,777,125479,5.143541693068053,0.1619330427084382
275,0.0316,12,238,12,27279,649165,789,125467,5.141656634140159,0.1619698127627054
276,0.0317,7,242,7,27521,648923,796,125460,5.1397398935496135,0.1620128541044935
277,0.0318,8,242,8,27763,648681,804,125452,5.137823152959068,0.16205484070566686
278,0.0319,5,207,5,27970,648474,809,125447,5.136183626916741,0.1620927717428523
279,0.032,6,224,6,28194,648250,815,125441,5.134409453808136,0.16213320304876236
280,0.0321,6,201,6,28395,648049,821,125435,5.13281745025979,0.16216883607159294
281,0.0322,10,204,10,28599,647845,831,125425,5.131201685464453,0.16220078368487073
282,0.0323,6,227,6,28826,647618,837,125419,5.129403751108859,0.16224191080116476
283,0.0324,14,236,14,29062,647382,851,125405,5.127534533012293,0.16227628052749335
284,0.0325,5,257,5,29319,647125,856,125400,5.125498986186795,0.1623248438561859
285,0.0326,12,244,12,29563,646881,868,125388,5.123566404764922,0.16236311440702655
286,0.0327,2,240,2,29803,646641,870,125386,5.121665505005702,0.1624114182535067
287,0.0328,11,241,11,30044,646400,881,125375,5.11975668483082,0.1624501959768067
288,0.0329,4,220,4,30264,646180,885,125371,5.118014193384869,0.16249217485299092
289,0.033,11,254,11,30518,645926,896,125360,5.116002407806362,0.16253374234719675
290,0.0331,9,223,9,30741,645703,905,125351,5.114236155113421,0.1625709742767692
291,0.0332,9,237,9,30978,645466,914,125342,5.112359016601191,0.16261118203236086
292,0.0333,5,222,5,31200,645244,919,125337,5.110600684323913,0.16265259589841952
293,0.0334,14,269,14,31469,644975,933,125323,5.108470092510455,0.1626941780973078
294,0.0335,9,233,9,31702,644742,942,125314,5.1066246356608795,0.1627336193731365
295,0.0336,9,237,9,31939,644505,951,125305,5.10474749714865,0.16277393122978398
296,0.0337,13,255,13,32194,644250,964,125292,5.1027277911544795,0.16281372556663573
297,0.0338,14,266,14,32460,643984,978,125278,5.100620960588012,0.16285478809560333
298,0.0339,13,243,13,32703,643741,991,125265,5.098696299581802,0.16289209707076407
299,0.034,13,258,13,32961,643483,1004,125252,5.0966528323406415,0.16293261006718832
300,0.0341,6,259,6,33220,643224,1010,125246,5.094601444683817,0.16298098819732715
301,0.0342,9,278,9,33498,642946,1019,125237,5.0923995691293875,0.16303016338554746
302,0.0343,12,239,12,33737,642707,1031,125225,5.090506589785832,0.16306782371355796
303,0.0344,10,229,10,33966,642478,1041,125215,5.08869281459891,0.16310556433365941
304,0.0345,9,237,9,34203,642241,1050,125206,5.086815676086681,0.16314611953659341
305,0.0346,6,230,6,34433,642011,1056,125200,5.084993980484096,0.16318848400244523
306,0.0347,8,249,8,34682,641762,1064,125192,5.083021796983906,0.1632327362527609
307,0.0348,7,292,7,34974,641470,1071,125185,5.080709035610189,0.16328726741493893
308,0.0349,12,225,12,35199,641245,1083,125173,5.07892694208592,0.16332210360403854
309,0.035,11,284,11,35483,640961,1094,125162,5.076677544037511,0.16337063369720006
310,0.0351,6,263,6,35746,640698,1100,125156,5.074594474718033,0.16342018191456859
311,0.0352,11,267,11,36013,640431,1111,125145,5.072479723735902,0.16346515564751246
312,0.0353,10,277,10,36290,640154,1121,125135,5.070285768597136,0.1635133916729497
313,0.0354,13,276,13,36566,639878,1134,125122,5.068099733874034,0.16355816993464053
314,0.0355,11,250,11,36816,639628,1145,125111,5.06611962995818,0.16359960718624264
315,0.0356,10,278,10,37094,639350,1155,125101,5.063917754403751,0.16364816057536716
316,0.0357,9,261,9,37355,639089,1164,125092,5.0618505259156,0.16369420333664406
317,0.0358,6,242,6,37597,638847,1170,125086,5.059933785325054,0.16373949024325432
318,0.0359,10,265,10,37862,638582,1180,125076,5.057834875174249,0.1637853594148166
319,0.036,5,278,5,38140,638304,1185,125071,5.05563299961982,0.16383952841002128
320,0.0361,9,235,9,38375,638069,1194,125062,5.053771701938918,0.16388012018906323
321,0.0362,9,245,9,38620,637824,1203,125053,5.051831200101382,0.16392288665145233
322,0.0363,15,300,15,38920,637524,1218,125038,5.049455075402357,0.16397092957687376
323,0.0364,16,231,16,39151,637293,1234,125022,5.047625459384109,0.16400306959721375
324,0.0365,10,245,10,39396,637048,1244,125012,5.045684957546572,0.16404482586672967
325,0.0366,12,295,12,39691,636753,1256,125000,5.043348434925865,0.16409518570980358
326,0.0367,7,260,7,39951,636493,1263,124993,5.0412891268533775,0.1641435298876145
327,0.0368,13,225,13,40176,636268,1276,124980,5.039507033329109,0.16417777123880786
328,0.0369,6,245,6,40421,636023,1282,124974,5.0375665314915725,0.16422403767688967
329,0.037,11,252,11,40673,635771,1293,124963,5.0355705867443925,0.16426635328511674
330,0.0371,8,249,8,40922,635522,1301,124955,5.033598403244202,0.16431134669424585
331,0.0372,14,294,14,41216,635228,1315,124941,5.0312698010391586,0.16435950426812984
332,0.0373,14,285,14,41501,634943,1329,124927,5.0290124825750855,0.16440575361575005
333,0.0374,11,269,11,41770,634674,1340,124916,5.0268818907616275,0.16445187535380928
334,0.0375,13,273,13,42043,634401,1353,124903,5.024719617285515,0.1644966969751246
335,0.0376,8,285,8,42328,634116,1361,124895,5.022462298821442,0.16454965738309457
336,0.0377,11,316,11,42644,633800,1372,124884,5.019959447471804,0.16460608105614458
337,0.0378,11,281,11,42925,633519,1383,124873,5.017733810670384,0.1646549541661832
338,0.0379,18,295,18,43220,633224,1401,124855,5.015397288049677,0.16469919361966234
339,0.038,8,264,8,43484,632960,1409,124847,5.013306298314536,0.16474775239605863
340,0.0381,11,290,11,43774,632670,1420,124836,5.011009377772146,0.16479869466380465
341,0.0382,20,245,20,44019,632425,1440,124816,5.009068875934609,0.16482995506054215
342,0.0383,12,285,12,44304,632140,1452,124804,5.006811557470536,0.16487877570863896
343,0.0384,13,294,13,44598,631846,1465,124791,5.004482955265492,0.16492849279112706
344,0.0385,4,280,4,44878,631566,1469,124787,5.002265238879737,0.16498513260342723
345,0.0386,15,294,15,45172,631272,1484,124772,4.9999366366746925,0.16503272296321378
346,0.0387,12,257,12,45429,631015,1496,124760,4.997901089849195,0.16507558466474812
347,0.0388,10,247,10,45676,630768,1506,124750,4.995944747180332,0.16511850147845583
348,0.0389,16,289,16,45965,630479,1522,124734,4.993655747053605,0.1651640000900408
349,0.039,13,280,13,46245,630199,1535,124721,4.991438030667849,0.16521088327239972
350,0.0391,7,284,7,46529,629915,1542,124714,4.98918863261944,0.16526531580418988
351,0.0392,11,262,11,46791,629653,1553,124703,4.987113483715626,0.16531054303273254
352,0.0393,10,281,10,47072,629372,1563,124693,4.984887846914206,0.16536107629978847
353,0.0394,12,275,12,47347,629097,1575,124681,4.982709732606767,0.16540811750939932
354,0.0395,13,310,13,47657,628787,1588,124668,4.9802544037511085,0.16546177276678767
355,0.0396,18,306,18,47963,628481,1606,124650,4.977830756558104,0.16550905486562098
356,0.0397,9,272,9,48235,628209,1615,124641,4.975676403497656,0.16555887627017335
357,0.0398,10,315,10,48550,627894,1625,124631,4.97318147256368,0.16561708913325138
358,0.0399,15,301,15,48851,627593,1640,124616,4.970797427448993,0.16566672294535162
359,0.04,12,301,12,49152,627292,1652,124604,4.968413382334305,0.1657197271963144
360,0.0401,13,279,13,49431,627013,1665,124591,4.966203586364212,0.16576681337512839
361,0.0402,14,322,14,49753,626691,1679,124577,4.963653212520593,0.16582231640373343
362,0.0403,13,309,13,50062,626382,1692,124564,4.961205804080598,0.16587610826877033
363,0.0404,16,305,16,50367,626077,1708,124548,4.958790077303257,0.16592572855953372
364,0.0405,20,276,20,50643,625801,1728,124528,4.956604042580155,0.16596453022607416
365,0.0406,12,289,12,50932,625512,1740,124516,4.954315042453428,0.16601513543494376
366,0.0407,16,286,16,51218,625226,1756,124500,4.952049803573692,0.1660606674971923
367,0.0408,13,276,13,51494,624950,1769,124487,4.949863768850589,0.1661073579233478
368,0.0409,14,304,14,51798,624646,1783,124473,4.947455962488911,0.16615918165204727
369,0.041,18,275,18,52073,624371,1801,124455,4.9452778481814725,0.16620015864833754
370,0.0411,14,278,14,52351,624093,1815,124441,4.943075972627043,0.16624628941370734
371,0.0412,9,316,9,52667,623777,1824,124432,4.940573121277405,0.1663064731913142
372,0.0413,15,306,15,52973,623471,1839,124417,4.9381494740844,0.1663577968893738
373,0.0414,6,324,6,53297,623147,1845,124411,4.935583259409454,0.16642320729629007
374,0.0415,21,297,21,53594,622850,1866,124390,4.93323089595742,0.16646592794818266
375,0.0416,13,295,13,53889,622555,1879,124377,4.930894373336713,0.16651716622128923
376,0.0417,11,286,11,54175,622269,1890,124366,4.928629134456976,0.1665686714391905
377,0.0418,13,292,13,54467,621977,1903,124353,4.926316373083259,0.1666193238915761
378,0.0419,14,277,14,54744,621700,1917,124339,4.924122417944494,0.16666554965625122
379,0.042,15,300,15,55044,621400,1932,124324,4.921746293245469,0.1667158358856628
380,0.0421,11,340,11,55384,621060,1943,124313,4.919053351919909,0.16677958552295294
381,0.0422,16,320,16,55704,620740,1959,124297,4.916518818907616,0.1668333250563395
382,0.0423,13,325,13,56029,620415,1972,124284,4.913944683817006,0.16689158975639823
383,0.0424,25,311,25,56340,620104,1997,124259,4.911481434545685,0.1669333376323111
384,0.0425,15,289,15,56629,619815,2012,124244,4.909192434418959,0.1669813818527832
385,0.0426,17,290,17,56919,619525,2029,124227,4.906895513876568,0.16702745001021846
386,0.0427,13,294,13,57213,619231,2042,124214,4.904566911671525,0.16707893657230866
387,0.0428,14,296,14,57509,618935,2056,124200,4.902222468635154,0.167129794721013
388,0.0429,12,262,12,57771,618673,2068,124188,4.90014731973134,0.16717528582063132
389,0.043,11,321,11,58092,618352,2079,124177,4.897604866303384,0.16723521909581981
390,0.0431,11,320,11,58412,618032,2090,124166,4.895070333291091,0.16729498058469572
391,0.0432,18,334,18,58746,617698,2108,124148,4.892424914459511,0.1673500969203851
392,0.0433,7,340,7,59086,617358,2115,124141,4.88973197313395,0.16741897156975263
393,0.0434,24,278,24,59364,617080,2139,124117,4.887530097579521,0.16745480621211364
394,0.0435,13,339,13,59703,616741,2152,124104,4.884845076669624,0.16751682200730247
395,0.0436,16,353,16,60056,616388,2168,124088,4.882049169940439,0.1675786926247441
396,0.0437,13,299,13,60355,616089,2181,124075,4.879680965657077,0.16763176809463848
397,0.0438,8,265,8,60620,615824,2189,124067,4.877582055506273,0.1676828073324314
398,0.0439,16,363,16,60983,615461,2205,124051,4.874706944620454,0.16774710890425037
399,0.044,14,343,14,61326,615118,2219,124037,4.871990242047903,0.16780918751817955
400,0.0441,15,323,15,61649,614795,2234,124022,4.86943194778862,0.16786565550061788
401,0.0442,20,299,20,61948,614496,2254,124002,4.867063743505259,0.16791108439020824
402,0.0443,17,319,17,62267,614177,2271,123985,4.86453713090863,0.16796448476079776
403,0.0444,12,305,12,62572,613872,2283,123973,4.862121404131289,0.16802038368492028
404,0.0445,11,306,11,62878,613566,2294,123962,4.859697756938284,0.16807768654207025
405,0.0446,12,348,12,63226,613218,2306,123950,4.856941452287416,0.16814348967942178
406,0.0447,13,343,13,63569,612875,2319,123937,4.854224749714865,0.16820708674668708
407,0.0448,18,335,18,63904,612540,2337,123919,4.8515714104676215,0.1682632705961907
408,0.0449,16,262,16,64166,612278,2353,123903,4.849496261563807,0.168305077148147
409,0.045,12,296,12,64462,611982,2365,123891,4.847151818527436,0.16835921415787777
410,0.0451,14,313,14,64775,611669,2379,123877,4.844672728424788,0.1684150277480946
411,0.0452,16,298,16,65073,611371,2395,123861,4.84231244455709,0.16846519193941503
412,0.0453,17,311,17,65384,611060,2412,123844,4.839849195285769,0.1685172485113702
413,0.0454,16,357,16,65741,610703,2428,123828,4.83702160689393,0.16858104014670586
414,0.0455,17,289,17,66030,610414,2445,123811,4.834732606767203,0.1686281453233001
415,0.0456,13,300,13,66330,610114,2458,123798,4.832356482068179,0.1686823488374628
416,0.0457,15,317,15,66647,609797,2473,123783,4.829845710302877,0.16873824259112843
417,0.0458,22,316,22,66963,609481,2495,123761,4.827342858953238,0.1687860215317726
418,0.0459,14,356,14,67319,609125,2509,123747,4.824523190977063,0.16885213243240293
419,0.046,15,314,15,67633,608811,2524,123732,4.822036180458751,0.16890749075480893
420,0.0461,17,336,17,67969,608475,2541,123715,4.819374920795843,0.16896570562285745
421,0.0462,17,356,17,68325,608119,2558,123698,4.816555252819668,0.16902859594680092
422,0.0463,12,313,12,68638,607806,2570,123686,4.814076162717019,0.1690872900865628
423,0.0464,15,343,15,68981,607463,2585,123671,4.811359460144469,0.16914956765791223
424,0.0465,18,341,18,69322,607122,2603,123653,4.808658598403245,0.16920803256816394
425,0.0466,16,323,16,69645,606799,2619,123637,4.806100304143961,0.16926465836842652
426,0.0467,16,294,16,69939,606505,2635,123621,4.803771701938918,0.16931461145062632
427,0.0468,16,325,16,70264,606180,2651,123605,4.801197566848308,0.16937180128393978
428,0.0469,21,315,21,70579,605865,2672,123584,4.798702635914333,0.16942102874909692
429,0.047,14,262,14,70841,605603,2686,123570,4.796627487010518,0.16946595663854805
430,0.0471,19,294,19,71135,605309,2705,123551,4.794298884805475,0.16951266361166753
431,0.0472,26,322,26,71457,604987,2731,123525,4.791748510961855,0.1695579482561715
432,0.0473,13,343,13,71800,604644,2744,123512,4.789031808389304,0.16962299287515312
433,0.0474,22,332,22,72132,604312,2766,123490,4.786402230389051,0.16967526882311398
434,0.0475,17,310,17,72442,604002,2783,123473,4.783946901533392,0.16972816935289872
435,0.0476,21,358,21,72800,603644,2804,123452,4.78111139272589,0.16978775842529734
436,0.0477,20,320,20,73120,603324,2824,123432,4.778576859713597,0.16983967108630682
437,0.0478,23,344,23,73464,602980,2847,123409,4.775852236725384,0.1698938172246551
438,0.0479,10,346,10,73810,602634,2857,123399,4.7731117729058425,0.16996334877340286
439,0.048,18,344,18,74154,602290,2875,123381,4.770387149917628,0.1700233301316988
440,0.0481,21,329,21,74483,601961,2896,123360,4.767781333164365,0.17007642133620837
441,0.0482,16,324,16,74807,601637,2912,123344,4.765215118489419,0.17013411385953564
442,0.0483,19,335,19,75142,601302,2931,123325,4.762561779242175,0.170191008615467
443,0.0484,22,335,22,75477,600967,2953,123303,4.7599084399949305,0.17024452207049856
444,0.0485,14,359,14,75836,600608,2967,123289,4.757065010771766,0.1703129036313177
445,0.0486,21,378,21,76214,600230,2988,123268,4.754071093650995,0.17037780339406605
446,0.0487,19,314,19,76528,599916,3007,123249,4.751584083132683,0.17042998485822738
447,0.0488,18,336,18,76864,599580,3025,123231,4.748922823469775,0.17048855094900325
448,0.0489,29,341,29,77205,599239,3054,123202,4.746221961728551,0.1705357254087185
449,0.049,16,367,16,77572,598872,3070,123186,4.743315169180079,0.17060402349949727
450,0.0491,22,326,22,77898,598546,3092,123164,4.740733113673806,0.17065580357761428
451,0.0492,17,324,17,78222,598222,3109,123147,4.73816689899886,0.17071290837282999
452,0.0493,12,355,12,78577,597867,3121,123135,4.735355151438347,0.1707831601021911
453,0.0494,12,362,12,78939,597505,3133,123123,4.732487960968192,0.17085514301414878
454,0.0495,15,374,15,79313,597131,3148,123108,4.729525725510075,0.170926595199649
455,0.0496,18,307,18,79620,596824,3166,123090,4.727094157901407,0.17097875579583116
456,0.0497,20,304,20,79924,596520,3186,123070,4.724686351539729,0.17102794646951736
457,0.0498,26,327,26,80251,596193,3212,123044,4.7220963756177925,0.17107573720484345
458,0.0499,17,342,17,80593,595851,3229,123027,4.719387593460905,0.17113752263944648
459,0.05,21,354,21,80947,595497,3250,123006,4.716583766316056,0.17119761504127332
460,0.0501,14,346,14,81293,595151,3264,122992,4.713843302496515,0.17126394046868104
461,0.0502,16,344,16,81637,594807,3280,122976,4.7111186795083,0.17132754606893727
462,0.0503,21,347,21,81984,594460,3301,122955,4.708370295273096,0.17138615724510917
463,0.0504,24,315,24,82299,594145,3325,122931,4.7058753643391205,0.17143371134998242
464,0.0505,15,375,15,82674,593770,3340,122916,4.70290520846534,0.1715060709990149
465,0.0506,23,323,23,82997,593447,3363,122893,4.700346914206057,0.17155680263561995
466,0.0507,33,399,33,83396,593048,3396,122860,4.6971866683563555,0.17161422976136598
467,0.0508,12,329,12,83725,592719,3408,122848,4.694580851603092,0.17167924177610203
468,0.0509,22,376,22,84101,592343,3430,122826,4.691602775313648,0.171744021343207
469,0.051,25,351,25,84452,591992,3455,122801,4.68882270941579,0.17179938807458942
470,0.0511,28,359,28,84811,591633,3483,122773,4.685979280192624,0.17185325991103098
471,0.0512,14,359,14,85170,591274,3497,122759,4.6831358509694585,0.17192342650829864
472,0.0513,19,337,19,85507,590937,3516,122740,4.680466670890889,0.17198256354064934
473,0.0514,22,393,22,85900,590544,3538,122718,4.677353947535167,0.17205178461771412
474,0.0515,25,357,25,86257,590187,3563,122693,4.674526359143328,0.17210891033554035
475,0.0516,20,374,20,86631,589813,3583,122673,4.671564123685211,0.17217601468660437
476,0.0517,25,365,25,86996,589448,3608,122648,4.668673171968065,0.17223520424212466
477,0.0518,21,355,21,87351,589093,3629,122627,4.665861424407553,0.1722966897094363
478,0.0519,16,343,16,87694,588750,3645,122611,4.6631447218350015,0.17236114996464524
479,0.052,18,378,18,88072,588372,3663,122593,4.660150804714231,0.1724318356037217
480,0.0521,21,346,21,88418,588026,3684,122572,4.65741034089469,0.17249133828127858
481,0.0522,13,345,13,88763,587681,3697,122559,4.6546777974908125,0.17255997972516332
482,0.0523,17,334,17,89097,587347,3714,122542,4.652032378659232,0.1726213534792059
483,0.0524,16,314,16,89411,587033,3730,122526,4.64954536814092,0.17267908658758468
484,0.0525,31,369,31,89780,586664,3761,122495,4.64662273476112,0.1727327721991824
485,0.0526,15,335,15,90115,586329,3776,122480,4.643969395513877,0.1727969029738618
486,0.0527,23,393,23,90508,585936,3799,122457,4.640856672158155,0.1728659091775328
487,0.0528,17,340,17,90848,585596,3816,122440,4.638163730832594,0.1729290601042885
488,0.0529,22,385,22,91233,585211,3838,122418,4.63511437080218,0.17299743227029984
489,0.053,21,342,21,91575,584869,3859,122397,4.632405588645292,0.17305653035774377
490,0.0531,27,406,27,91981,584463,3886,122370,4.629189899885946,0.17312434478865588
491,0.0532,19,367,19,92348,584096,3905,122351,4.626283107337473,0.1731920441306991
492,0.0533,20,332,20,92680,583764,3925,122331,4.623653529337219,0.17325005841990102
493,0.0534,20,346,20,93026,583418,3945,122311,4.620913065517678,0.1733115686049461
494,0.0535,24,339,24,93365,583079,3969,122287,4.618228044607781,0.17336673443290435
495,0.0536,26,368,26,93733,582711,3995,122261,4.6153133316436445,0.17342674602679256
496,0.0537,19,380,19,94113,582331,4014,122242,4.612303573691547,0.17349799098177193
497,0.0538,20,336,20,94449,581995,4034,122222,4.60964231402864,0.1735572983895589
498,0.0539,20,347,20,94796,581648,4054,122202,4.6068939297934355,0.1736193791290758
499,0.054,13,343,13,95139,581305,4067,122189,4.604177227220885,0.17368875925025656
500,0.0541,22,357,22,95496,580948,4089,122167,4.601349638829046,0.1737510933488832
501,0.0542,14,355,14,95851,580593,4103,122153,4.598537891268534,0.17382240525026113
502,0.0543,24,373,24,96224,580220,4127,122129,4.595583576226081,0.17388648663271394
503,0.0544,28,344,28,96568,579876,4155,122101,4.592858953237866,0.1739387472808938
504,0.0545,31,371,31,96939,579505,4186,122070,4.589920479026739,0.17399422727434702
505,0.0546,25,383,25,97322,579122,4211,122045,4.586886959827652,0.17405981741867488
506,0.0547,22,326,22,97648,578796,4233,122023,4.584304904321379,0.1741148570458278
507,0.0548,13,359,13,98007,578437,4246,122010,4.581461475098213,0.17418876802955827
508,0.0549,17,392,17,98399,578045,4263,121993,4.578356672158155,0.1742662541176336
509,0.055,29,345,29,98744,577700,4292,121964,4.575624128754277,0.17431795833428618
510,0.0551,23,355,23,99099,577345,4315,121941,4.572812381193765,0.1743792954527904
511,0.0552,24,361,24,99460,576984,4339,121917,4.569953111139273,0.17444101525108707
512,0.0553,28,337,28,99797,576647,4367,121889,4.567283931060702,0.1744920805799558
513,0.0554,20,390,20,100187,576257,4387,121869,4.564194968951971,0.17456590930577
514,0.0555,23,343,23,100530,575914,4410,121846,4.56147826637942,0.1746245127264389
515,0.0556,23,371,23,100901,575543,4433,121823,4.558539792168293,0.17469019137726818
516,0.0557,23,362,23,101263,575181,4456,121800,4.555672601698137,0.17475368769019528
517,0.0558,27,345,27,101608,574836,4483,121773,4.55294005829426,0.1748082496780834
518,0.0559,20,375,20,101983,574461,4503,121753,4.549969902420479,0.17487870108903297
519,0.056,21,340,21,102323,574121,4524,121732,4.547276961094918,0.17493924722606644
520,0.0561,27,384,27,102707,573737,4551,121705,4.544235521480167,0.17500381052625524
521,0.0562,27,353,27,103060,573384,4578,121678,4.541439614750982,0.17506064207221803
522,0.0563,25,372,25,103432,573012,4603,121653,4.5384932201241925,0.1751247003951545
523,0.0564,29,351,29,103783,572661,4632,121624,4.535713154226333,0.17517878104812865
524,0.0565,28,333,28,104116,572328,4660,121596,4.533075655810417,0.17522956404447748
525,0.0566,26,399,26,104515,571929,4686,121570,4.529915409960715,0.1752994596964091
526,0.0567,23,343,23,104858,571586,4709,121547,4.527198707388163,0.1753588416653081
527,0.0568,23,360,23,105218,571226,4732,121524,4.524347357749335,0.17542259112233852
528,0.0569,25,385,25,105603,570841,4757,121499,4.5212979977189205,0.17549036600514198
529,0.057,17,382,17,105985,570459,4774,121482,4.518272398935496,0.17556699198342055
530,0.0571,27,385,27,106370,570074,4801,121455,4.515223038905082,0.1756325475865799
531,0.0572,23,370,23,106740,569704,4824,121432,4.512292485109619,0.175699138809149
532,0.0573,33,355,33,107095,569349,4857,121399,4.509480737549106,0.17575005646053263
533,0.0574,29,414,29,107509,568935,4886,121370,4.506201685464453,0.1758208328202751
534,0.0575,28,351,28,107860,568584,4914,121342,4.503421619566595,0.17587683316761507
535,0.0576,27,395,27,108255,568189,4941,121315,4.500293055379546,0.1759453172135332
536,0.0577,28,405,28,108660,567784,4969,121287,4.497085287035864,0.1760152437121864
537,0.0578,18,374,18,109034,567410,4987,121269,4.494123051577747,0.17608929559344774
538,0.0579,28,349,28,109383,567061,5015,121241,4.491358826511215,0.17614506423052673
539,0.058,29,385,29,109768,566676,5044,121212,4.488309466480801,0.1762089177307934
540,0.0581,19,362,19,110130,566314,5063,121193,4.485442276010645,0.17627893243268797
541,0.0582,25,386,25,110516,565928,5088,121168,4.482384995564567,0.176347992129193
542,0.0583,30,386,30,110902,565542,5118,121138,4.479327715118489,0.17641113764781266
543,0.0584,18,387,18,111289,565155,5136,121120,4.4762625142567485,0.17648901679355944
544,0.0585,27,370,27,111659,564785,5163,121093,4.473331960461285,0.17655180658951009
545,0.0586,23,381,23,112040,564404,5186,121070,4.470314282093525,0.1766223080671185
546,0.0587,29,386,29,112426,564018,5215,121041,4.467257001647447,0.1766869714871274
547,0.0588,24,366,24,112792,563652,5239,121017,4.464358129514637,0.1767525621869838
548,0.0589,23,434,23,113226,563218,5262,120994,4.460920669116716,0.17683700373568426
549,0.059,26,400,26,113626,562818,5288,120968,4.45775250285135,0.17690914993872353
550,0.0591,22,375,22,114001,562443,5310,120946,4.454782346977569,0.17697972896842062
551,0.0592,27,396,27,114397,562047,5337,120919,4.451645862374858,0.17704980921451433
552,0.0593,31,377,31,114774,561670,5368,120888,4.44865986566975,0.17711022360004572
553,0.0594,22,356,22,115130,561314,5390,120866,4.445840197693575,0.1771761118766308
554,0.0595,32,353,32,115483,560961,5422,120834,4.44304429096439,0.17722922579367698
555,0.0596,19,375,19,115858,560586,5441,120815,4.44007413509061,0.17730381963043787
556,0.0597,12,377,12,116235,560209,5453,120803,4.437088138385502,0.17738747628529306
557,0.0598,22,378,22,116613,559831,5475,120781,4.434094221264732,0.17745940418329387
558,0.0599,26,386,26,116999,559445,5501,120755,4.431036940818654,0.17752866803881212
559,0.06,26,358,26,117357,559087,5527,120729,4.428201432011152,0.17759070101321534
560,0.0601,21,367,21,117724,558720,5548,120708,4.425294639462679,0.17766120913474276
561,0.0602,28,365,28,118089,558355,5576,120680,4.422403687745533,0.17772279779392816
562,0.0603,22,398,22,118487,557957,5598,120658,4.419251362311494,0.1778003728181664
563,0.0604,35,371,35,118858,557586,5633,120623,4.416312888100368,0.17785520392681312
564,0.0605,26,413,26,119271,557173,5659,120597,4.413041756431378,0.17793204184310313
565,0.0606,30,405,30,119676,556768,5689,120567,4.409833988087695,0.17800202263281834
566,0.0607,31,385,31,120061,556383,5720,120536,4.406784628057281,0.17806561789519867
567,0.0608,37,415,37,120476,555968,5757,120499,4.403497655556964,0.1781299013846943
568,0.0609,29,394,29,120870,555574,5786,120470,4.4003770117855785,0.17819846045523663
569,0.061,33,374,33,121244,555200,5819,120437,4.397414776327461,0.17825696342858666
570,0.0611,32,423,32,121667,554777,5851,120405,4.394064440501838,0.17832969480821467
571,0.0612,26,418,26,122085,554359,5877,120379,4.390753706754531,0.17840850819132759
572,0.0613,35,363,35,122448,553996,5912,120344,4.387878595868711,0.17846190349082067
573,0.0614,31,402,31,122850,553594,5943,120313,4.384694588772018,0.1785305687580037
574,0.0615,22,398,22,123248,553196,5965,120291,4.38154226333798,0.1786092381887104
575,0.0616,34,390,34,123638,552806,5999,120257,4.378453301229248,0.17867123879933974
576,0.0617,23,408,23,124046,552398,6022,120234,4.375221771638576,0.178751531297946
577,0.0618,33,412,33,124458,551986,6055,120201,4.371958560385249,0.17882077457612242
578,0.0619,21,355,21,124813,551631,6076,120180,4.369146812824737,0.1788895984138396
579,0.062,28,382,28,125195,551249,6104,120152,4.366121214041313,0.17895713589941034
580,0.0621,28,364,28,125559,550885,6132,120124,4.36323818273983,0.17901995353266498
581,0.0622,23,366,23,125925,550519,6155,120101,4.360339310607021,0.17908949926933285
582,0.0623,31,374,31,126299,550145,6186,120070,4.357377075148904,0.1791514663205091
583,0.0624,28,404,28,126703,549741,6214,120042,4.354177227220885,0.17922521174768544
584,0.0625,34,346,34,127049,549395,6248,120008,4.3514367634013436,0.17927616099718705
585,0.0626,31,417,31,127466,548978,6279,119977,4.3481339500697,0.17934988153164264
586,0.0627,30,435,30,127901,548543,6309,119947,4.344688569256115,0.17942975960747357
587,0.0628,22,387,22,128288,548156,6331,119925,4.341623368394373,0.1795066765856236
588,0.0629,17,399,17,128687,547757,6348,119908,4.338463122544671,0.17959305939355816
589,0.063,35,415,35,129102,547342,6383,119873,4.335176150044354,0.17966172822853202
590,0.0631,32,374,32,129476,546968,6415,119841,4.332213914586237,0.1797231291119346
591,0.0632,42,430,42,129906,546538,6457,119799,4.328808135850969,0.17978740487170905
592,0.0633,34,423,34,130329,546115,6491,119765,4.325457800025346,0.1798597344866943
593,0.0634,24,384,24,130713,545731,6515,119741,4.322416360410594,0.1799339416233891
594,0.0635,30,355,30,131068,545376,6545,119711,4.319604612850083,0.1799929933978562
595,0.0636,24,390,24,131458,544986,6569,119687,4.3165156507413505,0.18006899633353543
596,0.0637,26,386,26,131844,544600,6595,119661,4.313458370295273,0.18014154074979563
597,0.0638,30,371,30,132215,544229,6625,119631,4.310519896084147,0.18020516373934264
598,0.0639,25,398,25,132613,543831,6650,119606,4.307367570650108,0.18028237798012473
599,0.064,33,374,33,132987,543457,6683,119573,4.304405335191991,0.1803432725517699
600,0.0641,33,367,33,133354,543090,6716,119540,4.301498542643518,0.18040233614536016
601,0.0642,27,382,27,133736,542708,6743,119513,4.2984729438600935,0.18047298409443374
602,0.0643,31,419,31,134155,542289,6774,119482,4.295154289697123,0.18054886055750402
603,0.0644,33,383,33,134538,541906,6807,119449,4.292120770498036,0.1806125303354477
604,0.0645,27,423,27,134961,541483,6834,119422,4.288770434672411,0.1806946535432475
605,0.0646,23,438,23,135399,541045,6857,119399,4.285301292611837,0.18078595611437154
606,0.0647,34,376,34,135775,540669,6891,119365,4.282323216322393,0.1808467442586291
607,0.0648,43,376,43,136151,540293,6934,119322,4.279345140032949,0.18089643200958136
608,0.0649,23,372,23,136523,539921,6957,119299,4.2763987454061585,0.1809699341646188
609,0.065,33,400,33,136923,539521,6990,119266,4.273230579140793,0.18103878795422496
610,0.0651,21,399,21,137322,539122,7011,119245,4.270070333291091,0.1811223831085094
611,0.0652,29,393,29,137715,538729,7040,119216,4.266957609935369,0.18119447674197692
612,0.0653,25,396,25,138111,538333,7065,119191,4.263821125332657,0.18127247066266783
613,0.0654,30,391,30,138502,537942,7095,119161,4.260724242808263,0.1813429553662059
614,0.0655,26,409,26,138911,537533,7121,119135,4.257484792801926,0.1814234894954528
615,0.0656,27,402,27,139313,537131,7148,119108,4.254300785705234,0.18150094706349362
616,0.0657,33,368,33,139681,536763,7181,119075,4.251386072741098,0.18156160515249192
617,0.0658,29,373,29,140054,536390,7210,119046,4.248431757698644,0.18162871737286326
618,0.0659,25,388,25,140442,536002,7235,119021,4.24535863642124,0.18170506989830892
619,0.066,36,452,36,140894,535550,7271,118985,4.2417786085413764,0.18178554240796901
620,0.0661,24,362,24,141256,535188,7295,118961,4.23891141807122,0.18185612146468158
621,0.0662,33,358,33,141614,534830,7328,118928,4.236075909263718,0.18191440869557238
622,0.0663,26,389,26,142003,534441,7354,118902,4.23299486757065,0.18199016443124055
623,0.0664,24,384,24,142387,534057,7378,118878,4.229953427955899,0.18206712766201844
624,0.0665,29,399,29,142786,533658,7407,118849,4.226793182106197,0.18214210728773791
625,0.0666,23,427,23,143213,533231,7430,118826,4.223411164617919,0.18223253488575386
626,0.0667,30,406,30,143619,532825,7460,118796,4.220195475858573,0.18230842775171457
627,0.0668,32,397,32,144016,532428,7492,118764,4.217051070840197,0.1823793904102016
628,0.0669,25,392,25,144408,532036,7517,118739,4.213946267900139,0.18245783873074412
629,0.067,44,348,44,144756,531688,7561,118695,4.2111899632492715,0.18250015759944524
630,0.0671,19,375,19,145131,531313,7580,118676,4.2082198073754915,0.18258155138010027
631,0.0672,31,432,31,145563,530881,7611,118645,4.204798187808896,0.1826639734206175
632,0.0673,36,363,36,145926,530518,7647,118609,4.201923076923077,0.18272079269542016
633,0.0674,43,376,43,146302,530142,7690,118566,4.198945000633633,0.18277252631384228
634,0.0675,32,379,32,146681,529763,7722,118534,4.1959431630971995,0.18283903828029438
635,0.0676,27,387,27,147068,529376,7749,118507,4.192877962235458,0.1829141990143282
636,0.0677,28,396,28,147464,528980,7777,118479,4.189741477632746,0.18299073763744114
637,0.0678,37,435,37,147899,528545,7814,118442,4.186296096819161,0.18306704771502363
638,0.0679,31,425,31,148324,528120,7845,118411,4.18292992016221,0.18314821717752125
639,0.068,35,422,35,148746,527698,7880,118376,4.1795875047522495,0.1832235935821593
640,0.0681,35,416,35,149162,527282,7915,118341,4.176292611836269,0.1832973732348445
641,0.0682,29,418,29,149580,526864,7944,118312,4.1729818780889625,0.18337941894924795
642,0.0683,27,394,27,149974,526470,7971,118285,4.169861234317577,0.18345728222348023
643,0.0684,33,389,33,150363,526081,8004,118252,4.1667801926245085,0.18352622013772382
644,0.0685,39,374,39,150737,525707,8043,118213,4.163817957166392,0.1835833643930923
645,0.0686,29,397,29,151134,525310,8072,118184,4.160673552148017,0.18365983210410664
646,0.0687,28,384,28,151518,524926,8100,118156,4.157632112533266,0.18373395616733168
647,0.0688,34,390,34,151908,524536,8134,118122,4.1545431504245345,0.18380227119245385
648,0.0689,30,386,30,152294,524150,8164,118092,4.1514858699784565,0.18387461424198356
649,0.069,32,430,32,152724,523720,8196,118060,4.148080091243188,0.1839571192620524
650,0.0691,38,413,38,153137,523307,8234,118022,4.144808959574198,0.1840272309532237
651,0.0692,31,412,31,153549,522895,8265,117991,4.141545748320872,0.18410606566534454
652,0.0693,22,404,22,153953,522491,8287,117969,4.138345900392853,0.18419417293820067
653,0.0694,39,418,39,154371,522073,8326,117930,4.135035166645546,0.1842647612589316
654,0.0695,34,406,34,154777,521667,8360,117896,4.131819477886199,0.18433836854227026
655,0.0696,25,403,25,155180,521264,8385,117871,4.128627550373843,0.1844226963004686
656,0.0697,35,402,35,155582,520862,8420,117836,4.125443543277151,0.18449408014429355
657,0.0698,34,448,34,156030,520414,8454,117802,4.121895197059942,0.1845801421462326
658,0.0699,36,386,36,156416,520028,8490,117766,4.118837916613864,0.18464582608177563
659,0.07,28,378,28,156794,519650,8518,117738,4.1158439994930935,0.18471951150633523
660,0.0701,33,380,33,157174,519270,8551,117705,4.112834241540996,0.18478747203579418
661,0.0702,43,411,43,157585,518859,8594,117662,4.109578950703333,0.1848517173824587
662,0.0703,32,394,32,157979,518465,8626,117630,4.106458306931947,0.18492520771268442
663,0.0704,22,431,22,158410,518034,8648,117608,4.103044607781016,0.18502238681521987
664,0.0705,39,407,39,158817,517627,8687,117569,4.099820998606007,0.18509090107620324
665,0.0706,30,430,30,159247,517197,8717,117539,4.096415219870739,0.18517777469688185
666,0.0707,39,423,39,159670,516774,8756,117500,4.0930648840451145,0.18525116905312214
667,0.0708,35,418,35,160088,516356,8791,117465,4.089754150297807,0.18532834980223123
668,0.0709,34,414,34,160502,515942,8825,117431,4.086475098213154,0.18540575616579805
669,0.071,35,446,35,160948,515496,8860,117396,4.082942592827272,0.18549136345537628
670,0.0711,30,436,30,161384,515060,8890,117366,4.079489291598023,0.18558060547795316
671,0.0712,41,384,41,161768,514676,8931,117325,4.076447851983272,0.1856405290497958
672,0.0713,38,398,38,162166,514278,8969,117287,4.073295526549233,0.18570851772976654
673,0.0714,38,431,38,162597,513847,9007,117249,4.0698818273983015,0.18578631460189893
674,0.0715,38,397,38,162994,513450,9045,117211,4.066737422379926,0.18585420693526317
675,0.0716,30,376,30,163370,513074,9075,117181,4.063759346090483,0.1859263314055422
676,0.0717,26,369,26,163739,512705,9101,117155,4.0608367127106835,0.18600165116057538
677,0.0718,32,428,32,164167,512277,9133,117123,4.057446774806742,0.18608674928503335
678,0.0719,43,426,43,164593,511851,9176,117080,4.054072677734127,0.18615714601442765
679,0.072,32,435,32,165028,511416,9208,117048,4.050627296920543,0.1862445581608493
680,0.0721,35,408,35,165436,511008,9243,117013,4.04739576732987,0.18632020266838212
681,0.0722,34,449,34,165885,510559,9277,116979,4.043839500696997,0.18640942859237208
682,0.0723,37,383,37,166268,510176,9314,116942,4.040805981497909,0.1864752725962259
683,0.0724,30,431,30,166699,509745,9344,116912,4.0373922823469774,0.18656457998554232
684,0.0725,31,394,31,167093,509351,9375,116881,4.034271638575593,0.18664169189693278
685,0.0726,32,381,32,167474,508970,9407,116849,4.031253960207832,0.18671373032777847
686,0.0727,42,409,42,167883,508561,9449,116807,4.028014510201495,0.18678122321577056
687,0.0728,33,372,33,168255,508189,9482,116774,4.0250681155747055,0.1868494614881201
688,0.0729,36,434,36,168689,507755,9518,116738,4.021630655176784,0.18693243959499947
689,0.073,27,443,27,169132,507312,9545,116711,4.018121911037891,0.18702996524166576
690,0.0731,31,419,31,169551,506893,9576,116680,4.014803256874921,0.18711522147366869
691,0.0732,34,396,34,169947,506497,9610,116646,4.011666772272209,0.18718977826919342
692,0.0733,25,416,25,170363,506081,9635,116621,4.008371879356228,0.18728219918998174
693,0.0734,39,407,39,170770,505674,9674,116582,4.005148270181219,0.18735375793885475
694,0.0735,37,409,37,171179,505265,9711,116545,4.001908820174883,0.18742863575690324
695,0.0736,26,435,26,171614,504830,9737,116519,3.9984634393612977,0.18752585101126742
696,0.0737,39,413,39,172027,504417,9776,116480,3.9951923076923075,0.1875995535491394
697,0.0738,41,407,41,172434,504010,9817,116439,3.991968698517298,0.18766893008127986
698,0.0739,39,395,39,172829,503615,9856,116400,3.9888401343302498,0.18773739345015847
699,0.074,35,437,35,173266,503178,9891,116365,3.985378912685338,0.18782392828262123
700,0.0741,33,401,33,173667,502777,9924,116332,3.9822028260043085,0.1879022918419858
701,0.0742,40,448,40,174115,502329,9964,116292,3.978654479787099,0.18798585886997046
702,0.0743,29,411,29,174526,501918,9993,116263,3.975399188949436,0.18807274891981474
703,0.0744,38,417,38,174943,501501,10031,116225,3.9720963756177925,0.18814976219229884
704,0.0745,39,417,39,175360,501084,10070,116186,3.968793562286149,0.1882255738979701
705,0.0746,28,408,28,175768,500676,10098,116158,3.965562032695476,0.1883132252761683
706,0.0747,37,428,37,176196,500248,10135,116121,3.962172094791535,0.1883952632270604
707,0.0748,29,383,29,176579,499865,10164,116092,3.9591385755924473,0.18847419543896732
708,0.0749,34,409,34,176988,499456,10198,116058,3.955899125586111,0.18855460639400565
709,0.075,36,418,36,177406,499038,10234,116022,3.9525883918388036,0.1886352550970637
710,0.0751,39,437,39,177843,498601,10273,115983,3.9491271701938917,0.18871789698397615
711,0.0752,31,408,31,178251,498193,10304,115952,3.945895640603219,0.18880231867067224
712,0.0753,29,402,29,178653,497791,10333,115923,3.9427116335065264,0.18888765776892819
713,0.0754,34,399,34,179052,497392,10367,115889,3.939551387656824,0.18896558021526838
714,0.0755,34,404,34,179456,496988,10401,115855,3.936351539728805,0.18904515512129533
715,0.0756,36,395,36,179851,496593,10437,115819,3.9332229755417565,0.18911941634063342
716,0.0757,35,363,35,180214,496230,10472,115784,3.9303478646559373,0.1891852147173104
717,0.0758,43,396,43,180610,495834,10515,115741,3.927211380053225,0.18925070514654785
718,0.0759,25,446,25,181056,495388,10540,115716,3.9236788746673423,0.18935565795674714
719,0.076,29,334,29,181390,495054,10569,115687,3.9210334558357625,0.18942072007610428
720,0.0761,42,432,42,181822,494622,10611,115645,3.917611836269167,0.18949902255897827
721,0.0762,46,427,46,182249,494195,10657,115599,3.9142298187808895,0.18957057629297763
722,0.0763,35,439,35,182688,493756,10692,115564,3.910752756304651,0.18966060526488546
723,0.0764,48,417,48,183105,493339,10740,115516,3.9074499429730074,0.1897266179960746
724,0.0765,34,411,34,183516,492928,10774,115482,3.904194652135344,0.18980950345983794
725,0.0766,24,402,24,183918,492526,10798,115458,3.9010106450386517,0.18990302376378326
726,0.0767,38,422,38,184340,492104,10836,115420,3.897668229628691,0.1899842639961549
727,0.0768,31,376,31,184716,491728,10867,115389,3.8946901533392473,0.19006056493229476
728,0.0769,28,424,28,185140,491304,10895,115361,3.8913318970979596,0.19015601691213438
729,0.077,40,417,40,185557,490887,10935,115321,3.888029083766316,0.19023338524070946
730,0.0771,36,424,36,185981,490463,10971,115285,3.8846708275250283,0.19031841623909612
731,0.0772,32,392,32,186373,490071,11003,115253,3.8815660245849704,0.1903988607753864
732,0.0773,34,408,34,186781,489663,11037,115219,3.8783344949942973,0.1904817799174054
733,0.0774,27,449,27,187230,489214,11064,115192,3.8747782283614245,0.1905871219015033
734,0.0775,40,422,40,187652,488792,11104,115152,3.871435812951464,0.19066668432834832
735,0.0776,32,421,32,188073,488371,11136,115120,3.8681013179571666,0.1907567801342522
736,0.0777,34,422,34,188495,487949,11170,115086,3.8647589025472056,0.19084464417488206
737,0.0778,33,423,33,188918,487526,11203,115053,3.8614085667215816,0.19093430073069256
738,0.0779,34,419,34,189337,487107,11237,115019,3.858089912558611,0.191021480553904
739,0.078,43,423,43,189760,486684,11280,114976,3.854739576732987,0.19109796230429146
740,0.0781,35,376,35,190136,486308,11315,114941,3.8517615004435433,0.19117038032495687
741,0.0782,39,442,39,190578,485866,11354,114902,3.8482606767203142,0.19125852242462982
742,0.0783,34,408,34,190986,485458,11388,114868,3.845029147129641,0.1913427037976033
743,0.0784,39,422,39,191408,485036,11427,114829,3.8416867317196806,0.191424737232544
744,0.0785,31,380,31,191788,484656,11458,114798,3.8386769737675834,0.19150426888468505
745,0.0786,35,363,35,192151,484293,11493,114763,3.835801862881764,0.19157307497128817
746,0.0787,33,424,33,192575,483869,11526,114730,3.8324436066404766,0.19166420257969025
747,0.0788,46,442,46,193017,483427,11572,114684,3.8289427829172475,0.1917436729971527
748,0.0789,57,429,57,193446,482998,11629,114627,3.8255449245976427,0.19180422505751935
749,0.079,39,437,39,193883,482561,11668,114588,3.822083702952731,0.19189180589769053
750,0.0791,27,391,27,194274,482170,11695,114561,3.818986820428336,0.19198097635282899
751,0.0792,39,396,39,194670,481774,11734,114522,3.815850335825624,0.19205562338167623
752,0.0793,45,402,45,195072,481372,11779,114477,3.8126663287289317,0.19212417911249327
753,0.0794,34,410,34,195482,480962,11813,114443,3.809418958306932,0.19221034421948086
754,0.0795,47,424,47,195906,480538,11860,114396,3.8060607020656443,0.19228351380153091
755,0.0796,23,426,23,196332,480112,11883,114373,3.80268660499303,0.19239005189365585
756,0.0797,34,428,34,196760,479684,11917,114339,3.799296667089089,0.19248244596589695
757,0.0798,30,409,30,197169,479275,11947,114309,3.7960572170827525,0.1925742607617456
758,0.0799,31,439,31,197608,478836,11978,114278,3.792580154606514,0.19267459544033694
759,0.08,32,407,32,198015,478429,12010,114246,3.789356545431504,0.19276331885097228
760,0.0801,33,415,33,198430,478014,12043,114213,3.7860695729311873,0.19285341600433617
761,0.0802,46,381,46,198811,477633,12089,114167,3.783051894563427,0.19291483609327476
762,0.0803,29,401,29,199212,477232,12118,114138,3.7798758078823975,0.19300607064950875
763,0.0804,33,417,33,199629,476815,12151,114105,3.776572994550754,0.19309720435930414
764,0.0805,31,380,31,200009,476435,12182,114074,3.773563236598657,0.19317910480619263
765,0.0806,31,397,31,200406,476038,12213,114043,3.7704188315802813,0.19326668711583664
766,0.0807,38,412,38,200818,475626,12251,114005,3.767155620326955,0.1933497390740989
767,0.0808,27,384,27,201202,475242,12278,113978,3.7641141807122036,0.1934387834764604
768,0.0809,31,435,31,201637,474807,12309,113947,3.760668799898619,0.19353923710072457
769,0.081,40,420,40,202057,474387,12349,113907,3.757342225319985,0.19362257646686862
770,0.0811,20,374,20,202431,474013,12369,113887,3.754379989861868,0.19371831944208198
771,0.0812,33,414,33,202845,473599,12402,113854,3.7511009377772147,0.19380954731697686
772,0.0813,29,443,29,203288,473156,12431,113825,3.7475921936383223,0.19391598705920635
773,0.0814,37,389,37,203677,472767,12468,113788,3.7445111519452543,0.19399374312724296
774,0.0815,45,396,45,204073,472371,12513,113743,3.741374667342542,0.19406292973721836
775,0.0816,34,418,34,204491,471953,12547,113709,3.7380639335952353,0.19415464892719692
776,0.0817,39,416,39,204907,471537,12586,113670,3.7347690406792546,0.19423896159820372
777,0.0818,34,433,34,205340,471104,12620,113636,3.7313395006969965,0.19433594418031946
778,0.0819,33,417,33,205757,470687,12653,113603,3.728036687365353,0.19442913621660476
779,0.082,46,384,46,206141,470303,12699,113557,3.724995247750602,0.1944935429726304
780,0.0821,42,422,42,206563,469881,12741,113515,3.721652832340641,0.19457623980966615
781,0.0822,28,361,28,206924,469520,12769,113487,3.718793562286149,0.19465804012644788
782,0.0823,47,362,47,207286,469158,12816,113440,3.7159263718159927,0.19471402236190305
783,0.0824,46,417,46,207703,468741,12862,113394,3.712623558484349,0.1947898683295112
784,0.0825,34,446,34,208149,468295,12896,113360,3.7090910530984664,0.19489216116082558
785,0.0826,45,431,45,208580,467864,12941,113315,3.705677353947535,0.1949743538565571
786,0.0827,35,452,35,209032,467412,12976,113280,3.702097326067672,0.19507759707383604
787,0.0828,38,428,38,209460,466984,13014,113242,3.6987073881637307,0.19516877906195174
788,0.0829,40,457,40,209917,466527,13054,113202,3.695087758205551,0.19526709893760705
789,0.083,45,352,45,210269,466175,13099,113157,3.6922997718920287,0.19532323434576374
790,0.0831,42,426,42,210695,465749,13141,113115,3.6889256748194144,0.19540859338290167
791,0.0832,40,404,40,211099,465345,13181,113075,3.685725826891395,0.19548943674146813
792,0.0833,29,423,29,211522,464922,13210,113046,3.682375491065771,0.19559214350967527
793,0.0834,53,431,53,211953,464491,13263,112993,3.6789617919148396,0.19566429546099978
794,0.0835,36,380,36,212333,464111,13299,112957,3.6759520339627425,0.1957429627011028
795,0.0836,33,392,33,212725,463719,13332,112924,3.672847231022684,0.19583000227176953
796,0.0837,28,433,28,213158,463286,13360,112896,3.669417691040426,0.19593808900659862
797,0.0838,44,404,44,213562,462882,13404,112852,3.6662178431124066,0.1960141315260172
798,0.0839,31,438,31,214000,462444,13435,112821,3.6627487010518314,0.19612004902088603
799,0.084,29,416,29,214416,462028,13464,112792,3.6594538081358507,0.19622142583765353
800,0.0841,37,406,37,214822,461622,13501,112755,3.656238119376505,0.1963083480013998
801,0.0842,30,398,30,215220,461224,13531,112725,3.653085793942466,0.1964024678150846
802,0.0843,54,437,54,215657,460787,13585,112671,3.649624572297554,0.19647646383867695
803,0.0844,40,412,40,216069,460375,13625,112631,3.6463613610442276,0.19656164158839523
804,0.0845,35,417,35,216486,459958,13660,112596,3.643058547712584,0.19665568662519167
805,0.0846,50,410,50,216896,459548,13710,112546,3.6398111772905843,0.19672641209311756
806,0.0847,43,403,43,217299,459145,13753,112503,3.6366192497782284,0.19680467700403045
807,0.0848,44,406,44,217705,458739,13797,112459,3.6334035610188824,0.1968826921662891
808,0.0849,38,450,38,218155,458289,13835,112421,3.629839373970346,0.19698445795587952
809,0.085,54,427,54,218582,457862,13889,112367,3.626457356482068,0.1970559196393028
810,0.0851,45,389,45,218971,457473,13934,112322,3.623376314789,0.19712703691678587
811,0.0852,46,393,46,219364,457080,13980,112276,3.6202635914332784,0.1971982380092596
812,0.0853,36,403,36,219767,456677,14016,112240,3.6170716639209224,0.19728712624161346
813,0.0854,38,394,38,220161,456283,14054,112202,3.6139510201495373,0.19737020325954072
814,0.0855,35,429,35,220590,455854,14089,112167,3.610553161829933,0.1974698118555476
815,0.0856,44,440,44,221030,455414,14133,112123,3.6070681789380306,0.1975606876732266
816,0.0857,32,395,32,221425,455019,14165,112091,3.603939614750982,0.19765301264304985
817,0.0858,40,444,40,221869,454575,14205,112051,3.6004229501964264,0.19775125038385108
818,0.0859,39,396,39,222265,454179,14244,112012,3.5972864655937142,0.1978342997327757
819,0.086,54,422,54,222687,453757,14298,111958,3.5939440501837536,0.1979053056751191
820,0.0861,43,393,43,223080,453364,14341,111915,3.590831326828032,0.1979818815133766
821,0.0862,41,371,41,223451,452993,14382,111874,3.587892852616905,0.19805370113672777
822,0.0863,42,399,42,223850,452594,14424,111832,3.584732606767203,0.19813403351369355
823,0.0864,54,448,54,224298,452146,14478,111778,3.5811842605499935,0.19821465303835267
824,0.0865,49,457,49,224755,451689,14527,111729,3.5775646305918136,0.19830569843348989
825,0.0866,30,432,30,225187,451257,14557,111699,3.574143011025219,0.1984151514505574
826,0.0867,39,422,39,225609,450835,14596,111660,3.5708005956152578,0.198508431186055
827,0.0868,46,413,46,226022,450422,14642,111614,3.567529463946268,0.1985887025030425
828,0.0869,43,442,43,226464,449980,14685,111571,3.564028640223039,0.19868364583092185
829,0.087,37,405,37,226869,449575,14722,111534,3.5608208718793564,0.1987742132099111
830,0.0871,46,386,46,227255,449189,14768,111488,3.5577635914332784,0.19884532449164136
831,0.0872,42,452,42,227707,448737,14810,111446,3.554183563553415,0.19894570167248918
832,0.0873,41,443,41,228150,448294,14851,111405,3.550674819414523,0.19904448641144615
833,0.0874,54,416,54,228566,447878,14905,111351,3.5473799264985426,0.19911521040575506
834,0.0875,48,423,48,228989,447455,14953,111303,3.5440295906729187,0.19919714796029767
835,0.0876,38,405,38,229394,447050,14991,111265,3.540821822329236,0.19928714077178653
836,0.0877,43,415,43,229809,446635,15034,111222,3.537534849828919,0.19937367461553768
837,0.0878,38,415,38,230224,446220,15072,111184,3.5342478773286023,0.19946753162876477
838,0.0879,38,365,38,230589,445855,15110,111146,3.531356925611456,0.19954362739025602
839,0.088,37,388,37,230977,445467,15147,111109,3.5282838043340514,0.19962952049675156
840,0.0881,50,457,50,231434,445010,15197,111059,3.524664174375871,0.1997216172813086
841,0.0882,48,405,48,231839,444605,15245,111011,3.5214564060321885,0.19979806197085756
842,0.0883,46,393,46,232232,444212,15291,110965,3.5183436826764667,0.19987319359411504
843,0.0884,34,452,34,232684,443760,15325,110931,3.514763654796604,0.19998701980021308
844,0.0885,59,424,59,233108,443336,15384,110872,3.511405398555316,0.20005485305156187
845,0.0886,40,414,40,233522,442922,15424,110832,3.5081263464706627,0.20014663550963063
846,0.0887,35,402,35,233924,442520,15459,110797,3.5049423393739705,0.200241452910357
847,0.0888,42,421,42,234345,442099,15501,110755,3.501607844379673,0.20033318018862123
848,0.0889,37,355,37,234700,441744,15538,110718,3.498796096819161,0.20040835387773276
849,0.089,50,425,50,235125,441319,15588,110668,3.49542992016221,0.20049022893655105
850,0.0891,53,412,53,235537,440907,15641,110615,3.4921667089088837,0.20056316883098044
851,0.0892,49,410,49,235947,440497,15690,110566,3.488919338486884,0.20064130598497812
852,0.0893,44,397,44,236344,440100,15734,110522,3.4857749334685084,0.20072209246997033
853,0.0894,31,403,31,236747,439697,15765,110491,3.4825830059561524,0.20082408195016976
854,0.0895,32,402,32,237149,439295,15797,110459,3.4793989988594602,0.2009244134649316
855,0.0896,35,402,35,237551,438893,15832,110424,3.4762149917627676,0.20102054005246514
856,0.0897,41,416,41,237967,438477,15873,110383,3.4729200988467874,0.20111321648507816
857,0.0898,54,423,54,238390,438054,15927,110329,3.4695697630211635,0.2011896794758408
858,0.0899,47,421,47,238811,437633,15974,110282,3.466235268026866,0.20127574532546105
859,0.09,32,408,32,239219,437225,16006,110250,3.463003738436193,0.20137905840449336
860,0.0901,44,420,44,239639,436805,16050,110206,3.459677163857559,0.20146944028547872
861,0.0902,41,427,41,240066,436378,16091,110165,3.4562951463692815,0.2015669398382195
862,0.0903,44,388,44,240454,435990,16135,110121,3.453222025091877,0.20164581925652478
863,0.0904,46,373,46,240827,435617,16181,110075,3.4502677100494235,0.20171635281440814
864,0.0905,39,411,39,241238,435206,16220,110036,3.4470124192117604,0.20181130580549553
865,0.0906,27,443,27,241681,434763,16247,110009,3.443503675072868,0.201935855734142
866,0.0907,34,398,34,242079,434365,16281,109975,3.440351349638829,0.20203365543594076
867,0.0908,43,434,43,242513,433931,16324,109932,3.4369138892409072,0.20213178686544223
868,0.0909,40,453,40,242966,433478,16364,109892,3.4333259409453807,0.2022415665200508
869,0.091,42,365,42,243331,433113,16406,109850,3.430434989228235,0.20231581157463768
870,0.0911,37,399,37,243730,432714,16443,109813,3.4272747433785327,0.2024102026258601
871,0.0912,28,392,28,244122,432322,16471,109785,3.4241699404384742,0.2025153705818224
872,0.0913,44,411,44,244533,431911,16515,109741,3.420914649600811,0.20260425513060046
873,0.0914,42,465,42,244998,431446,16557,109699,3.4172316563173237,0.20271646231601512
874,0.0915,39,417,39,245415,431029,16596,109660,3.41392884298568,0.20281529677873972
875,0.0916,49,387,49,245802,430642,16645,109611,3.4108636421239384,0.2028882764186409
876,0.0917,46,402,46,246204,430240,16691,109565,3.4076796350272462,0.20297144339159512
877,0.0918,42,414,42,246618,429826,16733,109523,3.4044005829425927,0.2030651767223078
878,0.0919,53,396,53,247014,429430,16786,109470,3.401264098339881,0.20313601781406568
879,0.092,45,385,45,247399,429045,16831,109425,3.3982147383094663,0.20321466376956934
880,0.0921,35,390,35,247789,428655,16866,109390,3.395125776200735,0.20331013205215176
881,0.0922,42,391,42,248180,428264,16908,109348,3.3920288936763403,0.20339575753517405
882,0.0923,42,416,42,248596,427848,16950,109306,3.3887340007603597,0.20349099141028457
883,0.0924,44,377,44,248973,427471,16994,109262,3.385748004055253,0.20356862723178937
884,0.0925,53,375,53,249348,427096,17047,109209,3.3827778481814725,0.20363226149299374
885,0.0926,45,412,45,249760,426684,17092,109164,3.379514636928146,0.20372195100103013
886,0.0927,49,402,49,250162,426282,17141,109115,3.3763306298314535,0.20380203848732809
887,0.0928,36,412,36,250574,425870,17177,109079,3.373067418578127,0.2039054190212525
888,0.0929,47,410,47,250984,425460,17224,109032,3.3698200481561273,0.203991827754204
889,0.093,57,438,57,251422,425022,17281,108975,3.366350906095552,0.20407418019202356
890,0.0931,57,414,57,251836,424608,17338,108918,3.3630718540108986,0.20414750171500545
891,0.0932,39,371,39,252207,424237,17377,108879,3.360133379799772,0.2042313492748295
892,0.0933,47,406,47,252613,423831,17424,108832,3.356917691040426,0.20431680067885324
893,0.0934,42,410,42,253023,423421,17466,108790,3.353670320618426,0.20441140825725135
894,0.0935,51,393,51,253416,423028,17517,108739,3.3505575972627044,0.20448617533619048
895,0.0936,33,417,33,253833,422611,17550,108706,3.347254783931061,0.20459725549907118
896,0.0937,42,404,42,254237,422207,17592,108664,3.3440549360030416,0.20469002827428887
897,0.0938,41,404,41,254641,421803,17633,108623,3.3408550880750223,0.20478445626722672
898,0.0939,38,433,38,255074,421370,17671,108585,3.3374255480927637,0.20489475521506542
899,0.094,52,398,52,255472,420972,17723,108533,3.3342732226587253,0.20497068016354897
900,0.0941,40,391,40,255863,420581,17763,108493,3.33117634013433,0.20506205181127782
901,0.0942,49,430,49,256293,420151,17812,108444,3.327770561399062,0.20515517551244336
902,0.0943,42,364,42,256657,419787,17854,108402,3.3248875300975795,0.2052333539698858
903,0.0944,41,416,41,257073,419371,17895,108361,3.3215926371815994,0.20533338891710187
904,0.0945,34,420,34,257493,418951,17929,108327,3.3182660626029654,0.20544570416364802
905,0.0946,41,359,41,257852,418592,17970,108286,3.3154226333797996,0.20552385941337464
906,0.0947,40,432,40,258284,418160,18010,108246,3.3120010138132048,0.20563215464869322
907,0.0948,43,436,43,258720,417724,18053,108203,3.308547712583956,0.2057376784230511
908,0.0949,45,393,45,259113,417331,18098,108158,3.305434989228235,0.20582352818041863
909,0.095,52,401,52,259514,416930,18150,108106,3.3022589025472056,0.20590207147700348
910,0.0951,44,416,44,259930,416514,18194,108062,3.2989640096312254,0.2059987494662356
911,0.0952,43,414,43,260344,416100,18237,108019,3.295684957546572,0.20609632545280748
912,0.0953,55,371,55,260715,415729,18292,107964,3.2927464833354456,0.20615895190502834
913,0.0954,47,400,47,261115,415329,18339,107917,3.2895783170700796,0.2062452460219476
914,0.0955,41,384,41,261499,414945,18380,107876,3.2865368774553287,0.20633448159121381
915,0.0956,44,397,44,261896,414548,18424,107832,3.2833924724369536,0.2064244419771048
916,0.0957,39,424,39,262320,414124,18463,107793,3.280034216195666,0.2065328395127961
917,0.0958,40,382,40,262702,413742,18503,107753,3.2770086174122417,0.2066232658031237
918,0.0959,50,391,50,263093,413351,18553,107703,3.273911734887847,0.20670218441850557
919,0.096,51,394,51,263487,412957,18604,107652,3.270791091116462,0.20678090467126
920,0.0961,52,397,52,263884,412560,18656,107600,3.2676466860980864,0.2068594278683482
921,0.0962,51,406,51,264290,412154,18707,107549,3.2644309973387404,0.2069431964025607
922,0.0963,45,418,45,264708,411736,18752,107504,3.261120263591433,0.20704106001078498
923,0.0964,50,406,50,265114,411330,18802,107454,3.257904574832087,0.20712666543301259
924,0.0965,38,409,38,265523,410921,18840,107416,3.2546651248257508,0.20723197456481016
925,0.0966,37,409,37,265932,410512,18877,107379,3.2514256748194144,0.207338996043569
926,0.0967,57,393,57,266325,410119,18934,107322,3.248312951463693,0.2074091538938739
927,0.0968,46,388,46,266713,409731,18980,107276,3.2452398301862884,0.20749428924560015
928,0.0969,47,370,47,267083,409361,19027,107229,3.242309276390825,0.20757080082851004
929,0.097,59,402,59,267485,408959,19086,107170,3.2391252692941324,0.207641887977618
930,0.0971,44,375,44,267860,408584,19130,107126,3.2361551134203523,0.2077252719551686
931,0.0972,52,377,52,268237,408207,19182,107074,3.233169116715245,0.20779729894950522
932,0.0973,44,427,44,268664,407780,19226,107030,3.2297870992269675,0.2079019444066743
933,0.0974,40,373,40,269037,407407,19266,106990,3.226832784184514,0.20799110414718594
934,0.0975,50,392,50,269429,407015,19316,106940,3.2237279812444557,0.20807269118891733
935,0.0976,48,409,48,269838,406606,19364,106892,3.2204885312381193,0.20816439401906142
936,0.0977,40,392,40,270230,406214,19404,106852,3.2173837282980613,0.2082617051217582
937,0.0978,44,394,44,270624,405820,19448,106808,3.2142630845266758,0.20835381602253486
938,0.0979,41,393,41,271017,405427,19489,106767,3.2111503611709544,0.2084503137483063
939,0.098,45,398,45,271415,405029,19534,106722,3.2079980357369156,0.20854282649178996
940,0.0981,47,375,47,271790,404654,19581,106675,3.205027879863135,0.2086230196214179
941,0.0982,39,381,39,272171,404273,19620,106636,3.2020102014953746,0.20871818660465954
942,0.0983,35,414,35,272585,403859,19655,106601,3.198731149410721,0.20883320926223406
943,0.0984,52,426,52,273011,403433,19707,106549,3.1953570523381067,0.2089269817366103
944,0.0985,46,376,46,273387,403057,19753,106503,3.192378976048663,0.2090097338880603
945,0.0986,43,382,43,273769,402675,19796,106460,3.1893533772652387,0.2090997476111444
946,0.0987,39,399,39,274168,402276,19835,106421,3.1861931314155365,0.20920312091480783
947,0.0988,38,416,38,274584,401860,19873,106383,3.1828982384995563,0.20931522913252126
948,0.0989,37,406,37,274990,401454,19910,106346,3.1796825497402104,0.20942497046081135
949,0.099,43,405,43,275395,401049,19953,106303,3.1764747813965277,0.20952514230751038
950,0.0991,52,373,52,275768,400676,20005,106251,3.1735204663540744,0.2095982261745774
951,0.0992,44,406,44,276174,400270,20049,106207,3.170304777594728,0.20969757758002833
952,0.0993,42,405,42,276579,399865,20091,106165,3.1670970092510453,0.20979981424026242
953,0.0994,42,351,42,276930,399514,20133,106123,3.164316943353187,0.2098798149660725
954,0.0995,60,367,60,277297,399147,20193,106063,3.161410150804714,0.2099384414401932
955,0.0996,47,371,47,277668,398776,20240,106016,3.158471676593588,0.21001917621515395
956,0.0997,34,405,34,278073,398371,20274,105982,3.1552639082499048,0.21013456844709955
957,0.0998,30,382,30,278455,397989,20304,105952,3.152238309466481,0.21024683445085834
958,0.0999,55,446,55,278901,397543,20359,105897,3.148705804080598,0.21034681392022883
959,0.1,44,435,44,279336,397108,20403,105853,3.145260423267013,0.21045965790588136
960,0.1001,42,382,42,279718,396726,20445,105811,3.1422348244835887,0.21055365077596278
961,0.1002,46,397,46,280115,396329,20491,105765,3.1390904194652136,0.21064780698434954
962,0.1003,56,397,56,280512,395932,20547,105709,3.135946014446838,0.2107263959684316
963,0.1004,49,374,49,280886,395558,20596,105660,3.1329837789887214,0.2108064754258626
964,0.1005,40,348,40,281234,395210,20636,105620,3.130227474337853,0.21088992272827106
965,0.1006,40,411,40,281645,394799,20676,105580,3.12697218350019,0.2110000619530396
966,0.1007,57,385,57,282030,394414,20733,105523,3.123922823469776,0.21107259514698853
967,0.1008,38,384,38,282414,394030,20771,105485,3.120881383855025,0.21117483959440658
968,0.1009,37,388,37,282802,393642,20808,105448,3.1178082625776202,0.21128053056562945
969,0.101,39,370,39,283172,393272,20847,105409,3.114877708782157,0.21137560885616255
970,0.1011,45,345,45,283517,392927,20892,105364,3.112145165378279,0.21145073862461894
971,0.1012,48,373,48,283890,392554,20940,105316,3.1091908503358257,0.21153313113865066
972,0.1013,49,399,49,284289,392155,20989,105267,3.1060306044861234,0.211625139217807
973,0.1014,53,366,53,284655,391789,21042,105214,3.103131732353314,0.2116969112862498
974,0.1015,42,387,42,285042,391402,21084,105172,3.1000665314915725,0.21179522085328673
975,0.1016,35,379,35,285421,391023,21119,105137,3.0970646939551387,0.21190140277329894
976,0.1017,34,390,34,285811,390633,21153,105103,3.0939757318464074,0.2120140558684461
977,0.1018,45,363,45,286174,390270,21198,105058,3.091100620960588,0.21209784223787068
978,0.1019,55,385,55,286559,389885,21253,105003,3.0880512609301736,0.21217528006336786
979,0.102,31,380,31,286939,389505,21284,104972,3.0850415029780764,0.21228894367179868
980,0.1021,38,400,38,287339,389105,21322,104934,3.0818733367127105,0.21240023560892965
981,0.1022,48,380,48,287719,388725,21370,104886,3.0788635787606133,0.21248716094252357
982,0.1023,34,370,34,288089,388355,21404,104852,3.07593302496515,0.21259227869839642
983,0.1024,42,393,42,288482,387962,21446,104810,3.0728203016094287,0.21269471479710697
984,0.1025,50,387,50,288869,387575,21496,104760,3.0697551007476873,0.2127819472513634
985,0.1026,58,389,58,289258,387186,21554,104702,3.0666740590546193,0.21285739843216342
986,0.1027,35,385,35,289643,386801,21589,104667,3.0636246990242046,0.21296808744414691
987,0.1028,45,361,45,290004,386440,21634,104622,3.060765428969712,0.21305252697215424
988,0.1029,50,447,50,290451,385993,21684,104572,3.0572250031681665,0.2131664509290308
989,0.103,36,391,36,290842,385602,21720,104536,3.0541281206437714,0.2132787092614733
990,0.1031,51,393,51,291235,385209,21771,104485,3.0510153972880496,0.21336793997884393
991,0.1032,44,378,44,291613,384831,21815,104441,3.048021480167279,0.21346204156379273
992,0.1033,50,397,50,292010,384434,21865,104391,3.0448770751489036,0.2135549532041119
993,0.1034,42,376,42,292386,384058,21907,104349,3.0418989988594602,0.21365172898832327
994,0.1035,43,357,43,292743,383701,21950,104306,3.0390714104676215,0.21373873735417728
995,0.1036,47,388,47,293131,383313,21997,104259,3.035998289190217,0.21383303389037928
996,0.1037,45,423,45,293554,382890,22042,104214,3.0326479533645925,0.21394609775325188
997,0.1038,55,431,55,293985,382459,22097,104159,3.029234254213661,0.21404674714046748
998,0.1039,49,388,49,294373,382071,22146,104110,3.0261611329362563,0.2141383558798061
999,0.104,42,371,42,294744,381700,22188,104068,3.02322265872513,0.2142339553037664
1000,0.1041,40,395,40,295139,381305,22228,104028,3.020094094538081,0.21434355380738584
1001,0.1042,48,388,48,295527,380917,22276,103980,3.0170209732606765,0.21443729286838237
1002,0.1043,38,359,38,295886,380558,22314,103942,3.014177544037511,0.21453457172342622
1003,0.1044,45,390,45,296276,380168,22359,103897,3.01108858192878,0.21463439827295921
1004,0.1045,59,371,59,296647,379797,22418,103838,3.008150107717653,0.21470323694521695
1005,0.1046,58,391,58,297038,379406,22476,103780,3.005053225193258,0.21478271307529606
1006,0.1047,38,376,38,297414,379030,22514,103742,3.0020751489038147,0.21488818738452106
1007,0.1048,36,363,36,297777,378667,22550,103706,2.999200038017995,0.21499130341043135
1008,0.1049,52,333,52,298110,378334,22602,103654,2.9965625396020785,0.2150551466011602
1009,0.105,50,383,50,298493,377951,22652,103604,2.993529020402991,0.21514468752271287
1010,0.1051,55,369,55,298862,377582,22707,103549,2.990606387023191,0.21521997127601422
1011,0.1052,53,387,53,299249,377195,22760,103496,2.9875411861614496,0.2153067147086174
1012,0.1053,51,395,51,299644,376800,22811,103445,2.984412621974401,0.21540047267540527
1013,0.1054,61,390,61,300034,376410,22872,103384,2.98132365986567,0.21547580836775784
1014,0.1055,52,373,52,300407,376037,22924,103332,2.9783693448232165,0.2155583694398261
1015,0.1056,49,359,49,300766,375678,22973,103283,2.9755259156000506,0.21563968673858624
1016,0.1057,55,383,55,301149,375295,23028,103228,2.972492396400963,0.21572212829895324
1017,0.1058,63,348,63,301497,374947,23091,103165,2.9697360917500952,0.21577580148584433
1018,0.1059,50,381,50,301878,374566,23141,103115,2.9667184133823343,0.21586581840182045
1019,0.106,47,392,47,302270,374174,23188,103068,2.963613610442276,0.21596590409058716
1020,0.1061,48,355,48,302625,373819,23236,103020,2.960801862881764,0.2160477645494601
1021,0.1062,41,339,41,302964,373480,23277,102979,2.958116841971867,0.2161340220249801
1022,0.1063,53,374,53,303338,373106,23330,102926,2.9551546065137497,0.2162165568701264
1023,0.1064,42,375,42,303713,372731,23372,102884,2.9521844506399697,0.2163178200855734
1024,0.1065,44,385,44,304098,372346,23416,102840,2.949135090609555,0.21642051743948684
1025,0.1066,43,356,43,304454,371990,23459,102797,2.9463154226333796,0.21651182530271468
1026,0.1067,49,360,49,304814,371630,23508,102748,2.943464072994551,0.21659520466800736
1027,0.1068,49,395,49,305209,371235,23557,102699,2.940335508807502,0.21669472964590006
1028,0.1069,51,406,51,305615,370829,23608,102648,2.937119820048156,0.2167961696133075
1029,0.107,50,390,50,306005,370439,23658,102598,2.9340308579394248,0.21689212471751682
1030,0.1071,45,390,45,306395,370049,23703,102553,2.930941895830693,0.21699654254531298
1031,0.1072,40,341,40,306736,369708,23743,102513,2.928241034089469,0.21708691481319128
1032,0.1073,46,357,46,307093,369351,23789,102467,2.92541344569763,0.2171748428419433
1033,0.1074,51,370,51,307463,368981,23840,102416,2.922482891902167,0.21726061048330814
1034,0.1075,49,379,49,307842,368602,23889,102367,2.919481054365733,0.21735400843792266
1035,0.1076,34,344,34,308186,368258,23923,102333,2.9167564313775185,0.21745634744395875
1036,0.1077,47,374,47,308560,367884,23970,102286,2.913794195919402,0.21755109853882637
1037,0.1078,52,350,52,308910,367534,24022,102234,2.911022050437207,0.21762657311694283
1038,0.1079,53,388,53,309298,367146,24075,102181,2.907948929159802,0.21771813682144858
1039,0.108,49,369,49,309667,366777,24124,102132,2.9050262957800026,0.2178077196215044
1040,0.1081,51,389,51,310056,366388,24175,102081,2.9019452540869346,0.21790342584034375
1041,0.1082,70,358,70,310414,366030,24245,102011,2.899109745279432,0.2179531280379283
1042,0.1083,42,330,42,310744,365700,24287,101969,2.8964960081105056,0.21803668834154072
1043,0.1084,54,336,54,311080,365364,24341,101915,2.8938347484475986,0.21810310328518936
1044,0.1085,50,361,50,311441,365003,24391,101865,2.890975478393106,0.21818801031554957
1045,0.1086,51,381,51,311822,364622,24442,101814,2.887957800025345,0.21828075019938425
1046,0.1087,42,356,42,312178,364266,24484,101772,2.88513813204917,0.21837704221544166
1047,0.1088,56,357,56,312535,363909,24540,101716,2.882310543657331,0.21845046979865773
1048,0.1089,53,360,53,312895,363549,24593,101663,2.879459194018502,0.21853047642795112
1049,0.109,43,377,43,313272,363172,24636,101620,2.876473197313395,0.2186354326236252
1050,0.1091,53,368,53,313640,362804,24689,101567,2.8735584843492585,0.21871951521520508
1051,0.1092,39,396,39,314036,362408,24728,101528,2.8704219997465468,0.21884052972823836
1052,0.1093,46,389,46,314425,362019,24774,101482,2.8673409580534788,0.2189466689392256
1053,0.1094,47,365,47,314790,361654,24821,101435,2.8644500063363325,0.21903996855895952
1054,0.1095,53,366,53,315156,361288,24874,101382,2.861551134203523,0.2191237815289515
1055,0.1096,45,370,45,315526,360918,24919,101337,2.85862058040806,0.21922315605023202
1056,0.1097,45,372,45,315898,360546,24964,101292,2.85567418578127,0.21932365894534447
1057,0.1098,45,372,45,316270,360174,25009,101247,2.85272779115448,0.2194243434954196
1058,0.1099,55,350,55,316620,359824,25064,101192,2.849955645672285,0.21949780484842174
1059,0.11,58,401,58,317021,359423,25122,101134,2.8467795589912557,0.2195906261331388
1060,0.1101,47,395,47,317416,359028,25169,101087,2.8436509948042072,0.21969942297034437
1061,0.1102,47,349,47,317765,358679,25216,101040,2.8408867697376756,0.21978643475688409
1062,0.1103,28,359,28,318124,358320,25244,101012,2.8380433405145102,0.21991065286111136
1063,0.1104,49,407,49,318531,357913,25293,100963,2.8348197313395005,0.22002240256627062
1064,0.1105,43,370,43,318901,357543,25336,100920,2.8318891775440376,0.2201268150319655
1065,0.1106,53,386,53,319287,357157,25389,100867,2.8288318970979596,0.22022208443225683
1066,0.1107,57,352,57,319639,356805,25446,100810,2.826043910784438,0.2202943522393278
1067,0.1108,55,359,55,319998,356446,25501,100755,2.823200481561272,0.2203735337411773
1068,0.1109,44,372,44,320370,356074,25545,100711,2.8202540869344825,0.22047790536028986
1069,0.111,48,348,48,320718,355726,25593,100663,2.8174977822836142,0.22056403638124494
1070,0.1111,54,366,54,321084,355360,25647,100609,2.8145989101508047,0.22064877217530138
1071,0.1112,38,339,38,321423,355021,25685,100571,2.8119138892409072,0.22074794992010396
1072,0.1113,47,369,47,321792,354652,25732,100524,2.8089912558611076,0.22084644181591295
1073,0.1114,56,355,56,322147,354297,25788,100468,2.8061795083005956,0.22092289424208109
1074,0.1115,47,408,47,322555,353889,25835,100421,2.8029479787099225,0.22104069908212454
1075,0.1116,49,388,49,322943,353501,25884,100372,2.799874857432518,0.22114556274552574
1076,0.1117,57,353,57,323296,353148,25941,100315,2.797078950703333,0.2212198128623504
1077,0.1118,38,378,38,323674,352770,25979,100277,2.7940850335825624,0.22133906636618275
1078,0.1119,54,369,54,324043,352401,26033,100223,2.791162400202763,0.22142661458517446
1079,0.112,46,375,46,324418,352026,26079,100177,2.7881922443289824,0.22153103805149457
1080,0.1121,35,332,35,324750,351694,26114,100142,2.7855626663287287,0.221633513044556
1081,0.1122,52,356,52,325106,351338,26166,100090,2.7827429983525533,0.22171863508687986
1082,0.1123,51,379,51,325485,350959,26217,100039,2.7797411608161195,0.2218169481904576
1083,0.1124,38,363,38,325848,350596,26255,100001,2.7768660499303004,0.22193001728817546
1084,0.1125,59,412,59,326260,350184,26314,99942,2.7736028386769735,0.22203116460724331
1085,0.1126,44,379,44,326639,349805,26358,99898,2.7706010011405398,0.2221421693873512
1086,0.1127,42,343,42,326982,349462,26400,99856,2.767884298567989,0.2222390378306678
1087,0.1128,44,352,44,327334,349110,26444,99812,2.765096312254467,0.22233706523627714
1088,0.1129,51,347,51,327681,348763,26495,99761,2.7623479280192624,0.2224206508458856
1089,0.113,47,342,47,328023,348421,26542,99714,2.759639145862375,0.22250884220156872
1090,0.1131,39,329,39,328352,348092,26581,99675,2.757033329109112,0.2226046135601775
1091,0.1132,46,423,46,328775,347669,26627,99629,2.7536829932834874,0.22273517878461338
1092,0.1133,45,337,45,329112,347332,26672,99584,2.751013813204917,0.22282487089296424
1093,0.1134,52,371,52,329483,346961,26724,99532,2.7480753389937904,0.22291950825656842
1094,0.1135,44,375,44,329858,346586,26768,99488,2.74510518312001,0.22303025955334765
1095,0.1136,37,369,37,330227,346217,26805,99451,2.7421825497402104,0.22315041690226806
1096,0.1137,52,370,52,330597,345847,26857,99399,2.739251995944747,0.2232451274127112
1097,0.1138,49,335,49,330932,345512,26906,99350,2.7365986566975034,0.22332768364121908
1098,0.1139,39,309,39,331241,345203,26945,99311,2.7341512482575085,0.2234147855860558
1099,0.114,39,369,39,331610,344834,26984,99272,2.731228614877709,0.22353221978536655
1100,0.1141,41,342,41,331952,344492,27025,99231,2.728519832720821,0.2236327618807229
1101,0.1142,52,349,52,332301,344143,27077,99179,2.7257556076542895,0.22371774917554282
1102,0.1143,48,344,48,332645,343799,27125,99131,2.7230309846660754,0.22380737362562933
1103,0.1144,36,377,36,333022,343422,27161,99095,2.7200449879609683,0.22393489967617064
1104,0.1145,40,375,40,333397,343047,27201,99055,2.717074832087188,0.2240546299270304
1105,0.1146,48,353,48,333750,342694,27249,99007,2.714278925358003,0.22414936801139232
1106,0.1147,45,393,45,334143,342301,27294,98962,2.711166202002281,0.22426987986756197
1107,0.1148,49,325,49,334468,341976,27343,98913,2.7085920669116716,0.22434898579914672
1108,0.1149,42,371,42,334839,341605,27385,98871,2.705653592700545,0.22446398895740063
1109,0.115,45,372,45,335211,341233,27430,98826,2.702707198073755,0.2245744320647913
1110,0.1151,44,357,44,335568,340876,27474,98782,2.699879609681916,0.224679182455454
1111,0.1152,48,321,48,335889,340555,27522,98734,2.69733715625396,0.22475864408168655
1112,0.1153,45,351,45,336240,340204,27567,98689,2.694557090356102,0.22485890638492753
1113,0.1154,51,336,51,336576,339868,27618,98638,2.691895830693195,0.22494104983740246
1114,0.1155,45,324,45,336900,339544,27663,98593,2.6893296160182487,0.22502778811193758
1115,0.1156,62,349,62,337249,339195,27725,98531,2.686565390951717,0.22509743538195126
1116,0.1157,57,361,57,337610,338834,27782,98474,2.6837061208972246,0.2251822514109049
1117,0.1158,39,315,39,337925,338519,27821,98435,2.6812111899632494,0.22527542945023962
1118,0.1159,47,340,47,338265,338179,27868,98388,2.6785182486376886,0.22536746936896285
1119,0.116,49,362,49,338627,337817,27917,98339,2.675651058167533,0.22546749328222013
1120,0.1161,54,353,54,338980,337464,27971,98285,2.6728551514383474,0.2255541607668635
1121,0.1162,41,372,41,339352,337092,28012,98244,2.6699087568115574,0.2256739621809361
1122,0.1163,53,369,53,339721,336723,28065,98191,2.666986123431758,0.22577107198204702
1123,0.1164,47,360,47,340081,336363,28112,98144,2.6641347737929286,0.2258743817706044
1124,0.1165,51,370,51,340451,335993,28163,98093,2.6612042199974653,0.2259759586809987
1125,0.1166,50,374,50,340825,335619,28213,98043,2.6582419845393486,0.2260816027228579
1126,0.1167,44,376,44,341201,335243,28257,97999,2.6552639082499048,0.22619921429593623
1127,0.1168,54,400,54,341601,334843,28311,97945,2.6520957419845392,0.22631172768191354
1128,0.1169,48,336,48,341937,334507,28359,97897,2.6494344823216323,0.22640169841167057
1129,0.117,50,345,50,342282,334162,28409,97847,2.6467019389177544,0.22649296658171472
1130,0.1171,61,336,61,342618,333826,28470,97786,2.6440406792548474,0.22655996589529484
1131,0.1172,51,323,51,342941,333503,28521,97735,2.6414823849955646,0.22663819051196787
1132,0.1173,42,366,42,343307,333137,28563,97693,2.638583512862755,0.22675533272984705
1133,0.1174,45,366,45,343673,332771,28608,97648,2.6356846407299455,0.22686730836696337
1134,0.1175,57,368,57,344041,332403,28665,97591,2.632769927765809,0.22695898082298824
1135,0.1176,59,317,59,344358,332086,28724,97532,2.630259156000507,0.22702028313525038
1136,0.1177,56,327,56,344685,331759,28780,97476,2.6276691800785703,0.22709238529010914
1137,0.1178,48,337,48,345022,331422,28828,97428,2.625,0.2271843301853795
1138,0.1179,45,354,45,345376,331068,28873,97383,2.6221961728551513,0.22729086873411428
1139,0.118,69,384,69,345760,330684,28942,97314,2.6191547332404004,0.22737022135617457
1140,0.1181,47,371,47,346131,330313,28989,97267,2.6162162590292737,0.22748257635997943
1141,0.1182,54,391,54,346522,329922,29043,97213,2.613119376504879,0.2275931497067672
1142,0.1183,36,383,36,346905,329539,29079,97177,2.6100858573057915,0.2277322622071823
1143,0.1184,44,388,44,347293,329151,29123,97133,2.607012736028387,0.22785983053551154
1144,0.1185,48,340,48,347633,328811,29171,97085,2.604319794702826,0.2279547119484569
1145,0.1186,43,350,43,347983,328461,29214,97042,2.601547649220631,0.22806419696218358
1146,0.1187,39,367,39,348350,328094,29253,97003,2.598640856672158,0.22819027186736204
1147,0.1188,37,362,37,348712,327732,29290,96966,2.5957736662020023,0.22831753387112724
1148,0.1189,48,362,48,349074,327370,29338,96918,2.5929064757318465,0.22842503205369938
1149,0.119,52,335,52,349409,327035,29390,96866,2.590253136484603,0.22851090230973742
1150,0.1191,51,382,51,349791,326653,29441,96815,2.5872275377011786,0.22862412272001661
1151,0.1192,44,395,44,350186,326258,29485,96771,2.58409897351413,0.22875736651624357
1152,0.1193,41,327,41,350513,325931,29526,96730,2.5815089975921937,0.22885953518304267
1153,0.1194,51,361,51,350874,325570,29577,96679,2.578649727537701,0.22896205793264163
1154,0.1195,52,360,52,351234,325210,29629,96627,2.575798377898872,0.22906241036229633
1155,0.1196,47,344,47,351578,324866,29676,96580,2.573073754910658,0.22916340408972918
1156,0.1197,58,353,58,351931,324513,29734,96522,2.5702778481814725,0.22924934981652356
1157,0.1198,44,366,44,352297,324147,29778,96478,2.567378976048663,0.22936820208023775
1158,0.1199,49,338,49,352635,323809,29827,96429,2.5647018755544293,0.22946282820687325
1159,0.12,46,363,46,352998,323446,29873,96383,2.5618267646686097,0.2295768038892025
1160,0.1201,49,366,49,353364,323080,29922,96334,2.5589278925358,0.22968713490727538
1161,0.1202,40,326,40,353690,322754,29962,96294,2.5563458370295273,0.22979229109791718
1162,0.1203,46,336,46,354026,322418,30008,96248,2.5536845773666204,0.22989208581542328
1163,0.1204,53,315,53,354341,322103,30061,96195,2.5511896464326447,0.22996763073215745
1164,0.1205,62,331,62,354672,321772,30123,96133,2.548567988848055,0.23003553439178762
1165,0.1206,45,325,45,354997,321447,30168,96088,2.5459938537574454,0.23013160573365107
1166,0.1207,42,386,42,355383,321061,30210,96046,2.5429365733113674,0.23026705377756787
1167,0.1208,48,365,48,355748,320696,30258,95998,2.540045621594221,0.23038008706628846
1168,0.1209,46,343,46,356091,320353,30304,95952,2.5373289190216703,0.23048486085922582
1169,0.121,42,354,42,356445,319999,30346,95910,2.5345250918768216,0.23060332909362385
1170,0.1211,44,331,44,356776,319668,30390,95866,2.5319034342922317,0.23070554996703038
1171,0.1212,57,339,57,357115,319329,30447,95809,2.5292184133823343,0.23078831617438056
1172,0.1213,51,308,51,357423,319021,30498,95758,2.526778925358003,0.23086511130023457
1173,0.1214,54,352,54,357775,318669,30552,95704,2.5239909390444812,0.23096099408021276
1174,0.1215,58,344,58,358119,318325,30610,95646,2.5212663160562667,0.23104516983073695
1175,0.1216,55,350,55,358469,317975,30665,95591,2.5184941705740718,0.23113843981371776
1176,0.1217,42,325,42,358794,317650,30707,95549,2.5159200354834623,0.23124208916284889
1177,0.1218,44,348,44,359142,317302,30751,95505,2.513163730832594,0.2313550884553799
1178,0.1219,46,327,46,359469,316975,30797,95459,2.510573754910658,0.23145279002216113
1179,0.122,48,345,48,359814,316630,30845,95411,2.50784121150678,0.2315570537883366
1180,0.1221,48,312,48,360126,316318,30893,95363,2.505370041819795,0.23164294684476572
1181,0.1222,41,329,41,360455,315989,30934,95322,2.5027642250665316,0.23175164291740313
1182,0.1223,44,345,44,360800,315644,30978,95278,2.5000316816626538,0.23186395471646687
1183,0.1224,48,306,48,361106,315338,31026,95230,2.497608034469649,0.23194696128290562
1184,0.1225,56,358,56,361464,314980,31082,95174,2.494772525662147,0.23204454912057423
1185,0.1226,39,316,39,361780,314664,31121,95135,2.492269674312508,0.23215039568178547
1186,0.1227,56,321,56,362101,314343,31177,95079,2.4897272208845522,0.23222738397057316
1187,0.1228,53,344,53,362445,313999,31230,95026,2.4870025978963377,0.2323232076278956
1188,0.1229,40,303,40,362748,313696,31270,94986,2.4846027119503233,0.23242031701910043
1189,0.123,54,341,54,363089,313355,31324,94932,2.481901850209099,0.23251291371020874
1190,0.1231,46,325,46,363414,313030,31370,94886,2.4793277151184894,0.2326116161170437
1191,0.1232,39,309,39,363723,312721,31409,94847,2.4768803066784946,0.23271454088642876
1192,0.1233,49,326,49,364049,312395,31458,94798,2.4742982511722214,0.23280852077516068
1193,0.1234,49,345,49,364394,312050,31507,94749,2.4715657077683435,0.23291355190155336
1194,0.1235,53,311,53,364705,311739,31560,94696,2.469102458497022,0.23299174529752606
1195,0.1236,46,335,46,365040,311404,31606,94650,2.4664491192497784,0.23309707575839667
1196,0.1237,56,307,56,365347,311097,31662,94594,2.4640175516411102,0.23316760785918347
1197,0.1238,50,318,50,365665,310779,31712,94544,2.4614988594601446,0.23325594649205694
1198,0.1239,44,342,44,366007,310437,31756,94500,2.4587900773032567,0.23336963527659857
1199,0.124,40,325,40,366332,310112,31796,94460,2.4562159422126473,0.23348130864221944
1200,0.1241,49,342,49,366674,309770,31845,94411,2.45350716005576,0.23358594293150842
1201,0.1242,52,364,52,367038,309406,31897,94359,2.450624128754277,0.23369781927606403
1202,0.1243,58,315,58,367353,309091,31955,94301,2.4481291978203017,0.23377012930350627
1203,0.1244,48,371,48,367724,308720,32003,94253,2.445190723609175,0.2338940822337973
1204,0.1245,62,342,62,368066,308378,32065,94191,2.4424819414522876,0.23397479686712092
1205,0.1246,44,341,44,368407,308037,32109,94147,2.439781079711063,0.23408937202872318
1206,0.1247,47,302,47,368709,307735,32156,94100,2.437389114180712,0.234175718889594
1207,0.1248,60,332,60,369041,307403,32216,94040,2.434759536180459,0.23425492535677545
1208,0.1249,49,349,49,369390,307054,32265,93991,2.431995311113927,0.23436522086050193
1209,0.125,54,321,54,369711,306733,32319,93937,2.4294528576859715,0.23444979659071055
1210,0.1251,33,302,33,370013,306431,32352,93904,2.4270608921556205,0.23456355302434212
1211,0.1252,55,310,55,370323,306121,32407,93849,2.424605563299962,0.23464009800735056
1212,0.1253,39,337,39,370660,305784,32446,93810,2.4219363832213916,0.234763284734005
1213,0.1254,41,347,41,371007,305437,32487,93769,2.4191879989861866,0.23488875417704141
1214,0.1255,50,301,50,371308,305136,32537,93719,2.4168039538714994,0.23497010191673665
1215,0.1256,60,337,60,371645,304799,32597,93659,2.4141347737929286,0.23505363175039778
1216,0.1257,33,310,33,371955,304489,32630,93626,2.4116794449372705,0.23517325395928312
1217,0.1258,56,347,56,372302,304142,32686,93570,2.4089310607020655,0.2352707486824637
1218,0.1259,61,342,61,372644,303800,32747,93509,2.406222278545178,0.2353558565247704
1219,0.126,45,311,45,372955,303489,32792,93464,2.403759029273856,0.23545356755081837
1220,0.1261,46,353,46,373308,303136,32838,93418,2.4009631225446713,0.23557447409432258
1221,0.1262,53,358,53,373666,302778,32891,93365,2.3981276137371688,0.23568509351421077
1222,0.1263,69,320,69,373986,302458,32960,93296,2.3955930807248764,0.23574240563582427
1223,0.1264,49,317,49,374303,302141,33009,93247,2.393082308959574,0.23583669711776786
1224,0.1265,53,323,53,374626,301818,33062,93194,2.3905240147002913,0.23592700981236014
1225,0.1266,45,316,45,374942,301502,33107,93149,2.3880211633506527,0.23602879506196614
1226,0.1267,42,319,42,375261,301183,33149,93107,2.3854945507540237,0.23613837530751478
1227,0.1268,51,356,51,375617,300827,33200,93056,2.3826748827778483,0.2362528974340096
1228,0.1269,50,319,50,375936,300508,33250,93006,2.3801482701812193,0.23634737264747888
1229,0.127,58,337,58,376273,300171,33308,92948,2.3774790901026486,0.2364373128747275
1230,0.1271,48,345,48,376618,299826,33356,92900,2.3747465466987707,0.2365516925286332
1231,0.1272,45,355,45,376973,299471,33401,92855,2.3719347991382587,0.23667817070497493
1232,0.1273,39,303,39,377276,299168,33440,92816,2.3695349131922443,0.23678517490509818
1233,0.1274,55,285,55,377561,298883,33495,92761,2.3672775947281712,0.2368503028260359
1234,0.1275,50,342,50,377903,298541,33545,92711,2.364568812571284,0.23695981106805844
1235,0.1276,48,339,48,378242,298202,33593,92663,2.3618837916613864,0.23707162319470917
1236,0.1277,42,292,42,378534,297910,33635,92621,2.3595710302876696,0.2371668318264107
1237,0.1278,46,341,46,378875,297569,33681,92575,2.3568701685464455,0.23728418225065617
1238,0.1279,43,303,43,379178,297266,33724,92532,2.3544702826004307,0.23738449145454826
1239,0.128,34,323,34,379501,296943,33758,92498,2.3519119883411483,0.23751479684984375
1240,0.1281,50,342,50,379843,296601,33808,92448,2.3492032061842605,0.23762559471943123
1241,0.1282,51,310,51,380153,296291,33859,92397,2.3467478773286023,0.23771508253406332
1242,0.1283,39,309,39,380462,295982,33898,92358,2.344300468888607,0.23782767677808106
1243,0.1284,49,323,49,380785,295659,33947,92309,2.3417421746293248,0.2379294168591224
1244,0.1285,45,322,45,381107,295337,33992,92264,2.3391918007857053,0.2380386015515956
1245,0.1286,45,339,45,381446,294998,34037,92219,2.336506779875808,0.2381584486218322
1246,0.1287,56,308,56,381754,294690,34093,92163,2.3340672918514764,0.23823778024210746
1247,0.1288,58,298,58,382052,294392,34151,92105,2.331707007983779,0.23830715374246114
1248,0.1289,53,344,53,382396,294048,34204,92052,2.3289823849955646,0.2384149184149184
1249,0.129,55,296,55,382692,293752,34259,91997,2.326637941959194,0.23848927670583722
1250,0.1291,46,335,46,383027,293417,34305,91951,2.3239846027119504,0.23860569637333665
1251,0.1292,40,277,40,383304,293140,34345,91911,2.3217906475731844,0.2386982503616404
1252,0.1293,44,315,44,383619,292825,34389,91867,2.319295716639209,0.2388066297193599
1253,0.1294,38,310,38,383929,292515,34427,91829,2.316840387783551,0.23892398476364923
1254,0.1295,57,315,57,384244,292200,34484,91772,2.3143454568495754,0.23900701092788015
1255,0.1296,52,340,52,384584,291860,34536,91720,2.3116525155240146,0.23911569946295427
1256,0.1297,41,322,41,384906,291538,34577,91679,2.309102141680395,0.239235211381541
1257,0.1298,49,332,49,385238,291206,34626,91630,2.306472563680142,0.23934530712890115
1258,0.1299,41,317,41,385555,290889,34667,91589,2.3039617919148396,0.2394621389988444
1259,0.13,48,286,48,385841,290603,34715,91541,2.3016965530351032,0.23954582565734384
1260,0.1301,52,290,52,386131,290313,34767,91489,2.299399632492713,0.23962420312098942
1261,0.1302,47,319,47,386450,289994,34814,91442,2.296873019896084,0.239730911607714
1262,0.1303,44,316,44,386766,289678,34858,91398,2.2943701685464455,0.23984192129653928
1263,0.1304,61,308,61,387074,289370,34919,91337,2.291930680522114,0.239914159708122
1264,0.1305,44,289,44,387363,289081,34963,91293,2.289641680395387,0.24000851793235078
1265,0.1306,39,291,39,387654,288790,35002,91254,2.2873368394373337,0.24011430255444108
1266,0.1307,34,262,34,387916,288528,35036,91220,2.285261690533519,0.24021193001674795
1267,0.1308,36,326,36,388242,288202,35072,91184,2.2826796350272462,0.24034624366739943
1268,0.1309,50,331,50,388573,287871,35122,91134,2.2800579774426564,0.24045593066054538
1269,0.131,51,318,51,388891,287553,35173,91083,2.2775392852616907,0.24055557316261528
1270,0.1311,44,286,44,389177,287267,35217,91039,2.2752740463819543,0.24064910416435373
1271,0.1312,39,333,39,389510,286934,35256,91000,2.2726365479660373,0.24078278217889895
1272,0.1313,48,293,48,389803,286641,35304,90952,2.270315866176657,0.24087310940615955
1273,0.1314,48,320,48,390123,286321,35352,90904,2.2677813331643644,0.24098084697461727
1274,0.1315,38,311,38,390434,286010,35390,90866,2.265318083893043,0.24110317451893992
1275,0.1316,50,350,50,390784,285660,35440,90816,2.262545938410848,0.2412265323685972
1276,0.1317,43,296,43,391080,285364,35483,90773,2.2602014953744773,0.2413296219196729
1277,0.1318,39,313,39,391393,285051,35522,90734,2.2577224052718288,0.24145189403515308
1278,0.1319,44,286,44,391679,284765,35566,90690,2.2554571663920924,0.2415469230666791
1279,0.132,42,301,42,391980,284464,35608,90648,2.2530731212774047,0.24165582546012923
1280,0.1321,49,350,49,392330,284114,35657,90599,2.2503009757952097,0.2417823774462055
1281,0.1322,52,300,52,392630,283814,35709,90547,2.2479248510961853,0.2418708145346337
1282,0.1323,56,307,56,392937,283507,35765,90491,2.2454932834875176,0.24195583933603923
1283,0.1324,38,292,38,393229,283215,35803,90453,2.2431805221138004,0.24206782491409487
1284,0.1325,56,291,56,393520,282924,35859,90397,2.240875681155747,0.24214282078961538
1285,0.1326,51,302,51,393822,282622,35910,90346,2.238483715625396,0.24223525878895777
1286,0.1327,39,290,39,394112,282332,35949,90307,2.236186795083006,0.2423444674336288
1287,0.1328,57,320,57,394432,282012,36006,90250,2.2336522620707133,0.24243677839801
1288,0.1329,43,282,43,394714,281730,36049,90207,2.2314187048536307,0.24253300962259738
1289,0.133,41,299,41,395013,281431,36090,90166,2.22905050057027,0.24264458539762163
1290,0.1331,50,275,50,395288,281156,36140,90116,2.2268723862628312,0.24272231679200154
1291,0.1332,57,295,57,395583,280861,36197,90059,2.224535863642124,0.2427989863043244
1292,0.1333,35,307,35,395890,280554,36232,90024,2.222104296033456,0.2429286142188689
1293,0.1334,49,345,49,396235,280209,36281,89975,2.219371752629578,0.24305480517796554
1294,0.1335,54,302,54,396537,279907,36335,89921,2.216979787099227,0.2431427582551889
1295,0.1336,46,278,46,396815,279629,36381,89875,2.214777911544798,0.24323146704771803
1296,0.1337,51,302,51,397117,279327,36432,89824,2.212385946014447,0.2433259018667158
1297,0.1338,54,326,54,397443,279001,36486,89770,2.209803890508174,0.24343020465275197
1298,0.1339,51,298,51,397741,278703,36537,89719,2.2074436066404766,0.24352237379961023
1299,0.134,44,271,44,398012,278432,36581,89675,2.2052971739956915,0.24361123260356363
1300,0.1341,54,298,54,398310,278134,36635,89621,2.2029368901279938,0.2436975703933325
1301,0.1342,49,286,49,398596,277848,36684,89572,2.2006716512482574,0.24378640248217298
1302,0.1343,39,273,39,398869,277575,36723,89533,2.1985093777721456,0.24388735739891257
1303,0.1344,53,311,53,399180,277264,36776,89480,2.1960461285008237,0.24398490500185416
1304,0.1345,49,257,49,399437,277007,36825,89431,2.194010581675326,0.24405492880105228
1305,0.1346,39,304,39,399741,276703,36864,89392,2.1916027753136484,0.2441770578674934
1306,0.1347,52,288,52,400029,276415,36916,89340,2.1893216956025854,0.2442618692840836
1307,0.1348,46,295,46,400324,276120,36962,89294,2.186985172981878,0.24436392694313847
1308,0.1349,49,302,49,400626,275818,37011,89245,2.184593207451527,0.24446465404601397
1309,0.135,46,293,46,400919,275525,37057,89199,2.182272525662147,0.24456575383029358
1310,0.1351,47,280,47,401199,275245,37104,89152,2.180054809276391,0.24465624030933295
1311,0.1352,57,312,57,401511,274933,37161,89095,2.1775836395894057,0.2447476567736548
1312,0.1353,41,298,41,401809,274635,37202,89054,2.1752233557217084,0.24486305607263348
1313,0.1354,52,334,52,402143,274301,37254,89002,2.172577936890128,0.24498008549337605
1314,0.1355,51,296,51,402439,274005,37305,88951,2.1702334938537575,0.24507378304808297
1315,0.1356,44,257,44,402696,273748,37349,88907,2.16819794702826,0.24515586438901987
1316,0.1357,52,327,52,403023,273421,37401,88855,2.165607971106324,0.24526880058298092
1317,0.1358,54,297,54,403320,273124,37455,88801,2.1632556076542895,0.24535746356289287
1318,0.1359,53,304,53,403624,272820,37508,88748,2.160847801292612,0.24545313744579167
1319,0.136,58,315,58,403939,272505,37566,88690,2.1583528703586365,0.2455460346904027
1320,0.1361,57,309,57,404248,272196,37623,88633,2.1559054619186413,0.24563713005329393
1321,0.1362,42,307,42,404555,271889,37665,88591,2.1534738943099736,0.24575843320017754
1322,0.1363,53,300,53,404855,271589,37718,88538,2.1510977696109492,0.24585215771102972
1323,0.1364,55,275,55,405130,271314,37773,88483,2.1489196553035104,0.24592478536508086
1324,0.1365,42,297,42,405427,271017,37815,88441,2.1465672918514764,0.24603987113932643
1325,0.1366,42,320,42,405747,270697,37857,88399,2.144032758839184,0.24617094036135184
1326,0.1367,44,287,44,406034,270410,37901,88355,2.141759599543784,0.24627541705573286
1327,0.1368,49,316,49,406350,270094,37950,88306,2.1392567481941454,0.24638950892857142
1328,0.1369,49,299,49,406649,269795,37999,88257,2.1368885439107843,0.24649212963480166
1329,0.137,34,320,34,406969,269475,38033,88223,2.134354010898492,0.24664102119665193
1330,0.1371,60,288,60,407257,269187,38093,88163,2.132072931187429,0.24671330628235624
1331,0.1372,45,268,45,407525,268919,38138,88118,2.129950259789634,0.24680355257298264
1332,0.1373,39,308,39,407833,268611,38177,88079,2.1275107717653023,0.2469343127085144
1333,0.1374,38,289,38,408122,268322,38215,88041,2.1252217716385755,0.24705426769894742
1334,0.1375,46,312,46,408434,268010,38261,87995,2.1227506019515903,0.24717349475428715
1335,0.1376,34,279,34,408713,267731,38295,87961,2.120540805981498,0.24729541288530527
1336,0.1377,52,283,52,408996,267448,38347,87909,2.1182993283487517,0.2473822100028985
1337,0.1378,52,280,52,409276,267168,38399,87857,2.1160816119629957,0.24746707978311386
1338,0.1379,49,312,49,409588,266856,38448,87808,2.1136104422760105,0.24758080887826225
1339,0.138,35,277,35,409865,266579,38483,87773,2.111416487137245,0.2477000270917054
1340,0.1381,38,285,38,410150,266294,38521,87735,2.109159168673172,0.24781868152044043
1341,0.1382,48,271,48,410421,266023,38569,87687,2.107012736028387,0.24790647705747645
1342,0.1383,59,323,59,410744,265700,38628,87628,2.104454441769104,0.24800751709459765
1343,0.1384,48,290,48,411034,265410,38676,87580,2.102157521226714,0.24810901158673052
1344,0.1385,58,304,58,411338,265106,38734,87522,2.099749714865036,0.248199235454927
1345,0.1386,32,298,32,411636,264808,38766,87490,2.097389430997339,0.24834089322107988
1346,0.1387,46,268,46,411904,264540,38812,87444,2.095266759599544,0.24843174689758626
1347,0.1388,45,281,45,412185,264259,38857,87399,2.0930411227981245,0.24853408709598532
1348,0.1389,55,300,55,412485,263959,38912,87344,2.0906649980991,0.2486286766694278
1349,0.139,49,297,49,412782,263662,38961,87295,2.088312634647066,0.2487341754118026
1350,0.1391,31,289,31,413071,263373,38992,87264,2.08602363452034,0.24887276585186388
1351,0.1392,54,316,54,413387,263057,39046,87210,2.0835207831707008,0.24898149126237984
1352,0.1393,45,267,45,413654,262790,39091,87165,2.0814060321885695,0.2490748810561358
1353,0.1394,59,277,59,413931,262513,39150,87106,2.0792120770498035,0.24914549838538524
1354,0.1395,46,313,46,414244,262200,39196,87060,2.076732986947155,0.2492698848995018
1355,0.1396,51,256,51,414500,261944,39247,87009,2.074705360537321,0.24934303473533684
1356,0.1397,41,280,41,414780,261664,39288,86968,2.072487644151565,0.24945501273549187
1357,0.1398,35,307,35,415087,261357,39323,86933,2.070056076542897,0.24959947170461397
1358,0.1399,42,292,42,415379,261065,39365,86891,2.06774331516918,0.2497183551943349
1359,0.14,50,247,50,415626,260818,39415,86841,2.065786972500317,0.2497878668465364
1360,0.1401,40,289,40,415915,260529,39455,86801,2.06349797237359,0.24990930815075002
1361,0.1402,38,342,38,416257,260187,39493,86763,2.0607891902167026,0.25007349762213577
1362,0.1403,60,270,60,416527,259917,39553,86703,2.058650677987581,0.2501384801800242
1363,0.1404,45,313,45,416840,259604,39598,86658,2.0561715878849323,0.25026713875620193
1364,0.1405,47,311,47,417151,259293,39645,86611,2.0537083386136104,0.2503902816966557
1365,0.1406,44,284,44,417435,259009,39689,86567,2.051458940565201,0.2505006134685279
1366,0.1407,54,292,54,417727,258717,39743,86513,2.049146179191484,0.2505952553370217
1367,0.1408,48,256,48,417983,258461,39791,86465,2.04711855278165,0.2506769567965303
1368,0.1409,46,270,46,418253,258191,39837,86419,2.0449800405525282,0.250773337976263
1369,0.141,45,283,45,418536,257908,39882,86374,2.042738562919782,0.2508815447801512
1370,0.1411,41,303,41,418839,257605,39923,86333,2.0403386769737675,0.251013264018515
1371,0.1412,51,318,51,419157,257287,39974,86282,2.037819984792802,0.2511344155031449
1372,0.1413,49,298,49,419455,256989,40023,86233,2.0354597009251045,0.25124554952771094
1373,0.1414,42,249,42,419704,256740,40065,86191,2.0334875174249145,0.2513362746441704
1374,0.1415,49,277,49,419981,256463,40114,86142,2.031293562286149,0.2514324075830767
1375,0.1416,50,270,50,420251,256193,40164,86092,2.029155050057027,0.2515213929912208
1376,0.1417,47,266,47,420517,255927,40211,86045,2.027048219490559,0.2516141672417625
1377,0.1418,47,277,47,420794,255650,40258,85998,2.0248542643517933,0.25171521566056293
1378,0.1419,61,288,61,421082,255362,40319,85937,2.0225731846407298,0.25179388161113864
1379,0.142,39,322,39,421404,255040,40358,85898,2.0200228107971108,0.25194610163724784
1380,0.1421,56,285,56,421689,254755,40414,85842,2.0177654923330377,0.2520339286605578
1381,0.1422,47,274,47,421963,254481,40461,85795,2.015595298441262,0.2521335621671819
1382,0.1423,53,315,53,422278,254166,40514,85742,2.013100367507287,0.2522506089883145
1383,0.1424,51,322,51,422600,253844,40565,85691,2.0105499936636675,0.25237751630906974
1384,0.1425,43,263,43,422863,253581,40608,85648,2.0084669243441895,0.2524784142865144
1385,0.1426,47,281,47,423144,253300,40655,85601,2.00624128754277,0.2525840879784952
1386,0.1427,49,267,49,423411,253033,40704,85552,2.004126536560639,0.25267510374056734
1387,0.1428,45,254,45,423665,252779,40749,85507,2.0021147509821318,0.25276541151569976
1388,0.1429,45,263,45,423928,252516,40794,85462,2.0000316816626538,0.25286261235938434
1389,0.143,59,292,59,424220,252224,40853,85403,1.9977189202889367,0.2529507414987545
1390,0.1431,44,286,44,424506,251938,40897,85359,1.9954536814092003,0.25306777113345214
1391,0.1432,46,272,46,424778,251666,40943,85313,1.9932993283487517,0.2531700788476433
1392,0.1433,55,293,55,425071,251373,40998,85258,1.9909786465593715,0.2532684155648173
1393,0.1434,46,282,46,425353,251091,41044,85212,1.9887450893422887,0.253378649610619
1394,0.1435,55,284,55,425637,250807,41099,85157,1.9864956912938792,0.25347060994630377
1395,0.1436,53,317,53,425954,250490,41152,85104,1.9839849195285768,0.25359213811927506
1396,0.1437,56,311,56,426265,250179,41208,85048,1.9815216702572551,0.253702714876785
1397,0.1438,56,270,56,426535,249909,41264,84992,1.9793831580281334,0.25378246108551483
1398,0.1439,56,292,56,426827,249617,41320,84936,1.9770703966544165,0.2538790565321489
1399,0.144,59,278,59,427105,249339,41379,84877,1.9748685210999872,0.2539585178447471
1400,0.1441,49,276,49,427381,249063,41428,84828,1.972682486376885,0.25405895936098905
1401,0.1442,39,251,39,427632,248812,41467,84789,1.9706944620453681,0.25416290718553003
1402,0.1443,52,310,52,427942,248502,41519,84737,1.9682391331897098,0.25428296207826817
1403,0.1444,54,278,54,428220,248224,41573,84683,1.9660372576352807,0.25437434478698256
1404,0.1445,49,281,49,428501,247943,41622,84634,1.9638116208338614,0.25447941378988925
1405,0.1446,29,284,29,428785,247659,41651,84605,1.9615622227854517,0.2546318590036838
1406,0.1447,53,275,53,429060,247384,41704,84552,1.959384108478013,0.25472380217873325
1407,0.1448,43,259,43,429319,247125,41747,84509,1.9573327208211886,0.2548261034755182
1408,0.1449,57,259,57,429578,246866,41804,84452,1.9552813331643644,0.25489710791445075
1409,0.145,54,274,54,429852,246592,41858,84398,1.953111139272589,0.25498655548506
1410,0.1451,49,261,49,430113,246331,41907,84349,1.951043910784438,0.2550774162332164
1411,0.1452,56,285,56,430398,246046,41963,84293,1.9487865923203649,0.25517120291579254
1412,0.1453,38,252,38,430650,245794,42001,84255,1.9467906475731847,0.2552802765649949
1413,0.1454,54,264,54,430914,245530,42055,84201,1.9446996578380433,0.2553627047502358
1414,0.1455,44,263,44,431177,245267,42099,84157,1.9426165885185656,0.25546711836417507
1415,0.1456,44,251,44,431428,245016,42143,84113,1.9406285641870484,0.25556240866043406
1416,0.1457,69,246,69,431674,244770,42212,84044,1.9386801419338486,0.2555973894055606
1417,0.1458,54,232,54,431906,244538,42266,83990,1.9368426054999366,0.25565553012224224
1418,0.1459,55,249,55,432155,244289,42321,83935,1.9348704219997466,0.25572474895193525
1419,0.146,50,279,50,432434,244010,42371,83885,1.932660626029654,0.25582884764939995
1420,0.1461,60,260,60,432694,243750,42431,83825,1.9306013179571664,0.25589559642829884
1421,0.1462,53,312,53,433006,243438,42484,83772,1.9281301482701811,0.2560190703218117
1422,0.1463,29,260,29,433266,243178,42513,83743,1.9260708401976936,0.25615668617188864
1423,0.1464,49,246,49,433512,242932,42562,83694,1.9241224179444938,0.2562380214679787
1424,0.1465,47,306,47,433818,242626,42609,83647,1.921698770751489,0.25637119835230004
1425,0.1466,40,261,40,434079,242365,42649,83607,1.9196315422633379,0.25648521958941256
1426,0.1467,59,242,59,434321,242123,42708,83548,1.9177148016727918,0.25654111050722966
1427,0.1468,49,284,49,434605,241839,42757,83499,1.9154654036243821,0.2566530807959722
1428,0.1469,56,261,56,434866,241578,42813,83443,1.9133981751362312,0.25673110352869505
1429,0.147,44,285,44,435151,241293,42857,83399,1.9111408566721582,0.2568557278898156
1430,0.1471,54,244,54,435395,241049,42911,83345,1.909208275250285,0.25692522056511524
1431,0.1472,54,259,54,435654,240790,42965,83291,1.9071568875934608,0.2570067359703284
1432,0.1473,58,274,58,435928,240516,43023,83233,1.9049866937016855,0.2570911415942598
1433,0.1474,60,271,60,436199,240245,43083,83173,1.9028402610569002,0.2571687413811229
1434,0.1475,43,266,43,436465,239979,43126,83130,1.9007334304904322,0.2572815984698662
1435,0.1476,46,278,46,436743,239701,43172,83084,1.8985315549360031,0.25739733878587917
1436,0.1477,53,256,53,436999,239445,43225,83031,1.8965039285261691,0.2574796263908012
1437,0.1478,47,267,47,437266,239178,43272,82984,1.8943891775440376,0.25758469341511414
1438,0.1479,65,294,65,437560,238884,43337,82919,1.8920605753389939,0.2576700652262409
1439,0.148,51,257,51,437817,238627,43388,82868,1.8900250285134963,0.2577582855098835
1440,0.1481,49,290,49,438107,238337,43437,82819,1.8877281079711064,0.2578777914782847
1441,0.1482,43,283,43,438390,238054,43480,82776,1.8854866303383602,0.2580057974628308
1442,0.1483,47,252,47,438642,237802,43527,82729,1.8834906855911797,0.2580998405770425
1443,0.1484,39,239,39,438881,237563,43566,82690,1.881597706247624,0.25820210895760537
1444,0.1485,34,253,34,439134,237310,43600,82656,1.8795938410847801,0.2583274472912747
1445,0.1486,37,264,37,439398,237046,43637,82619,1.8775028513496388,0.2584549450205684
1446,0.1487,54,319,54,439717,236727,43691,82565,1.8749762387530098,0.25858775039775506
1447,0.1488,47,272,47,439989,236455,43738,82518,1.8728218856925611,0.2586990121420935
1448,0.1489,41,261,41,440250,236194,43779,82477,1.87075465720441,0.2588155181990203
1449,0.149,39,282,39,440532,235912,43818,82438,1.8685210999873274,0.2589539814669389
1450,0.1491,49,227,49,440759,235685,43867,82389,1.8667231656317325,0.25902462948873534
1451,0.1492,53,246,53,441005,235439,43920,82336,1.8647747433785324,0.25910156557312564
1452,0.1493,48,274,48,441279,235165,43968,82288,1.8626045494867571,0.2592131748636806
1453,0.1494,43,261,43,441540,234904,44011,82245,1.860537320998606,0.25932605809887466
1454,0.1495,41,263,41,441803,234641,44052,82204,1.858454251679128,0.2594454701825814
1455,0.1496,33,245,33,442048,234396,44085,82171,1.8565137498415918,0.25956906436868027
1456,0.1497,42,257,42,442305,234139,44127,82129,1.8544782030160942,0.2596816623875953
1457,0.1498,48,264,48,442569,233875,44175,82081,1.852387213280953,0.2597861727582322
1458,0.1499,36,263,36,442832,233612,44211,82045,1.8503041439614751,0.2599182023525536
1459,0.15,58,258,58,443090,233354,44269,81987,1.8482606767203142,0.2599947358573734
1460,0.1501,42,258,42,443348,233096,44311,81945,1.8462172094791536,0.2601090016854949
1461,0.1502,40,256,40,443604,232840,44351,81905,1.8441895830693196,0.2602265325898743
1462,0.1503,51,260,51,443864,232580,44402,81854,1.8421302749968318,0.2603217209334868
1463,0.1504,57,275,57,444139,232305,44459,81797,1.839952160689393,0.2604154064603218
1464,0.1505,54,268,54,444407,232037,44513,81743,1.837829489291598,0.26051054879214736
1465,0.1506,50,220,50,444627,231817,44563,81693,1.8360869978456469,0.2605754202417786
1466,0.1507,55,269,55,444896,231548,44618,81638,1.8339564060321887,0.2606693785801409
1467,0.1508,55,238,55,445134,231310,44673,81583,1.832071347104296,0.26073769627316684
1468,0.1509,36,261,36,445395,231049,44709,81547,1.8300041186161449,0.2608702606559265
1469,0.151,42,241,42,445636,230808,44751,81505,1.8280952984412622,0.2609721657439812
1470,0.1511,44,261,44,445897,230547,44795,81461,1.826028069953111,0.2610862541986103
1471,0.1512,51,247,51,446144,230300,44846,81410,1.824071727284248,0.26117224343139456
1472,0.1513,55,259,55,446403,230041,44901,81355,1.8220203396274237,0.2612589757093861
1473,0.1514,52,256,52,446659,229785,44953,81303,1.8199927132175897,0.26135048603610556
1474,0.1515,36,287,36,446946,229498,44989,81267,1.8177195539221898,0.261506282882564
1475,0.1516,53,243,53,447189,229255,45042,81214,1.8157948929159802,0.26158489253355405
1476,0.1517,44,259,44,447448,228996,45086,81170,1.813743505259156,0.26169857431182014
1477,0.1518,47,233,47,447681,228763,45133,81123,1.8118980484095806,0.2617833654956984
1478,0.1519,42,236,42,447917,228527,45175,81081,1.8100288303130148,0.2618827678871347
1479,0.152,46,264,46,448181,228263,45221,81035,1.8079378405778734,0.261996521154356
1480,0.1521,40,241,40,448422,228022,45261,80995,1.8060290204029907,0.26210532106647855
1481,0.1522,46,244,46,448666,227778,45307,80949,1.8040964389811178,0.2622025284474633
1482,0.1523,51,249,51,448915,227529,45358,80898,1.8021242554809276,0.262292211771343
1483,0.1524,39,252,39,449167,227277,45397,80859,1.8001283107337473,0.262413349949373
1484,0.1525,46,276,46,449443,227001,45443,80813,1.797942276010645,0.2625384160564497
1485,0.1526,37,278,37,449721,226723,45480,80776,1.7957404004562159,0.262687033128563
1486,0.1527,47,258,47,449979,226465,45527,80729,1.7936969332150552,0.2627948462535076
1487,0.1528,36,252,36,450231,226213,45563,80693,1.7917009884678747,0.2629241526721537
1488,0.1529,35,253,35,450484,225960,45598,80658,1.789697123305031,0.26305696338766804
1489,0.153,31,218,31,450702,225742,45629,80627,1.7879704726904069,0.26316957655637485
1490,0.1531,40,267,40,450969,225475,45669,80587,1.7858557217082753,0.2633028602047951
1491,0.1532,41,269,41,451238,225206,45710,80546,1.783725129894817,0.263435725686177
1492,0.1533,45,255,45,451493,224951,45755,80501,1.7817054239006462,0.26354713670232965
1493,0.1534,41,251,41,451744,224700,45796,80460,1.7797173995691293,0.2636649626425482
1494,0.1535,40,216,40,451960,224484,45836,80420,1.778006589785832,0.26375514916170334
1495,0.1536,49,259,49,452219,224225,45885,80371,1.7759552021290077,0.2638609830726602
1496,0.1537,48,248,48,452467,223977,45933,80323,1.773990939044481,0.2639599079855406
1497,0.1538,46,255,46,452722,223722,45979,80277,1.7719712330503106,0.2640699475985118
1498,0.1539,45,253,45,452975,223469,46024,80232,1.7699673678874668,0.2641808884396166
1499,0.154,62,251,62,453226,223218,46086,80170,1.7679793435559499,0.2642490803855129
1500,0.1541,51,264,51,453490,222954,46137,80119,1.7658883538208086,0.26435545231676855
1501,0.1542,52,260,52,453750,222694,46189,80067,1.7638290457483208,0.2644561221557598
1502,0.1543,51,253,51,454003,222441,46240,80016,1.7618251805854772,0.26455330840416985
1503,0.1544,48,244,48,454247,222197,46288,79968,1.759892599163604,0.26465010838449193
1504,0.1545,42,226,42,454473,221971,46330,79926,1.7581025852236725,0.26474592327846913
1505,0.1546,46,233,46,454706,221738,46376,79880,1.756257128374097,0.26483830540617603
1506,0.1547,32,273,32,454979,221465,46408,79848,1.7540948548979851,0.2650001825344409
1507,0.1548,38,237,38,455216,221228,46446,79810,1.752217716385756,0.2651160318630871
1508,0.1549,54,251,54,455467,220977,46500,79756,1.750229692054239,0.2652053482657374
1509,0.155,43,210,43,455677,220767,46543,79713,1.748566404764922,0.2652855431309904
1510,0.1551,47,238,47,455915,220529,46590,79666,1.7466813458370296,0.26538083579006977
1511,0.1552,48,250,48,456165,220279,46638,79618,1.744701241921176,0.265484483005832
1512,0.1553,58,266,58,456431,220013,46696,79560,1.7425944113547078,0.26557800602858067
1513,0.1554,51,263,51,456694,219750,46747,79509,1.74051134203523,0.26568624502521226
1514,0.1555,45,252,45,456946,219498,46792,79464,1.7385153972880496,0.2657996668472916
1515,0.1556,47,279,47,457225,219219,46839,79417,1.7363056013179572,0.26593243949155493
1516,0.1557,54,239,54,457464,218980,46893,79363,1.7344126219744012,0.2660126096472852
1517,0.1558,52,243,52,457707,218737,46945,79311,1.7324879609681916,0.26610143332617564
1518,0.1559,58,252,58,457959,218485,47003,79253,1.7304920162210113,0.2661836917021005
1519,0.156,43,234,43,458193,218251,47046,79210,1.7286386389557724,0.26628700905328767
1520,0.1561,57,270,57,458463,217981,47103,79153,1.7265001267266507,0.2663882288798993
1521,0.1562,39,243,39,458706,217738,47142,79114,1.724575465720441,0.26650991066255236
1522,0.1563,40,234,40,458940,217504,47182,79074,1.7227220884552021,0.26662125983720975
1523,0.1564,35,244,35,459184,217260,47217,79039,1.720789507033329,0.26675419086800833
1524,0.1565,42,235,42,459419,217025,47259,78997,1.7189282093524267,0.26686192242468465
1525,0.1566,44,245,44,459664,216780,47303,78953,1.7169877075148903,0.2669739258046955
1526,0.1567,52,225,52,459889,216555,47355,78901,1.7152056139906222,0.2670482237625907
1527,0.1568,42,239,42,460128,216316,47397,78859,1.7133126346470662,0.26716015922757685
1528,0.1569,42,238,42,460366,216078,47439,78817,1.7114275757191737,0.26727140168534563
1529,0.157,56,260,56,460626,215818,47495,78761,1.7093682676466861,0.2673680065449336
1530,0.1571,55,246,55,460872,215572,47550,78706,1.7074198453934863,0.26745458376093356
1531,0.1572,47,244,47,461116,215328,47597,78659,1.7054872639716132,0.26755944990764896
1532,0.1573,41,254,41,461370,215074,47638,78618,1.703475478393106,0.26768859894038655
1533,0.1574,56,274,56,461644,214800,47694,78562,1.7013052845013306,0.2677988287508266
1534,0.1575,46,264,46,461908,214536,47740,78516,1.6992142947661892,0.2679251463904017
1535,0.1576,41,265,41,462173,214271,47781,78475,1.6971153846153846,0.26806514862713754
1536,0.1577,47,244,47,462417,214027,47828,78428,1.6951828031935117,0.2681711716332427
1537,0.1578,49,269,49,462686,213758,47877,78379,1.6930522113800532,0.26829535457679105
1538,0.1579,44,276,44,462962,213482,47921,78335,1.690866176656951,0.2684387818393034
1539,0.158,35,227,35,463189,213255,47956,78300,1.6890682423013559,0.2685599629572465
1540,0.1581,52,234,52,463423,213021,48008,78248,1.6872148650361172,0.26864513559630443
1541,0.1582,48,237,48,463660,212784,48056,78200,1.685337726523888,0.26874329860061036
1542,0.1583,49,219,49,463879,212565,48105,78151,1.6836031554936004,0.2688224934300142
1543,0.1584,60,243,60,464122,212322,48165,78091,1.6816784944873906,0.26889636483215285
1544,0.1585,32,259,32,464381,212063,48197,78059,1.6796271068305664,0.26905577653538854
1545,0.1586,40,224,40,464605,211839,48237,78019,1.6778529337219616,0.2691628314554023
1546,0.1587,54,223,54,464828,211616,48291,77965,1.6760866810290205,0.2692338240423232
1547,0.1588,39,238,39,465066,211378,48330,77926,1.6742016221011278,0.26935680115034705
1548,0.1589,42,267,42,465333,211111,48372,77884,1.6720868711189962,0.2694994723092095
1549,0.159,48,222,48,465555,210889,48420,77836,1.6703285388417184,0.26958524547579876
1550,0.1591,48,238,48,465793,210651,48468,77788,1.668443479913826,0.2696861381435936
1551,0.1592,37,240,37,466033,210411,48505,77751,1.6665425801546065,0.26981697794990317
1552,0.1593,35,256,35,466289,210155,48540,77716,1.6645149537447725,0.2699681454540402
1553,0.1594,56,256,56,466545,209899,48596,77660,1.6624873273349385,0.2700663168254167
1554,0.1595,52,231,52,466776,209668,48648,77608,1.6606577113166898,0.2701513527061084
1555,0.1596,39,222,39,466998,209446,48687,77569,1.658899379039412,0.2702611361775517
1556,0.1597,39,240,39,467238,209206,48726,77530,1.6569984792801926,0.2703880921823559
1557,0.1598,50,225,50,467463,208981,48776,77480,1.6552163857559246,0.2704731185047877
1558,0.1599,31,233,31,467696,208748,48807,77449,1.653370928906349,0.2706142971449736
1559,0.16,43,247,43,467943,208501,48850,77406,1.6514145862374858,0.27073838695799685
1560,0.1601,42,203,42,468146,208298,48892,77364,1.6498067418578126,0.27082356071161023
1561,0.1602,43,222,43,468368,208076,48935,77321,1.6480484095805348,0.27092436150344956
1562,0.1603,46,240,46,468608,207836,48981,77275,1.6461475098213154,0.27103478995899843
1563,0.1604,41,215,41,468823,207621,49022,77234,1.6444446204536813,0.27113443681873234
1564,0.1605,42,216,42,469039,207405,49064,77192,1.642733810670384,0.27123265529854496
1565,0.1606,52,226,52,469265,207179,49116,77140,1.6409437967304523,0.27131496663958443
1566,0.1607,44,211,44,469476,206968,49160,77096,1.639272589025472,0.27140362735158274
1567,0.1608,58,279,58,469755,206689,49218,77038,1.6370627930553796,0.2715215682680887
1568,0.1609,50,241,50,469996,206448,49268,76988,1.6351539728804967,0.2716239292115328
1569,0.161,48,239,48,470235,206209,49316,76940,1.6332609935369409,0.27172972533895584
1570,0.1611,49,228,49,470463,205981,49365,76891,1.6314551387656824,0.27182259113662716
1571,0.1612,60,232,60,470695,205749,49425,76831,1.6296176023317703,0.271891145870196
1572,0.1613,48,246,48,470941,205503,49473,76783,1.6276691800785705,0.2720042793478954
1573,0.1614,51,263,51,471204,205240,49524,76732,1.6255861107590925,0.2721263104138
1574,0.1615,35,223,35,471427,205017,49559,76697,1.6238198580661514,0.27225129031571027
1575,0.1616,50,225,50,471652,204792,49609,76647,1.622037764541883,0.2723396544188972
1576,0.1617,49,202,49,471854,204590,49658,76598,1.6204378405778734,0.2724084953838713
1577,0.1618,49,217,49,472071,204373,49707,76549,1.6187191103789127,0.27249200845786375
1578,0.1619,40,222,40,472293,204151,49747,76509,1.6169607781016349,0.2726038623245208
1579,0.162,44,236,44,472529,203915,49791,76465,1.615091560005069,0.2727191668449961
1580,0.1621,32,221,32,472750,203694,49823,76433,1.6133411481434545,0.2728512424721644
1581,0.1622,58,212,58,472962,203482,49881,76375,1.611662020022811,0.2729072347663271
1582,0.1623,55,233,55,473195,203249,49936,76320,1.6098165631732353,0.27299164070408377
1583,0.1624,35,221,35,473416,203028,49971,76285,1.6080661513116208,0.2731165395094392
1584,0.1625,51,202,51,473618,202826,50022,76234,1.6064662273476111,0.2731813946821472
1585,0.1626,51,222,51,473840,202604,50073,76183,1.6047078950703333,0.27326597007751435
1586,0.1627,40,224,40,474064,202380,50113,76143,1.6029337219617286,0.2733813724539805
1587,0.1628,54,240,54,474304,202140,50167,76089,1.6010328222025092,0.273476165317059
1588,0.1629,46,226,46,474530,201914,50213,76043,1.5992428082625776,0.2735782872890411
1589,0.163,45,226,45,474756,201688,50258,75998,1.597452794322646,0.27368322493751934
1590,0.1631,53,208,53,474964,201480,50311,75945,1.5958053478646559,0.27374966207082996
1591,0.1632,50,236,50,475200,201244,50361,75895,1.5939361297680903,0.27385174948311136
1592,0.1633,46,228,46,475428,201016,50407,75849,1.5921302749968318,0.27395662145811134
1593,0.1634,50,245,50,475673,200771,50457,75799,1.5901897731592953,0.2740680478721481
1594,0.1635,49,212,49,475885,200559,50506,75750,1.5885106450386517,0.274149593390009
1595,0.1636,30,218,30,476103,200341,50536,75720,1.5867839944240274,0.2742872046395543
1596,0.1637,44,254,44,476357,200087,50580,75676,1.5847722088455203,0.27442405253786767
1597,0.1638,42,238,42,476595,199849,50622,75634,1.5828871499176276,0.2745505167288
1598,0.1639,42,187,42,476782,199662,50664,75592,1.5814060321885692,0.27462634512123346
1599,0.164,41,274,41,477056,199388,50705,75551,1.579235838296794,0.27479186292232094
1600,0.1641,38,235,38,477291,199153,50743,75513,1.5773745406158914,0.27492663817145185
1601,0.1642,40,208,40,477499,198945,50783,75473,1.5757270941579014,0.27502933481039876
1602,0.1643,41,227,41,477726,198718,50824,75432,1.5739291598023064,0.27514864125478755
1603,0.1644,47,229,47,477955,198489,50871,75385,1.5721153846153846,0.2752543140276185
1604,0.1645,38,203,38,478158,198286,50909,75347,1.5705075402357116,0.27535786984756955
1605,0.1646,43,222,43,478380,198064,50952,75304,1.5687492079584338,0.2754675016827134
1606,0.1647,45,235,45,478615,197829,50997,75259,1.5668879102775313,0.2755851593625498
1607,0.1648,46,227,46,478842,197602,51043,75213,1.5650899759219363,0.2756923189707311
1608,0.1649,54,247,54,479089,197355,51097,75159,1.5631336332530732,0.27579867456350865
1609,0.165,41,223,41,479312,197132,51138,75118,1.5613673805601318,0.27591551882460974
1610,0.1651,48,203,48,479515,196929,51186,75070,1.5597595361804588,0.27599366174140344
1611,0.1652,37,211,37,479726,196718,51223,75033,1.5580883284754783,0.2761093795423016
1612,0.1653,35,215,35,479941,196503,51258,74998,1.5563854391078444,0.27623471000106814
1613,0.1654,51,207,51,480148,196296,51309,74947,1.5547459130655177,0.27630943471352254
1614,0.1655,44,179,44,480327,196117,51353,74903,1.5533281586617667,0.27637443731089956
1615,0.1656,43,232,43,480559,195885,51396,74860,1.5514906222278546,0.27649633418899705
1616,0.1657,37,208,37,480767,195677,51433,74823,1.5498431757698643,0.27660998151571164
1617,0.1658,43,224,43,480991,195453,51476,74780,1.5480690026612596,0.2767241602617001
1618,0.1659,53,208,53,481199,195245,51529,74727,1.5464215562032695,0.27679537137184596
1619,0.166,35,191,35,481390,195054,51564,74692,1.5449087568115574,0.2768975258205868
1620,0.1661,39,215,39,481605,194839,51603,74653,1.5432058674439235,0.2770137889065353
1621,0.1662,57,239,57,481844,194600,51660,74596,1.5413128881003675,0.27710664348653025
1622,0.1663,40,219,40,482063,194381,51700,74556,1.5395783170700799,0.2772247775501326
1623,0.1664,35,222,35,482285,194159,51735,74521,1.537819984792802,0.27735968438290903
1624,0.1665,52,203,52,482488,193956,51787,74469,1.5362121404131288,0.2774294495669181
1625,0.1666,49,191,49,482679,193765,51836,74420,1.5346993410214167,0.27749501277103494
1626,0.1667,27,229,27,482908,193536,51863,74393,1.532885565834495,0.2776593799103494
1627,0.1668,45,220,45,483128,193316,51908,74348,1.531143074388544,0.2777661545818638
1628,0.1669,46,214,46,483342,193102,51954,74302,1.5294481054365734,0.2778642054718703
1629,0.167,41,202,41,483544,192900,51995,74261,1.5278481814725637,0.2779634752078335
1630,0.1671,32,206,32,483750,192694,52027,74229,1.5262165758459003,0.2780914346084826
1631,0.1672,46,226,46,483976,192468,52073,74183,1.524426561905969,0.2782025944024211
1632,0.1673,39,220,39,484196,192248,52112,74144,1.5226840704600177,0.27832667647677106
1633,0.1674,49,228,49,484424,192020,52161,74095,1.5208782156887592,0.2784322567311125
1634,0.1675,55,216,55,484640,191804,52216,74040,1.5191674059054618,0.2785092008847294
1635,0.1676,38,222,38,484862,191582,52254,74002,1.517409073628184,0.27863877342008553
1636,0.1677,46,205,46,485067,191377,52300,73956,1.5157853884171841,0.2787289933781324
1637,0.1678,50,238,50,485305,191139,52350,73906,1.5139003294892917,0.2788432153030617
1638,0.1679,45,185,45,485490,190954,52395,73861,1.51243505259156,0.2789154692898816
1639,0.168,45,220,45,485710,190734,52440,73816,1.510692561145609,0.27902475902475904
1640,0.1681,49,204,49,485914,190530,52489,73767,1.5090767963502725,0.2791064597782041
1641,0.1682,52,188,52,486102,190342,52541,73715,1.5075877582055506,0.2791632109733883
1642,0.1683,40,223,40,486325,190119,52581,73675,1.5058215055126094,0.2792899004526259
1643,0.1684,47,198,47,486523,189921,52628,73628,1.5042532632112533,0.2793711985247525
1644,0.1685,37,177,37,486700,189744,52665,73591,1.502851349638829,0.2794577249511079
1645,0.1686,41,202,41,486902,189542,52706,73550,1.5012514256748195,0.27956000182445684
1646,0.1687,54,201,54,487103,189341,52760,73496,1.4996594221264732,0.27962577567085306
1647,0.1688,52,173,52,487276,189168,52812,73444,1.4982891902167026,0.27966734193410814
1648,0.1689,53,206,53,487482,188962,52865,73391,1.4966575845900394,0.279741417098337
1649,0.169,49,240,49,487722,188722,52914,73342,1.49475668483082,0.2798629342450699
1650,0.1691,51,217,51,487939,188505,52965,73291,1.493037954631859,0.2799546211554034
1651,0.1692,44,220,44,488159,188285,53009,73247,1.4912954631859079,0.2800689781747549
1652,0.1693,38,208,38,488367,188077,53047,73209,1.4896480167279178,0.28018722778870664
1653,0.1694,48,208,48,488575,187869,53095,73161,1.4880005702699277,0.2802781289506953
1654,0.1695,49,193,49,488768,187676,53144,73112,1.486471930046889,0.28035032286761663
1655,0.1696,53,221,53,488989,187455,53197,73059,1.4847215181852744,0.28044174209447476
1656,0.1697,55,220,55,489209,187235,53252,73004,1.4829790267393232,0.28052674656757826
1657,0.1698,54,231,54,489440,187004,53306,72950,1.4811494107210745,0.2806265723935773
1658,0.1699,38,214,38,489654,186790,53344,72912,1.479454441769104,0.2807525548513296
1659,0.17,44,220,44,489874,186570,53388,72868,1.477711950323153,0.28086864684433277
1660,0.1701,67,220,67,490094,186350,53455,72801,1.4759694588772019,0.2809211617937033
1661,0.1702,44,237,44,490331,186113,53499,72757,1.4740923203649727,0.281056128558736
1662,0.1703,47,227,47,490558,185886,53546,72710,1.4722943860093778,0.2811721759037263
1663,0.1704,38,222,38,490780,185664,53584,72672,1.4705360537321,0.28130806391675955
1664,0.1705,40,194,40,490974,185470,53624,72632,1.4689994930933976,0.2814081254697755
1665,0.1706,44,207,44,491181,185263,53668,72588,1.4673599670510709,0.28151141550740544
1666,0.1707,34,200,34,491381,185063,53702,72554,1.465775883918388,0.2816351405380856
1667,0.1708,45,191,45,491572,184872,53747,72509,1.464263084526676,0.2817185417727027
1668,0.1709,53,220,53,491792,184652,53800,72456,1.4625205930807248,0.281811534452448
1669,0.171,43,190,43,491982,184462,53843,72413,1.4610157141046762,0.2818997566909976
1670,0.1711,41,170,41,492152,184292,53884,72372,1.4596692434418959,0.2819717607455662
1671,0.1712,38,196,38,492348,184096,53922,72334,1.4581168419718666,0.28208087977225754
1672,0.1713,51,207,51,492555,183889,53973,72283,1.4564773159295399,0.2821658885436347
1673,0.1714,47,187,47,492742,183702,54020,72236,1.4549961982004815,0.28224023005571663
1674,0.1715,44,211,44,492953,183491,54064,72192,1.4533249904955012,0.2823496282506072
1675,0.1716,46,205,46,493158,183286,54110,72146,1.4517013052845014,0.2824469917629741
1676,0.1717,45,216,45,493374,183070,54155,72101,1.449990495501204,0.28255953850555116
1677,0.1718,43,219,43,493593,182851,54198,72058,1.4482559244709163,0.2826812705710665
1678,0.1719,46,182,46,493775,182669,54244,72012,1.4468144088201749,0.2827537193587272
1679,0.172,32,213,32,493988,182456,54276,71980,1.4451273602838677,0.2829002185225361
1680,0.1721,45,203,45,494191,182253,54321,71935,1.4435195159041947,0.2829991974444112
1681,0.1722,36,213,36,494404,182040,54357,71899,1.4418324673678875,0.28313492610430063
1682,0.1723,44,194,44,494598,181846,54401,71855,1.4402959067291852,0.28322710592390254
1683,0.1724,52,236,52,494834,181610,54453,71803,1.4384266886326194,0.283343790571123
1684,0.1725,50,203,50,495037,181407,54503,71753,1.4368188442529464,0.2834294517301311
1685,0.1726,46,201,46,495238,181206,54549,71707,1.4352268407046003,0.28352437399421937
1686,0.1727,47,217,47,495455,180989,54596,71660,1.4335081105056393,0.28363460769684423
1687,0.1728,44,206,44,495661,180783,54640,71616,1.431876504878976,0.28374121925998125
1688,0.1729,34,211,34,495872,180572,54674,71582,1.4302052971739956,0.2838820720670701
1689,0.173,46,208,46,496080,180364,54720,71536,1.4285578507160055,0.2839857086145296
1690,0.1731,33,175,33,496255,180189,54753,71503,1.427171777974908,0.28408928372773073
1691,0.1732,47,184,47,496439,180005,54800,71456,1.42571442149284,0.28416334938618715
1692,0.1733,48,167,48,496606,179838,54848,71408,1.4243917120770497,0.28421547009703635
1693,0.1734,47,186,47,496792,179652,54895,71361,1.4229185147636547,0.2842920486189958
1694,0.1735,48,205,48,496997,179447,54943,71313,1.4212948295526548,0.2843874621151699
1695,0.1736,46,194,46,497191,179253,54989,71267,1.4197582689139525,0.2844762893182181
1696,0.1737,29,232,29,497423,179021,55018,71238,1.4179207324800405,0.2846570952493217
1697,0.1738,40,226,40,497649,178795,55058,71198,1.416130718540109,0.2847999743992832
1698,0.1739,48,212,48,497861,178583,55106,71150,1.4144515904194652,0.2849042777686569
1699,0.174,56,176,56,498037,178407,55162,71094,1.4130575972627044,0.284944749720442
1700,0.1741,33,182,33,498219,178225,55195,71061,1.411616081611963,0.2850581260078785
1701,0.1742,42,186,42,498405,178039,55237,71019,1.410142884298568,0.2851504468838584
1702,0.1743,32,208,32,498613,177831,55269,70987,1.4084954378405778,0.2852968836659727
1703,0.1744,40,178,40,498791,177653,55309,70947,1.4070856038524902,0.28538616251005633
1704,0.1745,44,183,44,498974,177470,55353,70903,1.4056361677860854,0.28546983770377615
1705,0.1746,37,189,37,499163,177281,55390,70866,1.4041392092257001,0.2855807243287245
1706,0.1747,51,212,51,499375,177069,55441,70815,1.4024600811050565,0.28567797840925596
1707,0.1748,32,208,32,499583,176861,55473,70783,1.4008126346470662,0.28582562064899614
1708,0.1749,41,188,41,499771,176673,55514,70742,1.3993235965023445,0.2859244589050785
1709,0.175,42,211,42,499982,176462,55556,70700,1.397652388797364,0.28604720790412763
1710,0.1751,30,212,30,500194,176250,55586,70670,1.3959732606767203,0.2862060586424753
1711,0.1752,37,186,37,500380,176064,55623,70633,1.3945000633633253,0.28631479101894225
1712,0.1753,36,184,36,500564,175880,55659,70597,1.3930427068812572,0.28642429111032675
1713,0.1754,60,226,60,500790,175654,55719,70537,1.3912526929413256,0.286513316896231
1714,0.1755,44,187,44,500977,175467,55763,70493,1.3897715752122672,0.28660351276630347
1715,0.1756,43,173,43,501150,175294,55806,70450,1.3884013433024964,0.2866804479458298
1716,0.1757,41,207,41,501357,175087,55847,70409,1.38676181726017,0.2868030436341122
1717,0.1758,43,167,43,501524,174920,55890,70366,1.3854391078443797,0.28687328261702666
1718,0.1759,41,179,41,501703,174741,55931,70325,1.3840213534406285,0.2869635118702717
1719,0.176,44,194,44,501897,174547,55975,70281,1.3824847928019262,0.28706275426013367
1720,0.1761,46,174,46,502071,174373,56021,70235,1.3811066404764922,0.2871328819989534
1721,0.1762,49,203,49,502274,174170,56070,70186,1.3794987960968192,0.2872284699373046
1722,0.1763,40,205,40,502479,173965,56110,70146,1.3778751108858194,0.28735288454842267
1723,0.1764,56,196,56,502675,173769,56166,70090,1.3763227094157902,0.2874201895357563
1724,0.1765,42,169,42,502844,173600,56208,70048,1.3749841591686731,0.28749671657473075
1725,0.1766,50,182,50,503026,173418,56258,69998,1.3735426435179319,0.28756532027475595
1726,0.1767,39,167,39,503193,173251,56297,69959,1.3722199341021417,0.28764853418856134
1727,0.1768,43,184,43,503377,173067,56340,69916,1.3707625776200736,0.2877402945885103
1728,0.1769,33,204,33,503581,172863,56373,69883,1.369146812824737,0.28788527926309804
1729,0.177,35,193,35,503774,172670,56408,69848,1.367618172601698,0.2880116115092488
1730,0.1771,38,196,38,503970,172474,56446,69810,1.366065771131669,0.2881329349028413
1731,0.1772,50,227,50,504197,172247,56496,69760,1.364267836776074,0.2882561248228357
1732,0.1773,42,197,42,504394,172050,56538,69718,1.3627075148903816,0.2883673604447239
1733,0.1774,45,178,45,504572,171872,56583,69673,1.3612976809022939,0.2884472872549628
1734,0.1775,48,193,48,504765,171679,56631,69625,1.3597690406792549,0.2885364519444352
1735,0.1776,44,201,44,504966,171478,56675,69581,1.3581770371309085,0.2886471776619002
1736,0.1777,35,216,35,505182,171262,56710,69546,1.3564662273476111,0.2888026975847979
1737,0.1778,39,198,39,505380,171064,56749,69507,1.3548979850462552,0.2889250990352121
1738,0.1779,36,197,36,505577,170867,56785,69471,1.3533376631605627,0.28905541362581033
1739,0.178,43,202,43,505779,170665,56828,69428,1.351737739196553,0.2891712794625416
1740,0.1781,38,211,38,505990,170454,56866,69390,1.3500665314915727,0.2893130534847651
1741,0.1782,42,174,42,506164,170280,56908,69348,1.3486883791661386,0.28939856778005907
1742,0.1783,47,160,47,506324,170120,56955,69301,1.3474211126599924,0.28945247075235675
1743,0.1784,39,188,39,506512,169932,56994,69262,1.3459320745152705,0.28956411950132527
1744,0.1785,39,210,39,506722,169722,57033,69223,1.3442687872259536,0.28970265123773253
1745,0.1786,35,202,35,506924,169520,57068,69188,1.342668863261944,0.2898436583608425
1746,0.1787,44,200,44,507124,169320,57112,69144,1.3410847801292611,0.2899557165861514
1747,0.1788,38,194,38,507318,169126,57150,69106,1.3395482194905588,0.29007857886430033
1748,0.1789,46,175,46,507493,168951,57196,69060,1.3381621467494613,0.29015465671754664
1749,0.179,50,192,50,507685,168759,57246,69010,1.3366414269420859,0.2902396864183304
1750,0.1791,34,182,34,507867,168577,57280,68976,1.3351999112913446,0.29036046692738043
1751,0.1792,36,170,36,508037,168407,57316,68940,1.3338534406285643,0.29046080211673203
1752,0.1793,41,197,41,508234,168210,57357,68899,1.3322931187428717,0.2905794381486995
1753,0.1794,35,187,35,508421,168023,57392,68864,1.3308120010138131,0.29070400655164697
1754,0.1795,52,216,52,508637,167807,57444,68812,1.3291011912305157,0.29081350187432115
1755,0.1796,41,180,41,508817,167627,57485,68771,1.3276755164111012,0.2909119366492102
1756,0.1797,45,183,45,509000,167444,57530,68726,1.3262260803446966,0.2910022441461659
1757,0.1798,49,180,49,509180,167264,57579,68677,1.324800405525282,0.29107700653977053
1758,0.1799,48,175,48,509355,167089,57627,68629,1.3234143327841845,0.2911487455349188
1759,0.18,24,195,24,509550,166894,57651,68605,1.3218698517298189,0.2913175852126761
1760,0.1801,35,179,35,509729,166715,57686,68570,1.3204520973260676,0.291433793059481
1761,0.1802,37,184,37,509913,166531,57723,68533,1.3189947408439995,0.2915503862777797
1762,0.1803,42,173,42,510086,166358,57765,68491,1.3176245089342289,0.29163845705112645
1763,0.1804,51,199,51,510285,166159,57816,68440,1.3160483462172095,0.2917318488143598
1764,0.1805,47,200,47,510485,165959,57863,68393,1.3144642630845267,0.2918387724448693
1765,0.1806,43,213,43,510698,165746,57906,68350,1.3127772145482195,0.2919742327933839
1766,0.1807,43,160,43,510858,165586,57949,68307,1.3115099480420733,0.2920437978049792
1767,0.1808,43,188,43,511046,165398,57992,68264,1.3100209098973514,0.2921484879869213
1768,0.1809,46,181,46,511227,165217,58038,68218,1.3085873146622735,0.29223552594940777
1769,0.181,36,178,36,511405,165039,58074,68182,1.3071774806741858,0.2923493167424889
1770,0.1811,43,174,43,511579,164865,58117,68139,1.3057993283487517,0.2924370397074728
1771,0.1812,42,183,42,511762,164682,58159,68097,1.3043498922823469,0.29253927545010505
1772,0.1813,37,183,37,511945,164499,58196,68060,1.3029004562159423,0.29265691716940645
1773,0.1814,42,199,42,512144,164300,58238,68018,1.3013242934989229,0.292779724343357
1774,0.1815,39,179,39,512323,164121,58277,67979,1.2999065390951716,0.2928866867729427
1775,0.1816,38,183,38,512506,163938,58315,67941,1.298457103028767,0.293001953605113
1776,0.1817,43,174,43,512680,163764,58358,67898,1.297078950703333,0.29309079607358995
1777,0.1818,53,183,53,512863,163581,58411,67845,1.295629514636928,0.29316066474812685
1778,0.1819,39,173,39,513036,163408,58450,67806,1.2942592827271575,0.2932607887065662
1779,0.182,42,189,42,513225,163219,58492,67764,1.2927623241667723,0.29337223951546215
1780,0.1821,48,175,48,513400,163044,58540,67716,1.2913762514256748,0.2934477379095164
1781,0.1822,37,174,37,513574,162870,58577,67679,1.2899980991002409,0.29355581676780207
1782,0.1823,33,173,33,513747,162697,58610,67646,1.28862786719047,0.2936750845478265
1783,0.1824,42,165,42,513912,162532,58652,67604,1.2873209986060068,0.29375673514791256
1784,0.1825,41,183,41,514095,162349,58693,67563,1.285871562539602,0.29386460906781725
1785,0.1826,33,185,33,514280,162164,58726,67530,1.2844062856418705,0.2939998432697415
1786,0.1827,35,174,35,514454,161990,58761,67495,1.2830281333164364,0.29411508377453865
1787,0.1828,26,201,26,514655,161789,58787,67469,1.2814361297680903,0.29429289272348186
1788,0.1829,34,185,34,514840,161604,58821,67435,1.2799708528703586,0.29442584014076206
1789,0.183,43,169,43,515009,161435,58864,67392,1.2786323026232416,0.2945107002233128
1790,0.1831,36,167,36,515176,161268,58900,67356,1.2773095932074516,0.29461473861011966
1791,0.1832,40,195,40,515371,161073,58940,67316,1.2757651121530857,0.2947427415506001
1792,0.1833,39,164,39,515535,160909,58979,67277,1.2744661639842858,0.2948340388980919
1793,0.1834,42,176,42,515711,160733,59021,67235,1.273072170827525,0.2949317448062886
1794,0.1835,40,141,40,515852,160592,59061,67195,1.2719553922189837,0.2949904955067673
1795,0.1836,48,169,48,516021,160423,59109,67147,1.2706168419718666,0.2950608603946039
1796,0.1837,35,178,35,516199,160245,59144,67112,1.269207007983779,0.29518334601529755
1797,0.1838,49,157,49,516356,160088,59193,67063,1.267963502724623,0.2952353280416991
1798,0.1839,36,181,36,516537,159907,59229,67027,1.266529907489545,0.2953590030581579
1799,0.184,44,174,44,516711,159733,59273,66983,1.265151755164111,0.29544893170309994
1800,0.1841,46,178,46,516889,159555,59319,66937,1.2637419211760232,0.29553803224837966
1801,0.1842,50,161,50,517050,159394,59369,66887,1.2624667342542137,0.2955926480791582
1802,0.1843,44,187,44,517237,159207,59413,66843,1.2609856165251552,0.2957000663570007
1803,0.1844,45,191,45,517428,159016,59458,66798,1.259472817133443,0.2958098257858237
1804,0.1845,47,160,47,517588,158856,59505,66751,1.2582055506272969,0.2958729117447597
1805,0.1846,41,180,41,517768,158676,59546,66710,1.2567798758078823,0.29598111683955525
1806,0.1847,45,157,45,517925,158519,59591,66665,1.2555363705487264,0.2960467884041495
1807,0.1848,35,164,35,518089,158355,59626,66630,1.2542374223799264,0.29615307687179143
1808,0.1849,37,156,37,518245,158199,59663,66593,1.253001837536434,0.2962427488522723
1809,0.185,37,187,37,518432,158012,59700,66556,1.2515207198073754,0.2963734815289801
1810,0.1851,37,159,37,518591,157853,59737,66519,1.2502613737168926,0.29646747365981496
1811,0.1852,49,203,49,518794,157650,59786,66470,1.2486535293372196,0.2965821881135106
1812,0.1853,39,190,39,518984,157460,59825,66431,1.247148650361171,0.2967113461461157
1813,0.1854,36,190,36,519174,157270,59861,66395,1.2456437713851223,0.29685020007600654
1814,0.1855,44,175,44,519349,157095,59905,66351,1.2442576986440248,0.29694422813565696
1815,0.1856,44,169,44,519518,156926,59949,66307,1.242919148396908,0.29703045696648794
1816,0.1857,51,163,51,519681,156763,60000,66256,1.2416281206437714,0.2970867952954681
1817,0.1858,33,155,33,519836,156608,60033,66223,1.2404004562159423,0.29718934977628786
1818,0.1859,33,185,33,520021,156423,60066,66190,1.2389351793182106,0.2973321414292966
1819,0.186,34,188,34,520209,156235,60100,66156,1.2374461411734887,0.2974760669271688
1820,0.1861,44,168,44,520377,156067,60144,66112,1.2361155113420352,0.29756187578484017
1821,0.1862,33,153,33,520530,155914,60177,66079,1.2349036877455328,0.2976625389088845
1822,0.1863,45,149,45,520679,155765,60222,66034,1.2337235458116842,0.297720007754769
1823,0.1864,41,153,41,520832,155612,60263,65993,1.2325117222151818,0.29779562735497844
1824,0.1865,40,189,40,521021,155423,60303,65953,1.2310147636547966,0.2979229907487713
1825,0.1866,47,169,47,521190,155254,60350,65906,1.2296762134076797,0.29800144691625974
1826,0.1867,43,166,43,521356,155088,60393,65863,1.228361424407553,0.298088716502754
1827,0.1868,41,177,41,521533,154911,60434,65822,1.2269595108351286,0.2981973696728627
1828,0.1869,31,150,31,521683,154761,60465,65791,1.2257714484856166,0.2983015343320396
1829,0.187,48,161,48,521844,154600,60513,65743,1.2244962615638069,0.29836663746976305
1830,0.1871,40,173,40,522017,154427,60553,65703,1.2231260296540363,0.2984736292190978
1831,0.1872,47,177,47,522194,154250,60600,65656,1.221724116081612,0.2985639318617955
1832,0.1873,36,186,36,522380,154064,60636,65620,1.220250918768217,0.29870177163562206
1833,0.1874,46,176,46,522556,153888,60682,65574,1.218856925611456,0.2987943243021571
1834,0.1875,39,179,39,522735,153709,60721,65535,1.217439171207705,0.2989135392530696
1835,0.1876,44,154,44,522889,153555,60765,65491,1.2162194271955393,0.2989828620472412
1836,0.1877,42,185,42,523074,153370,60807,65449,1.2147541502978076,0.29910108354393355
1837,0.1878,39,150,39,523224,153220,60846,65410,1.2135660879482955,0.29918126515116866
1838,0.1879,46,167,46,523391,153053,60892,65364,1.2122433785325053,0.2992624200497214
1839,0.188,32,157,32,523548,152896,60924,65332,1.2109998732733493,0.2993749656322745
1840,0.1881,34,202,34,523750,152694,60958,65298,1.2093999493093397,0.29954310249917426
1841,0.1882,38,152,38,523902,152542,60996,65260,1.2081960461285008,0.29962993911901636
1842,0.1883,31,179,31,524081,152363,61027,65229,1.2067782917247498,0.2997766462002279
1843,0.1884,38,151,38,524232,152212,61065,65191,1.2055823089595743,0.29986246739925393
1844,0.1885,50,182,50,524414,152030,61115,65141,1.2041407933088328,0.29995257193640035
1845,0.1886,42,174,42,524588,151856,61157,65099,1.202762640983399,0.3000576156345786
1846,0.1887,33,185,33,524773,151671,61190,65066,1.2012973640856672,0.3002071635207648
1847,0.1888,28,151,28,524924,151520,61218,65038,1.2001013813204917,0.3003260096602296
1848,0.1889,44,159,44,525083,151361,61262,64994,1.1988420352300089,0.30040442790783667
1849,0.189,36,164,36,525247,151197,61298,64958,1.197543087061209,0.30051583354537253
1850,0.1891,43,169,43,525416,151028,61341,64915,1.1962045368140921,0.3006117355042766
1851,0.1892,48,170,48,525586,150858,61389,64867,1.1948580661513115,0.3006930119364932
1852,0.1893,44,159,44,525745,150699,61433,64823,1.193598720060829,0.30077207895249675
1853,0.1894,32,154,32,525899,150545,61465,64791,1.192378976048663,0.3008832707954081
1854,0.1895,48,161,48,526060,150384,61513,64743,1.1911037891268534,0.3009524606395292
1855,0.1896,42,156,42,526216,150228,61555,64701,1.1898682042833608,0.3010342950462711
1856,0.1897,34,164,34,526380,150064,61589,64667,1.1885692561145609,0.30115353628493324
1857,0.1898,49,132,49,526512,149932,61638,64618,1.1875237612469902,0.30117921230482403
1858,0.1899,36,155,36,526667,149777,61674,64582,1.1862960968191611,0.3012796290335372
1859,0.19,39,156,39,526823,149621,61713,64543,1.1850605119756685,0.3013718458751237
1860,0.1901,38,174,38,526997,149447,61751,64505,1.1836823596502344,0.30149285821118754
1861,0.1902,42,172,42,527169,149275,61793,64463,1.1823200481561271,0.30159821837951134
1862,0.1903,41,194,41,527363,149081,61834,64422,1.180783487517425,0.3017381488784701
1863,0.1904,43,176,43,527539,148905,61877,64379,1.179389494360664,0.3018463644717841
1864,0.1905,45,193,45,527732,148712,61922,64334,1.1778608541376252,0.3019723440008261
1865,0.1906,34,166,34,527898,148546,61956,64300,1.1765460651374984,0.30209635135262114
1866,0.1907,36,127,36,528025,148419,61992,64264,1.1755401723482448,0.3021586116426795
1867,0.1908,29,150,29,528175,148269,62021,64235,1.1743521099987326,0.3022766630275195
1868,0.1909,34,172,34,528347,148097,62055,64201,1.1729897985046256,0.3024098201584565
1869,0.191,37,154,37,528501,147943,62092,64164,1.1717700544924599,0.3025076965870999
1870,0.1911,30,168,30,528669,147775,62122,64134,1.1704394246610061,0.30264877848510446
1871,0.1912,51,145,51,528814,147630,62173,64083,1.1692909643898113,0.3026880730044919
1872,0.1913,46,167,46,528981,147463,62219,64037,1.1679682549740211,0.30277541371158395
1873,0.1914,33,145,33,529126,147318,62252,64004,1.166819794702826,0.30287428663366806
1874,0.1915,30,164,30,529290,147154,62282,63974,1.165520846534026,0.3030104960024251
1875,0.1916,42,135,42,529425,147019,62324,63932,1.1644515904194652,0.30306564083602355
1876,0.1917,40,195,40,529620,146824,62364,63892,1.1629071093650996,0.3032138043622696
1877,0.1918,40,164,40,529784,146660,62404,63852,1.1616081611962996,0.3033176255985407
1878,0.1919,40,162,40,529946,146498,62444,63812,1.1603250538588266,0.3034187627787552
1879,0.192,27,167,27,530113,146331,62471,63785,1.1590023444430364,0.3035704087266082
1880,0.1921,35,160,35,530273,146171,62506,63750,1.1577350779368902,0.30368567222907666
1881,0.1922,33,165,33,530438,146006,62539,63717,1.1564282093524267,0.30381503220915207
1882,0.1923,35,179,35,530617,145827,62574,63682,1.1550104549486757,0.30395830250729083
1883,0.1924,49,142,49,530759,145685,62623,63633,1.1538857559244708,0.3040015669937607
1884,0.1925,40,160,40,530919,145525,62663,63593,1.1526184894183247,0.3041010338660469
1885,0.1926,20,157,20,531076,145368,62683,63573,1.1513749841591687,0.30426292589774145
1886,0.1927,52,185,52,531261,145183,62735,63521,1.149909707261437,0.30435928396197487
1887,0.1928,39,155,39,531416,145028,62774,63482,1.148682042833608,0.30445542180231167
1888,0.1929,41,166,41,531582,144862,62815,63441,1.1473672538334811,0.30456114410258134
1889,0.193,39,144,39,531726,144718,62854,63402,1.1462267139779496,0.30464155295022105
1890,0.1931,38,149,38,531875,144569,62892,63364,1.145046572044101,0.3047327744994782
1891,0.1932,37,159,37,532034,144410,62929,63327,1.1437872259536181,0.30484218025676696
1892,0.1933,44,146,44,532180,144264,62973,63283,1.1426308452667595,0.3049092494712041
1893,0.1934,28,154,28,532334,144110,63001,63255,1.1414111012545938,0.30504183444650734
1894,0.1935,46,150,46,532484,143960,63047,63209,1.1402230389050818,0.30510838976873955
1895,0.1936,38,158,38,532642,143802,63085,63171,1.1389716132302623,0.305213723529156
1896,0.1937,44,161,44,532803,143641,63129,63127,1.1376964263084526,0.3053035285924321
1897,0.1938,47,155,47,532958,143486,63176,63080,1.1364687618806235,0.30537455341150044
1898,0.1939,38,163,38,533121,143323,63214,63042,1.135177734127487,0.3054878491992344
1899,0.194,41,154,41,533275,143169,63255,63001,1.1339579901153212,0.30557792113304555
1900,0.1941,45,151,45,533426,143018,63300,62956,1.1327620073501456,0.3056502276986416
1901,0.1942,55,154,55,533580,142864,63355,62901,1.13154226333798,0.3056933880883532
1902,0.1943,39,147,39,533727,142717,63394,62862,1.1303779622354582,0.30578025965687156
1903,0.1944,37,159,37,533886,142558,63431,62825,1.1291186161449753,0.305891919000112
1904,0.1945,37,169,37,534055,142389,63468,62788,1.1277800658978583,0.3060187058003577
1905,0.1946,39,147,39,534202,142242,63507,62749,1.1266157647953365,0.3061061217321736
1906,0.1947,32,155,32,534357,142087,63539,62717,1.1253881003675072,0.306229370520107
1907,0.1948,30,157,30,534514,141930,63569,62687,1.1241445951083513,0.30636261894173017
1908,0.1949,50,188,50,534702,141742,63619,62637,1.1226555569636294,0.3064747356626659
1909,0.195,40,148,40,534850,141594,63659,62597,1.121483335445444,0.3065610139526228
1910,0.1951,21,155,21,535005,141439,63680,62576,1.120255671017615,0.3067225449109134
1911,0.1952,38,147,38,535152,141292,63718,62538,1.119091369915093,0.30681450228131285
1912,0.1953,33,184,33,535336,141108,63751,62505,1.117634013433025,0.30697941683487795
1913,0.1954,33,163,33,535499,140945,63784,62472,1.1163429856798885,0.30711297482511296
1914,0.1955,32,165,32,535664,140780,63816,62440,1.1150361170954253,0.3072532231079618
1915,0.1956,42,152,42,535816,140628,63858,62398,1.1138322139145862,0.30733994660782366
1916,0.1957,37,169,37,535985,140459,63895,62361,1.1124936636674694,0.30746967754659305
1917,0.1958,41,165,41,536150,140294,63936,62320,1.1111867950830059,0.30757993031083736
1918,0.1959,37,154,37,536304,140140,63973,62283,1.1099670510708401,0.3076873675422259
1919,0.196,34,125,34,536429,140015,64007,62249,1.1089769991129135,0.3077611438515999
1920,0.1961,37,129,37,536558,139886,64044,62212,1.107955265492333,0.30783085433799445
1921,0.1962,28,169,28,536727,139717,64072,62184,1.106616715245216,0.30799253099291235
1922,0.1963,38,181,38,536908,139536,64110,62146,1.105183120010138,0.3081385547545145
1923,0.1964,40,158,40,537066,139378,64150,62106,1.1039316943353188,0.30824283814099385
1924,0.1965,42,155,42,537221,139223,64192,62064,1.1027040299074895,0.30833585874895053
1925,0.1966,32,158,32,537379,139065,64224,62032,1.1014526042326702,0.3084680527307717
1926,0.1967,35,116,35,537495,138949,64259,61997,1.1005338360157142,0.3085256735640421
1927,0.1968,43,134,43,537629,138815,64302,61954,1.0994725003168166,0.3085834964561262
1928,0.1969,37,150,37,537779,138665,64339,61917,1.0982844379673045,0.30868672164002753
1929,0.197,39,152,39,537931,138513,64378,61878,1.0970805347864656,0.30878632273904516
1930,0.1971,31,146,31,538077,138367,64409,61847,1.0959241540996072,0.3089044722147302
1931,0.1972,24,165,24,538242,138202,64433,61823,1.094617285515144,0.3090763654543182
1932,0.1973,24,137,24,538379,138065,64457,61799,1.0935321885692562,0.309205259576512
1933,0.1974,41,147,41,538526,137918,64498,61758,1.0923678874667342,0.30929105150343555
1934,0.1975,41,162,41,538688,137756,64539,61717,1.0910847801292611,0.3094002697106877
1935,0.1976,41,170,41,538858,137586,64580,61676,1.0897383094664808,0.3095221366843653
1936,0.1977,46,151,46,539009,137435,64626,61630,1.0885423267013052,0.3095973676939693
1937,0.1978,38,137,38,539146,137298,64664,61592,1.0874572297554175,0.30967871687867665
1938,0.1979,32,135,32,539281,137163,64696,61560,1.0863879736408566,0.3097779320964357
1939,0.198,41,159,41,539440,137004,64737,61519,1.0851286275503738,0.30988348957047795
1940,0.1981,38,174,38,539614,136830,64775,61481,1.0837504752249398,0.31002314546343873
1941,0.1982,38,164,38,539778,136666,64813,61443,1.08245152705614,0.31014744408381245
1942,0.1983,42,168,42,539946,136498,64855,61401,1.0811208972246864,0.3102643267525354
1943,0.1984,37,158,37,540104,136340,64892,61364,1.079869471549867,0.31038319912596607
1944,0.1985,29,157,29,540261,136183,64921,61335,1.078625966290711,0.31052866067902674
1945,0.1986,32,139,32,540400,136044,64953,61303,1.0775250285134963,0.31063558098172256
1946,0.1987,35,162,35,540562,135882,64988,61268,1.0762419211760232,0.3107684504184631
1947,0.1988,37,154,37,540716,135728,65025,61231,1.0750221771638575,0.31088196020491576
1948,0.1989,34,134,34,540850,135594,65059,61197,1.0739608414649602,0.3109745872524658
1949,0.199,38,156,38,541006,135438,65097,61159,1.0727252566214676,0.3110881651296815
1950,0.1991,33,156,33,541162,135282,65130,61126,1.071489671777975,0.31121950226060036
1951,0.1992,37,133,37,541295,135149,65167,61089,1.070436256494741,0.31130056360134123
1952,0.1993,51,134,51,541429,135015,65218,61038,1.0693749207958434,0.3113341800431516
1953,0.1994,28,146,28,541575,134869,65246,61010,1.068218540108985,0.31146779389316875
1954,0.1995,42,156,42,541731,134713,65288,60968,1.0669829552654924,0.3115683178233962
1955,0.1996,35,152,35,541883,134561,65323,60933,1.0657790520846535,0.31168731521172005
1956,0.1997,40,160,40,542043,134401,65363,60893,1.0645117855785071,0.3118016938564421
1957,0.1998,31,163,31,542206,134238,65394,60862,1.0632207578253707,0.3119528446950282
1958,0.1999,32,153,32,542359,134085,65426,60830,1.0620089342288683,0.31208475489315857
1959,0.2,31,160,31,542519,133925,65457,60799,1.0607416677227222,0.31223167149401204
1960,0.2001,25,137,25,542656,133788,65482,60774,1.0596565707768344,0.3123631541616554
1961,0.2002,29,142,29,542798,133646,65511,60745,1.0585318717526295,0.312488746907007
1962,0.2003,48,143,48,542941,133503,65559,60697,1.0573992523127613,0.3125489186405767
1963,0.2004,34,144,34,543085,133359,65593,60663,1.0562587124572298,0.31266041995237653
1964,0.2005,34,127,34,543212,133232,65627,60629,1.0552528196679762,0.3127446985211053
1965,0.2006,39,131,39,543343,133101,65666,60590,1.054215245216069,0.3128178387225013
1966,0.2007,53,122,53,543465,132979,65719,60537,1.0532489545051325,0.3128268463589574
1967,0.2008,35,125,35,543590,132854,65754,60502,1.0522589025472058,0.31290469393243553
1968,0.2009,44,148,44,543738,132706,65798,60458,1.0510866810290205,0.3129879273570645
1969,0.201,36,150,36,543888,132556,65834,60422,1.0498986186795083,0.313103048015836
1970,0.2011,40,125,40,544013,132431,65874,60382,1.0489085667215816,0.31316353150461845
1971,0.2012,43,172,43,544185,132259,65917,60339,1.0475462552274744,0.3132898576309204
1972,0.2013,46,145,46,544330,132114,65963,60293,1.0463977949562793,0.31336177997681997
1973,0.2014,41,145,41,544475,131969,66004,60252,1.0452493346850842,0.3134517040281759
1974,0.2015,41,140,41,544615,131829,66045,60211,1.0441404764922062,0.31353363882524476
1975,0.2016,43,129,43,544744,131700,66088,60168,1.043118742871626,0.31359059353305396
1976,0.2017,45,141,45,544885,131559,66133,60123,1.0420019642630844,0.31366012458133785
1977,0.2018,25,109,25,544994,131450,66158,60098,1.0411386389557724,0.313749034184643
1978,0.2019,35,150,35,545144,131300,66193,60063,1.0399505766062602,0.31386945229746605
1979,0.202,45,150,45,545294,131150,66238,60018,1.0387625142567483,0.3139542182792099
1980,0.2021,50,134,50,545428,131016,66288,59968,1.0377011785578507,0.3139948896242617
1981,0.2022,37,136,37,545564,130880,66325,59931,1.0366240020276265,0.31408566592072784
1982,0.2023,31,140,31,545704,130740,66356,59900,1.0355151438347485,0.31420478388585815
1983,0.2024,28,126,28,545830,130614,66384,59872,1.0345171714611583,0.3143118129416335
1984,0.2025,42,151,42,545981,130463,66426,59830,1.0333211886959828,0.3144098837056539
1985,0.2026,41,145,41,546126,130318,66467,59789,1.0321727284247877,0.31450183317815755
1986,0.2027,42,147,42,546273,130171,66509,59747,1.031008427322266,0.3145936667403827
1987,0.2028,38,148,38,546421,130023,66547,59709,1.0298362058040806,0.31470178989311237
1988,0.2029,22,157,22,546578,129866,66569,59687,1.0285927005449247,0.3148829087379255
1989,0.203,39,146,39,546724,129720,66608,59648,1.027436319858066,0.31498458028811627
1990,0.2031,48,143,48,546867,129577,66656,59600,1.0263037004181979,0.3150488695771685
1991,0.2032,34,143,34,547010,129434,66690,59566,1.0251710809783297,0.31516402116402115
1992,0.2033,37,146,37,547156,129288,66727,59529,1.0240147002914712,0.31527351880392124
1993,0.2034,39,144,39,547300,129144,66766,59490,1.0228741604359397,0.3153726263558001
1994,0.2035,30,134,30,547434,129010,66796,59460,1.0218128247370422,0.3154878760545445
1995,0.2036,33,143,33,547577,128867,66829,59427,1.020680205297174,0.3156075074086269
1996,0.2037,35,131,35,547708,128736,66864,59392,1.0196426308452669,0.3156999489709134
1997,0.2038,40,144,40,547852,128592,66904,59352,1.018502090989735,0.31579619461116076
1998,0.2039,31,152,31,548004,128440,66935,59321,1.0172981878088962,0.31593887974606016
1999,0.204,31,129,31,548133,128311,66966,59290,1.0162764541883158,0.31604309145473636
2000,0.2041,30,133,30,548266,128178,66996,59260,1.0152230389050818,0.3161578762043983
2001,0.2042,38,137,38,548403,128041,67034,59222,1.014137941959194,0.3162504071813439
2002,0.2043,36,134,36,548537,127907,67070,59186,1.0130766062602965,0.3163453469664819
2003,0.2044,31,159,31,548696,127748,67101,59155,1.0118172601698137,0.31650107274896605
2004,0.2045,46,139,46,548835,127609,67147,59109,1.0107163223925992,0.3165683008601206
2005,0.2046,42,149,42,548984,127460,67189,59067,1.0095361804587504,0.3166672921346507
2006,0.2047,41,158,41,549142,127302,67230,59026,1.008284754783931,0.31678545360869004
2007,0.2048,35,124,35,549266,127178,67265,58991,1.0073026232416677,0.31686800702587437
2008,0.2049,27,149,27,549415,127029,67292,58964,1.0061224813078191,0.31702268364938463
2009,0.205,42,130,42,549545,126899,67334,58922,1.0050928272715751,0.31709010284090605
2010,0.2051,36,127,36,549672,126772,67370,58886,1.0040869344823216,0.31717458983722757
2011,0.2052,32,154,32,549826,126618,67402,58854,1.0028671904701558,0.31732013457556935
2012,0.2053,30,123,30,549949,126495,67432,58824,1.001892979343556,0.31742023214025544
2013,0.2054,32,123,32,550072,126372,67464,58792,1.000918768216956,0.31751312350132854
2014,0.2055,35,140,35,550212,126232,67499,58757,0.999809910024078,0.3176242911740698
2015,0.2056,37,130,37,550342,126102,67536,58720,0.9987802559878343,0.31771109499951306
2016,0.2057,32,148,32,550490,125954,67568,58688,0.997608034469649,0.3178475103172626
2017,0.2058,35,131,35,550621,125823,67603,58653,0.9965704600177417,0.31794379756716323
2018,0.2059,27,154,27,550775,125669,67630,58626,0.995350716005576,0.3181095526194417
2019,0.206,39,130,39,550905,125539,67669,58587,0.9943210619693321,0.3181897179105612
2020,0.2061,37,126,37,551031,125413,67706,58550,0.993323089595742,0.3182705217897077
2021,0.2062,37,148,37,551179,125265,67743,58513,0.9921508680775567,0.31838957873086005
2022,0.2063,43,145,43,551324,125120,67786,58470,0.9910024078063617,0.3184813987689961
2023,0.2064,41,139,41,551463,124981,67827,58429,0.9899014700291471,0.31857041600785124
2024,0.2065,28,140,28,551603,124841,67855,58401,0.9887926118362692,0.318709684460986
2025,0.2066,40,147,40,551750,124694,67895,58361,0.9876283107337473,0.3188167490644888
2026,0.2067,32,153,32,551903,124541,67927,58329,0.986416487137245,0.31896429157324874
2027,0.2068,33,157,33,552060,124384,67960,58296,0.985172981878089,0.3191153930370046
2028,0.2069,37,157,37,552217,124227,67997,58259,0.9839294766189329,0.3192518878160516
2029,0.207,29,136,29,552353,124091,68026,58230,0.9828523000887086,0.31938174977100825
2030,0.2071,35,124,35,552477,123967,68061,58195,0.9818701685464453,0.319468385283429
2031,0.2072,26,126,26,552603,123841,68087,58169,0.9808721961728551,0.3195923300917532
2032,0.2073,41,149,41,552752,123692,68128,58128,0.9796920542390065,0.31970080299197007
2033,0.2074,38,142,38,552894,123550,68166,58090,0.9785673552148016,0.31980841224399914
2034,0.2075,31,134,31,553028,123416,68197,58059,0.9775060195159042,0.31992836478853837
2035,0.2076,26,136,26,553164,123280,68223,58033,0.9764288429856799,0.3200708167643798
2036,0.2077,37,152,37,553316,123128,68260,57996,0.9752249398048409,0.32020052560676665
2037,0.2078,41,143,41,553459,122985,68301,57955,0.9740923203649727,0.3202995468110976
2038,0.2079,43,131,43,553590,122854,68344,57912,0.9730547459130655,0.32036998108051296
2039,0.208,31,156,31,553746,122698,68375,57881,0.9718191610695729,0.32053007271055883
2040,0.2081,37,134,37,553880,122564,68412,57844,0.9707578253706755,0.3206287969491375
2041,0.2082,39,158,39,554038,122406,68451,57805,0.9695063996958561,0.3207628835087758
2042,0.2083,44,129,44,554167,122277,68495,57761,0.9684846660752756,0.3208267143603017
2043,0.2084,39,112,39,554279,122165,68534,57722,0.9675975795209732,0.3208792186205785
2044,0.2085,39,123,39,554402,122042,68573,57683,0.9666233683943734,0.32095145360968147
2045,0.2086,43,143,43,554545,121899,68616,57640,0.9654907489545052,0.32104445273728827
2046,0.2087,36,155,36,554700,121744,68652,57604,0.964263084526676,0.32118562794120925
2047,0.2088,34,126,34,554826,121618,68686,57570,0.9632651121530857,0.32128267517914144
2048,0.2089,42,142,42,554968,121476,68728,57528,0.962140413128881,0.32137829322249784
2049,0.209,36,154,36,555122,121322,68764,57492,0.9609206691167153,0.32151844933841867
2050,0.2091,29,129,29,555251,121193,68793,57463,0.9598989354961348,0.3216404710728999
2051,0.2092,34,133,34,555384,121060,68827,57429,0.9588455202129008,0.32175092022477575
2052,0.2093,30,154,30,555538,120906,68857,57399,0.957625776200735,0.32191469672751744
2053,0.2094,26,125,26,555663,120781,68883,57373,0.9566357242428083,0.322041604454573
2054,0.2095,51,132,51,555795,120649,68934,57322,0.9555902293752376,0.322086182580308
2055,0.2096,26,130,26,555925,120519,68960,57296,0.9545605753389937,0.3222225346568062
2056,0.2097,38,130,38,556055,120389,68998,57258,0.95353092130275,0.322313351759388
2057,0.2098,33,134,33,556189,120255,69031,57225,0.9524695856038525,0.32243069641649763
2058,0.2099,35,123,35,556312,120132,69066,57190,0.9514953744772525,0.32252061221957795
2059,0.21,44,136,44,556448,119996,69110,57146,0.9504181979470283,0.32259994806426484
2060,0.2101,43,110,43,556558,119886,69153,57103,0.9495469522240527,0.32263587002582084
2061,0.2102,36,134,36,556692,119752,69189,57067,0.9484856165251553,0.32274246545902874
2062,0.2103,28,143,28,556835,119609,69217,57039,0.9473529970852871,0.32289638150446087
2063,0.2104,42,136,42,556971,119473,69259,56997,0.9462758205550628,0.3229840766135887
2064,0.2105,37,140,37,557111,119333,69296,56960,0.9451669623621848,0.3230984781017964
2065,0.2106,41,133,41,557244,119200,69337,56919,0.9441135470789507,0.32318489203322753
2066,0.2107,31,107,31,557351,119093,69368,56888,0.9432660626029654,0.3232621703479353
2067,0.2108,45,142,45,557493,118951,69413,56843,0.9421413635787607,0.32335005745361045
2068,0.2109,62,144,62,557637,118807,69475,56781,0.941000823723229,0.32337631273207734
2069,0.211,35,128,35,557765,118679,69510,56746,0.939987010518312,0.32347726948838534
2070,0.2111,50,118,50,557883,118561,69560,56696,0.9390524014700291,0.32350205697917916
2071,0.2112,26,125,26,558008,118436,69586,56670,0.9380623495121024,0.3236325425742122
2072,0.2113,40,111,40,558119,118325,69626,56630,0.9371831833734634,0.32368323283129946
2073,0.2114,45,117,45,558236,118208,69671,56585,0.936256494740844,0.32372577849227374
2074,0.2115,35,145,35,558381,118063,69706,56550,0.935108034469649,0.3238590482953732
2075,0.2116,35,135,35,558516,117928,69741,56515,0.9340387783550881,0.32397402016704596
2076,0.2117,23,123,23,558639,117805,69764,56492,0.9330645672284882,0.3241134385560279
2077,0.2118,36,133,36,558772,117672,69800,56456,0.9320111519452541,0.3242212625195259
2078,0.2119,38,120,38,558892,117552,69838,56418,0.9310607020656444,0.3242972926366615
2079,0.212,40,140,40,559032,117412,69878,56378,0.9299518438727664,0.32440301513320674
2080,0.2121,30,122,30,559154,117290,69908,56348,0.92898555316183,0.32451421923772444
2081,0.2122,29,133,29,559287,117157,69937,56319,0.9279321378785959,0.32465009569047015
2082,0.2123,34,131,34,559418,117026,69971,56285,0.9268945634266886,0.32476299830939753
2083,0.2124,46,145,46,559563,116881,70017,56239,0.9257461031554935,0.32485559149722737
2084,0.2125,39,117,39,559680,116764,70056,56200,0.9248194145228742,0.3249231053860919
2085,0.2126,40,110,40,559790,116654,70096,56160,0.9239481687998986,0.3249736711146088
2086,0.2127,38,111,38,559901,116543,70134,56122,0.9230690026612597,0.32503402542495585
2087,0.2128,51,137,51,560038,116406,70185,56071,0.9219839057153719,0.3250926210451249
2088,0.2129,40,104,40,560142,116302,70225,56031,0.9211601824863769,0.3251321569287368
2089,0.213,33,115,33,560257,116187,70258,55998,0.9202493346850843,0.3252199668960711
2090,0.2131,32,114,32,560371,116073,70290,55966,0.919346407299455,0.32530995878841423
2091,0.2132,42,117,42,560488,115956,70332,55924,0.9184197186668356,0.3253665347917151
2092,0.2133,31,125,31,560613,115831,70363,55893,0.9174296667089089,0.3254815867321982
2093,0.2134,34,136,34,560749,115695,70397,55859,0.9163524901786846,0.3256059316600021
2094,0.2135,39,124,39,560873,115571,70436,55820,0.9153703586364212,0.3256880466302198
2095,0.2136,33,102,33,560975,115469,70469,55787,0.914562476238753,0.3257520904377073
2096,0.2137,43,135,43,561110,115334,70512,55744,0.9134932201241921,0.3258396754696688
2097,0.2138,40,108,40,561218,115226,70552,55704,0.9126378152325434,0.3258877903235243
2098,0.2139,37,136,37,561354,115090,70589,55667,0.9115606387023191,0.3260012766680136
2099,0.214,27,108,27,561462,114982,70616,55640,0.9107052338106704,0.32610097173869723
2100,0.2141,41,104,41,561566,114878,70657,55599,0.9098815105816753,0.3261378367756354
2101,0.2142,35,147,35,561713,114731,70692,55564,0.9087172094791535,0.32628086555682784
2102,0.2143,43,136,43,561849,114595,70735,55521,0.9076400329489291,0.32637141715065016
2103,0.2144,30,114,30,561963,114481,70765,55491,0.9067371055633,0.3264714188219236
2104,0.2145,35,114,35,562077,114367,70800,55456,0.9058341781776708,0.32655176271765307
2105,0.2146,29,118,29,562195,114249,70829,55427,0.904899569129388,0.32666375916452534
2106,0.2147,36,128,36,562323,114121,70865,55391,0.903885755924471,0.32676742649487944
2107,0.2148,27,121,27,562444,114000,70892,55364,0.9029273856291978,0.32689355471056425
2108,0.2149,29,125,29,562569,113875,70921,55335,0.901937333671271,0.3270196796879617
2109,0.215,30,115,30,562684,113760,70951,55305,0.9010264858699785,0.327122704285334
2110,0.2151,36,136,36,562820,113624,70987,55269,0.8999493093397541,0.3272426921186787
2111,0.2152,26,116,26,562936,113508,71013,55243,0.8990305411227981,0.32736398599119415
2112,0.2153,28,128,28,563064,113380,71041,55215,0.8980167279178811,0.3275008155639254
2113,0.2154,33,107,33,563171,113273,71074,55182,0.8971692434418959,0.32757709774123656
2114,0.2155,27,120,27,563291,113153,71101,55155,0.8962187935622862,0.3277027829930841
2115,0.2156,28,118,28,563409,113035,71129,55127,0.8952841845140033,0.3278207918554727
2116,0.2157,42,135,42,563544,112900,71171,55085,0.8942149283994424,0.3279161829925291
2117,0.2158,45,152,45,563696,112748,71216,55040,0.8930110252186034,0.3280329940162586
2118,0.2159,41,120,41,563816,112628,71257,54999,0.8920605753389937,0.3281034678184302
2119,0.216,47,115,47,563931,112513,71304,54952,0.8911497275377012,0.3281402084017556
2120,0.2161,43,115,43,564046,112398,71347,54909,0.8902388797364086,0.3281930821782711
2121,0.2162,41,112,41,564158,112286,71388,54868,0.8893517931821062,0.3282482022566017
2122,0.2163,42,155,42,564313,112131,71430,54826,0.888124128754277,0.32838395515012847
2123,0.2164,40,123,40,564436,112008,71470,54786,0.8871499176276771,0.3284650526997374
2124,0.2165,29,106,29,564542,111902,71499,54757,0.8863103535673552,0.32855711362722684
2125,0.2166,25,108,25,564650,111794,71524,54732,0.8854549486757065,0.3286693969710436
2126,0.2167,25,129,25,564779,111665,71549,54707,0.8844332150551261,0.3288233596999495
2127,0.2168,37,111,37,564890,111554,71586,54670,0.8835540489164871,0.32889354124554815
2128,0.2169,31,120,31,565010,111434,71617,54639,0.8826035990368775,0.3290059190837764
2129,0.217,28,125,28,565135,111309,71645,54611,0.8816135470789507,0.32914054966248796
2130,0.2171,23,116,23,565251,111193,71668,54588,0.8806947788619947,0.32927778213426145
2131,0.2172,25,107,25,565358,111086,71693,54563,0.8798472943860094,0.3293892507651721
2132,0.2173,30,128,30,565486,110958,71723,54533,0.8788334811810924,0.32952245137197794
2133,0.2174,25,112,25,565598,110846,71748,54508,0.87794639462679,0.3296442783361757
2134,0.2175,43,107,43,565705,110739,71791,54465,0.8770989101508048,0.32968330064647344
2135,0.2176,32,93,32,565798,110646,71823,54433,0.8763623114941073,0.3297390946153054
2136,0.2177,37,106,37,565904,110540,71860,54396,0.8755227474337853,0.32980064994907116
2137,0.2178,41,127,41,566031,110413,71901,54355,0.8745168546445318,0.3298880850650612
2138,0.2179,35,101,35,566132,110312,71936,54320,0.873716892662527,0.32994800524806844
2139,0.218,29,142,29,566274,110170,71965,54291,0.8725921936383222,0.33011473844862915
2140,0.2181,31,108,31,566382,110062,71996,54260,0.8717367887466734,0.33020532856221324
2141,0.2182,50,137,50,566519,109925,72046,54210,0.8706516918007857,0.33027690620525785
2142,0.2183,35,118,35,566637,109807,72081,54175,0.8697170827525028,0.3303716261540901
2143,0.2184,37,121,37,566758,109686,72118,54138,0.8687587124572298,0.33046440082039263
2144,0.2185,28,144,28,566902,109542,72146,54110,0.8676181726016982,0.33064062767335567
2145,0.2186,25,100,25,567002,109442,72171,54085,0.8668261310353568,0.3307404893381521
2146,0.2187,35,111,35,567113,109331,72206,54050,0.8659469648967177,0.33082182138681976
2147,0.2188,47,115,47,567228,109216,72253,54003,0.8650361170954252,0.33086221579595515
2148,0.2189,35,92,35,567320,109124,72288,53968,0.8643074388543911,0.3309052559291688
2149,0.219,32,115,32,567435,109009,72320,53936,0.8633965910530985,0.3310073951333272
2150,0.2191,33,126,33,567561,108883,72353,53903,0.8623986186795083,0.33112798397896626
2151,0.2192,31,91,31,567652,108792,72384,53872,0.8616778608541377,0.33118575714355974
2152,0.2193,28,131,28,567783,108661,72412,53844,0.8606402864022303,0.3313374973077751
2153,0.2194,36,110,36,567893,108551,72448,53808,0.8597690406792549,0.33141371898077715
2154,0.2195,34,112,34,568005,108439,72482,53774,0.8588819541249525,0.3315024073286358
2155,0.2196,29,114,29,568119,108325,72511,53745,0.8579790267393232,0.33161596840871227
2156,0.2197,44,126,44,568245,108199,72555,53701,0.8569810543657331,0.331692402717727
2157,0.2198,22,106,22,568351,108093,72577,53679,0.8561414903054112,0.33181885616794005
2158,0.2199,37,98,37,568449,107995,72614,53642,0.8553652895703967,0.3318670848877423
2159,0.22,35,100,35,568549,107895,72649,53607,0.8545732480040552,0.33192777798417356
2160,0.2201,28,124,28,568673,107771,72677,53579,0.8535911164617919,0.3320669352339634
2161,0.2202,37,114,37,568787,107657,72714,53542,0.8526881890761627,0.3321484624594445
2162,0.2203,33,118,33,568905,107539,72747,53509,0.8517535800278798,0.3322549798817744
2163,0.2204,26,107,26,569012,107432,72773,53483,0.8509060955518946,0.33236802038343227
2164,0.2205,32,111,32,569123,107321,72805,53451,0.8500269294132556,0.3324646082651208
2165,0.2206,32,109,32,569232,107212,72837,53419,0.8491636041059435,0.33255722743430594
2166,0.2207,34,128,34,569360,107084,72871,53385,0.8481497909010265,0.3326810785883878
2167,0.2208,37,114,37,569474,106970,72908,53348,0.8472468635153972,0.3327636322808418
2168,0.2209,37,113,37,569587,106857,72945,53311,0.8463518565454315,0.33284426352330054
2169,0.221,43,126,43,569713,106731,72988,53268,0.8453538841718413,0.332927080794255
2170,0.2211,41,110,41,569823,106621,73029,53227,0.8444826384488658,0.33298508583153996
2171,0.2212,29,104,29,569927,106517,73058,53198,0.8436589152198707,0.3330808001753123
2172,0.2213,38,101,38,570028,106416,73096,53160,0.842858953237866,0.33313280192510153
2173,0.2214,38,109,38,570137,106307,73134,53122,0.8419956279305538,0.333201613257312
2174,0.2215,33,113,33,570250,106194,73167,53089,0.841100620960588,0.3332998499526001
2175,0.2216,34,119,34,570369,106075,73201,53055,0.8401580914966418,0.3334066486520455
2176,0.2217,31,133,31,570502,105942,73232,53024,0.8391046762134077,0.3335556030849364
2177,0.2218,26,104,26,570606,105838,73258,52998,0.8382809529844126,0.33366491223652067
2178,0.2219,34,116,34,570722,105722,73292,52964,0.8373621847674566,0.3337660537161438
2179,0.222,23,104,23,570826,105618,73315,52941,0.8365384615384616,0.3338883317881672
2180,0.2221,31,100,31,570926,105518,73346,52910,0.8357464199721202,0.3339687428989825
2181,0.2222,43,121,43,571047,105397,73389,52867,0.834788049676847,0.33404311782843854
2182,0.2223,40,115,40,571162,105282,73429,52827,0.8338772018755545,0.33411760241352484
2183,0.2224,33,125,33,571287,105157,73462,52794,0.8328871499176277,0.33424289811397206
2184,0.2225,33,122,33,571409,105035,73495,52761,0.8319208592066911,0.33436208775887855
2185,0.2226,32,117,32,571526,104918,73527,52729,0.8309941705740718,0.33447512480415104
2186,0.2227,37,128,37,571654,104790,73564,52692,0.8299803573691548,0.33459061988036726
2187,0.2228,33,114,33,571768,104676,73597,52659,0.8290774299835255,0.33469348841643626
2188,0.2229,30,133,30,571901,104543,73627,52629,0.8280240147002915,0.3348497187794264
2189,0.223,29,119,29,572020,104424,73656,52600,0.8270814852363452,0.3349806399021806
2190,0.2231,29,94,29,572114,104330,73685,52571,0.8263369661639843,0.33505841262961994
2191,0.2232,29,100,29,572214,104230,73714,52542,0.8255449245976428,0.3351491337738882
2192,0.2233,33,115,33,572329,104115,73747,52509,0.8246340767963503,0.33525513331290224
2193,0.2234,35,113,35,572442,104002,73782,52474,0.8237390698263845,0.3353485518545975
2194,0.2235,23,82,23,572524,103920,73805,52451,0.8230895957419846,0.335426645605643
2195,0.2236,24,109,24,572633,103811,73829,52427,0.8222262704346724,0.335558570898245
2196,0.2237,35,100,35,572733,103711,73864,52392,0.8214342288683311,0.33562455558189147
2197,0.2238,34,118,34,572851,103593,73898,52358,0.8204996198200482,0.3357336599316452
2198,0.2239,32,112,32,572963,103481,73930,52326,0.8196125332657458,0.3358385695122812
2199,0.224,31,109,31,573072,103372,73961,52295,0.8187492079584336,0.3359414647934373
2200,0.2241,40,95,40,573167,103277,74001,52255,0.8179967684704094,0.33597587634698967
2201,0.2242,25,120,25,573287,103157,74026,52230,0.8170463185907997,0.33612850495858726
2202,0.2243,30,94,30,573381,103063,74056,52200,0.8163017995184387,0.33620373173260854
2203,0.2244,32,108,32,573489,102955,74088,52168,0.81544639462679,0.3363008709217846
2204,0.2245,29,107,29,573596,102848,74117,52139,0.8145989101508048,0.3364088600979437
2205,0.2246,34,110,34,573706,102738,74151,52105,0.8137276644278292,0.33650213442002547
2206,0.2247,34,118,34,573824,102620,74185,52071,0.8127930553795463,0.3366129897666962
2207,0.2248,38,97,38,573921,102523,74223,52033,0.8120247750601952,0.3366611454747794
2208,0.2249,27,128,27,574049,102395,74250,52006,0.8110109618552782,0.33682424336629946
2209,0.225,30,120,30,574169,102275,74280,51976,0.8100605119756685,0.33695729687327797
2210,0.2251,34,121,34,574290,102154,74314,51942,0.8091021416803954,0.33707558924306924
2211,0.2252,24,107,24,574397,102047,74338,51918,0.8082546572044101,0.33720650797259116
2212,0.2253,28,119,28,574516,101928,74366,51890,0.8073121277404638,0.3373467344524048
2213,0.2254,36,119,36,574635,101809,74402,51854,0.8063695982765176,0.3374527374839747
2214,0.2255,24,121,24,574756,101688,74426,51830,0.8054112279812444,0.3376151330788572
2215,0.2256,30,120,30,574876,101568,74456,51800,0.8044607781016347,0.33774972614887067
2216,0.2257,31,107,31,574983,101461,74487,51769,0.8036132936256495,0.33785159564054035
2217,0.2258,34,107,34,575090,101354,74521,51735,0.8027658091496642,0.33794067503217085
2218,0.2259,35,93,35,575183,101261,74556,51700,0.8020292104929667,0.33799465223161457
2219,0.226,37,106,37,575289,101155,74593,51663,0.8011896464326448,0.3380688138831813
2220,0.2261,32,110,32,575399,101045,74625,51631,0.8003184007096692,0.3381736487725641
2221,0.2262,27,116,27,575515,100929,74652,51604,0.7993996324927132,0.3383136763847823
2222,0.2263,24,105,24,575620,100824,74676,51580,0.7985679888480548,0.3384425605627149
2223,0.2264,26,92,26,575712,100732,74702,51554,0.7978393106070206,0.3385340740448892
2224,0.2265,31,116,31,575828,100616,74733,51523,0.7969205423900646,0.3386574119719467
2225,0.2266,34,115,34,575943,100501,74767,51489,0.796009694588772,0.33876570827028096
2226,0.2267,35,103,35,576046,100398,74802,51454,0.7951938917754404,0.33884308405552777
2227,0.2268,24,120,24,576166,100278,74826,51430,0.7942434418958307,0.33900651251087616
2228,0.2269,29,130,29,576296,100148,74855,51401,0.7932137878595868,0.3391708292367485
2229,0.227,37,112,37,576408,100036,74892,51364,0.7923267013052845,0.33926023778071335
2230,0.2271,33,109,33,576517,99927,74925,51331,0.7914633759979723,0.33936056274709436
2231,0.2272,37,106,37,576623,99821,74962,51294,0.7906238119376505,0.3394368527280548
2232,0.2273,24,105,24,576728,99716,74986,51270,0.789792168292992,0.33956790695826106
2233,0.2274,34,92,34,576820,99624,75020,51236,0.789063490051958,0.33962614344425296
2234,0.2275,44,103,44,576923,99521,75064,51192,0.7882476872386263,0.3396654568617173
2235,0.2276,38,119,38,577042,99402,75102,51154,0.78730515777468,0.3397672626796674
2236,0.2277,29,122,29,577164,99280,75131,51125,0.7863388670637435,0.33991556131777534
2237,0.2278,27,102,27,577266,99178,75158,51098,0.7855309846660753,0.3400276823977215
2238,0.2279,33,119,33,577385,99059,75191,51065,0.784588455202129,0.3401521408968586
2239,0.228,34,87,34,577472,98972,75225,51031,0.783899379039412,0.34019986266941327
2240,0.2281,24,103,24,577575,98869,75249,51007,0.7830835762260804,0.34032800448370654
2241,0.2282,34,110,34,577685,98759,75283,50973,0.7822123305031048,0.3404282317741031
2242,0.2283,36,108,36,577793,98651,75319,50937,0.7813569256114561,0.34051528197448994
2243,0.2284,30,105,30,577898,98546,75349,50907,0.7805252819667976,0.3406221353870448
2244,0.2285,27,105,27,578003,98441,75376,50880,0.7796936383221391,0.3407424273879762
2245,0.2286,28,110,28,578113,98331,75404,50852,0.7788223925991636,0.3408699382637432
2246,0.2287,25,94,25,578207,98237,75429,50827,0.7780778735268027,0.3409743465893844
2247,0.2288,24,107,24,578314,98130,75453,50803,0.7772303890508174,0.34111311797922556
2248,0.2289,26,102,26,578416,98028,75479,50777,0.7764225066531492,0.3412318134471288
2249,0.229,25,83,25,578499,97945,75504,50752,0.7757651121530857,0.3413115261235936
2250,0.2291,19,131,19,578630,97814,75523,50733,0.7747275377011785,0.3415282705137095
2251,0.2292,29,113,29,578743,97701,75552,50704,0.7738325307312127,0.34165964758599776
2252,0.2293,39,104,39,578847,97597,75591,50665,0.7730088075022177,0.34172613346643105
2253,0.2294,39,116,39,578963,97481,75630,50626,0.7720900392852617,0.34182044062738426
2254,0.2295,32,118,32,579081,97363,75662,50594,0.7711554302369789,0.3419507018931176
2255,0.2296,29,121,29,579202,97242,75691,50565,0.7701970599417057,0.3421015242850474
2256,0.2297,26,93,26,579295,97149,75717,50539,0.7694604612850082,0.34220112669952873
2257,0.2298,36,90,36,579385,97059,75753,50503,0.7687476238753009,0.34224935959122266
2258,0.2299,23,119,23,579504,96940,75776,50480,0.7678050944113547,0.34242300908967577
2259,0.23,33,120,33,579624,96820,75809,50447,0.766854644531745,0.3425546795955645
2260,0.2301,25,109,25,579733,96711,75834,50422,0.7659913192244329,0.34269674376244624
2261,0.2302,32,115,32,579848,96596,75866,50390,0.7650804714231403,0.34282176533819547
2262,0.2303,36,104,36,579952,96492,75902,50354,0.7642567481941452,0.3429034498726557
2263,0.2304,30,107,30,580059,96385,75932,50324,0.76340926371816,0.3430191740111377
2264,0.2305,25,91,25,580150,96294,75957,50299,0.7626885058927892,0.34312006712462395
2265,0.2306,42,109,42,580259,96185,75999,50257,0.7618251805854771,0.34318706382048864
2266,0.2307,25,83,25,580342,96102,76024,50232,0.7611677860854138,0.34326950674484397
2267,0.2308,31,109,31,580451,95993,76055,50201,0.7603044607781017,0.34338618547956823
2268,0.2309,22,89,22,580540,95904,76077,50179,0.7595995437840578,0.3434965054113073
2269,0.231,25,104,25,580644,95800,76102,50154,0.7587758205550628,0.3436288145580114
2270,0.2311,25,96,25,580740,95704,76127,50129,0.758015460651375,0.3437424999828571
2271,0.2312,31,97,31,580837,95607,76158,50098,0.7572471803320239,0.34383171476613705
2272,0.2313,31,103,31,580940,95504,76189,50067,0.7564313775186922,0.34393526183099654
2273,0.2314,30,102,30,581042,95402,76219,50037,0.755623495121024,0.3440411443973075
2274,0.2315,30,91,30,581133,95311,76249,50007,0.7549027372956533,0.3441211687471614
2275,0.2316,34,87,34,581220,95224,76283,49973,0.7542136611329363,0.34417377769513147
2276,0.2317,45,110,45,581330,95114,76328,49928,0.7533424154099607,0.34423132609864726
2277,0.2318,36,99,36,581429,95015,76364,49892,0.7525582942592828,0.3443035878183939
2278,0.2319,40,94,40,581523,94921,76404,49852,0.7518137751869218,0.3443459761143307
2279,0.232,34,96,34,581619,94825,76438,49818,0.7510534152832341,0.3444204005724439
2280,0.2321,28,89,28,581708,94736,76466,49790,0.7503484982891903,0.3445054869020107
2281,0.2322,32,90,32,581798,94646,76498,49758,0.749635660879483,0.3445749425223678
2282,0.2323,31,101,31,581899,94545,76529,49727,0.7488356988974781,0.3446753354774315
2283,0.2324,30,87,30,581986,94458,76559,49697,0.7481466227347611,0.34474697374353996
2284,0.2325,36,95,36,582081,94363,76595,49661,0.7473941832467368,0.3448105871243682
2285,0.2326,26,96,26,582177,94267,76621,49635,0.7466338233430491,0.3449222387458131
2286,0.2327,22,118,22,582295,94149,76643,49613,0.7456992142947662,0.34510510426955665
2287,0.2328,30,89,30,582384,94060,76673,49583,0.7449942973007223,0.3451821529764764
2288,0.2329,25,105,25,582489,93955,76698,49558,0.7441626536560638,0.3453206329740163
2289,0.233,26,99,26,582588,93856,76724,49532,0.7433785325053859,0.34544034368287446
2290,0.2331,28,81,28,582669,93775,76752,49504,0.7427369788366494,0.34550771571549216
2291,0.2332,16,77,16,582746,93698,76768,49488,0.7421271068305665,0.34562038188091015
2292,0.2333,30,84,30,582830,93614,76798,49458,0.7414617919148397,0.3456860881234623
2293,0.2334,32,94,32,582924,93520,76830,49426,0.7407172728424788,0.3457669329676941
2294,0.2335,32,93,32,583017,93427,76862,49394,0.7399806741857813,0.3458454989112245
2295,0.2336,31,91,31,583108,93336,76893,49363,0.7392599163604106,0.34592393779914365
2296,0.2337,26,101,26,583209,93235,76919,49337,0.7384599543784057,0.3460497152316023
2297,0.2338,36,88,36,583297,93147,76955,49301,0.7377629578000253,0.34609822531730877
2298,0.2339,27,95,27,583392,93052,76982,49274,0.737010518312001,0.3462051908997653
2299,0.234,28,106,28,583498,92946,77010,49246,0.7361709542516791,0.3463345335883875
2300,0.2341,40,117,40,583615,92829,77050,49206,0.7352442656190596,0.3464357376702925
2301,0.2342,26,87,26,583702,92742,77076,49180,0.7345551894563427,0.34652837474105497
2302,0.2343,36,86,36,583788,92656,77112,49144,0.733874033709289,0.34657263751763046
2303,0.2344,29,90,29,583878,92566,77141,49115,0.7331611962995818,0.34665904390849867
2304,0.2345,20,105,20,583983,92461,77161,49095,0.7323295526549233,0.34682387182457824
2305,0.2346,27,102,27,584085,92359,77188,49068,0.7315216702572551,0.34694930953778275
2306,0.2347,25,104,25,584189,92255,77213,49043,0.7306979470282601,0.34708913077325937
2307,0.2348,28,84,28,584273,92171,77241,49015,0.7300326321125332,0.3471661496182341
2308,0.2349,30,84,30,584357,92087,77271,48985,0.7293673171968065,0.3472340365203584
2309,0.235,30,83,30,584440,92004,77301,48955,0.7287099226967432,0.34729956937832984
2310,0.2351,31,98,31,584538,91906,77332,48924,0.7279337219617286,0.34739757154015477
2311,0.2352,31,96,31,584634,91810,77363,48893,0.7271733620580408,0.3474908139840657
2312,0.2353,24,91,24,584725,91719,77387,48869,0.7264526042326701,0.3476043474549748
2313,0.2354,26,87,26,584812,91632,77413,48843,0.7257635280699531,0.34769887880405764
2314,0.2355,28,96,28,584908,91536,77441,48815,0.7250031681662653,0.3478065706692507
2315,0.2356,32,103,32,585011,91433,77473,48783,0.7241873653529337,0.3479132196040395
2316,0.2357,26,106,26,585117,91327,77499,48757,0.7233478012926119,0.34805545244282005
2317,0.2358,37,114,37,585231,91213,77536,48720,0.7224448739069826,0.3481666225979576
2318,0.2359,25,98,25,585329,91115,77561,48695,0.721668673171968,0.3482941134396681
2319,0.236,23,83,23,585412,91032,77584,48672,0.7210112786719047,0.34839374677890395
2320,0.2361,28,115,28,585527,90917,77612,48644,0.720100430870612,0.3485500963736287
2321,0.2362,23,92,23,585619,90825,77635,48621,0.719371752629578,0.34867260444903403
2322,0.2363,20,88,20,585707,90737,77655,48601,0.7186747560511976,0.3487993225107293
2323,0.2364,23,103,23,585810,90634,77678,48578,0.717858953237866,0.348949803177887
2324,0.2365,34,100,34,585910,90534,77712,48544,0.7170669116715245,0.349041545032284
2325,0.2366,22,112,22,586022,90422,77734,48522,0.7161798251172221,0.349219829571626
2326,0.2367,36,105,36,586127,90317,77770,48486,0.7153481814725636,0.3493152165299021
2327,0.2368,33,107,33,586234,90210,77803,48453,0.7145006969965784,0.3494299128101945
2328,0.2369,27,100,27,586334,90110,77830,48426,0.713708655430237,0.34955535023387424
2329,0.237,26,83,26,586417,90027,77856,48400,0.7130512609301736,0.34964277200257177
2330,0.2371,30,98,30,586515,89929,77886,48370,0.7122750601951591,0.349749455889052
2331,0.2372,25,87,25,586602,89842,77911,48345,0.711585984032442,0.34985201212849254
2332,0.2373,33,81,33,586683,89761,77944,48312,0.7109444303637055,0.34990186350698543
2333,0.2374,24,104,24,586787,89657,77968,48288,0.7101207071347104,0.3500525571785857
2334,0.2375,27,96,27,586883,89561,77995,48261,0.7093603472310227,0.3501690586408556
2335,0.2376,22,96,22,586979,89465,78017,48239,0.708599987327335,0.35030935920525186
2336,0.2377,37,100,37,587079,89365,78054,48202,0.7078079457609935,0.35038926486730104
2337,0.2378,27,88,27,587167,89277,78081,48175,0.7071109491826131,0.3504859878357536
2338,0.2379,32,86,32,587253,89191,78113,48143,0.7064297934355594,0.3505541235236722
2339,0.238,21,95,21,587348,89096,78134,48122,0.7056773539475352,0.3506974303662785
2340,0.2381,28,91,28,587439,89005,78162,48094,0.7049565961221644,0.3507975988154545
2341,0.2382,26,91,26,587530,88914,78188,48068,0.7042358382967938,0.35090741849294066
2342,0.2383,27,80,27,587610,88834,78215,48041,0.7036022050437207,0.3509844748858447
2343,0.2384,26,87,26,587697,88747,78241,48015,0.7029131288810037,0.3510843655401354
2344,0.2385,37,100,37,587797,88647,78278,47978,0.7021210873146623,0.3511655992680695
2345,0.2386,27,88,27,587885,88559,78305,47951,0.7014240907362819,0.351263643689107
2346,0.2387,27,82,27,587967,88477,78332,47924,0.7007746166518819,0.35134639775368215
2347,0.2388,23,92,23,588059,88385,78355,47901,0.7000459384108478,0.3514741059243062
2348,0.2389,30,83,30,588142,88302,78385,47871,0.6993885439107844,0.35154546055385427
2349,0.239,27,76,27,588218,88226,78412,47844,0.698786592320365,0.35161314029543617
2350,0.2391,31,77,31,588295,88149,78443,47813,0.6981767203142821,0.3516644356511378
2351,0.2392,27,89,27,588384,88060,78470,47786,0.6974718033202383,0.3517659702898871
2352,0.2393,26,87,26,588471,87973,78496,47760,0.6967827271575212,0.3518672688292456
2353,0.2394,26,82,26,588553,87891,78522,47734,0.6961332530731212,0.3519557603686636
2354,0.2395,31,85,31,588638,87806,78553,47703,0.695460017741731,0.3520282785645234
2355,0.2396,32,99,32,588737,87707,78585,47671,0.6946758965910531,0.35213254738583816
2356,0.2397,32,92,32,588829,87615,78617,47639,0.693947218350019,0.352218788353764
2357,0.2398,30,94,30,588923,87521,78647,47609,0.6932026992776581,0.35231998815955007
2358,0.2399,27,57,27,588980,87464,78674,47582,0.6927512355848435,0.3523392029382581
2359,0.24,26,92,26,589072,87372,78700,47556,0.6920225573438094,0.3524546424759872
2360,0.2401,32,97,32,589169,87275,78732,47524,0.6912542770244583,0.35255454417317633
2361,0.2402,34,72,34,589241,87203,78766,47490,0.6906840070966924,0.35257956983659133
2362,0.2403,23,87,23,589328,87116,78789,47467,0.6899949309339755,0.3526968487847648
2363,0.2404,29,107,29,589435,87009,78818,47438,0.6891474464579901,0.3528379212626537
2364,0.2405,28,98,28,589533,86911,78846,47410,0.6883712457229756,0.35296044549995903
2365,0.2406,33,67,33,589600,86844,78879,47377,0.6878405778735268,0.3529775519479068
2366,0.2407,39,84,39,589684,86760,78918,47338,0.6871752629578001,0.3530104848692747
2367,0.2408,21,94,21,589778,86666,78939,47317,0.6864307438854391,0.35315674376600015
2368,0.2409,37,82,37,589860,86584,78976,47280,0.6857812698010392,0.3531942867387797
2369,0.241,29,88,29,589948,86496,79005,47251,0.6850842732226587,0.353286428854479
2370,0.2411,27,92,27,590040,86404,79032,47224,0.6843555949816247,0.35339898823599847
2371,0.2412,29,90,29,590130,86314,79061,47195,0.6836427575719174,0.3534967680081493
2372,0.2413,26,86,26,590216,86228,79087,47169,0.6829616018248638,0.3535986566414537
2373,0.2414,30,109,30,590325,86119,79117,47139,0.6820982765175516,0.3537423644359063
2374,0.2415,33,81,33,590406,86038,79150,47106,0.6814567228488151,0.3537973922970618
2375,0.2416,33,97,33,590503,85941,79183,47073,0.6806884425294639,0.3538950787135189
2376,0.2417,32,89,32,590592,85852,79215,47041,0.6799835255354201,0.3539765074157405
2377,0.2418,18,85,18,590677,85767,79233,47023,0.6793102902040299,0.3541155207470442
2378,0.2419,24,97,24,590774,85670,79257,46999,0.6785420098846787,0.35425758843437427
2379,0.242,30,103,30,590877,85567,79287,46969,0.6777262070713471,0.35438673266131465
2380,0.2421,37,86,37,590963,85481,79324,46932,0.6770450513242935,0.3544364979269407
2381,0.2422,31,91,31,591054,85390,79355,46901,0.6763242934989229,0.35452903069747754
2382,0.2423,30,96,30,591150,85294,79385,46871,0.675563933595235,0.35464003329171867
2383,0.2424,33,94,33,591244,85200,79418,46838,0.6748194145228742,0.3547312137414987
2384,0.2425,23,83,23,591327,85117,79441,46815,0.6741620200228108,0.35484188824545976
2385,0.2426,22,92,22,591419,85025,79463,46793,0.6734333417817767,0.35498186894050887
2386,0.2427,28,84,28,591503,84941,79491,46765,0.67276802686605,0.3550711433040256
2387,0.2428,29,82,29,591585,84859,79520,46736,0.67211855278165,0.35515027166685664
2388,0.2429,34,92,34,591677,84767,79554,46702,0.6713898745406159,0.3552320318858438
2389,0.243,35,92,35,591769,84675,79589,46667,0.6706611962995818,0.3553090405201687
2390,0.2431,19,98,19,591867,84577,79608,46648,0.6698849955645673,0.35548104400838254
2391,0.2432,19,72,19,591939,84505,79627,46629,0.6693147256368014,0.3555828389281193
2392,0.2433,30,100,30,592039,84405,79657,46599,0.66852268407046,0.35570669597874877
2393,0.2434,37,78,37,592117,84327,79694,46562,0.6679048916487137,0.3557365401217826
2394,0.2435,26,85,26,592202,84242,79720,46536,0.6672316563173235,0.3558396672223157
2395,0.2436,31,76,31,592278,84166,79751,46505,0.6666297047269041,0.3558938096440679
2396,0.2437,23,70,23,592348,84096,79774,46482,0.6660752756304651,0.3559711436842347
2397,0.2438,30,89,30,592437,84007,79804,46452,0.6653703586364212,0.3560658904330096
2398,0.2439,33,90,33,592527,83917,79837,46419,0.664657521226714,0.35614872329977904
2399,0.244,30,81,30,592608,83836,79867,46389,0.6640159675579774,0.35622192359378
2400,0.2441,35,103,35,592711,83733,79902,46354,0.6632001647446458,0.3563307632584347
2401,0.2442,29,70,29,592781,83663,79931,46325,0.6626457356482068,0.3563790503738807
2402,0.2443,31,87,31,592868,83576,79962,46294,0.6619566594854898,0.35646415646415647
2403,0.2444,24,101,24,592969,83475,79986,46270,0.6611566975034849,0.3566226058807661
2404,0.2445,28,84,28,593053,83391,80014,46242,0.6604913825877582,0.35671472541713917
2405,0.2446,19,76,19,593129,83315,80033,46223,0.6598894309973388,0.3568296561626704
2406,0.2447,40,102,40,593231,83213,80073,46183,0.6590815485996705,0.3569121147485239
2407,0.2448,29,103,29,593334,83110,80102,46154,0.6582657457863389,0.35705223418739945
2408,0.2449,26,80,26,593414,83030,80128,46128,0.6576321125332657,0.35714396320785396
2409,0.245,25,87,25,593501,82943,80153,46103,0.6569430363705487,0.35726020178850953
2410,0.2451,26,91,26,593592,82852,80179,46077,0.656222278545178,0.3573827455421201
2411,0.2452,27,83,27,593675,82769,80206,46050,0.6555648840451147,0.35747832229717663
2412,0.2453,26,80,26,593755,82689,80232,46024,0.6549312507920416,0.35757071935235757
2413,0.2454,21,74,21,593829,82615,80253,46003,0.654345140032949,0.3576715545258051
2414,0.2455,30,93,30,593922,82522,80283,45973,0.6536085413762515,0.3577804583835947
2415,0.2456,24,76,24,593998,82446,80307,45949,0.6530065897858319,0.3578721912847074
2416,0.2457,23,76,23,594074,82370,80330,45926,0.6524046381954125,0.3579690715221051
2417,0.2458,31,78,31,594152,82292,80361,45895,0.6517868457736662,0.35803162567187
2418,0.2459,21,82,21,594234,82210,80382,45874,0.6511373716892662,0.35815558539708314
2419,0.246,27,72,27,594306,82138,80409,45847,0.6505671017615005,0.35822166660155486
2420,0.2461,22,89,22,594395,82049,80431,45825,0.6498621847674566,0.35836057368972585
2421,0.2462,31,82,31,594477,81967,80462,45794,0.6492127106830566,0.3584348901464453
2422,0.2463,26,78,26,594555,81889,80488,45768,0.6485949182613103,0.3585232302184761
2423,0.2464,32,96,32,594651,81793,80520,45736,0.6478345583576226,0.3586321542551106
2424,0.2465,28,76,28,594727,81717,80548,45708,0.6472326067672032,0.3587051206592113
2425,0.2466,26,84,26,594811,81633,80574,45682,0.6465672918514763,0.358810823547893
2426,0.2467,27,77,27,594888,81556,80601,45655,0.6459574198453935,0.35889191972392326
2427,0.2468,22,78,22,594966,81478,80623,45633,0.6453396274236471,0.3590011879381013
2428,0.2469,23,85,23,595051,81393,80646,45610,0.644666392092257,0.35912537499114194
2429,0.247,20,91,20,595142,81302,80666,45590,0.6439456342668863,0.3592819090249976
2430,0.2471,21,80,21,595222,81222,80687,45569,0.6433120010138133,0.3594024812486691
2431,0.2472,34,85,34,595307,81137,80721,45535,0.6426387656824231,0.3594717064544651
2432,0.2473,20,79,20,595386,81058,80741,45515,0.6420130528450133,0.3595948583031136
2433,0.2474,30,94,30,595480,80964,80771,45485,0.6412685337726524,0.35971023891054893
2434,0.2475,32,84,32,595564,80880,80803,45453,0.6406032188569256,0.3597872289900501
2435,0.2476,24,88,24,595652,80792,80827,45429,0.6399062222785452,0.35991633721805405
2436,0.2477,26,78,26,595730,80714,80853,45403,0.6392884298567989,0.3600069776477398
2437,0.2478,31,80,31,595810,80634,80884,45372,0.6386547966037258,0.36007809151945147
2438,0.2479,23,97,23,595907,80537,80907,45349,0.6378865162843746,0.3602386286004798
2439,0.248,30,86,30,595993,80451,80937,45319,0.637205360537321,0.3603323527073229
2440,0.2481,23,75,23,596068,80376,80960,45296,0.6366113293625649,0.36043032656438984
2441,0.2482,26,84,26,596152,80292,80986,45270,0.6359460144468382,0.3605390165814498
2442,0.2483,30,82,30,596234,80210,81016,45240,0.6352965403624382,0.3606217616580311
2443,0.2484,28,87,28,596321,80123,81044,45212,0.6346074641997212,0.36072924562173375
2444,0.2485,22,87,22,596408,80036,81066,45190,0.6339183880370042,0.36086755146694777
2445,0.2486,25,80,25,596488,79956,81091,45165,0.6332847547839311,0.3609705804780972
2446,0.2487,34,74,34,596562,79882,81125,45131,0.6326986440248384,0.36101045491268907
2447,0.2488,30,81,30,596643,79801,81155,45101,0.6320570903561019,0.36109109541880835
2448,0.2489,36,77,36,596720,79724,81191,45065,0.631447218350019,0.3611295867424212
2449,0.249,28,89,28,596809,79635,81219,45037,0.6307423013559752,0.3612439040041068
2450,0.2491,24,80,24,596889,79555,81243,45013,0.630108668102902,0.3613528353991394
2451,0.2492,21,75,21,596964,79480,81264,44992,0.629514636928146,0.3614628189472331
2452,0.2493,27,78,27,597042,79402,81291,44965,0.6288968445063997,0.3615508937258276
2453,0.2494,29,93,29,597135,79309,81320,44936,0.6281602458497022,0.36167250191154576
2454,0.2495,26,82,26,597217,79227,81346,44910,0.6275107717653022,0.36177771333284997
2455,0.2496,16,84,16,597301,79143,81362,44894,0.6268454568495755,0.36194038875496826
2456,0.2497,34,78,34,597379,79065,81396,44860,0.6262276644278292,0.3619931410127093
2457,0.2498,33,76,33,597455,78989,81429,44827,0.6256257128374098,0.36204529301544225
2458,0.2499,13,73,13,597528,78916,81442,44814,0.6250475224939804,0.3621918693930332
2459,0.25,19,76,19,597604,78840,81461,44795,0.624445570903561,0.3623164961378251
2460,0.2501,27,91,27,597695,78749,81488,44768,0.6237248130781904,0.3624440360436215
2461,0.2502,27,80,27,597775,78669,81515,44741,0.6230911798251172,0.3625395024714367
2462,0.2503,24,80,24,597855,78589,81539,44717,0.6224575465720441,0.36265064149352016
2463,0.2504,29,96,29,597951,78493,81568,44688,0.6216971866683564,0.36278322143837116
2464,0.2505,24,60,24,598011,78433,81592,44664,0.6212219617285515,0.3628358124081009
2465,0.2506,24,68,24,598079,78365,81616,44640,0.6206833734634394,0.36291207674484777
2466,0.2507,31,69,31,598148,78296,81647,44609,0.6201368647826638,0.36295512794434726
2467,0.2508,22,69,22,598217,78227,81669,44587,0.6195903561018882,0.36304492973113817
2468,0.2509,28,64,28,598281,78163,81697,44559,0.6190834494994297,0.3630889327097016
2469,0.251,29,71,29,598352,78092,81726,44530,0.6185210999873273,0.3631485377827796
2470,0.2511,26,73,26,598425,78019,81752,44504,0.6179429096438981,0.36322976094284337
2471,0.2512,33,66,33,598491,77953,81785,44471,0.6174201622101128,0.36325393713650916
2472,0.2513,21,88,21,598579,77865,81806,44450,0.6167231656317324,0.3634059600212566
2473,0.2514,21,94,21,598673,77771,81827,44429,0.6159786465593714,0.3635761047463175
2474,0.2515,19,68,19,598741,77703,81846,44410,0.6154400582942593,0.36367954271862946
2475,0.2516,34,77,34,598818,77626,81880,44376,0.6148301862881764,0.36373174210258846
2476,0.2517,24,73,24,598891,77553,81904,44352,0.6142519959447472,0.36382428940568473
2477,0.2518,34,79,34,598970,77474,81938,44318,0.6136262831073375,0.3638826852338413
2478,0.2519,29,66,29,599036,77408,81967,44289,0.6131035356735521,0.3639284452369409
2479,0.252,33,63,33,599099,77345,82000,44256,0.612604549486757,0.3639443754574387
2480,0.2521,28,69,28,599168,77276,82028,44228,0.6120580408059815,0.364004477218857
2481,0.2522,31,78,31,599246,77198,82059,44197,0.6114402483842352,0.36407595040981916
2482,0.2523,28,74,28,599320,77124,82087,44169,0.6108541376251425,0.3641512700650491
2483,0.2524,25,78,25,599398,77046,82112,44144,0.6102363452033963,0.36425447644195064
2484,0.2525,34,96,34,599494,76950,82146,44110,0.6094759852997085,0.36436477779613413
2485,0.2526,21,81,21,599575,76869,82167,44089,0.608834431630972,0.36449842093949963
2486,0.2527,30,73,30,599648,76796,82197,44059,0.6082562412875427,0.36456083736709277
2487,0.2528,27,80,27,599728,76716,82224,44032,0.6076226080344697,0.3646602842283102
2488,0.2529,26,75,26,599803,76641,82250,44006,0.6070285768597136,0.3647500559483452
2489,0.253,30,71,30,599874,76570,82280,43976,0.6064662273476112,0.36480679574602226
2490,0.2531,24,79,24,599953,76491,82304,43952,0.6058405145102015,0.3649195054922245
2491,0.2532,21,68,21,600021,76423,82325,43931,0.6053019262450894,0.36501487279193046
2492,0.2533,31,82,31,600103,76341,82356,43900,0.6046524521606894,0.36510009065127536
2493,0.2534,31,66,31,600169,76275,82387,43869,0.6041297047269041,0.36513683579704354
2494,0.2535,30,82,30,600251,76193,82417,43839,0.6034802306425041,0.36522760597174087
2495,0.2536,26,79,26,600330,76114,82443,43813,0.6028545178050944,0.3653305761004611
2496,0.2537,21,89,21,600419,76025,82464,43792,0.6021496008110505,0.36549070666099137
2497,0.2538,32,73,32,600492,75952,82496,43760,0.6015714104676213,0.36554397219994655
2498,0.2539,24,82,24,600574,75870,82520,43736,0.6009219363832214,0.3656672742170125
2499,0.254,27,70,27,600644,75800,82547,43709,0.6003675072867825,0.3657381452442912
2500,0.2541,28,92,28,600736,75708,82575,43681,0.5996388290457483,0.36587122766754054
2501,0.2542,17,70,17,600806,75638,82592,43664,0.5990843999493093,0.3659955407285712
2502,0.2543,20,70,20,600876,75568,82612,43644,0.5985299708528704,0.36610408348152873
2503,0.2544,18,69,18,600945,75499,82630,43626,0.5979834621720947,0.3662203567681007
2504,0.2545,27,97,27,601042,75402,82657,43599,0.5972151818527436,0.3663750724783825
2505,0.2546,20,65,20,601107,75337,82677,43579,0.5967003548346217,0.3664687678697568
2506,0.2547,32,76,32,601183,75261,82709,43547,0.5960984032442023,0.36653255673018653
2507,0.2548,29,88,29,601271,75173,82738,43518,0.5954014066658219,0.36664953534808875
2508,0.2549,23,79,23,601350,75094,82761,43495,0.5947756938284121,0.3667709484016224
2509,0.255,32,77,32,601427,75017,82793,43463,0.5941658218223292,0.36683828494260634
2510,0.2551,21,85,21,601512,74932,82814,43442,0.5934925864909391,0.36698937266629494
2511,0.2552,21,81,21,601593,74851,82835,43421,0.5928510328222025,0.3671283143939394
2512,0.2553,36,82,36,601675,74769,82871,43385,0.5922015587378026,0.3671902770959934
2513,0.2554,23,79,23,601754,74690,82894,43362,0.5915758459003928,0.3673127096533731
2514,0.2555,25,91,25,601845,74599,82919,43337,0.5908550880750222,0.3674620132953466
2515,0.2556,25,82,25,601927,74517,82944,43312,0.5902056139906222,0.36758353206765737
2516,0.2557,27,79,27,602006,74438,82971,43285,0.5895799011532126,0.36768515922971723
2517,0.2558,38,65,38,602071,74373,83009,43247,0.5890650741350906,0.36768406733548714
2518,0.2559,29,71,29,602142,74302,83038,43218,0.5885027246229882,0.3677501701837985
2519,0.256,21,81,21,602223,74221,83059,43197,0.5878611709542517,0.36789078335519254
2520,0.2561,16,71,16,602294,74150,83075,43181,0.5872988214421493,0.3680272050864648
2521,0.2562,25,75,25,602369,74075,83100,43156,0.5867047902673932,0.368127884262695
2522,0.2563,24,63,24,602432,74012,83124,43132,0.5862058040805982,0.3681964078399235
2523,0.2564,34,87,34,602519,73925,83158,43098,0.5855167279178811,0.36828657614315136
2524,0.2565,21,68,21,602587,73857,83179,43077,0.584978139652769,0.36838729539740367
2525,0.2566,26,56,26,602643,73801,83205,43051,0.5845345963756178,0.36842330469311607
2526,0.2567,18,77,18,602720,73724,83223,43033,0.5839247243695349,0.3685689080740341
2527,0.2568,33,89,33,602809,73635,83256,43000,0.5832198073754911,0.36867149654906334
2528,0.2569,18,74,18,602883,73561,83274,42982,0.5826336966163984,0.3688080794213295
2529,0.257,16,79,16,602962,73482,83290,42966,0.5820079837789888,0.36897155812036275
2530,0.2571,32,73,32,603035,73409,83322,42934,0.5814297934355594,0.3690295075767343
2531,0.2572,23,91,23,603126,73318,83345,42911,0.5807090356101888,0.3691935747532888
2532,0.2573,27,90,27,603216,73228,83372,42884,0.5799961982004815,0.36933305773735703
2533,0.2574,24,95,24,603311,73133,83396,42860,0.5792437587124573,0.3695050563396067
2534,0.2575,18,68,18,603379,73065,83414,42842,0.578705170447345,0.3696239226276239
2535,0.2576,19,79,19,603458,72986,83433,42823,0.5780794576099354,0.3697726428861315
2536,0.2577,28,81,28,603539,72905,83461,42795,0.5774379039411989,0.3698789974070873
2537,0.2578,27,71,27,603610,72834,83488,42768,0.5768755544290964,0.3699589972491825
2538,0.2579,31,68,31,603678,72766,83519,42737,0.5763369661639843,0.37000770542756467
2539,0.258,26,61,26,603739,72705,83545,42711,0.575853820808516,0.37006134331461843
2540,0.2581,24,65,24,603804,72640,83569,42687,0.5753389937903941,0.37013882265211095
2541,0.2582,23,79,23,603883,72561,83592,42664,0.5747132809529845,0.37026686916901713
2542,0.2583,17,79,17,603962,72482,83609,42647,0.5740875681155747,0.37042795472904305
2543,0.2584,21,69,21,604031,72413,83630,42626,0.5735410594347992,0.3705352097984162
2544,0.2585,34,86,34,604117,72327,83664,42592,0.5728599036877455,0.37062626719689523
2545,0.2586,16,84,16,604201,72243,83680,42576,0.5721945887720188,0.3708097091944713
2546,0.2587,20,65,20,604266,72178,83700,42556,0.5716797617538969,0.37091010511269545
2547,0.2588,27,86,27,604352,72092,83727,42529,0.5709986060068433,0.3710402107816194
2548,0.2589,21,62,21,604414,72030,83748,42508,0.5705075402357116,0.3711257399291065
2549,0.259,26,75,26,604489,71955,83774,42482,0.5699135090609555,0.37122608946407193
2550,0.2591,28,66,28,604555,71889,83802,42454,0.5693907616271702,0.3712863926956613
2551,0.2592,18,66,18,604621,71823,83820,42436,0.5688680141933848,0.371401815174297
2552,0.2593,23,77,23,604698,71746,83843,42413,0.568258142187302,0.3715256790966985
2553,0.2594,19,64,19,604762,71682,83862,42394,0.5677512355848435,0.3716294400224412
2554,0.2595,26,62,26,604824,71620,83888,42368,0.5672601698137119,0.37168824788574234
2555,0.2596,30,80,30,604904,71540,83918,42338,0.5666265365606387,0.3717838388450798
2556,0.2597,21,61,21,604965,71479,83939,42317,0.5661433912051704,0.3718672009560969
2557,0.2598,36,88,36,605053,71391,83975,42281,0.56544639462679,0.37195615454993314
2558,0.2599,25,85,25,605138,71306,84000,42256,0.5647731592953998,0.3720962998186013
2559,0.26,34,70,34,605208,71236,84034,42222,0.5642187301989608,0.37213770734544943
2560,0.2601,25,54,25,605262,71182,84059,42197,0.5637910277531365,0.3721765053493151
2561,0.2602,24,69,24,605331,71113,84083,42173,0.563244519072361,0.37227018342955
2562,0.2603,32,81,32,605412,71032,84115,42141,0.5626029654036244,0.37235913159499173
2563,0.2604,25,76,25,605488,70956,84140,42116,0.5620010138132049,0.37247063817744447
2564,0.2605,19,79,19,605567,70877,84159,42097,0.5613753009757952,0.3726255598633314
2565,0.2606,24,69,24,605636,70808,84183,42073,0.5608287922950197,0.37271994401183545
2566,0.2607,24,74,24,605710,70734,84207,42049,0.560242681535927,0.3728310117659576
2567,0.2608,15,87,15,605797,70647,84222,42034,0.55955360537321,0.3730353830725677
2568,0.2609,19,77,19,605874,70570,84241,42015,0.5589437333671271,0.37318470488963895
2569,0.261,25,72,25,605946,70498,84266,41990,0.5583734634393613,0.37328426143233057
2570,0.2611,31,81,31,606027,70417,84297,41959,0.5577319097706248,0.373380437104008
2571,0.2612,19,87,19,606114,70330,84316,41940,0.5570428336079077,0.37356373029304357
2572,0.2613,21,63,21,606177,70267,84337,41919,0.5565438474211126,0.3736562494428895
2573,0.2614,17,70,17,606247,70197,84354,41902,0.5559894183246736,0.3737945922800382
2574,0.2615,28,65,28,606312,70132,84382,41874,0.5554745913065517,0.37385497205506846
2575,0.2616,25,67,25,606379,70065,84407,41849,0.5549439234571031,0.3739389173829905
2576,0.2617,26,72,26,606451,69993,84433,41823,0.5543736535293372,0.3740341274951706
2577,0.2618,21,67,21,606518,69926,84454,41802,0.5538429856798884,0.3741407704425032
2578,0.2619,20,75,20,606593,69851,84474,41782,0.5532489545051325,0.3742800068080227
2579,0.262,29,76,29,606669,69775,84503,41753,0.5526470029147129,0.3743723549243239
2580,0.2621,27,71,27,606740,69704,84530,41726,0.5520846534026106,0.37445930180382303
2581,0.2622,19,76,19,606816,69628,84549,41707,0.5514827018121911,0.37460816454843493
2582,0.2623,23,57,23,606873,69571,84572,41684,0.5510312381193765,0.37467080131230057
2583,0.2624,33,72,33,606945,69499,84605,41651,0.5504609681916107,0.37472784525416103
2584,0.2625,23,75,23,607020,69424,84628,41628,0.5498669370168546,0.3748514209559486
2585,0.2626,23,67,23,607087,69357,84651,41605,0.5493362691674059,0.37494818045817485
2586,0.2627,15,78,15,607165,69279,84666,41590,0.5487184767456597,0.3751274026102878
2587,0.2628,24,79,24,607244,69200,84690,41566,0.5480927639082499,0.37525955618149975
2588,0.2629,19,68,19,607312,69132,84709,41547,0.5475541756431378,0.3753828639579324
2589,0.263,25,74,25,607386,69058,84734,41522,0.5469680648840451,0.37549285585096764
2590,0.2631,20,80,20,607466,68978,84754,41502,0.546334431630972,0.3756517016654598
2591,0.2632,25,62,25,607528,68916,84779,41477,0.5458433658598403,0.3757212866757856
2592,0.2633,31,64,31,607592,68852,84810,41446,0.5453364592573818,0.37576383977950645
2593,0.2634,22,62,22,607654,68790,84832,41424,0.5448453934862502,0.37585061788883445
2594,0.2635,26,77,26,607731,68713,84858,41398,0.5442355214801673,0.37596607060148396
2595,0.2636,20,60,20,607791,68653,84878,41378,0.5437602965403624,0.37605765647862877
2596,0.2637,29,71,29,607862,68582,84907,41349,0.5431979470282601,0.37613593981679416
2597,0.2638,30,74,30,607936,68508,84937,41319,0.5426118362691674,0.37621896255019255
2598,0.2639,29,70,29,608006,68438,84966,41290,0.5420574071727284,0.3762941090696996
2599,0.264,15,78,15,608084,68360,84981,41275,0.5414396147509821,0.37647649017193413
2600,0.2641,15,66,15,608150,68294,84996,41260,0.5409168673171968,0.37661792358106505
2601,0.2642,16,63,16,608213,68231,85012,41244,0.5404178811304017,0.3767435487554236
2602,0.2643,25,67,25,608280,68164,85037,41219,0.539887213280953,0.37683186601208596
2603,0.2644,27,65,27,608345,68099,85064,41192,0.5393723862628311,0.3769020321892928
2604,0.2645,18,65,18,608410,68034,85082,41174,0.5388575592447091,0.3770236612702366
2605,0.2646,25,58,25,608468,67976,85107,41149,0.5383981751362311,0.37708132875143185
2606,0.2647,27,70,27,608538,67906,85134,41122,0.5378437460397921,0.37716916755328905
2607,0.2648,20,69,20,608607,67837,85154,41102,0.5372972373590166,0.3772937148312358
2608,0.2649,26,60,26,608667,67777,85180,41076,0.5368220124192118,0.3773529438784416
2609,0.265,33,71,33,608738,67706,85213,41043,0.5362596629071094,0.3774103669918804
2610,0.2651,28,56,28,608794,67650,85241,41015,0.5358161196299582,0.3774444393318916
2611,0.2652,27,67,27,608861,67583,85268,40988,0.5352854517805095,0.3775225428521428
2612,0.2653,33,81,33,608942,67502,85301,40955,0.5346438981117729,0.37761509169532625
2613,0.2654,24,59,24,609001,67443,85325,40931,0.5341765935876315,0.37768283905733846
2614,0.2655,28,52,28,609053,67391,85353,40903,0.5337647319731339,0.3777032891942305
2615,0.2656,28,62,28,609115,67329,85381,40875,0.5332736662020022,0.37775867805256735
2616,0.2657,24,52,24,609167,67277,85405,40851,0.5328618045875048,0.37780223438887245
2617,0.2658,24,51,24,609218,67226,85429,40827,0.5324578633886706,0.3778423551405329
2618,0.2659,16,64,16,609282,67162,85445,40811,0.5319509567862122,0.37797412316041973
2619,0.266,25,52,25,609334,67110,85470,40786,0.5315390951717146,0.3780121598576407
2620,0.2661,19,66,19,609400,67044,85489,40767,0.5310163477379293,0.37813395664635335
2621,0.2662,25,71,25,609471,66973,85514,40742,0.5304539982258268,0.37823887109501925
2622,0.2663,23,62,23,609533,66911,85537,40719,0.5299629324546952,0.3783238873919911
2623,0.2664,20,49,20,609582,66862,85557,40699,0.5295748320871879,0.37838063982298414
2624,0.2665,22,62,22,609644,66800,85579,40677,0.5290837663160562,0.37847167300910894
2625,0.2666,28,62,28,609706,66738,85607,40649,0.5285927005449246,0.3785281272407275
2626,0.2667,22,74,22,609780,66664,85629,40627,0.5280065897858319,0.3786617703255632
2627,0.2668,28,55,28,609835,66609,85657,40599,0.5275709669243442,0.37869375419744794
2628,0.2669,23,62,23,609897,66547,85680,40576,0.5270799011532126,0.37877953380693224
2629,0.267,24,66,24,609963,66481,85704,40552,0.5265571537194272,0.37887380527500863
2630,0.2671,23,71,23,610034,66410,85727,40529,0.5259948042073248,0.3789917616585156
2631,0.2672,22,81,22,610115,66329,85749,40507,0.5253532505385883,0.3791512224343854
2632,0.2673,18,61,18,610176,66268,85767,40489,0.52487010518312,0.3792631864889422
2633,0.2674,21,77,21,610253,66191,85788,40468,0.5242602331770372,0.37941477043662514
2634,0.2675,19,70,19,610323,66121,85807,40449,0.5237058040805982,0.37955334521910483
2635,0.2676,18,74,18,610397,66047,85825,40431,0.5231196933215055,0.3797122410263153
2636,0.2677,17,61,17,610458,65986,85842,40414,0.5226365479660373,0.3798308270676692
2637,0.2678,35,65,35,610523,65921,85877,40379,0.5221217209479153,0.3798588899341486
2638,0.2679,25,63,25,610586,65858,85902,40354,0.5216227347611203,0.379938236734079
2639,0.268,31,66,31,610652,65792,85933,40323,0.521099987327335,0.3799934033831221
2640,0.2681,24,70,24,610722,65722,85957,40299,0.520545558230896,0.3801039416719329
2641,0.2682,29,67,29,610789,65655,85986,40270,0.5200148903814472,0.3801746518763276
2642,0.2683,30,69,30,610858,65586,86016,40240,0.5194683817006717,0.380246820252112
2643,0.2684,22,58,22,610916,65528,86038,40218,0.5190089975921937,0.3803264426077582
2644,0.2685,23,56,23,610972,65472,86061,40195,0.5185654543150424,0.38039312178825935
2645,0.2686,34,58,34,611030,65414,86095,40161,0.5181060702065644,0.3804025574236325
2646,0.2687,27,56,27,611086,65358,86122,40134,0.5176625269294133,0.3804459105903765
2647,0.2688,28,59,28,611145,65299,86150,40106,0.5171952224052718,0.38049428395237417
2648,0.2689,32,71,32,611216,65228,86182,40074,0.5166328728931694,0.3805625724107804
2649,0.269,18,63,18,611279,65165,86200,40056,0.5161338867063744,0.3806844641278832
2650,0.2691,18,61,18,611340,65104,86218,40038,0.515650741350906,0.3807992999942934
2651,0.2692,29,50,29,611390,65054,86247,40009,0.5152547205677354,0.38080960947241177
2652,0.2693,24,60,24,611450,64994,86271,39985,0.5147794956279306,0.38088570094971375
2653,0.2694,15,54,15,611504,64940,86286,39970,0.5143517931821062,0.38099323229434756
2654,0.2695,31,73,31,611577,64867,86317,39939,0.513773602838677,0.3810755109440299
2655,0.2696,23,61,23,611638,64806,86340,39916,0.5132904574832087,0.3811615515364489
2656,0.2697,19,64,19,611702,64742,86359,39897,0.5127835508807502,0.3812823134777664
2657,0.2698,27,64,27,611766,64678,86386,39870,0.5122766442782917,0.3813559322033898
2658,0.2699,35,63,35,611829,64615,86421,39835,0.5117776580914967,0.3813786500718047
2659,0.27,21,75,21,611904,64540,86442,39814,0.5111836269167406,0.381528259577975
2660,0.2701,32,50,32,611954,64490,86474,39782,0.5107876061335699,0.3815214055547031
2661,0.2702,25,79,25,612033,64411,86499,39757,0.5101618932961601,0.38166231472237155
2662,0.2703,22,56,22,612089,64355,86521,39735,0.509718350019009,0.38173695840138344
2663,0.2704,16,66,16,612155,64289,86537,39719,0.5091956025852237,0.3818840858395508
2664,0.2705,26,69,26,612224,64220,86563,39693,0.5086490939044481,0.3819830050138096
2665,0.2706,17,56,17,612280,64164,86580,39676,0.5082055506272969,0.38208782742681047
2666,0.2707,31,63,31,612343,64101,86611,39645,0.5077065644405019,0.3821352148516569
2667,0.2708,32,58,32,612401,64043,86643,39613,0.5072471803320239,0.38215829281469477
2668,0.2709,29,72,29,612473,63971,86672,39584,0.506676910404258,0.3822509777412969
2669,0.271,25,60,25,612533,63911,86697,39559,0.5062016854644532,0.3823233787571277
2670,0.2711,16,69,16,612602,63842,86713,39543,0.5056551767836777,0.38248295207235095
2671,0.2712,25,74,25,612676,63768,86738,39518,0.505069066024585,0.38260751699165424
2672,0.2713,23,53,23,612729,63715,86761,39495,0.504649283994424,0.38266640829376997
2673,0.2714,29,57,29,612786,63658,86790,39466,0.5041978203016094,0.3827043171327722
2674,0.2715,26,66,26,612852,63592,86816,39440,0.5036750728678241,0.3827936951626679
2675,0.2716,20,63,20,612915,63529,86836,39420,0.503176086681029,0.38290804184596255
2676,0.2717,20,55,20,612970,63474,86856,39400,0.5027404638195413,0.38299278729319364
2677,0.2718,17,57,17,613027,63417,86873,39383,0.5022890001267266,0.38310311284046694
2678,0.2719,22,74,22,613101,63343,86895,39361,0.501702889367634,0.3832470010905125
2679,0.272,31,44,31,613145,63299,86926,39330,0.5013543910784438,0.383225014372156
2680,0.2721,20,55,20,613200,63244,86946,39310,0.500918768216956,0.38331025606022195
2681,0.2722,26,59,26,613259,63185,86972,39284,0.5004514636928146,0.38337448399028
2682,0.2723,21,67,21,613326,63118,86993,39263,0.49992079584336585,0.38349889139586446
2683,0.2724,22,70,22,613396,63048,87015,39241,0.49936636674692686,0.3836287381829913
2684,0.2725,29,54,29,613450,62994,87044,39212,0.4989386643011025,0.38365653679823103
2685,0.2726,29,59,29,613509,62935,87073,39183,0.4984713597769611,0.38370316692453826
2686,0.2727,23,57,23,613566,62878,87096,39160,0.4980198960841465,0.3837785922891472
2687,0.2728,26,66,26,613632,62812,87122,39134,0.49749714865036115,0.3838698919035568
2688,0.2729,28,68,28,613700,62744,87150,39106,0.496958560385249,0.3839567992145312
2689,0.273,33,55,33,613755,62689,87183,39073,0.49652293752376125,0.38396454472199837
2690,0.2731,24,36,24,613791,62653,87207,39049,0.4962378025598783,0.38395508446244914
2691,0.2732,25,52,25,613843,62601,87232,39024,0.4958259409453808,0.384
2692,0.2733,19,62,19,613905,62539,87251,39005,0.4953348751742491,0.38411919955881196
2693,0.2734,32,58,32,613963,62481,87283,38973,0.4948754910657711,0.3841445384114968
2694,0.2735,18,61,18,614024,62420,87301,38955,0.4943923457103029,0.3842663378545006
2695,0.2736,14,54,14,614078,62366,87315,38941,0.49396464326447853,0.3843860740126546
2696,0.2737,29,64,29,614142,62302,87344,38912,0.49345773666202003,0.38445274369158416
2697,0.2738,22,54,22,614196,62248,87366,38890,0.4930300342161957,0.38452411556487176
2698,0.2739,27,57,27,614253,62191,87393,38863,0.49257857052338105,0.38457656302570903
2699,0.274,20,70,20,614323,62121,87413,38843,0.49202414142694206,0.3847212867952934
2700,0.2741,32,71,32,614394,62050,87445,38811,0.4914617919148397,0.38479689870217426
2701,0.2742,25,73,25,614467,61977,87470,38786,0.4908836015714105,0.3849230372259659
2702,0.2743,24,70,24,614537,61907,87494,38762,0.4903291724749715,0.3850440552702421
2703,0.2744,29,53,29,614590,61854,87523,38733,0.4899093904448105,0.3850696412061201
2704,0.2745,32,62,32,614652,61792,87555,38701,0.48941832467367885,0.3851114007940852
2705,0.2746,26,60,26,614712,61732,87581,38675,0.488943099733874,0.3851823080064139
2706,0.2747,30,54,30,614766,61678,87611,38645,0.48851539728804966,0.3852057853134376
2707,0.2748,19,68,19,614834,61610,87630,38626,0.4879768090229375,0.38535057264854944
2708,0.2749,20,52,20,614886,61558,87650,38606,0.48756494740844,0.3854278982468751
2709,0.275,19,60,19,614946,61498,87669,38587,0.48708972246863513,0.3855422890543038
2710,0.2751,27,64,27,615010,61434,87696,38560,0.48658281586617663,0.3856231373882433
2711,0.2752,30,71,30,615081,61363,87726,38530,0.48602046635407425,0.38571271260248463
2712,0.2753,17,51,17,615132,61312,87743,38513,0.4856165251552401,0.38580515902829954
2713,0.2754,22,62,22,615194,61250,87765,38491,0.4851254593841085,0.38590950561955467
2714,0.2755,21,77,21,615271,61173,87786,38470,0.4845155873780256,0.38607829952931966
2715,0.2756,28,65,28,615336,61108,87814,38442,0.4840007603599037,0.3861577096936213
2716,0.2757,29,56,29,615392,61052,87843,38413,0.4835572170827525,0.3861961493992862
2717,0.2758,28,67,28,615459,60985,87871,38385,0.48302654923330374,0.38628358659555195
2718,0.2759,25,52,25,615511,60933,87896,38360,0.4826146876188062,0.38633136273453317
2719,0.276,19,64,19,615575,60869,87915,38341,0.4821077810163477,0.38646305815945975
2720,0.2761,12,59,12,615634,60810,87927,38329,0.4816404764922063,0.3866187877626363
2721,0.2762,22,50,22,615684,60760,87949,38307,0.4812444557090356,0.38667770296869797
2722,0.2763,27,64,27,615748,60696,87976,38280,0.4807375491065771,0.38676042677012606
2723,0.2764,23,60,23,615808,60636,87999,38257,0.4802623241667723,0.3868524566956205
2724,0.2765,26,80,26,615888,60556,88025,38231,0.47962869091369914,0.3870043629222469
2725,0.2766,20,47,20,615935,60509,88045,38211,0.47925643137751867,0.38706442463533225
2726,0.2767,22,52,22,615987,60457,88067,38189,0.47884456976302114,0.38713176408572064
2727,0.2768,18,54,18,616041,60403,88085,38171,0.4784168673171968,0.3872319272830564
2728,0.2769,17,45,17,616086,60358,88102,38154,0.4780604486123432,0.3873030696767906
2729,0.277,24,65,24,616151,60293,88126,38130,0.47754562159422126,0.38740944697885654
2730,0.2771,26,59,26,616210,60234,88152,38104,0.47707831707007986,0.38747991620736644
2731,0.2772,23,60,23,616270,60174,88175,38081,0.476603092130275,0.3875731514935627
2732,0.2773,27,52,27,616322,60122,88202,38054,0.47619123051577744,0.3876100065189048
2733,0.2774,24,56,24,616378,60066,88226,38030,0.47574768723862626,0.38768145490132117
2734,0.2775,25,68,25,616446,59998,88251,38005,0.47520909897351415,0.38779425119639194
2735,0.2776,22,50,22,616496,59948,88273,37983,0.4748130781903434,0.38785471403335003
2736,0.2777,30,69,30,616565,59879,88303,37953,0.47426656950956786,0.38794055114890835
2737,0.2778,20,67,20,616632,59812,88323,37933,0.47373590166011914,0.38808123177656145
2738,0.2779,22,72,22,616704,59740,88345,37911,0.4731656317323533,0.3882295112185231
2739,0.278,17,48,17,616752,59692,88362,37894,0.47278545178050946,0.38831389748529505
2740,0.2781,26,51,26,616803,59641,88388,37868,0.4723815105816753,0.38835389553784777
2741,0.2782,23,49,23,616852,59592,88411,37845,0.471993410214168,0.3884048154191939
2742,0.2783,16,57,16,616909,59535,88427,37829,0.47154194652135345,0.38853169549320077
2743,0.2784,15,50,15,616959,59485,88442,37814,0.47114592573818276,0.38863708773985345
2744,0.2785,17,57,17,617016,59428,88459,37797,0.47069446204536813,0.38875803548470045
2745,0.2786,18,48,18,617064,59380,88477,37779,0.47031428209352427,0.38883685505202814
2746,0.2787,22,53,22,617117,59327,88499,37757,0.4698945000633633,0.3889106340900663
2747,0.2788,24,54,24,617171,59273,88523,37733,0.46946679761753896,0.3889759396326
2748,0.2789,27,66,27,617237,59207,88550,37706,0.4689440501837536,0.38907060972212193
2749,0.279,29,51,29,617288,59156,88579,37677,0.46854010898491955,0.389092561420177
2750,0.2791,22,49,22,617337,59107,88601,37655,0.46815200861741224,0.3891506996548232
2751,0.2792,25,59,25,617396,59048,88626,37630,0.46768470409327084,0.3892302281801444
2752,0.2793,26,67,26,617463,58981,88652,37604,0.46715403624382207,0.38933581819123053
2753,0.2794,21,50,21,617513,58931,88673,37583,0.4667580154606514,0.3894046459580993
2754,0.2795,21,56,21,617569,58875,88694,37562,0.4663144721835002,0.3894978068583635
2755,0.2796,30,68,30,617637,58807,88724,37532,0.46577588391838803,0.38958261970749125
2756,0.2797,18,69,18,617706,58738,88742,37514,0.4652293752376125,0.3897477455013922
2757,0.2798,19,65,19,617771,58673,88761,37495,0.46471454821949054,0.3898906081024873
2758,0.2799,19,54,19,617825,58619,88780,37476,0.4642868457736662,0.3899890733128675
2759,0.28,20,52,20,617877,58567,88800,37456,0.46387498415916867,0.3900732116263812
2760,0.2801,21,60,21,617937,58507,88821,37435,0.4633997592193638,0.39018365262346
2761,0.2802,24,61,24,617998,58446,88845,37411,0.4629166138638956,0.39027927016284675
2762,0.2803,26,49,26,618047,58397,88871,37385,0.4625285134963883,0.3903134200580485
2763,0.2804,27,56,27,618103,58341,88898,37358,0.4620849702192371,0.3903698053271194
2764,0.2805,24,59,24,618162,58282,88922,37334,0.46161766569509566,0.3904576639892905
2765,0.2806,22,54,22,618216,58228,88944,37312,0.4611899632492713,0.3905379945572535
2766,0.2807,18,58,18,618274,58170,88962,37294,0.4607305791407933,0.39066035364116314
2767,0.2808,30,52,30,618326,58118,88992,37264,0.4603187175262958,0.3906816799815479
2768,0.2809,34,50,34,618376,58068,89026,37230,0.4599226967431251,0.3906692690297803
2769,0.281,23,52,23,618428,58016,89049,37207,0.45951083512862756,0.3907354315659032
2770,0.2811,29,64,29,618492,57952,89078,37178,0.45900392852616906,0.3908125722695259
2771,0.2812,18,71,18,618563,57881,89096,37160,0.4584415790140667,0.3909891520501678
2772,0.2813,22,73,22,618636,57808,89118,37138,0.4578633886706374,0.39114865291850104
2773,0.2814,24,55,24,618691,57753,89142,37114,0.4574277658091497,0.39122139416235363
2774,0.2815,21,55,21,618746,57698,89163,37093,0.4569921429476619,0.3913135213258643
2775,0.2816,27,49,27,618795,57649,89190,37066,0.4566040425801546,0.39134244839782506
2776,0.2817,20,55,20,618850,57594,89210,37046,0.45616841971866684,0.3914412510566357
2777,0.2818,20,67,20,618917,57527,89230,37026,0.4556377518692181,0.39158990195974747
2778,0.2819,25,66,25,618983,57461,89255,37001,0.4551150044354328,0.3917024835383541
2779,0.282,13,54,13,619037,57407,89268,36988,0.45468730198960844,0.39184278828327773
2780,0.2821,14,43,14,619080,57364,89282,36974,0.4543467241160816,0.3919311412156289
2781,0.2822,17,49,17,619129,57315,89299,36957,0.4539586237485743,0.39202520366598775
2782,0.2823,17,55,17,619184,57260,89316,36940,0.4535230008870866,0.3921443736730361
2783,0.2824,27,63,27,619247,57197,89343,36913,0.45302401470029147,0.3922324938901286
2784,0.2825,19,62,19,619309,57135,89362,36894,0.4525329489291598,0.39236831190377436
2785,0.2826,21,45,21,619354,57090,89383,36873,0.45217653022430615,0.39242042080393347
2786,0.2827,20,59,20,619413,57031,89403,36853,0.45170922570016475,0.3925375995909846
2787,0.2828,20,52,20,619465,56979,89423,36833,0.45129736408566723,0.3926256768856863
2788,0.2829,30,65,30,619530,56914,89453,36803,0.4507825370675453,0.3927035649882092
2789,0.283,21,45,21,619575,56869,89474,36782,0.4504261183626917,0.39275608375778154
2790,0.2831,21,41,21,619616,56828,89495,36761,0.4501013813204917,0.392791887935548
2791,0.2832,13,45,13,619661,56783,89508,36748,0.44974496261563807,0.392896472827191
2792,0.2833,19,67,19,619728,56716,89527,36729,0.44921429476618935,0.39305473808122426
2793,0.2834,12,54,12,619782,56662,89539,36717,0.448786592320365,0.39320403945212523
2794,0.2835,24,48,24,619830,56614,89563,36693,0.4484064123685211,0.39325023846013696
2795,0.2836,19,60,19,619890,56554,89582,36674,0.44793118742871624,0.39337967134337326
2796,0.2837,26,59,26,619949,56495,89608,36648,0.44746388290457484,0.3934595192338662
2797,0.2838,22,38,22,619987,56457,89630,36626,0.4471629071093651,0.3934767895319231
2798,0.2839,25,61,25,620048,56396,89655,36601,0.44667976175389684,0.3935718356506124
2799,0.284,27,58,27,620106,56338,89682,36574,0.44622037764541883,0.3936412949888066
2800,0.2841,17,51,17,620157,56287,89699,36557,0.4458164364465847,0.39374649950454527
2801,0.2842,26,60,26,620217,56227,89725,36531,0.44534121150677985,0.3938312598374264
2802,0.2843,13,56,13,620273,56171,89738,36518,0.4448976682296287,0.3939841836679649
2803,0.2844,17,49,17,620322,56122,89755,36501,0.4445095678621214,0.39408138367360157
2804,0.2845,24,65,24,620387,56057,89779,36477,0.4439947408439995,0.39420105042470877
2805,0.2846,27,47,27,620434,56010,89806,36450,0.44362248130781906,0.3942245295262816
2806,0.2847,24,62,24,620496,55948,89830,36426,0.4431314155366874,0.39433173836793906
2807,0.2848,25,46,25,620542,55902,89855,36401,0.4427670764161703,0.394364213514187
2808,0.2849,33,42,33,620584,55860,89888,36368,0.44243441895830693,0.39432710239840396
2809,0.285,16,48,16,620632,55812,89904,36352,0.44205423900646307,0.3944273252028992
2810,0.2851,22,52,22,620684,55760,89926,36330,0.44164237739196555,0.39450537517645784
2811,0.2852,17,47,17,620731,55713,89943,36313,0.44127011785578507,0.39459500575924195
2812,0.2853,26,68,26,620799,55645,89969,36287,0.4407315295906729,0.3947156594004264
2813,0.2854,21,62,21,620861,55583,89990,36266,0.44024046381954124,0.39484371087328113
2814,0.2855,22,56,22,620917,55527,90012,36244,0.43979692054239006,0.39493957786228767
2815,0.2856,19,46,19,620963,55481,90031,36225,0.439432581421873,0.3950123219854753
2816,0.2857,22,56,22,621019,55425,90053,36203,0.43898903814472184,0.3951084821233684
2817,0.2858,23,51,23,621070,55374,90076,36180,0.4385850969458877,0.3951766170784455
2818,0.2859,23,48,23,621118,55326,90099,36157,0.43820491699404385,0.39523190100893063
2819,0.286,18,57,18,621175,55269,90117,36139,0.4377534533012292,0.39535926833537544
2820,0.2861,20,47,20,621222,55222,90137,36119,0.4373811937650488,0.3954303105943662
2821,0.2862,30,50,30,621272,55172,90167,36089,0.4369851729818781,0.3954482199406099
2822,0.2863,18,55,18,621327,55117,90185,36071,0.4365495501203903,0.3955673992191955
2823,0.2864,15,56,15,621383,55061,90200,36056,0.43610600684323914,0.39571100892259403
2824,0.2865,23,53,23,621436,55008,90223,36033,0.43568622481307817,0.39578871058094706
2825,0.2866,24,55,24,621491,54953,90247,36009,0.43525060195159043,0.3958686044721972
2826,0.2867,19,42,19,621533,54911,90266,35990,0.434917944493727,0.3959252373461238
2827,0.2868,17,54,17,621587,54857,90283,35973,0.43449024204790265,0.3960475613783992
2828,0.2869,15,57,15,621644,54800,90298,35958,0.4340387783550881,0.3961964785473457
2829,0.287,22,57,22,621701,54743,90320,35936,0.43358731466227346,0.3962990328521488
2830,0.2871,26,60,26,621761,54683,90346,35910,0.4331120897224686,0.3963882419171459
2831,0.2872,26,52,26,621813,54631,90372,35884,0.4327002281079711,0.3964425785781362
2832,0.2873,26,50,26,621863,54581,90398,35858,0.4323042073248004,0.39648824069262156
2833,0.2874,24,60,24,621923,54521,90422,35834,0.43182898238499556,0.3965912235072769
2834,0.2875,21,57,21,621980,54464,90443,35813,0.43137751869218094,0.39670126388781196
2835,0.2876,22,45,22,622025,54419,90465,35791,0.43102109998732735,0.3967520230573107
2836,0.2877,21,57,21,622082,54362,90486,35770,0.4305696362945127,0.3968623796210003
2837,0.2878,17,53,17,622135,54309,90503,35753,0.4301498542643518,0.39698207901223603
2838,0.2879,18,45,18,622180,54264,90521,35735,0.42979343555949817,0.3970599673329704
2839,0.288,18,50,18,622230,54214,90539,35717,0.4293974147763275,0.3971600449233301
2840,0.2881,21,49,21,622279,54165,90560,35696,0.4290093144088202,0.397235730739698
2841,0.2882,19,45,19,622324,54120,90579,35677,0.42865289570396653,0.39730725970800806
2842,0.2883,16,49,16,622373,54071,90595,35661,0.4282647953364593,0.39741675210627203
2843,0.2884,29,46,29,622419,54025,90624,35632,0.4279004562159422,0.39742574478289483
2844,0.2885,18,44,18,622463,53981,90642,35614,0.427551957926752,0.3974998604832859
2845,0.2886,18,40,18,622503,53941,90660,35596,0.42723514130021545,0.3975563175000279
2846,0.2887,27,44,27,622547,53897,90687,35569,0.42688664301102525,0.3975700266022847
2847,0.2888,30,59,30,622606,53838,90717,35539,0.4264193384868838,0.39763026281929353
2848,0.2889,19,50,19,622656,53788,90736,35520,0.4260233177037131,0.3977247279079142
2849,0.289,25,50,25,622706,53738,90761,35495,0.4256272969205424,0.39777884863223245
2850,0.2891,16,50,16,622756,53688,90777,35479,0.4252312761373717,0.39789383964919756
2851,0.2892,19,43,19,622799,53645,90796,35460,0.4248906982638449,0.3979574659110039
2852,0.2893,22,37,22,622836,53608,90818,35438,0.4245976428842986,0.3979740808121645
2853,0.2894,14,46,14,622882,53562,90832,35424,0.42423330376378154,0.39808509203694964
2854,0.2895,20,58,20,622940,53504,90852,35404,0.42377391965530353,0.3982093849822288
2855,0.2896,26,50,26,622990,53454,90878,35378,0.4233778988721328,0.3982573847262248
2856,0.2897,25,43,25,623033,53411,90903,35353,0.423037320998606,0.39828083457257446
2857,0.2898,23,68,23,623101,53343,90926,35330,0.42249873273349386,0.3984301873174472
2858,0.2899,22,49,22,623150,53294,90948,35308,0.42211063236598656,0.39850116250197515
2859,0.29,22,55,22,623205,53239,90970,35286,0.4216750095044988,0.39859926574414006
2860,0.2901,23,49,23,623254,53190,90993,35263,0.4212869091369915,0.3986636971046771
2861,0.2902,15,37,15,623291,53153,91008,35248,0.4209938537574452,0.398728521170575
2862,0.2903,17,57,17,623348,53096,91025,35231,0.42054239006463057,0.39887010766809694
2863,0.2904,14,54,14,623402,53042,91039,35217,0.4201146876188062,0.3990187969498861
2864,0.2905,24,52,24,623454,52990,91063,35193,0.4197028260043087,0.3990905276527222
2865,0.2906,24,66,24,623520,52924,91087,35169,0.41918007857052336,0.3992258181694346
2866,0.2907,21,47,21,623567,52877,91108,35148,0.41880781903434294,0.39929565464356714
2867,0.2908,12,45,12,623612,52832,91120,35136,0.4184514003294893,0.39941797017097125
2868,0.2909,23,41,23,623653,52791,91143,35113,0.4181266632872893,0.39944712413542044
2869,0.291,14,49,14,623702,52742,91157,35099,0.417738562919782,0.39957423071230974
2870,0.2911,25,38,25,623740,52704,91182,35074,0.4174375871245723,0.3995762036045478
2871,0.2912,23,44,23,623784,52660,91205,35051,0.4170890888353821,0.3996192039766962
2872,0.2913,18,41,18,623825,52619,91223,35033,0.4167643517931821,0.399682836672295
2873,0.2914,20,46,20,623871,52573,91243,35013,0.4164000126726651,0.39975566871417806
2874,0.2915,16,55,16,623926,52518,91259,34997,0.4159643898111773,0.3998971604867737
2875,0.2916,26,49,26,623975,52469,91285,34971,0.41557628944367,0.3999428179322964
2876,0.2917,22,44,22,624019,52425,91307,34949,0.4152277911544798,0.39999313296861766
2877,0.2918,18,47,18,624066,52378,91325,34931,0.41485553161829936,0.40008475643977137
2878,0.2919,24,57,24,624123,52321,91349,34907,0.41440406792548473,0.40018113449809695
2879,0.292,20,50,20,624173,52271,91369,34887,0.41400804714231404,0.40027306730305884
2880,0.2921,32,47,32,624220,52224,91401,34855,0.41363578760613356,0.40026872150575915
2881,0.2922,26,47,26,624267,52177,91427,34829,0.4132635280699531,0.4003057260418822
2882,0.2923,21,53,21,624320,52124,91448,34808,0.4128437460397922,0.4004049141858004
2883,0.2924,29,36,29,624356,52088,91477,34779,0.41255861107590924,0.4003706816167244
2884,0.2925,18,42,18,624398,52046,91495,34761,0.41222595361804587,0.4004400566774569
2885,0.2926,31,54,31,624452,51992,91526,34730,0.4117982511722215,0.4004750812942506
2886,0.2927,19,55,19,624507,51937,91545,34711,0.4113626283107337,0.40059782106915337
2887,0.2928,17,51,17,624558,51886,91562,34694,0.41095868711189965,0.4007161007161007
2888,0.2929,18,53,18,624611,51833,91580,34676,0.4105389050817387,0.40083690714260944
2889,0.293,19,46,19,624657,51787,91599,34657,0.41017456596122165,0.40091851371986487
2890,0.2931,28,40,28,624697,51747,91627,34629,0.4098577493346851,0.40090997499305364
2891,0.2932,14,41,14,624738,51706,91641,34615,0.4095330122924851,0.40100323212196337
2892,0.2933,17,33,17,624771,51673,91658,34598,0.40927163857559246,0.40103858770618167
2893,0.2934,17,49,17,624820,51624,91675,34581,0.40888353820808515,0.4011484252653558
2894,0.2935,27,43,27,624863,51581,91702,34554,0.40854296033455834,0.40116096824751846
2895,0.2936,24,50,24,624913,51531,91726,34530,0.40814693955138764,0.40122703663680415
2896,0.2937,19,40,19,624953,51491,91745,34511,0.4078301229248511,0.4012813655496384
2897,0.2938,19,49,19,625002,51442,91764,34492,0.4074420225573438,0.4013778015686457
2898,0.2939,27,43,27,625045,51399,91791,34465,0.407101444683817,0.40139057113574955
2899,0.294,16,43,16,625088,51356,91807,34449,0.4067608668102902,0.4014801002272595
2900,0.2941,17,49,17,625137,51307,91824,34432,0.4063727664427829,0.401590874631148
2901,0.2942,17,48,17,625185,51259,91841,34415,0.40599258649093906,0.40169713098489623
2902,0.2943,23,39,23,625224,51220,91864,34392,0.4056836902800659,0.40171938513292527
2903,0.2944,14,53,14,625277,51167,91878,34378,0.40526390824990494,0.40187036062890874
2904,0.2945,24,52,24,625329,51115,91902,34354,0.4048520466354074,0.40194690472569
2905,0.2946,20,57,20,625386,51058,91922,34334,0.40440058294259285,0.4020751358441072
2906,0.2947,25,45,25,625431,51013,91947,34309,0.4040441642377392,0.4021119992499004
2907,0.2948,22,40,22,625471,50973,91969,34287,0.40372734761120266,0.402146375791696
2908,0.2949,17,57,17,625528,50916,91986,34270,0.40327588391838803,0.4022961519498509
2909,0.295,19,49,19,625577,50867,92005,34251,0.40288778355088073,0.4023943231748866
2910,0.2951,30,49,30,625626,50818,92035,34221,0.4024996831833735,0.402415362363151
2911,0.2952,23,59,23,625685,50759,92058,34198,0.402032378659232,0.4025330461292183
2912,0.2953,19,49,19,625734,50710,92077,34179,0.4016442782917248,0.40263167194807337
2913,0.2954,27,50,27,625784,50660,92104,34152,0.40124825750855403,0.4026788661981795
2914,0.2955,25,54,25,625838,50606,92129,34127,0.4008205550627297,0.4027592555438849
2915,0.2956,17,38,17,625876,50568,92146,34110,0.40051957926751997,0.40282009494792037
2916,0.2957,16,38,16,625914,50530,92162,34094,0.40021860347231025,0.4028880695783702
2917,0.2958,10,45,10,625959,50485,92172,34084,0.3998621847674566,0.4030318438198394
2918,0.2959,20,48,20,626007,50437,92192,34064,0.39948200481561275,0.40311948971018097
2919,0.296,30,45,30,626052,50392,92222,34034,0.3991255861107591,0.40312226091488407
2920,0.2961,12,46,12,626098,50346,92234,34022,0.39876124699024207,0.4032571591124597
2921,0.2962,15,49,15,626147,50297,92249,34007,0.39837314662273476,0.40338536724236096
2922,0.2963,16,55,16,626202,50242,92265,33991,0.39793752376124697,0.40353543148172333
2923,0.2964,21,53,21,626255,50189,92286,33970,0.39751774173108606,0.4036407276702432
2924,0.2965,16,37,16,626292,50152,92302,33954,0.39722468635153974,0.4037048486433786
2925,0.2966,20,38,20,626330,50114,92322,33934,0.39692371055633,0.4037454787740339
2926,0.2967,25,55,25,626385,50059,92347,33909,0.39648808769484223,0.40383241234756095
2927,0.2968,30,41,30,626426,50018,92377,33879,0.39616335065264224,0.40381658462161935
2928,0.2969,26,37,26,626463,49981,92403,33853,0.3958702952730959,0.4038099100603574
2929,0.297,18,58,18,626521,49923,92421,33835,0.3954109111646179,0.4039614126411805
2930,0.2971,23,54,23,626575,49869,92444,33812,0.39498320871879355,0.40405826890214025
2931,0.2972,11,46,11,626621,49823,92455,33801,0.3946188695982765,0.40420214292547596
2932,0.2973,26,40,26,626661,49783,92481,33775,0.39430205297174,0.40421024916824244
2933,0.2974,13,52,13,626713,49731,92494,33762,0.3938901913572424,0.4043692285580827
2934,0.2975,10,52,10,626765,49679,92504,33752,0.3934783297427449,0.40454986755522526
2935,0.2976,17,51,17,626816,49628,92521,33735,0.3930743885439108,0.40467593536700935
2936,0.2977,18,54,18,626870,49574,92539,33717,0.39264668609808645,0.40480964329879576
2937,0.2978,14,49,14,626919,49525,92553,33703,0.39225858573057915,0.40494785408756667
2938,0.2979,14,48,14,626967,49477,92567,33689,0.3918784057787353,0.405081403458144
2939,0.298,24,52,24,627019,49425,92591,33665,0.39146654416423776,0.4051630761824528
2940,0.2981,18,46,18,627065,49379,92609,33647,0.3911022050437207,0.4052585936935418
2941,0.2982,17,53,17,627118,49326,92626,33630,0.39068242301355977,0.40539563141906554
2942,0.2983,20,42,20,627160,49284,92646,33610,0.39034976555569634,0.40545757232127777
2943,0.2984,24,45,24,627205,49239,92670,33586,0.38999334685084275,0.405505584062783
2944,0.2985,13,50,13,627255,49189,92683,33573,0.38959732606767206,0.4056571856649187
2945,0.2986,25,44,25,627299,49145,92708,33548,0.3892488277784818,0.40569334768360077
2946,0.2987,24,44,24,627343,49101,92732,33524,0.3889003294892916,0.40573676248108925
2947,0.2988,15,49,15,627392,49052,92747,33509,0.3885122291217843,0.4058695994476811
2948,0.2989,23,46,23,627438,49006,92770,33486,0.38814789000126726,0.4059302720263783
2949,0.299,28,44,28,627482,48962,92798,33458,0.38779939171207706,0.4059451589420044
2950,0.2991,15,47,15,627529,48915,92813,33443,0.3874271321758966,0.40606862721289977
2951,0.2992,33,47,33,627576,48868,92846,33410,0.3870548726397161,0.40606237390310895
2952,0.2993,13,44,13,627620,48824,92859,33397,0.3867063743505259,0.4061857676262755
2953,0.2994,23,48,23,627668,48776,92882,33374,0.38632619439868204,0.40625684723067557
2954,0.2995,22,46,22,627714,48730,92904,33352,0.385961855278165,0.406325381935138
2955,0.2996,15,50,15,627764,48680,92919,33337,0.3855658344949943,0.4064645134545277
2956,0.2997,17,44,17,627808,48636,92936,33320,0.38521733620580406,0.40655961735565427
2957,0.2998,19,44,19,627852,48592,92955,33301,0.38486883791661386,0.40664037219298355
2958,0.2999,18,49,18,627901,48543,92973,33283,0.38448073754910655,0.40675335467944174
2959,0.3,10,48,10,627949,48495,92983,33273,0.3841005575972627,0.406919577340769
2960,0.3001,23,45,23,627994,48450,93006,33250,0.38374413889240905,0.4069767441860465
2961,0.3002,14,44,14,628038,48406,93020,33236,0.38339564060321885,0.4070943876926092
2962,0.3003,18,42,18,628080,48364,93038,33218,0.3830629831453555,0.4071731509401584
2963,0.3004,25,42,25,628122,48322,93063,33193,0.3827303256874921,0.40720112862663316
2964,0.3005,24,46,24,628168,48276,93087,33169,0.382365986566975,0.40725643072011786
2965,0.3006,17,40,17,628208,48236,93104,33152,0.38204916994043847,0.407332776330663
2966,0.3007,14,33,14,628241,48203,93118,33138,0.3817877962235458,0.407396024145265
2967,0.3008,17,51,17,628292,48152,93135,33121,0.38138385502471167,0.40752771523138065
2968,0.3009,21,41,21,628333,48111,93156,33100,0.38105911798251174,0.4075802539064905
2969,0.301,16,59,16,628392,48052,93172,33084,0.3805918134583703,0.4077598106882272
2970,0.3011,23,41,23,628433,48011,93195,33061,0.3802670764161703,0.40779800671008487
2971,0.3012,24,52,24,628485,47959,93219,33037,0.3798552148016728,0.4078843399674058
2972,0.3013,18,42,18,628527,47917,93237,33019,0.3795225573438094,0.40796431748542056
2973,0.3014,13,53,13,628580,47864,93250,33006,0.37910277531364844,0.4081365153950785
2974,0.3015,24,47,24,628627,47817,93274,32982,0.378730515777468,0.408198121263877
2975,0.3016,17,38,17,628665,47779,93291,32965,0.37842953998225826,0.40826562964430796
2976,0.3017,22,52,22,628717,47727,93313,32943,0.37801767836776073,0.4083674228337672
2977,0.3018,27,51,27,628768,47676,93340,32916,0.3776137371689266,0.4084276354973198
2978,0.3019,16,51,16,628819,47625,93356,32900,0.3772097959700925,0.40856876746352067
2979,0.302,27,41,27,628860,47584,93383,32873,0.37688505892789254,0.40857849534533974
2980,0.3021,24,44,24,628904,47540,93407,32849,0.37653656063870233,0.40862555822314
2981,0.3022,20,54,20,628958,47486,93427,32829,0.376108858192878,0.4087530349249829
2982,0.3023,23,43,23,629001,47443,93450,32806,0.37576828031935117,0.40880260190158135
2983,0.3024,15,45,15,629046,47398,93465,32791,0.3754118616144975,0.40892142313783686
2984,0.3025,16,41,16,629087,47357,93481,32775,0.37508712457229754,0.4090126291618829
2985,0.3026,17,49,17,629136,47308,93498,32758,0.3746990242047903,0.4091374615941848
2986,0.3027,18,34,18,629170,47274,93516,32740,0.3744297300722342,0.40917839378108833
2987,0.3028,23,39,23,629209,47235,93539,32717,0.374120833861361,0.40920802481488894
2988,0.3029,20,35,20,629244,47200,93559,32697,0.37384361931314153,0.4092393957219921
2989,0.303,20,46,20,629290,47154,93579,32677,0.3734792801926245,0.40932720371785397
2990,0.3031,21,42,21,629332,47112,93600,32656,0.3731466227347611,0.409387222946545
2991,0.3032,21,36,21,629368,47076,93621,32635,0.37286148777087824,0.4094165171682704
2992,0.3033,24,39,24,629407,47037,93645,32611,0.3725525915600051,0.40943903173965446
2993,0.3034,21,45,21,629452,46992,93666,32590,0.37219617285515144,0.40951471438264936
2994,0.3035,19,37,19,629489,46955,93685,32571,0.3719031174756051,0.4095641676935845
2995,0.3036,24,36,24,629525,46919,93709,32547,0.37161798251172223,0.40957138902171997
2996,0.3037,24,27,24,629552,46892,93733,32523,0.37140413128881006,0.4095322042435308
2997,0.3038,19,40,19,629592,46852,93752,32504,0.37108731466227346,0.40959725792630675
2998,0.3039,18,45,18,629637,46807,93770,32486,0.37073089595741987,0.4096956856216816
2999,0.304,19,50,19,629687,46757,93789,32467,0.3703348751742491,0.40981268302534585
3000,0.3041,17,42,17,629729,46715,93806,32450,0.37000221771638575,0.40990336638666075
3001,0.3042,20,52,20,629781,46663,93826,32430,0.36959035610188823,0.4100236430531147
3002,0.3043,14,37,14,629818,46626,93840,32416,0.3692973007223419,0.41011108018521797
3003,0.3044,14,39,14,629857,46587,93854,32402,0.36898840451146875,0.4102090164453278
3004,0.3045,21,43,21,629900,46544,93875,32381,0.36864782663794193,0.4102755780804561
3005,0.3046,19,45,19,629945,46499,93894,32362,0.36829140793308834,0.4103676088307275
3006,0.3047,14,60,14,630005,46439,93908,32348,0.3678161829932835,0.4105753487250435
3007,0.3048,20,51,20,630056,46388,93928,32328,0.36741224179444937,0.4106916001829361
3008,0.3049,20,44,20,630100,46344,93948,32308,0.36706374350525917,0.4107714997711438
3009,0.305,16,40,16,630140,46304,93964,32292,0.36674692687872257,0.41086060359305815
3010,0.3051,29,43,29,630183,46261,93993,32263,0.3664063490051958,0.4108680148744333
3011,0.3052,21,45,21,630228,46216,94014,32242,0.36604993030034216,0.41094598383848685
3012,0.3053,14,46,14,630274,46170,94028,32228,0.36568559117982513,0.41108191535498356
3013,0.3054,16,29,16,630303,46141,94044,32212,0.3654558991255861,0.411113805470116
3014,0.3055,20,50,20,630353,46091,94064,32192,0.36505987834241543,0.4112259366656873
3015,0.3056,14,34,14,630387,46057,94078,32178,0.3647905842098593,0.41129929059883685
3016,0.3057,21,50,21,630437,46007,94099,32157,0.36439456342668863,0.41140422700987667
3017,0.3058,18,57,18,630494,45950,94117,32139,0.363943099733874,0.4115688509265069
3018,0.3059,18,50,18,630544,45900,94135,32121,0.3635470789507033,0.4116968508478487
3019,0.306,21,46,21,630590,45854,94156,32100,0.3631827398301863,0.4117813069245966
3020,0.3061,21,34,21,630624,45820,94177,32079,0.36291344569763023,0.4118024621625438
3021,0.3062,19,40,19,630664,45780,94196,32060,0.36259662907109363,0.4118705035971223
3022,0.3063,25,53,25,630717,45727,94221,32035,0.3621768470409327,0.41196214089143796
3023,0.3064,15,49,15,630766,45678,94236,32020,0.3617887466734254,0.4121084197791449
3024,0.3065,26,33,26,630799,45645,94262,31994,0.36152737295653276,0.41208670899934313
3025,0.3066,17,47,17,630846,45598,94279,31977,0.3611551134203523,0.41220754108926844
3026,0.3067,21,35,21,630881,45563,94300,31956,0.3608778988721328,0.4122344199486577
3027,0.3068,31,44,31,630925,45519,94331,31925,0.3605294005829426,0.41223335571509734
3028,0.3069,28,43,28,630968,45476,94359,31897,0.36018882270941577,0.4122497512052008
3029,0.307,22,42,22,631010,45434,94381,31875,0.3598561652515524,0.41230645849771697
3030,0.3071,13,51,13,631061,45383,94394,31862,0.35945222405271826,0.4124797721535374
3031,0.3072,19,51,19,631112,45332,94413,31843,0.3590482828538842,0.4126077097505669
3032,0.3073,21,44,21,631156,45288,94434,31822,0.358699784564694,0.4126831798729088
3033,0.3074,19,48,19,631204,45240,94453,31803,0.35831960461285006,0.4127954518905027
3034,0.3075,14,43,14,631247,45197,94467,31789,0.3579790267393233,0.4129192320681682
3035,0.3076,19,35,19,631282,45162,94486,31770,0.3577018121911038,0.41296209639681797
3036,0.3077,14,32,14,631314,45130,94500,31756,0.35744835888987453,0.4130270790521031
3037,0.3078,16,41,16,631355,45089,94516,31740,0.35712362184767454,0.41312525218342033
3038,0.3079,19,43,19,631398,45046,94535,31721,0.3567830439741478,0.41321140594265765
3039,0.308,14,39,14,631437,45007,94549,31707,0.35647414776327463,0.41331438850796465
3040,0.3081,18,40,18,631477,44967,94567,31689,0.35615733113673803,0.41339229805886035
3041,0.3082,25,32,25,631509,44935,94592,31664,0.3559038778355088,0.41337354273554483
3042,0.3083,20,40,20,631549,44895,94612,31644,0.35558706120897227,0.41343628738290283
3043,0.3084,21,51,21,631600,44844,94633,31623,0.35518312001013813,0.413550943544274
3044,0.3085,17,42,17,631642,44802,94650,31606,0.35485046255227476,0.4136477855721914
3045,0.3086,22,43,22,631685,44759,94672,31584,0.35450988467874794,0.4137118006889957
3046,0.3087,17,35,17,631720,44724,94689,31567,0.35423267013052845,0.4137709559450001
3047,0.3088,19,46,19,631766,44678,94708,31548,0.3538683310100114,0.4138745309999213
3048,0.3089,20,52,20,631818,44626,94728,31528,0.3534564693955139,0.41400320403393126
3049,0.309,15,35,15,631853,44591,94743,31513,0.3531792548472944,0.4140781036476401
3050,0.3091,18,37,18,631890,44554,94761,31495,0.3528861994677481,0.4141408828518455
3051,0.3092,7,39,7,631929,44515,94768,31488,0.3525773032568749,0.4142994355485968
3052,0.3093,16,42,16,631971,44473,94784,31472,0.35224464579901155,0.4144051616301271
3053,0.3094,21,44,21,632015,44429,94805,31451,0.3518961475098213,0.41448339483394836
3054,0.3095,15,47,15,632062,44382,94820,31436,0.35152388797364087,0.4146244955023873
3055,0.3096,25,30,25,632092,44352,94845,31411,0.3512862755037384,0.4145955149611288
3056,0.3097,16,33,16,632125,44319,94861,31395,0.35102490178684576,0.4146525081226722
3057,0.3098,15,38,15,632163,44281,94876,31380,0.35072392599163604,0.41474471656467665
3058,0.3099,15,43,15,632206,44238,94891,31365,0.35038334811810923,0.41486448950438476
3059,0.31,14,38,14,632244,44200,94905,31351,0.3500823723228995,0.41496472581435057
3060,0.3101,19,46,19,632290,44154,94924,31332,0.3497180332023825,0.41507034416977984
3061,0.3102,15,42,15,632332,44112,94939,31317,0.34938537574451906,0.4151851409935171
3062,0.3103,20,29,20,632361,44083,94959,31297,0.34915568369028005,0.415189705492173
3063,0.3104,16,36,16,632397,44047,94975,31281,0.34887054872639717,0.41526391248937977
3064,0.3105,18,59,18,632456,43988,94993,31263,0.3484032442022557,0.4154496285763644
3065,0.3106,16,41,16,632497,43947,95009,31247,0.3480785071600558,0.4155517727478256
3066,0.3107,17,44,17,632541,43903,95026,31230,0.3477300088708655,0.4156628911397122
3067,0.3108,20,46,20,632587,43857,95046,31210,0.3473656697503485,0.4157619193520455
3068,0.3109,11,49,11,632636,43808,95057,31199,0.3469775693828412,0.41594784486781233
3069,0.311,29,39,29,632675,43769,95086,31170,0.3466686731719681,0.415938296481138
3070,0.3111,19,44,19,632719,43725,95105,31151,0.34632017488277783,0.4160345103905123
3071,0.3112,17,36,17,632755,43689,95122,31134,0.34603503991889495,0.4161020007217032
3072,0.3113,16,31,16,632786,43658,95138,31118,0.3457895070333291,0.4161495667058949
3073,0.3114,17,36,17,632822,43622,95155,31101,0.34550437206944623,0.41621722896564645
3074,0.3115,18,37,18,632859,43585,95173,31083,0.3452113166898999,0.416282744950983
3075,0.3116,24,46,24,632905,43539,95197,31059,0.3448469775693828,0.4163516448162149
3076,0.3117,14,50,14,632955,43489,95211,31045,0.3444509567862121,0.4165213191295248
3077,0.3118,12,38,12,632993,43451,95223,31033,0.3441499809910024,0.41663981526233823
3078,0.3119,20,50,20,633043,43401,95243,31013,0.3437539602078317,0.4167629747090601
3079,0.312,15,40,15,633083,43361,95258,30998,0.3434371435812951,0.4168695114243064
3080,0.3121,19,29,19,633112,43332,95277,30979,0.3432074515270561,0.41688309940654816
3081,0.3122,19,50,19,633162,43282,95296,30960,0.3428114307438854,0.4170146278386897
3082,0.3123,17,48,17,633210,43234,95313,30943,0.34243125079204156,0.4171508688677083
3083,0.3124,8,36,8,633246,43198,95321,30935,0.3421461158281587,0.41729054537115723
3084,0.3125,23,39,23,633285,43159,95344,30912,0.3418372196172855,0.4173293191667454
3085,0.3126,18,37,18,633322,43122,95362,30894,0.3415441642377392,0.4173962386511025
3086,0.3127,14,36,14,633358,43086,95376,30880,0.3412590292738563,0.41748911662115024
3087,0.3128,24,37,24,633395,43049,95400,30856,0.34096597389431,0.4175089642108112
3088,0.3129,15,46,15,633441,43003,95415,30841,0.3406016347737929,0.41765072314609175
3089,0.313,16,35,16,633476,42968,95431,30825,0.34032442022557347,0.41772254820917976
3090,0.3131,17,39,17,633515,42929,95448,30808,0.3400155240147003,0.4178092409509473
3091,0.3132,14,42,14,633557,42887,95462,30794,0.3396828665568369,0.4179367815311953
3092,0.3133,27,47,27,633604,42840,95489,30767,0.33931060702065646,0.4179901368076406
3093,0.3134,13,40,13,633644,42800,95502,30754,0.33899379039411986,0.4181145824836175
3094,0.3135,17,48,17,633692,42752,95519,30737,0.338613610442276,0.4182530718883098
3095,0.3136,13,34,13,633726,42718,95532,30724,0.33834431630971995,0.4183437270226846
3096,0.3137,21,40,21,633766,42678,95553,30703,0.33802749968318335,0.41840530927624314
3097,0.3138,9,52,9,633818,42626,95562,30694,0.33761563806868583,0.4186306601200218
3098,0.3139,22,38,22,633856,42588,95584,30672,0.3373146622734761,0.41867321867321866
3099,0.314,26,35,26,633891,42553,95610,30646,0.3370374477252566,0.4186669216792579
3100,0.3141,24,43,24,633934,42510,95634,30622,0.3366968698517298,0.41872231034294155
3101,0.3142,11,32,11,633966,42478,95645,30611,0.3364434165505006,0.41881815321046945
3102,0.3143,15,31,15,633997,42447,95660,30596,0.33619788366493475,0.4188765521679011
3103,0.3144,16,40,16,634037,42407,95676,30580,0.33588106703839815,0.4189787222382068
3104,0.3145,12,40,12,634077,42367,95688,30568,0.3355642504118616,0.41911290875437035
3105,0.3146,14,29,14,634106,42338,95702,30554,0.3353345583576226,0.4191680842890852
3106,0.3147,19,26,19,634132,42312,95721,30535,0.33512862755037387,0.41916619764712343
3107,0.3148,18,36,18,634168,42276,95739,30517,0.33484349258649093,0.41922987100408005
3108,0.3149,23,37,23,634205,42239,95762,30494,0.3345504372069446,0.4192594833156889
3109,0.315,25,39,25,634244,42200,95787,30469,0.33424154099607145,0.4192847018673712
3110,0.3151,15,36,15,634280,42164,95802,30454,0.33395640603218857,0.4193726073425322
3111,0.3152,21,34,21,634314,42130,95823,30433,0.3336871118996325,0.419401072171768
3112,0.3153,9,43,9,634357,42087,95832,30424,0.3333465340261057,0.4195777192425977
3113,0.3154,18,42,18,634399,42045,95850,30406,0.33301387656824233,0.4196767470428289
3114,0.3155,25,45,25,634444,42000,95875,30381,0.3326574578633887,0.41973722385708956
3115,0.3156,17,32,17,634476,41968,95892,30364,0.3324040045621594,0.4197865398440524
3116,0.3157,22,38,22,634514,41930,95914,30342,0.3321030287669497,0.41983063980518043
3117,0.3158,22,45,22,634559,41885,95936,30320,0.33174661006209605,0.4199155183159061
3118,0.3159,21,46,21,634605,41839,95957,30299,0.331382270941579,0.420014416812221
3119,0.316,19,34,19,634639,41805,95976,30280,0.33111297680902296,0.42005965179995836
3120,0.3161,21,40,21,634679,41765,95997,30259,0.33079616018248637,0.42012384760635346
3121,0.3162,22,39,22,634718,41726,96019,30237,0.3304872639716132,0.4201742562149994
3122,0.3163,23,28,23,634746,41698,96042,30214,0.33026549233303765,0.4201524084992769
3123,0.3164,9,54,9,634800,41644,96051,30205,0.3298377898872133,0.4203955517822099
3124,0.3165,13,48,13,634848,41596,96064,30192,0.32945760993536943,0.4205716832896863
3125,0.3166,11,41,11,634889,41555,96075,30181,0.32913287289316945,0.42072320731571317
3126,0.3167,16,27,16,634916,41528,96091,30165,0.32891902167025727,0.4207523747088279
3127,0.3168,19,30,19,634946,41498,96110,30146,0.3286814092003548,0.42077494277259786
3128,0.3169,17,33,17,634979,41465,96127,30129,0.32842003548346216,0.42083135458278625
3129,0.317,11,45,11,635024,41420,96138,30118,0.32806361677860857,0.4210070172495737
3130,0.3171,9,43,9,635067,41377,96147,30109,0.32772303890508175,0.42118736535825196
3131,0.3172,28,39,28,635106,41338,96175,30081,0.3274141426942086,0.4211904395188955
3132,0.3173,10,38,10,635144,41300,96185,30071,0.3271131668989989,0.42133359487747124
3133,0.3174,14,46,14,635190,41254,96199,30057,0.3267488277784818,0.4214917754624111
3134,0.3175,20,46,20,635236,41208,96219,30037,0.32638448865796477,0.4216015158958523
3135,0.3176,19,40,19,635276,41168,96238,30018,0.3260676720314282,0.42168403899643186
3136,0.3177,13,38,13,635314,41130,96251,30005,0.32576669623621846,0.42180361284880863
3137,0.3178,24,41,24,635355,41089,96275,29981,0.3254419591940185,0.42185169551146756
3138,0.3179,12,36,12,635391,41053,96287,29969,0.3251568242301356,0.42196784095069134
3139,0.318,15,30,15,635421,41023,96302,29954,0.3249192117602332,0.42202403595530946
3140,0.3181,12,41,12,635462,40982,96314,29942,0.3245944747180332,0.4221702103660256
3141,0.3182,19,41,19,635503,40941,96333,29923,0.3242697376758332,0.42225953939941296
3142,0.3183,24,34,24,635537,40907,96357,29899,0.3240004435432772,0.4222664745925487
3143,0.3184,18,37,18,635574,40870,96375,29881,0.32370738816373085,0.4223403202781586
3144,0.3185,17,50,17,635624,40820,96392,29864,0.32331136738056016,0.42250014147473264
3145,0.3186,31,37,31,635661,40783,96423,29833,0.32301831200101383,0.42246799592160417
3146,0.3187,15,31,15,635692,40752,96438,29818,0.322772779115448,0.42253082046195267
3147,0.3188,20,41,20,635733,40711,96458,29798,0.322448042073248,0.4226127161071636
3148,0.3189,24,51,24,635784,40660,96482,29774,0.3220441008744139,0.42272198086151574
3149,0.319,16,21,16,635805,40639,96498,29758,0.3218777721454822,0.42271687713965084
3150,0.3191,25,40,25,635845,40599,96523,29733,0.32156095551894565,0.42275209008701586
3151,0.3192,16,23,16,635868,40576,96539,29717,0.32137878595868713,0.42275902294680834
3152,0.3193,31,38,31,635906,40538,96570,29686,0.32107781016347736,0.42273296878560035
3153,0.3194,25,51,25,635957,40487,96595,29661,0.3206738689646433,0.42283457832012317
3154,0.3195,11,37,11,635994,40450,96606,29650,0.32038081358509696,0.42296718972895864
3155,0.3196,21,23,21,636017,40427,96627,29629,0.32019864402483844,0.422933082105744
3156,0.3197,16,35,16,636052,40392,96643,29613,0.31992142947661895,0.4230126419541461
3157,0.3198,14,43,14,636095,40349,96657,29599,0.31958085160309213,0.4231572024932807
3158,0.3199,13,33,13,636128,40316,96670,29586,0.31931947788619947,0.42324969242654004
3159,0.32,14,37,14,636165,40279,96684,29572,0.31902642250665314,0.42335829121988233
3160,0.3201,13,28,13,636193,40251,96697,29559,0.3188046508680776,0.42342071336484743
3161,0.3202,30,33,30,636226,40218,96727,29529,0.3185432771511849,0.4233730483031528
3162,0.3203,19,40,19,636266,40178,96746,29510,0.3182264605246483,0.4234588451383308
3163,0.3204,16,37,16,636303,40141,96762,29494,0.317933405145102,0.42355137502692614
3164,0.3205,32,49,32,636352,40092,96794,29462,0.31754530477759474,0.42358455300917275
3165,0.3206,15,44,15,636396,40048,96809,29447,0.31719680648840454,0.423728325778833
3166,0.3207,23,47,23,636443,40001,96832,29424,0.31682454695222406,0.42382427079582286
3167,0.3208,22,30,22,636473,39971,96854,29402,0.3165869344823216,0.4238248309861185
3168,0.3209,15,38,15,636511,39933,96869,29387,0.3162859586871119,0.42393248701673397
3169,0.321,21,38,21,636549,39895,96890,29366,0.3159849828919022,0.4239904130751794
3170,0.3211,25,34,25,636583,39861,96915,29341,0.3157156887593461,0.42399063610878296
3171,0.3212,12,34,12,636617,39827,96927,29329,0.31544639462679,0.4240991381803459
3172,0.3213,16,42,16,636659,39785,96943,29313,0.3151137371689266,0.42422356652869836
3173,0.3214,18,40,18,636699,39745,96961,29295,0.31479692054239006,0.424319235225956
3174,0.3215,14,47,14,636746,39698,96975,29281,0.3144246610062096,0.4244915119094217
3175,0.3216,14,31,14,636777,39667,96989,29267,0.31417912812064375,0.42456552644558565
3176,0.3217,16,38,16,636815,39629,97005,29251,0.31387815232543403,0.42466608594657373
3177,0.3218,15,39,15,636854,39590,97020,29236,0.3135692561145609,0.4247813326359225
3178,0.3219,14,41,14,636895,39549,97034,29222,0.3132445190723609,0.4249174797516395
3179,0.322,9,44,9,636939,39505,97043,29213,0.3128960207831707,0.4251142349893769
3180,0.3221,11,39,11,636978,39466,97054,29202,0.31258712457229754,0.4252635871148133
3181,0.3222,23,38,23,637016,39428,97077,29179,0.3122861487770878,0.42530645560948593
3182,0.3223,12,34,12,637050,39394,97089,29167,0.31201685464453177,0.42541678213561646
3183,0.3224,15,30,15,637080,39364,97104,29152,0.3117792421746293,0.42547726078580184
3184,0.3225,15,27,15,637107,39337,97119,29137,0.31156539095171715,0.4255191751613751
3185,0.3226,18,44,18,637151,39293,97137,29119,0.31121689266252694,0.42564170028649945
3186,0.3227,17,52,17,637203,39241,97154,29102,0.3108050310480294,0.4258226884977247
3187,0.3228,22,33,22,637236,39208,97176,29080,0.31054365733113676,0.42584348641049674
3188,0.3229,20,29,20,637265,39179,97196,29060,0.31031396527689775,0.425856181948739
3189,0.323,17,41,17,637306,39138,97213,29043,0.30998922823469777,0.42596911162933954
3190,0.3231,13,43,13,637349,39095,97226,29030,0.30964865036117095,0.42612844036697245
3191,0.3232,11,47,11,637396,39048,97237,29019,0.3092763908249905,0.4263299396183172
3192,0.3233,22,34,22,637430,39014,97259,28997,0.3090070966924344,0.4263575009924865
3193,0.3234,18,36,18,637466,38978,97277,28979,0.30872196172855154,0.42643141986844624
3194,0.3235,18,36,18,637502,38942,97295,28961,0.3084368267646686,0.42650545631268133
3195,0.3236,26,44,26,637546,38898,97321,28935,0.3080883284754784,0.426562292689399
3196,0.3237,21,46,21,637592,38852,97342,28914,0.30772398935496137,0.42667414337573417
3197,0.3238,16,43,16,637635,38809,97358,28898,0.30738341148143455,0.42680963563590174
3198,0.3239,18,46,18,637681,38763,97376,28880,0.3070190723609175,0.42694735597179306
3199,0.324,19,23,19,637704,38740,97395,28861,0.306836902800659,0.42693155426694873
3200,0.3241,14,38,14,637742,38702,97409,28847,0.30653592700544924,0.4270529541518009
3201,0.3242,10,34,10,637776,38668,97419,28837,0.3062666328728932,0.42718317161691727
3202,0.3243,17,37,17,637813,38631,97436,28820,0.30597357749334686,0.4272731316066478
3203,0.3244,21,38,21,637851,38593,97457,28799,0.3056726016981371,0.42733558879392214
3204,0.3245,18,34,18,637885,38559,97475,28781,0.30540330756558104,0.4273982773982774
3205,0.3246,17,46,17,637931,38513,97492,28764,0.305038968445064,0.4275458180358815
3206,0.3247,27,37,27,637968,38476,97519,28737,0.3047459130655177,0.4275512177703718
3207,0.3248,17,28,17,637996,38448,97536,28720,0.30452414142694206,0.42758456407813245
3208,0.3249,15,38,15,638034,38410,97551,28705,0.30422316563173235,0.4276987260671981
3209,0.325,21,33,21,638067,38377,97572,28684,0.3039617919148397,0.42772997718495104
3210,0.3251,23,46,23,638113,38331,97595,28661,0.30359745279432265,0.42782720324814905
3211,0.3252,16,39,16,638152,38292,97611,28645,0.3032885565834495,0.4279397044982596
3212,0.3253,18,41,18,638193,38251,97629,28627,0.3029638195412495,0.4280480875624271
3213,0.3254,16,39,16,638232,38212,97645,28611,0.30265492333037636,0.42816096254283703
3214,0.3255,20,40,20,638272,38172,97665,28591,0.3023381067038398,0.4282461842637389
3215,0.3256,19,47,19,638319,38125,97684,28572,0.30196584716765934,0.4283850847864222
3216,0.3257,12,40,12,638359,38085,97696,28560,0.3016490305411228,0.42853927526446095
3217,0.3258,18,41,18,638400,38044,97714,28542,0.3013242934989228,0.42864866488451026
3218,0.3259,17,35,17,638435,38009,97731,28525,0.3010470789507033,0.4287281690564223
3219,0.326,10,34,10,638469,37975,97741,28515,0.30077778481814726,0.4288614829297639
3220,0.3261,26,37,26,638506,37938,97767,28489,0.30048472943860094,0.428876812139642
3221,0.3262,12,36,12,638542,37902,97779,28477,0.30019959447471806,0.42900616158724897
3222,0.3263,13,36,13,638578,37866,97792,28464,0.2999144595108351,0.429127091813659
3223,0.3264,15,33,15,638611,37833,97807,28449,0.29965308579394245,0.42921155064723454
3224,0.3265,21,48,21,638659,37785,97828,28428,0.2992729058420986,0.4293416700647909
3225,0.3266,13,30,13,638689,37755,97841,28415,0.2990352933721962,0.4294242103672359
3226,0.3267,18,34,18,638723,37721,97859,28397,0.2987659992396401,0.4294897002329169
3227,0.3268,14,45,14,638768,37676,97873,28383,0.29840958053478644,0.42966136332672306
3228,0.3269,15,38,15,638806,37638,97888,28368,0.29810860473957673,0.42977911098991
3229,0.327,15,26,15,638832,37612,97903,28353,0.29790267393232794,0.42981884332600623
3230,0.3271,13,40,13,638872,37572,97916,28340,0.2975858573057914,0.4299672290326496
3231,0.3272,13,32,13,638904,37540,97929,28327,0.2973324040045622,0.4300636130383956
3232,0.3273,17,35,17,638939,37505,97946,28310,0.2970551894563427,0.4301451036997645
3233,0.3274,16,37,16,638976,37468,97962,28294,0.29676213407679636,0.43024847176180775
3234,0.3275,21,50,21,639026,37418,97983,28273,0.29636611329362567,0.4303938134599869
3235,0.3276,21,29,21,639055,37389,98004,28252,0.29613642123938666,0.43040173062567605
3236,0.3277,21,29,21,639084,37360,98025,28231,0.29590672918514765,0.4304096598618713
3237,0.3278,14,26,14,639110,37334,98039,28217,0.29570079837789887,0.43045872679287883
3238,0.3279,15,33,15,639143,37301,98054,28202,0.2954394246610062,0.4305451658702655
3239,0.328,18,39,18,639182,37262,98072,28184,0.29513052845013305,0.4306451120007334
3240,0.3281,14,35,14,639217,37227,98086,28170,0.29485331390191355,0.4307537042983623
3241,0.3282,12,38,12,639255,37189,98098,28158,0.29455233810670384,0.4308996587448544
3242,0.3283,20,41,20,639296,37148,98118,28138,0.29422760106450385,0.43099592561958155
3243,0.3284,11,36,11,639332,37112,98129,28127,0.29394246610062097,0.4311378163368537
3244,0.3285,16,27,16,639359,37085,98145,28111,0.2937286148777088,0.4311767593103871
3245,0.3286,17,28,17,639387,37057,98162,28094,0.2935068432391332,0.43121364215437985
3246,0.3287,16,34,16,639421,37023,98178,28078,0.2932375491065771,0.4312990583861999
3247,0.3288,20,38,20,639459,36985,98198,28058,0.29293657331136735,0.4313761665359839
3248,0.3289,11,38,11,639497,36947,98209,28047,0.29263559751615764,0.43153214142843954
3249,0.329,13,42,13,639539,36905,98222,28034,0.29230294005829427,0.43169743913518843
3250,0.3291,22,34,22,639573,36871,98244,28012,0.29203364592573816,0.4317309618852396
3251,0.3292,22,24,22,639597,36847,98266,27990,0.29184355594981626,0.43169795024445917
3252,0.3293,22,46,22,639643,36801,98288,27968,0.2914792168292992,0.43181151476786733
3253,0.3294,19,28,19,639671,36773,98307,27949,0.2912574451907236,0.43183152560180466
3254,0.3295,20,35,20,639706,36738,98327,27929,0.2909802306425041,0.4318895263426477
3255,0.3296,17,33,17,639739,36705,98344,27912,0.29071885692561145,0.4319606295556897
3256,0.3297,24,30,24,639769,36675,98368,27888,0.29048124445570905,0.43195018818828124
3257,0.3298,20,37,20,639806,36638,98388,27868,0.29018818907616273,0.43202182742690604
3258,0.3299,14,33,14,639839,36605,98402,27854,0.28992681535927006,0.43211964194294045
3259,0.33,12,24,12,639863,36581,98414,27842,0.2897367253833481,0.4321748443878739
3260,0.3301,11,34,11,639897,36547,98425,27831,0.28946743125079205,0.43230606729006804
3261,0.3302,16,32,16,639929,36515,98441,27815,0.2892139779495628,0.43237991605782683
3262,0.3303,22,42,22,639971,36473,98463,27793,0.2888813204916994,0.4324681791304889
3263,0.3304,8,40,8,640011,36433,98471,27785,0.28856450386516286,0.4326668535301629
3264,0.3305,21,21,21,640032,36412,98492,27764,0.28839817513623117,0.43262278733482923
3265,0.3306,14,40,14,640072,36372,98506,27750,0.2880813585096946,0.4327687845045382
3266,0.3307,13,40,13,640112,36332,98519,27737,0.28776454188315803,0.43292387894301454
3267,0.3308,18,37,18,640149,36295,98537,27719,0.2874714865036117,0.4330146530446465
3268,0.3309,18,21,18,640170,36274,98555,27701,0.28730515777468,0.43299726455646737
3269,0.331,34,41,34,640211,36233,98589,27667,0.28698042073248003,0.4329733959311424
3270,0.3311,12,21,12,640232,36212,98601,27655,0.28681409200354835,0.43300922229007155
3271,0.3312,13,41,13,640273,36171,98614,27642,0.28648935496134836,0.4331719242160688
3272,0.3313,18,33,18,640306,36138,98632,27624,0.2862279812444557,0.4332360967347323
3273,0.3314,21,43,21,640349,36095,98653,27603,0.2858874033709289,0.4333417061760181
3274,0.3315,11,37,11,640386,36058,98664,27592,0.2855943479913826,0.4334956794972506
3275,0.3316,15,28,15,640414,36030,98679,27577,0.285372576352807,0.4335529108431462
3276,0.3317,17,26,17,640440,36004,98696,27560,0.2851666455455582,0.4335787552702788
3277,0.3318,23,34,23,640474,35970,98719,27537,0.28489735141300215,0.4336057442486655
3278,0.3319,21,41,21,640515,35929,98740,27516,0.28457261437080217,0.4336984789975569
3279,0.332,18,31,18,640546,35898,98758,27498,0.28432708148523633,0.4337497633920121
3280,0.3321,14,28,14,640574,35870,98772,27484,0.28410530984666077,0.43381633361745114
3281,0.3322,15,26,15,640600,35844,98787,27469,0.283899379039412,0.4338603446369624
3282,0.3323,12,34,12,640634,35810,98799,27457,0.28363008490685593,0.4339861223070479
3283,0.3324,22,38,22,640672,35772,98821,27435,0.28332910911164616,0.4340500261047036
3284,0.3325,14,24,14,640696,35748,98835,27421,0.28313901913572426,0.4340895059285409
3285,0.3326,10,22,10,640718,35726,98845,27411,0.28296476999112913,0.4341511316660595
3286,0.3327,18,36,18,640754,35690,98863,27393,0.28267963502724625,0.4342374332228968
3287,0.3328,17,24,17,640778,35666,98880,27376,0.2824895450513243,0.4342501824180705
3288,0.3329,12,29,12,640807,35637,98892,27364,0.2822598529970853,0.43434231202679324
3289,0.333,15,26,15,640833,35611,98907,27349,0.28205392218983655,0.4343869123252859
3290,0.3331,20,36,20,640869,35575,98927,27329,0.2817687872259536,0.4344556784942134
3291,0.3332,16,26,16,640895,35549,98943,27313,0.2815628564187049,0.43449142566256244
3292,0.3333,19,25,19,640920,35524,98962,27294,0.28136484602711953,0.4344932980992709
3293,0.3334,14,35,14,640955,35489,98976,27280,0.28108763147890004,0.434609440966082
3294,0.3335,16,36,16,640991,35453,98992,27264,0.2808024965150171,0.4347146706634565
3295,0.3336,15,29,15,641020,35424,99007,27249,0.2805728044607781,0.43478052749988033
3296,0.3337,17,34,17,641054,35390,99024,27232,0.28030351032822204,0.434863147136789
3297,0.3338,18,33,18,641087,35357,99042,27214,0.2800421366113294,0.43492991961132155
3298,0.3339,15,23,15,641110,35334,99057,27199,0.27985996705107086,0.43495434410631184
3299,0.334,16,36,16,641146,35298,99073,27183,0.2795748320871879,0.43506025831852885
3300,0.3341,12,23,12,641169,35275,99085,27171,0.2793926625269294,0.4351119367133203
3301,0.3342,16,32,16,641201,35243,99101,27155,0.2791392092257002,0.4351902304561044
3302,0.3343,24,26,24,641227,35217,99125,27131,0.2789332784184514,0.4351542952460384
3303,0.3344,17,27,17,641254,35190,99142,27114,0.2787194271955392,0.43518875192604006
3304,0.3345,16,25,16,641279,35165,99158,27098,0.27852141680395387,0.43521834797552317
3305,0.3346,16,26,16,641305,35139,99174,27082,0.2783154859967051,0.4352549782227865
3306,0.3347,19,33,19,641338,35106,99193,27063,0.27805411227981247,0.4353134198716402
3307,0.3348,10,31,10,641369,35075,99203,27053,0.27780857939424664,0.43543973731650787
3308,0.3349,16,24,16,641393,35051,99219,27037,0.2776184894183247,0.4354625692565391
3309,0.335,27,30,27,641423,35021,99246,27010,0.27738087694842223,0.43542744756653934
3310,0.3351,22,23,22,641446,34998,99268,26988,0.2771987073881637,0.4353886361436453
3311,0.3352,18,29,18,641475,34969,99286,26970,0.2769690153339247,0.43542840536657035
3312,0.3353,17,28,17,641503,34941,99303,26953,0.27674724369534914,0.4354703202249006
3313,0.3354,9,42,9,641545,34899,99312,26944,0.27641458623748577,0.4356839092540789
3314,0.3355,16,28,16,641573,34871,99328,26928,0.27619281459891015,0.4357352060712957
3315,0.3356,8,25,8,641598,34846,99336,26920,0.2759948042073248,0.43583848719360163
3316,0.3357,20,49,20,641647,34797,99356,26900,0.2756067038398175,0.4360017504902994
3317,0.3358,13,40,13,641687,34757,99369,26887,0.27528988721328096,0.4361657257802868
3318,0.3359,12,40,12,641727,34717,99381,26875,0.2749730705867444,0.43633913495259125
3319,0.336,16,40,16,641767,34677,99397,26859,0.2746562539602078,0.43647620904836193
3320,0.3361,22,42,22,641809,34635,99419,26837,0.27432359650234445,0.4365727485684539
3321,0.3362,12,33,12,641842,34602,99431,26825,0.2740622227854518,0.4366972178358051
3322,0.3363,17,43,17,641885,34559,99448,26808,0.27372164491192497,0.43684716541463653
3323,0.3364,20,41,20,641926,34518,99468,26788,0.273396907869725,0.436955599778162
3324,0.3365,17,25,17,641951,34493,99485,26771,0.27319889747813964,0.4369776704100287
3325,0.3366,12,36,12,641987,34457,99497,26759,0.27291376251425675,0.4371242812336644
3326,0.3367,11,35,11,642022,34422,99508,26748,0.27263654796603726,0.4372731731240804
3327,0.3368,11,25,11,642047,34397,99519,26737,0.2724385375744519,0.43735073772368893
3328,0.3369,15,42,15,642089,34355,99534,26722,0.27210588011658854,0.4375133028799712
3329,0.337,19,36,19,642125,34319,99553,26703,0.2718207451527056,0.43759627675264656
3330,0.3371,11,30,11,642155,34289,99564,26692,0.2715831326828032,0.4377101064265919
3331,0.3372,14,40,14,642195,34249,99578,26678,0.2712663160562666,0.4378682685837149
3332,0.3373,14,34,14,642229,34215,99592,26664,0.27099702192371056,0.43798354112255455
3333,0.3374,15,36,15,642265,34179,99607,26649,0.2707118869598277,0.4381041625567173
3334,0.3375,16,25,16,642290,34154,99623,26633,0.27051387656824233,0.43813644364749044
3335,0.3376,16,26,16,642316,34128,99639,26617,0.27030794576099354,0.4381759815622685
3336,0.3377,20,38,20,642354,34090,99659,26597,0.2700069699657838,0.438265196829634
3337,0.3378,21,23,21,642377,34067,99680,26576,0.26982480040552526,0.4382368946127335
3338,0.3379,24,21,24,642398,34046,99704,26552,0.26965847167659357,0.43816627611472325
3339,0.338,17,33,17,642431,34013,99721,26535,0.2693970979597009,0.4382473409526326
3340,0.3381,11,29,11,642460,33984,99732,26524,0.2691674059054619,0.43835525880875253
3341,0.3382,22,32,22,642492,33952,99754,26502,0.2689139526042327,0.43838290270288155
3342,0.3383,14,38,14,642530,33914,99768,26488,0.26861297680902296,0.43852852554551175
3343,0.3384,13,32,13,642562,33882,99781,26475,0.2683595235077937,0.43864009145583777
3344,0.3385,25,25,25,642587,33857,99806,26450,0.26816151311620834,0.43858921849868177
3345,0.3386,11,26,11,642613,33831,99817,26439,0.26795558230895955,0.4386759581881533
3346,0.3387,19,20,19,642633,33811,99836,26420,0.2677971739956913,0.4386445518088692
3347,0.3388,14,31,14,642664,33780,99850,26406,0.26755164111012547,0.43873990629049947
3348,0.3389,17,39,17,642703,33741,99867,26389,0.2672427448992523,0.43886579078662896
3349,0.339,16,35,16,642738,33706,99883,26373,0.2669655303510328,0.4389720201734383
3350,0.3391,12,22,12,642760,33684,99895,26361,0.2667912812064377,0.4390207344491631
3351,0.3392,13,27,13,642787,33657,99908,26348,0.2665774299835255,0.43909674193817183
3352,0.3393,21,33,21,642820,33624,99929,26327,0.26631605626663285,0.4391419659388501
3353,0.3394,14,36,14,642856,33588,99943,26313,0.26603092130274997,0.43927480342565234
3354,0.3395,14,30,14,642886,33558,99957,26299,0.2657933088328476,0.4393638170974155
3355,0.3396,15,37,15,642923,33521,99972,26284,0.26550025345330125,0.43949502549954017
3356,0.3397,12,30,12,642953,33491,99984,26272,0.2652626409833988,0.4396030989073507
3357,0.3398,11,20,11,642973,33471,99995,26261,0.2651042326701305,0.43964709033683785
3358,0.3399,16,28,16,643001,33443,100011,26245,0.26488246103155494,0.43970312290577673
3359,0.34,13,35,13,643036,33408,100024,26232,0.26460524648333544,0.4398390342052314
3360,0.3401,21,36,21,643072,33372,100045,26211,0.26432011151945256,0.4399073561250692
3361,0.3402,20,33,20,643105,33339,100065,26191,0.2640587378025599,0.43996304384344026
3362,0.3403,16,27,16,643132,33312,100081,26175,0.2638448865796477,0.44001210348479497
3363,0.3404,19,40,19,643172,33272,100100,26156,0.2635280699531111,0.4401292320118463
3364,0.3405,16,39,16,643211,33233,100116,26140,0.26321917374223797,0.44026746164081315
3365,0.3406,15,35,15,643246,33198,100131,26125,0.2629419591940185,0.44038568514741333
3366,0.3407,10,34,10,643280,33164,100141,26115,0.2626726650614624,0.4405438688236981
3367,0.3408,22,30,22,643310,33134,100163,26093,0.26243505259156,0.44055920441690444
3368,0.3409,23,30,23,643340,33104,100186,26070,0.2621974401216576,0.4405651130564099
3369,0.341,17,34,17,643374,33070,100203,26053,0.2619281459891015,0.4406576120968151
3370,0.3411,19,31,19,643405,33039,100222,26034,0.2616826131035357,0.440708953328932
3371,0.3412,22,25,22,643430,33014,100244,26012,0.26148460271195034,0.4406871548131332
3372,0.3413,23,28,23,643458,32986,100267,25989,0.2612628310733747,0.4406782534972446
3373,0.3414,25,22,25,643480,32964,100292,25964,0.2610885819287796,0.4406054846592452
3374,0.3415,9,28,9,643508,32936,100301,25955,0.26086681029020403,0.44072948328267475
3375,0.3416,21,35,21,643543,32901,100322,25934,0.26058959574198454,0.4407920455511175
3376,0.3417,18,39,18,643582,32862,100340,25916,0.2602806995311114,0.44091326686855625
3377,0.3418,10,26,10,643608,32836,100350,25906,0.26007476872386265,0.4410132443566784
3378,0.3419,14,25,14,643633,32811,100364,25892,0.2598767583322773,0.44106774781527347
3379,0.342,19,24,19,643657,32787,100383,25873,0.25968666835635534,0.44106716672349133
3380,0.3421,21,29,21,643686,32758,100404,25852,0.25945697630211634,0.4410851390547688
3381,0.3422,13,36,13,643722,32722,100417,25839,0.25917184133823346,0.4412322193951606
3382,0.3423,11,30,11,643752,32692,100428,25828,0.258934228868331,0.4413533834586466
3383,0.3424,22,33,22,643785,32659,100450,25806,0.25867285515143834,0.4413922859830668
3384,0.3425,16,29,16,643814,32630,100466,25790,0.25844316309719934,0.4414584046559398
3385,0.3426,9,33,9,643847,32597,100475,25781,0.25818178938030667,0.4416218438452842
3386,0.3427,16,30,16,643877,32567,100491,25765,0.2579441769104043,0.4416958101899472
3387,0.3428,14,25,14,643902,32542,100505,25751,0.25774616651881893,0.44175115365481277
3388,0.3429,12,25,12,643927,32517,100517,25739,0.25754815612723353,0.44182573468827246
3389,0.343,13,27,13,643954,32490,100530,25726,0.25733430490432135,0.44190600522193213
3390,0.3431,11,42,11,643996,32448,100541,25715,0.257001647446458,0.4421195605453639
3391,0.3432,16,27,16,644023,32421,100557,25699,0.2567877962235458,0.44217136958017894
3392,0.3433,13,43,13,644066,32378,100570,25686,0.256447218350019,0.4423739322127308
3393,0.3434,23,29,23,644095,32349,100593,25663,0.25621752629578,0.4423739915879473
3394,0.3435,11,27,11,644122,32322,100604,25652,0.2560036750728678,0.44247421257805225
3395,0.3436,15,25,15,644147,32297,100619,25637,0.25580566468128246,0.4425207995305002
3396,0.3437,20,32,20,644179,32265,100639,25617,0.25555221138005324,0.4425728205659791
3397,0.3438,10,29,10,644208,32236,100649,25607,0.25532251932581423,0.4426983386062272
3398,0.3439,13,28,13,644236,32208,100662,25594,0.2551007476872386,0.44278744680114873
3399,0.344,12,23,12,644259,32185,100674,25582,0.2549185781269801,0.44284799279865666
3400,0.3441,18,29,18,644288,32156,100692,25564,0.2546888860727411,0.4428967428967429
3401,0.3442,15,30,15,644318,32126,100707,25549,0.2544512736028387,0.44298222800173387
3402,0.3443,17,28,17,644346,32098,100724,25532,0.2542295019642631,0.44303314246052405
3403,0.3444,12,20,12,644366,32078,100736,25520,0.2540710936509948,0.4430709399631932
3404,0.3445,10,34,10,644400,32044,100746,25510,0.25380179951843873,0.4432359175730618
3405,0.3446,16,29,16,644429,32015,100762,25494,0.2535721074641997,0.44330452624806554
3406,0.3447,23,25,23,644454,31990,100785,25471,0.2533740970726144,0.4432745688379945
3407,0.3448,13,25,13,644479,31965,100798,25458,0.25317608668102903,0.44334151820699025
3408,0.3449,19,26,19,644505,31939,100817,25439,0.25297015587378024,0.4433580814946495
3409,0.345,15,32,15,644537,31907,100832,25424,0.252716702572551,0.44345990825208004
3410,0.3451,14,27,14,644564,31880,100846,25410,0.25250285134963885,0.44353290277535345
3411,0.3452,18,31,18,644595,31849,100864,25392,0.252257318464073,0.44359812022850753
3412,0.3453,12,46,12,644641,31803,100876,25380,0.2518929793435559,0.4438382036619275
3413,0.3454,17,27,17,644668,31776,100893,25363,0.25167912812064375,0.4438824620661895
3414,0.3455,17,15,17,644683,31761,100910,25346,0.25156032188569255,0.4438335055247168
3415,0.3456,12,38,12,644721,31723,100922,25334,0.25125934609048284,0.4440121282226545
3416,0.3457,7,32,7,644753,31691,100929,25327,0.25100589278925356,0.44419306184012064
3417,0.3458,11,22,11,644775,31669,100940,25316,0.2508316436446585,0.44425726068263577
3418,0.3459,12,38,12,644813,31631,100952,25304,0.2505306678494487,0.44443663827171337
3419,0.346,14,27,14,644840,31604,100966,25290,0.25031681662653654,0.4445108447287939
3420,0.3461,14,32,14,644872,31572,100980,25276,0.2500633633253073,0.4446242611877287
3421,0.3462,15,29,15,644901,31543,100995,25261,0.2498336712710683,0.4447045982677276
3422,0.3463,12,31,12,644932,31512,101007,25249,0.24958813838550248,0.44483007698948224
3423,0.3464,12,28,12,644960,31484,101019,25237,0.2493663667469269,0.4449322120554997
3424,0.3465,12,30,12,644990,31454,101031,25225,0.24912875427702447,0.44505019495756803
3425,0.3466,16,28,16,645018,31426,101047,25209,0.24890698263844888,0.44511344574909506
3426,0.3467,11,27,11,645045,31399,101058,25198,0.2486931314155367,0.44521794441401485
3427,0.3468,12,26,12,645071,31373,101070,25186,0.2484872006082879,0.44530490284481694
3428,0.3469,14,35,14,645106,31338,101084,25172,0.24820998606006844,0.445443284374447
3429,0.347,18,23,18,645129,31315,101102,25154,0.2480278164998099,0.4454479448901167
3430,0.3471,15,28,15,645157,31287,101117,25139,0.2478060448612343,0.44552156807145643
3431,0.3472,16,29,16,645186,31258,101133,25123,0.2475763528069953,0.44559337365424523
3432,0.3473,17,23,17,645209,31235,101150,25106,0.2473941832467368,0.4456079941783071
3433,0.3474,15,31,15,645240,31204,101165,25091,0.24714865036117095,0.44570565769606535
3434,0.3475,23,33,23,645273,31171,101188,25068,0.2468872766442783,0.44574050036451573
3435,0.3476,15,21,15,645294,31150,101203,25053,0.2467209479153466,0.445759123178478
3436,0.3477,23,25,23,645319,31125,101226,25030,0.24652293752376125,0.44573056718012644
3437,0.3478,21,32,21,645351,31093,101247,25009,0.246269484222532,0.4457773341413853
3438,0.3479,22,35,22,645386,31058,101269,24987,0.2459922696743125,0.4458381657596574
3439,0.348,14,24,14,645410,31034,101283,24973,0.24580217969839058,0.4458906922348992
3440,0.3481,23,24,23,645434,31010,101306,24950,0.24561208972246865,0.4458541815582559
3441,0.3482,16,26,16,645460,30984,101322,24934,0.24540615891521986,0.4459029292893165
3442,0.3483,18,35,18,645495,30949,101340,24916,0.2451289443670004,0.4460037590620245
3443,0.3484,7,24,7,645519,30925,101347,24909,0.24493885439107843,0.44612601640577426
3444,0.3485,18,37,18,645556,30888,101365,24891,0.24464579901153213,0.4462432098101436
3445,0.3486,27,29,27,645585,30859,101392,24864,0.24441610695729313,0.446207131705041
3446,0.3487,12,40,12,645625,30819,101404,24852,0.24409929033075656,0.4464083634208115
3447,0.3488,16,28,16,645653,30791,101420,24836,0.24387751869218097,0.4464738346486418
3448,0.3489,13,33,13,645686,30758,101433,24823,0.2436161449752883,0.4466094528705853
3449,0.349,16,27,16,645713,30731,101449,24807,0.24340229375237613,0.4466671468183946
3450,0.3491,15,24,15,645737,30707,101464,24792,0.2432122037764542,0.4467107515450729
3451,0.3492,14,35,14,645772,30672,101478,24778,0.2429349892282347,0.44685302073940486
3452,0.3493,12,29,12,645801,30643,101490,24766,0.2427052971739957,0.44696709920770994
3453,0.3494,19,41,19,645842,30602,101509,24747,0.2423805601317957,0.4471083488409908
3454,0.3495,14,31,14,645873,30571,101523,24733,0.24213502724622987,0.4472190076667149
3455,0.3496,19,32,19,645905,30539,101542,24714,0.24188157394500062,0.4472879300671457
3456,0.3497,16,39,16,645944,30500,101558,24698,0.2415726777341275,0.4474437479618827
3457,0.3498,18,21,18,645965,30479,101576,24680,0.24140634900519578,0.44743378233833103
3458,0.3499,12,22,12,645987,30457,101588,24668,0.24123209986060068,0.4474920634920635
3459,0.35,10,24,10,646011,30433,101598,24658,0.24104200988467875,0.44758672015392714
3460,0.3501,14,27,14,646038,30406,101612,24644,0.24082815866176657,0.44766575840145323
3461,0.3502,10,38,10,646076,30368,101622,24634,0.24052718286655683,0.4478746227409912
3462,0.3503,20,28,20,646104,30340,101642,24614,0.24030541122798124,0.4479018815736798
3463,0.3504,19,38,19,646142,30302,101661,24595,0.2400044354327715,0.44802083902581197
3464,0.3505,16,26,16,646168,30276,101677,24579,0.23979850462552274,0.4480721903199344
3465,0.3506,14,36,14,646204,30240,101691,24565,0.23951336966163983,0.4482255268679865
3466,0.3507,18,25,18,646229,30215,101709,24547,0.23931535927005448,0.44824878565428583
3467,0.3508,16,29,16,646258,30186,101725,24531,0.23908566721581548,0.4483250178189594
3468,0.3509,18,20,18,646278,30166,101743,24513,0.2389272589025472,0.4483073940635344
3469,0.351,22,24,22,646302,30142,101765,24491,0.23873716892662528,0.44828217377775337
3470,0.3511,13,30,13,646332,30112,101778,24478,0.23849955645672286,0.44839714233376077
3471,0.3512,14,27,14,646359,30085,101792,24464,0.23828570523381068,0.44847751562815086
3472,0.3513,9,22,9,646381,30063,101801,24455,0.23811145608921555,0.4485674456142925
3473,0.3514,18,22,18,646403,30041,101819,24437,0.23793720694462045,0.4485663937736334
3474,0.3515,22,30,22,646433,30011,101841,24415,0.23769959447471803,0.4485907470694154
3475,0.3516,16,22,16,646455,29989,101857,24399,0.23752534533012293,0.448609987497242
3476,0.3517,11,23,11,646478,29966,101868,24388,0.2373431757698644,0.44868822901718364
3477,0.3518,14,25,14,646503,29941,101882,24374,0.23714516537827907,0.4487526465985455
3478,0.3519,9,28,9,646531,29913,101891,24365,0.23692339373970345,0.4488927373889974
3479,0.352,21,30,21,646561,29883,101912,24344,0.23668578126980103,0.4489276559647408
3480,0.3521,16,26,16,646587,29857,101928,24328,0.23647985046255227,0.44898034511396145
3481,0.3522,17,36,17,646623,29821,101945,24311,0.23619471549866938,0.4491058893076184
3482,0.3523,12,27,12,646650,29794,101957,24299,0.23598086427575718,0.4492078457471392
3483,0.3524,13,30,13,646680,29764,101970,24286,0.23574325180585476,0.44932469935245145
3484,0.3525,17,34,17,646714,29730,101987,24269,0.2354739576732987,0.44943424878238486
3485,0.3526,15,18,15,646732,29712,102002,24254,0.23533139019135724,0.44943112329985546
3486,0.3527,13,21,13,646753,29691,102015,24241,0.23516506146242555,0.4494734109619521
3487,0.3528,11,25,11,646778,29666,102026,24230,0.2349670510708402,0.4495695413388749
3488,0.3529,19,19,19,646797,29647,102045,24211,0.23481656317323532,0.4495339596717294
3489,0.353,19,30,19,646827,29617,102064,24192,0.2345789507033329,0.44959021724990245
3490,0.3531,11,24,11,646851,29593,102075,24181,0.23438886072741097,0.44967828318518244
3491,0.3532,15,30,15,646881,29563,102090,24166,0.23415124825750855,0.4497757263302872
3492,0.3533,20,27,20,646908,29536,102110,24146,0.23393739703459637,0.4497969524235312
3493,0.3534,21,34,21,646942,29502,102131,24125,0.2336681029020403,0.4498666716392862
3494,0.3535,12,23,12,646965,29479,102143,24113,0.23348593334178178,0.4499365576951784
3495,0.3536,14,38,14,647003,29441,102157,24099,0.23318495754657204,0.4501120657452372
3496,0.3537,13,35,13,647038,29406,102170,24086,0.23290774299835254,0.450272938009422
3497,0.3538,14,30,14,647068,29376,102184,24072,0.23267013052845012,0.45038167938931295
3498,0.3539,22,22,22,647090,29354,102206,24050,0.23249588138385502,0.45034079844206426
3499,0.354,18,27,18,647117,29327,102224,24032,0.23228203016094284,0.45038325305946514
3500,0.3541,21,13,21,647130,29314,102245,24011,0.23217906475731848,0.4502766057196437
3501,0.3542,11,26,11,647156,29288,102256,24000,0.2319731339500697,0.45038282540159136
3502,0.3543,19,32,19,647188,29256,102275,23981,0.23171968064884046,0.450457388658264
3503,0.3544,19,30,19,647218,29226,102294,23962,0.23148206817893804,0.4505151537940889
3504,0.3545,14,30,14,647248,29196,102308,23948,0.23124445570903562,0.45062471774800544
3505,0.3546,17,26,17,647274,29170,102325,23931,0.23103852490178683,0.4506694789175345
3506,0.3547,16,30,16,647304,29140,102341,23915,0.23080091243188441,0.45075864668739984
3507,0.3548,18,32,18,647336,29108,102359,23897,0.23054745913065516,0.450844259975474
3508,0.3549,21,29,21,647365,29079,102380,23876,0.23031776707641616,0.4508733830610896
3509,0.355,20,22,20,647387,29057,102400,23856,0.23014351793182106,0.4508532874718878
3510,0.3551,18,26,18,647413,29031,102418,23838,0.2299375871245723,0.45088804403336546
3511,0.3552,11,19,11,647432,29012,102429,23827,0.22978709922696744,0.45093586176876926
3512,0.3553,19,24,19,647456,28988,102448,23808,0.2295970092510455,0.4509432532767634
3513,0.3554,16,21,16,647477,28967,102464,23792,0.2294306805221138,0.4509562349551735
3514,0.3555,14,31,14,647508,28936,102478,23778,0.22918514763654796,0.45107561558599235
3515,0.3556,15,32,15,647540,28904,102493,23763,0.2289316943353187,0.4511933468775514
3516,0.3557,13,18,13,647558,28886,102506,23750,0.22878912685337727,0.4512120981837526
3517,0.3558,21,24,21,647582,28862,102527,23729,0.22859903687745534,0.45119887433211003
3518,0.3559,11,30,11,647612,28832,102538,23718,0.22836142440755292,0.4513415794481446
3519,0.356,13,21,13,647633,28811,102551,23705,0.2281950956786212,0.45138624419224616
3520,0.3561,14,22,14,647655,28789,102565,23691,0.2280208465340261,0.4514291158536585
3521,0.3562,14,24,14,647679,28765,102579,23677,0.22783075655810417,0.4514892643301171
3522,0.3563,17,44,17,647723,28721,102596,23660,0.22748225826891394,0.4516904984631832
3523,0.3564,21,28,21,647751,28693,102617,23639,0.22726048663033835,0.45171214553237027
3524,0.3565,13,27,13,647778,28666,102630,23626,0.22704663540742617,0.4518090721334047
3525,0.3566,19,26,19,647804,28640,102649,23607,0.2268407046001774,0.4518345550940724
3526,0.3567,13,25,13,647829,28615,102662,23594,0.22664269420859207,0.451914420885288
3527,0.3568,8,30,8,647859,28585,102670,23586,0.22640508173868965,0.4520902417051619
3528,0.3569,17,27,17,647886,28558,102687,23569,0.22619123051577747,0.45214572102749057
3529,0.357,23,27,23,647913,28531,102710,23546,0.2259773792928653,0.45213818000268835
3530,0.3571,13,19,13,647932,28512,102723,23533,0.2258268913952604,0.4521663944663272
3531,0.3572,15,25,15,647957,28487,102738,23518,0.22562888100367506,0.4522257475242765
3532,0.3573,9,21,9,647978,28466,102747,23509,0.22546255227474338,0.45231361231361233
3533,0.3574,15,24,15,648002,28442,102762,23494,0.22527246229882145,0.4523644485520641
3534,0.3575,15,30,15,648032,28412,102777,23479,0.22503484982891903,0.45246767262145654
3535,0.3576,16,26,16,648058,28386,102793,23463,0.22482891902167026,0.45252560319388996
3536,0.3577,8,25,8,648083,28361,102801,23455,0.22463090863008492,0.4526594102207812
3537,0.3578,12,27,12,648110,28334,102813,23443,0.22441705740717272,0.45276860382022904
3538,0.3579,18,24,18,648134,28310,102831,23425,0.22422696743125078,0.45278824780129506
3539,0.358,8,13,8,648147,28297,102839,23417,0.22412400202762642,0.4528174188807673
3540,0.3581,17,25,17,648172,28272,102856,23400,0.22392599163604107,0.4528564793311658
3541,0.3582,12,23,12,648195,28249,102868,23388,0.22374382207578253,0.452931037821717
3542,0.3583,11,31,11,648226,28218,102879,23377,0.2234982891902167,0.4530865393933521
3543,0.3584,17,26,17,648252,28192,102896,23360,0.22329235838296793,0.45313469894475483
3544,0.3585,9,24,9,648276,28168,102905,23351,0.223102268407046,0.453250257186669
3545,0.3586,13,29,13,648305,28139,102918,23338,0.222872576352807,0.4533675233599472
3546,0.3587,8,22,8,648327,28117,102926,23330,0.2226983272082119,0.45347639318133226
3547,0.3588,14,20,14,648347,28097,102940,23316,0.2225399188949436,0.4535039775932157
3548,0.3589,18,22,18,648369,28075,102958,23298,0.2223656697503485,0.4535067058571623
3549,0.359,16,15,16,648384,28060,102974,23282,0.2222468635153973,0.45346889486190645
3550,0.3591,13,32,13,648416,28028,102987,23269,0.22199341021416805,0.45361327173129035
3551,0.3592,21,20,21,648436,28008,103008,23248,0.22183500190089975,0.4535664117371625
3552,0.3593,13,20,13,648456,27988,103021,23235,0.22167659358763148,0.45360482595708956
3553,0.3594,13,22,13,648478,27966,103034,23222,0.22150234444303638,0.4536610143002266
3554,0.3595,17,27,17,648505,27939,103051,23205,0.2212884932201242,0.45371891130924447
3555,0.3596,16,31,16,648536,27908,103067,23189,0.22104296033455836,0.4538231207311584
3556,0.3597,16,28,16,648564,27880,103083,23173,0.22082118869598277,0.4539008481382093
3557,0.3598,14,31,14,648595,27849,103097,23159,0.22057565581041694,0.4540268193224592
3558,0.3599,12,30,12,648625,27819,103109,23147,0.22033804334051452,0.45416552211278105
3559,0.36,12,20,12,648645,27799,103121,23135,0.22017963502724622,0.454215258962579
3560,0.3601,16,24,16,648669,27775,103137,23119,0.2199895450513243,0.45425786929697015
3561,0.3602,10,35,10,648704,27740,103147,23109,0.2197123305031048,0.45446321461582334
3562,0.3603,12,21,12,648725,27719,103159,23097,0.2195460017741731,0.45452219773299746
3563,0.3604,17,40,17,648765,27679,103176,23080,0.21922918514763653,0.4546976890797691
3564,0.3605,18,16,18,648781,27663,103194,23062,0.21910245849702192,0.454647609659931
3565,0.3606,10,21,10,648802,27642,103204,23052,0.21893612976809024,0.45472837022132795
3566,0.3607,14,26,14,648828,27616,103218,23038,0.21873019896084148,0.45481107118884984
3567,0.3608,7,29,7,648857,27587,103225,23031,0.21850050690660247,0.4549962463945632
3568,0.3609,12,24,12,648881,27563,103237,23019,0.2183104169306805,0.45508283579138825
3569,0.361,18,21,18,648902,27542,103255,23001,0.21814408820174883,0.4550778545001286
3570,0.3611,18,24,18,648926,27518,103273,22983,0.2179539982258269,0.45509989901190073
3571,0.3612,18,26,18,648952,27492,103291,22965,0.21774806741857813,0.45514002021523275
3572,0.3613,18,23,18,648975,27469,103309,22947,0.21756589785831962,0.4551531259917487
3573,0.3614,18,20,18,648995,27449,103327,22929,0.21740748954505132,0.45513914804081146
3574,0.3615,12,18,12,649013,27431,103339,22917,0.21726492206310988,0.45517200286009374
3575,0.3616,9,23,9,649036,27408,103348,22908,0.21708275250285136,0.45528261388027663
3576,0.3617,16,24,16,649060,27384,103364,22892,0.2168926625269294,0.45532659718354684
3577,0.3618,18,24,18,649084,27360,103382,22874,0.21670257255100747,0.4553489668352112
3578,0.3619,21,32,21,649116,27328,103403,22853,0.21644911924977822,0.4554114106932903
3579,0.362,14,24,14,649140,27304,103417,22839,0.2162590292738563,0.45547733482240793
3580,0.3621,16,17,16,649157,27287,103433,22823,0.21612438220757826,0.4554579924166833
3581,0.3622,12,18,12,649175,27269,103445,22811,0.2159818147256368,0.455491214057508
3582,0.3623,15,31,15,649206,27238,103460,22796,0.21573628184007096,0.4556101850741496
3583,0.3624,12,28,12,649234,27210,103472,22784,0.21551451020149537,0.4557346881625795
3584,0.3625,7,21,7,649255,27189,103479,22777,0.21534818147256368,0.4558499779850298
3585,0.3626,16,34,16,649289,27155,103495,22761,0.2150788873400076,0.4559860565750461
3586,0.3627,13,25,13,649314,27130,103508,22748,0.21488087694842226,0.4560728176751273
3587,0.3628,18,23,18,649337,27107,103526,22730,0.21469870738816374,0.4560868431085338
3588,0.3629,13,22,13,649359,27085,103539,22717,0.2145244582435686,0.45614633950443756
3589,0.363,18,25,18,649384,27060,103557,22699,0.21432644785198326,0.45617878172792864
3590,0.3631,13,18,13,649402,27042,103570,22686,0.21418388037004182,0.4562017374517375
3591,0.3632,13,21,13,649423,27021,103583,22673,0.21401755164111014,0.45625226385479134
3592,0.3633,17,18,17,649441,27003,103600,22656,0.21387498415916867,0.4562314988219658
3593,0.3634,21,33,21,649474,26970,103621,22635,0.213613610442276,0.4563048079830662
3594,0.3635,11,23,11,649497,26947,103632,22624,0.2134314408820175,0.45639587662141173
3595,0.3636,14,30,14,649527,26917,103646,22610,0.21319382841211507,0.4565186665859026
3596,0.3637,14,20,14,649547,26897,103660,22596,0.2130354200988468,0.4565494110278221
3597,0.3638,7,25,7,649572,26872,103667,22589,0.21283740970726145,0.4567032611552536
3598,0.3639,13,18,13,649590,26854,103680,22576,0.21269484222531998,0.4567266841998786
3599,0.364,15,21,15,649611,26833,103695,22561,0.2125285134963883,0.45675588128112726
3600,0.3641,13,29,13,649640,26804,103708,22548,0.2122988214421493,0.45688118009401846
3601,0.3642,18,27,18,649667,26777,103726,22530,0.2120849702192371,0.4569330926643276
3602,0.3643,12,15,12,649682,26762,103738,22518,0.2119661639842859,0.4569399350649351
3603,0.3644,19,20,19,649702,26742,103757,22499,0.21180775567101762,0.45691598464694055
3604,0.3645,12,26,12,649728,26716,103769,22487,0.21160182486376886,0.4570249781517387
3605,0.3646,14,21,14,649749,26695,103783,22473,0.21143549613483717,0.45706557110315654
3606,0.3647,21,24,21,649773,26671,103804,22452,0.2112454061589152,0.4570567758483806
3607,0.3648,7,26,7,649799,26645,103811,22445,0.21103947535166645,0.45722143002648197
3608,0.3649,18,24,18,649823,26621,103829,22427,0.21084938537574452,0.45724596313815036
3609,0.365,22,28,22,649851,26593,103851,22405,0.21062761373716893,0.45726356177803174
3610,0.3651,8,18,8,649869,26575,103859,22397,0.2104850462552275,0.4573429714939149
3611,0.3652,17,25,17,649894,26550,103876,22380,0.2102870358636421,0.457388105456775
3612,0.3653,14,22,14,649916,26528,103890,22366,0.210112786719047,0.45743854051621874
3613,0.3654,15,22,15,649938,26506,103905,22351,0.2099385375744519,0.4574779458419469
3614,0.3655,14,26,14,649964,26480,103919,22337,0.20973260676720315,0.4575660118401377
3615,0.3656,17,16,17,649980,26464,103936,22320,0.2096058801165885,0.45752705805182026
3616,0.3657,13,23,13,650003,26441,103949,22307,0.20942371055633,0.457598260441454
3617,0.3658,14,30,14,650033,26411,103963,22293,0.20918609808642757,0.45772421156373194
3618,0.3659,9,22,9,650055,26389,103972,22284,0.20901184894183247,0.45783083023442156
3619,0.366,16,19,16,650074,26370,103988,22268,0.2088613610442276,0.4578313253012048
3620,0.3661,16,25,16,650099,26345,104004,22252,0.20866335065264224,0.4578883470173056
3621,0.3662,18,22,18,650121,26323,104022,22234,0.20848910150804714,0.457894845233437
3622,0.3663,16,24,16,650145,26299,104038,22218,0.2082990115321252,0.45794257682874046
3623,0.3664,17,19,17,650164,26280,104055,22201,0.20814852363452033,0.4579319733503847
3624,0.3665,20,20,20,650184,26260,104075,22181,0.20799011532125206,0.4578972358126381
3625,0.3666,13,27,13,650211,26233,104088,22168,0.20777626409833988,0.45800706596971136
3626,0.3667,11,27,11,650238,26206,104099,22157,0.2075624128754277,0.4581394867977586
3627,0.3668,19,25,19,650263,26181,104118,22138,0.20736440248384236,0.45816345536952335
3628,0.3669,11,24,11,650287,26157,104129,22127,0.20717431250792043,0.45826774915085744
3629,0.367,10,20,10,650307,26137,104139,22117,0.20701590419465213,0.45834542214116963
3630,0.3671,16,28,16,650335,26109,104155,22101,0.20679413255607654,0.458431860609832
3631,0.3672,14,18,14,650353,26091,104169,22087,0.2066515650741351,0.45844576362655154
3632,0.3673,13,23,13,650376,26068,104182,22074,0.20646939551387658,0.4585185492916788
3633,0.3674,13,27,13,650403,26041,104195,22061,0.20625554429096438,0.4586295788116918
3634,0.3675,10,23,10,650426,26018,104205,22051,0.20607337473070586,0.45873639975868025
3635,0.3676,17,17,17,650443,26001,104222,22034,0.20593872766442783,0.45870719267201
3636,0.3677,6,22,6,650465,25979,104228,22028,0.20576447851983273,0.45884975107796777
3637,0.3678,22,22,22,650487,25957,104250,22006,0.2055902293752376,0.4588120009173738
3638,0.3679,14,27,14,650514,25930,104264,21992,0.20537637815232543,0.45891239931555444
3639,0.368,20,19,20,650533,25911,104284,21972,0.20522589025472057,0.458868491949126
3640,0.3681,13,29,13,650562,25882,104297,21959,0.20499619820048157,0.45899960285111097
3641,0.3682,10,30,10,650592,25852,104307,21949,0.20475858573057915,0.45917449425744233
3642,0.3683,11,19,11,650611,25833,104318,21938,0.20460809783297426,0.4592325888091101
3643,0.3684,19,31,19,650642,25802,104337,21919,0.20436256494740845,0.4593156052890761
3644,0.3685,11,21,11,650663,25781,104348,21908,0.20419623621847674,0.4593931514605045
3645,0.3686,9,23,9,650686,25758,104357,21899,0.20401406665821822,0.45951276832364607
3646,0.3687,13,25,13,650711,25733,104370,21886,0.20381605626663288,0.4596064596064596
3647,0.3688,10,26,10,650737,25707,104380,21876,0.20361012545938412,0.4597440262278545
3648,0.3689,16,16,16,650753,25691,104396,21860,0.20348339880876948,0.4597169355008307
3649,0.369,11,31,11,650784,25660,104407,21849,0.20323786592320364,0.45989180997284723
3650,0.3691,15,23,15,650807,25637,104422,21834,0.20305569636294513,0.45994396578964
3651,0.3692,8,18,8,650825,25619,104430,21826,0.20291312888100368,0.46002740014753923
3652,0.3693,16,13,16,650838,25606,104446,21810,0.2028101634773793,0.4599713176986671
3653,0.3694,14,19,14,650857,25587,104460,21796,0.20265967557977443,0.4599962011691957
3654,0.3695,13,30,13,650887,25557,104473,21783,0.202422063109872,0.46013941698352345
3655,0.3696,16,15,16,650902,25542,104489,21767,0.2023032568749208,0.4601027288676573
3656,0.3697,20,20,20,650922,25522,104509,21747,0.20214484856165252,0.46006896697624233
3657,0.3698,15,22,15,650944,25500,104524,21732,0.20197059941705742,0.46011178861788615
3658,0.3699,10,18,10,650962,25482,104534,21722,0.20182803193511595,0.4601728667062113
3659,0.37,17,24,17,650986,25458,104551,21705,0.20163794195919402,0.46021245467845556
3660,0.3701,11,32,11,651018,25426,104562,21694,0.20138448865796477,0.4603989813242784
3661,0.3702,22,22,22,651040,25404,104584,21672,0.20121023951336967,0.4603619678817232
3662,0.3703,12,18,12,651058,25386,104596,21660,0.2010676720314282,0.46040045912511157
3663,0.3704,12,29,12,651087,25357,104608,21648,0.2008379799771892,0.4605467503457079
3664,0.3705,20,20,20,651107,25337,104628,21628,0.20067957166392092,0.46051314808900246
3665,0.3706,16,25,16,651132,25312,104644,21612,0.20048156127233557,0.46057454607450343
3666,0.3707,8,28,8,651160,25284,104652,21604,0.20025978963375998,0.46075754990615936
3667,0.3708,7,23,7,651183,25261,104659,21597,0.20007762007350147,0.4609031542105937
3668,0.3709,14,16,14,651199,25245,104673,21583,0.19995089342288683,0.4608994618604254
3669,0.371,13,30,13,651229,25215,104686,21570,0.1997132809529844,0.46104520679705036
3670,0.3711,13,22,13,651251,25193,104699,21557,0.1995390318083893,0.4611122994652406
3671,0.3712,18,26,18,651277,25167,104717,21539,0.19933310100114054,0.4611613068984713
3672,0.3713,12,25,12,651302,25142,104729,21527,0.1991350906095552,0.4612697936531745
3673,0.3714,23,25,23,651327,25117,104752,21504,0.19893708021796985,0.4612513674095365
3674,0.3715,19,21,19,651348,25096,104771,21485,0.19877075148903814,0.46123956119447845
3675,0.3716,16,20,16,651368,25076,104787,21469,0.19861234317576987,0.46125255129444626
3676,0.3717,18,18,18,651386,25058,104805,21451,0.1984697756938284,0.4612225590745877
3677,0.3718,18,24,18,651410,25034,104823,21433,0.19827968571790647,0.4612520713624723
3678,0.3719,11,27,11,651437,25007,104834,21422,0.1980658344949943,0.4613926640677163
3679,0.372,11,27,11,651464,24980,104845,21411,0.19785198327208212,0.4615334870987907
3680,0.3721,15,26,15,651490,24954,104860,21396,0.19764605246483335,0.4616181229773463
3681,0.3722,15,29,15,651519,24925,104875,21381,0.19741636041059435,0.46173282080076017
3682,0.3723,17,32,17,651551,24893,104892,21364,0.1971629071093651,0.461854422033422
3683,0.3724,26,21,26,651572,24872,104918,21338,0.1969965783804334,0.4617615234797663
3684,0.3725,11,24,11,651596,24848,104929,21327,0.19680648840451148,0.4618733080671359
3685,0.3726,6,20,6,651616,24828,104935,21321,0.19664808009124318,0.4620035103685887
3686,0.3727,12,23,12,651639,24805,104947,21309,0.19646591053098467,0.46209394110248514
3687,0.3728,15,25,15,651664,24780,104962,21294,0.19626790013939932,0.4621695533272562
3688,0.3729,20,24,20,651688,24756,104982,21274,0.1960778101634774,0.46217684119052793
3689,0.373,25,22,25,651710,24734,105007,21249,0.19590356101888226,0.46210556075071224
3690,0.3731,11,27,11,651737,24707,105018,21238,0.19568970979597008,0.4622483404070084
3691,0.3732,16,25,16,651762,24682,105034,21222,0.19549169940438474,0.4623126524921575
3692,0.3733,23,28,23,651790,24654,105057,21199,0.19526992776580915,0.46232525679890085
3693,0.3734,14,26,14,651816,24628,105071,21185,0.1950639969585604,0.4624233296225962
3694,0.3735,16,31,16,651847,24597,105087,21169,0.19481846407299455,0.4625486168771577
3695,0.3736,15,16,15,651863,24581,105102,21154,0.19469173742237994,0.4625341642068438
3696,0.3737,17,26,17,651889,24555,105119,21137,0.19448580661513115,0.46259739122822374
3697,0.3738,14,25,14,651914,24530,105133,21123,0.1942877962235458,0.4626859133025212
3698,0.3739,10,19,10,651933,24511,105143,21113,0.19413730832594095,0.46276082763457826
3699,0.374,12,17,12,651950,24494,105155,21101,0.1940026612596629,0.46279197280403556
3700,0.3741,13,22,13,651972,24472,105168,21088,0.1938284121150678,0.46286215978928885
3701,0.3742,12,16,12,651988,24456,105180,21076,0.19370168546445318,0.46288324694720195
3702,0.3743,12,27,12,652015,24429,105192,21064,0.193487834241541,0.4630162882201657
3703,0.3744,12,18,12,652033,24411,105204,21052,0.19334526675959954,0.4630578712359501
3704,0.3745,15,19,15,652052,24392,105219,21037,0.19319477886199468,0.4630742477272227
3705,0.3746,21,22,21,652074,24370,105240,21016,0.19302052971739958,0.46305027982197156
3706,0.3747,15,19,15,652093,24351,105255,21001,0.1928700418197947,0.46306667842653026
3707,0.3748,16,23,16,652116,24328,105271,20985,0.19268787225953618,0.4631121311764836
3708,0.3749,16,24,16,652140,24304,105287,20969,0.19249778228361425,0.4631678925628962
3709,0.375,18,23,18,652163,24281,105305,20951,0.19231561272335573,0.4631897771489211
3710,0.3751,18,31,18,652194,24250,105323,20933,0.1920700798377899,0.46329371666334684
3711,0.3752,22,18,22,652212,24232,105345,20911,0.19192751235584843,0.46321688855415016
3712,0.3753,8,30,8,652242,24202,105353,20903,0.191689899885946,0.4634297749695156
3713,0.3754,17,19,17,652261,24183,105370,20886,0.19153941198834115,0.46342275178060305
3714,0.3755,16,22,16,652283,24161,105386,20870,0.19136516284374605,0.46345850636228375
3715,0.3756,11,10,11,652293,24151,105397,20859,0.1912859586871119,0.46343034881137524
3716,0.3757,8,24,8,652317,24127,105405,20851,0.19109586871118997,0.46358219574013965
3717,0.3758,18,19,18,652336,24108,105423,20833,0.19094538081358509,0.4635633385994971
3718,0.3759,8,21,8,652357,24087,105431,20825,0.1907790520846534,0.46368453865336656
3719,0.376,14,25,14,652382,24062,105445,20811,0.19058104169306805,0.46377554431395274
3720,0.3761,11,28,11,652410,24034,105456,20800,0.19035927005449246,0.46393362180488024
3721,0.3762,17,14,17,652424,24020,105473,20783,0.19024838423520465,0.4638751869294467
3722,0.3763,10,21,10,652445,23999,105483,20773,0.19008205550627297,0.4639730188510676
3723,0.3764,13,16,13,652461,23983,105496,20760,0.18995532885565836,0.46398319290168294
3724,0.3765,14,24,14,652485,23959,105510,20746,0.1897652388797364,0.4640644223241248
3725,0.3766,16,24,16,652509,23935,105526,20730,0.18957514890381447,0.46412179558938765
3726,0.3767,13,24,13,652533,23911,105539,20717,0.18938505892789254,0.4642152908487945
3727,0.3768,10,28,10,652561,23883,105549,20707,0.18916328728931694,0.4643866337743889
3728,0.3769,15,29,15,652590,23854,105564,20692,0.18893359523507794,0.4645085978539038
3729,0.377,7,19,7,652609,23835,105571,20685,0.18878310733747308,0.46462264150943394
3730,0.3771,15,26,15,652635,23809,105586,20670,0.1885771765302243,0.46471368510982713
3731,0.3772,12,17,12,652652,23792,105598,20658,0.18844252946394627,0.4647469066366704
3732,0.3773,17,23,17,652675,23769,105615,20641,0.18826035990368775,0.46478270659761317
3733,0.3774,15,24,15,652699,23745,105630,20626,0.18807026992776582,0.4648531698631989
3734,0.3775,8,21,8,652720,23724,105638,20618,0.1879039411988341,0.4649767714582112
3735,0.3776,14,24,14,652744,23700,105652,20604,0.18771385122291218,0.46505958829902494
3736,0.3777,20,32,20,652776,23668,105672,20584,0.18746039792168293,0.46515411732803036
3737,0.3778,15,23,15,652799,23645,105687,20569,0.1872782283614244,0.4652146378974985
3738,0.3779,10,17,10,652816,23628,105697,20559,0.18714358129514638,0.4652725914861837
3739,0.378,9,26,9,652842,23602,105706,20550,0.1869376504878976,0.46543757927160717
3740,0.3781,19,18,19,652860,23584,105725,20531,0.18679508300595615,0.46539725716876346
3741,0.3782,15,14,15,652874,23570,105740,20516,0.18668419718666834,0.4653631538356848
3742,0.3783,12,20,12,652894,23550,105752,20504,0.18652578887340007,0.465428791937168
3743,0.3784,16,21,16,652915,23529,105768,20488,0.1863594601444684,0.4654565281595747
3744,0.3785,11,19,11,652934,23510,105779,20477,0.1862089722468635,0.4655239047900516
3745,0.3786,18,27,18,652961,23483,105797,20459,0.18599512102395133,0.46559100632652134
3746,0.3787,13,25,13,652986,23458,105810,20446,0.18579711063236598,0.4656978862973761
3747,0.3788,8,17,8,653003,23441,105818,20438,0.18566246356608795,0.4657808974680371
3748,0.3789,12,22,12,653025,23419,105830,20426,0.18548821442149285,0.46586840004561525
3749,0.379,9,18,9,653043,23401,105839,20417,0.18534564693955138,0.46595006618284723
3750,0.3791,16,29,16,653072,23372,105855,20401,0.18511595488531238,0.46606355515957326
3751,0.3792,15,18,15,653090,23354,105870,20386,0.18497338740337094,0.4660722450845908
3752,0.3793,6,23,6,653113,23331,105876,20380,0.1847912178431124,0.4662441948251012
3753,0.3794,11,11,11,653124,23320,105887,20369,0.18470409327081486,0.4662271967772208
3754,0.3795,12,16,12,653140,23304,105899,20357,0.18457736662020022,0.46625134559446646
3755,0.3796,15,23,15,653163,23281,105914,20342,0.1843951970599417,0.466313641886161
3756,0.3797,10,25,10,653188,23256,105924,20332,0.18419718666835636,0.4664586583463339
3757,0.3798,18,14,18,653202,23242,105942,20314,0.18408630084906855,0.4663880980806318
3758,0.3799,16,23,16,653225,23219,105958,20298,0.18390413128881003,0.46643840338258613
3759,0.38,11,28,11,653253,23191,105969,20287,0.18368235965023444,0.46660379962279774
3760,0.3801,14,22,14,653275,23169,105983,20273,0.18350811050563934,0.4666682012798674
3761,0.3802,12,21,12,653296,23148,105995,20261,0.18334178177670765,0.46674652721785803
3762,0.3803,13,20,13,653316,23128,106008,20248,0.18318337346343935,0.466801918111398
3763,0.3804,9,18,9,653334,23110,106017,20239,0.1830408059814979,0.4668850492514245
3764,0.3805,7,18,7,653352,23092,106024,20232,0.18289823849955647,0.46699289077647493
3765,0.3806,15,23,15,653375,23069,106039,20217,0.18271606893929793,0.4670563230605739
3766,0.3807,8,11,8,653386,23058,106047,20209,0.1826289443670004,0.4670765248341692
3767,0.3808,15,19,15,653405,23039,106062,20194,0.1824784564693955,0.46709689357666595
3768,0.3809,7,15,7,653420,23024,106069,20187,0.1823596502344443,0.4671727106523802
3769,0.381,6,20,6,653440,23004,106075,20181,0.182201241921176,0.46731503994442514
3770,0.3811,15,23,15,653463,22981,106090,20166,0.1820190723609175,0.4673789602985144
3771,0.3812,7,19,7,653482,22962,106097,20159,0.18186858446331264,0.46749843463741564
3772,0.3813,13,19,13,653501,22943,106110,20146,0.18171809656570778,0.4675439207222261
3773,0.3814,5,15,5,653516,22928,106115,20141,0.18159929033075656,0.46764494183751654
3774,0.3815,9,14,9,653530,22914,106124,20132,0.18148840451146875,0.4676857315430005
3775,0.3816,13,17,13,653547,22897,106137,20119,0.18135375744519072,0.46770968941789104
3776,0.3817,18,21,18,653568,22876,106155,20101,0.18118742871625904,0.4677152895734928
3777,0.3818,18,19,18,653587,22857,106173,20083,0.18103694081865415,0.46769911504424777
3778,0.3819,10,27,10,653614,22830,106183,20073,0.18082308959574198,0.4678693797636529
3779,0.382,12,19,12,653633,22811,106195,20061,0.18067260169813712,0.46792778503452137
3780,0.3821,12,17,12,653650,22794,106207,20049,0.1805379546318591,0.4679644282613262
3781,0.3822,12,14,12,653664,22780,106219,20037,0.18042706881257128,0.4679683303360815
3782,0.3823,8,18,8,653682,22762,106227,20029,0.18028450133062984,0.46806571475310227
3783,0.3824,17,15,17,653697,22747,106244,20012,0.18016569509567862,0.46801842886877615
3784,0.3825,14,25,14,653722,22722,106258,19998,0.17996768470409327,0.46811797752808987
3785,0.3826,15,15,15,653737,22707,106273,19983,0.17984887846914205,0.46809557273366126
3786,0.3827,16,17,16,653754,22690,106289,19967,0.17971423140286402,0.46808261246688704
3787,0.3828,10,15,10,653769,22675,106299,19957,0.17959542516791283,0.46812253706136236
3788,0.3829,15,18,15,653787,22657,106314,19942,0.17945285768597136,0.4681330547665438
3789,0.383,17,32,17,653819,22625,106331,19925,0.1791994043847421,0.4682726204465335
3790,0.3831,8,17,8,653836,22608,106339,19917,0.17906475731846408,0.46835978835978836
3791,0.3832,13,23,13,653859,22585,106352,19904,0.17888258775820556,0.46845065781731743
3792,0.3833,6,14,6,653873,22571,106358,19898,0.17877170193891775,0.46852998657844547
3793,0.3834,16,25,16,653898,22546,106374,19882,0.1785736915473324,0.4686056377863675
3794,0.3835,17,17,17,653915,22529,106391,19865,0.17843904448105435,0.4685804594989857
3795,0.3836,14,18,14,653933,22511,106405,19851,0.1782964769991129,0.4686039374911477
3796,0.3837,16,26,16,653959,22485,106421,19835,0.17809054619186415,0.46869092627599246
3797,0.3838,8,19,8,653978,22466,106429,19827,0.1779400582942593,0.4688009836143097
3798,0.3839,17,19,17,653997,22447,106446,19810,0.1777895703966544,0.46879806895898907
3799,0.384,17,13,17,654010,22434,106463,19793,0.17768660499303005,0.46872853861273595
3800,0.3841,17,13,17,654023,22421,106480,19776,0.17758363958940565,0.46865890940114224
3801,0.3842,12,15,12,654038,22406,106492,19764,0.17746483335445445,0.46867441308987434
3802,0.3843,11,19,11,654057,22387,106503,19753,0.17731434545684957,0.46874703369719983
3803,0.3844,17,14,17,654071,22373,106520,19736,0.1772034596375618,0.4686884039041535
3804,0.3845,20,28,20,654099,22345,106540,19716,0.1769816879989862,0.46874777109436294
3805,0.3846,11,14,11,654113,22331,106551,19705,0.1768708021796984,0.4687648682082025
3806,0.3847,13,20,13,654133,22311,106564,19692,0.17671239386643012,0.46882365545318194
3807,0.3848,7,20,7,654153,22291,106571,19685,0.17655398555316182,0.46895845244901846
3808,0.3849,18,18,18,654171,22273,106589,19667,0.17641141807122038,0.4689318073438245
3809,0.385,13,26,13,654197,22247,106602,19654,0.17620548726397162,0.46905801770840794
3810,0.3851,10,12,10,654209,22235,106612,19644,0.17611044227601064,0.4690656414909621
3811,0.3852,15,17,15,654226,22218,106627,19629,0.1759757952097326,0.4690658828589863
3812,0.3853,13,26,13,654252,22192,106640,19616,0.17576986440248385,0.46919249904324534
3813,0.3854,11,19,11,654271,22173,106651,19605,0.17561937650487897,0.4692661209248887
3814,0.3855,13,18,13,654289,22155,106664,19592,0.17547680902293752,0.4693031834622847
3815,0.3856,7,21,7,654310,22134,106671,19585,0.17531048029400584,0.4694503703348594
3816,0.3857,11,16,11,654326,22118,106682,19574,0.1751837536433912,0.4694905497457546
3817,0.3858,15,27,15,654353,22091,106697,19559,0.17496990242047902,0.46960384153661466
3818,0.3859,13,21,13,654374,22070,106710,19546,0.17480357369154734,0.4696751249519416
3819,0.386,12,20,12,654394,22050,106722,19534,0.17464516537827907,0.4697479799923047
3820,0.3861,11,20,11,654414,22030,106733,19523,0.17448675706501077,0.4698337063509253
3821,0.3862,5,20,5,654434,22010,106738,19518,0.1743283487517425,0.46999614717780774
3822,0.3863,9,25,9,654459,21985,106747,19509,0.17413033836015715,0.47016436111244997
3823,0.3864,15,17,15,654476,21968,106762,19494,0.1739956912938791,0.4701654527036805
3824,0.3865,10,19,10,654495,21949,106772,19484,0.17384520339627424,0.47025317983250065
3825,0.3866,8,17,8,654512,21932,106780,19476,0.17371055632999619,0.4703438948995363
3826,0.3867,17,18,17,654530,21914,106797,19459,0.17356798884805474,0.4703308921277161
3827,0.3868,17,25,17,654555,21889,106814,19442,0.1733699784564694,0.4703975224407829
3828,0.3869,16,24,16,654579,21865,106830,19426,0.17317988848054747,0.47046571892179895
3829,0.387,17,26,17,654605,21839,106847,19409,0.1729739576732987,0.47054402637703646
3830,0.3871,15,12,15,654617,21827,106862,19394,0.17287891268533773,0.4704883433201523
3831,0.3872,12,14,12,654631,21813,106874,19382,0.17276802686604992,0.47049399198931907
3832,0.3873,18,25,18,654656,21788,106892,19364,0.17257001647446457,0.47054821150855364
3833,0.3874,17,10,17,654666,21778,106909,19347,0.17249081231783045,0.4704437689969605
3834,0.3875,12,15,12,654681,21763,106921,19335,0.17237200608287923,0.4704608496763833
3835,0.3876,8,15,8,654696,21748,106929,19327,0.17225319984792803,0.4705295191722459
3836,0.3877,18,26,18,654722,21722,106947,19309,0.17204726904067927,0.470595403475421
3837,0.3878,15,19,15,654741,21703,106962,19294,0.17189678114307438,0.4706198014488865
3838,0.3879,12,22,12,654763,21681,106974,19282,0.17172253199847928,0.47071747674730857
3839,0.388,12,17,12,654780,21664,106986,19270,0.17158788493220123,0.4707578052474715
3840,0.3881,14,22,14,654802,21642,107000,19256,0.17141363578760613,0.47082986943126803
3841,0.3882,8,23,8,654825,21619,107008,19248,0.1712314662273476,0.4709912643453153
3842,0.3883,7,24,7,654849,21595,107015,19241,0.17104137625142568,0.47117739249681656
3843,0.3884,7,15,7,654864,21580,107022,19234,0.17092257001647446,0.4712598618121233
3844,0.3885,9,22,9,654886,21558,107031,19225,0.17074832087187936,0.47139739597381264
3845,0.3886,6,28,6,654914,21530,107037,19219,0.17052654923330376,0.47164347591351935
3846,0.3887,11,15,11,654929,21515,107048,19208,0.17040774299835254,0.47167448370699605
3847,0.3888,18,17,18,654946,21498,107066,19190,0.17027309593207451,0.4716378293354306
3848,0.3889,9,19,9,654965,21479,107075,19181,0.17012260803446966,0.47174126906050173
3849,0.389,17,16,17,654981,21463,107092,19164,0.16999588138385502,0.4717060083195904
3850,0.3891,8,13,8,654994,21450,107100,19156,0.16989291598023065,0.47175294291484016
3851,0.3892,7,17,7,655011,21433,107107,19149,0.1697582689139526,0.4718594450741708
3852,0.3893,11,27,11,655038,21406,107118,19138,0.16954441769104042,0.4720303867403315
3853,0.3894,12,23,12,655061,21383,107130,19126,0.1693622481307819,0.4721419931373275
3854,0.3895,13,20,13,655081,21363,107143,19113,0.16920383981751363,0.4722057515564779
3855,0.3896,17,23,17,655104,21340,107160,19096,0.1690216702572551,0.4722524483133841
3856,0.3897,16,22,16,655126,21318,107176,19080,0.16884742111266,0.4723006089410367
3857,0.3898,9,21,9,655147,21297,107185,19071,0.1686810923837283,0.4724286563614744
3858,0.3899,11,16,11,655163,21281,107196,19060,0.16855436573311366,0.4724721747105922
3859,0.39,21,23,21,655186,21258,107217,19039,0.16837219617285515,0.47246693302230935
3860,0.3901,11,17,11,655203,21241,107228,19028,0.16823754910657712,0.47252228761578385
3861,0.3902,6,29,6,655232,21212,107234,19022,0.16800785705233812,0.4727842123577074
3862,0.3903,11,7,11,655239,21205,107245,19011,0.1679524141426942,0.4727222995822558
3863,0.3904,13,21,13,655260,21184,107258,18998,0.16778608541376253,0.4727987656164452
3864,0.3905,15,13,15,655273,21171,107273,18983,0.16768312001013813,0.47275489365941126
3865,0.3906,7,13,7,655286,21158,107280,18976,0.16758015460651374,0.4728160661783027
3866,0.3907,14,27,14,655313,21131,107294,18962,0.16736630338360156,0.4729503903424538
3867,0.3908,13,21,13,655334,21110,107307,18949,0.16719997465466988,0.4730272847549864
3868,0.3909,10,8,10,655342,21102,107317,18939,0.16713661132936256,0.4729901850603132
3869,0.391,14,15,14,655357,21087,107331,18925,0.16701780509441136,0.47298310506847946
3870,0.3911,12,21,12,655378,21066,107343,18913,0.16685147636547967,0.47307336351584584
3871,0.3912,10,19,10,655397,21047,107353,18903,0.1667009884678748,0.4731664580725907
3872,0.3913,14,11,14,655408,21036,107367,18889,0.16661386389557725,0.4731120851596744
3873,0.3914,7,27,7,655435,21009,107374,18882,0.16640001267266505,0.47333985109423177
3874,0.3915,13,24,13,655459,20985,107387,18869,0.16620992269674312,0.47345310382897576
3875,0.3916,19,19,19,655478,20966,107406,18850,0.16605943479913826,0.4734277677315652
3876,0.3917,11,23,11,655501,20943,107417,18839,0.16587726523887975,0.47355587954351214
3877,0.3918,12,14,12,655515,20929,107429,18827,0.16576637941959194,0.473563738806721
3878,0.3919,14,27,14,655542,20902,107443,18813,0.16555252819667976,0.4737001133073146
3879,0.392,14,31,14,655573,20871,107457,18799,0.16530699531111392,0.47388454751701536
3880,0.3921,13,24,13,655597,20847,107470,18786,0.165116905335192,0.47399894027704187
3881,0.3922,15,20,15,655617,20827,107485,18771,0.16495849702192372,0.47403909288347895
3882,0.3923,14,19,14,655636,20808,107499,18757,0.16480800912431884,0.4740806268166309
3883,0.3924,13,21,13,655657,20787,107512,18744,0.16464168039538715,0.47415952037641346
3884,0.3925,12,27,12,655684,20760,107524,18732,0.16442782917247498,0.4743239137040413
3885,0.3926,15,23,15,655707,20737,107539,18717,0.16424565961221646,0.47440056774978456
3886,0.3927,18,17,18,655724,20720,107557,18699,0.1641110125459384,0.4743651538598138
3887,0.3928,9,14,9,655738,20706,107566,18690,0.16400012672665062,0.4744136460554371
3888,0.3929,13,21,13,655759,20685,107579,18677,0.1638337979977189,0.4744931659976627
3889,0.393,8,22,8,655781,20663,107587,18669,0.1636595488531238,0.47465168310790196
3890,0.3931,11,17,11,655798,20646,107598,18658,0.16352490178684578,0.4747099531854264
3891,0.3932,16,12,16,655810,20634,107614,18642,0.1634298567988848,0.4746410021387107
3892,0.3933,18,11,18,655821,20623,107632,18624,0.16334273222658724,0.4745330853313629
3893,0.3934,13,19,13,655840,20604,107645,18611,0.16319224432898238,0.4745888053040928
3894,0.3935,13,24,13,655864,20580,107658,18598,0.16300215435306045,0.4747051916892133
3895,0.3936,16,29,16,655893,20551,107674,18582,0.16277246229882145,0.4748422047887972
3896,0.3937,11,22,11,655915,20529,107685,18571,0.16259821315422635,0.4749616368286445
3897,0.3938,10,13,10,655928,20516,107695,18561,0.16249524775060195,0.4749852854620365
3898,0.3939,11,20,11,655948,20496,107706,18550,0.16233683943733368,0.47508067407673
3899,0.394,13,23,13,655971,20473,107719,18537,0.16215466987707514,0.47518584978210715
3900,0.3941,9,22,9,655993,20451,107728,18528,0.16198042073248003,0.4753328715462172
3901,0.3942,12,18,12,656011,20433,107740,18516,0.1618378532505386,0.4753908957867981
3902,0.3943,6,21,6,656032,20412,107746,18510,0.1616715245216069,0.47556651765068597
3903,0.3944,13,22,13,656054,20390,107759,18497,0.16149727537701178,0.47566024635482296
3904,0.3945,9,18,9,656072,20372,107768,18488,0.16135470789507034,0.47575913535769426
3905,0.3946,11,17,11,656089,20355,107779,18477,0.16122006082879228,0.47581891223733
3906,0.3947,15,18,15,656107,20337,107794,18462,0.16107749334685084,0.47583700610840485
3907,0.3948,15,18,15,656125,20319,107809,18447,0.1609349258649094,0.47585513078470826
3908,0.3949,9,18,9,656143,20301,107818,18438,0.16079235838296793,0.47595446449314643
3909,0.395,14,17,14,656160,20284,107832,18424,0.1606577113166899,0.4759739588715511
3910,0.3951,18,21,18,656181,20263,107850,18406,0.16049138258775822,0.4759885179342626
3911,0.3952,11,22,11,656203,20241,107861,18395,0.1603171334431631,0.47611036339165547
3912,0.3953,11,29,11,656232,20212,107872,18384,0.16008744138892408,0.4763187895118665
3913,0.3954,13,15,13,656247,20197,107885,18371,0.1599686351539729,0.47632752540966605
3914,0.3955,14,11,14,656258,20186,107899,18357,0.15988151058167532,0.47627325324961733
3915,0.3956,8,17,8,656275,20169,107907,18349,0.1597468635153973,0.4763746819668726
3916,0.3957,12,25,12,656300,20144,107919,18337,0.15954885312381195,0.47652088043450014
3917,0.3958,16,19,16,656319,20125,107935,18321,0.15939836522620707,0.4765385215627113
3918,0.3959,6,14,6,656333,20111,107941,18315,0.15928747940691929,0.47663040649560195
3919,0.396,8,15,8,656348,20096,107949,18307,0.15916867317196806,0.4767075488894097
3920,0.3961,11,25,11,656373,20071,107960,18296,0.15897066278038272,0.47686814189277243
3921,0.3962,3,21,3,656394,20050,107963,18293,0.15880433405145103,0.4770883864069061
3922,0.3963,12,22,12,656416,20028,107975,18281,0.1586300849068559,0.47719856952674305
3923,0.3964,9,22,9,656438,20006,107984,18272,0.1584558357622608,0.4773499137885992
3924,0.3965,12,13,12,656451,19993,107996,18260,0.15835287035863643,0.47734818184194705
3925,0.3966,13,22,13,656473,19971,108009,18247,0.1581786212140413,0.47744518289811083
3926,0.3967,9,19,9,656492,19952,108018,18238,0.15802813331643645,0.4775595705682116
3927,0.3968,7,10,7,656502,19942,108025,18231,0.1579489291598023,0.4775888717156105
3928,0.3969,18,17,18,656519,19925,108043,18213,0.15781428209352427,0.4775551942944045
3929,0.397,8,15,8,656534,19910,108051,18205,0.15769547585857305,0.47763347763347763
3930,0.3971,7,19,7,656553,19891,108058,18198,0.1575449879609682,0.47777573577673343
3931,0.3972,12,13,12,656566,19878,108070,18186,0.1574420225573438,0.47777427490542246
3932,0.3973,11,29,11,656595,19849,108081,18175,0.1572123305031048,0.47798758678729225
3933,0.3974,9,13,9,656608,19836,108090,18166,0.15710936509948042,0.4780274722383033
3934,0.3975,11,19,11,656627,19817,108101,18155,0.15695887720187554,0.47811545349204676
3935,0.3976,16,24,16,656651,19793,108117,18139,0.1567687872259536,0.47819782769165875
3936,0.3977,10,18,10,656669,19775,108127,18129,0.15662621974401217,0.47828725200506544
3937,0.3978,18,12,18,656681,19763,108145,18111,0.1565311747560512,0.478190843322596
3938,0.3979,12,25,12,656706,19738,108157,18099,0.15633316436446584,0.47834130612892145
3939,0.398,8,17,8,656723,19721,108165,18091,0.15619851729818782,0.4784459959801121
3940,0.3981,12,12,12,656735,19709,108177,18079,0.15610347231022684,0.47843230655234464
3941,0.3982,15,11,15,656746,19698,108192,18064,0.15601634773792927,0.47836449340606957
3942,0.3983,14,17,14,656763,19681,108206,18050,0.15588170067165125,0.478386472661737
3943,0.3984,9,17,9,656780,19664,108215,18041,0.15574705360537322,0.47847765548335763
3944,0.3985,14,17,14,656797,19647,108229,18027,0.15561240653909517,0.47849976110845677
3945,0.3986,16,21,16,656818,19626,108245,18011,0.15544607781016348,0.4785450487552143
3946,0.3987,14,19,14,656837,19607,108259,17997,0.15529558991255862,0.4785927029039464
3947,0.3988,15,21,15,656858,19586,108274,17982,0.1551292611836269,0.47865204429301533
3948,0.3989,14,21,14,656879,19565,108288,17968,0.15496293245469522,0.4787253883249407
3949,0.399,10,16,10,656895,19549,108298,17958,0.15483620580408058,0.47879062574986003
3950,0.3991,15,24,15,656919,19525,108313,17943,0.15464611582815865,0.47888865164940747
3951,0.3992,11,18,11,656937,19507,108324,17932,0.1545035483462172,0.4789657843425305
3952,0.3993,18,14,18,656951,19493,108342,17914,0.1543926625269294,0.478894324591654
3953,0.3994,10,12,10,656963,19481,108352,17904,0.15429761753896845,0.47890865320315634
3954,0.3995,12,17,12,656980,19464,108364,17892,0.1541629704726904,0.4789592033408288
3955,0.3996,7,20,7,657000,19444,108371,17885,0.15400456215942213,0.4791181119237054
3956,0.3997,12,29,12,657029,19415,108383,17873,0.15377487010518312,0.47932310662947863
3957,0.3998,10,17,10,657046,19398,108393,17863,0.1536402230389051,0.47940205576876627
3958,0.3999,10,20,10,657066,19378,108403,17853,0.1534818147256368,0.47951975504284067
3959,0.4,10,18,10,657084,19360,108413,17843,0.15333924724369535,0.47961185925866195
3960,0.4001,15,10,15,657094,19350,108428,17828,0.1532600430870612,0.479530905374146
3961,0.4002,13,15,13,657109,19335,108441,17815,0.15314123685211,0.47954239569313595
3962,0.4003,11,19,11,657128,19316,108452,17804,0.15299074895450512,0.47963362068965515
3963,0.4004,15,18,15,657146,19298,108467,17789,0.15284818147256368,0.4796559441313668
3964,0.4005,6,16,6,657162,19282,108473,17783,0.15272145482194904,0.4797787670308917
3965,0.4006,9,19,9,657181,19263,108482,17774,0.1525709669243442,0.4798984798984799
3966,0.4007,10,25,10,657206,19238,108492,17764,0.15237295653275884,0.4800821577212043
3967,0.4008,10,16,10,657222,19222,108502,17754,0.1522462298821442,0.4801492860233665
3968,0.4009,10,21,10,657243,19201,108512,17744,0.15207990115321252,0.48028149952632293
3969,0.401,15,19,15,657262,19182,108527,17729,0.15192941325560766,0.4803175205223375
3970,0.4011,11,16,11,657278,19166,108538,17718,0.15180268660499302,0.48037089252792536
3971,0.4012,10,23,10,657301,19143,108548,17708,0.1516205170447345,0.48052970068654854
3972,0.4013,13,15,13,657316,19128,108561,17695,0.1515017108097833,0.4805420525215219
3973,0.4014,14,13,14,657329,19115,108575,17681,0.1513987454061589,0.4805141863246005
3974,0.4015,11,13,11,657342,19102,108586,17670,0.15129578000253455,0.48052866311323833
3975,0.4016,11,18,11,657360,19084,108597,17659,0.15115321252059308,0.48060855128868085
3976,0.4017,15,13,15,657373,19071,108612,17644,0.1510502471169687,0.48056652594307503
3977,0.4018,9,16,9,657389,19055,108621,17635,0.15092352046635407,0.4806486781139275
3978,0.4019,8,18,8,657407,19037,108629,17627,0.15078095298441263,0.4807713288239145
3979,0.402,13,18,13,657425,19019,108642,17614,0.15063838550247116,0.48082330139491714
3980,0.4021,18,15,18,657440,19004,108660,17596,0.15051957926751997,0.4807650273224044
3981,0.4022,15,22,15,657462,18982,108675,17581,0.15034533012292486,0.4808412876405109
3982,0.4023,15,21,15,657483,18961,108690,17566,0.15017900139399315,0.4809045363703562
3983,0.4024,11,22,11,657505,18939,108701,17555,0.15000475224939805,0.48103797884583765
3984,0.4025,13,11,13,657516,18928,108714,17542,0.14991762767710048,0.48099808061420346
3985,0.4026,13,24,13,657540,18904,108727,17529,0.14972753770117855,0.4811297450113908
3986,0.4027,14,18,14,657558,18886,108741,17515,0.1495849702192371,0.48116809977747865
3987,0.4028,10,19,10,657577,18867,108751,17505,0.14943448232163223,0.48127680633454306
3988,0.4029,9,24,9,657601,18843,108760,17496,0.1492443923457103,0.4814661933459919
3989,0.403,8,16,8,657617,18827,108768,17488,0.14911766569509569,0.4815640919730139
3990,0.4031,11,18,11,657635,18809,108779,17477,0.14897509821315422,0.48164581381248966
3991,0.4032,17,21,17,657656,18788,108796,17460,0.14880876948422253,0.48168174795850804
3992,0.4033,10,18,10,657674,18770,108806,17450,0.1486662020022811,0.48177802319160684
3993,0.4034,13,16,13,657690,18754,108819,17437,0.14853947535166645,0.4818048686137438
3994,0.4035,15,20,15,657710,18734,108834,17422,0.14838106703839818,0.4818564000442527
3995,0.4036,11,18,11,657728,18716,108845,17411,0.1482384995564567,0.48193871619564316
3996,0.4037,12,20,12,657748,18696,108857,17399,0.14808009124318844,0.4820335226485663
3997,0.4038,16,19,16,657767,18677,108873,17383,0.14792960334558358,0.48205768164170826
3998,0.4039,22,17,22,657784,18660,108895,17361,0.14779495627930553,0.4819688515032898
3999,0.404,11,24,11,657808,18636,108906,17350,0.1476048663033836,0.48213194019896627
4000,0.4041,13,20,13,657828,18616,108919,17337,0.14744645799011533,0.48221288904959253
4001,0.4042,9,13,9,657841,18603,108928,17328,0.14734349258649093,0.482257660515989
4002,0.4043,10,18,10,657859,18585,108938,17318,0.1472009251045495,0.4823552349385845
4003,0.4044,5,21,5,657880,18564,108943,17313,0.1470345963756178,0.48256543189229867
4004,0.4045,14,14,14,657894,18550,108957,17299,0.14692371055633,0.48255181455549667
4005,0.4046,8,25,8,657919,18525,108965,17291,0.14672570016474465,0.48277306231851685
4006,0.4047,13,22,13,657941,18503,108978,17278,0.14655145102014955,0.48288197646795783
4007,0.4048,11,15,11,657956,18488,108989,17267,0.14643264478519832,0.48292546496993427
4008,0.4049,16,22,16,657978,18466,109005,17251,0.14625839564060322,0.4829912926617577
4009,0.405,5,16,5,657994,18450,109010,17246,0.14613166898998858,0.4831353653070372
4010,0.4051,12,18,12,658012,18432,109022,17234,0.14598910150804714,0.4832052935568889
4011,0.4052,8,17,8,658029,18415,109030,17226,0.14585445444176912,0.48331977217249794
4012,0.4053,14,9,14,658038,18406,109044,17212,0.14578317070079838,0.4832388118367118
4013,0.4054,16,8,16,658046,18398,109060,17196,0.14571980737549106,0.4831151317637804
4014,0.4055,7,12,7,658058,18386,109067,17189,0.1456247623875301,0.48317638791286016
4015,0.4056,9,16,9,658074,18370,109076,17180,0.14549803573691547,0.4832630098452883
4016,0.4057,10,15,10,658089,18355,109086,17170,0.14537922950196427,0.4833216045038705
4017,0.4058,13,13,13,658102,18342,109099,17157,0.14527626409833988,0.48330938899687315
4018,0.4059,7,17,7,658119,18325,109106,17150,0.14514161703206185,0.4834390415785765
4019,0.406,10,18,10,658137,18307,109116,17140,0.14499904955012038,0.4835388044122211
4020,0.4061,9,23,9,658160,18284,109125,17131,0.14481687998986187,0.483721586898207
4021,0.4062,6,19,6,658179,18265,109131,17125,0.144666392092257,0.4838937552981068
4022,0.4063,20,15,20,658194,18250,109151,17105,0.1445475858573058,0.48380709942016686
4023,0.4064,9,18,9,658212,18232,109160,17096,0.14440501837536435,0.4839221014492754
4024,0.4065,15,15,15,658227,18217,109175,17081,0.14428621214041312,0.48390843673862544
4025,0.4066,14,19,14,658246,18198,109189,17067,0.14413572424280827,0.48396427052318164
4026,0.4067,10,16,10,658262,18182,109199,17057,0.14400899759219363,0.4840375720082863
4027,0.4068,9,14,9,658276,18168,109208,17048,0.14389811177290585,0.48409813721035894
4028,0.4069,14,13,14,658289,18155,109222,17034,0.14379514636928145,0.48407172696012957
4029,0.407,10,18,10,658307,18137,109232,17024,0.14365257888734,0.48417280509655586
4030,0.4071,9,17,9,658324,18120,109241,17015,0.14351793182106196,0.48427493951899814
4031,0.4072,6,18,6,658342,18102,109247,17009,0.14337536433912051,0.48443507732619406
4032,0.4073,14,8,14,658350,18094,109261,16995,0.1433120010138132,0.48433982159651173
4033,0.4074,12,18,12,658368,18076,109273,16983,0.14316943353187175,0.4844119912148093
4034,0.4075,13,13,13,658381,18063,109286,16970,0.14306646812824736,0.48440042245882453
4035,0.4076,11,21,11,658402,18042,109297,16959,0.14290013939931567,0.48452901345675836
4036,0.4077,11,16,11,658418,18026,109308,16948,0.14277341274870106,0.4845885514953966
4037,0.4078,11,18,11,658436,18008,109319,16937,0.1426308452667596,0.4846759193017599
4038,0.4079,10,21,10,658457,17987,109329,16927,0.1424645165378279,0.48481984304290543
4039,0.408,13,15,13,658472,17972,109342,16914,0.14234571030287668,0.48483632402683025
4040,0.4081,14,9,14,658481,17963,109356,16900,0.14227442656190598,0.48475461090554456
4041,0.4082,15,12,15,658493,17951,109371,16885,0.142179381573945,0.48469973590538523
4042,0.4083,8,16,8,658509,17935,109379,16877,0.14205265492333038,0.4848040905434908
4043,0.4084,14,15,14,658524,17920,109393,16863,0.14193384868837916,0.4848057959347957
4044,0.4085,12,20,12,658544,17900,109405,16851,0.1417754403751109,0.48490690915369344
4045,0.4086,20,14,20,658558,17886,109425,16831,0.14166455455582308,0.48480571477950285
4046,0.4087,13,15,13,658573,17871,109438,16818,0.14154574832087188,0.4848222779555479
4047,0.4088,10,13,10,658586,17858,109448,16808,0.1414427829172475,0.48485547798996137
4048,0.4089,9,16,9,658602,17842,109457,16799,0.14131605626663288,0.48494558471175775
4049,0.409,9,23,9,658625,17819,109466,16790,0.14113388670637436,0.4851339247016672
4050,0.4091,9,16,9,658641,17803,109475,16781,0.14100716005575972,0.4852243812167476
4051,0.4092,10,17,10,658658,17786,109485,16771,0.1408725129894817,0.4853141187024337
4052,0.4093,16,18,16,658676,17768,109501,16755,0.14072994550754023,0.485328621498711
4053,0.4094,13,20,13,658696,17748,109514,16742,0.14057153719427196,0.4854160626268484
4054,0.4095,8,12,8,658708,17736,109522,16734,0.14047649220631098,0.4854656222802437
4055,0.4096,16,16,16,658724,17720,109538,16718,0.14034976555569637,0.48545211684766826
4056,0.4097,13,24,13,658748,17696,109551,16705,0.14015967557977443,0.4855963489433447
4057,0.4098,16,24,16,658772,17672,109567,16689,0.1399695856038525,0.485695992549693
4058,0.4099,10,13,10,658785,17659,109577,16679,0.1398666202002281,0.485730094938552
4059,0.41,13,20,13,658805,17639,109590,16666,0.13970821188695984,0.48581839382014286
4060,0.4101,11,18,11,658823,17621,109601,16655,0.13956564440501837,0.48590850741043295
4061,0.4102,19,14,19,658837,17607,109620,16636,0.1394547585857306,0.485821919808428
4062,0.4103,13,19,13,658856,17588,109633,16623,0.1393042706881257,0.4858963491274736
4063,0.4104,10,22,10,658878,17566,109643,16613,0.1391300215435306,0.48605869100909915
4064,0.4105,10,20,10,658898,17546,109653,16603,0.13897161323026233,0.48619286069870277
4065,0.4106,11,12,11,658910,17534,109664,16592,0.13887656824230135,0.4861982066459591
4066,0.4107,22,12,22,658922,17522,109686,16570,0.1387815232543404,0.4860377801243694
4067,0.4108,11,27,11,658949,17495,109697,16559,0.1385676720314282,0.4862571210430493
4068,0.4109,14,19,14,658968,17476,109711,16545,0.13841718413382334,0.48631727462449664
4069,0.411,15,20,15,658988,17456,109726,16530,0.13825877582055507,0.486376743364915
4070,0.4111,11,16,11,659004,17440,109737,16519,0.13813204916994043,0.48643953002149654
4071,0.4112,10,12,10,659016,17428,109747,16509,0.13803700418197948,0.48646020567522175
4072,0.4113,8,15,8,659031,17413,109755,16501,0.13791819794702825,0.48655422539364274
4073,0.4114,9,13,9,659044,17400,109764,16492,0.1378152325434039,0.48660450843856956
4074,0.4115,5,13,5,659057,17387,109769,16487,0.1377122671397795,0.48671547499557183
4075,0.4116,8,19,8,659076,17368,109777,16479,0.13756177924217464,0.4868673737702012
4076,0.4117,13,17,13,659093,17351,109790,16466,0.13742713217589658,0.4869148653044327
4077,0.4118,12,16,12,659109,17335,109802,16454,0.13730040552528197,0.48696321287993133
4078,0.4119,11,16,11,659125,17319,109813,16443,0.13717367887466733,0.4870268349031455
4079,0.412,17,17,17,659142,17302,109830,16426,0.1370390318083893,0.4870137571157495
4080,0.4121,6,13,6,659155,17289,109836,16420,0.1369360664047649,0.487110267287668
4081,0.4122,5,19,5,659174,17270,109841,16415,0.13678557850716005,0.4873088911978625
4082,0.4123,12,14,12,659188,17256,109853,16403,0.13667469268787225,0.48732879764698894
4083,0.4124,9,16,9,659204,17240,109862,16394,0.13654796603725763,0.4874234405660938
4084,0.4125,6,11,6,659215,17229,109868,16388,0.13646084146496007,0.48749144777939735
4085,0.4126,17,23,17,659238,17206,109885,16371,0.13627867190470155,0.487565893319832
4086,0.4127,14,16,14,659254,17190,109899,16357,0.13615194525408694,0.48758458282409756
4087,0.4128,12,22,12,659276,17168,109911,16345,0.1359776961094918,0.48772118282457555
4088,0.4129,9,13,9,659289,17155,109920,16336,0.13587473070586745,0.4877728344928488
4089,0.413,8,17,8,659306,17138,109928,16328,0.1357400836395894,0.4878981653020977
4090,0.4131,13,18,13,659324,17120,109941,16315,0.13559751615764795,0.4879617167638702
4091,0.4132,10,20,10,659344,17100,109951,16305,0.13543910784437968,0.48810058374494836
4092,0.4133,15,21,15,659365,17079,109966,16290,0.13527277911544797,0.4881776499145914
4093,0.4134,5,20,5,659385,17059,109971,16285,0.1351143708021797,0.4883937140115163
4094,0.4135,14,21,14,659406,17038,109985,16271,0.134948042073248,0.4884865952145066
4095,0.4136,9,16,9,659422,17022,109994,16262,0.13482131542263337,0.4885831029924288
4096,0.4137,12,12,12,659434,17010,110006,16250,0.13472627043467242,0.4885748647023452
4097,0.4138,17,12,17,659446,16998,110023,16233,0.13463122544671144,0.48848966326622734
4098,0.4139,6,22,6,659468,16976,110029,16227,0.13445697630211634,0.4887208987139716
4099,0.414,12,16,12,659484,16960,110041,16215,0.1343302496515017,0.48877166541070083
4100,0.4141,11,18,11,659502,16942,110052,16204,0.13418768216956026,0.48886743498461355
4101,0.4142,11,22,11,659524,16920,110063,16193,0.13401343302496516,0.4890224383172772
4102,0.4143,12,18,12,659542,16902,110075,16181,0.1338708655430237,0.4891031647674032
4103,0.4144,9,18,9,659560,16884,110084,16172,0.13372829806108225,0.4892303969022265
4104,0.4145,5,22,5,659582,16862,110089,16167,0.13355404891648714,0.4894789427472827
4105,0.4146,9,11,9,659593,16851,110098,16158,0.13346692434418958,0.48950286285558486
4106,0.4147,11,15,11,659608,16836,110109,16147,0.13334811810923838,0.4895552254191553
4107,0.4148,11,14,11,659622,16822,110120,16136,0.13323723228995057,0.4895928150980035
4108,0.4149,11,9,11,659631,16813,110131,16125,0.13316594854897984,0.489556135770235
4109,0.415,12,24,12,659655,16789,110143,16113,0.1329758585730579,0.48972706826332746
4110,0.4151,14,14,14,659669,16775,110157,16099,0.13286497275377013,0.48971831842793695
4111,0.4152,8,8,8,659677,16767,110165,16091,0.1328016094284628,0.489713311826648
4112,0.4153,10,12,10,659689,16755,110175,16081,0.13270656444050183,0.48973687416250455
4113,0.4154,14,14,14,659703,16741,110189,16067,0.13259567862121405,0.48972811509387953
4114,0.4155,10,19,10,659722,16722,110199,16057,0.13244519072360916,0.4898563104426615
4115,0.4156,8,12,8,659734,16710,110207,16049,0.1323501457356482,0.4899111694496169
4116,0.4157,10,16,10,659750,16694,110217,16039,0.13222341908503357,0.4899948064644243
4117,0.4158,16,15,16,659765,16679,110233,16023,0.13210461285008238,0.4899700324139196
4118,0.4159,11,13,11,659778,16666,110244,16012,0.13200164744645798,0.48999326764183854
4119,0.416,10,11,10,659789,16655,110254,16002,0.13191452287416044,0.49000214349144133
4120,0.4161,17,9,17,659798,16646,110271,15985,0.1318432391331897,0.4898715944960314
4121,0.4162,12,17,12,659815,16629,110283,15973,0.13170859206691168,0.48993926752959943
4122,0.4163,6,12,6,659827,16617,110289,15967,0.1316135470789507,0.4900257795236926
4123,0.4164,12,13,12,659840,16604,110301,15955,0.1315105816753263,0.4900334776866611
4124,0.4165,11,15,11,659855,16589,110312,15944,0.1313917754403751,0.49008698859619465
4125,0.4166,12,15,12,659870,16574,110324,15932,0.1312729692054239,0.49012490001845815
4126,0.4167,11,16,11,659886,16558,110335,15921,0.13114624255480928,0.4901936635980172
4127,0.4168,16,15,16,659901,16543,110351,15905,0.13102743631985805,0.4901688856015779
4128,0.4169,16,13,16,659914,16530,110367,15889,0.1309244709162337,0.49011382214133686
4129,0.417,16,18,16,659932,16512,110383,15873,0.13078190343429222,0.4901343214451135
4130,0.4171,14,12,14,659944,16500,110397,15859,0.13068685844633127,0.49009549120801016
4131,0.4172,10,14,10,659958,16486,110407,15849,0.13057597262704346,0.49014999226843975
4132,0.4173,10,21,10,659979,16465,110417,15839,0.13040964389811177,0.49031079742446754
4133,0.4174,9,15,9,659994,16450,110426,15830,0.13029083766316057,0.49039653035935565
4134,0.4175,11,10,11,660004,16440,110437,15819,0.13021163350652643,0.4903747791314052
4135,0.4176,13,13,13,660017,16427,110450,15806,0.13010866810290203,0.4903670151707877
4136,0.4177,14,8,14,660025,16419,110464,15792,0.13004530477759474,0.4902672999906864
4137,0.4178,16,20,16,660045,16399,110480,15776,0.12988689646432644,0.49031857031857035
4138,0.4179,9,18,9,660063,16381,110489,15767,0.129744328982385,0.4904504168221973
4139,0.418,11,7,11,660070,16374,110500,15756,0.1296888860727411,0.4903828197945845
4140,0.4181,10,20,10,660090,16354,110510,15746,0.12953047775947282,0.4905295950155763
4141,0.4182,13,20,13,660110,16334,110523,15733,0.12937206944620452,0.4906289955405869
4142,0.4183,13,16,13,660126,16318,110536,15720,0.1292453427955899,0.49066733254260564
4143,0.4184,14,18,14,660144,16300,110550,15706,0.12910277531364847,0.4907204899081422
4144,0.4185,16,14,16,660158,16286,110566,15690,0.12899188949436066,0.4906805103827871
4145,0.4186,7,13,7,660171,16273,110573,15683,0.1288889240907363,0.49076855676555264
4146,0.4187,15,13,15,660184,16260,110588,15668,0.1287859586871119,0.4907291405662741
4147,0.4188,5,15,5,660199,16245,110593,15663,0.12866715245216068,0.49088003008649866
4148,0.4189,13,22,13,660221,16223,110606,15650,0.12849290330756558,0.4910112007027892
4149,0.419,7,12,7,660233,16211,110613,15643,0.12839785831960462,0.4910843222201293
4150,0.4191,10,15,10,660248,16196,110623,15633,0.1282790520846534,0.49115586414904644
4151,0.4192,7,15,7,660263,16181,110630,15626,0.1281602458497022,0.49127550539189485
4152,0.4193,17,17,17,660280,16164,110647,15609,0.12802559878342415,0.49126616938910395
4153,0.4194,12,15,12,660295,16149,110659,15597,0.12790679254847295,0.4913059913059913
4154,0.4195,7,9,7,660304,16140,110666,15590,0.12783550880750222,0.4913331232272298
4155,0.4196,11,16,11,660320,16124,110677,15579,0.1277087821568876,0.49140459893385485
4156,0.4197,6,12,6,660332,16112,110683,15573,0.12761373716892663,0.4914943979801168
4157,0.4198,7,18,7,660350,16094,110690,15566,0.1274711696869852,0.4916614024005054
4158,0.4199,9,16,9,660366,16078,110699,15557,0.12734444303637055,0.4917654496601865
4159,0.42,13,17,13,660383,16061,110712,15544,0.12720979597009252,0.49182091441227654
4160,0.4201,10,15,10,660398,16046,110722,15534,0.1270909897351413,0.49189360354654843
4161,0.4202,9,12,9,660410,16034,110731,15525,0.12699594474718034,0.49193573940872654
4162,0.4203,10,15,10,660425,16019,110741,15515,0.12687713851222912,0.4920086256104522
4163,0.4204,10,23,10,660448,15996,110751,15505,0.1266949689519706,0.49220659661598043
4164,0.4205,11,12,11,660460,15984,110762,15494,0.12659992396400963,0.49221678632695853
4165,0.4206,15,15,15,660475,15969,110777,15479,0.12648111772905843,0.49220936148562705
4166,0.4207,9,19,9,660494,15950,110786,15470,0.12633062983145354,0.49236155315085933
4167,0.4208,14,22,14,660516,15928,110800,15456,0.12615638068685844,0.4924802447106806
4168,0.4209,11,12,11,660528,15916,110811,15445,0.12606133569889746,0.49249067312904565
4169,0.421,13,20,13,660548,15896,110824,15432,0.1259029273856292,0.4925944841675179
4170,0.4211,8,10,8,660558,15886,110832,15424,0.12582372322899507,0.4926221654423507
4171,0.4212,10,16,10,660574,15870,110842,15414,0.12569699657838043,0.4927119294207902
4172,0.4213,15,14,15,660588,15856,110857,15399,0.12558611075909265,0.49268916973284277
4173,0.4214,10,18,10,660606,15838,110867,15389,0.12544354327715118,0.49281070868158966
4174,0.4215,11,9,11,660615,15829,110878,15378,0.12537225953618045,0.49277405710257316
4175,0.4216,13,12,13,660627,15817,110891,15365,0.1252772145482195,0.49275222884997755
4176,0.4217,6,7,6,660634,15810,110897,15359,0.1252217716385756,0.4927652475215759
4177,0.4218,10,17,10,660651,15793,110907,15349,0.12508712457229756,0.4928713634320211
4178,0.4219,13,24,13,660675,15769,110920,15336,0.12489703459637562,0.4930397042276161
4179,0.422,11,9,11,660684,15760,110931,15325,0.12482575085540489,0.4930030561364002
4180,0.4221,14,12,14,660696,15748,110945,15311,0.12473070586744392,0.49296500209279115
4181,0.4222,10,18,10,660714,15730,110955,15301,0.12458813838550246,0.4930875576036866
4182,0.4223,14,22,14,660736,15708,110969,15287,0.12441388924090736,0.4932085820293596
4183,0.4224,9,9,9,660745,15699,110978,15278,0.12434260549993664,0.49320463569745293
4184,0.4225,9,13,9,660758,15686,110987,15269,0.12423964009631225,0.4932644160878695
4185,0.4226,11,14,11,660772,15672,110998,15258,0.12412875427702445,0.4933074684772066
4186,0.4227,17,10,17,660782,15662,111015,15241,0.12404955012039032,0.4931883635892955
4187,0.4228,7,15,7,660797,15647,111022,15234,0.1239307438854391,0.4933130403808167
4188,0.4229,7,9,7,660806,15638,111029,15227,0.12385946014446839,0.49334197310869915
4189,0.423,8,15,8,660821,15623,111037,15219,0.12374065390951718,0.4934504895921146
4190,0.4231,12,15,12,660836,15608,111049,15207,0.12362184767456597,0.49349342852506894
4191,0.4232,14,16,14,660852,15592,111063,15193,0.12349512102395134,0.4935195712197499
4192,0.4233,7,19,7,660871,15573,111070,15186,0.12334463312634647,0.4937091582951331
4193,0.4234,10,12,10,660883,15561,111080,15176,0.1232495881383855,0.49373718970621727
4194,0.4235,14,20,14,660903,15541,111094,15162,0.12309117982511722,0.49382796469400386
4195,0.4236,9,14,9,660917,15527,111103,15153,0.12298029400582942,0.49390482398956975
4196,0.4237,13,19,13,660936,15508,111116,15140,0.12282980610822455,0.4939963456016706
4197,0.4238,11,12,11,660948,15496,111127,15129,0.12273476112026359,0.4940081632653061
4198,0.4239,7,11,7,660959,15485,111134,15122,0.12264763654796604,0.4940699839905904
4199,0.424,11,22,11,660981,15463,111145,15111,0.12247338740337092,0.49424347484791
4200,0.4241,9,10,9,660991,15453,111154,15102,0.12239418324673679,0.49425625920471283
4201,0.4242,12,20,12,661011,15433,111166,15090,0.1222357749334685,0.4943812862431609
4202,0.4243,8,10,8,661021,15423,111174,15082,0.12215657077683437,0.49441075233568266
4203,0.4244,13,14,13,661035,15409,111187,15069,0.12204568495754657,0.49442220618150795
4204,0.4245,7,8,7,661043,15401,111194,15062,0.12198232163223927,0.4944358730262942
4205,0.4246,14,21,14,661064,15380,111208,15048,0.12181599290330757,0.4945444984882345
4206,0.4247,9,16,9,661080,15364,111217,15039,0.12168926625269294,0.49465513271716605
4207,0.4248,10,13,10,661093,15351,111227,15029,0.12158630084906856,0.4947004608294931
4208,0.4249,9,23,9,661116,15328,111236,15020,0.12140413128881003,0.49492553051271915
4209,0.425,17,12,17,661128,15316,111253,15003,0.12130908630084906,0.49483822025792407
4210,0.4251,21,9,21,661137,15307,111274,14982,0.12123780255987834,0.4946350160124138
4211,0.4252,10,17,10,661154,15290,111284,14972,0.1211031554936003,0.4947458859295486
4212,0.4253,7,15,7,661169,15275,111291,14965,0.1209843492586491,0.4948743386243386
4213,0.4254,11,13,11,661182,15262,111302,14954,0.12088138385502471,0.4949033624569764
4214,0.4255,14,19,14,661201,15243,111316,14940,0.12073089595741984,0.4949806182288043
4215,0.4256,17,10,17,661211,15233,111333,14923,0.12065169180078571,0.4948600610160499
4216,0.4257,10,16,10,661227,15217,111343,14913,0.12052496515017108,0.49495519415864586
4217,0.4258,14,16,14,661243,15201,111357,14899,0.12039823849955646,0.49498338870431896
4218,0.4259,9,19,9,661262,15182,111366,14890,0.12024775060195159,0.49514498536844903
4219,0.426,8,12,8,661274,15170,111374,14882,0.12015270561399062,0.4952083056036204
4220,0.4261,6,16,6,661290,15154,111380,14876,0.120025978963376,0.4953712953712954
4221,0.4262,12,15,12,661305,15139,111392,14864,0.11990717272842479,0.49541712495417123
4222,0.4263,9,12,9,661317,15127,111401,14855,0.11981212774046382,0.4954639450336869
4223,0.4264,10,20,10,661337,15107,111411,14845,0.11965371942719553,0.49562633547008544
4224,0.4265,13,20,13,661357,15087,111424,14832,0.11949531111392726,0.4957384939336208
4225,0.4266,15,15,15,661372,15072,111439,14817,0.11937650487897605,0.49573421660142525
4226,0.4267,11,11,11,661383,15061,111450,14806,0.11928938030667849,0.4957310744299729
4227,0.4268,11,23,11,661406,15038,111461,14795,0.11910721074641997,0.4959273287969698
4228,0.4269,17,11,17,661417,15027,111478,14778,0.11902008617412242,0.4958228485153498
4229,0.427,9,15,9,661432,15012,111487,14769,0.11890127993917121,0.4959202175883953
4230,0.4271,18,16,18,661448,14996,111505,14751,0.11877455328855659,0.4958819376743873
4231,0.4272,13,11,13,661459,14985,111518,14738,0.11868742871625904,0.49584496854287924
4232,0.4273,7,7,7,661466,14978,111525,14731,0.11863198580661513,0.49584301053552793
4233,0.4274,13,16,13,661482,14962,111538,14718,0.1185052591560005,0.4958894878706199
4234,0.4275,8,10,8,661492,14952,111546,14710,0.11842605499936637,0.4959207066280089
4235,0.4276,10,13,10,661505,14939,111556,14700,0.11832308959574199,0.4959681500725396
4236,0.4277,7,17,7,661522,14922,111563,14693,0.11818844252946395,0.496133716022286
4237,0.4278,11,21,11,661543,14901,111574,14682,0.11802211380053225,0.49629854984281513
4238,0.4279,8,22,8,661565,14879,111582,14674,0.11784786465593715,0.49653165499272495
4239,0.428,13,17,13,661582,14862,111595,14661,0.11771321758965911,0.49659587440300784
4240,0.4281,16,22,16,661604,14840,111611,14645,0.117538968445064,0.4966932338477192
4241,0.4282,10,27,10,661631,14813,111621,14635,0.11732511722215182,0.49697772344471614
4242,0.4283,19,13,19,661644,14800,111640,14616,0.11722215181852744,0.4968724503671471
4243,0.4284,15,10,15,661654,14790,111655,14601,0.1171429476618933,0.4967847300193937
4244,0.4285,7,21,7,661675,14769,111662,14594,0.1169766189329616,0.49702005925825016
4245,0.4286,6,19,6,661694,14750,111668,14588,0.11682613103535673,0.49723907560160885
4246,0.4287,9,11,9,661705,14739,111677,14579,0.11673900646305918,0.49727130090729244
4247,0.4288,12,10,12,661715,14729,111689,14567,0.11665980230642505,0.4972351174221737
4248,0.4289,11,11,11,661726,14718,111700,14556,0.11657267773412748,0.4972330395572863
4249,0.429,8,10,8,661736,14708,111708,14548,0.11649347357749334,0.4972655181843041
4250,0.4291,13,9,13,661745,14699,111721,14535,0.11642218983652262,0.49719504686324145
4251,0.4292,14,11,14,661756,14688,111735,14521,0.11633506526422506,0.49714129206751345
4252,0.4293,13,20,13,661776,14668,111748,14508,0.11617665695095679,0.49725802029064986
4253,0.4294,15,13,15,661789,14655,111763,14493,0.11607369154733241,0.4972210786331824
4254,0.4295,13,10,13,661799,14645,111776,14480,0.11599448739069826,0.4971673819742489
4255,0.4296,8,20,8,661819,14625,111784,14472,0.11583607907742999,0.4973708629755645
4256,0.4297,9,18,9,661837,14607,111793,14463,0.11569351159548853,0.49752321981424147
4257,0.4298,10,13,10,661850,14594,111803,14453,0.11559054619186415,0.49757289909457086
4258,0.4299,16,19,16,661869,14575,111819,14437,0.11544005829425928,0.4976216737901558
4259,0.43,9,6,9,661875,14569,111828,14428,0.11539253580027879,0.49756871400489705
4260,0.4301,9,13,9,661888,14556,111837,14419,0.11528957039665441,0.4976358930112166
4261,0.4302,7,16,7,661904,14540,111844,14412,0.11516284374603979,0.4977894445979552
4262,0.4303,7,21,7,661925,14519,111851,14405,0.1149965150171081,0.49802931821324853
4263,0.4304,13,12,13,661937,14507,111864,14392,0.11490147002914713,0.498010311775494
4264,0.4305,24,15,24,661952,14492,111888,14368,0.11478266379419592,0.49785169785169786
4265,0.4306,9,19,9,661971,14473,111897,14359,0.11463217589659105,0.49802302996670367
4266,0.4307,9,8,9,661979,14465,111906,14350,0.11456881257128373,0.49800451153912895
4267,0.4308,11,11,11,661990,14454,111917,14339,0.11448168799898618,0.49800298683707844
4268,0.4309,9,11,9,662001,14443,111926,14330,0.11439456342668863,0.49803635352587494
4269,0.431,12,20,12,662021,14423,111938,14318,0.11423615511342035,0.4981733412198601
4270,0.4311,9,12,9,662033,14411,111947,14309,0.11414111012545938,0.4982242339832869
4271,0.4312,15,15,15,662048,14396,111962,14294,0.11402230389050817,0.4982223771348902
4272,0.4313,13,10,13,662058,14386,111975,14281,0.11394309973387404,0.4981686259462099
4273,0.4314,14,14,14,662072,14372,111989,14267,0.11383221391458624,0.4981668354341981
4274,0.4315,10,11,10,662083,14361,111999,14257,0.11374508934228868,0.49818296177231114
4275,0.4316,11,23,11,662106,14338,112010,14246,0.11356291978203016,0.4983907080884411
4276,0.4317,9,12,9,662118,14326,112019,14237,0.1134678747940692,0.4984420404019186
4277,0.4318,7,16,7,662134,14310,112026,14230,0.11334114814345457,0.4985984583041346
4278,0.4319,11,12,11,662146,14298,112037,14219,0.1132461031554936,0.4986148613107971
4279,0.432,11,8,11,662154,14290,112048,14208,0.11318273983018629,0.4985613025475472
4280,0.4321,10,10,10,662164,14280,112058,14198,0.11310353567355215,0.498560292155348
4281,0.4322,13,15,13,662179,14265,112071,14185,0.11298472943860094,0.4985940246045694
4282,0.4323,14,14,14,662193,14251,112085,14171,0.11287384361931314,0.4985926395046091
4283,0.4324,6,12,6,662205,14239,112091,14165,0.11277879863135218,0.498697366568089
4284,0.4325,14,13,14,662218,14226,112105,14151,0.1126758332277278,0.4986785072417803
4285,0.4326,5,12,5,662230,14214,112110,14146,0.11258078823976682,0.49880112834978846
4286,0.4327,18,17,18,662247,14197,112128,14128,0.11244614117348878,0.4987819947043248
4287,0.4328,9,20,9,662267,14177,112137,14119,0.11228773286022051,0.4989751201583263
4288,0.4329,20,14,20,662281,14163,112157,14099,0.11217684704093271,0.49886773759818837
4289,0.433,12,12,12,662293,14151,112169,14087,0.11208180205297175,0.4988667752673702
4290,0.4331,12,10,12,662303,14141,112181,14075,0.1120025978963376,0.49883045080805216
4291,0.4332,7,13,7,662316,14128,112188,14068,0.11189963249271322,0.49893601929351683
4292,0.4333,10,17,10,662333,14111,112198,14058,0.11176498542643518,0.49905924952962477
4293,0.4334,15,16,15,662349,14095,112213,14043,0.11163825877582055,0.4990759826569052
4294,0.4335,15,18,15,662367,14077,112228,14028,0.11149569129387911,0.4991282689912827
4295,0.4336,5,16,5,662383,14061,112233,14023,0.11136896464326448,0.49932345819683804
4296,0.4337,10,6,10,662389,14055,112243,14013,0.111321442149284,0.4992518170158187
4297,0.4338,9,9,9,662398,14046,112252,14004,0.11125015840831327,0.49925133689839574
4298,0.4339,13,14,13,662412,14032,112265,13991,0.11113927258902548,0.4992684580523142
4299,0.434,14,13,14,662425,14019,112279,13977,0.11103630718540108,0.4992498928418346
4300,0.4341,13,15,13,662440,14004,112292,13964,0.11091750095044987,0.49928489702517165
4301,0.4342,9,14,9,662454,13990,112301,13955,0.11080661513116208,0.49937376990517085
4302,0.4343,19,10,19,662464,13980,112320,13936,0.11072741097452794,0.4992119214787219
4303,0.4344,14,8,14,662472,13972,112334,13922,0.11066404764922064,0.499103749910375
4304,0.4345,10,12,10,662484,13960,112344,13912,0.11056900266125966,0.4991389207807118
4305,0.4346,7,12,7,662496,13948,112351,13905,0.11047395767329869,0.4992280903313826
4306,0.4347,13,13,13,662509,13935,112364,13892,0.11037099226967431,0.49922736910195137
4307,0.4348,10,9,10,662518,13926,112374,13882,0.11029970852870359,0.49920886075949367
4308,0.4349,9,15,9,662533,13911,112383,13873,0.11018090229375238,0.4993161531816873
4309,0.435,8,14,8,662547,13897,112391,13865,0.11007001647446459,0.49942367264606297
4310,0.4351,6,21,6,662568,13876,112397,13859,0.10990368774553289,0.4996935280331711
4311,0.4352,8,16,8,662584,13860,112405,13851,0.10977696109491826,0.49983760961351087
4312,0.4353,12,11,12,662595,13849,112417,13839,0.10968983652262071,0.499819416353655
4313,0.4354,8,6,8,662601,13843,112425,13831,0.10964231402864022,0.4997831899978319
4314,0.4355,16,16,16,662617,13827,112441,13815,0.1095155873780256,0.4997829390058606
4315,0.4356,10,11,10,662628,13816,112451,13805,0.10942846280572804,0.49980087614496216
4316,0.4357,8,8,8,662636,13808,112459,13797,0.10936509948042074,0.4998007607317515
4317,0.4358,14,11,14,662647,13797,112473,13783,0.10927797490812317,0.499746192893401
4318,0.4359,9,15,9,662662,13782,112482,13774,0.10915916867317196,0.4998548410509508
4319,0.436,12,10,12,662672,13772,112494,13762,0.10907996451653783,0.49981840633398705
4320,0.4361,7,11,7,662683,13761,112501,13755,0.10899283994424028,0.4998909725250763
4321,0.4362,10,9,10,662692,13752,112511,13745,0.10892155620326954,0.4998727133869149
4322,0.4363,5,13,5,662705,13739,112516,13740,0.10881859079964516,0.50001819571309
4323,0.4364,18,15,18,662720,13724,112534,13722,0.10869978456469395,0.49996356481818843
4324,0.4365,11,10,11,662730,13714,112545,13711,0.10862058040805982,0.49994530537830445
4325,0.4366,14,18,14,662748,13696,112559,13697,0.10847801292611836,0.5000182528383164
4326,0.4367,11,18,11,662766,13678,112570,13686,0.1083354454441769,0.5001461774594358
4327,0.4368,7,16,7,662782,13662,112577,13679,0.10820871879356228,0.5003108884093486
4328,0.4369,7,5,7,662787,13657,112584,13672,0.10816911671524522,0.5002744337516923
4329,0.437,11,21,11,662808,13636,112595,13661,0.10800278798631352,0.5004579257793896
4330,0.4371,14,12,14,662820,13624,112609,13647,0.10790774299835255,0.5004216933739137
4331,0.4372,9,8,9,662828,13616,112618,13638,0.10784437967304523,0.5004036104791957
4332,0.4373,10,19,10,662847,13597,112628,13628,0.10769389177544038,0.5005693296602387
4333,0.4374,13,10,13,662857,13587,112641,13615,0.10761468761880623,0.5005146680391148
4334,0.4375,13,17,13,662874,13570,112654,13602,0.1074800405525282,0.5005888414544384
4335,0.4376,14,11,14,662885,13559,112668,13588,0.10739291598023064,0.500534129001363
4336,0.4377,6,11,6,662896,13548,112674,13582,0.10730579140793309,0.5006266126059713
4337,0.4378,7,12,7,662908,13536,112681,13575,0.10721074641997212,0.5007192652428903
4338,0.4379,10,23,10,662931,13513,112691,13565,0.10702857685971359,0.5009601890833887
4339,0.438,12,16,12,662947,13497,112703,13553,0.10690185020909897,0.5010351201478743
4340,0.4381,17,14,17,662961,13483,112720,13536,0.10679096438981117,0.5009807912950146
4341,0.4382,10,24,10,662985,13459,112730,13526,0.10660087441388924,0.5012414304243098
4342,0.4383,13,18,13,663003,13441,112743,13513,0.10645830693194779,0.5013356088150182
4343,0.4384,6,17,6,663020,13424,112749,13507,0.10632365986566975,0.5015409750844751
4344,0.4385,6,12,6,663032,13412,112755,13501,0.10622861487770878,0.5016534760153086
4345,0.4386,11,12,11,663044,13400,112766,13490,0.10613356988974781,0.5016734845667534
4346,0.4387,6,13,6,663057,13387,112772,13484,0.10603060448612343,0.501804919802017
4347,0.4388,8,15,8,663072,13372,112780,13476,0.10591179825117222,0.5019368295589988
4348,0.4389,15,18,15,663090,13354,112795,13461,0.10576923076923077,0.5019951519671826
4349,0.439,7,14,7,663104,13340,112802,13454,0.10565834494994297,0.5021273419422259
4350,0.4391,14,15,14,663119,13325,112816,13440,0.10553953871499176,0.5021483280403513
4351,0.4392,4,14,4,663133,13311,112820,13436,0.10542865289570397,0.5023367106591393
4352,0.4393,6,8,6,663141,13303,112826,13430,0.10536528957039666,0.5023753413384207
4353,0.4394,9,25,9,663166,13278,112835,13421,0.1051672791788113,0.5026780029214577
4354,0.4395,6,15,6,663181,13263,112841,13415,0.10504847294386009,0.5028487892645626
4355,0.4396,7,5,7,663186,13258,112848,13408,0.10500887086554303,0.5028125703142579
4356,0.4397,9,16,9,663202,13242,112857,13399,0.1048821442149284,0.5029465860891108
4357,0.4398,7,17,7,663219,13225,112864,13392,0.10474749714865036,0.503137092835406
4358,0.4399,10,17,10,663236,13208,112874,13382,0.10461285008237232,0.5032719067318541
4359,0.44,19,16,19,663252,13192,112893,13363,0.1044861234317577,0.5032197326303898
4360,0.4401,11,16,11,663268,13176,112904,13352,0.10435939678114307,0.5033172496984318
4361,0.4402,10,11,10,663279,13165,112914,13342,0.10427227220884552,0.5033387407100012
4362,0.4403,6,12,6,663291,13153,112920,13336,0.10417722722088456,0.5034542640341274
4363,0.4404,16,16,16,663307,13137,112936,13320,0.10405050057026993,0.5034584420002268
4364,0.4405,17,14,17,663321,13123,112953,13303,0.10393961475098214,0.5034057367743888
4365,0.4406,13,12,13,663333,13111,112966,13290,0.10384456976302116,0.5033900231051854
4366,0.4407,4,15,4,663348,13096,112970,13286,0.10372576352806995,0.5036009400348722
4367,0.4408,9,10,9,663358,13086,112979,13277,0.10364655937143581,0.5036225012327884
4368,0.4409,8,11,8,663369,13075,112987,13269,0.10355943479913826,0.5036820528393562
4369,0.441,3,16,3,663385,13059,112990,13266,0.10343270814852364,0.5039316239316239
4370,0.4411,10,8,10,663393,13051,113000,13256,0.10336934482321632,0.5038963013646558
4371,0.4412,8,15,8,663408,13036,113008,13248,0.1032505385882651,0.5040328717090246
4372,0.4413,8,13,8,663421,13023,113016,13240,0.10314757318464073,0.504131287362449
4373,0.4414,8,11,8,663432,13012,113024,13232,0.10306044861234318,0.5041914342325865
4374,0.4415,13,11,13,663443,13001,113037,13219,0.10297332404004562,0.5041571319603356
4375,0.4416,12,12,12,663455,12989,113049,13207,0.10287827905208466,0.5041609406016185
4376,0.4417,6,12,6,663467,12977,113055,13201,0.10278323406412368,0.5042784017113607
4377,0.4418,10,6,10,663473,12971,113065,13191,0.1027357115701432,0.5042045715159391
4378,0.4419,14,21,14,663494,12950,113079,13177,0.1025693828412115,0.5043441650399969
4379,0.442,12,14,12,663508,12936,113091,13165,0.10245849702192371,0.5043868051032527
4380,0.4421,10,17,10,663525,12919,113101,13155,0.10232384995564567,0.5045255810385825
4381,0.4422,9,14,9,663539,12905,113110,13146,0.10221296413635787,0.5046255422056735
4382,0.4423,19,20,19,663559,12885,113129,13127,0.1020545558230896,0.5046516992157466
4383,0.4424,11,4,11,663563,12881,113140,13116,0.10202287416043594,0.5045197522791092
4384,0.4425,5,14,5,663577,12867,113145,13111,0.10191198834114815,0.5046962814689353
4385,0.4426,10,7,10,663584,12860,113155,13101,0.10185654543150424,0.5046415777512423
4386,0.4427,11,5,11,663589,12855,113166,13090,0.10181694335318718,0.5045288109462324
4387,0.4428,5,18,5,663607,12837,113171,13085,0.10167437587124573,0.5047835815137721
4388,0.4429,18,17,18,663624,12820,113189,13067,0.10153972880496769,0.5047707343454243
4389,0.443,12,12,12,663636,12808,113201,13055,0.10144468381700672,0.504775161427522
4390,0.4431,7,10,7,663646,12798,113208,13048,0.10136547966037257,0.5048363383115375
4391,0.4432,7,7,7,663653,12791,113215,13041,0.10131003675072868,0.5048389594301641
4392,0.4433,5,9,5,663662,12782,113220,13036,0.10123875300975795,0.5049190487256953
4393,0.4434,16,17,16,663679,12765,113236,13020,0.10110410594347992,0.5049447353112274
4394,0.4435,6,13,6,663692,12752,113242,13014,0.10100114053985554,0.5050842195140883
4395,0.4436,14,17,14,663709,12735,113256,13000,0.1008664934735775,0.5051486302700602
4396,0.4437,13,17,13,663726,12718,113269,12987,0.10073184640729946,0.5052324450496013
4397,0.4438,6,15,6,663741,12703,113275,12981,0.10061304017234825,0.5054119296059804
4398,0.4439,6,15,6,663756,12688,113281,12975,0.10049423393739704,0.5055917079063242
4399,0.444,9,19,9,663775,12669,113290,12966,0.10034374603979217,0.5057928613224107
4400,0.4441,10,13,10,663788,12656,113300,12956,0.10024078063616779,0.5058566297048258
4401,0.4442,11,7,11,663795,12649,113311,12945,0.10018533772652388,0.5057826052981167
4402,0.4443,5,15,5,663810,12634,113316,12940,0.10006653149157267,0.5059826386173457
4403,0.4444,9,14,9,663824,12620,113325,12931,0.09995564567228488,0.5060858674807248
4404,0.4445,7,14,7,663838,12606,113332,12924,0.09984475985299708,0.5062279670975323
4405,0.4446,7,16,7,663854,12590,113339,12917,0.09971803320238246,0.5064100050966401
4406,0.4447,5,13,5,663867,12577,113344,12912,0.09961506779875808,0.5065714621993801
4407,0.4448,12,13,12,663880,12564,113356,12900,0.0995121023951337,0.5065975494816211
4408,0.4449,7,14,7,663894,12550,113363,12893,0.0994012165758459,0.5067405573242149
4409,0.445,6,11,6,663905,12539,113369,12887,0.09931409200354835,0.50684338865728
4410,0.4451,13,10,13,663915,12529,113382,12874,0.0992348878469142,0.5067905365508011
4411,0.4452,3,14,3,663929,12515,113385,12871,0.0991240020276264,0.5070117387536437
4412,0.4453,12,8,12,663937,12507,113397,12859,0.0990606387023191,0.5069384215091067
4413,0.4454,7,16,7,663953,12491,113404,12852,0.09893391205170447,0.507122282287022
4414,0.4455,6,11,6,663964,12480,113410,12846,0.09884678747940692,0.5072257758824923
4415,0.4456,7,11,7,663975,12469,113417,12839,0.09875966290710937,0.5073099415204678
4416,0.4457,11,19,11,663994,12450,113428,12828,0.0986091750095045,0.5074768573463091
4417,0.4458,10,13,10,664007,12437,113438,12818,0.09850620960588012,0.5075430607800435
4418,0.4459,8,15,8,664022,12422,113446,12810,0.09838740337092891,0.5076886493341788
4419,0.446,10,25,10,664047,12397,113456,12800,0.09818939297934355,0.5079969837679089
4420,0.4461,9,12,9,664059,12385,113465,12791,0.09809434799138259,0.5080632348268191
4421,0.4462,6,13,6,664072,12372,113471,12785,0.0979913825877582,0.5082084509281711
4422,0.4463,11,19,11,664091,12353,113482,12774,0.09784089469015333,0.5083774425916345
4423,0.4464,6,17,6,664108,12336,113488,12768,0.0977062476238753,0.5086042065009561
4424,0.4465,11,13,11,664121,12323,113499,12757,0.09760328222025091,0.508652312599681
4425,0.4466,9,16,9,664137,12307,113508,12748,0.09747655556963629,0.5088006385950908
4426,0.4467,6,6,6,664143,12301,113514,12742,0.09742903307565581,0.5088048556482849
4427,0.4468,7,14,7,664157,12287,113521,12735,0.09731814725636802,0.5089521221325234
4428,0.4469,11,17,11,664174,12270,113532,12724,0.09718350019008998,0.5090821797231335
4429,0.447,14,10,14,664184,12260,113546,12710,0.09710429603345584,0.5090108129755707
4430,0.4471,8,12,8,664196,12248,113554,12702,0.09700925104549486,0.5090981963927855
4431,0.4472,12,14,12,664210,12234,113566,12690,0.09689836522620707,0.5091478093403948
4432,0.4473,5,11,5,664221,12223,113571,12685,0.09681124065390952,0.5092741287939618
4433,0.4474,11,11,11,664232,12212,113582,12674,0.09672411608161197,0.5092823274130033
4434,0.4475,6,8,6,664240,12204,113588,12668,0.09666075275630465,0.5093277581215825
4435,0.4476,10,12,10,664252,12192,113598,12658,0.09656570776834368,0.5093762575452716
4436,0.4477,6,9,6,664261,12183,113604,12652,0.09649442402737296,0.509442319307429
4437,0.4478,9,15,9,664276,12168,113613,12643,0.09637561779242175,0.50957236709524
4438,0.4479,14,10,14,664286,12158,113627,12629,0.0962964136357876,0.5095009480776214
4439,0.448,14,13,14,664299,12145,113641,12615,0.09619344823216322,0.5094911147011308
4440,0.4481,8,19,8,664318,12126,113649,12607,0.09604296033455836,0.509723850725751
4441,0.4482,14,13,14,664331,12113,113663,12593,0.09593999493093397,0.5097142394560026
4442,0.4483,10,16,10,664347,12097,113673,12583,0.09581326828031936,0.5098460291734198
4443,0.4484,8,16,8,664363,12081,113681,12575,0.09568654162970473,0.5100178455548345
4444,0.4485,8,20,8,664383,12061,113689,12567,0.09552813331643645,0.5102728601591684
4445,0.4486,13,19,13,664402,12042,113702,12554,0.09537764541883158,0.510408196454708
4446,0.4487,9,13,9,664415,12029,113711,12545,0.0952746800152072,0.5104989012777733
4447,0.4488,8,11,8,664426,12018,113719,12537,0.09518755544290965,0.5105681124007331
4448,0.4489,14,11,14,664437,12007,113733,12523,0.0951004308706121,0.5105177333876886
4449,0.449,7,14,7,664451,11993,113740,12516,0.09498954505132429,0.5106695499612387
4450,0.4491,12,14,12,664465,11979,113752,12504,0.09487865923203649,0.5107217252787648
4451,0.4492,10,15,10,664480,11964,113762,12494,0.09475985299708528,0.5108349006460055
4452,0.4493,13,12,13,664492,11952,113775,12481,0.09466480800912432,0.5108255228584292
4453,0.4494,13,14,13,664506,11938,113788,12468,0.09455392218983652,0.5108579857412112
4454,0.4495,9,12,9,664518,11926,113797,12459,0.09445887720187555,0.510928849702686
4455,0.4496,4,11,4,664529,11915,113801,12455,0.094371752629578,0.511079195732458
4456,0.4497,5,15,5,664544,11900,113806,12450,0.0942529463946268,0.5112936344969199
4457,0.4498,9,15,9,664559,11885,113815,12441,0.09413414015967558,0.5114281016196662
4458,0.4499,12,11,12,664570,11874,113827,12429,0.09404701558737802,0.5114183434143933
4459,0.45,6,11,6,664581,11863,113833,12423,0.09395989101508047,0.5115292761261632
4460,0.4501,8,11,8,664592,11852,113841,12415,0.09387276644278292,0.5116001153830304
4461,0.4502,11,17,11,664609,11835,113852,12404,0.09373811937650488,0.5117372828912083
4462,0.4503,8,20,8,664629,11815,113860,12396,0.09357971106323659,0.5119986782867292
4463,0.4504,7,10,7,664639,11805,113867,12389,0.09350050690660246,0.5120691080433165
4464,0.4505,6,12,6,664651,11793,113873,12383,0.09340546191864149,0.5122021839841164
4465,0.4506,9,16,9,664667,11777,113882,12374,0.09327873526802687,0.5123597366568672
4466,0.4507,9,12,9,664679,11765,113891,12365,0.0931836902800659,0.5124326564442603
4467,0.4508,4,11,4,664690,11754,113895,12361,0.09309656570776835,0.5125855276798673
4468,0.4509,8,7,8,664697,11747,113903,12353,0.09304112279812445,0.5125726141078838
4469,0.451,13,15,13,664712,11732,113916,12340,0.09292231656317324,0.5126287803256896
4470,0.4511,12,16,12,664728,11716,113928,12328,0.09279558991255861,0.5127266677757445
4471,0.4512,9,13,9,664741,11703,113937,12319,0.09269262450893423,0.5128215802181334
4472,0.4513,10,17,10,664758,11686,113947,12309,0.09255797744265619,0.5129818712231715
4473,0.4514,16,17,16,664775,11669,113963,12293,0.09242333037637815,0.5130206159752942
4474,0.4515,8,9,8,664784,11660,113971,12285,0.09235204663540743,0.5130507412821048
4475,0.4516,9,9,9,664793,11651,113980,12276,0.0922807628944367,0.5130605592009028
4476,0.4517,13,16,13,664809,11635,113993,12263,0.09215403624382208,0.5131391748263453
4477,0.4518,16,15,16,664824,11620,114009,12247,0.09203523000887087,0.5131352914065446
4478,0.4519,8,9,8,664833,11611,114017,12239,0.09196394626790014,0.5131656184486373
4479,0.452,9,7,9,664840,11604,114026,12230,0.09190850335825625,0.5131324997902157
4480,0.4521,6,16,6,664856,11588,114032,12224,0.09178177670764162,0.5133546111204434
4481,0.4522,9,11,9,664867,11577,114041,12215,0.09169465213534406,0.5134078681909886
4482,0.4523,13,10,13,664877,11567,114054,12202,0.09161544797870992,0.5133577348647398
4483,0.4524,8,12,8,664889,11555,114062,12194,0.09152040299074896,0.5134531980293907
4484,0.4525,16,9,16,664898,11546,114078,12178,0.09144911924977824,0.5133198448828191
4485,0.4526,12,8,12,664906,11538,114090,12166,0.09138575592447092,0.5132467094161323
4486,0.4527,12,11,12,664917,11527,114102,12154,0.09129863135217337,0.5132384612136311
4487,0.4528,10,14,10,664931,11513,114112,12144,0.09118774553288557,0.5133364331910217
4488,0.4529,6,7,6,664938,11506,114118,12138,0.09113230262324166,0.5133649128743022
4489,0.453,16,10,16,664948,11496,114134,12122,0.09105309846660753,0.5132526039461428
4490,0.4531,8,14,8,664962,11482,114142,12114,0.09094221264731973,0.5133921003559926
4491,0.4532,9,11,9,664973,11471,114151,12105,0.09085508807502218,0.5134458771632169
4492,0.4533,9,8,9,664981,11463,114160,12096,0.09079172474971486,0.5134343562969566
4493,0.4534,6,16,6,664997,11447,114166,12090,0.09066499809910024,0.5136593448612823
4494,0.4535,12,6,12,665003,11441,114178,12078,0.09061747560511976,0.5135422424422807
4495,0.4536,6,7,6,665010,11434,114184,12072,0.09056203269547586,0.5135710031481324
4496,0.4537,8,10,8,665020,11424,114192,12064,0.09048282853884172,0.5136239782016349
4497,0.4538,3,11,3,665031,11413,114195,12061,0.09039570396654416,0.5138025048990372
4498,0.4539,14,13,14,665044,11400,114209,12047,0.09029273856291978,0.5137970742525696
4499,0.454,8,15,8,665059,11385,114217,12039,0.09017393232796857,0.5139600409836066
4500,0.4541,10,13,10,665072,11372,114227,12029,0.09007096692434419,0.5140378616298449
4501,0.4542,8,13,8,665085,11359,114235,12021,0.0899680015207198,0.5141573994867408
4502,0.4543,12,11,12,665096,11348,114247,12009,0.08988087694842226,0.5141499336387378
4503,0.4544,10,16,10,665112,11332,114257,11999,0.08975415029780763,0.5142942865715143
4504,0.4545,10,8,10,665120,11324,114267,11989,0.08969078697250031,0.5142624286878565
4505,0.4546,13,11,13,665131,11313,114280,11976,0.08960366240020276,0.5142341878139894
4506,0.4547,12,12,12,665143,11301,114292,11964,0.0895086174122418,0.5142488716956802
4507,0.4548,10,12,10,665155,11289,114302,11954,0.08941357242428083,0.5143053822656284
4508,0.4549,13,10,13,665165,11279,114315,11941,0.08933436826764668,0.5142549526270457
4509,0.455,8,12,8,665177,11267,114323,11933,0.08923932327968571,0.514353448275862
4510,0.4551,10,16,10,665193,11251,114333,11923,0.08911259662907109,0.5144990075084146
4511,0.4552,11,12,11,665205,11239,114344,11912,0.08901755164111012,0.5145350092868558
4512,0.4553,9,16,9,665221,11223,114353,11903,0.0888908249904955,0.514702066937646
4513,0.4554,10,10,10,665231,11213,114363,11893,0.08881162083386136,0.5147147926945382
4514,0.4555,10,13,10,665244,11200,114373,11883,0.08870865543023698,0.5147944374648009
4515,0.4556,11,11,11,665255,11189,114384,11872,0.08862153085793942,0.5148085512336846
4516,0.4557,9,10,9,665265,11179,114393,11863,0.08854232670130528,0.5148424615918757
4517,0.4558,6,12,6,665277,11167,114399,11857,0.08844728171334432,0.5149843641417651
4518,0.4559,12,16,12,665293,11151,114411,11845,0.08832055506272969,0.5150895807966603
4519,0.456,6,12,6,665305,11139,114417,11839,0.08822551007476873,0.5152319610061799
4520,0.4561,11,16,11,665321,11123,114428,11828,0.0880987834241541,0.5153588078950808
4521,0.4562,7,16,7,665337,11107,114435,11821,0.08797205677353948,0.5155704815073273
4522,0.4563,6,15,6,665352,11092,114441,11815,0.08785325053858827,0.5157812022525865
4523,0.4564,10,16,10,665368,11076,114451,11805,0.08772652388797364,0.5159302478038548
4524,0.4565,11,11,11,665379,11065,114462,11794,0.08763939931567609,0.515945579421672
4525,0.4566,6,14,6,665393,11051,114468,11788,0.0875285134963883,0.5161346819037611
4526,0.4567,6,17,6,665410,11034,114474,11782,0.08739386643011025,0.5163920056100981
4527,0.4568,9,15,9,665425,11019,114483,11773,0.08727506019515904,0.5165408915408916
4528,0.4569,4,13,4,665438,11006,114487,11769,0.08717209479153466,0.5167508232711306
4529,0.457,13,11,13,665449,10995,114500,11756,0.08708497021923711,0.5167245395806778
4530,0.4571,10,14,10,665463,10981,114510,11746,0.0869740843999493,0.5168302019624236
4531,0.4572,10,17,10,665480,10964,114520,11736,0.08683943733367128,0.5170044052863436
4532,0.4573,9,8,9,665488,10956,114529,11727,0.08677607400836396,0.5169951064673985
4533,0.4574,5,9,5,665497,10947,114534,11722,0.08670479026739324,0.51709382857647
4534,0.4575,9,7,9,665504,10940,114543,11713,0.08664934735774933,0.5170617578245706
4535,0.4576,10,15,10,665519,10925,114553,11703,0.08653054112279812,0.5171910906841082
4536,0.4577,13,12,13,665531,10913,114566,11690,0.08643549613483716,0.517187983895943
4537,0.4578,11,11,11,665542,10902,114577,11679,0.0863483715625396,0.5172047296399628
4538,0.4579,9,16,9,665558,10886,114586,11670,0.08622164491192498,0.5173789679021104
4539,0.458,5,12,5,665570,10874,114591,11665,0.08612659992396401,0.517547362349705
4540,0.4581,6,15,6,665585,10859,114597,11659,0.0860077936890128,0.5177635669242384
4541,0.4582,12,14,12,665599,10845,114609,11647,0.08589690786972501,0.517828561266228
4542,0.4583,9,11,9,665610,10834,114618,11638,0.08580978329742744,0.5178889284442862
4543,0.4584,11,11,11,665621,10823,114629,11627,0.0857226587251299,0.5179064587973274
4544,0.4585,7,14,7,665635,10809,114636,11620,0.0856117729058421,0.5180792723705916
4545,0.4586,8,8,8,665643,10801,114644,11612,0.08554840958053479,0.5180921786463213
4546,0.4587,11,12,11,665655,10789,114655,11601,0.08545336459257381,0.5181330951317552
4547,0.4588,10,7,10,665662,10782,114665,11591,0.08539792168292992,0.5180798283645466
4548,0.4589,10,5,10,665667,10777,114675,11581,0.08535831960461285,0.5179801413364344
4549,0.459,7,12,7,665679,10765,114682,11574,0.08526327461665188,0.5181073458973097
4550,0.4591,5,14,5,665693,10751,114687,11569,0.08515238879736409,0.5183243727598567
4551,0.4592,7,10,7,665703,10741,114694,11562,0.08507318464072995,0.5184055956597767
4552,0.4593,12,7,12,665710,10734,114706,11550,0.08501774173108605,0.5183091007000539
4553,0.4594,14,3,14,665713,10731,114720,11536,0.0849939804840958,0.5180760767054385
4554,0.4595,8,17,8,665730,10714,114728,11528,0.08485933341781776,0.5182987141444114
4555,0.4596,6,7,6,665737,10707,114734,11522,0.08480389050817387,0.5183319087678259
4556,0.4597,7,6,7,665743,10701,114741,11515,0.08475636801419338,0.5183201296362981
4557,0.4598,9,9,9,665752,10692,114750,11506,0.08468508427322266,0.5183349851337958
4558,0.4599,4,7,4,665759,10685,114754,11502,0.08462964136357876,0.5184116825167892
4559,0.46,9,10,9,665769,10675,114763,11493,0.08455043720694462,0.5184500180440275
4560,0.4601,13,11,13,665780,10664,114776,11480,0.08446331263464707,0.5184248554913294
4561,0.4602,7,11,7,665791,10653,114783,11473,0.0843761880623495,0.5185302359215402
4562,0.4603,8,12,8,665803,10641,114791,11465,0.08428114307438854,0.5186374739889623
4563,0.4604,4,12,4,665815,10629,114795,11461,0.08418609808642757,0.5188320507016749
4564,0.4605,6,11,6,665826,10618,114801,11455,0.08409897351413002,0.5189598151587913
4565,0.4606,8,10,8,665836,10608,114809,11447,0.08401976935749589,0.5190206302425754
4566,0.4607,11,10,11,665846,10598,114820,11436,0.08394056520086174,0.519016066079695
4567,0.4608,7,15,7,665861,10583,114827,11429,0.08382175896591053,0.5192167908413593
4568,0.4609,10,6,10,665867,10577,114837,11419,0.08377423647193005,0.5191398436079288
4569,0.461,9,8,9,665875,10569,114846,11410,0.08371087314662273,0.5191318986305109
4570,0.4611,12,6,12,665881,10563,114858,11398,0.08366335065264226,0.5190109739993625
4571,0.4612,4,9,4,665890,10554,114862,11394,0.08359206691167152,0.5191361399671952
4572,0.4613,9,12,9,665902,10542,114871,11385,0.08349702192371056,0.5192228759064167
4573,0.4614,9,12,9,665914,10530,114880,11376,0.08340197693574959,0.5193097781429745
4574,0.4615,8,10,8,665924,10520,114888,11368,0.08332277277911544,0.5193713450292398
4575,0.4616,6,11,6,665935,10509,114894,11362,0.08323564820681789,0.5195007087010196
4576,0.4617,5,13,5,665948,10496,114899,11357,0.08313268280319351,0.5196998123827392
4577,0.4618,10,13,10,665961,10483,114909,11347,0.08302971739956913,0.51978928080623
4578,0.4619,10,14,10,665975,10469,114919,11337,0.08291883158028134,0.5199027790516372
4579,0.462,8,16,8,665991,10453,114927,11329,0.08279210492966671,0.5201083463410155
4580,0.4621,11,12,11,666003,10441,114938,11318,0.08269705994170574,0.5201525805413851
4581,0.4622,13,13,13,666016,10428,114951,11305,0.08259409453808136,0.5201766898265311
4582,0.4623,10,11,10,666027,10417,114961,11295,0.0825069699657838,0.5202192336035372
4583,0.4624,6,15,6,666042,10402,114967,11289,0.08238816373083259,0.5204462680374349
4584,0.4625,12,14,12,666056,10388,114979,11277,0.0822772779115448,0.5205169628432956
4585,0.4626,17,15,17,666071,10373,114996,11260,0.08215847167659358,0.5205010863033329
4586,0.4627,15,16,15,666087,10357,115011,11245,0.08203174502597896,0.520553652439589
4587,0.4628,9,12,9,666099,10345,115020,11236,0.08193670003801799,0.5206431583337194
4588,0.4629,8,13,8,666112,10332,115028,11228,0.08183373463439361,0.5207792207792208
4589,0.463,6,10,6,666122,10322,115034,11222,0.08175453047775948,0.5208874860750092
4590,0.4631,9,9,9,666131,10313,115043,11213,0.08168324673678874,0.5209049521508873
4591,0.4632,11,11,11,666142,10302,115054,11202,0.08159612216449119,0.5209263392857143
4592,0.4633,9,12,9,666154,10290,115063,11193,0.08150107717653023,0.5210166177908113
4593,0.4634,16,10,16,666164,10280,115079,11177,0.08142187301989609,0.5209022696555903
4594,0.4635,5,9,5,666173,10271,115084,11172,0.08135058927892536,0.5210091871473208
4595,0.4636,8,18,8,666191,10253,115092,11164,0.0812080217969839,0.5212681514684596
4596,0.4637,5,19,5,666210,10234,115097,11159,0.08105753389937904,0.5216192212405927
4597,0.4638,11,19,11,666229,10215,115108,11148,0.08090704600177417,0.521836820671254
4598,0.4639,9,13,9,666242,10202,115117,11139,0.0808040805981498,0.5219530481233307
4599,0.464,9,8,9,666250,10194,115126,11130,0.08074071727284247,0.5219471018570625
4600,0.4641,7,9,7,666259,10185,115133,11123,0.08066943353187175,0.5220105124835742
4601,0.4642,6,10,6,666269,10175,115139,11117,0.08059022937523762,0.5221209844072892
4602,0.4643,4,10,4,666279,10165,115143,11113,0.08051102521860347,0.5222765297490366
4603,0.4644,12,11,12,666290,10154,115155,11101,0.08042390064630592,0.522277111267937
4604,0.4645,9,10,9,666300,10144,115164,11092,0.08034469648967178,0.522320587681296
4605,0.4646,10,5,10,666305,10139,115174,11082,0.08030509441135471,0.5222185570896754
4606,0.4647,14,10,14,666315,10129,115188,11068,0.08022589025472057,0.522149360758598
4607,0.4648,7,8,7,666323,10121,115195,11061,0.08016252692941325,0.5221886507411954
4608,0.4649,11,8,11,666331,10113,115206,11050,0.08009916360410595,0.5221376931436942
4609,0.465,11,10,11,666341,10103,115217,11039,0.0800199594474718,0.5221360325418598
4610,0.4651,8,7,8,666348,10096,115225,11031,0.0799645165378279,0.5221280825483978
4611,0.4652,10,12,10,666360,10084,115235,11021,0.07986947154986694,0.522198531153755
4612,0.4653,13,7,13,666367,10077,115248,11008,0.07981402864022304,0.5220773061418069
4613,0.4654,8,7,8,666374,10070,115256,11000,0.07975858573057915,0.5220692928334124
4614,0.4655,9,3,9,666377,10067,115265,10991,0.0797348244835889,0.5219394054516099
4615,0.4656,7,6,7,666383,10061,115272,10984,0.07968730198960841,0.5219291993347589
4616,0.4657,15,4,15,666387,10057,115287,10969,0.07965562032695477,0.5216874346047751
4617,0.4658,7,9,7,666396,10048,115294,10962,0.07958433658598403,0.521751546882437
4618,0.4659,5,7,5,666403,10041,115299,10957,0.07952889367634014,0.5218116011048671
4619,0.466,8,6,8,666409,10035,115307,10949,0.07948137118235965,0.5217784979031643
4620,0.4661,10,10,10,666419,10025,115317,10939,0.07940216702572551,0.5217992749475291
4621,0.4662,9,10,9,666429,10015,115326,10930,0.07932296286909137,0.5218429219384101
4622,0.4663,6,11,6,666440,10004,115332,10924,0.07923583829679381,0.521980122324159
4623,0.4664,12,12,12,666452,9992,115344,10912,0.07914079330883285,0.5220053578262533
4624,0.4665,7,9,7,666461,9983,115351,10905,0.07906950956786211,0.5220700880888548
4625,0.4666,7,11,7,666472,9972,115358,10898,0.07898238499556456,0.522184954480115
4626,0.4667,10,13,10,666485,9959,115368,10888,0.07887941959194018,0.5222813834124814
4627,0.4668,8,8,8,666493,9951,115376,10880,0.07881605626663288,0.5222984974317123
4628,0.4669,15,12,15,666505,9939,115391,10865,0.0787210112786719,0.5222553355124014
4629,0.467,5,8,5,666513,9931,115396,10860,0.07865764795336459,0.5223413977201674
4630,0.4671,10,9,10,666522,9922,115406,10850,0.07858636421239387,0.5223377623724245
4631,0.4672,8,10,8,666532,9912,115414,10842,0.07850716005575972,0.5224053194564903
4632,0.4673,12,13,12,666545,9899,115426,10830,0.07840419465213534,0.5224564619615032
4633,0.4674,8,11,8,666556,9888,115434,10822,0.07831707007983779,0.5225494929985515
4634,0.4675,10,12,10,666568,9876,115444,10812,0.07822202509187683,0.5226218097447796
4635,0.4676,7,7,7,666575,9869,115451,10805,0.07816658218223292,0.5226371287607623
4636,0.4677,6,7,6,666582,9862,115457,10799,0.07811113927258903,0.5226755723343497
4637,0.4678,8,11,8,666593,9851,115465,10791,0.07802401470029147,0.5227691115202016
4638,0.4679,10,15,10,666608,9836,115475,10781,0.07790520846534026,0.5229179803075132
4639,0.468,11,16,11,666624,9820,115486,10770,0.07777848181472563,0.523069451189898
4640,0.4681,9,11,9,666635,9809,115495,10761,0.07769135724242808,0.5231404958677686
4641,0.4682,6,5,6,666640,9804,115501,10755,0.07765175516411102,0.523128556836422
4642,0.4683,8,12,8,666652,9792,115509,10747,0.07755671017615004,0.5232484541603778
4643,0.4684,11,8,11,666660,9784,115520,10736,0.07749334685084273,0.5231968810916179
4644,0.4685,7,8,7,666668,9776,115527,10729,0.07742998352553541,0.5232382345769324
4645,0.4686,4,8,4,666676,9768,115531,10725,0.07736662020022811,0.5233494363929146
4646,0.4687,7,8,7,666684,9760,115538,10718,0.07730325687492079,0.5233909561480613
4647,0.4688,6,9,6,666693,9751,115544,10712,0.07723197313395007,0.5234814054635195
4648,0.4689,8,11,8,666704,9740,115552,10704,0.07714484856165252,0.5235765994912933
4649,0.469,11,10,11,666714,9730,115563,10693,0.07706564440501837,0.5235763599862899
4650,0.4691,12,15,12,666729,9715,115575,10681,0.07694683817006716,0.5236811139439106
4651,0.4692,14,14,14,666743,9701,115589,10667,0.07683595235077936,0.5237136684996072
4652,0.4693,4,16,4,666759,9685,115593,10663,0.07670922570016475,0.5240318458816592
4653,0.4694,10,10,10,666769,9675,115603,10653,0.0766300215435306,0.5240554899645808
4654,0.4695,8,15,8,666784,9660,115611,10645,0.07651121530857939,0.5242551095789214
4655,0.4696,13,6,13,666790,9654,115624,10632,0.07646369281459892,0.5241052942916297
4656,0.4697,8,7,8,666797,9647,115632,10624,0.07640824990495501,0.5240984657885649
4657,0.4698,6,10,6,666807,9637,115638,10618,0.07632904574832088,0.524216242902987
4658,0.4699,10,8,10,666815,9629,115648,10608,0.07626568242301356,0.5241883678410831
4659,0.47,11,8,11,666823,9621,115659,10597,0.07620231909770625,0.5241369077060045
4660,0.4701,9,6,9,666829,9615,115668,10588,0.07615479660372576,0.5240805820917686
4661,0.4702,7,5,7,666834,9610,115675,10581,0.0761151945254087,0.5240453667475607
4662,0.4703,5,7,5,666841,9603,115680,10576,0.0760597516157648,0.524109222458992
4663,0.4704,6,11,6,666852,9592,115686,10570,0.07597262704346724,0.5242535462751711
4664,0.4705,5,14,5,666866,9578,115691,10565,0.07586174122417945,0.5244998262423671
4665,0.4706,7,7,7,666873,9571,115698,10558,0.07580629831453554,0.5245168662129266
4666,0.4707,5,8,5,666881,9563,115703,10553,0.07574293498922824,0.5246072777888248
4667,0.4708,7,14,7,666895,9549,115710,10546,0.07563204916994044,0.524807165961682
4668,0.4709,10,15,10,666910,9534,115720,10536,0.07551324293498923,0.5249626307922272
4669,0.471,12,14,12,666924,9520,115732,10524,0.07540235711570144,0.525044901217322
4670,0.4711,12,11,12,666935,9509,115744,10512,0.07531523254340387,0.5250486988661905
4671,0.4712,11,9,11,666944,9500,115755,10501,0.07524394880243315,0.5250237488125594
4672,0.4713,9,12,9,666956,9488,115764,10492,0.07514890381447219,0.5251251251251251
4673,0.4714,8,10,8,666966,9478,115772,10484,0.07506969965783804,0.5251978759643322
4674,0.4715,8,12,8,666978,9466,115780,10476,0.07497465466987707,0.5253234379701134
4675,0.4716,7,10,7,666988,9456,115787,10469,0.07489545051324294,0.5254203262233376
4676,0.4717,7,7,7,666995,9449,115794,10462,0.07484000760359903,0.5254381999899553
4677,0.4718,6,18,6,667013,9431,115800,10456,0.07469744012165759,0.5257706039121034
4678,0.4719,6,9,6,667022,9422,115806,10450,0.07462615638068686,0.5258655394524959
4679,0.472,13,9,13,667031,9413,115819,10437,0.07455487263971614,0.5257934508816121
4680,0.4721,9,5,9,667036,9408,115828,10428,0.07451527056139906,0.5257108287961283
4681,0.4722,8,11,8,667047,9397,115836,10420,0.07442814598910151,0.5258111722258667
4682,0.4723,9,6,9,667053,9391,115845,10411,0.07438062349512102,0.5257549742450257
4683,0.4724,1,6,1,667059,9385,115846,10410,0.07433310100114054,0.5258903763576661
4684,0.4725,10,8,10,667067,9377,115856,10400,0.07426973767583323,0.5258633766496436
4685,0.4726,5,9,5,667076,9368,115861,10395,0.0741984539348625,0.5259828973334008
4686,0.4727,8,8,8,667084,9360,115869,10387,0.07413509060955518,0.5260039499670837
4687,0.4728,7,11,7,667095,9349,115876,10380,0.07404796603725763,0.5261290486086472
4688,0.4729,8,5,8,667100,9344,115884,10372,0.07400836395894056,0.5260701967944816
4689,0.473,13,10,13,667110,9334,115897,10359,0.07392915980230642,0.5260244757020262
4690,0.4731,11,13,11,667123,9321,115908,10348,0.07382619439868204,0.5261070720423001
4691,0.4732,7,11,7,667134,9310,115915,10341,0.07373906982638449,0.526232761691517
4692,0.4733,5,16,5,667150,9294,115920,10336,0.07361234317576987,0.5265410086602139
4693,0.4734,11,10,11,667160,9284,115931,10325,0.07353313901913572,0.5265439339078994
4694,0.4735,13,12,13,667172,9272,115944,10312,0.07343809403117475,0.5265522875816994
4695,0.4736,8,8,8,667180,9264,115952,10304,0.07337473070586745,0.526573998364677
4696,0.4737,10,11,10,667191,9253,115962,10294,0.0732876061335699,0.5266281270783241
4697,0.4738,8,10,8,667201,9243,115970,10286,0.07320840197693575,0.5267038762865482
4698,0.4739,7,8,7,667209,9235,115977,10279,0.07314503865162844,0.52675002562263
4699,0.474,8,10,8,667219,9225,115985,10271,0.07306583449499429,0.5268260155929422
4700,0.4741,7,7,7,667226,9218,115992,10264,0.0730103915853504,0.5268452930910584
4701,0.4742,15,7,15,667233,9211,116007,10249,0.0729549486757065,0.5266700924974306
4702,0.4743,5,6,5,667239,9205,116012,10244,0.07290742618172602,0.5267108848783999
4703,0.4744,12,2,12,667241,9203,116024,10232,0.07289158535039919,0.5264728582454336
4704,0.4745,5,11,5,667252,9192,116029,10227,0.07280446077810164,0.5266491580410938
4705,0.4746,2,12,2,667264,9180,116031,10225,0.07270941579014066,0.5269260499871167
4706,0.4747,8,7,8,667271,9173,116039,10217,0.07265397288049677,0.5269210933470861
4707,0.4748,8,15,8,667286,9158,116047,10209,0.07253516664554556,0.5271337842722156
4708,0.4749,11,19,11,667305,9139,116058,10198,0.07238467874794069,0.5273827377566324
4709,0.475,12,13,12,667318,9126,116070,10186,0.07228171334431631,0.5274440762220381
4710,0.4751,7,15,7,667333,9111,116077,10179,0.0721629071093651,0.5276827371695179
4711,0.4752,6,6,6,667339,9105,116083,10173,0.07211538461538461,0.5276999688764394
4712,0.4753,7,10,7,667349,9095,116090,10166,0.07203618045875047,0.527802294792586
4713,0.4754,10,5,10,667354,9090,116100,10156,0.0719965783804334,0.5276940662994908
4714,0.4755,12,7,12,667361,9083,116112,10144,0.07194113547078951,0.5275914079159515
4715,0.4756,14,11,14,667372,9072,116126,10130,0.07185401089849196,0.5275492136235809
4716,0.4757,4,7,4,667379,9065,116130,10126,0.07179856798884805,0.5276431660674274
4717,0.4758,8,12,8,667391,9053,116138,10118,0.07170352300088709,0.5277763288300037
4718,0.4759,17,12,17,667403,9041,116155,10101,0.07160847801292612,0.5276878069167276
4719,0.476,6,6,6,667409,9035,116161,10095,0.07156095551894563,0.5277051751176163
4720,0.4761,3,8,3,667417,9027,116164,10092,0.07149759219363833,0.52785187509807
4721,0.4762,5,8,5,667425,9019,116169,10087,0.071434228868331,0.5279493352873443
4722,0.4763,10,21,10,667446,8998,116179,10077,0.07126790013939932,0.5282830930537352
4723,0.4764,7,12,7,667458,8986,116186,10070,0.07117285515143834,0.5284424853064652
4724,0.4765,6,9,6,667467,8977,116192,10064,0.07110157141046762,0.5285436689249514
4725,0.4766,8,7,8,667474,8970,116200,10056,0.07104612850082373,0.5285398927783034
4726,0.4767,7,9,7,667483,8961,116207,10049,0.070974844759853,0.5286165176223041
4727,0.4768,11,11,11,667494,8950,116218,10038,0.07088772018755544,0.5286496734779861
4728,0.4769,11,14,11,667508,8936,116229,10027,0.07077683436826765,0.5287665453778411
4729,0.477,9,12,9,667520,8924,116238,10018,0.07068178938030668,0.528877626438602
4730,0.4771,10,13,10,667533,8911,116248,10008,0.07057882397668229,0.5289920186056345
4731,0.4772,9,4,9,667537,8907,116257,9999,0.07054714231402864,0.5288797207235798
4732,0.4773,6,4,6,667541,8903,116263,9993,0.07051546065137498,0.5288420829805249
4733,0.4774,8,8,8,667549,8895,116271,9985,0.07045209732606768,0.5288665254237288
4734,0.4775,9,10,9,667559,8885,116280,9976,0.07037289316943353,0.5289221144159907
4735,0.4776,13,6,13,667565,8879,116293,9963,0.07032537067545305,0.5287655238297421
4736,0.4777,11,15,11,667580,8864,116304,9952,0.07020656444050184,0.5289115646258503
4737,0.4778,10,9,10,667589,8855,116314,9942,0.07013528069953111,0.5289141884343246
4738,0.4779,6,8,6,667597,8847,116320,9936,0.0700719173742238,0.5289889793962625
4739,0.478,6,7,6,667604,8840,116326,9930,0.0700164744645799,0.529035695258391
4740,0.4781,12,6,12,667610,8834,116338,9918,0.06996895197059942,0.5289035836177475
4741,0.4782,7,4,7,667614,8830,116345,9911,0.06993727030794576,0.5288405101115202
4742,0.4783,4,11,4,667625,8819,116349,9907,0.06985014573564821,0.5290505179963687
4743,0.4784,7,15,7,667640,8804,116356,9900,0.069731339500697,0.5292985457656116
4744,0.4785,11,8,11,667648,8796,116367,9889,0.06966797617538968,0.5292480599411292
4745,0.4786,15,16,15,667664,8780,116382,9874,0.06954124952477506,0.5293234694971588
4746,0.4787,7,11,7,667675,8769,116389,9867,0.0694541249524775,0.5294591113972955
4747,0.4788,12,15,12,667690,8754,116401,9855,0.0693353187175263,0.5295824600999517
4748,0.4789,8,5,8,667695,8749,116409,9847,0.06929571663920922,0.5295224779522478
4749,0.479,7,15,7,667710,8734,116416,9840,0.06917691040425801,0.5297728006891353
4750,0.4791,5,18,5,667728,8716,116421,9835,0.06903434292231657,0.5301600991860277
4751,0.4792,4,5,4,667733,8711,116425,9831,0.0689947408439995,0.5302017042390249
4752,0.4793,11,12,11,667745,8699,116436,9820,0.06889969585603853,0.53026621307846
4753,0.4794,8,11,8,667756,8688,116444,9812,0.06881257128374096,0.5303783783783784
4754,0.4795,10,7,10,667763,8681,116454,9802,0.06875712837409707,0.5303251636639074
4755,0.4796,10,11,10,667774,8670,116464,9792,0.06867000380179952,0.5303867403314917
4756,0.4797,10,9,10,667783,8661,116474,9782,0.06859872006082879,0.5303909342297891
4757,0.4798,9,13,9,667796,8648,116483,9773,0.06849575465720441,0.5305358015308616
4758,0.4799,7,9,7,667805,8639,116490,9766,0.06842447091623369,0.5306166802499321
4759,0.48,11,14,11,667819,8625,116501,9755,0.06831358509694589,0.530739934711643
4760,0.4801,6,9,6,667828,8616,116507,9749,0.06824230135597516,0.5308467193030221
4761,0.4802,11,9,11,667837,8607,116518,9738,0.06817101761500444,0.5308258381030253
4762,0.4803,16,9,16,667846,8598,116534,9722,0.06809973387403372,0.5306768558951965
4763,0.4804,5,10,5,667856,8588,116539,9717,0.06802052971739957,0.5308385686970774
4764,0.4805,9,8,9,667864,8580,116548,9708,0.06795716639209226,0.5308398950131233
4765,0.4806,8,11,8,667875,8569,116556,9700,0.0678700418197947,0.5309540752093711
4766,0.4807,6,15,6,667890,8554,116562,9694,0.06775123558484349,0.5312362998684788
4767,0.4808,10,8,10,667898,8546,116572,9684,0.06768787225953618,0.5312122874382885
4768,0.4809,15,14,15,667912,8532,116587,9669,0.06757698644024838,0.5312345475523322
4769,0.481,5,7,5,667919,8525,116592,9664,0.06752154353060448,0.5313101324976635
4770,0.4811,12,11,12,667930,8514,116604,9652,0.06743441895830693,0.5313222503578113
4771,0.4812,13,13,13,667943,8501,116617,9639,0.06733145355468255,0.531367144432194
4772,0.4813,9,11,9,667954,8490,116626,9630,0.067244328982385,0.5314569536423841
4773,0.4814,7,9,7,667963,8481,116633,9623,0.06717304524141426,0.5315399911621741
4774,0.4815,5,5,5,667968,8476,116638,9618,0.0671334431630972,0.5315574223499503
4775,0.4816,10,6,10,667974,8470,116648,9608,0.06708592066911671,0.5314747206549397
4776,0.4817,8,8,8,667982,8462,116656,9600,0.06702255734380941,0.5315026021481564
4777,0.4818,7,14,7,667996,8448,116663,9593,0.06691167152452161,0.5317332742087467
4778,0.4819,4,11,4,668007,8437,116667,9589,0.06682454695222405,0.5319538444469101
4779,0.482,5,12,5,668019,8425,116672,9584,0.06672950196426308,0.532178355266811
4780,0.4821,12,11,12,668030,8414,116684,9572,0.06664237739196553,0.5321917046591793
4781,0.4822,9,11,9,668041,8403,116693,9563,0.06655525281966798,0.5322832016030279
4782,0.4823,9,6,9,668047,8397,116702,9554,0.06650773032568749,0.5322266169015654
4783,0.4824,10,11,10,668058,8386,116712,9544,0.06642060575338994,0.532292247629671
4784,0.4825,10,8,10,668066,8378,116722,9534,0.06635724242808262,0.532268870031264
4785,0.4826,8,10,8,668076,8368,116730,9526,0.06627803827144849,0.5323572147088409
4786,0.4827,7,5,7,668081,8363,116737,9519,0.06623843619313141,0.5323230063751259
4787,0.4828,7,6,7,668087,8357,116744,9512,0.06619091369915094,0.5323185404891152
4788,0.4829,4,8,4,668095,8349,116748,9508,0.06612755037384362,0.532452259618077
4789,0.483,16,9,16,668104,8340,116764,9492,0.0660562666328729,0.5323014804845222
4790,0.4831,11,12,11,668116,8328,116775,9481,0.06596122164491193,0.5323712729518782
4791,0.4832,9,7,9,668123,8321,116784,9472,0.06590577873526803,0.5323441802956219
4792,0.4833,4,10,4,668133,8311,116788,9468,0.06582657457863389,0.532538387985826
4793,0.4834,7,11,7,668144,8300,116795,9461,0.06573945000633634,0.5326839704971567
4794,0.4835,8,10,8,668154,8290,116803,9453,0.06566024584970219,0.5327734881361664
4795,0.4836,9,12,9,668166,8278,116812,9444,0.06556520086174122,0.5328969642252568
4796,0.4837,9,6,9,668172,8272,116821,9435,0.06551767836776073,0.5328401197266618
4797,0.4838,8,7,8,668179,8265,116829,9427,0.06546223545811684,0.5328397015600271
4798,0.4839,9,10,9,668189,8255,116838,9418,0.06538303130148271,0.5329032988174051
4799,0.484,10,12,10,668201,8243,116848,9408,0.06528798631352173,0.533000963118237
4800,0.4841,12,12,12,668213,8231,116860,9396,0.06519294132556076,0.5330458955012197
4801,0.4842,4,7,4,668220,8224,116864,9392,0.06513749841591687,0.5331516802906449
4802,0.4843,5,5,5,668225,8219,116869,9387,0.0650978963375998,0.5331705100533909
4803,0.4844,9,9,9,668234,8210,116878,9378,0.06502661259662908,0.5332044575847169
4804,0.4845,15,4,15,668238,8206,116893,9363,0.06499493093397542,0.5329273151573795
4805,0.4846,11,7,11,668245,8199,116904,9352,0.06493948802433151,0.5328471312175944
4806,0.4847,6,6,6,668251,8193,116910,9346,0.06489196553035104,0.5328696048805519
4807,0.4848,10,9,10,668260,8184,116920,9336,0.0648206817893803,0.5328767123287671
4808,0.4849,9,11,9,668271,8173,116929,9327,0.06473355721708275,0.5329714285714285
4809,0.485,16,11,16,668282,8162,116945,9311,0.0646464326447852,0.5328792994906427
4810,0.4851,5,13,5,668295,8149,116950,9306,0.06454346724116082,0.5331423660842166
4811,0.4852,5,11,5,668306,8138,116955,9301,0.06445634266886326,0.5333448018808418
4812,0.4853,7,12,7,668318,8126,116962,9294,0.06436129768090229,0.5335246842709529
4813,0.4854,11,12,11,668330,8114,116973,9283,0.06426625269294133,0.5335977467379434
4814,0.4855,11,8,11,668338,8106,116984,9272,0.06420288936763402,0.5335481643457245
4815,0.4856,6,10,6,668348,8096,116990,9266,0.06412368521099987,0.5336942748531275
4816,0.4857,8,9,8,668357,8087,116998,9258,0.06405240147002915,0.5337561256846354
4817,0.4858,9,4,9,668361,8083,117007,9249,0.06402071980737549,0.5336372028617586
4818,0.4859,9,12,9,668373,8071,117016,9240,0.06392567481941452,0.5337646583097453
4819,0.486,6,13,6,668386,8058,117022,9234,0.06382270941579014,0.5340041637751561
4820,0.4861,10,9,10,668395,8049,117032,9224,0.06375142567481941,0.534012620853355
4821,0.4862,7,9,7,668404,8040,117039,9217,0.06368014193384869,0.5341021034942343
4822,0.4863,8,4,8,668408,8036,117047,9209,0.06364846027119503,0.5340098579298347
4823,0.4864,6,16,6,668424,8020,117053,9203,0.0635217336205804,0.5343436102885676
4824,0.4865,10,6,10,668430,8014,117063,9193,0.06347421112659993,0.5342593130702621
4825,0.4866,12,12,12,668442,8002,117075,9181,0.06337916613863896,0.5343071640574987
4826,0.4867,8,8,8,668450,7994,117083,9173,0.06331580281333164,0.5343391390458437
4827,0.4868,9,11,9,668461,7983,117092,9164,0.06322867824103409,0.5344375109348574
4828,0.4869,11,4,11,668465,7979,117103,9153,0.06319699657838043,0.5342633667989727
4829,0.487,9,9,9,668474,7970,117112,9144,0.06312571283740971,0.5342994039967278
4830,0.4871,4,8,4,668482,7962,117116,9140,0.06306234951210239,0.5344404163255759
4831,0.4872,5,8,5,668490,7954,117121,9135,0.06299898618679509,0.534554391713968
4832,0.4873,8,5,8,668495,7949,117129,9127,0.06295938410847801,0.5344928554696651
4833,0.4874,6,9,6,668504,7940,117135,9121,0.06288810036750729,0.5346111013422425
4834,0.4875,5,9,5,668513,7931,117140,9116,0.06281681662653656,0.5347568487123834
4835,0.4876,6,6,6,668519,7925,117146,9110,0.06276929413255608,0.5347813325506311
4836,0.4877,8,9,8,668528,7916,117154,9102,0.06269801039158535,0.534845457750617
4837,0.4878,4,11,4,668539,7905,117158,9098,0.0626108858192878,0.5350820443451155
4838,0.4879,5,11,5,668550,7894,117163,9093,0.06252376124699024,0.5352916936480838
4839,0.488,10,10,10,668560,7884,117173,9083,0.0624445570903561,0.5353332940413744
4840,0.4881,8,11,8,668571,7873,117181,9075,0.062357432518058545,0.5354614113759736
4841,0.4882,7,8,7,668579,7865,117188,9068,0.06229406919275123,0.5355223528022205
4842,0.4883,8,6,8,668585,7859,117196,9060,0.06224654669877075,0.5354926414090667
4843,0.4884,6,8,6,668593,7851,117202,9054,0.06218318337346344,0.5355811889973381
4844,0.4885,6,12,6,668605,7839,117208,9048,0.06208813838550247,0.535796766743649
4845,0.4886,9,6,9,668611,7833,117217,9039,0.06204061589152199,0.5357396870554765
4846,0.4887,4,10,4,668621,7823,117221,9035,0.061961411734887846,0.5359473247123028
4847,0.4888,6,9,6,668630,7814,117227,9029,0.06189012799391712,0.536068396366443
4848,0.4889,7,9,7,668639,7805,117234,9022,0.0618188442529464,0.5361621204017353
4849,0.489,9,8,9,668647,7797,117243,9013,0.061755480927639085,0.5361689470553243
4850,0.4891,1,13,1,668660,7784,117244,9012,0.0616525155240147,0.5365563229340319
4851,0.4892,6,7,6,668667,7777,117250,9006,0.0615970726143708,0.5366144312697372
4852,0.4893,14,5,14,668672,7772,117264,8992,0.06155747053605373,0.5363874970174183
4853,0.4894,8,7,8,668679,7765,117272,8984,0.061502027626409835,0.5363902322526718
4854,0.4895,7,6,7,668685,7759,117279,8977,0.06145450513242935,0.5363886233269598
4855,0.4896,13,9,13,668694,7750,117292,8964,0.061383221391458624,0.536316860117267
4856,0.4897,4,9,4,668703,7741,117296,8960,0.0613119376504879,0.536494820669421
4857,0.4898,7,4,7,668707,7737,117303,8953,0.061280255987834244,0.5364289994008389
4858,0.4899,6,8,6,668715,7729,117309,8947,0.06121689266252693,0.5365195490525306
4859,0.49,6,5,6,668720,7724,117315,8941,0.061177290584209856,0.5365136513651365
4860,0.4901,7,11,7,668731,7713,117322,8934,0.061090166011912306,0.5366732744638674
4861,0.4902,4,9,4,668740,7704,117326,8930,0.06101888227094158,0.5368522303715282
4862,0.4903,7,8,7,668748,7696,117333,8923,0.060955518945634266,0.5369155785546663
4863,0.4904,12,10,12,668758,7686,117345,8911,0.06087631478900013,0.536904259805989
4864,0.4905,5,12,5,668770,7674,117350,8906,0.06078126980103916,0.5371531966224367
4865,0.4906,13,7,13,668777,7667,117363,8893,0.06072582689139526,0.5370169082125604
4866,0.4907,9,7,9,668784,7660,117372,8884,0.06067038398175136,0.5369922630560928
4867,0.4908,9,9,9,668793,7651,117381,8875,0.060599100240780635,0.5370325547621929
4868,0.4909,7,4,7,668797,7647,117388,8868,0.06056741857812698,0.5369663941871027
4869,0.491,11,10,11,668807,7637,117399,8857,0.06048821442149284,0.5369831453862011
4870,0.4911,11,11,11,668818,7626,117410,8846,0.06040108984919529,0.5370325400679942
4871,0.4912,10,5,10,668823,7621,117420,8836,0.060361487770878214,0.5369143829373519
4872,0.4913,6,13,6,668836,7608,117426,8830,0.06025852236725383,0.5371699720160603
4873,0.4914,7,7,7,668843,7601,117433,8823,0.060203079457609936,0.5372016561130054
4874,0.4915,8,9,8,668852,7592,117441,8815,0.06013179571663921,0.537270677149997
4875,0.4916,6,14,6,668866,7578,117447,8809,0.06002090989735141,0.5375602611826448
4876,0.4917,9,7,9,668873,7571,117456,8800,0.059965466987707515,0.5375358866287948
4877,0.4918,5,8,5,668881,7563,117461,8795,0.0599021036624002,0.5376574153319477
4878,0.4919,5,8,5,668889,7555,117466,8790,0.05983874033709289,0.5377791373508718
4879,0.492,9,6,9,668895,7549,117475,8781,0.05979121784311241,0.5377219840783833
4880,0.4921,9,7,9,668902,7542,117484,8772,0.05973577493346851,0.5376976829716807
4881,0.4922,8,8,8,668910,7534,117492,8764,0.0596724116081612,0.5377346913731746
4882,0.4923,6,10,6,668920,7524,117498,8758,0.059593207451527054,0.537894607542071
4883,0.4924,6,5,6,668925,7519,117504,8752,0.059553605373209986,0.5378894966504825
4884,0.4925,5,10,5,668935,7509,117509,8747,0.059474401216575844,0.5380782480314961
4885,0.4926,7,8,7,668943,7501,117516,8740,0.05941103789126853,0.5381442029431686
4886,0.4927,9,10,9,668953,7491,117525,8731,0.059331833734634395,0.5382197016397485
4887,0.4928,8,6,8,668959,7485,117533,8723,0.05928431124065391,0.5381910167818361
4888,0.4929,6,9,6,668968,7476,117539,8717,0.059213027499683185,0.5383190267399494
4889,0.493,10,14,10,668982,7462,117549,8707,0.05910214168039539,0.5384995979961655
4890,0.4931,8,15,8,668997,7447,117557,8699,0.05898333544544418,0.5387712126842562
4891,0.4932,12,6,12,669003,7441,117569,8687,0.05893581295146369,0.5386284722222222
4892,0.4933,7,7,7,669010,7434,117576,8680,0.05888037004181979,0.5386620330147698
4893,0.4934,4,5,4,669015,7429,117580,8676,0.058840767963502724,0.5387146848804719
4894,0.4935,8,11,8,669026,7418,117588,8668,0.058753643391205174,0.5388536615690662
4895,0.4936,14,6,14,669032,7412,117602,8654,0.058706120897224684,0.5386530561434084
4896,0.4937,9,10,9,669042,7402,117611,8645,0.05862691674059055,0.5387299806817474
4897,0.4938,8,11,8,669053,7391,117619,8637,0.05853979216829299,0.5388694784127777
4898,0.4939,9,7,9,669060,7384,117628,8628,0.05848434925864909,0.5388458656007994
4899,0.494,8,13,8,669073,7371,117636,8620,0.05838138385502471,0.539053217434807
4900,0.4941,10,10,10,669083,7361,117646,8610,0.05830217969839057,0.5391021225972075
4901,0.4942,11,7,11,669090,7354,117657,8599,0.05824673678874667,0.5390208738168369
4902,0.4943,10,6,10,669096,7348,117667,8589,0.05819921429476619,0.5389345548095626
4903,0.4944,15,6,15,669102,7342,117682,8574,0.05815169180078571,0.5387031917567228
4904,0.4945,12,12,12,669114,7330,117694,8562,0.058056646812824735,0.5387616410772715
4905,0.4946,10,11,10,669125,7319,117704,8552,0.057969522240527184,0.5388444332430219
4906,0.4947,7,8,7,669133,7311,117711,8545,0.05790615891521987,0.5389127144298688
4907,0.4948,13,4,13,669137,7307,117724,8532,0.05787447725256621,0.5386703706042049
4908,0.4949,6,9,6,669146,7298,117730,8526,0.05780319351159549,0.5388018200202225
4909,0.495,7,5,7,669151,7293,117737,8519,0.057763591433278416,0.5387680242853529
4910,0.4951,5,7,5,669158,7286,117742,8514,0.05770814852363452,0.5388607594936708
4911,0.4952,7,11,7,669169,7275,117749,8507,0.05762102395133697,0.5390318083893043
4912,0.4953,6,10,6,669179,7265,117755,8501,0.057541819794702825,0.5391982747684891
4913,0.4954,11,7,11,669186,7258,117766,8490,0.05748637688505893,0.5391160782321565
4914,0.4955,8,8,8,669194,7250,117774,8482,0.057423013559751615,0.5391558606661582
4915,0.4956,8,10,8,669204,7240,117782,8474,0.05734380940311747,0.5392643502609138
4916,0.4957,6,5,6,669209,7235,117788,8468,0.057304207324800405,0.5392600140100617
4917,0.4958,7,10,7,669219,7225,117795,8461,0.05722500316816626,0.5393981894683157
4918,0.4959,9,9,9,669228,7216,117804,8452,0.05715371942719554,0.5394434516211386
4919,0.496,5,16,5,669244,7200,117809,8447,0.057026992776580916,0.5398478941650157
4920,0.4961,10,6,10,669250,7194,117819,8437,0.05697947028260043,0.5397607318789585
4921,0.4962,6,6,6,669256,7188,117825,8431,0.056931947788619944,0.5397912798514629
4922,0.4963,4,8,4,669264,7180,117829,8427,0.05686858446331264,0.5399500224258346
4923,0.4964,7,8,7,669272,7172,117836,8420,0.056805221138005325,0.5400205233453053
4924,0.4965,9,6,9,669278,7166,117845,8411,0.056757698644024836,0.5399627656159722
4925,0.4966,9,10,9,669288,7156,117854,8402,0.0566784944873907,0.5400437074174058
4926,0.4967,8,4,8,669292,7152,117862,8394,0.05664681282473704,0.5399459668081822
4927,0.4968,3,7,3,669299,7145,117865,8391,0.05659136991509314,0.540100411946447
4928,0.4969,4,7,4,669306,7138,117869,8387,0.056535927005449245,0.5402254428341385
4929,0.497,16,6,16,669312,7132,117885,8371,0.05648840451146876,0.5399600077404373
4930,0.4971,8,10,8,669322,7122,117893,8363,0.05640920035483462,0.5400710364869228
4931,0.4972,7,11,7,669333,7111,117900,8356,0.05632207578253707,0.5402469774358312
4932,0.4973,6,4,6,669337,7107,117906,8350,0.05629039411988341,0.5402083198550819
4933,0.4974,6,4,6,669341,7103,117912,8344,0.056258712457229756,0.540169612222438
4934,0.4975,7,11,7,669352,7092,117919,8337,0.0561715878849322,0.5403461014971807
4935,0.4976,11,13,11,669365,7079,117930,8326,0.05606862248130782,0.5404738721194418
4936,0.4977,6,8,6,669373,7071,117936,8320,0.056005259156000506,0.5405756611006433
4937,0.4978,9,5,9,669378,7066,117945,8311,0.05596565707768344,0.540482538856734
4938,0.4979,10,8,10,669386,7058,117955,8301,0.055902293752376125,0.5404648740152354
4939,0.498,9,5,9,669391,7053,117964,8292,0.05586269167405906,0.5403714565004888
4940,0.4981,5,5,5,669396,7048,117969,8287,0.05582308959574198,0.5403977828496902
4941,0.4982,7,4,7,669400,7044,117976,8280,0.05579140793308833,0.5403288958496476
4942,0.4983,7,10,7,669410,7034,117983,8273,0.05571220377645419,0.5404716796237016
4943,0.4984,7,15,7,669425,7019,117990,8266,0.05559339754150298,0.5407916257769054
4944,0.4985,9,4,9,669429,7015,117999,8257,0.055561715878849324,0.5406626506024096
4945,0.4986,11,5,11,669434,7010,118010,8246,0.05552211380053225,0.5405086523335081
4946,0.4987,7,7,7,669441,7003,118017,8239,0.05546667089088835,0.5405458601233434
4947,0.4988,9,7,9,669448,6996,118026,8230,0.055411227981244454,0.5405227899645344
4948,0.4989,5,6,5,669454,6990,118031,8225,0.05536370548726397,0.5405849490634242
4949,0.499,3,10,3,669464,6980,118034,8222,0.05528450133062983,0.5408498881726088
4950,0.4991,7,7,7,669471,6973,118041,8215,0.05522905842098593,0.540887542796945
4951,0.4992,10,14,10,669485,6959,118051,8205,0.055118172601698136,0.5410841466631495
4952,0.4993,7,8,7,669493,6951,118058,8198,0.05505480927639082,0.5411578322001452
4953,0.4994,11,11,11,669504,6940,118069,8187,0.05496768470409327,0.5412176902227804
4954,0.4995,6,9,6,669513,6931,118075,8181,0.054896400963122545,0.5413578613022764
4955,0.4996,4,10,4,669523,6921,118079,8177,0.0548171968064884,0.5415949132335409
4956,0.4997,5,9,5,669532,6912,118084,8172,0.05474591306551768,0.5417661097852029
4957,0.4998,14,11,14,669543,6901,118098,8158,0.054658788493220124,0.5417358390331364
4958,0.4999,5,10,5,669553,6891,118103,8153,0.05457958433658598,0.5419436320127625
4959,0.5,10,6,10,669559,6885,118113,8143,0.0545320618426055,0.5418552036199095
4960,0.5001,6,5,6,669564,6880,118119,8137,0.05449245976428843,0.5418525670906306
4961,0.5002,10,12,10,669576,6868,118129,8127,0.05439741477632746,0.5419806602200734
4962,0.5003,5,8,5,669584,6860,118134,8122,0.054334051451020146,0.5421172073154452
4963,0.5004,8,9,8,669593,6851,118142,8114,0.054262767710049425,0.5421984630805212
4964,0.5005,7,6,7,669599,6845,118149,8107,0.05421524521606894,0.5422017121455324
4965,0.5006,7,14,7,669613,6831,118156,8100,0.05410435939678114,0.5424954792043399
4966,0.5007,9,16,9,669629,6815,118165,8091,0.05397763274616652,0.5428015564202334
4967,0.5008,9,6,9,669635,6809,118174,8082,0.05393011025218603,0.5427439392921899
4968,0.5009,9,6,9,669641,6803,118183,8073,0.05388258775820555,0.5426862059693466
4969,0.501,9,5,9,669646,6798,118192,8064,0.05384298567988848,0.5425918449737586
4970,0.5011,7,7,7,669653,6791,118199,8057,0.053787542770244584,0.5426320043103449
4971,0.5012,6,9,6,669662,6782,118205,8051,0.053716259029273856,0.5427762421627452
4972,0.5013,7,4,7,669666,6778,118212,8044,0.053684577366620204,0.542706787208204
4973,0.5014,8,10,8,669676,6768,118220,8036,0.05360537320998606,0.5428262631721157
4974,0.5015,7,5,7,669681,6763,118227,8029,0.05356577113166899,0.5427934018388318
4975,0.5016,12,7,12,669688,6756,118239,8017,0.05351032822202509,0.5426792120760847
4976,0.5017,12,9,12,669697,6747,118251,8005,0.05343904448105437,0.5426382863340564
4977,0.5018,9,3,9,669700,6744,118260,7996,0.05341528323406412,0.5424694708276798
4978,0.5019,6,8,6,669708,6736,118266,7990,0.05335191990875681,0.5425777536330301
4979,0.502,5,7,5,669715,6729,118271,7985,0.05329647699911291,0.5426804403969009
4980,0.5021,10,11,10,669726,6718,118281,7975,0.05320935242681536,0.5427754713128701
4981,0.5022,7,7,7,669733,6711,118288,7968,0.053153909517171465,0.5428162681381565
4982,0.5023,12,5,12,669738,6706,118300,7956,0.05311430743885439,0.5426271995634975
4983,0.5024,6,11,6,669749,6695,118306,7950,0.05302718286655684,0.5428473881870945
4984,0.5025,11,5,11,669754,6690,118317,7939,0.052987580788239765,0.5426891790279582
4985,0.5026,10,4,10,669758,6686,118327,7929,0.05295589912558611,0.542524803284297
4986,0.5027,7,5,7,669763,6681,118334,7922,0.052916297047269044,0.5424912689173458
4987,0.5028,6,4,6,669767,6677,118340,7916,0.052884615384615384,0.5424518604810525
4988,0.5029,11,4,11,669771,6673,118351,7905,0.05285293372196173,0.5422554534229661
4989,0.503,9,9,9,669780,6664,118360,7896,0.052781649980991004,0.5423076923076923
4990,0.5031,5,10,5,669790,6654,118365,7891,0.05270244582435686,0.5425232038501203
4991,0.5032,2,1,2,669791,6653,118367,7889,0.052694525408693446,0.5424975931783799
4992,0.5033,8,8,8,669799,6645,118375,7881,0.052631162083386133,0.5425444031391987
4993,0.5034,9,1,9,669800,6644,118384,7872,0.052623241667722725,0.5422981537613668
4994,0.5035,12,6,12,669806,6638,118396,7860,0.052575719173742236,0.5421437439646848
4995,0.5036,9,6,9,669812,6632,118405,7851,0.05252819667976175,0.5420838224124837
4996,0.5037,10,6,10,669818,6626,118415,7841,0.05248067418578127,0.5419921199972351
4997,0.5038,8,9,8,669827,6617,118423,7833,0.05240939044481054,0.542076124567474
4998,0.5039,13,9,13,669836,6608,118436,7820,0.052338106703839815,0.5420016634322151
4999,0.504,8,9,8,669845,6599,118444,7812,0.052266822962869094,0.5420859065991257
5000,0.5041,5,5,5,669850,6594,118449,7807,0.05222722088455202,0.5421151308936879
5001,0.5042,5,12,5,669862,6582,118454,7802,0.052132175896591054,0.5424082313681868
5002,0.5043,4,6,4,669868,6576,118458,7798,0.05208465340261057,0.54250730485599
5003,0.5044,9,7,9,669875,6569,118467,7789,0.052029210492966674,0.5424850257696058
5004,0.5045,7,7,7,669882,6562,118474,7782,0.051973767583322776,0.542526491912995
5005,0.5046,8,7,8,669889,6555,118482,7774,0.05191832467367887,0.5425361155698234
5006,0.5047,4,11,4,669900,6544,118486,7770,0.05183120010138132,0.542825206091938
5007,0.5048,8,10,8,669910,6534,118494,7762,0.05175199594474718,0.5429490766648013
5008,0.5049,2,9,2,669919,6525,118496,7760,0.05168071220377645,0.5432271613580679
5009,0.505,2,1,2,669920,6524,118498,7758,0.05167279178811304,0.5432012323204033
5010,0.5051,8,8,8,669928,6516,118506,7750,0.05160942846280573,0.5432496845646992
5011,0.5052,7,5,7,669933,6511,118513,7743,0.051569826384488655,0.5432159393854357
5012,0.5053,3,6,3,669939,6505,118516,7740,0.05152230389050817,0.5433485433485433
5013,0.5054,7,6,7,669945,6499,118523,7733,0.05147478139652769,0.5433530073074762
5014,0.5055,9,9,9,669954,6490,118532,7724,0.05140349765555696,0.5434079076966372
5015,0.5056,4,9,4,669963,6481,118536,7720,0.051332213914586235,0.5436236884726428
5016,0.5057,8,7,8,669970,6474,118544,7712,0.05127677100494234,0.5436345692936698
5017,0.5058,9,8,9,669978,6466,118553,7703,0.051213407679635024,0.5436516338485426
5018,0.5059,11,9,11,669987,6457,118564,7692,0.051142123938664304,0.5436426602586755
5019,0.506,3,10,3,669997,6447,118567,7689,0.05106291978203016,0.5439303904923599
5020,0.5061,4,6,4,670003,6441,118571,7685,0.05101539728804968,0.5440322809004672
5021,0.5062,7,6,7,670009,6435,118578,7678,0.050967874794069196,0.544037412314887
5022,0.5063,4,8,4,670017,6427,118582,7674,0.05090451146876188,0.5442167222182824
5023,0.5064,11,3,11,670020,6424,118593,7663,0.05088075022177164,0.5439767161212465
5024,0.5065,7,8,7,670028,6416,118600,7656,0.050817386896464325,0.5440591245025582
5025,0.5066,7,7,7,670035,6409,118607,7649,0.05076194398682043,0.5441030018494807
5026,0.5067,8,10,8,670045,6399,118615,7641,0.050682739830186285,0.5442307692307692
5027,0.5068,7,9,7,670054,6390,118622,7634,0.050611456089215565,0.5443525385054193
5028,0.5069,10,7,10,670061,6383,118632,7624,0.05055601317957167,0.5442992789319626
5029,0.507,5,5,5,670066,6378,118637,7619,0.05051641110125459,0.544330928056012
5030,0.5071,13,5,13,670071,6373,118650,7606,0.050476809022937524,0.5441018670863438
5031,0.5072,8,5,8,670076,6368,118658,7598,0.05043720694462046,0.5440355148217099
5032,0.5073,3,9,3,670085,6359,118661,7595,0.05036592320364973,0.5442883760928766
5033,0.5074,6,5,6,670090,6354,118667,7589,0.050326321125332654,0.5442874560711468
5034,0.5075,6,5,6,670095,6349,118673,7583,0.050286719047015586,0.5442865345966121
5035,0.5076,7,11,7,670106,6338,118680,7576,0.050199594474718036,0.5444875664798046
5036,0.5077,6,5,6,670111,6333,118686,7570,0.05015999239640096,0.5444868014097677
5037,0.5078,9,13,9,670124,6320,118695,7561,0.05005702699277658,0.5447013903897414
5038,0.5079,5,7,5,670131,6313,118700,7556,0.05000158408313268,0.5448121710289134
5039,0.508,6,9,6,670140,6304,118706,7550,0.049930300342161955,0.5449689620326259
5040,0.5081,9,4,9,670144,6300,118715,7541,0.0498986186795083,0.5448305758254461
5041,0.5082,5,6,5,670150,6294,118720,7536,0.04985109618552782,0.5449023861171367
5042,0.5083,11,11,11,670161,6283,118731,7525,0.04976397161323026,0.5449739281575898
5043,0.5084,7,6,7,670167,6277,118738,7518,0.04971644911924978,0.5449800652410294
5044,0.5085,12,5,12,670172,6272,118750,7506,0.049676847040932705,0.544781535781681
5045,0.5086,4,7,4,670179,6265,118754,7502,0.04962140413128881,0.5449262729715988
5046,0.5087,2,7,2,670186,6258,118756,7500,0.04956596122164491,0.5451373746184038
5047,0.5088,6,8,6,670194,6250,118762,7494,0.0495025978963376,0.5452561117578579
5048,0.5089,6,6,6,670200,6244,118768,7488,0.049455075402357114,0.5452956597727935
5049,0.509,4,10,4,670210,6234,118772,7484,0.04937587124572298,0.545560577343636
5050,0.5091,2,5,2,670215,6229,118774,7482,0.049336269167405904,0.5456932390051783
5051,0.5092,4,7,4,670222,6222,118778,7478,0.049280826257762006,0.5458394160583941
5052,0.5093,8,8,8,670230,6214,118786,7470,0.04921746293245469,0.5458930137386729
5053,0.5094,7,13,7,670243,6201,118793,7463,0.04911449752883031,0.5461797423887588
5054,0.5095,8,6,8,670249,6195,118801,7455,0.04906697503484983,0.5461538461538461
5055,0.5096,3,7,3,670256,6188,118804,7452,0.04901153212520593,0.5463343108504399
5056,0.5097,7,8,7,670264,6180,118811,7445,0.04894816879989862,0.5464220183486238
5057,0.5098,5,8,5,670272,6172,118816,7440,0.04888480547459131,0.5465765501028504
5058,0.5099,4,4,4,670276,6168,118820,7436,0.04885312381193765,0.5466039400176419
5059,0.51,10,11,10,670287,6157,118830,7426,0.0487659992396401,0.5467128027681661
5060,0.5101,9,8,9,670295,6149,118839,7417,0.048702635914332784,0.546734483266991
5061,0.5102,3,11,3,670306,6138,118842,7414,0.04861551134203523,0.547077922077922
5062,0.5103,7,10,7,670316,6128,118849,7407,0.04853630718540109,0.547247875877355
5063,0.5104,6,12,6,670328,6116,118855,7401,0.04844126219744012,0.5475327365539691
5064,0.5105,2,7,2,670335,6109,118857,7399,0.04838581928779622,0.5477494817885697
5065,0.5106,6,4,6,670339,6105,118863,7393,0.04835413762514257,0.5477107719662172
5066,0.5107,7,7,7,670346,6098,118870,7386,0.04829869471549867,0.5477603085137941
5067,0.5108,2,10,2,670356,6088,118872,7384,0.04821949055886453,0.5480997624703088
5068,0.5109,9,11,9,670367,6077,118881,7375,0.04813236598656698,0.5482456140350878
5069,0.511,4,6,4,670373,6071,118885,7371,0.04808484349258649,0.5483558994197292
5070,0.5111,8,9,8,670382,6062,118893,7363,0.04801355975161577,0.5484543761638734
5071,0.5112,9,13,9,670395,6049,118902,7354,0.04791059434799138,0.5486831306423935
5072,0.5113,1,5,1,670400,6044,118903,7353,0.04787099226967431,0.5488542210942748
5073,0.5114,6,8,6,670408,6036,118909,7347,0.047807628944367,0.5489800493162968
5074,0.5115,10,7,10,670415,6029,118919,7337,0.0477521860347231,0.5489301212030525
5075,0.5116,5,11,5,670426,6018,118924,7332,0.04766506146242555,0.5492134831460674
5076,0.5117,7,9,7,670435,6009,118931,7325,0.04759377772145482,0.5493475326233689
5077,0.5118,5,8,5,670443,6001,118936,7320,0.04753041439614751,0.549508295173035
5078,0.5119,3,2,3,670445,5999,118939,7317,0.04751457356482068,0.549489336136978
5079,0.512,4,6,4,670451,5993,118943,7313,0.0474670510708402,0.5496016834510747
5080,0.5121,7,6,7,670457,5987,118950,7306,0.047419528576859715,0.549612578048597
5081,0.5122,9,8,9,670465,5979,118959,7297,0.0473561652515524,0.5496384453148538
5082,0.5123,9,7,9,670472,5972,118968,7288,0.047300722341908505,0.5496229260935144
5083,0.5124,5,3,5,670475,5969,118973,7283,0.04727696109491826,0.5495774222758829
5084,0.5125,4,11,4,670486,5958,118977,7279,0.04718983652262071,0.5498980131449724
5085,0.5126,7,4,7,670490,5954,118984,7272,0.04715815485996705,0.5498261001058521
5086,0.5127,4,4,4,670494,5950,118988,7268,0.0471264731973134,0.5498562566197609
5087,0.5128,10,7,10,670501,5943,118998,7258,0.0470710302876695,0.5498068328156958
5088,0.5129,6,6,6,670507,5937,119004,7252,0.04702350779368901,0.5498521495185382
5089,0.513,5,5,5,670512,5932,119009,7247,0.04698390571537194,0.5498899764777297
5090,0.5131,3,8,3,670520,5924,119012,7244,0.04692054239006463,0.5501215066828675
5091,0.5132,4,7,4,670527,5917,119016,7240,0.04686509948042073,0.5502774188644828
5092,0.5133,6,5,6,670532,5912,119022,7234,0.046825497402103664,0.550281454434809
5093,0.5134,3,8,3,670540,5904,119025,7231,0.04676213407679635,0.550513894175866
5094,0.5135,4,10,4,670550,5894,119029,7227,0.04668292992016221,0.5507964331986891
5095,0.5136,8,7,8,670557,5887,119037,7219,0.04662748701051831,0.5508164199603235
5096,0.5137,11,9,11,670566,5878,119048,7208,0.04655620326954758,0.5508176677365123
5097,0.5138,5,6,5,670572,5872,119053,7203,0.0465086807755671,0.5508986615678776
5098,0.5139,10,7,10,670579,5865,119063,7193,0.0464532378659232,0.5508500536069842
5099,0.514,7,6,7,670585,5859,119070,7186,0.04640571537194272,0.5508623993867382
5100,0.5141,4,8,4,670593,5851,119074,7182,0.04634235204663541,0.5510626870252436
5101,0.5142,5,9,5,670602,5842,119079,7177,0.04627106830566468,0.5512712189876334
5102,0.5143,12,6,12,670608,5836,119091,7165,0.0462235458116842,0.5511114529651565
5103,0.5144,9,10,9,670618,5826,119100,7156,0.046144341655050054,0.5512247727622862
5104,0.5145,6,8,6,670626,5818,119106,7150,0.04608097832974274,0.5513571869216533
5105,0.5146,6,8,6,670634,5810,119112,7144,0.046017615004435436,0.5514898872935001
5106,0.5147,7,8,7,670642,5802,119119,7137,0.04595425167912812,0.5515882216554603
5107,0.5148,0,8,0,670650,5794,119119,7137,0.04589088835382081,0.5519294718119249
5108,0.5149,10,8,10,670658,5786,119129,7127,0.0458275250285135,0.5519244172539302
5109,0.515,10,13,10,670671,5773,119139,7117,0.04572455962488912,0.552133436772692
5110,0.5151,5,4,5,670675,5769,119144,7112,0.04569287796223546,0.5521310457262635
5111,0.5152,6,10,6,670685,5759,119150,7106,0.045613673805601315,0.55235134084726
5112,0.5153,8,8,8,670693,5751,119158,7098,0.045550310480294,0.5524165304692972
5113,0.5154,7,10,7,670703,5741,119165,7091,0.04547110632365987,0.5526028678304239
5114,0.5155,5,6,5,670709,5735,119170,7086,0.045423583829679384,0.55268699789408
5115,0.5156,4,4,4,670713,5731,119174,7082,0.045391902167025724,0.5527198938578006
5116,0.5157,11,4,11,670717,5727,119185,7071,0.04536022050437207,0.5525082044069386
5117,0.5158,8,8,8,670725,5719,119193,7063,0.04529685717906476,0.5525739320920043
5118,0.5159,8,6,8,670731,5713,119201,7055,0.045249334685084276,0.5525532581453634
5119,0.516,8,7,8,670738,5706,119209,7047,0.04519389177544038,0.55257586450247
5120,0.5161,12,6,12,670744,5700,119221,7035,0.04514636928145989,0.552414605418139
5121,0.5162,5,11,5,670755,5689,119226,7030,0.04505924470916234,0.5527164085226826
5122,0.5163,9,6,9,670761,5683,119235,7021,0.045011722215181856,0.5526605793450882
5123,0.5164,3,9,3,670770,5674,119238,7018,0.04494043847421113,0.5529467381027419
5124,0.5165,9,4,9,670774,5670,119247,7009,0.04490875681155747,0.5528038488839814
5125,0.5166,7,9,7,670783,5661,119254,7002,0.04483747307058675,0.5529495380241649
5126,0.5167,7,6,7,670789,5655,119261,6995,0.04478995057660626,0.5529644268774704
5127,0.5168,9,5,9,670794,5650,119270,6986,0.04475034849828919,0.5528648306426084
5128,0.5169,5,2,5,670796,5648,119275,6981,0.04473450766696236,0.55277535830232
5129,0.517,12,11,12,670807,5637,119287,6969,0.04464738309466481,0.5528319847691575
5130,0.5171,6,4,6,670811,5633,119293,6963,0.04461570143201115,0.552794537948555
5131,0.5172,6,7,6,670818,5626,119299,6957,0.04456025852236725,0.552888818246841
5132,0.5173,6,5,6,670823,5621,119305,6951,0.044520656444050184,0.5528953229398663
5133,0.5174,7,2,7,670825,5619,119312,6944,0.044504815612723354,0.552734219533551
5134,0.5175,7,8,7,670833,5611,119319,6937,0.04444145228741604,0.5528371055148231
5135,0.5176,8,7,8,670840,5604,119327,6929,0.044386009377772144,0.5528604484161813
5136,0.5177,8,6,8,670846,5598,119335,6921,0.04433848688379166,0.5528396836808052
5137,0.5178,8,8,8,670854,5590,119343,6913,0.04427512355848435,0.5529073022474607
5138,0.5179,2,15,2,670869,5575,119345,6911,0.04415631732353314,0.5534999199102996
5139,0.518,3,4,3,670873,5571,119348,6908,0.044124635660879485,0.5535699975959613
5140,0.5181,3,9,3,670882,5562,119351,6905,0.04405335191990876,0.5538621961979626
5141,0.5182,7,5,7,670887,5557,119358,6898,0.04401374984159169,0.5538338016860699
5142,0.5183,10,8,10,670895,5549,119368,6888,0.04395038651628438,0.553831309801399
5143,0.5184,7,8,7,670903,5541,119375,6881,0.043887023190977065,0.5539365641603606
5144,0.5185,7,5,7,670908,5536,119382,6874,0.04384742111265999,0.5539081385979049
5145,0.5186,11,5,11,670913,5531,119393,6863,0.04380781903434292,0.5537356785541391
5146,0.5187,7,5,7,670918,5526,119400,6856,0.043768216956025854,0.5537069940235826
5147,0.5188,6,6,6,670924,5520,119406,6850,0.043720694462045365,0.5537590945836701
5148,0.5189,8,8,8,670932,5512,119414,6842,0.04365733113673806,0.5538287194430953
5149,0.519,8,6,8,670938,5506,119422,6834,0.04360980864275757,0.5538087520259319
5150,0.5191,7,5,7,670943,5501,119429,6827,0.0435702065644405,0.5537800129785854
5151,0.5192,8,8,8,670951,5493,119437,6819,0.04350684323913319,0.553849902534113
5152,0.5193,5,13,5,670964,5480,119442,6814,0.04340387783550881,0.5542541076948104
5153,0.5194,10,6,10,670970,5474,119452,6804,0.043356355341528326,0.5541619156214367
5154,0.5195,7,7,7,670977,5467,119459,6797,0.04330091243188443,0.5542237442922374
5155,0.5196,6,11,6,670988,5456,119465,6791,0.04321378785958687,0.5545031436270107
5156,0.5197,2,4,2,670992,5452,119467,6789,0.04318210619693322,0.5546115513438444
5157,0.5198,5,5,5,670997,5447,119472,6784,0.04314250411861614,0.5546562014553185
5158,0.5199,4,3,4,671000,5444,119476,6780,0.043118742871625905,0.5546465968586387
5159,0.52,4,8,4,671008,5436,119480,6776,0.04305537954631859,0.5548640681297085
5160,0.5201,5,5,5,671013,5431,119485,6771,0.04301577746800152,0.5549090313063432
5161,0.5202,3,6,3,671019,5425,119488,6768,0.042968254974021035,0.5550725826293775
5162,0.5203,11,8,11,671027,5417,119499,6757,0.04290489164871372,0.5550353211762773
5163,0.5204,4,3,4,671030,5414,119503,6753,0.042881130401723484,0.555025889701652
5164,0.5205,5,3,5,671033,5411,119508,6748,0.04285736915473324,0.5549798503166379
5165,0.5206,10,7,10,671040,5404,119518,6738,0.04280192624508934,0.5549332894086642
5166,0.5207,10,3,10,671043,5401,119528,6728,0.0427781649980991,0.5547036029351142
5167,0.5208,6,8,6,671051,5393,119534,6722,0.04271480167279179,0.5548493602971523
5168,0.5209,7,6,7,671057,5387,119541,6715,0.0426672791788113,0.554866964138159
5169,0.521,13,4,13,671061,5383,119554,6702,0.04263559751615765,0.5545717832023169
5170,0.5211,7,7,7,671068,5376,119561,6695,0.04258015460651375,0.5546350758015077
5171,0.5212,7,11,7,671079,5365,119568,6688,0.04249303003421619,0.5548826018418651
5172,0.5213,9,5,9,671084,5360,119577,6679,0.042453427955899126,0.5547802973668909
5173,0.5214,9,11,9,671095,5349,119586,6670,0.04236630338360157,0.5549546551293785
5174,0.5215,10,17,10,671112,5332,119596,6660,0.042231656317323535,0.5553702468312208
5175,0.5216,13,8,13,671120,5324,119609,6647,0.04216829299201622,0.5552585414752318
5176,0.5217,4,6,4,671126,5318,119613,6643,0.04212077049803574,0.5553883454560655
5177,0.5218,6,6,6,671132,5312,119619,6637,0.04207324800405525,0.5554439702067119
5178,0.5219,6,5,6,671137,5307,119625,6631,0.04203364592573818,0.5554531747361368
5179,0.522,4,9,4,671146,5298,119629,6627,0.041962362184767454,0.5557232704402516
5180,0.5221,4,4,4,671150,5294,119633,6623,0.0419306805221138,0.5557606780229923
5181,0.5222,5,8,5,671158,5286,119638,6618,0.04186731719680649,0.5559475806451613
5182,0.5223,6,7,6,671165,5279,119644,6612,0.04181187428716259,0.5560507947186948
5183,0.5224,6,5,6,671170,5274,119650,6606,0.04177227220884552,0.556060606060606
5184,0.5225,4,3,4,671173,5271,119654,6602,0.04174851096185528,0.5560515455234566
5185,0.5226,4,6,4,671179,5265,119658,6598,0.041700988467874796,0.5561830902807047
5186,0.5227,5,8,5,671187,5257,119663,6593,0.04163762514256748,0.5563713080168776
5187,0.5228,11,6,11,671193,5251,119674,6582,0.041590102648587,0.5562410208738274
5188,0.5229,13,6,13,671199,5245,119687,6569,0.04154258015460651,0.5560352124597935
5189,0.523,4,11,4,671210,5234,119691,6565,0.04145545558230896,0.556403085007204
5190,0.5231,4,7,4,671217,5227,119695,6561,0.04140001267266506,0.5565829657278588
5191,0.5232,7,7,7,671224,5220,119702,6554,0.041344569763021165,0.5566502463054187
5192,0.5233,4,7,4,671231,5213,119706,6550,0.04128912685337727,0.5568307404573664
5193,0.5234,8,11,8,671242,5202,119714,6542,0.04120200228107971,0.5570504087193461
5194,0.5235,9,8,9,671250,5194,119723,6533,0.0411386389557724,0.5570904749722861
5195,0.5236,4,7,4,671257,5187,119727,6529,0.0410831960461285,0.5572721065209969
5196,0.5237,6,1,6,671258,5186,119733,6523,0.041075275630465084,0.557092834571697
5197,0.5238,6,5,6,671263,5181,119739,6517,0.041035673552148016,0.5571037784236622
5198,0.5239,8,5,8,671268,5176,119747,6509,0.04099607147383095,0.5570389388104408
5199,0.524,7,6,7,671274,5170,119754,6502,0.040948548979850466,0.5570596298834818
5200,0.5241,9,0,9,671274,5170,119763,6493,0.040948548979850466,0.5567178256023322
5201,0.5242,2,3,2,671277,5167,119765,6491,0.04092478773286022,0.5567850403156631
5202,0.5243,8,4,8,671281,5163,119773,6483,0.04089310607020656,0.5566718186501803
5203,0.5244,4,6,4,671287,5157,119777,6479,0.04084558357622608,0.5568064627019594
5204,0.5245,4,10,4,671297,5147,119781,6475,0.04076637941959194,0.5571330235759766
5205,0.5246,6,9,6,671306,5138,119787,6469,0.040695095678621215,0.557336090290342
5206,0.5247,5,11,5,671317,5127,119792,6464,0.04060797110632366,0.5576740574583728
5207,0.5248,5,7,5,671324,5120,119797,6459,0.04055252819667976,0.5578201917264013
5208,0.5249,5,5,5,671329,5115,119802,6454,0.04051292611836269,0.557870170282652
5209,0.525,2,6,2,671335,5109,119804,6452,0.04046540362438221,0.558083210794914
5210,0.5251,3,5,3,671340,5104,119807,6449,0.040425801546065135,0.5582099887475115
5211,0.5252,5,6,5,671346,5098,119812,6444,0.04037827905208465,0.5583087853058395
5212,0.5253,8,9,8,671355,5089,119820,6436,0.040306995311113925,0.5584381778741866
5213,0.5254,7,8,7,671363,5081,119827,6429,0.04024363198580661,0.5585577758470894
5214,0.5255,8,5,8,671368,5076,119835,6421,0.040204029907489544,0.5584935200487083
5215,0.5256,4,8,4,671376,5068,119839,6417,0.04014066658218223,0.5587287766652155
5216,0.5257,5,5,5,671381,5063,119844,6412,0.040101064503865164,0.5587799564270153
5217,0.5258,11,5,11,671386,5058,119855,6401,0.040061462425548096,0.5586002268958897
5218,0.5259,6,4,6,671390,5054,119861,6395,0.040029780762894436,0.5585640667307188
5219,0.526,10,10,10,671400,5044,119871,6385,0.039950576606260293,0.5586665500043748
5220,0.5261,8,11,8,671411,5033,119879,6377,0.03986345203396274,0.5588957055214724
5221,0.5262,8,11,8,671422,5022,119887,6369,0.039776327461665185,0.559125625493811
5222,0.5263,9,8,9,671430,5014,119896,6360,0.03971296413635787,0.5591700369263232
5223,0.5264,4,2,4,671432,5012,119900,6356,0.03969712330503105,0.5591133004926109
5224,0.5265,9,4,9,671436,5008,119909,6347,0.03966544164237739,0.5589608102157639
5225,0.5266,4,6,4,671442,5002,119913,6343,0.03961791914839691,0.5591009255178493
5226,0.5267,6,6,6,671448,4996,119919,6337,0.039570396654416425,0.5591635048089649
5227,0.5268,7,6,7,671454,4990,119926,6330,0.03952287416043594,0.5591872791519434
5228,0.5269,7,8,7,671462,4982,119933,6323,0.03945951083512863,0.5593100398053958
5229,0.527,7,5,7,671467,4977,119940,6316,0.039419908756811554,0.5592845125298858
5230,0.5271,5,2,5,671469,4975,119945,6311,0.03940406792548473,0.5591883749778487
5231,0.5272,9,13,9,671482,4962,119954,6302,0.039301102521860344,0.5594815340909091
5232,0.5273,7,8,7,671490,4954,119961,6295,0.03923773919655304,0.5596052982487332
5233,0.5274,3,2,3,671492,4952,119964,6292,0.03922189836522621,0.559587335467805
5234,0.5275,12,8,12,671500,4944,119976,6280,0.039158535039918896,0.5595153243050606
5235,0.5276,5,7,5,671507,4937,119981,6275,0.039103092130275,0.5596682126293258
5236,0.5277,8,6,8,671513,4931,119989,6267,0.039055569636294515,0.5596535095552777
5237,0.5278,8,6,8,671519,4925,119997,6259,0.039008047142314026,0.5596387696709585
5238,0.5279,4,8,4,671527,4917,120001,6255,0.03894468381700671,0.5598818474758325
5239,0.528,4,4,4,671531,4913,120005,6251,0.03891300215435306,0.5599247581512002
5240,0.5281,5,9,5,671540,4904,120010,6246,0.03884171841338233,0.5601793721973094
5241,0.5282,5,8,5,671548,4896,120015,6241,0.03877835508807502,0.560384304570351
5242,0.5283,6,3,6,671551,4893,120021,6235,0.03875459384108478,0.5602983465132998
5243,0.5284,7,14,7,671565,4879,120028,6228,0.03864370802179699,0.5607274691635905
5244,0.5285,3,6,3,671571,4873,120031,6225,0.0385961855278165,0.5609118760136962
5245,0.5286,9,8,9,671579,4865,120040,6216,0.038532822202509184,0.5609602021478206
5246,0.5287,8,7,8,671586,4858,120048,6208,0.03847737929286529,0.5609976504608711
5247,0.5288,9,3,9,671589,4855,120057,6199,0.03845361804587505,0.5607924733128279
5248,0.5289,7,8,7,671597,4847,120064,6192,0.038390254720567736,0.5609203732222121
5249,0.529,5,7,5,671604,4840,120069,6187,0.03833481181092384,0.5610773555817539
5250,0.5291,5,7,5,671611,4833,120074,6182,0.03827936890127994,0.561234679981843
5251,0.5292,5,5,5,671616,4828,120079,6177,0.038239766822962866,0.5612903225806452
5252,0.5293,4,11,4,671627,4817,120083,6173,0.038152642250665315,0.5616924476797088
5253,0.5294,9,3,9,671630,4814,120092,6164,0.03812888100367507,0.5614866095828019
5254,0.5295,7,7,7,671637,4807,120099,6157,0.03807343809403117,0.5615651222181686
5255,0.5296,7,7,7,671644,4800,120106,6150,0.038017995184387275,0.5616438356164384
5256,0.5297,6,5,6,671649,4795,120112,6144,0.03797839310607021,0.5616601151842033
5257,0.5298,1,8,1,671657,4787,120113,6143,0.037915029780762895,0.5620311070448307
5258,0.5299,12,7,12,671664,4780,120125,6131,0.037859586871119,0.5619099990834937
5259,0.53,10,3,10,671667,4777,120135,6121,0.03783582562412875,0.5616626904019086
5260,0.5301,4,10,4,671677,4767,120139,6117,0.03775662146749462,0.5620176405733186
5261,0.5302,3,2,3,671679,4765,120142,6114,0.03774078063616779,0.5620001838404265
5262,0.5303,10,1,10,671680,4764,120152,6104,0.03773286022050437,0.5616488774383511
5263,0.5304,3,10,3,671690,4754,120155,6101,0.03765365606387023,0.5620451404882543
5264,0.5305,5,6,5,671696,4748,120160,6096,0.037606133569889746,0.5621541866469937
5265,0.5306,6,4,6,671700,4744,120166,6090,0.037574451907236094,0.5621192541997415
5266,0.5307,7,10,7,671710,4734,120173,6083,0.03749524775060195,0.5623555514467967
5267,0.5308,3,4,3,671714,4730,120176,6080,0.0374635660879483,0.5624421831637373
5268,0.5309,2,3,2,671717,4727,120178,6078,0.03743980484095805,0.562517353077279
5269,0.531,8,3,8,671720,4724,120186,6070,0.03741604359396781,0.5623494534000371
5270,0.5311,2,1,2,671721,4723,120188,6068,0.0374081231783044,0.5623204522287091
5271,0.5312,4,3,4,671724,4720,120192,6064,0.037384361931314156,0.5623145400593472
5272,0.5313,6,6,6,671730,4714,120198,6058,0.03733683943733367,0.5623839584106944
5273,0.5314,9,7,9,671737,4707,120207,6049,0.037281396527689775,0.5623837857939754
5274,0.5315,9,3,9,671740,4704,120216,6040,0.03725763528069953,0.5621742367833209
5275,0.5316,4,2,4,671742,4702,120220,6036,0.0372417944493727,0.5621158502514435
5276,0.5317,8,5,8,671747,4697,120228,6028,0.03720219237105563,0.5620512820512821
5277,0.5318,5,3,5,671750,4694,120233,6023,0.03717843112406539,0.5620042922459644
5278,0.5319,7,6,7,671756,4688,120240,6016,0.037130908630084905,0.5620328849028401
5279,0.532,5,10,5,671766,4678,120245,6011,0.03705170447345077,0.5623538216858452
5280,0.5321,5,7,5,671773,4671,120250,6006,0.03699626156380687,0.5625175611126721
5281,0.5322,4,1,4,671774,4670,120254,6002,0.03698834114814346,0.5624062968515742
5282,0.5323,4,7,4,671781,4663,120258,5998,0.03693289823849956,0.5626113872995029
5283,0.5324,7,4,7,671785,4659,120265,5991,0.0369012165758459,0.5625352112676056
5284,0.5325,7,6,7,671791,4653,120272,5984,0.03685369408186542,0.562564632885212
5285,0.5326,9,8,9,671799,4645,120281,5975,0.036790330756558104,0.562617702448211
5286,0.5327,8,5,8,671804,4640,120289,5967,0.036750728678241036,0.5625530310172527
5287,0.5328,5,5,5,671809,4635,120294,5962,0.03671112659992396,0.5626120600169859
5288,0.5329,6,8,6,671817,4627,120300,5956,0.03664776327461665,0.5627893791930455
5289,0.533,6,7,6,671824,4620,120306,5950,0.03659232036497275,0.5629139072847682
5290,0.5331,8,4,8,671828,4616,120314,5942,0.0365606387023191,0.5627959840878954
5291,0.5332,8,6,8,671834,4610,120322,5934,0.036513116208338615,0.5627845220030349
5292,0.5333,3,7,3,671841,4603,120325,5931,0.03645767329869472,0.5630339851908107
5293,0.5334,6,6,6,671847,4597,120331,5925,0.03641015080471423,0.5631058734080974
5294,0.5335,9,5,9,671852,4592,120340,5916,0.03637054872639716,0.5629996193376475
5295,0.5336,11,6,11,671858,4586,120351,5905,0.03632302623241668,0.5628634067295777
5296,0.5337,9,5,9,671863,4581,120360,5896,0.03628342415409961,0.5627565142693519
5297,0.5338,6,7,6,671870,4574,120366,5890,0.03622798124445571,0.5628822629969419
5298,0.5339,4,13,4,671883,4561,120370,5886,0.036125015840831325,0.5634153345458026
5299,0.534,5,5,5,671888,4556,120375,5881,0.03608541376251426,0.5634760946632174
5300,0.5341,4,6,4,671894,4550,120379,5877,0.036037891268533774,0.5636328761868227
5301,0.5342,4,5,4,671899,4545,120383,5873,0.0359982891902167,0.563735841812248
5302,0.5343,4,8,4,671907,4537,120387,5869,0.035934925864909394,0.5640015375744762
5303,0.5344,5,3,5,671910,4534,120392,5864,0.03591116461791915,0.563954606655126
5304,0.5345,2,3,2,671913,4531,120394,5862,0.035887403370928904,0.5640334840758202
5305,0.5346,2,8,2,671921,4523,120396,5860,0.03582404004562159,0.564384089376866
5306,0.5347,9,2,9,671923,4521,120405,5851,0.03580819921429477,0.5641149247975318
5307,0.5348,2,5,2,671928,4516,120407,5849,0.035768597135977694,0.5643029425952726
5308,0.5349,4,8,4,671936,4508,120411,5845,0.03570523381067038,0.5645706558485463
5309,0.535,8,5,8,671941,4503,120419,5837,0.03566563173235331,0.5645067698259187
5310,0.5351,9,6,9,671947,4497,120428,5828,0.03561810923837283,0.5644552058111381
5311,0.5352,2,7,2,671954,4490,120430,5826,0.03556266632872893,0.5647537805350911
5312,0.5353,6,9,6,671963,4481,120436,5820,0.035491382587758205,0.5649936899330162
5313,0.5354,3,4,3,671967,4477,120439,5817,0.03545970092510455,0.56508645813095
5314,0.5355,7,4,7,671971,4473,120446,5810,0.03542801926245089,0.5650102110279102
5315,0.5356,5,5,5,671976,4468,120451,5805,0.035388417184133825,0.5650734936240631
5316,0.5357,6,3,6,671979,4465,120457,5799,0.03536465593714358,0.5649844115354637
5317,0.5358,6,7,6,671986,4458,120463,5793,0.03530921302749968,0.5651155984781973
5318,0.5359,8,7,8,671993,4451,120471,5785,0.035253770117855784,0.5651621727237202
5319,0.536,10,6,10,671999,4445,120481,5775,0.0352062476238753,0.565068493150685
5320,0.5361,4,6,4,672005,4439,120485,5771,0.03515872512989482,0.565230166503428
5321,0.5362,4,8,4,672013,4431,120489,5767,0.035095361804587506,0.5655030398117278
5322,0.5363,7,4,7,672017,4427,120496,5760,0.035063680141933846,0.565426524001178
5323,0.5364,6,7,6,672024,4420,120502,5754,0.03500823723228995,0.5655592687241989
5324,0.5365,5,4,5,672028,4416,120507,5749,0.034976555569636296,0.5655681259222823
5325,0.5366,6,6,6,672034,4410,120513,5743,0.03492903307565581,0.5656456219836502
5326,0.5367,7,7,7,672041,4403,120520,5736,0.034873590166011915,0.5657362659039353
5327,0.5368,8,4,8,672045,4399,120528,5728,0.034841908503358256,0.5656166683124321
5328,0.5369,4,5,4,672050,4394,120532,5724,0.03480230642504119,0.5657244514726231
5329,0.537,0,6,0,672056,4388,120532,5724,0.034754783931060705,0.5660601265822784
5330,0.5371,3,2,3,672058,4386,120535,5721,0.034738943099733875,0.5660433363015732
5331,0.5372,3,5,3,672063,4381,120538,5718,0.0346993410214168,0.5661946727398752
5332,0.5373,7,9,7,672072,4372,120545,5711,0.03462805728044608,0.5663988892194783
5333,0.5374,7,8,7,672080,4364,120552,5704,0.03456469395513877,0.5665474771553437
5334,0.5375,8,5,8,672085,4359,120560,5696,0.03452509187682169,0.5664843361511686
5335,0.5376,11,3,11,672088,4356,120571,5685,0.034501330629831455,0.5661786674634001
5336,0.5377,3,7,3,672095,4349,120574,5682,0.03444588772018756,0.5664440235270661
5337,0.5378,4,2,4,672097,4347,120578,5678,0.03443004688886073,0.5663840399002493
5338,0.5379,4,4,4,672101,4343,120582,5674,0.034398365226207074,0.5664370570030948
5339,0.538,5,3,5,672104,4340,120587,5669,0.03437460397921683,0.5663902487761016
5340,0.5381,8,4,8,672108,4336,120595,5661,0.034342922316563176,0.5662698809642893
5341,0.5382,7,4,7,672112,4332,120602,5654,0.03431124065390952,0.5661926697376327
5342,0.5383,7,7,7,672119,4325,120609,5647,0.03425579774426562,0.5662855996791015
5343,0.5384,7,6,7,672125,4319,120616,5640,0.034208275250285136,0.5663219198714731
5344,0.5385,5,12,5,672137,4307,120621,5635,0.034113230262324164,0.5667873667270167
5345,0.5386,8,5,8,672142,4302,120629,5627,0.034073628184007096,0.56672373854366
5346,0.5387,7,5,7,672147,4297,120636,5620,0.03403402610569003,0.5667036402137743
5347,0.5388,2,3,2,672150,4294,120638,5618,0.03401026485869978,0.5667877320419693
5348,0.5389,6,7,6,672157,4287,120644,5612,0.033954821949055886,0.5669259521163754
5349,0.539,6,5,6,672162,4282,120650,5606,0.03391521987073882,0.5669498381877023
5350,0.5391,2,5,2,672167,4277,120652,5604,0.03387561779242174,0.5671490739803664
5351,0.5392,5,3,5,672170,4274,120657,5599,0.033851856545431505,0.5671021979135015
5352,0.5393,4,7,4,672177,4267,120661,5595,0.03379641363578761,0.5673291421618333
5353,0.5394,9,5,9,672182,4262,120670,5586,0.03375681155747053,0.5672217709179529
5354,0.5395,5,12,5,672194,4250,120675,5581,0.03366176656950957,0.5676940290916489
5355,0.5396,5,8,5,672202,4242,120680,5576,0.033598403244202255,0.567936443267468
5356,0.5397,5,8,5,672210,4234,120685,5571,0.03353503991889494,0.568179500254972
5357,0.5398,9,2,9,672212,4232,120694,5562,0.03351919908756812,0.56789871349806
5358,0.5399,6,4,6,672216,4228,120700,5556,0.03348751742491446,0.5678659035159443
5359,0.54,7,6,7,672222,4222,120707,5549,0.033439994930933976,0.5679050250741992
5360,0.5401,4,4,4,672226,4218,120711,5545,0.03340831326828032,0.5679606678275121
5361,0.5402,8,10,8,672236,4208,120719,5537,0.03332910911164618,0.5681888147768086
5362,0.5403,6,8,6,672244,4200,120725,5531,0.03326574578633887,0.5683896824581235
5363,0.5404,9,4,9,672248,4196,120734,5522,0.03323406412368521,0.5682239143856761
5364,0.5405,7,3,7,672251,4193,120741,5515,0.03321030287669497,0.5680881747012773
5365,0.5406,10,4,10,672255,4189,120751,5505,0.03317862121404131,0.5678770373426862
5366,0.5407,8,2,8,672257,4187,120759,5497,0.03316278038271449,0.5676373399421727
5367,0.5408,4,3,4,672260,4184,120763,5493,0.03313901913572424,0.567634597499225
5368,0.5409,4,3,4,672263,4181,120767,5489,0.033115257888734,0.5676318510858325
5369,0.541,5,5,5,672268,4176,120772,5484,0.03307565581041693,0.5677018633540373
5370,0.5411,6,2,6,672270,4174,120778,5478,0.0330598149790901,0.5675507666804808
5371,0.5412,7,6,7,672276,4168,120785,5471,0.03301229248510962,0.567589998962548
5372,0.5413,8,6,8,672282,4162,120793,5463,0.032964769991129135,0.5675844155844156
5373,0.5414,6,7,6,672289,4155,120799,5457,0.03290932708148524,0.5677278401997503
5374,0.5415,6,6,6,672295,4149,120805,5451,0.032861804587504755,0.5678125
5375,0.5416,7,8,7,672303,4141,120812,5444,0.03279844126219744,0.5679707876890976
5376,0.5417,4,8,4,672311,4133,120816,5440,0.03273507793689013,0.5682649117309099
5377,0.5418,6,7,6,672318,4126,120822,5434,0.03267963502724623,0.5684100418410042
5378,0.5419,9,7,9,672325,4119,120831,5425,0.032624192117602334,0.5684199497066219
5379,0.542,5,6,5,672331,4113,120836,5420,0.032576669623621844,0.568551347949229
5380,0.5421,0,4,0,672335,4109,120836,5420,0.03254498796096819,0.5687900094448526
5381,0.5422,5,7,5,672342,4102,120841,5415,0.032489545051324294,0.568981822002732
5382,0.5423,2,5,2,672347,4097,120843,5413,0.032449942973007226,0.5691903259726604
5383,0.5424,3,1,3,672348,4096,120846,5410,0.03244202255734381,0.5691142436355986
5384,0.5425,5,5,5,672353,4091,120851,5405,0.032402420479026736,0.5691870261162595
5385,0.5426,7,5,7,672358,4086,120858,5398,0.03236281840070967,0.5691691269506537
5386,0.5427,5,5,5,672363,4081,120863,5393,0.0323232163223926,0.569242136373232
5387,0.5428,10,3,10,672366,4078,120873,5383,0.032299455075402356,0.5689673396046929
5388,0.5429,6,6,6,672372,4072,120879,5377,0.03225193258142187,0.5690549264472431
5389,0.543,4,4,4,672376,4068,120883,5373,0.03222025091876822,0.5691134413727359
5390,0.5431,7,6,7,672382,4062,120890,5366,0.03217272842478773,0.5691557064064489
5391,0.5432,6,3,6,672385,4059,120896,5360,0.03214896717779749,0.5690625331776197
5392,0.5433,3,6,3,672391,4053,120899,5357,0.03210144468381701,0.5692879914984059
5393,0.5434,5,4,5,672395,4049,120904,5352,0.03206976302116335,0.5693011381767897
5394,0.5435,5,2,5,672397,4047,120909,5347,0.03205392218983652,0.5691931019799872
5395,0.5436,5,6,5,672403,4041,120914,5342,0.03200639969585604,0.5693275071938613
5396,0.5437,2,5,2,672408,4036,120916,5340,0.03196679761753897,0.5695392491467577
5397,0.5438,1,7,1,672415,4029,120917,5339,0.03191135470789507,0.5699188727583262
5398,0.5439,4,5,4,672420,4024,120921,5335,0.031871752629578,0.5700395341382626
5399,0.544,3,4,3,672424,4020,120924,5332,0.031840070966924344,0.5701454234388366
5400,0.5441,3,4,3,672428,4016,120927,5329,0.03180838930427069,0.5702514713750669
5401,0.5442,6,2,6,672430,4014,120933,5323,0.03179254847294386,0.5700974617114705
5402,0.5443,6,5,6,672435,4009,120939,5317,0.03175294639462679,0.570126527986275
5403,0.5444,8,7,8,672442,4002,120947,5309,0.03169750348498289,0.5701858017398775
5404,0.5445,8,2,8,672444,4000,120955,5301,0.031681662653656066,0.569938716267068
5405,0.5446,5,7,5,672451,3993,120960,5296,0.03162621974401217,0.5701367208526213
5406,0.5447,3,10,3,672461,3983,120963,5293,0.031547015587378026,0.570612332902113
5407,0.5448,3,4,3,672465,3979,120966,5290,0.031515333924724366,0.5707196029776674
5408,0.5449,8,4,8,672469,3975,120974,5282,0.03148365226207071,0.5705952252349573
5409,0.545,7,2,7,672471,3973,120981,5275,0.03146781143074388,0.570393598615917
5410,0.5451,1,4,1,672475,3969,120982,5274,0.03143612976809023,0.5705939629990263
5411,0.5452,4,5,4,672480,3964,120986,5270,0.03139652768977316,0.5707169157461555
5412,0.5453,5,6,5,672486,3958,120991,5265,0.03134900519579267,0.5708554700206007
5413,0.5454,2,11,2,672497,3947,120993,5263,0.03126188062349512,0.5714440825190011
5414,0.5455,8,3,8,672500,3944,121001,5255,0.031238119376504878,0.5712577454071095
5415,0.5456,6,12,6,672512,3932,121007,5249,0.031143074388543912,0.5717242130486875
5416,0.5457,8,5,8,672517,3927,121015,5241,0.03110347231022684,0.5716623036649214
5417,0.5458,10,6,10,672523,3921,121025,5231,0.031055949816246358,0.5715690559440559
5418,0.5459,4,5,4,672528,3916,121029,5227,0.031016347737929287,0.5716941922782457
5419,0.546,2,4,2,672532,3912,121031,5225,0.03098466607527563,0.5718507168654919
5420,0.5461,6,6,6,672538,3906,121037,5219,0.030937143581295148,0.571945205479452
5421,0.5462,1,5,1,672543,3901,121038,5218,0.030897541502978076,0.5722118653361115
5422,0.5463,10,0,10,672543,3901,121048,5208,0.030897541502978076,0.5717422329564167
5423,0.5464,6,6,6,672549,3895,121054,5202,0.030850019008997594,0.5718368692975706
5424,0.5465,7,3,7,672552,3892,121061,5195,0.03082625776200735,0.5716958292065588
5425,0.5466,9,2,9,672554,3890,121070,5186,0.030810416930680522,0.5713970912296166
5426,0.5467,9,1,9,672555,3889,121079,5177,0.030802496515017107,0.571034634899625
5427,0.5468,4,4,4,672559,3885,121083,5173,0.03077081485236345,0.5710973724884081
5428,0.5469,5,4,5,672563,3881,121088,5168,0.030739133189709795,0.5711128301469776
5429,0.547,4,4,4,672567,3877,121092,5164,0.03070745152705614,0.5711757548943701
5430,0.5471,6,6,6,672573,3871,121098,5158,0.030659929033075656,0.5712703510909293
5431,0.5472,6,8,6,672581,3863,121104,5152,0.030596565707768343,0.5714919578480311
5432,0.5473,6,6,6,672587,3857,121110,5146,0.03054904321378786,0.5715872486948795
5433,0.5474,6,2,6,672589,3855,121116,5140,0.03053320238246103,0.5714285714285714
5434,0.5475,6,4,6,672593,3851,121122,5134,0.030501520719807374,0.5713967723984419
5435,0.5476,3,1,3,672594,3850,121125,5131,0.030493600304143963,0.5713172252533125
5436,0.5477,3,7,3,672601,3843,121128,5128,0.030438157394500065,0.5716196633597146
5437,0.5478,6,5,6,672606,3838,121134,5122,0.030398555316182994,0.5716517857142858
5438,0.5479,4,6,4,672612,3832,121138,5118,0.030351032822202507,0.5718435754189944
5439,0.548,7,8,7,672620,3824,121145,5111,0.0302876694968952,0.5720201454952434
5440,0.5481,11,6,11,672626,3818,121156,5100,0.030240147002914712,0.5718771024893474
5441,0.5482,5,8,5,672634,3810,121161,5095,0.0301767836776074,0.5721504772599663
5442,0.5483,4,9,4,672643,3801,121165,5091,0.030105499936636675,0.5725371120107963
5443,0.5484,5,6,5,672649,3795,121170,5086,0.03005797744265619,0.5726832563900461
5444,0.5485,2,4,2,672653,3791,121172,5084,0.030026295780002536,0.5728450704225352
5445,0.5486,10,6,10,672659,3785,121182,5074,0.02997877328602205,0.5727508748165707
5446,0.5487,7,4,7,672663,3781,121189,5067,0.029947091623368394,0.5726717902350814
5447,0.5488,4,5,4,672668,3776,121193,5063,0.029907489545051326,0.5728023532073764
5448,0.5489,4,3,4,672671,3773,121197,5059,0.02988372829806108,0.5728034420289855
5449,0.549,3,4,3,672675,3769,121200,5056,0.029852046635407425,0.5729178470254958
5450,0.5491,8,1,8,672676,3768,121208,5048,0.029844126219744013,0.5725952813067151
5451,0.5492,6,8,6,672684,3760,121214,5042,0.0297807628944367,0.5728243581004318
5452,0.5493,9,3,9,672687,3757,121223,5033,0.02975700164744646,0.5725824800910125
5453,0.5494,1,9,1,672696,3748,121224,5032,0.02968571790647573,0.5731207289293849
5454,0.5495,7,2,7,672698,3746,121231,5025,0.029669877075148905,0.5729107285372249
5455,0.5496,4,4,4,672702,3742,121235,5021,0.02963819541249525,0.572977290882118
5456,0.5497,6,4,6,672706,3738,121241,5015,0.029606513749841593,0.5729464183708443
5457,0.5498,8,1,8,672707,3737,121249,5007,0.029598593334178178,0.5726212259835316
5458,0.5499,4,8,4,672715,3729,121253,5003,0.029535230008870865,0.5729500687127805
5459,0.55,1,1,1,672716,3728,121254,5002,0.02952730959320745,0.5729667812142039
5460,0.5501,7,1,7,672717,3727,121261,4995,0.02951938917754404,0.5726897500573263
5461,0.5502,3,6,3,672723,3721,121264,4992,0.029471866683563552,0.5729369907035464
5462,0.5503,3,4,3,672727,3717,121267,4989,0.029440185020909896,0.573053066850448
5463,0.5504,3,2,3,672729,3715,121270,4986,0.02942434418958307,0.5730375818871394
5464,0.5505,7,6,7,672735,3709,121277,4979,0.029376821695602587,0.5730893186003683
5465,0.5506,5,2,5,672737,3707,121282,4974,0.029360980864275757,0.5729754636562608
5466,0.5507,6,4,6,672741,3703,121288,4968,0.0293292992016221,0.5729442970822282
5467,0.5508,4,4,4,672745,3699,121292,4964,0.029297617538968444,0.5730116587787141
5468,0.5509,6,7,6,672752,3692,121298,4958,0.029242174629324547,0.5731791907514451
5469,0.551,4,3,4,672755,3689,121302,4954,0.029218413382334305,0.5731806085849821
5470,0.5511,6,4,6,672759,3685,121308,4948,0.02918673171968065,0.5731495424533766
5471,0.5512,7,3,7,672762,3682,121315,4941,0.029162970472690408,0.5730024353473269
5472,0.5513,6,6,6,672768,3676,121321,4935,0.02911544797870992,0.5731041690860528
5473,0.5514,9,2,9,672770,3674,121330,4926,0.029099607147383095,0.5727906976744186
5474,0.5515,3,8,3,672778,3666,121333,4923,0.029036243822075782,0.5731749912679008
5475,0.5516,6,2,6,672780,3664,121339,4917,0.029020402990748956,0.5730101386784757
5476,0.5517,5,5,5,672785,3659,121344,4912,0.028980800912431885,0.5730953214327383
5477,0.5518,6,2,6,672787,3657,121350,4906,0.028964960081105058,0.5729300478804158
5478,0.5519,4,6,4,672793,3651,121354,4902,0.028917437587124572,0.573132234303753
5479,0.552,2,2,2,672795,3649,121356,4900,0.028901596755797745,0.5731664522166335
5480,0.5521,6,9,6,672804,3640,121362,4894,0.028830313014827018,0.573470822591985
5481,0.5522,2,3,2,672807,3637,121364,4892,0.028806551767836776,0.5735725172939383
5482,0.5523,4,7,4,672814,3630,121368,4888,0.02875110885819288,0.5738436252641466
5483,0.5524,4,4,4,672818,3626,121372,4884,0.028719427195539222,0.5739130434782609
5484,0.5525,9,6,9,672824,3620,121381,4875,0.028671904701558736,0.5738669805768098
5485,0.5526,9,7,9,672831,3613,121390,4866,0.02861646179191484,0.573888430239415
5486,0.5527,9,4,9,672835,3609,121399,4857,0.028584780129261182,0.573706591070163
5487,0.5528,3,4,3,672839,3605,121402,4854,0.028553098466607526,0.5738266934625842
5488,0.5529,3,1,3,672840,3604,121405,4851,0.028545178050944114,0.5737433471318746
5489,0.553,4,2,4,672842,3602,121409,4847,0.028529337219617285,0.5736773582672505
5490,0.5531,4,2,4,672844,3600,121413,4843,0.028513496388290458,0.5736112756129338
5491,0.5532,6,4,6,672848,3596,121419,4837,0.028481814725636802,0.5735799833985533
5492,0.5533,4,1,4,672849,3595,121423,4833,0.028473894309973387,0.5734456573327005
5493,0.5534,3,7,3,672856,3588,121426,4830,0.02841845140032949,0.5737704918032787
5494,0.5535,7,11,7,672867,3577,121433,4823,0.028331326828031935,0.5741666666666667
5495,0.5536,10,4,10,672871,3573,121443,4813,0.02829964516537828,0.5739327450512759
5496,0.5537,6,5,6,672876,3568,121449,4807,0.028260043087061208,0.5739701492537314
5497,0.5538,5,6,5,672882,3562,121454,4802,0.028212520593080725,0.5741272118603539
5498,0.5539,3,7,3,672889,3555,121457,4799,0.028157077683436827,0.5744553507301892
5499,0.554,6,5,6,672894,3550,121463,4793,0.028117475605119756,0.5744935874385713
5500,0.5541,3,2,3,672896,3548,121466,4790,0.02810163477379293,0.5744782921563925
5501,0.5542,5,6,5,672902,3542,121471,4785,0.028054112279812443,0.5746367239101717
5502,0.5543,3,8,3,672910,3534,121474,4782,0.027990748954505134,0.575036075036075
5503,0.5544,5,5,5,672915,3529,121479,4777,0.027951146876188063,0.5751264146400192
5504,0.5545,6,3,6,672918,3526,121485,4771,0.02792738562919782,0.5750271182355068
5505,0.5546,8,5,8,672923,3521,121493,4763,0.02788778355088075,0.5749637856108161
5506,0.5547,5,6,5,672929,3515,121498,4758,0.027840261056900267,0.5751238970143842
5507,0.5548,4,7,4,672936,3508,121502,4754,0.02778481814725637,0.5754054708303075
5508,0.5549,5,2,5,672938,3506,121507,4749,0.02776897731592954,0.5752877044215627
5509,0.555,6,3,6,672941,3503,121513,4743,0.0277452160689393,0.575187969924812
5510,0.5551,5,4,5,672945,3499,121518,4738,0.027713534406285642,0.5752094209056695
5511,0.5552,3,8,3,672953,3491,121521,4735,0.02765017108097833,0.5756139071237539
5512,0.5553,8,12,8,672965,3479,121529,4727,0.02755512609301736,0.5760419205459419
5513,0.5554,5,3,5,672968,3476,121534,4722,0.02753136484602712,0.5759941449133935
5514,0.5555,9,1,9,672969,3475,121543,4713,0.027523444430363704,0.5755984367366879
5515,0.5556,4,4,4,672973,3471,121547,4709,0.027491762767710048,0.5756723716381418
5516,0.5557,4,11,4,672984,3460,121551,4705,0.027404638195412494,0.5762400489895897
5517,0.5558,6,0,6,672984,3460,121557,4699,0.027404638195412494,0.5759284226008089
5518,0.5559,9,3,9,672987,3457,121566,4690,0.027380876948422252,0.5756720265128268
5519,0.556,6,2,6,672989,3455,121572,4684,0.027365036117095426,0.5755006757586927
5520,0.5561,7,3,7,672992,3452,121579,4677,0.027341274870105185,0.5753475212203223
5521,0.5562,10,5,10,672997,3447,121589,4667,0.027301672791788113,0.5751787034754745
5522,0.5563,3,2,3,672999,3445,121592,4664,0.027285831960461283,0.5751633986928104
5523,0.5564,3,7,3,673006,3438,121595,4661,0.027230389050817386,0.5755031485368564
5524,0.5565,0,5,0,673011,3433,121595,4661,0.027190786972500318,0.575858660736348
5525,0.5566,0,4,0,673015,3429,121595,4661,0.02715910530984666,0.5761433868974042
5526,0.5567,5,1,5,673016,3428,121600,4656,0.027151184894183247,0.5759524987629886
5527,0.5568,5,9,5,673025,3419,121605,4651,0.02707990115321252,0.5763320941759603
5528,0.5569,10,6,10,673031,3413,121615,4641,0.027032378659232036,0.5762354109759126
5529,0.557,3,5,3,673036,3408,121618,4638,0.026992776580914965,0.5764354958985831
5530,0.5571,8,6,8,673042,3402,121626,4630,0.026945254086934482,0.5764442231075697
5531,0.5573,3,3,3,673045,3399,121629,4627,0.02692149283994424,0.5765013705457264
5532,0.5574,3,3,3,673048,3396,121632,4624,0.026897731592954,0.5765586034912719
5533,0.5575,4,3,4,673051,3393,121636,4620,0.026873970345963755,0.5765630849868963
5534,0.5576,4,3,4,673054,3390,121640,4616,0.026850209098973513,0.5765675743192605
5535,0.5577,1,4,1,673058,3386,121641,4615,0.026818527436319857,0.5768028996375453
5536,0.5578,7,5,7,673063,3381,121648,4608,0.02677892535800279,0.5767930904994367
5537,0.5579,7,5,7,673068,3376,121655,4601,0.026739323279685718,0.5767832518490661
5538,0.558,7,3,7,673071,3373,121662,4594,0.026715562032695477,0.5766285929459019
5539,0.5581,10,7,10,673078,3366,121672,4584,0.02666011912305158,0.5766037735849057
5540,0.5582,3,6,3,673084,3360,121675,4581,0.026612596629071093,0.5768794862108046
5541,0.5583,8,5,8,673089,3355,121683,4573,0.026572994550754025,0.576816347124117
5542,0.5584,5,5,5,673094,3350,121688,4568,0.026533392472436954,0.5769133619600909
5543,0.5585,4,4,4,673098,3346,121692,4564,0.026501710809783297,0.5769911504424778
5544,0.5586,5,2,5,673100,3344,121697,4559,0.02648586997845647,0.5768695432114387
5545,0.5587,8,4,8,673104,3340,121705,4551,0.026454188315802814,0.576732986947155
5546,0.5588,4,4,4,673108,3336,121709,4547,0.026422506653149158,0.5768108588100976
5547,0.5589,9,6,9,673114,3330,121718,4538,0.026374984159168672,0.5767666497203864
5548,0.559,4,1,4,673115,3329,121722,4534,0.02636706374350526,0.5766246979524354
5549,0.5591,1,4,1,673119,3325,121723,4533,0.026335382080851604,0.576864342071774
5550,0.5592,0,1,0,673120,3324,121723,4533,0.02632746166518819,0.5769377625047728
5551,0.5593,6,8,6,673128,3316,121729,4527,0.026264098339880877,0.5772026010455183
5552,0.5594,3,4,3,673132,3312,121732,4524,0.02623241667722722,0.5773353751914242
5553,0.5595,5,6,5,673138,3306,121737,4519,0.026184894183246737,0.5775079872204473
5554,0.5596,3,4,3,673142,3302,121740,4516,0.02615321252059308,0.5776413404962906
5555,0.5597,8,1,8,673143,3301,121748,4508,0.026145292104929666,0.5772826226149315
5556,0.5598,3,6,3,673149,3295,121751,4505,0.026097769610949183,0.5775641025641025
5557,0.5599,3,4,3,673153,3291,121754,4502,0.026066087948295527,0.5776979340433722
5558,0.56,5,7,5,673160,3284,121759,4497,0.02601064503865163,0.5779462793985349
5559,0.5601,10,4,10,673164,3280,121769,4487,0.025978963375997973,0.5777005278743401
5560,0.5602,4,3,4,673167,3277,121773,4483,0.02595520212900773,0.5777061855670103
5561,0.5603,3,6,3,673173,3271,121776,4480,0.025907679635027245,0.5779899367823507
5562,0.5604,5,1,5,673174,3270,121781,4475,0.02589975921936383,0.577792123950936
5563,0.5605,3,3,3,673177,3267,121784,4472,0.02587599797237359,0.5778524357152087
5564,0.5606,5,5,5,673182,3262,121789,4467,0.02583639589405652,0.5779531634105317
5565,0.5607,6,0,6,673182,3262,121795,4461,0.02583639589405652,0.5776252751521429
5566,0.5608,6,12,6,673194,3250,121801,4455,0.025741350906095552,0.5781959766385464
5567,0.5609,6,7,6,673201,3243,121807,4449,0.025685907996451655,0.578393135725429
5568,0.561,5,3,5,673204,3240,121812,4444,0.025662146749461413,0.5783446121811556
5569,0.5611,5,3,5,673207,3237,121817,4439,0.02563838550247117,0.5782959874934862
5570,0.5612,4,3,4,673210,3234,121821,4435,0.025614624255480927,0.5783022558351806
5571,0.5613,3,4,3,673214,3230,121824,4432,0.02558294259282727,0.5784390498564344
5572,0.5614,6,6,6,673220,3224,121830,4426,0.025535420098846788,0.578562091503268
5573,0.5615,8,4,8,673224,3220,121838,4418,0.02550373843619313,0.5784236711180938
5574,0.5616,3,6,3,673230,3214,121841,4415,0.02545621594221265,0.5787128063966444
5575,0.5617,5,3,5,673233,3211,121846,4410,0.025432454695222404,0.5786642172943184
5576,0.5618,4,3,4,673236,3208,121850,4406,0.025408693448232163,0.5786708694510113
5577,0.5619,2,4,2,673240,3204,121852,4404,0.025377011785578506,0.5788643533123028
5578,0.562,5,5,5,673245,3199,121857,4399,0.02533740970726144,0.5789681495130298
5579,0.5621,1,3,1,673248,3196,121858,4398,0.025313648460271194,0.5791414274427179
5580,0.5622,3,8,3,673256,3188,121861,4395,0.025250285134963885,0.5795859158644336
5581,0.5623,4,4,4,673260,3184,121865,4391,0.02521860347231023,0.5796699669966997
5582,0.5624,7,6,7,673266,3178,121872,4384,0.025171080978329742,0.5797408093097064
5583,0.5625,4,4,4,673270,3174,121876,4380,0.025139399315676086,0.5798252581413821
5584,0.5626,7,4,7,673274,3170,121883,4373,0.02510771765302243,0.5797428079013655
5585,0.5627,7,5,7,673279,3165,121890,4366,0.02506811557470536,0.5797370867082725
5586,0.5628,4,4,4,673283,3161,121894,4362,0.025036433912051705,0.5798218795693207
5587,0.5629,8,4,8,673287,3157,121902,4354,0.02500475224939805,0.5796831314072693
5588,0.563,3,4,3,673291,3153,121905,4351,0.024973070586744393,0.5798240938166311
5589,0.5631,6,1,6,673292,3152,121911,4345,0.024965150171080978,0.5795651593970922
5590,0.5632,1,5,1,673297,3147,121912,4344,0.02492554809276391,0.57989587505006
5591,0.5633,4,3,4,673300,3144,121916,4340,0.024901786845773665,0.5799037947621593
5592,0.5634,4,3,4,673303,3141,121920,4336,0.024878025598783424,0.5799117293031965
5593,0.5635,8,5,8,673308,3136,121928,4328,0.024838423520466352,0.579849946409432
5594,0.5636,10,3,10,673311,3133,121938,4318,0.02481466227347611,0.5795195275801905
5595,0.5637,1,5,1,673316,3128,121939,4317,0.024775060195159043,0.579852249832102
5596,0.5638,10,4,10,673320,3124,121949,4307,0.024743378532505387,0.579598977257435
5597,0.5639,7,3,7,673323,3121,121956,4300,0.024719617285515146,0.5794367335938553
5598,0.564,9,4,9,673327,3117,121965,4291,0.02468793562286149,0.5792386609071274
5599,0.5641,4,7,4,673334,3110,121969,4287,0.024632492713217588,0.5795592807895092
5600,0.5642,2,5,2,673339,3105,121971,4285,0.02459289063490052,0.5798376184032477
5601,0.5643,5,5,5,673344,3100,121976,4280,0.02455328855658345,0.5799457994579946
5602,0.5644,3,4,3,673348,3096,121979,4277,0.024521606893929793,0.5800895158008952
5603,0.5645,5,6,5,673354,3090,121984,4272,0.02447408439994931,0.5802770986145069
5604,0.5646,6,4,6,673358,3086,121990,4266,0.024442402737295654,0.5802502720348205
5605,0.5647,7,5,7,673363,3081,121997,4259,0.024402800658978582,0.5802452316076294
5606,0.5648,3,2,3,673365,3079,122000,4256,0.024386959827651756,0.5802317655078392
5607,0.5649,5,3,5,673368,3076,122005,4251,0.024363198580661515,0.5801828852190528
5608,0.565,4,5,4,673373,3071,122009,4247,0.024323596502344443,0.5803498223558349
5609,0.5651,1,2,1,673375,3069,122010,4246,0.024307755671017613,0.5804511278195489
5610,0.5652,5,4,5,673379,3065,122015,4241,0.02427607400836396,0.5804817957842869
5611,0.5653,6,3,6,673382,3062,122021,4235,0.024252312761373716,0.5803754967794984
5612,0.5654,2,6,2,673388,3056,122023,4233,0.024204790267393233,0.580738098504596
5613,0.5655,9,4,9,673392,3052,122032,4224,0.024173108604739577,0.5805387575590985
5614,0.5656,6,5,6,673397,3047,122038,4218,0.024133506526422505,0.5805918788713007
5615,0.5657,8,4,8,673401,3043,122046,4210,0.02410182486376885,0.5804494691851647
5616,0.5658,5,2,5,673403,3041,122051,4205,0.024085984032442023,0.5803201766491858
5617,0.5659,2,3,2,673406,3038,122053,4203,0.02406222278545178,0.5804446899599502
5618,0.566,3,6,3,673412,3032,122056,4200,0.024014700291471295,0.5807522123893806
5619,0.5661,3,6,3,673418,3026,122059,4197,0.023967177797490812,0.5810605011767963
5620,0.5662,7,7,7,673425,3019,122066,4190,0.023911734887846915,0.581217922041892
5621,0.5663,8,5,8,673430,3014,122074,4182,0.023872132809529843,0.5811561978877154
5622,0.5664,1,5,1,673435,3009,122075,4181,0.023832530731212775,0.5815020862308762
5623,0.5665,5,2,5,673437,3007,122080,4176,0.023816689899885946,0.5813726855074481
5624,0.5666,6,5,6,673442,3002,122086,4170,0.023777087821568874,0.5814277746793084
5625,0.5667,3,4,3,673446,2998,122089,4167,0.02374540615891522,0.5815771109560363
5626,0.5668,3,6,3,673452,2992,122092,4164,0.023697883664934735,0.5818893236444941
5627,0.5669,6,3,6,673455,2989,122098,4158,0.023674122417944494,0.5817825661116552
5628,0.567,4,3,4,673458,2986,122102,4154,0.023650361170954252,0.5817927170868348
5629,0.5671,7,6,7,673464,2980,122109,4147,0.023602838676973766,0.5818717552967588
5630,0.5672,3,3,3,673467,2977,122112,4144,0.023579077429983525,0.5819407386603005
5631,0.5673,3,5,3,673472,2972,122115,4141,0.023539475351666457,0.5821734851680023
5632,0.5674,3,4,3,673476,2968,122118,4138,0.0235077936890128,0.582324795947087
5633,0.5675,4,4,4,673480,2964,122122,4134,0.023476112026359144,0.5824175824175825
5634,0.5676,6,2,6,673482,2962,122128,4128,0.023460271195032315,0.582228490832158
5635,0.5677,5,0,5,673482,2962,122133,4123,0.023460271195032315,0.5819336626676076
5636,0.5678,6,2,6,673484,2960,122139,4117,0.023444430363705488,0.5817436766991663
5637,0.5679,3,2,3,673486,2958,122142,4114,0.023428589532378658,0.5817307692307693
5638,0.568,4,5,4,673491,2953,122146,4110,0.02338898745406159,0.5819057057907405
5639,0.5681,4,4,4,673495,2949,122150,4106,0.023357305791407934,0.5819985825655564
5640,0.5682,3,9,3,673504,2940,122153,4103,0.023286022050437206,0.5825642481896919
5641,0.5683,5,2,5,673506,2938,122158,4098,0.02327018121911038,0.5824332006822058
5642,0.5684,5,7,5,673513,2931,122163,4093,0.023214738309466482,0.5827164009111617
5643,0.5685,0,2,0,673515,2929,122163,4093,0.023198897478139652,0.5828823696952435
5644,0.5686,6,3,6,673518,2926,122169,4087,0.02317513623114941,0.5827748467132469
5645,0.5687,7,5,7,673523,2921,122176,4080,0.02313553415283234,0.5827738894443651
5646,0.5688,3,5,3,673528,2916,122179,4077,0.023095932074515272,0.583011583011583
5647,0.5689,8,4,8,673532,2912,122187,4069,0.023064250411861616,0.5828677839851024
5648,0.569,8,4,8,673536,2908,122195,4061,0.02303256874920796,0.5827234897402783
5649,0.5691,5,2,5,673538,2906,122200,4056,0.02301672791788113,0.5825912094225797
5650,0.5692,6,8,6,673546,2898,122206,4050,0.022953364592573817,0.582901554404145
5651,0.5693,1,3,1,673549,2895,122207,4049,0.022929603345583575,0.5830933179723502
5652,0.5694,3,4,3,673553,2891,122210,4046,0.02289792168292992,0.5832492431886983
5653,0.5695,8,4,8,673557,2887,122218,4038,0.022866240020276263,0.5831046931407943
5654,0.5696,5,5,5,673562,2882,122223,4033,0.022826637941959195,0.5832248734634852
5655,0.5697,5,2,5,673564,2880,122228,4028,0.022810797110632365,0.5830920671685003
5656,0.5698,4,2,4,673566,2878,122232,4024,0.02279495627930554,0.5830194146624167
5657,0.5699,5,2,5,673568,2876,122237,4019,0.02277911544797871,0.5828861493836113
5658,0.57,1,3,1,673571,2873,122238,4018,0.022755354200988467,0.5830793789000145
5659,0.5701,5,5,5,673576,2868,122243,4013,0.022715752122671396,0.5832001162621712
5660,0.5702,5,4,5,673580,2864,122248,4008,0.022684070460017743,0.5832363213038417
5661,0.5703,4,3,4,673583,2861,122252,4004,0.0226603092130275,0.5832483612527313
5662,0.5704,4,1,4,673584,2860,122256,4000,0.022652388797364087,0.5830903790087464
5663,0.5705,6,2,6,673586,2858,122262,3994,0.022636547966037257,0.5828955049620549
5664,0.5706,4,2,4,673588,2856,122266,3990,0.02262070713471043,0.5828220858895705
5665,0.5707,5,2,5,673590,2854,122271,3985,0.0226048663033836,0.5826875274162889
5666,0.5708,3,5,3,673595,2849,122274,3982,0.022565264225066533,0.5829307568438004
5667,0.5709,6,4,6,673599,2845,122280,3976,0.022533582562412877,0.5829057322973171
5668,0.571,3,5,3,673604,2840,122283,3973,0.022493980484095805,0.5831498605606928
5669,0.5711,2,0,2,673604,2840,122285,3971,0.022493980484095805,0.5830274555865511
5670,0.5712,3,7,3,673611,2833,122288,3968,0.022438537574451908,0.5834436112336421
5671,0.5713,3,5,3,673616,2828,122291,3965,0.022398935496134836,0.5836890917120565
5672,0.5714,6,7,6,673623,2821,122297,3959,0.02234349258649094,0.5839233038348083
5673,0.5715,3,7,3,673630,2814,122300,3956,0.02228804967684704,0.5843426883308714
5674,0.5716,5,3,5,673633,2811,122305,3951,0.0222642884298568,0.5842945874001775
5675,0.5717,3,6,3,673639,2805,122308,3948,0.022216765935876313,0.5846290537538872
5676,0.5718,2,4,2,673643,2801,122310,3946,0.022185084273222657,0.5848525270490589
5677,0.5719,3,8,3,673651,2793,122313,3943,0.022121720947915348,0.5853622327790974
5678,0.572,4,5,4,673656,2788,122317,3939,0.022082118869598277,0.5855507655715773
5679,0.5721,1,1,1,673657,2787,122318,3938,0.02207419845393486,0.5855762081784387
5680,0.5722,4,2,4,673659,2785,122322,3934,0.022058357622608035,0.5855037952076202
5681,0.5723,4,2,4,673661,2783,122326,3930,0.022042516791281205,0.585431252793088
5682,0.5724,6,3,6,673664,2780,122332,3924,0.022018755544290964,0.5853221957040573
5683,0.5725,5,5,5,673669,2775,122337,3919,0.021979153465973893,0.5854496564087243
5684,0.5726,3,5,3,673674,2770,122340,3916,0.021939551387656825,0.5857014657493269
5685,0.5727,2,2,2,673676,2768,122342,3914,0.021923710556329995,0.5857527686321461
5686,0.5728,1,2,1,673678,2766,122343,3913,0.02190786972500317,0.5858661476268903
5687,0.5729,7,2,7,673680,2764,122350,3906,0.02189202889367634,0.5856071964017991
5688,0.573,2,10,2,673690,2754,122352,3904,0.0218128247370422,0.5863622709522379
5689,0.5731,2,4,2,673694,2750,122354,3902,0.021781143074388543,0.5865904990980156
5690,0.5732,6,2,6,673696,2748,122360,3896,0.021765302243061717,0.5863937387116195
5691,0.5733,2,7,2,673703,2741,122362,3894,0.02170985933341782,0.586887716654107
5692,0.5734,3,5,3,673708,2736,122365,3891,0.021670257255100748,0.5871435038478949
5693,0.5735,6,6,6,673714,2730,122371,3885,0.021622734761120265,0.5873015873015873
5694,0.5736,1,9,1,673723,2721,122372,3884,0.021551451020149538,0.5880393641180923
5695,0.5737,2,3,2,673726,2718,122374,3882,0.021527689773159296,0.5881818181818181
5696,0.5738,0,3,0,673729,2715,122374,3882,0.021503928526169055,0.5884492951341519
5697,0.5739,3,3,3,673732,2712,122377,3879,0.02148016727917881,0.5885298133818844
5698,0.574,6,3,6,673735,2709,122383,3873,0.02145640603218857,0.5884229717411121
5699,0.5741,8,5,8,673740,2704,122391,3865,0.0214168039538715,0.5883696148576648
5700,0.5742,5,6,5,673746,2698,122396,3860,0.021369281459891015,0.5885940835620616
5701,0.5743,1,3,1,673749,2695,122397,3859,0.021345520212900773,0.5888007323771742
5702,0.5744,5,1,5,673750,2694,122402,3854,0.021337599797237358,0.5885766646304215
5703,0.5745,2,6,2,673756,2688,122404,3852,0.021290077303256875,0.5889908256880734
5704,0.5746,2,5,2,673761,2683,122406,3850,0.021250475224939804,0.5893157814174192
5705,0.5747,4,9,4,673770,2674,122410,3846,0.02117919148396908,0.589877300613497
5706,0.5748,3,3,3,673773,2671,122413,3843,0.021155430236978835,0.5899600859686829
5707,0.5749,7,4,7,673777,2667,122420,3836,0.02112374857432518,0.589881593110872
5708,0.575,6,5,6,673782,2662,122426,3830,0.02108414649600811,0.5899568699938386
5709,0.5751,5,2,5,673784,2660,122431,3825,0.02106830566468128,0.5898226676946801
5710,0.5752,5,3,5,673787,2657,122436,3820,0.02104454441769104,0.5897792187741239
5711,0.5753,6,1,6,673788,2656,122442,3814,0.021036624002027625,0.5894899536321484
5712,0.5754,3,1,3,673789,2655,122445,3811,0.021028703586364213,0.5893906588308073
5713,0.5755,4,3,4,673792,2652,122449,3807,0.021004942339373972,0.5894101254064097
5714,0.5756,6,2,6,673794,2650,122455,3801,0.020989101508047142,0.5892109750426291
5715,0.5757,7,7,7,673801,2643,122462,3794,0.020933658598403244,0.589405002330278
5716,0.5758,3,3,3,673804,2640,122465,3791,0.020909897351413003,0.5894884154874825
5717,0.5759,7,5,7,673809,2635,122472,3784,0.020870295273095932,0.5894999221062471
5718,0.576,3,0,3,673809,2635,122475,3781,0.020870295273095932,0.5893079800498753
5719,0.5761,6,4,6,673813,2631,122481,3775,0.020838613610442275,0.5892912894161724
5720,0.5762,6,3,6,673816,2628,122487,3769,0.020814852363452034,0.5891824292637173
5721,0.5763,3,5,3,673821,2623,122490,3766,0.020775250285134963,0.5894506182501174
5722,0.5764,5,4,5,673825,2619,122495,3761,0.020743568622481307,0.5894984326018808
5723,0.5765,5,3,5,673828,2616,122500,3756,0.020719807375491065,0.5894538606403014
5724,0.5766,2,3,2,673831,2613,122502,3754,0.020696046128500824,0.5896026386053086
5725,0.5767,7,4,7,673835,2609,122509,3747,0.020664364465847167,0.5895217117684078
5726,0.5768,7,5,7,673840,2604,122516,3740,0.020624762387530096,0.5895334174022698
5727,0.5769,6,3,6,673843,2601,122522,3734,0.020601001140539855,0.5894238358326757
5728,0.577,2,5,2,673848,2596,122524,3732,0.020561399062222787,0.5897597977243995
5729,0.5771,6,3,6,673851,2593,122530,3726,0.020537637815232542,0.5896502611172654
5730,0.5772,2,1,2,673852,2592,122532,3724,0.02052971739956913,0.5896136795440152
5731,0.5773,1,2,1,673854,2590,122533,3723,0.0205138765682423,0.5897354664977031
5732,0.5774,3,0,3,673854,2590,122536,3720,0.0205138765682423,0.589540412044374
5733,0.5775,6,6,6,673860,2584,122542,3714,0.020466354074261818,0.5897110193712289
5734,0.5776,1,6,1,673866,2578,122543,3713,0.020418831580281332,0.5902082339850581
5735,0.5777,4,2,4,673868,2576,122547,3709,0.020402990748954505,0.5901352426412092
5736,0.5778,3,1,3,673869,2575,122550,3706,0.02039507033329109,0.590033434166534
5737,0.5779,1,3,1,673872,2572,122551,3705,0.02037130908630085,0.5902501194838299
5738,0.578,4,1,4,673873,2571,122555,3701,0.020363388670637434,0.5900829081632653
5739,0.5781,3,0,3,673873,2571,122558,3698,0.020363388670637434,0.5898867442973361
5740,0.5782,2,6,2,673879,2565,122560,3696,0.02031586617665695,0.5903210349784379
5741,0.5783,5,3,5,673882,2562,122565,3691,0.02029210492966671,0.5902766671997441
5742,0.5784,5,5,5,673887,2557,122570,3686,0.02025250285134964,0.5904212718244434
5743,0.5785,4,5,4,673892,2552,122574,3682,0.020212900773032567,0.590632017965993
5744,0.5786,6,5,6,673897,2547,122580,3676,0.0201732986947155,0.5907118753013016
5745,0.5787,3,5,3,673902,2542,122583,3673,0.02013369661639843,0.5909895414320193
5746,0.5788,2,5,2,673907,2537,122585,3671,0.020094094538081357,0.5913337628865979
5747,0.5789,3,2,3,673909,2535,122588,3668,0.02007825370675453,0.5913267773657908
5748,0.579,11,7,11,673916,2528,122599,3657,0.020022810797110633,0.591269199676637
5749,0.5791,7,0,7,673916,2528,122606,3650,0.020022810797110633,0.5908060861120104
5750,0.5792,3,2,3,673918,2526,122609,3647,0.020006969965783803,0.5907986392353799
5751,0.5793,3,3,3,673921,2523,122612,3644,0.01998320871879356,0.5908869790822118
5752,0.5794,3,5,3,673926,2518,122615,3641,0.019943606640476494,0.5911673973047573
5753,0.5795,3,4,3,673930,2514,122618,3638,0.019911924977822838,0.5913524057217165
5754,0.5796,3,6,3,673936,2508,122621,3635,0.01986440248384235,0.5917304248738401
5755,0.5797,7,6,7,673942,2502,122628,3628,0.01981687998986187,0.5918433931484502
5756,0.5798,1,4,1,673946,2498,122629,3627,0.019785198327208212,0.5921632653061224
5757,0.5799,7,6,7,673952,2492,122636,3620,0.019737675833227726,0.5922774869109948
5758,0.58,5,2,5,673954,2490,122641,3615,0.0197218350019009,0.5921375921375921
5759,0.5801,3,6,3,673960,2484,122644,3612,0.019674312507920417,0.59251968503937
5760,0.5802,4,3,4,673963,2481,122648,3608,0.019650551260930172,0.5925439316800788
5761,0.5803,4,3,4,673966,2478,122652,3604,0.01962679001393993,0.5925682341335087
5762,0.5804,5,1,5,673967,2477,122657,3599,0.01961886959827652,0.5923304805793285
5763,0.5805,3,2,3,673969,2475,122660,3596,0.01960302876694969,0.5923241640586394
5764,0.5806,1,7,1,673976,2468,122661,3595,0.01954758585730579,0.5929407883885865
5765,0.5807,7,4,7,673980,2464,122668,3588,0.019515904194652135,0.5928618638466623
5766,0.5808,5,6,5,673986,2458,122673,3583,0.019468381700671653,0.5931137228935607
5767,0.5809,9,2,9,673988,2456,122682,3574,0.019452540869344823,0.5927031509121061
5768,0.581,6,1,6,673989,2455,122688,3568,0.019444620453681408,0.592395816038519
5769,0.5811,6,3,6,673992,2452,122694,3562,0.019420859206691166,0.5922846691054207
5770,0.5812,3,5,3,673997,2447,122697,3559,0.0193812571283741,0.5925740925740925
5771,0.5813,4,3,4,674000,2444,122701,3555,0.019357495881383854,0.5925987664610769
5772,0.5814,3,2,3,674002,2442,122704,3552,0.019341655050057027,0.5925925925925926
5773,0.5815,7,3,7,674005,2439,122711,3545,0.019317893803066786,0.5924131016042781
5774,0.5816,5,2,5,674007,2437,122716,3540,0.019302052971739956,0.592270369750711
5775,0.5817,7,3,7,674010,2434,122723,3533,0.019278291724749715,0.592089827383945
5776,0.5818,7,1,7,674011,2433,122730,3526,0.0192703713090863,0.591710018459473
5777,0.5819,3,3,3,674014,2430,122733,3523,0.019246610062096058,0.5918024525449354
5778,0.582,2,4,2,674018,2426,122735,3521,0.019214928399442402,0.5920632251555407
5779,0.5821,2,3,2,674021,2423,122737,3519,0.01919116715245216,0.5922248401211713
5780,0.5822,3,2,3,674023,2421,122740,3516,0.019175326321125334,0.5922182920667004
5781,0.5823,5,2,5,674025,2419,122745,3511,0.019159485489798504,0.5920741989881956
5782,0.5824,1,3,1,674028,2416,122746,3510,0.019135724242808263,0.5923050961862977
5783,0.5825,3,2,3,674030,2414,122749,3507,0.019119883411481433,0.5922985982097618
5784,0.5826,3,3,3,674033,2411,122752,3504,0.01909612216449119,0.5923922231614539
5785,0.5827,4,4,4,674037,2407,122756,3500,0.019064440501837535,0.5925173522938886
5786,0.5828,2,8,2,674045,2399,122758,3498,0.019001077176530223,0.5931829743937596
5787,0.5829,3,2,3,674047,2397,122761,3495,0.018985236345203396,0.5931771894093686
5788,0.583,4,4,4,674051,2393,122765,3491,0.01895355468254974,0.5933038749150238
5789,0.5831,8,3,8,674054,2390,122773,3483,0.0189297934355595,0.5930529541971735
5790,0.5832,3,5,3,674059,2385,122776,3480,0.018890191357242427,0.5933503836317136
5791,0.5833,7,3,7,674062,2382,122783,3473,0.018866430110252186,0.5931682322801025
5792,0.5834,5,3,5,674065,2379,122788,3468,0.018842668863261944,0.5931246793227296
5793,0.5835,5,6,5,674071,2373,122793,3463,0.018795146369281458,0.593385880740233
5794,0.5836,2,4,2,674075,2369,122795,3461,0.018763464706627805,0.5936535162950257
5795,0.5837,2,6,2,674081,2363,122797,3459,0.01871594221264732,0.5941257299896943
5796,0.5838,2,4,2,674085,2359,122799,3457,0.018684260549993663,0.59439477303989
5797,0.5839,3,1,3,674086,2358,122802,3454,0.018676340134330248,0.594287680660702
5798,0.584,2,3,2,674089,2355,122804,3452,0.018652578887340007,0.5944549681418977
5799,0.5841,3,1,3,674090,2354,122807,3449,0.018644658471676595,0.5943477511631915
5800,0.5842,4,5,4,674095,2349,122811,3445,0.018605056393359524,0.5945806006213324
5801,0.5843,6,5,6,674100,2344,122817,3439,0.018565454315042453,0.5946740446135224
5802,0.5844,3,3,3,674103,2341,122820,3436,0.01854169306805221,0.5947723732040852
5803,0.5845,4,4,4,674107,2337,122824,3432,0.018510011405398555,0.5949037961518461
5804,0.5846,3,2,3,674109,2335,122827,3429,0.01849417057407173,0.5948993754337266
5805,0.5847,2,2,2,674111,2333,122829,3427,0.0184783297427449,0.5949652777777777
5806,0.5848,4,3,4,674114,2330,122833,3423,0.018454568495754657,0.5949939162176255
5807,0.5849,5,7,5,674121,2323,122838,3418,0.01839912558611076,0.5953666608604773
5808,0.585,4,2,4,674123,2321,122842,3414,0.01838328475478393,0.5952920662598082
5809,0.5851,5,3,5,674126,2318,122847,3409,0.018359523507793688,0.5952505674873406
5810,0.5852,1,2,1,674128,2316,122848,3408,0.018343682676466862,0.5953878406708596
5811,0.5853,2,8,2,674136,2308,122850,3406,0.01828031935115955,0.5960798039901996
5812,0.5854,3,4,3,674140,2304,122853,3403,0.018248637688505893,0.5962852637112318
5813,0.5855,2,3,2,674143,2301,122855,3401,0.01822487644151565,0.5964573833742547
5814,0.5856,4,3,4,674146,2298,122859,3397,0.01820111519452541,0.5964881474978051
5815,0.5857,3,2,3,674148,2296,122862,3394,0.01818527436319858,0.5964850615114236
5816,0.5858,6,5,6,674153,2291,122868,3388,0.01814567228488151,0.5965839056171861
5817,0.5859,3,3,3,674156,2288,122871,3385,0.018121911037891267,0.5966860567600917
5818,0.586,4,9,4,674165,2279,122875,3381,0.018050627296920543,0.5973498233215547
5819,0.5861,7,6,7,674171,2273,122882,3374,0.018003104802940057,0.5974853904728175
5820,0.5862,3,0,3,674171,2273,122885,3371,0.018003104802940057,0.5972714386959603
5821,0.5863,7,8,7,674179,2265,122892,3364,0.017939741477632744,0.5976194705986854
5822,0.5864,5,6,5,674185,2259,122897,3359,0.017892218983652262,0.5978996084015664
5823,0.5865,3,2,3,674187,2257,122900,3356,0.017876378152325435,0.5978977373953323
5824,0.5866,4,2,4,674189,2255,122904,3352,0.017860537320998605,0.5978241483859461
5825,0.5867,3,7,3,674196,2248,122907,3349,0.017805094411354708,0.5983562622833661
5826,0.5868,7,1,7,674197,2247,122914,3342,0.017797173995691293,0.5979602791196994
5827,0.5869,3,4,3,674201,2243,122917,3339,0.017765492333037636,0.5981726979577212
5828,0.587,4,2,4,674203,2241,122921,3335,0.01774965150171081,0.5980989956958394
5829,0.5871,2,1,2,674204,2240,122923,3333,0.017741731086047395,0.5980620850529338
5830,0.5872,4,3,4,674207,2237,122927,3329,0.017717969839057154,0.598095580309019
5831,0.5873,9,3,9,674210,2234,122936,3320,0.017694208592066912,0.5977673748649622
5832,0.5874,5,1,5,674211,2233,122941,3315,0.017686288176403497,0.5975126171593367
5833,0.5875,1,3,1,674214,2230,122942,3314,0.017662526929413256,0.5977633477633477
5834,0.5876,2,2,2,674216,2228,122944,3312,0.017646686098086426,0.5978339350180505
5835,0.5877,6,3,6,674219,2225,122950,3306,0.017622924851096185,0.5977219309347315
5836,0.5878,3,5,3,674224,2220,122953,3303,0.017583322772779117,0.5980445410103205
5837,0.5879,3,8,3,674232,2212,122956,3300,0.017519959447471804,0.5986937590711175
5838,0.588,7,1,7,674233,2211,122963,3293,0.01751203903180839,0.5982921511627907
5839,0.5881,4,3,4,674236,2208,122967,3289,0.017488277784818148,0.5983263598326359
5840,0.5882,5,2,5,674238,2206,122972,3284,0.017472436953491318,0.5981785063752277
5841,0.5883,2,1,2,674239,2205,122974,3282,0.017464516537827907,0.598141060688901
5842,0.5884,7,9,7,674248,2196,122981,3275,0.01739323279685718,0.598610857247304
5843,0.5885,5,6,5,674254,2190,122986,3270,0.017345710302876696,0.5989010989010989
5844,0.5886,3,2,3,674256,2188,122989,3267,0.017329869471549866,0.5989000916590285
5845,0.5887,2,5,2,674261,2183,122991,3265,0.0172902673932328,0.5993024963289281
5846,0.5888,3,3,3,674264,2180,122994,3262,0.017266506146242554,0.5994119808893789
5847,0.5889,4,4,4,674268,2176,122998,3258,0.017234824483588897,0.5995583364004416
5848,0.589,4,3,4,674271,2173,123002,3254,0.017211063236598656,0.599594619495117
5849,0.5891,1,2,1,674273,2171,123003,3253,0.01719522240527183,0.5997418879056047
5850,0.5892,9,5,9,674278,2166,123012,3244,0.01715562032695476,0.599630314232902
5851,0.5893,2,1,2,674279,2165,123014,3242,0.017147699911291343,0.5995931200295913
5852,0.5894,6,3,6,674282,2162,123020,3236,0.017123938664301102,0.599481289366432
5853,0.5895,7,6,7,674288,2156,123027,3229,0.01707641617032062,0.5996285979572887
5854,0.5896,0,3,0,674291,2153,123027,3229,0.017052654923330378,0.5999628390932739
5855,0.5897,3,3,3,674294,2150,123030,3226,0.017028893676340133,0.6000744047619048
5856,0.5898,4,5,4,674299,2145,123034,3222,0.016989291598023065,0.6003353828954723
5857,0.5899,5,1,5,674300,2144,123039,3217,0.01698137118235965,0.600074612945346
5858,0.59,5,2,5,674302,2142,123044,3212,0.016965530351032824,0.5999252895031751
5859,0.5901,2,4,2,674306,2138,123046,3210,0.016933848688379168,0.6002243829468961
5860,0.5902,4,4,4,674310,2134,123050,3206,0.01690216702572551,0.600374531835206
5861,0.5903,1,6,1,674316,2128,123051,3205,0.016854644531745025,0.6009750609413088
5862,0.5904,4,5,4,674321,2123,123055,3201,0.016815042453427957,0.6012396694214877
5863,0.5905,3,2,3,674323,2121,123058,3198,0.016799201622101127,0.6012408347433729
5864,0.5906,2,3,2,674326,2118,123060,3196,0.016775440375110886,0.6014301844185171
5865,0.5907,1,1,1,674327,2117,123061,3195,0.01676751995944747,0.6014683734939759
5866,0.5908,6,3,6,674330,2114,123067,3189,0.01674375871245723,0.601357722044126
5867,0.5909,5,3,5,674333,2111,123072,3184,0.016719997465466988,0.6013220018885741
5868,0.591,6,6,6,674339,2105,123078,3178,0.016672474971486502,0.60155214840053
5869,0.5911,4,2,4,674341,2103,123082,3174,0.016656634140159676,0.6014781125639568
5870,0.5912,4,4,4,674345,2099,123086,3170,0.01662495247750602,0.6016321882710192
5871,0.5913,5,5,5,674350,2094,123091,3165,0.016585350399188948,0.6018254420992584
5872,0.5914,4,1,4,674351,2093,123095,3161,0.016577429983525536,0.6016368481157214
5873,0.5915,3,5,3,674356,2088,123098,3158,0.016537827905208465,0.601982462828822
5874,0.5916,11,5,11,674361,2083,123109,3147,0.016498225826891394,0.6017208413001912
5875,0.5917,2,3,2,674364,2080,123111,3145,0.016474464579901153,0.6019138755980862
5876,0.5918,5,2,5,674366,2078,123116,3140,0.016458623748574326,0.6017631276351092
5877,0.5919,5,2,5,674368,2076,123121,3135,0.016442782917247496,0.6016119746689695
5878,0.592,1,3,1,674371,2073,123122,3134,0.016419021670257255,0.6018820818129441
5879,0.5921,4,3,4,674374,2070,123126,3130,0.016395260423267013,0.6019230769230769
5880,0.5922,3,5,3,674379,2065,123129,3127,0.016355658344949942,0.6022727272727273
5881,0.5923,1,2,1,674381,2063,123130,3126,0.016339817513623116,0.6024282135286182
5882,0.5924,2,1,2,674382,2062,123132,3124,0.0163318970979597,0.6023910528345545
5883,0.5925,0,4,0,674386,2058,123132,3124,0.016300215435306045,0.6028560401389425
5884,0.5926,1,4,1,674390,2054,123133,3123,0.016268533772652388,0.60324512265791
5885,0.5927,7,3,7,674393,2051,123140,3116,0.016244772525662147,0.6030578672343719
5886,0.5928,2,5,2,674398,2046,123142,3114,0.016205170447345076,0.6034883720930233
5887,0.5929,8,2,8,674400,2044,123150,3106,0.01618932961601825,0.6031067961165049
5888,0.593,5,1,5,674401,2043,123155,3101,0.016181409200354834,0.6028382581648523
5889,0.5931,3,3,3,674404,2040,123158,3098,0.016157647953364593,0.602958349552355
5890,0.5932,6,4,6,674408,2036,123164,3092,0.016125966290710936,0.6029641185647426
5891,0.5933,6,4,6,674412,2032,123170,3086,0.01609428462805728,0.6029699101211411
5892,0.5934,7,4,7,674416,2028,123177,3079,0.016062602965403624,0.6028979831603681
5893,0.5935,2,1,2,674417,2027,123179,3077,0.01605468254974021,0.6028605015673981
5894,0.5936,6,1,6,674418,2026,123185,3071,0.016046762134076797,0.602511281145772
5895,0.5937,3,3,3,674421,2023,123188,3068,0.016023000887086553,0.6026320958554312
5896,0.5938,5,3,5,674424,2020,123193,3063,0.01599923964009631,0.6025968915994492
5897,0.5939,2,8,2,674432,2012,123195,3061,0.015935876314789,0.6033904987187069
5898,0.594,3,2,3,674434,2010,123198,3058,0.015920035483462172,0.6033938437253354
5899,0.5941,4,2,4,674436,2008,123202,3054,0.015904194652135346,0.603318846305808
5900,0.5942,4,4,4,674440,2004,123206,3050,0.01587251298948169,0.6034823901859913
5901,0.5943,2,5,2,674445,1999,123208,3048,0.015832910911164618,0.6039231226471171
5902,0.5944,2,8,2,674453,1991,123210,3046,0.015769547585857305,0.6047250347429025
5903,0.5945,0,3,0,674456,1988,123210,3046,0.015745786338867064,0.6050854191497815
5904,0.5946,2,4,2,674460,1984,123212,3044,0.015714104676213408,0.6054097056483692
5905,0.5947,4,1,4,674461,1983,123216,3040,0.015706184260549993,0.6052160063706948
5906,0.5948,4,3,4,674464,1980,123220,3036,0.01568242301355975,0.6052631578947368
5907,0.5949,3,2,3,674466,1978,123223,3033,0.015666582182232925,0.605268409499102
5908,0.595,6,1,6,674467,1977,123229,3027,0.01565866176656951,0.604916067146283
5909,0.5951,5,4,5,674471,1973,123234,3022,0.015626980103915854,0.605005005005005
5910,0.5952,3,0,3,674471,1973,123237,3019,0.015626980103915854,0.6047676282051282
5911,0.5953,1,0,1,674471,1973,123238,3018,0.015626980103915854,0.6046884391905429
5912,0.5954,8,2,8,674473,1971,123246,3010,0.015611139272589026,0.604296326038948
5913,0.5955,2,2,2,674475,1969,123248,3008,0.015595298441262197,0.6043801486839462
5914,0.5956,4,9,4,674484,1960,123252,3004,0.015524014700291472,0.6051571313456889
5915,0.5957,1,7,1,674491,1953,123253,3003,0.015468571790647574,0.6059322033898306
5916,0.5958,3,2,3,674493,1951,123256,3000,0.015452730959320746,0.6059381943041809
5917,0.5959,3,3,3,674496,1948,123259,2997,0.015428969712330503,0.606066734074823
5918,0.596,1,1,1,674497,1947,123260,2996,0.01542104929666709,0.6061096500101153
5919,0.5961,4,5,4,674502,1942,123264,2992,0.01538144721835002,0.6064045399270369
5920,0.5962,3,2,3,674504,1940,123267,2989,0.015365606387023192,0.6064110367214445
5921,0.5963,2,4,2,674508,1936,123269,2987,0.015333924724369535,0.6067438553727402
5922,0.5964,5,2,5,674510,1934,123274,2982,0.015318083893042707,0.6065907241659886
5923,0.5965,3,0,3,674510,1934,123277,2979,0.015318083893042707,0.6063504986769794
5924,0.5966,2,3,2,674513,1931,123279,2977,0.015294322646052464,0.606560717196414
5925,0.5967,2,2,2,674515,1929,123281,2975,0.015278481814725638,0.606647634584013
5926,0.5968,5,3,5,674518,1926,123286,2970,0.015254720567735395,0.6066176470588235
5927,0.5969,4,4,4,674522,1922,123290,2966,0.015223038905081738,0.6067921440261865
5928,0.597,8,4,8,674526,1918,123298,2958,0.015191357242428082,0.6066447908121411
5929,0.5971,5,3,5,674529,1915,123303,2953,0.01516759599543784,0.6066146261298274
5930,0.5972,1,3,1,674532,1912,123304,2952,0.0151438347484476,0.6069078947368421
5931,0.5973,0,3,0,674535,1909,123304,2952,0.015120073501457356,0.6072824521703353
5932,0.5974,4,0,4,674535,1909,123308,2948,0.015120073501457356,0.606959028206712
5933,0.5975,4,4,4,674539,1905,123312,2944,0.0150883918388037,0.6071354918539905
5934,0.5976,3,5,3,674544,1900,123315,2941,0.01504878976048663,0.607519107622392
5935,0.5977,5,2,5,674546,1898,123320,2936,0.015032948929159802,0.6073645014480761
5936,0.5978,1,2,1,674548,1896,123321,2935,0.015017108097832974,0.6075346719105775
5937,0.5979,3,4,3,674552,1892,123324,2932,0.014985426435179318,0.6077943615257048
5938,0.598,1,3,1,674555,1889,123325,2931,0.014961665188189076,0.6080912863070539
5939,0.5981,1,5,1,674560,1884,123326,2930,0.014922063109872007,0.6086414624013294
5940,0.5982,3,4,3,674564,1880,123329,2927,0.01489038144721835,0.6089036821302267
5941,0.5983,4,4,4,674568,1876,123333,2923,0.014858699784564694,0.6090852260887685
5942,0.5984,5,3,5,674571,1873,123338,2918,0.014834938537574453,0.6090586516384888
5943,0.5985,2,5,2,674576,1868,123340,2916,0.014795336459257381,0.6095317725752508
5944,0.5986,4,1,4,674577,1867,123344,2912,0.014787416043593968,0.609332496338146
5945,0.5987,4,1,4,674578,1866,123348,2908,0.014779495627930553,0.6091328026811897
5946,0.5988,2,2,2,674580,1864,123350,2906,0.014763654796603725,0.609224318658281
5947,0.5989,2,3,2,674583,1861,123352,2904,0.014739893549613484,0.6094438614900315
5948,0.599,3,1,3,674584,1860,123355,2901,0.01473197313395007,0.6093257718966604
5949,0.5991,5,3,5,674587,1857,123360,2896,0.014708211886959827,0.6092993898590364
5950,0.5992,4,4,4,674591,1853,123364,2892,0.014676530224306171,0.6094836670179136
5951,0.5993,6,3,6,674594,1850,123370,2886,0.01465276897731593,0.609375
5952,0.5994,5,2,5,674596,1848,123375,2881,0.014636928145989101,0.6092197081835483
5953,0.5995,4,4,4,674600,1844,123379,2877,0.014605246483335445,0.6094047871213726
5954,0.5996,3,3,3,674603,1841,123382,2874,0.014581485236345204,0.609544008483563
5955,0.5997,4,2,4,674605,1839,123386,2870,0.014565644405018376,0.60947122531323
5956,0.5998,3,3,3,674608,1836,123389,2867,0.014541883158028132,0.6096108866680842
5957,0.5999,2,6,2,674614,1830,123391,2865,0.01449436066404765,0.610223642172524
5958,0.6,2,1,2,674615,1829,123393,2863,0.014486440248384235,0.6101875532821824
5959,0.6001,5,3,5,674618,1826,123398,2858,0.014462679001393993,0.6101622544833476
5960,0.6002,2,4,2,674622,1822,123400,2856,0.014430997338740337,0.6105173150919196
5961,0.6003,3,1,3,674623,1821,123403,2853,0.014423076923076924,0.610397946084724
5962,0.6004,0,2,0,674625,1819,123403,2853,0.014407236091750096,0.6106592465753424
5963,0.6005,3,3,3,674628,1816,123406,2850,0.014383474844759853,0.6108015430775825
5964,0.6006,4,3,4,674631,1813,123410,2846,0.014359713597769611,0.6108606997209701
5965,0.6007,2,3,2,674634,1810,123412,2844,0.014335952350779368,0.6110872367855608
5966,0.6008,2,3,2,674637,1807,123414,2842,0.014312191103789127,0.6113142611314261
5967,0.6009,2,0,2,674637,1807,123416,2840,0.014312191103789127,0.6111469765440068
5968,0.601,3,2,3,674639,1805,123419,2837,0.014296350272462299,0.6111589831968979
5969,0.6011,3,2,3,674641,1803,123422,2834,0.01428050944113547,0.6111710157429372
5970,0.6012,0,4,0,674645,1799,123422,2834,0.014248827778481814,0.611698683358515
5971,0.6013,3,5,3,674650,1794,123425,2831,0.014209225700164745,0.6121081081081081
5972,0.6014,4,1,4,674651,1793,123429,2827,0.014201305284501331,0.611904761904762
5973,0.6015,1,2,1,674653,1791,123430,2826,0.014185464453174503,0.6120857699805068
5974,0.6016,2,2,2,674655,1789,123432,2824,0.014169623621847675,0.6121829611966183
5975,0.6017,2,1,2,674656,1788,123434,2822,0.01416170320618426,0.6121475054229935
5976,0.6018,3,5,3,674661,1783,123437,2819,0.01412210112786719,0.6125597566275532
5977,0.6019,2,4,2,674665,1779,123439,2817,0.014090419465213534,0.6129242819843342
5978,0.602,3,3,3,674668,1776,123442,2814,0.014066658218223293,0.6130718954248366
5979,0.6021,3,1,3,674669,1775,123445,2811,0.014058737802559878,0.6129524640209333
5980,0.6022,4,4,4,674673,1771,123449,2807,0.014027056139906222,0.6131498470948012
5981,0.6023,3,5,3,674678,1766,123452,2804,0.013987454061589152,0.613566739606127
5982,0.6024,2,1,2,674679,1765,123454,2802,0.013979533645925739,0.613531858988395
5983,0.6025,3,3,3,674682,1762,123457,2799,0.013955772398935496,0.6136812102609077
5984,0.6026,2,5,2,674687,1757,123459,2797,0.013916170320618426,0.6141853315766359
5985,0.6027,4,2,4,674689,1755,123463,2793,0.013900329489291598,0.6141160949868074
5986,0.6028,4,5,4,674694,1750,123467,2789,0.013860727410974528,0.6144525225820665
5987,0.6029,3,2,3,674696,1748,123470,2786,0.0138448865796477,0.6144684605205117
5988,0.603,4,1,4,674697,1747,123474,2782,0.013836966163984285,0.6142636343563701
5989,0.6031,2,2,2,674699,1745,123476,2780,0.013821125332657457,0.6143646408839779
5990,0.6032,3,2,3,674701,1743,123479,2777,0.013805284501330629,0.6143805309734514
5991,0.6033,3,0,3,674701,1743,123482,2774,0.013805284501330629,0.6141244188620766
5992,0.6034,2,4,2,674705,1739,123484,2772,0.013773602838676974,0.6144978940367989
5993,0.6035,1,4,1,674709,1735,123485,2771,0.013741921176023318,0.6149578339991123
5994,0.6036,4,1,4,674710,1734,123489,2767,0.013734000760359903,0.6147522772717174
5995,0.6037,5,2,5,674712,1732,123494,2762,0.013718159929033075,0.6145972407654651
5996,0.6038,5,3,5,674715,1729,123499,2757,0.013694398682042834,0.6145786892554614
5997,0.6039,3,1,3,674716,1728,123502,2754,0.01368647826637942,0.6144578313253012
5998,0.604,3,2,3,674718,1726,123505,2751,0.013670637435052592,0.6144739781103418
5999,0.6041,2,2,2,674720,1724,123507,2749,0.013654796603725764,0.6145763469707132
6000,0.6042,6,5,6,674725,1719,123513,2743,0.013615194525408693,0.6147467503361721
6001,0.6043,5,5,5,674730,1714,123518,2738,0.013575592447091623,0.6150044923629829
6002,0.6044,5,3,5,674733,1711,123523,2733,0.013551831200101382,0.614986498649865
6003,0.6045,7,4,7,674737,1707,123530,2726,0.013520149537447726,0.614933453643131
6004,0.6046,3,4,3,674741,1703,123533,2723,0.01348846787479407,0.6152281970176231
6005,0.6047,1,3,1,674744,1700,123534,2722,0.013464706627803828,0.6155585707824514
6006,0.6048,3,4,3,674748,1696,123537,2719,0.013433024965150172,0.6158550396375991
6007,0.6049,4,2,4,674750,1694,123541,2715,0.013417184133823343,0.6157858924926287
6008,0.605,7,1,7,674751,1693,123548,2708,0.013409263718159928,0.6153147012042718
6009,0.6051,5,1,5,674752,1692,123553,2703,0.013401343302496515,0.6150170648464164
6010,0.6052,2,3,2,674755,1689,123555,2701,0.013377582055506272,0.6152619589977221
6011,0.6053,4,2,4,674757,1687,123559,2697,0.013361741224179446,0.615191605839416
6012,0.6054,3,1,3,674758,1686,123562,2694,0.01335382080851603,0.6150684931506849
6013,0.6055,6,1,6,674759,1685,123568,2688,0.013345900392852618,0.6146809970272125
6014,0.6056,1,2,1,674761,1683,123569,2687,0.01333005956152579,0.6148741418764302
6015,0.6057,2,3,2,674764,1680,123571,2685,0.013306298314535546,0.6151202749140894
6016,0.6058,4,1,4,674765,1679,123575,2681,0.013298377898872133,0.6149082568807339
6017,0.6059,3,1,3,674766,1678,123578,2678,0.013290457483208718,0.6147842056932966
6018,0.606,4,0,4,674766,1678,123582,2674,0.013290457483208718,0.6144301470588235
6019,0.6061,7,5,7,674771,1673,123589,2667,0.013250855404891649,0.614516129032258
6020,0.6062,4,3,4,674774,1670,123593,2663,0.013227094157901407,0.6145857373644127
6021,0.6063,2,1,2,674775,1669,123595,2661,0.013219173742237992,0.6145496535796767
6022,0.6064,5,3,5,674778,1666,123600,2656,0.013195412495247751,0.6145303100416474
6023,0.6065,2,2,2,674780,1664,123602,2654,0.013179571663920923,0.6146364057433997
6024,0.6066,5,4,5,674784,1660,123607,2649,0.013147890001267266,0.6147598050591785
6025,0.6067,2,4,2,674788,1656,123609,2647,0.01311620833861361,0.6151522193818266
6026,0.6068,5,4,5,674792,1652,123614,2642,0.013084526675959954,0.6152771308802981
6027,0.6069,6,6,6,674798,1646,123620,2636,0.013037004181979471,0.6156001868285848
6028,0.607,1,4,1,674802,1642,123621,2635,0.013005322519325815,0.6160860416179565
6029,0.6071,4,2,4,674804,1640,123625,2631,0.012989481687998987,0.6160149847810817
6030,0.6072,3,3,3,674807,1637,123628,2628,0.012965720441008743,0.6161781946072684
6031,0.6073,0,2,0,674809,1635,123628,2628,0.012949879609681915,0.6164672765657987
6032,0.6074,5,1,5,674810,1634,123633,2623,0.012941959194018502,0.6161616161616161
6033,0.6075,6,2,6,674812,1632,123639,2617,0.012926118362691674,0.6159096257943045
6034,0.6076,4,0,4,674812,1632,123643,2613,0.012926118362691674,0.615547703180212
6035,0.6077,4,3,4,674815,1629,123647,2609,0.012902357115701433,0.6156205757432751
6036,0.6078,2,3,2,674818,1626,123649,2607,0.01287859586871119,0.6158752657689582
6037,0.6079,4,1,4,674819,1625,123653,2603,0.012870675453047776,0.6156575212866604
6038,0.608,5,3,5,674822,1622,123658,2598,0.012846914206057533,0.6156398104265403
6039,0.6081,5,4,5,674826,1618,123663,2593,0.012815232543403879,0.6157682260745666
6040,0.6082,2,2,2,674828,1616,123665,2591,0.01279939171207705,0.6158782980746375
6041,0.6083,5,2,5,674830,1614,123670,2586,0.012783550880750222,0.6157142857142858
6042,0.6084,4,4,4,674834,1610,123674,2582,0.012751869218096566,0.6159351145038168
6043,0.6085,5,2,5,674836,1608,123679,2577,0.012736028386769738,0.6157706093189964
6044,0.6086,4,1,4,674837,1607,123683,2573,0.012728107971106324,0.6155502392344497
6045,0.6087,2,2,2,674839,1605,123685,2571,0.012712267139779496,0.6156609195402298
6046,0.6088,0,2,0,674841,1603,123685,2571,0.012696426308452668,0.6159559175850503
6047,0.6089,3,2,3,674843,1601,123688,2568,0.01268058547712584,0.6159750539697769
6048,0.609,4,1,4,674844,1600,123692,2564,0.012672665061462425,0.6157540826128722
6049,0.6091,4,5,4,674849,1595,123696,2560,0.012633062983145356,0.6161251504211793
6050,0.6092,2,1,2,674850,1594,123698,2558,0.012625142567481942,0.6160886319845857
6051,0.6093,2,4,2,674854,1590,123700,2556,0.012593460904828286,0.6164978292329957
6052,0.6094,1,1,1,674855,1589,123701,2555,0.012585540489164871,0.6165540540540541
6053,0.6095,5,4,5,674859,1585,123706,2550,0.012553858826511215,0.6166868198307134
6054,0.6096,4,0,4,674859,1585,123710,2546,0.012553858826511215,0.616315662067296
6055,0.6097,4,3,4,674862,1582,123714,2542,0.012530097579520973,0.61639185257032
6056,0.6098,4,2,4,674864,1580,123718,2538,0.012514256748194145,0.616318601262749
6057,0.6099,0,3,0,674867,1577,123718,2538,0.012490495501203904,0.616767922235723
6058,0.61,5,3,5,674870,1574,123723,2533,0.01246673425421366,0.6167518870221573
6059,0.6101,6,2,6,674872,1572,123729,2527,0.012450893422886833,0.6164918272749451
6060,0.6102,3,3,3,674875,1569,123732,2524,0.012427132175896591,0.6166625946738333
6061,0.6103,5,3,5,674878,1566,123737,2519,0.01240337092890635,0.6166462668298653
6062,0.6104,2,2,2,674880,1564,123739,2517,0.012387530097579522,0.6167605978926733
6063,0.6105,5,4,5,674884,1560,123744,2512,0.012355848434925865,0.6168958742632613
6064,0.6106,8,0,8,674884,1560,123752,2504,0.012355848434925865,0.6161417322834646
6065,0.6107,2,0,2,674884,1560,123754,2502,0.012355848434925865,0.6159527326440177
6066,0.6108,4,1,4,674885,1559,123758,2498,0.01234792801926245,0.615725905841755
6067,0.6109,3,5,3,674890,1554,123761,2495,0.01230832594094538,0.616201531242282
6068,0.611,3,0,3,674890,1554,123764,2492,0.01230832594094538,0.615916955017301
6069,0.6111,3,5,3,674895,1549,123767,2489,0.012268723862628311,0.616394254581476
6070,0.6112,3,2,3,674897,1547,123770,2486,0.012252883031301483,0.616414579717332
6071,0.6113,3,2,3,674899,1545,123773,2483,0.012237042199974655,0.6164349553128103
6072,0.6114,1,2,1,674901,1543,123774,2482,0.012221201368647827,0.6166459627329193
6073,0.6115,5,4,5,674905,1539,123779,2477,0.01218951970599417,0.6167828685258964
6074,0.6116,2,0,2,674905,1539,123781,2475,0.01218951970599417,0.6165919282511211
6075,0.6117,4,1,4,674906,1538,123785,2471,0.012181599290330757,0.6163631828386131
6076,0.6118,2,1,2,674907,1537,123787,2469,0.012173678874667342,0.6163255117324014
6077,0.6119,2,2,2,674909,1535,123789,2467,0.012157838043340514,0.6164417791104447
6078,0.612,2,3,2,674912,1532,123791,2465,0.012134076796350273,0.6167125344008006
6079,0.6121,3,2,3,674914,1530,123794,2462,0.012118235965023445,0.6167334669338678
6080,0.6122,4,5,4,674919,1525,123798,2458,0.012078633886706375,0.6171227717800652
6081,0.6123,2,2,2,674921,1523,123800,2456,0.012062793055379547,0.617240512691631
6082,0.6124,2,2,2,674923,1521,123802,2454,0.012046952224052719,0.6173584905660378
6083,0.6125,3,1,3,674924,1520,123805,2451,0.012039031808389304,0.6172248803827751
6084,0.6126,3,4,3,674928,1516,123808,2448,0.012007350145735647,0.6175580221997982
6085,0.6127,3,2,3,674930,1514,123811,2445,0.01199150931440882,0.6175801970194493
6086,0.6128,5,2,5,674932,1512,123816,2440,0.011975668483081993,0.6174089068825911
6087,0.6129,5,4,5,674936,1508,123821,2435,0.011943986820428337,0.6175500887648998
6088,0.613,4,6,4,674942,1502,123825,2431,0.011896464326447852,0.6181032290872108
6089,0.6131,1,3,1,674945,1499,123826,2430,0.01187270307945761,0.6184779842199033
6090,0.6132,4,3,4,674948,1496,123830,2426,0.011848941832467368,0.6185619581845997
6091,0.6133,1,3,1,674951,1493,123831,2425,0.011825180585477126,0.6189382337927514
6092,0.6134,0,5,0,674956,1488,123831,2425,0.011785578507160055,0.6197291081012011
6093,0.6135,2,2,2,674958,1486,123833,2423,0.011769737675833229,0.6198516244563828
6094,0.6136,1,7,1,674965,1479,123834,2422,0.011714294766189329,0.6208664445014099
6095,0.6137,4,1,4,674966,1478,123838,2418,0.011706374350525916,0.6206365503080082
6096,0.6138,3,2,3,674968,1476,123841,2415,0.011690533519199088,0.6206630686198921
6097,0.6139,2,2,2,674970,1474,123843,2413,0.01167469268787226,0.6207872395163365
6098,0.614,5,3,5,674973,1471,123848,2408,0.011650931440882018,0.6207785511729828
6099,0.6141,3,3,3,674976,1468,123851,2405,0.011627170193891775,0.6209656596953266
6100,0.6142,2,0,2,674976,1468,123853,2403,0.011627170193891775,0.620769826918109
6101,0.6143,4,2,4,674978,1466,123857,2399,0.011611329362564947,0.6206985769728331
6102,0.6144,0,1,0,674979,1465,123857,2399,0.011603408946901534,0.6208592132505176
6103,0.6145,4,4,4,674983,1461,123861,2395,0.011571727284247877,0.6211099585062241
6104,0.6146,3,2,3,674985,1459,123864,2392,0.01155588645292105,0.6211373669176837
6105,0.6147,5,1,5,674986,1458,123869,2387,0.011547966037257636,0.6208062418725617
6106,0.6148,2,0,2,674986,1458,123871,2385,0.011547966037257636,0.6206088992974239
6107,0.6149,2,6,2,674992,1452,123873,2383,0.011500443543277152,0.6213820078226858
6108,0.615,1,1,1,674993,1451,123874,2382,0.011492523127613737,0.6214453430733107
6109,0.6151,1,2,1,674995,1449,123875,2381,0.011476682296286908,0.6216710182767624
6110,0.6152,2,3,2,674998,1446,123877,2379,0.011452921049296667,0.6219607843137255
6111,0.6153,1,5,1,675003,1441,123878,2378,0.011413318970979597,0.6226760932181199
6112,0.6154,3,0,3,675003,1441,123881,2375,0.011413318970979597,0.6223794549266247
6113,0.6155,1,3,1,675006,1438,123882,2374,0.011389557723989354,0.6227701993704092
6114,0.6156,0,2,0,675008,1436,123882,2374,0.011373716892662526,0.6230971128608924
6115,0.6157,3,6,3,675014,1430,123885,2371,0.011326194398682043,0.6237832149434359
6116,0.6158,5,4,5,675018,1426,123890,2366,0.011294512736028387,0.6239451476793249
6117,0.6159,4,2,4,675020,1424,123894,2362,0.011278671904701559,0.623877443211833
6118,0.616,4,0,4,675020,1424,123898,2358,0.011278671904701559,0.6234796404019037
6119,0.6161,4,4,4,675024,1420,123902,2354,0.011246990242047903,0.6237413884472708
6120,0.6162,4,2,4,675026,1418,123906,2350,0.011231149410721075,0.6236730360934183
6121,0.6163,3,1,3,675027,1417,123909,2347,0.011223228995057661,0.623538788522848
6122,0.6164,3,2,3,675029,1415,123912,2344,0.011207388163730833,0.6235700984304337
6123,0.6165,4,0,4,675029,1415,123916,2340,0.011207388163730833,0.6231691078561917
6124,0.6166,0,2,0,675031,1413,123916,2340,0.011191547332404005,0.6235011990407674
6125,0.6167,5,6,5,675037,1407,123921,2335,0.01114402483842352,0.6239978621058258
6126,0.6168,2,1,2,675038,1406,123923,2333,0.011136104422760107,0.6239636266381385
6127,0.6169,1,0,1,675038,1406,123924,2332,0.011136104422760107,0.6238630283574104
6128,0.617,4,1,4,675039,1405,123928,2328,0.011128184007096692,0.6236271095633539
6129,0.6171,11,1,11,675040,1404,123939,2317,0.011120263591433279,0.6226820747110992
6130,0.6172,1,3,1,675043,1401,123940,2316,0.011096502344443036,0.6230831315577078
6131,0.6173,6,3,6,675046,1398,123946,2310,0.011072741097452795,0.6229773462783171
6132,0.6174,1,3,1,675049,1395,123947,2309,0.011048979850462552,0.6233801295896328
6133,0.6175,3,0,3,675049,1395,123950,2306,0.011048979850462552,0.6230748446365847
6134,0.6176,3,2,3,675051,1393,123953,2303,0.011033139019135725,0.6231060606060606
6135,0.6177,3,0,3,675051,1393,123956,2300,0.011033139019135725,0.6227998916869754
6136,0.6178,1,2,1,675053,1391,123957,2299,0.011017298187808897,0.6230352303523036
6137,0.6179,2,2,2,675055,1389,123959,2297,0.011001457356482069,0.6231687466087901
6138,0.618,0,2,0,675057,1387,123959,2297,0.01098561652515524,0.6235070575461455
6139,0.6181,4,2,4,675059,1385,123963,2293,0.010969775693828412,0.623436650353453
6140,0.6182,4,1,4,675060,1384,123967,2289,0.010961855278164997,0.6231962973046556
6141,0.6183,2,1,2,675061,1383,123969,2287,0.010953934862501584,0.6231607629427793
6142,0.6184,3,2,3,675063,1381,123972,2284,0.010938094031174756,0.6231923601637108
6143,0.6185,5,2,5,675065,1379,123977,2279,0.010922253199847928,0.6230180426462548
6144,0.6186,2,0,2,675065,1379,123979,2277,0.010922253199847928,0.6228118161925602
6145,0.6187,3,4,3,675069,1375,123982,2274,0.010890571537194272,0.6231844340915319
6146,0.6188,5,1,5,675070,1374,123987,2269,0.010882651121530858,0.6228383200658798
6147,0.6189,3,3,3,675073,1371,123990,2266,0.010858889874540615,0.6230409678306297
6148,0.619,5,1,5,675074,1370,123995,2261,0.010850969458877202,0.6226934728724869
6149,0.6191,3,3,3,675077,1367,123998,2258,0.010827208211886959,0.6228965517241379
6150,0.6192,1,3,1,675080,1364,123999,2257,0.010803446964896718,0.6233084783209059
6151,0.6193,7,2,7,675082,1362,124006,2250,0.01078760613356989,0.6229235880398671
6152,0.6194,2,5,2,675087,1357,124008,2248,0.01074800405525282,0.6235783633841886
6153,0.6195,4,1,4,675088,1356,124012,2244,0.010740083639589405,0.6233333333333333
6154,0.6196,6,1,6,675089,1355,124018,2238,0.010732163223925992,0.6228778179794044
6155,0.6197,1,1,1,675090,1354,124019,2237,0.010724242808262577,0.6229462545252019
6156,0.6198,6,2,6,675092,1352,124025,2231,0.01070840197693575,0.6226625732626291
6157,0.6199,2,4,2,675096,1348,124027,2229,0.010676720314282094,0.6231478892927034
6158,0.62,5,5,5,675101,1343,124032,2224,0.010637118235965023,0.623493131483039
6159,0.6201,0,4,0,675105,1339,124032,2224,0.010605436573311368,0.6241930957058659
6160,0.6202,1,3,1,675108,1336,124033,2223,0.010581675326321125,0.6246136555212138
6161,0.6203,4,5,4,675113,1331,124037,2219,0.010542073248004056,0.6250704225352113
6162,0.6204,1,0,1,675113,1331,124038,2218,0.010542073248004056,0.6249647788109327
6163,0.6205,4,1,4,675114,1330,124042,2214,0.01053415283234064,0.6247178329571106
6164,0.6206,4,2,4,675116,1328,124046,2210,0.010518312001013812,0.6246466930469191
6165,0.6207,2,3,2,675119,1325,124048,2208,0.010494550754023571,0.624964619303708
6166,0.6208,2,1,2,675120,1324,124050,2206,0.010486630338360158,0.624929178470255
6167,0.6209,3,1,3,675121,1323,124053,2203,0.010478709922696743,0.6247872943845717
6168,0.621,0,1,0,675122,1322,124053,2203,0.01047078950703333,0.6249645390070921
6169,0.6211,4,1,4,675123,1321,124057,2199,0.010462869091369915,0.6247159090909091
6170,0.6212,6,3,6,675126,1318,124063,2193,0.010439107844379673,0.6246083736827115
6171,0.6213,3,4,3,675130,1314,124066,2190,0.010407426181726017,0.625
6172,0.6214,2,0,2,675130,1314,124068,2188,0.010407426181726017,0.624785836664763
6173,0.6215,3,2,3,675132,1312,124071,2185,0.010391585350399189,0.6248212753788962
6174,0.6216,3,2,3,675134,1310,124074,2182,0.01037574451907236,0.6248568155784651
6175,0.6217,5,1,5,675135,1309,124079,2177,0.010367824103408948,0.6244979919678715
6176,0.6218,0,4,0,675139,1305,124079,2177,0.010336142440755291,0.625215393452039
6177,0.6219,3,4,3,675143,1301,124082,2174,0.010304460778101635,0.6256115107913669
6178,0.622,4,1,4,675144,1300,124086,2170,0.01029654036243822,0.6253602305475504
6179,0.6221,1,1,1,675145,1299,124087,2169,0.010288619946774807,0.6254325259515571
6180,0.6222,3,4,3,675149,1295,124090,2166,0.01025693828412115,0.6258306847731869
6181,0.6223,2,2,2,675151,1293,124092,2164,0.010241097452794322,0.6259762800115707
6182,0.6224,1,3,1,675154,1290,124093,2163,0.01021733620580408,0.6264118158123371
6183,0.6225,4,3,4,675157,1287,124097,2159,0.010193574958813838,0.626523505513639
6184,0.6226,1,1,1,675158,1286,124098,2158,0.010185654543150425,0.6265969802555168
6185,0.6227,2,0,2,675158,1286,124100,2156,0.010185654543150425,0.6263800116211505
6186,0.6228,2,4,2,675162,1282,124102,2154,0.010153972880496768,0.6268917345750873
6187,0.6229,2,3,2,675165,1279,124104,2152,0.010130211633506527,0.6272223841445642
6188,0.623,2,1,2,675166,1278,124106,2150,0.010122291217843112,0.6271878646441074
6189,0.6231,2,1,2,675167,1277,124108,2148,0.010114370802179699,0.6271532846715329
6190,0.6233,3,4,3,675171,1273,124111,2145,0.010082689139526042,0.6275599765944997
6191,0.6234,2,5,2,675176,1268,124113,2143,0.010043087061208973,0.6282615068894752
6192,0.6235,2,3,2,675179,1265,124115,2141,0.01001932581421873,0.6285965942454492
6193,0.6236,1,0,1,675179,1265,124116,2140,0.01001932581421873,0.6284875183553598
6194,0.6237,5,0,5,675179,1265,124121,2135,0.01001932581421873,0.6279411764705882
6195,0.6238,9,1,9,675180,1264,124130,2126,0.010011405398555316,0.6271386430678466
6196,0.6239,3,4,3,675184,1260,124133,2123,0.00997972373590166,0.6275495122672184
6197,0.624,5,1,5,675185,1259,124138,2118,0.009971803320238247,0.6271838910275392
6198,0.6241,2,4,2,675189,1255,124140,2116,0.00994012165758459,0.6277069118955799
6199,0.6242,2,3,2,675192,1252,124142,2114,0.009916360410594348,0.6280451574569221
6200,0.6243,2,2,2,675194,1250,124144,2112,0.00990051957926752,0.62819750148721
6201,0.6244,2,1,2,675195,1249,124146,2110,0.009892599163604106,0.6281631437927955
6202,0.6245,0,1,0,675196,1248,124146,2110,0.009884678747940691,0.6283502084574152
6203,0.6246,6,0,6,675196,1248,124152,2104,0.009884678747940691,0.6276849642004774
6204,0.6247,4,4,4,675200,1244,124156,2100,0.009852997085287037,0.6279904306220095
6205,0.6248,3,0,3,675200,1244,124159,2097,0.009852997085287037,0.6276563903023047
6206,0.6249,6,1,6,675201,1243,124165,2091,0.009845076669623622,0.6271745650869825
6207,0.625,1,1,1,675202,1242,124166,2090,0.009837156253960208,0.6272509003601441
6208,0.6251,3,1,3,675203,1241,124169,2087,0.009829235838296793,0.6271033653846154
6209,0.6252,0,1,0,675204,1240,124169,2087,0.00982131542263338,0.6272918545235948
6210,0.6253,1,3,1,675207,1237,124170,2086,0.009797554175643137,0.6277460126391815
6211,0.6254,1,0,1,675207,1237,124171,2085,0.009797554175643137,0.627633955448525
6212,0.6255,2,2,2,675209,1235,124173,2083,0.009781713344316309,0.6277878239903556
6213,0.6256,4,1,4,675210,1234,124177,2079,0.009773792928652896,0.6275279203139149
6214,0.6257,3,1,3,675211,1233,124180,2076,0.00976587251298948,0.6273798730734361
6215,0.6258,2,4,2,675215,1229,124182,2074,0.009734190850335826,0.6279140175597941
6216,0.6259,3,0,3,675215,1229,124185,2071,0.009734190850335826,0.6275757575757576
6217,0.626,1,3,1,675218,1226,124186,2070,0.009710429603345583,0.6280339805825242
6218,0.6261,4,3,4,675221,1223,124190,2066,0.009686668356355342,0.6281544542414108
6219,0.6262,2,4,2,675225,1219,124192,2064,0.009654986693701685,0.6286932683521169
6220,0.6263,3,0,3,675225,1219,124195,2061,0.009654986693701685,0.6283536585365853
6221,0.6264,1,4,1,675229,1215,124196,2060,0.009623305031048029,0.6290076335877862
6222,0.6265,3,1,3,675230,1214,124199,2057,0.009615384615384616,0.6288596759400795
6223,0.6266,5,2,5,675232,1212,124204,2052,0.009599543784057788,0.6286764705882353
6224,0.6267,3,1,3,675233,1211,124207,2049,0.009591623368394373,0.6285276073619632
6225,0.6268,0,2,0,675235,1209,124207,2049,0.009575782537067545,0.6289134438305709
6226,0.6269,0,1,0,675236,1208,124207,2049,0.009567862121404131,0.6291065397605158
6227,0.627,2,2,2,675238,1206,124209,2047,0.009552021290077303,0.6292652935751614
6228,0.6271,2,2,2,675240,1204,124211,2045,0.009536180458750475,0.6294244382887042
6229,0.6272,3,1,3,675241,1203,124214,2042,0.009528260043087062,0.6292758089368259
6230,0.6273,3,2,3,675243,1201,124217,2039,0.009512419211760234,0.629320987654321
6231,0.6274,1,1,1,675244,1200,124218,2038,0.009504498796096819,0.6294008647313156
6232,0.6275,5,2,5,675246,1198,124223,2033,0.00948865796476999,0.6292169606932838
6233,0.6276,3,0,3,675246,1198,124226,2030,0.00948865796476999,0.6288723667905824
6234,0.6277,6,3,6,675249,1195,124232,2024,0.00946489671777975,0.6287666977322149
6235,0.6278,3,2,3,675251,1193,124235,2021,0.009449055886452921,0.6288114499066584
6236,0.6279,5,1,5,675252,1192,124240,2016,0.009441135470789508,0.628428927680798
6237,0.628,2,3,2,675255,1189,124242,2014,0.009417374223799265,0.6287855135810178
6238,0.6281,4,1,4,675256,1188,124246,2010,0.009409453808135852,0.6285178236397748
6239,0.6282,4,2,4,675258,1186,124250,2006,0.009393612976809023,0.6284461152882206
6240,0.6283,3,1,3,675259,1185,124253,2003,0.009385692561145608,0.6282936010037641
6241,0.6284,3,3,3,675262,1182,124256,2000,0.009361931314155367,0.6285355122564424
6242,0.6285,4,5,4,675267,1177,124260,1996,0.009322329235838298,0.6290576741254333
6243,0.6286,0,2,0,675269,1175,124260,1996,0.00930648840451147,0.629454430778934
6244,0.6287,5,4,5,675273,1171,124265,1991,0.009274806741857813,0.6296647691334598
6245,0.6288,2,1,2,675274,1170,124267,1989,0.009266886326194398,0.6296296296296297
6246,0.6289,3,1,3,675275,1169,124270,1986,0.009258965910530985,0.6294770206022187
6247,0.629,2,4,2,675279,1165,124272,1984,0.009227284247877329,0.6300412829469673
6248,0.6291,1,4,1,675283,1161,124273,1983,0.009195602585223672,0.6307251908396947
6249,0.6292,1,0,1,675283,1161,124274,1982,0.009195602585223672,0.630607699650016
6250,0.6293,0,3,0,675286,1158,124274,1982,0.009171841338233431,0.6312101910828025
6251,0.6294,4,3,4,675289,1155,124278,1978,0.009148080091243188,0.6313437599744653
6252,0.6295,1,1,1,675290,1154,124279,1977,0.009140159675579775,0.6314276588949217
6253,0.6296,2,3,2,675293,1151,124281,1975,0.009116398428589533,0.6317978246960972
6254,0.6297,3,0,3,675293,1151,124284,1972,0.009116398428589533,0.6314441242395132
6255,0.6298,2,2,2,675295,1149,124286,1970,0.009100557597262705,0.6316126963770439
6256,0.6299,4,1,4,675296,1148,124290,1966,0.00909263718159929,0.6313423249839435
6257,0.63,4,1,4,675297,1147,124294,1962,0.009084716765935877,0.6310710839498231
6258,0.6301,0,4,0,675301,1143,124294,1962,0.00905303510328222,0.6318840579710145
6259,0.6302,1,3,1,675304,1140,124295,1961,0.009029273856291977,0.6323766526926797
6260,0.6303,5,2,5,675306,1138,124300,1956,0.009013433024965151,0.632191338073691
6261,0.6304,3,1,3,675307,1137,124303,1953,0.009005512609301736,0.6320388349514563
6262,0.6305,1,2,1,675309,1135,124304,1952,0.008989671777974908,0.6323291221250404
6263,0.6306,4,2,4,675311,1133,124308,1948,0.00897383094664808,0.6322622525154171
6264,0.6307,1,0,1,675311,1133,124309,1947,0.00897383094664808,0.6321428571428571
6265,0.6308,0,4,0,675315,1129,124309,1947,0.008942149283994423,0.63296488946684
6266,0.6309,4,1,4,675316,1128,124313,1943,0.00893422886833101,0.6326929338977532
6267,0.631,3,1,3,675317,1127,124316,1940,0.008926308452667595,0.6325399413107271
6268,0.6311,3,1,3,675318,1126,124319,1937,0.008918388037004182,0.6323865491348352
6269,0.6312,1,3,1,675321,1123,124320,1936,0.00889462679001394,0.6328865642366787
6270,0.6314,1,4,1,675325,1119,124321,1935,0.008862945127360284,0.6335952848722987
6271,0.6315,5,2,5,675327,1117,124326,1930,0.008847104296033456,0.6334099113882508
6272,0.6316,4,0,4,675327,1117,124330,1926,0.008847104296033456,0.6329280315478146
6273,0.6317,2,0,2,675327,1117,124332,1924,0.008847104296033456,0.6326866162446564
6274,0.6318,6,3,6,675330,1114,124338,1918,0.008823343049043213,0.6325857519788918
6275,0.6319,3,0,3,675330,1114,124341,1915,0.008823343049043213,0.632221855397821
6276,0.632,2,2,2,675332,1112,124343,1913,0.008807502217716385,0.632396694214876
6277,0.6321,1,1,1,675333,1111,124344,1912,0.008799581802052972,0.6324842871319881
6278,0.6322,4,0,4,675333,1111,124348,1908,0.008799581802052972,0.6319973501159324
6279,0.6323,2,0,2,675333,1111,124350,1906,0.008799581802052972,0.6317533974146503
6280,0.6324,0,2,0,675335,1109,124350,1906,0.008783740970726144,0.6321724709784411
6281,0.6325,3,2,3,675337,1107,124353,1903,0.008767900139399315,0.6322259136212625
6282,0.6326,3,1,3,675338,1106,124356,1900,0.008759979723735902,0.6320691949434465
6283,0.6327,2,2,2,675340,1104,124358,1898,0.008744138892409074,0.6322451698867422
6284,0.6329,0,3,0,675343,1101,124358,1898,0.008720377645418831,0.6328776258752917
6285,0.633,7,2,7,675345,1099,124365,1891,0.008704536814092003,0.6324414715719063
6286,0.6331,2,2,2,675347,1097,124367,1889,0.008688695982765176,0.6326188881446752
6287,0.6332,1,6,1,675353,1091,124368,1888,0.008641173488784692,0.6337697213830145
6288,0.6333,4,1,4,675354,1090,124372,1884,0.008633253073121277,0.6334902488231339
6289,0.6334,4,4,4,675358,1086,124376,1880,0.00860157141046762,0.6338503034389751
6290,0.6335,3,2,3,675360,1084,124379,1877,0.008585730579140794,0.6339074636946977
6291,0.6336,1,1,1,675361,1083,124380,1876,0.00857781016347738,0.6339979722879351
6292,0.6337,3,3,3,675364,1080,124383,1873,0.008554048916487138,0.634270233660684
6293,0.6338,5,2,5,675366,1078,124388,1868,0.00853820808516031,0.6340801086218602
6294,0.6339,3,0,3,675366,1078,124391,1865,0.00853820808516031,0.6337071015970098
6295,0.634,3,3,3,675369,1075,124394,1862,0.008514446838170067,0.6339802519577801
6296,0.6341,3,4,3,675373,1071,124397,1859,0.008482765175516412,0.6344709897610922
6297,0.6342,2,2,2,675375,1069,124399,1857,0.008466924344189584,0.6346548188653451
6298,0.6343,3,1,3,675376,1068,124402,1854,0.008459003928526169,0.6344969199178645
6299,0.6344,1,6,1,675382,1062,124403,1853,0.008411481434545684,0.6356775300171527
6300,0.6345,4,1,4,675383,1061,124407,1849,0.008403561018882271,0.6353951890034364
6301,0.6346,2,2,2,675385,1059,124409,1847,0.008387720187555443,0.6355815554026153
6302,0.6347,3,1,3,675386,1058,124412,1844,0.00837979977189203,0.6354238456237078
6303,0.6348,8,1,8,675387,1057,124420,1836,0.008371879356228615,0.6346353266505358
6304,0.6349,3,4,3,675391,1053,124423,1833,0.008340197693574958,0.6351351351351351
6305,0.635,6,3,6,675394,1050,124429,1827,0.008316436446584717,0.635036496350365
6306,0.6351,3,0,3,675394,1050,124432,1824,0.008316436446584717,0.6346555323590815
6307,0.6352,3,2,3,675396,1048,124435,1821,0.008300595615257889,0.6347159288950854
6308,0.6353,1,1,1,675397,1047,124436,1820,0.008292675199594474,0.634809905824904
6309,0.6354,4,1,4,675398,1046,124440,1816,0.00828475478393106,0.6345213137665968
6310,0.6355,4,1,4,675399,1045,124444,1812,0.008276834368267646,0.6342317115855792
6311,0.6356,1,1,1,675400,1044,124445,1811,0.008268913952604233,0.6343257443082312
6312,0.6357,3,1,3,675401,1043,124448,1808,0.00826099353694082,0.6341634514205542
6313,0.6358,2,3,2,675404,1040,124450,1806,0.008237232289950576,0.634574841883345
6314,0.6359,4,1,4,675405,1039,124454,1802,0.008229311874287163,0.6342837029215065
6315,0.636,1,1,1,675406,1038,124455,1801,0.008221391458623748,0.6343783022190912
6316,0.6362,2,2,2,675408,1036,124457,1799,0.00820555062729692,0.6345679012345679
6317,0.6363,3,0,3,675408,1036,124460,1796,0.00820555062729692,0.634180790960452
6318,0.6364,1,4,1,675412,1032,124461,1795,0.008173868964643264,0.6349487088786699
6319,0.6365,3,4,3,675416,1028,124464,1792,0.008142187301989609,0.6354609929078014
6320,0.6366,5,3,5,675419,1025,124469,1787,0.008118426054999366,0.6354907539118065
6321,0.6367,6,0,6,675419,1025,124475,1781,0.008118426054999366,0.6347113328581611
6322,0.6368,4,0,4,675419,1025,124479,1777,0.008118426054999366,0.6341898643825838
6323,0.6369,4,1,4,675420,1024,124483,1773,0.008110505639335953,0.6338934572756525
6324,0.637,3,0,3,675420,1024,124486,1770,0.008110505639335953,0.6335003579098067
6325,0.6371,1,4,1,675424,1020,124487,1769,0.008078823976682296,0.6342775188239512
6326,0.6372,0,3,0,675427,1017,124487,1769,0.008055062729692055,0.6349605168700646
6327,0.6373,3,2,3,675429,1015,124490,1766,0.008039221898365227,0.6350233728874506
6328,0.6374,0,2,0,675431,1013,124490,1766,0.008023381067038399,0.6354803886290032
6329,0.6375,2,3,2,675434,1010,124492,1764,0.007999619820048156,0.6359048305695746
6330,0.6376,2,0,2,675434,1010,124494,1762,0.007999619820048156,0.6356421356421357
6331,0.6377,4,4,4,675438,1006,124498,1758,0.0079679381573945,0.6360347322720694
6332,0.6378,1,0,1,675438,1006,124499,1757,0.0079679381573945,0.6359030039811798
6333,0.6379,3,1,3,675439,1005,124502,1754,0.007960017741731086,0.6357375860819138
6334,0.638,1,2,1,675441,1003,124503,1753,0.007944176910404258,0.636066763425254
6335,0.6381,3,0,3,675441,1003,124506,1750,0.007944176910404258,0.6356701779876498
6336,0.6382,6,0,6,675441,1003,124512,1744,0.007944176910404258,0.634874408445577
6337,0.6383,4,1,4,675442,1002,124516,1740,0.007936256494740845,0.6345733041575492
6338,0.6384,1,1,1,675443,1001,124517,1739,0.00792833607907743,0.6346715328467153
6339,0.6385,0,1,0,675444,1000,124517,1739,0.007920415663414017,0.6349032493610807
6340,0.6386,5,2,5,675446,998,124522,1734,0.007904574832087188,0.6346998535871157
6341,0.6387,4,1,4,675447,997,124526,1730,0.007896654416423773,0.6343967730106344
6342,0.6388,4,0,4,675447,997,124530,1726,0.007896654416423773,0.6338597135512303
6343,0.6389,3,3,3,675450,994,124533,1723,0.007872893169433532,0.6341553183658447
6344,0.639,1,3,1,675453,991,124534,1722,0.00784913192244329,0.6347217102838186
6345,0.6391,6,2,6,675455,989,124540,1716,0.007833291091116463,0.6343807763401109
6346,0.6392,1,1,1,675456,988,124541,1715,0.007825370675453048,0.6344802071772105
6347,0.6393,1,2,1,675458,986,124542,1714,0.007809529844126219,0.6348148148148148
6348,0.6394,2,2,2,675460,984,124544,1712,0.007793689012799392,0.6350148367952523
6349,0.6395,3,1,3,675461,983,124547,1709,0.007785768597135978,0.6348439821693908
6350,0.6396,5,2,5,675463,981,124552,1704,0.00776992776580915,0.6346368715083799
6351,0.6397,2,1,2,675464,980,124554,1702,0.007762007350145736,0.6346010439970171
6352,0.6398,4,5,4,675469,975,124558,1698,0.007722405271828665,0.6352413019079686
6353,0.6399,1,1,1,675470,974,124559,1697,0.007714484856165251,0.6353425683264695
6354,0.64,1,0,1,675470,974,124560,1696,0.007714484856165251,0.6352059925093633
6355,0.6401,1,3,1,675473,971,124561,1695,0.00769072360917501,0.6357839459864967
6356,0.6402,5,3,5,675476,968,124566,1690,0.007666962362184768,0.63581640331076
6357,0.6403,3,2,3,675478,966,124569,1687,0.0076511215308579395,0.6358839050131926
6358,0.6404,2,1,2,675479,965,124571,1685,0.0076432011151945254,0.6358490566037736
6359,0.6405,2,2,2,675481,963,124573,1683,0.007627360283867697,0.6360544217687075
6360,0.6406,4,2,4,675483,961,124577,1679,0.007611519452540869,0.6359848484848485
6361,0.6407,2,2,2,675485,959,124579,1677,0.007595678621214041,0.6361911987860395
6362,0.6408,3,3,3,675488,956,124582,1674,0.0075719173742238,0.6365019011406844
6363,0.6409,3,1,3,675489,955,124585,1671,0.0075639969585603855,0.6363290175171363
6364,0.641,2,1,2,675490,954,124587,1669,0.007556076542896971,0.6362943194815097
6365,0.6411,1,1,1,675491,953,124588,1668,0.007548156127233557,0.6363983212514307
6366,0.6412,1,2,1,675493,951,124589,1667,0.007532315295906729,0.6367456073338427
6367,0.6413,2,2,2,675495,949,124591,1665,0.007516474464579901,0.6369548584544759
6368,0.6414,3,1,3,675496,948,124594,1662,0.007508554048916487,0.6367816091954023
6369,0.6415,3,1,3,675497,947,124597,1659,0.007500633633253073,0.6366078280890253
6370,0.6416,2,0,2,675497,947,124599,1657,0.007500633633253073,0.6363287250384024
6371,0.6417,0,3,0,675500,944,124599,1657,0.0074768723862628315,0.6370626682045367
6372,0.6418,1,1,1,675501,943,124600,1656,0.007468951970599417,0.6371681415929203
6373,0.6419,3,1,3,675502,942,124603,1653,0.007461031554936003,0.6369942196531792
6374,0.642,0,3,0,675505,939,124603,1653,0.007437270307945761,0.6377314814814815
6375,0.6421,2,2,2,675507,937,124605,1651,0.007421429476618933,0.6379443585780525
6376,0.6422,4,3,4,675510,934,124609,1647,0.007397668229628691,0.6381247578457963
6377,0.6423,1,1,1,675511,933,124610,1646,0.007389747813965277,0.638231872818922
6378,0.6424,3,2,3,675513,931,124613,1643,0.007373906982638449,0.6383061383061384
6379,0.6425,2,1,2,675514,930,124615,1641,0.007365986566975035,0.6382730455075846
6380,0.6426,3,1,3,675515,929,124618,1638,0.007358066151311621,0.638098948188547
6381,0.6427,3,4,3,675519,925,124621,1635,0.007326384488657965,0.638671875
6382,0.6428,1,0,1,675519,925,124622,1634,0.007326384488657965,0.6385306760453302
6383,0.6429,1,2,1,675521,923,124623,1633,0.007310543657331137,0.6388888888888888
6384,0.643,3,2,3,675523,921,124626,1630,0.0072947028260043085,0.6389651117208938
6385,0.6431,0,3,0,675526,918,124626,1630,0.007270941579014066,0.6397174254317112
6386,0.6432,1,2,1,675528,916,124627,1629,0.007255100747687239,0.6400785854616896
6387,0.6433,4,2,4,675530,914,124631,1625,0.007239259916360411,0.6400157542339504
6388,0.6434,5,0,5,675530,914,124636,1620,0.007239259916360411,0.6393054459352802
6389,0.6435,5,2,5,675532,912,124641,1615,0.007223419085033583,0.6390977443609023
6390,0.6436,2,0,2,675532,912,124643,1613,0.007223419085033583,0.6388118811881188
6391,0.6437,2,3,2,675535,909,124645,1611,0.00719965783804334,0.6392857142857142
6392,0.6438,4,1,4,675536,908,124649,1607,0.007191737422379926,0.6389662027833002
6393,0.6439,6,2,6,675538,906,124655,1601,0.007175896591053098,0.6386118867171918
6394,0.644,4,2,4,675540,904,124659,1597,0.007160055759726271,0.6385445821671332
6395,0.6441,2,0,2,675540,904,124661,1595,0.007160055759726271,0.6382553021208484
6396,0.6442,3,2,3,675542,902,124664,1592,0.007144214928399443,0.6383319967923016
6397,0.6443,2,0,2,675542,902,124666,1590,0.007144214928399443,0.6380417335473515
6398,0.6444,4,0,4,675542,902,124670,1586,0.007144214928399443,0.637459807073955
6399,0.6445,2,2,2,675544,900,124672,1584,0.0071283740970726145,0.6376811594202898
6400,0.6446,1,0,1,675544,900,124673,1583,0.0071283740970726145,0.6375352396294804
6401,0.6447,2,2,2,675546,898,124675,1581,0.007112533265745786,0.6377571601452199
6402,0.6448,1,1,1,675547,897,124676,1580,0.007104612850082372,0.6378683891804602
6403,0.6449,2,1,2,675548,896,124678,1578,0.007096692434418958,0.6378334680679062
6404,0.645,2,1,2,675549,895,124680,1576,0.007088772018755544,0.6377984621610684
6405,0.6451,3,0,3,675549,895,124683,1573,0.007088772018755544,0.6373581847649918
6406,0.6452,2,0,2,675549,895,124685,1571,0.007088772018755544,0.6370640713706407
6407,0.6454,2,4,2,675553,891,124687,1569,0.007057090356101888,0.6378048780487805
6408,0.6455,5,2,5,675555,889,124692,1564,0.0070412495247750605,0.6375866286180187
6409,0.6456,2,4,2,675559,885,124694,1562,0.007009567862121404,0.638332652227217
6410,0.6457,2,1,2,675560,884,124696,1560,0.00700164744645799,0.6382978723404256
6411,0.6458,1,2,1,675562,882,124697,1559,0.006985806615131162,0.6386726751331422
6412,0.6459,0,1,0,675563,881,124697,1559,0.006977886199467748,0.6389344262295082
6413,0.646,3,2,3,675565,879,124700,1556,0.00696204536814092,0.6390143737166324
6414,0.6461,4,2,4,675567,877,124704,1552,0.006946204536814092,0.638946068340881
6415,0.6462,1,1,1,675568,876,124705,1551,0.006938284121150678,0.6390605686032138
6416,0.6463,2,0,2,675568,876,124707,1549,0.006938284121150678,0.6387628865979381
6417,0.6464,2,3,2,675571,873,124709,1547,0.006914522874160436,0.6392561983471075
6418,0.6465,4,0,4,675571,873,124713,1543,0.006914522874160436,0.6386589403973509
6419,0.6466,6,0,6,675571,873,124719,1537,0.006914522874160436,0.637759336099585
6420,0.6467,2,2,2,675573,871,124721,1535,0.006898682042833608,0.6379883624272652
6421,0.6468,3,1,3,675574,870,124724,1532,0.006890761627170194,0.6378018318068276
6422,0.6469,2,1,2,675575,869,124726,1530,0.00688284121150678,0.637765735723218
6423,0.647,1,2,1,675577,867,124727,1529,0.006867000380179952,0.6381469115191987
6424,0.6471,2,2,2,675579,865,124729,1527,0.0068511595488531234,0.6383779264214047
6425,0.6472,3,0,3,675579,865,124732,1524,0.0068511595488531234,0.6379238174968606
6426,0.6473,4,2,4,675581,863,124736,1520,0.006835318717526296,0.6378514477549307
6427,0.6474,2,1,2,675582,862,124738,1518,0.006827398301862882,0.6378151260504201
6428,0.6475,3,1,3,675583,861,124741,1515,0.006819477886199468,0.6376262626262627
6429,0.6476,1,2,1,675585,859,124742,1514,0.00680363705487264,0.6380109565950274
6430,0.6477,2,1,2,675586,858,124744,1512,0.006795716639209226,0.6379746835443038
6431,0.6478,2,2,2,675588,856,124746,1510,0.006779875807882398,0.6382079459002535
6432,0.6479,1,0,1,675588,856,124747,1509,0.006779875807882398,0.6380549682875264
6433,0.648,2,0,2,675588,856,124749,1507,0.006779875807882398,0.637748624629708
6434,0.6481,1,1,1,675589,855,124750,1506,0.0067719553922189835,0.6378653113087674
6435,0.6483,2,1,2,675590,854,124752,1504,0.006764034976555569,0.6378286683630195
6436,0.6484,2,0,2,675590,854,124754,1502,0.006764034976555569,0.6375212224108658
6437,0.6485,1,3,1,675593,851,124755,1501,0.006740273729565327,0.6381802721088435
6438,0.6486,5,1,5,675594,850,124760,1496,0.006732353313901914,0.6376811594202898
6439,0.6487,1,1,1,675595,849,124761,1495,0.0067244328982385,0.6377986348122867
6440,0.6488,5,1,5,675596,848,124766,1490,0.006716512482575086,0.6372968349016254
6441,0.6489,2,1,2,675597,847,124768,1488,0.006708592066911672,0.6372591006423983
6442,0.649,1,3,1,675600,844,124769,1487,0.0066848308199214295,0.6379236379236379
6443,0.6491,0,2,0,675602,842,124769,1487,0.006668989988594601,0.6384714469729498
6444,0.6492,2,0,2,675602,842,124771,1485,0.006668989988594601,0.6381607219596046
6445,0.6493,2,1,2,675603,841,124773,1483,0.006661069572931187,0.6381239242685026
6446,0.6494,3,4,3,675607,837,124776,1480,0.006629387910277532,0.6387570133793699
6447,0.6495,2,3,2,675610,834,124778,1478,0.0066056266632872895,0.639273356401384
6448,0.6496,2,2,2,675612,832,124780,1476,0.006589785831960461,0.6395147313691508
6449,0.6497,2,2,2,675614,830,124782,1474,0.006573945000633633,0.6397569444444444
6450,0.6498,1,1,1,675615,829,124783,1473,0.006566024584970219,0.6398783666377064
6451,0.6499,2,0,2,675615,829,124785,1471,0.006566024584970219,0.6395652173913043
6452,0.65,3,3,3,675618,826,124788,1468,0.006542263337979977,0.6399302528334786
6453,0.6501,4,1,4,675619,825,124792,1464,0.006534342922316563,0.6395806028833552
6454,0.6502,3,0,3,675619,825,124795,1461,0.006534342922316563,0.6391076115485564
6455,0.6503,1,3,1,675622,822,124796,1460,0.0065105816753263214,0.6397896581945661
6456,0.6504,2,3,2,675625,819,124798,1458,0.006486820428336079,0.6403162055335968
6457,0.6505,3,2,3,675627,817,124801,1455,0.006470979597009251,0.6404049295774648
6458,0.6506,5,1,5,675628,816,124806,1450,0.006463059181345837,0.6398940864960282
6459,0.6507,1,1,1,675629,815,124807,1449,0.006455138765682423,0.640017667844523
6460,0.6508,4,1,4,675630,814,124811,1445,0.006447218350019009,0.6396635679504206
6461,0.6509,5,1,5,675631,813,124816,1440,0.006439297934355595,0.6391478029294274
6462,0.651,4,0,4,675631,813,124820,1436,0.006439297934355595,0.6385060026678524
6463,0.6511,1,1,1,675632,812,124821,1435,0.006431377518692181,0.6386292834890965
6464,0.6512,6,4,6,675636,808,124827,1429,0.006399695856038525,0.6388019669199821
6465,0.6513,3,1,3,675637,807,124830,1426,0.006391775440375111,0.638602776533811
6466,0.6514,4,1,4,675638,806,124834,1422,0.006383855024711697,0.6382405745062837
6467,0.6515,1,1,1,675639,805,124835,1421,0.006375934609048283,0.6383647798742138
6468,0.6516,1,1,1,675640,804,124836,1420,0.006368014193384869,0.6384892086330936
6469,0.6517,2,3,2,675643,801,124838,1418,0.006344252946394627,0.6390265885534024
6470,0.6518,2,2,2,675645,799,124840,1416,0.0063284121150677984,0.6392776523702032
6471,0.6519,4,1,4,675646,798,124844,1412,0.006320491699404384,0.6389140271493212
6472,0.652,3,3,3,675649,795,124847,1409,0.006296730452414143,0.6392921960072595
6473,0.6521,3,3,3,675652,792,124850,1406,0.006272969205423901,0.6396724294813467
6474,0.6522,1,1,1,675653,791,124851,1405,0.006265048789760487,0.6397996357012751
6475,0.6523,4,0,4,675653,791,124855,1401,0.006265048789760487,0.6391423357664233
6476,0.6524,1,0,1,675653,791,124856,1400,0.006265048789760487,0.6389776357827476
6477,0.6525,4,1,4,675654,790,124860,1396,0.006257128374097073,0.6386093321134492
6478,0.6526,3,3,3,675657,787,124863,1393,0.00623336712710683,0.6389908256880734
6479,0.6527,4,2,4,675659,785,124867,1389,0.006217526295780002,0.6389144434222631
6480,0.6528,2,1,2,675660,784,124869,1387,0.006209605880116588,0.6388760939659143
6481,0.6529,4,2,4,675662,782,124873,1383,0.006193765048789761,0.6387990762124711
6482,0.653,0,1,0,675663,781,124873,1383,0.006185844633126347,0.63909426987061
6483,0.6531,1,2,1,675665,779,124874,1382,0.0061700038017995186,0.6395187413234613
6484,0.6533,0,1,0,675666,778,124874,1382,0.0061620833861361045,0.6398148148148148
6485,0.6534,3,1,3,675667,777,124877,1379,0.00615416297047269,0.6396103896103896
6486,0.6535,0,1,0,675668,776,124877,1379,0.006146242554809276,0.6399071925754061
6487,0.6536,3,0,3,675668,776,124880,1376,0.006146242554809276,0.6394052044609665
6488,0.6537,6,2,6,675670,774,124886,1370,0.006130401723482448,0.6389925373134329
6489,0.6538,1,0,1,675670,774,124887,1369,0.006130401723482448,0.6388240783947737
6490,0.654,2,3,2,675673,771,124889,1367,0.006106640476492206,0.6393826005612722
6491,0.6541,5,0,5,675673,771,124894,1362,0.006106640476492206,0.6385372714486639
6492,0.6542,2,1,2,675674,770,124896,1360,0.006098720060828793,0.6384976525821596
6493,0.6543,1,1,1,675675,769,124897,1359,0.006090799645165379,0.6386278195488722
6494,0.6544,2,2,2,675677,767,124899,1357,0.0060749588138385505,0.6388888888888888
6495,0.6545,2,2,2,675679,765,124901,1355,0.006059117982511722,0.6391509433962265
6496,0.6546,2,0,2,675679,765,124903,1353,0.006059117982511722,0.6388101983002833
6497,0.6547,3,0,3,675679,765,124906,1350,0.006059117982511722,0.6382978723404256
6498,0.6548,1,1,1,675680,764,124907,1349,0.006051197566848308,0.6384287742546143
6499,0.6549,1,1,1,675681,763,124908,1348,0.006043277151184894,0.6385599242065372
6500,0.655,4,2,4,675683,761,124912,1344,0.006027436319858066,0.638479809976247
6501,0.6551,1,2,1,675685,759,124913,1343,0.006011595488531238,0.6389153187440533
6502,0.6552,4,2,4,675687,757,124917,1339,0.00599575465720441,0.6388358778625954
6503,0.6553,3,3,3,675690,754,124920,1336,0.005971993410214168,0.6392344497607656
6504,0.6554,1,4,1,675694,750,124921,1335,0.005940311747560512,0.6402877697841727
6505,0.6555,3,2,3,675696,748,124924,1332,0.005924470916233684,0.6403846153846153
6506,0.6556,2,4,2,675700,744,124926,1330,0.0058927892535800275,0.6412729026036644
6507,0.6557,3,1,3,675701,743,124929,1327,0.005884868837916614,0.6410628019323672
6508,0.6558,1,2,1,675703,741,124930,1326,0.005869028006589786,0.6415094339622641
6509,0.6559,0,3,0,675706,738,124930,1326,0.005845266759599544,0.6424418604651163
6510,0.656,2,1,2,675707,737,124932,1324,0.00583734634393613,0.6424065987384765
6511,0.6561,1,1,1,675708,736,124933,1323,0.005829425928272716,0.6425449247207382
6512,0.6562,2,1,2,675709,735,124935,1321,0.005821505512609302,0.6425097276264592
6513,0.6563,3,0,3,675709,735,124938,1318,0.005821505512609302,0.6419873356064296
6514,0.6564,2,2,2,675711,733,124940,1316,0.0058056646812824735,0.6422645192776965
6515,0.6566,4,0,4,675711,733,124944,1312,0.0058056646812824735,0.6415647921760391
6516,0.6567,3,2,3,675713,731,124947,1309,0.005789823849955645,0.6416666666666667
6517,0.6568,3,0,3,675713,731,124950,1306,0.005789823849955645,0.6411389297987237
6518,0.6569,3,1,3,675714,730,124953,1303,0.005781903434292232,0.6409247417609444
6519,0.657,4,2,4,675716,728,124957,1299,0.005766062602965404,0.6408485446472619
6520,0.6571,1,2,1,675718,726,124958,1298,0.005750221771638576,0.6413043478260869
6521,0.6572,3,0,3,675718,726,124961,1295,0.005750221771638576,0.640771895101435
6522,0.6573,1,1,1,675719,725,124962,1294,0.005742301355975162,0.640911342248638
6523,0.6574,1,1,1,675720,724,124963,1293,0.005734380940311748,0.6410510659395141
6524,0.6575,5,1,5,675721,723,124968,1288,0.0057264605246483335,0.6404773744405768
6525,0.6576,1,0,1,675721,723,124969,1287,0.0057264605246483335,0.6402985074626866
6526,0.6577,2,2,2,675723,721,124971,1285,0.005710619693321505,0.6405782652043869
6527,0.6578,1,2,1,675725,719,124972,1284,0.005694778861994677,0.6410384423364952
6528,0.6579,2,2,2,675727,717,124974,1282,0.005678938030667849,0.6413206603301651
6529,0.658,3,1,3,675728,716,124977,1279,0.005671017615004436,0.6411027568922306
6530,0.6581,2,2,2,675730,714,124979,1277,0.005655176783677608,0.6413862380713209
6531,0.6582,1,2,1,675732,712,124980,1276,0.0056393359523507795,0.641851106639839
6532,0.6583,1,2,1,675734,710,124981,1275,0.005623495121023951,0.6423173803526449
6533,0.6584,2,0,2,675734,710,124983,1273,0.005623495121023951,0.6419566313666163
6534,0.6585,2,5,2,675739,705,124985,1271,0.005583893042706881,0.6432186234817814
6535,0.6586,1,1,1,675740,704,124986,1270,0.005575972627043467,0.6433637284701115
6536,0.6587,1,2,1,675742,702,124987,1269,0.0055601317957166396,0.6438356164383562
6537,0.6588,6,0,6,675742,702,124993,1263,0.0055601317957166396,0.6427480916030535
6538,0.6589,2,5,2,675747,697,124995,1261,0.005520529717399569,0.6440245148110316
6539,0.659,5,1,5,675748,696,125000,1256,0.005512609301736155,0.6434426229508197
6540,0.6591,0,2,0,675750,694,125000,1256,0.005496768470409327,0.6441025641025641
6541,0.6592,3,5,3,675755,689,125003,1253,0.005457166392092257,0.645211122554068
6542,0.6593,2,3,2,675758,686,125005,1251,0.005433405145102015,0.645844088797109
6543,0.6594,2,3,2,675761,683,125007,1249,0.005409643898111773,0.6464803312629399
6544,0.6595,0,4,0,675765,679,125007,1249,0.0053779622354581166,0.6478215767634855
6545,0.6596,3,2,3,675767,677,125010,1246,0.005362121404131288,0.6479459178367135
6546,0.6597,1,0,1,675767,677,125011,1245,0.005362121404131288,0.6477627471383975
6547,0.6599,3,2,3,675769,675,125014,1242,0.005346280572804461,0.647887323943662
6548,0.66,0,2,0,675771,673,125014,1242,0.005330439741477633,0.6485639686684073
6549,0.6601,3,0,3,675771,673,125017,1239,0.005330439741477633,0.6480125523012552
6550,0.6602,1,1,1,675772,672,125018,1238,0.005322519325814219,0.6481675392670158
6551,0.6603,1,0,1,675772,672,125019,1237,0.005322519325814219,0.6479832372970141
6552,0.6604,7,1,7,675773,671,125026,1230,0.005314598910150805,0.6470278800631246
6553,0.6605,1,1,1,675774,670,125027,1229,0.005306678494487391,0.6471827277514481
6554,0.6606,6,0,6,675774,670,125033,1223,0.005306678494487391,0.6460644479661912
6555,0.6607,2,2,2,675776,668,125035,1221,0.0052908376631605625,0.6463737427210164
6556,0.6608,1,2,1,675778,666,125036,1220,0.005274996831833734,0.6468716861081655
6557,0.6609,2,0,2,675778,666,125038,1218,0.005274996831833734,0.6464968152866242
6558,0.661,2,3,2,675781,663,125040,1216,0.005251235584843493,0.6471527408195848
6559,0.6611,1,0,1,675781,663,125041,1215,0.005251235584843493,0.646964856230032
6560,0.6612,3,0,3,675781,663,125044,1212,0.005251235584843493,0.6464
6561,0.6613,2,0,2,675781,663,125046,1210,0.005251235584843493,0.6460224239188468
6562,0.6614,1,2,1,675783,661,125047,1209,0.005235394753516665,0.646524064171123
6563,0.6615,1,2,1,675785,659,125048,1208,0.005219553922189837,0.647027316550616
6564,0.6616,3,1,3,675786,658,125051,1205,0.005211633506526423,0.6468062265163714
6565,0.6617,5,2,5,675788,656,125056,1200,0.0051957926751995944,0.646551724137931
6566,0.6618,2,4,2,675792,652,125058,1198,0.005164111012545938,0.6475675675675676
6567,0.6619,1,2,1,675794,650,125059,1197,0.00514827018121911,0.6480779642663779
6568,0.6621,1,2,1,675796,648,125060,1196,0.005132429349892283,0.648590021691974
6569,0.6622,2,1,2,675797,647,125062,1194,0.005124508934228869,0.6485605649103748
6570,0.6623,2,2,2,675799,645,125064,1192,0.00510866810290204,0.6488840500816548
6571,0.6624,2,1,2,675800,644,125066,1190,0.005100747687238626,0.648854961832061
6572,0.6625,2,2,2,675802,642,125068,1188,0.005084906855911798,0.6491803278688525
6573,0.6626,1,0,1,675802,642,125069,1187,0.005084906855911798,0.6489885183160197
6574,0.6627,0,1,0,675803,641,125069,1187,0.005076986440248384,0.649343544857768
6575,0.6628,2,1,2,675804,640,125071,1185,0.00506906602458497,0.6493150684931507
6576,0.6629,3,0,3,675804,640,125074,1182,0.00506906602458497,0.6487376509330406
6577,0.663,1,2,1,675806,638,125075,1181,0.005053225193258142,0.6492578339747114
6578,0.6631,1,1,1,675807,637,125076,1180,0.005045304777594728,0.6494221243808476
6579,0.6632,2,2,2,675809,635,125078,1178,0.0050294639462679005,0.6497517926089355
6580,0.6633,0,4,0,675813,631,125078,1178,0.004997782283614244,0.6511885019347706
6581,0.6634,1,1,1,675814,630,125079,1177,0.00498986186795083,0.6513558384061982
6582,0.6635,4,2,4,675816,628,125083,1173,0.004974021036624002,0.6513048306496391
6583,0.6637,3,1,3,675817,627,125086,1170,0.004966100620960588,0.6510851419031719
6584,0.6638,1,3,1,675820,624,125087,1169,0.004942339373970346,0.6519799219185722
6585,0.6639,2,0,2,675820,624,125089,1167,0.004942339373970346,0.6515912897822446
6586,0.664,1,1,1,675821,623,125090,1166,0.0049344189583069315,0.6517607602012297
6587,0.6641,1,1,1,675822,622,125091,1165,0.004926498542643518,0.6519306099608282
6588,0.6642,1,3,1,675825,619,125092,1164,0.004902737295653276,0.6528323051037577
6589,0.6643,2,0,2,675825,619,125094,1162,0.004902737295653276,0.652442448062886
6590,0.6644,2,0,2,675825,619,125096,1160,0.004902737295653276,0.6520517144463182
6591,0.6645,1,4,1,675829,615,125097,1159,0.00487105563299962,0.653325817361894
6592,0.6647,1,0,1,675829,615,125098,1158,0.00487105563299962,0.6531302876480541
6593,0.6648,3,0,3,675829,615,125101,1155,0.00487105563299962,0.652542372881356
6594,0.6649,3,2,3,675831,613,125104,1152,0.004855214801672792,0.6526912181303116
6595,0.665,5,2,5,675833,611,125109,1147,0.004839373970345963,0.6524459613196815
6596,0.6652,1,0,1,675833,611,125110,1146,0.004839373970345963,0.6522481502561184
6597,0.6653,1,0,1,675833,611,125111,1145,0.004839373970345963,0.6520501138952164
6598,0.6654,3,3,3,675836,608,125114,1142,0.004815612723355722,0.6525714285714286
6599,0.6655,3,1,3,675837,607,125117,1139,0.004807692307692308,0.652348224513173
6600,0.6656,1,2,1,675839,605,125118,1138,0.00479185147636548,0.6528973034997131
6601,0.6658,2,0,2,675839,605,125120,1136,0.00479185147636548,0.652498564043653
6602,0.6659,1,1,1,675840,604,125121,1135,0.004783931060702066,0.652673950546291
6603,0.666,3,0,3,675840,604,125124,1132,0.004783931060702066,0.652073732718894
6604,0.6661,0,3,0,675843,601,125124,1132,0.0047601698137118235,0.6532025389497981
6605,0.6662,2,1,2,675844,600,125126,1130,0.004752249398048409,0.653179190751445
6606,0.6663,4,1,4,675845,599,125130,1126,0.004744328982384995,0.6527536231884058
6607,0.6664,1,0,1,675845,599,125131,1125,0.004744328982384995,0.6525522041763341
6608,0.6665,3,0,3,675845,599,125134,1122,0.004744328982384995,0.6519465427077281
6609,0.6666,1,1,1,675846,598,125135,1121,0.004736408566721581,0.6521233275159977
6610,0.6667,0,1,0,675847,597,125135,1121,0.004728488151058167,0.6525029103608847
6611,0.6668,0,2,0,675849,595,125135,1121,0.00471264731973134,0.6532634032634033
6612,0.6669,1,1,1,675850,594,125136,1120,0.004704726904067926,0.6534422403733956
6613,0.667,2,1,2,675851,593,125138,1118,0.004696806488404512,0.6534190531852718
6614,0.6671,4,0,4,675851,593,125142,1114,0.004696806488404512,0.6526069127123608
6615,0.6672,4,1,4,675852,592,125146,1110,0.004688886072741098,0.6521739130434783
6616,0.6673,2,1,2,675853,591,125148,1108,0.0046809656570776835,0.6521483225426722
6617,0.6674,2,2,2,675855,589,125150,1106,0.004665124825750855,0.6525073746312684
6618,0.6675,3,1,3,675856,588,125153,1103,0.004657204410087441,0.6522767593140154
6619,0.6676,0,1,0,675857,587,125153,1103,0.004649283994424027,0.6526627218934912
6620,0.6677,3,2,3,675859,585,125156,1100,0.004633443163097199,0.6528189910979229
6621,0.6678,3,0,3,675859,585,125159,1097,0.004633443163097199,0.6521997621878716
6622,0.6679,2,2,2,675861,583,125161,1095,0.004617602331770371,0.6525625744934446
6623,0.668,3,1,3,675862,582,125164,1092,0.004609681916106958,0.6523297491039427
6624,0.6681,2,0,2,675862,582,125166,1090,0.004609681916106958,0.6519138755980861
6625,0.6682,2,3,2,675865,579,125168,1088,0.0045859206691167154,0.6526694661067787
6626,0.6683,1,2,1,675867,577,125169,1087,0.004570079837789887,0.6532451923076923
6627,0.6684,1,2,1,675869,575,125170,1086,0.004554239006463059,0.6538229981938591
6628,0.6685,2,0,2,675869,575,125172,1084,0.004554239006463059,0.6534056660638939
6629,0.6686,5,1,5,675870,574,125177,1079,0.004546318590799645,0.6527525710828797
6630,0.6687,1,0,1,675870,574,125178,1078,0.004546318590799645,0.652542372881356
6631,0.6688,1,2,1,675872,572,125179,1077,0.004530477759472817,0.6531231049120679
6632,0.6689,2,2,2,675874,570,125181,1075,0.004514636928145989,0.6534954407294833
6633,0.669,0,3,0,675877,567,125181,1075,0.004490875681155747,0.6546894031668696
6634,0.6691,3,1,3,675878,566,125184,1072,0.004482955265492333,0.6544566544566545
6635,0.6692,1,0,1,675878,566,125185,1071,0.004482955265492333,0.6542455711667685
6636,0.6693,3,0,3,675878,566,125188,1068,0.004482955265492333,0.653610771113831
6637,0.6694,0,1,0,675879,565,125188,1068,0.004475034849828919,0.6540110226576853
6638,0.6695,3,3,3,675882,562,125191,1065,0.004451273602838677,0.6545789797172711
6639,0.6696,1,2,1,675884,560,125192,1064,0.004435432771511849,0.6551724137931034
6640,0.6697,1,0,1,675884,560,125193,1063,0.004435432771511849,0.6549599507085644
6641,0.6698,0,2,0,675886,558,125193,1063,0.004419591940185021,0.6557680444170265
6642,0.6699,2,0,2,675886,558,125195,1061,0.004419591940185021,0.6553428042001236
6643,0.67,4,3,4,675889,555,125199,1057,0.004395830693194779,0.6557071960297767
6644,0.6701,1,0,1,675889,555,125200,1056,0.004395830693194779,0.6554934823091247
6645,0.6702,2,2,2,675891,553,125202,1054,0.004379989861867951,0.65588052271313
6646,0.6703,3,3,3,675894,550,125205,1051,0.004356228614877709,0.6564647095565271
6647,0.6704,1,0,1,675894,550,125206,1050,0.004356228614877709,0.65625
6648,0.6706,1,0,1,675894,550,125207,1049,0.004356228614877709,0.6560350218886805
6649,0.6707,1,1,1,675895,549,125208,1048,0.004348308199214295,0.6562304320601127
6650,0.6708,3,1,3,675896,548,125211,1045,0.004340387783550881,0.6559949780288763
6651,0.6709,2,0,2,675896,548,125213,1043,0.004340387783550881,0.6555625392834695
6652,0.671,2,2,2,675898,546,125215,1041,0.0043245469522240525,0.6559546313799622
6653,0.6711,0,2,0,675900,544,125215,1041,0.004308706120897224,0.656782334384858
6654,0.6712,1,2,1,675902,542,125216,1040,0.004292865289570397,0.6573957016434893
6655,0.6713,3,0,3,675902,542,125219,1037,0.004292865289570397,0.6567447751741609
6656,0.6714,1,1,1,675903,541,125220,1036,0.004284944873906983,0.6569435637285986
6657,0.6715,2,0,2,675903,541,125222,1034,0.004284944873906983,0.6565079365079365
6658,0.6716,1,0,1,675903,541,125223,1033,0.004284944873906983,0.656289707750953
6659,0.6717,2,1,2,675904,540,125225,1031,0.004277024458243569,0.6562698917886697
6660,0.6718,2,3,2,675907,537,125227,1029,0.004253263211253327,0.657088122605364
6661,0.6719,3,4,3,675911,533,125230,1026,0.00422158154859967,0.6581141757536882
6662,0.672,2,2,2,675913,531,125232,1024,0.004205740717272842,0.6585209003215434
6663,0.6722,1,1,1,675914,530,125233,1023,0.004197820301609428,0.6587250482936252
6664,0.6723,2,2,2,675916,528,125235,1021,0.004181979470282601,0.6591349257585539
6665,0.6724,1,1,1,675917,527,125236,1020,0.004174059054619187,0.6593406593406593
6666,0.6725,2,0,2,675917,527,125238,1018,0.004174059054619187,0.6588996763754046
6667,0.6726,3,2,3,675919,525,125241,1015,0.0041582182232923585,0.6590909090909091
6668,0.6727,1,2,1,675921,523,125242,1014,0.00414237739196553,0.6597267404033832
6669,0.6728,3,0,3,675921,523,125245,1011,0.00414237739196553,0.6590612777053455
6670,0.6729,0,3,0,675924,520,125245,1011,0.004118616144975288,0.6603527106466361
6671,0.673,1,0,1,675924,520,125246,1010,0.004118616144975288,0.6601307189542484
6672,0.6731,1,0,1,675924,520,125247,1009,0.004118616144975288,0.6599084368868542
6673,0.6732,4,2,4,675926,518,125251,1005,0.00410277531364846,0.659881812212738
6674,0.6733,3,3,3,675929,515,125254,1002,0.004079014066658219,0.6605141727092947
6675,0.6734,1,1,1,675930,514,125255,1001,0.0040710936509948045,0.6607260726072607
6676,0.6735,2,1,2,675931,513,125257,999,0.0040631732353313904,0.6607142857142857
6677,0.6736,0,1,0,675932,512,125257,999,0.004055252819667976,0.6611515552614163
6678,0.6737,2,2,2,675934,510,125259,997,0.004039411988341148,0.661579296615793
6679,0.6738,2,2,2,675936,508,125261,995,0.00402357115701432,0.6620093147039254
6680,0.6739,3,1,3,675937,507,125264,992,0.004015650741350906,0.6617745163442295
6681,0.674,2,1,2,675938,506,125266,990,0.004007730325687492,0.6617647058823529
6682,0.6741,1,0,1,675938,506,125267,989,0.004007730325687492,0.6615384615384615
6683,0.6742,0,1,0,675939,505,125267,989,0.003999809910024078,0.6619812583668006
6684,0.6744,5,2,5,675941,503,125272,984,0.00398396907869725,0.6617350369872226
6685,0.6746,1,0,1,675941,503,125273,983,0.00398396907869725,0.6615074024226111
6686,0.6747,3,0,3,675941,503,125276,980,0.00398396907869725,0.6608226567768037
6687,0.6748,1,1,1,675942,502,125277,979,0.003976048663033836,0.6610398379473329
6688,0.6749,1,3,1,675945,499,125278,978,0.003952287416043594,0.6621530128639134
6689,0.675,4,3,4,675948,496,125282,974,0.003928526169053352,0.6625850340136055
6690,0.6751,0,1,0,675949,495,125282,974,0.003920605753389938,0.6630360789652825
6691,0.6752,3,0,3,675949,495,125285,971,0.003920605753389938,0.6623465211459755
6692,0.6753,2,2,2,675951,493,125287,969,0.0039047649220631097,0.6627906976744186
6693,0.6754,5,0,5,675951,493,125292,964,0.0039047649220631097,0.6616334934797529
6694,0.6755,2,2,2,675953,491,125294,962,0.003888924090736282,0.6620784583620096
6695,0.6756,1,0,1,675953,491,125295,961,0.003888924090736282,0.6618457300275482
6696,0.6757,6,2,6,675955,489,125301,955,0.003873083259409454,0.6613573407202216
6697,0.6758,2,2,2,675957,487,125303,953,0.0038572424280826256,0.6618055555555555
6698,0.6759,1,1,1,675958,486,125304,952,0.0038493220124192116,0.6620305980528511
6699,0.676,2,3,2,675961,483,125306,950,0.0038255607654289698,0.6629448709002094
6700,0.6761,1,0,1,675961,483,125307,949,0.0038255607654289698,0.6627094972067039
6701,0.6762,2,0,2,675961,483,125309,947,0.0038255607654289698,0.6622377622377622
6702,0.6763,1,1,1,675962,482,125310,946,0.0038176403497655557,0.6624649859943977
6703,0.6764,2,0,2,675962,482,125312,944,0.0038176403497655557,0.6619915848527349
6704,0.6765,4,0,4,675962,482,125316,940,0.0038176403497655557,0.6610407876230661
6705,0.6766,2,0,2,675962,482,125318,938,0.0038176403497655557,0.6605633802816901
6706,0.6768,2,1,2,675963,481,125320,936,0.0038097199341021416,0.6605504587155964
6707,0.6769,1,0,1,675963,481,125321,935,0.0038097199341021416,0.6603107344632768
6708,0.677,1,1,1,675964,480,125322,934,0.0038017995184387275,0.6605374823196606
6709,0.6771,3,0,3,675964,480,125325,931,0.0038017995184387275,0.6598157335223246
6710,0.6772,2,1,2,675965,479,125327,929,0.0037938791027753134,0.6598011363636364
6711,0.6773,3,0,3,675965,479,125330,926,0.0037938791027753134,0.6590747330960854
6712,0.6774,1,1,1,675966,478,125331,925,0.0037859586871119,0.6593014967925873
6713,0.6775,0,3,0,675969,475,125331,925,0.0037621974401216575,0.6607142857142857
6714,0.6776,4,1,4,675970,474,125335,921,0.0037542770244582435,0.6602150537634408
6715,0.6777,1,0,1,675970,474,125336,920,0.0037542770244582435,0.6599713055954088
6716,0.6778,0,1,0,675971,473,125336,920,0.0037463566087948294,0.6604450825556353
6717,0.6779,4,1,4,675972,472,125340,916,0.0037384361931314157,0.659942363112392
6718,0.6781,1,1,1,675973,471,125341,915,0.0037305157774680017,0.6601731601731602
6719,0.6782,1,0,1,675973,471,125342,914,0.0037305157774680017,0.6599277978339351
6720,0.6783,1,0,1,675973,471,125343,913,0.0037305157774680017,0.6596820809248555
6721,0.6784,2,0,2,675973,471,125345,911,0.0037305157774680017,0.6591895803183792
6722,0.6785,6,1,6,675974,470,125351,905,0.0037225953618045876,0.6581818181818182
6723,0.6786,1,1,1,675975,469,125352,904,0.0037146749461411735,0.6584122359796067
6724,0.6787,0,3,0,675978,466,125352,904,0.0036909136991509313,0.6598540145985401
6725,0.6788,2,0,2,675978,466,125354,902,0.0036909136991509313,0.6593567251461988
6726,0.6789,3,0,3,675978,466,125357,899,0.0036909136991509313,0.6586080586080586
6727,0.679,1,2,1,675980,464,125358,898,0.0036750728678241035,0.6593245227606461
6728,0.6792,1,0,1,675980,464,125359,897,0.0036750728678241035,0.6590742101396032
6729,0.6793,1,1,1,675981,463,125360,896,0.0036671524521606894,0.659308314937454
6730,0.6794,1,0,1,675981,463,125361,895,0.0036671524521606894,0.6590574374079529
6731,0.6795,2,0,2,675981,463,125363,893,0.0036671524521606894,0.6585545722713865
6732,0.6796,1,1,1,675982,462,125364,892,0.0036592320364972754,0.6587887740029542
6733,0.6797,2,1,2,675983,461,125366,890,0.0036513116208338613,0.6587712805329385
6734,0.6798,1,2,1,675985,459,125367,889,0.003635470789507033,0.6594955489614244
6735,0.6799,4,0,4,675985,459,125371,885,0.003635470789507033,0.6584821428571429
6736,0.68,2,1,2,675986,458,125373,883,0.0036275503738436195,0.6584638329604773
6737,0.6801,0,1,0,675987,457,125373,883,0.0036196299581802054,0.658955223880597
6738,0.6802,2,1,2,675988,456,125375,881,0.0036117095425167913,0.6589379207180255
6739,0.6803,1,0,1,675988,456,125376,880,0.0036117095425167913,0.6586826347305389
6740,0.6804,4,1,4,675989,455,125380,876,0.0036037891268533772,0.6581517655897822
6741,0.6805,1,1,1,675990,454,125381,875,0.003595868711189963,0.6583897667419112
6742,0.6806,1,0,1,675990,454,125382,874,0.003595868711189963,0.6581325301204819
6743,0.6807,2,1,2,675991,453,125384,872,0.003587948295526549,0.6581132075471698
6744,0.6808,2,1,2,675992,452,125386,870,0.0035800278798631354,0.6580937972768532
6745,0.6809,1,0,1,675992,452,125387,869,0.0035800278798631354,0.6578349735049205
6746,0.681,1,0,1,675992,452,125388,868,0.0035800278798631354,0.6575757575757576
6747,0.6811,2,0,2,675992,452,125390,866,0.0035800278798631354,0.6570561456752656
6748,0.6813,2,0,2,675992,452,125392,864,0.0035800278798631354,0.6565349544072948
6749,0.6814,1,1,1,675993,451,125393,863,0.0035721074641997213,0.6567732115677322
6750,0.6815,1,1,1,675994,450,125394,862,0.0035641870485363073,0.6570121951219512
6751,0.6816,0,3,0,675997,447,125394,862,0.003540425801546065,0.6585179526355996
6752,0.6817,3,0,3,675997,447,125397,859,0.003540425801546065,0.6577335375191424
6753,0.6818,1,0,1,675997,447,125398,858,0.003540425801546065,0.6574712643678161
6754,0.6819,2,1,2,675998,446,125400,856,0.003532505385882651,0.6574500768049155
6755,0.682,1,2,1,676000,444,125401,855,0.003516664554555823,0.6581986143187067
6756,0.6821,1,0,1,676000,444,125402,854,0.003516664554555823,0.6579352850539292
6757,0.6822,3,1,3,676001,443,125405,851,0.003508744138892409,0.6576506955177743
6758,0.6823,2,2,2,676003,441,125407,849,0.003492903307565581,0.6581395348837209
6759,0.6824,0,2,0,676005,439,125407,849,0.003477062476238753,0.6591614906832298
6760,0.6825,2,0,2,676005,439,125409,847,0.003477062476238753,0.6586314152410575
6761,0.6826,2,0,2,676005,439,125411,845,0.003477062476238753,0.6580996884735203
6762,0.6827,1,2,1,676007,437,125412,844,0.003461221644911925,0.6588602654176424
6763,0.6828,1,0,1,676007,437,125413,843,0.003461221644911925,0.65859375
6764,0.6829,1,0,1,676007,437,125414,842,0.003461221644911925,0.6583268178264269
6765,0.683,0,1,0,676008,436,125414,842,0.003453301229248511,0.6588419405320813
6766,0.6831,2,0,2,676008,436,125416,840,0.003453301229248511,0.658307210031348
6767,0.6832,1,2,1,676010,434,125417,839,0.003437460397921683,0.6590730557737627
6768,0.6833,1,1,1,676011,433,125418,838,0.0034295399822582688,0.6593233674272226
6769,0.6834,4,0,4,676011,433,125422,834,0.0034295399822582688,0.6582478295185478
6770,0.6836,3,1,3,676012,432,125425,831,0.003421619566594855,0.6579572446555819
6771,0.6837,5,1,5,676013,431,125430,826,0.003413699150931441,0.6571201272871917
6772,0.6838,1,1,1,676014,430,125431,825,0.003405778735268027,0.6573705179282868
6773,0.6839,2,1,2,676015,429,125433,823,0.003397858319604613,0.6573482428115016
6774,0.684,2,0,2,676015,429,125435,821,0.003397858319604613,0.6568
6775,0.6841,2,0,2,676015,429,125437,819,0.003397858319604613,0.65625
6776,0.6843,2,0,2,676015,429,125439,817,0.003397858319604613,0.6556982343499197
6777,0.6844,2,2,2,676017,427,125441,815,0.0033820174882777847,0.6561996779388084
6778,0.6845,2,2,2,676019,425,125443,813,0.003366176656950957,0.6567043618739903
6779,0.6846,2,1,2,676020,424,125445,811,0.003358256241287543,0.6566801619433198
6780,0.6848,1,3,1,676023,421,125446,810,0.0033344949942973007,0.6580016246953696
6781,0.6849,4,3,4,676026,418,125450,806,0.003310733747307059,0.6584967320261438
6782,0.685,2,3,2,676029,415,125452,804,0.0032869725003168166,0.6595570139458573
6783,0.6851,5,0,5,676029,415,125457,799,0.0032869725003168166,0.658154859967051
6784,0.6852,2,0,2,676029,415,125459,797,0.0032869725003168166,0.6575907590759076
6785,0.6853,0,2,0,676031,413,125459,797,0.0032711316689899884,0.6586776859504132
6786,0.6854,2,3,2,676034,410,125461,795,0.0032473704219997466,0.6597510373443983
6787,0.6855,2,2,2,676036,408,125463,793,0.0032315295906729185,0.6602830974188176
6788,0.6856,1,1,1,676037,407,125464,792,0.0032236091750095044,0.6605504587155964
6789,0.6857,2,0,2,676037,407,125466,790,0.0032236091750095044,0.6599832915622389
6790,0.6858,4,1,4,676038,406,125470,786,0.0032156887593460903,0.6593959731543624
6791,0.6859,1,2,1,676040,404,125471,785,0.0031998479280192626,0.6602186711522288
6792,0.686,1,2,1,676042,402,125472,784,0.0031840070966924344,0.6610455311973018
6793,0.6861,2,1,2,676043,401,125474,782,0.0031760866810290203,0.6610312764158918
6794,0.6862,6,1,6,676044,400,125480,776,0.0031681662653656063,0.6598639455782312
6795,0.6865,0,2,0,676046,398,125480,776,0.0031523254340387785,0.6609880749574105
6796,0.6866,4,2,4,676048,396,125484,772,0.0031364846027119504,0.660958904109589
6797,0.6868,2,0,2,676048,396,125486,770,0.0031364846027119504,0.660377358490566
6798,0.6869,3,2,3,676050,394,125489,767,0.003120643771385122,0.6606373815676141
6799,0.687,2,1,2,676051,393,125491,765,0.003112723355721708,0.6606217616580311
6800,0.6874,3,0,3,676051,393,125494,762,0.003112723355721708,0.6597402597402597
6801,0.6875,0,2,0,676053,391,125494,762,0.0030968825243948804,0.6608846487424112
6802,0.6876,1,0,1,676053,391,125495,761,0.0030968825243948804,0.6605902777777778
6803,0.6877,0,1,0,676054,390,125495,761,0.0030889621087314663,0.6611642050390965
6804,0.6879,2,0,2,676054,390,125497,759,0.0030889621087314663,0.660574412532637
6805,0.688,1,1,1,676055,389,125498,758,0.0030810416930680522,0.6608544027898866
6806,0.6881,1,2,1,676057,387,125499,757,0.003065200861741224,0.6617132867132867
6807,0.6882,1,1,1,676058,386,125500,756,0.00305728044607781,0.6619964973730298
6808,0.6883,0,3,0,676061,383,125500,756,0.003033519199087568,0.6637401229148375
6809,0.6885,4,0,4,676061,383,125504,752,0.003033519199087568,0.6625550660792952
6810,0.6886,1,2,1,676063,381,125505,751,0.00301767836776074,0.6634275618374559
6811,0.6887,0,1,0,676064,380,125505,751,0.003009757952097326,0.6640141467727675
6812,0.6888,4,1,4,676065,379,125509,747,0.003001837536433912,0.6634103019538188
6813,0.6889,1,0,1,676065,379,125510,746,0.003001837536433912,0.6631111111111111
6814,0.689,0,1,0,676066,378,125510,746,0.0029939171207704982,0.6637010676156584
6815,0.6891,1,0,1,676066,378,125511,745,0.0029939171207704982,0.6634016028495102
6816,0.6892,1,0,1,676066,378,125512,744,0.0029939171207704982,0.6631016042780749
6817,0.6893,2,0,2,676066,378,125514,742,0.0029939171207704982,0.6625
6818,0.6894,2,1,2,676067,377,125516,740,0.002985996705107084,0.6624888093106536
6819,0.6895,0,2,0,676069,375,125516,740,0.002970155873780256,0.6636771300448431
6820,0.6897,0,1,0,676070,374,125516,740,0.002962235458116842,0.6642728904847397
6821,0.6898,0,1,0,676071,373,125516,740,0.002954315042453428,0.6648697214734951
6822,0.6899,2,0,2,676071,373,125518,738,0.002954315042453428,0.6642664266426642
6823,0.69,0,1,0,676072,372,125518,738,0.0029463946267900137,0.6648648648648648
6824,0.6901,1,0,1,676072,372,125519,737,0.0029463946267900137,0.6645626690712354
6825,0.6902,0,1,0,676073,371,125519,737,0.0029384742111266,0.6651624548736462
6826,0.6903,0,1,0,676074,370,125519,737,0.002930553795463186,0.6657633242999097
6827,0.6904,2,0,2,676074,370,125521,735,0.002930553795463186,0.665158371040724
6828,0.6905,3,2,3,676076,368,125524,732,0.002914712964136358,0.6654545454545454
6829,0.6906,1,1,1,676077,367,125525,731,0.0029067925484729438,0.6657559198542805
6830,0.6907,1,1,1,676078,366,125526,730,0.0028988721328095297,0.666058394160584
6831,0.6908,0,1,0,676079,365,125526,730,0.002890951717146116,0.6666666666666666
6832,0.6909,3,2,3,676081,363,125529,727,0.002875110885819288,0.6669724770642201
6833,0.691,2,1,2,676082,362,125531,725,0.002867190470155874,0.6669733210671573
6834,0.6911,0,1,0,676083,361,125531,725,0.0028592700544924597,0.6675874769797422
6835,0.6912,2,0,2,676083,361,125533,723,0.0028592700544924597,0.6669741697416974
6836,0.6913,0,1,0,676084,360,125533,723,0.0028513496388290456,0.667590027700831
6837,0.6914,0,2,0,676086,358,125533,723,0.002835508807502218,0.6688251618871416
6838,0.6915,1,2,1,676088,356,125534,722,0.0028196679761753897,0.6697588126159555
6839,0.6916,0,1,0,676089,355,125534,722,0.0028117475605119757,0.6703806870937791
6840,0.6917,2,1,2,676090,354,125536,720,0.0028038271448485616,0.6703910614525139
6841,0.6918,2,1,2,676091,353,125538,718,0.0027959067291851475,0.6704014939309056
6842,0.692,1,1,1,676092,352,125539,717,0.0027879863135217334,0.6707202993451824
6843,0.6921,3,0,3,676092,352,125542,714,0.0027879863135217334,0.6697936210131332
6844,0.6922,2,4,2,676096,348,125544,712,0.0027563046508680775,0.6716981132075471
6845,0.6923,2,1,2,676097,347,125546,710,0.0027483842352046635,0.6717123935666982
6846,0.6924,1,1,1,676098,346,125547,709,0.0027404638195412494,0.6720379146919432
6847,0.6925,3,1,3,676099,345,125550,706,0.0027325434038778353,0.6717411988582302
6848,0.6926,1,1,1,676100,344,125551,705,0.0027246229882144216,0.6720686367969495
6849,0.6928,3,0,3,676100,344,125554,702,0.0027246229882144216,0.6711281070745698
6850,0.693,0,1,0,676101,343,125554,702,0.0027167025725510076,0.6717703349282297
6851,0.6932,2,0,2,676101,343,125556,700,0.0027167025725510076,0.6711409395973155
6852,0.6933,1,1,1,676102,342,125557,699,0.0027087821568875935,0.6714697406340058
6853,0.6934,0,1,0,676103,341,125557,699,0.0027008617412241794,0.6721153846153847
6854,0.6935,1,1,1,676104,340,125558,698,0.0026929413255607653,0.6724470134874759
6855,0.6936,1,1,1,676105,339,125559,697,0.0026850209098973512,0.6727799227799228
6856,0.6937,4,1,4,676106,338,125563,693,0.0026771004942339376,0.6721629485935985
6857,0.6938,1,1,1,676107,337,125564,692,0.0026691800785705235,0.6724975704567542
6858,0.6941,1,0,1,676107,337,125565,691,0.0026691800785705235,0.6721789883268483
6859,0.6943,0,1,0,676108,336,125565,691,0.0026612596629071094,0.6728334956183057
6860,0.6945,2,0,2,676108,336,125567,689,0.0026612596629071094,0.6721951219512196
6861,0.6946,3,1,3,676109,335,125570,686,0.0026533392472436954,0.6718903036238981
6862,0.6948,3,0,3,676109,335,125573,683,0.0026533392472436954,0.6709233791748527
6863,0.6949,1,1,1,676110,334,125574,682,0.0026454188315802813,0.6712598425196851
6864,0.6951,1,1,1,676111,333,125575,681,0.002637498415916867,0.6715976331360947
6865,0.6952,1,2,1,676113,331,125576,680,0.0026216575845900395,0.6726013847675568
6866,0.6953,1,0,1,676113,331,125577,679,0.0026216575845900395,0.6722772277227723
6867,0.6954,3,0,3,676113,331,125580,676,0.0026216575845900395,0.6713008937437934
6868,0.6955,1,0,1,676113,331,125581,675,0.0026216575845900395,0.6709741550695825
6869,0.6956,0,1,0,676114,330,125581,675,0.0026137371689266254,0.6716417910447762
6870,0.6957,1,1,1,676115,329,125582,674,0.0026058167532632113,0.6719840478564307
6871,0.6958,1,0,1,676115,329,125583,673,0.0026058167532632113,0.6716566866267465
6872,0.6959,0,1,0,676116,328,125583,673,0.0025978963375997972,0.6723276723276723
6873,0.696,1,1,1,676117,327,125584,672,0.002589975921936383,0.6726726726726727
6874,0.6961,2,1,2,676118,326,125586,670,0.002582055506272969,0.6726907630522089
6875,0.6962,0,2,0,676120,324,125586,670,0.0025662146749461413,0.6740442655935613
6876,0.6963,2,0,2,676120,324,125588,668,0.0025662146749461413,0.6733870967741935
6877,0.6964,3,0,3,676120,324,125591,665,0.0025662146749461413,0.6723963599595552
6878,0.6965,1,0,1,676120,324,125592,664,0.0025662146749461413,0.6720647773279352
6879,0.6967,0,1,0,676121,323,125592,664,0.0025582942592827273,0.6727456940222898
6880,0.6968,2,2,2,676123,321,125594,662,0.002542453427955899,0.6734486266531028
6881,0.6969,3,0,3,676123,321,125597,659,0.002542453427955899,0.6724489795918367
6882,0.697,0,1,0,676124,320,125597,659,0.002534533012292485,0.6731358529111338
6883,0.6971,2,1,2,676125,319,125599,657,0.002526612596629071,0.673155737704918
6884,0.6972,1,0,1,676125,319,125600,656,0.002526612596629071,0.6728205128205128
6885,0.6973,1,2,1,676127,317,125601,655,0.002510771765302243,0.6738683127572016
6886,0.6976,2,0,2,676127,317,125603,653,0.002510771765302243,0.6731958762886598
6887,0.6979,0,1,0,676128,316,125603,653,0.002502851349638829,0.673890608875129
6888,0.698,1,2,1,676130,314,125604,652,0.002487010518312001,0.6749482401656315
6889,0.6981,0,2,0,676132,312,125604,652,0.002471169686985173,0.6763485477178424
6890,0.6982,1,0,1,676132,312,125605,651,0.002471169686985173,0.67601246105919
6891,0.6983,0,2,0,676134,310,125605,651,0.002455328855658345,0.6774193548387096
6892,0.6984,1,0,1,676134,310,125606,650,0.002455328855658345,0.6770833333333334
6893,0.6985,1,0,1,676134,310,125607,649,0.002455328855658345,0.6767466110531803
6894,0.6986,2,0,2,676134,310,125609,647,0.002455328855658345,0.6760710553814002
6895,0.6987,2,1,2,676135,309,125611,645,0.002447408439994931,0.6761006289308176
6896,0.6988,2,0,2,676135,309,125613,643,0.002447408439994931,0.6754201680672269
6897,0.6989,0,1,0,676136,308,125613,643,0.002439488024331517,0.676130389064143
6898,0.6992,2,1,2,676137,307,125615,641,0.002431567608668103,0.6761603375527426
6899,0.6993,2,1,2,676138,306,125617,639,0.0024236471930046887,0.6761904761904762
6900,0.6996,1,0,1,676138,306,125618,638,0.0024236471930046887,0.6758474576271186
6901,0.6999,1,1,1,676139,305,125619,637,0.0024157267773412747,0.6762208067940552
6902,0.7,1,0,1,676139,305,125620,636,0.0024157267773412747,0.6758767268862912
6903,0.7001,4,1,4,676140,304,125624,632,0.002407806361677861,0.6752136752136753
6904,0.7002,1,1,1,676141,303,125625,631,0.002399885946014447,0.6755888650963597
6905,0.7003,1,3,1,676144,300,125626,630,0.0023761246990242047,0.6774193548387096
6906,0.7005,1,0,1,676144,300,125627,629,0.0023761246990242047,0.6770721205597416
6907,0.7008,1,1,1,676145,299,125628,628,0.0023682042833607906,0.6774541531823085
6908,0.7009,3,1,3,676146,298,125631,625,0.002360283867697377,0.6771397616468039
6909,0.701,1,0,1,676146,298,125632,624,0.002360283867697377,0.6767895878524945
6910,0.7011,1,1,1,676147,297,125633,623,0.002352363452033963,0.6771739130434783
6911,0.7012,2,0,2,676147,297,125635,621,0.002352363452033963,0.6764705882352942
6912,0.7014,1,1,1,676148,296,125636,620,0.002344443036370549,0.6768558951965066
6913,0.7015,0,1,0,676149,295,125636,620,0.0023365226207071347,0.6775956284153005
6914,0.7016,1,0,1,676149,295,125637,619,0.0023365226207071347,0.6772428884026258
6915,0.7017,2,1,2,676150,294,125639,617,0.0023286022050437206,0.677277716794731
6916,0.7018,1,0,1,676150,294,125640,616,0.0023286022050437206,0.676923076923077
6917,0.7019,0,3,0,676153,291,125640,616,0.002304840958053479,0.679162072767365
6918,0.702,1,1,1,676154,290,125641,615,0.0022969205423900648,0.6795580110497238
6919,0.7021,0,1,0,676155,289,125641,615,0.0022890001267266507,0.6803097345132744
6920,0.7022,1,1,1,676156,288,125642,614,0.0022810797110632366,0.6807095343680709
6921,0.7024,0,1,0,676157,287,125642,614,0.0022731592953998225,0.681465038845727
6922,0.7025,3,0,3,676157,287,125645,611,0.0022731592953998225,0.6804008908685969
6923,0.7026,2,1,2,676158,286,125647,609,0.0022652388797364084,0.6804469273743017
6924,0.7027,1,1,1,676159,285,125648,608,0.0022573184640729944,0.6808510638297872
6925,0.7028,1,1,1,676160,284,125649,607,0.0022493980484095807,0.6812570145903479
6926,0.7029,0,1,0,676161,283,125649,607,0.0022414776327461666,0.6820224719101123
6927,0.703,2,1,2,676162,282,125651,605,0.0022335572170827525,0.6820744081172492
6928,0.7031,1,1,1,676163,281,125652,604,0.0022256368014193385,0.6824858757062147
6929,0.7032,1,0,1,676163,281,125653,603,0.0022256368014193385,0.6821266968325792
6930,0.7033,1,0,1,676163,281,125654,602,0.0022256368014193385,0.681766704416761
6931,0.7034,2,0,2,676163,281,125656,600,0.0022256368014193385,0.681044267877412
6932,0.7035,2,0,2,676163,281,125658,598,0.0022256368014193385,0.6803185437997725
6933,0.7036,0,4,0,676167,277,125658,598,0.0021939551387656826,0.6834285714285714
6934,0.7037,1,2,1,676169,275,125659,597,0.0021781143074388544,0.6846330275229358
6935,0.7038,0,2,0,676171,273,125659,597,0.0021622734761120263,0.6862068965517242
6936,0.704,1,0,1,676171,273,125660,596,0.0021622734761120263,0.6858457997698504
6937,0.7041,0,1,0,676172,272,125660,596,0.002154353060448612,0.6866359447004609
6938,0.7043,1,1,1,676173,271,125661,595,0.0021464326447851985,0.687066974595843
6939,0.7045,4,0,4,676173,271,125665,591,0.0021464326447851985,0.685614849187935
6940,0.7046,2,0,2,676173,271,125667,589,0.0021464326447851985,0.6848837209302325
6941,0.7047,2,0,2,676173,271,125669,587,0.0021464326447851985,0.6841491841491841
6942,0.7048,0,1,0,676174,270,125669,587,0.0021385122291217844,0.6849474912485414
6943,0.7049,1,0,1,676174,270,125670,586,0.0021385122291217844,0.6845794392523364
6944,0.705,3,0,3,676174,270,125673,583,0.0021385122291217844,0.6834701055099648
6945,0.7051,1,0,1,676174,270,125674,582,0.0021385122291217844,0.6830985915492958
6946,0.7052,0,1,0,676175,269,125674,582,0.0021305918134583704,0.6839012925969448
6947,0.7053,1,2,1,676177,267,125675,581,0.002114750982131542,0.6851415094339622
6948,0.7054,1,1,1,676178,266,125676,580,0.002106830566468128,0.6855791962174941
6949,0.7055,3,0,3,676178,266,125679,577,0.002106830566468128,0.6844602609727165
6950,0.7056,2,1,2,676179,265,125681,575,0.002098910150804714,0.6845238095238095
6951,0.7057,0,1,0,676180,264,125681,575,0.0020909897351413004,0.6853396901072706
6952,0.7058,1,1,1,676181,263,125682,574,0.0020830693194778863,0.6857825567502986
6953,0.7059,0,1,0,676182,262,125682,574,0.0020751489038144722,0.6866028708133971
6954,0.706,1,2,1,676184,260,125683,573,0.002059308072487644,0.687875150060024
6955,0.7061,1,1,1,676185,259,125684,572,0.00205138765682423,0.6883273164861613
6956,0.7062,3,2,3,676187,257,125687,569,0.0020355468254974023,0.6888619854721549
6957,0.7063,2,3,2,676190,254,125689,567,0.00201178557850716,0.6906211936662606
6958,0.7064,1,2,1,676192,252,125690,566,0.001995944747180332,0.6919315403422983
6959,0.7065,0,1,0,676193,251,125690,566,0.001988024331516918,0.6927784577723378
6960,0.7067,2,2,2,676195,249,125692,564,0.00197218350019009,0.6937269372693727
6961,0.7068,0,1,0,676196,248,125692,564,0.001964263084526676,0.6945812807881774
6962,0.7069,1,0,1,676196,248,125693,563,0.001964263084526676,0.6942046855733662
6963,0.707,1,2,1,676198,246,125694,562,0.001948422253199848,0.6955445544554455
6964,0.7071,1,0,1,676198,246,125695,561,0.001948422253199848,0.6951672862453532
6965,0.7072,1,2,1,676200,244,125696,560,0.0019325814218730199,0.6965174129353234
6966,0.7073,1,0,1,676200,244,125697,559,0.0019325814218730199,0.6961394769613948
6967,0.7074,1,0,1,676200,244,125698,558,0.0019325814218730199,0.6957605985037406
6968,0.7075,0,1,0,676201,243,125698,558,0.0019246610062096058,0.6966292134831461
6969,0.7076,1,0,1,676201,243,125699,557,0.0019246610062096058,0.69625
6970,0.7077,3,1,3,676202,242,125702,554,0.001916740590546192,0.6959798994974874
6971,0.7078,4,1,4,676203,241,125706,550,0.0019088201748827778,0.695322376738306
6972,0.7079,0,2,0,676205,239,125706,550,0.00189297934355595,0.697084917617237
6973,0.7081,0,1,0,676206,238,125706,550,0.0018850589278925358,0.6979695431472082
6974,0.7082,0,2,0,676208,236,125706,550,0.0018692180965657079,0.6997455470737913
6975,0.7083,1,0,1,676208,236,125707,549,0.0018692180965657079,0.6993630573248407
6976,0.7084,2,0,2,676208,236,125709,547,0.0018692180965657079,0.698595146871009
6977,0.7085,1,0,1,676208,236,125710,546,0.0018692180965657079,0.6982097186700768
6978,0.7086,1,2,1,676210,234,125711,545,0.0018533772652388797,0.699614890885751
6979,0.7088,1,1,1,676211,233,125712,544,0.0018454568495754656,0.7001287001287001
6980,0.7089,1,0,1,676211,233,125713,543,0.0018454568495754656,0.6997422680412371
6981,0.709,2,0,2,676211,233,125715,541,0.0018454568495754656,0.6989664082687338
6982,0.7091,1,0,1,676211,233,125716,540,0.0018454568495754656,0.6985769728331177
6983,0.7092,1,0,1,676211,233,125717,539,0.0018454568495754656,0.6981865284974094
6984,0.7093,1,0,1,676211,233,125718,538,0.0018454568495754656,0.6977950713359273
6985,0.7094,0,2,0,676213,231,125718,538,0.0018296160182486377,0.6996098829648895
6986,0.7095,0,2,0,676215,229,125718,538,0.0018137751869218097,0.7014341590612777
6987,0.7096,1,0,1,676215,229,125719,537,0.0018137751869218097,0.7010443864229765
6988,0.7097,1,2,1,676217,227,125720,536,0.0017979343555949816,0.7024901703800787
6989,0.7098,0,3,0,676220,224,125720,536,0.0017741731086047396,0.7052631578947368
6990,0.7099,2,1,2,676221,223,125722,534,0.0017662526929413255,0.7054161162483488
6991,0.7101,2,0,2,676221,223,125724,532,0.0017662526929413255,0.704635761589404
6992,0.7102,2,0,2,676221,223,125726,530,0.0017662526929413255,0.703851261620186
6993,0.7103,1,0,1,676221,223,125727,529,0.0017662526929413255,0.7034574468085106
6994,0.7104,1,1,1,676222,222,125728,528,0.0017583322772779116,0.704
6995,0.7105,0,1,0,676223,221,125728,528,0.0017504118616144975,0.7049399198931909
6996,0.711,2,1,2,676224,220,125730,526,0.0017424914459510834,0.7050938337801609
6997,0.7112,1,1,1,676225,219,125731,525,0.0017345710302876696,0.7056451612903226
6998,0.7113,1,1,1,676226,218,125732,524,0.0017266506146242555,0.706199460916442
6999,0.7114,1,1,1,676227,217,125733,523,0.0017187301989608414,0.7067567567567568
7000,0.7115,3,0,3,676227,217,125736,520,0.0017187301989608414,0.7055630936227951
7001,0.7116,1,0,1,676227,217,125737,519,0.0017187301989608414,0.7051630434782609
7002,0.7117,1,0,1,676227,217,125738,518,0.0017187301989608414,0.7047619047619048
7003,0.7118,2,2,2,676229,215,125740,516,0.0017028893676340135,0.7058823529411765
7004,0.7119,1,1,1,676230,214,125741,515,0.0016949689519705994,0.7064471879286695
7005,0.712,3,1,3,676231,213,125744,512,0.0016870485363071853,0.7062068965517241
7006,0.7122,3,0,3,676231,213,125747,509,0.0016870485363071853,0.7049861495844876
7007,0.7123,0,2,0,676233,211,125747,509,0.0016712077049803574,0.7069444444444445
7008,0.7124,1,0,1,676233,211,125748,508,0.0016712077049803574,0.7065368567454798
7009,0.7126,0,1,0,676234,210,125748,508,0.0016632872893169433,0.7075208913649025
7010,0.7127,1,0,1,676234,210,125749,507,0.0016632872893169433,0.7071129707112971
7011,0.7129,4,0,4,676234,210,125753,503,0.0016632872893169433,0.7054698457223001
7012,0.713,2,1,2,676235,209,125755,501,0.0016553668736535294,0.7056338028169014
7013,0.7132,2,0,2,676235,209,125757,499,0.0016553668736535294,0.7048022598870056
7014,0.7134,2,1,2,676236,208,125759,497,0.0016474464579901153,0.7049645390070922
7015,0.7135,1,1,1,676237,207,125760,496,0.0016395260423267013,0.705547652916074
7016,0.7136,0,1,0,676238,206,125760,496,0.0016316056266632872,0.7065527065527065
7017,0.7137,0,1,0,676239,205,125760,496,0.0016236852109998733,0.7075606276747504
7018,0.7138,1,1,1,676240,204,125761,495,0.0016157647953364592,0.7081545064377682
7019,0.7139,0,1,0,676241,203,125761,495,0.0016078443796730452,0.7091690544412608
7020,0.714,1,1,1,676242,202,125762,494,0.0015999239640096313,0.7097701149425287
7021,0.7142,0,1,0,676243,201,125762,494,0.0015920035483462172,0.7107913669064748
7022,0.7143,0,2,0,676245,199,125762,494,0.0015761627170193893,0.7128427128427128
7023,0.7144,1,0,1,676245,199,125763,493,0.0015761627170193893,0.7124277456647399
7024,0.7145,4,0,4,676245,199,125767,489,0.0015761627170193893,0.7107558139534884
7025,0.7146,1,0,1,676245,199,125768,488,0.0015761627170193893,0.710334788937409
7026,0.7147,1,0,1,676245,199,125769,487,0.0015761627170193893,0.7099125364431487
7027,0.7149,2,0,2,676245,199,125771,485,0.0015761627170193893,0.7090643274853801
7028,0.715,1,0,1,676245,199,125772,484,0.0015761627170193893,0.7086383601756955
7029,0.7151,0,1,0,676246,198,125772,484,0.0015682423013559752,0.7096774193548387
7030,0.7152,1,1,1,676247,197,125773,483,0.001560321885692561,0.7102941176470589
7031,0.7153,1,0,1,676247,197,125774,482,0.001560321885692561,0.7098674521354934
7032,0.7154,0,1,0,676248,196,125774,482,0.001552401470029147,0.7109144542772862
7033,0.7155,0,1,0,676249,195,125774,482,0.0015444810543657332,0.7119645494830132
7034,0.7156,1,1,1,676250,194,125775,481,0.001536560638702319,0.7125925925925926
7035,0.7157,1,0,1,676250,194,125776,480,0.001536560638702319,0.712166172106825
7036,0.7158,1,0,1,676250,194,125777,479,0.001536560638702319,0.711738484398217
7037,0.7159,1,1,1,676251,193,125778,478,0.001528640223038905,0.7123695976154992
7038,0.716,0,1,0,676252,192,125778,478,0.0015207198073754911,0.7134328358208956
7039,0.7161,1,0,1,676252,192,125779,477,0.0015207198073754911,0.7130044843049327
7040,0.7163,1,0,1,676252,192,125780,476,0.0015207198073754911,0.7125748502994012
7041,0.7165,3,0,3,676252,192,125783,473,0.0015207198073754911,0.7112781954887218
7042,0.7166,1,0,1,676252,192,125784,472,0.0015207198073754911,0.7108433734939759
7043,0.7167,1,0,1,676252,192,125785,471,0.0015207198073754911,0.7104072398190046
7044,0.7168,1,0,1,676252,192,125786,470,0.0015207198073754911,0.7099697885196374
7045,0.7169,1,2,1,676254,190,125787,469,0.001504878976048663,0.7116843702579666
7046,0.717,1,0,1,676254,190,125788,468,0.001504878976048663,0.7112462006079028
7047,0.7172,0,1,0,676255,189,125788,468,0.0014969585603852491,0.7123287671232876
7048,0.7174,1,0,1,676255,189,125789,467,0.0014969585603852491,0.711890243902439
7049,0.7175,1,0,1,676255,189,125790,466,0.0014969585603852491,0.7114503816793893
7050,0.7178,1,0,1,676255,189,125791,465,0.0014969585603852491,0.7110091743119266
7051,0.718,0,1,0,676256,188,125791,465,0.001489038144721835,0.7120980091883614
7052,0.7181,1,1,1,676257,187,125792,464,0.001481117729058421,0.7127496159754224
7053,0.7182,1,0,1,676257,187,125793,463,0.001481117729058421,0.7123076923076923
7054,0.7183,0,1,0,676258,186,125793,463,0.0014731973133950069,0.7134052388289677
7055,0.7184,1,0,1,676258,186,125794,462,0.0014731973133950069,0.7129629629629629
7056,0.7185,0,1,0,676259,185,125794,462,0.001465276897731593,0.714064914992272
7057,0.7186,3,0,3,676259,185,125797,459,0.001465276897731593,0.7127329192546584
7058,0.7187,2,0,2,676259,185,125799,457,0.001465276897731593,0.7118380062305296
7059,0.7188,1,0,1,676259,185,125800,456,0.001465276897731593,0.7113884555382215
7060,0.7192,2,0,2,676259,185,125802,454,0.001465276897731593,0.7104851330203443
7061,0.7193,1,0,1,676259,185,125803,453,0.001465276897731593,0.7100313479623824
7062,0.7195,2,0,2,676259,185,125805,451,0.001465276897731593,0.7091194968553459
7063,0.7197,4,0,4,676259,185,125809,447,0.001465276897731593,0.7072784810126582
7064,0.7199,2,2,2,676261,183,125811,445,0.0014494360664047648,0.7085987261146497
7065,0.72,1,0,1,676261,183,125812,444,0.0014494360664047648,0.7081339712918661
7066,0.7201,2,0,2,676261,183,125814,442,0.0014494360664047648,0.7072
7067,0.7202,1,1,1,676262,182,125815,441,0.001441515650741351,0.7078651685393258
7068,0.7203,0,1,0,676263,181,125815,441,0.001433595235077937,0.7090032154340836
7069,0.7206,0,1,0,676264,180,125815,441,0.0014256748194145228,0.7101449275362319
7070,0.7207,1,0,1,676264,180,125816,440,0.0014256748194145228,0.7096774193548387
7071,0.7208,2,0,2,676264,180,125818,438,0.0014256748194145228,0.7087378640776699
7072,0.7212,3,0,3,676264,180,125821,435,0.0014256748194145228,0.7073170731707317
7073,0.7214,2,0,2,676264,180,125823,433,0.0014256748194145228,0.7063621533442088
7074,0.7215,1,0,1,676264,180,125824,432,0.0014256748194145228,0.7058823529411765
7075,0.7216,2,0,2,676264,180,125826,430,0.0014256748194145228,0.7049180327868853
7076,0.7217,1,0,1,676264,180,125827,429,0.0014256748194145228,0.7044334975369458
7077,0.7218,1,0,1,676264,180,125828,428,0.0014256748194145228,0.7039473684210527
7078,0.7219,1,0,1,676264,180,125829,427,0.0014256748194145228,0.7034596375617792
7079,0.722,1,0,1,676264,180,125830,426,0.0014256748194145228,0.7029702970297029
7080,0.7221,0,1,0,676265,179,125830,426,0.001417754403751109,0.7041322314049587
7081,0.7222,2,1,2,676266,178,125832,424,0.0014098339880876949,0.7043189368770764
7082,0.7223,1,0,1,676266,178,125833,423,0.0014098339880876949,0.7038269550748752
7083,0.7226,1,0,1,676266,178,125834,422,0.0014098339880876949,0.7033333333333334
7084,0.7227,0,1,0,676267,177,125834,422,0.0014019135724242808,0.7045075125208681
7085,0.7228,0,2,0,676269,175,125834,422,0.0013860727410974528,0.7068676716917923
7086,0.7229,2,0,2,676269,175,125836,420,0.0013860727410974528,0.7058823529411765
7087,0.723,2,0,2,676269,175,125838,418,0.0013860727410974528,0.7048903878583473
7088,0.7231,2,1,2,676270,174,125840,416,0.0013781523254340388,0.7050847457627119
7089,0.7234,0,1,0,676271,173,125840,416,0.0013702319097706247,0.7062818336162988
7090,0.7235,1,1,1,676272,172,125841,415,0.0013623114941072108,0.706984667802385
7091,0.7236,3,0,3,676272,172,125844,412,0.0013623114941072108,0.7054794520547946
7092,0.7237,4,0,4,676272,172,125848,408,0.0013623114941072108,0.7034482758620689
7093,0.7239,1,0,1,676272,172,125849,407,0.0013623114941072108,0.7029360967184801
7094,0.7241,1,0,1,676272,172,125850,406,0.0013623114941072108,0.7024221453287197
7095,0.7242,0,1,0,676273,171,125850,406,0.0013543910784437967,0.7036395147313691
7096,0.7244,2,1,2,676274,170,125852,404,0.0013464706627803827,0.7038327526132404
7097,0.7245,0,3,0,676277,167,125852,404,0.0013227094157901406,0.7075306479859895
7098,0.7246,1,0,1,676277,167,125853,403,0.0013227094157901406,0.7070175438596491
7099,0.7247,1,0,1,676277,167,125854,402,0.0013227094157901406,0.7065026362038664
7100,0.7248,0,1,0,676278,166,125854,402,0.0013147890001267266,0.7077464788732394
7101,0.7249,0,1,0,676279,165,125854,402,0.0013068685844633127,0.708994708994709
7102,0.725,3,0,3,676279,165,125857,399,0.0013068685844633127,0.7074468085106383
7103,0.7251,2,1,2,676280,164,125859,397,0.0012989481687998986,0.7076648841354723
7104,0.7252,0,1,0,676281,163,125859,397,0.0012910277531364845,0.7089285714285715
7105,0.7253,1,0,1,676281,163,125860,396,0.0012910277531364845,0.7084078711985689
7106,0.7254,1,0,1,676281,163,125861,395,0.0012910277531364845,0.7078853046594982
7107,0.7255,1,2,1,676283,161,125862,394,0.0012751869218096566,0.7099099099099099
7108,0.7256,0,1,0,676284,160,125862,394,0.0012672665061462425,0.7111913357400722
7109,0.7258,1,0,1,676284,160,125863,393,0.0012672665061462425,0.7106690777576854
7110,0.7261,4,1,4,676285,159,125867,389,0.0012593460904828286,0.7098540145985401
7111,0.7262,0,1,0,676286,158,125867,389,0.0012514256748194146,0.7111517367458866
7112,0.7263,1,0,1,676286,158,125868,388,0.0012514256748194146,0.7106227106227107
7113,0.7264,3,0,3,676286,158,125871,385,0.0012514256748194146,0.7090239410681399
7114,0.7265,3,0,3,676286,158,125874,382,0.0012514256748194146,0.7074074074074074
7115,0.7266,3,0,3,676286,158,125877,379,0.0012514256748194146,0.7057728119180633
7116,0.7268,2,1,2,676287,157,125879,377,0.0012435052591560005,0.7059925093632958
7117,0.7271,1,0,1,676287,157,125880,376,0.0012435052591560005,0.7054409005628518
7118,0.7273,1,1,1,676288,156,125881,375,0.0012355848434925864,0.7062146892655368
7119,0.7274,0,1,0,676289,155,125881,375,0.0012276644278291725,0.7075471698113207
7120,0.7275,3,1,3,676290,154,125884,372,0.0012197440121657585,0.7072243346007605
7121,0.7276,4,0,4,676290,154,125888,368,0.0012197440121657585,0.7049808429118773
7122,0.7277,1,0,1,676290,154,125889,367,0.0012197440121657585,0.7044145873320538
7123,0.7278,1,0,1,676290,154,125890,366,0.0012197440121657585,0.7038461538461539
7124,0.7283,2,1,2,676291,153,125892,364,0.0012118235965023444,0.7040618955512572
7125,0.7284,1,1,1,676292,152,125893,363,0.0012039031808389305,0.7048543689320388
7126,0.7286,1,0,1,676292,152,125894,362,0.0012039031808389305,0.7042801556420234
7127,0.7288,2,2,2,676294,150,125896,360,0.0011880623495121023,0.7058823529411765
7128,0.7289,1,0,1,676294,150,125897,359,0.0011880623495121023,0.7053045186640472
7129,0.7291,1,1,1,676295,149,125898,358,0.0011801419338486885,0.7061143984220908
7130,0.7292,2,0,2,676295,149,125900,356,0.0011801419338486885,0.7049504950495049
7131,0.7293,2,0,2,676295,149,125902,354,0.0011801419338486885,0.7037773359840954
7132,0.7294,2,0,2,676295,149,125904,352,0.0011801419338486885,0.7025948103792415
7133,0.7295,2,0,2,676295,149,125906,350,0.0011801419338486885,0.7014028056112225
7134,0.7296,1,1,1,676296,148,125907,349,0.0011722215181852744,0.7022132796780685
7135,0.7298,2,0,2,676296,148,125909,347,0.0011722215181852744,0.701010101010101
7136,0.7299,1,0,1,676296,148,125910,346,0.0011722215181852744,0.7004048582995951
7137,0.73,3,2,3,676298,146,125913,343,0.0011563806868584462,0.7014314928425358
7138,0.7301,2,0,2,676298,146,125915,341,0.0011563806868584462,0.7002053388090349
7139,0.7303,1,0,1,676298,146,125916,340,0.0011563806868584462,0.6995884773662552
7140,0.7305,2,0,2,676298,146,125918,338,0.0011563806868584462,0.6983471074380165
7141,0.7306,1,0,1,676298,146,125919,337,0.0011563806868584462,0.6977225672877847
7142,0.7307,0,1,0,676299,145,125919,337,0.0011484602711950324,0.6991701244813278
7143,0.7309,1,0,1,676299,145,125920,336,0.0011484602711950324,0.6985446985446986
7144,0.731,3,0,3,676299,145,125923,333,0.0011484602711950324,0.696652719665272
7145,0.7311,0,2,0,676301,143,125923,333,0.0011326194398682042,0.6995798319327731
7146,0.7312,1,1,1,676302,142,125924,332,0.0011246990242047904,0.70042194092827
7147,0.7314,1,0,1,676302,142,125925,331,0.0011246990242047904,0.6997885835095138
7148,0.7317,2,1,2,676303,141,125927,329,0.0011167786085413763,0.7
7149,0.7318,1,0,1,676303,141,125928,328,0.0011167786085413763,0.6993603411513859
7150,0.7319,1,0,1,676303,141,125929,327,0.0011167786085413763,0.6987179487179487
7151,0.7322,2,0,2,676303,141,125931,325,0.0011167786085413763,0.6974248927038627
7152,0.7323,1,0,1,676303,141,125932,324,0.0011167786085413763,0.6967741935483871
7153,0.7325,0,1,0,676304,140,125932,324,0.0011088581928779622,0.6982758620689655
7154,0.7326,0,1,0,676305,139,125932,324,0.0011009377772145481,0.6997840172786177
7155,0.7327,2,0,2,676305,139,125934,322,0.0011009377772145481,0.6984815618221258
7156,0.7328,1,1,1,676306,138,125935,321,0.0010930173615511342,0.6993464052287581
7157,0.7331,1,2,1,676308,136,125936,320,0.001077176530224306,0.7017543859649122
7158,0.7332,0,1,0,676309,135,125936,320,0.0010692561145608922,0.7032967032967034
7159,0.7335,1,0,1,676309,135,125937,319,0.0010692561145608922,0.7026431718061674
7160,0.7337,1,0,1,676309,135,125938,318,0.0010692561145608922,0.7019867549668874
7161,0.7338,1,0,1,676309,135,125939,317,0.0010692561145608922,0.7013274336283186
7162,0.7339,2,0,2,676309,135,125941,315,0.0010692561145608922,0.7
7163,0.734,1,0,1,676309,135,125942,314,0.0010692561145608922,0.6993318485523385
7164,0.7341,1,0,1,676309,135,125943,313,0.0010692561145608922,0.6986607142857143
7165,0.7342,0,3,0,676312,132,125943,313,0.0010454948675706502,0.7033707865168539
7166,0.7344,3,1,3,676313,131,125946,310,0.0010375744519072361,0.7029478458049887
7167,0.7346,1,0,1,676313,131,125947,309,0.0010375744519072361,0.7022727272727273
7168,0.7347,1,0,1,676313,131,125948,308,0.0010375744519072361,0.7015945330296127
7169,0.7348,2,0,2,676313,131,125950,306,0.0010375744519072361,0.700228832951945
7170,0.7349,3,0,3,676313,131,125953,303,0.0010375744519072361,0.6981566820276498
7171,0.735,2,0,2,676313,131,125955,301,0.0010375744519072361,0.6967592592592593
7172,0.7353,1,0,1,676313,131,125956,300,0.0010375744519072361,0.6960556844547564
7173,0.7354,2,0,2,676313,131,125958,298,0.0010375744519072361,0.6946386946386947
7174,0.7355,3,0,3,676313,131,125961,295,0.0010375744519072361,0.6924882629107981
7175,0.7357,1,0,1,676313,131,125962,294,0.0010375744519072361,0.691764705882353
7176,0.7359,1,0,1,676313,131,125963,293,0.0010375744519072361,0.6910377358490566
7177,0.7361,2,3,2,676316,128,125965,291,0.001013813204916994,0.6945107398568019
7178,0.7366,2,1,2,676317,127,125967,289,0.00100589278925358,0.6947115384615384
7179,0.7368,1,0,1,676317,127,125968,288,0.00100589278925358,0.6939759036144578
7180,0.737,1,1,1,676318,126,125969,287,0.000997972373590166,0.6949152542372882
7181,0.7372,2,0,2,676318,126,125971,285,0.000997972373590166,0.6934306569343066
7182,0.7374,0,1,0,676319,125,125971,285,0.000990051957926752,0.6951219512195121
7183,0.7376,1,0,1,676319,125,125972,284,0.000990051957926752,0.6943765281173594
7184,0.7377,1,0,1,676319,125,125973,283,0.000990051957926752,0.6936274509803921
7185,0.7378,2,0,2,676319,125,125975,281,0.000990051957926752,0.6921182266009852
7186,0.7379,1,0,1,676319,125,125976,280,0.000990051957926752,0.691358024691358
7187,0.7381,1,1,1,676320,124,125977,279,0.000982131542263338,0.6923076923076923
7188,0.7384,0,1,0,676321,123,125977,279,0.000974211126599924,0.6940298507462687
7189,0.7385,0,1,0,676322,122,125977,279,0.0009662907109365099,0.6957605985037406
7190,0.7386,2,0,2,676322,122,125979,277,0.0009662907109365099,0.6942355889724311
7191,0.7387,1,0,1,676322,122,125980,276,0.0009662907109365099,0.6934673366834171
7192,0.7388,1,0,1,676322,122,125981,275,0.0009662907109365099,0.6926952141057935
7193,0.739,1,0,1,676322,122,125982,274,0.0009662907109365099,0.6919191919191919
7194,0.7391,1,0,1,676322,122,125983,273,0.0009662907109365099,0.6911392405063291
7195,0.7394,1,0,1,676322,122,125984,272,0.0009662907109365099,0.6903553299492385
7196,0.7395,1,0,1,676322,122,125985,271,0.0009662907109365099,0.6895674300254453
7197,0.7396,1,0,1,676322,122,125986,270,0.0009662907109365099,0.6887755102040817
7198,0.7397,1,0,1,676322,122,125987,269,0.0009662907109365099,0.6879795396419437
7199,0.7399,1,1,1,676323,121,125988,268,0.000958370295273096,0.6889460154241646
7200,0.74,2,0,2,676323,121,125990,266,0.000958370295273096,0.6873385012919897
7201,0.7401,0,1,0,676324,120,125990,266,0.0009504498796096819,0.689119170984456
7202,0.7402,1,2,1,676326,118,125991,265,0.0009346090482828539,0.6919060052219321
7203,0.7403,1,0,1,676326,118,125992,264,0.0009346090482828539,0.6910994764397905
7204,0.7404,1,1,1,676327,117,125993,263,0.0009266886326194399,0.6921052631578948
7205,0.7406,1,3,1,676330,114,125994,262,0.0009029273856291978,0.6968085106382979
7206,0.7407,0,1,0,676331,113,125994,262,0.0008950069699657839,0.6986666666666667
7207,0.7408,1,0,1,676331,113,125995,261,0.0008950069699657839,0.6978609625668449
7208,0.741,1,0,1,676331,113,125996,260,0.0008950069699657839,0.6970509383378016
7209,0.7411,0,1,0,676332,112,125996,260,0.0008870865543023698,0.6989247311827957
7210,0.7412,1,1,1,676333,111,125997,259,0.0008791661386389558,0.7
7211,0.7413,1,0,1,676333,111,125998,258,0.0008791661386389558,0.6991869918699187
7212,0.7414,0,1,0,676334,110,125998,258,0.0008712457229755417,0.7010869565217391
7213,0.7416,0,1,0,676335,109,125998,258,0.0008633253073121277,0.7029972752043597
7214,0.7418,1,0,1,676335,109,125999,257,0.0008633253073121277,0.7021857923497268
7215,0.7419,0,1,0,676336,108,125999,257,0.0008554048916487138,0.7041095890410959
7216,0.7421,1,0,1,676336,108,126000,256,0.0008554048916487138,0.7032967032967034
7217,0.7422,1,0,1,676336,108,126001,255,0.0008554048916487138,0.7024793388429752
7218,0.7424,1,0,1,676336,108,126002,254,0.0008554048916487138,0.7016574585635359
7219,0.7425,1,0,1,676336,108,126003,253,0.0008554048916487138,0.7008310249307479
7220,0.7426,2,0,2,676336,108,126005,251,0.0008554048916487138,0.6991643454038997
7221,0.7428,1,0,1,676336,108,126006,250,0.0008554048916487138,0.6983240223463687
7222,0.7429,0,1,0,676337,107,126006,250,0.0008474844759852997,0.7002801120448179
7223,0.743,3,1,3,676338,106,126009,247,0.0008395640603218857,0.6997167138810199
7224,0.7432,0,1,0,676339,105,126009,247,0.0008316436446584716,0.7017045454545454
7225,0.7433,1,0,1,676339,105,126010,246,0.0008316436446584716,0.7008547008547008
7226,0.7434,1,1,1,676340,104,126011,245,0.0008237232289950577,0.7020057306590258
7227,0.7435,1,0,1,676340,104,126012,244,0.0008237232289950577,0.7011494252873564
7228,0.7438,1,2,1,676342,102,126013,243,0.0008078823976682296,0.7043478260869566
7229,0.7439,0,1,0,676343,101,126013,243,0.0007999619820048156,0.7063953488372093
7230,0.7441,0,2,0,676345,99,126013,243,0.0007841211506779876,0.7105263157894737
7231,0.7443,1,0,1,676345,99,126014,242,0.0007841211506779876,0.7096774193548387
7232,0.7444,1,0,1,676345,99,126015,241,0.0007841211506779876,0.7088235294117647
7233,0.7446,1,0,1,676345,99,126016,240,0.0007841211506779876,0.7079646017699115
7234,0.745,1,0,1,676345,99,126017,239,0.0007841211506779876,0.7071005917159763
7235,0.7451,1,0,1,676345,99,126018,238,0.0007841211506779876,0.7062314540059347
7236,0.7452,1,0,1,676345,99,126019,237,0.0007841211506779876,0.7053571428571429
7237,0.7453,2,0,2,676345,99,126021,235,0.0007841211506779876,0.7035928143712575
7238,0.7454,2,0,2,676345,99,126023,233,0.0007841211506779876,0.7018072289156626
7239,0.7459,1,0,1,676345,99,126024,232,0.0007841211506779876,0.7009063444108762
7240,0.746,0,1,0,676346,98,126024,232,0.0007762007350145735,0.703030303030303
7241,0.7461,1,0,1,676346,98,126025,231,0.0007762007350145735,0.7021276595744681
7242,0.7463,1,0,1,676346,98,126026,230,0.0007762007350145735,0.7012195121951219
7243,0.7467,1,1,1,676347,97,126027,229,0.0007682803193511595,0.7024539877300614
7244,0.747,2,1,2,676348,96,126029,227,0.0007603599036877456,0.7027863777089783
7245,0.7471,0,2,0,676350,94,126029,227,0.0007445190723609175,0.7071651090342679
7246,0.7473,2,0,2,676350,94,126031,225,0.0007445190723609175,0.7053291536050157
7247,0.7474,2,0,2,676350,94,126033,223,0.0007445190723609175,0.7034700315457413
7248,0.7476,0,3,0,676353,91,126033,223,0.0007207578253706755,0.7101910828025477
7249,0.7478,1,0,1,676353,91,126034,222,0.0007207578253706755,0.7092651757188498
7250,0.7481,0,1,0,676354,90,126034,222,0.0007128374097072614,0.7115384615384616
7251,0.7482,3,0,3,676354,90,126037,219,0.0007128374097072614,0.7087378640776699
7252,0.7483,1,0,1,676354,90,126038,218,0.0007128374097072614,0.7077922077922078
7253,0.7485,0,1,0,676355,89,126038,218,0.0007049169940438474,0.7100977198697068
7254,0.7488,0,1,0,676356,88,126038,218,0.0006969965783804334,0.7124183006535948
7255,0.7492,2,0,2,676356,88,126040,216,0.0006969965783804334,0.7105263157894737
7256,0.7494,0,1,0,676357,87,126040,216,0.0006890761627170194,0.7128712871287128
7257,0.7495,1,2,1,676359,85,126041,215,0.0006732353313901913,0.7166666666666667
7258,0.7496,0,1,0,676360,84,126041,215,0.0006653149157267774,0.7190635451505016
7259,0.7497,1,0,1,676360,84,126042,214,0.0006653149157267774,0.7181208053691275
7260,0.7498,1,0,1,676360,84,126043,213,0.0006653149157267774,0.7171717171717171
7261,0.7499,1,0,1,676360,84,126044,212,0.0006653149157267774,0.7162162162162162
7262,0.7502,1,0,1,676360,84,126045,211,0.0006653149157267774,0.7152542372881356
7263,0.7503,2,0,2,676360,84,126047,209,0.0006653149157267774,0.7133105802047781
7264,0.7505,1,0,1,676360,84,126048,208,0.0006653149157267774,0.7123287671232876
7265,0.7506,1,0,1,676360,84,126049,207,0.0006653149157267774,0.711340206185567
7266,0.7512,1,0,1,676360,84,126050,206,0.0006653149157267774,0.7103448275862069
7267,0.7514,1,0,1,676360,84,126051,205,0.0006653149157267774,0.7093425605536332
7268,0.7516,1,1,1,676361,83,126052,204,0.0006573945000633633,0.710801393728223
7269,0.7522,1,0,1,676361,83,126053,203,0.0006573945000633633,0.7097902097902098
7270,0.7526,0,1,0,676362,82,126053,203,0.0006494740843999493,0.712280701754386
7271,0.7528,1,1,1,676363,81,126054,202,0.0006415536687365353,0.7137809187279152
7272,0.7529,0,2,0,676365,79,126054,202,0.0006257128374097073,0.7188612099644128
7273,0.753,1,0,1,676365,79,126055,201,0.0006257128374097073,0.7178571428571429
7274,0.7533,2,1,2,676366,78,126057,199,0.0006177924217462932,0.7184115523465704
7275,0.7537,1,0,1,676366,78,126058,198,0.0006177924217462932,0.717391304347826
7276,0.7538,1,0,1,676366,78,126059,197,0.0006177924217462932,0.7163636363636363
7277,0.7542,0,1,0,676367,77,126059,197,0.0006098720060828792,0.718978102189781
7278,0.7543,1,0,1,676367,77,126060,196,0.0006098720060828792,0.717948717948718
7279,0.7544,0,1,0,676368,76,126060,196,0.0006019515904194653,0.7205882352941176
7280,0.7545,1,0,1,676368,76,126061,195,0.0006019515904194653,0.7195571955719557
7281,0.7546,1,0,1,676368,76,126062,194,0.0006019515904194653,0.7185185185185186
7282,0.7548,2,0,2,676368,76,126064,192,0.0006019515904194653,0.7164179104477612
7283,0.755,1,0,1,676368,76,126065,191,0.0006019515904194653,0.7153558052434457
7284,0.7552,4,0,4,676368,76,126069,187,0.0006019515904194653,0.7110266159695817
7285,0.7554,0,1,0,676369,75,126069,187,0.0005940311747560512,0.7137404580152672
7286,0.7555,1,0,1,676369,75,126070,186,0.0005940311747560512,0.7126436781609196
7287,0.7557,1,0,1,676369,75,126071,185,0.0005940311747560512,0.7115384615384616
7288,0.7558,0,1,0,676370,74,126071,185,0.0005861107590926372,0.7142857142857143
7289,0.756,2,0,2,676370,74,126073,183,0.0005861107590926372,0.7120622568093385
7290,0.7565,1,1,1,676371,73,126074,182,0.0005781903434292231,0.7137254901960784
7291,0.7566,2,2,2,676373,71,126076,180,0.0005623495121023952,0.7171314741035857
7292,0.7568,0,1,0,676374,70,126076,180,0.0005544290964389811,0.72
7293,0.7569,1,0,1,676374,70,126077,179,0.0005544290964389811,0.7188755020080321
7294,0.7571,1,0,1,676374,70,126078,178,0.0005544290964389811,0.717741935483871
7295,0.7572,2,0,2,676374,70,126080,176,0.0005544290964389811,0.7154471544715447
7296,0.7573,0,1,0,676375,69,126080,176,0.0005465086807755671,0.7183673469387755
7297,0.7574,3,0,3,676375,69,126083,173,0.0005465086807755671,0.7148760330578512
7298,0.7575,0,1,0,676376,68,126083,173,0.000538588265112153,0.7178423236514523
7299,0.7579,1,0,1,676376,68,126084,172,0.000538588265112153,0.7166666666666667
7300,0.758,1,0,1,676376,68,126085,171,0.000538588265112153,0.7154811715481172
7301,0.7581,1,0,1,676376,68,126086,170,0.000538588265112153,0.7142857142857143
7302,0.7582,0,1,0,676377,67,126086,170,0.0005306678494487391,0.7172995780590717
7303,0.7583,1,0,1,676377,67,126087,169,0.0005306678494487391,0.7161016949152542
7304,0.7586,1,0,1,676377,67,126088,168,0.0005306678494487391,0.7148936170212766
7305,0.759,1,0,1,676377,67,126089,167,0.0005306678494487391,0.7136752136752137
7306,0.7594,0,1,0,676378,66,126089,167,0.0005227474337853251,0.7167381974248928
7307,0.7595,0,2,0,676380,64,126089,167,0.000506906602458497,0.7229437229437229
7308,0.7598,0,1,0,676381,63,126089,167,0.000498986186795083,0.7260869565217392
7309,0.7599,2,1,2,676382,62,126091,165,0.000491065771131669,0.7268722466960352
7310,0.7601,1,1,1,676383,61,126092,164,0.00048314535546825497,0.7288888888888889
7311,0.7604,2,1,2,676384,60,126094,162,0.00047522493980484094,0.7297297297297297
7312,0.7606,1,2,1,676386,58,126095,161,0.00045938410847801294,0.7351598173515982
7313,0.7612,3,0,3,676386,58,126098,158,0.00045938410847801294,0.7314814814814815
7314,0.7613,0,1,0,676387,57,126098,158,0.0004514636928145989,0.7348837209302326
7315,0.7615,1,0,1,676387,57,126099,157,0.0004514636928145989,0.7336448598130841
7316,0.7618,0,1,0,676388,56,126099,157,0.0004435432771511849,0.7370892018779343
7317,0.762,1,0,1,676388,56,126100,156,0.0004435432771511849,0.7358490566037735
7318,0.7621,0,1,0,676389,55,126100,156,0.00043562286148777086,0.7393364928909952
7319,0.7622,0,1,0,676390,54,126100,156,0.0004277024458243569,0.7428571428571429
7320,0.7623,1,0,1,676390,54,126101,155,0.0004277024458243569,0.7416267942583732
7321,0.7629,1,0,1,676390,54,126102,154,0.0004277024458243569,0.7403846153846154
7322,0.763,1,0,1,676390,54,126103,153,0.0004277024458243569,0.7391304347826086
7323,0.7632,0,1,0,676391,53,126103,153,0.00041978203016094286,0.7427184466019418
7324,0.764,1,0,1,676391,53,126104,152,0.00041978203016094286,0.7414634146341463
7325,0.7642,1,0,1,676391,53,126105,151,0.00041978203016094286,0.7401960784313726
7326,0.7643,1,0,1,676391,53,126106,150,0.00041978203016094286,0.7389162561576355
7327,0.7646,1,0,1,676391,53,126107,149,0.00041978203016094286,0.7376237623762376
7328,0.7648,1,0,1,676391,53,126108,148,0.00041978203016094286,0.736318407960199
7329,0.765,1,0,1,676391,53,126109,147,0.00041978203016094286,0.735
7330,0.7651,1,0,1,676391,53,126110,146,0.00041978203016094286,0.7336683417085427
7331,0.7654,1,0,1,676391,53,126111,145,0.00041978203016094286,0.7323232323232324
7332,0.7656,1,0,1,676391,53,126112,144,0.00041978203016094286,0.7309644670050761
7333,0.7662,0,1,0,676392,52,126112,144,0.00041186161449752884,0.7346938775510204
7334,0.7665,1,0,1,676392,52,126113,143,0.00041186161449752884,0.7333333333333333
7335,0.7667,1,0,1,676392,52,126114,142,0.00041186161449752884,0.7319587628865979
7336,0.7668,1,0,1,676392,52,126115,141,0.00041186161449752884,0.7305699481865285
7337,0.7669,1,0,1,676392,52,126116,140,0.00041186161449752884,0.7291666666666666
7338,0.7674,0,1,0,676393,51,126116,140,0.0004039411988341148,0.7329842931937173
7339,0.7681,1,0,1,676393,51,126117,139,0.0004039411988341148,0.7315789473684211
7340,0.7683,1,0,1,676393,51,126118,138,0.0004039411988341148,0.7301587301587301
7341,0.7686,1,0,1,676393,51,126119,137,0.0004039411988341148,0.7287234042553191
7342,0.769,1,0,1,676393,51,126120,136,0.0004039411988341148,0.7272727272727273
7343,0.7692,1,0,1,676393,51,126121,135,0.0004039411988341148,0.7258064516129032
7344,0.7695,1,0,1,676393,51,126122,134,0.0004039411988341148,0.7243243243243244
7345,0.7697,2,1,2,676394,50,126124,132,0.0003960207831707008,0.7252747252747253
7346,0.7698,1,1,1,676395,49,126125,131,0.00038810036750728676,0.7277777777777777
7347,0.7699,1,0,1,676395,49,126126,130,0.00038810036750728676,0.7262569832402235
7348,0.7701,1,0,1,676395,49,126127,129,0.00038810036750728676,0.7247191011235955
7349,0.7704,0,1,0,676396,48,126127,129,0.0003801799518438728,0.7288135593220338
7350,0.7709,1,0,1,676396,48,126128,128,0.0003801799518438728,0.7272727272727273
7351,0.771,2,0,2,676396,48,126130,126,0.0003801799518438728,0.7241379310344828
7352,0.7713,1,2,1,676398,46,126131,125,0.00036433912051704473,0.7309941520467836
7353,0.7717,1,0,1,676398,46,126132,124,0.00036433912051704473,0.7294117647058823
7354,0.7719,2,0,2,676398,46,126134,122,0.00036433912051704473,0.7261904761904762
7355,0.772,1,0,1,676398,46,126135,121,0.00036433912051704473,0.7245508982035929
7356,0.7723,1,0,1,676398,46,126136,120,0.00036433912051704473,0.7228915662650602
7357,0.7729,1,0,1,676398,46,126137,119,0.00036433912051704473,0.7212121212121212
7358,0.773,1,0,1,676398,46,126138,118,0.00036433912051704473,0.7195121951219512
7359,0.7731,0,1,0,676399,45,126138,118,0.0003564187048536307,0.7239263803680982
7360,0.7733,2,0,2,676399,45,126140,116,0.0003564187048536307,0.7204968944099379
7361,0.7738,1,0,1,676399,45,126141,115,0.0003564187048536307,0.71875
7362,0.774,0,2,0,676401,43,126141,115,0.0003405778735268027,0.7278481012658228
7363,0.7746,2,0,2,676401,43,126143,113,0.0003405778735268027,0.7243589743589743
7364,0.7752,1,0,1,676401,43,126144,112,0.0003405778735268027,0.7225806451612903
7365,0.7753,1,0,1,676401,43,126145,111,0.0003405778735268027,0.7207792207792207
7366,0.776,1,0,1,676401,43,126146,110,0.0003405778735268027,0.7189542483660131
7367,0.7763,0,1,0,676402,42,126146,110,0.0003326574578633887,0.7236842105263158
7368,0.7765,0,1,0,676403,41,126146,110,0.00032473704219997465,0.7284768211920529
7369,0.7768,1,0,1,676403,41,126147,109,0.00032473704219997465,0.7266666666666667
7370,0.777,1,0,1,676403,41,126148,108,0.00032473704219997465,0.7248322147651006
7371,0.7778,0,1,0,676404,40,126148,108,0.0003168166265365606,0.7297297297297297
7372,0.7779,1,0,1,676404,40,126149,107,0.0003168166265365606,0.7278911564625851
7373,0.778,1,0,1,676404,40,126150,106,0.0003168166265365606,0.726027397260274
7374,0.7786,1,0,1,676404,40,126151,105,0.0003168166265365606,0.7241379310344828
7375,0.7787,1,0,1,676404,40,126152,104,0.0003168166265365606,0.7222222222222222
7376,0.7791,2,0,2,676404,40,126154,102,0.0003168166265365606,0.7183098591549296
7377,0.7793,1,0,1,676404,40,126155,101,0.0003168166265365606,0.7163120567375887
7378,0.7797,1,0,1,676404,40,126156,100,0.0003168166265365606,0.7142857142857143
7379,0.7802,1,0,1,676404,40,126157,99,0.0003168166265365606,0.7122302158273381
7380,0.7803,2,0,2,676404,40,126159,97,0.0003168166265365606,0.708029197080292
7381,0.7806,0,2,0,676406,38,126159,97,0.00030097579520973263,0.7185185185185186
7382,0.7809,2,1,2,676407,37,126161,95,0.0002930553795463186,0.7196969696969697
7383,0.7814,1,0,1,676407,37,126162,94,0.0002930553795463186,0.7175572519083969
7384,0.782,1,0,1,676407,37,126163,93,0.0002930553795463186,0.7153846153846154
7385,0.7823,1,0,1,676407,37,126164,92,0.0002930553795463186,0.7131782945736435
7386,0.7828,0,1,0,676408,36,126164,92,0.0002851349638829046,0.71875
7387,0.7829,0,1,0,676409,35,126164,92,0.00027721454821949055,0.7244094488188977
7388,0.7831,1,0,1,676409,35,126165,91,0.00027721454821949055,0.7222222222222222
7389,0.7832,1,0,1,676409,35,126166,90,0.00027721454821949055,0.72
7390,0.7836,0,1,0,676410,34,126166,90,0.0002692941325560765,0.7258064516129032
7391,0.7838,1,0,1,676410,34,126167,89,0.0002692941325560765,0.7235772357723578
7392,0.784,1,0,1,676410,34,126168,88,0.0002692941325560765,0.7213114754098361
7393,0.7848,1,0,1,676410,34,126169,87,0.0002692941325560765,0.71900826446281
7394,0.7852,0,1,0,676411,33,126169,87,0.00026137371689266255,0.725
7395,0.786,1,0,1,676411,33,126170,86,0.00026137371689266255,0.7226890756302521
7396,0.7863,0,1,0,676412,32,126170,86,0.0002534533012292485,0.7288135593220338
7397,0.7866,1,1,1,676413,31,126171,85,0.0002455328855658345,0.7327586206896551
7398,0.7868,0,1,0,676414,30,126171,85,0.00023761246990242047,0.7391304347826086
7399,0.787,0,1,0,676415,29,126171,85,0.00022969205423900647,0.7456140350877193
7400,0.7871,0,1,0,676416,28,126171,85,0.00022177163857559244,0.7522123893805309
7401,0.7872,1,0,1,676416,28,126172,84,0.00022177163857559244,0.75
7402,0.7874,0,1,0,676417,27,126172,84,0.00021385122291217844,0.7567567567567568
7403,0.7881,1,0,1,676417,27,126173,83,0.00021385122291217844,0.7545454545454545
7404,0.7893,1,0,1,676417,27,126174,82,0.00021385122291217844,0.7522935779816514
7405,0.7895,1,0,1,676417,27,126175,81,0.00021385122291217844,0.75
7406,0.7905,1,0,1,676417,27,126176,80,0.00021385122291217844,0.7476635514018691
7407,0.7909,1,0,1,676417,27,126177,79,0.00021385122291217844,0.7452830188679245
7408,0.7912,1,0,1,676417,27,126178,78,0.00021385122291217844,0.7428571428571429
7409,0.7915,1,0,1,676417,27,126179,77,0.00021385122291217844,0.7403846153846154
7410,0.7916,2,0,2,676417,27,126181,75,0.00021385122291217844,0.7352941176470589
7411,0.7925,1,0,1,676417,27,126182,74,0.00021385122291217844,0.7326732673267327
7412,0.7926,0,1,0,676418,26,126182,74,0.00020593080724876442,0.74
7413,0.793,1,0,1,676418,26,126183,73,0.00020593080724876442,0.7373737373737373
7414,0.7933,1,0,1,676418,26,126184,72,0.00020593080724876442,0.7346938775510204
7415,0.7936,1,0,1,676418,26,126185,71,0.00020593080724876442,0.7319587628865979
7416,0.7937,2,0,2,676418,26,126187,69,0.00020593080724876442,0.7263157894736842
7417,0.7938,1,1,1,676419,25,126188,68,0.0001980103915853504,0.7311827956989247
7418,0.7945,0,1,0,676420,24,126188,68,0.0001900899759219364,0.7391304347826086
7419,0.7949,1,0,1,676420,24,126189,67,0.0001900899759219364,0.7362637362637363
7420,0.795,2,0,2,676420,24,126191,65,0.0001900899759219364,0.7303370786516854
7421,0.7953,1,1,1,676421,23,126192,64,0.00018216956025852237,0.735632183908046
7422,0.7956,0,1,0,676422,22,126192,64,0.00017424914459510834,0.7441860465116279
7423,0.7964,1,1,1,676423,21,126193,63,0.00016632872893169434,0.75
7424,0.7965,1,0,1,676423,21,126194,62,0.00016632872893169434,0.7469879518072289
7425,0.7966,0,1,0,676424,20,126194,62,0.0001584083132682803,0.7560975609756098
7426,0.7967,1,0,1,676424,20,126195,61,0.0001584083132682803,0.7530864197530864
7427,0.7969,1,0,1,676424,20,126196,60,0.0001584083132682803,0.75
7428,0.7975,1,0,1,676424,20,126197,59,0.0001584083132682803,0.7468354430379747
7429,0.7976,2,0,2,676424,20,126199,57,0.0001584083132682803,0.7402597402597403
7430,0.7978,0,1,0,676425,19,126199,57,0.00015048789760486631,0.75
7431,0.7981,1,1,1,676426,18,126200,56,0.0001425674819414523,0.7567567567567568
7432,0.7984,1,0,1,676426,18,126201,55,0.0001425674819414523,0.7534246575342466
7433,0.7989,1,0,1,676426,18,126202,54,0.0001425674819414523,0.75
7434,0.7994,0,1,0,676427,17,126202,54,0.00013464706627803826,0.7605633802816901
7435,0.8002,1,0,1,676427,17,126203,53,0.00013464706627803826,0.7571428571428571
7436,0.8011,0,1,0,676428,16,126203,53,0.00012672665061462426,0.7681159420289855
7437,0.8012,0,1,0,676429,15,126203,53,0.00011880623495121023,0.7794117647058824
7438,0.802,0,1,0,676430,14,126203,53,0.00011088581928779622,0.7910447761194029
7439,0.8024,1,0,1,676430,14,126204,52,0.00011088581928779622,0.7878787878787878
7440,0.8032,2,0,2,676430,14,126206,50,0.00011088581928779622,0.78125
7441,0.8035,1,0,1,676430,14,126207,49,0.00011088581928779622,0.7777777777777778
7442,0.8037,1,0,1,676430,14,126208,48,0.00011088581928779622,0.7741935483870968
7443,0.8038,1,0,1,676430,14,126209,47,0.00011088581928779622,0.7704918032786885
7444,0.804,1,0,1,676430,14,126210,46,0.00011088581928779622,0.7666666666666667
7445,0.8043,1,0,1,676430,14,126211,45,0.00011088581928779622,0.7627118644067796
7446,0.8049,1,0,1,676430,14,126212,44,0.00011088581928779622,0.7586206896551724
7447,0.8057,0,1,0,676431,13,126212,44,0.00010296540362438221,0.7719298245614035
7448,0.8061,1,0,1,676431,13,126213,43,0.00010296540362438221,0.7678571428571429
7449,0.8063,1,0,1,676431,13,126214,42,0.00010296540362438221,0.7636363636363637
7450,0.8067,1,0,1,676431,13,126215,41,0.00010296540362438221,0.7592592592592593
7451,0.8069,1,0,1,676431,13,126216,40,0.00010296540362438221,0.7547169811320755
7452,0.8083,1,0,1,676431,13,126217,39,0.00010296540362438221,0.75
7453,0.8085,1,0,1,676431,13,126218,38,0.00010296540362438221,0.7450980392156863
7454,0.8087,1,0,1,676431,13,126219,37,0.00010296540362438221,0.74
7455,0.8088,1,0,1,676431,13,126220,36,0.00010296540362438221,0.7346938775510204
7456,0.809,1,0,1,676431,13,126221,35,0.00010296540362438221,0.7291666666666666
7457,0.8097,1,0,1,676431,13,126222,34,0.00010296540362438221,0.723404255319149
7458,0.8102,1,0,1,676431,13,126223,33,0.00010296540362438221,0.717391304347826
7459,0.8115,0,1,0,676432,12,126223,33,9.50449879609682e-05,0.7333333333333333
7460,0.8121,2,0,2,676432,12,126225,31,9.50449879609682e-05,0.7209302325581395
7461,0.8124,2,0,2,676432,12,126227,29,9.50449879609682e-05,0.7073170731707317
7462,0.8135,0,1,0,676433,11,126227,29,8.712457229755417e-05,0.725
7463,0.8138,3,0,3,676433,11,126230,26,8.712457229755417e-05,0.7027027027027027
7464,0.8139,1,0,1,676433,11,126231,25,8.712457229755417e-05,0.6944444444444444
7465,0.8162,1,0,1,676433,11,126232,24,8.712457229755417e-05,0.6857142857142857
7466,0.8165,0,1,0,676434,10,126232,24,7.920415663414016e-05,0.7058823529411765
7467,0.8174,1,0,1,676434,10,126233,23,7.920415663414016e-05,0.696969696969697
7468,0.8186,1,1,1,676435,9,126234,22,7.128374097072614e-05,0.7096774193548387
7469,0.8188,1,0,1,676435,9,126235,21,7.128374097072614e-05,0.7
7470,0.8193,1,0,1,676435,9,126236,20,7.128374097072614e-05,0.6896551724137931
7471,0.8196,0,1,0,676436,8,126236,20,6.336332530731213e-05,0.7142857142857143
7472,0.82,0,1,0,676437,7,126236,20,5.544290964389811e-05,0.7407407407407407
7473,0.8201,1,0,1,676437,7,126237,19,5.544290964389811e-05,0.7307692307692307
7474,0.8203,1,0,1,676437,7,126238,18,5.544290964389811e-05,0.72
7475,0.8205,0,1,0,676438,6,126238,18,4.75224939804841e-05,0.75
7476,0.8213,1,0,1,676438,6,126239,17,4.75224939804841e-05,0.7391304347826086
7477,0.8237,0,1,0,676439,5,126239,17,3.960207831707008e-05,0.7727272727272727
7478,0.8256,1,0,1,676439,5,126240,16,3.960207831707008e-05,0.7619047619047619
7479,0.8262,0,1,0,676440,4,126240,16,3.1681662653656065e-05,0.8
7480,0.8296,1,0,1,676440,4,126241,15,3.1681662653656065e-05,0.7894736842105263
7481,0.8335,1,0,1,676440,4,126242,14,3.1681662653656065e-05,0.7777777777777778
7482,0.835,1,0,1,676440,4,126243,13,3.1681662653656065e-05,0.7647058823529411
7483,0.836,0,1,0,676441,3,126243,13,2.376124699024205e-05,0.8125
7484,0.8368,1,0,1,676441,3,126244,12,2.376124699024205e-05,0.8
7485,0.8374,1,0,1,676441,3,126245,11,2.376124699024205e-05,0.7857142857142857
7486,0.8391,1,0,1,676441,3,126246,10,2.376124699024205e-05,0.7692307692307693
7487,0.8395,1,0,1,676441,3,126247,9,2.376124699024205e-05,0.75
7488,0.8485,1,0,1,676441,3,126248,8,2.376124699024205e-05,0.7272727272727273
7489,0.8496,1,0,1,676441,3,126249,7,2.376124699024205e-05,0.7
7490,0.8522,1,0,1,676441,3,126250,6,2.376124699024205e-05,0.6666666666666666
7491,0.8532,1,0,1,676441,3,126251,5,2.376124699024205e-05,0.625
7492,0.8564,1,0,1,676441,3,126252,4,2.376124699024205e-05,0.5714285714285714
7493,0.8609,0,1,0,676442,2,126252,4,1.5840831326828033e-05,0.6666666666666666
7494,0.8699,1,0,1,676442,2,126253,3,1.5840831326828033e-05,0.6
7495,0.871,0,1,0,676443,1,126253,3,7.920415663414016e-06,0.75
7496,0.8805,0,1,0,676444,0,126253,3,0.0,1.0
7497,0.8816,1,0,1,676444,0,126254,2,0.0,1.0
7498,0.8859,1,0,1,676444,0,126255,1,0.0,1.0
7499,0.8956,1,0,1,676444,0,126256,0,0.0,
