,y_proba,y_test,Neg,Pos,TN,FP,FN,TP,FP/P,Prec
0,0.0002,0,6,0,6,676438,0,126256,5.35767013052845,0.15729032483113117
1,0.0003,0,5,0,11,676433,0,126256,5.357630528450133,0.15729130460240517
2,0.0004,0,16,0,27,676417,0,126256,5.357503801799519,0.1572944399525087
3,0.0005,0,12,0,39,676405,0,126256,5.357408756811558,0.1572967915471164
4,0.0006,0,23,0,62,676382,0,126256,5.357226587251299,0.15730129896665745
5,0.0007,0,37,0,99,676345,0,126256,5.356933531871753,0.15730855057494322
6,0.0008,0,32,0,131,676313,0,126256,5.356680078570523,0.15731482277536263
7,0.0009,0,45,0,176,676268,0,126256,5.356323659865669,0.1573236439034845
8,0.001,0,53,0,229,676215,0,126256,5.355903877835509,0.15733403450093525
9,0.0011,0,40,0,269,676175,0,126256,5.355587061208972,0.1573418773701415
10,0.0012,0,60,0,329,676115,0,126256,5.355111836269168,0.1573536431401434
11,0.0013,0,64,0,393,676051,0,126256,5.354604929666709,0.15736619523449252
12,0.0014,0,75,0,468,675976,0,126256,5.3540108984919526,0.15738090726872028
13,0.0015,0,67,0,535,675909,0,126256,5.3534802306425044,0.15739405234583909
14,0.0016,0,85,0,620,675824,0,126256,5.352806995311114,0.15741073209654896
15,0.0017,0,80,0,700,675744,0,126256,5.352173362058041,0.15742643391521197
16,0.0018,0,90,0,790,675654,0,126256,5.351460524648333,0.1574441022059832
17,0.0019,1,85,1,875,675569,1,126255,5.350787289316943,0.1574597417887217
18,0.002,0,91,0,966,675478,1,126255,5.3500665314915725,0.157477614118416
19,0.0021,2,92,2,1058,675386,3,126253,5.349337853250539,0.157493585017695
20,0.0022,1,96,1,1154,675290,4,126252,5.348577493346851,0.15751139678270135
21,0.0023,0,103,0,1257,675187,4,126252,5.3477616905335195,0.15753163996261724
22,0.0024,1,101,1,1358,675086,5,126251,5.3469617285515145,0.15755044382076455
23,0.0025,0,128,0,1486,674958,5,126251,5.345947915346597,0.1575756138535638
24,0.0026,0,87,0,1573,674871,5,126251,5.34525883918388,0.1575927262015024
25,0.0027,0,87,0,1660,674784,5,126251,5.3445697630211635,0.15760984226656763
26,0.0028,1,122,1,1782,674662,6,126250,5.343603472310227,0.15763279860958507
27,0.0029,0,131,0,1913,674531,6,126250,5.34256589785832,0.15765858580560727
28,0.003,1,111,1,2024,674420,7,126249,5.341686731719681,0.15767939060960273
29,0.0031,1,121,1,2145,674299,8,126248,5.340728361424407,0.15770217114048268
30,0.0032,0,126,0,2271,674173,8,126248,5.339730389050818,0.15772699616826644
31,0.0033,0,112,0,2383,674061,8,126248,5.338843302496515,0.15774906942193578
32,0.0034,0,114,0,2497,673947,8,126248,5.337940375110886,0.15777154318634834
33,0.0035,0,122,0,2619,673825,8,126248,5.336974084399949,0.15779560115139493
34,0.0036,0,161,0,2780,673664,8,126248,5.33569889747814,0.15782736100971106
35,0.0037,1,142,1,2922,673522,9,126247,5.334574198453935,0.15785433043791394
36,0.0038,4,164,4,3086,673358,13,126243,5.333275250285135,0.15788249389382955
37,0.0039,1,149,1,3235,673209,14,126242,5.332095108351286,0.15791086633202034
38,0.004,1,152,1,3387,673057,15,126241,5.330891205170447,0.15793984221154062
39,0.0041,0,150,0,3537,672907,15,126241,5.329703142820935,0.15796948750419196
40,0.0042,1,178,1,3715,672729,16,126240,5.328293308832848,0.15800362717452116
41,0.0043,3,151,3,3866,672578,19,126237,5.327097326067672,0.1580303324299118
42,0.0044,0,165,0,4031,672413,19,126237,5.325790457483209,0.15806298128091154
43,0.0045,0,159,0,4190,672254,19,126237,5.324531111392726,0.1580944556670019
44,0.0046,1,159,1,4349,672095,20,126236,5.323271765302243,0.15812488804768948
45,0.0047,1,165,1,4514,671930,21,126235,5.3219648967177795,0.15815652152123935
46,0.0048,1,164,1,4678,671766,22,126234,5.32066594854898,0.15818796992481202
47,0.0049,2,194,2,4872,671572,24,126232,5.3191293879102775,0.15822432577425033
48,0.005,0,183,0,5055,671389,24,126232,5.317679951843873,0.1582606275411505
49,0.0051,0,175,0,5230,671214,24,126232,5.316293879102775,0.15829535793019214
50,0.0052,1,186,1,5416,671028,25,126231,5.314820681789381,0.15833123238495897
51,0.0053,5,180,5,5596,670848,30,126226,5.313395006969966,0.15836170794681548
52,0.0054,3,180,3,5776,670668,33,126223,5.311969332150551,0.15839430988679756
53,0.0055,0,172,0,5948,670496,33,126223,5.310607020656444,0.1584285049057447
54,0.0056,0,190,0,6138,670306,33,126223,5.309102141680396,0.15846629564020895
55,0.0057,0,209,0,6347,670097,33,126223,5.307446774806742,0.15850788627687362
56,0.0058,2,191,2,6538,669906,35,126221,5.30593397541503,0.15854380017258554
57,0.0059,4,218,4,6756,669688,39,126217,5.304207324800405,0.158582996714432
58,0.006,1,194,1,6950,669494,40,126216,5.302670764161703,0.158620602983499
59,0.0061,3,206,3,7156,669288,43,126213,5.30103915853504,0.15865850577183435
60,0.0062,2,214,2,7370,669074,45,126211,5.29934418958307,0.15869908271877378
61,0.0063,1,220,1,7590,668854,46,126210,5.297601698137118,0.15874193775595424
62,0.0064,2,227,2,7817,668627,48,126208,5.295803763781524,0.15878515666773607
63,0.0065,1,235,1,8052,668392,49,126207,5.293942466100621,0.1588310581815482
64,0.0066,4,191,4,8243,668201,53,126203,5.292429666708909,0.15886501075019763
65,0.0067,2,210,2,8453,667991,55,126201,5.290766379419592,0.15890489957088463
66,0.0068,1,218,1,8671,667773,56,126200,5.289039728804967,0.158947470505924
67,0.0069,2,219,2,8890,667554,58,126198,5.28730515777468,0.15898920569648958
68,0.007,4,232,4,9122,667322,62,126194,5.285467621340768,0.15903144990145127
69,0.0071,4,239,4,9361,667083,66,126190,5.283574641997212,0.1590751229400219
70,0.0072,2,226,2,9587,666857,68,126188,5.281784628057281,0.15911833502512468
71,0.0073,2,224,2,9811,666633,70,126186,5.280010454948676,0.15916117045630843
72,0.0074,1,246,1,10057,666387,71,126185,5.278062032695476,0.15920951030316488
73,0.0075,1,243,1,10300,666144,72,126184,5.276137371689266,0.15925727728920347
74,0.0076,6,251,6,10551,665893,78,126178,5.274149347357749,0.15930137576050632
75,0.0077,1,239,1,10790,665654,79,126177,5.272256368014193,0.15934839631183928
76,0.0078,2,260,2,11050,665394,81,126175,5.270197059941705,0.15939861212351672
77,0.0079,1,255,1,11305,665139,82,126174,5.268177353947535,0.1594489159156996
78,0.008,2,234,2,11539,664905,84,126172,5.266323976682297,0.1594939557084835
79,0.0081,2,242,2,11781,664663,86,126170,5.26440723609175,0.15954063626581086
80,0.0082,3,236,3,12017,664427,89,126167,5.262538017995184,0.15958507147790144
81,0.0083,1,267,1,12284,664160,90,126166,5.260423267013053,0.15963792156654344
82,0.0084,2,250,2,12534,663910,92,126164,5.2584431630971995,0.15968630786483293
83,0.0085,9,277,9,12811,663633,101,126155,5.256249207958434,0.1597327384057494
84,0.0086,2,272,2,13083,663361,103,126153,5.254094854897985,0.1597856402799697
85,0.0087,5,230,5,13313,663131,108,126148,5.2522731592954,0.15982687997526857
86,0.0088,5,263,5,13576,662868,113,126143,5.250190089975922,0.15987483064241184
87,0.0089,2,246,2,13822,662622,115,126141,5.248241667722722,0.15992256229057397
88,0.009,3,260,3,14082,662362,118,126138,5.246182359650234,0.1599720989220038
89,0.0091,1,254,1,14336,662108,119,126137,5.2441705740717275,0.16002258181149262
90,0.0092,6,280,6,14616,661828,125,126131,5.2419528576859715,0.1600730494860773
91,0.0093,4,294,4,14910,661534,129,126127,5.239624255480928,0.1601285324524129
92,0.0094,2,301,2,15211,661233,131,126125,5.23724021036624,0.16018761478260207
93,0.0095,4,275,4,15486,660958,135,126121,5.235062096058801,0.1602393152402745
94,0.0096,3,288,3,15774,660670,138,126118,5.2327810163477375,0.1602947680950904
95,0.0097,1,290,1,16064,660380,139,126117,5.230484095805348,0.16035280490580384
96,0.0098,4,310,4,16374,660070,143,126113,5.22802876694969,0.16041176163819365
97,0.0099,4,291,4,16665,659779,147,126109,5.225723925991636,0.1604668858666884
98,0.01,0,276,0,16941,659503,147,126109,5.223537891268534,0.1605232608463211
99,0.0101,2,260,2,17201,659243,149,126107,5.221478583196046,0.16057426625071625
100,0.0102,1,270,1,17471,658973,150,126106,5.219340070966925,0.16062842083408166
101,0.0103,2,292,2,17763,658681,152,126104,5.217027309593208,0.16068604777104556
102,0.0104,3,256,3,18019,658425,155,126101,5.214999683183374,0.16073527199863358
103,0.0105,6,278,6,18297,658147,161,126095,5.212797807628944,0.16078582886404963
104,0.0106,6,314,6,18611,657833,167,126089,5.210310797110632,0.1608438084401254
105,0.0107,6,293,6,18904,657540,173,126083,5.207990115321252,0.1608975234264436
106,0.0108,3,287,3,19191,657253,176,126080,5.205716956025852,0.16095325998011062
107,0.0109,5,293,5,19484,656960,181,126075,5.203396274236472,0.1610081286277114
108,0.011,3,334,3,19818,656626,184,126072,5.200750855404892,0.16107361971028417
109,0.0111,4,293,4,20111,656333,188,126068,5.198430173615511,0.1611296509079104
110,0.0112,6,297,6,20408,656036,194,126062,5.1960778101634775,0.16118440400052167
111,0.0113,2,273,2,20681,655763,196,126060,5.193915536687365,0.1612385412043391
112,0.0114,5,289,5,20970,655474,201,126055,5.191626536560639,0.16129279911557984
113,0.0115,2,307,2,21277,655167,203,126053,5.189194968951971,0.16135403599498221
114,0.0116,5,329,5,21606,654838,208,126048,5.1865891521987075,0.16141664724428406
115,0.0117,4,289,4,21895,654549,212,126044,5.184300152071981,0.16147211158696018
116,0.0118,3,317,3,22212,654232,215,126041,5.181789380306679,0.16153448857002614
117,0.0119,5,290,5,22502,653942,220,126036,5.179492459764289,0.1615891730279572
118,0.012,4,306,4,22808,653636,224,126032,5.177068812571283,0.16164829132399944
119,0.0121,4,329,4,23137,653307,228,126028,5.17446299581802,0.16171222901576343
120,0.0122,4,319,4,23456,652988,232,126024,5.171936383221391,0.16177414468583282
121,0.0123,4,312,4,23768,652676,236,126020,5.169465213534406,0.16183465691360943
122,0.0124,4,290,4,24058,652386,240,126016,5.167168292992017,0.16189064262424813
123,0.0125,2,334,2,24392,652052,242,126014,5.164522874160436,0.16195798299887157
124,0.0126,3,328,3,24720,651724,245,126011,5.161924977822836,0.16202305412511975
125,0.0127,6,330,6,25050,651394,251,126005,5.15931124065391,0.1620853641437666
126,0.0128,3,314,3,25364,651080,254,126002,5.156824230135597,0.16214762406026648
127,0.0129,7,320,7,25684,650760,261,125995,5.154289697123305,0.16220687346718077
128,0.013,3,303,3,25987,650457,264,125992,5.15188981117729,0.1622669357549562
129,0.0131,5,333,5,26320,650124,269,125987,5.149252312761374,0.16233116139315124
130,0.0132,12,330,12,26650,649794,281,125975,5.146638575592447,0.16238725703141013
131,0.0133,5,362,5,27012,649432,286,125970,5.1437713851222915,0.16245766711976498
132,0.0134,2,321,2,27333,649111,288,125968,5.141228931694335,0.16252278799967487
133,0.0135,7,328,7,27661,648783,295,125961,5.1386310353567355,0.1625840277562653
134,0.0136,7,339,7,28000,648444,302,125954,5.135946014446838,0.16264763080483163
135,0.0137,6,330,6,28330,648114,308,125948,5.133332277277912,0.1627104805558211
136,0.0138,5,315,5,28645,647799,313,125943,5.130837346343936,0.162771311367355
137,0.0139,3,340,3,28985,647459,316,125940,5.128144405018375,0.16283962094598
138,0.014,2,360,2,29345,647099,318,125938,5.125293055379546,0.1629132887559069
139,0.0141,2,342,2,29687,646757,320,125936,5.1225842732226585,0.16298322878555907
140,0.0142,5,357,5,30044,646400,325,125931,5.11975668483082,0.1630531469020407
141,0.0143,10,328,10,30372,646072,335,125921,5.11715878849322,0.16311158261797712
142,0.0144,6,309,6,30681,645763,341,125915,5.114711380053225,0.163170389722138
143,0.0145,2,359,2,31040,645404,343,125913,5.111867950830059,0.16324416549875084
144,0.0146,5,332,5,31372,645072,348,125908,5.1092383728298065,0.16330903525383278
145,0.0147,4,367,4,31739,644705,352,125904,5.106331580281333,0.16338246763274242
146,0.0148,9,364,9,32103,644341,361,125895,5.10344854897985,0.1634499036658894
147,0.0149,3,329,3,32432,644012,364,125892,5.100842732226587,0.16351649036763025
148,0.015,1,393,1,32825,643619,365,125891,5.097730008870865,0.16359891359436524
149,0.0151,10,343,10,33168,643276,375,125881,5.0950133062983145,0.16366099508942908
150,0.0152,7,349,7,33517,642927,382,125874,5.092249081231783,0.16372767465182797
151,0.0153,10,356,10,33873,642571,392,125864,5.0894294132556075,0.16379264348969008
152,0.0154,6,357,6,34230,642214,398,125858,5.086601824863769,0.16386224208147152
153,0.0155,3,385,3,34615,641829,401,125855,5.083552464833354,0.16394115287019137
154,0.0156,8,362,8,34977,641467,409,125847,5.080685274363199,0.16400977956872936
155,0.0157,8,326,8,35303,641141,417,125839,5.078103218856926,0.16407077107616888
156,0.0158,9,369,9,35672,640772,426,125830,5.075180585477126,0.16413993180294337
157,0.0159,4,349,4,36021,640423,430,125826,5.072416360410594,0.1642103284963504
158,0.016,6,336,6,36357,640087,436,125820,5.069755100747687,0.16427581938799357
159,0.0161,7,383,7,36740,639704,443,125813,5.0667215815486,0.16435036713750314
160,0.0162,6,392,6,37132,639312,449,125807,5.063616778608542,0.1644280170796961
161,0.0163,7,367,7,37499,638945,456,125800,5.060709986060068,0.16449927753695676
162,0.0164,8,382,8,37881,638563,464,125792,5.057684387276645,0.16457274433999908
163,0.0165,8,353,8,38234,638210,472,125784,5.054888480547459,0.16464003644007674
164,0.0166,7,355,7,38589,637855,479,125777,5.052076732986947,0.1647089173842898
165,0.0167,2,355,2,38944,637500,481,125775,5.0492649854264355,0.16478333497101308
166,0.0168,4,349,4,39293,637151,485,125771,5.046500760359904,0.16485433635417512
167,0.0169,10,398,10,39691,636753,495,125761,5.043348434925865,0.16492943080389344
168,0.017,12,378,12,40069,636375,507,125749,5.040354517805095,0.16499808430124233
169,0.0171,10,360,10,40429,636015,517,125739,5.037503168166265,0.16506509975661435
170,0.0172,4,386,4,40815,635629,521,125735,5.034445887720188,0.1651443987370036
171,0.0173,12,365,12,41180,635264,533,125723,5.031554936003041,0.16521044380521613
172,0.0174,6,435,6,41615,634829,539,125717,5.028109555189456,0.1652983514475127
173,0.0175,7,422,7,42037,634407,546,125710,5.024767139779495,0.16538243454626064
174,0.0176,9,364,9,42401,634043,555,125701,5.021884108478013,0.16545178375873978
175,0.0177,12,386,12,42787,633657,567,125689,5.018826828031935,0.16552269979693052
176,0.0178,5,387,5,43174,633270,572,125684,5.0157616271701935,0.1656016043133049
177,0.0179,8,375,8,43549,632895,580,125676,5.0127914712964134,0.16567466987269483
178,0.018,3,380,3,43929,632515,583,125673,5.009781713344316,0.16575440392092727
179,0.0181,8,395,8,44324,632120,591,125665,5.006653149157268,0.1658319972023727
180,0.0182,6,379,6,44703,631741,597,125659,5.003651311620834,0.16590837074201215
181,0.0183,9,370,9,45073,631371,606,125650,5.000720757825371,0.16597954350011426
182,0.0184,10,356,10,45429,631015,616,125640,4.997901089849195,0.16604661305350524
183,0.0185,8,372,8,45801,630643,624,125632,4.994954695222405,0.1661194671250537
184,0.0186,2,392,2,46193,630251,626,125630,4.991849892282347,0.16620341032517022
185,0.0187,9,402,9,46595,629849,635,125621,4.988665885185655,0.16628191721709665
186,0.0188,8,415,8,47010,629434,643,125613,4.985378912685338,0.16636447797289441
187,0.0189,6,397,6,47407,629037,649,125607,4.982234507666963,0.16644537026730485
188,0.019,10,379,10,47786,628658,659,125597,4.9792326701305285,0.16651795480308385
189,0.0191,13,391,13,48177,628267,672,125584,4.976135787606133,0.1665899494727738
190,0.0192,13,373,13,48550,627894,685,125571,4.97318147256368,0.16665803985586589
191,0.0193,4,417,4,48967,627477,689,125567,4.9698786592320365,0.16674590063794414
192,0.0194,7,403,7,49370,627074,696,125560,4.966686731719681,0.1668274353802778
193,0.0195,7,405,7,49775,626669,703,125553,4.963478963375998,0.1669095027797645
194,0.0196,7,391,7,50166,626278,710,125546,4.960382080851603,0.1669885505118219
195,0.0197,11,393,11,50559,625885,721,125535,4.957269357495881,0.1670636927417423
196,0.0198,15,409,15,50968,625476,736,125520,4.954029907489545,0.16713804068197433
197,0.0199,1,371,1,51339,625105,737,125519,4.951091433278418,0.16721954000937886
198,0.02,13,395,13,51734,624710,750,125506,4.94796286909137,0.16729315290529662
199,0.0201,15,368,15,52102,624342,765,125491,4.945048156127234,0.16735859851460258
200,0.0202,6,418,6,52520,623924,771,125485,4.941737422379926,0.16744528021414207
201,0.0203,2,426,2,52946,623498,773,125483,4.9383633253073125,0.16753829536396783
202,0.0204,15,406,15,53352,623092,788,125468,4.935147636547966,0.16761248263332265
203,0.0205,9,403,9,53755,622689,797,125459,4.93195570903561,0.16769275597876357
204,0.0206,13,377,13,54132,622312,810,125446,4.928969712330503,0.1677628323602021
205,0.0207,8,432,8,54564,621880,818,125438,4.925548092763909,0.16785090149039633
206,0.0208,6,401,6,54965,621479,824,125432,4.922372006082879,0.1679343322028997
207,0.0209,11,425,11,55390,621054,835,125421,4.919005829425928,0.1680176831106199
208,0.021,6,377,6,55767,620677,841,125415,4.9160198327208215,0.16809589165947364
209,0.0211,12,416,12,56183,620261,853,125403,4.912724939804841,0.1681762831516608
210,0.0212,7,411,7,56594,619850,860,125396,4.909469648967177,0.16826121844330597
211,0.0213,9,426,9,57020,619424,869,125387,4.9060955518945635,0.16834740625474112
212,0.0214,9,385,9,57405,619039,878,125378,4.903046191864149,0.1684244180345156
213,0.0215,9,381,9,57786,618658,887,125369,4.900028513496388,0.1685006054887793
214,0.0216,8,420,8,58206,618238,895,125361,4.896701938917754,0.1685868324190861
215,0.0217,7,391,7,58597,617847,902,125354,4.893605056393359,0.16866769554938704
216,0.0218,10,438,10,59035,617409,912,125344,4.8901359143327845,0.16875596598061535
217,0.0219,4,367,4,59402,617042,916,125340,4.887229121784311,0.1688349124844083
218,0.022,7,409,7,59811,616633,923,125333,4.883989671777975,0.168920139197753
219,0.0221,12,402,12,60213,616231,935,125321,4.880805664681282,0.1689982631022504
220,0.0222,9,414,9,60627,615817,944,125312,4.877526612596629,0.1690825753681208
221,0.0223,11,407,11,61034,615410,955,125301,4.87430300342162,0.16916314190014728
222,0.0224,11,413,11,61447,614997,966,125290,4.8710318717526295,0.16924517112957543
223,0.0225,13,434,13,61881,614563,979,125277,4.867594411354708,0.16932985510380621
224,0.0226,11,386,11,62267,614177,990,125266,4.86453713090863,0.16940589065012449
225,0.0227,14,439,14,62706,613738,1004,125252,4.8610600684323915,0.1694907914856764
226,0.0228,13,393,13,63099,613345,1017,125239,4.85794734507667,0.16956635941206416
227,0.0229,6,405,6,63504,612940,1023,125233,4.854739576732987,0.1696526424022553
228,0.023,10,415,10,63919,612525,1033,125223,4.85145260423267,0.16973682070300428
229,0.0231,17,408,17,64327,612117,1050,125206,4.848221074641997,0.16981160224216524
230,0.0232,6,404,6,64731,611713,1056,125200,4.845021226713978,0.16989793910543036
231,0.0233,7,424,7,65155,611289,1063,125193,4.84166297047269,0.16998786121045728
232,0.0234,8,419,8,65574,610870,1071,125185,4.83834431630972,0.17007560576315628
233,0.0235,17,402,17,65976,610468,1088,125168,4.835160309213028,0.17014936735015687
234,0.0236,11,398,11,66374,610070,1099,125157,4.832007983778989,0.17022905850846065
235,0.0237,11,371,11,66745,609699,1110,125146,4.829069509567862,0.17030258081636263
236,0.0238,6,458,6,67203,609241,1116,125140,4.825441959194018,0.17040201203462507
237,0.0239,10,409,10,67612,608832,1126,125130,4.822202509187682,0.17048566547041946
238,0.024,14,388,14,68000,608444,1140,125116,4.8191293879102775,0.17056000872457605
239,0.0241,10,408,10,68408,608036,1150,125106,4.815897858319604,0.1706436133791271
240,0.0242,10,424,10,68832,607612,1160,125096,4.812539602078317,0.17073104156089466
241,0.0243,5,375,5,69207,607237,1165,125091,4.809569446204537,0.17081280519111655
242,0.0244,12,402,12,69609,606835,1177,125079,4.806385439107844,0.17089302841590678
243,0.0245,11,409,11,70018,606426,1188,125068,4.803145989101508,0.17097611190248999
244,0.0246,11,402,11,70420,606024,1199,125057,4.799961982004816,0.17105765298236447
245,0.0247,18,407,18,70827,605617,1217,125039,4.7967383728298065,0.17113251653308809
246,0.0248,6,422,6,71249,605195,1223,125033,4.793395957419845,0.17122460382236782
247,0.0249,12,411,12,71660,604784,1235,125021,4.790140666582182,0.17130740403258404
248,0.025,14,425,14,72085,604359,1249,125007,4.786774489925231,0.17139131793914167
249,0.0251,9,413,9,72498,603946,1258,124998,4.783503358256241,0.1714781931122281
250,0.0252,12,415,12,72913,603531,1270,124986,4.780216385755924,0.17156222847236235
251,0.0253,10,399,10,73312,603132,1280,124976,4.777056139906223,0.17164486587154654
252,0.0254,16,459,16,73771,602673,1296,124960,4.773420669116716,0.17173492681063118
253,0.0255,15,433,15,74204,602240,1311,124945,4.769991129134457,0.17182010079965895
254,0.0256,17,426,17,74630,601814,1328,124928,4.766617032061842,0.1719014450795468
255,0.0257,10,424,10,75054,601390,1338,124918,4.763258775820555,0.17199039525931148
256,0.0258,12,399,12,75453,600991,1350,124906,4.760098529970853,0.1720712442674374
257,0.0259,10,391,10,75844,600600,1360,124896,4.757001647446458,0.17215256872539614
258,0.026,13,418,13,76262,600182,1373,124883,4.753690913699151,0.17223697185769551
259,0.0261,8,428,8,76690,599754,1381,124875,4.75030097579521,0.17232956450818282
260,0.0262,14,396,14,77086,599358,1395,124861,4.747164491192498,0.17240779377508736
261,0.0263,11,381,11,77467,598977,1406,124850,4.744146812824737,0.1724859669506664
262,0.0264,15,426,15,77893,598551,1421,124835,4.740772715752123,0.17257038427616792
263,0.0265,8,430,8,78323,598121,1429,124827,4.737366937016855,0.17266387070716013
264,0.0266,7,394,7,78717,597727,1436,124820,4.734246293245469,0.17275000795795983
265,0.0267,15,437,15,79154,597290,1451,124805,4.7307850716005575,0.17283736904423933
266,0.0268,19,429,19,79583,596861,1470,124786,4.727387213280953,0.17291833819027863
267,0.0269,12,399,12,79982,596462,1482,124774,4.7242269674312505,0.17300023847949908
268,0.027,10,407,10,80389,596055,1492,124764,4.721003358256241,0.17308644749930288
269,0.0271,10,393,10,80782,595662,1502,124754,4.717890634900519,0.17316939101852263
270,0.0272,9,428,9,81210,595234,1511,124745,4.714500696996579,0.17326199791938376
271,0.0273,9,397,9,81607,594837,1520,124736,4.711356291978203,0.17334724899350032
272,0.0274,11,403,11,82010,594434,1531,124725,4.708164364465847,0.17343174457943236
273,0.0275,12,424,12,82434,594010,1543,124713,4.70480610822456,0.17352025745662794
274,0.0276,6,399,6,82833,593611,1549,124707,4.701645862374858,0.1736097383053188
275,0.0277,13,441,13,83274,593170,1562,124694,4.698152959067292,0.17370142533961866
276,0.0278,17,390,17,83664,592780,1579,124677,4.69506399695856,0.17377626812477961
277,0.0279,9,408,9,84072,592372,1588,124668,4.691832467367887,0.17386477741827513
278,0.028,17,427,17,84499,591945,1605,124651,4.68845044987961,0.17394878006575532
279,0.0281,15,459,15,84958,591486,1620,124636,4.684814979090103,0.17404297033187083
280,0.0282,14,375,14,85333,591111,1634,124622,4.681844823216323,0.1741180021041366
281,0.0283,10,449,10,85782,590662,1644,124612,4.67828855658345,0.17421575508126955
282,0.0284,11,425,11,86207,590237,1655,124601,4.674922379926499,0.17430662611668657
283,0.0285,10,406,10,86613,589831,1665,124591,4.671706691167152,0.17439412560083536
284,0.0286,11,441,11,87054,589390,1676,124580,4.668213787859587,0.17448912419289325
285,0.0287,11,420,11,87474,588970,1687,124569,4.664887213280953,0.1745791049963632
286,0.0288,12,401,12,87875,588569,1699,124557,4.661711126599924,0.1746633834694009
287,0.0289,9,435,9,88310,588134,1708,124548,4.658265745786339,0.17475957018698382
288,0.029,18,401,18,88711,587733,1726,124530,4.65508965910531,0.1748371037102868
289,0.0291,12,414,12,89125,587319,1738,124518,4.651810607020656,0.17492487746492524
290,0.0292,25,435,25,89560,586884,1763,124493,4.648365226207071,0.1750028465918915
291,0.0293,16,437,16,89997,586447,1779,124477,4.644904004562159,0.17509185229363478
292,0.0294,16,441,16,90438,586006,1795,124461,4.641411101254594,0.17518195778269785
293,0.0295,9,395,9,90833,585611,1804,124452,4.638282537067545,0.17526895500821757
294,0.0296,17,432,17,91265,585179,1821,124435,4.6348609175009505,0.17535589771340476
295,0.0297,9,472,9,91737,584707,1830,124426,4.631122481307819,0.1754621488493696
296,0.0298,12,444,12,92181,584263,1842,124414,4.627605816753263,0.17555811744983962
297,0.0299,9,407,9,92588,583856,1851,124405,4.624382207578254,0.17564852504938153
298,0.03,10,439,10,93027,583417,1861,124395,4.620905145102015,0.17574581951139567
299,0.0301,20,443,20,93470,582974,1881,124375,4.6173964009631225,0.17583258052248607
300,0.0302,11,426,11,93896,582548,1892,124364,4.614022303890509,0.17592571635507673
301,0.0303,12,400,12,94296,582148,1904,124352,4.610854137625142,0.17601132342533615
302,0.0304,15,413,15,94709,581735,1919,124337,4.607583005956153,0.17609677200058918
303,0.0305,14,442,14,95151,581293,1933,124323,4.604082182232924,0.17619073263644816
304,0.0306,13,448,13,95599,580845,1946,124310,4.600533836015714,0.17628748289383186
305,0.0307,18,466,18,96065,580379,1964,124292,4.596842922316563,0.17638302129646316
306,0.0308,12,426,12,96491,579953,1976,124280,4.593468825243948,0.17647568347407747
307,0.0309,15,403,15,96894,579550,1991,124265,4.590276897731593,0.17655918103478896
308,0.031,12,470,12,97364,579080,2003,124253,4.586554302369788,0.17666311690195113
309,0.0311,13,424,13,97788,578656,2016,124240,4.583196046128501,0.17675445585122124
310,0.0312,10,375,10,98163,578281,2026,124230,4.58022589025472,0.17683708867192116
311,0.0313,11,392,11,98555,577889,2037,124219,4.577121087314662,0.1769229235388288
312,0.0314,14,428,14,98983,577461,2051,124205,4.573731149410721,0.17701441996619474
313,0.0315,12,409,12,99392,577052,2063,124193,4.570491699404385,0.1771035800611769
314,0.0316,12,429,12,99821,576623,2075,124181,4.56709384108478,0.1771979041215518
315,0.0317,22,436,22,100257,576187,2097,124159,4.563640539855531,0.1772823718561968
316,0.0318,16,388,16,100645,575799,2113,124143,4.560567418578127,0.1773618385523372
317,0.0319,21,404,21,101049,575395,2134,124122,4.557367570650108,0.1774395761646965
318,0.032,11,422,11,101471,574973,2145,124111,4.554025155240147,0.17753374415663925
319,0.0321,12,430,12,101901,574543,2157,124099,4.550619376504879,0.17762888575264585
320,0.0322,18,425,18,102326,574118,2175,124081,4.547253199847928,0.17771580881668406
321,0.0323,18,422,18,102748,573696,2193,124063,4.543910784437967,0.17780207779476867
322,0.0324,12,429,12,103177,573267,2205,124051,4.540512926118363,0.17789731514172874
323,0.0325,13,428,13,103605,572839,2218,124038,4.5371229882144215,0.17799123805205222
324,0.0326,15,445,15,104050,572394,2233,124023,4.533598403244202,0.17808726668073868
325,0.0327,20,421,20,104471,571973,2253,124003,4.530263908249905,0.17817137372553077
326,0.0328,15,435,15,104906,571538,2268,123988,4.52681852743632,0.17826508282939818
327,0.0329,8,430,8,105336,571108,2276,123980,4.523412748701052,0.17836590474875125
328,0.033,9,446,9,105782,570662,2285,123971,4.5198802433151695,0.17846978188482263
329,0.0331,14,428,14,106210,570234,2299,123957,4.516490305411228,0.1785632484431518
330,0.0332,24,449,24,106659,569785,2323,123933,4.512934038778355,0.1786504026131656
331,0.0333,19,439,19,107098,569346,2342,123914,4.509456976302117,0.17874102068488013
332,0.0334,15,421,15,107519,568925,2357,123899,4.506122481307819,0.1788318533999977
333,0.0335,18,409,18,107928,568516,2375,123881,4.502883031301483,0.17891614203989908
334,0.0336,13,462,13,108390,568054,2388,123868,4.4992237992649855,0.17902017857504168
335,0.0337,12,431,12,108821,567623,2400,123856,4.495810100114054,0.17911751477629834
336,0.0338,19,445,19,109266,567178,2419,123837,4.492285515143835,0.17921029210653894
337,0.0339,19,431,19,109697,566747,2438,123818,4.488871815992903,0.17929955905671444
338,0.034,17,477,17,110174,566270,2455,123801,4.485093777721455,0.17940327879305173
339,0.0341,16,398,16,110572,565872,2471,123785,4.481941452287416,0.17948777435739796
340,0.0342,14,406,14,110978,565466,2485,123771,4.47872576352807,0.17957683641476008
341,0.0343,12,434,12,111412,565032,2497,123759,4.4752883031301485,0.17967569262664582
342,0.0344,16,434,16,111846,564598,2513,123743,4.471850842732227,0.17976991055305439
343,0.0345,15,458,15,112304,564140,2528,123728,4.468223292358383,0.17987171957410433
344,0.0346,21,423,21,112727,563717,2549,123707,4.4648729565327585,0.17995734801228935
345,0.0347,12,431,12,113158,563286,2561,123695,4.4614592573818275,0.18005592585530023
346,0.0348,12,422,12,113580,562864,2573,123683,4.458116841971867,0.1801522692546905
347,0.0349,11,428,11,114008,562436,2584,123672,4.454726904067925,0.1802515055938715
348,0.035,18,434,18,114442,562002,2602,123654,4.451289443670004,0.18034407924673598
349,0.0351,18,470,18,114912,561532,2620,123636,4.447566848308199,0.18044625551689514
350,0.0352,14,412,14,115324,561120,2634,123622,4.4443036370548725,0.18053807127355997
351,0.0353,10,430,10,115754,560690,2644,123612,4.440897858319604,0.18063954219043638
352,0.0354,13,406,13,116160,560284,2657,123599,4.437682169560259,0.18073120694621742
353,0.0355,18,435,18,116595,559849,2675,123581,4.434236788746674,0.18082466382804382
354,0.0356,15,470,15,117065,559379,2690,123566,4.430514193384869,0.18093111451141747
355,0.0357,14,402,14,117467,558977,2704,123552,4.427330186288176,0.18102087969888458
356,0.0358,16,417,16,117884,558560,2720,123536,4.424027372956533,0.18111233609345312
357,0.0359,13,485,13,118369,558075,2733,123523,4.420185971359777,0.1812255904506762
358,0.036,13,427,13,118796,557648,2746,123510,4.416803953871499,0.18132356956829399
359,0.0361,15,393,15,119189,557255,2761,123495,4.413691230515777,0.18141020932794713
360,0.0362,18,435,18,119624,556820,2779,123477,4.410245849702193,0.18150454874856128
361,0.0363,15,441,15,120065,556379,2794,123462,4.406752946394627,0.1816042280474405
362,0.0364,18,423,18,120488,555956,2812,123444,4.403402610569002,0.18169561377686194
363,0.0365,19,415,19,120903,555541,2831,123425,4.400115638068685,0.18178377120503825
364,0.0366,22,427,22,121330,555114,2853,123403,4.396733620580408,0.18187164065159753
365,0.0367,11,463,11,121793,554651,2864,123392,4.393066468128247,0.18198255862828758
366,0.0368,18,398,18,122191,554253,2882,123374,4.3899141426942085,0.18206771571971012
367,0.0369,20,417,20,122608,553836,2902,123354,4.386611329362565,0.18215567270633057
368,0.037,19,440,19,123048,553396,2921,123335,4.383126346470663,0.18225114558074035
369,0.0371,15,420,15,123468,552976,2936,123320,4.379799771892029,0.18234619160840815
370,0.0372,18,400,18,123868,552576,2954,123302,4.376631605626663,0.18243233246236748
371,0.0373,12,419,12,124287,552157,2966,123290,4.373312951463693,0.18253097578344415
372,0.0374,12,423,12,124710,551734,2978,123278,4.369962615638069,0.1826308273038109
373,0.0375,15,432,15,125142,551302,2993,123263,4.366540996071474,0.18272961093445406
374,0.0376,15,460,15,125602,550842,3008,123248,4.362897604866303,0.18283611980596062
375,0.0377,18,381,18,125983,550461,3026,123230,4.359879926498543,0.1829176877826778
376,0.0378,21,420,21,126403,550041,3047,123209,4.356553351919909,0.18300631266245823
377,0.0379,12,432,12,126835,549609,3059,123197,4.353131732353314,0.18310924694488456
378,0.038,10,413,10,127248,549196,3069,123187,4.349860600684324,0.18320956954592843
379,0.0381,24,430,24,127678,548766,3093,123163,4.346454821949056,0.18329764007804397
380,0.0382,24,441,24,128119,548325,3117,123139,4.342961918641491,0.1833888339508894
381,0.0383,21,426,21,128545,547899,3138,123118,4.339587821568876,0.18347970319678936
382,0.0384,17,418,17,128963,547481,3155,123101,4.336277087821569,0.1835733735769824
383,0.0385,14,428,14,129391,547053,3169,123087,4.332887149917628,0.1836735607485003
384,0.0386,18,435,18,129826,546618,3187,123069,4.329441769104043,0.18377092582056992
385,0.0387,13,441,13,130267,546177,3200,123056,4.325948865796477,0.1838761686886331
386,0.0388,14,405,14,130672,545772,3214,123042,4.322741097452794,0.18397043124097281
387,0.0389,18,430,18,131102,545342,3232,123024,4.319335318717527,0.18406681369189934
388,0.039,13,463,13,131565,544879,3245,123011,4.3156681662653655,0.18417853239305873
389,0.0391,16,432,16,131997,544447,3261,122995,4.312246546698771,0.1842781844714597
390,0.0392,12,399,12,132396,544048,3273,122983,4.309086300849069,0.18437373975122595
391,0.0393,20,393,20,132789,543655,3293,122963,4.305973577493347,0.1844579654314765
392,0.0394,14,416,14,133205,543239,3307,122949,4.302678684577367,0.18455601121605314
393,0.0395,22,404,22,133609,542835,3329,122927,4.299478836649348,0.18464105791559146
394,0.0396,16,395,16,134004,542440,3345,122911,4.296350272462298,0.18473106676025136
395,0.0397,19,439,19,134443,542001,3364,122892,4.29287320998606,0.18482973952199827
396,0.0398,9,417,9,134860,541584,3373,122883,4.289570396654416,0.1849346920163078
397,0.0399,14,429,14,135289,541155,3387,122869,4.286172538334812,0.18503698661494164
398,0.04,10,464,10,135753,540691,3397,122859,4.282497465466988,0.1851540953959762
399,0.0401,15,453,15,136206,540238,3412,122844,4.278909517171461,0.18526215460531276
400,0.0402,23,426,23,136632,539812,3435,122821,4.275535420098847,0.18535297819456623
401,0.0403,20,450,20,137082,539362,3455,122801,4.27197123305031,0.1854543367720637
402,0.0404,18,384,18,137466,538978,3473,122783,4.26892979343556,0.1855397945784052
403,0.0405,13,464,13,137930,538514,3486,122770,4.265254720567736,0.18565397015503174
404,0.0406,19,426,19,138356,538088,3505,122751,4.261880623495121,0.18575023568524254
405,0.0407,20,437,20,138793,537651,3525,122731,4.258419401850209,0.1858484937505868
406,0.0408,21,390,21,139183,537261,3546,122710,4.255330439741478,0.1859324121817474
407,0.0409,16,434,16,139617,536827,3562,122694,4.251892979343556,0.1860350163224522
408,0.041,12,436,12,140053,536391,3574,122682,4.248439678114307,0.18614326485836927
409,0.0411,26,428,26,140481,535963,3600,122656,4.245049740210367,0.18623210080486594
410,0.0412,22,425,22,140906,535538,3622,122634,4.241683563553416,0.18632515512662343
411,0.0413,22,400,22,141306,535138,3644,122612,4.23851539728805,0.1864112504751045
412,0.0414,15,415,15,141721,534723,3659,122597,4.235228424787733,0.18651037546400537
413,0.0415,11,397,11,142118,534326,3670,122586,4.232084019769357,0.18660946976155102
414,0.0416,17,412,17,142530,533914,3687,122569,4.228820808516031,0.1867055201734089
415,0.0417,15,429,15,142959,533485,3702,122554,4.225422950196426,0.18680901592740676
416,0.0418,19,434,19,143393,533051,3721,122535,4.221985489798505,0.18690911642408473
417,0.0419,20,391,20,143784,532660,3741,122515,4.21888860727411,0.18699584080589154
418,0.042,15,424,15,144208,532236,3756,122500,4.215530351032823,0.1870983113804648
419,0.0421,18,402,18,144610,531834,3774,122482,4.2123463439361295,0.18719089858722696
420,0.0422,12,405,12,145015,531429,3786,122470,4.209138575592447,0.18729192122942534
421,0.0423,22,423,22,145438,531006,3808,122448,4.205788239766823,0.18738579915342166
422,0.0424,26,400,26,145838,530606,3834,122422,4.202620073501457,0.18746822494594412
423,0.0425,15,449,15,146287,530157,3849,122407,4.199063806868584,0.18757853635811966
424,0.0426,20,412,20,146699,529745,3869,122387,4.195800595615258,0.18767212772874203
425,0.0427,21,423,21,147122,529322,3890,122366,4.192450259789633,0.18776776617031463
426,0.0428,16,407,16,147529,528915,3906,122350,4.189226650614624,0.1878651547373189
427,0.0429,22,430,22,147959,528485,3928,122328,4.185820871879356,0.18796182620814275
428,0.043,23,385,23,148344,528100,3951,122305,4.182771511848942,0.18804437235261107
429,0.0431,21,391,21,148735,527709,3972,122284,4.179674629324547,0.18813125679815013
430,0.0432,23,429,23,149164,527280,3995,122261,4.176276771004942,0.18822676320663362
431,0.0433,10,437,10,149601,526843,4005,122251,4.17281554936003,0.18834097988889129
432,0.0434,11,434,11,150035,526409,4016,122240,4.169378088962109,0.18845323125449973
433,0.0435,18,436,18,150471,525973,4034,122222,4.16592478773286,0.18855745570391627
434,0.0436,25,386,25,150857,525587,4059,122197,4.162867507286783,0.18863849678287825
435,0.0437,19,361,19,151218,525226,4078,122178,4.16000823723229,0.18871987198101958
436,0.0438,22,405,22,151623,524821,4100,122156,4.1568004688886075,0.18881042139055948
437,0.0439,13,374,13,151997,524447,4113,122143,4.15383823343049,0.18890332358991013
438,0.044,12,389,12,152386,524058,4125,122131,4.150757191737422,0.1890019792970787
439,0.0441,18,407,18,152793,523651,4143,122113,4.147533582562413,0.18909849418673075
440,0.0442,19,416,19,153209,523235,4162,122094,4.144238689646433,0.189196518365051
441,0.0443,20,402,20,153611,522833,4182,122074,4.14105468254974,0.18928930838089833
442,0.0444,28,427,28,154038,522406,4210,122046,4.137672665061462,0.18937950382650687
443,0.0445,14,379,14,154417,522027,4224,122032,4.134670827525029,0.18947332464882877
444,0.0446,12,438,12,154855,521589,4236,122020,4.131201685464453,0.18958715617711996
445,0.0447,23,415,23,155270,521174,4259,121997,4.127914712964136,0.18968050487350954
446,0.0448,28,424,28,155694,520750,4287,121969,4.124556456722849,0.18977033509200755
447,0.0449,16,385,16,156079,520365,4303,121953,4.121507096692435,0.18986389919012078
448,0.045,26,431,26,156510,519934,4329,121927,4.118093397541503,0.18995857358524665
449,0.0451,21,418,21,156928,519516,4350,121906,4.1147826637941955,0.19005584467012357
450,0.0452,17,433,17,157361,519083,4367,121889,4.111353123811938,0.1901627528191559
451,0.0453,13,399,13,157760,518684,4380,121876,4.108192877962235,0.19026476832771325
452,0.0454,18,423,18,158183,518261,4398,121858,4.104842542136612,0.19036772850048195
453,0.0455,14,440,14,158623,517821,4412,121844,4.101357559244709,0.19048095487481728
454,0.0456,29,422,29,159045,517399,4441,121815,4.098015143834749,0.19056998125823277
455,0.0457,21,423,21,159468,516976,4462,121794,4.094664808009124,0.19066956807614635
456,0.0458,14,440,14,159908,516536,4476,121780,4.091179825117222,0.19078324842241148
457,0.0459,23,408,23,160316,516128,4499,121757,4.087948295526549,0.1908760983562868
458,0.046,27,385,27,160701,515743,4526,121730,4.084898935496135,0.19095710720297174
459,0.0461,20,400,20,161101,515343,4546,121710,4.081730769230769,0.1910516079509868
460,0.0462,28,416,28,161517,514927,4574,121682,4.078435876314789,0.19114087296912233
461,0.0463,17,393,17,161910,514534,4591,121665,4.075323152959068,0.1912373329728591
462,0.0464,16,410,16,162320,514124,4607,121649,4.072075782537068,0.19134030542347663
463,0.0465,15,394,15,162714,513730,4622,121634,4.068955138765682,0.19143986754049647
464,0.0466,10,421,10,163135,513309,4632,121624,4.0656206437713855,0.1915540694844968
465,0.0467,24,397,24,163532,512912,4656,121600,4.06247623875301,0.19164334165468896
466,0.0468,18,427,18,163959,512485,4674,121582,4.059094221264732,0.19174945234494148
467,0.0469,18,397,18,164356,512088,4692,121564,4.055949816246357,0.19184662874890318
468,0.047,28,435,28,164791,511653,4720,121536,4.0525044354327715,0.19194269009726952
469,0.0471,20,432,20,165223,511221,4740,121516,4.049082815866177,0.1920481969601904
470,0.0472,13,368,13,165591,510853,4753,121503,4.04616810290204,0.19214334963216922
471,0.0473,31,424,31,166015,510429,4784,121472,4.042809846660753,0.1922326440375945
472,0.0474,20,416,20,166431,510013,4804,121452,4.0395149537447725,0.19233370020507867
473,0.0475,28,371,28,166802,509642,4832,121424,4.036576479533646,0.19241093641552548
474,0.0476,18,412,18,167214,509230,4850,121406,4.033313268280319,0.19251358945572405
475,0.0477,23,409,23,167623,508821,4873,121383,4.030073818273983,0.19260905992345337
476,0.0478,28,441,28,168064,508380,4901,121355,4.026580914966417,0.19270804385971876
477,0.0479,20,434,20,168498,507946,4921,121335,4.023143454568496,0.19281529237335943
478,0.048,24,404,24,168902,507542,4945,121311,4.019943606640476,0.19290835855120353
479,0.0481,20,402,20,169304,507140,4965,121291,4.016759599543784,0.19300607385695487
480,0.0482,21,396,21,169700,506744,4986,121270,4.013623114941072,0.1931007907467031
481,0.0483,24,410,24,170110,506334,5010,121246,4.010375744519072,0.1931960865547022
482,0.0484,22,377,22,170487,505957,5032,121224,4.007389747813965,0.19328391644517293
483,0.0485,28,408,28,170895,505549,5060,121196,4.004158218223292,0.19337370062784706
484,0.0486,27,384,27,171279,505165,5087,121169,4.001116778608542,0.19345748434541316
485,0.0487,16,419,16,171698,504746,5103,121153,3.9977981244455707,0.19356637412745506
486,0.0488,17,424,17,172122,504322,5120,121136,3.9944398682042834,0.19367567446575149
487,0.0489,23,392,23,172514,503930,5143,121113,3.991335065264225,0.19376746879814669
488,0.049,23,394,23,172908,503536,5166,121090,3.98821442149284,0.19386000582748716
489,0.0491,25,403,25,173311,503133,5191,121065,3.985022493980484,0.1939528803360472
490,0.0492,25,397,25,173708,502736,5216,121040,3.981878088962109,0.19404401580054378
491,0.0493,26,397,26,174105,502339,5242,121014,3.9787336839437333,0.19413398186902125
492,0.0494,28,407,28,174512,501932,5270,120986,3.975510074768724,0.19422460099082062
493,0.0495,20,409,20,174921,501523,5290,120966,3.9722706247623876,0.19432632544510828
494,0.0496,25,366,25,175287,501157,5315,120941,3.969371752629578,0.19440827650948886
495,0.0497,23,402,23,175689,500755,5338,120918,3.9661877455328858,0.19450418467586658
496,0.0498,15,402,15,176091,500353,5353,120903,3.963003738436193,0.1946105953101459
497,0.0499,14,401,14,176492,499952,5367,120889,3.9598276517551643,0.19471813233984225
498,0.05,28,378,28,176870,499574,5395,120861,3.956833734634394,0.194800422284365
499,0.0501,18,417,18,177287,499157,5413,120843,3.95353092130275,0.19490806451612902
500,0.0502,21,399,21,177686,498758,5434,120822,3.9503706754530477,0.19500629458665547
501,0.0503,26,389,26,178075,498369,5460,120796,3.9472896337599797,0.19509500698521395
502,0.0504,30,390,30,178465,497979,5490,120766,3.9442006716512483,0.1951789509410177
503,0.0505,22,405,22,178870,497574,5512,120744,3.9409929033075657,0.19527815784111088
504,0.0506,25,426,25,179296,497148,5537,120719,3.9376188062349513,0.19538023555231143
505,0.0507,14,416,14,179712,496732,5551,120705,3.934323913318971,0.195493629309549
506,0.0508,16,417,16,180129,496315,5567,120689,3.931021099987327,0.1956048907300439
507,0.0509,22,424,22,180553,495891,5589,120667,3.92766284374604,0.19571070361588042
508,0.051,31,389,31,180942,495502,5620,120636,3.924581802052972,0.1957937994410343
509,0.0511,26,394,26,181336,495108,5646,120610,3.921461158281587,0.19588512923123896
510,0.0512,28,380,28,181716,494728,5674,120582,3.9184514003294892,0.19596951130324552
511,0.0513,16,420,16,182136,494308,5690,120566,3.9151248257508553,0.19608244941239994
512,0.0514,28,422,28,182558,493886,5718,120538,3.9117824103408947,0.19618048774136426
513,0.0515,17,390,17,182948,493496,5735,120521,3.9086934482321634,0.19628283907448815
514,0.0516,24,386,24,183334,493110,5759,120497,3.9056361677860854,0.1963748783830693
515,0.0517,12,394,12,183728,492716,5771,120485,3.9025155240147003,0.19648532862797027
516,0.0518,20,424,20,184152,492292,5791,120465,3.8991572677734125,0.19659506133752858
517,0.0519,24,379,24,184531,491913,5815,120441,3.8961554302369787,0.19668525068832735
518,0.052,23,405,23,184936,491508,5838,120418,3.892947661893296,0.19678523220127925
519,0.0521,26,382,26,185318,491126,5864,120392,3.889922063109872,0.19687400861462787
520,0.0522,30,385,30,185703,490741,5894,120362,3.8868727030794576,0.19695861417797
521,0.0523,26,388,26,186091,490353,5920,120336,3.883799581802053,0.19704956205204285
522,0.0524,23,421,23,186512,489932,5943,120313,3.8804650868077557,0.19715524092782408
523,0.0525,29,379,29,186891,489553,5972,120284,3.877463249271322,0.19723959025116547
524,0.0526,20,425,20,187316,489128,5992,120264,3.874097072614371,0.19735080211095649
525,0.0527,29,390,29,187706,488738,6021,120235,3.8710081105056395,0.19743896691643142
526,0.0528,24,358,24,188064,488380,6045,120211,3.868172601698137,0.19752345992628875
527,0.0529,27,410,27,188474,487970,6072,120184,3.8649252312761373,0.19762099731318053
528,0.053,23,401,23,188875,487569,6095,120161,3.8617491445951084,0.1977210274299442
529,0.0531,22,402,22,189277,487167,6117,120139,3.858565137498416,0.1978228438381969
530,0.0532,23,375,23,189652,486792,6140,120116,3.8555949816246358,0.19791467570043564
531,0.0533,24,391,24,190043,486401,6164,120092,3.8524980991002407,0.19801052938780828
532,0.0534,28,414,28,190457,485987,6192,120064,3.8492190470155876,0.19810874002352938
533,0.0535,20,438,20,190895,485549,6212,120044,3.845749904955012,0.19822554091609382
534,0.0536,20,406,20,191301,485143,6232,120024,3.842534216195666,0.1983320306626105
535,0.0537,21,402,21,191703,484741,6253,120003,3.8393502090989737,0.19843603243686586
536,0.0538,25,433,25,192136,484308,6278,119978,3.835920669116715,0.19854505978956985
537,0.0539,23,361,23,192497,483947,6301,119955,3.8330613990622227,0.19863322194660724
538,0.054,19,381,19,192878,483566,6320,119936,3.830043720694462,0.19873339276423277
539,0.0541,17,375,17,193253,483191,6337,119919,3.8270735648206817,0.19883437515544428
540,0.0542,24,377,24,193630,482814,6361,119895,3.8240875681155746,0.19892684529349985
541,0.0543,25,391,25,194021,482423,6386,119870,3.82099068559118,0.19902273478190846
542,0.0544,29,399,29,194420,482024,6415,119841,3.8178304397414777,0.1991160808486953
543,0.0545,26,419,26,194839,481605,6441,119815,3.814511785578507,0.1992201789099132
544,0.0546,30,423,30,195262,481182,6471,119785,3.811161449752883,0.1993204285759451
545,0.0547,25,393,25,195655,480789,6496,119760,3.8080487263971614,0.19941753295734402
546,0.0548,26,419,26,196074,480370,6522,119734,3.804730072234191,0.19952208283897457
547,0.0549,23,359,23,196433,480011,6545,119711,3.8018866430110254,0.19961081967978497
548,0.055,26,399,26,196832,479612,6571,119685,3.798726397161323,0.1997089923693928
549,0.0551,32,397,32,197229,479215,6603,119653,3.7955819921429477,0.19979862006318588
550,0.0552,18,392,18,197621,478823,6621,119635,3.7924771892028892,0.19990542360533237
551,0.0553,19,394,19,198015,478429,6640,119616,3.789356545431504,0.2000117048048224
552,0.0554,22,379,22,198394,478050,6662,119594,3.7863547078950703,0.20010909504654945
553,0.0555,32,376,32,198770,477674,6694,119562,3.7833766316056265,0.20019221882137045
554,0.0556,31,395,31,199165,477279,6725,119531,3.780248067418578,0.20028317219885725
555,0.0557,25,358,25,199523,476921,6750,119506,3.777412558611076,0.20036986923797884
556,0.0558,23,415,23,199938,476506,6773,119483,3.774125586110759,0.20047853232190527
557,0.0559,26,377,26,200315,476129,6799,119457,3.771139589405652,0.20057053053631213
558,0.056,16,390,16,200705,475739,6815,119441,3.7680506272969208,0.20068046641352197
559,0.0561,20,371,20,201076,475368,6835,119421,3.765112153085794,0.2007787635615319
560,0.0562,19,412,19,201488,474956,6854,119402,3.761848941832467,0.20089239145430868
561,0.0563,19,373,19,201861,474583,6873,119383,3.758894626790014,0.20099298613051925
562,0.0564,26,371,26,202232,474212,6899,119357,3.755956152578887,0.20108361454186455
563,0.0565,24,351,24,202583,473861,6923,119333,3.753176086681029,0.20117027481734476
564,0.0566,23,406,23,202989,473455,6946,119310,3.749960397921683,0.20127706595362413
565,0.0567,23,410,23,203399,473045,6969,119287,3.746713027499683,0.20138537171721266
566,0.0568,27,426,27,203825,472619,6996,119260,3.743338930427069,0.2014938864193526
567,0.0569,26,408,26,204233,472211,7022,119234,3.7401074008363957,0.2015977817041314
568,0.057,17,373,17,204606,471838,7039,119217,3.7371530857939423,0.20170204126519528
569,0.0571,27,388,27,204994,471450,7066,119190,3.7340799645165377,0.20179804957334416
570,0.0572,23,380,23,205374,471070,7089,119167,3.7310702065644406,0.20189686515755537
571,0.0573,22,387,22,205761,470683,7111,119145,3.728005005702699,0.20199956597516563
572,0.0574,25,397,25,206158,470286,7136,119120,3.724860600684324,0.20210177704332838
573,0.0575,20,393,20,206551,469893,7156,119100,3.7217478773286023,0.2022095338993842
574,0.0576,25,354,25,206905,469539,7181,119075,3.7189440501837536,0.20229726102335316
575,0.0577,26,389,26,207294,469150,7207,119049,3.7158630084906856,0.2023957878201085
576,0.0578,23,373,23,207667,468777,7230,119026,3.7129086934482323,0.20249301211460302
577,0.0579,23,388,23,208055,468389,7253,119003,3.7098355721708276,0.20259554096753105
578,0.058,34,405,34,208460,467984,7287,118969,3.706627803827145,0.2026891420607783
579,0.0581,23,385,23,208845,467599,7310,118946,3.7035784437967303,0.20279091970778032
580,0.0582,26,359,26,209204,467240,7336,118920,3.700735014573565,0.2028797597925481
581,0.0583,27,344,27,209548,466896,7363,118893,3.6980103915853504,0.2029621587295084
582,0.0584,28,380,28,209928,466516,7391,118865,3.6950006336332533,0.20305578759816256
583,0.0585,15,369,15,210297,466147,7406,118850,3.6920780002534532,0.20316343502616252
584,0.0586,29,387,29,210684,465760,7435,118821,3.689012799391712,0.20325840217181196
585,0.0587,26,335,26,211019,465425,7461,118795,3.6863594601444682,0.20333949539557017
586,0.0588,32,380,32,211399,465045,7493,118763,3.683349702192371,0.2034281818680114
587,0.0589,15,412,15,211811,464633,7508,118748,3.6800864909390443,0.20355136694544387
588,0.059,29,405,29,212216,464228,7537,118719,3.6768787225953616,0.20365316229434235
589,0.0591,31,337,31,212553,463891,7568,118688,3.6742095425167913,0.20372859303201798
590,0.0592,24,360,24,212913,463531,7592,118664,3.671358192877962,0.20382174357388846
591,0.0593,24,391,24,213304,463140,7616,118640,3.6682613103535675,0.203925882636048
592,0.0594,21,395,21,213699,462745,7637,118619,3.6651327461665186,0.20403568160395208
593,0.0595,29,338,29,214037,462407,7666,118590,3.662455645672285,0.20411465119441236
594,0.0596,20,408,20,214445,461999,7686,118570,3.659224116081612,0.2042306771460412
595,0.0597,29,435,29,214880,461564,7715,118541,3.6557787352680267,0.20434404116496152
596,0.0598,22,382,22,215262,461182,7737,118519,3.652753136484603,0.20444850017509025
597,0.0599,31,371,31,215633,460811,7768,118488,3.649814662273476,0.2045368626564175
598,0.06,17,368,17,216001,460443,7785,118471,3.64689994930934,0.20464352218118753
599,0.0601,30,383,30,216384,460060,7815,118441,3.6438664301102524,0.2047377619053381
600,0.0602,16,372,16,216756,459688,7831,118425,3.6409200354834623,0.2048474952128736
601,0.0603,27,367,27,217123,459321,7858,118398,3.6380132429349894,0.20494046413567843
602,0.0604,26,376,26,217499,458945,7884,118372,3.6350351666455456,0.20503813329591888
603,0.0605,24,408,24,217907,458537,7908,118348,3.6318036370548725,0.20515007323816706
604,0.0606,21,364,21,218271,458173,7929,118327,3.62892060575339,0.2052506504770165
605,0.0607,37,387,37,218658,457786,7966,118290,3.6258554048916487,0.2053374901922663
606,0.0608,30,372,30,219030,457414,7996,118260,3.6229090102648587,0.20542876697575363
607,0.0609,28,362,28,219392,457052,8024,118232,3.620041819794703,0.2055193608721953
608,0.061,12,400,12,219792,456652,8036,118220,3.6168736535293373,0.20564577853852684
609,0.0611,20,390,20,220182,456262,8056,118200,3.6137846914206055,0.20575773506341585
610,0.0612,22,348,22,220530,455914,8078,118178,3.6110283867697377,0.20585202371745295
611,0.0613,28,394,28,220924,455520,8106,118150,3.6079077429983526,0.20595464291317309
612,0.0614,20,379,20,221303,455141,8126,118130,3.604905905461919,0.20606310104645098
613,0.0615,26,365,26,221668,454776,8152,118104,3.6020149537447725,0.20615835777126099
614,0.0616,22,360,22,222028,454416,8174,118082,3.5991636041059434,0.20625748910913225
615,0.0617,28,352,28,222380,454064,8202,118054,3.5963756177924218,0.20634554410104208
616,0.0618,20,365,20,222745,453699,8222,118034,3.5934846660752755,0.2064495140214051
617,0.0619,24,393,24,223138,453306,8246,118010,3.5903719427195537,0.20655819196381686
618,0.062,22,377,22,223515,452929,8268,117988,3.587385946014447,0.20666401596028844
619,0.0621,19,374,19,223889,452555,8287,117969,3.58442371055633,0.20677307177261606
620,0.0622,25,396,25,224285,452159,8312,117944,3.581287225953618,0.20688191432074554
621,0.0623,25,365,25,224650,451794,8337,117919,3.578396274236472,0.20697965466822768
622,0.0624,25,367,25,225017,451427,8362,117894,3.575489481687999,0.2070782563790902
623,0.0625,26,364,26,225381,451063,8388,117868,3.5726064503865165,0.2071745079807569
624,0.0626,21,369,21,225750,450694,8409,117847,3.5696838170067164,0.2072796860736517
625,0.0627,20,399,20,226149,450295,8429,117827,3.5665235711570142,0.20739735479351265
626,0.0628,21,363,21,226512,449932,8450,117806,3.563648460271195,0.20750064290218376
627,0.0629,43,398,43,226910,449534,8493,117763,3.560496134837156,0.20758614975929715
628,0.063,23,364,23,227274,449170,8516,117740,3.5576131035356737,0.20768728722372157
629,0.0631,32,360,32,227634,448810,8548,117708,3.5547617538968446,0.2077745102538666
630,0.0632,21,396,21,228030,448414,8569,117687,3.5516252692941324,0.20789046477572024
631,0.0633,26,375,26,228405,448039,8595,117661,3.5486551134203523,0.20799186848152731
632,0.0634,33,369,33,228774,447670,8628,117628,3.5457324800405527,0.20808140131399722
633,0.0635,22,347,22,229121,447323,8650,117606,3.542984095805348,0.20817837285747412
634,0.0636,29,380,29,229501,446943,8679,117577,3.5399743378532507,0.20827782895203004
635,0.0637,29,372,29,229873,446571,8708,117548,3.5370279432264606,0.2083744741800932
636,0.0638,23,336,23,230209,446235,8731,117525,3.534366683563553,0.20846636866751808
637,0.0639,24,345,24,230554,445890,8755,117501,3.5316341401596754,0.20856030714015666
638,0.064,24,391,24,230945,445499,8779,117477,3.5285372576352807,0.2086714176092764
639,0.0641,18,345,18,231290,445154,8797,117459,3.525804714231403,0.2087740596111359
640,0.0642,23,375,23,231665,444779,8820,117436,3.522834558357623,0.2088809441228
641,0.0643,21,368,21,232033,444411,8841,117415,3.519919845393486,0.20898819207370253
642,0.0644,29,359,29,232392,444052,8870,117386,3.5170764161703207,0.20908096708808452
643,0.0645,20,379,20,232771,443673,8890,117366,3.5140745786338865,0.20919401325041576
644,0.0646,20,346,20,233117,443327,8910,117346,3.5113341148143453,0.20929490094939474
645,0.0647,21,369,21,233486,442958,8931,117325,3.5084114814345457,0.20940310521647096
646,0.0648,23,368,23,233854,442590,8954,117302,3.5054967684704095,0.20950826230773079
647,0.0649,19,381,19,234235,442209,8973,117283,3.5024790901026486,0.2096240875651484
648,0.065,22,367,22,234602,441842,8995,117261,3.4995722975541756,0.20973058631414962
649,0.0651,16,358,16,234960,441484,9011,117245,3.4967367887466736,0.20984233859348628
650,0.0652,16,347,16,235307,441137,9027,117229,3.4939884045114686,0.2099501044118016
651,0.0653,30,338,30,235645,440799,9057,117199,3.491311304017235,0.21003480299212543
652,0.0654,25,357,25,236002,440442,9082,117174,3.488483715625396,0.210133855556512
653,0.0655,28,333,28,236335,440109,9110,117146,3.4858462172094793,0.21021973782200248
654,0.0656,27,347,27,236682,439762,9137,117119,3.4830978329742743,0.21031243658878648
655,0.0657,19,366,19,237048,439396,9156,117100,3.4801989608414647,0.21042379460050029
656,0.0658,24,387,24,237435,439009,9180,117076,3.477133759979724,0.21053615904043446
657,0.0659,31,357,31,237792,438652,9211,117045,3.474306171587885,0.21062737427051073
658,0.066,27,354,27,238146,438298,9238,117018,3.4715023444430364,0.21072326387138135
659,0.0661,25,357,25,238503,437941,9263,116993,3.4686747560511977,0.21082326907343937
660,0.0662,30,337,30,238840,437604,9293,116963,3.466005575972627,0.2109086909246313
661,0.0663,27,374,27,239214,437230,9320,116936,3.4630433405145102,0.2110125846767936
662,0.0664,26,353,26,239567,436877,9346,116910,3.460247433785325,0.21111004772593073
663,0.0665,22,380,22,239947,436497,9368,116888,3.4572376758332277,0.21122365080369002
664,0.0666,22,388,22,240335,436109,9390,116866,3.454164554555823,0.21134047651340476
665,0.0667,30,366,30,240701,435743,9420,116836,3.4512656824230135,0.21143764059075715
666,0.0668,17,351,17,241052,435392,9437,116819,3.448485616525155,0.2115477598236906
667,0.0669,24,356,24,241408,435036,9461,116795,3.44566594854898,0.21164994355155836
668,0.067,22,344,22,241752,434692,9483,116773,3.4429413255607653,0.2117505190719266
669,0.0671,21,359,21,242111,434333,9504,116752,3.4400978963376,0.21185842474391428
670,0.0672,20,357,20,242468,433976,9524,116732,3.437270307945761,0.21196714048098084
671,0.0673,31,346,31,242814,433630,9555,116701,3.4345298441262195,0.2120560171969233
672,0.0674,21,350,21,243164,433280,9576,116680,3.431757698644025,0.21216088442795838
673,0.0675,21,362,21,243526,432918,9597,116659,3.4288905081738688,0.21227052806067212
674,0.0676,27,332,27,243858,432586,9624,116632,3.4262609301736155,0.21236011929689122
675,0.0677,26,346,26,244204,432240,9650,116606,3.4235204663540744,0.2124566818378926
676,0.0678,24,345,24,244549,431895,9674,116582,3.4207879229501965,0.21255585922472592
677,0.0679,33,368,33,244917,431527,9707,116549,3.4178732099860603,0.21265116516687466
678,0.068,29,369,29,245286,431158,9736,116520,3.4149505766062602,0.21275274887799034
679,0.0681,35,353,35,245639,430805,9771,116485,3.4121546698770753,0.21283962798516326
680,0.0682,26,344,26,245983,430461,9797,116459,3.4094300468888608,0.21293607840269144
681,0.0683,28,366,28,246349,430095,9825,116431,3.406531174756051,0.21303835499134532
682,0.0684,29,365,29,246714,429730,9854,116402,3.403640223038905,0.213138948093135
683,0.0685,35,350,35,247064,429380,9889,116367,3.4008680775567104,0.21322517576825892
684,0.0686,37,380,37,247444,429000,9926,116330,3.397858319604613,0.213320374818917
685,0.0687,30,326,30,247770,428674,9956,116300,3.39527626409834,0.21340467618638687
686,0.0688,24,353,24,248123,428321,9980,116276,3.3924803573691547,0.21350833735771588
687,0.0689,26,339,26,248462,427982,10006,116250,3.3897953364592572,0.21360375722118508
688,0.069,19,352,19,248814,427630,10025,116231,3.3870073501457356,0.21371453367680346
689,0.0691,35,372,35,249186,427258,10060,116196,3.3840609555189456,0.2138101844866355
690,0.0692,28,360,28,249546,426898,10088,116168,3.3812096058801164,0.2139113846199173
691,0.0693,16,348,16,249894,426550,10104,116152,3.3784533012292486,0.2140253767260854
692,0.0694,32,337,32,250231,426213,10136,116120,3.375784121150678,0.21411199392255312
693,0.0695,26,408,26,250639,425805,10162,116094,3.372552591560005,0.2142354940680828
694,0.0696,29,378,29,251017,425427,10191,116065,3.3695586744392347,0.2143429635156198
695,0.0697,33,375,33,251392,425052,10224,116032,3.3665885185654543,0.21444359840616245
696,0.0698,27,353,27,251745,424699,10251,116005,3.3637926118362693,0.21454437178197314
697,0.0699,28,364,28,252109,424335,10279,115977,3.3609095805347864,0.21464820326033848
698,0.07,33,343,33,252452,423992,10312,115944,3.3581928779622356,0.21473656137023647
699,0.0701,29,337,29,252789,423655,10341,115915,3.355523697883665,0.21482847452601145
700,0.0702,33,345,33,253134,423310,10374,115882,3.352791154479787,0.21491787711983856
701,0.0703,33,349,33,253483,422961,10407,115849,3.3500269294132554,0.2150090013177187
702,0.0704,33,317,33,253800,422644,10440,115816,3.3475161576479535,0.21508747167849052
703,0.0705,28,335,28,254135,422309,10468,115788,3.34486281840071,0.21518053436462198
704,0.0706,32,344,32,254479,421965,10500,115756,3.3421381954124953,0.21527148837408247
705,0.0707,19,368,19,254847,421597,10519,115737,3.339223482448359,0.21539117197125066
706,0.0708,30,316,30,255163,421281,10549,115707,3.33672063109872,0.21547408880645377
707,0.0709,29,360,29,255523,420921,10578,115678,3.333869281459891,0.2155762496762014
708,0.071,28,365,28,255888,420556,10606,115650,3.330978329742745,0.21568203265163016
709,0.0711,19,360,19,256248,420196,10625,115631,3.328126980103916,0.21579912919655037
710,0.0712,23,357,23,256605,419839,10648,115608,3.3252993917120772,0.21590932435890015
711,0.0713,34,312,34,256917,419527,10682,115574,3.322828222025092,0.21598539341171105
712,0.0714,30,327,30,257244,419200,10712,115544,3.3202382461031554,0.2160734856305073
713,0.0715,26,376,26,257620,418824,10738,115518,3.3172601698137116,0.21618738560697082
714,0.0716,22,329,22,257949,418495,10760,115496,3.3146543530604484,0.2162882895030066
715,0.0717,36,347,36,258296,418148,10796,115460,3.311905968825244,0.2163760663258422
716,0.0718,27,395,27,258691,417753,10823,115433,3.3087774046381955,0.21649668220846008
717,0.0719,19,334,19,259025,417419,10842,115414,3.306131985806615,0.21660445205158088
718,0.072,23,331,23,259356,417088,10865,115391,3.3035103282220253,0.21670525973794272
719,0.0721,28,328,28,259684,416760,10893,115363,3.3009124318844254,0.21679762009911244
720,0.0722,24,361,24,260045,416399,10917,115339,3.298053161829933,0.21690945540849066
721,0.0723,26,340,26,260385,416059,10943,115313,3.295360220504372,0.2170099290139488
722,0.0724,21,312,21,260697,415747,10964,115292,3.292889050817387,0.21710646487357801
723,0.0725,31,338,31,261035,415409,10995,115261,3.290211950323153,0.21719901256901653
724,0.0726,34,338,34,261373,415071,11029,115227,3.287534849828919,0.21728726112487695
725,0.0727,17,316,17,261689,414755,11046,115210,3.28503199847928,0.2173917145471871
726,0.0728,22,352,22,262041,414403,11068,115188,3.2822440121657586,0.2175036962486145
727,0.0729,31,362,31,262403,414041,11099,115157,3.2793768216956027,0.21760664250431785
728,0.073,32,342,32,262745,413699,11131,115125,3.276668039538715,0.21770002874302224
729,0.0731,29,340,29,263085,413359,11160,115096,3.273975098213154,0.21779716342924185
730,0.0732,27,352,27,263437,413007,11187,115069,3.2711871118996325,0.21790234738939093
731,0.0733,21,355,21,263792,412652,11208,115048,3.2683753643391205,0.21801781315141178
732,0.0734,28,315,28,264107,412337,11236,115020,3.2658804334051452,0.21810651987173774
733,0.0735,27,339,27,264446,411998,11263,114993,3.263195412495248,0.21820676254433188
734,0.0736,29,317,29,264763,411681,11292,114964,3.2606846407299455,0.2182950564421954
735,0.0737,21,338,21,265101,411343,11313,114943,3.2580075402357114,0.21840406166989051
736,0.0738,17,337,17,265438,411006,11330,114926,3.255338360157141,0.21851874386802855
737,0.0739,30,313,30,265751,410693,11360,114896,3.2528592700544925,0.21860427063732307
738,0.074,30,352,30,266103,410341,11390,114866,3.250071283740971,0.21870614824250248
739,0.0741,24,363,24,266466,409978,11414,114842,3.2471961728551513,0.21882169124652262
740,0.0742,23,345,23,266811,409633,11437,114819,3.2444636294512734,0.21893137980215538
741,0.0743,25,369,25,267180,409264,11462,114794,3.241540996071474,0.21904827328272825
742,0.0744,28,327,28,267507,408937,11490,114766,3.2389510201495373,0.21914329304968655
743,0.0745,37,333,37,267840,408604,11527,114729,3.2363135217336207,0.21922752817040012
744,0.0746,26,338,26,268178,408266,11553,114703,3.2336364212393867,0.21933040008107554
745,0.0747,23,330,23,268508,407936,11576,114680,3.23102268407046,0.21943453702144597
746,0.0748,31,339,31,268847,407597,11607,114649,3.2283376631605627,0.21953064264733477
747,0.0749,25,342,25,269189,407255,11632,114624,3.2256288810036753,0.2196371189490284
748,0.075,32,325,32,269514,406930,11664,114592,3.2230547459130654,0.21972610934917414
749,0.0751,23,325,23,269839,406605,11687,114569,3.220480610822456,0.21982869444753575
750,0.0752,28,348,28,270187,406257,11715,114541,3.2177243061715877,0.21993364029815782
751,0.0753,30,329,30,270516,405928,11745,114511,3.2151184894183245,0.22002770737780988
752,0.0754,16,342,16,270858,405586,11761,114495,3.212409707261437,0.22014839996077534
753,0.0755,33,378,33,271236,405208,11794,114462,3.2094157901406666,0.22025901052591068
754,0.0756,31,356,31,271592,404852,11825,114431,3.206596122164491,0.2203634626976042
755,0.0757,21,315,21,271907,404537,11846,114410,3.204101191230516,0.2204656737585919
756,0.0758,13,329,13,272236,404208,11859,114397,3.2014953744772527,0.22058599512152793
757,0.0759,32,346,32,272582,403862,11891,114365,3.198754910657711,0.2206851437690433
758,0.076,23,317,23,272899,403545,11914,114342,3.196244138892409,0.22078561539486413
759,0.0761,20,337,20,273236,403208,11934,114322,3.1935749588138385,0.22089927153981412
760,0.0762,21,314,21,273550,402894,11955,114301,3.1910879482955266,0.22100174982356752
761,0.0763,38,350,38,273900,402544,11993,114263,3.1883158028133316,0.2210941415267208
762,0.0764,34,360,34,274260,402184,12027,114229,3.1854644531745024,0.22119698768233953
763,0.0765,35,328,35,274588,401856,12062,114194,3.182866556836903,0.2212847592287569
764,0.0766,23,347,23,274935,401509,12085,114171,3.180118172601698,0.22139892956872478
765,0.0767,19,314,19,275249,401195,12104,114152,3.177631162083386,0.2215051217917248
766,0.0768,30,338,30,275587,400857,12134,114122,3.174954061589152,0.2216051528314747
767,0.0769,33,346,33,275933,400511,12167,114089,3.172213597769611,0.22170423630003885
768,0.077,35,322,35,276255,400189,12202,114054,3.1696632239259914,0.22179008756560614
769,0.0771,23,300,23,276555,399889,12225,114031,3.1672870992269675,0.2218847291407223
770,0.0772,29,329,29,276884,399560,12254,114002,3.1646812824737043,0.22198293487446502
771,0.0773,28,305,28,277189,399255,12282,113974,3.162265555696363,0.2220724082232298
772,0.0774,20,337,20,277526,398918,12302,113954,3.1595963756177925,0.22218799232557052
773,0.0775,27,308,27,277834,398610,12329,113927,3.157156887593461,0.22228053779532014
774,0.0776,31,319,31,278153,398291,12360,113896,3.154630274996832,0.2223719071354798
775,0.0777,25,330,25,278483,397961,12385,113871,3.152016537827905,0.22247729723815626
776,0.0778,31,352,31,278835,397609,12416,113840,3.1492285515143834,0.2225832878742553
777,0.0779,28,349,28,279184,397260,12444,113812,3.146464326447852,0.2226926930060735
778,0.078,23,301,23,279485,396959,12467,113789,3.1440802813331645,0.2227889291783815
779,0.0781,29,307,29,279792,396652,12496,113760,3.1416487137244964,0.22287877244265417
780,0.0782,31,344,31,280136,396308,12527,113729,3.138924090736282,0.22298186210020057
781,0.0783,31,339,31,280475,395969,12558,113698,3.1362390698263845,0.22308291492288101
782,0.0784,28,342,28,280817,395627,12586,113670,3.133530287669497,0.22319000504617148
783,0.0785,31,326,31,281143,395301,12617,113639,3.130948232163224,0.22328565253271507
784,0.0786,30,328,30,281471,394973,12647,113609,3.128350335825624,0.22338383977411705
785,0.0787,28,351,28,281822,394622,12675,113581,3.1255702699277657,0.22349533552537076
786,0.0788,28,313,28,282135,394309,12703,113553,3.123091179825117,0.22359026664723883
787,0.0789,22,337,22,282472,393972,12725,113531,3.1204219997465468,0.223705081546316
788,0.079,29,303,29,282775,393669,12754,113502,3.1180221138005324,0.22379434155344055
789,0.0791,26,338,26,283113,393331,12780,113476,3.1153450133062983,0.2239037740204851
790,0.0792,35,318,35,283431,393013,12815,113441,3.1128263211253326,0.223990727687016
791,0.0793,31,321,31,283752,392692,12846,113410,3.110283867697377,0.22408526344491822
792,0.0794,26,333,26,284085,392359,12872,113384,3.10764636928146,0.22419292011950734
793,0.0795,31,331,31,284416,392028,12903,113353,3.1050247116968697,0.22429216769130617
794,0.0796,26,357,26,284773,391671,12929,113327,3.102197123305031,0.22441078974570197
795,0.0797,37,278,37,285051,391393,12966,113290,3.099995247750602,0.2244775433291789
796,0.0798,27,325,27,285376,391068,12993,113263,3.097421112659992,0.224580682131378
797,0.0799,37,337,37,285713,390731,13030,113226,3.094751932581422,0.2246739305139129
798,0.08,27,334,27,286047,390397,13057,113199,3.0921065137498416,0.22478137236991558
799,0.0801,22,296,22,286343,390101,13079,113177,3.089762070713471,0.22487968876048625
800,0.0802,21,301,21,286644,389800,13100,113156,3.0873780255987833,0.22498190696601691
801,0.0803,30,305,30,286949,389495,13130,113126,3.0849622988214422,0.22507217167607402
802,0.0804,21,321,21,287270,389174,13151,113105,3.082419845393486,0.22518361309152882
803,0.0805,27,317,27,287587,388857,13178,113078,3.0799090736281842,0.2252841503381912
804,0.0806,36,307,36,287894,388550,13214,113042,3.077477506019516,0.2253664332764478
805,0.0807,27,309,27,288203,388241,13241,113015,3.075030097579521,0.22546363534800581
806,0.0808,30,315,30,288518,387926,13271,112985,3.0725351666455456,0.22555903144470774
807,0.0809,20,315,20,288833,387611,13291,112965,3.0700402357115704,0.225670028127597
808,0.081,34,316,34,289149,387295,13325,112931,3.0675373843619314,0.22575995649966216
809,0.0811,30,313,30,289462,386982,13355,112901,3.065058294259283,0.22585485003490816
810,0.0812,33,289,33,289751,386693,13388,112868,3.062769294132556,0.22593437037719116
811,0.0813,23,310,23,290061,386383,13411,112845,3.060313965276898,0.22603900422251957
812,0.0814,30,349,30,290410,386034,13441,112815,3.057549740210366,0.22615059867815712
813,0.0815,32,342,32,290752,385692,13473,112783,3.0548409580534788,0.22625608104719394
814,0.0816,20,314,20,291066,385378,13493,112763,3.052353947535167,0.2263676348664334
815,0.0817,29,339,29,291405,385039,13522,112734,3.0496689266252694,0.22647672734358834
816,0.0818,33,314,33,291719,384725,13555,112701,3.047181916106957,0.2265683739892969
817,0.0819,33,324,33,292043,384401,13588,112668,3.044615701432011,0.22666470852135218
818,0.082,25,313,25,292356,384088,13613,112643,3.0421366113293624,0.2267686131930562
819,0.0821,33,306,33,292662,383782,13646,112610,3.039712964136358,0.22685700011281407
820,0.0822,31,318,31,292980,383464,13677,112579,3.0371942719553924,0.22695411486504194
821,0.0823,24,291,24,293271,383173,13701,112555,3.034889430997339,0.22704991446922507
822,0.0824,17,305,17,293576,382868,13718,112538,3.0324737042199974,0.22716317525423593
823,0.0825,26,306,26,293882,382562,13744,112512,3.0300500570269926,0.22726299502700606
824,0.0826,32,289,32,294171,382273,13776,112480,3.027761056900266,0.22734576647337157
825,0.0827,34,299,34,294470,381974,13810,112446,3.025392852616905,0.227430120140771
826,0.0828,30,320,30,294790,381654,13840,112416,3.022858319604613,0.22753051187078754
827,0.0829,32,291,32,295081,381363,13872,112384,3.0205534786465593,0.22761454753142804
828,0.083,24,308,24,295389,381055,13896,112360,3.018113990622228,0.22771906002046957
829,0.0831,30,272,30,295661,380783,13926,112330,3.0159596375617794,0.22779768531756414
830,0.0832,33,334,33,295995,380449,13959,112297,3.013314218730199,0.2279003786940939
831,0.0833,31,322,31,296317,380127,13990,112266,3.0107638448865797,0.22800080423564104
832,0.0834,36,324,36,296641,379803,14026,112230,3.0081976302116336,0.22809445707909834
833,0.0835,33,311,33,296952,379492,14059,112197,3.0057343809403116,0.2281869230346825
834,0.0836,30,368,30,297320,379124,14089,112167,3.0028196679761754,0.22831071605219716
835,0.0837,26,321,26,297641,378803,14115,112141,3.0002772145482193,0.22841912723243385
836,0.0838,30,296,30,297937,378507,14145,112111,2.997932771511849,0.22850975708188448
837,0.0839,26,323,26,298260,378184,14171,112085,2.9953744772525663,0.2286193905794574
838,0.084,33,301,33,298561,377883,14204,112052,2.9929904321378786,0.22870788982211926
839,0.0841,33,349,33,298910,377534,14237,112019,2.990226207071347,0.2288189429949362
840,0.0842,39,332,39,299242,377202,14276,111980,2.987596629071094,0.22891275639741446
841,0.0843,22,283,22,299525,376919,14298,111958,2.9853551514383474,0.22901056912065818
842,0.0844,33,322,33,299847,376597,14331,111925,2.982804777594728,0.22910943621781618
843,0.0845,30,278,30,300125,376319,14361,111895,2.980602902040299,0.22919252622825237
844,0.0846,42,313,42,300438,376006,14403,111853,2.9781238119376505,0.22927321213711338
845,0.0847,14,295,14,300733,375711,14417,111839,2.9757872893169433,0.22938980617372579
846,0.0848,24,343,24,301076,375368,14441,111815,2.9730705867443925,0.22951334508798543
847,0.0849,27,310,27,301386,375058,14468,111788,2.970615257888734,0.2296167576605333
848,0.085,28,297,28,301683,374761,14496,111760,2.9682628944367,0.22971259205666353
849,0.0851,27,302,27,301985,374459,14523,111733,2.965870928906349,0.2298125020568006
850,0.0852,26,330,26,302315,374129,14549,111707,2.9632571917374224,0.22992738290287257
851,0.0853,27,323,27,302638,373806,14576,111680,2.9606988974781396,0.23003752940352554
852,0.0854,23,310,23,302948,373496,14599,111657,2.9582435686224815,0.2301480151622272
853,0.0855,17,304,17,303252,373192,14616,111640,2.9558357622608034,0.2302653290211867
854,0.0856,27,318,27,303570,372874,14643,111613,2.9533170700798377,0.2303735703950777
855,0.0857,30,299,30,303869,372575,14673,111583,2.950948865796477,0.23046815295833178
856,0.0858,30,309,30,304178,372266,14703,111553,2.9485014573564823,0.23056762963008895
857,0.0859,30,294,30,304472,371972,14733,111523,2.9461728551514383,0.23066008955625186
858,0.086,33,285,33,304757,371687,14766,111490,2.9439155366873653,0.2307435991365483
859,0.0861,31,306,31,305063,371381,14797,111459,2.9414918894943605,0.23084044403943335
860,0.0862,31,318,31,305381,371063,14828,111428,2.938973197313395,0.23094316785183558
861,0.0863,32,322,32,305703,370741,14860,111396,2.936422823469776,0.23104636234099438
862,0.0864,26,323,26,306026,370418,14886,111370,2.933864529210493,0.23115976321535614
863,0.0865,32,311,32,306337,370107,14918,111338,2.931401279939171,0.23125798377800164
864,0.0866,24,320,24,306657,369787,14942,111314,2.9288667469268788,0.23137345380699686
865,0.0867,20,284,20,306941,369503,14962,111294,2.926617348878469,0.23147814982206627
866,0.0868,23,287,23,307228,369216,14985,111271,2.9243441895830693,0.23157962650394287
867,0.0869,32,323,32,307551,368893,15017,111239,2.9217858953237865,0.23168420351070124
868,0.087,20,300,20,307851,368593,15037,111219,2.9194097706247626,0.2317970371728927
869,0.0871,24,307,24,308158,368286,15061,111195,2.9169782030160945,0.2319069994431479
870,0.0872,24,303,24,308461,367983,15085,111171,2.9145783170700796,0.23201517674902014
871,0.0873,34,303,34,308764,367680,15119,111137,2.9121784311240653,0.23210746485609324
872,0.0874,30,302,30,309066,367378,15149,111107,2.9097864655937142,0.23220581627428238
873,0.0875,34,277,34,309343,367101,15183,111073,2.9075925104549487,0.2322857369911371
874,0.0876,26,327,26,309670,366774,15209,111047,2.905002534533012,0.23240292913036473
875,0.0877,29,280,29,309950,366494,15238,111018,2.902784818147256,0.23249258657374056
876,0.0878,35,297,35,310247,366197,15273,110983,2.9004324546952223,0.2325809966888805
877,0.0879,33,277,33,310524,365920,15306,110950,2.8982384995564567,0.2326629899133936
878,0.088,37,323,37,310847,365597,15343,110913,2.895680205297174,0.23276111729029822
879,0.0881,26,284,26,311131,365313,15369,110887,2.8934308072487642,0.23285804283914321
880,0.0882,30,294,30,311425,365019,15399,110857,2.8911022050437207,0.23295354251947986
881,0.0883,30,277,30,311702,364742,15429,110827,2.888908249904955,0.23304084160237526
882,0.0884,29,296,29,311998,364446,15458,110798,2.8865638068685846,0.23313918744897358
883,0.0885,36,273,36,312271,364173,15494,110762,2.8844015333924724,0.23321507153610493
884,0.0886,26,286,26,312557,363887,15520,110736,2.882136294512736,0.23331359837176033
885,0.0887,29,304,29,312861,363583,15549,110707,2.8797284881510583,0.23341626431086465
886,0.0888,32,327,32,313188,363256,15581,110675,2.8771385122291218,0.23352555540785472
887,0.0889,35,305,35,313493,362951,15616,110640,2.8747227854517807,0.23361930442090326
888,0.089,31,280,31,313773,362671,15647,110609,2.8725050690660248,0.23370731913455037
889,0.0891,29,297,29,314070,362374,15676,110580,2.870152705613991,0.23380709329025656
890,0.0892,19,272,19,314342,362102,15695,110561,2.867998352553542,0.2339108413393898
891,0.0893,23,303,23,314645,361799,15718,110538,2.8655984666075276,0.23402358908999296
892,0.0894,28,304,28,314949,361495,15746,110510,2.86319066024585,0.23412887575343483
893,0.0895,31,295,31,315244,361200,15777,110479,2.8608541376251426,0.23422497079581664
894,0.0896,28,289,28,315533,360911,15805,110451,2.858565137498416,0.23432308926048345
895,0.0897,23,279,23,315812,360632,15828,110428,2.8563553415283236,0.23442448944932706
896,0.0898,31,328,31,316140,360304,15859,110397,2.8537574451907237,0.23453742396978125
897,0.0899,31,310,31,316450,359994,15890,110366,2.851302116335065,0.23464155115230886
898,0.09,25,281,25,316731,359713,15915,110341,2.849076479533646,0.23474111485063417
899,0.0901,40,273,40,317004,359440,15955,110301,2.846914206057534,0.23481237533023516
900,0.0902,37,298,37,317302,359142,15992,110264,2.8445539221898364,0.23490113036475888
901,0.0903,30,280,30,317582,358862,16022,110234,2.8423362058040804,0.2349924109350751
902,0.0904,32,303,32,317885,358559,16054,110202,2.839936319858066,0.23509208317244823
903,0.0905,31,312,31,318197,358247,16085,110171,2.837465150171081,0.23519804960526708
904,0.0906,27,337,27,318534,357910,16112,110144,2.8347959700925105,0.2353232746648891
905,0.0907,33,313,33,318847,357597,16145,110111,2.832316879989862,0.23542680475852454
906,0.0908,36,285,36,319132,357312,16181,110075,2.830059561525789,0.235511471221921
907,0.0909,32,319,32,319451,356993,16213,110043,2.82753294892916,0.23561995220925153
908,0.091,31,270,31,319721,356723,16244,110012,2.825394436700038,0.23570548598240973
909,0.0911,28,298,28,320019,356425,16272,109984,2.823034152832341,0.23581020091807833
910,0.0912,23,283,23,320302,356142,16295,109961,2.8207926751995944,0.2359156667088605
911,0.0913,25,251,25,320553,355891,16320,109936,2.8188046508680777,0.2360017774839157
912,0.0914,31,268,31,320821,355623,16351,109905,2.8166819794702826,0.23608676599474146
913,0.0915,37,273,37,321094,355350,16388,109868,2.8145197059941705,0.23616455081273727
914,0.0916,30,270,30,321364,355080,16418,109838,2.8123811937650487,0.23625241440426054
915,0.0917,32,305,32,321669,354775,16450,109806,2.8099654669877077,0.23635490904707682
916,0.0918,32,290,32,321959,354485,16482,109774,2.8076685464453175,0.23644991265651286
917,0.0919,29,310,29,322269,354175,16511,109745,2.805213217589659,0.23656018279013624
918,0.092,28,309,28,322578,353866,16539,109717,2.802765809149664,0.23667175025831405
919,0.0921,25,304,25,322882,353562,16564,109692,2.8003580027879864,0.23678586693261147
920,0.0922,35,294,35,323176,353268,16599,109657,2.7980294005829425,0.23687854404061132
921,0.0923,36,298,36,323474,352970,16635,109621,2.795669116715245,0.2369717525848968
922,0.0924,28,278,28,323752,352692,16663,109593,2.793467241160816,0.2370680424413511
923,0.0925,26,293,26,324045,352399,16689,109567,2.7911465593714357,0.2371754631293212
924,0.0926,20,275,20,324320,352124,16709,109547,2.788968445063997,0.23728369336605504
925,0.0927,30,314,30,324634,351810,16739,109517,2.786481434545685,0.2373956000841052
926,0.0928,23,309,23,324943,351501,16762,109494,2.78403402610569,0.2375166758858556
927,0.0929,18,293,18,325236,351208,16780,109476,2.7817133443163096,0.23763794705264346
928,0.093,26,266,26,325502,350942,16806,109450,2.7796065137498416,0.2377321934351596
929,0.0931,33,285,33,325787,350657,16839,109417,2.7773491952857685,0.2378247847085469
930,0.0932,27,286,27,326073,350371,16866,109390,2.775083956406032,0.23792796692194423
931,0.0933,30,273,30,326346,350098,16896,109360,2.7729216829299204,0.23801957959160577
932,0.0934,26,295,26,326641,349803,16922,109334,2.770585160309213,0.238129360082067
933,0.0935,29,300,29,326941,349503,16951,109305,2.7682090356101887,0.23823690955693885
934,0.0936,32,278,32,327219,349225,16983,109273,2.76600716005576,0.2383281933618031
935,0.0937,15,283,15,327502,348942,16998,109258,2.7637656824230135,0.23845045831514622
936,0.0938,28,298,28,327800,348644,17026,109230,2.761405398555316,0.23855907957210937
937,0.0939,24,251,24,328051,348393,17050,109206,2.759417374223799,0.23864999704981874
938,0.094,31,271,31,328322,348122,17081,109175,2.757270941579014,0.2387398124194998
939,0.0941,25,251,25,328573,347871,17106,109150,2.7552829172474973,0.2388292879320644
940,0.0942,23,283,23,328856,347588,17129,109127,2.753041439614751,0.2389389444182915
941,0.0943,30,263,30,329119,347325,17159,109097,2.750958370295273,0.23902660257393377
942,0.0944,34,289,34,329408,347036,17193,109063,2.7486693701685465,0.2391213311145168
943,0.0945,28,320,28,329728,346716,17221,109035,2.746134837156254,0.23924248109164872
944,0.0946,38,332,38,330060,346384,17259,108997,2.7435052591560005,0.23935342054235903
945,0.0947,30,292,30,330352,346092,17289,108967,2.7411924977822837,0.2394568616377217
946,0.0948,29,294,29,330646,345798,17318,108938,2.7388638955772397,0.23956317511699096
947,0.0949,35,310,35,330956,345488,17353,108903,2.7364085667215816,0.23966803919972007
948,0.095,27,296,27,331252,345192,17380,108876,2.734064123685211,0.23977906392875076
949,0.0951,29,293,29,331545,344899,17409,108847,2.731743441895831,0.23988531028372703
950,0.0952,25,272,25,331817,344627,17434,108822,2.729589088835382,0.23998729735868862
951,0.0953,32,295,32,332112,344332,17466,108790,2.727252566214675,0.24008986542255728
952,0.0954,41,283,41,332395,344049,17507,108749,2.7250110885819288,0.24017111383000808
953,0.0955,27,265,27,332660,343784,17534,108722,2.722912178431124,0.24026642740648743
954,0.0956,33,280,33,332940,343504,17567,108689,2.720694462045368,0.240359757890989
955,0.0957,29,243,29,333183,343261,17596,108660,2.7187698010391586,0.24044025393818833
956,0.0958,31,292,31,333475,342969,17627,108629,2.7164570396654417,0.2405435807953091
957,0.0959,32,295,32,333770,342674,17659,108597,2.7141205170447344,0.24064697266166007
958,0.096,25,288,25,334058,342386,17684,108572,2.7118394373336714,0.24075856288168743
959,0.0961,28,283,28,334341,342103,17712,108544,2.709597959700925,0.24086258202096097
960,0.0962,27,255,27,334596,341848,17739,108517,2.7075782537067545,0.2409534488692505
961,0.0963,44,287,44,334883,341561,17783,108473,2.705305094411355,0.24103289973646436
962,0.0964,32,285,32,335168,341276,17815,108441,2.7030477759472817,0.24113164501230774
963,0.0965,39,269,39,335437,341007,17854,108402,2.7009171841338233,0.24121012262771774
964,0.0966,28,286,28,335723,340721,17882,108374,2.698651945254087,0.24131642525523553
965,0.0967,24,266,24,335989,340455,17906,108350,2.696545114687619,0.2414188790231838
966,0.0968,33,273,33,336262,340182,17939,108317,2.6943828412115067,0.24151001451508253
967,0.0969,36,280,36,336542,339902,17975,108281,2.6921651248257508,0.2415999714402376
968,0.097,23,288,23,336830,339614,17998,108258,2.6898840451146877,0.2417163832523578
969,0.0971,31,303,31,337133,339311,18029,108227,2.6874841591686733,0.2418275096192949
970,0.0972,21,299,21,337432,339012,18050,108206,2.6851159548853123,0.24195358863015354
971,0.0973,29,280,29,337712,338732,18079,108177,2.6828982384995563,0.24205598902684886
972,0.0974,32,237,32,337949,338495,18111,108145,2.681021099987327,0.24213012717177146
973,0.0975,32,278,32,338227,338217,18143,108113,2.6788192244328983,0.2422266036340824
974,0.0976,32,290,32,338517,337927,18175,108081,2.676522303890508,0.24232973399580277
975,0.0977,36,290,36,338807,337637,18211,108045,2.674225383348118,0.2424262142065419
976,0.0978,33,272,33,339079,337365,18244,108012,2.6720710302876696,0.2425181363204656
977,0.0979,42,289,42,339368,337076,18286,107970,2.6697820301609427,0.24260413530286756
978,0.098,33,298,33,339666,336778,18319,107937,2.6674217462932455,0.24271049998313526
979,0.0981,24,269,24,339935,336509,18343,107913,2.665291154479787,0.2428165122338678
980,0.0982,24,235,24,340170,336274,18367,107889,2.663429856798885,0.2429040690016953
981,0.0983,23,261,23,340431,336013,18390,107866,2.6613626283107337,0.24300766650370934
982,0.0984,29,290,29,340721,335723,18419,107837,2.6590657077683435,0.24311705293534133
983,0.0985,37,266,37,340987,335457,18456,107800,2.6569588772018755,0.24319976898277973
984,0.0986,28,267,28,341254,335190,18484,107772,2.654844126219744,0.2432985222208677
985,0.0987,32,295,32,341549,334895,18516,107740,2.652507603599037,0.2434059665412812
986,0.0988,28,301,28,341850,334594,18544,107712,2.650123558484349,0.24352371435160275
987,0.0989,31,261,31,342111,334333,18575,107681,2.6480563299961983,0.243614455650726
988,0.099,34,284,34,342395,334049,18609,107647,2.6458069319477886,0.24371287039049483
989,0.0991,23,265,23,342660,333784,18632,107624,2.643708021796984,0.24381977671451355
990,0.0992,35,306,35,342966,333478,18667,107589,2.641284374603979,0.24392892689772755
991,0.0993,30,284,30,343250,333194,18697,107559,2.63903497655557,0.24403464071713635
992,0.0994,30,255,30,343505,332939,18727,107529,2.637015270561399,0.24412443128672232
993,0.0995,39,299,39,343804,332640,18766,107490,2.6346470662780384,0.2442232976620544
994,0.0996,27,265,27,344069,332375,18793,107463,2.6325481561272337,0.24432404658078657
995,0.0997,38,273,38,344342,332102,18831,107425,2.6303858826511215,0.24441046852639314
996,0.0998,32,269,32,344611,331833,18863,107393,2.628255290837663,0.24450510671044065
997,0.0999,33,266,33,344877,331567,18896,107360,2.626148460271195,0.24459648187511818
998,0.1,23,284,23,345161,331283,18919,107337,2.6238990622227853,0.2447152432629611
999,0.1001,22,259,22,345420,331024,18941,107315,2.621847674565961,0.24482193005869887
1000,0.1002,34,226,34,345646,330798,18975,107281,2.6200576606260295,0.2448896203652766
1001,0.1003,26,284,26,345930,330514,19001,107255,2.6178082625776202,0.24500364347406967
1002,0.1004,30,263,30,346193,330251,19031,107225,2.6157251932581422,0.2450991597253335
1003,0.1005,31,276,31,346469,329975,19062,107194,2.61353915853504,0.24520036873611806
1004,0.1006,24,247,24,346716,329728,19086,107170,2.6115828158661767,0.24529752940045502
1005,0.1007,22,306,22,347022,329422,19108,107148,2.609159168673172,0.2454314313855739
1006,0.1008,33,271,33,347293,329151,19141,107115,2.607012736028387,0.2455268116241009
1007,0.1009,18,278,18,347571,328873,19159,107097,2.6048108604739575,0.24565222377686538
1008,0.101,26,267,26,347838,328606,19185,107071,2.602696109491826,0.24575775172891845
1009,0.1011,36,267,36,348105,328339,19221,107035,2.6005813585096944,0.24584610013459693
1010,0.1012,34,249,34,348354,328090,19255,107001,2.5986091750095044,0.24592786336651412
1011,0.1013,26,257,26,348611,327833,19281,106975,2.5965736281840073,0.2460281319570937
1012,0.1014,37,278,37,348889,327555,19318,106938,2.594371752629578,0.24612134142552355
1013,0.1015,34,258,34,349147,327297,19352,106904,2.592328285388417,0.24620855318159102
1014,0.1016,25,260,25,349407,327037,19377,106879,2.5902689773159295,0.2463126503747269
1015,0.1017,37,264,37,349671,326773,19414,106842,2.588177987580788,0.2463983026417444
1016,0.1018,32,257,32,349928,326516,19446,106810,2.5861424407552907,0.24648878673331395
1017,0.1019,31,289,31,350217,326227,19477,106779,2.5838534406285643,0.24659935428146493
1018,0.102,21,244,21,350461,325983,19498,106758,2.5819208592066913,0.24670183781985067
1019,0.1021,34,284,34,350745,325699,19532,106724,2.5796714611582816,0.2468046334260666
1020,0.1022,29,251,29,350996,325448,19561,106695,2.5776834368267645,0.2468974390421689
1021,0.1023,33,272,33,351268,325176,19594,106662,2.575529083766316,0.24699540105317272
1022,0.1024,28,237,28,351505,324939,19622,106634,2.573651945254087,0.2470821854008476
1023,0.1025,35,268,35,351773,324671,19657,106599,2.571529273856292,0.24717462378556357
1024,0.1026,20,249,20,352022,324422,19677,106579,2.569557090356102,0.24728248890373805
1025,0.1027,25,255,25,352277,324167,19702,106554,2.5675373843619314,0.24738519830702474
1026,0.1028,33,235,33,352512,323932,19735,106521,2.565676086681029,0.24746255688774385
1027,0.1029,31,260,31,352772,323672,19766,106490,2.5636167786085413,0.24755789679237125
1028,0.103,35,268,35,353040,323404,19801,106455,2.561494107210746,0.24765097392400764
1029,0.1031,21,242,21,353282,323162,19822,106434,2.5595773666202004,0.24775370347954823
1030,0.1032,29,247,29,353529,322915,19851,106405,2.557621023951337,0.24784542998229758
1031,0.1033,31,265,31,353794,322650,19882,106374,2.5555221138005324,0.24794417095547103
1032,0.1034,25,264,25,354058,322386,19907,106349,2.553431124065391,0.2480529931076306
1033,0.1035,20,263,20,354321,322123,19927,106329,2.551348054745913,0.24817015675034776
1034,0.1036,32,272,32,354593,321851,19959,106297,2.5491937016854647,0.24827162569952446
1035,0.1037,29,266,29,354859,321585,19988,106268,2.5470868711189962,0.2483750260019212
1036,0.1038,29,274,29,355133,321311,20017,106239,2.5449166772272207,0.2484832183370366
1037,0.1039,39,280,39,355413,321031,20056,106200,2.5426989608414647,0.2485774674590561
1038,0.104,31,271,31,355684,320760,20087,106169,2.5405525281966796,0.248680693979561
1039,0.1041,29,240,29,355924,320520,20116,106140,2.5386516284374605,0.24876951202362538
1040,0.1042,28,253,28,356177,320267,20144,106112,2.5366477632746167,0.24886779133118658
1041,0.1043,35,231,35,356408,320036,20179,106077,2.534818147256368,0.24894100860569848
1042,0.1044,32,271,32,356679,319765,20211,106045,2.532671714611583,0.2490430003992391
1043,0.1045,26,237,26,356916,319528,20237,106019,2.5307945760993538,0.2491358181352471
1044,0.1046,41,240,41,357156,319288,20278,105978,2.528893676340134,0.24920402759684526
1045,0.1047,26,255,26,357411,319033,20304,105952,2.5268739703459637,0.2493076226219749
1046,0.1048,32,241,32,357652,318792,20336,105920,2.524965150171081,0.2493925295258905
1047,0.1049,33,282,33,357934,318510,20369,105887,2.522731592953998,0.24949987865135712
1048,0.105,31,234,31,358168,318276,20400,105856,2.5208782156887595,0.24958267709109427
1049,0.1051,25,280,25,358448,317996,20425,105831,2.5186604993030035,0.2497032987516133
1050,0.1052,36,247,36,358695,317749,20461,105795,2.51670415663414,0.2497851462894056
1051,0.1053,35,250,35,358945,317499,20496,105760,2.514724052718287,0.24987064657809993
1052,0.1054,32,217,32,359162,317282,20528,105728,2.5130053225193256,0.24994208174747642
1053,0.1055,36,259,36,359421,317023,20564,105692,2.5109539348625014,0.2500313449960375
1054,0.1056,17,252,17,359673,316771,20581,105675,2.5089579901153214,0.2501503150698551
1055,0.1057,30,250,30,359923,316521,20611,105645,2.5069778861994676,0.2502451642244994
1056,0.1058,35,236,35,360159,316285,20646,105610,2.5051086681029022,0.250322947652852
1057,0.1059,31,255,31,360414,316030,20677,105579,2.5030889621087313,0.250419227293535
1058,0.106,36,251,36,360665,315779,20713,105543,2.5011009377772147,0.25050436483259836
1059,0.1061,25,224,25,360889,315555,20738,105518,2.4993267646686097,0.2505931275574544
1060,0.1062,31,252,31,361141,315303,20769,105487,2.4973308199214297,0.25068799163478217
1061,0.1063,29,269,29,361410,315034,20798,105458,2.4952002281079713,0.25079668578712555
1062,0.1064,39,256,39,361666,314778,20837,105419,2.493172601698137,0.25087994440702815
1063,0.1065,23,259,23,361925,314519,20860,105396,2.491121214041313,0.2509936534774895
1064,0.1066,37,279,37,362204,314240,20897,105359,2.48891141807122,0.2510944973653417
1065,0.1067,34,243,34,362447,313997,20931,105325,2.4869867570650106,0.2511792846547522
1066,0.1068,22,262,22,362709,313735,20953,105303,2.4849116081611964,0.2512970184088317
1067,0.1069,33,236,33,362945,313499,20986,105270,2.4830423900646306,0.25137963889399645
1068,0.107,30,212,30,363157,313287,21016,105240,2.481363261943987,0.25145331125590464
1069,0.1071,29,261,29,363418,313026,21045,105211,2.4792960334558356,0.25155832697728797
1070,0.1072,36,247,36,363665,312779,21081,105175,2.4773396907869727,0.2516425252539753
1071,0.1073,33,277,33,363942,312502,21114,105142,2.4751457356482067,0.2517502945091992
1072,0.1074,37,281,37,364223,312221,21151,105105,2.4729200988467874,0.2518534670737026
1073,0.1075,37,258,37,364481,311963,21188,105068,2.4708766316056265,0.2519429011272543
1074,0.1076,39,238,39,364719,311725,21227,105029,2.468991572677734,0.2520167772834814
1075,0.1077,33,241,33,364960,311484,21260,104996,2.467082752502851,0.2521033422973492
1076,0.1078,35,258,35,365218,311226,21295,104961,2.4650392852616907,0.2521967288742801
1077,0.1079,35,257,35,365475,310969,21330,104926,2.463003738436193,0.25228964041404683
1078,0.108,29,262,29,365737,310707,21359,104897,2.4609285895323785,0.25239651206436897
1079,0.1081,35,259,35,365996,310448,21394,104862,2.4588772018755543,0.25249091040427635
1080,0.1082,30,269,30,366265,310179,21424,104832,2.4567466100620963,0.25260053347983547
1081,0.1083,26,266,26,366531,309913,21450,104806,2.454639779495628,0.25271569424116086
1082,0.1084,33,255,33,366786,309658,21483,104773,2.4526200735014574,0.2528116863844645
1083,0.1085,25,258,25,367044,309400,21508,104748,2.4505766062602965,0.2529240754512879
1084,0.1086,35,281,35,367325,309119,21543,104713,2.448350969458877,0.25303263159929634
1085,0.1087,27,248,27,367573,308871,21570,104686,2.4463867063743505,0.2531356016220255
1086,0.1088,26,230,26,367803,308641,21596,104660,2.444565010771765,0.25322948650015364
1087,0.1089,37,245,37,368048,308396,21633,104623,2.442624508934229,0.2533128015902416
1088,0.109,23,249,23,368297,308147,21656,104600,2.440652325434039,0.2534240103501661
1089,0.1091,32,266,32,368563,307881,21688,104568,2.4385454948675704,0.25352952728701
1090,0.1092,26,235,26,368798,307646,21714,104542,2.4366841971866684,0.2536269857443691
1091,0.1093,26,249,26,369047,307397,21740,104516,2.4347120136864784,0.2537331912321291
1092,0.1094,30,238,30,369285,307159,21770,104486,2.432826954758586,0.2538255049860924
1093,0.1095,24,277,24,369562,306882,21794,104462,2.43063299961982,0.2539528958730406
1094,0.1096,38,255,38,369817,306627,21832,104424,2.4286132936256495,0.2540414693067284
1095,0.1097,29,253,29,370070,306374,21861,104395,2.4266094284628057,0.25414527386438607
1096,0.1098,33,246,33,370316,306128,21894,104362,2.4246610062096057,0.25423761845599163
1097,0.1099,33,240,33,370556,305888,21927,104329,2.4227601064503865,0.2543263687267958
1098,0.11,33,231,33,370787,305657,21960,104296,2.420930490432138,0.2544096518381375
1099,0.1101,26,258,26,371045,305399,21986,104270,2.418887023190977,0.2545225535737388
1100,0.1102,24,241,24,371286,305158,22010,104246,2.4169782030160945,0.2546286797393284
1101,0.1103,31,245,31,371531,304913,22041,104215,2.4150377011785578,0.25472468273987603
1102,0.1104,34,252,34,371783,304661,22075,104181,2.4130417564313773,0.2548197103037359
1103,0.1105,29,235,29,372018,304426,22104,104152,2.4111804587504753,0.25491338251202955
1104,0.1106,36,248,36,372266,304178,22140,104116,2.4092161956659486,0.25500252269198176
1105,0.1107,26,279,26,372545,303899,22166,104090,2.407006399695856,0.255129427509075
1106,0.1108,28,244,28,372789,303655,22194,104062,2.405073818273983,0.25523095676658075
1107,0.1109,41,242,41,373031,303413,22235,104021,2.403157077683437,0.25530760810339836
1108,0.111,31,234,31,373265,303179,22266,103990,2.401303700418198,0.2553976358711002
1109,0.1111,27,231,27,373496,302948,22293,103963,2.3994740843999494,0.25549321596122987
1110,0.1112,37,221,37,373717,302727,22330,103926,2.397723672538335,0.2555643263421148
1111,0.1113,34,209,34,373926,302518,22364,103892,2.396068305664681,0.25563347358578775
1112,0.1114,33,245,33,374171,302273,22397,103859,2.394127803827145,0.25572720199344057
1113,0.1115,27,263,27,374434,302010,22424,103832,2.392044734507667,0.2558434070401782
1114,0.1116,23,207,23,374641,301803,22447,103809,2.3904052084653404,0.255931777166356
1115,0.1117,28,224,28,374865,301579,22475,103781,2.3886310353567355,0.25602180777580424
1116,0.1118,29,261,29,375126,301318,22504,103752,2.3865638068685846,0.25613350778877725
1117,0.1119,41,219,41,375345,301099,22545,103711,2.3848292358382968,0.25619673427039846
1118,0.112,35,259,35,375604,300840,22580,103676,2.3827778481814725,0.2562964134916789
1119,0.1121,27,220,27,375824,300620,22607,103649,2.3810353567355214,0.2563862180874616
1120,0.1122,31,248,31,376072,300372,22638,103618,2.3790710936509947,0.2564865466967004
1121,0.1123,26,260,26,376332,300112,22664,103592,2.377011785578507,0.256603848364148
1122,0.1124,27,221,27,376553,299891,22691,103565,2.3752613737168926,0.2566946581535533
1123,0.1125,29,256,29,376809,299635,22720,103536,2.373233747307059,0.2568041848248014
1124,0.1126,37,235,37,377044,299400,22757,103499,2.3713724496261563,0.2568857207389445
1125,0.1127,35,236,35,377280,299164,22792,103464,2.3695032315295905,0.25697169595755887
1126,0.1128,31,269,31,377549,298895,22823,103433,2.367372639716132,0.25708625797856477
1127,0.1129,29,275,29,377824,298620,22852,103404,2.3651945254086932,0.2572085248641872
1128,0.113,35,247,35,378071,298373,22887,103369,2.3632381827398303,0.2573019500077164
1129,0.1131,32,239,32,378310,298134,22919,103337,2.361345203396274,0.25739592648036846
1130,0.1132,24,270,24,378580,297864,22943,103313,2.3592066911671523,0.25752473347175936
1131,0.1133,35,215,35,378795,297649,22978,103278,2.3575038017995182,0.2575980165965375
1132,0.1134,29,215,29,379010,297434,23007,103249,2.3558009124318846,0.25768250711909413
1133,0.1135,29,235,29,379245,297199,23036,103220,2.353939614750982,0.2577799754756892
1134,0.1136,33,229,33,379474,296970,23069,103187,2.3521258395640605,0.2578662874821632
1135,0.1137,26,217,26,379691,296753,23095,103161,2.3504071093650993,0.2579579609616067
1136,0.1138,20,208,20,379899,296545,23115,103141,2.3487596629071095,0.2580550732324875
1137,0.1139,24,222,24,380121,296323,23139,103117,2.3470013306298316,0.2581539154816743
1138,0.114,21,237,21,380358,296086,23160,103096,2.3451241921176025,0.25826815838389505
1139,0.1141,28,240,28,380598,295846,23188,103068,2.343223292358383,0.2583714785643021
1140,0.1142,32,225,32,380823,295621,23220,103036,2.3414411988341146,0.25845777196938724
1141,0.1143,21,242,21,381065,295379,23241,103015,2.339524458243569,0.25857568136066306
1142,0.1144,29,229,29,381294,295150,23270,102986,2.3377106830566468,0.2586704040830269
1143,0.1145,41,236,41,381530,294914,23311,102945,2.335841464960081,0.25874744570312597
1144,0.1146,30,234,30,381764,294680,23341,102915,2.3339880876948422,0.25884379833750426
1145,0.1147,22,258,22,382022,294422,23363,102893,2.3319446204536813,0.2589708417754175
1146,0.1148,20,232,20,382254,294190,23383,102873,2.3301070840197693,0.2590848303669695
1147,0.1149,30,265,30,382519,293925,23413,102843,2.3280081738689646,0.25920185095572223
1148,0.115,41,230,41,382749,293695,23454,102802,2.3261864782663793,0.2592756061206012
1149,0.1151,24,231,24,382980,293464,23478,102778,2.324356862248131,0.25938189288364183
1150,0.1152,33,252,33,383232,293212,23511,102745,2.3223609175009505,0.25948524713542126
1151,0.1153,29,237,29,383469,292975,23540,102716,2.3204837789887214,0.2595863944340407
1152,0.1154,27,250,27,383719,292725,23567,102689,2.318503675072868,0.2596999600418802
1153,0.1155,32,243,32,383962,292482,23599,102657,2.316579014066658,0.259799716049289
1154,0.1156,31,199,31,384161,292283,23630,102626,2.315002851349639,0.25987252759496493
1155,0.1157,35,222,35,384383,292061,23665,102591,2.3132445190723607,0.25995307258039996
1156,0.1158,24,247,24,384630,291814,23689,102567,2.311288176403498,0.26007084519791773
1157,0.1159,35,201,35,384831,291613,23724,102532,2.3096961728551513,0.26013776655799264
1158,0.116,29,236,29,385067,291377,23753,102503,2.307826954758586,0.26023915913476187
1159,0.1161,26,221,26,385288,291156,23779,102477,2.3060765428969714,0.26033640472216507
1160,0.1162,33,248,33,385536,290908,23812,102444,2.3041122798124447,0.26043848766499217
1161,0.1163,35,239,35,385775,290669,23847,102409,2.3022193004688885,0.26053098876050046
1162,0.1164,22,227,22,386002,290442,23869,102387,2.3004213661132935,0.2606401258562886
1163,0.1165,36,244,36,386246,290198,23905,102351,2.2984887846914206,0.26073432870800844
1164,0.1166,28,247,28,386493,289951,23933,102323,2.2965324420225572,0.2608457353788423
1165,0.1167,29,227,29,386720,289724,23962,102294,2.2947345076669623,0.26094209959746745
1166,0.1168,32,214,32,386934,289510,23994,102262,2.2930395387149916,0.26102426921781036
1167,0.1169,27,233,27,387167,289277,24021,102235,2.291194081865416,0.26112864995198104
1168,0.117,34,221,34,387388,289056,24055,102201,2.2894436700038017,0.2612119399780707
1169,0.1171,33,271,33,387659,288785,24088,102168,2.2872972373590166,0.26133064588326477
1170,0.1172,22,250,22,387909,288535,24110,102146,2.2853171334431632,0.26145627762803925
1171,0.1173,22,231,22,388140,288304,24132,102124,2.2834875174249145,0.2615693546569406
1172,0.1174,30,240,30,388380,288064,24162,102094,2.281586617665695,0.26167347587387674
1173,0.1175,23,250,23,388630,287814,24185,102071,2.2796065137498416,0.2617977095810303
1174,0.1176,24,258,24,388888,287556,24209,102047,2.2775630465086807,0.26192560118890257
1175,0.1177,39,262,39,389150,287294,24248,102008,2.2754878976048665,0.26202793717987577
1176,0.1178,32,220,32,389370,287074,24280,101976,2.2737454061589153,0.26211540933042027
1177,0.1179,33,218,33,389588,286856,24313,101943,2.272018755544291,0.26219974845614313
1178,0.118,39,234,39,389822,286622,24352,101904,2.270165378279052,0.2622836052156098
1179,0.1181,42,210,42,390032,286412,24394,101862,2.268502090989735,0.26234566311419255
1180,0.1182,32,234,32,390266,286178,24426,101830,2.2666487137244964,0.2624430424114967
1181,0.1183,29,201,29,390467,285977,24455,101801,2.26505671017615,0.2625239183244021
1182,0.1184,32,255,32,390722,285722,24487,101769,2.2630370041819794,0.26263577734708676
1183,0.1185,27,211,27,390933,285511,24514,101742,2.261365796476999,0.26272746757287874
1184,0.1186,36,228,36,391161,285283,24550,101706,2.259559941705741,0.26281367170643094
1185,0.1187,30,224,30,391385,285059,24580,101676,2.257785768597136,0.26290871009864636
1186,0.1188,28,217,28,391602,284842,24608,101648,2.256067038398175,0.26300292374964424
1187,0.1189,31,227,31,391829,284615,24639,101617,2.25426910404258,0.2630983450361441
1188,0.119,19,209,19,392038,284406,24658,101598,2.2526137371689265,0.263204526377965
1189,0.1191,22,229,22,392267,284177,24680,101576,2.250799961982005,0.26331875578414166
1190,0.1192,30,204,30,392471,283973,24710,101546,2.2491841971866684,0.26340076623979625
1191,0.1193,37,265,37,392736,283708,24747,101509,2.2470852870358637,0.263511215756314
1192,0.1194,27,233,27,392969,283475,24774,101482,2.2452398301862884,0.263619053556631
1193,0.1195,34,219,34,393188,283256,24808,101448,2.2435052591560005,0.2637040425885876
1194,0.1196,37,229,37,393417,283027,24845,101411,2.241691483969079,0.2637902600679433
1195,0.1197,32,226,32,393643,282801,24877,101379,2.2399014700291473,0.2638841168202405
1196,0.1198,27,205,27,393848,282596,24904,101352,2.2382777848181474,0.26397324637711356
1197,0.1199,39,212,39,394060,282384,24943,101313,2.2365986566975034,0.2640442849435883
1198,0.12,30,186,30,394246,282198,24973,101283,2.2351254593841086,0.2641147801325229
1199,0.1201,33,233,33,394479,281965,25006,101250,2.233280002534533,0.2642119958769881
1200,0.1202,28,244,28,394723,281721,25034,101222,2.23134742111266,0.26432654468158445
1201,0.1203,42,249,42,394972,281472,25076,101180,2.22937523761247,0.2644177999853653
1202,0.1204,35,233,35,395205,281239,25111,101145,2.2275297807628944,0.2645115904431148
1203,0.1205,26,246,26,395451,280993,25137,101119,2.2255813585096944,0.2646318356921531
1204,0.1206,20,192,20,395643,280801,25157,101099,2.224060638702319,0.264726368159204
1205,0.1207,33,228,33,395871,280573,25190,101066,2.222254783931061,0.26482094335222556
1206,0.1208,32,244,32,396115,280329,25222,101034,2.2203222025091875,0.2649286899882789
1207,0.1209,26,238,26,396353,280091,25248,101008,2.218437143581295,0.2650439911938893
1208,0.121,34,236,34,396589,279855,25282,100974,2.2165679254847293,0.26514262306704584
1209,0.1211,28,237,28,396826,279618,25310,100946,2.2146907869725,0.2652536761228072
1210,0.1212,29,206,29,397032,279412,25339,100917,2.213059181345837,0.2653413229072724
1211,0.1213,33,231,33,397263,279181,25372,100884,2.211229565327588,0.2654388065199374
1212,0.1214,43,213,43,397476,278968,25415,100841,2.209542516791281,0.26550450357943073
1213,0.1215,39,216,39,397692,278752,25454,100802,2.207831707007984,0.26558012825579497
1214,0.1216,34,207,34,397899,278545,25488,100768,2.2061921809656573,0.26565923129447183
1215,0.1217,30,228,30,398127,278317,25518,100738,2.2043863261943986,0.2657609054095052
1216,0.1218,33,216,33,398343,278101,25551,100705,2.202675516411101,0.2658484818086303
1217,0.1219,31,203,31,398546,277898,25582,100674,2.2010676720314284,0.2659309193495557
1218,0.122,30,223,30,398769,277675,25612,100644,2.1993014193384868,0.26602946190912957
1219,0.1221,32,237,32,399006,277438,25644,100612,2.1974242808262576,0.2661341092448089
1220,0.1222,31,221,31,399227,277217,25675,100581,2.195673868964643,0.2662295724170059
1221,0.1223,33,211,33,399438,277006,25708,100548,2.194002661259663,0.2663142226012703
1222,0.1224,33,213,33,399651,276793,25741,100515,2.192315612723356,0.2664003943727671
1223,0.1225,23,198,23,399849,276595,25764,100492,2.1907473704219997,0.266495530209209
1224,0.1226,34,221,34,400070,276374,25798,100458,2.1889969585603852,0.2665856402853261
1225,0.1227,27,218,27,400288,276156,25825,100431,2.187270307945761,0.2666873790120211
1226,0.1228,31,213,31,400501,275943,25856,100400,2.1855832594094537,0.26677791270197665
1227,0.1229,35,222,35,400723,275721,25891,100365,2.183824927132176,0.2668671527257064
1228,0.123,40,229,40,400952,275492,25931,100325,2.1820111519452543,0.2669517344877959
1229,0.1231,34,218,34,401170,275274,25965,100291,2.18028450133063,0.2670403259089638
1230,0.1232,33,246,33,401416,275028,25998,100258,2.1783360790774298,0.2671509195653448
1231,0.1233,24,235,24,401651,274793,26022,100234,2.1764747813965277,0.2672714231242017
1232,0.1234,36,237,36,401888,274556,26058,100198,2.1745976428842986,0.26737006142696274
1233,0.1235,36,210,36,402098,274346,26094,100162,2.1729343555949816,0.2674495604900296
1234,0.1236,36,231,36,402329,274115,26130,100126,2.171104739576733,0.2675441760790507
1235,0.1237,36,212,36,402541,273903,26166,100090,2.1694256114560893,0.26762532988585347
1236,0.1238,22,225,22,402766,273678,26188,100068,2.167643517931821,0.2677433337079193
1237,0.1239,25,212,25,402978,273466,26213,100043,2.1659643898111773,0.26784629018310135
1238,0.124,28,196,28,403174,273270,26241,100015,2.1644119883411483,0.2679320090547437
1239,0.1241,38,223,38,403397,273047,26279,99977,2.1626457356482067,0.2680176074461697
1240,0.1242,32,220,32,403617,272827,26311,99945,2.1609032442022555,0.26811294839741184
1241,0.1243,33,217,33,403834,272610,26344,99912,2.159184514003295,0.26820429397458406
1242,0.1244,33,204,33,404038,272406,26377,99879,2.1575687492079583,0.26828639348885935
1243,0.1245,29,248,29,404286,272158,26406,99850,2.1556044861234316,0.26840820627513384
1244,0.1246,27,231,27,404517,271927,26433,99823,2.1537748701051833,0.26852185608607937
1245,0.1247,30,224,30,404741,271703,26463,99793,2.1520006969965784,0.2686246958244503
1246,0.1248,37,220,37,404961,271483,26500,99756,2.150258205550627,0.26871099211020394
1247,0.1249,23,230,23,405191,271253,26523,99733,2.1484365099480423,0.2688322470389718
1248,0.125,32,248,32,405439,271005,26555,99701,2.1464722468635156,0.2689489784357415
1249,0.1251,28,206,28,405645,270799,26583,99673,2.144840641236852,0.2690432745254702
1250,0.1252,33,197,33,405842,270602,26616,99640,2.1432803193511596,0.2691212774347589
1251,0.1253,35,221,35,406063,270381,26651,99605,2.141529907489545,0.2692128891363457
1252,0.1254,31,214,31,406277,270167,26682,99574,2.1398349385375743,0.2693074341228049
1253,0.1255,42,233,42,406510,269934,26724,99532,2.137989481687999,0.269394206774101
1254,0.1256,29,211,29,406721,269723,26753,99503,2.1363182739830187,0.26949077258914594
1255,0.1257,27,211,27,406932,269512,26780,99476,2.1346470662780384,0.2695914230273071
1256,0.1258,34,228,34,407160,269284,26814,99442,2.13284121150678,0.26969077309438444
1257,0.1259,34,226,34,407386,269058,26848,99408,2.1310511975668485,0.2697888000521079
1258,0.126,26,219,26,407605,268839,26874,99382,2.1293166265365606,0.2698976973067804
1259,0.1261,26,200,26,407805,268639,26900,99356,2.127732543403878,0.2699927988152013
1260,0.1262,31,242,31,408047,268397,26931,99325,2.1258158028133316,0.2701089409934679
1261,0.1263,30,228,30,408275,268169,26961,99295,2.1240099480420733,0.2702169464219624
1262,0.1264,31,197,31,408472,267972,26992,99264,2.1224496261563806,0.2703002973564683
1263,0.1265,26,221,26,408693,267751,27018,99238,2.120699214294766,0.27041137472785287
1264,0.1266,27,248,27,408941,267503,27045,99211,2.1187349512102394,0.2705405302224622
1265,0.1267,25,212,25,409153,267291,27070,99186,2.1170558230895957,0.2706472711793646
1266,0.1268,28,204,28,409357,267087,27098,99158,2.115440058294259,0.27074226269300605
1267,0.1269,21,218,21,409575,266869,27119,99137,2.113713407679635,0.27086167986317167
1268,0.127,34,222,34,409797,266647,27153,99103,2.1119550754023573,0.2709583048530417
1269,0.1271,30,216,30,410013,266431,27183,99073,2.11024426561906,0.27105859306601293
1270,0.1272,35,232,35,410245,266199,27218,99038,2.108406729185148,0.271160917431695
1271,0.1273,31,216,31,410461,265983,27249,99007,2.1066959194018504,0.27125948656127563
1272,0.1274,32,213,32,410674,265770,27281,98975,2.105008870865543,0.27135395961562186
1273,0.1275,30,217,30,410891,265553,27311,98945,2.1032901406665823,0.27145553610719403
1274,0.1276,35,232,35,411123,265321,27346,98910,2.10145260423267,0.2715584340706859
1275,0.1277,35,209,35,411332,265112,27381,98875,2.0997972373590166,0.27164431696736424
1276,0.1278,30,229,30,411561,264883,27411,98845,2.097983462172095,0.27175526767254654
1277,0.1279,40,212,40,411773,264671,27451,98805,2.096304334051451,0.2718336286302259
1278,0.128,31,232,31,412005,264439,27482,98774,2.094466797617539,0.27194511209675865
1279,0.1281,26,219,26,412224,264220,27508,98748,2.0927322265872514,0.27205704084106586
1280,0.1282,24,214,24,412438,264006,27532,98724,2.0910372576352807,0.27216938218509634
1281,0.1283,30,201,30,412639,263805,27562,98694,2.0894452540869346,0.27226006140706593
1282,0.1284,47,220,47,412859,263585,27609,98647,2.0877027626409834,0.2723309922922326
1283,0.1285,29,215,29,413074,263370,27638,98618,2.0859998732733493,0.2724344453407295
1284,0.1286,25,197,25,413271,263173,27663,98593,2.084439551387657,0.27253252102187603
1285,0.1287,25,226,25,413497,262947,27688,98568,2.0826495374477254,0.27265258702958384
1286,0.1288,30,211,30,413708,262736,27718,98538,2.080978329742745,0.2727514296628044
1287,0.1289,36,214,36,413922,262522,27754,98502,2.0792833607907744,0.2728405867753944
1288,0.129,33,238,33,414160,262284,27787,98469,2.077398301862882,0.27295407106801606
1289,0.1291,27,201,27,414361,262083,27814,98442,2.0758062983145353,0.2730517994591221
1290,0.1292,34,218,34,414579,261865,27848,98408,2.0740796476999113,0.2731484180052349
1291,0.1293,38,211,38,414790,261654,27886,98370,2.072408439994931,0.2732317845476968
1292,0.1294,32,212,32,415002,261442,27918,98338,2.0707293118742873,0.27332814497748625
1293,0.1295,19,190,19,415192,261252,27937,98319,2.0692244328982383,0.2734341757260736
1294,0.1296,32,208,32,415400,261044,27969,98287,2.0675769864402485,0.273527750180196
1295,0.1297,26,222,26,415622,260822,27995,98261,2.0658186541629706,0.2736442549494128
1296,0.1298,36,219,36,415841,260603,28031,98225,2.0640840831326828,0.2737383927675655
1297,0.1299,33,217,33,416058,260386,28064,98192,2.062365352933722,0.27383721254510873
1298,0.13,27,235,27,416293,260151,28091,98165,2.0605040552528195,0.2739620893289722
1299,0.1301,34,204,34,416497,259947,28125,98131,2.058888290457483,0.2740492294974838
1300,0.1302,33,193,33,416690,259754,28158,98098,2.0573596502344444,0.2741300872986598
1301,0.1303,39,217,39,416907,259537,28197,98059,2.0556409200354833,0.27421727312386046
1302,0.1304,29,218,29,417125,259319,28226,98030,2.053914269420859,0.27432565922949276
1303,0.1305,43,222,43,417347,259097,28269,97987,2.0521559371435814,0.2744088225739602
1304,0.1306,29,196,29,417543,258901,28298,97958,2.0506035356735524,0.2745005730554645
1305,0.1307,24,221,24,417764,258680,28322,97934,2.048853123811938,0.2746218600503626
1306,0.1308,25,215,25,417979,258465,28347,97909,2.0471502344443038,0.274736653066722
1307,0.1309,35,197,35,418176,258268,28382,97874,2.045589912558611,0.2748173481364175
1308,0.131,28,232,28,418408,258036,28410,97846,2.043752376124699,0.2749394462209384
1309,0.1311,28,198,28,418606,257838,28438,97818,2.042184133823343,0.2750354274917336
1310,0.1312,36,232,36,418838,257606,28474,97782,2.040346597389431,0.27514153544858017
1311,0.1313,31,204,31,419042,257402,28505,97751,2.0387308325940947,0.27523630660588533
1312,0.1314,31,207,31,419249,257195,28536,97720,2.0370913065517677,0.27533353056365606
1313,0.1315,29,226,29,419475,256969,28565,97691,2.035301292611836,0.2754497264986184
1314,0.1316,30,201,30,419676,256768,28595,97661,2.03370928906349,0.2755446083700826
1315,0.1317,25,200,25,419876,256568,28620,97636,2.0321252059308073,0.27564906099310005
1316,0.1318,19,207,19,420083,256361,28639,97617,2.0304856798884807,0.2757713756222138
1317,0.1319,28,210,28,420293,256151,28667,97589,2.0288223925991637,0.2758777633289987
1318,0.132,29,217,29,420510,255934,28696,97560,2.0271036624002026,0.2759877112482814
1319,0.1321,40,235,40,420745,255699,28736,97520,2.0252423647193005,0.2760893383425014
1320,0.1322,37,212,37,420957,255487,28773,97483,2.023563236598657,0.2761792786922401
1321,0.1323,25,224,25,421181,255263,28798,97458,2.021789063490052,0.27630336725060317
1322,0.1324,32,215,32,421396,255048,28830,97426,2.020086174122418,0.2764062030107185
1323,0.1325,30,236,30,421632,254812,28860,97396,2.018216956025852,0.27652977785853816
1324,0.1326,29,192,29,421824,254620,28889,97367,2.016696236218477,0.2766210115714501
1325,0.1327,20,206,20,422030,254414,28909,97347,2.0150646305918136,0.2767418787187892
1326,0.1328,37,216,37,422246,254198,28946,97310,2.013353820808516,0.27683580459050716
1327,0.1329,32,202,32,422448,253996,28978,97278,2.0117538968445063,0.27692912085722254
1328,0.133,36,191,36,422639,253805,29014,97242,2.0102410974527944,0.27700564311901255
1329,0.1331,24,180,24,422819,253625,29038,97218,2.0088154226333796,0.27709830322964973
1330,0.1332,38,203,38,423022,253422,29076,97180,2.007207578253707,0.27718039258190197
1331,0.1333,32,233,32,423255,253189,29108,97148,2.0053621214041315,0.2772987152370432
1332,0.1334,36,193,36,423448,252996,29144,97112,2.0038334811810925,0.2773772664434974
1333,0.1335,37,224,37,423672,252772,29181,97075,2.0020593080724876,0.27747844057545157
1334,0.1336,23,212,23,423884,252560,29204,97052,2.000380179951844,0.27759916707664495
1335,0.1337,22,188,22,424072,252372,29226,97030,1.998891141807122,0.27770304692016645
1336,0.1338,24,215,24,424287,252157,29250,97006,1.997188252439488,0.27782439720130714
1337,0.1339,35,189,35,424476,251968,29285,96971,1.9956912938791027,0.27790244140093256
1338,0.134,29,215,29,424691,251753,29314,96942,1.9939884045114689,0.2780137369334232
1339,0.1341,26,222,26,424913,251531,29340,96916,1.9922300722341908,0.2781369907044687
1340,0.1342,34,184,34,425097,251347,29374,96882,1.9907727157521227,0.27821347446651484
1341,0.1343,35,196,35,425293,251151,29409,96847,1.9892203142820934,0.278297576422853
1342,0.1344,27,202,27,425495,250949,29436,96820,1.9876203903180838,0.27840319292403864
1343,0.1345,42,226,42,425721,250723,29478,96778,1.9858303763781524,0.2784970402962869
1344,0.1346,26,188,26,425909,250535,29504,96752,1.9843413382334305,0.27859378554336905
1345,0.1347,24,223,24,426132,250312,29528,96728,1.9825750855404891,0.27872291378515446
1346,0.1348,28,212,28,426344,250100,29556,96700,1.9808959574198455,0.27883506343713954
1347,0.1349,28,201,28,426545,249899,29584,96672,1.9793039538714992,0.2789385147632087
1348,0.135,30,184,30,426729,249715,29614,96642,1.977846597389431,0.27902424377159984
1349,0.1351,27,198,27,426927,249517,29641,96615,1.976278355088075,0.27912761605399095
1350,0.1352,25,205,25,427132,249312,29666,96590,1.974654669877075,0.27924094107579606
1351,0.1353,39,184,39,427316,249128,29705,96551,1.973197313395007,0.279308259975295
1352,0.1354,35,215,35,427531,248913,29740,96516,1.9714944240273728,0.2794090826190042
1353,0.1355,31,210,31,427741,248703,29771,96485,1.969831136738056,0.279514351599708
1354,0.1356,26,206,26,427947,248497,29797,96459,1.9681995311113927,0.2796269669175199
1355,0.1357,37,189,37,428136,248308,29834,96422,1.9667025725510074,0.27970295593653005
1356,0.1358,38,216,38,428352,248092,29872,96384,1.96499176276771,0.2797988829410467
1357,0.1359,22,206,22,428558,247886,29894,96362,1.9633601571410468,0.27992029002347146
1358,0.136,33,226,33,428784,247660,29927,96329,1.9615701432011152,0.2800351174020099
1359,0.1361,24,186,24,428970,247474,29951,96305,1.9600969458877202,0.2801363666774294
1360,0.1362,35,226,35,429196,247248,29986,96270,1.9583069319477886,0.28024732328436935
1361,0.1363,31,185,31,429381,247063,30017,96239,1.956841655050057,0.2803333508106565
1362,0.1364,35,198,35,429579,246865,30052,96204,1.955273412748701,0.2804217227438212
1363,0.1365,27,222,27,429801,246643,30079,96177,1.9535150804714232,0.28054664255294326
1364,0.1366,36,199,36,430000,246444,30115,96141,1.9519389177544038,0.2806340032400718
1365,0.1367,31,180,31,430180,246264,30146,96110,1.9505132429349892,0.2807164095404441
1366,0.1368,31,187,31,430367,246077,30177,96079,1.9490321252059308,0.2808046622008674
1367,0.1369,18,210,18,430577,245867,30195,96061,1.9473688379166139,0.28093926206686787
1368,0.137,36,195,36,430772,245672,30231,96025,1.9458243568622482,0.281023831054999
1369,0.1371,22,182,22,430954,245490,30253,96003,1.9443828412115067,0.28112728518593355
1370,0.1372,29,188,29,431142,245302,30282,95974,1.942893803066785,0.28122106447567363
1371,0.1373,26,212,26,431354,245090,30308,95948,1.9412146749461412,0.28134108222544113
1372,0.1374,29,175,29,431529,244915,30337,95919,1.9398286022050437,0.2814243884119542
1373,0.1375,25,213,25,431742,244702,30362,95894,1.9381415536687365,0.28154764001926036
1374,0.1376,38,195,38,431937,244507,30400,95856,1.9365970726143709,0.28162873167765
1375,0.1377,40,167,40,432104,244340,30440,95816,1.9352743631985807,0.28168252213690187
1376,0.1378,32,192,32,432296,244148,30472,95784,1.9337536433912053,0.2817740018591954
1377,0.1379,42,203,42,432499,243945,30514,95742,1.932145799011532,0.2818535887449328
1378,0.138,23,203,23,432702,243742,30537,95719,1.930537954631859,0.28197348148977347
1379,0.1381,28,207,28,432909,243535,30565,95691,1.9288984285895323,0.2820862787640098
1380,0.1382,38,190,38,433099,243345,30603,95653,1.9273935496134837,0.2821639065717202
1381,0.1383,33,168,33,433267,243177,30636,95620,1.9260629197820303,0.28223390407825333
1382,0.1384,31,200,31,433467,242977,30667,95589,1.9244788366493473,0.2823349066356338
1383,0.1385,32,201,32,433668,242776,30699,95557,1.9228868331010012,0.28243476101946896
1384,0.1386,31,186,31,433854,242590,30730,95526,1.9214136357876062,0.28252434075879285
1385,0.1387,30,170,30,434024,242420,30760,95496,1.9200671651248258,0.2826027770215083
1386,0.1388,28,181,28,434205,242239,30788,95468,1.9186335698897479,0.282694762027438
1387,0.1389,40,185,40,434390,242054,30828,95428,1.9171682929920162,0.28276471041418505
1388,0.139,32,168,32,434558,241886,30860,95396,1.9158376631605627,0.2828375068933415
1389,0.1391,28,197,28,434755,241689,30888,95368,1.9142773412748701,0.2829432410541837
1390,0.1392,29,181,29,434936,241508,30917,95339,1.9128437460397922,0.2830335434188222
1391,0.1393,22,215,22,435151,241293,30939,95317,1.9111408566721582,0.28316746383054575
1392,0.1394,31,163,31,435314,241130,30970,95286,1.9098498289190218,0.2832386093408161
1393,0.1395,26,187,26,435501,240943,30996,95260,1.9083687111899632,0.28334071974372627
1394,0.1396,33,185,33,435686,240758,31029,95227,1.9069034342922317,0.2834263434379511
1395,0.1397,26,197,26,435883,240561,31055,95201,1.9053431124065392,0.28353714833721505
1396,0.1398,42,190,42,436073,240371,31097,95159,1.9038382334304904,0.2836080231275892
1397,0.1399,27,204,27,436277,240167,31124,95132,1.9022224686351539,0.2837228861404299
1398,0.14,26,150,26,436427,240017,31150,95106,1.901034406285642,0.2837943083584236
1399,0.1401,34,193,34,436620,239824,31184,95072,1.899505766062603,0.28388514643351964
1400,0.1402,38,171,38,436791,239653,31222,95034,1.8981513749841592,0.2839488835837663
1401,0.1403,29,204,29,436995,239449,31251,95005,1.8965356101888227,0.2840599903125691
1402,0.1404,35,177,35,437172,239272,31286,94970,1.8951336966163985,0.28413544677209923
1403,0.1405,35,186,35,437358,239086,31321,94935,1.8936604993030035,0.284218656910793
1404,0.1406,20,188,20,437546,238898,31341,94915,1.8921714611582816,0.28433584072519646
1405,0.1407,33,163,33,437709,238735,31374,94882,1.890880433405145,0.2844039722196411
1406,0.1408,30,184,30,437893,238551,31404,94852,1.8894230769230769,0.2844965402230934
1407,0.1409,30,172,30,438065,238379,31434,94822,1.8880607654289696,0.2845789778542081
1408,0.141,27,222,27,438287,238157,31461,94795,1.8863024331516918,0.28471070905115453
1409,0.1411,35,168,35,438455,237989,31496,94760,1.8849718033202383,0.28477921796909983
1410,0.1412,29,181,29,438636,237808,31525,94731,1.8835382080851604,0.28487184961763884
1411,0.1413,33,171,33,438807,237637,31558,94698,1.8821838170067164,0.2849474175154588
1412,0.1414,32,171,32,438978,237466,31590,94666,1.8808294259282727,0.28502523093227994
1413,0.1415,33,183,33,439161,237283,31623,94633,1.879379989861868,0.2851112932187662
1414,0.1416,23,207,23,439368,237076,31646,94610,1.8777404638195412,0.28523965437190596
1415,0.1417,30,176,30,439544,236900,31676,94580,1.8763464706627804,0.2853264148666586
1416,0.1418,35,208,35,439752,236692,31711,94545,1.8746990242047903,0.28543006970839613
1417,0.1419,26,198,26,439950,236494,31737,94519,1.8731307819034342,0.28554467649306825
1418,0.142,27,185,27,440135,236309,31764,94492,1.8716655050057027,0.28564605306513585
1419,0.1421,20,183,20,440318,236126,31784,94472,1.870216068939298,0.2857609543917386
1420,0.1422,22,182,22,440500,235944,31806,94450,1.8687745532885567,0.2858708087919272
1421,0.1423,27,216,27,440716,235728,31833,94423,1.867063743505259,0.28599943662142474
1422,0.1424,28,196,28,440912,235532,31861,94395,1.86551134203523,0.2861087452678926
1423,0.1425,30,204,30,441116,235328,31891,94365,1.8638955772398935,0.2862208175484466
1424,0.1426,35,195,35,441311,235133,31926,94330,1.8623510961855279,0.2863143964572653
1425,0.1427,26,182,26,441493,234951,31952,94304,1.8609095805347864,0.2864163034729921
1426,0.1428,22,177,22,441670,234774,31974,94282,1.8595076669623622,0.28652265875717203
1427,0.1429,36,189,36,441859,234585,32010,94246,1.858010708401977,0.28660923088151663
1428,0.143,26,207,26,442066,234378,32036,94220,1.8563711823596503,0.2867333337390976
1429,0.1431,26,169,26,442235,234209,32062,94194,1.8550326321125332,0.28682441999616326
1430,0.1432,20,181,20,442416,234028,32082,94174,1.8535990368774553,0.28693914113868896
1431,0.1433,28,187,28,442603,233841,32110,94146,1.852117919148397,0.2870418644641404
1432,0.1434,26,197,26,442800,233644,32136,94120,1.8505575972627044,0.2871578330750174
1433,0.1435,34,184,34,442984,233460,32170,94086,1.849100240780636,0.28724515029949993
1434,0.1436,24,188,24,443172,233272,32194,94062,1.8476112026359144,0.2873578668882548
1435,0.1437,32,179,32,443351,233093,32226,94030,1.8461934482321631,0.2874453951571733
1436,0.1438,30,179,30,443530,232914,32256,94000,1.844775693828412,0.2875373951559126
1437,0.1439,25,180,25,443710,232734,32281,93975,1.8433500190089975,0.2876412954647714
1438,0.144,16,177,16,443887,232557,32297,93959,1.8419481054365734,0.28776231486359016
1439,0.1441,33,165,33,444052,232392,32330,93926,1.84064123685211,0.28783579208011817
1440,0.1442,34,205,34,444257,232187,32364,93892,1.83901755164111,0.2879424924634828
1441,0.1443,25,175,25,444432,232012,32389,93867,1.8376314789000128,0.2880424943000316
1442,0.1444,32,157,32,444589,231855,32421,93835,1.8363879736408566,0.28811139427062543
1443,0.1445,43,192,43,444781,231663,32464,93792,1.8348672538334811,0.2881873070009679
1444,0.1446,38,193,38,444974,231470,32502,93754,1.8333386136104424,0.2882751580449167
1445,0.1447,27,181,27,445155,231289,32529,93727,1.8319050183753642,0.2883765722302902
1446,0.1448,36,208,36,445363,231081,32565,93691,1.8302575719173741,0.2884823814860887
1447,0.1449,25,191,25,445554,230890,32590,93666,1.8287447725256623,0.2885973452963433
1448,0.145,32,188,32,445742,230702,32622,93634,1.8272557343809404,0.28869444033348135
1449,0.1451,31,223,31,445965,230479,32653,93603,1.825489481687999,0.2888250504501947
1450,0.1452,25,158,25,446123,230321,32678,93578,1.8242380560131797,0.2889110494320761
1451,0.1453,33,169,33,446292,230152,32711,93545,1.8228995057660626,0.28898939440279026
1452,0.1454,37,162,37,446454,229990,32748,93508,1.8216163984285896,0.28905279167104586
1453,0.1455,28,205,28,446659,229785,32776,93480,1.8199927132175897,0.28917451626374646
1454,0.1456,34,184,34,446843,229601,32810,93446,1.8185353567355216,0.28926441044182427
1455,0.1457,34,167,34,447010,229434,32844,93412,1.8172126473197314,0.2893391895826493
1456,0.1458,32,211,32,447221,229223,32876,93380,1.815541439614751,0.28945794056471885
1457,0.1459,33,194,33,447415,229029,32909,93347,1.8140048789760486,0.2895593964811276
1458,0.146,37,195,37,447610,228834,32946,93310,1.812460397921683,0.2896530744015099
1459,0.1461,28,176,28,447786,228658,32974,93282,1.811066404764922,0.2897496427905821
1460,0.1462,37,170,37,447956,228488,33011,93245,1.8097199341021417,0.28982106280673725
1461,0.1463,35,153,35,448109,228335,33046,93210,1.8085081105056393,0.2898816650857578
1462,0.1464,29,180,29,448289,228155,33075,93181,1.8070824356862247,0.2899799586725421
1463,0.1465,25,203,25,448492,227952,33100,93156,1.8054745913065517,0.2901080010463769
1464,0.1466,37,186,37,448678,227766,33137,93119,1.8040013939931567,0.2901943063714415
1465,0.1467,23,175,23,448853,227591,33160,93096,1.8026153212520593,0.29030175841240835
1466,0.1468,39,195,39,449048,227396,33199,93057,1.8010708401976936,0.29039203877011605
1467,0.1469,27,195,27,449243,227201,33226,93030,1.799526359143328,0.2905090387876252
1468,0.147,40,194,40,449437,227007,33266,92990,1.7979897985046256,0.29059647434194696
1469,0.1471,29,198,29,449635,226809,33295,92961,1.7964215562032695,0.29071207430340557
1470,0.1472,34,180,34,449815,226629,33329,92927,1.7949958813838551,0.29080036050019403
1471,0.1473,28,193,28,450008,226436,33357,92899,1.7934672411608161,0.29091393051184494
1472,0.1474,30,174,30,450182,226262,33387,92869,1.792089088835382,0.2910058878642313
1473,0.1475,36,198,36,450380,226064,33423,92833,1.790520846534026,0.2911065328303496
1474,0.1476,27,172,27,450552,225892,33450,92806,1.7891585350399188,0.2912035845847793
1475,0.1477,33,187,33,450739,225705,33483,92773,1.7876774173108605,0.2913011259804445
1476,0.1478,27,190,27,450929,225515,33510,92746,1.7861725383348117,0.2914149078900651
1477,0.1479,24,211,24,451140,225304,33534,92722,1.7845013306298314,0.29155477854011935
1478,0.148,33,180,33,451320,225124,33567,92689,1.7830756558104168,0.29164634549247515
1479,0.1481,33,193,33,451513,224931,33600,92656,1.781547015587378,0.29174997717160966
1480,0.1482,43,170,43,451683,224761,33643,92613,1.7802005449245977,0.29181029321872615
1481,0.1483,39,180,39,451863,224581,33682,92574,1.778774870105183,0.29188882407655564
1482,0.1484,26,174,26,452037,224407,33708,92548,1.7773967177797492,0.291990976637062
1483,0.1485,23,193,23,452230,224214,33731,92525,1.7758680775567102,0.29211748474295873
1484,0.1486,20,184,20,452414,224030,33751,92505,1.774410721074642,0.2922425640134582
1485,0.1487,33,173,33,452587,223857,33784,92472,1.7730404891648714,0.29232855666094476
1486,0.1488,35,221,35,452808,223636,33819,92437,1.771290077303257,0.2924545911862133
1487,0.1489,32,186,32,452994,223450,33851,92405,1.769816879989862,0.2925551281442434
1488,0.149,34,197,34,453191,223253,33885,92371,1.7682565581041694,0.2926615213038299
1489,0.1491,29,172,29,453363,223081,33914,92342,1.7668942466100621,0.2927560767604138
1490,0.1492,32,185,32,453548,222896,33946,92310,1.7654289697123304,0.2928561004549406
1491,0.1493,22,149,22,453697,222747,33968,92288,1.7642488277784818,0.29294522830796577
1492,0.1494,32,161,32,453858,222586,34000,92256,1.762973640856672,0.2930231671759168
1493,0.1495,23,177,23,454035,222409,34023,92233,1.761571727284248,0.2931363263645667
1494,0.1496,29,177,29,454212,222232,34052,92204,1.7601698137118236,0.2932361434441349
1495,0.1497,39,202,39,454414,222030,34091,92165,1.758569889747814,0.29333694043508013
1496,0.1498,35,199,35,454613,221831,34126,92130,1.7569937270307945,0.2934440901895458
1497,0.1499,38,187,38,454800,221644,34164,92092,1.7555126093017361,0.2935334166305429
1498,0.15,28,172,28,454972,221472,34192,92064,1.7541502978076289,0.2936313533374158
1499,0.1501,27,190,27,455162,221282,34219,92037,1.7526454188315803,0.29374854381636606
1500,0.1502,32,176,32,455338,221106,34251,92005,1.7512514256748195,0.2938414811360827
1501,0.1503,33,173,33,455511,220933,34284,91972,1.7498811937650487,0.29392946741023634
1502,0.1504,33,159,33,455670,220774,34317,91939,1.7486218476745659,0.2940044065964639
1503,0.1505,28,163,28,455833,220611,34345,91911,1.7473308199214295,0.29409449574749935
1504,0.1506,27,180,27,456013,220431,34372,91884,1.7459051451020149,0.294202968157149
1505,0.1507,36,187,36,456200,220244,34408,91848,1.7444240273729565,0.29429783525370723
1506,0.1508,32,195,32,456395,220049,34440,91816,1.7428795463185909,0.2944094399820435
1507,0.1509,29,158,29,456553,219891,34469,91787,1.7416281206437714,0.29449303447789066
1508,0.151,33,188,33,456741,219703,34502,91754,1.7401390824990495,0.2945960437556388
1509,0.1511,26,177,26,456918,219526,34528,91728,1.7387371689266253,0.2947046463659905
1510,0.1512,36,170,36,457088,219356,34564,91692,1.737390698263845,0.2947840847714822
1511,0.1513,28,183,28,457271,219173,34592,91664,1.7359412621974402,0.2948941084877283
1512,0.1514,35,184,35,457455,218989,34627,91629,1.734483905715372,0.29498934382424713
1513,0.1515,32,180,32,457635,218809,34659,91597,1.7330582308959575,0.29508772381977155
1514,0.1516,36,198,36,457833,218611,34695,91561,1.7314899885946013,0.29519427930309633
1515,0.1517,32,175,32,458008,218436,34727,91529,1.730103915853504,0.29528817769748195
1516,0.1518,32,180,32,458188,218256,34759,91497,1.7286782410340895,0.29538696961772765
1517,0.1519,29,161,29,458349,218095,34788,91468,1.7274030541122798,0.29547458837134927
1518,0.152,26,182,26,458531,217913,34814,91442,1.7259615384615385,0.2955892098075027
1519,0.1521,30,183,30,458714,217730,34844,91412,1.7245121023951338,0.29569582910118974
1520,0.1522,22,167,22,458881,217563,34866,91390,1.7231893929793436,0.2958055108705855
1521,0.1523,44,185,44,459066,217378,34910,91346,1.721724116081612,0.2958824062917039
1522,0.1524,26,149,26,459215,217229,34936,91320,1.7205439741477633,0.29596595678482185
1523,0.1525,26,154,26,459369,217075,34962,91294,1.7193242301355975,0.2960544023556194
1524,0.1526,27,169,27,459538,216906,34989,91267,1.7179856798884805,0.29615508172357735
1525,0.1527,32,163,32,459701,216743,35021,91235,1.7166946521353441,0.29623869237413064
1526,0.1528,31,173,31,459874,216570,35052,91204,1.7153244202255735,0.2963343232371805
1527,0.1529,31,173,31,460047,216397,35083,91173,1.7139541883158027,0.2964300809571805
1528,0.153,34,169,34,460216,216228,35117,91139,1.7126156380686859,0.2965152407382705
1529,0.1531,31,180,31,460396,216048,35148,91108,1.7111899632492713,0.29661800518303405
1530,0.1532,20,174,20,460570,215874,35168,91088,1.7098118109238374,0.2967403131332217
1531,0.1533,45,167,45,460737,215707,35213,91043,1.7084891015080472,0.29679869600652
1532,0.1534,34,185,34,460922,215522,35247,91009,1.7070238246103155,0.2968998241613409
1533,0.1535,28,175,28,461097,215347,35275,90981,1.705637751869218,0.2970051709278943
1534,0.1536,29,172,29,461269,215175,35304,90952,1.7042754403751108,0.2971054496989811
1535,0.1537,26,171,26,461440,215004,35330,90926,1.702921049296667,0.2972117804726571
1536,0.1538,37,174,37,461614,214830,35367,90889,1.701542896971233,0.29729588282049857
1537,0.1539,32,160,32,461774,214670,35399,90857,1.7002756304650868,0.29737797314148995
1538,0.154,29,179,29,461953,214491,35428,90828,1.6988578760613358,0.2974855806549871
1539,0.1541,34,178,34,462131,214313,35462,90794,1.697448042073248,0.29758084868587087
1540,0.1542,30,166,30,462297,214147,35492,90764,1.6961332530731212,0.2976737474213787
1541,0.1543,32,181,32,462478,213966,35524,90732,1.6946996578380433,0.29777681507591125
1542,0.1544,37,177,37,462655,213789,35561,90695,1.693297744265619,0.297864584017551
1543,0.1545,32,151,32,462806,213638,35593,90663,1.6921017615004434,0.29793855426041976
1544,0.1546,33,183,33,462989,213455,35626,90630,1.6906523254340389,0.2980416659815512
1545,0.1547,31,156,31,463145,213299,35657,90599,1.6894167405905463,0.2981230544458996
1546,0.1548,31,162,31,463307,213137,35688,90568,1.6881336332530732,0.29821043446765777
1547,0.1549,27,169,27,463476,212968,35715,90541,1.6867950830059562,0.29831405329001776
1548,0.155,29,158,29,463634,212810,35744,90512,1.6855436573311366,0.2984023578902948
1549,0.1551,27,159,27,463793,212651,35771,90485,1.6842843112406538,0.2984963844611
1550,0.1552,32,160,32,463953,212491,35803,90453,1.6830170447345076,0.2985799355656491
1551,0.1553,36,157,36,464110,212334,35839,90417,1.6817735394753517,0.29865136696493155
1552,0.1554,33,158,33,464268,212176,35872,90384,1.6805221138005322,0.29873083024854574
1553,0.1555,31,168,31,464436,212008,35903,90353,1.6791914839690787,0.2988249145888524
1554,0.1556,25,173,25,464609,211835,35928,90328,1.677821252059308,0.2989379904223879
1555,0.1557,27,171,27,464780,211664,35955,90301,1.6764668609808642,0.29904459126057653
1556,0.1558,15,141,15,464921,211523,35970,90286,1.6753500823723229,0.299149462077009
1557,0.1559,25,168,25,465089,211355,35995,90261,1.6740194525408694,0.2992579969232401
1558,0.156,34,187,34,465276,211168,36029,90227,1.672538334811811,0.2993646211781881
1559,0.1561,26,186,26,465462,210982,36055,90201,1.671065137498416,0.29948901498424546
1560,0.1562,23,194,23,465656,210788,36078,90178,1.6695285768597137,0.2996285294684449
1561,0.1563,30,173,30,465829,210615,36108,90148,1.668158344949943,0.29973101744562997
1562,0.1564,26,172,26,466001,210443,36134,90122,1.6667960334558358,0.29984196430056725
1563,0.1565,34,155,34,466156,210288,36168,90088,1.6655683690280065,0.2999174368125283
1564,0.1566,23,160,23,466316,210128,36191,90065,1.6643011025218604,0.30002365145089993
1565,0.1567,47,170,47,466486,209958,36238,90018,1.66295463185908,0.30008400672053764
1566,0.1568,40,144,40,466630,209814,36278,89978,1.6618140920035482,0.30013476010033624
1567,0.1569,27,164,27,466794,209650,36305,89951,1.6605151438347485,0.3002359805207593
1568,0.157,31,180,31,466974,209470,36336,89920,1.659089469015334,0.3003440328668292
1569,0.1571,30,155,30,467129,209315,36366,89890,1.6578618045875047,0.3004294714326298
1570,0.1572,27,172,27,467301,209143,36393,89863,1.6564994930933976,0.3005391196163288
1571,0.1573,41,151,41,467452,208992,36434,89822,1.655303510328222,0.30059501897501456
1572,0.1574,34,157,34,467609,208835,36468,89788,1.654060005069066,0.3006734243511049
1573,0.1575,30,177,30,467786,208658,36498,89758,1.6526580914966418,0.30078145943917217
1574,0.1576,40,174,40,467960,208484,36538,89718,1.6512799391712076,0.3008631732852228
1575,0.1577,34,189,34,468149,208295,36572,89684,1.6497829806108224,0.30097422972759824
1576,0.1578,27,158,27,468307,208137,36599,89657,1.6485315549360031,0.3010705386945338
1577,0.1579,31,150,31,468457,207987,36630,89626,1.647343492586491,0.30114947935742054
1578,0.158,37,189,37,468646,207798,36667,89589,1.6458465340261057,0.30125392165763804
1579,0.1581,33,148,33,468794,207650,36700,89556,1.6446743125079204,0.30132635276542197
1580,0.1582,33,148,33,468942,207502,36733,89523,1.643502090989735,0.301398872148809
1581,0.1583,37,164,37,469106,207338,36770,89486,1.6422031428209352,0.30147831711721423
1582,0.1584,38,181,38,469287,207157,36808,89448,1.6407695475858572,0.3015727988402084
1583,0.1585,30,191,30,469478,206966,36838,89418,1.6392567481941451,0.30169644785143596
1584,0.1586,36,165,36,469643,206801,36874,89382,1.6379498796096819,0.3017796429909887
1585,0.1587,39,175,39,469818,206626,36913,89343,1.6365638068685844,0.3018660738117843
1586,0.1588,28,148,28,469966,206478,36941,89315,1.635391585350399,0.30195102656249473
1587,0.1589,40,172,40,470138,206306,36981,89275,1.634029273856292,0.30203226865055605
1588,0.159,31,177,31,470315,206129,37012,89244,1.6326273602838677,0.30214000602627866
1589,0.1591,28,179,28,470494,205950,37040,89216,1.6312096058801167,0.3022570350243592
1590,0.1592,32,156,32,470650,205794,37072,89184,1.629974021036624,0.3023411915464882
1591,0.1593,28,162,28,470812,205632,37100,89156,1.628690913699151,0.30244107629889955
1592,0.1594,23,140,23,470952,205492,37123,89133,1.627582055506273,0.3025303351718286
1593,0.1595,31,165,31,471117,205327,37154,89102,1.6262751869218097,0.30262643965098546
1594,0.1596,25,152,25,471269,205175,37179,89077,1.6250712837409707,0.30272351589793783
1595,0.1597,42,140,42,471409,205035,37221,89035,1.6239624255480927,0.30276804842384464
1596,0.1598,27,163,27,471572,204872,37248,89008,1.6226713977949563,0.30287192051177353
1597,0.1599,31,173,31,471745,204699,37279,88977,1.6213011658851857,0.3029767498876313
1598,0.16,28,150,28,471895,204549,37307,88949,1.6201131035356735,0.3030650975475131
1599,0.1601,26,162,26,472057,204387,37333,88923,1.6188299961982004,0.3031707067607651
1600,0.1602,29,145,29,472202,204242,37362,88894,1.6176815359270054,0.3032517329840074
1601,0.1603,28,154,28,472356,204088,37390,88866,1.6164617919148396,0.3033445523870642
1602,0.1604,34,151,34,472507,203937,37424,88832,1.6152658091496641,0.3034201025381786
1603,0.1605,26,160,26,472667,203777,37450,88806,1.613998542643518,0.30352412819610164
1604,0.1606,32,166,32,472833,203611,37482,88774,1.6126837536433911,0.3036202267558185
1605,0.1607,34,146,34,472979,203465,37516,88740,1.6115273729565327,0.30369090193528514
1606,0.1608,42,150,42,473129,203315,37558,88698,1.6103393106070207,0.3037467510008116
1607,0.1609,28,155,28,473284,203160,37586,88670,1.6091116461791914,0.30384127745605316
1608,0.161,28,155,28,473439,203005,37614,88642,1.6078839817513624,0.30393592253649104
1609,0.1611,28,165,28,473604,202840,37642,88614,1.606577113166899,0.30404111798088207
1610,0.1612,29,166,29,473770,202674,37671,88585,1.6052623241667723,0.3041451079623291
1611,0.1613,34,166,34,473936,202508,37705,88551,1.6039475351666455,0.30423728522395804
1612,0.1614,33,178,33,474114,202330,37738,88518,1.6025377011785578,0.3043445373528441
1613,0.1615,33,134,33,474248,202196,37771,88485,1.6014763654796604,0.3044058607201709
1614,0.1616,36,153,36,474401,202043,37807,88449,1.600264541883158,0.30447998567946793
1615,0.1617,22,150,22,474551,201893,37829,88427,1.5990764795336458,0.3045845963075227
1616,0.1618,22,163,22,474714,201730,37851,88405,1.5977854517805095,0.3047029830940769
1617,0.1619,38,163,38,474877,201567,37889,88367,1.5964944240273728,0.30478315754620017
1618,0.162,30,155,30,475032,201412,37919,88337,1.5952667595995438,0.3048742187203407
1619,0.1621,27,162,27,475194,201250,37946,88310,1.5939836522620707,0.30497996960906204
1620,0.1622,26,157,26,475351,201093,37972,88284,1.5927401470029148,0.30508298862729244
1621,0.1623,32,150,32,475501,200943,38004,88252,1.5915520846534026,0.3051643354829786
1622,0.1624,26,167,26,475668,200776,38030,88226,1.5902293752376124,0.3052781641649539
1623,0.1625,27,169,27,475837,200607,38057,88199,1.5888908249904956,0.30539185473985997
1624,0.1626,25,170,25,476007,200437,38082,88174,1.587544354327715,0.30551157093804465
1625,0.1627,22,139,22,476146,200298,38104,88152,1.5864434165505006,0.30560582423296934
1626,0.1628,23,146,23,476292,200152,38127,88129,1.5852870358636422,0.30570519735952073
1627,0.1629,36,171,36,476463,199981,38163,88093,1.5839326447851982,0.30579989863715573
1628,0.163,27,156,27,476619,199825,38190,88066,1.5826970599417058,0.3059004970631246
1629,0.1631,42,154,42,476773,199671,38232,88024,1.5814773159295399,0.30596291211178506
1630,0.1632,33,152,33,476925,199519,38265,87991,1.580273412748701,0.3060450071301868
1631,0.1633,24,152,24,477077,199367,38289,87967,1.5790695095678622,0.30614894164978734
1632,0.1634,24,157,24,477234,199210,38313,87943,1.5778260043087062,0.3062583361483251
1633,0.1635,25,160,25,477394,199050,38338,87918,1.5765587378025598,0.3063686543447353
1634,0.1636,21,162,21,477556,198888,38359,87897,1.5752756304650868,0.30649092525759714
1635,0.1637,24,165,24,477721,198723,38383,87873,1.5739687618806235,0.30660930368881634
1636,0.1638,36,163,36,477884,198560,38419,87837,1.572677734127487,0.30669664835874677
1637,0.1639,31,152,31,478036,198408,38450,87806,1.571473830946648,0.3067844340248905
1638,0.164,28,154,28,478190,198254,38478,87778,1.5702540869344823,0.3068817474967836
1639,0.1641,38,161,38,478351,198093,38516,87740,1.5689789000126726,0.3069624570990753
1640,0.1642,28,160,28,478511,197933,38544,87712,1.5677116335065264,0.30706646361742723
1641,0.1643,28,139,28,478650,197794,38572,87684,1.5666106957293118,0.3071480114054323
1642,0.1644,28,149,28,478799,197645,38600,87656,1.5654305537954631,0.3072404232722633
1643,0.1645,26,139,26,478938,197506,38626,87630,1.5643296160182487,0.3073270299085349
1644,0.1646,39,156,39,479094,197350,38665,87591,1.563094031174756,0.3074004793974893
1645,0.1647,37,148,37,479242,197202,38702,87554,1.5619218096565708,0.30747025523606175
1646,0.1648,26,152,26,479394,197050,38728,87528,1.560717906475732,0.3075712107049737
1647,0.1649,28,137,28,479531,196913,38756,87500,1.5596328095298442,0.3076511973784602
1648,0.165,24,167,24,479698,196746,38780,87476,1.558310100114054,0.30777350099570056
1649,0.1651,23,161,23,479859,196585,38803,87453,1.5570349131922443,0.30789190178778897
1650,0.1652,31,153,31,480012,196432,38834,87422,1.555823089595742,0.3079822725767472
1651,0.1653,29,186,29,480198,196246,38863,87393,1.5543498922823469,0.3081134822785301
1652,0.1654,24,134,24,480332,196112,38887,87369,1.5532885565834496,0.3082005495959165
1653,0.1655,25,166,25,480498,195946,38912,87344,1.5519737675833227,0.3083200960146846
1654,0.1656,34,165,34,480663,195781,38946,87310,1.5506668989988595,0.30841672818987537
1655,0.1657,34,162,34,480825,195619,38980,87276,1.5493837916613864,0.3085102246416515
1656,0.1658,36,165,36,480990,195454,39016,87240,1.5480769230769231,0.3086022342179176
1657,0.1659,28,180,28,481170,195274,39044,87212,1.5466512482575085,0.3087303441586486
1658,0.166,29,158,29,481328,195116,39073,87183,1.545399822582689,0.30883212480384276
1659,0.1661,34,157,34,481485,194959,39107,87149,1.544156317323533,0.30892069703801384
1660,0.1662,37,151,37,481636,194808,39144,87112,1.5429603345583576,0.3089954597048808
1661,0.1663,19,162,19,481798,194646,39163,87093,1.5416772272208845,0.3091265320030241
1662,0.1664,34,141,34,481939,194505,39197,87059,1.5405604486123432,0.3091979088235712
1663,0.1665,29,148,29,482087,194357,39226,87030,1.539388227094158,0.3092893417250975
1664,0.1666,29,143,29,482230,194214,39255,87001,1.5382556076542897,0.30937538893729
1665,0.1667,38,158,38,482388,194056,39293,86963,1.5370041819794702,0.3094559442599967
1666,0.1668,38,153,38,482541,193903,39331,86925,1.535792358382968,0.3095311008873759
1667,0.1669,30,143,30,482684,193760,39361,86895,1.5346597389430998,0.30961500774972833
1668,0.167,18,147,18,482831,193613,39379,86877,1.5334954378405778,0.3097329673072124
1669,0.1671,29,141,29,482972,193472,39408,86848,1.5323786592320365,0.30981735159817353
1670,0.1672,20,127,20,483099,193345,39428,86828,1.531372766442783,0.3099085208067872
1671,0.1673,37,159,37,483258,193186,39465,86791,1.5301134203523001,0.3099933208799294
1672,0.1674,39,169,39,483427,193017,39504,86752,1.528774870105183,0.3100843910511887
1673,0.1675,31,134,31,483561,192883,39535,86721,1.5277135344062855,0.3101565070599848
1674,0.1676,34,158,34,483719,192725,39569,86687,1.5264621087314663,0.3102479492648848
1675,0.1677,32,136,32,483855,192589,39601,86655,1.5253849322012418,0.31032000687570727
1676,0.1678,29,157,29,484012,192432,39630,86626,1.5241414269420859,0.31042292283324613
1677,0.1679,29,147,29,484159,192285,39659,86597,1.5229771258395641,0.31051484140245694
1678,0.168,27,150,27,484309,192135,39686,86570,1.521789063490052,0.3106151665739761
1679,0.1681,38,144,38,484453,191991,39724,86532,1.5206485236345204,0.3106817031268513
1680,0.1682,26,159,26,484612,191832,39750,86506,1.5193891775440376,0.31079478906940483
1681,0.1683,26,145,26,484757,191687,39776,86480,1.5182407172728425,0.3108923776005062
1682,0.1684,24,151,24,484908,191536,39800,86456,1.517044734507667,0.3110017554461999
1683,0.1685,28,169,28,485077,191367,39828,86428,1.51570618426055,0.31112151046635106
1684,0.1686,34,154,34,485231,191213,39862,86394,1.5144864402483842,0.31120973174307565
1685,0.1687,37,145,37,485376,191068,39899,86357,1.513337979977189,0.31128052626836084
1686,0.1688,28,151,28,485527,190917,39927,86329,1.5121419972120136,0.3113805068422989
1687,0.1689,27,125,27,485652,190792,39954,86302,1.511151945254087,0.3114538748583513
1688,0.169,30,151,30,485803,190641,39984,86272,1.5099559624889114,0.3115491147038962
1689,0.1691,33,151,33,485954,190490,40017,86239,1.5087599797237359,0.3116370167203293
1690,0.1692,33,160,33,486114,190330,40050,86206,1.5074927132175897,0.311735180952932
1691,0.1693,23,148,23,486262,190182,40073,86183,1.5063204916994044,0.3118448428708411
1692,0.1694,31,137,31,486399,190045,40104,86152,1.5052353947535166,0.3119222873528677
1693,0.1695,30,155,30,486554,189890,40134,86122,1.5040077303256876,0.3120226656812023
1694,0.1696,32,144,32,486698,189746,40166,86090,1.5028671904701558,0.3121057439928073
1695,0.1697,20,150,20,486848,189596,40186,86070,1.5016791281206439,0.3122256643909659
1696,0.1698,41,144,41,486992,189452,40227,86029,1.500538588265112,0.3122865097774438
1697,0.1699,21,167,21,487159,189285,40248,86008,1.499215878849322,0.31242349060818836
1698,0.17,20,141,20,487300,189144,40268,85988,1.4980991002407806,0.3125336202259279
1699,0.1701,28,131,28,487431,189013,40296,85960,1.4970615257888733,0.3126125110465391
1700,0.1702,29,131,29,487562,188882,40325,85931,1.4960239513369662,0.31268899215102636
1701,0.1703,33,142,33,487704,188740,40358,85898,1.4948992523127613,0.3127680801637064
1702,0.1704,34,169,34,487873,188571,40392,85864,1.4935607020656445,0.3128755443001075
1703,0.1705,29,146,29,488019,188425,40421,85835,1.4924043213787859,0.3129694450521403
1704,0.1706,28,149,28,488168,188276,40449,85807,1.4912241794449372,0.3130693986857996
1705,0.1707,29,143,29,488311,188133,40478,85778,1.490091560005069,0.3131601140516445
1706,0.1708,25,138,25,488449,187995,40503,85753,1.488998542643518,0.3132552566594094
1707,0.1709,26,146,26,488595,187849,40529,85727,1.4878421619566595,0.31335716583326023
1708,0.171,24,163,24,488758,187686,40553,85703,1.486551134203523,0.31348371734049285
1709,0.1711,35,126,35,488884,187560,40588,85668,1.485553161829933,0.3135403399358777
1710,0.1712,30,133,30,489017,187427,40618,85638,1.4844997465466987,0.31361763682639665
1711,0.1713,29,143,29,489160,187284,40647,85609,1.4833671271068305,0.31370903614237083
1712,0.1714,25,132,25,489292,187152,40672,85584,1.4823216322392598,0.3137979584653291
1713,0.1715,24,147,24,489439,187005,40696,85560,1.481157331136738,0.31390677453084587
1714,0.1716,21,143,21,489582,186862,40717,85539,1.4800247116968699,0.3140186710034104
1715,0.1717,35,164,35,489746,186698,40752,85504,1.47872576352807,0.3141196611340108
1716,0.1718,20,153,20,489899,186545,40772,85484,1.4775139399315675,0.31424590760543913
1717,0.1719,21,156,21,490055,186389,40793,85463,1.476278355088075,0.3143732619219281
1718,0.172,24,124,24,490179,186265,40817,85439,1.4752962235458116,0.3144561728940317
1719,0.1721,30,147,30,490326,186118,40847,85409,1.4741319224432898,0.31455067083568117
1720,0.1722,24,140,24,490466,185978,40871,85385,1.4730230642504119,0.3146523291679411
1721,0.1723,26,156,26,490622,185822,40897,85359,1.4717874794069192,0.3147676275255272
1722,0.1724,35,146,35,490768,185676,40932,85324,1.4706310987200608,0.31484870848708485
1723,0.1725,22,120,22,490888,185556,40954,85302,1.4696806488404512,0.3149325476818111
1724,0.1726,34,138,34,491026,185418,40988,85268,1.4685876314789,0.31500705614623586
1725,0.1727,35,144,35,491170,185274,41023,85233,1.4674470916233684,0.31508611607093345
1726,0.1728,28,152,28,491322,185122,41051,85205,1.4662431884425295,0.3151923411275973
1727,0.1729,34,165,34,491487,184957,41085,85171,1.464936319858066,0.31529867322158384
1728,0.173,24,130,24,491617,184827,41109,85147,1.4639066658218223,0.31538963011252935
1729,0.1731,42,147,42,491764,184680,41151,85105,1.4627423647193005,0.3154548992716422
1730,0.1732,28,141,28,491905,184539,41179,85077,1.461625586110759,0.3155487804878049
1731,0.1733,32,133,32,492038,184406,41211,85045,1.460572170827525,0.3156232487539478
1732,0.1734,35,128,35,492166,184278,41246,85010,1.459558357622608,0.3156843231038888
1733,0.1735,31,161,31,492327,184117,41277,84979,1.4582831707007984,0.3157943633498826
1734,0.1736,26,126,26,492453,183991,41303,84953,1.4572851983272082,0.31587616752929976
1735,0.1737,18,151,18,492604,183840,41321,84935,1.4560892155620326,0.3160078132266766
1736,0.1738,35,132,35,492736,183708,41356,84900,1.455043720694462,0.31607398141529663
1737,0.1739,39,131,39,492867,183577,41395,84861,1.4540061462425549,0.3161288640207422
1738,0.174,20,147,20,493014,183430,41415,84841,1.452841845140033,0.3162511042937925
1739,0.1741,29,129,29,493143,183301,41444,84812,1.4518201115194524,0.3163293089107951
1740,0.1742,40,163,40,493306,183138,41484,84772,1.450529083766316,0.3164196931805457
1741,0.1743,24,143,24,493449,182995,41508,84748,1.4493964643264479,0.316527416216297
1742,0.1744,29,124,29,493573,182871,41537,84719,1.4484143327841845,0.31660002242236257
1743,0.1745,31,122,31,493695,182749,41568,84688,1.447448042073248,0.3166652333072836
1744,0.1746,27,156,27,493851,182593,41595,84661,1.4462124572297554,0.3167810397599288
1745,0.1747,35,158,35,494009,182435,41630,84626,1.444961031554936,0.3168789153039942
1746,0.1748,30,138,30,494147,182297,41660,84596,1.4438680141933848,0.3169659751286096
1747,0.1749,20,124,20,494271,182173,41680,84576,1.4428858826511215,0.31706210707444077
1748,0.175,31,136,31,494407,182037,41711,84545,1.4418087061208973,0.317144443360767
1749,0.1751,24,145,24,494552,181892,41735,84521,1.4406602458497022,0.31725553933178935
1750,0.1752,22,124,22,494676,181768,41757,84499,1.4396781143074389,0.3173468736268482
1751,0.1753,18,140,18,494816,181628,41775,84481,1.4385692561145609,0.3174676542319125
1752,0.1754,41,148,41,494964,181480,41816,84440,1.4373970345963756,0.3175391095066185
1753,0.1755,30,142,30,495106,181338,41846,84410,1.436272335572171,0.3176317413489471
1754,0.1756,26,133,26,495239,181205,41872,84384,1.4352189202889367,0.31772400212358193
1755,0.1757,26,144,26,495383,181061,41898,84358,1.4340783804334052,0.317829544983592
1756,0.1758,24,138,24,495521,180923,41922,84334,1.432985363071854,0.3179331742423386
1757,0.1759,35,141,35,495662,180782,41957,84299,1.4318685844633126,0.3180122302239693
1758,0.176,18,149,18,495811,180633,41975,84281,1.430688442529464,0.3181447564115147
1759,0.1761,31,137,31,495948,180496,42006,84250,1.4296033455835762,0.3182295483217877
1760,0.1762,38,153,38,496101,180343,42044,84212,1.428391521987074,0.3183156621496475
1761,0.1763,31,137,31,496238,180206,42075,84181,1.4273064250411862,0.318400677794294
1762,0.1764,31,139,31,496377,180067,42106,84150,1.4262054872639716,0.318488212340614
1763,0.1765,28,146,28,496523,179921,42134,84122,1.4250491065771131,0.31859204750741354
1764,0.1766,26,160,26,496683,179761,42160,84096,1.423781840070967,0.31871809351277397
1765,0.1767,30,141,30,496824,179620,42190,84066,1.4226650614624254,0.31881101006500157
1766,0.1768,25,154,25,496978,179466,42215,84041,1.4214453174502597,0.31893270387503936
1767,0.1769,33,143,33,497121,179323,42248,84008,1.4203126980103915,0.3190205482833392
1768,0.177,33,140,33,497261,179183,42281,83975,1.4192038398175135,0.3191048723580511
1769,0.1771,20,128,20,497389,179055,42301,83955,1.4181900266125966,0.3192083951180563
1770,0.1772,26,146,26,497535,178909,42327,83929,1.4170336459257382,0.31931836340255215
1771,0.1773,22,153,22,497688,178756,42349,83907,1.4158218223292358,0.31944735269147156
1772,0.1774,26,142,26,497830,178614,42375,83881,1.414697123305031,0.31955275338577876
1773,0.1775,33,145,33,497975,178469,42408,83848,1.413548663033836,0.3196437897658177
1774,0.1776,33,154,33,498129,178315,42441,83815,1.4123289190216703,0.31974592759317894
1775,0.1777,26,136,26,498265,178179,42467,83789,1.411251742491446,0.3198444084773713
1776,0.1778,26,143,26,498408,178036,42493,83763,1.4101191230515777,0.3199515658959736
1777,0.1779,27,146,27,498554,177890,42520,83736,1.4089627423647193,0.32005993288128853
1778,0.178,29,153,29,498707,177737,42549,83707,1.407750918768217,0.3201718149967106
1779,0.1781,30,138,30,498845,177599,42579,83677,1.4066579014066658,0.3202628637915461
1780,0.1782,29,142,29,498987,177457,42608,83648,1.405533202382461,0.3203615403764769
1781,0.1783,37,143,37,499130,177314,42645,83611,1.4044005829425927,0.32044073967615216
1782,0.1784,34,150,34,499280,177164,42679,83577,1.4032125205930808,0.32053647105748617
1783,0.1785,27,132,27,499412,177032,42706,83550,1.40216702572551,0.3206284394163833
1784,0.1786,34,126,34,499538,176906,42740,83516,1.4011690533519199,0.320694872169018
1785,0.1787,28,141,28,499679,176765,42768,83488,1.4000522747433786,0.32079553357694246
1786,0.1788,28,135,28,499814,176630,42796,83460,1.3989830186288177,0.32088892306509287
1787,0.1789,20,136,20,499950,176494,42816,83440,1.3979058420985933,0.32100456269668454
1788,0.179,26,164,26,500114,176330,42842,83414,1.3966068939297935,0.32113927559443145
1789,0.1791,36,129,36,500243,176201,42878,83378,1.395585160309213,0.3212047199503812
1790,0.1792,32,133,32,500376,176068,42910,83346,1.3945317450259789,0.321285666926226
1791,0.1793,23,134,23,500510,175934,42933,83323,1.3934704093270815,0.321391514983202
1792,0.1794,28,150,28,500660,175784,42961,83295,1.3922823469775694,0.32150425159893314
1793,0.1795,24,129,24,500789,175655,42985,83271,1.391260613356989,0.3216015386635564
1794,0.1796,29,150,29,500939,175505,43014,83242,1.390072551007477,0.3217119425539233
1795,0.1797,30,139,30,501078,175366,43044,83212,1.3889716132302623,0.3218061861411257
1796,0.1798,29,136,29,501214,175230,43073,83183,1.387894436700038,0.32189944004365106
1797,0.1799,33,123,33,501337,175107,43106,83150,1.386920225573438,0.3219661035325277
1798,0.18,25,151,25,501488,174956,43131,83125,1.3857242428082626,0.32208880157779923
1799,0.1801,33,118,33,501606,174838,43164,83092,1.3847896337599797,0.32214942038537586
1800,0.1802,29,138,29,501744,174700,43193,83063,1.3836966163984286,0.322245628736475
1801,0.1803,28,134,28,501878,174566,43221,83035,1.382635280699531,0.3223395871910435
1802,0.1804,34,127,34,502005,174439,43255,83001,1.3816293879102775,0.32240910503418274
1803,0.1805,24,117,24,502122,174322,43279,82977,1.380702699277658,0.3224925087155411
1804,0.1806,36,138,36,502260,174184,43315,82941,1.379609681916107,0.32257073407875547
1805,0.1807,32,133,32,502393,174051,43347,82909,1.3785562666328728,0.32265333125778334
1806,0.1808,43,126,43,502519,173925,43390,82866,1.3775582942592828,0.32269822540509596
1807,0.1809,30,142,30,502661,173783,43420,82836,1.376433595235078,0.3227976104653202
1808,0.181,26,136,26,502797,173647,43446,82810,1.3753564187048537,0.32290013530533385
1809,0.1811,35,148,35,502945,173499,43481,82775,1.3741841971866684,0.32299413908551006
1810,0.1812,31,128,31,503073,173371,43512,82744,1.3731703839817513,0.32307361927259237
1811,0.1813,28,138,28,503211,173233,43540,82716,1.3720773666202002,0.3231737572719565
1812,0.1814,23,148,23,503359,173085,43563,82693,1.3709051451020149,0.32329989287585326
1813,0.1815,26,161,26,503520,172924,43589,82667,1.3696299581802054,0.3234347062298751
1814,0.1816,32,126,32,503646,172798,43621,82635,1.3686319858066152,0.3235094917258146
1815,0.1817,33,123,33,503769,172675,43654,82602,1.3676577746800151,0.32357791732118446
1816,0.1818,33,122,33,503891,172553,43687,82569,1.3666914839690787,0.3236451580028379
1817,0.1819,29,158,29,504049,172395,43716,82540,1.3654400582942592,0.3237688038127366
1818,0.182,27,120,27,504169,172275,43743,82513,1.3644896084146496,0.3238496318507936
1819,0.1821,22,143,22,504312,172132,43765,82491,1.3633569889747814,0.32397308962662447
1820,0.1822,24,137,24,504449,171995,43789,82467,1.3622718920288936,0.32408375317336185
1821,0.1823,23,150,23,504599,171845,43812,82444,1.3610838296793817,0.32421378824880354
1822,0.1824,25,128,25,504727,171717,43837,82419,1.3600700164744646,0.32431060534516953
1823,0.1825,31,142,31,504869,171575,43868,82388,1.3589453174502597,0.324409461220729
1824,0.1826,23,143,23,505012,171432,43891,82365,1.3578126980103915,0.3245310228253289
1825,0.1827,36,140,36,505152,171292,43927,82329,1.3567038398175135,0.324614286671845
1826,0.1828,26,141,26,505293,171151,43953,82303,1.3555870612089722,0.324725591231545
1827,0.1829,31,148,31,505441,171003,43984,82272,1.354414839690787,0.3248326917382292
1828,0.183,21,141,21,505582,170862,44005,82251,1.3532980610822456,0.324957627620865
1829,0.1831,34,136,34,505718,170726,44039,82217,1.3522208845520214,0.325041610165136
1830,0.1832,34,154,34,505872,170572,44073,82183,1.3510011405398554,0.32514885956756545
1831,0.1833,31,113,31,505985,170459,44104,82152,1.3501061335698898,0.32521149118605286
1832,0.1834,31,132,31,506117,170327,44135,82121,1.3490606387023192,0.32529867537076945
1833,0.1835,35,142,35,506259,170185,44170,82086,1.3479359396781143,0.3253881738289379
1834,0.1836,25,145,25,506404,170040,44195,82061,1.3467874794069192,0.3255084271779961
1835,0.1837,18,132,18,506536,169908,44213,82043,1.3457419845393486,0.3256307774130684
1836,0.1838,26,137,26,506673,169771,44239,82017,1.3446568875934608,0.3257383195386595
1837,0.1839,38,127,38,506800,169644,44277,81979,1.3436509948042072,0.325800900553606
1838,0.184,31,131,31,506931,169513,44308,81948,1.3426134203523001,0.3258875133718549
1839,0.1841,26,112,26,507043,169401,44334,81922,1.3417263337979977,0.3259630037839752
1840,0.1842,24,135,24,507178,169266,44358,81898,1.3406570776834368,0.32607380038540557
1841,0.1843,21,123,21,507301,169143,44379,81877,1.339682866556837,0.3261771970360927
1842,0.1844,33,139,33,507440,169004,44412,81844,1.3385819287796223,0.3262692945528766
1843,0.1845,35,139,35,507579,168865,44447,81809,1.337480991002408,0.3263561438362176
1844,0.1846,30,124,30,507703,168741,44477,81779,1.3364988594601446,0.32643701101708444
1845,0.1847,22,120,22,507823,168621,44499,81757,1.3355484095805348,0.3265342801683854
1846,0.1848,26,145,26,507968,168476,44525,81731,1.3343999493093397,0.32665353087643434
1847,0.1849,22,139,22,508107,168337,44547,81709,1.3332990115321253,0.32677587323932394
1848,0.185,23,119,23,508226,168218,44570,81686,1.332356482068179,0.3268695178948716
1849,0.1851,37,128,37,508354,168090,44607,81649,1.331342668863262,0.3269373225647576
1850,0.1852,30,122,30,508476,167968,44637,81619,1.3303763781523255,0.32701623081330355
1851,0.1853,19,129,19,508605,167839,44656,81600,1.329354644531745,0.32713408889548146
1852,0.1854,25,110,25,508715,167729,44681,81575,1.3284833988087694,0.32721095529955396
1853,0.1855,33,138,33,508853,167591,44714,81542,1.3273903814472183,0.3273030871060839
1854,0.1856,13,127,13,508980,167464,44727,81529,1.3263844886579648,0.32743490780865325
1855,0.1857,28,112,28,509092,167352,44755,81501,1.3254974021036623,0.3275066002820943
1856,0.1858,31,137,31,509229,167215,44786,81470,1.3244123051577747,0.32760319279409694
1857,0.1859,18,155,18,509384,167060,44804,81452,1.3231846407299455,0.3277588204996137
1858,0.186,28,143,28,509527,166917,44832,81424,1.3220520212900773,0.32787175697931475
1859,0.1861,25,122,25,509649,166795,44857,81399,1.3210857305791408,0.32796522075473217
1860,0.1862,30,142,30,509791,166653,44887,81369,1.319961031554936,0.32807170331664126
1861,0.1863,34,135,34,509926,166518,44921,81335,1.318891775440375,0.3281582228175572
1862,0.1864,27,125,27,510051,166393,44948,81308,1.3179017234824484,0.32825059244815324
1863,0.1865,36,164,36,510215,166229,44984,81272,1.3166027753136484,0.32837039042266497
1864,0.1866,29,136,29,510351,166093,45013,81243,1.3155255987834242,0.3284721997606495
1865,0.1867,20,111,20,510462,165982,45033,81223,1.314646432644785,0.32856536073299486
1866,0.1868,27,147,27,510609,165835,45060,81196,1.3134821315422633,0.3286874926628642
1867,0.1869,31,127,31,510736,165708,45091,81165,1.3124762387530098,0.3287722837248302
1868,0.187,31,132,31,510868,165576,45122,81134,1.3114307438854391,0.32886384824287623
1869,0.1871,25,125,25,510993,165451,45147,81109,1.3104406919275124,0.3289625243348475
1870,0.1872,30,145,30,511138,165306,45177,81079,1.3092922316563174,0.32907441605617227
1871,0.1873,30,130,30,511268,165176,45207,81049,1.3082625776200736,0.3291664128337902
1872,0.1874,24,121,24,511389,165055,45231,81025,1.3073042073248005,0.32926284135240574
1873,0.1875,23,118,23,511507,164937,45254,81002,1.3063695982765176,0.3293580928604247
1874,0.1876,43,130,43,511637,164807,45297,80959,1.3053399442402738,0.3294149719652027
1875,0.1877,30,124,30,511761,164683,45327,80929,1.3043578126980104,0.3294993729948048
1876,0.1878,37,122,37,511883,164561,45364,80892,1.303391521987074,0.32956207502047236
1877,0.1879,24,116,24,511999,164445,45388,80868,1.302472753770118,0.3296523217277519
1878,0.188,24,133,24,512132,164312,45412,80844,1.3014193384868837,0.3297655370457994
1879,0.1881,24,128,24,512260,164184,45436,80820,1.3004055252819668,0.32987216535240244
1880,0.1882,24,122,24,512382,164062,45460,80796,1.2994392345710304,0.3299708402420995
1881,0.1883,19,121,19,512503,163941,45479,80777,1.2984808642757573,0.3300819719023529
1882,0.1884,26,132,26,512635,163809,45505,80751,1.2974353694081866,0.33018891069676154
1883,0.1885,25,143,25,512778,163666,45530,80726,1.2963027499683184,0.3303135945530132
1884,0.1886,24,123,24,512901,163543,45554,80702,1.2953285388417184,0.3304141333497103
1885,0.1887,21,149,21,513050,163394,45575,80681,1.2941483969078698,0.33055823005223806
1886,0.1888,23,147,23,513197,163247,45598,80658,1.2929840958053478,0.33069432770955903
1887,0.1889,36,129,36,513326,163118,45634,80622,1.2919623621847676,0.3307704931484369
1888,0.189,27,136,27,513462,162982,45661,80595,1.2908851856545431,0.33088099451097597
1889,0.1891,26,100,26,513562,162882,45687,80569,1.2900931440882017,0.3309454469277185
1890,0.1892,32,132,32,513694,162750,45719,80537,1.289047649220631,0.3310370056764233
1891,0.1893,41,147,41,513841,162603,45760,80496,1.2878833481181093,0.3311243567435489
1892,0.1894,29,129,29,513970,162474,45789,80467,1.286861614497529,0.331220337448187
1893,0.1895,39,144,39,514114,162330,45828,80428,1.2857210746419971,0.3313093698250933
1894,0.1896,38,148,38,514262,162182,45866,80390,1.2845488531238118,0.3314067575812542
1895,0.1897,29,117,29,514379,162065,45895,80361,1.2836221644911925,0.33148672172126753
1896,0.1898,28,125,28,514504,161940,45923,80333,1.2826321125332658,0.33158048977806026
1897,0.1899,25,130,25,514634,161810,45948,80308,1.281602458497022,0.3316895067694265
1898,0.19,26,124,26,514758,161686,45974,80282,1.2806203269547587,0.3317876744032269
1899,0.1901,21,120,21,514878,161566,45995,80261,1.279669877075149,0.3318942880654352
1900,0.1902,30,133,30,515011,161433,46025,80231,1.278616461791915,0.3319940082097458
1901,0.1903,29,121,29,515132,161312,46054,80202,1.2776580914966418,0.3320801278600826
1902,0.1904,26,119,26,515251,161193,46080,80176,1.2767155620326955,0.3321719027712755
1903,0.1905,25,122,25,515373,161071,46105,80151,1.2757492713217589,0.33227068841150476
1904,0.1906,26,134,26,515507,160937,46131,80125,1.2746879356228615,0.33238337025329584
1905,0.1907,36,122,36,515629,160815,46167,80089,1.273721644911925,0.33245193105967524
1906,0.1908,35,103,35,515732,160712,46202,80054,1.2729058420985933,0.33249711337979615
1907,0.1909,27,120,27,515852,160592,46229,80027,1.2719553922189837,0.3325880333639488
1908,0.191,28,110,28,515962,160482,46257,79999,1.271084146496008,0.3326624556617779
1909,0.1911,26,130,26,516092,160352,46283,79973,1.2700544924597643,0.3327702070113388
1910,0.1912,26,140,26,516232,160212,46309,79947,1.2689456342668863,0.3328919590771114
1911,0.1913,33,109,33,516341,160103,46342,79914,1.2680823089595743,0.33295141594137084
1912,0.1914,31,122,31,516463,159981,46373,79883,1.2671160182486376,0.33303455291331757
1913,0.1915,33,128,33,516591,159853,46406,79850,1.2661022050437207,0.3331205700387563
1914,0.1916,28,115,28,516706,159738,46434,79822,1.265191357242428,0.3332025379863082
1915,0.1917,26,128,26,516834,159610,46460,79796,1.2641775440375111,0.3333082713048127
1916,0.1918,36,129,36,516963,159481,46496,79760,1.2631558104169307,0.33338767184554485
1917,0.1919,27,124,27,517087,159357,46523,79733,1.2621736788746674,0.3334852984231879
1918,0.192,27,134,27,517221,159223,46550,79706,1.2611123431757698,0.3335970099904156
1919,0.1921,42,121,42,517342,159102,46592,79664,1.2601539728804967,0.33364884447534404
1920,0.1922,27,129,27,517471,158973,46619,79637,1.2591322392599165,0.3337538242320104
1921,0.1923,37,120,37,517591,158853,46656,79600,1.2581817893803067,0.3338184044654502
1922,0.1924,40,132,40,517723,158721,46696,79560,1.257136294512736,0.3338914978533748
1923,0.1925,20,127,20,517850,158594,46716,79540,1.2561304017234824,0.3340136225822436
1924,0.1926,22,143,22,517993,158451,46738,79518,1.2549977822836142,0.3341527677974862
1925,0.1927,22,119,22,518112,158332,46760,79496,1.254055252819668,0.3342583715962797
1926,0.1928,32,114,32,518226,158218,46792,79464,1.2531523254340389,0.3343290615191727
1927,0.1929,26,134,26,518360,158084,46818,79438,1.2520909897351413,0.33444480932292586
1928,0.193,35,124,35,518484,157960,46853,79403,1.251108858192878,0.3345213870738068
1929,0.1931,26,137,26,518621,157823,46879,79377,1.2500237612469902,0.334641652613828
1930,0.1932,26,121,26,518742,157702,46905,79351,1.249065390951717,0.3347394886375621
1931,0.1933,28,138,28,518880,157564,46933,79323,1.247972373590166,0.33485585954484626
1932,0.1934,23,116,23,518996,157448,46956,79300,1.24705360537321,0.3349553111325122
1933,0.1935,40,135,40,519131,157313,46996,79260,1.245984349258649,0.33503400641662406
1934,0.1936,36,128,36,519259,157185,47032,79224,1.2449705360537322,0.33511414540055584
1935,0.1937,24,132,24,519391,157053,47056,79200,1.2439250411861615,0.33523383830046605
1936,0.1938,27,135,27,519526,156918,47083,79173,1.2428557850716007,0.3353495050637254
1937,0.1939,41,136,41,519662,156782,47124,79132,1.2417786085413762,0.3354273167340641
1938,0.194,22,104,22,519766,156678,47146,79110,1.2409548853123813,0.3355132576721462
1939,0.1941,30,111,30,519877,156567,47176,79080,1.2400757191737422,0.3355867038409146
1940,0.1942,25,112,25,519989,156455,47201,79055,1.23918863261944,0.33567576748333405
1941,0.1943,25,127,25,520116,156328,47226,79030,1.2381827398301863,0.3357863340103162
1942,0.1944,14,126,14,520242,156202,47240,79016,1.2371847674565961,0.3359266722784821
1943,0.1945,30,130,30,520372,156072,47270,78986,1.2361551134203523,0.3360277038007641
1944,0.1946,24,131,24,520503,155941,47294,78962,1.235117538968445,0.3361472607842386
1945,0.1947,29,128,29,520631,155813,47323,78933,1.2341037257635281,0.33624854097620405
1946,0.1948,22,122,22,520753,155691,47345,78911,1.2331374350525917,0.33636115634137814
1947,0.1949,23,106,23,520859,155585,47368,78888,1.2322978709922696,0.33644811982616335
1948,0.195,23,136,23,520995,155449,47391,78865,1.2312206944620454,0.3365782667702314
1949,0.1951,30,112,30,521107,155337,47421,78835,1.230333607907743,0.33665425413798405
1950,0.1952,25,127,25,521234,155210,47446,78810,1.2293277151184894,0.3367660883685155
1951,0.1953,25,134,25,521368,155076,47471,78785,1.228266379419592,0.33688815150880225
1952,0.1954,29,123,29,521491,154953,47500,78756,1.227292168292992,0.33698317137979283
1953,0.1955,29,130,29,521621,154823,47529,78727,1.2262625142567483,0.33708841789766647
1954,0.1956,33,114,33,521735,154709,47562,78694,1.225359586871119,0.3371593338560344
1955,0.1957,20,143,20,521878,154566,47582,78674,1.2242269674312507,0.33730920939804493
1956,0.1958,21,126,21,522004,154440,47603,78653,1.2232289950576607,0.337431840510011
1957,0.1959,29,118,29,522122,154322,47632,78624,1.2222943860093778,0.3375202836708937
1958,0.196,24,120,24,522242,154202,47656,78600,1.221343936129768,0.33762596541266826
1959,0.1961,39,133,39,522375,154069,47695,78561,1.220290520846534,0.3377079482439926
1960,0.1962,23,118,23,522493,153951,47718,78538,1.219355911798251,0.3378138320522691
1961,0.1963,22,103,22,522596,153848,47740,78516,1.2185401089849195,0.33790087965433546
1962,0.1964,31,99,31,522695,153749,47771,78485,1.2177559878342414,0.3379565438307914
1963,0.1965,28,116,28,522811,153633,47799,78457,1.2168372196172854,0.33804558576414323
1964,0.1966,32,124,32,522935,153509,47831,78425,1.215855088075022,0.3381349866772444
1965,0.1967,28,96,28,523031,153413,47859,78397,1.2150947281713345,0.33819507355161554
1966,0.1968,29,111,29,523142,153302,47888,78368,1.2142155620326955,0.3382742694349722
1967,0.1969,28,131,28,523273,153171,47916,78340,1.2131779875807882,0.3383856490620316
1968,0.197,27,132,27,523405,153039,47943,78313,1.2121324927132175,0.3385015042013901
1969,0.1971,25,125,25,523530,152914,47968,78288,1.2111424407552909,0.33861298777692234
1970,0.1972,29,120,29,523650,152794,47997,78259,1.210191990875681,0.33870583805447235
1971,0.1973,27,114,27,523764,152680,48024,78232,1.209289063490052,0.3387957317073171
1972,0.1974,36,146,36,523910,152534,48060,78196,1.2081326828031935,0.3389069475144108
1973,0.1975,23,115,23,524025,152419,48083,78173,1.2072218350019008,0.33901002636691646
1974,0.1976,30,113,30,524138,152306,48113,78143,1.206326828031935,0.33909021084925517
1975,0.1977,20,110,20,524248,152196,48133,78123,1.2054555823089597,0.3391947689943079
1976,0.1978,23,107,23,524355,152089,48156,78100,1.2046080978329743,0.3392864124697531
1977,0.1979,22,123,22,524478,151966,48178,78078,1.2036338867063743,0.339404635634922
1978,0.198,35,106,35,524584,151860,48213,78043,1.2027943226460525,0.3394605551036742
1979,0.1981,26,128,26,524712,151732,48239,78017,1.2017805094411356,0.339574927420794
1980,0.1982,25,108,25,524820,151624,48264,77992,1.2009251045494869,0.3396627412723852
1981,0.1983,33,123,33,524943,151501,48297,77959,1.1999508934228869,0.33974984746796827
1982,0.1984,27,124,27,525067,151377,48324,77932,1.1989687618806235,0.33985582772590694
1983,0.1985,35,135,35,525202,151242,48359,77897,1.1978995057660626,0.3399552236851867
1984,0.1986,24,100,24,525302,151142,48383,77873,1.1971074641997212,0.34003449555705956
1985,0.1987,22,110,22,525412,151032,48405,77851,1.1962362184767457,0.3401344791880568
1986,0.1988,22,137,22,525549,150895,48427,77829,1.195151121530858,0.34027474160997534
1987,0.1989,27,112,27,525661,150783,48454,77802,1.1942640349765556,0.3403635409147582
1988,0.199,42,110,42,525771,150673,48496,77760,1.19339278925358,0.34040615847972927
1989,0.1991,27,113,27,525884,150560,48523,77733,1.1924977822836142,0.34049664247261197
1990,0.1992,27,120,27,526004,150440,48550,77706,1.1915473324040045,0.3405976874457584
1991,0.1993,22,116,22,526120,150324,48572,77684,1.1906285641870484,0.34070734360197885
1992,0.1994,33,112,33,526232,150212,48605,77651,1.1897414776327462,0.3407793279295015
1993,0.1995,29,109,29,526341,150103,48634,77622,1.1888781523254341,0.3408584916017126
1994,0.1996,25,127,25,526468,149976,48659,77597,1.1878722595361804,0.34097630210965274
1995,0.1997,30,117,30,526585,149859,48689,77567,1.186945570903561,0.3410647859083834
1996,0.1998,22,104,22,526689,149755,48711,77545,1.1861218476745659,0.3411570611526617
1997,0.1999,25,110,25,526799,149645,48736,77520,1.1852506019515905,0.3412497523826294
1998,0.2,34,103,34,526902,149542,48770,77486,1.1844347991382587,0.3413059182127315
1999,0.2001,29,124,29,527026,149418,48799,77457,1.1834526675959955,0.3414082644628099
2000,0.2002,42,108,42,527134,149310,48841,77415,1.1825972627043466,0.34144889182930865
2001,0.2003,26,133,26,527267,149177,48867,77389,1.1815438474211126,0.34157375775712157
2002,0.2004,20,113,20,527380,149064,48887,77369,1.1806488404511468,0.34168606166062365
2003,0.2005,32,118,32,527498,148946,48919,77337,1.1797142314028641,0.3417711449821684
2004,0.2006,22,101,22,527599,148845,48941,77315,1.1789142694208592,0.3418597453130527
2005,0.2007,20,122,20,527721,148723,48961,77295,1.1779479787099227,0.3419860365103664
2006,0.2008,37,91,37,527812,148632,48998,77258,1.177227220884552,0.34201602549913673
2007,0.2009,25,122,25,527934,148510,49023,77233,1.1762609301736155,0.3421279951094829
2008,0.201,33,103,33,528037,148407,49056,77200,1.175445127360284,0.34218796402593893
2009,0.2011,21,132,21,528169,148275,49077,77179,1.1743996324927133,0.3423270378879949
2010,0.2012,26,108,26,528277,148167,49103,77153,1.1735442276010646,0.342415231670513
2011,0.2013,28,132,28,528409,148035,49131,77125,1.172498732733494,0.3425341979037129
2012,0.2014,26,119,26,528528,147916,49157,77099,1.1715562032695477,0.34263937959691576
2013,0.2015,38,113,38,528641,147803,49195,77061,1.1706611962995819,0.34270047673260284
2014,0.2016,34,119,34,528760,147684,49229,77027,1.1697186668356356,0.34278250730938853
2015,0.2017,26,102,26,528862,147582,49255,77001,1.1689107844379674,0.3428621044335502
2016,0.2018,27,117,27,528979,147465,49282,76974,1.1679840958053478,0.34296178471655997
2017,0.2019,20,102,20,529081,147363,49302,76954,1.1671762134076797,0.3430591528952331
2018,0.202,30,123,30,529204,147240,49332,76924,1.1662020022810797,0.3431594725290412
2019,0.2021,27,130,27,529334,147110,49359,76897,1.165172348244836,0.34327945108858204
2020,0.2022,30,100,30,529434,147010,49389,76867,1.1643803066784946,0.34334478307284805
2021,0.2023,24,111,24,529545,146899,49413,76843,1.1635011405398554,0.343444681821026
2022,0.2024,31,112,31,529657,146787,49444,76812,1.1626140539855532,0.3435256866086163
2023,0.2025,23,105,23,529762,146682,49467,76789,1.1617824103408947,0.3436195300508791
2024,0.2026,28,119,28,529881,146563,49495,76761,1.1608398808769484,0.34372033458114665
2025,0.2027,18,119,18,530000,146444,49513,76743,1.1598973514130022,0.3438506723061827
2026,0.2028,26,104,26,530104,146340,49539,76717,1.159073628184007,0.34393451001313563
2027,0.2029,28,113,28,530217,146227,49567,76689,1.1581786212140412,0.34402644942489546
2028,0.203,26,111,26,530328,146116,49593,76663,1.1572994550754023,0.34412130407264596
2029,0.2031,29,121,29,530449,145995,49622,76634,1.1563410847801292,0.34422289998158373
2030,0.2032,27,114,27,530563,145881,49649,76607,1.1554381573945,0.3443196936463989
2031,0.2033,30,122,30,530685,145759,49679,76577,1.1544718666835636,0.3444201568796776
2032,0.2034,22,110,22,530795,145649,49701,76555,1.153600620960588,0.34452575111159117
2033,0.2035,29,117,29,530912,145532,49730,76526,1.1526739323279687,0.344621675418134
2034,0.2036,30,96,30,531008,145436,49760,76496,1.1519135724242808,0.34468215489429194
2035,0.2037,23,116,23,531124,145320,49783,76473,1.1509948042073248,0.344794470519809
2036,0.2038,25,113,25,531237,145207,49808,76448,1.150099797237359,0.34489634792808643
2037,0.2039,42,126,42,531363,145081,49850,76406,1.1491018248637688,0.34496832771223596
2038,0.204,24,106,24,531469,144975,49874,76382,1.148262260803447,0.345062500847048
2039,0.2041,35,104,35,531573,144871,49909,76347,1.1474385375744518,0.345121102261118
2040,0.2042,18,109,18,531682,144762,49927,76329,1.1465752122671398,0.3452379337015075
2041,0.2043,24,125,24,531807,144637,49951,76305,1.145585160309213,0.3453621312380625
2042,0.2044,24,94,24,531901,144543,49975,76281,1.1448406412368521,0.3454379958700141
2043,0.2045,32,140,32,532041,144403,50007,76249,1.1437317830439742,0.34556224280767905
2044,0.2046,27,99,27,532140,144304,50034,76222,1.142947661893296,0.34563724912255245
2045,0.2047,26,114,26,532254,144190,50060,76196,1.142044734507667,0.34573884003521094
2046,0.2048,31,102,31,532356,144088,50091,76165,1.1412368521099987,0.3458068675568551
2047,0.2049,26,123,26,532479,143965,50117,76139,1.140262640983399,0.34592283647730165
2048,0.205,19,110,19,532589,143855,50136,76120,1.1393913952604233,0.3460393226503012
2049,0.2051,25,116,25,532705,143739,50161,76095,1.1384726270434673,0.346147547695079
2050,0.2052,32,111,32,532816,143628,50193,76063,1.1375934609048284,0.3462272009322184
2051,0.2053,28,126,28,532942,143502,50221,76035,1.1365954885312382,0.3463425299607811
2052,0.2054,25,90,25,533032,143412,50246,76010,1.1358826511215308,0.3464101138445552
2053,0.2055,24,126,24,533158,143286,50270,75986,1.1348846787479407,0.3465376336239921
2054,0.2056,38,114,38,533272,143172,50308,75948,1.1339817513623114,0.34660460021905803
2055,0.2057,35,109,35,533381,143063,50343,75913,1.1331184260549994,0.34667269472453605
2056,0.2058,24,121,24,533502,142942,50367,75889,1.1321600557597262,0.34679273046323417
2057,0.2059,32,119,32,533621,142823,50399,75857,1.13121752629578,0.346885860618255
2058,0.206,31,93,31,533714,142730,50430,75826,1.1304809276390826,0.34694082981020885
2059,0.2061,35,111,35,533825,142619,50465,75791,1.1296017615004434,0.34701249942768186
2060,0.2062,34,123,34,533948,142496,50499,75757,1.1286275503738437,0.3471063398899442
2061,0.2063,25,106,25,534054,142390,50524,75732,1.1277879863135218,0.34720019071895547
2062,0.2064,39,90,39,534144,142300,50563,75693,1.1270751489038144,0.34722674581293894
2063,0.2065,34,119,34,534263,142181,50597,75659,1.1261326194398682,0.34731454278369445
2064,0.2066,24,99,24,534362,142082,50621,75635,1.1253484982891901,0.34740052453414294
2065,0.2067,25,115,25,534477,141967,50646,75610,1.1244376504878977,0.3475091576775119
2066,0.2068,28,122,28,534599,141845,50674,75582,1.123471359776961,0.34762012077616855
2067,0.2069,24,112,24,534711,141733,50698,75558,1.1225842732226587,0.3477272413491585
2068,0.207,19,106,19,534817,141627,50717,75539,1.121744709162337,0.34783990127368003
2069,0.2071,20,104,20,534921,141523,50737,75519,1.1209209859333418,0.3479464804047143
2070,0.2072,26,105,26,535026,141418,50763,75493,1.1200893422886833,0.3480367524007542
2071,0.2073,20,106,20,535132,141312,50783,75473,1.1192497782283615,0.34814678137325
2072,0.2074,28,104,28,535236,141208,50811,75445,1.1184260549993663,0.3482296575630155
2073,0.2075,28,116,28,535352,141092,50839,75417,1.1175072867824103,0.3483319400117316
2074,0.2076,28,127,28,535479,140965,50867,75389,1.1165013939931567,0.3484520739158971
2075,0.2077,32,100,32,535579,140865,50899,75357,1.1157093524268153,0.3485168021755418
2076,0.2078,27,126,27,535705,140739,50926,75330,1.1147113800532251,0.34863862932674283
2077,0.2079,24,105,24,535810,140634,50950,75306,1.1138797364085666,0.3487357599333148
2078,0.208,34,86,34,535896,140548,50984,75272,1.1131985806615132,0.3487721249189139
2079,0.2081,23,125,23,536021,140423,51007,75249,1.1122085287035863,0.3489048184279832
2080,0.2082,23,114,23,536135,140309,51030,75226,1.1113056013179572,0.3490198807618252
2081,0.2083,36,105,36,536240,140204,51066,75190,1.1104739576732987,0.34908121860404656
2082,0.2084,37,104,37,536344,140100,51103,75153,1.1096502344443036,0.34913799110813787
2083,0.2085,19,118,19,536462,139982,51122,75134,1.1087156253960209,0.349272020677216
2084,0.2086,31,124,31,536586,139858,51153,75103,1.1077334938537575,0.34937965491414724
2085,0.2087,36,107,36,536693,139751,51189,75067,1.1068860093777722,0.34944464616559134
2086,0.2088,26,99,26,536792,139652,51215,75041,1.106101888227094,0.3495269990172013
2087,0.2089,28,95,28,536887,139557,51243,75013,1.1053494487390698,0.3495968681549145
2088,0.209,23,126,23,537013,139431,51266,74990,1.1043514763654796,0.34973253552590466
2089,0.2091,25,109,25,537122,139322,51291,74965,1.1034881510581676,0.3498345676592607
2090,0.2092,29,107,29,537229,139215,51320,74936,1.1026406665821822,0.34992131720141395
2091,0.2093,29,108,29,537337,139107,51349,74907,1.1017852616905335,0.35000981244217666
2092,0.2094,33,101,33,537438,139006,51382,74874,1.1009852997085288,0.35007480830372173
2093,0.2095,30,129,30,537567,138877,51412,74844,1.0999635660879483,0.35019488024106193
2094,0.2096,23,99,23,537666,138778,51435,74821,1.0991794449372703,0.3502872204457886
2095,0.2097,22,108,22,537774,138670,51457,74799,1.0983240400456216,0.350397481601544
2096,0.2098,25,115,25,537889,138555,51482,74774,1.0974131922443289,0.3505102447393463
2097,0.2099,40,115,40,538004,138440,51522,74734,1.0965023444430364,0.3505774625423363
2098,0.21,34,91,34,538095,138349,51556,74700,1.0957815866176657,0.3506235654708541
2099,0.2101,15,105,15,538200,138244,51571,74685,1.0949499429730072,0.3507507197234759
2100,0.2102,29,116,29,538316,138128,51600,74656,1.0940311747560512,0.3508534476276412
2101,0.2103,28,99,28,538415,138029,51628,74628,1.093247053605373,0.35093131192483673
2102,0.2104,26,119,26,538534,137910,51654,74602,1.0923045241414269,0.35104841138382775
2103,0.2105,29,101,29,538635,137809,51683,74573,1.0915045621594222,0.3511267433209971
2104,0.2106,25,112,25,538747,137697,51708,74548,1.0906174756051197,0.35123560036749985
2105,0.2107,27,115,27,538862,137582,51735,74521,1.0897066278038272,0.3513434510591552
2106,0.2108,38,89,38,538951,137493,51773,74483,1.0890017108097834,0.35137468392648225
2107,0.2109,21,110,21,539061,137383,51794,74462,1.0881304650868078,0.35149283674384574
2108,0.211,29,111,29,539172,137272,51823,74433,1.0872512989481689,0.35158829503318295
2109,0.2111,25,113,25,539285,137159,51848,74408,1.086356291978203,0.35169946163626653
2110,0.2112,27,117,27,539402,137042,51875,74381,1.0854296033455835,0.3518112977301429
2111,0.2113,29,113,29,539515,136929,51904,74352,1.0845345963756179,0.3519104888750053
2112,0.2114,28,131,28,539646,136798,51932,74324,1.0834970219237106,0.35204289462964544
2113,0.2115,34,109,34,539755,136689,51966,74290,1.0826336966163985,0.3521203532105091
2114,0.2116,22,102,22,539857,136587,51988,74268,1.0818258142187303,0.35222309169808635
2115,0.2117,27,102,27,539959,136485,52015,74241,1.081017931821062,0.35231058341163407
2116,0.2118,23,110,23,540069,136375,52038,74218,1.0801466860980864,0.3524238697392601
2117,0.2119,32,111,32,540180,136264,52070,74186,1.0792675199594475,0.35251128534093606
2118,0.212,30,112,30,540292,136152,52100,74156,1.078380433405145,0.3526066530992639
2119,0.2121,20,102,20,540394,136050,52120,74136,1.077572551007477,0.3527161656818247
2120,0.2122,28,95,28,540489,135955,52148,74108,1.0768201115194524,0.35278940127485564
2121,0.2123,18,108,18,540597,135847,52166,74090,1.0759647066278037,0.3529153984290525
2122,0.2124,25,100,25,540697,135747,52191,74065,1.0751726650614624,0.3530065010580901
2123,0.2125,33,107,33,540804,135640,52224,74032,1.0743251805854772,0.35308481819222404
2124,0.2126,30,98,30,540902,135542,52254,74002,1.0735489798504625,0.35315733211163286
2125,0.2127,22,115,22,541017,135427,52276,73980,1.07263813204917,0.3532833190867545
2126,0.2128,25,107,25,541124,135320,52301,73955,1.0717906475731847,0.35338669215147533
2127,0.2129,36,109,36,541233,135211,52337,73919,1.0709273222658726,0.3534595706020179
2128,0.213,31,96,31,541329,135115,52368,73888,1.0701669623621848,0.35352602594221133
2129,0.2131,30,91,30,541420,135024,52398,73858,1.069446204536814,0.35358719276912326
2130,0.2132,23,93,23,541513,134931,52421,73835,1.0687096058801167,0.3536734908941111
2131,0.2133,23,95,23,541608,134836,52444,73812,1.0679571663920921,0.3537632759480081
2132,0.2134,25,116,25,541724,134720,52469,73787,1.0670383981751361,0.35388260346175426
2133,0.2135,30,113,30,541837,134607,52499,73757,1.0661433912051705,0.3539814939240944
2134,0.2136,30,104,30,541941,134503,52529,73727,1.0653196679761754,0.35406521634730825
2135,0.2137,29,108,29,542049,134395,52558,73698,1.0644642630845267,0.3541589577736877
2136,0.2138,19,91,19,542140,134304,52577,73679,1.063743505259156,0.3542549150651736
2137,0.2139,32,102,32,542242,134202,52609,73647,1.0629356228614877,0.3543293448609327
2138,0.214,24,90,24,542332,134112,52633,73623,1.0622227854517805,0.3544082605242256
2139,0.2141,20,109,20,542441,134003,52653,73603,1.0613594601444685,0.35453214261630206
2140,0.2142,25,77,25,542518,133926,52678,73578,1.0607495881383855,0.35458593569280594
2141,0.2143,26,114,26,542632,133812,52704,73552,1.0598466607527564,0.35469994791767134
2142,0.2144,32,108,32,542740,133704,52736,73520,1.0589912558611076,0.3547851600200749
2143,0.2145,29,104,29,542844,133600,52765,73491,1.0581675326321125,0.3548729785456635
2144,0.2146,39,96,39,542940,133504,52804,73452,1.0574071727284249,0.3549160207966911
2145,0.2147,30,104,30,543044,133400,52834,73422,1.0565834494994297,0.35500091866435873
2146,0.2148,30,90,30,543134,133310,52864,73392,1.0558706120897225,0.3550618765178857
2147,0.2149,26,118,26,543252,133192,52890,73366,1.0549360030414396,0.35518353198617336
2148,0.215,25,95,25,543347,133097,52915,73341,1.0541835635534154,0.3552688942927174
2149,0.2151,27,78,27,543425,133019,52942,73314,1.053565771131669,0.3553188292711297
2150,0.2152,21,108,21,543533,132911,52963,73293,1.0527103662400203,0.35543927372892864
2151,0.2153,32,108,32,543641,132803,52995,73261,1.0518549613483716,0.3555254678158242
2152,0.2154,25,106,25,543747,132697,53020,73236,1.0510153972880496,0.355630229249319
2153,0.2155,26,105,26,543852,132592,53046,73210,1.0501837536433911,0.35573026501200183
2154,0.2156,26,100,26,543952,132492,53072,73184,1.0493917120770497,0.35582177794200587
2155,0.2157,28,91,28,544043,132401,53100,73156,1.0486709542516792,0.35589155319449106
2156,0.2158,24,110,24,544153,132291,53124,73132,1.0477997085287036,0.3560068736217463
2157,0.2159,27,117,27,544270,132174,53151,73105,1.046873019896084,0.3561250785516297
2158,0.216,36,99,36,544369,132075,53187,73069,1.0460888987454062,0.3561839488359396
2159,0.2161,29,103,29,544472,131972,53216,73040,1.0452730959320746,0.3562718279905567
2160,0.2162,20,122,20,544594,131850,53236,73020,1.044306805221138,0.35642114511641526
2161,0.2163,25,98,25,544692,131752,53261,72995,1.0435306044861234,0.3565131601439826
2162,0.2164,29,88,29,544780,131664,53290,72966,1.042833607907743,0.3565752822166838
2163,0.2165,28,104,28,544884,131560,53318,72938,1.042009884678748,0.3566685248755489
2164,0.2166,24,77,24,544961,131483,53342,72914,1.041400012672665,0.35672734922723914
2165,0.2167,29,90,29,545051,131393,53371,72885,1.0406871752629578,0.35679319358912853
2166,0.2168,33,86,33,545137,131307,53404,72852,1.0400060195159042,0.3568395221371578
2167,0.2169,35,111,35,545248,131196,53439,72817,1.0391268533772653,0.3569233333169945
2168,0.217,26,115,26,545363,131081,53465,72791,1.0382160055759726,0.35704265421440906
2169,0.2171,19,109,19,545472,130972,53484,72772,1.0373526802686606,0.35717370818281763
2170,0.2172,13,100,13,545572,130872,53497,72759,1.0365606387023192,0.3573080719536809
2171,0.2173,30,122,30,545694,130750,53527,72729,1.0355943479913825,0.35742754780591607
2172,0.2174,31,114,31,545808,130636,53558,72698,1.0346914206057534,0.35752997531155634
2173,0.2175,27,101,27,545909,130535,53585,72671,1.0338914586237486,0.35762231430174307
2174,0.2176,28,103,28,546012,130432,53613,72643,1.0330756558104168,0.35771512987812387
2175,0.2177,21,90,21,546102,130342,53634,72622,1.0323628184007096,0.35780729587513055
2176,0.2178,28,116,28,546218,130226,53662,72594,1.0314440501837536,0.35792328172764026
2177,0.2179,26,92,26,546310,130134,53688,72568,1.0307153719427196,0.35800337441169794
2178,0.218,28,105,28,546415,130029,53716,72540,1.029883728298061,0.35810020289382877
2179,0.2181,31,103,31,546518,129926,53747,72509,1.0290679254847295,0.35818410847926496
2180,0.2182,38,96,38,546614,129830,53785,72471,1.0283075655810416,0.35823352331426933
2181,0.2183,16,90,16,546704,129740,53801,72455,1.0275947281713345,0.3583421944162813
2182,0.2184,32,100,32,546804,129640,53833,72423,1.026802686604993,0.35841791916382515
2183,0.2185,31,96,31,546900,129544,53864,72392,1.0260423267013052,0.3584898185563743
2184,0.2186,28,106,28,547006,129438,53892,72364,1.0252027626409834,0.3585891120999792
2185,0.2187,22,101,22,547107,129337,53914,72342,1.0244028006589785,0.3586987242102549
2186,0.2188,22,88,22,547195,129249,53936,72320,1.0237058040805982,0.3587853290932633
2187,0.2189,39,91,39,547286,129158,53975,72281,1.0229850462552275,0.3588232665968358
2188,0.219,25,122,25,547408,129036,54000,72256,1.022018755544291,0.35896111122150903
2189,0.2191,26,107,26,547515,128929,54026,72230,1.0211712710683056,0.35906919402065035
2190,0.2192,23,106,23,547621,128823,54049,72207,1.0203317070079838,0.35918519623936723
2191,0.2193,20,109,20,547730,128714,54069,72187,1.0194683817006716,0.3593162801578887
2192,0.2194,23,111,23,547841,128603,54092,72164,1.0185892155620326,0.35944154168762793
2193,0.2195,29,95,29,547936,128508,54121,72135,1.0178367760740084,0.3595191459457843
2194,0.2196,21,90,21,548026,128418,54142,72114,1.0171239386643012,0.35961342828077314
2195,0.2197,25,110,25,548136,128308,54167,72089,1.0162526929413256,0.3597309340958198
2196,0.2198,24,93,24,548229,128215,54191,72065,1.015516094284628,0.3598212502496505
2197,0.2199,25,101,25,548330,128114,54216,72040,1.0147161323026233,0.35992285939826335
2198,0.22,36,108,36,548438,128006,54252,72004,1.0138607274109745,0.360001999900005
2199,0.2201,37,90,37,548528,127916,54289,71967,1.0131478900012674,0.3600456266916146
2200,0.2202,29,107,29,548635,127809,54318,71938,1.012300405525282,0.3601455841639674
2201,0.2203,31,103,31,548738,127706,54349,71907,1.0114846027119504,0.36023204901484374
2202,0.2204,33,88,33,548826,127618,54382,71874,1.0107876061335699,0.3602851242155074
2203,0.2205,33,107,33,548933,127511,54415,71841,1.0099401216575845,0.3603726072474818
2204,0.2206,30,100,30,549033,127411,54445,71811,1.0091480800912431,0.36045717842406966
2205,0.2207,32,100,32,549133,127311,54477,71779,1.0083560385249017,0.36053543623486867
2206,0.2208,30,103,30,549236,127208,54507,71749,1.0075402357115701,0.36062566283166714
2207,0.2209,22,85,22,549321,127123,54529,71727,1.0068670003801798,0.36070907719386475
2208,0.221,25,91,25,549412,127032,54554,71702,1.0061462425548093,0.360793824911691
2209,0.2211,23,99,23,549511,126933,54577,71679,1.0053621214041313,0.36089964352607096
2210,0.2212,26,97,26,549608,126836,54603,71653,1.0045938410847801,0.3609922968023417
2211,0.2213,27,105,27,549713,126731,54630,71626,1.0037621974401216,0.36109640698336837
2212,0.2214,25,85,25,549798,126646,54655,71601,1.0030889621087316,0.3611706608422826
2213,0.2215,23,94,23,549892,126552,54678,71578,1.0023444430363706,0.3612678544390047
2214,0.2216,39,94,39,549986,126458,54717,71539,1.0015999239640097,0.3613135552558877
2215,0.2217,36,87,36,550073,126371,54753,71503,1.0009108478012927,0.3613562165822695
2216,0.2218,17,120,17,550193,126251,54770,71486,0.9999603979216829,0.3615206056529633
2217,0.2219,19,114,19,550307,126137,54789,71467,0.9990574705360538,0.3616677800044534
2218,0.222,26,94,26,550401,126043,54815,71441,0.9983129514636928,0.36175588908468537
2219,0.2221,29,89,29,550490,125954,54844,71412,0.997608034469649,0.3618252383895909
2220,0.2222,34,78,34,550568,125876,54878,71378,0.9969902420479027,0.36185831466028573
2221,0.2223,21,108,21,550676,125768,54899,71357,0.996134837156254,0.36198858592263794
2222,0.2224,30,84,30,550760,125684,54929,71327,0.9954695222405272,0.3620457740938323
2223,0.2225,26,81,26,550841,125603,54955,71301,0.9948279685717907,0.3621104700767887
2224,0.2226,31,116,31,550957,125487,54986,71270,0.9939092003548347,0.36222345329518135
2225,0.2227,32,97,32,551054,125390,55018,71238,0.9931409200354835,0.362298350184104
2226,0.2228,34,124,34,551178,125266,55052,71204,0.9921587884932201,0.36241665394207767
2227,0.2229,29,104,29,551282,125162,55081,71175,0.9913350652642251,0.36251445219189454
2228,0.223,16,98,16,551380,125064,55097,71159,0.9905588645292105,0.3626435229305433
2229,0.2231,33,92,33,551472,124972,55130,71126,0.9898301862881764,0.36270640190109027
2230,0.2232,33,93,33,551565,124879,55163,71093,0.9890935876314789,0.3627712122139898
2231,0.2233,25,98,25,551663,124781,55188,71068,0.9883173868964643,0.3628713958202493
2232,0.2234,26,86,26,551749,124695,55214,71042,0.9876362311494107,0.3629461982149517
2233,0.2235,23,101,23,551850,124594,55237,71019,0.9868362691674059,0.36305869241819305
2234,0.2236,33,75,33,551925,124519,55270,70986,0.9862422379926499,0.3630904580445513
2235,0.2237,25,104,25,552029,124415,55295,70961,0.9854185147636548,0.36320223568913274
2236,0.2238,36,97,36,552126,124318,55331,70925,0.9846502344443037,0.3632652643116527
2237,0.2239,19,89,19,552215,124229,55350,70906,0.9839453174502598,0.3633689497014887
2238,0.224,30,104,30,552319,124125,55380,70876,0.9831215942212648,0.3634648027446013
2239,0.2241,22,107,22,552426,124018,55402,70854,0.9822741097452794,0.3635925120078821
2240,0.2242,26,83,26,552509,123935,55428,70828,0.9816167152452161,0.3636625026314033
2241,0.2243,20,98,20,552607,123837,55448,70808,0.9808405145102015,0.36378021526368515
2242,0.2244,27,112,27,552719,123725,55475,70781,0.9799534279558991,0.3639013706518051
2243,0.2245,26,99,26,552818,123626,55501,70755,0.9791693068052212,0.36400162567329114
2244,0.2246,41,82,41,552900,123544,55542,70714,0.9785198327208212,0.36402104417836073
2245,0.2247,28,107,28,553007,123437,55570,70686,0.9776723482448358,0.36412995884052896
2246,0.2248,33,94,33,553101,123343,55603,70653,0.976927829172475,0.3641982308913586
2247,0.2249,19,102,19,553203,123241,55622,70634,0.9761199467748067,0.36432753062540296
2248,0.225,34,90,34,553293,123151,55656,70600,0.9754071093650994,0.36438521607630414
2249,0.2251,29,80,29,553373,123071,55685,70571,0.9747734761120264,0.3644405655797813
2250,0.2252,27,88,27,553461,122983,55712,70544,0.974076479533646,0.36451761252951786
2251,0.2253,24,88,24,553549,122895,55736,70520,0.9733794829552654,0.3646046066747667
2252,0.2254,41,111,41,553660,122784,55777,70479,0.9725003168166265,0.36467921950916626
2253,0.2255,22,87,22,553747,122697,55799,70457,0.9718112406539096,0.36477111527589384
2254,0.2256,27,79,27,553826,122618,55826,70430,0.9711855278164998,0.36483154448634536
2255,0.2257,22,97,22,553923,122521,55848,70408,0.9704172474971486,0.3649425436300401
2256,0.2258,22,100,22,554023,122421,55870,70386,0.9696252059308073,0.36505935987801275
2257,0.2259,26,84,26,554107,122337,55896,70360,0.9689598910150805,0.36513282510884965
2258,0.226,31,90,31,554197,122247,55927,70329,0.9682470536053732,0.3652012711864407
2259,0.2261,18,94,18,554291,122153,55945,70311,0.9675025345330123,0.36532026768642445
2260,0.2262,18,103,18,554394,122050,55963,70293,0.9666867317196807,0.36545650218619863
2261,0.2263,28,94,28,554488,121956,55991,70265,0.9659422126473197,0.3655427866882391
2262,0.2264,26,100,26,554588,121856,56017,70239,0.9651501710809783,0.36564720580962545
2263,0.2265,25,77,25,554665,121779,56042,70214,0.9645402990748955,0.36571124988931886
2264,0.2266,21,93,21,554758,121686,56063,70193,0.963803700418198,0.365819083901834
2265,0.2267,29,76,29,554834,121610,56092,70164,0.9632017488277785,0.3658681573101672
2266,0.2268,31,92,31,554926,121518,56123,70133,0.9624730705867444,0.36594121606461744
2267,0.2269,24,86,24,555012,121432,56147,70109,0.9617919148396908,0.366026072746827
2268,0.227,16,87,16,555099,121345,56163,70093,0.9611028386769738,0.3661394289534993
2269,0.2271,21,83,21,555182,121262,56184,70072,0.9604454441769104,0.36622868909864426
2270,0.2272,20,102,20,555284,121160,56204,70052,0.9596375617792422,0.36635775997322345
2271,0.2273,23,82,23,555366,121078,56227,70029,0.9589880876948422,0.36643869664638135
2272,0.2274,29,86,29,555452,120992,56256,70000,0.9583069319477886,0.3665074976962386
2273,0.2275,24,106,24,555558,120886,56280,69976,0.9574673678874668,0.36663138812335616
2274,0.2276,24,103,24,555661,120783,56304,69952,0.9566515650741351,0.3667496788738302
2275,0.2277,16,109,16,555770,120674,56320,69936,0.9557882397668229,0.3669062483605267
2276,0.2278,30,88,30,555858,120586,56350,69906,0.9550912431884425,0.36697604098859793
2277,0.2279,31,83,31,555941,120503,56381,69875,0.9544338486883792,0.36703295548855436
2278,0.228,23,94,23,556035,120409,56404,69852,0.9536893296160183,0.3671377739000636
2279,0.2281,22,98,22,556133,120311,56426,69830,0.9529131288810037,0.36725377483025756
2280,0.2282,23,96,23,556229,120215,56449,69807,0.9521527689773159,0.36736272642115125
2281,0.2283,22,100,22,556329,120115,56471,69785,0.9513607274109745,0.36748288572933124
2282,0.2284,28,81,28,556410,120034,56499,69757,0.950719173742238,0.367546406310099
2283,0.2285,24,86,24,556496,119948,56523,69733,0.9500380179951844,0.36763302597518993
2284,0.2286,17,94,17,556590,119854,56540,69716,0.9492934989228234,0.3677586115946616
2285,0.2287,28,71,28,556661,119783,56568,69688,0.9487311494107211,0.3678029883201123
2286,0.2288,29,88,29,556749,119695,56597,69659,0.9480341528323406,0.36787709792240986
2287,0.2289,25,76,25,556825,119619,56622,69634,0.9474322012419212,0.3679413272180626
2288,0.229,28,81,28,556906,119538,56650,69606,0.9467906475731847,0.3680053292729349
2289,0.2291,19,89,19,556995,119449,56669,69587,0.9460857305791408,0.36811506802937005
2290,0.2292,27,97,27,557092,119352,56696,69560,0.9453174502597896,0.3682137714914881
2291,0.2293,20,96,20,557188,119256,56716,69540,0.9445570903561019,0.3683340748744677
2292,0.2294,19,109,19,557297,119147,56735,69521,0.9436937650487898,0.3684832616023915
2293,0.2295,27,87,27,557384,119060,56762,69494,0.9430046888860727,0.36856285202117167
2294,0.2296,18,102,18,557486,118958,56780,69476,0.9421968064884045,0.36870203891017544
2295,0.2297,27,93,27,557579,118865,56807,69449,0.941460207831707,0.368793610671538
2296,0.2298,29,110,29,557689,118755,56836,69420,0.9405889621087314,0.3689119170984456
2297,0.2299,19,97,19,557786,118658,56855,69401,0.9398206817893803,0.3690384400640225
2298,0.23,31,105,31,557891,118553,56886,69370,0.9389890381447218,0.36914055224746306
2299,0.2301,31,86,31,557977,118467,56917,69339,0.9383078823976683,0.3692054566946743
2300,0.2302,26,77,26,558054,118390,56943,69313,0.9376980103915854,0.36926953751405145
2301,0.2303,26,96,26,558150,118294,56969,69287,0.9369376504878976,0.3693710983521785
2302,0.2304,22,75,22,558225,118219,56991,69265,0.9363436193131416,0.3694448592946598
2303,0.2305,26,96,26,558321,118123,57017,69239,0.9355832594094539,0.3695466530032771
2304,0.2306,22,94,22,558415,118029,57039,69217,0.9348387403370929,0.3696580968351794
2305,0.2307,21,111,21,558526,117918,57060,69196,0.933959574198454,0.36980664194020757
2306,0.2308,30,96,30,558622,117822,57090,69166,0.9331992142947662,0.36989539435685714
2307,0.2309,23,104,23,558726,117718,57113,69143,0.9323754910657711,0.3700237074616961
2308,0.231,23,61,23,558787,117657,57136,69120,0.9318923457103029,0.3700669782682022
2309,0.2311,27,90,27,558877,117567,57163,69093,0.9311795083005956,0.37015429122468657
2310,0.2312,26,106,26,558983,117461,57189,69067,0.9303399442402738,0.3702768485160405
2311,0.2313,23,85,23,559068,117376,57212,69044,0.9296667089088836,0.37036798626756784
2312,0.2314,30,82,30,559150,117294,57242,69014,0.9290172348244836,0.37042961118148443
2313,0.2315,25,82,25,559232,117212,57267,68989,0.9283677607400836,0.37050821424159913
2314,0.2316,26,91,26,559323,117121,57293,68963,0.9276470029147129,0.37060144880806517
2315,0.2317,18,95,18,559418,117026,57311,68945,0.9268945634266886,0.37072984497582956
2316,0.2318,30,83,30,559501,116943,57341,68915,0.9262371689266252,0.37079383185012216
2317,0.2319,22,91,22,559592,116852,57363,68893,0.9255164111012546,0.3709009663786374
2318,0.232,27,94,27,559686,116758,57390,68866,0.9247718920288936,0.3709972848338577
2319,0.2321,33,87,33,559773,116671,57423,68833,0.9240828158661767,0.37105938416422285
2320,0.2322,17,83,17,559856,116588,57440,68816,0.9234254213661133,0.37116782809432375
2321,0.2323,29,93,29,559949,116495,57469,68787,0.9226888227094158,0.3712557075161106
2322,0.2324,30,90,30,560039,116405,57499,68757,0.9219759852997085,0.37133429105323984
2323,0.2325,28,80,28,560119,116325,57527,68729,0.9213423520466354,0.37139969954715923
2324,0.2326,26,89,26,560208,116236,57553,68703,0.9206374350525915,0.37149005888428077
2325,0.2327,37,76,37,560284,116160,57590,68666,0.9200354834621721,0.37151699436226504
2326,0.2328,25,97,25,560381,116063,57615,68641,0.919267203142821,0.3716270356895357
2327,0.2329,23,103,23,560484,115960,57638,68618,0.9184514003294892,0.3717561139464075
2328,0.233,38,84,38,560568,115876,57676,68580,0.9177860854137625,0.37179598386607104
2329,0.2331,30,97,30,560665,115779,57706,68550,0.9170178050944113,0.37188939342154514
2330,0.2332,31,85,31,560750,115694,57737,68519,0.9163445697630211,0.3719552908860938
2331,0.2333,22,79,22,560829,115615,57759,68497,0.9157188569256115,0.3720398453115495
2332,0.2334,24,97,24,560926,115518,57783,68473,0.9149505766062603,0.3721540727535586
2333,0.2335,25,88,25,561014,115430,57808,68448,0.9142535800278798,0.3722468158235352
2334,0.2336,26,87,26,561101,115343,57834,68422,0.9135645038651629,0.3723342312192202
2335,0.2337,35,82,35,561183,115261,57869,68387,0.9129150297807629,0.37238085903467505
2336,0.2338,28,98,28,561281,115163,57897,68359,0.9121388290457483,0.3724839528775842
2337,0.2339,20,80,20,561361,115083,57917,68339,0.9115051957926752,0.3725779895541429
2338,0.234,17,76,17,561437,115007,57934,68322,0.9109032442022558,0.3726742632098577
2339,0.2341,22,83,22,561520,114924,57956,68300,0.9102458497021924,0.3727677596821377
2340,0.2342,27,83,27,561603,114841,57983,68273,0.909588455202129,0.3728442391078782
2341,0.2343,23,93,23,561696,114748,58006,68250,0.9088518565454315,0.37295489568192003
2342,0.2344,36,88,36,561784,114660,58042,68214,0.908154859967051,0.37301092555530035
2343,0.2345,23,93,23,561877,114567,58065,68191,0.9074182613103535,0.373121833243962
2344,0.2346,28,102,28,561979,114465,58093,68163,0.9066103789126854,0.3732341152506735
2345,0.2347,24,91,24,562070,114374,58117,68139,0.9058896210873146,0.37333778963690256
2346,0.2348,21,78,21,562148,114296,58138,68118,0.9052718286655683,0.373425285339941
2347,0.2349,26,73,26,562221,114223,58164,68092,0.9046936383221391,0.3734854510051285
2348,0.235,32,98,32,562319,114125,58196,68060,0.9039174375871246,0.3735763097949886
2349,0.2351,27,89,27,562408,114036,58223,68033,0.9032125205930808,0.3736660277147675
2350,0.2352,32,77,32,562485,113959,58255,68001,0.9026026485869978,0.3737140030775995
2351,0.2353,28,91,28,562576,113868,58283,67973,0.9018818907616272,0.3738045875242657
2352,0.2354,25,81,25,562657,113787,58308,67948,0.9012403370928906,0.37388505241147824
2353,0.2355,26,91,26,562748,113696,58334,67922,0.9005195792675199,0.3739827550132696
2354,0.2356,22,87,22,562835,113609,58356,67900,0.899830503104803,0.37408613346996566
2355,0.2357,31,90,31,562925,113519,58387,67869,0.8991176656950957,0.3741647738549408
2356,0.2358,26,109,26,563034,113410,58413,67843,0.8982543403877835,0.3743000115860151
2357,0.2359,28,94,28,563128,113316,58441,67815,0.8975098213154227,0.3743975354853669
2358,0.236,21,80,21,563208,113236,58462,67794,0.8968761880623495,0.3744904159531569
2359,0.2361,28,71,28,563279,113165,58490,67766,0.8963138385502472,0.3745405707148029
2360,0.2362,28,95,28,563374,113070,58518,67738,0.8955613990622228,0.3746405026326269
2361,0.2363,29,86,29,563460,112984,58547,67709,0.8948802433151691,0.3747184450974858
2362,0.2364,27,90,27,563550,112894,58574,67682,0.894167405905462,0.3748117136275031
2363,0.2365,21,94,21,563644,112800,58595,67661,0.893422886833101,0.3749341963083436
2364,0.2366,24,74,24,563718,112726,58619,67637,0.8928367760740084,0.3750048513276005
2365,0.2367,15,85,15,563803,112641,58634,67622,0.8921635407426182,0.37512967164642774
2366,0.2368,27,75,27,563878,112566,58661,67595,0.8915695095678621,0.37519218920854125
2367,0.2369,20,91,20,563969,112475,58681,67575,0.8908487517424915,0.3753124132185504
2368,0.237,25,69,25,564038,112406,58706,67550,0.8903022430617159,0.37536953477516727
2369,0.2371,18,92,18,564130,112314,58724,67532,0.8895735648206818,0.37549903806590085
2370,0.2372,15,94,15,564224,112220,58739,67517,0.8888290457483209,0.3756433010454164
2371,0.2373,35,86,35,564310,112134,58774,67482,0.8881478900012673,0.37570149652592194
2372,0.2374,22,67,22,564377,112067,58796,67460,0.8876172221518185,0.3757652052337531
2373,0.2375,26,115,26,564492,111952,58822,67434,0.8867063743505259,0.3759156232927876
2374,0.2376,24,95,24,564587,111857,58846,67410,0.8859539348625016,0.37603128294666616
2375,0.2377,23,69,23,564656,111788,58869,67387,0.885407426181726,0.3760959955350914
2376,0.2378,32,94,32,564750,111694,58901,67355,0.8846629071093651,0.3761819390222788
2377,0.2379,26,73,26,564823,111621,58927,67329,0.8840847167659359,0.37624476110645433
2378,0.238,29,73,29,564896,111548,58956,67300,0.8835065264225066,0.3762971909107175
2379,0.2381,23,71,23,564967,111477,58979,67277,0.8829441769104043,0.37636640298958346
2380,0.2382,25,75,25,565042,111402,59004,67252,0.8823501457356482,0.37643713546855934
2381,0.2383,23,88,23,565130,111314,59027,67229,0.8816531491572678,0.3765423455414102
2382,0.2384,23,91,23,565221,111223,59050,67206,0.880932391331897,0.3766540192457504
2383,0.2385,25,96,25,565317,111127,59075,67181,0.8801720314282093,0.37676941023397714
2384,0.2386,30,102,30,565419,111025,59105,67151,0.8793641490305412,0.37688016343390807
2385,0.2387,29,93,29,565512,110932,59134,67122,0.8786275503738437,0.37697552427915126
2386,0.2388,22,87,22,565599,110845,59156,67100,0.8779384742111266,0.3770828064851499
2387,0.2389,30,72,30,565671,110773,59186,67070,0.8773682042833608,0.37713039028806306
2388,0.239,30,89,30,565760,110684,59216,67040,0.876663287289317,0.3772141072674484
2389,0.2391,22,72,22,565832,110612,59238,67018,0.8760930173615511,0.37728987220627147
2390,0.2392,21,81,21,565913,110531,59259,66997,0.8754514636928146,0.37738835563967377
2391,0.2393,33,86,33,565999,110445,59292,66964,0.8747703079457609,0.377455484220079
2392,0.2394,31,81,31,566080,110364,59323,66933,0.8741287542770244,0.3775190781569908
2393,0.2395,25,103,25,566183,110261,59348,66908,0.8733129514636928,0.37765071767634295
2394,0.2396,28,69,28,566252,110192,59376,66880,0.8727664427829173,0.3776994668835276
2395,0.2397,17,79,17,566331,110113,59393,66863,0.8721407299455075,0.37780829038965735
2396,0.2398,25,75,25,566406,110038,59418,66838,0.8715466987707515,0.37788054908523483
2397,0.2399,22,77,22,566483,109961,59440,66816,0.8709368267646687,0.3779677220452887
2398,0.24,29,77,29,566560,109884,59469,66787,0.8703269547585857,0.37803035019895737
2399,0.2401,19,85,19,566645,109799,59488,66768,0.8696537194271955,0.37814540655954965
2400,0.2402,26,84,26,566729,109715,59514,66742,0.8689884045114687,0.3782337906685481
2401,0.2403,24,87,24,566816,109628,59538,66718,0.8682993283487518,0.37833577172150207
2402,0.2404,26,82,26,566898,109546,59564,66692,0.8676498542643518,0.37842009101328883
2403,0.2405,20,80,20,566978,109466,59584,66672,0.8670162210112786,0.3785213866400209
2404,0.2406,14,99,14,567077,109367,59598,66658,0.8662320998606007,0.3786848459025707
2405,0.2407,24,84,24,567161,109283,59622,66634,0.8655667849448739,0.3787809023573617
2406,0.2408,27,91,27,567252,109192,59649,66607,0.8648460271195032,0.3788815636038885
2407,0.2409,25,93,25,567345,109099,59674,66582,0.8641094284628057,0.3789937443434407
2408,0.241,27,95,27,567440,109004,59701,66555,0.8633569889747814,0.37910332139052966
2409,0.2411,27,95,27,567535,108909,59728,66528,0.862604549486757,0.3792130508387626
2410,0.2412,18,81,18,567616,108828,59746,66510,0.8619629958180205,0.37932450467097834
2411,0.2413,20,72,20,567688,108756,59766,66490,0.8613927258902547,0.37940951576640836
2412,0.2414,23,81,23,567769,108675,59789,66467,0.8607511722215182,0.37950348859782346
2413,0.2415,26,87,26,567856,108588,59815,66441,0.8600620960588011,0.379599952007953
2414,0.2416,24,80,24,567936,108508,59839,66417,0.859428462805728,0.379688437901958
2415,0.2417,26,84,26,568020,108424,59865,66391,0.8587631478900013,0.37977862311586535
2416,0.2418,24,86,24,568106,108338,59889,66367,0.8580819921429477,0.3798803697661773
2417,0.2419,19,89,19,568195,108249,59908,66348,0.8573770751489038,0.38000652932180967
2418,0.242,23,77,23,568272,108172,59931,66325,0.856767203142821,0.3800924944268383
2419,0.2421,25,77,25,568349,108095,59956,66300,0.8561573311367381,0.38017144986954904
2420,0.2422,28,92,28,568441,108003,59984,66272,0.8554286528957039,0.38027255773920526
2421,0.2423,24,112,24,568553,107891,60008,66248,0.8545415663414015,0.3804317240824858
2422,0.2424,16,81,16,568634,107810,60024,66232,0.853900012672665,0.3805518208248584
2423,0.2425,29,77,29,568711,107733,60053,66203,0.8532901406665822,0.38061700855487074
2424,0.2426,17,78,17,568789,107655,60070,66186,0.8526723482448358,0.3807272162493313
2425,0.2427,18,86,18,568875,107569,60088,66168,0.8519911924977823,0.38085151694803066
2426,0.2428,28,89,28,568964,107480,60116,66140,0.8512862755037385,0.38094689551894945
2427,0.2429,23,93,23,569057,107387,60139,66117,0.850549676847041,0.3810690243452601
2428,0.243,26,88,26,569145,107299,60165,66091,0.8498526802686605,0.38116961762500723
2429,0.2431,26,83,26,569228,107216,60191,66065,0.8491952857685972,0.38125934176280146
2430,0.2432,29,90,29,569318,107126,60220,66036,0.8484824483588899,0.38135387671660065
2431,0.2433,27,73,27,569391,107053,60247,66009,0.8479042580154607,0.3814182200598629
2432,0.2434,25,95,25,569486,106958,60272,65984,0.8471518185274364,0.3815383192052827
2433,0.2435,25,77,25,569563,106881,60297,65959,0.8465419465213534,0.38161883823189074
2434,0.2436,24,70,24,569633,106811,60321,65935,0.8459875174249145,0.38168756440091234
2435,0.2437,31,82,31,569715,106729,60352,65904,0.8453380433405145,0.3817578330910081
2436,0.2438,22,76,22,569791,106653,60374,65882,0.844736091750095,0.3818471614455038
2437,0.2439,26,87,26,569878,106566,60400,65856,0.844047015587378,0.3819466193409194
2438,0.244,30,76,30,569954,106490,60430,65826,0.8434450639969585,0.3820074746396156
2439,0.2441,25,80,25,570034,106410,60455,65801,0.8428114307438854,0.3820952203982324
2440,0.2442,31,86,31,570120,106324,60486,65770,0.8421302749968318,0.38217485792648204
2441,0.2443,31,74,31,570194,106250,60517,65739,0.8415441642377391,0.3822279331817732
2442,0.2444,32,86,32,570280,106164,60549,65707,0.8408630084906856,0.3823041699879561
2443,0.2445,26,81,26,570361,106083,60575,65681,0.8402214548219491,0.38239095503132203
2444,0.2446,29,70,29,570431,106013,60604,65652,0.8396670257255101,0.38244254798590277
2445,0.2447,23,70,23,570501,105943,60627,65629,0.8391125966290711,0.38251579511808453
2446,0.2448,30,68,30,570569,105875,60657,65599,0.8385740083639589,0.38255945507773775
2447,0.2449,16,74,16,570643,105801,60673,65583,0.8379878976048662,0.38266699341828875
2448,0.245,28,75,28,570718,105726,60701,65555,0.8373938664301103,0.3827336365387871
2449,0.2451,28,91,28,570809,105635,60729,65527,0.8366731086047395,0.38283614353653267
2450,0.2452,22,89,22,570898,105546,60751,65505,0.8359681916106957,0.3829559605030079
2451,0.2453,26,77,26,570975,105469,60777,65479,0.8353583196046128,0.3830346070149987
2452,0.2454,23,93,23,571068,105376,60800,65456,0.8346217209479153,0.38316006368830197
2453,0.2455,23,71,23,571139,105305,60823,65433,0.834059371435813,0.3832363035762396
2454,0.2456,25,68,25,571207,105237,60848,65408,0.8335207831707008,0.38329866096281756
2455,0.2457,29,89,29,571296,105148,60877,65379,0.8328158661766569,0.38339383206178496
2456,0.2458,22,79,22,571375,105069,60899,65357,0.8321901533392473,0.3834919554528065
2457,0.2459,32,87,32,571462,104982,60931,65325,0.8315010771765302,0.3835720199404605
2458,0.246,24,77,24,571539,104905,60955,65301,0.8308912051704473,0.38365862543036083
2459,0.2461,30,91,30,571630,104814,60985,65271,0.8301704473450767,0.38375518123291297
2460,0.2462,23,74,23,571704,104740,61008,65248,0.8295843365859841,0.38383885921359157
2461,0.2463,21,93,21,571797,104647,61029,65227,0.8288477379292866,0.3839728269187751
2462,0.2464,24,89,24,571886,104558,61053,65203,0.8281428209352427,0.38408704001508004
2463,0.2465,23,79,23,571965,104479,61076,65180,0.827517108097833,0.3841823893810526
2464,0.2466,28,84,28,572049,104395,61104,65152,0.8268517931821062,0.3842710280925053
2465,0.2467,21,84,21,572133,104311,61125,65131,0.8261864782663794,0.38438521736051273
2466,0.2468,30,85,30,572218,104226,61155,65101,0.8255132429349892,0.38446910415940755
2467,0.2469,29,98,29,572316,104128,61184,65072,0.8247370421999747,0.3845862884160757
2468,0.247,25,74,25,572390,104054,61209,65047,0.824150931440882,0.3846636034086138
2469,0.2471,28,80,28,572470,103974,61237,65019,0.8235172981878089,0.38474374678241113
2470,0.2472,25,85,25,572555,103889,61262,64994,0.8228440628564188,0.38484631372014944
2471,0.2473,23,90,23,572645,103799,61285,64971,0.8221312254467115,0.38496770753095927
2472,0.2474,18,62,18,572707,103737,61303,64953,0.8216401596755798,0.38504357104748355
2473,0.2475,19,65,19,572772,103672,61322,64934,0.8211253326574579,0.3851227121217513
2474,0.2476,21,85,21,572857,103587,61343,64913,0.8204520973260677,0.38524035608308604
2475,0.2477,24,71,24,572928,103516,61367,64889,0.8198897478139653,0.3853151628514593
2476,0.2478,21,87,21,573015,103429,61388,64868,0.8192006716512482,0.38543764891828136
2477,0.2479,26,87,26,573102,103342,61414,64842,0.8185115954885313,0.38554202540075155
2478,0.248,28,97,28,573199,103245,61442,64814,0.8177433151691801,0.3856621781636211
2479,0.2481,19,84,19,573283,103161,61461,64795,0.8170780002534533,0.38578556288551763
2480,0.2482,23,79,23,573362,103082,61484,64772,0.8164522874160436,0.38588296972368846
2481,0.2483,34,76,34,573438,103006,61518,64738,0.8158503358256242,0.3859333269744372
2482,0.2484,25,75,25,573513,102931,61543,64713,0.8152563046508681,0.3860144114910167
2483,0.2485,34,97,34,573610,102834,61577,64679,0.8144880243315169,0.3861133165784148
2484,0.2486,20,79,20,573689,102755,61597,64659,0.8138623114941073,0.38622217974601886
2485,0.2487,25,75,25,573764,102680,61622,64634,0.8132682803193512,0.3863035968299126
2486,0.2488,23,71,23,573835,102609,61645,64611,0.8127059308072487,0.38638320775026913
2487,0.2489,26,83,26,573918,102526,61671,64585,0.8120485363071854,0.3864796452657216
2488,0.249,23,71,23,573989,102455,61694,64562,0.811486186795083,0.3865594520318291
2489,0.2491,28,74,28,574063,102381,61722,64534,0.8109000760359903,0.3866279243926549
2490,0.2492,36,64,36,574127,102317,61758,64498,0.8103931694335319,0.38664388694062285
2491,0.2493,22,64,22,574191,102253,61780,64476,0.8098862628310733,0.3867113699476396
2492,0.2494,23,87,23,574278,102166,61803,64453,0.8091971866683564,0.38682863298903486
2493,0.2495,27,70,27,574348,102096,61830,64426,0.8086427575719174,0.3868918221015842
2494,0.2496,23,86,23,574434,102010,61853,64403,0.8079616018248638,0.3870070246915806
2495,0.2497,28,82,28,574516,101928,61881,64375,0.8073121277404638,0.3870946405055832
2496,0.2498,19,78,19,574594,101850,61900,64356,0.8066943353187175,0.3872062380419479
2497,0.2499,23,76,23,574670,101774,61923,64333,0.8060923837282981,0.38729854852595014
2498,0.25,28,75,28,574745,101699,61951,64305,0.805498352553542,0.38737018385099153
2499,0.2501,13,79,13,574824,101620,61964,64292,0.8048726397161323,0.3875066300207339
2500,0.2502,24,72,24,574896,101548,61988,64268,0.8043023697883664,0.3875862401698268
2501,0.2503,25,82,25,574978,101466,62013,64243,0.8036528957039666,0.38768564169719205
2502,0.2504,26,82,26,575060,101384,62039,64217,0.8030034216195666,0.3877814747495486
2503,0.2505,18,78,18,575138,101306,62057,64199,0.8023856291978203,0.38789764659677956
2504,0.2506,19,80,19,575218,101226,62076,64180,0.8017519959447472,0.3880149450443152
2505,0.2507,23,80,23,575298,101146,62099,64157,0.801118362691674,0.38811757802338737
2506,0.2508,21,87,21,575385,101059,62120,64136,0.8004292865289571,0.38824419625291323
2507,0.2509,28,89,28,575474,100970,62148,64108,0.7997243695349132,0.38834974981523884
2508,0.251,23,75,23,575549,100895,62171,64085,0.7991303383601571,0.3884410231543217
2509,0.2511,19,73,19,575622,100822,62190,64066,0.7985521480167279,0.3885425258357188
2510,0.2512,32,71,32,575693,100751,62222,64034,0.7979897985046255,0.38859119458688596
2511,0.2513,20,79,20,575772,100672,62242,64014,0.7973640856672158,0.3887033506187533
2512,0.2514,28,76,28,575848,100596,62270,63986,0.7967621340767963,0.3887788458033078
2513,0.2515,24,76,24,575924,100520,62294,63962,0.7961601824863769,0.38886929876825427
2514,0.2516,30,92,30,576016,100428,62324,63932,0.7954315042453428,0.3889754198101728
2515,0.2517,18,77,18,576093,100351,62342,63914,0.79482163223926,0.38909079840501626
2516,0.2518,22,68,22,576161,100283,62364,63892,0.7942830439741477,0.38917009288868587
2517,0.2519,30,86,30,576247,100197,62394,63862,0.7936018882270942,0.389262399502618
2518,0.252,22,85,22,576332,100112,62416,63840,0.7929286528957039,0.38938225822191863
2519,0.2521,21,94,21,576426,100018,62437,63819,0.7921841338233431,0.389527396131521
2520,0.2522,26,57,26,576483,99961,62463,63793,0.7917326701305285,0.3895660564016757
2521,0.2523,23,100,23,576583,99861,62486,63770,0.790940628564187,0.38971832965636094
2522,0.2524,18,78,18,576661,99783,62504,63752,0.7903228361424408,0.389837037942948
2523,0.2525,24,80,24,576741,99703,62528,63728,0.7896892028893676,0.3899382614069546
2524,0.2526,20,70,20,576811,99633,62548,63708,0.7891347737929286,0.3900306720296802
2525,0.2527,36,69,36,576880,99564,62584,63672,0.7885882651121531,0.3900610159523635
2526,0.2528,18,92,18,576972,99472,62602,63654,0.787859586871119,0.390213699839388
2527,0.2529,28,72,28,577044,99400,62630,63626,0.7872893169433531,0.39028130482254364
2528,0.253,14,62,14,577106,99338,62644,63612,0.7867982511722215,0.3903774163853943
2529,0.2531,15,90,15,577196,99248,62659,63597,0.7860854137625143,0.39053701372470756
2530,0.2532,27,76,27,577272,99172,62686,63570,0.7854834621720947,0.3906182792395325
2531,0.2533,28,54,28,577326,99118,62714,63542,0.7850557597262704,0.3906430591417681
2532,0.2534,24,82,24,577408,99036,62738,63518,0.7844062856418705,0.39075015071914565
2533,0.2535,22,80,22,577488,98956,62760,63496,0.7837726523887973,0.3908600694358949
2534,0.2536,30,83,30,577571,98873,62790,63466,0.783115257888734,0.39094733859393
2535,0.2537,25,65,25,577636,98808,62815,63441,0.782600430870612,0.39101011408390807
2536,0.2538,26,76,26,577712,98732,62841,63415,0.7819984792801926,0.3910957341178067
2537,0.2539,24,83,24,577795,98649,62865,63391,0.7813410847801293,0.3912058750925697
2538,0.254,11,63,11,577858,98586,62876,63380,0.7808420985933342,0.39131669609671166
2539,0.2541,21,79,21,577937,98507,62897,63359,0.7802163857559244,0.39142871263884943
2540,0.2542,21,74,21,578011,98433,62918,63338,0.7796302749968318,0.39152876597165126
2541,0.2543,17,71,17,578082,98362,62935,63321,0.7790679254847295,0.3916367212384728
2542,0.2544,25,76,25,578158,98286,62960,63296,0.7784659738943099,0.3917268012526148
2543,0.2545,32,85,32,578243,98201,62992,63264,0.7777927385629197,0.3918124670981327
2544,0.2546,19,72,19,578315,98129,63011,63245,0.777222468635154,0.3919156741482519
2545,0.2547,19,69,19,578384,98060,63030,63226,0.7766759599543784,0.3920117059137185
2546,0.2548,24,78,24,578462,97982,63054,63202,0.7760581675326321,0.392110879491761
2547,0.2549,24,82,24,578544,97900,63078,63178,0.7754086934482322,0.3922199183004507
2548,0.255,17,81,17,578625,97819,63095,63161,0.7747671397794956,0.39235308734004226
2549,0.2551,28,72,28,578697,97747,63123,63133,0.7741968698517299,0.3924229239184485
2550,0.2552,26,79,26,578776,97668,63149,63107,0.7735711570143201,0.3925174933913855
2551,0.2553,29,77,29,578853,97591,63178,63078,0.7729612850082372,0.3925959581499854
2552,0.2554,21,76,21,578929,97515,63199,63057,0.7723593334178178,0.3927023391375831
2553,0.2555,31,74,31,579003,97441,63230,63026,0.7717732226587252,0.3927661139050397
2554,0.2556,22,79,22,579082,97362,63252,63004,0.7711475098213154,0.39287629547410297
2555,0.2557,21,72,21,579154,97290,63273,62983,0.7705772398935496,0.39297323941025625
2556,0.2558,26,68,26,579222,97222,63299,62957,0.7700386516284374,0.39304153478296155
2557,0.2559,26,75,26,579297,97147,63325,62931,0.7694446204536814,0.3931271005384875
2558,0.256,30,74,30,579371,97073,63355,62901,0.7688585096945888,0.39319514421093427
2559,0.2561,24,70,24,579441,97003,63379,62877,0.7683040805981498,0.39327620715536654
2560,0.2562,22,65,22,579506,96938,63401,62855,0.7677892535800279,0.3933526499909258
2561,0.2563,30,77,30,579583,96861,63431,62825,0.767179381573945,0.3934283531430432
2562,0.2564,36,88,36,579671,96773,63467,62789,0.7664823849955645,0.39350847946252865
2563,0.2565,23,66,23,579737,96707,63490,62766,0.7659596375617792,0.393583866861475
2564,0.2566,29,61,29,579798,96646,63519,62737,0.765476492206311,0.39362416317926
2565,0.2567,21,58,21,579856,96588,63540,62716,0.765017108097833,0.39368754080249085
2566,0.2568,26,74,26,579930,96514,63566,62690,0.7644309973387403,0.39377151327856086
2567,0.2569,24,81,24,580011,96433,63590,62666,0.7637894436700038,0.3938805397896907
2568,0.257,35,79,35,580090,96354,63625,62631,0.7631637308325941,0.393942824794792
2569,0.2571,22,63,22,580153,96291,63647,62609,0.762664744645799,0.3940151038388924
2570,0.2572,23,68,23,580221,96223,63670,62586,0.7621261563806868,0.3940960524907279
2571,0.2573,23,64,23,580285,96159,63693,62563,0.7616192497782284,0.39416716019203385
2572,0.2574,25,76,25,580361,96083,63718,62538,0.7610172981878089,0.3942605329685224
2573,0.2575,23,65,23,580426,96018,63741,62515,0.7605024711696869,0.3943343026373058
2574,0.2576,21,67,21,580493,95951,63762,62494,0.7599718033202383,0.3944207769257471
2575,0.2577,23,82,23,580575,95869,63785,62471,0.7593223292358383,0.39453707212327904
2576,0.2578,28,73,28,580648,95796,63813,62443,0.7587441388924091,0.3946119477499226
2577,0.2579,28,73,28,580721,95723,63841,62415,0.7581659485489799,0.3946869190200964
2578,0.258,24,76,24,580797,95647,63865,62391,0.7575639969585604,0.3947847985927435
2579,0.2581,21,76,21,580873,95571,63886,62370,0.7569620453681409,0.3948942959712804
2580,0.2582,22,65,22,580938,95506,63908,62348,0.756447218350019,0.3949725695896208
2581,0.2583,22,74,22,581012,95432,63930,62326,0.7558611075909264,0.395073466955717
2582,0.2584,9,78,9,581090,95354,63939,62317,0.7552433151691801,0.3952343804504316
2583,0.2585,19,68,19,581158,95286,63958,62298,0.754704726904068,0.3953320134023759
2584,0.2586,19,67,19,581225,95219,63977,62279,0.7541740590546192,0.39542724352055264
2585,0.2587,28,73,28,581298,95146,64005,62251,0.75359586871119,0.39550309091024605
2586,0.2588,24,80,24,581378,95066,64029,62227,0.7529622354581168,0.3956120107061344
2587,0.2589,20,71,20,581449,94995,64049,62207,0.7523998859460145,0.3957137949898856
2588,0.259,33,85,33,581534,94910,64082,62174,0.7517266506146243,0.3958009727279672
2589,0.2591,23,82,23,581616,94828,64105,62151,0.7510771765302243,0.395919199383357
2590,0.2592,18,80,18,581696,94748,64123,62133,0.7504435432771512,0.3960517844735819
2591,0.2593,29,88,29,581784,94660,64152,62104,0.7497465466987707,0.396162384220867
2592,0.2594,26,59,26,581843,94601,64178,62078,0.7492792421746294,0.39621136208426144
2593,0.2595,18,77,18,581920,94524,64196,62060,0.7486693701685464,0.3963367904766771
2594,0.2596,28,67,28,581987,94457,64224,62032,0.7481387023190977,0.39639846890196756
2595,0.2597,25,77,25,582064,94380,64249,62007,0.7475288303130149,0.39649715129774216
2596,0.2598,31,84,31,582148,94296,64280,61976,0.746863515397288,0.39659056004914506
2597,0.2599,30,78,30,582226,94218,64310,61946,0.7462457229755417,0.39667272866985986
2598,0.26,23,90,23,582316,94128,64333,61923,0.7455328855658345,0.39681258050252805
2599,0.2601,24,67,24,582383,94061,64357,61899,0.7450022177163858,0.39689022826365733
2600,0.2602,20,72,20,582455,93989,64377,61879,0.74443194778862,0.39699617625170014
2601,0.2603,30,83,30,582538,93906,64407,61849,0.7437745532885566,0.3970915861449071
2602,0.2604,23,83,23,582621,93823,64430,61826,0.7431171587884933,0.3972142448714736
2603,0.2605,20,70,20,582691,93753,64450,61806,0.7425627296920543,0.397315488014194
2604,0.2606,19,61,19,582752,93692,64469,61787,0.7420795843365859,0.39739771930614426
2605,0.2607,19,81,19,582833,93611,64488,61768,0.7414380306678494,0.39753119790962743
2606,0.2608,18,72,18,582905,93539,64506,61750,0.7408677607400836,0.3976456799902118
2607,0.2609,32,65,32,582970,93474,64538,61718,0.7403529337219618,0.3976880251559359
2608,0.261,30,65,30,583035,93409,64568,61688,0.7398381067038399,0.3977381896490583
2609,0.2611,17,76,17,583111,93333,64585,61671,0.7392361551134203,0.397867151815437
2610,0.2612,19,72,19,583183,93261,64604,61652,0.7386658851856546,0.3979782200331799
2611,0.2613,23,64,23,583247,93197,64627,61629,0.738158978583196,0.3980532985415886
2612,0.2614,23,70,23,583317,93127,64650,61606,0.737604549486757,0.3981438994913819
2613,0.2615,27,59,27,583376,93068,64677,61579,0.7371372449626157,0.3981907182163249
2614,0.2616,18,75,18,583451,92993,64695,61561,0.7365432137878596,0.3983138579396198
2615,0.2617,24,73,24,583524,92920,64719,61537,0.7359650234444304,0.3984086185799284
2616,0.2618,25,62,25,583586,92858,64744,61512,0.7354739576732987,0.3984712055451189
2617,0.2619,23,76,23,583662,92782,64767,61489,0.7348720060828793,0.39857782732982866
2618,0.262,36,71,36,583733,92711,64803,61453,0.7343096565707768,0.3986209491191199
2619,0.2621,23,79,23,583812,92632,64826,61430,0.7336839437333671,0.39873557398969245
2620,0.2622,27,70,27,583882,92562,64853,61403,0.7331295146369281,0.39881141817945637
2621,0.2623,17,68,17,583950,92494,64870,61386,0.732590926371816,0.3989212373277879
2622,0.2624,24,84,24,584034,92410,64894,61362,0.7319256114560893,0.3990453398538095
2623,0.2625,24,74,24,584108,92336,64918,61338,0.7313395006969966,0.3991436417351016
2624,0.2626,29,69,29,584177,92267,64947,61309,0.730792992016221,0.3992095119029015
2625,0.2627,19,70,19,584247,92197,64966,61290,0.7302385629197821,0.39931720601744775
2626,0.2628,29,67,29,584314,92130,64995,61261,0.7297078950703333,0.3993780599904818
2627,0.2629,21,72,21,584386,92058,65016,61240,0.7291376251425675,0.3994833592088612
2628,0.263,26,67,26,584453,91991,65042,61214,0.7286069572931188,0.3995561502561927
2629,0.2631,19,66,19,584519,91925,65061,61195,0.7280842098593334,0.3996538662486938
2630,0.2632,25,81,25,584600,91844,65086,61170,0.7274426561905969,0.39976734155044635
2631,0.2633,27,72,27,584672,91772,65113,61143,0.7268723862628311,0.399849589641304
2632,0.2634,22,95,22,584767,91677,65135,61121,0.7261199467748067,0.40001178025890394
2633,0.2635,22,64,22,584831,91613,65157,61099,0.7256130401723483,0.4000929854890251
2634,0.2636,23,65,23,584896,91548,65180,61076,0.7250982131542263,0.4001729741063004
2635,0.2637,24,67,24,584963,91481,65204,61052,0.7245675453047776,0.4002543711852517
2636,0.2638,25,54,25,585017,91427,65229,61027,0.7241398428589533,0.4002977947446443
2637,0.2639,33,75,33,585092,91352,65262,60994,0.7235458116841972,0.4003649587124047
2638,0.264,24,67,24,585159,91285,65286,60970,0.7230151438347484,0.4004466191586483
2639,0.2641,24,63,24,585222,91222,65310,60946,0.7225161576479534,0.4005178486935492
2640,0.2642,22,81,22,585303,91141,65332,60924,0.7218746039792169,0.4006444612501233
2641,0.2643,25,84,25,585387,91057,65357,60899,0.72120928906349,0.4007673273842428
2642,0.2644,19,91,19,585478,90966,65376,60880,0.7204885312381194,0.4009325237411588
2643,0.2645,29,88,29,585566,90878,65405,60851,0.719791534659739,0.4010505572435065
2644,0.2646,26,54,26,585620,90824,65431,60825,0.7193638322139145,0.4010906764963831
2645,0.2647,25,76,25,585696,90748,65456,60800,0.7187618806234951,0.4011930213529707
2646,0.2648,27,83,27,585779,90665,65483,60773,0.7181044861234318,0.40130614508907936
2647,0.2649,29,65,29,585844,90600,65512,60744,0.7175896591053098,0.4013637805264827
2648,0.265,32,59,32,585903,90541,65544,60712,0.7171223545811685,0.40139369136479935
2649,0.2651,23,77,23,585980,90464,65567,60689,0.7165124825750855,0.40150708222794124
2650,0.2652,25,79,25,586059,90385,65592,60664,0.7158867697376758,0.40161801799416086
2651,0.2653,34,58,34,586117,90327,65626,60630,0.7154273856291978,0.4016375524155886
2652,0.2654,28,72,28,586189,90255,65654,60602,0.7148571157014321,0.40171818344524945
2653,0.2655,21,64,21,586253,90191,65675,60581,0.7143502090989735,0.40180537500331626
2654,0.2656,19,67,19,586320,90124,65694,60562,0.7138195412495247,0.40190860464807615
2655,0.2657,22,69,22,586389,90055,65716,60540,0.7132730325687492,0.4020053786646303
2656,0.2658,30,68,30,586457,89987,65746,60510,0.7127344443036371,0.40206781530528846
2657,0.2659,14,57,14,586514,89930,65760,60496,0.7122829806108224,0.40216451943148124
2658,0.266,18,70,18,586584,89860,65778,60478,0.7117285515143835,0.40228019529327247
2659,0.2661,22,74,22,586658,89786,65800,60456,0.7111424407552909,0.40239080949401634
2660,0.2662,23,84,23,586742,89702,65823,60433,0.710477125839564,0.40252439471142637
2661,0.2663,14,53,14,586795,89649,65837,60419,0.7100573438094031,0.4026108164298851
2662,0.2664,25,57,25,586852,89592,65862,60394,0.7096058801165885,0.40266424866320855
2663,0.2665,21,61,21,586913,89531,65883,60373,0.7091227347611203,0.402744423097449
2664,0.2666,27,68,27,586981,89463,65910,60346,0.7085841464960081,0.4028195902782877
2665,0.2667,21,66,21,587047,89397,65931,60325,0.7080613990622228,0.40291339950040744
2666,0.2668,20,71,20,587118,89326,65951,60305,0.7074990495501204,0.40302477427805733
2667,0.2669,21,65,21,587183,89261,65972,60284,0.7069842225319984,0.4031161188939784
2668,0.267,22,67,22,587250,89194,65994,60262,0.7064535546825498,0.40320897120222676
2669,0.2671,21,70,21,587320,89124,66015,60241,0.7058991255861108,0.40331402939108896
2670,0.2672,39,74,39,587394,89050,66054,60202,0.7053130148270181,0.40335807895371584
2671,0.2673,28,69,28,587463,88981,66082,60174,0.7047665061462426,0.40343267071167577
2672,0.2674,19,70,19,587533,88911,66101,60155,0.7042120770498036,0.4035460802597507
2673,0.2675,13,57,13,587590,88854,66114,60142,0.703760613356989,0.40364842009181456
2674,0.2676,28,68,28,587658,88786,66142,60114,0.7032220250918768,0.4037206178643385
2675,0.2677,22,64,22,587722,88722,66164,60092,0.7027151184894184,0.40380609351270713
2676,0.2678,35,52,35,587774,88670,66199,60057,0.7023032568749208,0.40380697519616476
2677,0.2679,24,71,24,587845,88599,66223,60033,0.7017409073628184,0.40390360083965765
2678,0.268,15,63,15,587908,88536,66238,60018,0.7012419211760234,0.4040147017246254
2679,0.2681,20,54,20,587962,88482,66258,59998,0.700814218730199,0.4040813577586207
2680,0.2682,23,71,23,588033,88411,66281,59975,0.7002518692180966,0.4041823352607389
2681,0.2683,21,70,21,588103,88341,66302,59954,0.6996974401216576,0.40428874877777404
2682,0.2684,27,73,27,588176,88268,66329,59927,0.6991192497782284,0.40437936502581057
2683,0.2685,26,64,26,588240,88204,66355,59901,0.6986123431757698,0.4044495459302522
2684,0.2686,16,83,16,588323,88121,66371,59885,0.6979549486757065,0.404611975190195
2685,0.2687,21,65,21,588388,88056,66392,59864,0.6974401216575846,0.4047052460789616
2686,0.2688,21,77,21,588465,87979,66413,59843,0.6968302496515018,0.40483148651756845
2687,0.2689,25,75,25,588540,87904,66438,59818,0.6962362184767457,0.4049362992648353
2688,0.269,26,58,26,588598,87846,66464,59792,0.6957768343682676,0.404990585079722
2689,0.2691,27,67,27,588665,87779,66491,59765,0.6952461665188189,0.40506560754757903
2690,0.2692,23,63,23,588728,87716,66514,59742,0.6947471803320239,0.40514587204492125
2691,0.2693,24,67,24,588795,87649,66538,59718,0.6942165124825751,0.40523319332007846
2692,0.2694,27,65,27,588860,87584,66565,59691,0.6937016854644532,0.4053030045832626
2693,0.2695,25,59,25,588919,87525,66590,59666,0.6932343809403118,0.4053644584247678
2694,0.2696,17,68,17,588987,87457,66607,59649,0.6926957926751995,0.40548312101477846
2695,0.2697,19,56,19,589043,87401,66626,59630,0.6922522493980484,0.4055607320905115
2696,0.2698,15,61,15,589104,87340,66641,59615,0.6917691040425802,0.4056684018917356
2697,0.2699,24,78,24,589182,87262,66665,59591,0.6911513116208339,0.40578673912007246
2698,0.27,20,62,20,589244,87200,66685,59571,0.6906602458497022,0.40587718282221963
2699,0.2701,27,65,27,589309,87135,66712,59544,0.6901454188315803,0.405947681672223
2700,0.2702,24,85,24,589394,87050,66736,59520,0.6894721835001901,0.4060858292965818
2701,0.2703,24,70,24,589464,86980,66760,59496,0.6889177544037511,0.4061825828122013
2702,0.2704,24,64,24,589528,86916,66784,59472,0.6884108478012926,0.40626280842692025
2703,0.2705,29,66,29,589594,86850,66813,59443,0.6878881003675072,0.4063283957537271
2704,0.2706,25,60,25,589654,86790,66838,59418,0.6874128754277025,0.4063936309914642
2705,0.2707,21,81,21,589735,86709,66859,59397,0.6867713217589659,0.4065336125826455
2706,0.2708,25,77,25,589812,86632,66884,59372,0.6861614497528831,0.4066463932495
2707,0.2709,20,66,20,589878,86566,66904,59352,0.6856387023190977,0.4067489960114585
2708,0.271,27,56,27,589934,86510,66931,59325,0.6851951590419465,0.4067953509102753
2709,0.2711,25,72,25,590006,86438,66956,59300,0.6846248891141807,0.4068945642179802
2710,0.2712,25,70,25,590076,86368,66981,59275,0.6840704600177417,0.4069883207569193
2711,0.2713,25,58,25,590134,86310,67006,59250,0.6836110759092637,0.40704863973619126
2712,0.2714,18,86,18,590220,86224,67024,59232,0.6829299201622101,0.4072159278407216
2713,0.2715,23,70,23,590290,86154,67047,59209,0.6823754910657711,0.40731823091158
2714,0.2716,27,77,27,590367,86077,67074,59182,0.6817656190596882,0.40742398061393786
2715,0.2717,23,70,23,590437,86007,67097,59159,0.6812111899632493,0.40752655580507835
2716,0.2718,21,68,21,590505,85939,67118,59138,0.6806726016981371,0.4076318093150534
2717,0.2719,17,69,17,590574,85870,67135,59121,0.6801260930173616,0.4077563434971826
2718,0.272,20,62,20,590636,85808,67155,59101,0.6796350272462299,0.4078490638952722
2719,0.2721,20,72,20,590708,85736,67175,59081,0.679064757318464,0.40797005876381914
2720,0.2722,12,63,12,590771,85673,67187,59069,0.6785657711316689,0.4080985477608434
2721,0.2723,26,73,26,590844,85600,67213,59043,0.6779875807882397,0.40819811535988604
2722,0.2724,26,53,26,590897,85547,67239,59017,0.6775677987580788,0.40824133255858996
2723,0.2725,15,76,15,590973,85471,67254,59002,0.6769658471676594,0.40839464813494564
2724,0.2726,20,80,20,591053,85391,67274,58982,0.6763322139145862,0.40853899274795147
2725,0.2727,24,78,24,591131,85313,67298,58958,0.6757144214928399,0.4086614773585821
2726,0.2728,22,64,22,591195,85249,67320,58936,0.6752075148903814,0.40875264417241736
2727,0.2729,18,51,18,591246,85198,67338,58918,0.6748035736915473,0.4088234477781787
2728,0.273,13,76,13,591322,85122,67351,58905,0.6742016221011279,0.40898581515965754
2729,0.2731,21,54,21,591376,85068,67372,58884,0.6737739196553035,0.40905301767255753
2730,0.2732,22,66,22,591442,85002,67394,58862,0.6732511722215182,0.40915030862481233
2731,0.2733,29,67,29,591509,84935,67423,58833,0.6727205043720694,0.40922180179177564
2732,0.2734,16,63,16,591572,84872,67439,58817,0.6722215181852743,0.40933543973442643
2733,0.2735,22,64,22,591636,84808,67461,58795,0.6717146115828159,0.40942737965084297
2734,0.2736,23,72,23,591708,84736,67484,58772,0.6711443416550501,0.40953814421495666
2735,0.2737,25,64,25,591772,84672,67509,58747,0.6706374350525915,0.40961797251410204
2736,0.2738,21,68,21,591840,84604,67530,58726,0.6700988467874794,0.4097258075769204
2737,0.2739,21,62,21,591902,84542,67551,58705,0.6696077810163478,0.4098166104700273
2738,0.274,24,77,24,591979,84465,67575,58681,0.6689979090102649,0.4099381051513839
2739,0.2741,26,51,26,592030,84414,67601,58655,0.6685939678114308,0.4099770041029154
2740,0.2742,25,63,25,592093,84351,67626,58630,0.6680949816246357,0.4100544827634441
2741,0.2743,24,67,24,592160,84284,67650,58606,0.6675643137751869,0.4101476660368115
2742,0.2744,16,69,16,592229,84215,67666,58590,0.6670178050944113,0.41027975210952
2743,0.2745,22,64,22,592293,84151,67688,58568,0.6665108984919529,0.4103728305271197
2744,0.2746,20,54,20,592347,84097,67708,58548,0.6660831960461285,0.41044551158470327
2745,0.2747,22,64,22,592411,84033,67730,58526,0.66557628944367,0.41053879446404645
2746,0.2748,32,69,32,592480,83964,67762,58494,0.6650297807628944,0.4106052310154572
2747,0.2749,17,61,17,592541,83903,67779,58477,0.6645466354074262,0.41071077398511024
2748,0.275,27,68,27,592609,83835,67806,58450,0.664008047142314,0.4107952349158379
2749,0.2751,22,69,22,592678,83766,67828,58428,0.6634615384615384,0.4109034136461454
2750,0.2752,15,66,15,592744,83700,67843,58413,0.6629387910277531,0.41103206603196046
2751,0.2753,35,78,35,592822,83622,67878,58378,0.6623209986060068,0.41111267605633806
2752,0.2754,28,53,28,592875,83569,67906,58350,0.6619012165758459,0.4111500221957596
2753,0.2755,31,67,31,592942,83502,67937,58319,0.6613705487263971,0.4112155463577326
2754,0.2756,23,46,23,592988,83456,67960,58296,0.6610062096058801,0.4112534567413511
2755,0.2757,29,66,29,593054,83390,67989,58267,0.6604834621720947,0.41132453743902525
2756,0.2758,19,64,19,593118,83326,68008,58248,0.6599765555696363,0.4114314775311851
2757,0.2759,28,63,28,593181,83263,68036,58220,0.6594775693828412,0.411498201197317
2758,0.276,21,75,21,593256,83188,68057,58199,0.6588835382080852,0.41162907480885796
2759,0.2761,24,63,24,593319,83125,68081,58175,0.6583845520212901,0.41171266808209483
2760,0.2762,25,65,25,593384,83060,68106,58150,0.6578697250031682,0.41179803130089937
2761,0.2763,29,77,29,593461,82983,68135,58121,0.6572598529970853,0.41190185962127224
2762,0.2764,20,51,20,593512,82932,68155,58101,0.6568559117982512,0.41196741188232544
2763,0.2765,25,69,25,593581,82863,68180,58076,0.6563094031174757,0.4120647939888888
2764,0.2766,18,67,18,593648,82796,68198,58058,0.6557787352680269,0.412185667428685
2765,0.2767,24,72,24,593720,82724,68222,58034,0.655208465340261,0.4122962815612612
2766,0.2768,15,64,15,593784,82660,68237,58019,0.6547015587378026,0.4124211858202006
2767,0.2769,17,48,17,593832,82612,68254,58002,0.6543213787859586,0.41249093262406306
2768,0.277,28,56,28,593888,82556,68282,57974,0.6538778355088075,0.41253824806091227
2769,0.2771,24,48,24,593936,82508,68306,57950,0.6534976555569636,0.4125788491933532
2770,0.2772,28,60,28,593996,82448,68334,57922,0.6530224306171588,0.41263802806867567
2771,0.2773,18,63,18,594059,82385,68352,57904,0.6525234444303637,0.412747970261389
2772,0.2774,20,58,20,594117,82327,68372,57884,0.6520640603218857,0.4128349416236957
2773,0.2775,25,55,25,594172,82272,68397,57859,0.6516284374603979,0.4128922222777258
2774,0.2776,33,40,33,594212,82232,68430,57826,0.6513116208338614,0.4128718102500393
2775,0.2777,21,55,21,594267,82177,68451,57805,0.6508759979723736,0.4129459501935963
2776,0.2778,18,65,18,594332,82112,68469,57787,0.6503611709542517,0.4130622806453227
2777,0.2779,26,63,26,594395,82049,68495,57761,0.6498621847674566,0.4131392604248623
2778,0.278,23,67,23,594462,81982,68518,57738,0.6493315169180078,0.4132407672487833
2779,0.2781,21,52,21,594514,81930,68539,57717,0.6489196553035104,0.4133064083009302
2780,0.2782,22,64,22,594578,81866,68561,57695,0.6484127487010518,0.4134034579861136
2781,0.2783,22,76,22,594654,81790,68583,57673,0.6478107971106324,0.41353620673583674
2782,0.2784,15,61,15,594715,81729,68598,57658,0.6473276517551642,0.4136540710396235
2783,0.2785,23,47,23,594762,81682,68621,57635,0.6469553922189837,0.4136968209191987
2784,0.2786,20,69,20,594831,81613,68641,57615,0.6464088835382081,0.413817622891947
2785,0.2787,17,52,17,594883,81561,68658,57598,0.6459970219237106,0.41390064602361326
2786,0.2788,26,78,26,594961,81483,68684,57572,0.6453792295019642,0.41402322821905
2787,0.2789,15,59,15,595020,81424,68699,57557,0.6449119249778228,0.41413574517380075
2788,0.279,22,53,22,595073,81371,68721,57535,0.6444921429476619,0.41420097044044174
2789,0.2791,28,66,28,595139,81305,68749,57507,0.6439693955138766,0.4142797452669798
2790,0.2792,19,69,19,595208,81236,68768,57488,0.643422886833101,0.4144055823073152
2791,0.2793,22,73,22,595281,81163,68790,57466,0.6428446964896718,0.41453087016425133
2792,0.2794,26,63,26,595344,81100,68816,57440,0.6423457103028767,0.41460949906164285
2793,0.2795,23,73,23,595417,81027,68839,57417,0.6417675199594475,0.4147308659096819
2794,0.2796,18,66,18,595483,80961,68857,57399,0.6412447725256621,0.41485255854293146
2795,0.2797,26,75,26,595558,80886,68883,57373,0.640650741350906,0.41496756088211256
2796,0.2798,23,72,23,595630,80814,68906,57350,0.6400804714231403,0.4150864190382444
2797,0.2799,29,60,29,595690,80754,68935,57321,0.6396052464833355,0.4151439435089625
2798,0.28,25,63,25,595753,80691,68960,57296,0.6391062602965404,0.4152275214331785
2799,0.2801,24,56,24,595809,80635,68984,57272,0.6386627170193891,0.41529436504310874
2800,0.2802,20,55,20,595864,80580,69004,57252,0.6382270941579014,0.4153752394219049
2801,0.2803,22,49,22,595913,80531,69026,57230,0.6378389937903941,0.4154296208651215
2802,0.2804,17,64,17,595977,80467,69043,57213,0.6373320871879357,0.41555055200464847
2803,0.2805,23,75,23,596052,80392,69066,57190,0.6367380560131796,0.4156793766626448
2804,0.2806,26,63,26,596115,80329,69092,57164,0.6362390698263845,0.4157593477486127
2805,0.2807,28,51,28,596166,80278,69120,57136,0.6358351286275504,0.41579460608089425
2806,0.2808,19,38,19,596204,80240,69139,57117,0.6355341528323406,0.41582882561500323
2807,0.2809,25,60,25,596264,80180,69164,57092,0.6350589278925358,0.4159041902208753
2808,0.281,22,61,22,596325,80119,69186,57070,0.6345757825370676,0.4159954515303705
2809,0.2811,21,72,21,596397,80047,69207,57049,0.6340055126093017,0.41612446752640486
2810,0.2812,19,71,19,596468,79976,69226,57030,0.6334431630971994,0.4162591419353897
2811,0.2813,14,57,14,596525,79919,69240,57016,0.6329916994043847,0.4163727315879797
2812,0.2814,19,55,19,596580,79864,69259,56997,0.6325560765428969,0.41645903507938714
2813,0.2815,26,61,26,596641,79803,69285,56971,0.6320729311874287,0.4165338441516663
2814,0.2816,25,63,25,596704,79740,69310,56946,0.6315739450006337,0.4166191124182433
2815,0.2817,35,62,35,596766,79678,69345,56911,0.631082879229502,0.4166587353300778
2816,0.2818,21,51,21,596817,79627,69366,56890,0.6306789380306679,0.4167246570024246
2817,0.2819,16,55,16,596872,79572,69382,56874,0.6302433151691801,0.4168242381601513
2818,0.282,24,59,24,596931,79513,69406,56850,0.6297760106450386,0.41690194554241256
2819,0.2821,18,56,18,596987,79457,69424,56832,0.6293324673678875,0.4169962359398044
2820,0.2822,22,67,22,597054,79390,69446,56810,0.6288017995184387,0.4171071953010279
2821,0.2823,27,43,27,597097,79347,69473,56783,0.6284612216449119,0.4171233379857489
2822,0.2824,23,60,23,597157,79287,69496,56760,0.6279859967051071,0.4172087587377891
2823,0.2825,22,67,22,597224,79220,69518,56738,0.6274553288556584,0.41732005472278205
2824,0.2826,20,66,20,597290,79154,69538,56718,0.626932581421873,0.41743699952896846
2825,0.2827,14,53,14,597343,79101,69552,56704,0.6265127993917121,0.41753985493906703
2826,0.2828,26,62,26,597405,79039,69578,56678,0.6260217336205804,0.4176190160407318
2827,0.2829,25,62,25,597467,78977,69603,56653,0.6255306678494488,0.41770257317702575
2828,0.283,23,51,23,597518,78926,69626,56630,0.6251267266506146,0.41776092537401516
2829,0.2831,20,60,20,597578,78866,69646,56610,0.6246515017108097,0.41785998996132157
2830,0.2832,23,59,23,597637,78807,69669,56587,0.6241841971866684,0.41794318802901165
2831,0.2833,20,64,20,597701,78743,69689,56567,0.6236772905842098,0.4180548370408691
2832,0.2834,16,61,16,597762,78682,69705,56551,0.6231941452287416,0.41817455798510716
2833,0.2835,26,60,26,597822,78622,69731,56525,0.6227189202889367,0.41824827780120905
2834,0.2836,30,49,30,597871,78573,69761,56495,0.6223308199214295,0.41827079693191577
2835,0.2837,34,66,34,597937,78507,69795,56461,0.6218080724876441,0.41832878904629245
2836,0.2838,24,58,24,597995,78449,69819,56437,0.6213486883791661,0.4184051717746838
2837,0.2839,22,68,22,598063,78381,69841,56415,0.620810100114054,0.41852132110745127
2838,0.284,18,63,18,598126,78318,69859,56397,0.6203111139272589,0.4186393497383365
2839,0.2841,22,66,22,598192,78252,69881,56375,0.6197883664934736,0.4187495821789091
2840,0.2842,19,49,19,598241,78203,69900,56356,0.6194002661259663,0.41881999717595997
2841,0.2843,14,62,14,598303,78141,69914,56342,0.6189092003548347,0.4189525813671616
2842,0.2844,24,76,24,598379,78065,69938,56318,0.6183072487644151,0.4190857474531749
2843,0.2845,18,60,18,598439,78005,69956,56300,0.6178320238246103,0.4191951155951007
2844,0.2846,20,54,20,598493,77951,69976,56280,0.617404321378786,0.41927721614232183
2845,0.2847,23,68,23,598561,77883,69999,56257,0.6168657331136738,0.41939018935440586
2846,0.2848,20,59,20,598620,77824,70019,56237,0.6163984285895324,0.41948814345708296
2847,0.2849,24,65,24,598685,77759,70043,56213,0.6158836015714104,0.4195876750365748
2848,0.285,26,56,26,598741,77703,70069,56187,0.6154400582942593,0.4196504593322877
2849,0.2851,20,48,20,598789,77655,70089,56167,0.6150598783424154,0.4197142472837052
2850,0.2852,26,66,26,598855,77589,70115,56141,0.61453713090863,0.4198085695057205
2851,0.2853,22,67,22,598922,77522,70137,56119,0.6140064630591814,0.4199235264626873
2852,0.2854,18,62,18,598984,77460,70155,56101,0.6135153972880497,0.4200402812198172
2853,0.2855,20,62,20,599046,77398,70175,56081,0.613024331516918,0.4201484877771035
2854,0.2856,25,50,25,599096,77348,70200,56056,0.6126283107337473,0.42019729543342027
2855,0.2857,22,88,22,599184,77260,70222,56034,0.6119313141553668,0.4203790118084835
2856,0.2858,21,72,21,599256,77188,70243,56013,0.6113610442276011,0.42051486099954205
2857,0.2859,21,54,21,599310,77134,70264,55992,0.6109333417817767,0.42059402370686416
2858,0.286,25,64,25,599374,77070,70289,55967,0.6104264351793182,0.4206874779196765
2859,0.2861,16,70,16,599444,77000,70305,55951,0.6098720060828793,0.42083925656820936
2860,0.2862,20,65,20,599509,76935,70325,55931,0.6093571790647573,0.4209579576415336
2861,0.2863,17,57,17,599566,76878,70342,55914,0.6089057153719427,0.42106452195915417
2862,0.2864,23,59,23,599625,76819,70365,55891,0.6084384108478013,0.42115138271418884
2863,0.2865,31,74,31,599699,76745,70396,55860,0.6078523000887086,0.42125108404660455
2864,0.2866,25,51,25,599750,76694,70421,55835,0.6074483588898746,0.42130401647941207
2865,0.2867,20,64,20,599814,76630,70441,55815,0.606941452287416,0.4214202121635396
2866,0.2868,22,60,22,599874,76570,70463,55793,0.6064662273476112,0.42151507596533777
2867,0.2869,26,69,26,599943,76501,70489,55767,0.6059197186668356,0.42162125381800586
2868,0.287,15,52,15,599995,76449,70504,55752,0.6055078570523381,0.4217214695804116
2869,0.2871,20,53,20,600048,76396,70524,55732,0.6050880750221772,0.42180310002421895
2870,0.2872,23,45,23,600093,76351,70547,55709,0.6047316563173235,0.4218461305467212
2871,0.2873,29,52,29,600145,76299,70576,55680,0.604319794702826,0.4218852999340804
2872,0.2874,22,75,22,600220,76224,70598,55658,0.60372576352807,0.42202878330628896
2873,0.2875,21,55,21,600275,76169,70619,55637,0.6032901406665822,0.42211280214861235
2874,0.2876,20,56,20,600331,76113,70639,55617,0.602846597389431,0.4222045092234115
2875,0.2877,30,61,30,600392,76052,70669,55587,0.6023634520339627,0.4222684766672491
2876,0.2878,22,68,22,600460,75984,70691,55565,0.6018248637688506,0.42239013599495245
2877,0.2879,18,62,18,600522,75922,70709,55547,0.6013337979977189,0.42251024956453614
2878,0.288,16,67,16,600589,75855,70725,55531,0.6008031301482701,0.4226553818519477
2879,0.2881,26,53,26,600642,75802,70751,55505,0.6003833481181092,0.4227116604598384
2880,0.2882,16,63,16,600705,75739,70767,55489,0.5998843619313141,0.4228442100771177
2881,0.2883,17,62,17,600767,75677,70784,55472,0.5993932961601824,0.42296929446659903
2882,0.2884,24,50,24,600817,75627,70808,55448,0.5989972753770118,0.4230249856952127
2883,0.2885,19,62,19,600879,75565,70827,55429,0.5985062096058801,0.423141517932119
2884,0.2886,18,60,18,600939,75505,70845,55411,0.5980309846660753,0.4232561337040545
2885,0.2887,18,61,18,601000,75444,70863,55393,0.5975478393106071,0.42337412199912866
2886,0.2888,13,54,13,601054,75390,70876,55380,0.5971201368647827,0.423491626519844
2887,0.2889,20,62,20,601116,75328,70896,55360,0.596629071093651,0.4236043095004897
2888,0.289,24,66,24,601182,75262,70920,55336,0.5961063236598657,0.4237124611402931
2889,0.2891,27,50,27,601232,75212,70947,55309,0.595710302876695,0.42375556423870486
2890,0.2892,18,47,18,601279,75165,70965,55291,0.5953380433405145,0.42382872386091863
2891,0.2893,25,73,25,601352,75092,70990,55266,0.5947598529970853,0.4239555685113303
2892,0.2894,25,53,25,601405,75039,71015,55241,0.5943400709669243,0.42401750076757755
2893,0.2895,22,49,22,601454,74990,71037,55219,0.5939519705994171,0.4240797487116866
2894,0.2896,16,54,16,601508,74936,71053,55203,0.5935242681535927,0.4241849099808666
2895,0.2897,19,59,19,601567,74877,71072,55184,0.5930569636294513,0.4242932162600626
2896,0.2898,21,57,21,601624,74820,71093,55163,0.5926054999366367,0.4243862658963095
2897,0.2899,16,58,16,601682,74762,71109,55147,0.5921461158281587,0.4245048456996821
2898,0.29,19,66,19,601748,74696,71128,55128,0.5916233683943734,0.42463643086024155
2899,0.2901,16,73,16,601821,74623,71144,55112,0.5910451780509441,0.42480440898755156
2900,0.2902,16,57,16,601878,74566,71160,55096,0.5905937143581295,0.42492017707578167
2901,0.2903,21,56,21,601934,74510,71181,55075,0.5901501710809783,0.4250106107960026
2902,0.2904,22,58,22,601992,74452,71203,55053,0.5896907869725003,0.4251032778657195
2903,0.2905,18,63,18,602055,74389,71221,55035,0.5891918007857052,0.42523025095809125
2904,0.2906,25,60,25,602115,74329,71246,55010,0.5887165758459004,0.42531641654875946
2905,0.2907,29,63,29,602178,74266,71275,54981,0.5882175896591053,0.4253947867261909
2906,0.2908,17,59,17,602237,74207,71292,54964,0.5877502851349639,0.42551346664498996
2907,0.2909,19,60,19,602297,74147,71311,54945,0.5872750601951591,0.4256266848449168
2908,0.291,16,58,16,602355,74089,71327,54929,0.5868156760866811,0.4257467950208498
2909,0.2911,22,49,22,602404,74040,71349,54907,0.5864275757191737,0.42581060435682877
2910,0.2912,16,48,16,602452,73992,71365,54891,0.5860473957673299,0.42589790740439004
2911,0.2913,14,65,14,602517,73927,71379,54877,0.585532568749208,0.4260504332163597
2912,0.2914,23,59,23,602576,73868,71402,54854,0.5850652642250666,0.4261431612311804
2913,0.2915,18,56,18,602632,73812,71420,54836,0.5846217209479153,0.42624836763882845
2914,0.2916,22,54,22,602686,73758,71442,54814,0.584194018502091,0.42632921631459414
2915,0.2917,19,49,19,602735,73709,71461,54795,0.5838059181345837,0.4264069600946274
2916,0.2918,21,65,21,602800,73644,71482,54774,0.5832910911164618,0.42652899126290705
2917,0.2919,22,54,22,602854,73590,71504,54752,0.5828633886706375,0.42661015100278943
2918,0.292,21,62,21,602916,73528,71525,54731,0.5823723228995058,0.4267224912091939
2919,0.2921,26,58,26,602974,73470,71551,54705,0.5819129387910278,0.4267992978349912
2920,0.2922,17,60,17,603034,73410,71568,54688,0.5814377138512229,0.42692313697325485
2921,0.2923,19,54,19,603088,73356,71587,54669,0.5810100114053985,0.4270181605155243
2922,0.2924,30,63,30,603151,73293,71617,54639,0.5805110252186034,0.4270940812306538
2923,0.2925,27,56,27,603207,73237,71644,54612,0.5800674819414523,0.42716016550774744
2924,0.2926,26,56,26,603263,73181,71670,54586,0.5796239386643011,0.42723081859948187
2925,0.2927,24,58,24,603321,73123,71694,54562,0.579164554555823,0.4273172259858245
2926,0.2928,17,50,17,603371,73073,71711,54545,0.5787685337726524,0.42740835932235266
2927,0.2929,26,62,26,603433,73011,71737,54519,0.5782774680015207,0.4274994119030816
2928,0.293,21,60,21,603493,72951,71758,54498,0.5778022430617159,0.42760633665230796
2929,0.2931,16,55,16,603548,72896,71774,54482,0.5773666202002281,0.4277190723672848
2930,0.2932,14,51,14,603599,72845,71788,54468,0.576962679001394,0.4278274803044465
2931,0.2933,15,62,15,603661,72783,71803,54453,0.5764716132302623,0.4279684994812789
2932,0.2934,26,70,26,603731,72713,71829,54427,0.5759171841338233,0.42808714802579834
2933,0.2935,20,61,20,603792,72652,71849,54407,0.5754340387783551,0.4282026460148435
2934,0.2936,13,43,13,603835,72609,71862,54394,0.5750934609048283,0.4282890955331764
2935,0.2937,23,51,23,603886,72558,71885,54371,0.5746895197059941,0.428357585736908
2936,0.2938,26,44,26,603930,72514,71911,54345,0.574341021416804,0.4283889988097021
2937,0.2939,24,77,24,604007,72437,71935,54321,0.5737311494107211,0.42854099938465423
2938,0.294,26,46,26,604053,72391,71961,54295,0.573366810290204,0.42857932210346844
2939,0.2941,17,50,17,604103,72341,71978,54278,0.5729707895070333,0.4286718422985492
2940,0.2942,14,56,14,604159,72285,71992,54264,0.5725272462298822,0.42879833108124127
2941,0.2943,26,45,26,604204,72240,72018,54238,0.5721708275250285,0.4288334730150698
2942,0.2944,23,54,23,604258,72186,72041,54215,0.5717431250792041,0.4289127459434656
2943,0.2945,27,55,27,604313,72131,72068,54188,0.5713075022177164,0.42897743015698353
2944,0.2946,26,44,26,604357,72087,72094,54162,0.5709590039285262,0.4290093386878312
2945,0.2947,20,51,20,604408,72036,72114,54142,0.570555062729692,0.4290922347794386
2946,0.2948,22,51,22,604459,71985,72136,54120,0.5701511215308579,0.42916617104793625
2947,0.2949,16,50,16,604509,71935,72152,54104,0.5697551007476872,0.42926395798125977
2948,0.295,28,65,28,604574,71870,72180,54076,0.5692402737295653,0.4293586140091785
2949,0.2951,16,48,16,604622,71822,72196,54060,0.5688600937777215,0.4294498021957071
2950,0.2952,26,62,26,604684,71760,72222,54034,0.5683690280065898,0.42954353943749307
2951,0.2953,17,58,17,604742,71702,72239,54017,0.5679096438981118,0.42966456939682945
2952,0.2954,21,55,21,604797,71647,72260,53996,0.567474021036624,0.4297573283032083
2953,0.2955,18,48,18,604845,71599,72278,53978,0.5670938410847801,0.42983985920988715
2954,0.2956,26,66,26,604911,71533,72304,53952,0.5665710936509948,0.42994780252619835
2955,0.2957,20,62,20,604973,71471,72324,53932,0.5660800278798631,0.43006945607361863
2956,0.2958,17,56,17,605029,71415,72341,53915,0.565636484602712,0.4301843134125908
2957,0.2959,22,52,22,605081,71363,72363,53893,0.5652246229882144,0.4302628217410743
2958,0.296,32,63,32,605144,71300,72395,53861,0.5647256368014193,0.43033373015555965
2959,0.2961,18,53,18,605197,71247,72413,53843,0.5643058547712584,0.43043408745703093
2960,0.2962,16,62,16,605259,71185,72429,53827,0.5638147890001267,0.4305746648321761
2961,0.2963,25,51,25,605310,71134,72454,53802,0.5634108478012926,0.43063648588077097
2962,0.2964,19,53,19,605363,71081,72473,53783,0.5629910657711317,0.4307326371091748
2963,0.2965,24,47,24,605410,71034,72497,53759,0.5626188062349512,0.43078538059025745
2964,0.2966,19,54,19,605464,70980,72516,53740,0.5621911037891268,0.4308851828094933
2965,0.2967,22,47,22,605511,70933,72538,53718,0.5618188442529464,0.4309472045952299
2966,0.2968,23,63,23,605574,70870,72561,53695,0.5613198580661514,0.4310600891101032
2967,0.2969,18,63,18,605637,70807,72579,53677,0.5608208718793563,0.4311959769930272
2968,0.297,28,54,28,605691,70753,72607,53649,0.5603931694335319,0.43125512451568304
2969,0.2971,22,61,22,605752,70692,72629,53627,0.5599100240780636,0.43136608241700786
2970,0.2972,20,47,20,605799,70645,72649,53607,0.5595377645418832,0.4314377233364453
2971,0.2973,23,61,23,605860,70584,72672,53584,0.5590546191864149,0.4315443592552026
2972,0.2974,15,70,15,605930,70514,72687,53569,0.5585001900899759,0.4317190912534352
2973,0.2975,28,54,28,605984,70460,72715,53541,0.5580724876441515,0.4317787759776131
2974,0.2976,21,53,21,606037,70407,72736,53520,0.5576527056139906,0.4318671475949551
2975,0.2977,21,61,21,606098,70346,72757,53499,0.5571695602585224,0.43198352779684285
2976,0.2978,20,52,20,606150,70294,72777,53479,0.5567576986440248,0.43207323083386523
2977,0.2979,16,61,16,606211,70233,72793,53463,0.5562745532885566,0.4322128443927047
2978,0.298,23,58,23,606269,70175,72816,53440,0.5558151691800786,0.4323099947417385
2979,0.2981,14,44,14,606313,70131,72830,53426,0.5554666708908883,0.4323996212274497
2980,0.2982,25,65,25,606378,70066,72855,53401,0.5549518438727664,0.43251233123020727
2981,0.2983,27,58,27,606436,70008,72882,53374,0.5544924597642884,0.43259146390883596
2982,0.2984,11,68,11,606504,69940,72893,53363,0.5539538714991763,0.4327794133151667
2983,0.2985,19,43,19,606547,69897,72912,53344,0.5536132936256495,0.4328429662206571
2984,0.2986,23,41,23,606588,69856,72935,53321,0.5532885565834496,0.4328811385242375
2985,0.2987,16,53,16,606641,69803,72951,53305,0.5528687745532885,0.43299379406699806
2986,0.2988,14,49,14,606690,69754,72965,53291,0.5524806741857813,0.4331017107562274
2987,0.2989,24,58,24,606748,69696,72989,53267,0.5520212900773033,0.4331953514471833
2988,0.299,18,67,18,606815,69629,73007,53249,0.5514906222278545,0.4333485245528085
2989,0.2991,28,82,28,606897,69547,73035,53221,0.5508411481434545,0.433508731917112
2990,0.2992,17,55,17,606952,69492,73052,53204,0.5504055252819668,0.43362456803807786
2991,0.2993,25,51,25,607003,69441,73077,53179,0.5500015840831327,0.43368944707225576
2992,0.2994,23,42,23,607045,69399,73100,53156,0.5496689266252693,0.43373179388845823
2993,0.2995,26,60,26,607105,69339,73126,53130,0.5491937016854644,0.4338240697645935
2994,0.2996,17,51,17,607156,69288,73143,53113,0.5487897604866303,0.4339261934134525
2995,0.2997,28,44,28,607200,69244,73171,53085,0.5484412621974402,0.4339527013218452
2996,0.2998,18,57,18,607257,69187,73189,53067,0.5479897985046255,0.4340716868159733
2997,0.2999,25,72,25,607329,69115,73214,53042,0.5474195285768597,0.434211711158591
2998,0.3,18,43,18,607372,69072,73232,53024,0.5470789507033329,0.43428122133403224
2999,0.3001,20,39,20,607411,69033,73252,53004,0.5467700544924597,0.4343272941812729
3000,0.3002,21,46,21,607457,68987,73273,52983,0.5464057153719427,0.4343937033696811
3001,0.3003,18,57,18,607514,68930,73291,52965,0.5459542516791281,0.4345133106362033
3002,0.3004,22,46,22,607560,68884,73313,52943,0.5455899125586111,0.43457525835816363
3003,0.3005,29,41,29,607601,68843,73342,52914,0.5452651755164111,0.4345869231337829
3004,0.3006,13,44,13,607645,68799,73355,52901,0.5449166772272209,0.43468364831552997
3005,0.3007,18,62,18,607707,68737,73373,52883,0.5444256114560893,0.4348215753987831
3006,0.3008,21,60,21,607767,68677,73394,52862,0.5439503865162844,0.4349385793860407
3007,0.3009,28,37,28,607804,68640,73422,52834,0.5436573311367381,0.4349408103791758
3008,0.301,21,56,21,607860,68584,73443,52813,0.5432137878595868,0.43504369959718936
3009,0.3011,20,50,20,607910,68534,73463,52793,0.5428177670764162,0.43512985567928
3010,0.3012,16,52,16,607962,68482,73479,52777,0.5424059054619187,0.4352419201873675
3011,0.3013,22,46,22,608008,68436,73501,52755,0.5420415663414015,0.4353046018268683
3012,0.3014,17,51,17,608059,68385,73518,52738,0.5416376251425675,0.4354086341982943
3013,0.3015,14,47,14,608106,68338,73532,52724,0.541265365606387,0.43551238208521253
3014,0.3016,22,45,22,608151,68293,73554,52702,0.5409089469015333,0.43557171783958015
3015,0.3017,19,55,19,608206,68238,73573,52683,0.5404733240400457,0.43568114719527623
3016,0.3018,26,72,26,608278,68166,73599,52657,0.5399030541122798,0.43581933903313114
3017,0.3019,29,50,29,608328,68116,73628,52628,0.5395070333291091,0.4358643079573312
3018,0.302,24,52,24,608380,68064,73652,52604,0.5390951717146116,0.43593993436536616
3019,0.3021,16,48,16,608428,68016,73668,52588,0.5387149917627677,0.43603860568472025
3020,0.3022,20,52,20,608480,67964,73688,52568,0.5383031301482701,0.43613314306574186
3021,0.3023,20,45,20,608525,67919,73708,52548,0.5379467114434165,0.43620244548299536
3022,0.3024,16,57,16,608582,67862,73724,52532,0.537495247750602,0.436334036579896
3023,0.3025,17,55,17,608637,67807,73741,52515,0.5370596248891142,0.43645384883894883
3024,0.3026,29,51,29,608688,67756,73770,52486,0.53665568369028,0.4365030521781075
3025,0.3027,22,48,22,608736,67708,73792,52464,0.5362755037384362,0.436574243584196
3026,0.3028,23,44,23,608780,67664,73815,52441,0.535927005449246,0.4366262853336664
3027,0.3029,13,51,13,608831,67613,73828,52428,0.5355230642504119,0.4367507768179205
3028,0.303,20,46,20,608877,67567,73848,52408,0.5351587251298948,0.4368243384038341
3029,0.3031,17,49,17,608926,67518,73865,52391,0.5347706247623876,0.43692299994162237
3030,0.3032,28,42,28,608968,67476,73893,52363,0.5344379673045241,0.4369445672944534
3031,0.3033,21,51,21,609019,67425,73914,52342,0.5340340261056901,0.43703190361284827
3032,0.3034,12,59,12,609078,67366,73926,52330,0.5335667215815486,0.43719088357171504
3033,0.3035,24,42,24,609120,67324,73950,52306,0.5332340641236852,0.437231463679679
3034,0.3036,19,45,19,609165,67279,73969,52287,0.5328776454188315,0.43730659217503304
3035,0.3037,25,56,25,609221,67223,73994,52262,0.5324341021416804,0.4373938151232372
3036,0.3038,14,38,14,609259,67185,74008,52248,0.5321331263464707,0.43746703172490015
3037,0.3039,23,63,23,609322,67122,74031,52225,0.5316341401596756,0.43758954980016257
3038,0.304,19,58,19,609380,67064,74050,52206,0.5311747560511976,0.43771275257818393
3039,0.3041,14,40,14,609420,67024,74064,52192,0.530857939424661,0.4377935847537243
3040,0.3042,18,50,18,609470,66974,74082,52174,0.5304619186414903,0.43789236915432905
3041,0.3043,26,57,26,609527,66917,74108,52148,0.5300104549486757,0.4379792550287658
3042,0.3044,27,54,27,609581,66863,74135,52121,0.5295827525028514,0.438050494184092
3043,0.3045,29,48,29,609629,66815,74164,52092,0.5292025725510074,0.43809027222955754
3044,0.3046,12,50,12,609679,66765,74176,52080,0.5288065517678368,0.4382178467752114
3045,0.3047,13,63,13,609742,66702,74189,52067,0.5283075655810416,0.4383888051595955
3046,0.3048,17,47,17,609789,66655,74206,52050,0.5279353060448613,0.4384819510551367
3047,0.3049,22,53,22,609842,66602,74228,52028,0.5275155240147003,0.4385737165978252
3048,0.305,21,43,21,609885,66559,74249,52007,0.5271749461411734,0.43863333502015756
3049,0.3051,22,48,22,609933,66511,74271,51985,0.5267947661893296,0.4387067917904402
3050,0.3052,19,50,19,609983,66461,74290,51966,0.5263987454061589,0.4388019623903333
3051,0.3053,17,38,17,610021,66423,74307,51949,0.5260977696109492,0.4388622309329909
3052,0.3054,20,62,20,610083,66361,74327,51929,0.5256067038398176,0.4389973793220052
3053,0.3055,23,55,23,610138,66306,74350,51906,0.5251710809783298,0.43909247792102324
3054,0.3056,22,47,22,610185,66259,74372,51884,0.5247988214421493,0.43916270959769094
3055,0.3057,20,53,20,610238,66206,74392,51864,0.5243790394119884,0.4392648428898111
3056,0.3058,20,64,20,610302,66142,74412,51844,0.5238721328095298,0.4394080653636872
3057,0.3059,18,45,18,610347,66097,74430,51826,0.5235157141046762,0.4394901757926783
3058,0.306,18,54,18,610401,66043,74448,51808,0.5230880116588519,0.43960594309764023
3059,0.3061,18,56,18,610457,65987,74466,51790,0.5226444683817006,0.43972931896720074
3060,0.3062,24,48,24,610505,65939,74490,51766,0.5222642884298568,0.43979440125738073
3061,0.3063,20,51,20,610556,65888,74510,51746,0.5218603472310227,0.4398898277708826
3062,0.3064,15,46,15,610602,65842,74525,51731,0.5214960081105057,0.43999047400338515
3063,0.3065,34,56,34,610658,65786,74559,51697,0.5210524648333544,0.4400381331767149
3064,0.3066,23,41,23,610699,65745,74582,51674,0.5207277277911545,0.4400820991492007
3065,0.3067,23,54,23,610753,65691,74605,51651,0.5203000253453302,0.4401748734468477
3066,0.3068,14,40,14,610793,65651,74619,51637,0.5199832087187936,0.44025816792851785
3067,0.3069,26,48,26,610841,65603,74645,51611,0.5196030287669496,0.44031429692698826
3068,0.307,23,52,23,610893,65551,74668,51588,0.5191911671524522,0.44039986682488325
3069,0.3071,23,57,23,610950,65494,74691,51565,0.5187397034596376,0.44050436104870194
3070,0.3072,17,56,17,611006,65438,74708,51548,0.5182961601824864,0.44063392200776164
3071,0.3073,23,48,23,611054,65390,74731,51525,0.5179159802306426,0.4407047855279477
3072,0.3074,24,54,24,611108,65336,74755,51501,0.5174882777848181,0.4407935842241756
3073,0.3075,20,62,20,611170,65274,74775,51481,0.5169972120136864,0.4409318658729819
3074,0.3076,16,48,16,611218,65226,74791,51465,0.5166170320618426,0.44103658379823635
3075,0.3077,17,48,17,611266,65178,74808,51448,0.5162368521099987,0.44113662476634713
3076,0.3078,21,35,21,611301,65143,74829,51427,0.5159596375617792,0.44116839667152785
3077,0.3079,27,63,27,611364,65080,74856,51400,0.5154606513749842,0.4412774725274725
3078,0.308,19,43,19,611407,65037,74875,51381,0.5151200735014574,0.4413492758851724
3079,0.3081,13,41,13,611448,64996,74888,51368,0.5147953364592573,0.4414423704925922
3080,0.3082,19,48,19,611496,64948,74907,51349,0.5144151565074135,0.4415333155627402
3081,0.3083,24,44,24,611540,64904,74931,51325,0.5140666582182233,0.4415851465641105
3082,0.3084,22,51,22,611591,64853,74953,51303,0.5136627170193891,0.44167326698577775
3083,0.3085,21,43,21,611634,64810,74974,51282,0.5133221391458623,0.4417358646590635
3084,0.3086,21,41,21,611675,64769,74995,51261,0.5129974021036624,0.441790916142377
3085,0.3087,17,49,17,611724,64720,75012,51244,0.5126093017361552,0.44189576075333725
3086,0.3088,21,56,21,611780,64664,75033,51223,0.5121657584590039,0.4420081631244229
3087,0.3089,15,41,15,611821,64623,75048,51208,0.511841021416804,0.4420923586949953
3088,0.309,13,34,13,611855,64589,75061,51195,0.5115717272842478,0.4421595384509086
3089,0.3091,23,53,23,611908,64536,75084,51172,0.5111519452540869,0.44225118401493413
3090,0.3092,14,63,14,611971,64473,75098,51158,0.5106529590672918,0.44242460931757055
3091,0.3093,19,43,19,612014,64430,75117,51139,0.5103123811937651,0.44249755557286125
3092,0.3094,18,62,18,612076,64368,75135,51121,0.5098213154226334,0.4426482175791634
3093,0.3095,19,51,19,612127,64317,75154,51102,0.5094173742237993,0.4427520598861539
3094,0.3096,18,57,18,612184,64260,75172,51084,0.5089659105309846,0.44288389513108617
3095,0.3097,16,41,16,612225,64219,75188,51068,0.5086411734887847,0.44296408094581347
3096,0.3098,19,45,19,612270,64174,75207,51049,0.5082847547839311,0.4430452253456341
3097,0.3099,26,48,26,612318,64126,75233,51023,0.5079045748320872,0.4431041520117413
3098,0.31,19,40,19,612358,64086,75252,51004,0.5075877582055506,0.4431662177426362
3099,0.3101,21,52,21,612410,64034,75273,50983,0.5071758965910531,0.4432649086656755
3100,0.3102,18,60,18,612470,63974,75291,50965,0.5067006716512482,0.44340911265975863
3101,0.3103,9,59,9,612529,63915,75300,50956,0.5062333671271069,0.4435932480782791
3102,0.3104,18,56,18,612585,63859,75318,50938,0.5057898238499556,0.443722396926749
3103,0.3105,23,51,23,612636,63808,75341,50915,0.5053858826511215,0.44380812914585566
3104,0.3106,19,47,19,612683,63761,75360,50896,0.505013623114941,0.44389788674045194
3105,0.3107,21,46,21,612729,63715,75381,50875,0.504649283994424,0.4439741687756349
3106,0.3108,19,44,19,612773,63671,75400,50856,0.5043007857052338,0.44405249417168
3107,0.3109,23,44,23,612817,63627,75423,50833,0.5039522874160436,0.44411147999301065
3108,0.311,16,48,16,612865,63579,75439,50817,0.5035721074641997,0.4442200776250918
3109,0.3111,22,61,22,612926,63518,75461,50795,0.5030889621087314,0.444350161398966
3110,0.3112,21,32,21,612958,63486,75482,50774,0.5028355088075022,0.44437248380885697
3111,0.3113,18,48,18,613006,63438,75500,50756,0.5024553288556584,0.4444716885300454
3112,0.3114,16,39,16,613045,63399,75516,50740,0.5021464326447852,0.44454568552379115
3113,0.3115,20,53,20,613098,63346,75536,50720,0.5017266506146243,0.4446548489471008
3114,0.3116,16,47,16,613145,63299,75552,50704,0.5013543910784438,0.444760225608098
3115,0.3117,17,63,17,613208,63236,75569,50687,0.5008554048916487,0.4449233254040009
3116,0.3118,14,60,14,613268,63176,75583,50673,0.5003801799518439,0.44508954843696474
3117,0.3119,19,45,19,613313,63131,75602,50654,0.5000237612469902,0.44517291382871205
3118,0.312,24,46,24,613359,63085,75626,50630,0.4996594221264732,0.4452358967594425
3119,0.3121,19,41,19,613400,63044,75645,50611,0.4993346850842732,0.4453037701816902
3120,0.3122,15,50,15,613450,62994,75660,50596,0.4989386643011025,0.44542653402588256
3121,0.3123,20,38,20,613488,62956,75680,50576,0.4986376885058928,0.44547792692809074
3122,0.3124,15,30,15,613518,62926,75695,50561,0.49840007603599035,0.4455223946355089
3123,0.3125,20,35,20,613553,62891,75715,50541,0.49812286148777085,0.4455620988786233
3124,0.3126,14,37,14,613590,62854,75729,50527,0.4978298061082246,0.4456390400508022
3125,0.3127,18,58,18,613648,62796,75747,50509,0.49737042199974657,0.4457790918317815
3126,0.3128,21,41,21,613689,62755,75768,50488,0.4970456849575466,0.44583771182324733
3127,0.3129,23,41,23,613730,62714,75791,50465,0.4967209479153466,0.4458866044054109
3128,0.313,25,34,25,613764,62680,75816,50440,0.49645165378279055,0.4458981612446959
3129,0.3131,17,37,17,613801,62643,75833,50423,0.4961585984032442,0.44596076627810305
3130,0.3132,15,63,15,613864,62580,75848,50408,0.4956596122164491,0.4461358728360534
3131,0.3133,23,57,23,613921,62523,75871,50385,0.49520814852363454,0.4462482729301732
3132,0.3134,17,56,17,613977,62467,75888,50368,0.49476460524648336,0.4463863163025657
3133,0.3135,26,52,26,614029,62415,75914,50342,0.4943527436319858,0.4464645210496909
3134,0.3136,13,51,13,614080,62364,75927,50329,0.4939488024331517,0.44660271711641364
3135,0.3137,20,34,20,614114,62330,75947,50309,0.4936795083005956,0.44663926348777955
3136,0.3138,16,51,16,614165,62279,75963,50293,0.4932755671017615,0.44676296059410864
3137,0.3139,15,44,15,614209,62235,75978,50278,0.49292706881257126,0.44686391794725944
3138,0.314,18,34,18,614243,62201,75996,50260,0.4926577746800152,0.4469104845235237
3139,0.3141,23,47,23,614290,62154,76019,50237,0.49228551514383473,0.4469841891254638
3140,0.3142,22,55,22,614345,62099,76041,50215,0.491849892282347,0.44709475221254696
3141,0.3143,6,50,6,614395,62049,76047,50209,0.4914538714991763,0.44726433750823996
3142,0.3144,19,50,19,614445,61999,76066,50190,0.49105785071600555,0.447370063018656
3143,0.3145,20,50,20,614495,61949,76086,50170,0.49066182993283486,0.44747099064386947
3144,0.3146,19,35,19,614530,61914,76105,50151,0.49038461538461536,0.44751706598848884
3145,0.3147,16,65,16,614595,61849,76121,50135,0.4898697883664935,0.44769788541220173
3146,0.3148,21,52,21,614647,61797,76142,50114,0.48945792675199595,0.44780227144784696
3147,0.3149,19,57,19,614704,61740,76161,50095,0.48900646305918133,0.4479366924486967
3148,0.315,28,45,28,614749,61695,76189,50067,0.48865004435432774,0.4479787405379288
3149,0.3151,15,46,15,614795,61649,76204,50052,0.48828570523381065,0.44808909499467325
3150,0.3152,27,47,27,614842,61602,76231,50025,0.48791344569763023,0.44814426617216263
3151,0.3153,22,52,22,614894,61550,76253,50003,0.48750158408313266,0.4482443322904808
3152,0.3154,12,42,12,614936,61508,76265,49991,0.4871689266252693,0.4483537968950394
3153,0.3155,13,43,13,614979,61465,76278,49978,0.48682834875174247,0.4484624426837038
3154,0.3156,22,52,22,615031,61413,76300,49956,0.48641648713724495,0.4485628855426555
3155,0.3157,19,46,19,615077,61367,76319,49937,0.4860521480167279,0.4486541364191763
3156,0.3158,22,47,22,615124,61320,76341,49915,0.48567988848054744,0.4487346608531487
3157,0.3159,15,47,15,615171,61273,76356,49900,0.485307628944367,0.4488499905552607
3158,0.316,22,57,22,615228,61216,76378,49878,0.4848561652515524,0.4489711415557996
3159,0.3161,13,40,13,615268,61176,76391,49865,0.48453934862501585,0.44906836213650814
3160,0.3162,18,48,18,615316,61128,76409,49847,0.484159168673172,0.4491732372155891
3161,0.3163,21,53,21,615369,61075,76430,49826,0.483739386643011,0.44928359527867195
3162,0.3164,23,30,23,615399,61045,76453,49803,0.4835017741731086,0.44929092090069284
3163,0.3165,16,33,16,615432,61012,76469,49787,0.48324040045621597,0.44934521069684746
3164,0.3166,13,54,13,615486,60958,76482,49774,0.48281269801039156,0.4494996929523534
3165,0.3167,15,35,15,615521,60923,76497,49759,0.4825354834621721,0.44956722863699605
3166,0.3168,19,58,19,615579,60865,76516,49740,0.48207609935369405,0.4497084218615795
3167,0.3169,19,44,19,615623,60821,76535,49721,0.48172760106450385,0.4497928389209531
3168,0.317,18,54,18,615677,60767,76553,49703,0.4812998986186795,0.44992305603331223
3169,0.3171,25,39,25,615716,60728,76578,49678,0.48099100240780635,0.449957429849827
3170,0.3172,18,55,18,615771,60673,76596,49660,0.4805553795463186,0.4500919942356321
3171,0.3173,20,58,20,615829,60615,76616,49640,0.4800959954378406,0.45022901455716297
3172,0.3174,21,51,21,615880,60564,76637,49619,0.47969205423900646,0.45033262844540445
3173,0.3175,21,38,21,615918,60526,76658,49598,0.47939107844379675,0.45038320438778107
3174,0.3176,16,55,16,615973,60471,76674,49582,0.47895545558230895,0.45052838177968796
3175,0.3177,18,44,18,616017,60427,76692,49564,0.47860695729311875,0.45061868698348045
3176,0.3178,11,53,11,616070,60374,76703,49553,0.4781871752629578,0.45078097282742186
3177,0.3179,29,45,29,616115,60329,76732,49524,0.47783075655810414,0.4508206421308476
3178,0.318,25,50,25,616165,60279,76757,49499,0.47743473577493345,0.45090090910747144
3179,0.3181,17,42,17,616207,60237,76774,49482,0.4771020783170701,0.45098843409072265
3180,0.3182,14,42,14,616249,60195,76788,49468,0.4767694208592067,0.4510910699141917
3181,0.3183,20,39,20,616288,60156,76808,49448,0.47646052464833355,0.451151417831466
3182,0.3184,18,35,18,616323,60121,76826,49430,0.47618331010011405,0.45120537466568084
3183,0.3185,23,37,23,616360,60084,76849,49407,0.47589025472056773,0.45124256788229167
3184,0.3186,20,50,20,616410,60034,76869,49387,0.47549423393739704,0.4513484614470714
3185,0.3187,27,53,27,616463,59981,76896,49360,0.4750744519072361,0.4514317593583377
3186,0.3188,17,50,17,616513,59931,76913,49343,0.4746784311240654,0.4515529769204019
3187,0.3189,21,40,21,616553,59891,76934,49322,0.47436161449752884,0.45161290322580644
3188,0.319,27,41,27,616594,59850,76961,49295,0.47403687745532885,0.45164689174950756
3189,0.3191,24,49,24,616643,59801,76985,49271,0.47364877708782155,0.4517291330497286
3190,0.3192,22,54,22,616697,59747,77007,49249,0.4732210746419972,0.4518422694410804
3191,0.3193,20,35,20,616732,59712,77027,49229,0.4729438600937777,0.4518868011125288
3192,0.3194,22,47,22,616779,59665,77049,49207,0.4725716005575973,0.4519711220515835
3193,0.3195,24,51,24,616830,59614,77073,49183,0.47216765935876315,0.45206209730047703
3194,0.3196,20,52,20,616882,59562,77093,49163,0.4717557977442656,0.4521775120717406
3195,0.3197,20,45,20,616927,59517,77113,49143,0.471399379039412,0.452263942573164
3196,0.3198,22,45,22,616972,59472,77135,49121,0.47104296033455834,0.45234039026456585
3197,0.3199,22,44,22,617016,59428,77157,49099,0.47069446204536813,0.4524127636440701
3198,0.32,13,44,13,617060,59384,77170,49086,0.47034596375617793,0.45253065363695033
3199,0.3201,16,51,16,617111,59333,77186,49070,0.4699420225573438,0.45266274918590815
3200,0.3202,18,55,18,617166,59278,77204,49052,0.46950639969585606,0.4528016246653743
3201,0.3203,20,45,20,617211,59233,77224,49032,0.4691499809910024,0.45288874520851613
3202,0.3204,20,35,20,617246,59198,77244,49012,0.4688727664427829,0.4529341096017004
3203,0.3205,24,39,24,617285,59159,77268,48988,0.46856387023190976,0.45297604186893764
3204,0.3206,27,44,27,617329,59115,77295,48961,0.46821537194271956,0.45302379806802623
3205,0.3207,22,44,22,617373,59071,77317,48939,0.46786687365352936,0.4530969354689381
3206,0.3208,21,43,21,617416,59028,77338,48918,0.46752629578000254,0.45317102995942415
3207,0.3209,15,50,15,617466,58978,77353,48903,0.46713027499683185,0.45330503054291305
3208,0.321,16,40,16,617506,58938,77369,48887,0.46681345837029525,0.4533920704845815
3209,0.3211,27,42,27,617548,58896,77396,48860,0.4664808009124319,0.45343182746204386
3210,0.3212,21,35,21,617583,58861,77417,48839,0.4662035863642124,0.45347260909935005
3211,0.3213,18,49,18,617632,58812,77435,48821,0.4658154859967051,0.453587654343928
3212,0.3214,24,42,24,617674,58770,77459,48797,0.4654828285388417,0.4536428458542118
3213,0.3215,16,47,16,617721,58723,77475,48781,0.46511056900266123,0.4537598600982289
3214,0.3216,19,40,19,617761,58683,77494,48762,0.4647937523761247,0.45383219321513335
3215,0.3217,20,42,20,617803,58641,77514,48742,0.4644610949182613,0.4539079742603578
3216,0.3218,21,43,21,617846,58598,77535,48721,0.4641205170447345,0.4539829853054911
3217,0.3219,11,41,11,617887,58557,77546,48710,0.4637957800025345,0.45410051553599895
3218,0.322,24,31,24,617918,58526,77570,48686,0.4635502471169687,0.45410961459538113
3219,0.3221,23,46,23,617964,58480,77593,48663,0.46318590799645165,0.45418739441680744
3220,0.3222,17,36,17,618000,58444,77610,48646,0.46290077303256877,0.45425343169296856
3221,0.3223,22,47,22,618047,58397,77632,48624,0.4625285134963883,0.4543407368647275
3222,0.3224,23,42,23,618089,58355,77655,48601,0.4621958560385249,0.45440181009013053
3223,0.3225,23,42,23,618131,58313,77678,48578,0.4618631985806615,0.45446295759231364
3224,0.3226,24,44,24,618175,58269,77702,48554,0.4615147002914713,0.45452758301114926
3225,0.3227,27,42,27,618217,58227,77729,48527,0.4611820428336079,0.45456844708395
3226,0.3228,17,42,17,618259,58185,77746,48510,0.4608493853757445,0.4546604808097849
3227,0.3229,28,54,28,618313,58131,77774,48482,0.46042168292992014,0.45474754485850694
3228,0.323,21,48,21,618361,58083,77795,48461,0.4600415029780763,0.454844946688692
3229,0.3231,26,45,26,618406,58038,77821,48435,0.45968508427322263,0.4549040601842721
3230,0.3232,18,54,18,618460,57984,77839,48417,0.4592573818273983,0.4550427157639496
3231,0.3233,23,53,23,618513,57931,77862,48394,0.45883759979723737,0.45515165765342114
3232,0.3234,10,38,10,618551,57893,77872,48384,0.4585366240020276,0.4552631331332273
3233,0.3235,27,43,27,618594,57850,77899,48357,0.45819604612850084,0.45530897210165056
3234,0.3236,22,45,22,618639,57805,77921,48335,0.4578396274236472,0.45538910872432636
3235,0.3237,24,60,24,618699,57745,77945,48311,0.45736440248384236,0.45552349702044204
3236,0.3238,23,44,23,618743,57701,77968,48288,0.45701590419465216,0.4555944484805027
3237,0.3239,16,33,16,618776,57668,77984,48272,0.4567545304777595,0.4556541438550123
3238,0.324,23,46,23,618822,57622,78007,48249,0.4563901913572424,0.45573386479772554
3239,0.3241,15,51,15,618873,57571,78022,48234,0.4559862501584083,0.4558763763527244
3240,0.3242,25,48,25,618921,57523,78047,48209,0.45560607020656446,0.4559546778647902
3241,0.3243,21,34,21,618955,57489,78068,48188,0.45533677607400835,0.45599326248852634
3242,0.3244,19,32,19,618987,57457,78087,48169,0.45508332277277913,0.45603355234506654
3243,0.3245,15,45,15,619032,57412,78102,48154,0.4547269040679255,0.4561506545668113
3244,0.3246,16,35,16,619067,57377,78118,48138,0.454449689519706,0.4562194948585509
3245,0.3247,13,49,13,619116,57328,78131,48125,0.4540615891521987,0.4563644467203399
3246,0.3248,17,37,17,619153,57291,78148,48108,0.4537685337726524,0.4564369680926764
3247,0.3249,23,47,23,619200,57244,78171,48085,0.45339627423647194,0.4565219455230753
3248,0.325,25,39,25,619239,57205,78196,48060,0.4530873780255988,0.4565620101648221
3249,0.3251,22,48,22,619287,57157,78218,48038,0.4527071980737549,0.45665668520366937
3250,0.3252,18,42,18,619329,57115,78236,48020,0.4523745406158915,0.45674608836258146
3251,0.3253,17,48,17,619377,57067,78253,48003,0.45199436066404763,0.45686685067098126
3252,0.3254,16,45,16,619422,57022,78269,47987,0.45163794195919404,0.4569798779152263
3253,0.3255,21,47,21,619469,56975,78290,47966,0.45126568242301357,0.4570758807329833
3254,0.3256,16,52,16,619521,56923,78306,47950,0.45085382080851605,0.45721968476156877
3255,0.3257,18,46,18,619567,56877,78324,47932,0.45048948168799896,0.4573271379366276
3256,0.3258,31,38,31,619605,56839,78355,47901,0.45018850589278925,0.45733244223792247
3257,0.3259,22,42,22,619647,56797,78377,47879,0.4498558484349259,0.4574018877297566
3258,0.326,22,35,22,619682,56762,78399,47857,0.4495786338867064,0.45744080903086437
3259,0.3261,24,48,24,619730,56714,78423,47833,0.4491984539348625,0.457526280046295
3260,0.3262,18,41,18,619771,56673,78441,47815,0.44887371689266253,0.4576123573998928
3261,0.3263,17,33,17,619804,56640,78458,47798,0.44861234317576987,0.45766866466228767
3262,0.3264,13,50,13,619854,56590,78471,47785,0.4482163223925992,0.4578203592814371
3263,0.3265,25,37,25,619891,56553,78496,47760,0.44792326701305285,0.4578528083747951
3264,0.3266,11,50,11,619941,56503,78507,47749,0.44752724622988216,0.45801519395311363
3265,0.3267,18,40,18,619981,56463,78525,47731,0.44721042960334556,0.4580973952434881
3266,0.3268,14,48,14,620029,56415,78539,47717,0.4468302496515017,0.45823570084124
3267,0.3269,13,39,13,620068,56376,78552,47704,0.44652135344062854,0.4583397386625673
3268,0.327,12,28,12,620096,56348,78564,47692,0.446299581802053,0.45840061514802
3269,0.3271,16,42,16,620138,56306,78580,47676,0.4459669243441896,0.4585024331134235
3270,0.3272,19,48,19,620186,56258,78599,47657,0.4455867443923457,0.45861521435788866
3271,0.3273,17,48,17,620234,56210,78616,47640,0.44520656444050183,0.4587385652383245
3272,0.3274,12,46,12,620280,56164,78628,47628,0.4448422253199848,0.4588792970556498
3273,0.3275,18,45,18,620325,56119,78646,47610,0.44448580661513115,0.458984469145562
3274,0.3276,19,48,19,620373,56071,78665,47591,0.4441056266632873,0.4590978372016747
3275,0.3277,20,39,20,620412,56032,78685,47571,0.44379673045241413,0.45916624035983516
3276,0.3278,22,44,22,620456,55988,78707,47549,0.44344823216322393,0.45924645295884564
3277,0.3279,17,40,17,620496,55948,78724,47532,0.4431314155366874,0.45933513722458447
3278,0.328,16,36,16,620532,55912,78740,47516,0.44284628057280445,0.45941137796341414
3279,0.3281,25,38,25,620570,55874,78765,47491,0.44254530477759474,0.4594495235331108
3280,0.3282,25,54,25,620624,55820,78790,47466,0.4421176023317704,0.45955889471951666
3281,0.3283,18,43,18,620667,55777,78808,47448,0.4417770244582436,0.4596560910632114
3282,0.3284,21,50,21,620717,55727,78829,47427,0.4413810036750729,0.4597688892335731
3283,0.3285,17,45,17,620762,55682,78846,47410,0.44102458497021924,0.4598804950917627
3284,0.3286,15,48,15,620810,55634,78861,47395,0.4406444050183754,0.4600161119684749
3285,0.3287,23,39,23,620849,55595,78884,47372,0.4403355088075022,0.4600697310788894
3286,0.3288,22,45,22,620894,55550,78906,47350,0.4399790901026486,0.46015549076773565
3287,0.3289,18,30,18,620924,55520,78924,47332,0.4397414776327462,0.4601952319838214
3288,0.329,15,37,15,620961,55483,78939,47317,0.43944842225319986,0.46028210116731516
3289,0.3291,18,41,18,621002,55442,78957,47299,0.43912368521099987,0.4603712247301467
3290,0.3292,16,46,16,621048,55396,78973,47283,0.43875934609048284,0.4604933822884913
3291,0.3293,19,41,19,621089,55355,78992,47264,0.43843460904828285,0.4605774759060213
3292,0.3294,16,39,16,621128,55316,79008,47248,0.4381257128374097,0.4606684606684607
3293,0.3295,8,36,8,621164,55280,79016,47240,0.4378405778735268,0.46078813889972686
3294,0.3296,29,41,29,621205,55239,79045,47211,0.43751584083132683,0.4608199121522694
3295,0.3297,23,42,23,621247,55197,79068,47188,0.43718318337346346,0.4608878253650437
3296,0.3298,22,50,22,621297,55147,79090,47166,0.43678716259029277,0.4609971362387966
3297,0.3299,21,55,21,621352,55092,79111,47145,0.43635153972880497,0.46113442295842016
3298,0.33,11,41,11,621393,55051,79122,47134,0.436026802686605,0.4612614375886872
3299,0.3301,15,26,15,621419,55025,79137,47119,0.43582087187935625,0.4612997337092732
3300,0.3302,13,46,13,621465,54979,79150,47106,0.43545653275883917,0.4614389969143361
3301,0.3303,20,43,20,621508,54936,79170,47086,0.4351159548853124,0.46152790574581953
3302,0.3304,18,53,18,621561,54883,79188,47068,0.43469617285515144,0.461672764367196
3303,0.3305,18,41,18,621602,54842,79206,47050,0.43437143581295146,0.4617634357947631
3304,0.3306,18,38,18,621640,54804,79224,47032,0.43407046001774174,0.4618406064652971
3305,0.3307,14,51,14,621691,54753,79238,47018,0.4336665188189076,0.46199801515166405
3306,0.3308,23,45,23,621736,54708,79261,46995,0.43331010011405396,0.46208076457921593
3307,0.3309,21,40,21,621776,54668,79282,46974,0.4329932834875174,0.46215147281635544
3308,0.331,13,34,13,621810,54634,79295,46961,0.43272398935496137,0.4622373148284857
3309,0.3311,15,40,15,621850,54594,79310,46946,0.43240717272842477,0.46233996454599174
3310,0.3312,24,41,24,621891,54553,79334,46922,0.4320824356862248,0.46239960581423994
3311,0.3313,19,47,19,621938,54506,79353,46903,0.43171017615004437,0.4625131891646698
3312,0.3314,26,37,26,621975,54469,79379,46877,0.43141712077049804,0.46254415566475243
3313,0.3315,23,40,23,622015,54429,79402,46854,0.4311003041439615,0.46260478066407984
3314,0.3316,25,50,25,622065,54379,79427,46829,0.43070428336079075,0.46270057702948386
3315,0.3317,14,36,14,622101,54343,79441,46815,0.43041914839690787,0.4627908815911742
3316,0.3318,21,42,21,622143,54301,79462,46794,0.4300864909390445,0.46287155645679806
3317,0.3319,21,38,21,622181,54263,79483,46773,0.42978551514383473,0.46293400372144583
3318,0.332,22,47,22,622228,54216,79505,46751,0.4294132556076543,0.4630324759574911
3319,0.3321,17,37,17,622265,54179,79522,46734,0.429120200228108,0.46311178936311476
3320,0.3322,19,42,19,622307,54137,79541,46715,0.42878754277024456,0.4632035061277912
3321,0.3323,16,32,16,622339,54105,79557,46699,0.42853408946901533,0.46326534661322966
3322,0.3324,16,45,16,622384,54060,79573,46683,0.4281776707641617,0.46338703433489176
3323,0.3325,15,38,15,622422,54022,79588,46668,0.427876694968952,0.46348197437680005
3324,0.3326,20,42,20,622464,53980,79608,46648,0.4275440375110886,0.4635687880112891
3325,0.3327,20,33,20,622497,53947,79628,46628,0.42728266379419594,0.46361421824509075
3326,0.3328,22,39,22,622536,53908,79650,46606,0.4269737675833228,0.46367670175298964
3327,0.3329,15,39,15,622575,53869,79665,46591,0.42666487137244963,0.4637766275134382
3328,0.333,16,33,16,622608,53836,79681,46575,0.42640349765555696,0.46384360279252274
3329,0.3331,16,52,16,622660,53784,79697,46559,0.42599163604105944,0.46399848519577847
3330,0.3332,18,39,18,622699,53745,79715,46541,0.4256827398301863,0.4640827234110444
3331,0.3333,18,49,18,622748,53696,79733,46523,0.425294639462679,0.4642133727137569
3332,0.3334,17,42,17,622790,53654,79750,46506,0.4249619820048156,0.4643170926517572
3333,0.3335,13,42,13,622832,53612,79763,46493,0.42462932454695224,0.46444233554767494
3334,0.3336,18,36,18,622868,53576,79781,46475,0.4243441895830693,0.4645130983198569
3335,0.3337,21,38,21,622906,53538,79802,46454,0.4240432137878596,0.46457716617329387
3336,0.3338,11,28,11,622934,53510,79813,46443,0.42382144214928397,0.4646483847408282
3337,0.3339,18,31,18,622965,53479,79831,46425,0.4235759092637182,0.46469610826393337
3338,0.334,22,44,22,623009,53435,79853,46403,0.42322741097452793,0.46478294837636974
3339,0.3341,23,37,23,623046,53398,79876,46380,0.4229343555949816,0.46483192687766844
3340,0.3342,18,51,18,623097,53347,79894,46362,0.4225304143961475,0.46497307163846796
3341,0.3343,22,34,22,623131,53313,79916,46340,0.4222611202635914,0.4650135971822223
3342,0.3344,22,32,22,623163,53281,79938,46318,0.4220076669623622,0.46504482976736716
3343,0.3345,17,36,17,623199,53245,79955,46301,0.42172253199847926,0.4651216523014486
3344,0.3346,21,41,21,623240,53204,79976,46280,0.4213977949562793,0.4652004342406819
3345,0.3347,22,45,22,623285,53159,79998,46258,0.4210413762514257,0.4652926561855618
3346,0.3348,21,37,21,623322,53122,80019,46237,0.42074832087187936,0.46535291216699043
3347,0.3349,17,32,17,623354,53090,80036,46220,0.42049486757065013,0.4654113382338133
3348,0.335,19,36,19,623390,53054,80055,46201,0.4202097326067672,0.46547780968213187
3349,0.3351,12,40,12,623430,53014,80067,46189,0.41989291598023065,0.46560083868431396
3350,0.3352,17,46,17,623476,52968,80084,46172,0.4195285768597136,0.46572523703853136
3351,0.3353,21,36,21,623512,52932,80105,46151,0.4192434418958307,0.4657812137299032
3352,0.3354,22,32,22,623544,52900,80127,46129,0.41898998859460146,0.4658130446636844
3353,0.3355,26,34,26,623578,52866,80153,46103,0.41872069446204535,0.4658327355030363
3354,0.3356,19,45,19,623623,52821,80172,46084,0.41836427575719176,0.4659420656185228
3355,0.3357,27,41,27,623664,52780,80199,46057,0.4180395387149918,0.4659894573894392
3356,0.3358,15,28,15,623692,52752,80214,46042,0.41781776707641616,0.4660404478004737
3357,0.3359,23,26,23,623718,52726,80237,46019,0.4176118362691674,0.4660387867740139
3358,0.336,14,43,14,623761,52683,80251,46005,0.4172712583956406,0.46616609922178986
3359,0.3361,13,44,13,623805,52639,80264,45992,0.4169227601064504,0.4663036976204236
3360,0.3362,22,46,22,623851,52593,80286,45970,0.4165584209859333,0.4664021996083723
3361,0.3363,10,44,10,623895,52549,80296,45960,0.4162099226967431,0.4665563552568801
3362,0.3364,21,36,21,623931,52513,80317,45939,0.41592478773286023,0.4666131719010279
3363,0.3365,13,33,13,623964,52480,80330,45926,0.41566341401596757,0.46669918500904417
3364,0.3366,11,46,11,624010,52434,80341,45915,0.41529907489545054,0.4668578226519843
3365,0.3367,23,48,23,624058,52386,80364,45892,0.4149188949436066,0.4669610696188364
3366,0.3368,23,43,23,624101,52343,80387,45869,0.41457831707007986,0.46704068749236344
3367,0.3369,25,31,25,624132,52312,80412,45844,0.414332784184514,0.4670524471249847
3368,0.337,16,37,16,624169,52275,80428,45828,0.4140397288049677,0.46714167762453745
3369,0.3371,20,26,20,624195,52249,80448,45808,0.4138337979977189,0.46715685774600485
3370,0.3372,25,29,25,624224,52220,80473,45783,0.4136041059434799,0.46715916859687967
3371,0.3373,19,38,19,624262,52182,80492,45764,0.4133031301482702,0.4672370489861761
3372,0.3374,21,47,21,624309,52135,80513,45743,0.4129308706120897,0.4673471055804164
3373,0.3375,16,37,16,624346,52098,80529,45727,0.4126378152325434,0.4674367492972144
3374,0.3376,17,45,17,624391,52053,80546,45710,0.41228139652768975,0.46755930157626097
3375,0.3377,20,35,20,624426,52018,80566,45690,0.4120041819794703,0.467617799975437
3376,0.3378,20,44,20,624470,51974,80586,45670,0.41165568369028005,0.4677194707304084
3377,0.3379,20,35,20,624505,51939,80606,45650,0.41137846914206055,0.46777813073194724
3378,0.338,14,37,14,624542,51902,80620,45636,0.41108541376251423,0.4678791855481966
3379,0.3381,18,34,18,624576,51868,80638,45618,0.4108161196299582,0.4679441150524178
3380,0.3382,29,48,29,624624,51820,80667,45589,0.4104359396781143,0.46801630239505587
3381,0.3383,21,37,21,624661,51783,80688,45568,0.410142884298568,0.46807942394017527
3382,0.3384,20,33,20,624694,51750,80708,45548,0.4098815105816753,0.4681288412917018
3383,0.3385,24,33,24,624727,51717,80732,45524,0.40962013686478266,0.46815643607120455
3384,0.3386,28,35,28,624762,51682,80760,45496,0.40934292231656316,0.4681718084340077
3385,0.3387,19,41,19,624803,51641,80779,45477,0.4090181852743632,0.468265409089973
3386,0.3388,17,33,17,624836,51608,80796,45460,0.4087568115574705,0.46833147896320104
3387,0.3389,16,41,16,624877,51567,80812,45444,0.4084320745152706,0.4684417231035656
3388,0.339,14,36,14,624913,51531,80826,45430,0.40814693955138764,0.4685388970823321
3389,0.3391,17,35,17,624948,51496,80843,45413,0.40786972500316815,0.4686148861302872
3390,0.3392,18,47,18,624995,51449,80861,45395,0.40749746546698773,0.4687435463219198
3391,0.3393,15,36,15,625031,51413,80876,45380,0.4072123305031048,0.4688355562902276
3392,0.3394,24,38,24,625069,51375,80900,45356,0.4069113547078951,0.4688879469870052
3393,0.3395,13,46,13,625115,51329,80913,45343,0.40654701558737805,0.46903963919232045
3394,0.3396,24,39,24,625154,51290,80937,45319,0.4062381193765049,0.46909708205239675
3395,0.3397,17,50,17,625204,51240,80954,45302,0.4058420985933342,0.46924654554494416
3396,0.3398,19,47,19,625251,51193,80973,45283,0.4054698390571537,0.46937062067249885
3397,0.3399,20,39,20,625290,51154,80993,45263,0.40516094284628057,0.46945040812304883
3398,0.34,23,42,23,625332,51112,81016,45240,0.4048282853884172,0.46952839588176687
3399,0.3401,18,39,18,625371,51073,81034,45222,0.40451938917754404,0.4696193987226751
3400,0.3402,12,54,12,625425,51019,81046,45210,0.4040916867317197,0.4698167911960012
3401,0.3403,13,33,13,625458,50986,81059,45197,0.403830313014827,0.4699063244024412
3402,0.3404,16,36,16,625494,50950,81075,45181,0.4035451780509441,0.4699940705911725
3403,0.3405,15,44,15,625538,50906,81090,45166,0.4031966797617539,0.47012657173786326
3404,0.3406,12,39,12,625577,50867,81102,45154,0.40288778355088073,0.4702512991949678
3405,0.3407,25,33,25,625610,50834,81127,45129,0.40262640983398806,0.47027500182361953
3406,0.3408,26,36,26,625646,50798,81153,45103,0.4023412748701052,0.47030792171093105
3407,0.3409,25,45,25,625691,50753,81178,45078,0.40198485616525154,0.47039058342290074
3408,0.341,21,35,21,625726,50718,81199,45057,0.40170764161703204,0.4704463586530932
3409,0.3411,12,25,12,625751,50693,81211,45045,0.4015096312254467,0.47050283064196036
3410,0.3412,10,45,10,625796,50648,81221,45035,0.4011532125205931,0.4706687708370348
3411,0.3413,20,45,20,625841,50603,81241,45015,0.40079679381573946,0.47077956033382834
3412,0.3414,13,30,13,625871,50573,81254,45002,0.400559181345837,0.47085534920219724
3413,0.3415,16,34,16,625905,50539,81270,44986,0.40028988721328096,0.47093431038995026
3414,0.3416,18,34,18,625939,50505,81288,44968,0.40002059308072485,0.47100227289390717
3415,0.3417,11,33,11,625972,50472,81299,44957,0.39975921936383224,0.4711041716878517
3416,0.3418,8,32,8,626004,50440,81307,44949,0.39950576606260296,0.47121785530826404
3417,0.3419,24,36,24,626040,50404,81331,44925,0.3992206310987201,0.47126267977215747
3418,0.342,16,30,16,626070,50374,81347,44909,0.39898301862881763,0.47132227154896467
3419,0.3421,26,36,26,626106,50338,81373,44883,0.39869788366493475,0.47135610842146164
3420,0.3422,18,35,18,626141,50303,81391,44865,0.39842066911671525,0.4714294720914593
3421,0.3423,8,30,8,626171,50273,81399,44857,0.3981830566468128,0.47153369073898876
3422,0.3424,19,31,19,626202,50242,81418,44838,0.39793752376124697,0.47158182583087926
3423,0.3425,19,43,19,626245,50199,81437,44819,0.3975969458877202,0.4716895746069166
3424,0.3426,13,27,13,626272,50172,81450,44806,0.39738309466480803,0.4717513529448925
3425,0.3427,22,46,22,626318,50126,81472,44784,0.39701875554429095,0.47185754925719103
3426,0.3428,16,40,16,626358,50086,81488,44768,0.3967019389177544,0.4719674447044932
3427,0.3429,18,41,18,626399,50045,81506,44750,0.3963772018755544,0.47207131177804734
3428,0.343,25,39,25,626438,50006,81531,44725,0.39606830566468126,0.4721263366796508
3429,0.3431,19,36,19,626474,49970,81550,44706,0.3957831707007984,0.47219992395115973
3430,0.3432,22,29,22,626503,49941,81572,44684,0.3955534786465594,0.472221928665786
3431,0.3433,16,43,16,626546,49898,81588,44668,0.39521290077303256,0.4723473552862551
3432,0.3434,18,36,18,626582,49862,81606,44650,0.3949277658091497,0.4724267817843237
3433,0.3435,19,32,19,626614,49830,81625,44631,0.3946743125079204,0.4724807063232445
3434,0.3436,17,29,17,626643,49801,81642,44614,0.3944446204536814,0.4725308478525658
3435,0.3437,11,37,11,626680,49764,81653,44603,0.39415156507413507,0.4726546356247417
3436,0.3438,17,32,17,626712,49732,81670,44586,0.39389811177290585,0.47271994741194684
3437,0.3439,14,47,14,626759,49685,81684,44572,0.39352585223672537,0.47287734597960895
3438,0.344,16,56,16,626815,49629,81700,44556,0.3930823089595742,0.47306896002548177
3439,0.3441,24,44,24,626859,49585,81724,44532,0.392733810670384,0.4731557529458015
3440,0.3442,25,36,25,626895,49549,81749,44507,0.3924486757065011,0.47319681891639026
3441,0.3443,19,40,19,626935,49509,81768,44488,0.3921318590799645,0.47329170079896166
3442,0.3444,21,32,21,626967,49477,81789,44467,0.3918784057787353,0.4733351784041557
3443,0.3445,21,34,21,627001,49443,81810,44446,0.3916091116461792,0.4733887888890072
3444,0.3446,25,33,25,627034,49410,81835,44421,0.3913477379292865,0.47341496946638106
3445,0.3447,14,32,14,627066,49378,81849,44407,0.3910942846280573,0.4734978941195287
3446,0.3448,24,42,24,627108,49336,81873,44383,0.3907616271701939,0.47357526222004076
3447,0.3449,18,45,18,627153,49291,81891,44365,0.39040520846534027,0.47370163150251987
3448,0.345,20,58,20,627211,49233,81911,44345,0.38994582435686226,0.47388275021906856
3449,0.3451,9,31,9,627242,49202,81920,44336,0.3897002914712964,0.4739891808676688
3450,0.3452,20,32,20,627274,49170,81940,44316,0.38944683817006714,0.47403889352416406
3451,0.3453,20,42,20,627316,49128,81960,44296,0.38911418071220377,0.4741394074327796
3452,0.3454,18,47,18,627363,49081,81978,44278,0.3887419211760233,0.47427671676003386
3453,0.3455,20,37,20,627400,49044,81998,44258,0.38844886579647697,0.4743521039206019
3454,0.3456,21,31,21,627431,49013,82019,44237,0.3882033329109112,0.47439142091152814
3455,0.3457,12,36,12,627467,48977,82031,44225,0.38791819794702825,0.4745069848286517
3456,0.3458,12,38,12,627505,48939,82043,44213,0.38761722215181854,0.4746328581243559
3457,0.3459,18,32,18,627537,48907,82061,44195,0.38736376885058926,0.4746944211724775
3458,0.346,18,35,18,627572,48872,82079,44177,0.38708655430236977,0.4747713570269428
3459,0.3461,15,30,15,627602,48842,82094,44162,0.3868489418324674,0.4748397918369102
3460,0.3462,16,38,16,627640,48804,82110,44146,0.38654796603725766,0.4749435180204411
3461,0.3463,13,39,13,627679,48765,82123,44133,0.3862390698263845,0.4750694309888265
3462,0.3464,14,37,14,627716,48728,82137,44119,0.3859460144468382,0.4751795965405452
3463,0.3465,23,40,23,627756,48688,82160,44096,0.3856291978203016,0.4752543541989998
3464,0.3466,22,39,22,627795,48649,82182,44074,0.3853203016094285,0.47532974558631624
3465,0.3467,17,53,17,627848,48596,82199,44057,0.3849005195792675,0.47550538028989886
3466,0.3468,17,42,17,627890,48554,82216,44040,0.38456786212140415,0.47562477050348834
3467,0.3469,15,36,15,627926,48518,82231,44025,0.3842827271575212,0.47572479820191693
3468,0.347,16,50,16,627976,48468,82247,44009,0.3838867063743505,0.4758913027022935
3469,0.3471,30,39,30,628015,48429,82277,43979,0.38357781016347736,0.475921998095403
3470,0.3472,23,34,23,628049,48395,82300,43956,0.3833085160309213,0.4759666922935323
3471,0.3473,21,31,21,628080,48364,82321,43935,0.3830629831453555,0.47600732402301216
3472,0.3474,16,45,16,628125,48319,82337,43919,0.38270656444050183,0.47614865890413927
3473,0.3475,16,32,16,628157,48287,82353,43903,0.3824531111392726,0.47622301768087644
3474,0.3476,18,33,18,628190,48254,82371,43885,0.38219173742237994,0.4762912556029477
3475,0.3477,19,34,19,628224,48220,82390,43866,0.38192244328982383,0.4763590556653563
3476,0.3478,22,35,22,628259,48185,82412,43844,0.38164522874160434,0.4764150430842452
3477,0.3479,18,44,18,628303,48141,82430,43826,0.38129673045241413,0.4765404982221884
3478,0.348,18,37,18,628340,48104,82448,43808,0.3810036750728678,0.4766298198276612
3479,0.3481,22,30,22,628370,48074,82470,43786,0.3807660626029654,0.47666013498802523
3480,0.3482,12,31,12,628401,48043,82482,43774,0.3805205297173996,0.4767526710739841
3481,0.3483,10,28,10,628429,48015,82492,43764,0.38029875807882396,0.4768411074428791
3482,0.3484,27,26,27,628455,47989,82519,43737,0.38009282727157523,0.4768222750365218
3483,0.3485,17,28,17,628483,47961,82536,43720,0.3798710556329996,0.4768708892791309
3484,0.3486,17,42,17,628525,47919,82553,43703,0.37953839817513624,0.4769924254000131
3485,0.3487,10,44,10,628569,47875,82563,43693,0.37918989988594604,0.47716451161977985
3486,0.3488,13,41,13,628610,47834,82576,43680,0.37886516284374605,0.47730401905719344
3487,0.3489,15,38,15,628648,47796,82591,43665,0.3785641870485363,0.4774166037983403
3488,0.349,11,43,11,628691,47753,82602,43654,0.3782236091750095,0.47757830363101295
3489,0.3491,12,34,12,628725,47719,82614,43642,0.3779543150424534,0.4776874158557809
3490,0.3492,11,33,11,628758,47686,82625,43631,0.37769294132556075,0.47779712430325133
3491,0.3493,22,35,22,628793,47651,82647,43609,0.37741572677734125,0.47785448170063555
3492,0.3494,13,33,13,628826,47618,82660,43596,0.3771543530604486,0.47795294581972064
3493,0.3495,19,38,19,628864,47580,82679,43577,0.3768533772652389,0.47804337571442673
3494,0.3496,11,31,11,628895,47549,82690,43566,0.37660784437967304,0.4781430060912034
3495,0.3497,11,33,11,628928,47516,82701,43555,0.3763464706627804,0.47825323099559686
3496,0.3498,17,41,17,628969,47475,82718,43538,0.3760217336205804,0.4783712216936042
3497,0.3499,17,50,17,629019,47425,82735,43521,0.3756257128374097,0.47853671409407783
3498,0.35,26,41,26,629060,47384,82761,43495,0.3753009757952097,0.4786034177312691
3499,0.3501,20,35,20,629095,47349,82781,43475,0.3750237612469902,0.4786730379635339
3500,0.3502,18,42,18,629137,47307,82799,43457,0.37469110378912684,0.47879115067647965
3501,0.3503,12,30,12,629167,47277,82811,43445,0.37445349131922445,0.4788805361433831
3502,0.3504,21,39,21,629206,47238,82832,43424,0.3741445951083513,0.47896582912355784
3503,0.3505,17,50,17,629256,47188,82849,43407,0.3737485743251806,0.47913240245046634
3504,0.3506,21,33,21,629289,47155,82870,43386,0.37348720060828794,0.47918622502512676
3505,0.3507,17,43,17,629332,47112,82887,43369,0.3731466227347611,0.47931609951260484
3506,0.3508,17,35,17,629367,47077,82904,43352,0.37286940818654163,0.47940373110396
3507,0.3509,15,28,15,629395,47049,82919,43337,0.372647636547966,0.47946584648064966
3508,0.351,16,37,16,629432,47012,82935,43321,0.37235458116841974,0.47957003531378345
3509,0.3511,19,40,19,629472,46972,82954,43302,0.37203776454188314,0.4796729955468906
3510,0.3512,19,36,19,629508,46936,82973,43283,0.37175262957800026,0.47975481882973653
3511,0.3513,13,34,13,629542,46902,82986,43270,0.37148333544544415,0.4798607106418844
3512,0.3514,23,36,23,629578,46866,83009,43247,0.37119820048156127,0.4799196564313695
3513,0.3515,22,21,22,629599,46845,83031,43225,0.3710318717526296,0.4799045187076718
3514,0.3516,16,30,16,629629,46815,83047,43209,0.37079425928272713,0.4799720074646761
3515,0.3517,23,44,23,629673,46771,83070,43186,0.37044576099353693,0.4800738130440099
3516,0.3518,19,35,19,629708,46736,83089,43167,0.37016854644531744,0.4801508292270558
3517,0.3519,15,36,15,629744,46700,83104,43152,0.36988341148143455,0.48025642167119265
3518,0.352,16,31,16,629775,46669,83120,43136,0.3696378785958687,0.4803296030287846
3519,0.3521,19,36,19,629811,46633,83139,43117,0.3693527436319858,0.48041225626740947
3520,0.3522,23,25,23,629836,46608,83162,43094,0.36915473324040043,0.48041292278878955
3521,0.3523,16,43,16,629879,46565,83178,43078,0.3688141553668737,0.4805506286045759
3522,0.3524,22,35,22,629914,46530,83200,43056,0.3685369408186542,0.4806108097247338
3523,0.3525,20,38,20,629952,46492,83220,43036,0.3682359650234444,0.4806987758019837
3524,0.3526,15,35,15,629987,46457,83235,43021,0.3679587504752249,0.4807997496591341
3525,0.3527,18,36,18,630023,46421,83253,43003,0.36767361551134203,0.4808887994274468
3526,0.3528,14,24,14,630047,46397,83267,42989,0.3674835255354201,0.4809366119974045
3527,0.3529,17,37,17,630084,46360,83284,42972,0.3671904701558738,0.48103703040343887
3528,0.353,21,31,21,630115,46329,83305,42951,0.36694493727030797,0.4810819892473118
3529,0.3531,18,30,18,630145,46299,83323,42933,0.3667073248004055,0.48113905325443784
3530,0.3532,16,43,16,630188,46256,83339,42917,0.3663667469268787,0.481277965303399
3531,0.3533,14,33,14,630221,46223,83353,42903,0.36610537320998604,0.48137468303300945
3532,0.3534,20,24,20,630245,46199,83373,42883,0.36591528323406414,0.48138793471183855
3533,0.3535,14,35,14,630280,46164,83387,42869,0.36563806868584464,0.48149562521761596
3534,0.3536,23,34,23,630314,46130,83410,42846,0.36536877455328853,0.48154558532638014
3535,0.3537,21,21,21,630335,46109,83431,42825,0.36520244582435685,0.48153687003845547
3536,0.3538,27,34,27,630369,46075,83458,42798,0.3649331516918008,0.4815635794898338
3537,0.3539,16,33,16,630402,46042,83474,42782,0.36467177797490813,0.48164910384580745
3538,0.354,13,26,13,630428,46016,83487,42769,0.36446584716765934,0.48171425353381764
3539,0.3541,19,26,19,630454,45990,83506,42750,0.3642599163604106,0.4817444219066937
3540,0.3542,13,36,13,630490,45954,83519,42737,0.36397478139652767,0.4818639997293976
3541,0.3543,20,23,20,630513,45931,83539,42717,0.36379261183626915,0.4818721234545619
3542,0.3544,14,40,14,630553,45891,83553,42703,0.3634757952097326,0.4820078109127029
3543,0.3545,18,35,18,630588,45856,83571,42685,0.3631985806615131,0.4820930416417253
3544,0.3546,18,30,18,630618,45826,83589,42667,0.3629609681916107,0.4821511305979004
3545,0.3547,23,25,23,630643,45801,83612,42644,0.3627629578000253,0.4821527502967946
3546,0.3548,17,29,17,630672,45772,83629,42627,0.3625332657457863,0.4822113372323216
3547,0.3549,19,33,19,630705,45739,83648,42608,0.36227189202889365,0.4822801000599907
3548,0.355,16,29,16,630734,45710,83664,42592,0.36204219997465464,0.4823446807546828
3549,0.3551,15,26,15,630760,45684,83679,42577,0.3618362691674059,0.48239879448454015
3550,0.3552,21,40,21,630800,45644,83700,42556,0.36151945254086937,0.4824943310657596
3551,0.3553,21,35,21,630835,45609,83721,42535,0.3612422379926499,0.4825626247957887
3552,0.3554,21,38,21,630873,45571,83742,42514,0.3609412621974401,0.48264744281092126
3553,0.3555,14,33,14,630906,45538,83756,42500,0.36067988848054744,0.4827460869170131
3554,0.3556,18,35,18,630941,45503,83774,42482,0.36040267393232794,0.482832300960391
3555,0.3557,21,37,21,630978,45466,83795,42461,0.3601096185527817,0.48291196105860545
3556,0.3558,22,27,22,631005,45439,83817,42439,0.3598957673298695,0.482930881449282
3557,0.3559,13,40,13,631045,45399,83830,42426,0.3595789507033329,0.48307429547395386
3558,0.356,17,27,17,631072,45372,83847,42409,0.3593650994804207,0.4831227714425673
3559,0.3561,25,30,25,631102,45342,83872,42384,0.35912748701051833,0.48314068805143284
3560,0.3562,17,32,17,631134,45310,83889,42367,0.35887403370928905,0.483216807144405
3561,0.3563,14,37,14,631171,45273,83903,42353,0.35858097832974273,0.4833382785931116
3562,0.3564,20,32,20,631203,45241,83923,42333,0.3583275250285135,0.48339689862287893
3563,0.3565,13,37,13,631240,45204,83936,42320,0.3580344696489672,0.4835245189890773
3564,0.3566,17,40,17,631280,45164,83953,42303,0.35771765302243064,0.4836452604982451
3565,0.3567,12,27,12,631307,45137,83965,42291,0.35750380179951846,0.48372374982843025
3566,0.3568,16,25,16,631332,45112,83981,42275,0.3573057914079331,0.48376760845434674
3567,0.3569,14,27,14,631359,45085,83995,42261,0.3570919401850209,0.4838344056968837
3568,0.357,22,32,22,631391,45053,84017,42239,0.35683848688379166,0.4838816844613481
3569,0.3571,19,34,19,631425,45019,84036,42220,0.3565691927512356,0.4839578628824264
3570,0.3572,18,52,18,631477,44967,84054,42202,0.35615733113673803,0.4841400039004692
3571,0.3573,13,39,13,631516,44928,84067,42189,0.35584843492586493,0.48427976169978304
3572,0.3574,19,28,19,631544,44900,84086,42170,0.3556266632872893,0.48432295853910645
3573,0.3575,13,35,13,631579,44865,84099,42157,0.3553494487390698,0.484440716140746
3574,0.3576,13,41,13,631620,44824,84112,42144,0.35502471169686983,0.4845920338515316
3575,0.3577,15,26,15,631646,44798,84127,42129,0.3548187808896211,0.48464803800890405
3576,0.3578,18,31,18,631677,44767,84145,42111,0.35457324800405526,0.4847141969198186
3577,0.3579,14,32,14,631709,44735,84159,42097,0.354319794702826,0.48480974755850376
3578,0.358,14,39,14,631748,44696,84173,42083,0.35401089849195283,0.48494451422579193
3579,0.3581,21,39,21,631787,44657,84194,42062,0.35370200228107973,0.48503788097187467
3580,0.3582,20,33,20,631820,44624,84214,42042,0.35344062856418706,0.4851037315671659
3581,0.3583,18,29,18,631849,44595,84232,42024,0.35321093650994806,0.4851591452221799
3582,0.3584,10,32,10,631881,44563,84242,42014,0.3529574832087188,0.485279000196357
3583,0.3585,21,32,21,631913,44531,84263,41993,0.35270402990748956,0.48533354907308957
3584,0.3586,20,37,20,631950,44494,84283,41973,0.35241097452794323,0.4854221841858744
3585,0.3587,11,31,11,631981,44463,84294,41962,0.3521654416423774,0.4855308070581429
3586,0.3588,23,27,23,632008,44436,84317,41939,0.3519515904194652,0.4855455861070912
3587,0.3589,14,32,14,632040,44404,84331,41925,0.35169813711823594,0.4856421364778927
3588,0.359,21,36,21,632076,44368,84352,41904,0.35141300215435306,0.48571958456973297
3589,0.3591,18,34,18,632110,44334,84370,41886,0.351143708021797,0.48580375782881
3590,0.3592,15,24,15,632134,44310,84385,41871,0.35095361804587505,0.48584954920458107
3591,0.3593,11,48,11,632182,44262,84396,41860,0.3505734380940312,0.48605466663570285
3592,0.3594,16,42,16,632224,44220,84412,41844,0.35024078063616776,0.48619631901840493
3593,0.3595,21,32,21,632256,44188,84433,41823,0.34998732733493854,0.4862517584960063
3594,0.3596,15,44,15,632300,44144,84448,41808,0.34963882904574833,0.48641102010424425
3595,0.3597,18,31,18,632331,44113,84466,41790,0.3493932961601825,0.48647893554357824
3596,0.3598,17,41,17,632372,44072,84483,41773,0.3490685591179825,0.4866095870464209
3597,0.3599,20,37,20,632409,44035,84503,41753,0.3487755037384362,0.4866997715298177
3598,0.36,21,33,21,632442,44002,84524,41732,0.3485141300215435,0.4867613782163436
3599,0.3601,16,25,16,632467,43977,84540,41716,0.3483161196299582,0.4868075572100405
3600,0.3602,21,33,21,632500,43944,84561,41695,0.3480547459130655,0.48686930020201075
3601,0.3603,17,37,17,632537,43907,84578,41678,0.3477616905335192,0.4869778582695566
3602,0.3604,25,43,25,632580,43864,84603,41653,0.34742111265999237,0.48707274576984694
3603,0.3605,21,30,21,632610,43834,84624,41632,0.34718350019009,0.487117684225306
3604,0.3606,15,29,15,632639,43805,84639,41617,0.34695380813585097,0.4871929947788626
3605,0.3607,16,36,16,632675,43769,84655,41601,0.3466686731719681,0.4873023310296357
3606,0.3608,9,35,9,632710,43734,84664,41592,0.3463914586237486,0.48744814007453763
3607,0.3609,22,34,22,632744,43700,84686,41570,0.3461221644911925,0.48751026152222354
3608,0.361,15,23,15,632767,43677,84701,41555,0.34593999493093397,0.4875516238032664
3609,0.3611,19,34,19,632801,43643,84720,41536,0.3456707007983779,0.48763192805738503
3610,0.3612,17,28,17,632829,43615,84737,41519,0.3454489291598023,0.48768999459675333
3611,0.3613,16,25,16,632854,43590,84753,41503,0.34525091876821695,0.48773694663485834
3612,0.3614,24,34,24,632888,43556,84777,41479,0.3449816246356609,0.48778738166637264
3613,0.3615,19,37,19,632925,43519,84796,41460,0.3446885692561146,0.4878852422363172
3614,0.3616,18,30,18,632955,43489,84814,41442,0.3444509567862121,0.48794904098621233
3615,0.3617,15,31,15,632986,43458,84829,41427,0.3442054239006463,0.4880367556105319
3616,0.3618,15,45,15,633031,43413,84844,41412,0.3438490051957927,0.4882051282051282
3617,0.3619,17,42,17,633073,43371,84861,41395,0.3435163477379293,0.48834438336125335
3618,0.362,13,36,13,633109,43335,84874,41382,0.3432312127740464,0.48847338786784233
3619,0.3621,13,36,13,633145,43299,84887,41369,0.34294607781016345,0.4886025416922568
3620,0.3622,19,31,19,633176,43268,84906,41350,0.3427005449245976,0.4886667139379328
3621,0.3623,21,25,21,633201,43243,84927,41329,0.34250253453301227,0.4886841980797427
3622,0.3624,24,35,24,633236,43208,84951,41305,0.3422253199847928,0.48874137706625015
3623,0.3625,18,35,18,633271,43173,84969,41287,0.34194810543657334,0.4888349514563107
3624,0.3626,11,33,11,633304,43140,84980,41276,0.34168673171968067,0.48895943896891586
3625,0.3627,20,44,20,633348,43096,85000,41256,0.3413382334304904,0.48909332321699545
3626,0.3628,16,31,16,633379,43065,85016,41240,0.3410927005449246,0.48917620544451695
3627,0.3629,12,38,12,633417,43027,85028,41228,0.34079172474971486,0.4893240757225091
3628,0.363,13,32,13,633449,42995,85041,41215,0.34053827144848564,0.48943118394489965
3629,0.3631,14,39,14,633488,42956,85055,41201,0.3402293752376125,0.4895730598761838
3630,0.3632,19,25,19,633513,42931,85074,41182,0.34003136484602714,0.4896032717891408
3631,0.3633,14,43,14,633556,42888,85088,41168,0.3396907869725003,0.4897687256114971
3632,0.3634,13,37,13,633593,42851,85101,41155,0.339397731592954,0.4899054829416946
3633,0.3635,14,24,14,633617,42827,85115,41141,0.33920764161703204,0.4899604611280488
3634,0.3636,16,29,16,633646,42798,85131,41125,0.33897794956279304,0.49003252981900075
3635,0.3637,19,34,19,633680,42764,85150,41106,0.338708655430237,0.4901156551806367
3636,0.3638,16,33,16,633713,42731,85166,41090,0.3384472817133443,0.4902112835685568
3637,0.3639,27,44,27,633757,42687,85193,41063,0.3380987834241541,0.4903044776119403
3638,0.364,15,37,15,633794,42650,85208,41048,0.3378057280446078,0.4904298788501517
3639,0.3641,14,24,14,633818,42626,85222,41034,0.33761563806868583,0.49048529763327753
3640,0.3642,20,39,20,633857,42587,85242,41014,0.3373067418578127,0.49059221779643786
3641,0.3643,15,30,15,633887,42557,85257,40999,0.3370691293879103,0.49067691129302504
3642,0.3644,13,38,13,633925,42519,85270,40986,0.33676815359270057,0.4908209089276091
3643,0.3645,11,32,11,633957,42487,85281,40975,0.3365147002914713,0.4909419855742733
3644,0.3646,18,36,18,633993,42451,85299,40957,0.3362295653275884,0.4910440245539996
3645,0.3647,16,33,16,634026,42418,85315,40941,0.33596819161069574,0.49114072865557407
3646,0.3648,19,23,19,634049,42395,85334,40922,0.3357860220504372,0.4911602674124128
3647,0.3649,8,27,8,634076,42368,85342,40914,0.33557217082752505,0.4912706227035854
3648,0.365,14,26,14,634102,42342,85356,40900,0.33536624002027626,0.49133850700367604
3649,0.3651,7,27,7,634129,42315,85363,40893,0.3351523887973641,0.49145514854340927
3650,0.3652,11,42,11,634171,42273,85374,40882,0.3348197313395007,0.49163610125668933
3651,0.3653,12,34,12,634205,42239,85386,40870,0.3345504372069446,0.4917638282255833
3652,0.3654,12,30,12,634235,42209,85398,40858,0.3343128247370422,0.4918680101604729
3653,0.3655,22,34,22,634269,42175,85420,40836,0.3340435306044861,0.4919348038211803
3654,0.3656,23,25,23,634294,42150,85443,40813,0.33384552021290076,0.49194219109723614
3655,0.3657,20,33,20,634327,42117,85463,40793,0.3335841464960081,0.49201543842721024
3656,0.3658,19,30,19,634357,42087,85482,40774,0.3333465340261057,0.4920770929629138
3657,0.3659,13,36,13,634393,42051,85495,40761,0.33306139906222276,0.49221127372844514
3658,0.366,14,34,14,634427,42017,85509,40747,0.3327921049296667,0.4923275820405007
3659,0.3661,19,35,19,634462,41982,85528,40728,0.3325148903814472,0.49241929633659776
3660,0.3662,19,35,19,634497,41947,85547,40709,0.3322376758332277,0.4925111304684475
3661,0.3663,14,22,14,634519,41925,85561,40695,0.33206342668863265,0.49255628177196803
3662,0.3664,13,25,13,634544,41900,85574,40682,0.33186541629704724,0.49262551161270013
3663,0.3665,7,34,7,634578,41866,85581,40675,0.3315961221644912,0.4927854036175961
3664,0.3666,21,32,21,634610,41834,85602,40654,0.33134266886326197,0.49284744447677237
3665,0.3667,16,28,16,634638,41806,85618,40638,0.33112089722468635,0.4929164038620154
3666,0.3668,18,24,18,634662,41782,85636,40620,0.3309308072487644,0.49294920026212957
3667,0.3669,11,28,11,634690,41754,85647,40609,0.33070903561018883,0.4930490632929835
3668,0.367,11,25,11,634715,41729,85658,40598,0.3305110252186035,0.4931310505666428
3669,0.3671,20,41,20,634756,41688,85678,40578,0.3301862881764035,0.4932535920064182
3670,0.3672,16,29,16,634785,41659,85694,40562,0.3299565961221645,0.49332895488987
3671,0.3673,19,29,19,634814,41630,85713,40543,0.3297269040679255,0.4933859053460382
3672,0.3674,19,26,19,634840,41604,85732,40524,0.3295209732606767,0.4934248977206312
3673,0.3675,12,37,12,634877,41567,85744,40512,0.3292279178811304,0.493573264781491
3674,0.3676,12,32,12,634909,41535,85756,40500,0.32897446457990115,0.4936917169500823
3675,0.3677,22,36,22,634945,41499,85778,40478,0.32868932961601827,0.4937726435463606
3676,0.3678,24,29,24,634974,41470,85802,40454,0.32845963756177926,0.49379913090181143
3677,0.3679,17,21,17,634995,41449,85819,40437,0.3282933088328476,0.493820677527294
3678,0.368,19,31,19,635026,41418,85838,40418,0.32804777594728174,0.4938902194633169
3679,0.3681,14,27,14,635053,41391,85852,40404,0.3278339247243695,0.4939666238767651
3680,0.3682,20,32,20,635085,41359,85872,40384,0.3275804714231403,0.49403618658478404
3681,0.3683,16,21,16,635106,41338,85888,40368,0.3274141426942086,0.4940640834210462
3682,0.3684,19,28,19,635134,41310,85907,40349,0.327192371055633,0.4941157741338983
3683,0.3685,25,30,25,635164,41280,85932,40324,0.3269547585857306,0.49414244399784324
3684,0.3686,15,29,15,635193,41251,85947,40309,0.3267250665314916,0.49422511034820993
3685,0.3687,20,26,20,635219,41225,85967,40289,0.3265191357242428,0.49425865495497706
3686,0.3688,16,39,16,635258,41186,85983,40273,0.32621023951336964,0.4943959537927055
3687,0.3689,14,40,14,635298,41146,85997,40259,0.3258934228868331,0.49455193169952705
3688,0.369,14,24,14,635322,41122,86011,40245,0.3257033329109112,0.49461083731733996
3689,0.3691,21,32,21,635354,41090,86032,40224,0.3254498796096819,0.4946749637208845
3690,0.3692,12,34,12,635388,41056,86044,40212,0.32518058547712586,0.4948073042279864
3691,0.3693,17,31,17,635419,41025,86061,40195,0.32493505259156,0.4948904210785521
3692,0.3694,16,31,16,635450,40994,86077,40179,0.3246895197059942,0.4949798578345016
3693,0.3695,21,37,21,635487,40957,86098,40158,0.32439646432644786,0.4950748936694816
3694,0.3696,15,37,15,635524,40920,86113,40143,0.32410340894690154,0.49520743125717037
3695,0.3697,15,40,15,635564,40880,86128,40128,0.323786592320365,0.49535848311277897
3696,0.3698,19,39,19,635603,40841,86147,40109,0.32347769610949184,0.49547869054972205
3697,0.3699,13,32,13,635635,40809,86160,40096,0.32322424280826256,0.4955935974290835
3698,0.37,18,26,18,635661,40783,86178,40078,0.32301831200101383,0.4956406673179901
3699,0.3701,19,24,19,635685,40759,86197,40059,0.32282822202509187,0.49566928159568413
3700,0.3702,15,25,15,635710,40734,86212,40044,0.3226302116335065,0.4957290351333284
3701,0.3703,11,29,11,635739,40705,86223,40033,0.3224005195792675,0.49583839084445985
3702,0.3704,16,35,16,635774,40670,86239,40017,0.322123305031048,0.4959534993245504
3703,0.3705,13,27,13,635801,40643,86252,40004,0.32190945380813585,0.49603829032698055
3704,0.3706,14,35,14,635836,40608,86266,39990,0.32163223925991635,0.4961661579691804
3705,0.3707,15,28,15,635864,40580,86281,39975,0.3214104676213408,0.4962448016882875
3706,0.3708,20,25,20,635889,40555,86301,39955,0.32121245722975544,0.4962737548130667
3707,0.3709,16,33,16,635922,40522,86317,39939,0.3209510835128628,0.496377126806776
3708,0.371,13,32,13,635954,40490,86330,39926,0.3206976302116335,0.49649323517707916
3709,0.3711,10,26,10,635980,40464,86340,39916,0.32049169940438477,0.4965911918387659
3710,0.3712,16,34,16,636014,40430,86356,39900,0.32022240527182866,0.4967011079297896
3711,0.3713,20,43,20,636057,40387,86376,39880,0.31988182739830184,0.49684179052412575
3712,0.3714,15,44,15,636101,40343,86391,39865,0.31953332910911164,0.4970202473568721
3713,0.3715,14,35,14,636136,40308,86405,39851,0.31925611456089215,0.49714941553662095
3714,0.3716,19,27,19,636163,40281,86424,39832,0.31904226333797997,0.49719770823711507
3715,0.3717,15,37,15,636200,40244,86439,39817,0.31874920795843364,0.4973332833714293
3716,0.3718,15,27,15,636227,40217,86454,39802,0.31853535673552147,0.497406865869356
3717,0.3719,13,40,13,636267,40177,86467,39789,0.3182185401089849,0.4975739689367981
3718,0.372,21,34,21,636301,40143,86488,39768,0.3179492459764288,0.4976536396741375
3719,0.3721,16,23,16,636324,40120,86504,39752,0.3177670764161703,0.4976963141025641
3720,0.3722,13,40,13,636364,40080,86517,39739,0.31745025978963376,0.49786391711246697
3721,0.3723,18,36,18,636400,40044,86535,39721,0.3171651248257509,0.4979753024509497
3722,0.3724,14,31,14,636431,40013,86549,39707,0.31691959194018504,0.49808078273958856
3723,0.3725,16,29,16,636460,39984,86565,39691,0.31668989988594604,0.4981612802008158
3724,0.3726,16,26,16,636486,39958,86581,39675,0.31648396907869725,0.49822309846420454
3725,0.3727,18,31,18,636517,39927,86599,39657,0.3162384361931314,0.4983036791314837
3726,0.3728,12,27,12,636544,39900,86611,39645,0.31602458497021924,0.49839713369790684
3727,0.3729,15,28,15,636572,39872,86626,39630,0.3158028133316436,0.498478025710045
3728,0.373,12,25,12,636597,39847,86638,39618,0.31560480294005827,0.4985591140753791
3729,0.3731,15,31,15,636628,39816,86653,39603,0.31535927005449244,0.49865901106788046
3730,0.3732,20,37,20,636665,39779,86673,39583,0.31506621467494617,0.498765152087901
3731,0.3733,12,22,12,636687,39757,86685,39571,0.31489196553035104,0.49882765227914483
3732,0.3734,17,27,17,636714,39730,86702,39554,0.31467811430743886,0.4988900660915191
3733,0.3735,12,35,12,636749,39695,86714,39542,0.31440089975921937,0.4990345419437889
3734,0.3736,10,20,10,636769,39675,86724,39532,0.31424249144595107,0.49909730200613583
3735,0.3737,10,32,10,636801,39643,86734,39522,0.31398903814472184,0.4992357733847028
3736,0.3738,15,31,15,636832,39612,86749,39507,0.313743505259156,0.49933644257384446
3737,0.3739,14,32,14,636864,39580,86763,39493,0.31349005195792673,0.4994498754315632
3738,0.374,10,30,10,636894,39550,86773,39483,0.31325243948802434,0.4995761264282009
3739,0.3741,20,29,20,636923,39521,86793,39463,0.31302274743378533,0.4996328370302846
3740,0.3742,20,20,20,636943,39501,86813,39443,0.31286433912051703,0.49963265099310905
3741,0.3743,8,28,8,636971,39473,86821,39435,0.31264256748194147,0.4997592132610128
3742,0.3744,11,26,11,636997,39447,86832,39424,0.3124366366746927,0.4998541922886739
3743,0.3745,11,36,11,637033,39411,86843,39413,0.3121515017108098,0.5000126864914239
3744,0.3746,16,29,16,637062,39382,86859,39397,0.3119218096565708,0.5000952030363421
3745,0.3747,15,27,15,637089,39355,86874,39382,0.3117079584336586,0.5001714568754208
3746,0.3748,13,36,13,637125,39319,86887,39369,0.3114228234697757,0.500317710451403
3747,0.3749,13,27,13,637152,39292,86900,39356,0.3112089722468635,0.5004068762079138
3748,0.375,13,26,13,637178,39266,86913,39343,0.31100304143961477,0.5004897658028978
3749,0.3751,14,27,14,637205,39239,86927,39329,0.3107891902167026,0.5005727522655534
3750,0.3752,9,32,9,637237,39207,86936,39320,0.3105357369154733,0.5007194977523655
3751,0.3753,11,36,11,637273,39171,86947,39309,0.31025060195159043,0.5008792048929663
3752,0.3754,14,23,14,637296,39148,86961,39295,0.3100684323913319,0.5009369860918119
3753,0.3755,18,32,18,637328,39116,86979,39277,0.30981497909010264,0.5010268773997678
3754,0.3756,8,35,8,637363,39081,86987,39269,0.30953776454188314,0.5011997447351627
3755,0.3757,17,22,17,637385,39059,87004,39252,0.30936351539728807,0.501232266220582
3756,0.3758,15,28,15,637413,39031,87019,39237,0.30914174375871245,0.5013159912096898
3757,0.3759,12,33,12,637446,38998,87031,39225,0.3088803700418198,0.501450979890825
3758,0.376,18,27,18,637473,38971,87049,39207,0.3086665188189076,0.5015093760392949
3759,0.3761,16,32,16,637505,38939,87065,39191,0.3084130655176784,0.5016126967874056
3760,0.3762,9,27,9,637532,38912,87074,39182,0.3081992142947662,0.501728685942582
3761,0.3763,13,32,13,637564,38880,87087,39169,0.30794576099353693,0.5018514010429346
3762,0.3764,16,35,16,637599,38845,87103,39153,0.30766854644531744,0.5019744096002462
3763,0.3765,19,33,19,637632,38812,87122,39134,0.30740717272842477,0.5020655325481744
3764,0.3766,17,37,17,637669,38775,87139,39117,0.30711411734887845,0.502195347404098
3765,0.3767,15,21,15,637690,38754,87154,39102,0.30694778861994676,0.5022348951911221
3766,0.3768,17,31,17,637721,38723,87171,39085,0.3067022557343809,0.502326238947152
3767,0.3769,12,30,12,637751,38693,87183,39073,0.30646464326447853,0.5024432271172492
3768,0.377,9,26,9,637777,38667,87192,39064,0.30625871245722974,0.5025536787124828
3769,0.3771,16,29,16,637806,38638,87208,39048,0.30602902040299074,0.5026388281028756
3770,0.3772,17,28,17,637834,38610,87225,39031,0.3058072487644152,0.5027111964039618
3771,0.3773,17,32,17,637866,38578,87242,39014,0.3055537954631859,0.5028095679967007
3772,0.3774,15,23,15,637889,38555,87257,38999,0.3053716259029274,0.5028625215978544
3773,0.3775,19,32,19,637921,38523,87276,38980,0.30511817260169816,0.5029482729700786
3774,0.3776,21,30,21,637951,38493,87297,38959,0.3048805601317957,0.5030083148272478
3775,0.3777,12,32,12,637983,38461,87309,38947,0.3046271068305665,0.5031392104175278
3776,0.3778,7,30,7,638013,38431,87316,38940,0.30438949436066404,0.5032893461374417
3777,0.3779,14,29,14,638042,38402,87330,38926,0.30415980230642503,0.5033881647010139
3778,0.378,12,26,12,638068,38376,87342,38914,0.3039538714991763,0.503480398499159
3779,0.3781,18,33,18,638101,38343,87360,38896,0.30369249778228363,0.5035797977705563
3780,0.3782,19,28,19,638129,38315,87379,38877,0.303470726143708,0.5036402736034822
3781,0.3783,9,28,9,638157,38287,87388,38868,0.30324895450513245,0.5037651480785432
3782,0.3784,20,34,20,638191,38253,87408,38848,0.30297966037257634,0.5038585751157573
3783,0.3785,16,28,16,638219,38225,87424,38832,0.3027578887340008,0.5039386428228454
3784,0.3786,10,34,10,638253,38191,87434,38822,0.30248859460144467,0.5040967109449054
3785,0.3787,18,24,18,638277,38167,87452,38804,0.30229850462552277,0.5041379220745476
3786,0.3788,23,26,23,638303,38141,87475,38781,0.302092573818274,0.5041600582408153
3787,0.3789,10,41,10,638344,38100,87485,38771,0.301767836776074,0.5043644547358562
3788,0.379,19,22,19,638366,38078,87504,38752,0.3015935876314789,0.5043863074319928
3789,0.3791,21,27,21,638393,38051,87525,38731,0.30137973640856675,0.5044281211742335
3790,0.3792,16,32,16,638425,38019,87541,38715,0.30112628310733747,0.5045351473922902
3791,0.3793,17,30,17,638455,37989,87558,38698,0.3008886706374351,0.5046226870264843
3792,0.3794,13,21,13,638476,37968,87571,38685,0.30072234190850333,0.504676920668467
3793,0.3795,15,30,15,638506,37938,87586,38670,0.30048472943860094,0.5047775689223057
3794,0.3796,16,31,16,638537,37907,87602,38654,0.3002391965530351,0.504878462924988
3795,0.3797,12,25,12,638562,37882,87614,38642,0.30004118616144976,0.5049657623752025
3796,0.3798,25,22,25,638584,37860,87639,38617,0.29986693701685463,0.5049492004131961
3797,0.3799,12,22,12,638606,37838,87651,38605,0.29969268787225956,0.5050168099106523
3798,0.38,7,35,7,638641,37803,87658,38598,0.29941547332404006,0.5052028114815251
3799,0.3801,14,26,14,638667,37777,87672,38584,0.29920954251679127,0.5052841109990702
3800,0.3802,14,27,14,638694,37750,87686,38570,0.2989956912938791,0.5053721174004193
3801,0.3803,16,31,16,638725,37719,87702,38554,0.29875015840831326,0.5054737587350701
3802,0.3804,20,17,20,638742,37702,87722,38534,0.29861551134203523,0.5054567395980901
3803,0.3805,20,36,20,638778,37666,87742,38514,0.29833037637815235,0.5055657652927278
3804,0.3806,14,20,14,638798,37646,87756,38500,0.29817196806488405,0.5056076484647913
3805,0.3807,14,27,14,638825,37619,87770,38486,0.2979581168419719,0.5056960777872676
3806,0.3808,16,20,16,638845,37599,87786,38470,0.2977997085287036,0.5057250654011489
3807,0.3809,18,24,18,638869,37575,87804,38452,0.2976096185527817,0.5057676877951254
3808,0.381,18,26,18,638895,37549,87822,38434,0.2974036877455329,0.5058236710843215
3809,0.3811,20,25,20,638920,37524,87842,38414,0.29720567735394754,0.5058600437198767
3810,0.3812,14,29,14,638949,37495,87856,38400,0.29697598529970853,0.5059621845971408
3811,0.3813,18,30,18,638979,37465,87874,38382,0.2967383728298061,0.5060450644059752
3812,0.3814,14,25,14,639004,37440,87888,38368,0.29654036243822074,0.5061207260447447
3813,0.3815,22,33,22,639037,37407,87910,38346,0.2962789887213281,0.5061977743455705
3814,0.3816,21,28,21,639065,37379,87931,38325,0.2960572170827525,0.506248018598753
3815,0.3817,16,23,16,639088,37356,87947,38309,0.295875047522494,0.5062974955395493
3816,0.3818,16,31,16,639119,37325,87963,38293,0.29562951463692816,0.5064005924515327
3817,0.3819,15,20,15,639139,37305,87978,38278,0.29547110632365986,0.5064366325761084
3818,0.382,14,19,14,639158,37286,87992,38264,0.295320618426055,0.5064725347452018
3819,0.3821,16,18,16,639176,37268,88008,38248,0.29517805094411353,0.5064886911383019
3820,0.3822,14,24,14,639200,37244,88022,38234,0.29498796096819163,0.5065582023901004
3821,0.3823,19,32,19,639232,37212,88041,38215,0.29473450766696235,0.5066488127593567
3822,0.3824,20,32,20,639264,37180,88061,38195,0.29448105436573313,0.5067330016583748
3823,0.3825,15,31,15,639295,37149,88076,38180,0.2942355214801673,0.5068433139959378
3824,0.3826,14,26,14,639321,37123,88090,38166,0.2940295906729185,0.506926642670244
3825,0.3827,24,22,24,639343,37101,88114,38142,0.29385534152832343,0.5069175870180614
3826,0.3828,18,30,18,639373,37071,88132,38124,0.293617729058421,0.5070017953321364
3827,0.3829,17,28,17,639401,37043,88149,38107,0.2933959574198454,0.5070791749833666
3828,0.383,18,36,18,639437,37007,88167,38089,0.2931108224559625,0.5072041120698839
3829,0.3831,12,21,12,639458,36986,88179,38077,0.2929444937270308,0.50726722886109
3830,0.3832,23,17,23,639475,36969,88202,38054,0.29280984666075277,0.5072311157911574
3831,0.3833,19,32,19,639507,36937,88221,38035,0.2925563933595235,0.5073227338206263
3832,0.3834,15,30,15,639537,36907,88236,38020,0.2923187808896211,0.5074272291697252
3833,0.3835,18,27,18,639564,36880,88254,38002,0.2921049296667089,0.5074917870783365
3834,0.3836,16,29,16,639593,36851,88270,37986,0.2918752376124699,0.5075831473736253
3835,0.3837,12,30,12,639623,36821,88282,37974,0.29163762514256747,0.5077077344742296
3836,0.3838,17,47,17,639670,36774,88299,37957,0.29126536560638705,0.50791505533179
3837,0.3839,15,24,15,639694,36750,88314,37942,0.2910752756304651,0.5079794355486531
3838,0.384,20,25,20,639719,36725,88334,37922,0.29087726523887975,0.5080177368146074
3839,0.3841,22,23,22,639742,36702,88356,37900,0.29069509567862123,0.5080292753545481
3840,0.3842,12,29,12,639771,36673,88368,37888,0.2904654036243822,0.5081476911522109
3841,0.3843,12,27,12,639798,36646,88380,37876,0.29025155240147005,0.5082525965486702
3842,0.3844,6,34,6,639832,36612,88386,37870,0.28998225826891394,0.5084449934212293
3843,0.3845,6,26,6,639858,36586,88392,37864,0.2897763274616652,0.5085829415715245
3844,0.3846,16,23,16,639881,36563,88408,37848,0.2895941579014067,0.508634476085525
3845,0.3847,16,33,16,639914,36530,88424,37832,0.289332784184514,0.5087544713697857
3846,0.3848,9,26,9,639940,36504,88433,37823,0.28912685337726524,0.508872953300954
3847,0.3849,16,30,16,639970,36474,88449,37807,0.28888924090736284,0.5089726848049972
3848,0.385,14,31,14,640001,36443,88463,37793,0.288643708021797,0.5090926235249744
3849,0.3851,19,21,19,640022,36422,88482,37774,0.28847737929286527,0.5091110032885869
3850,0.3852,17,31,17,640053,36391,88499,37757,0.28823184640729943,0.5092113071154988
3851,0.3853,16,31,16,640084,36360,88515,37741,0.2879863135217336,0.5093183627751312
3852,0.3854,15,24,15,640108,36336,88530,37726,0.2877962235458117,0.5093840295968243
3853,0.3855,14,22,14,640130,36314,88544,37712,0.28762197440121656,0.5094426282657445
3854,0.3856,5,36,5,640166,36278,88549,37707,0.2873368394373337,0.5096573629789822
3855,0.3857,21,23,21,640189,36255,88570,37686,0.28715466987707516,0.5096766340731124
3856,0.3858,14,27,14,640216,36228,88584,37672,0.286940818654163,0.5097699594046008
3857,0.3859,8,27,8,640243,36201,88592,37664,0.2867269674312508,0.509903201787044
3858,0.386,12,29,12,640272,36172,88604,37652,0.2864972753770118,0.510023840485479
3859,0.3861,15,28,15,640300,36144,88619,37637,0.2862755037384362,0.5101177810005286
3860,0.3862,17,18,17,640318,36126,88636,37620,0.2861329362564947,0.5101293629484989
3861,0.3863,11,24,11,640342,36102,88647,37609,0.2859428462805728,0.5102223548724071
3862,0.3864,12,25,12,640367,36077,88659,37597,0.28574483588898747,0.5103157151776746
3863,0.3865,18,30,18,640397,36047,88677,37579,0.285507223419085,0.5104039333930949
3864,0.3866,15,28,15,640425,36019,88692,37564,0.28528545178050946,0.5104983488033921
3865,0.3867,17,24,17,640449,35995,88709,37547,0.2850953618045875,0.5105517935329471
3866,0.3868,14,33,14,640482,35962,88723,37533,0.28483398808769483,0.5106878018912852
3867,0.3869,15,28,15,640510,35934,88738,37518,0.28461221644911927,0.5107825518706094
3868,0.387,14,20,14,640530,35914,88752,37504,0.28445380813585097,0.5108284072025934
3869,0.3871,14,34,14,640564,35880,88766,37490,0.2841845140032949,0.5109717868338558
3870,0.3872,21,27,21,640591,35853,88787,37469,0.2839706627803827,0.5110198848913013
3871,0.3873,11,33,11,640624,35820,88798,37458,0.2837092890634901,0.5111766150822894
3872,0.3874,13,26,13,640650,35794,88811,37445,0.2835033582562413,0.511271317194391
3873,0.3875,8,29,8,640679,35765,88819,37437,0.2832736662020023,0.5114204529930876
3874,0.3876,18,23,18,640702,35742,88837,37419,0.28309149664174377,0.5114610243162341
3875,0.3877,18,27,18,640729,35715,88855,37401,0.2828776454188316,0.5115296241588708
3876,0.3878,13,29,13,640758,35686,88868,37388,0.2826479533645926,0.5116457289870542
3877,0.3879,19,24,19,640782,35662,88887,37369,0.2824578633886706,0.5116868179266338
3878,0.388,10,19,10,640801,35643,88897,37359,0.28230737549106577,0.5117531026547217
3879,0.3881,21,24,21,640825,35619,88918,37338,0.2821172855151438,0.5117809120440807
3880,0.3882,19,17,19,640842,35602,88937,37319,0.2819826384488658,0.5117730146322733
3881,0.3883,16,26,16,640868,35576,88953,37303,0.28177670764161705,0.511848406262435
3882,0.3884,12,30,12,640898,35546,88965,37291,0.2815390951717146,0.5119788019825089
3883,0.3885,12,21,12,640919,35525,88977,37279,0.2813727664427829,0.5120460414262953
3884,0.3886,23,24,23,640943,35501,89000,37256,0.28118267646686096,0.5120606951908407
3885,0.3887,15,22,15,640965,35479,89015,37241,0.2810084273222659,0.5121149614961497
3886,0.3888,11,29,11,640994,35450,89026,37230,0.2807787352680269,0.5122454595487067
3887,0.3889,8,22,8,641016,35428,89034,37222,0.28060448612343175,0.5123468685478321
3888,0.389,14,34,14,641050,35394,89048,37208,0.2803351919908757,0.5124927687942481
3889,0.3891,12,26,12,641076,35368,89060,37196,0.2801292611836269,0.5125957775205336
3890,0.3892,11,24,11,641100,35344,89071,37185,0.279939171207705,0.5126914751340843
3891,0.3893,15,30,15,641130,35314,89086,37170,0.27970155873780256,0.5128028254511341
3892,0.3894,20,22,20,641152,35292,89106,37150,0.27952730959320743,0.5128240523453246
3893,0.3895,27,34,27,641186,35258,89133,37123,0.2792580154606514,0.5128832152084111
3894,0.3896,17,18,17,641204,35240,89150,37106,0.2791154479787099,0.5128963591629115
3895,0.3897,16,27,16,641231,35213,89166,37090,0.27890159675579773,0.5129800976446344
3896,0.3898,13,25,13,641256,35188,89179,37077,0.2787035863642124,0.5130699508752508
3897,0.3899,16,22,16,641278,35166,89195,37061,0.2785293372196173,0.5131183629390671
3898,0.39,16,28,16,641306,35138,89211,37045,0.2783075655810417,0.5132094814568527
3899,0.3901,18,24,18,641330,35114,89229,37027,0.27811747560511973,0.5132587571561248
3900,0.3902,16,26,16,641356,35088,89245,37011,0.277911544797871,0.5133358299005534
3901,0.3903,14,25,14,641381,35063,89259,36997,0.27771353440628566,0.5134193727449348
3902,0.3904,17,21,17,641402,35042,89276,36980,0.27754720567735397,0.5134542223209575
3903,0.3905,22,22,22,641424,35020,89298,36958,0.27737295653275884,0.5134624468587624
3904,0.3906,16,22,16,641446,34998,89314,36942,0.2771987073881637,0.513511259382819
3905,0.3907,16,22,16,641468,34976,89330,36926,0.27702445824356864,0.5135601235014325
3906,0.3908,12,29,12,641497,34947,89342,36914,0.27679476618932963,0.5136861440837172
3907,0.3909,19,25,19,641522,34922,89361,36895,0.2765967557977443,0.5137363019897796
3908,0.391,11,30,11,641552,34892,89372,36884,0.27635914332784184,0.5138765046812305
3909,0.3911,11,30,11,641582,34862,89383,36873,0.27612153085793945,0.5140168676378337
3910,0.3912,9,14,9,641596,34848,89392,36864,0.27601064503865164,0.5140562248995983
3911,0.3913,14,35,14,641631,34813,89406,36850,0.27573343049043214,0.5142123550507235
3912,0.3914,20,28,20,641659,34785,89426,36830,0.2755116588518565,0.5142777351113593
3913,0.3915,24,19,24,641678,34766,89450,36806,0.27536117095425167,0.5142513832224892
3914,0.3916,12,18,12,641696,34748,89462,36794,0.27521860347231025,0.5142992927231557
3915,0.3917,14,25,14,641721,34723,89476,36780,0.27502059308072485,0.5143840118596422
3916,0.3918,16,24,16,641745,34699,89492,36764,0.27483050310480295,0.5144480360466255
3917,0.3919,19,29,19,641774,34670,89511,36745,0.27460081105056394,0.5145277602744521
3918,0.392,16,22,16,641796,34648,89527,36729,0.2744265619059688,0.5145775249730306
3919,0.3921,14,29,14,641825,34619,89541,36715,0.2741968698517298,0.5146914514817619
3920,0.3922,9,25,9,641850,34594,89550,36706,0.27399885946014446,0.5148106591865358
3921,0.3923,13,21,13,641871,34573,89563,36693,0.2738325307312128,0.5148738528891758
3922,0.3924,17,26,17,641897,34547,89580,36676,0.273626599923964,0.5149460146301055
3923,0.3925,13,30,13,641927,34517,89593,36663,0.2733889874540616,0.5150744591177296
3924,0.3926,18,24,18,641951,34493,89611,36645,0.27319889747813964,0.5151255306587197
3925,0.3927,18,38,18,641989,34455,89629,36627,0.2728979216829299,0.5152781294842577
3926,0.3928,18,21,18,642010,34434,89647,36609,0.27273159295399824,0.5153076305899245
3927,0.3929,16,22,16,642032,34412,89663,36593,0.2725573438094031,0.5153580733751144
3928,0.393,15,14,15,642046,34398,89678,36578,0.2724464579901153,0.515357303877367
3929,0.3931,15,21,15,642067,34377,89693,36563,0.2722801292611836,0.5154073865238229
3930,0.3932,13,26,13,642093,34351,89706,36550,0.2720741984539349,0.5155075386806957
3931,0.3933,16,22,16,642115,34329,89722,36534,0.27189994930933975,0.5155581897464121
3932,0.3934,8,24,8,642139,34305,89730,36526,0.2717098593334178,0.5156781635159746
3933,0.3935,20,22,20,642161,34283,89750,36506,0.2715356101888227,0.5157015920552628
3934,0.3936,16,22,16,642183,34261,89766,36490,0.2713613610442276,0.5157524275275261
3935,0.3937,19,20,19,642203,34241,89785,36471,0.27120295273095935,0.5157681864464306
3936,0.3938,8,27,8,642230,34214,89793,36463,0.27098910150804717,0.515910409326938
3937,0.3939,17,35,17,642265,34179,89810,36446,0.2707118869598277,0.5160495575221239
3938,0.394,10,29,10,642294,34150,89820,36436,0.27048219490558867,0.516193012778738
3939,0.3941,14,25,14,642319,34125,89834,36422,0.27028418451400327,0.5162799268572724
3940,0.3942,16,24,16,642343,34101,89850,36406,0.27009409453808136,0.5163458947338562
3941,0.3943,12,36,12,642379,34065,89862,36394,0.2698089595741985,0.5165273421422387
3942,0.3944,13,24,13,642403,34041,89875,36381,0.2696188695982765,0.5166141262673596
3943,0.3945,16,24,16,642427,34017,89891,36365,0.26942877962235456,0.5166804012389531
3944,0.3946,16,20,16,642447,33997,89907,36349,0.2692703713090863,0.5167173684360162
3945,0.3947,14,29,14,642476,33968,89921,36335,0.2690406792548473,0.5168342744975322
3946,0.3948,6,33,6,642509,33935,89927,36329,0.26877930553795465,0.5170357508823864
3947,0.3949,17,20,17,642529,33915,89944,36312,0.26862089722468635,0.5170660856935366
3948,0.395,9,25,9,642554,33890,89953,36303,0.268422886833101,0.5171883236220136
3949,0.3951,25,19,25,642573,33871,89978,36278,0.26827239893549615,0.5171563386505866
3950,0.3952,20,29,20,642602,33842,89998,36258,0.26804270688125714,0.5172325249643367
3951,0.3953,13,25,13,642627,33817,90011,36245,0.2678446964896718,0.5173275099197854
3952,0.3954,16,31,16,642658,33786,90027,36229,0.26759916360410596,0.5174462615153895
3953,0.3955,13,24,13,642682,33762,90040,36216,0.267409073628184,0.5175340821401012
3954,0.3956,14,21,14,642703,33741,90054,36202,0.2672427448992523,0.5175928970733311
3955,0.3957,17,30,17,642733,33711,90071,36185,0.26700513242934987,0.5176977223303193
3956,0.3958,11,18,11,642751,33693,90082,36174,0.26686256494740845,0.5177551633818541
3957,0.3959,12,30,12,642781,33663,90094,36162,0.266624952477506,0.5178947368421053
3958,0.396,11,24,11,642805,33639,90105,36151,0.2664348625015841,0.5179968476859149
3959,0.3961,11,19,11,642824,33620,90116,36140,0.2662843746039792,0.5180619266055045
3960,0.3962,13,22,13,642846,33598,90129,36127,0.2661101254593841,0.5181355324489064
3961,0.3963,17,28,17,642874,33570,90146,36110,0.2658883538208085,0.5182261768082663
3962,0.3964,12,29,12,642903,33541,90158,36098,0.2656586617665695,0.5183589655221931
3963,0.3965,11,17,11,642920,33524,90169,36087,0.26552401470029147,0.5184094467828361
3964,0.3966,15,17,15,642937,33507,90184,36072,0.26538936763401344,0.5184322856034148
3965,0.3967,16,15,16,642952,33492,90200,36056,0.26527056139906224,0.5184333122447806
3966,0.3968,16,21,16,642973,33471,90216,36040,0.2651042326701305,0.5184790896404886
3967,0.3969,20,31,20,643004,33440,90236,36020,0.26485869978456467,0.5185718399078606
3968,0.397,12,34,12,643038,33406,90248,36008,0.2645894056520086,0.518742616763189
3969,0.3971,16,22,16,643060,33384,90264,35992,0.2644151565074135,0.5187961254612546
3970,0.3972,8,15,8,643075,33369,90272,35984,0.2642963502724623,0.5188528254004874
3971,0.3973,16,18,16,643093,33351,90288,35968,0.2641537827905208,0.5188764985069029
3972,0.3974,13,24,13,643117,33327,90301,35955,0.2639636928145989,0.5189659651857625
3973,0.3975,22,28,22,643145,33299,90323,35933,0.2637419211760233,0.519022995146753
3974,0.3976,12,29,12,643174,33270,90335,35921,0.2635122291217843,0.5191571158098597
3975,0.3977,14,31,14,643205,33239,90349,35907,0.26326669623621846,0.5192925114974113
3976,0.3978,21,22,21,643227,33217,90370,35886,0.2630924470916234,0.5193117520223435
3977,0.3979,11,24,11,643251,33193,90381,35875,0.2629023571157014,0.5194156483465571
3978,0.398,14,36,14,643287,33157,90395,35861,0.26261722215181854,0.519589092700455
3979,0.3981,12,22,12,643309,33135,90407,35849,0.2624429730072234,0.5196712281108663
3980,0.3982,15,23,15,643332,33112,90422,35834,0.2622608034469649,0.5197400864444638
3981,0.3983,23,33,23,643365,33079,90445,35811,0.26199942973007223,0.519828712440122
3982,0.3984,16,19,16,643384,33060,90461,35795,0.2618489418324674,0.5198605765739598
3983,0.3985,19,23,19,643407,33037,90480,35776,0.26166677227220886,0.5199017627483179
3984,0.3986,15,21,15,643428,33016,90495,35761,0.2615004435432772,0.5199557991770505
3985,0.3987,12,27,12,643455,32989,90507,35749,0.261286592320365,0.5200762314876779
3986,0.3988,24,28,24,643483,32961,90531,35725,0.2610648206817894,0.5201205485834085
3987,0.3989,12,20,12,643503,32941,90543,35713,0.2609064123685211,0.520188190054476
3988,0.399,22,21,22,643524,32920,90565,35691,0.2607400836395894,0.5201935549693197
3989,0.3991,14,28,14,643552,32892,90579,35677,0.26051831200101383,0.5203080109087197
3990,0.3992,7,16,7,643568,32876,90586,35670,0.2603915853503992,0.5203804744259329
3991,0.3993,15,23,15,643591,32853,90601,35655,0.2602094157901407,0.5204501664039236
3992,0.3994,14,16,14,643607,32837,90615,35641,0.26008268913952604,0.520473728788808
3993,0.3995,14,25,14,643632,32812,90629,35627,0.2598846787479407,0.5205657592892942
3994,0.3996,13,29,13,643661,32783,90642,35614,0.2596549866937017,0.5206953521353276
3995,0.3997,19,21,19,643682,32762,90661,35595,0.25948865796477,0.5207220913732317
3996,0.3998,23,22,23,643704,32740,90684,35572,0.25931440882017487,0.5207284225319124
3997,0.3999,14,16,14,643720,32724,90698,35558,0.2591876821695603,0.5207521748044873
3998,0.4,15,20,15,643740,32704,90713,35543,0.259029273856292,0.520799449060032
3999,0.4001,19,22,19,643762,32682,90732,35524,0.25885502471169686,0.5208339442277805
4000,0.4002,18,24,18,643786,32658,90750,35506,0.25866493473577495,0.5208907927938501
4001,0.4003,11,22,11,643808,32636,90761,35495,0.2584906855911798,0.5209816383144237
4002,0.4004,16,30,16,643838,32606,90777,35479,0.25825307312127743,0.5210986267166042
4003,0.4005,11,20,11,643858,32586,90788,35468,0.25809466480800913,0.5211743615364269
4004,0.4006,11,19,11,643877,32567,90799,35457,0.2579441769104043,0.5212425026461249
4005,0.4007,15,28,15,643905,32539,90814,35442,0.25772240527182866,0.5213515541107074
4006,0.4008,17,28,17,643933,32511,90831,35425,0.2575006336332531,0.5214466556759303
4007,0.4009,12,29,12,643962,32482,90843,35413,0.2572709415790141,0.5215848000589145
4008,0.401,9,34,9,643996,32448,90852,35404,0.257001647446458,0.521782703531215
4009,0.4011,18,25,18,644021,32423,90870,35386,0.25680363705487264,0.5218481322538306
4010,0.4012,11,25,11,644046,32398,90881,35375,0.2566056266632873,0.5219630236229768
4011,0.4013,14,26,14,644072,32372,90895,35361,0.2563996958560385,0.5220645770894542
4012,0.4014,18,17,18,644089,32355,90913,35343,0.2562650487897605,0.522068598776921
4013,0.4015,16,21,16,644110,32334,90929,35327,0.2560987200608288,0.5221176157609257
4014,0.4016,14,25,14,644135,32309,90943,35313,0.25590070966924344,0.5222117062494455
4015,0.4017,10,20,10,644155,32289,90953,35303,0.25574230135597514,0.5222955379334833
4016,0.4018,10,32,10,644187,32257,90963,35293,0.2554888480547459,0.5224722427831237
4017,0.4019,11,23,11,644210,32234,90974,35282,0.2553066784944874,0.5225724272764974
4018,0.402,11,35,11,644245,32199,90985,35271,0.2550294639462679,0.5227656736327256
4019,0.4021,13,29,13,644274,32170,90998,35258,0.2547997718920289,0.5228984991398232
4020,0.4022,16,26,16,644300,32144,91014,35242,0.2545938410847801,0.5229869705873623
4021,0.4023,11,24,11,644324,32120,91025,35231,0.2544037511088582,0.523095425457677
4022,0.4024,11,18,11,644342,32102,91036,35220,0.25426118362691674,0.5231573631205252
4023,0.4025,16,24,16,644366,32078,91052,35204,0.2540710936509948,0.5232305817306263
4024,0.4026,21,19,21,644385,32059,91073,35183,0.2539206057533899,0.5232295291633206
4025,0.4027,25,24,25,644409,32035,91098,35158,0.253730515777468,0.5232390278749275
4026,0.4028,13,23,13,644432,32012,91111,35145,0.25354834621720945,0.5233259377280105
4027,0.4029,16,21,16,644453,31991,91127,35129,0.25338201748827777,0.523376042908224
4028,0.403,26,24,26,644477,31967,91153,35103,0.25319192751235586,0.5233785597137319
4029,0.4031,12,22,12,644499,31945,91165,35091,0.25301767836776073,0.523465003878513
4030,0.4032,15,13,15,644512,31932,91180,35076,0.25291471296413637,0.5234598853868195
4031,0.4033,16,29,16,644541,31903,91196,35060,0.25268502090989736,0.5235727192628765
4032,0.4034,19,24,19,644565,31879,91215,35041,0.2524949309339754,0.5236252241482366
4033,0.4035,23,17,23,644582,31862,91238,35018,0.2523602838676974,0.5235944976076555
4034,0.4036,14,22,14,644604,31840,91252,35004,0.25218603472310225,0.5236670456585483
4035,0.4037,10,16,10,644620,31824,91262,34994,0.25205930807248766,0.5237211529827293
4036,0.4038,9,23,9,644643,31801,91271,34985,0.25187713851222915,0.5238373311771928
4037,0.4039,15,28,15,644671,31773,91286,34970,0.25165536687365353,0.5239500771616499
4038,0.404,11,26,11,644697,31747,91297,34959,0.25144943606640474,0.5240757952807843
4039,0.4041,19,25,19,644722,31722,91316,34940,0.2512514256748194,0.5241366895682698
4040,0.4042,14,31,14,644753,31691,91330,34926,0.25100589278925356,0.5242805890388339
4041,0.4043,13,22,13,644775,31669,91343,34913,0.2508316436446585,0.5243609383917576
4042,0.4044,8,25,8,644800,31644,91351,34905,0.25063363325307314,0.5245007438128296
4043,0.4045,25,16,25,644816,31628,91376,34880,0.2505069066024585,0.5244481866843087
4044,0.4046,15,19,15,644835,31609,91391,34865,0.25035641870485364,0.5244907783494298
4045,0.4047,15,16,15,644851,31593,91406,34850,0.250229692054239,0.5245097301446352
4046,0.4048,13,15,13,644866,31578,91419,34837,0.2501108858192878,0.5245351200782956
4047,0.4049,8,26,8,644892,31552,91427,34829,0.24990495501203902,0.5246832678025338
4048,0.405,8,22,8,644914,31530,91435,34821,0.24973070586744392,0.5247999276574581
4049,0.4051,12,24,12,644938,31506,91447,34809,0.249540615891522,0.5249038679031893
4050,0.4052,14,17,14,644955,31489,91461,34795,0.24940596882524396,0.5249381449520246
4051,0.4053,5,23,5,644978,31466,91466,34790,0.24922379926498542,0.5250845206471867
4052,0.4054,16,18,16,644996,31448,91482,34774,0.24908123178304398,0.525112500377518
4053,0.4055,18,20,18,645016,31428,91500,34756,0.2489228234697757,0.5251420282847818
4054,0.4056,19,27,19,645043,31401,91519,34737,0.2487089722468635,0.5252199945568357
4055,0.4057,17,26,17,645069,31375,91536,34720,0.24850304143961474,0.5253044859671685
4056,0.4058,19,25,19,645094,31350,91555,34701,0.2483050310480294,0.5253667620475088
4057,0.4059,14,14,14,645108,31336,91569,34687,0.24819414522874161,0.5253775199551671
4058,0.406,13,17,13,645125,31319,91582,34674,0.24805949816246356,0.525419362659676
4059,0.4061,13,25,13,645150,31294,91595,34661,0.2478614877708782,0.5255249791524524
4060,0.4062,13,25,13,645175,31269,91608,34648,0.24766347737929287,0.5256307174173582
4061,0.4063,12,15,12,645190,31254,91620,34636,0.24754467114434164,0.5256639854302626
4062,0.4064,10,26,10,645216,31228,91630,34626,0.24733874033709288,0.525799495854466
4063,0.4065,15,30,15,645246,31198,91645,34611,0.24710112786719046,0.5259311036484371
4064,0.4066,15,21,15,645267,31177,91660,34596,0.24693479913825878,0.5259909081233941
4065,0.4067,18,20,18,645287,31157,91678,34578,0.2467763908249905,0.526021145508481
4066,0.4068,14,25,14,645312,31132,91692,34564,0.24657838043340516,0.5261203117389186
4067,0.4069,12,20,12,645332,31112,91704,34552,0.24641997212013686,0.5261939571150097
4068,0.407,13,22,13,645354,31090,91717,34539,0.24624572297554176,0.5262764936232458
4069,0.4071,12,24,12,645378,31066,91729,34527,0.24605563299961983,0.526382388364612
4070,0.4072,11,25,11,645403,31041,91740,34516,0.24585762260803448,0.5265036533093339
4071,0.4073,8,16,8,645419,31025,91748,34508,0.24573089595741984,0.5265743976317275
4072,0.4074,12,23,12,645442,31002,91760,34496,0.24554872639716133,0.5266725701548138
4073,0.4075,18,28,18,645470,30974,91778,34478,0.24532695475858574,0.5267677076330746
4074,0.4076,18,15,18,645485,30959,91796,34460,0.2452081485236345,0.5267582812332808
4075,0.4077,13,19,13,645504,30940,91809,34447,0.24505766062602966,0.5268172572529708
4076,0.4078,10,20,10,645524,30920,91819,34437,0.24489925231276138,0.5269060697400432
4077,0.4079,17,22,17,645546,30898,91836,34420,0.24472500316816626,0.5269604090755994
4078,0.408,14,22,14,645568,30876,91850,34406,0.24455075402357115,0.5270365491253332
4079,0.4081,13,31,13,645599,30845,91863,34393,0.24430522113800532,0.5271927404273583
4080,0.4082,15,35,15,645634,30810,91878,34378,0.24402800658978582,0.527367000061361
4081,0.4083,18,31,18,645665,30779,91896,34360,0.24378247370422,0.5274873731558667
4082,0.4084,14,26,14,645691,30753,91910,34346,0.24357654289697123,0.527596430052689
4083,0.4085,11,17,11,645708,30736,91921,34335,0.2434418958306932,0.5276544082617448
4084,0.4086,21,17,21,645725,30719,91942,34314,0.24330724876441515,0.5276398136330785
4085,0.4087,17,24,17,645749,30695,91959,34297,0.24311715878849322,0.5277111029049729
4086,0.4088,15,29,15,645778,30666,91974,34282,0.2428874667342542,0.527837654739176
4087,0.4089,9,21,9,645799,30645,91983,34273,0.24272113800532252,0.5279429434055269
4088,0.409,14,25,14,645824,30620,91997,34259,0.24252312761373718,0.5280445136330708
4089,0.4091,18,20,18,645844,30600,92015,34241,0.24236471930046888,0.5280763714316559
4090,0.4092,10,27,10,645871,30573,92025,34231,0.2421508680775567,0.5282235664465157
4091,0.4093,13,23,13,645894,30550,92038,34218,0.2419686985172982,0.5283164525691699
4092,0.4094,19,16,19,645910,30534,92057,34199,0.24184197186668357,0.5283085906724545
4093,0.4095,12,26,12,645936,30508,92069,34187,0.2416360410594348,0.5284334183476312
4094,0.4096,20,25,20,645961,30483,92089,34167,0.24143803066784944,0.528491879350348
4095,0.4097,18,31,18,645992,30452,92107,34149,0.2411924977822836,0.5286141081407408
4096,0.4098,10,17,10,646009,30435,92117,34139,0.24105785071600558,0.5286802737944064
4097,0.4099,23,27,23,646036,30408,92140,34116,0.2408439994930934,0.5287334945136694
4098,0.41,16,19,16,646055,30389,92156,34100,0.24069351159548852,0.5287723487726589
4099,0.4101,7,24,7,646079,30365,92163,34093,0.2405034216195666,0.5289180551677061
4100,0.4102,14,20,14,646099,30345,92177,34079,0.24034501330629832,0.5289798832733142
4101,0.4103,14,19,14,646118,30326,92191,34065,0.24019452540869346,0.5290335605907658
4102,0.4104,10,21,10,646139,30305,92201,34055,0.24002819667976175,0.5291330018645121
4103,0.4105,22,22,22,646161,30283,92223,34033,0.23985394753516665,0.5291529323962934
4104,0.4106,12,23,12,646184,30260,92235,34021,0.23967177797490813,0.5292543675425087
4105,0.4107,14,25,14,646209,30235,92249,34007,0.23947376758332278,0.5293577410416861
4106,0.4108,19,26,19,646235,30209,92268,33988,0.23926783677607402,0.5294328395407885
4107,0.4109,10,18,10,646253,30191,92278,33978,0.23912526929413255,0.5295080178902586
4108,0.411,13,25,13,646278,30166,92291,33965,0.2389272589025472,0.5296190609845473
4109,0.4111,13,19,13,646297,30147,92304,33952,0.23877677100494235,0.5296806502441536
4110,0.4112,17,21,17,646318,30126,92321,33935,0.23861044227601064,0.5297294765926227
4111,0.4113,19,22,19,646340,30104,92340,33916,0.23843619313141554,0.5297719462667916
4112,0.4114,11,23,11,646363,30081,92351,33905,0.23825402357115702,0.5298815365861282
4113,0.4115,14,20,14,646383,30061,92365,33891,0.23809561525788872,0.5299443332499375
4114,0.4116,12,14,12,646397,30047,92377,33879,0.23798472943860094,0.5299721553045709
4115,0.4117,16,19,16,646416,30028,92393,33863,0.23783424154099608,0.5300120517756804
4116,0.4118,16,12,16,646428,30016,92409,33847,0.2377391965530351,0.5299938931775833
4117,0.4119,15,31,15,646459,29985,92424,33832,0.23749366366746927,0.5301408715546014
4118,0.412,15,21,15,646480,29964,92439,33817,0.23732733493853758,0.5302049199604898
4119,0.4121,17,26,17,646506,29938,92456,33800,0.23712140413128882,0.5302958988358593
4120,0.4122,6,25,6,646531,29913,92462,33794,0.23692339373970345,0.5304597610937574
4121,0.4123,14,18,14,646549,29895,92476,33780,0.236780826257762,0.5305064782096585
4122,0.4124,10,22,10,646571,29873,92486,33770,0.2366065771131669,0.5306160928931697
4123,0.4125,14,22,14,646593,29851,92500,33756,0.2364323279685718,0.5306963070102347
4124,0.4126,13,21,13,646614,29830,92513,33743,0.2362659992396401,0.530775643748132
4125,0.4127,11,26,11,646640,29804,92524,33732,0.23606006843239133,0.5309116091664569
4126,0.4128,14,16,14,646656,29788,92538,33718,0.23593334178177672,0.5309419582401663
4127,0.4129,12,22,12,646678,29766,92550,33706,0.2357590926371816,0.5310373077892614
4128,0.413,12,19,12,646697,29747,92562,33694,0.23560860473957673,0.5311076433221419
4129,0.4131,11,21,11,646718,29726,92573,33683,0.23544227601064505,0.5312021952719646
4130,0.4132,11,22,11,646740,29704,92584,33672,0.23526802686604992,0.5313052259530422
4131,0.4133,15,16,15,646756,29688,92599,33657,0.2351413002154353,0.5313284394979872
4132,0.4134,11,21,11,646777,29667,92610,33646,0.23497497148650362,0.5314232464106897
4133,0.4135,13,14,13,646791,29653,92623,33633,0.2348640856672158,0.5314445532977278
4134,0.4136,12,25,12,646816,29628,92635,33621,0.23466607527563046,0.5315657164540151
4135,0.4137,14,26,14,646842,29602,92649,33607,0.2344601444683817,0.5316806151022797
4136,0.4138,12,15,12,646857,29587,92661,33595,0.23434133823343048,0.5317178943369947
4137,0.4139,11,25,11,646882,29562,92672,33584,0.23414332784184513,0.5318468311532005
4138,0.414,14,22,14,646904,29540,92686,33570,0.23396907869725003,0.5319283790207574
4139,0.4141,10,19,10,646923,29521,92696,33560,0.23381859079964518,0.5320143941915949
4140,0.4142,12,24,12,646947,29497,92708,33548,0.23362850082372322,0.5321278451899437
4141,0.4143,8,27,8,646974,29470,92716,33540,0.23341464960081104,0.5322964608792256
4142,0.4144,12,22,12,646996,29448,92728,33528,0.23324040045621594,0.5323932926829268
4143,0.4145,16,20,16,647016,29428,92744,33512,0.23308199214294767,0.5324435970765808
4144,0.4146,11,21,11,647037,29407,92755,33501,0.23291566341401596,0.5325395816112418
4145,0.4147,15,19,15,647056,29388,92770,33486,0.2327651755164111,0.5325889874988071
4146,0.4148,9,22,9,647078,29366,92779,33477,0.232590926371816,0.5327084957751858
4147,0.4149,16,19,16,647097,29347,92795,33461,0.23244043847421111,0.5327506050184689
4148,0.415,9,24,9,647121,29323,92804,33452,0.23225034849828918,0.5328872958980486
4149,0.4151,15,23,15,647144,29300,92819,33437,0.23206817893803067,0.5329709740663404
4150,0.4152,9,19,9,647163,29281,92828,33428,0.2319176910404258,0.5330654292047393
4151,0.4153,10,18,10,647181,29263,92838,33418,0.23177512355848434,0.5331440149327548
4152,0.4154,12,27,12,647208,29236,92850,33406,0.23156127233557217,0.5332843778934261
4153,0.4155,12,20,12,647228,29216,92862,33394,0.2314028640223039,0.5333652771122824
4154,0.4156,6,26,6,647254,29190,92868,33388,0.23119693321505513,0.5335421394100163
4155,0.4157,19,12,19,647266,29178,92887,33369,0.23110188822709415,0.5335028058899708
4156,0.4158,12,25,12,647291,29153,92899,33357,0.2309038778355088,0.5336266197408415
4157,0.4159,6,23,6,647314,29130,92905,33351,0.2307217082752503,0.5337782685936525
4158,0.416,4,18,4,647332,29112,92909,33347,0.23057914079330882,0.5339022398693543
4159,0.4161,9,19,9,647351,29093,92918,33338,0.23042865289570397,0.5339975332767375
4160,0.4162,7,23,7,647374,29070,92925,33331,0.23024648333544545,0.5341420810563934
4161,0.4163,18,16,18,647390,29054,92943,33313,0.2301197566848308,0.5341446598361312
4162,0.4164,12,21,12,647411,29033,92955,33301,0.22995342795589913,0.5342349279686849
4163,0.4165,20,28,20,647439,29005,92975,33281,0.22973165631732353,0.5343255306168321
4164,0.4166,19,20,19,647459,28985,92994,33262,0.22957324800405526,0.5343550693206098
4165,0.4167,14,25,14,647484,28960,93008,33248,0.2293752376124699,0.5344650205761317
4166,0.4168,17,17,17,647501,28943,93025,33231,0.22924059054619186,0.5344838678547302
4167,0.4169,17,18,17,647519,28925,93042,33214,0.22909802306425042,0.5345113374853152
4168,0.417,11,30,11,647549,28895,93053,33203,0.228860410594348,0.534687107475281
4169,0.4171,10,19,10,647568,28876,93063,33193,0.22870992269674312,0.5347758140134367
4170,0.4172,15,14,15,647582,28862,93078,33178,0.22859903687745534,0.5347840103159253
4171,0.4173,9,22,9,647604,28840,93087,33169,0.2284247877328602,0.5349062232901676
4172,0.4174,10,15,10,647619,28825,93097,33159,0.228305981497909,0.5349606350025813
4173,0.4175,12,26,12,647645,28799,93109,33147,0.22810005069066025,0.5350950828140638
4174,0.4176,11,20,11,647665,28779,93120,33136,0.22794164237739198,0.5351853347331018
4175,0.4177,8,21,8,647686,28758,93128,33128,0.22777531364846026,0.5353068545389911
4176,0.4178,14,23,14,647709,28735,93142,33114,0.22759314408820175,0.5354007340458212
4177,0.4179,15,21,15,647730,28714,93157,33099,0.22742681535927006,0.5354698849756524
4178,0.418,12,19,12,647749,28695,93169,33087,0.22727632746166518,0.5355443333009614
4179,0.4181,11,21,11,647770,28674,93180,33076,0.2271099987327335,0.5356437246963562
4180,0.4182,16,20,16,647790,28654,93196,33060,0.22695159041946522,0.5356969245227987
4181,0.4183,13,17,13,647807,28637,93209,33047,0.22681694335318717,0.5357467090331366
4182,0.4184,12,27,12,647834,28610,93221,33035,0.226603092130275,0.5358909887257685
4183,0.4185,12,17,12,647851,28593,93233,33023,0.22646844506399696,0.5359484549467671
4184,0.4186,10,28,10,647879,28565,93243,33013,0.22624667342542137,0.5361167949592387
4185,0.4187,15,10,15,647889,28555,93258,32998,0.22616746926878722,0.5360908485370331
4186,0.4188,13,16,13,647905,28539,93271,32985,0.2260407426181726,0.536132241076653
4187,0.4189,16,16,16,647921,28523,93287,32969,0.22591401596755797,0.5361510440382489
4188,0.419,10,20,10,647941,28503,93297,32959,0.2257556076542897,0.5362500406755394
4189,0.4191,11,22,11,647963,28481,93308,32948,0.2255813585096946,0.5363590486578
4190,0.4192,16,19,16,647982,28462,93324,32932,0.22543087061208972,0.5364042088803466
4191,0.4193,16,24,16,648006,28438,93340,32916,0.2252407806361678,0.5364931381816996
4192,0.4194,15,15,15,648021,28423,93355,32901,0.22512197440121656,0.5365109908029483
4193,0.4195,16,26,16,648047,28397,93371,32885,0.2249160435939678,0.5366176038641036
4194,0.4196,17,25,17,648072,28372,93388,32868,0.22471803320238246,0.5367080339647289
4195,0.4197,14,16,14,648088,28356,93402,32854,0.22459130655176784,0.5367423623590917
4196,0.4198,17,16,17,648104,28340,93419,32837,0.2244645799011532,0.5367540088595387
4197,0.4199,17,24,17,648128,28316,93436,32820,0.22427448992523127,0.5368359068306726
4198,0.42,8,22,8,648150,28294,93444,32812,0.22410024078063617,0.5369685464602494
4199,0.4201,16,29,16,648179,28265,93460,32796,0.22387054872639717,0.5371022420202748
4200,0.4202,12,18,12,648197,28247,93472,32784,0.2237279812444557,0.537169635103472
4201,0.4203,10,17,10,648214,28230,93482,32774,0.22359333417817767,0.5372434594452823
4202,0.4204,11,16,11,648230,28214,93493,32763,0.22346660752756306,0.5373009495383505
4203,0.4205,12,23,12,648253,28191,93505,32751,0.22328443796730452,0.5374126218371567
4204,0.4206,7,15,7,648268,28176,93512,32744,0.22316563173235332,0.5374917925147735
4205,0.4207,11,25,11,648293,28151,93523,32733,0.22296762134076797,0.5376289337100059
4206,0.4208,11,18,11,648311,28133,93534,32722,0.2228250538588265,0.5377043792621806
4207,0.4209,9,22,9,648333,28111,93543,32713,0.2226508047142314,0.5378304616598711
4208,0.421,12,13,12,648346,28098,93555,32701,0.222547839310607,0.537854241023701
4209,0.4211,17,19,17,648365,28079,93572,32684,0.22239735141300215,0.5378931257508681
4210,0.4212,9,20,9,648385,28059,93581,32675,0.22223894309973388,0.5380017782461224
4211,0.4213,12,24,12,648409,28035,93593,32663,0.22204885312381195,0.5381231671554252
4212,0.4214,14,16,14,648425,28019,93607,32649,0.2219221264731973,0.5381585020109448
4213,0.4215,12,23,12,648448,27996,93619,32637,0.2217399569129388,0.5382712384345159
4214,0.4216,20,22,20,648470,27974,93639,32617,0.2215657077683437,0.5383142710963674
4215,0.4217,14,22,14,648492,27952,93653,32603,0.22139145862374857,0.5384031046156387
4216,0.4218,18,9,18,648501,27943,93671,32585,0.22132017488277786,0.5383458895056833
4217,0.4219,13,13,13,648514,27930,93684,32572,0.22121720947915346,0.5383623681861757
4218,0.422,12,23,12,648537,27907,93696,32560,0.22103503991889495,0.5384755321084228
4219,0.4221,12,23,12,648560,27884,93708,32548,0.22085287035863643,0.5385888271114642
4220,0.4222,19,27,19,648587,27857,93727,32529,0.22063901913572423,0.5386844632861921
4221,0.4223,14,26,14,648613,27831,93741,32515,0.22043308832847547,0.5388095317005269
4222,0.4224,11,24,11,648637,27807,93752,32504,0.22024299835255354,0.5389398285553216
4223,0.4225,16,25,16,648662,27782,93768,32488,0.2200449879609682,0.5390409822465572
4224,0.4226,10,22,10,648684,27760,93778,32478,0.2198707388163731,0.5391613267372755
4225,0.4227,9,23,9,648707,27737,93787,32469,0.21968856925611457,0.5392984087964655
4226,0.4228,8,16,8,648723,27721,93795,32461,0.21956184260549994,0.5393805456781098
4227,0.4229,18,21,18,648744,27700,93813,32443,0.21939551387656825,0.5394310227291622
4228,0.423,14,17,14,648761,27683,93827,32429,0.2192608668102902,0.5394763108863455
4229,0.4231,16,27,16,648788,27656,93843,32413,0.21904701558737802,0.5395961311158834
4230,0.4232,13,16,13,648804,27640,93856,32400,0.2189202889367634,0.5396402398401066
4231,0.4233,13,24,13,648828,27616,93869,32387,0.21873019896084148,0.5397563455160576
4232,0.4234,19,21,19,648849,27595,93888,32368,0.21856387023190976,0.5397995430515484
4233,0.4235,17,18,17,648867,27577,93905,32351,0.21842130274996832,0.5398311306901615
4234,0.4236,9,19,9,648886,27558,93914,32342,0.21827081485236347,0.5399332220367279
4235,0.4237,19,15,19,648901,27543,93933,32323,0.21815200861741224,0.5399224935689707
4236,0.4238,10,22,10,648923,27521,93943,32313,0.21797775947281714,0.5400441220710632
4237,0.4239,15,24,15,648947,27497,93958,32298,0.2177876694968952,0.5401454971151434
4238,0.424,19,25,19,648972,27472,93977,32279,0.21758965910530984,0.5402252681963482
4239,0.4241,11,19,11,648991,27453,93988,32268,0.21743917120770498,0.5403124529060129
4240,0.4242,15,21,15,649012,27432,94003,32253,0.2172728424787733,0.5403870319175672
4241,0.4243,17,19,17,649031,27413,94020,32236,0.2171223545811684,0.5404281714697647
4242,0.4244,16,19,16,649050,27394,94036,32220,0.21697186668356355,0.5404770691448317
4243,0.4245,15,13,15,649063,27381,94051,32205,0.21686890127993916,0.5404793072198167
4244,0.4246,7,16,7,649079,27365,94058,32198,0.21674217462932455,0.5405704883904437
4245,0.4247,9,18,9,649097,27347,94067,32189,0.2165996071473831,0.5406644719161515
4246,0.4248,10,15,10,649112,27332,94077,32179,0.21648080091243188,0.5407235637109106
4247,0.4249,9,17,9,649129,27315,94086,32170,0.21634615384615385,0.5408086072119022
4248,0.425,12,30,12,649159,27285,94098,32158,0.21610854137625143,0.5409888464579513
4249,0.4251,15,22,15,649181,27263,94113,32143,0.2159342922316563,0.5410732922600411
4250,0.4252,11,26,11,649207,27237,94124,32132,0.21572836142440754,0.5412252185484007
4251,0.4253,9,20,9,649227,27217,94133,32123,0.21556995311113927,0.5413380519042804
4252,0.4254,17,20,17,649247,27197,94150,32106,0.215411544797871,0.5413891371431462
4253,0.4255,17,20,17,649267,27177,94167,32089,0.2152531364846027,0.5414402861674484
4254,0.4256,15,12,15,649279,27165,94182,32074,0.21515809149664175,0.5414338526983913
4255,0.4257,16,13,16,649292,27152,94198,32058,0.21505512609301736,0.5414288127005573
4256,0.4258,12,20,12,649312,27132,94210,32046,0.21489671777974909,0.5415188076650106
4257,0.4259,10,22,10,649334,27110,94220,32036,0.21472246863515398,0.5416427146383526
4258,0.426,15,18,15,649352,27092,94235,32021,0.21457990115321252,0.5416913369309627
4259,0.4261,16,27,16,649379,27065,94251,32005,0.21436604993030034,0.5418147960047401
4260,0.4262,10,15,10,649394,27050,94261,31995,0.21424724369534914,0.5418748412227962
4261,0.4263,11,21,11,649415,27029,94272,31984,0.21408091496641743,0.5419822750919289
4262,0.4264,15,19,15,649434,27010,94287,31969,0.21393042706881257,0.5420403872564811
4263,0.4265,10,15,10,649449,26995,94297,31959,0.21381162083386135,0.5421006208230146
4264,0.4266,9,14,9,649463,26981,94306,31950,0.21370073501457357,0.542159474639833
4265,0.4267,7,10,7,649473,26971,94313,31943,0.21362153085793942,0.5421971008588791
4266,0.4268,16,25,16,649498,26946,94329,31927,0.21342352046635407,0.5423029232415538
4267,0.4269,15,27,15,649525,26919,94344,31912,0.2132096692434419,0.5424351107409359
4268,0.427,11,23,11,649548,26896,94355,31901,0.21302749968318338,0.5425616953245914
4269,0.4271,10,16,10,649564,26880,94365,31891,0.21290077303256874,0.5426315699920029
4270,0.4272,15,24,15,649588,26856,94380,31876,0.2127106830566468,0.5427364979908738
4271,0.4273,13,21,13,649609,26835,94393,31863,0.21254435432771512,0.5428293979351937
4272,0.4274,11,11,11,649620,26824,94404,31852,0.21245722975541756,0.5428454564046629
4273,0.4275,10,20,10,649640,26804,94414,31842,0.2122988214421493,0.5429526310404802
4274,0.4276,10,22,10,649662,26782,94424,31832,0.2121245722975542,0.5430784454225953
4275,0.4277,16,16,16,649678,26766,94440,31816,0.21199784564693955,0.5431019767163975
4276,0.4278,16,28,16,649706,26738,94456,31800,0.21177607400836396,0.5432368717755988
4277,0.4279,12,20,12,649726,26718,94468,31788,0.21161766569509569,0.5433288893446826
4278,0.428,13,21,13,649747,26697,94481,31775,0.21145133696616397,0.5434224928170749
4279,0.4281,15,11,15,649758,26686,94496,31760,0.21136421239386644,0.5434075899120556
4280,0.4282,14,22,14,649780,26664,94510,31746,0.21118996324927133,0.5435028248587571
4281,0.4283,17,21,17,649801,26643,94527,31729,0.21102363452033962,0.5435654080723634
4282,0.4284,13,18,13,649819,26625,94540,31716,0.21088106703839818,0.5436314084434617
4283,0.4285,5,23,5,649842,26602,94545,31711,0.21069889747813966,0.5438066983348482
4284,0.4286,9,19,9,649861,26583,94554,31702,0.21054840958053478,0.5439135283520632
4285,0.4287,9,19,9,649880,26564,94563,31693,0.21039792168292992,0.5440204610604734
4286,0.4288,10,23,10,649903,26541,94573,31683,0.2102157521226714,0.5441570486397362
4287,0.4289,12,19,12,649922,26522,94585,31671,0.21006526422506652,0.5442407162373482
4288,0.429,12,19,12,649941,26503,94597,31659,0.20991477632746167,0.5443244730236236
4289,0.4291,12,22,12,649963,26481,94609,31647,0.20974052718286657,0.5444364161849711
4290,0.4292,14,20,14,649983,26461,94623,31633,0.20958211886959827,0.5445140634144662
4291,0.4293,10,10,10,649993,26451,94633,31623,0.20950291471296414,0.5445293935323897
4292,0.4294,14,19,14,650012,26432,94647,31609,0.20935242681535926,0.5445977843248738
4293,0.4295,13,22,13,650034,26410,94660,31596,0.20917817767076416,0.5447022721787401
4294,0.4296,16,26,16,650060,26384,94676,31580,0.2089722468635154,0.5448209233317232
4295,0.4297,11,23,11,650083,26361,94687,31569,0.20879007730325688,0.5449508026929052
4296,0.4298,16,25,16,650108,26336,94703,31553,0.20859206691167154,0.545060374164349
4297,0.4299,12,27,12,650135,26309,94715,31541,0.20837821568875933,0.5452203975799481
4298,0.43,9,25,9,650160,26284,94724,31532,0.208180205297174,0.5453853604538536
4299,0.4301,10,15,10,650175,26269,94734,31522,0.2080613990622228,0.5454482531882127
4300,0.4302,13,26,13,650201,26243,94747,31509,0.20785546825497403,0.5455914946668514
4301,0.4303,12,22,12,650223,26221,94759,31497,0.2076812191103789,0.5457049793825149
4302,0.4304,12,15,12,650238,26206,94771,31485,0.2075624128754277,0.5457523703870621
4303,0.4305,9,17,9,650255,26189,94780,31476,0.20742776580914968,0.5458423653862828
4304,0.4306,13,26,13,650281,26163,94793,31463,0.2072218350019009,0.5459861867906848
4305,0.4307,13,23,13,650304,26140,94806,31450,0.20703966544164237,0.5461017537766973
4306,0.4308,12,25,12,650329,26115,94818,31438,0.20684165505005703,0.5462443313120081
4307,0.4309,16,16,16,650345,26099,94834,31422,0.20671492839944242,0.5462700578919003
4308,0.431,9,20,9,650365,26079,94843,31413,0.20655652008617412,0.5463890628261323
4309,0.4311,13,18,13,650383,26061,94856,31400,0.20641395260423268,0.5464575973268826
4310,0.4312,13,21,13,650404,26040,94869,31387,0.206247623875301,0.5465547564734359
4311,0.4313,17,22,17,650426,26018,94886,31370,0.20607337473070586,0.5466299574824005
4312,0.4314,18,22,18,650448,25996,94904,31352,0.20589912558611076,0.5466973564902001
4313,0.4315,15,18,15,650466,25978,94919,31337,0.20575655810416932,0.5467504143766903
4314,0.4316,9,9,9,650475,25969,94928,31328,0.20568527436319858,0.5467651011396757
4315,0.4317,14,11,14,650486,25958,94942,31314,0.20559814979090102,0.5467593239279229
4316,0.4318,11,16,11,650502,25942,94953,31303,0.2054714231402864,0.5468250502227269
4317,0.4319,14,22,14,650524,25920,94967,31289,0.2052971739956913,0.5469244349665262
4318,0.432,16,20,16,650544,25900,94983,31273,0.205138765682423,0.5469889633218478
4319,0.4321,12,21,12,650565,25879,94995,31261,0.20497243695349132,0.5470948547427371
4320,0.4322,16,23,16,650588,25856,95011,31245,0.2047902673932328,0.5471883154410606
4321,0.4323,13,15,13,650603,25841,95024,31232,0.20467146115828158,0.5472289874371419
4322,0.4324,16,20,16,650623,25821,95040,31216,0.2045130528450133,0.5472938618791311
4323,0.4325,17,14,17,650637,25807,95057,31199,0.2044021670257255,0.547293267375364
4324,0.4326,10,19,10,650656,25788,95067,31189,0.20425167912812064,0.5473963178124507
4325,0.4327,9,18,9,650674,25770,95076,31180,0.2041091116461792,0.5474978050921862
4326,0.4328,15,25,15,650699,25745,95091,31165,0.20391110125459383,0.5476190476190477
4327,0.4329,10,22,10,650721,25723,95101,31155,0.20373685210999873,0.5477513274025106
4328,0.433,13,26,13,650747,25697,95114,31142,0.20353092130274997,0.5478984500079171
4329,0.4331,11,21,11,650768,25676,95125,31131,0.20336459257381828,0.5480134490467724
4330,0.4332,7,21,7,650789,25655,95132,31124,0.20319826384488657,0.548160411419715
4331,0.4333,17,16,17,650805,25639,95149,31107,0.20307153719427196,0.5481796073732069
4332,0.4334,11,18,11,650823,25621,95160,31096,0.20292896971233051,0.5482659520073346
4333,0.4335,14,15,14,650838,25606,95174,31082,0.2028101634773793,0.5482994637313011
4334,0.4336,18,14,18,650852,25592,95192,31064,0.2026992776580915,0.5482914430951709
4335,0.4337,12,24,12,650876,25568,95204,31052,0.20250918768216955,0.5484281172730484
4336,0.4338,8,12,8,650888,25556,95212,31044,0.2024141426942086,0.5484805653710247
4337,0.4339,13,10,13,650898,25546,95225,31031,0.20233493853757445,0.5484737614224862
4338,0.434,16,29,16,650927,25517,95241,31015,0.20210524648333544,0.548627326116182
4339,0.4341,5,25,5,650952,25492,95246,31010,0.2019072360917501,0.5488301299069059
4340,0.4342,8,16,8,650968,25476,95254,31002,0.20178050944113546,0.5489217040263465
4341,0.4343,9,20,9,650988,25456,95263,30993,0.2016221011278672,0.5490442700490709
4342,0.4344,13,26,13,651014,25430,95276,30980,0.20141617032061843,0.5491934054245701
4343,0.4345,17,15,17,651029,25415,95293,30963,0.2012973640856672,0.5492035900528575
4344,0.4346,16,21,16,651050,25394,95309,30947,0.20113103535673552,0.5492802754654692
4345,0.4347,11,22,11,651072,25372,95320,30936,0.20095678621214041,0.549406833842438
4346,0.4348,8,15,8,651087,25357,95328,30928,0.2008379799771892,0.5494892067158212
4347,0.4349,9,11,9,651098,25346,95337,30919,0.20075085540489165,0.549524571225451
4348,0.435,8,19,8,651117,25327,95345,30911,0.20060036750728677,0.5496461467335254
4349,0.4351,15,21,15,651138,25306,95360,30896,0.20043403877835508,0.5497313262873207
4350,0.4352,16,17,16,651155,25289,95376,30880,0.20029939171207706,0.5497694457797005
4351,0.4353,9,16,9,651171,25273,95385,30871,0.20017266506146242,0.5498539469934455
4352,0.4354,11,21,11,651192,25252,95396,30860,0.20000633633253073,0.5499714856002281
4353,0.4355,8,21,8,651213,25231,95404,30852,0.19984000760359905,0.5501132250414564
4354,0.4356,7,17,7,651230,25214,95411,30845,0.199705360537321,0.5502238712784745
4355,0.4357,11,23,11,651253,25191,95422,30834,0.19952319097706248,0.5503614457831325
4356,0.4358,6,24,6,651277,25167,95428,30828,0.19933310100114054,0.5505491561746585
4357,0.4359,19,14,19,651291,25153,95447,30809,0.19922221518185274,0.5505342911261213
4358,0.436,9,17,9,651308,25136,95456,30800,0.1990875681155747,0.5506292906178489
4359,0.4361,15,21,15,651329,25115,95471,30785,0.19892123938664302,0.5507155635062612
4360,0.4362,16,6,16,651335,25109,95487,30769,0.19887371689266253,0.55064605032392
4361,0.4363,6,12,6,651347,25097,95493,30763,0.19877867190470155,0.5507160759040458
4362,0.4364,11,19,11,651366,25078,95504,30752,0.1986281840070967,0.5508149740283002
4363,0.4365,13,18,13,651384,25060,95517,30739,0.19848561652515523,0.5508880087456764
4364,0.4366,14,25,14,651409,25035,95531,30725,0.19828760613356988,0.5510222381635581
4365,0.4367,10,17,10,651426,25018,95541,30715,0.19815295906729186,0.5511097554411211
4366,0.4368,9,19,9,651445,24999,95550,30706,0.19800247116968697,0.5512252042007001
4367,0.4369,10,16,10,651461,24983,95560,30696,0.19787574451907236,0.5513030047235044
4368,0.437,17,16,17,651477,24967,95577,30679,0.19774901786845775,0.5513244438054846
4369,0.4371,14,20,14,651497,24947,95591,30665,0.19759060955518945,0.5514097676760411
4370,0.4372,11,22,11,651519,24925,95602,30654,0.19741636041059435,0.5515392504363159
4371,0.4373,14,17,14,651536,24908,95616,30640,0.19728171334431632,0.5515950169223014
4372,0.4374,15,14,15,651550,24894,95631,30625,0.1971708275250285,0.5516129613285542
4373,0.4375,6,15,6,651565,24879,95637,30619,0.1970520212900773,0.5517135752639735
4374,0.4376,11,15,11,651580,24864,95648,30608,0.1969332150551261,0.5517738678973175
4375,0.4377,13,13,13,651593,24851,95661,30595,0.1968302496515017,0.5517981459438012
4376,0.4378,16,26,16,651619,24825,95677,30579,0.19662431884425294,0.5519276586528048
4377,0.4379,15,21,15,651640,24804,95692,30564,0.19645799011532125,0.5520156046814044
4378,0.438,17,13,17,651653,24791,95709,30547,0.19635502471169686,0.5520076620044093
4379,0.4381,16,13,16,651666,24778,95725,30531,0.1962520593080725,0.5520078106637256
4380,0.4382,16,15,16,651681,24763,95741,30515,0.19613325307312127,0.5520279315460038
4381,0.4383,11,21,11,651702,24742,95752,30504,0.19596692434418958,0.5521485718423054
4382,0.4384,11,18,11,651720,24724,95763,30493,0.19582435686224814,0.5522393465780466
4383,0.4385,12,17,12,651737,24707,95775,30481,0.19568970979597008,0.5523120968326448
4384,0.4386,11,10,11,651747,24697,95786,30470,0.19561050563933596,0.5523229466891438
4385,0.4387,9,19,9,651766,24678,95795,30461,0.19546001774173108,0.5524401965940623
4386,0.4388,10,14,10,651780,24664,95805,30451,0.1953491319224433,0.5524993196044634
4387,0.4389,9,20,9,651800,24644,95814,30442,0.195190723609175,0.5526268017282068
4388,0.439,15,14,15,651814,24630,95829,30427,0.19507983778988722,0.5526454401801769
4389,0.4391,10,14,10,651828,24616,95839,30417,0.1949689519705994,0.5527047407918885
4390,0.4392,3,16,3,651844,24600,95842,30414,0.1948422253199848,0.5528410949940016
4391,0.4393,17,15,17,651859,24585,95859,30397,0.19472341908503357,0.5528536611982103
4392,0.4394,10,17,10,651876,24568,95869,30387,0.19458877201875555,0.552943317259576
4393,0.4395,12,22,12,651898,24546,95881,30375,0.19441452287416044,0.5530671327907358
4394,0.4396,19,29,19,651927,24517,95900,30356,0.19418483081992144,0.5532046726076577
4395,0.4397,15,10,15,651937,24507,95915,30341,0.1941056266632873,0.5531833430571762
4396,0.4398,11,19,11,651956,24488,95926,30330,0.19395513876568243,0.5532854171987304
4397,0.4399,21,14,21,651970,24474,95947,30309,0.19384425294639462,0.5532555719840097
4398,0.44,14,17,14,651987,24457,95961,30295,0.1937096058801166,0.5533131209818819
4399,0.4401,13,10,13,651997,24447,95974,30282,0.19363040172348245,0.5533081181823165
4400,0.4402,13,23,13,652020,24424,95987,30269,0.19344823216322393,0.5534346260033277
4401,0.4403,16,13,16,652033,24411,96003,30253,0.19334526675959954,0.5534355334406557
4402,0.4404,13,17,13,652050,24394,96016,30240,0.1932106196933215,0.5535014825932569
4403,0.4405,13,18,13,652068,24376,96029,30227,0.19306805221138004,0.5535776422540886
4404,0.4406,11,29,11,652097,24347,96040,30216,0.19283836015714104,0.5537818668328355
4405,0.4407,16,23,16,652120,24324,96056,30200,0.19265619059688252,0.553884527914313
4406,0.4408,13,15,13,652135,24309,96069,30187,0.19253738436193132,0.5539305637110981
4407,0.4409,7,16,7,652151,24293,96076,30180,0.19241065771131668,0.5540359444128283
4408,0.441,17,18,17,652169,24275,96093,30163,0.19226809022937524,0.5540798706785701
4409,0.4411,8,14,8,652183,24261,96101,30155,0.19215720441008743,0.5541568656277566
4410,0.4412,7,13,7,652196,24248,96108,30148,0.19205423900646307,0.5542319288182954
4411,0.4413,13,19,13,652215,24229,96121,30135,0.19190375110885818,0.5543190346552865
4412,0.4414,13,21,13,652236,24208,96134,30122,0.1917374223799265,0.5544266519418369
4413,0.4415,15,14,15,652250,24194,96149,30107,0.19162653656063872,0.5544465111139758
4414,0.4416,7,16,7,652266,24178,96156,30100,0.19149980991002408,0.5545524890379159
4415,0.4417,7,14,7,652280,24164,96163,30093,0.1913889240907363,0.5546381112114566
4416,0.4418,11,24,11,652304,24140,96174,30082,0.19119883411481434,0.5547932573494153
4417,0.4419,6,18,6,652322,24122,96180,30076,0.1910562666328729,0.5549282261338057
4418,0.442,8,20,8,652342,24102,96188,30068,0.19089785831960462,0.5550673804688943
4419,0.4421,11,14,11,652356,24088,96199,30057,0.19078697250031681,0.5551205097423585
4420,0.4422,9,18,9,652374,24070,96208,30048,0.19064440501837537,0.555231161535903
4421,0.4423,14,21,14,652395,24049,96222,30034,0.19047807628944366,0.5553316199175342
4422,0.4424,15,19,15,652414,24030,96237,30019,0.1903275883918388,0.5554034302207257
4423,0.4425,10,19,10,652433,24011,96247,30009,0.19017710049423395,0.5555164753794891
4424,0.4426,8,21,8,652454,23990,96255,30001,0.19001077176530223,0.5556666851882721
4425,0.4427,6,15,6,652469,23975,96261,29995,0.18989196553035104,0.5557717250324254
4426,0.4428,9,22,9,652491,23953,96270,29986,0.18971771638575594,0.5559242848402826
4427,0.4429,11,17,11,652508,23936,96281,29975,0.18958306931947788,0.5560089777596409
4428,0.443,4,23,4,652531,23913,96285,29971,0.18940089975921937,0.5562133471902606
4429,0.4431,15,14,15,652545,23899,96300,29956,0.18929001393993156,0.5562343329310184
4430,0.4432,12,23,12,652568,23876,96312,29944,0.18910784437967304,0.5563730955035303
4431,0.4433,8,22,8,652590,23854,96320,29936,0.18893359523507794,0.5565346718720952
4432,0.4434,15,21,15,652611,23833,96335,29921,0.18876726650614625,0.5566283439371954
4433,0.4435,14,27,14,652638,23806,96349,29907,0.18855341528323408,0.556792582801184
4434,0.4436,13,29,13,652667,23777,96362,29894,0.18832372322899507,0.5569860818691659
4435,0.4437,11,11,11,652678,23766,96373,29883,0.1882365986566975,0.5570094503159425
4436,0.4438,13,15,13,652693,23751,96386,29870,0.18811779242174628,0.5570578691184424
4437,0.4439,18,23,18,652716,23728,96404,29852,0.18793562286148777,0.5571481896229936
4438,0.444,6,13,6,652729,23715,96410,29846,0.1878326574578634,0.557233808181326
4439,0.4441,11,16,11,652745,23699,96421,29835,0.18770593080724876,0.5573093734822729
4440,0.4442,10,20,10,652765,23679,96431,29825,0.1875475224939805,0.5574349581339713
4441,0.4443,15,16,15,652781,23663,96446,29810,0.18742079584336585,0.557477605520543
4442,0.4444,15,20,15,652801,23643,96461,29795,0.18726238753009758,0.5575620345072795
4443,0.4445,10,15,10,652816,23628,96471,29785,0.18714358129514638,0.5576357815513078
4444,0.4446,12,15,12,652831,23613,96483,29773,0.18702477506019516,0.557693028134717
4445,0.4447,13,22,13,652853,23591,96496,29760,0.18685052591560006,0.557815223707147
4446,0.4448,13,19,13,652872,23572,96509,29747,0.18670003801799517,0.5579061872878336
4447,0.4449,8,21,8,652893,23551,96517,29739,0.1865337092890635,0.5580596734847063
4448,0.445,8,9,8,652902,23542,96525,29731,0.18646242554809275,0.5580875865823213
4449,0.4451,12,11,12,652913,23531,96537,29719,0.18637530097579522,0.5581032863849765
4450,0.4452,17,14,17,652927,23517,96554,29702,0.1862644151565074,0.5581089460531014
4451,0.4453,6,20,6,652947,23497,96560,29696,0.18610600684323914,0.5582689451619574
4452,0.4454,15,20,15,652967,23477,96575,29681,0.18594759852997086,0.5583543398923962
4453,0.4455,13,20,13,652987,23457,96588,29668,0.18578919021670257,0.5584564705882353
4454,0.4456,16,15,16,653002,23442,96604,29652,0.18567038398175137,0.5584811843146118
4455,0.4457,16,14,16,653016,23428,96620,29636,0.18555949816246356,0.5584954017789838
4456,0.4458,18,24,18,653040,23404,96638,29618,0.18536940818654163,0.5585983176794538
4457,0.4459,9,20,9,653060,23384,96647,29609,0.18521099987327336,0.5587341724378692
4458,0.446,11,17,11,653077,23367,96658,29598,0.1850763528069953,0.5588218634947607
4459,0.4461,21,12,21,653089,23355,96679,29577,0.18498130781903435,0.5587735207435955
4460,0.4462,7,19,7,653108,23336,96686,29570,0.18483081992142947,0.558915812951272
4461,0.4463,13,22,13,653130,23314,96699,29557,0.18465657077683437,0.5590399273703921
4462,0.4464,18,10,18,653140,23304,96717,29539,0.18457736662020022,0.5589955150161801
4463,0.4465,8,16,8,653156,23288,96725,29531,0.1844506399695856,0.559098051837407
4464,0.4466,18,10,18,653166,23278,96743,29513,0.18437143581295146,0.5590536265651342
4465,0.4467,4,26,4,653192,23252,96747,29509,0.1841655050057027,0.5592956918936336
4466,0.4468,10,23,10,653215,23229,96757,29499,0.18398333544544418,0.5594560764679107
4467,0.4469,19,20,19,653235,23209,96776,29480,0.1838249271321759,0.5595095750536165
4468,0.447,17,14,17,653249,23195,96793,29463,0.1837140413128881,0.559516122906301
4469,0.4471,11,19,11,653268,23176,96804,29452,0.18356355341528324,0.5596260545717109
4470,0.4472,10,7,10,653275,23169,96814,29442,0.18350811050563934,0.5596168101727775
4471,0.4473,13,16,13,653291,23153,96827,29429,0.1833813838550247,0.5596782168803013
4472,0.4474,18,18,18,653309,23135,96845,29411,0.18323881637308326,0.5597191032619039
4473,0.4475,14,9,14,653318,23126,96859,29397,0.18316753263211252,0.5596976562648744
4474,0.4476,12,18,12,653336,23108,96871,29385,0.18302496515017108,0.5597889242375174
4475,0.4477,12,16,12,653352,23092,96883,29373,0.18289823849955647,0.5598589535881063
4476,0.4478,13,23,13,653375,23069,96896,29360,0.18271606893929793,0.5599954223807435
4477,0.4479,17,19,17,653394,23050,96913,29343,0.18256558104169307,0.5600557326360391
4478,0.448,9,19,9,653413,23031,96922,29334,0.18241509314408821,0.5601833285591521
4479,0.4481,16,15,16,653428,23016,96938,29318,0.182296286909137,0.5602094240837696
4480,0.4482,15,18,15,653446,22998,96953,29303,0.18215371942719555,0.5602760941473395
4481,0.4483,12,16,12,653462,22982,96965,29291,0.1820269927765809,0.5603466416696956
4482,0.4484,11,22,11,653484,22960,96976,29280,0.1818527436319858,0.5604900459418071
4483,0.4485,10,10,10,653494,22950,96986,29270,0.18177353947535166,0.5605132133282267
4484,0.4486,11,10,11,653504,22940,96997,29259,0.18169433531871754,0.5605279794632081
4485,0.4487,11,11,11,653515,22929,97008,29248,0.18160721074641997,0.5605535005845488
4486,0.4488,13,16,13,653531,22913,97021,29235,0.18148048409580536,0.5606159392498274
4487,0.4489,10,19,10,653550,22894,97031,29225,0.18132999619820048,0.5607360079817341
4488,0.449,13,15,13,653565,22879,97044,29212,0.18121118996324928,0.5607878520281815
4489,0.4491,18,16,18,653581,22863,97062,29194,0.18108446331263464,0.5608083446990798
4490,0.4492,8,13,8,653594,22850,97070,29186,0.18098149790901027,0.5608809285879007
4491,0.4493,6,18,6,653612,22832,97076,29180,0.1808389304270688,0.561024378989464
4492,0.4494,6,18,6,653630,22814,97082,29174,0.18069636294512736,0.5611679618373471
4493,0.4495,9,16,9,653646,22798,97091,29165,0.18056963629451273,0.5612647460693185
4494,0.4496,10,19,10,653665,22779,97101,29155,0.18041914839690787,0.5613856048061
4495,0.4497,9,19,9,653684,22760,97110,29146,0.180268660499303,0.5615150464300852
4496,0.4498,11,15,11,653699,22745,97121,29135,0.1801498542643518,0.5615844255975327
4497,0.4499,7,15,7,653714,22730,97128,29128,0.1800310480294006,0.5616876856029928
4498,0.45,14,20,14,653734,22710,97142,29114,0.1798726397161323,0.5617860450756407
4499,0.4501,15,19,15,653753,22691,97157,29099,0.17972215181852744,0.5618652249469009
4500,0.4502,5,17,5,653770,22674,97162,29094,0.1795875047522494,0.5620074177097821
4501,0.4503,10,14,10,653784,22660,97172,29084,0.1794766189329616,0.5620748299319728
4502,0.4504,13,24,13,653808,22636,97185,29071,0.17928652895703967,0.5622256174212389
4503,0.4505,19,19,19,653827,22617,97204,29052,0.1791360410594348,0.5622713812924578
4504,0.4506,13,22,13,653849,22595,97217,29039,0.17896179191483969,0.5624007436960142
4505,0.4507,7,16,7,653865,22579,97224,29032,0.17883506526422507,0.5625157427680145
4506,0.4508,5,16,5,653881,22563,97229,29027,0.17870833861361043,0.5626477999612328
4507,0.4509,8,19,8,653900,22544,97237,29019,0.17855785071600558,0.5627872699416248
4508,0.451,10,19,10,653919,22525,97247,29009,0.17840736281840072,0.5629099235456204
4509,0.4511,15,11,15,653930,22514,97262,28994,0.17832023824610316,0.5629028500427118
4510,0.4512,9,16,9,653946,22498,97271,28985,0.17819351159548852,0.5630013790960122
4511,0.4513,18,25,18,653971,22473,97289,28967,0.17799550120390317,0.5631220839813375
4512,0.4514,17,18,17,653989,22455,97306,28950,0.17785293372196173,0.5631747884447038
4513,0.4515,10,7,10,653996,22448,97316,28940,0.17779749081231783,0.5631664980151008
4514,0.4516,12,13,12,654009,22435,97328,28928,0.17769452540869346,0.5632069777855655
4515,0.4517,11,17,11,654026,22418,97339,28917,0.1775598783424154,0.5632998928606214
4516,0.4518,11,10,11,654036,22408,97350,28906,0.17748067418578126,0.5633160540982968
4517,0.4519,8,12,8,654048,22396,97358,28898,0.1773856291978203,0.5633797325223223
4518,0.452,16,13,16,654061,22383,97374,28882,0.1772826637941959,0.5633863259533795
4519,0.4521,12,16,12,654077,22367,97386,28870,0.1771559371435813,0.5634599996096571
4520,0.4522,12,11,12,654088,22356,97398,28858,0.17706881257128373,0.5634787362830476
4521,0.4523,14,14,14,654102,22342,97412,28844,0.17695792675199595,0.5635134607119134
4522,0.4524,9,23,9,654125,22319,97421,28835,0.1767757571917374,0.5636900340149353
4523,0.4525,11,14,11,654139,22305,97432,28824,0.17666487137244963,0.563750513407264
4524,0.4526,12,10,12,654149,22295,97444,28812,0.17658566721581548,0.5637583892617449
4525,0.4527,13,11,13,654160,22284,97457,28799,0.17649854264351794,0.563768768474835
4526,0.4528,15,16,15,654176,22268,97472,28784,0.1763718159929033,0.5638172843375382
4527,0.4529,9,18,9,654194,22250,97481,28775,0.17622924851096186,0.5639392454679079
4528,0.453,14,19,14,654213,22231,97495,28761,0.17607876061335698,0.5640296517100721
4529,0.4531,11,14,11,654227,22217,97506,28750,0.1759678747940692,0.5640904899248533
4530,0.4532,13,19,13,654246,22198,97519,28737,0.17581738689646434,0.5641896534799254
4531,0.4533,14,25,14,654271,22173,97533,28723,0.17561937650487897,0.5643469034894687
4532,0.4534,15,37,15,654308,22136,97548,28708,0.17532632112533267,0.5646290614428447
4533,0.4535,13,20,13,654328,22116,97561,28695,0.17516791281206437,0.56473991852158
4534,0.4536,21,16,21,654344,22100,97582,28674,0.17504118616144976,0.5647378579587978
4535,0.4537,8,8,8,654352,22092,97590,28666,0.17497782283614244,0.5647582647070413
4536,0.4538,8,20,8,654372,22072,97598,28658,0.17481941452287417,0.5649122807017544
4537,0.4539,15,14,15,654386,22058,97613,28643,0.17470852870358636,0.564939547543441
4538,0.454,14,15,14,654401,22043,97627,28629,0.17458972246863516,0.5649865803599621
4539,0.4541,12,12,12,654413,22031,97639,28617,0.17449467748067418,0.565017374822303
4540,0.4542,10,14,10,654427,22017,97649,28607,0.1743837916613864,0.5650877054361567
4541,0.4543,14,19,14,654446,21998,97663,28593,0.17423330376378152,0.5651795773951889
4542,0.4544,18,19,18,654465,21979,97681,28575,0.17408281586617666,0.5652371721327689
4543,0.4545,13,14,13,654479,21965,97694,28562,0.17397193004688885,0.5652819284738853
4544,0.4546,14,14,14,654493,21951,97708,28548,0.17386104422760107,0.5653181251113883
4545,0.4547,13,11,13,654504,21940,97721,28535,0.1737739196553035,0.5653293709757305
4546,0.4548,12,12,12,654516,21928,97733,28523,0.17367887466734255,0.5653604487522547
4547,0.4549,7,14,7,654530,21914,97740,28516,0.17356798884805474,0.5654570692048384
4548,0.455,9,23,9,654553,21891,97749,28507,0.17338581928779623,0.565637525298623
4549,0.4551,12,14,12,654567,21877,97761,28495,0.17327493346850842,0.5656912570475661
4550,0.4552,14,21,14,654588,21856,97775,28481,0.17310860473957673,0.5658064644297436
4551,0.4553,15,20,15,654608,21836,97790,28466,0.17295019642630846,0.5659019522086597
4552,0.4554,13,14,13,654622,21822,97803,28453,0.17283931060702065,0.5659472899055197
4553,0.4555,13,12,13,654634,21810,97816,28440,0.1727442656190597,0.5659701492537313
4554,0.4556,10,17,10,654651,21793,97826,28430,0.17260961855278165,0.5660753041435199
4555,0.4557,8,19,8,654670,21774,97834,28422,0.1724591306551768,0.5662204159694
4556,0.4558,9,13,9,654683,21761,97843,28413,0.1723561652515524,0.5662893131900985
4557,0.4559,8,8,8,654691,21753,97851,28405,0.17229280192624508,0.5663104589497189
4558,0.456,15,19,15,654710,21734,97866,28390,0.17214231402864022,0.5663953395578964
4559,0.4561,13,11,13,654721,21723,97879,28377,0.17205518945634266,0.5664071856287425
4560,0.4562,10,16,10,654737,21707,97889,28367,0.17192846280572804,0.5665015776650557
4561,0.4563,8,8,8,654745,21699,97897,28359,0.17186509948042072,0.5665228335131248
4562,0.4564,17,16,17,654761,21683,97914,28342,0.1717383728298061,0.5665567216391804
4563,0.4565,16,11,16,654772,21672,97930,28326,0.17165124825750855,0.5665426617064683
4564,0.4566,11,13,11,654785,21659,97941,28315,0.17154828285388418,0.5665946292071877
4565,0.4567,7,11,7,654796,21648,97948,28308,0.17146115828158662,0.566658659620466
4566,0.4568,11,11,11,654807,21637,97959,28297,0.17137403370928905,0.5666880281972203
4567,0.4569,14,10,14,654817,21627,97973,28283,0.17129482955265493,0.5666800240432779
4568,0.457,12,10,12,654827,21617,97985,28271,0.17121562539602078,0.5666893842206543
4569,0.4571,10,17,10,654844,21600,97995,28261,0.17108097832974276,0.5667956920238263
4570,0.4572,10,10,10,654854,21590,98005,28251,0.1710017741731086,0.5668224955358039
4571,0.4573,15,9,15,654863,21581,98020,28236,0.17093049043213787,0.5667944677519722
4572,0.4574,9,15,9,654878,21566,98029,28227,0.17081168419718668,0.5668869118149138
4573,0.4575,16,18,16,654896,21548,98045,28211,0.1706691167152452,0.5669527120721879
4574,0.4576,11,12,11,654908,21536,98056,28200,0.17057407172728425,0.5669937268779154
4575,0.4577,11,15,11,654923,21521,98067,28189,0.17045526549233303,0.5670690002011668
4576,0.4578,11,25,11,654948,21496,98078,28178,0.17025725510074768,0.5672585255868261
4577,0.4579,16,21,16,654969,21475,98094,28162,0.170090926371816,0.5673590265326268
4578,0.458,13,15,13,654984,21460,98107,28149,0.16997212013686477,0.5674172025237356
4579,0.4581,8,17,8,655001,21443,98115,28141,0.16983747307058675,0.5675419490158116
4580,0.4582,14,16,14,655017,21427,98129,28127,0.1697107464199721,0.5676030189288453
4581,0.4583,12,14,12,655031,21413,98141,28115,0.16959986060068433,0.5676586981101599
4582,0.4584,10,19,10,655050,21394,98151,28105,0.16944937270307947,0.5677892482676418
4583,0.4585,11,15,11,655065,21379,98162,28094,0.16933056646812825,0.5678653002647909
4584,0.4586,15,10,15,655075,21369,98177,28079,0.1692513623114941,0.5678490535512053
4585,0.4587,16,18,16,655093,21351,98193,28063,0.16910879482955266,0.567915975229692
4586,0.4588,15,15,15,655108,21336,98208,28048,0.16898998859460143,0.5679572331119391
4587,0.4589,11,14,11,655122,21322,98219,28037,0.16887910277531365,0.5680220425859519
4588,0.459,13,13,13,655135,21309,98232,28024,0.16877613737168926,0.5680578922830559
4589,0.4591,14,12,14,655147,21297,98246,28010,0.1686810923837283,0.5680734986918693
4590,0.4592,13,16,13,655163,21281,98259,27997,0.16855436573311366,0.568143999350623
4591,0.4593,9,12,9,655175,21269,98268,27988,0.1684593207451527,0.5682035040704875
4592,0.4594,10,17,10,655192,21252,98278,27978,0.16832467367887466,0.5683120048750762
4593,0.4595,13,15,13,655207,21237,98291,27965,0.16820586744392346,0.5683712044225845
4594,0.4596,8,9,8,655216,21228,98299,27957,0.16813458370295273,0.5684050015248552
4595,0.4597,16,17,16,655233,21211,98315,27941,0.1679999366366747,0.5684611002604166
4596,0.4598,8,25,8,655258,21186,98323,27933,0.16780192624508936,0.5686801441397422
4597,0.4599,4,15,4,655273,21171,98327,27929,0.16768312001013813,0.5688187372708757
4598,0.46,8,20,8,655293,21151,98335,27921,0.16752471169686986,0.5689802738832735
4599,0.4601,8,12,8,655305,21139,98343,27913,0.16742966670890888,0.5690491723069395
4600,0.4602,10,16,10,655321,21123,98353,27903,0.16730294005829427,0.5691469832333864
4601,0.4603,16,14,16,655335,21109,98369,27887,0.16719205423900646,0.5691689117478977
4602,0.4604,12,10,12,655345,21099,98381,27875,0.1671128500823723,0.5691795646669662
4603,0.4605,11,19,11,655364,21080,98392,27864,0.16696236218476745,0.5693036940176528
4604,0.4606,8,18,8,655382,21062,98400,27856,0.166819794702826,0.5694427409133652
4605,0.4607,16,18,16,655400,21044,98416,27840,0.16667722722088454,0.5695114966042059
4606,0.4608,10,17,10,655417,21027,98426,27830,0.16654258015460652,0.5696215486010193
4607,0.4609,12,12,12,655429,21015,98438,27818,0.16644753516664554,0.5696557655683656
4608,0.461,9,22,9,655451,20993,98447,27809,0.16627328602205044,0.5698332035572312
4609,0.4611,16,15,16,655466,20978,98463,27793,0.16615447978709924,0.5698673391974739
4610,0.4612,8,13,8,655479,20965,98471,27785,0.16605151438347485,0.5699487179487179
4611,0.4613,13,22,13,655501,20943,98484,27772,0.16587726523887975,0.5700913476341989
4612,0.4614,7,11,7,655512,20932,98491,27765,0.16579014066658218,0.570158325974906
4613,0.4615,12,18,12,655530,20914,98503,27753,0.16564757318464074,0.5702632173752235
4614,0.4616,9,17,9,655547,20897,98512,27744,0.16551292611836269,0.5703830102177175
4615,0.4617,8,11,8,655558,20886,98520,27736,0.16542580154606515,0.5704413639916087
4616,0.4618,14,18,14,655576,20868,98534,27722,0.16528323406412368,0.5705289154146944
4617,0.4619,9,17,9,655593,20851,98543,27713,0.16514858699784565,0.5706490404414792
4618,0.462,12,14,12,655607,20837,98555,27701,0.16503770117855784,0.5707074869174668
4619,0.4621,8,21,8,655628,20816,98563,27693,0.16487137244962616,0.5708837535302728
4620,0.4622,9,12,9,655640,20804,98572,27684,0.16477632746166518,0.5709453885497443
4621,0.4623,13,20,13,655660,20784,98585,27671,0.1646179191483969,0.5710659374677536
4622,0.4624,12,12,12,655672,20772,98597,27659,0.16452287416043593,0.5711011542194049
4623,0.4625,6,14,6,655686,20758,98603,27653,0.16441198834114815,0.57121315403524
4624,0.4626,11,21,11,655707,20737,98614,27642,0.16424565961221646,0.5713636081771016
4625,0.4627,12,14,12,655721,20723,98626,27630,0.16413477379292865,0.5714226625028437
4626,0.4628,6,16,6,655737,20707,98632,27624,0.16400804714231404,0.5715586269681985
4627,0.4629,13,14,13,655751,20693,98645,27611,0.16389716132302623,0.5716089764822789
4628,0.463,9,16,9,655767,20677,98654,27602,0.16377043467241162,0.5717185525797966
4629,0.4631,10,16,10,655783,20661,98664,27592,0.16364370802179698,0.5718193687439123
4630,0.4632,9,11,9,655794,20650,98673,27583,0.16355658344949944,0.5718698816163208
4631,0.4633,10,15,10,655809,20635,98683,27573,0.16343777721454822,0.571959010952539
4632,0.4634,14,15,14,655824,20620,98697,27559,0.16331897097959702,0.5720127026297764
4633,0.4635,12,13,12,655837,20607,98709,27547,0.16321600557597263,0.5720604726502472
4634,0.4636,8,14,8,655851,20593,98717,27539,0.16310511975668482,0.5721557383861049
4635,0.4637,18,14,18,655865,20579,98735,27521,0.16299423393739704,0.5721621621621622
4636,0.4638,10,13,10,655878,20566,98745,27511,0.16289126853377264,0.5722278844353849
4637,0.4639,7,15,7,655893,20551,98752,27504,0.16277246229882145,0.5723441889501613
4638,0.464,8,17,8,655910,20534,98760,27496,0.1626378152325434,0.5724755361232563
4639,0.4641,14,16,14,655926,20518,98774,27482,0.16251108858192878,0.5725416666666666
4640,0.4642,7,15,7,655941,20503,98781,27475,0.16239228234697756,0.5726583017216225
4641,0.4643,10,16,10,655957,20487,98791,27465,0.16226555569636295,0.5727602602602603
4642,0.4644,19,16,19,655973,20471,98810,27446,0.16213882904574833,0.5727821023853747
4643,0.4645,9,13,9,655986,20458,98819,27437,0.16203586364212394,0.5728572919929011
4644,0.4646,12,11,12,655997,20447,98831,27425,0.16194873906982638,0.5728818516042781
4645,0.4647,8,17,8,656014,20430,98839,27417,0.16181409200354835,0.5730139820678413
4646,0.4648,12,13,12,656027,20417,98851,27405,0.16171112659992395,0.573062607168249
4647,0.4649,15,11,15,656038,20406,98866,27390,0.16162400202762642,0.5730605071554105
4648,0.465,9,18,9,656056,20388,98875,27381,0.16148143454568495,0.5731960057778057
4649,0.4651,10,10,10,656066,20378,98885,27371,0.16140223038905083,0.573226664432763
4650,0.4652,11,15,11,656081,20363,98896,27360,0.1612834241540996,0.573308467615196
4651,0.4653,7,12,7,656093,20351,98903,27353,0.16118837916613865,0.5733900721113534
4652,0.4654,11,13,11,656106,20338,98914,27342,0.16108541376251426,0.5734479865771812
4653,0.4655,10,14,10,656120,20324,98924,27332,0.16097452794322645,0.5735269430921605
4654,0.4656,8,18,8,656138,20306,98932,27324,0.160831960461285,0.5736720554272517
4655,0.4657,9,10,9,656148,20296,98941,27315,0.16075275630465086,0.5737119573207872
4656,0.4658,13,13,13,656161,20283,98954,27302,0.1606497909010265,0.5737522328464852
4657,0.4659,12,21,12,656182,20262,98966,27290,0.1604834621720948,0.5738980484522207
4658,0.466,13,14,13,656196,20248,98979,27277,0.160372576352807,0.5739505523408732
4659,0.4661,10,13,10,656209,20235,98989,27267,0.1602696109491826,0.5740179360869017
4660,0.4662,9,19,9,656228,20216,98998,27258,0.16011912305157774,0.5741669124152168
4661,0.4663,9,16,9,656244,20200,99007,27249,0.15999239640096313,0.5742797529979558
4662,0.4664,6,21,6,656265,20179,99013,27243,0.15982606767203142,0.5744801990637257
4663,0.4665,14,25,14,656290,20154,99027,27229,0.15962805728044607,0.5746575776122238
4664,0.4666,10,15,10,656305,20139,99037,27219,0.15950925104549488,0.574749778284556
4665,0.4667,11,14,11,656319,20125,99048,27208,0.15939836522620707,0.574820949443306
4666,0.4668,12,13,12,656332,20112,99060,27196,0.1592953998225827,0.5748710577492179
4667,0.4669,9,17,9,656349,20095,99069,27187,0.15916075275630465,0.5749968275453661
4668,0.467,8,15,8,656364,20080,99077,27179,0.15904194652135345,0.5751073869527498
4669,0.4671,9,12,9,656376,20068,99086,27170,0.15894690153339247,0.5751725305897795
4670,0.4672,6,11,6,656387,20057,99092,27164,0.1588597769610949,0.5752525359479892
4671,0.4673,9,15,9,656402,20042,99101,27155,0.1587409707261437,0.5753543657435854
4672,0.4674,11,11,11,656413,20031,99112,27144,0.15865384615384615,0.575389507154213
4673,0.4675,12,25,12,656438,20006,99124,27132,0.1584558357622608,0.5755865755865756
4674,0.4676,10,16,10,656454,19990,99134,27122,0.1583291091116462,0.575691968076074
4675,0.4677,10,11,10,656465,19979,99144,27112,0.15824198453934862,0.5757363402773353
4676,0.4678,15,16,15,656481,19963,99159,27097,0.158115257888734,0.575796855078623
4677,0.4679,14,18,14,656499,19945,99173,27083,0.15797269040679254,0.5758909585778685
4678,0.468,12,19,12,656518,19926,99185,27071,0.1578222025091877,0.5760154903504479
4679,0.4681,11,17,11,656535,19909,99196,27060,0.15768755544290963,0.5761246779790926
4680,0.4682,8,13,8,656548,19896,99204,27052,0.15758459003928527,0.5762119792110421
4681,0.4683,4,10,4,656558,19886,99208,27048,0.15750538588265112,0.5762986321217028
4682,0.4684,7,18,7,656576,19868,99215,27041,0.15736281840070968,0.5764565435204332
4683,0.4685,11,17,11,656593,19851,99226,27030,0.15722817133443162,0.5765661995264606
4684,0.4686,20,8,20,656601,19843,99246,27010,0.15716480800912433,0.5764838964420634
4685,0.4687,9,10,9,656611,19833,99255,27001,0.15708560385249018,0.5765256010590597
4686,0.4688,9,14,9,656625,19819,99264,26992,0.15697471803320237,0.5766166072077076
4687,0.4689,8,18,8,656643,19801,99272,26984,0.15683215055126093,0.576766057497061
4688,0.469,10,12,10,656655,19789,99282,26974,0.15673710556329995,0.5768235570857302
4689,0.4691,14,12,14,656667,19777,99296,26960,0.156642060575339,0.5768448980465156
4690,0.4692,6,16,6,656683,19761,99302,26954,0.15651533392472436,0.5769881194477149
4691,0.4693,12,12,12,656695,19749,99314,26942,0.1564202889367634,0.5770276927030905
4692,0.4694,10,15,10,656710,19734,99324,26932,0.15630148270181218,0.5771225303218618
4693,0.4695,14,13,14,656723,19721,99338,26918,0.15619851729818782,0.5771564570423894
4694,0.4696,7,15,7,656738,19706,99345,26911,0.1560797110632366,0.5772786751614218
4695,0.4697,12,12,12,656750,19694,99357,26899,0.15598466607527564,0.577318481316936
4696,0.4698,17,10,17,656760,19684,99374,26882,0.1559054619186415,0.5772881501524718
4697,0.4699,13,14,13,656774,19670,99387,26869,0.15579457609935368,0.5773437332130041
4698,0.47,6,14,6,656788,19656,99393,26863,0.1556836902800659,0.5774629721189192
4699,0.4701,12,11,12,656799,19645,99405,26851,0.15559656570776834,0.5774905368203717
4700,0.4702,17,16,17,656815,19629,99422,26834,0.15546983905715372,0.5775348126466221
4701,0.4703,9,11,9,656826,19618,99431,26825,0.15538271448485616,0.5775897336520035
4702,0.4704,12,14,12,656840,19604,99443,26813,0.15527182866556838,0.5776547385656118
4703,0.4705,8,11,8,656851,19593,99451,26805,0.15518470409327081,0.5777188671925514
4704,0.4706,11,14,11,656865,19579,99462,26794,0.155073818273983,0.5777931123714231
4705,0.4707,8,12,8,656877,19567,99470,26786,0.15497877328602205,0.5778698250382931
4706,0.4708,7,14,7,656891,19553,99477,26779,0.15486788746673424,0.5779806613139946
4707,0.4709,8,12,8,656903,19541,99485,26771,0.1547728424787733,0.5780575228882363
4708,0.471,9,12,9,656915,19529,99494,26762,0.1546777974908123,0.5781253375386144
4709,0.4711,7,12,7,656927,19517,99501,26755,0.15458275250285136,0.5782114453665284
4710,0.4712,11,18,11,656945,19499,99512,26744,0.1544401850209099,0.5783361806111195
4711,0.4713,7,7,7,656952,19492,99519,26737,0.154384742111266,0.578359903956391
4712,0.4714,17,20,17,656972,19472,99536,26720,0.15422633379799772,0.5784551437478351
4713,0.4715,3,15,3,656987,19457,99539,26717,0.15410752756304652,0.5786156711569281
4714,0.4716,7,14,7,657001,19443,99546,26710,0.1539966417437587,0.5787272766667388
4715,0.4717,14,13,14,657014,19430,99560,26696,0.15389367634013432,0.5787625200537657
4716,0.4718,3,15,3,657029,19415,99563,26693,0.15377487010518312,0.5789233972412596
4717,0.4719,14,11,14,657040,19404,99577,26679,0.15368774553288556,0.5789336631729705
4718,0.472,15,13,15,657053,19391,99592,26664,0.1535847801292612,0.5789599392031267
4719,0.4721,10,16,10,657069,19375,99602,26654,0.15345805347864655,0.5790697169175955
4720,0.4722,13,15,13,657084,19360,99615,26641,0.15333924724369535,0.5791395839220886
4721,0.4723,10,17,10,657101,19343,99625,26631,0.1532046001774173,0.5792621916735546
4722,0.4724,16,19,16,657120,19324,99641,26615,0.15305411227981244,0.5793552319380048
4723,0.4725,7,14,7,657134,19310,99648,26608,0.15294322646052466,0.5794677468530859
4724,0.4726,8,22,8,657156,19288,99656,26600,0.15276897731592953,0.5796722454672245
4725,0.4727,3,11,3,657167,19277,99659,26597,0.152681852743632,0.5797837555042071
4726,0.4728,7,14,7,657181,19263,99666,26590,0.1525709669243442,0.5798966261749504
4727,0.4729,14,8,14,657189,19255,99680,26576,0.15250760359903687,0.5798695206301412
4728,0.473,6,12,6,657201,19243,99686,26570,0.15241255861107592,0.5799663850872023
4729,0.4731,10,8,10,657209,19235,99696,26560,0.1523491952857686,0.5799759799104706
4730,0.4732,15,16,15,657225,19219,99711,26545,0.15222246863515398,0.5800410803251465
4731,0.4733,18,13,18,657238,19206,99729,26527,0.1521195032315296,0.5800406708503706
4732,0.4734,14,7,14,657245,19199,99743,26513,0.15206406032188569,0.5800008750437522
4733,0.4735,12,15,12,657260,19184,99755,26501,0.1519452540869345,0.580080989383824
4734,0.4736,9,8,9,657268,19176,99764,26492,0.15188189076162717,0.580099851099238
4735,0.4737,16,9,16,657277,19167,99780,26476,0.15181060702065644,0.5800670420436869
4736,0.4738,10,9,10,657286,19158,99790,26466,0.15173932327968573,0.5800894266175697
4737,0.4739,14,16,14,657302,19142,99804,26452,0.1516125966290711,0.5801640566741237
4738,0.474,9,8,9,657310,19134,99813,26443,0.15154923330376377,0.5801829870329333
4739,0.4741,9,18,9,657328,19116,99822,26434,0.15140666582182233,0.5803293084522503
4740,0.4742,10,11,10,657339,19105,99832,26424,0.15131954124952476,0.580377341913945
4741,0.4743,8,8,8,657347,19097,99840,26416,0.15125617792421747,0.580405598400457
4742,0.4744,14,12,14,657359,19085,99854,26402,0.1511611329362565,0.5804295732846747
4743,0.4745,14,9,14,657368,19076,99868,26388,0.15108984919528576,0.5804152736230864
4744,0.4746,9,12,9,657380,19064,99877,26379,0.1509948042073248,0.5804854433025989
4745,0.4747,10,14,10,657394,19050,99887,26369,0.150883918388037,0.5805720073097161
4746,0.4748,9,14,9,657408,19036,99896,26360,0.15077303256874922,0.5806679002555292
4747,0.4749,15,22,15,657430,19014,99911,26345,0.1505987834241541,0.5808108644370467
4748,0.475,14,10,14,657440,19004,99925,26331,0.15051957926751997,0.5808095290614316
4749,0.4751,11,5,11,657445,18999,99936,26320,0.1504799771892029,0.5807718616915643
4750,0.4752,15,13,15,657458,18986,99951,26305,0.1503770117855785,0.5807997173831445
4751,0.4753,15,16,15,657474,18970,99966,26290,0.15025028513496388,0.5808661069376934
4752,0.4754,7,28,7,657502,18942,99973,26283,0.1500285134963883,0.5811608623548922
4753,0.4755,4,11,4,657513,18931,99977,26279,0.14994138892409073,0.581265206812652
4754,0.4756,11,13,11,657526,18918,99988,26268,0.14983842352046636,0.5813305005975302
4755,0.4757,11,8,11,657534,18910,99999,26257,0.14977506019515904,0.5813315030885381
4756,0.4758,9,12,9,657546,18898,100008,26248,0.14968001520719806,0.5814025605812253
4757,0.4759,11,13,11,657559,18885,100019,26237,0.1495770498035737,0.581468020034573
4758,0.476,10,10,10,657569,18875,100029,26227,0.14949784564693955,0.5815041461575984
4759,0.4761,9,16,9,657585,18859,100038,26218,0.14937111899632494,0.5816269938105908
4760,0.4762,13,14,13,657599,18845,100051,26205,0.14926023317703713,0.5816870144284129
4761,0.4763,14,10,14,657609,18835,100065,26191,0.14918102902040298,0.5816861368986808
4762,0.4764,9,17,9,657626,18818,100074,26182,0.14904638195412495,0.5818222222222222
4763,0.4765,7,15,7,657641,18803,100081,26175,0.14892757571917375,0.5819511761305527
4764,0.4766,11,20,11,657661,18783,100092,26164,0.14876916740590546,0.5821078158720271
4765,0.4767,9,20,9,657681,18763,100101,26155,0.14861075909263718,0.5822832717396144
4766,0.4768,12,12,12,657693,18751,100113,26143,0.1485157141046762,0.5823272597674523
4767,0.4769,19,14,19,657707,18737,100132,26124,0.14840482828538842,0.5823320924633869
4768,0.477,8,11,8,657718,18726,100140,26116,0.14831770371309086,0.5824004281700191
4769,0.4771,10,12,10,657730,18714,100150,26106,0.1482226587251299,0.5824631860776439
4770,0.4772,11,12,11,657742,18702,100161,26095,0.14812761373716893,0.582516686385249
4771,0.4773,8,15,8,657757,18687,100169,26087,0.1480088075022177,0.5826372448295886
4772,0.4774,6,19,6,657776,18668,100175,26081,0.14785831960461285,0.5828286665623813
4773,0.4775,10,14,10,657790,18654,100185,26071,0.14774743378532507,0.5829178311906092
4774,0.4776,9,15,9,657805,18639,100194,26062,0.14762862755037384,0.5830294624281336
4775,0.4777,12,20,12,657825,18619,100206,26050,0.14747021923710557,0.5831784906758603
4776,0.4778,15,14,15,657839,18605,100221,26035,0.14735933341781776,0.5832213261648745
4777,0.4779,13,11,13,657850,18594,100234,26022,0.14727220884552022,0.5832436793975255
4778,0.478,9,14,9,657864,18580,100243,26013,0.14716132302623242,0.5833426771017872
4779,0.4781,6,17,6,657881,18563,100249,26007,0.1470266759599544,0.583509086829706
4780,0.4782,10,9,10,657890,18554,100259,25997,0.14695539221898365,0.5835334784853314
4781,0.4783,15,11,15,657901,18543,100274,25982,0.1468682676466861,0.5835373385738349
4782,0.4784,15,13,15,657914,18530,100289,25967,0.14676530224306172,0.5835674315122368
4783,0.4785,5,13,5,657927,18517,100294,25962,0.14666233683943733,0.5836911801074665
4784,0.4786,7,12,7,657939,18505,100301,25955,0.14656729185147638,0.5837831758884391
4785,0.4787,17,9,17,657948,18496,100318,25938,0.14649600811050564,0.5837421794121619
4786,0.4788,11,15,11,657963,18481,100329,25927,0.14637720187555442,0.5838362457214916
4787,0.4789,14,10,14,657973,18471,100343,25913,0.1462979977189203,0.5838365176640231
4788,0.479,13,13,13,657986,18458,100356,25900,0.1461950323152959,0.5838856576040399
4789,0.4791,15,12,15,657998,18446,100371,25885,0.14609998732733495,0.583902912183348
4790,0.4792,14,11,14,658009,18435,100385,25871,0.1460128627550374,0.5839163995847063
4791,0.4793,11,10,11,658019,18425,100396,25860,0.14593365859840324,0.5839449023371345
4792,0.4794,8,23,8,658042,18402,100404,25852,0.14575148903814472,0.5841731820852353
4793,0.4795,10,22,10,658064,18380,100414,25842,0.14557723989354962,0.5843697707023653
4794,0.4796,13,11,13,658075,18369,100427,25829,0.14549011532125206,0.5843929589574189
4795,0.4797,10,11,10,658086,18358,100437,25819,0.1454029907489545,0.584444394141748
4796,0.4798,11,21,11,658107,18337,100448,25808,0.1452366620200228,0.5846188696341601
4797,0.4799,7,9,7,658116,18328,100455,25801,0.14516537827905207,0.5846722110176981
4798,0.48,10,9,10,658125,18319,100465,25791,0.14509409453808136,0.5846973475402403
4799,0.4801,16,9,16,658134,18310,100481,25775,0.14502281079711063,0.5846659861630941
4800,0.4802,7,13,7,658147,18297,100488,25768,0.14491984539348626,0.5847724951775786
4801,0.4803,14,18,14,658165,18279,100502,25754,0.1447772779115448,0.5848795221765494
4802,0.4804,9,28,9,658193,18251,100511,25745,0.1445555062729692,0.5851668333484862
4803,0.4805,13,13,13,658206,18238,100524,25732,0.14445254086934484,0.5852171935410507
4804,0.4806,4,14,4,658220,18224,100528,25728,0.14434165505005703,0.5853658536585366
4805,0.4807,10,11,10,658231,18213,100538,25718,0.14425453047775946,0.5854180419293893
4806,0.4808,11,17,11,658248,18196,100549,25707,0.14411988341148144,0.585540851422454
4807,0.4809,8,9,8,658257,18187,100557,25699,0.1440485996705107,0.5855853803035137
4808,0.481,7,12,7,658269,18175,100564,25692,0.14395355468254975,0.585679440125835
4809,0.4811,9,14,9,658283,18161,100573,25683,0.14384266886326194,0.5857814068059484
4810,0.4812,11,7,11,658290,18154,100584,25672,0.14378722595361804,0.5857710035138959
4811,0.4813,6,12,6,658302,18142,100590,25666,0.14369218096565708,0.5858747260774287
4812,0.4814,16,15,16,658317,18127,100606,25650,0.14357337473070586,0.5859241154030655
4813,0.4815,11,17,11,658334,18110,100617,25639,0.14343872766442783,0.5860476810898535
4814,0.4816,11,12,11,658346,18098,100628,25628,0.14334368267646685,0.5861043772583817
4815,0.4817,7,8,7,658354,18090,100635,25621,0.14328031935115954,0.5861453638672188
4816,0.4818,5,14,5,658368,18076,100640,25616,0.14316943353187175,0.5862858189142177
4817,0.4819,15,11,15,658379,18065,100655,25601,0.1430823089595742,0.5862913937617368
4818,0.482,8,13,8,658392,18052,100663,25593,0.14297934355594982,0.5863901936075152
4819,0.4821,7,18,7,658410,18034,100670,25586,0.14283677607400835,0.5865657955066483
4820,0.4822,9,13,9,658423,18021,100679,25577,0.142733810670384,0.5866553511628974
4821,0.4823,7,15,7,658438,18006,100686,25570,0.14261500443543276,0.5867908940701303
4822,0.4824,6,16,6,658454,17990,100692,25564,0.14248827778481815,0.5869495339119254
4823,0.4825,13,21,13,658475,17969,100705,25551,0.14232194905588647,0.587109375
4824,0.4826,9,12,9,658487,17957,100714,25542,0.14222690406792549,0.5871859123198234
4825,0.4827,13,15,13,658502,17942,100727,25529,0.14210809783297426,0.5872650732672356
4826,0.4828,14,10,14,658512,17932,100741,25515,0.14202889367634014,0.5872672451492623
4827,0.4829,11,18,11,658530,17914,100752,25504,0.14188632619439867,0.5874061449168547
4828,0.483,15,11,15,658541,17903,100767,25489,0.14179920162210113,0.5874124262536873
4829,0.4831,7,10,7,658551,17893,100774,25482,0.14171999746546698,0.5874812680115273
4830,0.4832,13,20,13,658571,17873,100787,25469,0.1415615891521987,0.5876286281205297
4831,0.4833,10,10,10,658581,17863,100797,25459,0.14148238499556456,0.5876690826831633
4832,0.4834,11,14,11,658595,17849,100808,25448,0.14137149917627678,0.5877543478762963
4833,0.4835,10,10,10,658605,17839,100818,25438,0.14129229501964263,0.5877949026041547
4834,0.4836,11,14,11,658619,17825,100829,25427,0.14118140920035482,0.5878803292333302
4835,0.4837,10,15,10,658634,17810,100839,25417,0.14106260296540363,0.5879889883637541
4836,0.4838,8,5,8,658639,17805,100847,25409,0.14102300088708655,0.5879807469801454
4837,0.4839,12,13,12,658652,17792,100859,25397,0.14092003548346216,0.5880432517539188
4838,0.484,10,12,10,658664,17780,100869,25387,0.1408249904955012,0.5881112887159172
4839,0.4841,9,24,9,658688,17756,100878,25378,0.14063490051957928,0.5883525756943478
4840,0.4842,11,21,11,658709,17735,100889,25367,0.14046857179064756,0.5885341747482715
4841,0.4843,5,8,5,658717,17727,100894,25362,0.14040520846534027,0.5885956972777275
4842,0.4844,11,14,11,658731,17713,100905,25351,0.14029432264605246,0.5886819617313765
4843,0.4845,8,13,8,658744,17700,100913,25343,0.1401913572424281,0.5887833097135423
4844,0.4846,12,13,12,658757,17687,100925,25331,0.1400883918388037,0.5888465293598029
4845,0.4847,7,15,7,658772,17672,100932,25324,0.1399695856038525,0.5889850218624988
4846,0.4848,8,13,8,658785,17659,100940,25316,0.1398666202002281,0.589086678301338
4847,0.4849,8,13,8,658798,17646,100948,25308,0.13976365479660371,0.5891884341388463
4848,0.485,8,12,8,658810,17634,100956,25300,0.13966860980864276,0.5892765640285089
4849,0.4851,14,12,14,658822,17622,100970,25286,0.13957356482068178,0.5893073552717442
4850,0.4852,15,13,15,658835,17609,100985,25271,0.13947059941705742,0.5893423507462686
4851,0.4853,9,17,9,658852,17592,100994,25262,0.13933595235077936,0.5894898959257012
4852,0.4854,9,14,9,658866,17578,101003,25253,0.13922506653149158,0.5895963204221242
4853,0.4855,14,13,14,658879,17565,101017,25239,0.1391221011278672,0.58964115503224
4854,0.4856,9,8,9,658887,17557,101026,25230,0.13905873780255987,0.5896650851894267
4855,0.4857,10,13,10,658900,17544,101036,25220,0.1389557723989355,0.5897483864933122
4856,0.4858,13,11,13,658911,17533,101049,25207,0.13886864782663794,0.5897753860552176
4857,0.4859,13,16,13,658927,17517,101062,25194,0.13874192117602333,0.5898714616843436
4858,0.486,12,13,12,658940,17504,101074,25182,0.13863895577239893,0.5899358103359416
4859,0.4861,6,11,6,658951,17493,101080,25176,0.1385518312001014,0.590030232721648
4860,0.4862,6,13,6,658964,17480,101086,25170,0.138448865796477,0.5901524032825323
4861,0.4863,13,18,13,658982,17462,101099,25157,0.13830629831453556,0.5902766371806002
4862,0.4864,9,10,9,658992,17452,101108,25148,0.1382270941579014,0.5903286384976526
4863,0.4865,22,17,22,659009,17435,101130,25126,0.13809244709162335,0.5903526702850027
4864,0.4866,11,12,11,659021,17423,101141,25115,0.1379974021036624,0.5904132775400818
4865,0.4867,16,10,16,659031,17413,101157,25099,0.13791819794702825,0.5903980052691005
4866,0.4868,3,17,3,659048,17396,101160,25096,0.13778355088075023,0.5906052904076061
4867,0.4869,8,14,8,659062,17382,101168,25088,0.13767266506146242,0.5907228631975512
4868,0.487,13,12,13,659074,17370,101181,25075,0.13757762007350147,0.590764518789021
4869,0.4871,9,9,9,659083,17361,101190,25066,0.13750633633253073,0.5908030263747143
4870,0.4872,7,7,7,659090,17354,101197,25059,0.13745089342288683,0.5908329993162473
4871,0.4873,14,11,14,659101,17343,101211,25045,0.1373637688505893,0.5908511842974427
4872,0.4874,17,11,17,659112,17332,101228,25028,0.13727664427829173,0.5908404154863078
4873,0.4875,11,16,11,659128,17316,101239,25017,0.1371499176276771,0.5909574091134576
4874,0.4876,11,12,11,659140,17304,101250,25006,0.13705487263971614,0.5910186717088158
4875,0.4877,4,10,4,659150,17294,101254,25002,0.13697566848308199,0.5911197276338188
4876,0.4878,15,13,15,659163,17281,101269,24987,0.13687270307945762,0.5911564303965174
4877,0.4879,12,18,12,659181,17263,101281,24975,0.13673013559751615,0.5912922013352905
4878,0.488,8,8,8,659189,17255,101289,24967,0.13666677227220886,0.5913267964568235
4879,0.4881,12,8,12,659197,17247,101301,24955,0.13660340894690154,0.5913226861286195
4880,0.4882,12,15,12,659212,17232,101313,24943,0.13648460271195031,0.591416716064019
4881,0.4883,12,16,12,659228,17216,101325,24931,0.1363578760613357,0.5915249009419413
4882,0.4884,13,12,13,659240,17204,101338,24918,0.13626283107337472,0.5915673519775889
4883,0.4885,8,18,8,659258,17186,101346,24910,0.13612026359143328,0.5917426833903459
4884,0.4886,8,19,8,659277,17167,101354,24902,0.1359697756938284,0.5919323016948347
4885,0.4887,19,13,19,659290,17154,101373,24883,0.13586681029020403,0.5919309180008088
4886,0.4888,9,9,9,659299,17145,101382,24874,0.1357955265492333,0.5919702991503843
4887,0.4889,14,25,14,659324,17120,101396,24860,0.13559751615764795,0.5921867555979038
4888,0.489,7,14,7,659338,17106,101403,24853,0.13548663033836017,0.5923163087776162
4889,0.4891,9,14,9,659352,17092,101412,24844,0.13537574451907236,0.5924265547500954
4890,0.4892,8,8,8,659360,17084,101420,24836,0.13531238119376504,0.5924618320610687
4891,0.4893,19,11,19,659371,17073,101439,24817,0.1352252566214675,0.592432561470518
4892,0.4894,12,7,12,659378,17066,101451,24805,0.1351698137118236,0.5924147978314347
4893,0.4895,10,12,10,659390,17054,101461,24795,0.13507476872386262,0.5924872756816173
4894,0.4896,12,15,12,659405,17039,101473,24783,0.13495596248891142,0.5925828511309837
4895,0.4897,12,13,12,659418,17026,101485,24771,0.13485299708528703,0.5926501902050386
4896,0.4898,9,14,9,659432,17012,101494,24762,0.13474211126599925,0.592761047541533
4897,0.4899,10,16,10,659448,16996,101504,24752,0.1346153846153846,0.5928906773977196
4898,0.49,11,14,11,659462,16982,101515,24741,0.13450449879609683,0.592982287946696
4899,0.4901,10,15,10,659477,16967,101525,24731,0.1343856925611456,0.593097990311286
4900,0.4902,19,10,19,659487,16957,101544,24712,0.13430648840451148,0.5930547889318198
4901,0.4903,10,10,10,659497,16947,101554,24702,0.13422728424787733,0.5930994741770511
4902,0.4904,11,7,11,659504,16940,101565,24691,0.13417184133823343,0.59309168648363
4903,0.4905,9,15,9,659519,16925,101574,24682,0.13405303510328223,0.593217487442017
4904,0.4906,10,8,10,659527,16917,101584,24672,0.1339896717779749,0.5932337877804227
4905,0.4907,12,12,12,659539,16905,101596,24660,0.13389462679001393,0.5932876217971851
4906,0.4908,9,10,9,659549,16895,101605,24651,0.1338154226333798,0.5933423193568574
4907,0.4909,8,13,8,659562,16882,101613,24643,0.13371245722975542,0.5934497290788682
4908,0.491,8,5,8,659567,16877,101621,24635,0.13367285515143834,0.5934428598959337
4909,0.4911,16,14,16,659581,16863,101637,24619,0.13356196933215056,0.5934863314208573
4910,0.4912,13,11,13,659592,16852,101650,24606,0.133474844759853,0.593516329779536
4911,0.4913,7,17,7,659609,16835,101657,24599,0.13334019769357497,0.5936911715016653
4912,0.4914,6,13,6,659622,16822,101663,24593,0.13323723228995057,0.5938186647349994
4913,0.4915,9,9,9,659631,16813,101672,24584,0.13316594854897984,0.593859458414861
4914,0.4916,11,18,11,659649,16795,101683,24573,0.1330233810670384,0.5940098626958035
4915,0.4917,8,12,8,659661,16783,101691,24565,0.13292833607907742,0.5941037051368869
4916,0.4918,6,12,6,659673,16771,101697,24559,0.13283329109111647,0.5942172755867409
4917,0.4919,13,15,13,659688,16756,101710,24546,0.13271448485616524,0.5943053605152293
4918,0.492,13,10,13,659698,16746,101723,24533,0.13263528069953112,0.5943215678674386
4919,0.4921,10,21,10,659719,16725,101733,24523,0.1324689519705994,0.5945257951900699
4920,0.4922,10,7,10,659726,16718,101743,24513,0.13241350906095553,0.5945283888336446
4921,0.4923,14,10,14,659736,16708,101757,24499,0.13233430490432138,0.5945349091173829
4922,0.4924,9,8,9,659744,16700,101766,24490,0.13227094157901406,0.5945617868414663
4923,0.4925,14,11,14,659755,16689,101780,24476,0.13218381700671653,0.5945827766306329
4924,0.4926,8,12,8,659767,16677,101788,24468,0.13208877201875555,0.5946773605541378
4925,0.4927,9,9,9,659776,16668,101797,24459,0.1320174882777848,0.5947187978700124
4926,0.4928,12,12,12,659788,16656,101809,24447,0.13192244328982386,0.5947741040799942
4927,0.4929,4,9,4,659797,16647,101813,24443,0.13185115954885313,0.5948649306400584
4928,0.493,10,19,10,659816,16628,101823,24433,0.13170067165124827,0.5950415235868586
4929,0.4931,7,17,7,659833,16611,101830,24426,0.13156602458497021,0.5952189487535638
4930,0.4932,8,14,8,659847,16597,101838,24418,0.13145513876568243,0.5953431671339754
4931,0.4933,6,9,6,659856,16588,101844,24412,0.1313838550247117,0.5954146341463414
4932,0.4934,8,17,8,659873,16571,101852,24404,0.13124920795843367,0.5955826723611959
4933,0.4935,13,13,13,659886,16558,101865,24391,0.13114624255480928,0.5956433612542431
4934,0.4936,4,11,4,659897,16547,101869,24387,0.1310591179825117,0.5957639126398593
4935,0.4937,10,11,10,659908,16536,101879,24377,0.13097199341021418,0.5958252878058319
4936,0.4938,11,12,11,659920,16524,101890,24366,0.1308769484222532,0.5958914159941306
4937,0.4939,10,11,10,659931,16513,101900,24356,0.13078982384995563,0.595952922753187
4938,0.494,13,10,13,659941,16503,101913,24343,0.1307106196933215,0.5959702296430495
4939,0.4941,7,10,7,659951,16493,101920,24336,0.13063141553668736,0.5960469274290333
4940,0.4942,20,17,20,659968,16476,101940,24316,0.13049676847040934,0.5960972739752892
4941,0.4943,12,11,12,659979,16465,101952,24304,0.13040964389811177,0.5961392234295666
4942,0.4944,11,11,11,659990,16454,101963,24293,0.1303225193258142,0.5961911306353842
4943,0.4945,7,14,7,660004,16440,101970,24286,0.13021163350652643,0.596326670922752
4944,0.4946,10,12,10,660016,16428,101980,24276,0.13011658851856545,0.5964033018867925
4945,0.4947,9,16,9,660032,16412,101989,24267,0.12998986186795083,0.5965485877233954
4946,0.4948,10,16,10,660048,16396,101999,24257,0.1298631352173362,0.596684131552407
4947,0.4949,15,10,15,660058,16386,102014,24242,0.12978393106070207,0.5966820911686521
4948,0.495,10,9,10,660067,16377,102024,24232,0.12971264731973134,0.5967150139131719
4949,0.4951,3,10,3,660077,16367,102027,24229,0.1296334431630972,0.5968322002167701
4950,0.4952,11,6,11,660083,16361,102038,24218,0.12958592066911673,0.5968111584809878
4951,0.4953,9,10,9,660093,16351,102047,24209,0.12950671651248258,0.5968688362919132
4952,0.4954,9,15,9,660108,16336,102056,24200,0.12938791027753135,0.5970001973554372
4953,0.4955,9,13,9,660121,16323,102065,24191,0.129284944873907,0.5971022362640075
4954,0.4956,11,12,11,660133,16311,102076,24180,0.129189899885946,0.5971697414240201
4955,0.4957,7,17,7,660150,16294,102083,24173,0.12905525281966798,0.597350927916574
4956,0.4958,8,8,8,660158,16286,102091,24165,0.12899188949436066,0.5973894341301822
4957,0.4959,10,15,10,660173,16271,102101,24155,0.12887308325940947,0.5975115024983921
4958,0.496,9,12,9,660185,16259,102110,24146,0.1287780382714485,0.5975993070164584
4959,0.4961,10,11,10,660196,16248,102120,24136,0.12869091369915092,0.597662440570523
4960,0.4962,11,11,11,660207,16237,102131,24125,0.12860378912685339,0.5977156731579208
4961,0.4963,8,9,8,660216,16228,102139,24117,0.12853250538588265,0.5977692403023919
4962,0.4964,6,10,6,660226,16218,102145,24111,0.1284533012292485,0.5978576210667261
4963,0.4965,12,11,12,660237,16207,102157,24099,0.12836617665695096,0.5979010569146033
4964,0.4966,5,16,5,660253,16191,102162,24094,0.12823945000633633,0.5980886185925283
4965,0.4967,8,16,8,660269,16175,102170,24086,0.1281127233557217,0.5982464419661707
4966,0.4968,9,11,9,660280,16164,102179,24077,0.12802559878342415,0.5983201212693522
4967,0.4969,10,12,10,660292,16152,102189,24067,0.1279305537954632,0.5983987667520326
4968,0.497,7,8,7,660300,16144,102196,24060,0.12786719047015588,0.5984479156302855
4969,0.4971,12,10,12,660310,16134,102208,24048,0.12778798631352173,0.5984769299686427
4970,0.4972,13,13,13,660323,16121,102221,24035,0.12768502090989736,0.5985406913039147
4971,0.4973,13,21,13,660344,16100,102234,24022,0.12751869218096565,0.5987238921290066
4972,0.4974,9,13,9,660357,16087,102243,24013,0.12741572677734128,0.5988279301745636
4973,0.4975,10,11,10,660368,16076,102253,24003,0.12732860220504372,0.5988921879288406
4974,0.4976,7,10,7,660378,16066,102260,23996,0.12724939804840957,0.5989715940292547
4975,0.4977,12,5,12,660383,16061,102272,23984,0.12720979597009252,0.5989262080159821
4976,0.4978,13,12,13,660395,16049,102285,23971,0.12711475098213154,0.598975512243878
4977,0.4979,8,18,8,660413,16031,102293,23963,0.1269721835001901,0.5991648747312097
4978,0.498,4,6,4,660419,16025,102297,23959,0.1269246610062096,0.5992146858743498
4979,0.4981,5,13,5,660432,16012,102302,23954,0.12682169560258522,0.5993594555372066
4980,0.4982,11,16,11,660448,15996,102313,23943,0.1266949689519706,0.5994892210621198
4981,0.4983,13,8,13,660456,15988,102326,23930,0.12663160562666329,0.599478931810211
4982,0.4984,15,6,15,660462,15982,102341,23915,0.1265840831326828,0.5994185026443091
4983,0.4985,14,10,14,660472,15972,102355,23901,0.12650487897604867,0.5994281844857422
4984,0.4986,9,11,9,660483,15961,102364,23892,0.1264177544037511,0.5995031741650566
4985,0.4987,11,10,11,660493,15951,102375,23881,0.12633855024711696,0.5995430809399478
4986,0.4988,9,9,9,660502,15942,102384,23872,0.12626726650614625,0.5995880845933591
4987,0.4989,12,16,12,660518,15926,102396,23860,0.1261405398555316,0.5997084401548284
4988,0.499,15,8,15,660526,15918,102411,23845,0.1260771765302243,0.599678092699243
4989,0.4991,6,12,6,660538,15906,102417,23839,0.12598213154226334,0.5997987168197257
4990,0.4992,10,11,10,660549,15895,102427,23829,0.12589500696996578,0.5998640620279931
4991,0.4993,11,11,11,660560,15884,102438,23818,0.12580788239766824,0.5999193995264722
4992,0.4994,15,12,15,660572,15872,102453,23803,0.12571283740970726,0.5999495904221802
4993,0.4995,6,10,6,660582,15862,102459,23797,0.1256336332530731,0.6000403439320204
4994,0.4996,12,18,12,660600,15844,102471,23785,0.12549106577113167,0.6001917787478867
4995,0.4997,11,15,11,660615,15829,102482,23774,0.12537225953618045,0.6003080574703936
4996,0.4998,7,12,7,660627,15817,102489,23767,0.1252772145482195,0.6004193613581245
4997,0.4999,9,12,9,660639,15805,102498,23758,0.12518216956025852,0.6005105780653641
4998,0.5,12,5,12,660644,15800,102510,23746,0.12514256748194144,0.6004652809386537
4999,0.5001,10,10,10,660654,15790,102520,23736,0.12506336332530732,0.6005161159742954
5000,0.5002,8,7,8,660661,15783,102528,23728,0.12500792041566341,0.6005416213206449
5001,0.5003,7,17,7,660678,15766,102535,23721,0.12487327334938537,0.6007293539645959
5002,0.5004,5,10,5,660688,15756,102540,23716,0.12479406919275124,0.6008309687880016
5003,0.5005,8,8,8,660696,15748,102548,23708,0.12473070586744392,0.6008718572587186
5004,0.5006,8,10,8,660706,15738,102556,23700,0.12465150171080978,0.6009432527004412
5005,0.5007,13,7,13,660713,15731,102569,23687,0.12459605880116588,0.6009183621695672
5006,0.5008,12,12,12,660725,15719,102581,23675,0.12450101381320491,0.6009798446463929
5007,0.5009,10,8,10,660733,15711,102591,23665,0.12443765048789761,0.6010006095083299
5008,0.501,11,6,11,660739,15705,102602,23654,0.12439012799391712,0.6009807159734749
5009,0.5011,17,7,17,660746,15698,102619,23637,0.12433468508427323,0.6009152154569721
5010,0.5012,11,15,11,660761,15683,102630,23626,0.12421587884932202,0.6010328423516244
5011,0.5013,9,11,9,660772,15672,102639,23617,0.12412875427702445,0.6011097253684238
5012,0.5014,13,15,13,660787,15657,102652,23604,0.12400994804207324,0.6012073049591198
5013,0.5015,15,13,15,660800,15644,102667,23589,0.12390698263844886,0.6012540463385415
5014,0.5016,9,14,9,660814,15630,102676,23580,0.12379609681916107,0.6013771996939556
5015,0.5017,11,10,11,660824,15620,102687,23569,0.12371689266252693,0.6014187654699023
5016,0.5018,11,12,11,660836,15608,102698,23558,0.12362184767456597,0.6014910892100291
5017,0.5019,10,12,10,660848,15596,102708,23548,0.12352680268660499,0.6015736766809728
5018,0.502,11,8,11,660856,15588,102719,23537,0.12346343936129768,0.6015846645367412
5019,0.5021,9,8,9,660864,15580,102728,23528,0.12340007603599037,0.6016160376393577
5020,0.5022,10,20,10,660884,15560,102738,23518,0.12324166772272209,0.6018219970315779
5021,0.5023,5,12,5,660896,15548,102743,23513,0.12314662273476112,0.6019559151071401
5022,0.5024,9,10,9,660906,15538,102752,23504,0.12306741857812697,0.6020183392244249
5023,0.5025,11,15,11,660921,15523,102763,23493,0.12294861234317576,0.6021375845806849
5024,0.5026,9,12,9,660933,15511,102772,23484,0.1228535673552148,0.6022310552634953
5025,0.5027,11,16,11,660949,15495,102783,23473,0.12272684070460017,0.6023660439334839
5026,0.5028,10,12,10,660961,15483,102793,23463,0.12263179571663921,0.6024495455245725
5027,0.5029,14,6,14,660967,15477,102807,23449,0.12258427322265872,0.6023994245491445
5028,0.503,11,10,11,660977,15467,102818,23438,0.12250506906602458,0.6024418455211412
5029,0.5031,8,7,8,660984,15460,102826,23430,0.12244962615638069,0.6024685008999743
5030,0.5032,10,10,10,660994,15450,102836,23420,0.12237042199974654,0.6025212245948032
5031,0.5033,18,9,18,661003,15441,102854,23402,0.12229913825877582,0.6024766367170404
5032,0.5034,10,14,10,661017,15427,102864,23392,0.12218825243948803,0.6025915144645663
5033,0.5035,5,17,5,661034,15410,102869,23387,0.12205360537320999,0.6028043405417944
5034,0.5036,8,9,8,661043,15401,102877,23379,0.12198232163223927,0.602862300154719
5035,0.5037,12,8,12,661051,15393,102889,23367,0.12191895830693195,0.6028637770897833
5036,0.5038,18,9,18,661060,15384,102907,23349,0.12184767456596123,0.602819301370924
5037,0.5039,4,14,4,661074,15370,102911,23345,0.12173678874667343,0.602996254681648
5038,0.504,11,7,11,661081,15363,102922,23334,0.12168134583702953,0.6029924800372122
5039,0.5041,7,11,7,661092,15352,102929,23327,0.12159422126473197,0.6030921171695235
5040,0.5042,10,11,10,661103,15341,102939,23317,0.12150709669243442,0.6031610533395416
5041,0.5043,4,7,4,661110,15334,102943,23313,0.12145165378279052,0.6032292286594043
5042,0.5044,9,18,9,661128,15316,102952,23304,0.12130908630084906,0.6034179181771103
5043,0.5045,10,12,10,661140,15304,102962,23294,0.1212140413128881,0.6035027721643609
5044,0.5046,12,10,12,661150,15294,102974,23282,0.12113483715625396,0.6035358772293654
5045,0.5047,10,12,10,661162,15282,102984,23272,0.121039792168293,0.6036208953675365
5046,0.5048,13,9,13,661171,15273,102997,23259,0.12096850842732226,0.6036281532232949
5047,0.5049,9,11,9,661182,15262,103006,23250,0.12088138385502471,0.603707935189032
5048,0.505,6,10,6,661192,15252,103012,23244,0.12080217969839058,0.6038029925187033
5049,0.5051,12,15,12,661207,15237,103024,23232,0.12068337346343937,0.6039148405209389
5050,0.5052,12,11,12,661218,15226,103036,23220,0.1205962488911418,0.6039640014565885
5051,0.5053,11,9,11,661227,15217,103047,23209,0.12052496515017108,0.6039920886899495
5052,0.5054,16,8,16,661235,15209,103063,23193,0.12046160182486376,0.6039529191187959
5053,0.5055,9,14,9,661249,15195,103072,23184,0.12035071600557597,0.6040803564449309
5054,0.5056,12,10,12,661259,15185,103084,23172,0.12027151184894183,0.6041139818025393
5055,0.5057,8,7,8,661266,15178,103092,23164,0.12021606893929794,0.604141672317563
5056,0.5058,12,10,12,661276,15168,103104,23152,0.12013686478266379,0.6041753653444677
5057,0.5059,15,7,15,661283,15161,103119,23137,0.1200814218730199,0.6041307640085645
5058,0.506,20,7,20,661290,15154,103139,23117,0.120025978963376,0.6040343863499777
5059,0.5061,10,7,10,661297,15147,103149,23107,0.1199705360537321,0.6040414074345166
5060,0.5062,8,6,8,661303,15141,103157,23099,0.11992301355975162,0.6040533472803348
5061,0.5063,10,14,10,661317,15127,103167,23089,0.11981212774046382,0.6041710278417417
5062,0.5064,9,9,9,661326,15118,103176,23080,0.1197408439994931,0.6042201162364522
5063,0.5065,7,10,7,661336,15108,103183,23073,0.11966163984285895,0.6043058065529976
5064,0.5066,7,10,7,661346,15098,103190,23066,0.11958243568622481,0.6043915732103553
5065,0.5067,11,13,11,661359,15085,103201,23055,0.11947947028260043,0.6044834819087572
5066,0.5068,10,9,10,661368,15076,103211,23045,0.1194081865416297,0.6045224416988012
5067,0.5069,6,10,6,661378,15066,103217,23039,0.11932898238499556,0.6046188164282903
5068,0.507,10,14,10,661392,15052,103227,23029,0.11921809656570777,0.6047372705548699
5069,0.5071,10,20,10,661412,15032,103237,23019,0.11905968825243948,0.6049512496386429
5070,0.5072,11,10,11,661422,15022,103248,23008,0.11898048409580535,0.6049960557454641
5071,0.5073,11,7,11,661429,15015,103259,22997,0.11892504118616146,0.6049931600547196
5072,0.5074,8,5,8,661434,15010,103267,22989,0.11888543910784438,0.604989604989605
5073,0.5075,14,10,14,661444,15000,103281,22975,0.11880623495121025,0.6050032916392364
5074,0.5076,7,11,7,661455,14989,103288,22968,0.11871911037891268,0.6051057775904313
5075,0.5077,9,18,9,661473,14971,103297,22959,0.11857654289697123,0.6052992354336937
5076,0.5078,11,7,11,661480,14964,103308,22948,0.11852109998732734,0.6052964760497995
5077,0.5079,11,8,11,661488,14956,103319,22937,0.11845773666202002,0.6053096878051355
5078,0.508,17,9,17,661497,14947,103336,22920,0.1183864529210493,0.6052763620038556
5079,0.5081,7,15,7,661512,14932,103343,22913,0.11826764668609809,0.6054432553838024
5080,0.5082,5,10,5,661522,14922,103348,22908,0.11818844252946395,0.6055511498810467
5081,0.5083,12,11,12,661533,14911,103360,22896,0.1181013179571664,0.6056021371703653
5082,0.5084,14,15,14,661548,14896,103374,22882,0.11798251172221519,0.6056964370797819
5083,0.5085,9,10,9,661558,14886,103383,22873,0.11790330756558104,0.6057628644826399
5084,0.5086,16,8,16,661566,14878,103399,22857,0.11783994424027373,0.6057241287928978
5085,0.5087,8,10,8,661576,14868,103407,22849,0.11776074008363958,0.6058010976482753
5086,0.5088,6,16,6,661592,14852,103413,22843,0.11763401343302496,0.6059954901180528
5087,0.5089,9,12,9,661604,14840,103422,22834,0.117538968445064,0.6060943887030844
5088,0.509,10,7,10,661611,14833,103432,22824,0.1174835255354201,0.606102451071514
5089,0.5091,11,9,11,661620,14824,103443,22813,0.11741224179444937,0.6061322634641443
5090,0.5092,10,9,10,661629,14815,103453,22803,0.11734095805347865,0.6061725769578393
5091,0.5093,9,10,9,661639,14805,103462,22794,0.11726175389684451,0.6062395276470118
5092,0.5094,7,4,7,661643,14801,103469,22787,0.11723007223419085,0.6062307119293392
5093,0.5095,8,5,8,661648,14796,103477,22779,0.11719047015587378,0.6062275449101796
5094,0.5096,10,17,10,661665,14779,103487,22769,0.11705582308959574,0.606397144987749
5095,0.5097,9,9,9,661674,14770,103496,22760,0.11698453934862502,0.6064481747934986
5096,0.5098,15,14,15,661688,14756,103511,22745,0.11687365352933722,0.6065171595424123
5097,0.5099,10,13,10,661701,14743,103521,22735,0.11677068812571284,0.606622551897113
5098,0.51,11,8,11,661709,14735,103532,22724,0.11670732480040552,0.6066365893376758
5099,0.5101,8,12,8,661721,14723,103540,22716,0.11661227981244456,0.6067469750794626
5100,0.5102,10,11,10,661732,14712,103550,22706,0.116525155240147,0.6068202469399754
5101,0.5103,5,9,5,661741,14703,103555,22701,0.11645387149917627,0.6069136990696182
5102,0.5104,13,9,13,661750,14694,103568,22688,0.11638258775820555,0.6069231180782194
5103,0.5105,13,14,13,661764,14680,103581,22675,0.11627170193891775,0.6070137866416812
5104,0.5106,10,11,10,661775,14669,103591,22665,0.1161845773666202,0.60708737343976
5105,0.5107,10,17,10,661792,14652,103601,22655,0.11604993030034216,0.607258691398397
5106,0.5108,16,12,16,661804,14640,103617,22639,0.1159548853123812,0.607285603154591
5107,0.5109,13,10,13,661814,14630,103630,22626,0.11587568115574705,0.6073115739746618
5108,0.511,12,13,12,661827,14617,103642,22614,0.11577271575212267,0.6073970615884612
5109,0.5111,10,12,10,661839,14605,103652,22604,0.1156776707641617,0.6074874358354162
5110,0.5112,13,5,13,661844,14600,103665,22591,0.11563806868584463,0.6074319055685515
5111,0.5113,12,14,12,661858,14586,103677,22579,0.11552718286655683,0.6075339701331899
5112,0.5114,10,11,10,661869,14575,103687,22569,0.11544005829425928,0.6076082274391558
5113,0.5115,8,9,8,661878,14566,103695,22561,0.11536877455328856,0.6076709672206211
5114,0.5116,5,6,5,661884,14560,103700,22556,0.11532125205930807,0.6077163487444768
5115,0.5117,6,13,6,661897,14547,103706,22550,0.11521828665568369,0.607865865164299
5116,0.5118,12,17,12,661914,14530,103718,22538,0.11508363958940565,0.6080176972051365
5117,0.5119,12,15,12,661929,14515,103730,22526,0.11496483335445444,0.6081369293485597
5118,0.512,12,15,12,661944,14500,103742,22514,0.11484602711950323,0.6082563354406441
5119,0.5121,11,11,11,661955,14489,103753,22503,0.11475890254720568,0.6083207179930796
5120,0.5122,6,10,6,661965,14479,103759,22497,0.11467969839057154,0.6084216789268715
5121,0.5123,6,8,6,661973,14471,103765,22491,0.11461633506526422,0.6084898003354797
5122,0.5124,6,6,6,661979,14465,103771,22485,0.11456881257128373,0.6085250338294993
5123,0.5125,10,11,10,661990,14454,103781,22475,0.11448168799898618,0.6086002870372877
5124,0.5126,12,12,12,662002,14442,103793,22463,0.11438664301102522,0.608670911800569
5125,0.5127,13,8,13,662010,14434,103806,22450,0.11432327968571791,0.6086650037956838
5126,0.5128,7,10,7,662020,14424,103813,22443,0.11424407552908376,0.608755797868012
5127,0.5129,12,11,12,662031,14413,103825,22431,0.11415695095678621,0.6088101183367712
5128,0.513,8,10,8,662041,14403,103833,22423,0.11407774680015208,0.608890457828708
5129,0.5131,11,11,11,662052,14392,103844,22412,0.11399062222785451,0.6089555483099663
5130,0.5132,6,10,6,662062,14382,103850,22406,0.11391141807122038,0.6090573012939002
5131,0.5133,7,9,7,662071,14373,103857,22399,0.11384013433024966,0.6091319482214729
5132,0.5134,14,18,14,662089,14355,103871,22385,0.1136975668483082,0.6092814371257484
5133,0.5135,10,17,10,662106,14338,103881,22375,0.11356291978203016,0.6094571405224307
5134,0.5136,12,13,12,662119,14325,103893,22363,0.11345995437840578,0.6095453554295682
5135,0.5137,14,9,14,662128,14316,103907,22349,0.11338867063743505,0.609545888449475
5136,0.5138,7,15,7,662143,14301,103914,22342,0.11326986440248384,0.6097208198018721
5137,0.5139,8,9,8,662152,14292,103922,22334,0.11319858066151312,0.6097853983508983
5138,0.514,12,10,12,662162,14282,103934,22322,0.11311937650487898,0.6098240629439405
5139,0.5141,7,14,7,662176,14268,103941,22315,0.11300849068559118,0.609982778886368
5140,0.5142,11,2,11,662178,14266,103952,22304,0.11299264985426435,0.6098988241728193
5141,0.5143,14,17,14,662195,14249,103966,22290,0.11285800278798631,0.6100331153014588
5142,0.5144,13,17,13,662212,14232,103979,22277,0.11272335572170827,0.6101783121969925
5143,0.5145,8,16,8,662228,14216,103987,22269,0.11259662907109365,0.6103604220912704
5144,0.5146,11,11,11,662239,14205,103998,22258,0.1125095044987961,0.6104270082000932
5145,0.5147,6,14,6,662253,14191,104004,22252,0.1123986186795083,0.6105973712372746
5146,0.5148,9,8,9,662261,14183,104013,22243,0.11233525535420098,0.6106352605281942
5147,0.5149,7,12,7,662273,14171,104020,22236,0.11224021036624002,0.6107616667124454
5148,0.515,8,10,8,662283,14161,104028,22228,0.11216100620960588,0.6108439363543928
5149,0.5151,7,16,7,662299,14145,104035,22221,0.11203427955899126,0.6110377825441347
5150,0.5152,13,8,13,662307,14137,104048,22208,0.11197091623368394,0.6110331544916769
5151,0.5153,11,9,11,662316,14128,104059,22197,0.11189963249271322,0.6110667584308328
5152,0.5154,9,12,9,662328,14116,104068,22188,0.11180458750475225,0.6111723226090789
5153,0.5155,11,10,11,662338,14106,104079,22177,0.11172538334811812,0.6112228867513712
5154,0.5156,7,7,7,662345,14099,104086,22170,0.11166994043847421,0.6112658192947145
5155,0.5157,9,11,9,662356,14088,104095,22161,0.11158281586617666,0.6113547959943723
5156,0.5158,12,9,12,662365,14079,104107,22149,0.11151153212520593,0.6113779397151374
5157,0.5159,5,9,5,662374,14070,104112,22144,0.1114402483842352,0.6114762246644944
5158,0.516,10,6,10,662380,14064,104122,22134,0.11139272589025472,0.611470246974971
5159,0.5161,5,14,5,662394,14050,104127,22129,0.11128184007096692,0.6116531689654219
5160,0.5162,8,7,8,662401,14043,104135,22121,0.11122639716132303,0.6116856542417874
5161,0.5163,8,12,8,662413,14031,104143,22113,0.11113135217336206,0.6118027888446215
5162,0.5164,11,13,11,662426,14018,104154,22102,0.11102838676973767,0.611904761904762
5163,0.5165,9,11,9,662437,14007,104163,22093,0.11094126219744012,0.611994459833795
5164,0.5166,14,5,14,662442,14002,104177,22079,0.11090166011912306,0.61192871594468
5165,0.5167,12,8,12,662450,13994,104189,22067,0.11083829679381574,0.6119353317988964
5166,0.5168,14,10,14,662460,13984,104203,22053,0.1107590926371816,0.6119543802203291
5167,0.5169,8,13,8,662473,13971,104211,22045,0.11065612723355722,0.6120890715237672
5168,0.517,12,12,12,662485,13959,104223,22033,0.11056108224559624,0.6121638141809291
5169,0.5171,12,7,12,662492,13952,104235,22021,0.11050563933595235,0.6121535596141551
5170,0.5172,8,16,8,662508,13936,104243,22013,0.11037891268533773,0.6123397034688031
5171,0.5173,13,11,13,662519,13925,104256,22000,0.11029178811304018,0.6123869171885873
5172,0.5174,6,8,6,662527,13917,104262,21994,0.11022842478773286,0.6124585781515413
5173,0.5175,11,6,11,662533,13911,104273,21983,0.11018090229375238,0.6124421908954143
5174,0.5176,9,10,9,662543,13901,104282,21974,0.11010169813711823,0.6125156794425087
5175,0.5177,9,12,9,662555,13889,104291,21965,0.11000665314915727,0.6126234171919451
5176,0.5178,11,11,11,662566,13878,104302,21954,0.10991952857685972,0.6126925653047556
5177,0.5179,9,14,9,662580,13864,104311,21945,0.10980864275757192,0.6128347622106174
5178,0.518,8,8,8,662588,13856,104319,21937,0.1097452794322646,0.6128852010169586
5179,0.5181,11,13,11,662601,13843,104330,21926,0.10964231402864022,0.6129889010036624
5180,0.5182,10,3,10,662604,13840,104340,21916,0.10961855278164997,0.6129320953126748
5181,0.5183,7,6,7,662610,13834,104347,21909,0.1095710302876695,0.6129591808186218
5182,0.5184,15,9,15,662619,13825,104362,21894,0.10949974654669876,0.6129510904560598
5183,0.5185,11,15,11,662634,13810,104373,21883,0.10938094031174755,0.6130894012831648
5184,0.5186,10,10,10,662644,13800,104383,21873,0.10930173615511342,0.6131528046421664
5185,0.5187,7,13,7,662657,13787,104390,21866,0.10919877075148904,0.6133004235267719
5186,0.5188,9,10,9,662667,13777,104399,21857,0.1091195665948549,0.6133748667003424
5187,0.5189,10,7,10,662674,13770,104409,21847,0.109064123685211,0.6133868658225005
5188,0.519,5,16,5,662690,13754,104414,21842,0.10893739703459637,0.6136082705922014
5189,0.5191,6,5,6,662695,13749,104420,21836,0.10889779495627931,0.6136293382042995
5190,0.5192,17,15,17,662710,13734,104437,21819,0.1087789887213281,0.6137034849379799
5191,0.5193,12,8,12,662718,13726,104449,21807,0.10871562539602078,0.6137111980412574
5192,0.5194,14,5,14,662723,13721,104463,21793,0.10867602331770371,0.6136453229712227
5193,0.5195,9,9,9,662732,13712,104472,21784,0.10860473957673299,0.613702952445346
5194,0.5196,11,11,11,662743,13701,104483,21773,0.10851761500443544,0.6137734678919772
5195,0.5197,13,9,13,662752,13692,104496,21760,0.1084463312634647,0.613787656549701
5196,0.5198,7,10,7,662762,13682,104503,21753,0.10836712710683057,0.6138845773952307
5197,0.5199,9,17,9,662779,13665,104512,21744,0.10823248004055253,0.6140811658053037
5198,0.52,13,8,13,662787,13657,104525,21731,0.10816911671524522,0.6140782186051769
5199,0.5201,13,8,13,662795,13649,104538,21718,0.1081057533899379,0.6140752679051092
5200,0.5202,8,12,8,662807,13637,104546,21710,0.10801070840197693,0.6141963957337256
5201,0.5203,12,5,12,662812,13632,104558,21698,0.10797110632365986,0.6141522785168412
5202,0.5204,15,9,15,662821,13623,104573,21683,0.10789982258268914,0.6141449045488019
5203,0.5205,6,6,6,662827,13617,104579,21677,0.10785230008870865,0.6141837139457131
5204,0.5206,14,9,14,662836,13608,104593,21663,0.10778101634773793,0.6141872926767032
5205,0.5207,8,12,8,662848,13596,104601,21655,0.10768597135977696,0.6143088139343564
5206,0.5208,5,16,5,662864,13580,104606,21650,0.10755924470916234,0.6145330684076071
5207,0.5209,9,9,9,662873,13571,104615,21641,0.10748796096819162,0.6145916164943769
5208,0.521,6,12,6,662885,13559,104621,21635,0.10739291598023064,0.6147354662726601
5209,0.5211,10,8,10,662893,13551,104631,21625,0.10732955265492333,0.6147657493745736
5210,0.5212,9,9,9,662902,13542,104640,21616,0.1072582689139526,0.6148245065134536
5211,0.5213,10,8,10,662910,13534,104650,21606,0.10719490558864529,0.6148548662492885
5212,0.5214,11,10,11,662920,13524,104661,21595,0.10711570143201116,0.6149093083516045
5213,0.5215,6,16,6,662936,13508,104667,21589,0.10698897478139653,0.6151237997549648
5214,0.5216,6,8,6,662944,13500,104673,21583,0.10692561145608921,0.6151982441638401
5215,0.5217,5,9,5,662953,13491,104678,21578,0.10685432771511849,0.61530126322393
5216,0.5218,8,6,8,662959,13485,104686,21570,0.106806805221138,0.615318784766795
5217,0.5219,12,8,12,662967,13477,104698,21558,0.1067434418958307,0.6153275296132439
5218,0.522,9,8,9,662975,13469,104707,21549,0.10668007857052338,0.6153692386772517
5219,0.5221,4,12,4,662987,13457,104711,21545,0.10658503358256241,0.6155362550711387
5220,0.5222,9,6,9,662993,13451,104720,21536,0.10653751108858193,0.6155429159402064
5221,0.5223,7,5,7,662998,13446,104727,21529,0.10649790901026486,0.6155539671193709
5222,0.5224,9,7,9,663005,13439,104736,21520,0.10644246610062096,0.6155782488057439
5223,0.5225,12,9,12,663014,13430,104748,21508,0.10637118235965023,0.6156047856202416
5224,0.5226,10,12,10,663026,13418,104758,21498,0.10627613737168927,0.6157062664680949
5225,0.5227,7,12,7,663038,13406,104765,21491,0.1061810923837283,0.615840903229504
5226,0.5228,6,9,6,663047,13397,104771,21485,0.10610980864275757,0.6159337193968236
5227,0.5229,8,8,8,663055,13389,104779,21477,0.10604644531745026,0.6159869213560488
5228,0.523,7,14,7,663069,13375,104786,21470,0.10593555949816247,0.6161572679007031
5229,0.5231,12,10,12,663079,13365,104798,21458,0.10585635534152832,0.6162019355023979
5230,0.5232,6,7,6,663086,13358,104804,21452,0.10580091243188443,0.6162596954898018
5231,0.5233,7,6,7,663092,13352,104811,21445,0.10575338993790394,0.6162887605253327
5232,0.5234,8,12,8,663104,13340,104819,21437,0.10565834494994297,0.6164131466198924
5233,0.5235,8,11,8,663115,13329,104827,21429,0.10557122037764542,0.6165199378560331
5234,0.5236,7,14,7,663129,13315,104834,21422,0.10546033455835763,0.616691136252411
5235,0.5237,7,6,7,663135,13309,104841,21415,0.10541281206437714,0.6167204239142956
5236,0.5238,10,7,10,663142,13302,104851,21405,0.10535736915473325,0.6167343763505921
5237,0.5239,13,6,13,663148,13296,104864,21392,0.10530984666075276,0.6166974169741697
5238,0.524,11,17,11,663165,13279,104875,21381,0.10517519959447472,0.6168782458165032
5239,0.5241,9,10,9,663175,13269,104884,21372,0.10509599543784058,0.6169567853122023
5240,0.5242,6,4,6,663179,13265,104890,21366,0.10506431377518692,0.6169616817302417
5241,0.5243,4,7,4,663186,13258,104894,21362,0.10500887086554303,0.6170421721548238
5242,0.5244,12,14,12,663200,13244,104906,21350,0.10489798504625522,0.6171590449210845
5243,0.5245,11,10,11,663210,13234,104917,21339,0.10481878088962109,0.617215746391693
5244,0.5246,8,6,8,663216,13228,104925,21331,0.10477125839564061,0.6172342949738129
5245,0.5247,10,9,10,663225,13219,104935,21321,0.10469997465466988,0.6172843080486392
5246,0.5248,12,8,12,663233,13211,104947,21309,0.10463661132936257,0.6172943221320973
5247,0.5249,12,10,12,663243,13201,104959,21297,0.10455740717272842,0.6173401356600383
5248,0.525,14,10,14,663253,13191,104973,21283,0.10447820301609428,0.6173638104078436
5249,0.5251,13,9,13,663262,13182,104986,21270,0.10440691927512356,0.6173807035876001
5250,0.5252,13,6,13,663268,13176,104999,21257,0.10435939678114307,0.6173438271425667
5251,0.5253,8,9,8,663277,13167,105007,21249,0.10428811304017235,0.6174163179916318
5252,0.5254,9,10,9,663287,13157,105016,21240,0.1042089088835382,0.6174957118353345
5253,0.5255,14,8,14,663295,13149,105030,21226,0.1041455455582309,0.6174836363636363
5254,0.5256,9,8,9,663303,13141,105039,21217,0.10408218223292358,0.6175272134582921
5255,0.5257,11,8,11,663311,13133,105050,21206,0.10401881890761627,0.6175485599464167
5256,0.5258,8,15,8,663326,13118,105058,21198,0.10390001267266506,0.6177293390838093
5257,0.5259,14,11,14,663337,13107,105072,21184,0.10381288810036751,0.6177714269050189
5258,0.526,4,7,4,663344,13100,105076,21180,0.10375744519072361,0.617852975495916
5259,0.5261,8,9,8,663353,13091,105084,21172,0.10368616144975289,0.6179260426699354
5260,0.5262,8,12,8,663365,13079,105092,21164,0.10359111646179192,0.6180533247671057
5261,0.5263,8,10,8,663375,13069,105100,21156,0.10351191230515777,0.6181446311176041
5262,0.5264,3,9,3,663384,13060,105103,21153,0.10344062856418705,0.6182737555899804
5263,0.5265,3,8,3,663392,13052,105106,21150,0.10337726523887973,0.6183848897725279
5264,0.5266,7,4,7,663396,13048,105113,21143,0.10334558357622609,0.6183791056125881
5265,0.5267,9,8,9,663404,13040,105122,21134,0.10328222025091877,0.6184233627904254
5266,0.5268,5,5,5,663409,13035,105127,21129,0.1032426181726017,0.6184580259922726
5267,0.5269,14,5,14,663414,13030,105141,21115,0.10320301609428463,0.6183921511202226
5268,0.527,12,7,12,663421,13023,105153,21103,0.10314757318464073,0.6183848092363594
5269,0.5271,13,6,13,663427,13017,105166,21090,0.10310005069066025,0.6183481396780719
5270,0.5272,15,9,15,663436,13008,105181,21075,0.10302876694968952,0.6183434556817181
5271,0.5273,10,12,10,663448,12996,105191,21065,0.10293372196172855,0.6184492528111329
5272,0.5274,7,14,7,663462,12982,105198,21058,0.10282283614244075,0.6186251468860164
5273,0.5275,11,10,11,663472,12972,105209,21047,0.10274363198580662,0.6186836767688645
5274,0.5276,7,10,7,663482,12962,105216,21040,0.10266442782917247,0.6187871301688136
5275,0.5277,9,12,9,663494,12950,105225,21031,0.1025693828412115,0.6189046820281923
5276,0.5278,5,15,5,663509,12935,105230,21026,0.1024505766062603,0.6191219339830982
5277,0.5279,9,9,9,663518,12926,105239,21017,0.10237929286528957,0.6191851044397961
5278,0.528,12,11,12,663529,12915,105251,21005,0.10229216829299202,0.6192511792452831
5279,0.5281,10,3,10,663532,12912,105261,20995,0.10226840704600178,0.6191936768218952
5280,0.5282,10,7,10,663539,12905,105271,20985,0.10221296413635787,0.6192092062555326
5281,0.5283,5,9,5,663548,12896,105276,20980,0.10214168039538715,0.6193175109221868
5282,0.5284,18,9,18,663557,12887,105294,20962,0.10207039665441642,0.6192797423852994
5283,0.5285,5,10,5,663567,12877,105299,20957,0.10199119249778228,0.6194065141573565
5284,0.5286,7,9,7,663576,12868,105306,20950,0.10191990875681156,0.6194925779170856
5285,0.5287,2,4,2,663580,12864,105308,20948,0.1018882270941579,0.6195433573879097
5286,0.5288,14,9,14,663589,12855,105322,20934,0.10181694335318718,0.6195507413655331
5287,0.5289,16,9,16,663598,12846,105338,20918,0.10174565961221645,0.6195356000473877
5288,0.529,13,11,13,663609,12835,105351,20905,0.1016585350399189,0.6195909899229401
5289,0.5291,9,10,9,663619,12825,105360,20896,0.10157933088328476,0.6196732006761365
5290,0.5292,6,7,6,663626,12818,105366,20890,0.10152388797364086,0.6197341877299157
5291,0.5293,9,10,9,663636,12808,105375,20881,0.10144468381700672,0.6198165573332541
5292,0.5294,9,7,9,663643,12801,105384,20872,0.10138924090736282,0.6198437917619458
5293,0.5295,5,14,5,663657,12787,105389,20867,0.10127835508807502,0.6200451655078149
5294,0.5296,6,15,6,663672,12772,105395,20861,0.10115954885312381,0.6202539172836202
5295,0.5297,12,7,12,663679,12765,105407,20849,0.10110410594347992,0.6202475159159874
5296,0.5298,3,18,3,663697,12747,105410,20846,0.10096153846153846,0.6205459470723067
5297,0.5299,5,10,5,663707,12737,105415,20841,0.10088233430490433,0.620674250997677
5298,0.53,10,9,10,663716,12728,105425,20831,0.1008110505639336,0.6207276736493936
5299,0.5301,6,10,6,663726,12718,105431,20825,0.10073184640729946,0.6208448856691411
5300,0.5302,6,9,6,663735,12709,105437,20819,0.10066056266632872,0.6209436888570747
5301,0.5303,9,12,9,663747,12697,105446,20810,0.10056551767836776,0.6210642552302504
5302,0.5304,8,14,8,663761,12683,105454,20802,0.10045463185907996,0.6212333880842168
5303,0.5305,5,12,5,663773,12671,105459,20797,0.100359586871119,0.6213995458348273
5304,0.5306,8,6,8,663779,12665,105467,20789,0.10031206437713851,0.6214204579422491
5305,0.5307,4,6,4,663785,12659,105471,20785,0.10026454188315803,0.6214866642746083
5306,0.5308,8,7,8,663792,12652,105479,20777,0.10020909897351413,0.6215262197493194
5307,0.5309,7,5,7,663797,12647,105486,20770,0.10016949689519707,0.621539934763743
5308,0.531,10,13,10,663810,12634,105496,20760,0.10006653149157267,0.6216685632149488
5309,0.5311,9,4,9,663814,12630,105505,20751,0.10003484982891903,0.6216410532937899
5310,0.5312,9,6,9,663820,12624,105514,20742,0.09998732733493854,0.6216507822334113
5311,0.5313,10,6,10,663826,12618,105524,20732,0.09993980484095806,0.6216491754122938
5312,0.5314,12,11,12,663837,12607,105536,20720,0.0998526802686605,0.6217181264440244
5313,0.5315,8,15,8,663852,12592,105544,20712,0.09973387403370929,0.6219072784049964
5314,0.5316,11,10,11,663862,12582,105555,20701,0.09965466987707515,0.6219691734519124
5315,0.5317,11,12,11,663874,12570,105566,20690,0.09955962488911418,0.6220685508117859
5316,0.5318,9,9,9,663883,12561,105575,20681,0.09948834114814345,0.6221346489380903
5317,0.5319,8,7,8,663890,12554,105583,20673,0.09943289823849956,0.6221747374123454
5318,0.532,8,12,8,663902,12542,105591,20665,0.0993378532505386,0.6223085494022345
5319,0.5321,6,12,6,663914,12530,105597,20659,0.09924280826257761,0.6224652746391877
5320,0.5322,8,10,8,663924,12520,105605,20651,0.09916360410594348,0.6225618763377649
5321,0.5323,12,8,12,663932,12512,105617,20639,0.09910024078063617,0.6225754879189165
5322,0.5324,9,9,9,663941,12503,105626,20630,0.09902895703966544,0.6226420788941539
5323,0.5325,13,12,13,663953,12491,105639,20617,0.09893391205170447,0.6227195843904797
5324,0.5326,2,14,2,663967,12477,105641,20615,0.09882302623241668,0.6229602320802611
5325,0.5327,10,13,10,663980,12464,105651,20605,0.0987200608287923,0.6230911125223019
5326,0.5328,7,5,7,663985,12459,105658,20598,0.09868045875047522,0.6231055449677829
5327,0.5329,10,7,10,663992,12452,105668,20588,0.09862501584083133,0.6231234866828087
5328,0.533,9,11,9,664003,12441,105677,20579,0.09853789126853377,0.6232283464566929
5329,0.5331,13,11,13,664014,12430,105690,20566,0.09845076669623622,0.6232876712328768
5330,0.5332,7,8,7,664022,12422,105697,20559,0.09838740337092891,0.6233589036111701
5331,0.5333,12,10,12,664032,12412,105709,20547,0.09830819921429476,0.6234109044570527
5332,0.5334,9,14,9,664046,12398,105718,20538,0.09819731339500697,0.6235729900412922
5333,0.5335,7,6,7,664052,12392,105725,20531,0.09814979090102649,0.6236065972116758
5334,0.5336,8,10,8,664062,12382,105733,20523,0.09807058674439234,0.623704604163501
5335,0.5337,7,9,7,664071,12373,105740,20516,0.09799930300342162,0.6237951898811153
5336,0.5338,12,10,12,664081,12363,105752,20504,0.09792009884678748,0.6238476283201996
5337,0.5339,13,9,13,664090,12354,105765,20491,0.09784881510581675,0.6238696909727508
5338,0.534,10,8,10,664098,12346,105775,20481,0.09778545178050944,0.6239071496024614
5339,0.5341,6,4,6,664102,12342,105781,20475,0.09775377011785578,0.6239144345918274
5340,0.5342,11,13,11,664115,12329,105792,20464,0.0976508047142314,0.6240356173573629
5341,0.5343,8,7,8,664122,12322,105800,20456,0.0975953618045875,0.6240771249008481
5342,0.5344,4,10,4,664132,12312,105804,20452,0.09751615764795336,0.6242217067513124
5343,0.5345,11,12,11,664144,12300,105815,20441,0.0974211126599924,0.624324241776366
5344,0.5346,6,6,6,664150,12294,105821,20435,0.09737359016601191,0.6243698249259066
5345,0.5347,7,10,7,664160,12284,105828,20428,0.09729438600937777,0.6244803130349719
5346,0.5348,6,8,6,664168,12276,105834,20422,0.09723102268407045,0.6245641935286562
5347,0.5349,13,7,13,664175,12269,105847,20409,0.09717557977442656,0.6245486259869025
5348,0.535,8,10,8,664185,12259,105855,20401,0.09709637561779243,0.6246478873239436
5349,0.5351,11,12,11,664197,12247,105866,20390,0.09700133062983145,0.6247510494224346
5350,0.5352,12,4,12,664201,12243,105878,20378,0.0969696489671778,0.6246896171178076
5351,0.5353,6,9,6,664210,12234,105884,20372,0.09689836522620707,0.6247929828865852
5352,0.5354,4,8,4,664218,12226,105888,20368,0.09683500190089976,0.6249002883966375
5353,0.5355,8,15,8,664233,12211,105896,20360,0.09671619566594855,0.6250959442448805
5354,0.5356,10,9,10,664242,12202,105906,20350,0.09664491192497782,0.625153600393217
5355,0.5357,7,10,7,664252,12192,105913,20343,0.09656570776834368,0.6252650991240203
5356,0.5358,6,6,6,664258,12186,105919,20337,0.0965181852743632,0.6253113181440827
5357,0.5359,9,7,9,664265,12179,105928,20328,0.0964627423647193,0.6253422339803735
5358,0.536,9,12,9,664277,12167,105937,20319,0.09636769737675834,0.6254694329865172
5359,0.5361,9,8,9,664285,12159,105946,20310,0.09630433405145102,0.6255197265083619
5360,0.5362,11,6,11,664291,12153,105957,20299,0.09625681155747054,0.6255084432392457
5361,0.5363,5,7,5,664298,12146,105962,20294,0.09620136864782663,0.6255856966707768
5362,0.5364,8,9,8,664307,12137,105970,20286,0.09613008490685591,0.6256669648089319
5363,0.5365,10,14,10,664321,12123,105980,20276,0.09601919908756812,0.6258217846229822
5364,0.5366,8,11,8,664332,12112,105988,20268,0.09593207451527055,0.6259419394688079
5365,0.5367,8,8,8,664340,12104,105996,20260,0.09586871118996325,0.6260042021999753
5366,0.5368,6,10,6,664350,12094,106002,20254,0.09578950703332911,0.6261283541486337
5367,0.5369,9,6,9,664356,12088,106011,20245,0.09574198453934862,0.626140475675007
5368,0.537,5,14,5,664370,12074,106016,20240,0.09563109872006083,0.626353902333354
5369,0.5371,16,9,16,664379,12065,106032,20224,0.09555981497909011,0.6263433367400663
5370,0.5372,7,7,7,664386,12058,106039,20217,0.0955043720694462,0.6263981409759876
5371,0.5373,10,4,10,664390,12054,106049,20207,0.09547269040679254,0.6263600012398872
5372,0.5374,9,3,9,664393,12051,106058,20198,0.09544892915980231,0.6263139942323793
5373,0.5375,10,3,10,664396,12048,106068,20188,0.09542516791281207,0.6262563593497953
5374,0.5376,15,3,15,664399,12045,106083,20173,0.09540140666582182,0.6261406667080514
5375,0.5377,12,10,12,664409,12035,106095,20161,0.09532220250918769,0.6261958007205864
5376,0.5378,10,8,10,664417,12027,106105,20151,0.09525883918388037,0.6262353160544472
5377,0.5379,14,5,14,664422,12022,106119,20137,0.0952192371055633,0.6261699679716409
5378,0.538,11,8,11,664430,12014,106130,20126,0.09515587378025599,0.6261978842563783
5379,0.5381,12,12,12,664442,12002,106142,20114,0.09506082879229502,0.6262921908083199
5380,0.5382,6,16,6,664458,11986,106148,20108,0.0949341021416804,0.6265345547454353
5381,0.5383,10,6,10,664464,11980,106158,20098,0.0948865796476999,0.626535320157117
5382,0.5384,5,4,5,664468,11976,106163,20093,0.09485489798504626,0.6265552402631825
5383,0.5385,8,5,8,664473,11971,106171,20085,0.09481529590672919,0.6265597704017969
5384,0.5386,5,5,5,664478,11966,106176,20080,0.09477569382841211,0.6265992635586345
5385,0.5387,14,11,14,664489,11955,106190,20066,0.09468856925611456,0.6266512601105525
5386,0.5388,8,5,8,664494,11950,106198,20058,0.09464896717779749,0.6266558360409897
5387,0.5389,9,6,9,664500,11944,106207,20049,0.09460144468381701,0.6266683336979965
5388,0.539,13,8,13,664508,11936,106220,20036,0.09453808135850969,0.6266733391717753
5389,0.5391,9,7,9,664515,11929,106229,20027,0.0944826384488658,0.6267054700212793
5390,0.5392,7,14,7,664529,11915,106236,20020,0.094371752629578,0.6268983873493033
5391,0.5393,8,15,8,664544,11900,106244,20012,0.0942529463946268,0.6270995236901479
5392,0.5394,9,5,9,664549,11895,106253,20003,0.09421334431630972,0.6270926076870024
5393,0.5395,9,12,9,664561,11883,106262,19994,0.09411829932834875,0.6272233899049472
5394,0.5396,6,5,6,664566,11878,106268,19988,0.09407869725003168,0.6272516161425972
5395,0.5397,6,15,6,664581,11863,106274,19982,0.09395989101508047,0.6274768409483436
5396,0.5398,9,3,9,664584,11860,106283,19973,0.09393612976809022,0.6274306537241228
5397,0.5399,6,9,6,664593,11851,106289,19967,0.0938648460271195,0.6275378716449809
5398,0.54,11,13,11,664606,11838,106300,19956,0.09376188062349512,0.6276655972825061
5399,0.5401,11,7,11,664613,11831,106311,19945,0.09370643771385122,0.6276749748237663
5400,0.5402,10,7,10,664620,11824,106321,19935,0.09365099480420733,0.6276960861488082
5401,0.5403,12,9,12,664629,11815,106333,19923,0.09357971106323659,0.6277333165290818
5402,0.5404,7,9,7,664638,11806,106340,19916,0.09350842732226587,0.6278292667549334
5403,0.5405,6,7,6,664645,11799,106346,19910,0.09345298441262198,0.6278974423665206
5404,0.5406,10,6,10,664651,11793,106356,19900,0.09340546191864149,0.6278989051210047
5405,0.5407,7,8,7,664659,11785,106363,19893,0.09334209859333417,0.6279752509628133
5406,0.5408,6,8,6,664667,11777,106369,19887,0.09327873526802687,0.6280634158665993
5407,0.5409,3,9,3,664676,11768,106372,19884,0.09320745152705615,0.6282067483887274
5408,0.541,13,3,13,664679,11765,106385,19871,0.0931836902800659,0.6281135415349601
5409,0.5411,9,7,9,664686,11758,106394,19862,0.093128247370422,0.628146742567995
5410,0.5412,9,13,9,664699,11745,106403,19853,0.09302528196679762,0.6282992594468004
5411,0.5413,7,8,7,664707,11737,106410,19846,0.09296191864149031,0.6283760250767818
5412,0.5414,6,9,6,664716,11728,106416,19840,0.09289063490051958,0.6284845413076533
5413,0.5415,10,13,10,664729,11715,106426,19830,0.0927876694968952,0.6286257727056586
5414,0.5416,6,9,6,664738,11706,106432,19824,0.09271638575592447,0.6287345385347288
5415,0.5417,7,14,7,664752,11692,106439,19817,0.09260549993663668,0.6289314164207052
5416,0.5418,11,11,11,664763,11681,106450,19806,0.09251837536433911,0.6290215009368946
5417,0.5419,7,10,7,664773,11671,106457,19799,0.09243917120770498,0.6291388624086431
5418,0.542,6,5,6,664778,11666,106463,19793,0.0923995691293879,0.6291681235894339
5419,0.5421,11,5,11,664783,11661,106474,19782,0.09235996705107084,0.6291384409884553
5420,0.5422,5,10,5,664793,11651,106479,19777,0.0922807628944367,0.6292796232658776
5421,0.5423,9,9,9,664802,11642,106488,19768,0.09220947915346597,0.6293537090098694
5422,0.5424,3,8,3,664810,11634,106491,19765,0.09214611582815867,0.6294786458167457
5423,0.5425,11,9,11,664819,11625,106502,19754,0.09207483208718793,0.629529303037063
5424,0.5426,5,5,5,664824,11620,106507,19749,0.09203523000887087,0.629570595173579
5425,0.5427,8,10,8,664834,11610,106515,19741,0.09195602585223672,0.6296768843099104
5426,0.5428,8,12,8,664846,11598,106523,19733,0.09186098086427576,0.6298234974944943
5427,0.5429,5,9,5,664855,11589,106528,19728,0.09178969712330504,0.6299453970686847
5428,0.543,11,9,11,664864,11580,106539,19717,0.0917184133823343,0.6299964852861296
5429,0.5431,8,7,8,664871,11573,106547,19709,0.09166297047269041,0.6300428361357969
5430,0.5432,15,7,15,664878,11566,106562,19694,0.0916075275630465,0.6300063979526551
5431,0.5433,5,9,5,664887,11557,106567,19689,0.09153624382207579,0.630128656468028
5432,0.5434,7,5,7,664892,11552,106574,19682,0.09149664174375871,0.6301466350771595
5433,0.5435,4,11,4,664903,11541,106578,19678,0.09140951717146116,0.6303212787084788
5434,0.5436,9,9,9,664912,11532,106587,19669,0.09133823343049043,0.6303964616518701
5435,0.5437,12,9,12,664921,11523,106599,19657,0.0912669496895197,0.6304361770365619
5436,0.5438,5,5,5,664926,11518,106604,19652,0.09122734761120263,0.6304780237407764
5437,0.5439,3,12,3,664938,11506,106607,19649,0.09113230262324166,0.6306852832611138
5438,0.544,13,8,13,664946,11498,106620,19636,0.09106893929793436,0.6306931329093596
5439,0.5441,13,8,13,664954,11490,106633,19623,0.09100557597262704,0.6307009931539871
5440,0.5442,10,9,10,664963,11481,106643,19613,0.09093429223165632,0.630764777770631
5441,0.5443,4,6,4,664969,11475,106647,19609,0.09088676973767583,0.6308390168575473
5442,0.5444,9,11,9,664980,11464,106656,19600,0.09079964516537828,0.6309554468194695
5443,0.5445,8,12,8,664992,11452,106664,19592,0.09070460017741731,0.6311042391444401
5444,0.5446,7,12,7,665004,11440,106671,19585,0.09060955518945635,0.6312651087832393
5445,0.5447,6,6,6,665010,11434,106677,19579,0.09056203269547586,0.6313158997839615
5446,0.5448,8,9,8,665019,11425,106685,19571,0.09049074895450514,0.6314040521357595
5447,0.5449,8,9,8,665028,11416,106693,19563,0.0904194652135344,0.6314923012363214
5448,0.545,9,6,9,665034,11410,106702,19554,0.09037194271955393,0.6315075571631572
5449,0.5451,2,9,2,665043,11401,106704,19552,0.09030065897858319,0.631667366652667
5450,0.5452,6,6,6,665049,11395,106710,19546,0.09025313648460272,0.6317184318541741
5451,0.5453,9,13,9,665062,11382,106719,19537,0.09015017108097834,0.6318768394838126
5452,0.5454,14,9,14,665071,11373,106733,19523,0.0900788873400076,0.6318940963231486
5453,0.5455,9,3,9,665074,11370,106742,19514,0.09005512609301736,0.6318482061909079
5454,0.5456,9,10,9,665084,11360,106751,19505,0.08997592193638322,0.6319455694151952
5455,0.5457,10,6,10,665090,11354,106761,19495,0.08992839944240273,0.6319491717721806
5456,0.5458,8,12,8,665102,11342,106769,19487,0.08983335445444177,0.6320996464367965
5457,0.5459,12,6,12,665108,11336,106781,19475,0.08978583196046129,0.6320794521437149
5458,0.546,9,8,9,665116,11328,106790,19466,0.08972246863515397,0.6321361304150159
5459,0.5461,9,14,9,665130,11314,106799,19457,0.08961158281586618,0.6323161418218453
5460,0.5462,10,5,10,665135,11309,106809,19447,0.0895719807375491,0.632299388737157
5461,0.5463,7,14,7,665149,11295,106816,19440,0.0894610949182613,0.6325036603221084
5462,0.5464,7,4,7,665153,11291,106823,19433,0.08942941325560766,0.6325022783491733
5463,0.5465,8,4,8,665157,11287,106831,19425,0.089397731592954,0.6324889294087002
5464,0.5466,8,9,8,665166,11278,106839,19417,0.08932644785198328,0.6325785958625183
5465,0.5467,8,11,8,665177,11267,106847,19409,0.08923932327968571,0.6327096101186596
5466,0.5468,8,5,8,665182,11262,106855,19401,0.08919972120136865,0.6327169552881323
5467,0.5469,7,3,7,665185,11259,106862,19394,0.08917595995437841,0.6326950053828336
5468,0.547,9,7,9,665192,11252,106871,19385,0.0891205170447345,0.6327316643274472
5469,0.5471,16,7,16,665199,11245,106887,19369,0.08906507413509061,0.6326843927614817
5470,0.5472,9,7,9,665206,11238,106896,19360,0.08900963122544671,0.6327210928818877
5471,0.5473,7,8,7,665214,11230,106903,19353,0.0889462679001394,0.6328025373573554
5472,0.5474,9,12,9,665226,11218,106912,19344,0.08885122291217844,0.6329428702310058
5473,0.5475,10,15,10,665241,11203,106922,19334,0.08873241667722723,0.6331335756623113
5474,0.5476,9,4,9,665245,11199,106931,19325,0.08870073501457357,0.6331083737386974
5475,0.5477,6,13,6,665258,11186,106937,19319,0.08859776961094919,0.6333060154073102
5476,0.5478,5,11,5,665269,11175,106942,19314,0.08851064503865162,0.6334743678047821
5477,0.5479,7,11,7,665280,11164,106949,19307,0.08842352046635407,0.6336188507105116
5478,0.548,14,9,14,665289,11155,106963,19293,0.08835223672538335,0.6336376773515502
5479,0.5481,7,10,7,665299,11145,106970,19286,0.0882730325687492,0.6337616246590647
5480,0.5482,7,7,7,665306,11138,106977,19279,0.08821758965910531,0.633823190978729
5481,0.5483,10,10,10,665316,11128,106987,19269,0.08813838550247118,0.6339112412409119
5482,0.5484,10,2,10,665318,11126,106997,19259,0.08812254467114435,0.6338324831331249
5483,0.5485,8,6,8,665324,11120,107005,19251,0.08807502217716386,0.633861249218004
5484,0.5486,9,8,9,665332,11112,107014,19242,0.08801165885185655,0.6339197469855703
5485,0.5487,7,9,7,665341,11103,107021,19235,0.08794037511088582,0.6340233370690224
5486,0.5488,3,7,3,665348,11096,107024,19232,0.08788493220124192,0.6341334740174096
5487,0.5489,9,4,9,665352,11092,107033,19223,0.08785325053858827,0.6341085271317829
5488,0.549,9,7,9,665359,11085,107042,19214,0.08779780762894436,0.6341463414634146
5489,0.5491,5,9,5,665368,11076,107047,19209,0.08772652388797364,0.634274393263992
5490,0.5492,8,8,8,665376,11068,107055,19201,0.08766316056266633,0.634345369850342
5491,0.5493,4,6,4,665382,11062,107059,19197,0.08761563806868584,0.6344228163521597
5492,0.5494,8,7,8,665389,11055,107067,19189,0.08756019515904194,0.6344729533130539
5493,0.5495,12,3,12,665392,11052,107079,19177,0.08753643391205171,0.6343908167653578
5494,0.5496,7,4,7,665396,11048,107086,19170,0.08750475224939805,0.6343900986167185
5495,0.5497,8,11,8,665407,11037,107094,19162,0.0874176276771005,0.6345243219974172
5496,0.5498,3,10,3,665417,11027,107097,19159,0.08733842352046635,0.6346982044656463
5497,0.5499,11,8,11,665425,11019,107108,19148,0.08727506019515904,0.634733317863891
5498,0.55,10,8,10,665433,11011,107118,19138,0.08721169686985172,0.6347805897376364
5499,0.5501,7,8,7,665441,11003,107125,19131,0.08714833354454442,0.634864272914316
5500,0.5502,13,8,13,665449,10995,107138,19118,0.08708497021923711,0.6348753030252715
5501,0.5503,10,7,10,665456,10988,107148,19108,0.08702952730959321,0.6349016480595427
5502,0.5504,10,9,10,665465,10979,107158,19098,0.08695824356862249,0.6349702430428567
5503,0.5505,10,7,10,665472,10972,107168,19088,0.08690280065897858,0.6349966733200266
5504,0.5506,4,9,4,665481,10963,107172,19084,0.08683151691800786,0.6351382833560755
5505,0.5507,10,12,10,665493,10951,107182,19074,0.08673647193004688,0.635270607826811
5506,0.5508,8,7,8,665500,10944,107190,19066,0.08668102902040299,0.6353215594801733
5507,0.5509,3,6,3,665506,10938,107193,19063,0.0866335065264225,0.6354121529282357
5508,0.551,8,8,8,665514,10930,107201,19055,0.0865701432011152,0.6354844088711022
5509,0.5511,6,7,6,665521,10923,107207,19049,0.08651470029147129,0.6355598558654745
5510,0.5512,6,10,6,665531,10913,107213,19043,0.08643549613483716,0.6356990252370143
5511,0.5513,8,7,8,665538,10906,107221,19035,0.08638005322519325,0.6357503089409171
5512,0.5514,3,8,3,665546,10898,107224,19032,0.08631668989988595,0.6358837287003007
5513,0.5515,8,7,8,665553,10891,107232,19024,0.08626124699024205,0.6359351495905065
5514,0.5516,4,6,4,665559,10885,107236,19020,0.08621372449626157,0.6360140444741682
5515,0.5517,2,5,2,665564,10880,107238,19018,0.08617412241794449,0.6360960599371195
5516,0.5518,5,8,5,665572,10872,107243,19013,0.08611075909263718,0.6362054542412582
5517,0.5519,8,4,8,665576,10868,107251,19005,0.08607907742998352,0.6361932179560138
5518,0.552,8,15,8,665591,10853,107259,18997,0.08596027119503231,0.6364154103852596
5519,0.5521,10,12,10,665603,10841,107269,18987,0.08586522620707135,0.6365495507576774
5520,0.5522,5,5,5,665608,10836,107274,18982,0.08582562412875427,0.6365953450935676
5521,0.5523,8,10,8,665618,10826,107282,18974,0.08574641997212014,0.6367114093959731
5522,0.5524,11,11,11,665629,10815,107293,18963,0.08565929539982259,0.6368124118476728
5523,0.5525,3,12,3,665641,10803,107296,18960,0.08556425041186161,0.637032557201895
5524,0.5526,10,9,10,665650,10794,107306,18950,0.08549296667089089,0.6371032813340506
5525,0.5527,13,10,13,665660,10784,107319,18937,0.08541376251425675,0.6371589112075636
5526,0.5528,5,10,5,665670,10774,107324,18932,0.0853345583576226,0.6373123274759308
5527,0.5529,13,7,13,665677,10767,107337,18919,0.08527911544797871,0.6373037795593882
5528,0.553,6,9,6,665686,10758,107343,18913,0.08520783170700798,0.6374237470931212
5529,0.5531,9,11,9,665697,10747,107352,18904,0.08512070713471043,0.637550166942093
5530,0.5532,7,6,7,665703,10741,107359,18897,0.08507318464072995,0.6375936297995816
5531,0.5533,11,5,11,665708,10736,107370,18886,0.08503358256241288,0.6375666734184052
5532,0.5534,10,9,10,665717,10727,107380,18876,0.08496229882144216,0.6376380772219031
5533,0.5535,10,6,10,665723,10721,107390,18866,0.08491477632746167,0.6376449116165883
5534,0.5536,5,8,5,665731,10713,107395,18861,0.08485141300215435,0.6377561371474945
5535,0.5537,8,6,8,665737,10707,107403,18853,0.08480389050817387,0.637787550744249
5536,0.5538,9,9,9,665746,10698,107412,18844,0.08473260676720314,0.6378715049759665
5537,0.5539,6,6,6,665752,10692,107418,18838,0.08468508427322266,0.6379275313240772
5538,0.554,6,6,6,665758,10686,107424,18832,0.08463756177924217,0.6379836032251508
5539,0.5541,12,10,12,665768,10676,107436,18820,0.08455835762260804,0.6380526173040413
5540,0.5542,10,6,10,665774,10670,107446,18810,0.08451083512862755,0.6380597014925373
5541,0.5543,8,2,8,665776,10668,107454,18802,0.08449499429730072,0.6380047505938242
5542,0.5544,4,13,4,665789,10655,107458,18798,0.08439202889367634,0.6382371914575765
5543,0.5545,4,6,4,665795,10649,107462,18794,0.08434450639969586,0.6383181061712462
5544,0.5546,8,11,8,665806,10638,107470,18786,0.0842573818273983,0.638458401305057
5545,0.5547,8,9,8,665815,10629,107478,18778,0.08418609808642757,0.6385554459822491
5546,0.5548,11,6,11,665821,10623,107489,18767,0.0841385755924471,0.6385505273902689
5547,0.5549,6,9,6,665830,10614,107495,18761,0.08406729185147636,0.6386723404255319
5548,0.555,8,7,8,665837,10607,107503,18753,0.08401184894183247,0.6387261580381471
5549,0.5551,10,5,10,665842,10602,107513,18743,0.0839722468635154,0.6387118759584256
5550,0.5552,8,8,8,665850,10594,107521,18735,0.08390888353820808,0.6387875481605237
5551,0.5553,9,12,9,665862,10582,107530,18726,0.08381383855024711,0.6389381738774396
5552,0.5554,9,12,9,665874,10570,107539,18717,0.08371879356228615,0.639089015604193
5553,0.5555,9,4,9,665878,10566,107548,18708,0.08368711189963249,0.6390653822504612
5554,0.5556,5,12,5,665890,10554,107553,18703,0.08359206691167152,0.6392658167276207
5555,0.5557,6,7,6,665897,10547,107559,18697,0.08353662400202763,0.6393448228696484
5556,0.5558,8,6,8,665903,10541,107567,18689,0.08348910150804714,0.6393773520355799
5557,0.5559,5,15,5,665918,10526,107572,18684,0.08337029527309593,0.6396439575487847
5558,0.556,12,12,12,665930,10514,107584,18672,0.08327525028513497,0.6397587884602206
5559,0.5561,6,8,6,665938,10506,107590,18666,0.08321188695982765,0.6398601398601399
5560,0.5562,2,6,2,665944,10500,107592,18664,0.08316436446584717,0.6399670827047045
5561,0.5563,8,9,8,665953,10491,107600,18656,0.08309308072487644,0.6400658729886438
5562,0.5564,12,7,12,665960,10484,107612,18644,0.08303763781523255,0.6400714089535842
5563,0.5565,7,6,7,665966,10478,107619,18637,0.08299011532125206,0.6401167782929761
5564,0.5566,5,5,5,665971,10473,107624,18632,0.082950513242935,0.6401649201168185
5565,0.5567,10,9,10,665980,10464,107634,18622,0.08287922950196426,0.6402392903802516
5566,0.5568,2,6,2,665986,10458,107636,18620,0.08283170700798378,0.640346653827636
5567,0.5569,8,3,8,665989,10455,107644,18612,0.08280794576099354,0.6403137578697492
5568,0.557,8,5,8,665994,10450,107652,18604,0.08276834368267647,0.6403249122323948
5569,0.5571,11,9,11,666003,10441,107663,18593,0.08269705994170574,0.6403871323276159
5570,0.5572,11,11,11,666014,10430,107674,18582,0.08260993536940818,0.6404935888597821
5571,0.5573,6,8,6,666022,10422,107680,18576,0.08254657204410087,0.6405959031657356
5572,0.5574,9,10,9,666032,10412,107689,18567,0.08246736788746674,0.6407053383484592
5573,0.5575,9,8,9,666040,10404,107698,18558,0.08240400456215942,0.6407706650093226
5574,0.5576,4,3,4,666043,10401,107702,18554,0.08238024331516917,0.6407874287687791
5575,0.5577,12,13,12,666056,10388,107714,18542,0.0822772779115448,0.6409263740062219
5576,0.5578,4,7,4,666063,10381,107718,18538,0.0822218350019009,0.6410318475742591
5577,0.5579,7,8,7,666071,10373,107725,18531,0.08215847167659358,0.6411223360088569
5578,0.558,8,6,8,666077,10367,107733,18523,0.08211094918261311,0.6411561093804085
5579,0.5581,6,3,6,666080,10364,107739,18517,0.08208718793562286,0.6411481596897615
5580,0.5582,5,6,5,666086,10358,107744,18512,0.08203966544164237,0.6412192587461032
5581,0.5583,7,8,7,666094,10350,107751,18505,0.08197630211633507,0.641309998267198
5582,0.5584,7,3,7,666097,10347,107758,18498,0.08195254086934482,0.6412896515860634
5583,0.5585,8,9,8,666106,10338,107766,18490,0.0818812571283741,0.6413903149715554
5584,0.5586,6,7,6,666113,10331,107772,18484,0.0818258142187302,0.6414714558389728
5585,0.5587,11,7,11,666120,10324,107783,18473,0.0817703713090863,0.6414904330312186
5586,0.5588,5,3,5,666123,10321,107788,18468,0.08174661006209606,0.6414950154572927
5587,0.5589,7,8,7,666131,10313,107795,18461,0.08168324673678874,0.6415861541669563
5588,0.559,10,10,10,666141,10303,107805,18451,0.0816040425801546,0.6416846351811922
5589,0.5591,9,13,9,666154,10290,107814,18442,0.08150107717653023,0.6418627314492552
5590,0.5592,5,8,5,666162,10282,107819,18437,0.0814377138512229,0.6419791775479647
5591,0.5593,13,2,13,666164,10280,107832,18424,0.08142187301989609,0.6418617614269788
5592,0.5594,10,4,10,666168,10276,107842,18414,0.08139019135724243,0.6418264203555246
5593,0.5595,4,8,4,666176,10268,107846,18410,0.08132682803193511,0.6419555059627589
5594,0.5596,9,9,9,666185,10259,107855,18401,0.08125554429096439,0.6420446615491975
5595,0.5597,5,5,5,666190,10254,107860,18396,0.08121594221264732,0.6420942408376963
5596,0.5598,6,7,6,666197,10247,107866,18390,0.08116049930300342,0.6421762056081294
5597,0.5599,14,10,14,666207,10237,107880,18376,0.08108129514636928,0.64222556180757
5598,0.56,9,7,9,666214,10230,107889,18367,0.08102585223672538,0.6422701681994615
5599,0.5601,7,5,7,666219,10225,107896,18360,0.08098625015840831,0.642294909917789
5600,0.5602,7,8,7,666227,10217,107903,18353,0.080922886833101,0.6423871193559678
5601,0.5603,10,8,10,666235,10209,107913,18343,0.08085952350779368,0.6424418604651163
5602,0.5604,5,12,5,666247,10197,107918,18338,0.08076447851983272,0.642649377956895
5603,0.5605,9,6,9,666253,10191,107927,18329,0.08071695602585224,0.642671809256662
5604,0.5606,3,10,3,666263,10181,107930,18326,0.0806377518692181,0.6428596485073842
5605,0.5607,6,7,6,666270,10174,107936,18320,0.0805823089595742,0.6429423738330877
5606,0.5608,5,7,5,666277,10167,107941,18315,0.0805268660499303,0.6430377080261218
5607,0.5609,5,2,5,666279,10165,107946,18310,0.08051102521860347,0.6430201931518876
5608,0.561,5,9,5,666288,10156,107951,18305,0.08043974147763275,0.6431608165559889
5609,0.5611,13,10,13,666298,10146,107964,18292,0.08036053732099861,0.6432238554047401
5610,0.5612,11,5,11,666303,10141,107975,18281,0.08032093524268154,0.6431989304060235
5611,0.5613,4,15,4,666318,10126,107979,18277,0.08020212900773033,0.6434883639052212
5612,0.5614,8,5,8,666323,10121,107987,18269,0.08016252692941325,0.6435012328284607
5613,0.5615,12,5,12,666328,10116,107999,18257,0.08012292485109619,0.6434638564832763
5614,0.5616,8,14,8,666342,10102,108007,18249,0.08001203903180838,0.6436809989065642
5615,0.5617,6,8,6,666350,10094,108013,18243,0.07994867570650108,0.6437872745879945
5616,0.5618,9,8,9,666358,10086,108022,18234,0.07988531238119377,0.6438559322033899
5617,0.5619,11,6,11,666364,10080,108033,18223,0.07983778988721328,0.6438540084090025
5618,0.562,10,2,10,666366,10078,108043,18213,0.07982194905588645,0.6437736382595172
5619,0.5621,7,11,7,666377,10067,108050,18206,0.0797348244835889,0.6439359105860715
5620,0.5622,10,6,10,666383,10061,108060,18196,0.07968730198960841,0.6439466326927841
5621,0.5623,8,5,8,666388,10056,108068,18188,0.07964769991129135,0.6439597790681206
5622,0.5624,5,7,5,666395,10049,108073,18183,0.07959225700164745,0.6440563899121564
5623,0.5625,4,6,4,666401,10043,108077,18179,0.07954473450766696,0.6441428672666714
5624,0.5626,6,7,6,666408,10036,108083,18173,0.07948929159802307,0.6442270197454713
5625,0.5627,10,7,10,666415,10029,108093,18163,0.07943384868837916,0.6442607832009081
5626,0.5628,10,3,10,666418,10026,108103,18153,0.07941008744138893,0.6442031299904184
5627,0.5629,9,8,9,666426,10018,108112,18144,0.07934672411608161,0.6442724238335346
5628,0.563,7,9,7,666435,10009,108119,18137,0.07927544037511089,0.6443899666027144
5629,0.5631,6,8,6,666443,10001,108125,18131,0.07921207704980357,0.6444973695435803
5630,0.5632,10,8,10,666451,9993,108135,18121,0.07914871372449626,0.6445543145763677
5631,0.5633,8,6,8,666457,9987,108143,18113,0.07910119123051577,0.6445907473309609
5632,0.5634,7,12,7,666469,9975,108150,18106,0.07900614624255481,0.6447776076350558
5633,0.5635,8,5,8,666474,9970,108158,18098,0.07896654416423773,0.6447912213196523
5634,0.5636,5,7,5,666481,9963,108163,18093,0.07891110125459384,0.6448887938408896
5635,0.5637,9,7,9,666488,9956,108172,18084,0.07885565834494994,0.6449358059914408
5636,0.5638,9,3,9,666491,9953,108181,18075,0.07883189709795971,0.644890823462252
5637,0.5639,9,4,9,666495,9949,108190,18066,0.07880021543530605,0.6448688202748527
5638,0.564,8,6,8,666501,9943,108198,18058,0.07875269294132556,0.6449055390878897
5639,0.5641,6,12,6,666513,9931,108204,18052,0.07865764795336459,0.6451059571882929
5640,0.5642,4,6,4,666519,9925,108208,18048,0.0786101254593841,0.6451935795231116
5641,0.5643,12,6,12,666525,9919,108220,18036,0.07856260296540363,0.6451797531747451
5642,0.5644,6,5,6,666530,9914,108226,18030,0.07852300088708655,0.6452190094474664
5643,0.5645,6,7,6,666537,9907,108232,18024,0.07846755797744266,0.6453045003759263
5644,0.5646,9,13,9,666550,9894,108241,18015,0.07836459257381827,0.6454907019241105
5645,0.5647,8,5,8,666555,9889,108249,18007,0.0783249904955012,0.6455047318611987
5646,0.5648,6,5,6,666560,9884,108255,18001,0.07828538841718413,0.6455441993903532
5647,0.5649,10,5,10,666565,9879,108265,17991,0.07824578633886706,0.6455328310010764
5648,0.565,6,10,6,666575,9869,108271,17985,0.07816658218223292,0.6456882314927838
5649,0.5651,9,5,9,666580,9864,108280,17976,0.07812698010391585,0.6456896551724138
5650,0.5652,11,6,11,666586,9858,108291,17965,0.07807945760993537,0.6456888186033138
5651,0.5653,6,5,6,666591,9853,108297,17959,0.0780398555316183,0.6457284625341579
5652,0.5654,12,10,12,666601,9843,108309,17947,0.07796065137498416,0.6458078445483987
5653,0.5655,7,9,7,666610,9834,108316,17940,0.07788936763401343,0.6459278461870814
5654,0.5656,10,5,10,666615,9829,108326,17930,0.07784976555569637,0.6459166396484023
5655,0.5657,4,8,4,666623,9821,108330,17926,0.07778640223038905,0.6460518254225682
5656,0.5658,14,7,14,666630,9814,108344,17912,0.07773095932074515,0.6460362114982328
5657,0.5659,9,7,9,666637,9807,108353,17903,0.07767551641110125,0.646084446048358
5658,0.566,8,9,8,666646,9798,108361,17895,0.07760423267013053,0.6461921785288701
5659,0.5661,12,7,12,666653,9791,108373,17883,0.07754878976048662,0.6462022114620222
5660,0.5662,6,9,6,666662,9782,108379,17877,0.0774775060195159,0.6463357315882714
5661,0.5663,2,5,2,666667,9777,108381,17875,0.07743790394119883,0.6464270215535947
5662,0.5664,8,7,8,666674,9770,108389,17867,0.07738246103155494,0.6464884032275573
5663,0.5665,10,6,10,666680,9764,108399,17857,0.07733493853757445,0.6465008508019261
5664,0.5666,15,10,15,666690,9754,108414,17842,0.07725573438094031,0.6465429772430787
5665,0.5667,8,8,8,666698,9746,108422,17834,0.077192371055633,0.646627991298042
5666,0.5668,8,3,8,666701,9743,108430,17826,0.07716860980864276,0.6465958141390692
5667,0.5669,8,4,8,666705,9739,108438,17818,0.0771369281459891,0.646587074064666
5668,0.567,21,5,21,666710,9734,108459,17797,0.07709732606767203,0.6464349278994588
5669,0.5671,7,13,7,666723,9721,108466,17790,0.07699436066404765,0.6466504307367962
5670,0.5672,5,9,5,666732,9712,108471,17785,0.07692307692307693,0.6467978324908171
5671,0.5673,5,4,5,666736,9708,108476,17780,0.07689139526042327,0.6468277066356228
5672,0.5674,12,4,12,666740,9704,108488,17768,0.07685971359776961,0.6467676179382644
5673,0.5675,11,16,11,666756,9688,108499,17757,0.07673298694715498,0.6470030971032975
5674,0.5676,16,5,16,666761,9683,108515,17741,0.07669338486883792,0.6469151108518086
5675,0.5677,5,3,5,666764,9680,108520,17736,0.07666962362184768,0.646921505690108
5676,0.5678,8,6,8,666770,9674,108528,17728,0.07662210112786719,0.6469600759068681
5677,0.5679,5,7,5,666777,9667,108533,17723,0.0765666582182233,0.6470609711573567
5678,0.568,6,7,6,666784,9660,108539,17717,0.07651121530857939,0.6471490667348504
5679,0.5681,8,8,8,666792,9652,108547,17709,0.07644785198327209,0.6472351156755967
5680,0.5682,6,9,6,666801,9643,108553,17703,0.07637656824230135,0.6473707306370219
5681,0.5683,13,8,13,666809,9635,108566,17690,0.07631320491699405,0.6473924977127173
5682,0.5684,11,8,11,666817,9627,108577,17679,0.07624984159168673,0.6474401230498792
5683,0.5685,9,7,9,666824,9620,108586,17670,0.07619439868204284,0.6474899230487358
5684,0.5686,7,8,7,666832,9612,108593,17663,0.07613103535673552,0.6475893675527039
5685,0.5687,6,6,6,666838,9606,108599,17657,0.07608351286275504,0.6476543300443824
5686,0.5688,7,7,7,666845,9599,108606,17650,0.07602806995311114,0.6477301919336489
5687,0.5689,4,8,4,666853,9591,108610,17646,0.07596470662780383,0.6478687080074899
5688,0.569,9,6,9,666859,9585,108619,17637,0.07591718413382334,0.6478950848578355
5689,0.5691,6,11,6,666870,9574,108625,17631,0.07583005956152579,0.6480793971696379
5690,0.5692,7,11,7,666881,9563,108632,17624,0.07574293498922824,0.6482510023172839
5691,0.5693,4,13,4,666894,9550,108636,17620,0.07563996958560386,0.6485093853514906
5692,0.5694,6,6,6,666900,9544,108642,17614,0.07559244709162337,0.6485750055232344
5693,0.5695,8,9,8,666909,9535,108650,17606,0.07552116335065265,0.6486864890755684
5694,0.5696,3,9,3,666918,9526,108653,17603,0.07544987960968191,0.648862840502783
5695,0.5697,7,10,7,666928,9516,108660,17596,0.07537067545304778,0.6490115078194157
5696,0.5698,5,9,5,666937,9507,108665,17591,0.07529939171207704,0.6491622998007233
5697,0.5699,11,4,11,666941,9503,108676,17580,0.0752677100494234,0.6491156814237714
5698,0.57,14,8,14,666949,9495,108690,17566,0.07520434672411608,0.6491260485569639
5699,0.5701,9,8,9,666957,9487,108699,17557,0.07514098339880877,0.6492013015826061
5700,0.5702,6,5,6,666962,9482,108705,17551,0.0751013813204917,0.6492435171827026
5701,0.5703,8,6,8,666968,9476,108713,17543,0.07505385882651122,0.649283837299678
5702,0.5704,8,5,8,666973,9471,108721,17535,0.07501425674819415,0.6493001555209953
5703,0.5705,6,7,6,666980,9464,108727,17529,0.07495881383855024,0.6493905827436743
5704,0.5706,5,7,5,666987,9457,108732,17524,0.07490337092890635,0.6494940884326007
5705,0.5707,11,5,11,666992,9452,108743,17513,0.07486376885058928,0.6494715371778231
5706,0.5708,5,7,5,666999,9445,108748,17508,0.07480832594094539,0.6495751864356473
5707,0.5709,13,5,13,667004,9440,108761,17495,0.07476872386262831,0.6495266382030815
5708,0.571,6,14,6,667018,9426,108767,17489,0.07465783804334052,0.6497863644807728
5709,0.5711,6,5,6,667023,9421,108773,17483,0.07461823596502344,0.6498290217068095
5710,0.5712,12,2,12,667025,9419,108785,17471,0.07460239513369661,0.6497210859055411
5711,0.5713,2,4,2,667029,9415,108787,17469,0.07457071347104297,0.6497916976640381
5712,0.5714,10,5,10,667034,9410,108797,17459,0.07453111139272589,0.6497822769734638
5713,0.5715,8,9,8,667043,9401,108805,17451,0.07445982765175517,0.649895724713243
5714,0.5716,14,5,14,667048,9396,108819,17437,0.0744202255734381,0.6498341594305519
5715,0.5717,7,4,7,667052,9392,108826,17430,0.07438854391078444,0.6498396838416225
5716,0.5718,7,6,7,667058,9386,108833,17423,0.07434102141680396,0.6498936924167257
5717,0.5719,9,5,9,667063,9381,108842,17414,0.07430141933848688,0.6498973689121105
5718,0.572,9,6,9,667069,9375,108851,17405,0.0742538968445064,0.6499253174010455
5719,0.5721,5,8,5,667077,9367,108856,17400,0.07419053351919909,0.6500541711809318
5720,0.5722,8,7,8,667084,9360,108864,17392,0.07413509060955518,0.6501196172248804
5721,0.5723,7,8,7,667092,9352,108871,17385,0.07407172728424788,0.6502225380558776
5722,0.5724,16,6,16,667098,9346,108887,17369,0.07402420479026739,0.650159086655437
5723,0.5725,5,13,5,667111,9333,108892,17364,0.07392123938664301,0.6504101584447691
5724,0.5726,8,2,8,667113,9331,108900,17356,0.07390539855531618,0.6503541049949414
5725,0.5727,11,8,11,667121,9323,108911,17345,0.07384203523000887,0.6504049797510124
5726,0.5728,5,4,5,667125,9319,108916,17340,0.07381035356735521,0.6504370006376833
5727,0.5729,8,8,8,667133,9311,108924,17332,0.07374699024204791,0.6505273430169275
5728,0.573,5,7,5,667140,9304,108929,17327,0.073691547332404,0.6506327212646915
5729,0.5731,4,6,4,667146,9298,108933,17323,0.07364402483842351,0.6507268697644717
5730,0.5732,16,9,16,667155,9289,108949,17307,0.07357274109745279,0.6507369529252519
5731,0.5733,9,8,9,667163,9281,108958,17298,0.07350937777214549,0.6508145528424696
5732,0.5734,10,11,10,667174,9270,108968,17288,0.07342225319984792,0.6509526319752993
5733,0.5735,3,8,3,667182,9262,108971,17285,0.07335888987454062,0.6511093532225863
5734,0.5736,8,5,8,667187,9257,108979,17277,0.07331928779622354,0.651126856109143
5735,0.5737,6,5,6,667192,9252,108985,17271,0.07327968571790648,0.6511706820495419
5736,0.5738,5,13,5,667205,9239,108990,17266,0.07317672031428209,0.6514242595736653
5737,0.5739,9,8,9,667213,9231,108999,17257,0.07311335698897478,0.6515025672002416
5738,0.574,8,11,8,667224,9220,109007,17249,0.07302623241667723,0.651667988968227
5739,0.5741,5,7,5,667231,9213,109012,17244,0.07297078950703333,0.6517745776165098
5740,0.5742,15,8,15,667239,9205,109027,17229,0.07290742618172602,0.6517742301581296
5741,0.5743,7,5,7,667244,9200,109034,17222,0.07286782410340895,0.6518053137536901
5742,0.5744,9,8,9,667252,9192,109043,17213,0.07280446077810164,0.6518841128574133
5743,0.5745,8,10,8,667262,9182,109051,17205,0.07272525662146749,0.6520256186758631
5744,0.5746,9,7,9,667269,9175,109060,17196,0.0726698137118236,0.6520799362936559
5745,0.5747,10,5,10,667274,9170,109070,17186,0.07263021163350653,0.6520716345424192
5746,0.5748,5,6,5,667280,9164,109075,17181,0.07258268913952604,0.6521541089390777
5747,0.5749,8,7,8,667287,9157,109083,17173,0.07252724622988214,0.6522218002278769
5748,0.575,2,5,2,667292,9152,109085,17171,0.07248764415156507,0.6523192645215211
5749,0.5751,9,6,9,667298,9146,109094,17162,0.0724401216575846,0.6523490953322183
5750,0.5752,6,6,6,667304,9140,109100,17156,0.0723925991636041,0.6524186188013386
5751,0.5753,7,6,7,667310,9134,109107,17149,0.07234507666962363,0.652474983829852
5752,0.5754,12,3,12,667313,9131,109119,17137,0.07232131542263338,0.6523907415867215
5753,0.5755,7,5,7,667318,9126,109126,17130,0.07228171334431631,0.6524223034734917
5754,0.5756,8,10,8,667328,9116,109134,17122,0.07220250918768217,0.6525649820870493
5755,0.5757,12,8,12,667336,9108,109146,17110,0.07213914586237485,0.6526050804790602
5756,0.5758,5,6,5,667342,9102,109151,17105,0.07209162336839438,0.6526882130728431
5757,0.5759,9,6,9,667348,9096,109160,17096,0.07204410087441389,0.6527183872938301
5758,0.576,10,5,10,667353,9091,109170,17086,0.07200449879609681,0.6527103946212324
5759,0.5761,7,5,7,667358,9086,109177,17079,0.07196489671777975,0.6527422128798013
5760,0.5762,5,12,5,667370,9074,109182,17074,0.07186985172981879,0.6529753709652746
5761,0.5763,6,4,6,667374,9070,109188,17068,0.07183817006716513,0.6529956385339353
5762,0.5764,5,2,5,667376,9068,109193,17063,0.0718223292358383,0.6529792200834258
5763,0.5765,14,11,14,667387,9057,109207,17049,0.07173520466354075,0.6530682601700758
5764,0.5766,10,6,10,667393,9051,109217,17039,0.07168768216956026,0.6530854733614412
5765,0.5767,4,7,4,667400,9044,109221,17035,0.07163223925991637,0.6532075616396334
5766,0.5768,5,5,5,667405,9039,109226,17030,0.07159263718159929,0.6532663316582915
5767,0.5769,10,6,10,667411,9033,109236,17020,0.0715451146876188,0.6532836909377039
5768,0.577,13,3,13,667414,9030,109249,17007,0.07152135344062856,0.6531858509044821
5769,0.5771,7,6,7,667420,9024,109256,17000,0.07147383094664808,0.6532431601598524
5770,0.5772,6,3,6,667423,9021,109262,16994,0.07145006969965784,0.6532385162406305
5771,0.5773,13,6,13,667429,9015,109275,16981,0.07140254720567736,0.6532158793660563
5772,0.5774,9,8,9,667437,9007,109284,16972,0.07133918388037004,0.653296893644867
5773,0.5775,9,6,9,667443,9001,109293,16963,0.07129166138638955,0.6533276844862117
5774,0.5776,5,7,5,667450,8994,109298,16958,0.07123621847674566,0.653437114673243
5775,0.5777,7,0,7,667450,8994,109305,16951,0.07123621847674566,0.6533436114858354
5776,0.5778,7,3,7,667453,8991,109312,16944,0.07121245722975542,0.6533256217466744
5777,0.5779,5,7,5,667460,8984,109317,16939,0.07115701432011153,0.6534351733981406
5778,0.578,7,5,7,667465,8979,109324,16932,0.07111741224179445,0.6534676392265834
5779,0.5781,7,6,7,667471,8973,109331,16925,0.07106988974781396,0.653525368754344
5780,0.5782,5,9,5,667480,8964,109336,16920,0.07099860600684324,0.6536856745479833
5781,0.5783,12,3,12,667483,8961,109348,16908,0.070974844759853,0.6536008349762263
5782,0.5784,5,7,5,667490,8954,109353,16903,0.0709194018502091,0.6537107939822872
5783,0.5785,7,6,7,667496,8948,109360,16896,0.07087187935622861,0.6537687664448227
5784,0.5786,10,4,10,667500,8944,109370,16886,0.07084019769357495,0.6537359659310878
5785,0.5787,5,7,5,667507,8937,109375,16881,0.07078475478393106,0.6538461538461539
5786,0.5788,5,5,5,667512,8932,109380,16876,0.07074515270561399,0.6539057656540608
5787,0.5789,7,7,7,667519,8925,109387,16869,0.0706897097959701,0.6539892998371715
5788,0.579,2,8,2,667527,8917,109389,16867,0.07062634647066278,0.6541653738752715
5789,0.5791,11,5,11,667532,8912,109400,16856,0.0705867443923457,0.6541446755665943
5790,0.5792,7,5,7,667537,8907,109407,16849,0.07054714231402864,0.654177667339649
5791,0.5793,6,6,6,667543,8901,109413,16843,0.07049961982004815,0.6542495338719702
5792,0.5794,3,3,3,667546,8898,109416,16840,0.07047585857305791,0.6542854922682415
5793,0.5795,5,9,5,667555,8889,109421,16835,0.07040457483208719,0.654447208832219
5794,0.5796,5,4,5,667559,8885,109426,16830,0.07037289316943353,0.6544818199494459
5795,0.5797,8,7,8,667566,8878,109434,16822,0.07031745025978964,0.6545525291828794
5796,0.5798,10,4,10,667570,8874,109444,16812,0.07028576859713598,0.6545199719691661
5797,0.5799,9,8,9,667578,8866,109453,16803,0.07022240527182867,0.654602828314309
5798,0.58,6,1,6,667579,8865,109459,16797,0.07021448485616526,0.654547580079495
5799,0.5801,4,3,4,667582,8862,109463,16793,0.07019072360917501,0.6545702592087312
5800,0.5802,7,10,7,667592,8852,109470,16786,0.07011151945254086,0.654731258288478
5801,0.5803,8,5,8,667597,8847,109478,16778,0.0700719173742238,0.6547512195121952
5802,0.5804,11,8,11,667605,8839,109489,16767,0.07000855404891648,0.6548074669999219
5803,0.5805,4,5,4,667610,8834,109493,16763,0.06996895197059942,0.6548814314177442
5804,0.5806,11,6,11,667616,8828,109504,16752,0.06992142947661893,0.654886630179828
5805,0.5807,5,7,5,667623,8821,109509,16747,0.06986598656697504,0.6549984355444305
5806,0.5808,9,6,9,667629,8815,109518,16738,0.06981846407299455,0.6550307204633506
5807,0.5809,4,6,4,667635,8809,109522,16734,0.06977094157901406,0.655130564146733
5808,0.581,17,6,17,667641,8803,109539,16717,0.06972341908503359,0.6550548589341693
5809,0.5811,9,4,9,667645,8799,109548,16708,0.06969173742237993,0.6550358725055867
5810,0.5812,9,3,9,667648,8796,109557,16699,0.06966797617538968,0.6549911747401451
5811,0.5813,13,6,13,667654,8790,109570,16686,0.0696204536814092,0.6549693829486576
5812,0.5814,10,5,10,667659,8785,109580,16676,0.06958085160309213,0.6549624916539021
5813,0.5815,8,11,8,667670,8774,109588,16668,0.06949372703079458,0.6551371747504127
5814,0.5816,6,2,6,667672,8772,109594,16662,0.06947788619946775,0.6551073366359991
5815,0.5817,10,13,10,667685,8759,109604,16652,0.06937492079584337,0.6553067569162961
5816,0.5818,5,9,5,667694,8750,109609,16647,0.06930363705487264,0.6554711186360593
5817,0.5819,7,2,7,667696,8748,109616,16640,0.0692877962235458,0.6554277611469986
5818,0.582,10,9,10,667705,8739,109626,16630,0.06921651248257508,0.6555244589853758
5819,0.5821,7,7,7,667712,8732,109633,16623,0.0691610695729312,0.6556103332676001
5820,0.5822,3,8,3,667720,8724,109636,16620,0.06909770624762387,0.6557765151515151
5821,0.5823,12,5,12,667725,8719,109648,16608,0.0690581041693068,0.6557428830891934
5822,0.5824,7,2,7,667727,8717,109655,16601,0.06904226333797998,0.6556995023303579
5823,0.5825,10,5,10,667732,8712,109665,16591,0.06900266125966291,0.6556930008299411
5824,0.5826,9,9,9,667741,8703,109674,16582,0.06893137751869217,0.6558038362665612
5825,0.5827,10,6,10,667747,8697,109684,16572,0.0688838550247117,0.6558233408524279
5826,0.5828,12,10,12,667757,8687,109696,16560,0.06880465086807756,0.6559195151899235
5827,0.5829,5,7,5,667764,8680,109701,16555,0.06874920795843366,0.6560332871012483
5828,0.583,4,0,4,667764,8680,109705,16551,0.06874920795843366,0.6559787562918632
5829,0.5831,8,6,8,667770,8674,109713,16543,0.06870168546445317,0.65602569695047
5830,0.5832,8,7,8,667777,8667,109721,16535,0.06864624255480928,0.6560987223236251
5831,0.5833,5,10,5,667787,8657,109726,16530,0.06856703839817514,0.6562909437408186
5832,0.5834,4,1,4,667788,8656,109730,16526,0.06855911798251173,0.656262409657692
5833,0.5835,5,10,5,667798,8646,109735,16521,0.06847991382587758,0.6564548813922995
5834,0.5836,7,4,7,667802,8642,109742,16514,0.06844823216322393,0.6564636667196693
5835,0.5837,12,9,12,667811,8633,109754,16502,0.0683769484222532,0.6565347125522181
5836,0.5838,7,9,7,667820,8624,109761,16495,0.06830566468128248,0.6566742306620487
5837,0.5839,7,5,7,667825,8619,109768,16488,0.0682660626029654,0.6567092842633528
5838,0.584,8,9,8,667834,8610,109776,16480,0.06819477886199468,0.6568353925866879
5839,0.5841,11,7,11,667841,8603,109787,16469,0.06813933595235078,0.6568682195277601
5840,0.5842,6,8,6,667849,8595,109793,16463,0.06807597262704347,0.6569957698140314
5841,0.5843,8,4,8,667853,8591,109801,16455,0.06804429096438981,0.656991136309191
5842,0.5844,8,6,8,667859,8585,109809,16447,0.06799676847040932,0.6570389900926814
5843,0.5845,2,8,2,667867,8577,109811,16445,0.06793340514510202,0.6572216449524418
5844,0.5846,8,2,8,667869,8575,109819,16437,0.06791756431377519,0.6571645610107149
5845,0.5847,7,5,7,667874,8570,109826,16430,0.06787796223545811,0.6572
5846,0.5848,8,4,8,667878,8566,109834,16422,0.06784628057280447,0.6571954538178325
5847,0.5849,7,10,7,667888,8556,109841,16415,0.06776707641617032,0.6573625405470346
5848,0.585,4,3,4,667891,8553,109845,16411,0.06774331516918009,0.65738663675693
5849,0.5851,9,4,9,667895,8549,109854,16402,0.06771163350652643,0.6573684421466074
5850,0.5852,4,4,4,667899,8545,109858,16398,0.06767995184387277,0.6574189151264884
5851,0.5853,10,6,10,667905,8539,109868,16388,0.06763242934989228,0.6574397239940627
5852,0.5854,8,6,8,667911,8533,109876,16380,0.0675849068559118,0.657488058443383
5853,0.5855,4,2,4,667913,8531,109880,16376,0.06756906602458497,0.65748584735215
5854,0.5856,7,7,7,667920,8524,109887,16369,0.06751362311494107,0.6575744185112281
5855,0.5857,8,3,8,667923,8521,109895,16361,0.06748986186795083,0.6575436058194679
5856,0.5858,6,4,6,667927,8517,109901,16355,0.06745818020529717,0.6575667417175941
5857,0.5859,4,5,4,667932,8512,109905,16351,0.0674185781269801,0.6576438885090294
5858,0.586,11,5,11,667937,8507,109916,16340,0.06737897604866304,0.6576246629371755
5859,0.5861,6,4,6,667941,8503,109922,16334,0.06734729438600938,0.657647864073761
5860,0.5862,7,3,7,667944,8500,109929,16327,0.06732353313901913,0.6576308051717887
5861,0.5863,5,8,5,667952,8492,109934,16322,0.06726016981371183,0.6577738373498832
5862,0.5864,7,8,7,667960,8484,109941,16315,0.06719680648840451,0.6578894310254446
5863,0.5865,12,7,12,667967,8477,109953,16303,0.06714136357876062,0.657909604519774
5864,0.5866,7,5,7,667972,8472,109960,16296,0.06710176150044354,0.6579457364341085
5865,0.5867,5,9,5,667981,8463,109965,16291,0.06703047775947282,0.6581158600630201
5866,0.5868,11,7,11,667988,8456,109976,16280,0.06697503484982892,0.658150064683053
5867,0.5869,6,6,6,667994,8450,109982,16274,0.06692751235584843,0.6582268241384889
5868,0.587,5,4,5,667998,8446,109987,16269,0.06689583069319478,0.6582642120169937
5869,0.5871,6,7,6,668005,8439,109993,16263,0.06684038778355088,0.6583677435025505
5870,0.5872,12,8,12,668013,8431,110005,16251,0.06677702445824357,0.6584150392998946
5871,0.5873,10,6,10,668019,8425,110015,16241,0.06672950196426308,0.6584367145057974
5872,0.5874,4,5,4,668024,8420,110019,16237,0.06668989988594601,0.6585148233767287
5873,0.5875,6,8,6,668032,8412,110025,16231,0.0666265365606387,0.6586454571277848
5874,0.5876,8,7,8,668039,8405,110033,16223,0.0665710936509948,0.6587217800877051
5875,0.5877,8,4,8,668043,8401,110041,16215,0.06653941198834115,0.6587179070523237
5876,0.5878,8,8,8,668051,8393,110049,16207,0.06647604866303383,0.6588211382113821
5877,0.5879,10,5,10,668056,8388,110059,16197,0.06643644658471677,0.6588163514338011
5878,0.588,7,5,7,668061,8383,110066,16190,0.0663968445063997,0.6588532128759207
5879,0.5881,11,9,11,668070,8374,110077,16179,0.06632556076542898,0.6589418808292266
5880,0.5882,7,5,7,668075,8369,110084,16172,0.0662859586871119,0.6589788517175339
5881,0.5883,8,5,8,668080,8364,110092,16164,0.06624635660879483,0.6590019569471625
5882,0.5884,3,5,3,668085,8359,110095,16161,0.06620675453047777,0.659094616639478
5883,0.5885,4,10,4,668095,8349,110099,16157,0.06612755037384362,0.6593079245898964
5884,0.5886,7,5,7,668100,8344,110106,16150,0.06608794829552656,0.6593451457499796
5885,0.5887,6,7,6,668107,8337,110112,16144,0.06603250538588265,0.6594501858584209
5886,0.5888,7,4,7,668111,8333,110119,16137,0.06600082372322899,0.6594605639558643
5887,0.5889,8,5,8,668116,8328,110127,16129,0.06596122164491193,0.6594839923130392
5888,0.589,4,5,4,668121,8323,110131,16125,0.06592161956659486,0.6595631544502618
5889,0.5891,9,12,9,668133,8311,110140,16116,0.06582657457863389,0.6597617390592377
5890,0.5892,5,4,5,668137,8307,110145,16111,0.06579489291598023,0.6598001474322222
5891,0.5893,9,5,9,668142,8302,110154,16102,0.06575529083766316,0.6598098672348796
5892,0.5894,8,6,8,668148,8296,110162,16094,0.06570776834368268,0.6598605986059861
5893,0.5895,7,6,7,668154,8290,110169,16087,0.06566024584970219,0.6599253394593264
5894,0.5896,3,7,3,668161,8283,110172,16084,0.0656048029400583,0.6600730496162843
5895,0.5897,4,9,4,668170,8274,110176,16080,0.06553351919908756,0.6602611480660261
5896,0.5898,10,6,10,668176,8268,110186,16070,0.06548599670510709,0.6602843290327882
5897,0.5899,8,6,8,668182,8262,110194,16062,0.0654384742111266,0.6603354711396152
5898,0.59,9,10,9,668192,8252,110203,16053,0.06535927005449246,0.6604813824315985
5899,0.5901,2,3,2,668195,8249,110205,16051,0.06533550880750222,0.6605349794238683
5900,0.5902,5,5,5,668200,8244,110210,16046,0.06529590672918514,0.6606010703993412
5901,0.5903,13,3,13,668203,8241,110223,16033,0.0652721454821949,0.6605009475158606
5902,0.5904,5,6,5,668209,8235,110228,16028,0.06522462298821442,0.6605943205704159
5903,0.5905,7,7,7,668216,8228,110235,16021,0.06516918007857052,0.6606870386407687
5904,0.5906,6,3,6,668219,8225,110241,16015,0.06514541883158029,0.6606848184818482
5905,0.5907,7,7,7,668226,8218,110248,16008,0.06508997592193638,0.6607776768760836
5906,0.5908,5,3,5,668229,8215,110253,16003,0.06506621467494614,0.6607894954166322
5907,0.5909,11,8,11,668237,8207,110264,15992,0.06500285134963883,0.6608537542873673
5908,0.591,3,6,3,668243,8201,110267,15989,0.06495532885565834,0.6609756097560976
5909,0.5911,6,4,6,668247,8197,110273,15983,0.06492364719300468,0.6610008271298594
5910,0.5912,11,9,11,668256,8188,110284,15972,0.06485236345203396,0.661092715231788
5911,0.5913,6,5,6,668261,8183,110290,15966,0.06481276137371689,0.6611453890430246
5912,0.5914,4,9,4,668270,8174,110294,15962,0.06474147763274617,0.6613357640039774
5913,0.5915,4,5,4,668275,8169,110298,15958,0.06470187555442909,0.6614166701206118
5914,0.5916,8,13,8,668288,8156,110306,15950,0.06459891015080471,0.6616609972620924
5915,0.5917,8,3,8,668291,8153,110314,15942,0.06457514890381447,0.6616310437850177
5916,0.5918,7,7,7,668298,8146,110321,15935,0.06451970599417058,0.6617250114197916
5917,0.5919,6,5,6,668303,8141,110327,15929,0.0644801039158535,0.6617781470710428
5918,0.592,9,9,9,668312,8132,110336,15920,0.06440882017488278,0.6618992183602195
5919,0.5921,8,3,8,668315,8129,110344,15912,0.06438505892789254,0.6618693066012229
5920,0.5922,8,7,8,668322,8122,110352,15904,0.06432961601824863,0.6619495546491301
5921,0.5923,7,8,7,668330,8114,110359,15897,0.06426625269294133,0.6620715505393361
5922,0.5924,9,3,9,668333,8111,110368,15888,0.06424249144595108,0.6620275844826867
5923,0.5925,6,4,6,668337,8107,110374,15882,0.06421080978329742,0.6620534411605319
5924,0.5926,5,8,5,668345,8099,110379,15877,0.06414744645799011,0.6622038705372039
5925,0.5927,9,3,9,668348,8096,110388,15868,0.06412368521099987,0.6621599065264564
5926,0.5928,3,6,3,668354,8090,110391,15865,0.0640761627170194,0.662283448131914
5927,0.5929,7,3,7,668357,8087,110398,15858,0.06405240147002915,0.6622676968051785
5928,0.593,3,4,3,668361,8083,110401,15855,0.06402071980737549,0.6623360347564542
5929,0.5931,7,8,7,668369,8075,110408,15848,0.06395735648206818,0.6624587217322242
5930,0.5932,3,5,3,668374,8070,110411,15845,0.06391775440375111,0.6625548818733012
5931,0.5933,2,6,2,668380,8064,110413,15843,0.06387023190977062,0.6626929351236039
5932,0.5934,3,12,3,668392,8052,110416,15840,0.06377518692180965,0.6629834254143646
5933,0.5935,3,8,3,668400,8044,110419,15837,0.06371182359650235,0.663163184121268
5934,0.5936,12,5,12,668405,8039,110431,15825,0.06367222151818527,0.6631327522628226
5935,0.5937,8,4,8,668409,8035,110439,15817,0.06364053985553161,0.6631309743417743
5936,0.5938,4,8,4,668417,8027,110443,15813,0.06357717653022431,0.6632969798657719
5937,0.5939,6,5,6,668422,8022,110449,15807,0.06353757445190723,0.6633513785723278
5938,0.594,7,4,7,668426,8018,110456,15800,0.06350589278925357,0.6633638424720799
5939,0.5941,8,5,8,668431,8013,110464,15792,0.06346629071093651,0.6633900441083805
5940,0.5942,8,4,8,668435,8009,110472,15784,0.06343460904828285,0.6633883915437313
5941,0.5943,7,7,7,668442,8002,110479,15777,0.06337916613863896,0.6634845872408428
5942,0.5944,9,7,9,668449,7995,110488,15768,0.06332372322899506,0.6635525817447292
5943,0.5945,12,6,12,668455,7989,110500,15756,0.06327620073501457,0.6635502210991788
5944,0.5946,8,3,8,668458,7986,110508,15748,0.06325243948802434,0.6635206876211343
5945,0.5947,7,7,7,668465,7979,110515,15741,0.06319699657838043,0.6636172006745362
5946,0.5948,10,4,10,668469,7975,110525,15731,0.06316531491572677,0.6635872774824939
5947,0.5949,10,5,10,668474,7970,110535,15721,0.06312571283740971,0.6635853277615972
5948,0.595,7,6,7,668480,7964,110542,15714,0.06307819034342922,0.6636540248331785
5949,0.5951,8,6,8,668486,7958,110550,15706,0.06303066784944873,0.663708586883029
5950,0.5952,7,3,7,668489,7955,110557,15699,0.0630069066024585,0.6636932442715819
5951,0.5953,7,5,7,668494,7950,110564,15692,0.06296730452414143,0.6637340326537517
5952,0.5954,8,9,8,668503,7941,110572,15684,0.0628960207831707,0.6638730158730158
5953,0.5955,6,7,6,668510,7934,110578,15678,0.0628405778735268,0.6639844147043876
5954,0.5956,9,8,9,668518,7926,110587,15669,0.0627772145482195,0.6640813731722822
5955,0.5957,6,6,6,668524,7920,110593,15663,0.062729692054239,0.6641648645210533
5956,0.5958,12,7,12,668531,7913,110605,15651,0.06267424914459511,0.6641911390256323
5957,0.5959,9,7,9,668538,7906,110614,15642,0.06261880623495121,0.6642602344148123
5958,0.596,5,11,5,668549,7895,110619,15637,0.06253168166265366,0.6644994050654428
5959,0.5961,8,9,8,668558,7886,110627,15629,0.06246039792168293,0.6646395917499468
5960,0.5962,2,6,2,668564,7880,110629,15627,0.06241287542770244,0.6647807036201983
5961,0.5963,6,5,6,668569,7875,110635,15621,0.062373273349385375,0.6648365679264555
5962,0.5964,8,6,8,668575,7869,110643,15613,0.06232575085540489,0.6648922578996679
5963,0.5965,2,3,2,668578,7866,110645,15611,0.06230198960841465,0.664948673169485
5964,0.5966,9,6,9,668584,7860,110654,15602,0.062254467114434164,0.6649901969141591
5965,0.5967,5,6,5,668590,7854,110659,15597,0.06220694462045368,0.6650889087885378
5966,0.5968,9,4,9,668594,7850,110668,15588,0.06217526295780003,0.6650738117586825
5967,0.5969,6,6,6,668600,7844,110674,15582,0.06212774046381954,0.665158371040724
5968,0.597,7,3,7,668603,7841,110681,15575,0.0621039792168293,0.6651434916296549
5969,0.5971,5,6,5,668609,7835,110686,15570,0.06205645672284882,0.6652424695577868
5970,0.5972,3,8,3,668617,7827,110689,15567,0.061993093397541506,0.6654270325724545
5971,0.5973,13,5,13,668622,7822,110702,15554,0.06195349131922443,0.6653832991101984
5972,0.5974,12,6,12,668628,7816,110714,15542,0.06190596882524395,0.6653823101292919
5973,0.5975,8,9,8,668637,7807,110722,15534,0.06183468508427322,0.6655241849106722
5974,0.5976,9,4,9,668641,7803,110731,15525,0.06180300342161957,0.6655092592592593
5975,0.5977,7,4,7,668645,7799,110738,15518,0.06177132175896591,0.6655230089634172
5976,0.5978,5,4,5,668649,7795,110743,15513,0.061739640096312255,0.66556547108289
5977,0.5979,8,5,8,668654,7790,110751,15505,0.06170003801799519,0.6655934749946341
5978,0.598,6,7,6,668661,7783,110757,15499,0.06164459510835129,0.6657074134524525
5979,0.5981,7,9,7,668670,7774,110764,15492,0.06157331136738056,0.6658643514140806
5980,0.5982,4,0,4,668670,7774,110768,15488,0.06157331136738056,0.6658068953658327
5981,0.5983,6,11,6,668681,7763,110774,15482,0.061486186795083005,0.6660357066035707
5982,0.5984,10,6,10,668687,7757,110784,15472,0.06143866430110252,0.6660639717594387
5983,0.5985,5,8,5,668695,7749,110789,15467,0.06137530097579521,0.6662215713301172
5984,0.5986,4,5,4,668700,7744,110793,15463,0.06133569889747814,0.6663075796096005
5985,0.5987,7,6,7,668706,7738,110800,15456,0.06128817640349766,0.6663792360093127
5986,0.5988,7,7,7,668713,7731,110807,15449,0.061232733493853754,0.6664797238999137
5987,0.5989,8,9,8,668722,7722,110815,15441,0.06116144975288303,0.6666234943660148
5988,0.599,10,5,10,668727,7717,110825,15431,0.06112184767456596,0.6666234663901849
5989,0.5991,6,9,6,668736,7708,110831,15425,0.06105056393359524,0.6667963515324429
5990,0.5992,4,5,4,668741,7703,110835,15421,0.06101096185527816,0.6668828922331776
5991,0.5993,7,5,7,668746,7698,110842,15414,0.060971359776961095,0.6669262720664589
5992,0.5994,4,8,4,668754,7690,110846,15410,0.06090799645165378,0.6670995670995671
5993,0.5995,8,2,8,668756,7688,110854,15402,0.06089215562032695,0.6670420095279341
5994,0.5996,10,4,10,668760,7684,110864,15392,0.0608604739576733,0.6670133472005547
5995,0.5997,7,10,7,668770,7674,110871,15385,0.06078126980103916,0.6672015265189297
5996,0.5998,5,3,5,668773,7671,110876,15380,0.06075750855404892,0.6672161728341504
5997,0.5999,5,6,5,668779,7665,110881,15375,0.06070998606006843,0.6673177083333334
5998,0.6,6,8,6,668787,7657,110887,15369,0.06064662273476112,0.6674628680621906
5999,0.6001,8,4,8,668791,7653,110895,15361,0.060614941072107464,0.6674632832189102
6000,0.6002,14,4,14,668795,7649,110909,15347,0.06058325940945381,0.6673769351191512
6001,0.6003,7,6,7,668801,7643,110916,15340,0.06053573691547332,0.6674498542400905
6002,0.6004,4,9,4,668810,7634,110920,15336,0.0604644531745026,0.6676534610361341
6003,0.6005,10,10,10,668820,7624,110930,15326,0.06038524901786846,0.6677995642701525
6004,0.6006,6,8,6,668828,7616,110936,15320,0.060321885692561146,0.6679455877223579
6005,0.6007,3,5,3,668833,7611,110939,15317,0.06028228361424408,0.6680478018143754
6006,0.6008,4,4,4,668837,7607,110943,15313,0.06025060195159042,0.6681064572425829
6007,0.6009,7,5,7,668842,7602,110950,15306,0.06021099987327335,0.6681508643268728
6008,0.601,8,6,8,668848,7596,110958,15298,0.06016347737929287,0.6682100113566873
6009,0.6011,6,3,6,668851,7593,110964,15292,0.06013971613230262,0.668210618308936
6010,0.6012,7,5,7,668856,7588,110971,15285,0.060100114053985555,0.6682551479910812
6011,0.6013,7,4,7,668860,7584,110978,15278,0.060068432391331895,0.6682704925203394
6012,0.6014,8,7,8,668867,7577,110986,15270,0.060012989481688,0.6683590843436775
6013,0.6015,1,13,1,668880,7564,110987,15269,0.05991002407806362,0.6687250908772391
6014,0.6016,7,7,7,668887,7557,110994,15262,0.05985458116841972,0.6688286077391647
6015,0.6017,7,3,7,668890,7554,111001,15255,0.059830819921429475,0.6688149414704722
6016,0.6018,9,7,9,668897,7547,111010,15246,0.05977537701178558,0.668889571359628
6017,0.6019,5,4,5,668901,7543,111015,15241,0.059743695349131924,0.6689343398876404
6018,0.602,11,5,11,668906,7538,111026,15230,0.05970409327081485,0.6689212930428672
6019,0.6021,10,10,10,668916,7528,111036,15220,0.059624889114180714,0.6690698083347987
6020,0.6022,4,3,4,668919,7525,111040,15216,0.05960112786719047,0.6690998636823359
6021,0.6023,9,8,9,668927,7517,111049,15207,0.059537764541883156,0.6692043654286217
6022,0.6024,8,4,8,668931,7513,111057,15199,0.059506082879229504,0.6692057062345896
6023,0.6025,8,8,8,668939,7505,111065,15191,0.05944271955392219,0.6693249911878745
6024,0.6026,12,7,12,668946,7498,111077,15179,0.05938727664427829,0.6693566168364422
6025,0.6027,7,11,7,668957,7487,111084,15172,0.059300152071980736,0.6695794165673684
6026,0.6028,5,8,5,668965,7479,111089,15167,0.05923678874667342,0.669743000971474
6027,0.6029,8,7,8,668972,7472,111097,15159,0.059181345837029525,0.6698334143431576
6028,0.603,12,7,12,668979,7465,111109,15147,0.05912590292738563,0.6698655581107377
6029,0.6031,8,8,8,668987,7457,111117,15139,0.059062539602078315,0.6699858382014516
6030,0.6032,6,5,6,668992,7452,111123,15133,0.05902293752376125,0.670046491033872
6031,0.6033,4,8,4,669000,7444,111127,15129,0.058959574198453935,0.6702254906303992
6032,0.6034,5,3,5,669003,7441,111132,15124,0.05893581295146369,0.6702415244848217
6033,0.6035,9,7,9,669010,7434,111141,15115,0.05888037004181979,0.6703179741895428
6034,0.6036,8,5,8,669015,7429,111149,15107,0.058840767963502724,0.6703496627618033
6035,0.6037,9,3,9,669018,7426,111158,15098,0.05881700671651248,0.6703072278458533
6036,0.6038,12,7,12,669025,7419,111170,15086,0.05876156380686858,0.6703399244612308
6037,0.6039,8,4,8,669029,7415,111178,15078,0.05872988214421493,0.670341884141733
6038,0.604,5,5,5,669034,7410,111183,15073,0.05869028006589786,0.6704176488902727
6039,0.6041,8,3,8,669037,7407,111191,15065,0.058666518818907616,0.6703898184407262
6040,0.6042,2,5,2,669042,7402,111193,15063,0.05862691674059055,0.6705096817271311
6041,0.6043,5,2,5,669044,7400,111198,15058,0.05861107590926372,0.6704960370469321
6042,0.6044,8,3,8,669047,7397,111206,15050,0.058587314662273474,0.6704682140152359
6043,0.6045,9,4,9,669051,7393,111215,15041,0.05855563299961982,0.6704555585272355
6044,0.6046,16,7,16,669058,7386,111231,15025,0.05850019008997592,0.6704296997010397
6045,0.6047,4,7,4,669065,7379,111235,15021,0.058444747180332025,0.6705803571428571
6046,0.6048,9,3,9,669068,7376,111244,15012,0.05842098593334178,0.6705377881007683
6047,0.6049,8,6,8,669074,7370,111252,15004,0.0583734634393613,0.6705998033431662
6048,0.605,10,8,10,669082,7362,111262,14994,0.058310100114053985,0.6706924315619968
6049,0.6051,6,5,6,669087,7357,111268,14988,0.05827049803573692,0.6707540836876259
6050,0.6052,5,11,5,669098,7346,111273,14983,0.05818337346343936,0.6710107931389673
6051,0.6053,1,5,1,669103,7341,111274,14982,0.05814377138512229,0.6711463512968687
6052,0.6054,12,6,12,669109,7335,111286,14970,0.05809624889114181,0.6711499663752521
6053,0.6055,7,7,7,669116,7328,111293,14963,0.05804080598149791,0.6712574581669732
6054,0.6056,5,2,5,669118,7326,111298,14958,0.05802496515017108,0.6712439418416801
6055,0.6057,6,3,6,669121,7323,111304,14952,0.05800120390318084,0.6712457912457912
6056,0.6058,8,8,8,669129,7315,111312,14944,0.057937840577873524,0.6713688844961588
6057,0.6059,2,6,2,669135,7309,111314,14942,0.05789031808389304,0.6715203811064672
6058,0.606,4,6,4,669141,7303,111318,14938,0.05784279558991256,0.6716424621195091
6059,0.6061,9,10,9,669151,7293,111327,14929,0.057763591433278416,0.6718117181171812
6060,0.6062,10,5,10,669156,7288,111337,14919,0.05772398935496135,0.6718151934074841
6061,0.6063,4,7,4,669163,7281,111341,14915,0.05766854644531745,0.6719679221481348
6062,0.6064,6,6,6,669169,7275,111347,14909,0.05762102395133697,0.6720609448250991
6063,0.6065,6,7,6,669176,7268,111353,14903,0.05756558104169307,0.6721843850074422
6064,0.6066,8,6,8,669182,7262,111361,14895,0.05751805854771258,0.6722480480209415
6065,0.6067,4,4,4,669186,7258,111365,14891,0.05748637688505893,0.6723102623143257
6066,0.6068,11,5,11,669191,7253,111376,14880,0.05744677480674186,0.672299281615687
6067,0.6069,11,5,11,669196,7248,111387,14869,0.057407172728424785,0.6722882850296152
6068,0.607,10,5,10,669201,7243,111397,14859,0.05736757065010772,0.6722921002624197
6069,0.6071,8,4,8,669205,7239,111405,14851,0.057335888987454064,0.6722951561792666
6070,0.6072,6,9,6,669214,7230,111411,14845,0.05726460524648334,0.672480181200453
6071,0.6073,5,4,5,669218,7226,111416,14840,0.05723292358382968,0.6725278709326565
6072,0.6074,6,3,6,669221,7223,111422,14834,0.05720916233683944,0.6725302625017001
6073,0.6075,2,4,2,669225,7219,111424,14832,0.05717748067418578,0.6726225568001452
6074,0.6076,8,1,8,669226,7218,111432,14824,0.057169560258522364,0.6725342527901279
6075,0.6077,3,7,3,669233,7211,111435,14821,0.05711411734887847,0.6727033405954974
6076,0.6078,4,4,4,669237,7207,111439,14817,0.057082435686224814,0.6727660733745006
6077,0.6079,11,4,11,669241,7203,111450,14806,0.057050754023571154,0.6727247944022899
6078,0.608,11,6,11,669247,7197,111461,14795,0.05700323152959067,0.6727446344125136
6079,0.6081,5,7,5,669254,7190,111466,14790,0.056947788619946774,0.672884440400364
6080,0.6082,4,5,4,669259,7185,111470,14786,0.056908186541629706,0.6729780164762642
6081,0.6083,7,5,7,669264,7180,111477,14779,0.05686858446331264,0.6730270048727174
6082,0.6084,7,9,7,669273,7171,111484,14772,0.05679730072234191,0.6731987421956889
6083,0.6085,3,5,3,669278,7166,111487,14769,0.056757698644024836,0.6733074994301345
6084,0.6086,10,4,10,669282,7162,111497,14759,0.05672601698137118,0.6732813284065507
6085,0.6087,7,6,7,669288,7156,111504,14752,0.0566784944873907,0.6733613291948147
6086,0.6088,3,6,3,669294,7150,111507,14749,0.05663097199341022,0.6735010731083612
6087,0.6089,10,2,10,669296,7148,111517,14739,0.05661513116208339,0.6734134417690867
6088,0.609,3,5,3,669301,7143,111520,14736,0.05657552908376631,0.673522555875497
6089,0.6091,10,4,10,669305,7139,111530,14726,0.05654384742111266,0.6734964555225246
6090,0.6092,4,3,4,669308,7136,111534,14722,0.056520086174122415,0.6735291426480007
6091,0.6093,6,1,6,669309,7135,111540,14716,0.05651216575845901,0.6734703217244062
6092,0.6094,7,4,7,669313,7131,111547,14709,0.05648048409580535,0.673489010989011
6093,0.6095,8,3,8,669316,7128,111555,14701,0.0564567228488151,0.6734619084703835
6094,0.6096,10,10,10,669326,7118,111565,14691,0.05637751869218097,0.6736209821633271
6095,0.6097,6,5,6,669331,7113,111571,14685,0.0563379166138639,0.6736856592347922
6096,0.6098,9,6,9,669337,7107,111580,14676,0.05629039411988341,0.6737363999449112
6097,0.6099,7,3,7,669340,7104,111587,14669,0.05626663287289317,0.6737243374822027
6098,0.61,8,8,8,669348,7096,111595,14661,0.05620326954758586,0.673852093579078
6099,0.6101,6,6,6,669354,7090,111601,14655,0.056155747053605376,0.6739480340308117
6100,0.6102,7,2,7,669356,7088,111608,14648,0.056139906222278546,0.6739050423260949
6101,0.6103,7,3,7,669359,7085,111615,14641,0.0561161449752883,0.6738930313909601
6102,0.6104,7,6,7,669365,7079,111622,14634,0.05606862248130782,0.6739741168885
6103,0.6105,4,7,4,669372,7072,111626,14630,0.05601317957166392,0.6741314164593125
6104,0.6106,2,1,2,669373,7071,111628,14628,0.056005259156000506,0.6741324484999309
6105,0.6107,6,1,6,669374,7070,111634,14622,0.05599733874033709,0.6740733911119307
6106,0.6108,7,1,7,669375,7069,111641,14615,0.055989418324673676,0.6739992621287585
6107,0.6109,5,7,5,669382,7062,111646,14610,0.05593397541502978,0.6741417497231451
6108,0.611,7,4,7,669386,7058,111653,14603,0.055902293752376125,0.6741609343982272
6109,0.6111,10,7,10,669393,7051,111663,14593,0.05584685084273223,0.6742284235815931
6110,0.6112,2,5,2,669398,7046,111665,14591,0.05580724876441516,0.6743541156352544
6111,0.6113,7,6,7,669404,7040,111672,14584,0.05575972627043467,0.6744358120606734
6112,0.6114,11,7,11,669411,7033,111683,14573,0.05570428336079077,0.674488567990373
6113,0.6115,11,7,11,669418,7026,111694,14562,0.055648840451146875,0.6745414118954975
6114,0.6116,6,3,6,669421,7023,111700,14556,0.05562507920415664,0.6745446962324482
6115,0.6117,2,5,2,669426,7018,111702,14554,0.05558547712583956,0.6746708696458372
6116,0.6118,9,6,9,669432,7012,111711,14545,0.05553795463185908,0.6747228278517419
6117,0.6119,8,8,8,669440,7004,111719,14537,0.05547459130655177,0.6748526066570726
6118,0.612,10,7,10,669447,6997,111729,14527,0.05541914839690787,0.6749210183980673
6119,0.6121,6,3,6,669450,6994,111735,14521,0.055395387149917624,0.6749244712990936
6120,0.6122,7,6,7,669456,6988,111742,14514,0.05534786465593714,0.675006976095247
6121,0.6123,6,4,6,669460,6984,111748,14508,0.05531618299328349,0.6750418760469011
6122,0.6124,6,7,6,669467,6977,111754,14502,0.05526074008363959,0.6751710973509009
6123,0.6125,8,7,8,669474,6970,111762,14494,0.05520529717399569,0.6752702199030935
6124,0.6126,16,3,16,669477,6967,111778,14478,0.05518153592700545,0.675122406155281
6125,0.6127,8,4,8,669481,6963,111786,14470,0.055149854264351796,0.6751271403909859
6126,0.6128,8,5,8,669486,6958,111794,14462,0.05511025218603472,0.6751633986928105
6127,0.6129,4,5,4,669491,6953,111798,14458,0.05507065010771765,0.6752603801784129
6128,0.613,6,7,6,669498,6946,111804,14452,0.055015207198073755,0.6753902233853631
6129,0.6131,4,5,4,669503,6941,111808,14448,0.05497560511975669,0.6754874000654542
6130,0.6132,7,5,7,669508,6936,111815,14441,0.05493600304143961,0.6755391308415587
6131,0.6133,4,6,4,669514,6930,111819,14437,0.05488848054745913,0.6756680863013057
6132,0.6134,9,1,9,669515,6929,111828,14428,0.054880560131795715,0.6755630472444631
6133,0.6135,6,3,6,669518,6926,111834,14422,0.05485679888480548,0.6755667978264943
6134,0.6136,3,4,3,669522,6922,111837,14419,0.05482511722215182,0.6756478140668197
6135,0.6137,6,6,6,669528,6916,111843,14413,0.054777594728171335,0.6757466360354447
6136,0.6138,5,4,5,669532,6912,111848,14408,0.05474591306551768,0.675797373358349
6137,0.6139,4,6,4,669538,6906,111852,14404,0.05469839057153719,0.6759267949319568
6138,0.614,6,5,6,669543,6901,111858,14398,0.054658788493220124,0.6759941781304286
6139,0.6141,12,4,12,669547,6897,111870,14386,0.05462710683056647,0.6759385424987079
6140,0.6142,8,4,8,669551,6893,111878,14378,0.05459542516791281,0.6759437732123549
6141,0.6143,8,5,8,669556,6888,111886,14370,0.054555823089595744,0.6759808072255151
6142,0.6144,5,6,5,669562,6882,111891,14365,0.05450830059561526,0.676095448769238
6143,0.6145,5,7,5,669569,6875,111896,14360,0.054452857685971356,0.6762420532140334
6144,0.6146,7,4,7,669573,6871,111903,14353,0.054421176023317704,0.6762627214474181
6145,0.6147,10,5,10,669578,6866,111913,14343,0.054381573945000636,0.6762695082276392
6146,0.6148,5,6,5,669584,6860,111918,14338,0.054334051451020146,0.6763845645815643
6147,0.6149,4,4,4,669588,6856,111922,14334,0.05430236978836649,0.6764511562057575
6148,0.615,4,4,4,669592,6852,111926,14330,0.05427068812571284,0.6765177981304882
6149,0.6151,7,7,7,669599,6845,111933,14323,0.05421524521606894,0.6766345427059712
6150,0.6152,7,3,7,669602,6842,111940,14316,0.0541914839690787,0.6766234993855752
6151,0.6153,4,6,4,669608,6836,111944,14312,0.054143961475098215,0.6767543030073766
6152,0.6154,6,9,6,669617,6827,111950,14306,0.05407267773412749,0.6769507405479581
6153,0.6155,13,8,13,669625,6819,111963,14293,0.054009314408820175,0.6770083364910952
6154,0.6156,7,2,7,669627,6817,111970,14286,0.053993473577493345,0.6769653603753021
6155,0.6157,2,6,2,669633,6811,111972,14284,0.05394595108351286,0.6771272813462906
6156,0.6158,6,2,6,669635,6809,111978,14278,0.05393011025218603,0.6770996348461137
6157,0.6159,7,6,7,669641,6803,111985,14271,0.05388258775820555,0.6771851570655785
6158,0.616,7,5,7,669646,6798,111992,14264,0.05384298567988848,0.6772386288101795
6159,0.6161,7,7,7,669653,6791,111999,14257,0.053787542770244584,0.6773565184340555
6160,0.6162,8,5,8,669658,6786,112007,14249,0.05374794069192751,0.6773948181602092
6161,0.6163,6,8,6,669666,6778,112013,14243,0.053684577366620204,0.6775605347033918
6162,0.6164,9,2,9,669668,6776,112022,14234,0.053668736535293374,0.6774869109947644
6163,0.6165,9,5,9,669673,6771,112031,14225,0.0536291344569763,0.6775100019051248
6164,0.6166,11,6,11,669679,6765,112042,14214,0.053581611962995816,0.6775346775346776
6165,0.6167,8,4,8,669683,6761,112050,14206,0.05354993030034216,0.677540897600992
6166,0.6168,9,6,9,669689,6755,112059,14197,0.05350240780636168,0.6775964108438335
6167,0.6169,10,3,10,669692,6752,112069,14187,0.053478646559371436,0.6775395195568079
6168,0.617,6,5,6,669697,6747,112075,14181,0.05343904448105437,0.6776089449541285
6169,0.6171,6,6,6,669703,6741,112081,14175,0.05339152198707388,0.677710843373494
6170,0.6172,5,10,5,669713,6731,112086,14170,0.05331231783043974,0.6779579924405531
6171,0.6173,4,6,4,669719,6725,112090,14166,0.05326479533645926,0.678091043990235
6172,0.6174,5,5,5,669724,6720,112095,14161,0.053225193258142185,0.6781763325511231
6173,0.6175,8,4,8,669728,6716,112103,14153,0.05319351159548853,0.6781829507882505
6174,0.6176,5,5,5,669733,6711,112108,14148,0.053153909517171465,0.6782683733640156
6175,0.6177,9,4,9,669737,6707,112117,14139,0.053122227854517805,0.6782596181521635
6176,0.6178,7,5,7,669742,6702,112124,14132,0.05308262577620074,0.6783142939425938
6177,0.6179,6,3,6,669745,6699,112130,14126,0.05305886452921049,0.6783193277310925
6178,0.618,6,6,6,669751,6693,112136,14120,0.05301134203523001,0.6784221400086484
6179,0.6181,9,3,9,669754,6690,112145,14111,0.052987580788239765,0.6783808470746598
6180,0.6182,6,5,6,669759,6685,112151,14105,0.0529479787099227,0.6784511784511784
6181,0.6183,6,8,6,669767,6677,112157,14099,0.052884615384615384,0.67861956103196
6182,0.6184,3,6,3,669773,6671,112160,14096,0.0528370928906349,0.6787692011364184
6183,0.6185,4,6,4,669779,6665,112164,14092,0.05278957039665442,0.6789035024329142
6184,0.6186,7,3,7,669782,6662,112171,14085,0.052765809149664174,0.6788933339759965
6185,0.6187,7,7,7,669789,6655,112178,14078,0.052710366240020276,0.6790141320600009
6186,0.6188,9,3,9,669792,6652,112187,14069,0.05268660499303003,0.6789730225375223
6187,0.6189,8,4,8,669796,6648,112195,14061,0.05265492333037638,0.6789801535564247
6188,0.619,7,8,7,669804,6640,112202,14054,0.052591560005069066,0.6791340485164782
6189,0.6191,5,8,5,669812,6632,112207,14049,0.05252819667976175,0.6793191818577439
6190,0.6192,8,3,8,669815,6629,112215,14041,0.052504435432771515,0.6792936623125302
6191,0.6193,10,9,10,669824,6620,112225,14031,0.05243315169180079,0.6794344099559343
6192,0.6194,5,7,5,669831,6613,112230,14026,0.05237770878215689,0.6795871893018073
6193,0.6195,6,6,6,669837,6607,112236,14020,0.0523301862881764,0.6796916662626654
6194,0.6196,7,5,7,669842,6602,112243,14013,0.05229058420985933,0.6797477564879941
6195,0.6197,9,7,9,669849,6595,112252,14004,0.052235141300215435,0.6798388271275304
6196,0.6198,4,6,4,669855,6589,112256,14000,0.05218761880623495,0.6799747437952305
6197,0.6199,7,6,7,669861,6583,112263,13993,0.05214009631225447,0.6800641524105754
6198,0.62,3,3,3,669864,6580,112266,13990,0.052116335065264224,0.6801166747690812
6199,0.6201,7,3,7,669867,6577,112273,13983,0.052092573818273986,0.6801070038910506
6200,0.6202,7,6,7,669873,6571,112280,13976,0.0520450513242935,0.6801966223779627
6201,0.6203,6,2,6,669875,6569,112286,13970,0.052029210492966674,0.6801694337601636
6202,0.6204,3,8,3,669883,6561,112289,13967,0.05196584716765936,0.6803877630553391
6203,0.6205,5,4,5,669887,6557,112294,13962,0.0519341655050057,0.6804425166918466
6204,0.6206,9,1,9,669888,6556,112303,13953,0.051926245089342286,0.6803354624798869
6205,0.6207,7,2,7,669890,6554,112310,13946,0.05191040425801546,0.6802926829268293
6206,0.6208,6,5,6,669895,6549,112316,13940,0.05187080217969839,0.6803650739421153
6207,0.6209,8,4,8,669899,6545,112324,13932,0.051839120517044736,0.6803731015285442
6208,0.621,4,4,4,669903,6541,112328,13928,0.051807438854391076,0.6804435976354487
6209,0.6211,12,3,12,669906,6538,112340,13916,0.05178367760740084,0.6803559206023272
6210,0.6212,9,3,9,669909,6535,112349,13907,0.05175991636041059,0.6803150376675472
6211,0.6213,7,3,7,669912,6532,112356,13900,0.051736155113420355,0.6803054032889585
6212,0.6214,15,3,15,669915,6529,112371,13885,0.05171239386643011,0.6801704712452239
6213,0.6215,6,12,6,669927,6517,112377,13879,0.051617348878469145,0.6804765640321632
6214,0.6216,4,4,4,669931,6513,112381,13875,0.051585667215815485,0.6805473808122425
6215,0.6217,7,6,7,669937,6507,112388,13868,0.051538144721835,0.6806380368098159
6216,0.6218,6,2,6,669939,6505,112394,13862,0.05152230389050817,0.6806107919673983
6217,0.6219,7,7,7,669946,6498,112401,13855,0.051466860980864275,0.6807350267773793
6218,0.622,5,3,5,669949,6495,112406,13850,0.05144309973387404,0.6807569427377734
6219,0.6221,11,4,11,669953,6491,112417,13839,0.05141141807122038,0.6807181505164781
6220,0.6222,8,5,8,669958,6486,112425,13831,0.05137181599290331,0.6807599547177241
6221,0.6223,3,7,3,669965,6479,112428,13828,0.05131637308325941,0.6809474565420791
6222,0.6224,11,6,11,669971,6473,112439,13817,0.05126885058927892,0.6809758501724987
6223,0.6225,7,6,7,669977,6467,112446,13810,0.05122132809529844,0.6810672190166198
6224,0.6226,8,3,8,669980,6464,112454,13802,0.0511975668483082,0.6810421395440639
6225,0.6227,5,0,5,669980,6464,112459,13797,0.0511975668483082,0.6809634272740733
6226,0.6228,7,4,7,669984,6460,112466,13790,0.05116588518565454,0.6809876543209876
6227,0.6229,6,5,6,669989,6455,112472,13784,0.051126283107337474,0.6810613172587578
6228,0.623,4,4,4,669993,6451,112476,13780,0.051094601444683814,0.6811329148336711
6229,0.6231,4,6,4,669999,6445,112480,13776,0.05104707895070333,0.6812719450076653
6230,0.6232,9,7,9,670006,6438,112489,13767,0.050991636041059434,0.681365998515219
6231,0.6233,4,1,4,670007,6437,112493,13763,0.05098371562539602,0.6813366336633664
6232,0.6234,11,5,11,670012,6432,112504,13752,0.05094411354707895,0.6813317479191439
6233,0.6235,4,3,4,670015,6429,112508,13748,0.050920352300088706,0.6813698765921594
6234,0.6236,7,3,7,670018,6426,112515,13741,0.05089659105309847,0.6813606386671295
6235,0.6237,5,2,5,670020,6424,112520,13736,0.05088075022177164,0.6813492063492064
6236,0.6238,10,3,10,670023,6421,112530,13726,0.05085698897478139,0.6812925001240879
6237,0.6239,6,3,6,670026,6418,112536,13720,0.050833227727791155,0.6812990366471348
6238,0.624,7,6,7,670032,6412,112543,13713,0.05078570523381067,0.6813913043478261
6239,0.6241,6,3,6,670035,6409,112549,13707,0.05076194398682043,0.6813978922250945
6240,0.6242,9,5,9,670040,6404,112558,13698,0.05072234190850336,0.6814247338573276
6241,0.6243,2,3,2,670043,6401,112560,13696,0.050698580661513115,0.6814947504602678
6242,0.6244,8,4,8,670047,6397,112568,13688,0.05066689899885946,0.6815036096589495
6243,0.6245,3,4,3,670051,6393,112571,13685,0.0506352173362058,0.6815917920111565
6244,0.6246,9,7,9,670058,6386,112580,13676,0.050579774426561905,0.6816867710098694
6245,0.6247,10,3,10,670061,6383,112590,13666,0.05055601317957167,0.6816300064841139
6246,0.6248,4,3,4,670064,6380,112594,13662,0.05053225193258142,0.681668496158068
6247,0.6249,7,4,7,670068,6376,112601,13655,0.05050057026992777,0.6816933752683341
6248,0.625,9,11,9,670079,6365,112610,13646,0.05041344569763021,0.6819249412822947
6249,0.6251,7,6,7,670085,6359,112617,13639,0.05036592320364973,0.682018201820182
6250,0.6252,5,7,5,670092,6352,112622,13634,0.05031048029400583,0.6821775242669869
6251,0.6253,8,4,8,670096,6348,112630,13626,0.05027879863135217,0.6821868428957645
6252,0.6254,11,5,11,670101,6343,112641,13615,0.050239196553035104,0.6821825834251929
6253,0.6255,7,8,7,670109,6335,112648,13608,0.05017583322772779,0.6823446823446824
6254,0.6256,10,2,10,670111,6333,112658,13598,0.05015999239640096,0.6822537755255632
6255,0.6257,8,3,8,670114,6330,112666,13590,0.05013623114941072,0.6822289156626506
6256,0.6258,7,4,7,670118,6326,112673,13583,0.05010454948675706,0.6822542568687529
6257,0.6259,3,3,3,670121,6323,112676,13580,0.050080788239766826,0.6823091996181481
6258,0.626,8,5,8,670126,6318,112684,13572,0.05004118616144975,0.6823529411764706
6259,0.6261,3,7,3,670133,6311,112687,13569,0.04998574325180585,0.6825452716297786
6260,0.6262,5,5,5,670138,6306,112692,13564,0.049946141173488785,0.6826371414192249
6261,0.6263,8,5,8,670143,6301,112700,13556,0.04990653909517172,0.6826811703681321
6262,0.6264,3,5,3,670148,6296,112703,13553,0.04986693701685464,0.6828051791022218
6263,0.6265,6,4,6,670152,6292,112709,13547,0.04983525535420099,0.6828469176873835
6264,0.6266,6,6,6,670158,6286,112715,13541,0.04978773286022051,0.682957583093761
6265,0.6267,5,3,5,670161,6283,112720,13536,0.04976397161323026,0.6829809778495384
6266,0.6268,7,4,7,670165,6279,112727,13529,0.04973228995057661,0.6830068659127625
6267,0.6269,7,3,7,670168,6276,112734,13522,0.049708528703586365,0.6829982826548137
6268,0.627,3,5,3,670173,6271,112737,13519,0.0496689266252693,0.6831227892875189
6269,0.6271,7,7,7,670180,6264,112744,13512,0.0496134837156254,0.683252427184466
6270,0.6272,6,6,6,670186,6258,112750,13506,0.04956596122164491,0.6833636915604129
6271,0.6273,9,5,9,670191,6253,112759,13497,0.04952635914332784,0.6833924050632911
6272,0.6274,13,12,13,670203,6241,112772,13484,0.049431314155366876,0.6835994930291508
6273,0.6275,7,3,7,670206,6238,112779,13477,0.04940755290837663,0.6835911742328177
6274,0.6276,8,4,8,670210,6234,112787,13469,0.04937587124572298,0.6836014820078161
6275,0.6277,13,3,13,670213,6231,112800,13456,0.049352109998732734,0.6834967237263169
6276,0.6278,2,6,2,670219,6225,112802,13454,0.04930458750475225,0.6836729508613243
6277,0.6279,7,4,7,670223,6221,112809,13447,0.04927290584209859,0.6836994102094773
6278,0.628,1,1,1,670224,6220,112810,13446,0.049264985426435176,0.6837180921387166
6279,0.6281,10,8,10,670232,6212,112820,13436,0.04920162210112787,0.6838355048859935
6280,0.6282,4,3,4,670235,6209,112824,13432,0.049177860854137626,0.6838755664171885
6281,0.6283,3,6,3,670241,6203,112827,13429,0.04913033836015714,0.6840362673186634
6282,0.6284,3,1,3,670242,6202,112830,13426,0.04912241794449373,0.6840228245363766
6283,0.6285,6,3,6,670245,6199,112836,13420,0.04909865669750348,0.6840307864824915
6284,0.6286,2,4,2,670249,6195,112838,13418,0.04906697503484983,0.6841380716871462
6285,0.6287,6,3,6,670252,6192,112844,13412,0.049043213787859585,0.6841460926341563
6286,0.6288,11,6,11,670258,6186,112855,13401,0.0489956912938791,0.6841782815132486
6287,0.6289,7,1,7,670259,6185,112862,13394,0.04898777087821569,0.6841003115583023
6288,0.629,7,10,7,670269,6175,112869,13387,0.04890856672158155,0.6843369798589102
6289,0.6291,6,2,6,670271,6173,112875,13381,0.04889272589025472,0.6843101155773754
6290,0.6292,8,3,8,670274,6170,112883,13373,0.04886896464326448,0.6842859335823569
6291,0.6293,5,2,5,670276,6168,112888,13368,0.04885312381193765,0.6842751842751843
6292,0.6294,4,5,4,670281,6163,112892,13364,0.04881352173362058,0.6843857223331797
6293,0.6295,4,6,4,670287,6157,112896,13360,0.0487659992396401,0.6845314341343444
6294,0.6296,3,6,3,670293,6151,112899,13357,0.048718476745659614,0.6846934590937052
6295,0.6297,11,5,11,670298,6146,112910,13346,0.04867887466734254,0.6846911553457828
6296,0.6298,7,2,7,670300,6144,112917,13339,0.048663033836015716,0.6846481548016219
6297,0.6299,6,4,6,670304,6140,112923,13333,0.04863135217336206,0.6846916243003133
6298,0.63,7,7,7,670311,6133,112930,13326,0.04857590926371816,0.6848245028007606
6299,0.6301,9,4,9,670315,6129,112939,13317,0.048544227601064506,0.6848195001542734
6300,0.6302,8,2,8,670317,6127,112947,13309,0.048528386769737676,0.6847602387322494
6301,0.6303,5,6,5,670323,6121,112952,13304,0.04848086427575719,0.6848906048906049
6302,0.6304,1,5,1,670328,6116,112953,13303,0.04844126219744012,0.6850507235182038
6303,0.6305,8,6,8,670334,6110,112961,13295,0.048393739703459636,0.6851326977583098
6304,0.6306,7,8,7,670342,6102,112968,13288,0.04833037637815232,0.6853017019082001
6305,0.6307,11,4,11,670346,6098,112979,13277,0.04829869471549867,0.6852645161290323
6306,0.6308,7,3,7,670349,6095,112986,13270,0.048274933468508426,0.6852569067906016
6307,0.6309,8,3,8,670352,6092,112994,13262,0.04825117222151819,0.6852330267644932
6308,0.631,10,2,10,670354,6090,113004,13252,0.04823533139019136,0.6851411436252715
6309,0.6311,5,1,5,670355,6089,113009,13247,0.04822741097452794,0.6850951592883741
6310,0.6312,6,8,6,670363,6081,113015,13241,0.04816404764922063,0.685281026808819
6311,0.6313,11,7,11,670370,6074,113026,13230,0.04810860473957673,0.6853501864898467
6312,0.6314,4,2,4,670372,6072,113030,13226,0.0480927639082499,0.685355995439942
6313,0.6315,6,5,6,670377,6067,113036,13220,0.048053161829932835,0.6854357857624307
6314,0.6316,7,5,7,670382,6062,113043,13213,0.04801355975161577,0.6854993514915694
6315,0.6317,13,2,13,670384,6060,113056,13200,0.04799771892028894,0.6853582554517134
6316,0.6318,10,3,10,670387,6057,113066,13190,0.04797395767329869,0.6853016054450044
6317,0.6319,15,4,15,670391,6053,113081,13175,0.04794227601064504,0.6851986686082796
6318,0.632,12,3,12,670394,6050,113093,13163,0.047918514763654795,0.6851090407536564
6319,0.6321,15,3,15,670397,6047,113108,13148,0.04789475351666456,0.6849700442823652
6320,0.6322,10,1,10,670398,6046,113118,13138,0.04788683310100114,0.6848415346121768
6321,0.6323,5,1,5,670399,6045,113123,13133,0.04787891268533773,0.6847950776931901
6322,0.6324,9,6,9,670405,6039,113132,13124,0.047831390191357244,0.6848614517559881
6323,0.6325,6,10,6,670415,6029,113138,13118,0.0477521860347231,0.6851203843944221
6324,0.6326,10,7,10,670422,6022,113148,13108,0.047696743125079204,0.6852064819654993
6325,0.6327,3,4,3,670426,6018,113151,13105,0.04766506146242555,0.685300423573707
6326,0.6328,6,4,6,670430,6014,113157,13099,0.04763337979977189,0.6853450531052163
6327,0.6329,6,4,6,670434,6010,113163,13093,0.04760169813711824,0.6853897293618804
6328,0.633,10,4,10,670438,6006,113173,13083,0.04757001647446458,0.6853685368536854
6329,0.6331,8,7,8,670445,5999,113181,13075,0.04751457356482068,0.6854880989829086
6330,0.6332,8,5,8,670450,5994,113189,13067,0.04747497148650361,0.6855359110225067
6331,0.6333,9,2,9,670452,5992,113198,13058,0.04745913065517678,0.6854593175853019
6332,0.6334,4,6,4,670458,5986,113202,13054,0.0474116081611963,0.685609243697479
6333,0.6335,3,7,3,670465,5979,113205,13051,0.0473561652515524,0.6858118759852864
6334,0.6336,4,4,4,670469,5975,113209,13047,0.04732448358889874,0.6858900220796972
6335,0.6337,6,3,6,670472,5972,113215,13041,0.047300722341908505,0.6858991216536054
6336,0.6338,6,5,6,670477,5967,113221,13035,0.04726112026359143,0.6859804231133565
6337,0.6339,7,6,7,670483,5961,113228,13028,0.04721359776961095,0.6860814155563747
6338,0.634,6,0,6,670483,5961,113234,13022,0.04721359776961095,0.6859821945951641
6339,0.6341,1,3,1,670486,5958,113235,13021,0.04718983652262071,0.6860740818799727
6340,0.6342,5,5,5,670491,5953,113240,13016,0.047150234444303635,0.6861721756550161
6341,0.6343,8,4,8,670495,5949,113248,13008,0.04711855278164998,0.6861845228675423
6342,0.6344,3,5,3,670500,5944,113251,13005,0.047078950703332914,0.6863159005752283
6343,0.6345,7,3,7,670503,5941,113258,12998,0.04705518945634267,0.6863086752204446
6344,0.6346,9,2,9,670505,5939,113267,12989,0.04703934862501584,0.6862320371935756
6345,0.6347,7,6,7,670511,5933,113274,12982,0.04699182613103536,0.6863335976738039
6346,0.6348,3,6,3,670517,5927,113277,12979,0.046944303637054874,0.6865016396911033
6347,0.6349,5,4,5,670521,5923,113282,12974,0.046912621974401214,0.6865640048684977
6348,0.635,3,4,3,670525,5919,113285,12971,0.04688094031174756,0.6866596082583377
6349,0.6351,5,4,5,670529,5915,113290,12966,0.0468492586490939,0.6867221015836026
6350,0.6352,1,3,1,670532,5912,113291,12965,0.046825497402103664,0.6868146421571224
6351,0.6353,5,2,5,670534,5910,113296,12960,0.046809656570776834,0.6868044515103339
6352,0.6354,8,5,8,670539,5905,113304,12952,0.046770054492459766,0.6868536882855173
6353,0.6355,7,5,7,670544,5900,113311,12945,0.04673045241414269,0.6869196073228974
6354,0.6356,5,4,5,670548,5896,113316,12940,0.04669877075148904,0.6869823741771076
6355,0.6357,3,4,3,670552,5892,113319,12937,0.046667089088835385,0.6870784428275533
6356,0.6358,8,4,8,670556,5888,113327,12929,0.046635407426181726,0.6870914598501355
6357,0.6359,6,2,6,670558,5886,113333,12923,0.046619566594854896,0.6870647030676804
6358,0.636,5,6,5,670564,5880,113338,12918,0.04657204410087441,0.6872007660389403
6359,0.6361,3,2,3,670566,5878,113341,12915,0.04655620326954758,0.6872239663704571
6360,0.6362,5,1,5,670567,5877,113346,12910,0.046548282853884175,0.6871773034545164
6361,0.6363,11,4,11,670571,5873,113357,12899,0.046516601191230515,0.6871404219049648
6362,0.6364,7,7,7,670578,5866,113364,12892,0.04646115828158662,0.687280093826634
6363,0.6365,4,5,4,670583,5861,113368,12888,0.04642155620326955,0.6873966611552617
6364,0.6366,4,4,4,670587,5857,113372,12884,0.04638987454061589,0.6874766554612881
6365,0.6367,7,5,7,670592,5852,113379,12877,0.04635027246229882,0.687543381921085
6366,0.6368,4,8,4,670600,5844,113383,12873,0.04628690913699151,0.6877704760378266
6367,0.6369,5,7,5,670607,5837,113388,12868,0.04623146622734761,0.6879443998930768
6368,0.637,9,2,9,670609,5835,113397,12859,0.04621562539602078,0.6878677650583075
6369,0.6371,7,2,7,670611,5833,113404,12852,0.04619978456469395,0.6878244581214878
6370,0.6372,2,4,2,670615,5829,113406,12850,0.0461681029020403,0.6879383264628728
6371,0.6373,4,6,4,670621,5823,113410,12846,0.046120580408059816,0.6880925598585891
6372,0.6374,4,3,4,670624,5820,113414,12842,0.04609681916106957,0.6881363197942343
6373,0.6375,3,8,3,670632,5812,113417,12839,0.04603345583576226,0.6883813200364591
6374,0.6376,4,2,4,670634,5810,113421,12835,0.046017615004435436,0.6883883078573344
6375,0.6377,7,6,7,670640,5804,113428,12828,0.045970092510454946,0.6884929154143409
6376,0.6378,2,4,2,670644,5800,113430,12826,0.04593841084780129,0.6886073230967464
6377,0.6379,8,5,8,670649,5795,113438,12818,0.045898808769484226,0.6886584645140493
6378,0.638,4,4,4,670653,5791,113442,12814,0.045867127106830566,0.68873958613276
6379,0.6381,2,6,2,670659,5785,113444,12812,0.04581960461285008,0.6889283217723289
6380,0.6382,10,6,10,670665,5779,113454,12802,0.0457720821188696,0.6889833701092514
6381,0.6383,7,4,7,670669,5775,113461,12795,0.04574040045621594,0.6890145395799677
6382,0.6384,6,5,6,670674,5770,113467,12789,0.04570079837789887,0.689099628212727
6383,0.6385,11,2,11,670676,5768,113478,12778,0.04568495754657204,0.6889895395233474
6384,0.6386,7,3,7,670679,5765,113485,12771,0.045661196299581805,0.6889835994820889
6385,0.6387,4,7,4,670686,5758,113489,12767,0.04560575338993791,0.6891767881241565
6386,0.6388,8,5,8,670691,5753,113497,12759,0.04556615131162083,0.6892286084701815
6387,0.6389,8,5,8,670696,5748,113505,12751,0.045526549233303765,0.6892805016487378
6388,0.639,5,3,5,670699,5745,113510,12746,0.04550278798631352,0.6893083121518576
6389,0.6391,9,2,9,670701,5743,113519,12737,0.0454869471549867,0.6892316017316017
6390,0.6392,11,2,11,670703,5741,113530,12726,0.04547110632365987,0.6891211349975632
6391,0.6393,8,7,8,670710,5734,113538,12718,0.04541566341401597,0.689247778018643
6392,0.6394,9,4,9,670714,5730,113547,12709,0.04538398175136231,0.6892456206952655
6393,0.6395,3,3,3,670717,5727,113550,12706,0.04536022050437207,0.6893072207454023
6394,0.6396,9,2,9,670719,5725,113559,12697,0.04534437967304524,0.6892302681576377
6395,0.6397,8,3,8,670722,5722,113567,12689,0.045320618426055,0.6892075389712672
6396,0.6398,6,7,6,670729,5715,113573,12683,0.0452651755164111,0.6893684096097402
6397,0.6399,10,4,10,670733,5711,113583,12673,0.045233493853757446,0.6893494342906875
6398,0.64,3,4,3,670737,5707,113586,12670,0.045201812191103787,0.6894487674810905
6399,0.6401,6,3,6,670740,5704,113592,12664,0.04517805094411355,0.6894599303135889
6400,0.6402,8,6,8,670746,5698,113600,12656,0.045130528450133066,0.6895499618611747
6401,0.6403,4,3,4,670749,5695,113604,12652,0.04510676720314282,0.6895950291600806
6402,0.6404,8,5,8,670754,5690,113612,12644,0.04506716512482575,0.6896476491763935
6403,0.6405,6,7,6,670761,5683,113618,12638,0.045011722215181856,0.6898095082146171
6404,0.6406,6,1,6,670762,5682,113624,12632,0.04500380179951844,0.6897455498525717
6405,0.6407,7,2,7,670764,5680,113631,12625,0.04498796096819161,0.6897022671401256
6406,0.6408,7,4,7,670768,5676,113638,12618,0.04495627930553796,0.6897343391275829
6407,0.6409,8,7,8,670775,5669,113646,12610,0.04490083639589405,0.6898626839542644
6408,0.641,6,3,6,670778,5666,113652,12604,0.044877075148903815,0.6898741105637657
6409,0.6411,8,5,8,670783,5661,113660,12596,0.04483747307058675,0.6899271512296653
6410,0.6412,13,5,13,670788,5656,113673,12583,0.04479787099226967,0.6898952793464554
6411,0.6413,6,5,6,670793,5651,113679,12577,0.044758268913952605,0.6899824445907395
6412,0.6414,7,9,7,670802,5642,113686,12570,0.04468698517298188,0.6902042609268614
6413,0.6415,7,2,7,670804,5640,113693,12563,0.04467114434165505,0.6901609624787123
6414,0.6416,4,3,4,670807,5637,113697,12559,0.04464738309466481,0.6902066388217191
6415,0.6417,5,5,5,670812,5632,113702,12554,0.044607781016347735,0.690311228417464
6416,0.6418,3,5,3,670817,5627,113705,12551,0.04456817893803067,0.6904499944988448
6417,0.6419,9,2,9,670819,5625,113714,12542,0.04455233810670384,0.6903726537127759
6418,0.642,8,3,8,670822,5622,113722,12534,0.0445285768597136,0.6903502974223398
6419,0.6421,10,3,10,670825,5619,113732,12524,0.044504815612723354,0.6902937772143526
6420,0.6422,5,6,5,670831,5613,113737,12519,0.04445729311874287,0.6904367968232958
6421,0.6423,6,9,6,670840,5604,113743,12513,0.044386009377772144,0.6906772644477562
6422,0.6424,2,7,2,670847,5597,113745,12511,0.044330566468128246,0.6909100949856417
6423,0.6425,6,3,6,670850,5594,113751,12505,0.04430680522113801,0.6909221503950495
6424,0.6426,5,6,5,670856,5588,113756,12500,0.04425928272715752,0.6910659000442282
6425,0.6427,9,1,9,670857,5587,113765,12491,0.044251362311494104,0.6909503263635358
6426,0.6428,8,4,8,670861,5583,113773,12483,0.04421968064884045,0.6909664563268018
6427,0.6429,8,1,8,670862,5582,113781,12475,0.044211760233177036,0.6908678074984771
6428,0.643,3,5,3,670867,5577,113784,12472,0.04417215815485997,0.6910078120671506
6429,0.6431,5,7,5,670874,5570,113789,12467,0.04411671524521607,0.6911903309863059
6430,0.6432,8,5,8,670879,5565,113797,12459,0.044077113166898996,0.6912450066577897
6431,0.6433,6,3,6,670882,5562,113803,12453,0.04405335191990876,0.6912572855953372
6432,0.6434,9,3,9,670885,5559,113812,12444,0.04402959067291851,0.6912181303116147
6433,0.6435,5,4,5,670889,5555,113817,12439,0.04399790901026486,0.6912859842169612
6434,0.6436,7,2,7,670891,5553,113824,12432,0.04398206817893803,0.6912427022518766
6435,0.6437,4,7,4,670898,5546,113828,12428,0.04392662526929413,0.6914431957271615
6436,0.6438,6,8,6,670906,5538,113834,12422,0.04386326194398682,0.6916481069042316
6437,0.6439,7,3,7,670909,5535,113841,12415,0.043839500696996575,0.6916434540389972
6438,0.644,11,4,11,670913,5531,113852,12404,0.04380781903434292,0.6916085865625872
6439,0.6441,4,9,4,670922,5522,113856,12400,0.043736535293372195,0.69188706617565
6440,0.6442,4,4,4,670926,5518,113860,12396,0.04370485363071854,0.691972758736184
6441,0.6443,4,6,4,670932,5512,113864,12392,0.04365733113673806,0.6921358355674709
6442,0.6444,10,4,10,670936,5508,113874,12382,0.0436256494740844,0.6921185019564002
6443,0.6445,7,2,7,670938,5506,113881,12375,0.04360980864275757,0.6920753872825904
6444,0.6446,7,4,7,670942,5502,113888,12368,0.043578126980103916,0.6921096810296586
6445,0.6447,7,4,7,670946,5498,113895,12361,0.04354644531745026,0.6921440170222297
6446,0.6448,3,2,3,670948,5496,113898,12358,0.043530604486123434,0.6921698218886524
6447,0.6449,2,3,2,670951,5493,113900,12356,0.04350684323913319,0.6922516667600426
6448,0.645,8,5,8,670956,5488,113908,12348,0.04346724116081612,0.6923076923076923
6449,0.6451,4,11,4,670967,5477,113912,12344,0.043380116588518564,0.6926659558947309
6450,0.6452,12,5,12,670972,5472,113924,12332,0.043340514510201496,0.6926533363289149
6451,0.6453,8,5,8,670977,5467,113932,12324,0.04330091243188443,0.6927097970884155
6452,0.6454,1,5,1,670982,5462,113933,12323,0.04326131035356735,0.692887264548777
6453,0.6455,2,5,2,670987,5457,113935,12321,0.043221708275250285,0.6930475869051637
6454,0.6456,7,4,7,670991,5453,113942,12314,0.043190026612596626,0.6930826813755839
6455,0.6457,5,2,5,670993,5451,113947,12309,0.0431741857812698,0.6930743243243244
6456,0.6458,8,1,8,670994,5450,113955,12301,0.04316626536560639,0.6929750436595121
6457,0.6459,5,2,5,670996,5448,113960,12296,0.04315042453427956,0.6929666366095582
6458,0.646,11,5,11,671001,5443,113971,12285,0.04311082245596249,0.6929715703971119
6459,0.6461,8,7,8,671008,5436,113979,12277,0.04305537954631859,0.6931067577485462
6460,0.6462,5,6,5,671014,5430,113984,12272,0.04300785705233811,0.6932549994350921
6461,0.6463,3,3,3,671017,5427,113987,12269,0.042984095805347865,0.6933205244122965
6462,0.6464,4,5,4,671022,5422,113991,12265,0.0429444937270308,0.6934471645841579
6463,0.6465,7,4,7,671026,5418,113998,12258,0.04291281206437714,0.6934826883910387
6464,0.6466,10,4,10,671030,5414,114008,12248,0.042881130401723484,0.693466198618503
6465,0.6467,4,3,4,671033,5411,114012,12244,0.04285736915473324,0.6935145851033702
6466,0.6468,8,3,8,671036,5408,114020,12236,0.042833607907743,0.6934935388800726
6467,0.6469,11,4,11,671040,5404,114031,12225,0.04280192624508934,0.6934596403653072
6468,0.647,4,3,4,671043,5401,114035,12221,0.0427781649980991,0.6935081148564295
6469,0.6471,3,4,3,671047,5397,114038,12218,0.042746483335445444,0.6936133976724382
6470,0.6472,9,3,9,671050,5394,114047,12209,0.0427227220884552,0.6935749588138386
6471,0.6473,5,3,5,671053,5391,114052,12204,0.04269896084146496,0.6936061381074169
6472,0.6474,9,7,9,671060,5384,114061,12195,0.042643517931821064,0.6937254678878207
6473,0.6475,4,3,4,671063,5381,114065,12191,0.04261975668483082,0.6937741862053266
6474,0.6476,3,2,3,671065,5379,114068,12188,0.04260391585350399,0.6938008766437069
6475,0.6477,4,3,4,671068,5376,114072,12184,0.04258015460651375,0.6938496583143507
6476,0.6478,4,1,4,671069,5375,114076,12180,0.042572234190850336,0.6938194246653375
6477,0.6479,7,5,7,671074,5370,114083,12173,0.04253263211253327,0.6938950008550419
6478,0.648,3,2,3,671076,5368,114086,12170,0.04251679128120644,0.693921769871137
6479,0.6481,4,6,4,671082,5362,114090,12166,0.042469268787225956,0.6940894568690096
6480,0.6482,4,7,4,671089,5355,114094,12162,0.04241382587758206,0.6942969686590169
6481,0.6483,1,2,1,671091,5353,114095,12161,0.04239798504625523,0.6943587986753454
6482,0.6484,3,4,3,671095,5349,114098,12158,0.04236630338360157,0.6944650711144114
6483,0.6485,10,2,10,671097,5347,114108,12148,0.042350462552274745,0.6943698199485567
6484,0.6486,5,4,5,671101,5343,114113,12143,0.042318780889621085,0.6944412672995539
6485,0.6487,8,7,8,671108,5336,114121,12135,0.04226333797997719,0.6945795890332551
6486,0.6488,8,4,8,671112,5332,114129,12127,0.042231656317323535,0.6945987742711496
6487,0.6489,3,4,3,671116,5328,114132,12124,0.042199974654669875,0.6947054778821912
6488,0.649,2,5,2,671121,5323,114134,12122,0.04216037257635281,0.6948695901404414
6489,0.6491,7,2,7,671123,5321,114141,12115,0.04214453174502598,0.6948267951364991
6490,0.6492,5,3,5,671126,5318,114146,12110,0.04212077049803574,0.6948588478310764
6491,0.6493,13,7,13,671133,5311,114159,12097,0.04206532758839184,0.6949103860294118
6492,0.6494,2,3,2,671136,5308,114161,12095,0.0420415663414016,0.6949951157846348
6493,0.6495,7,2,7,671138,5306,114168,12088,0.04202572551007477,0.6949522823962286
6494,0.6496,7,3,7,671141,5303,114175,12081,0.04200196426308453,0.6949493787390704
6495,0.6497,5,0,5,671141,5303,114180,12076,0.04200196426308453,0.6948616145923241
6496,0.6498,4,3,4,671144,5300,114184,12072,0.041978203016094284,0.6949113516002763
6497,0.6499,7,1,7,671145,5299,114191,12065,0.04197028260043087,0.6948283805574752
6498,0.65,4,4,4,671149,5295,114195,12061,0.041938600937777216,0.694918183913344
6499,0.6501,5,4,5,671153,5291,114200,12056,0.04190691927512356,0.6949904882688649
6500,0.6502,8,2,8,671155,5289,114208,12048,0.041891078443796734,0.6949299186710504
6501,0.6503,5,4,5,671159,5285,114213,12043,0.041859396781143074,0.6950023084025854
6502,0.6504,6,4,6,671163,5281,114219,12037,0.04182771511848942,0.6950571659544982
6503,0.6505,11,2,11,671165,5279,114230,12026,0.04181187428716259,0.6949436579023404
6504,0.6506,10,2,10,671167,5277,114240,12016,0.04179603345583576,0.6948476262071358
6505,0.6507,7,4,7,671171,5273,114247,12009,0.04176435179318211,0.6948848512903599
6506,0.6508,6,3,6,671174,5270,114253,12003,0.041740590546191864,0.694899554217565
6507,0.6509,9,0,9,671174,5270,114262,11994,0.041740590546191864,0.694740500463392
6508,0.651,5,2,5,671176,5268,114267,11989,0.041724749714865034,0.6947325722895057
6509,0.6511,6,4,6,671180,5264,114273,11983,0.04169306805221138,0.6947874992752363
6510,0.6512,10,5,10,671185,5259,114283,11973,0.04165346597389431,0.6948119777158774
6511,0.6513,6,4,6,671189,5255,114289,11967,0.04162178431124065,0.6948670305423296
6512,0.6514,5,3,5,671192,5252,114294,11962,0.04159802306425041,0.6948995004066457
6513,0.6515,6,0,6,671192,5252,114300,11956,0.04159802306425041,0.694793119479312
6514,0.6516,10,4,10,671196,5248,114310,11946,0.041566341401596756,0.6947772478771664
6515,0.6517,4,5,4,671201,5243,114314,11942,0.04152673932327969,0.694908350305499
6516,0.6518,6,5,6,671206,5238,114320,11936,0.04148713724496261,0.6950040759287295
6517,0.6519,5,7,5,671213,5231,114325,11931,0.041431694335318715,0.695198694790817
6518,0.652,7,5,7,671218,5226,114332,11924,0.04139209225700165,0.6952769679300291
6519,0.6521,9,8,9,671226,5218,114341,11915,0.041328728931694335,0.695441545555361
6520,0.6522,8,1,8,671227,5217,114349,11907,0.04132080851603092,0.6953398738612474
6521,0.6523,3,2,3,671229,5215,114352,11904,0.04130496768470409,0.6953677200771073
6522,0.6524,4,6,4,671235,5209,114356,11900,0.04125744519072361,0.6955403588754456
6523,0.6525,3,4,3,671239,5205,114359,11897,0.041225763528069954,0.6956496316220325
6524,0.6526,5,3,5,671242,5202,114364,11892,0.04120200228107971,0.6956826956826957
6525,0.6527,10,2,10,671244,5200,114374,11882,0.04118616144975288,0.69558599695586
6526,0.6528,6,1,6,671245,5199,114380,11876,0.04117824103408947,0.6955197657393851
6527,0.6529,5,4,5,671249,5195,114385,11871,0.04114655937143581,0.6955935778741357
6528,0.653,9,2,9,671251,5193,114394,11862,0.04113071854010898,0.6955145118733509
6529,0.6531,4,2,4,671253,5191,114398,11858,0.04111487770878216,0.695524664203179
6530,0.6532,10,7,10,671260,5184,114408,11848,0.04105943479913826,0.6956317519962424
6531,0.6533,13,4,13,671264,5180,114421,11835,0.0410277531364846,0.6955627387599177
6532,0.6534,6,3,6,671267,5177,114427,11829,0.041003991889494364,0.6955780312830766
6533,0.6535,5,2,5,671269,5175,114432,11824,0.040988151058167534,0.6955703276663333
6534,0.6536,4,0,4,671269,5175,114436,11820,0.040988151058167534,0.6954986760812003
6535,0.6537,8,5,8,671274,5170,114444,11812,0.040948548979850466,0.6955600047108703
6536,0.6538,4,5,4,671279,5165,114448,11808,0.04090894690153339,0.6956931597242679
6537,0.6539,8,5,8,671284,5160,114456,11800,0.04086934482321632,0.6957547169811321
6538,0.654,6,3,6,671287,5157,114462,11794,0.04084558357622608,0.6957701610524453
6539,0.6541,5,2,5,671289,5155,114467,11789,0.040829742744899256,0.6957625118035883
6540,0.6542,8,2,8,671291,5153,114475,11781,0.040813901913572426,0.6957009566552498
6541,0.6543,3,1,3,671292,5152,114478,11778,0.04080598149790901,0.6956881275841701
6542,0.6544,2,3,2,671295,5149,114480,11776,0.040782220250918766,0.6957754800590842
6543,0.6545,6,5,6,671300,5144,114486,11770,0.0407426181726017,0.6958732411020456
6544,0.6546,10,7,10,671307,5137,114496,11760,0.0406871752629578,0.6959815351837604
6545,0.6547,0,6,0,671313,5131,114496,11760,0.04063965276897732,0.6962287608785744
6546,0.6548,2,6,2,671319,5125,114498,11758,0.040592130274996835,0.696440206124504
6547,0.6549,2,4,2,671323,5121,114500,11756,0.040560448612343175,0.6965692954909047
6548,0.655,4,6,4,671329,5115,114504,11752,0.04051292611836269,0.6967451236141579
6549,0.6551,6,3,6,671332,5112,114510,11746,0.04048916487137245,0.6967611816348321
6550,0.6552,5,1,5,671333,5111,114515,11741,0.04048124445570903,0.6967125563731308
6551,0.6553,4,2,4,671335,5109,114519,11737,0.04046540362438221,0.6967232577466461
6552,0.6554,7,5,7,671340,5104,114526,11730,0.040425801546065135,0.6968040869668528
6553,0.6555,3,3,3,671343,5101,114529,11727,0.0404020402990749,0.696874257190397
6554,0.6556,10,4,10,671347,5097,114539,11717,0.04037035863642124,0.6968597597240395
6555,0.6557,6,5,6,671352,5092,114545,11711,0.04033075655810417,0.6969588763911206
6556,0.6558,7,1,7,671353,5091,114552,11704,0.040322836142440754,0.6968740696635903
6557,0.6559,6,5,6,671358,5086,114558,11698,0.04028323406412369,0.6969733079122974
6558,0.656,7,4,7,671362,5082,114565,11691,0.04025155240147003,0.6970130566982651
6559,0.6561,12,2,12,671364,5080,114577,11679,0.040235711570143204,0.6968792887403783
6560,0.6562,6,3,6,671367,5077,114583,11673,0.04021195032315296,0.6968955223880597
6561,0.6563,2,3,2,671370,5074,114585,11671,0.040188189076162714,0.696984174380412
6562,0.6564,12,2,12,671372,5072,114597,11659,0.04017234824483589,0.69685015838862
6563,0.6565,6,4,6,671376,5068,114603,11653,0.04014066658218223,0.6969080796603074
6564,0.6566,8,7,8,671383,5061,114611,11645,0.040085223672538334,0.6970549503172513
6565,0.6567,7,5,7,671388,5056,114618,11638,0.040045621594221266,0.6971366958188571
6566,0.6568,6,2,6,671390,5054,114624,11632,0.040029780762894436,0.6971113508330337
6567,0.6569,6,2,6,671392,5052,114630,11626,0.040013939931567606,0.6970859815325579
6568,0.657,6,2,6,671394,5050,114636,11620,0.03999809910024078,0.6970605878824235
6569,0.6571,4,4,4,671398,5046,114640,11616,0.03996641743758712,0.6971552034569679
6570,0.6572,4,5,4,671403,5041,114644,11612,0.039926815359270056,0.6972917792589923
6571,0.6573,7,5,7,671408,5036,114651,11605,0.03988721328095299,0.6973739558920738
6572,0.6574,5,4,5,671412,5032,114656,11600,0.03985553161829933,0.6974506974506974
6573,0.6575,9,3,9,671415,5029,114665,11591,0.03983177037130908,0.6974127557160048
6574,0.6576,7,3,7,671418,5026,114672,11584,0.039808009124318845,0.6974111980734498
6575,0.6577,5,7,5,671425,5019,114677,11579,0.03975256621467495,0.6976141703819737
6576,0.6578,5,2,5,671427,5017,114682,11574,0.03973672538334812,0.6976071363992526
6577,0.6579,5,3,5,671430,5014,114687,11569,0.03971296413635787,0.6976421636615812
6578,0.658,4,0,4,671430,5014,114691,11565,0.03971296413635787,0.697569214065987
6579,0.6581,9,2,9,671432,5012,114700,11556,0.03969712330503105,0.6974891356832448
6580,0.6582,4,4,4,671436,5008,114704,11552,0.03966544164237739,0.6975845410628019
6581,0.6583,7,1,7,671437,5007,114711,11545,0.039657521226713975,0.6974987916868052
6582,0.6584,10,1,10,671438,5006,114721,11535,0.03964960081105057,0.6973580799226166
6583,0.6585,6,4,6,671442,5002,114727,11529,0.03961791914839691,0.6974169741697417
6584,0.6586,6,3,6,671445,4999,114733,11523,0.03959415790140666,0.6974337247306621
6585,0.6587,8,5,8,671450,4994,114741,11515,0.039554555823089595,0.6974983342419286
6586,0.6588,9,3,9,671453,4991,114750,11506,0.03953079457609936,0.6974601442686549
6587,0.6589,5,2,5,671455,4989,114755,11501,0.03951495374477253,0.6974530018192844
6588,0.659,4,2,4,671457,4987,114759,11497,0.0394991129134457,0.6974642077165737
6589,0.6591,5,0,5,671457,4987,114764,11492,0.0394991129134457,0.697372413374598
6590,0.6592,4,6,4,671463,4981,114768,11488,0.039451590419465214,0.6975529783229097
6591,0.6593,2,0,2,671463,4981,114770,11486,0.039451590419465214,0.6975162446104329
6592,0.6594,8,4,8,671467,4977,114778,11478,0.039419908756811554,0.697538742023701
6593,0.6595,6,7,6,671474,4970,114784,11472,0.03936446584716766,0.6977253375501764
6594,0.6596,9,4,9,671478,4966,114793,11463,0.039332784184514004,0.6977296244445798
6595,0.6597,4,9,4,671487,4957,114797,11459,0.039261500443543276,0.6980384990253411
6596,0.6598,3,3,3,671490,4954,114800,11456,0.03923773919655304,0.6981109079829372
6597,0.6599,6,3,6,671493,4951,114806,11450,0.039213977949562794,0.6981281629168953
6598,0.66,5,9,5,671502,4942,114811,11445,0.039142694208592066,0.6984194788551901
6599,0.6601,5,5,5,671507,4937,114816,11440,0.039103092130275,0.698540636258167
6600,0.6602,3,3,3,671510,4934,114819,11437,0.03907933088328475,0.6986134017469916
6601,0.6603,9,6,9,671516,4928,114828,11428,0.03903180838930427,0.6987038395695769
6602,0.6604,9,4,9,671520,4924,114837,11419,0.03900012672665062,0.698708927369516
6603,0.6605,8,1,8,671521,4923,114845,11411,0.0389922063109872,0.6986041386065874
6604,0.6606,5,2,5,671523,4921,114850,11406,0.03897636547966037,0.6985974153243094
6605,0.6607,6,5,6,671528,4916,114856,11400,0.038936763401343305,0.6987006619269429
6606,0.6608,8,6,8,671534,4910,114864,11392,0.038889240907362815,0.6988099619678567
6607,0.6609,3,3,3,671537,4907,114867,11389,0.03886547966037258,0.6988831615120275
6608,0.661,4,4,4,671541,4903,114871,11385,0.03883379799771892,0.6989808447937131
6609,0.6611,7,1,7,671542,4902,114878,11378,0.03882587758205551,0.6988943488943489
6610,0.6612,11,7,11,671549,4895,114889,11367,0.038770434672411605,0.6989915139589227
6611,0.6613,4,2,4,671551,4893,114893,11363,0.03875459384108478,0.6990034448818898
6612,0.6614,5,3,5,671554,4890,114898,11358,0.03873083259409454,0.69903988183161
6613,0.6615,3,2,3,671556,4888,114901,11355,0.03871499176276771,0.6990703687742412
6614,0.6616,5,6,5,671562,4882,114906,11350,0.038667469268787225,0.6992360768851651
6615,0.6617,7,5,7,671567,4877,114913,11343,0.03862786719047016,0.6993218249075216
6616,0.6618,6,1,6,671568,4876,114919,11337,0.03861994677480674,0.699253685314254
6617,0.6619,7,5,7,671573,4871,114926,11330,0.038580344696489674,0.6993395469415468
6618,0.662,11,4,11,671577,4867,114937,11319,0.038548663033836014,0.6993080439886321
6619,0.6621,8,3,8,671580,4864,114945,11311,0.038524901786845776,0.6992890262751159
6620,0.6622,7,4,7,671584,4860,114952,11304,0.038493220124192117,0.6993318485523385
6621,0.6623,8,2,8,671586,4858,114960,11296,0.03847737929286529,0.6992695307663737
6622,0.6624,7,4,7,671590,4854,114967,11289,0.038445697630211634,0.6993123954655268
6623,0.6625,5,2,5,671592,4852,114972,11284,0.038429856798884804,0.6993058998512642
6624,0.6626,5,3,5,671595,4849,114977,11279,0.038406095551894566,0.6993427579365079
6625,0.6627,3,2,3,671597,4847,114980,11276,0.038390254720567736,0.6993735657135769
6626,0.6628,9,2,9,671599,4845,114989,11267,0.038374413889240906,0.6992924528301887
6627,0.6629,6,5,6,671604,4840,114995,11261,0.03833481181092384,0.6993975529470219
6628,0.663,7,5,7,671609,4835,115002,11254,0.03829520973260677,0.6994841195848095
6629,0.6631,5,3,5,671612,4832,115007,11249,0.038271448485616526,0.6995211740563397
6630,0.6632,6,7,6,671619,4825,115013,11243,0.03821600557597263,0.699713716704008
6631,0.6633,4,3,4,671622,4822,115017,11239,0.03819224432898238,0.6997696282921362
6632,0.6634,7,5,7,671627,4817,115024,11232,0.038152642250665315,0.6998566888902735
6633,0.6635,1,6,1,671633,4811,115025,11231,0.03810511975668483,0.7000997381872585
6634,0.6636,1,3,1,671636,4808,115026,11230,0.03808135850969459,0.7002119965082928
6635,0.6637,5,6,5,671642,4802,115031,11225,0.038033836015714105,0.700380607724465
6636,0.6638,7,4,7,671646,4798,115038,11218,0.038002154353060445,0.7004245754245755
6637,0.6639,9,4,9,671650,4794,115047,11209,0.03797047269040679,0.7004311691557833
6638,0.664,6,5,6,671655,4789,115053,11203,0.037930870612089725,0.7005377688844422
6639,0.6641,2,4,2,671659,4785,115055,11201,0.037899188949436065,0.7006755911422494
6640,0.6642,5,5,5,671664,4780,115060,11196,0.037859586871119,0.7008012018027041
6641,0.6643,9,8,9,671672,4772,115069,11187,0.037796223545811684,0.7009837709129645
6642,0.6644,4,2,4,671674,4770,115073,11183,0.037780382714484854,0.7009966777408638
6643,0.6645,4,2,4,671676,4768,115077,11179,0.03776454188315803,0.701009594281056
6644,0.6646,5,7,5,671683,4761,115082,11174,0.03770909897351413,0.7012237213680578
6645,0.6647,6,2,6,671685,4759,115088,11168,0.037693258142187304,0.7011992214478558
6646,0.6648,8,4,8,671689,4755,115096,11160,0.037661576479533644,0.7012252591894439
6647,0.6649,10,5,10,671694,4750,115106,11150,0.037621974401216576,0.7012578616352201
6648,0.665,10,6,10,671700,4744,115116,11140,0.037574451907236094,0.7013346764039284
6649,0.6651,2,6,2,671706,4738,115118,11138,0.03752692941325561,0.7015621063240111
6650,0.6652,9,4,9,671710,4734,115127,11129,0.03749524775060195,0.7015696904746895
6651,0.6653,6,2,6,671712,4732,115133,11123,0.03747940691927512,0.7015452538631347
6652,0.6654,3,4,3,671716,4728,115136,11120,0.03744772525662147,0.701665825340737
6653,0.6655,2,5,2,671721,4723,115138,11118,0.0374081231783044,0.7018496307051323
6654,0.6656,5,4,5,671725,4719,115143,11113,0.03737644151565074,0.7019327943405761
6655,0.6657,9,7,9,671732,4712,115152,11104,0.03732099860600684,0.7020738492665655
6656,0.6658,5,3,5,671735,4709,115157,11099,0.0372972373590166,0.7021128542510121
6657,0.6659,6,2,6,671737,4707,115163,11093,0.037281396527689775,0.7020886075949367
6658,0.6661,5,4,5,671741,4703,115168,11088,0.037249714865036115,0.7021721233614084
6659,0.6662,4,2,4,671743,4701,115172,11084,0.03723387403370929,0.70218561925879
6660,0.6663,4,6,4,671749,4695,115176,11080,0.0371863515397288,0.7023771790808241
6661,0.6664,6,6,6,671755,4689,115182,11074,0.03713882904574832,0.7025312440525281
6662,0.6665,2,1,2,671756,4688,115184,11072,0.037130908630084905,0.7025380710659899
6663,0.6666,7,3,7,671759,4685,115191,11065,0.03710714738309467,0.7025396825396826
6664,0.6667,7,4,7,671763,4681,115198,11058,0.03707546572044101,0.7025859330325942
6665,0.6668,7,4,7,671767,4677,115205,11051,0.037043784057787355,0.7026322482197355
6666,0.6669,4,5,4,671772,4672,115209,11047,0.03700418197947028,0.7027800750683886
6667,0.667,4,1,4,671773,4671,115213,11043,0.03699626156380687,0.7027491408934707
6668,0.6671,10,4,10,671777,4667,115223,11033,0.03696457990115321,0.7027388535031848
6669,0.6672,8,3,8,671780,4664,115231,11025,0.03694081865416297,0.7027216521129453
6670,0.6673,11,4,11,671784,4660,115242,11014,0.036909136991509314,0.7026923567691719
6671,0.6674,6,3,6,671787,4657,115248,11008,0.03688537574451907,0.7027130545802744
6672,0.6675,10,4,10,671791,4653,115258,10998,0.03685369408186542,0.7027027027027027
6673,0.6676,7,7,7,671798,4646,115265,10991,0.03679825117222152,0.7028841849459615
6674,0.6677,11,4,11,671802,4642,115276,10980,0.03676656950956786,0.7028549481500448
6675,0.6678,7,3,7,671805,4639,115283,10973,0.03674280826257762,0.7028567768383295
6676,0.6679,4,3,4,671808,4636,115287,10969,0.036719047015587376,0.7029157321371355
6677,0.668,5,2,5,671810,4634,115292,10964,0.03670320618426055,0.7029106295678933
6678,0.6681,7,3,7,671813,4631,115299,10957,0.03667944493727031,0.7029124967924044
6679,0.6682,3,2,3,671815,4629,115302,10954,0.03666360410594348,0.7029455175511775
6680,0.6683,7,1,7,671816,4628,115309,10947,0.036655683690280064,0.7028571428571428
6681,0.6684,4,5,4,671821,4623,115313,10943,0.036616081611962996,0.7030065527431582
6682,0.6685,6,1,6,671822,4622,115319,10937,0.03660816119629958,0.70293720676136
6683,0.6686,7,8,7,671830,4614,115326,10930,0.03654479787099227,0.7031652084405559
6684,0.6687,3,2,3,671832,4612,115329,10927,0.03652895703966544,0.7031984040157024
6685,0.6688,9,2,9,671834,4610,115338,10918,0.036513116208338615,0.7031169500257599
6686,0.6689,0,2,0,671836,4608,115338,10918,0.036497275377011786,0.7032075228648719
6687,0.669,11,6,11,671842,4602,115349,10907,0.0364497528830313,0.7032690695725062
6688,0.6691,6,2,6,671844,4600,115355,10901,0.03643391205170447,0.7032449519385846
6689,0.6692,8,2,8,671846,4598,115363,10893,0.03641807122037764,0.7031824930604867
6690,0.6693,9,2,9,671848,4596,115372,10884,0.03640223038905082,0.7031007751937984
6691,0.6694,8,2,8,671850,4594,115380,10876,0.03638638955772399,0.7030381383322559
6692,0.6695,4,3,4,671853,4591,115384,10872,0.036362628310733745,0.7030977171312165
6693,0.6696,5,1,5,671854,4590,115389,10867,0.03635470789507033,0.7030471630976257
6694,0.6697,7,4,7,671858,4586,115396,10860,0.03632302623241668,0.7030946523371747
6695,0.6698,10,1,10,671859,4585,115406,10850,0.03631510581675326,0.7029478458049887
6696,0.6699,4,5,4,671864,4580,115410,10846,0.036275503738436195,0.7030986645922469
6697,0.67,5,5,5,671869,4575,115415,10841,0.03623590166011912,0.7032304099636741
6698,0.6701,5,2,5,671871,4573,115420,10836,0.0362200608287923,0.7032253877603998
6699,0.6702,8,1,8,671872,4572,115428,10828,0.03621214041312888,0.7031168831168831
6700,0.6703,8,3,8,671875,4569,115436,10820,0.03618837916613864,0.7030996166092663
6701,0.6704,6,3,6,671878,4566,115442,10814,0.0361646179191484,0.7031209362808842
6702,0.6705,10,4,10,671882,4562,115452,10804,0.03613293625649474,0.7031107640244696
6703,0.6706,10,5,10,671887,4557,115462,10794,0.03609333417817767,0.7031463748290013
6704,0.6707,4,4,4,671891,4553,115466,10790,0.03606165251552401,0.7032522974646419
6705,0.6708,2,1,2,671892,4552,115468,10788,0.036053732099860604,0.7032594524119948
6706,0.6709,7,4,7,671896,4548,115475,10781,0.036022050437206944,0.7033074564550851
6707,0.671,3,3,3,671899,4545,115478,10778,0.0359982891902167,0.7033870651961104
6708,0.6711,4,1,4,671900,4544,115482,10774,0.03599036877455329,0.7033555294424859
6709,0.6712,2,6,2,671906,4538,115484,10772,0.0359428462805728,0.7035924232527759
6710,0.6713,8,1,8,671907,4537,115492,10764,0.035934925864909394,0.703483432455395
6711,0.6714,6,4,6,671911,4533,115498,10758,0.035903244202255734,0.7035511084951932
6712,0.6715,4,4,4,671915,4529,115502,10754,0.03587156253960208,0.7036576588366158
6713,0.6716,4,2,4,671917,4527,115506,10750,0.03585572170827525,0.7036721869476992
6714,0.6717,9,0,9,671917,4527,115515,10741,0.03585572170827525,0.7034975111343987
6715,0.6718,8,5,8,671922,4522,115523,10733,0.03581611962995818,0.7035725991478203
6716,0.6719,6,5,6,671927,4517,115529,10727,0.03577651755164111,0.703686696405143
6717,0.672,6,3,6,671930,4514,115535,10721,0.03575275630465087,0.7037085658024286
6718,0.6721,1,9,1,671939,4505,115536,10720,0.03568147256368014,0.7041050903119869
6719,0.6722,11,4,11,671943,4501,115547,10709,0.03564979090102648,0.7040762656147271
6720,0.6723,8,5,8,671948,4496,115555,10701,0.035610188822709415,0.7041521352898599
6721,0.6724,3,6,3,671954,4490,115558,10698,0.03556266632872893,0.7043718725309455
6722,0.6725,8,3,8,671957,4487,115566,10690,0.03553890508173869,0.7043552744284114
6723,0.6726,4,2,4,671959,4485,115570,10686,0.035523064250411865,0.7043701799485861
6724,0.6727,5,6,5,671965,4479,115575,10681,0.035475541756431375,0.7045514511873351
6725,0.6728,6,2,6,671967,4477,115581,10675,0.03545970092510455,0.7045274551214361
6726,0.6729,8,6,8,671973,4471,115589,10667,0.03541217843112406,0.7046505482890738
6727,0.673,2,3,2,671976,4468,115591,10665,0.035388417184133825,0.7047512059736999
6728,0.6731,5,4,5,671980,4464,115596,10660,0.035356735521480165,0.7048399894207882
6729,0.6732,11,6,11,671986,4458,115607,10649,0.03530921302749968,0.7049050109220891
6730,0.6733,4,2,4,671988,4456,115611,10645,0.03529337219617285,0.7049202039600027
6731,0.6734,10,4,10,671992,4452,115621,10635,0.0352616905335192,0.7049115132233048
6732,0.6735,9,2,9,671994,4450,115630,10626,0.03524584970219237,0.7048288670734943
6733,0.6736,2,3,2,671997,4447,115632,10624,0.03522208845520213,0.704929998009422
6734,0.6737,8,4,8,672001,4443,115640,10616,0.03519040679254847,0.7049604887442725
6735,0.6738,5,3,5,672004,4440,115645,10611,0.035166645545558234,0.7050029898345624
6736,0.6739,4,1,4,672005,4439,115649,10607,0.03515872512989482,0.7049714209756746
6737,0.674,3,1,3,672006,4438,115652,10604,0.035150804714231404,0.7049594468820636
6738,0.6741,6,3,6,672009,4435,115658,10598,0.03512704346724116,0.7049823721146811
6739,0.6742,3,3,3,672012,4432,115661,10595,0.03510328222025092,0.7050642177413988
6740,0.6743,4,5,4,672017,4427,115665,10591,0.035063680141933846,0.7052204021840458
6741,0.6744,4,3,4,672020,4424,115669,10587,0.03503991889494361,0.7052827926187463
6742,0.6745,7,1,7,672021,4423,115676,10580,0.035031998479280194,0.7051922948743584
6743,0.6746,5,4,5,672025,4419,115681,10575,0.035000316816626534,0.7052821128451381
6744,0.6747,5,7,5,672032,4412,115686,10570,0.034944873906982636,0.7055132826057936
6745,0.6748,11,4,11,672036,4408,115697,10559,0.03491319224432898,0.7054854012160086
6746,0.6749,4,4,4,672040,4404,115701,10555,0.034881510581675323,0.7055952938030617
6747,0.675,7,4,7,672044,4400,115708,10548,0.03484982891902167,0.7056462402997057
6748,0.6751,8,1,8,672045,4399,115716,10540,0.034841908503358256,0.7055358457728095
6749,0.6752,6,4,6,672049,4395,115722,10534,0.0348102268407046,0.7056065376113604
6750,0.6753,3,7,3,672056,4388,115725,10531,0.034754783931060705,0.7058784100811046
6751,0.6754,5,3,5,672059,4385,115730,10526,0.03473102268407046,0.7059218026959962
6752,0.6755,4,7,4,672066,4378,115734,10522,0.03467557977442656,0.7061744966442953
6753,0.6756,3,3,3,672069,4375,115737,10519,0.03465181852743632,0.7062575533771989
6754,0.6757,6,1,6,672070,4374,115743,10513,0.0346438981117729,0.7061866057634177
6755,0.6758,12,5,12,672075,4369,115755,10501,0.034604296033455835,0.706186953597848
6756,0.6759,5,1,5,672076,4368,115760,10496,0.03459637561779242,0.7061356297093649
6757,0.676,7,7,7,672083,4361,115767,10489,0.03454093270814852,0.7063299663299664
6758,0.6761,3,4,3,672087,4357,115770,10486,0.03450925104549487,0.706460958027353
6759,0.6762,4,2,4,672089,4355,115774,10482,0.03449341021416804,0.7064770506167015
6760,0.6763,6,1,6,672090,4354,115780,10476,0.034485489798504625,0.7064059339177343
6761,0.6764,6,2,6,672092,4352,115786,10470,0.034469648967177795,0.7063824045338011
6762,0.6765,4,7,4,672099,4345,115790,10466,0.0344142060575339,0.7066369590169469
6763,0.6766,4,2,4,672101,4343,115794,10462,0.034398365226207074,0.7066531577169876
6764,0.6767,5,4,5,672105,4339,115799,10457,0.034366683563553414,0.7067450662341174
6765,0.6768,6,2,6,672107,4337,115805,10451,0.034350842732226584,0.7067216662158506
6766,0.6769,2,3,2,672110,4334,115807,10449,0.034327081485236347,0.706825407562741
6767,0.677,5,5,5,672115,4329,115812,10444,0.03428747940691927,0.7069654098693563
6768,0.6771,5,2,5,672117,4327,115817,10439,0.03427163857559245,0.7069619395909522
6769,0.6772,4,2,4,672119,4325,115821,10435,0.03425579774426562,0.7069783197831978
6770,0.6773,2,1,2,672120,4324,115823,10433,0.034247877328602204,0.706986514874297
6771,0.6774,2,3,2,672123,4321,115825,10431,0.034224116081611966,0.7070905639913232
6772,0.6775,6,4,6,672127,4317,115831,10425,0.034192434418958306,0.7071632071632071
6773,0.6776,6,3,6,672130,4314,115837,10419,0.03416867317196806,0.7071879454286296
6774,0.6777,4,9,4,672139,4305,115841,10415,0.03409738943099734,0.7075407608695652
6775,0.6778,9,0,9,672139,4305,115850,10406,0.03409738943099734,0.707361838080348
6776,0.6779,5,2,5,672141,4303,115855,10401,0.03408154859967051,0.7073585418933623
6777,0.678,8,3,8,672144,4300,115863,10393,0.034057787352680266,0.7073436330225278
6778,0.6781,4,4,4,672148,4296,115867,10389,0.03402610569002661,0.7074565883554648
6779,0.6782,6,4,6,672152,4292,115873,10383,0.03399442402737295,0.7075298126064736
6780,0.6783,10,3,10,672155,4289,115883,10373,0.033970662780382715,0.7074751057154549
6781,0.6784,8,1,8,672156,4288,115891,10365,0.0339627423647193,0.707363679792534
6782,0.6785,3,3,3,672159,4285,115894,10362,0.033938981117729056,0.7074486242916638
6783,0.6786,4,4,4,672163,4281,115898,10358,0.0339072994550754,0.7075619919393401
6784,0.6787,5,3,5,672166,4278,115903,10353,0.03388353820808516,0.7076071355341398
6785,0.6788,2,3,2,672169,4275,115905,10351,0.03385977696109492,0.707712293176535
6786,0.6789,4,1,4,672170,4274,115909,10347,0.033851856545431505,0.7076807331919841
6787,0.679,4,2,4,672172,4272,115913,10343,0.033836015714104675,0.7076975709887102
6788,0.6791,8,4,8,672176,4268,115921,10335,0.03380433405145102,0.707731288091488
6789,0.6792,2,1,2,672177,4267,115923,10333,0.03379641363578761,0.7077397260273972
6790,0.6793,2,3,2,672180,4264,115925,10331,0.03377265238879736,0.707845152449469
6791,0.6794,8,3,8,672183,4261,115933,10323,0.033748891141807125,0.7078304991771804
6792,0.6795,8,3,8,672186,4258,115941,10315,0.03372512989481688,0.7078158237837096
6793,0.6796,10,3,10,672189,4255,115951,10305,0.033701368647826635,0.707760989010989
6794,0.6797,7,4,7,672193,4251,115958,10298,0.03366968698517298,0.7078149701010379
6795,0.6798,5,3,5,672196,4248,115963,10293,0.03364592573818274,0.7078605322880132
6796,0.6799,6,4,6,672200,4244,115969,10287,0.033614244075529084,0.7079347601679169
6797,0.68,9,1,9,672201,4243,115978,10278,0.03360632365986567,0.7078024929412575
6798,0.6801,7,3,7,672204,4240,115985,10271,0.033582562412875425,0.7078078698918062
6799,0.6802,8,5,8,672209,4235,115993,10263,0.03354296033455836,0.7078907435508346
6800,0.6803,9,5,9,672214,4230,116002,10254,0.03350335825624129,0.707953603976802
6801,0.6804,7,3,7,672217,4227,116009,10247,0.033479597009251044,0.7079590990742021
6802,0.6805,9,6,9,672223,4221,116018,10238,0.03343207451527056,0.7080710975862784
6803,0.6806,4,5,4,672228,4216,116022,10234,0.033392472436953494,0.7082352941176471
6804,0.6807,8,4,8,672232,4212,116030,10226,0.033360790774299834,0.7082698434686244
6805,0.6808,4,3,4,672235,4209,116034,10222,0.033337029527309596,0.7083362206361306
6806,0.6809,1,3,1,672238,4206,116035,10221,0.03331326828031935,0.7084632979829486
6807,0.681,1,4,1,672242,4202,116036,10220,0.0332815866176657,0.7086395784218555
6808,0.6811,5,4,5,672246,4198,116041,10215,0.03324990495501204,0.7087351696385208
6809,0.6812,5,7,5,672253,4191,116046,10210,0.03319446204536814,0.7089785431567253
6810,0.6813,2,3,2,672256,4188,116048,10208,0.033170700798377896,0.7090858571825507
6811,0.6814,5,3,5,672259,4185,116053,10203,0.03314693955138766,0.7091326105087573
6812,0.6815,6,3,6,672262,4182,116059,10197,0.03312317830439741,0.7091591904861256
6813,0.6816,2,2,2,672264,4180,116061,10195,0.03310733747307058,0.7092173913043478
6814,0.6817,4,3,4,672267,4177,116065,10191,0.033083576226080345,0.7092845211581291
6815,0.6818,1,5,1,672272,4172,116066,10190,0.03304397414776328,0.7095112101378638
6816,0.6819,6,2,6,672274,4170,116072,10184,0.03302813331643645,0.70948864428034
6817,0.682,5,4,5,672278,4166,116077,10179,0.03299645165378279,0.7095852213314744
6818,0.6821,3,2,3,672280,4164,116080,10176,0.032980610822455965,0.7096234309623431
6819,0.6822,7,6,7,672286,4158,116087,10169,0.032933088328475475,0.7097787394430097
6820,0.6823,5,5,5,672291,4153,116092,10164,0.03289348625015841,0.7099252636725571
6821,0.6824,4,3,4,672294,4150,116096,10160,0.03286972500316817,0.7099930118798043
6822,0.6825,4,1,4,672295,4149,116100,10156,0.032861804587504755,0.7099615519049284
6823,0.6826,2,0,2,672295,4149,116102,10154,0.032861804587504755,0.7099209955953296
6824,0.6827,6,4,6,672299,4145,116108,10148,0.032830122924851095,0.709997901070454
6825,0.6828,7,5,7,672304,4140,116115,10141,0.03279052084653403,0.710104334430362
6826,0.6829,8,4,8,672308,4136,116123,10133,0.03275883918388037,0.7101408648118298
6827,0.683,6,1,6,672309,4135,116129,10127,0.03275091876821696,0.7100687140653484
6828,0.6831,5,0,5,672309,4135,116134,10122,0.03275091876821696,0.709967033737813
6829,0.6832,7,6,7,672315,4129,116141,10115,0.03270339627423647,0.7101235607975288
6830,0.6833,4,2,4,672317,4127,116145,10111,0.03268755544290965,0.710141873858688
6831,0.6834,5,0,5,672317,4127,116150,10106,0.03268755544290965,0.7100400477762945
6832,0.6835,5,5,5,672322,4122,116155,10101,0.03264795336459257,0.7101877241088378
6833,0.6836,5,3,5,672325,4119,116160,10096,0.032624192117602334,0.7102356665494196
6834,0.6837,4,8,4,672333,4111,116164,10092,0.03256082879229502,0.7105541082869816
6835,0.6838,9,3,9,672336,4108,116173,10083,0.032537067545304776,0.7105207525896695
6836,0.6839,5,3,5,672339,4105,116178,10078,0.03251330629831454,0.710568991045618
6837,0.684,7,2,7,672341,4103,116185,10071,0.03249746546698771,0.7105263157894737
6838,0.6841,5,4,5,672345,4099,116190,10066,0.03246578380433405,0.7106247793858101
6839,0.6842,10,1,10,672346,4098,116200,10056,0.03245786338867064,0.7104705383637134
6840,0.6843,5,4,5,672350,4094,116205,10051,0.03242618172601698,0.7105691056910569
6841,0.6844,9,4,9,672354,4090,116214,10042,0.03239450006336333,0.7105859043305972
6842,0.6845,5,1,5,672355,4089,116219,10037,0.03238657964769991,0.7105337675208835
6843,0.6846,11,3,11,672358,4086,116230,10026,0.03236281840070967,0.7104591836734694
6844,0.6847,2,3,2,672361,4083,116232,10024,0.03233905715371943,0.7105692209541362
6845,0.6848,11,5,11,672366,4078,116243,10013,0.032299455075402356,0.7105954155134483
6846,0.6849,9,3,9,672369,4075,116252,10004,0.03227569382841212,0.710561829675403
6847,0.685,8,5,8,672374,4070,116260,9996,0.03223609175009504,0.7106497938290914
6848,0.6851,4,3,4,672377,4067,116264,9992,0.032212330503104805,0.7107191123123977
6849,0.6852,3,3,3,672380,4064,116267,9989,0.03218856925611456,0.7108090799117626
6850,0.6853,7,3,7,672383,4061,116274,9982,0.032164808009124315,0.7108167770419426
6851,0.6854,4,2,4,672385,4059,116278,9978,0.03214896717779749,0.7108356486428724
6852,0.6855,5,3,5,672388,4056,116283,9973,0.03212520593080725,0.710884596193599
6853,0.6856,9,0,9,672388,4056,116292,9964,0.03212520593080725,0.7106990014265335
6854,0.6857,7,2,7,672390,4054,116299,9957,0.03210936509948042,0.7106559132110485
6855,0.6858,8,4,8,672394,4050,116307,9949,0.032077683436826765,0.7106936209729267
6856,0.6859,6,3,6,672397,4047,116313,9943,0.03205392218983652,0.71072194424589
6857,0.686,7,2,7,672399,4045,116320,9936,0.0320380813585097,0.7106787783420356
6858,0.6861,3,5,3,672404,4040,116323,9933,0.03199847928019262,0.7108709654333357
6859,0.6862,9,8,9,672412,4032,116332,9924,0.03193511595488531,0.711092003439381
6860,0.6863,6,2,6,672414,4030,116338,9918,0.03191927512355849,0.7110696874103815
6861,0.6864,7,2,7,672416,4028,116345,9911,0.03190343429223166,0.7110266159695817
6862,0.6865,10,4,10,672420,4024,116355,9901,0.031871752629578,0.7110233393177738
6863,0.6866,10,2,10,672422,4022,116365,9891,0.031855911798251174,0.7109178466182707
6864,0.6867,4,4,4,672426,4018,116369,9887,0.031824230135597514,0.7110391945343402
6865,0.6868,4,6,4,672432,4012,116373,9883,0.03177670764161703,0.7112630442605253
6866,0.6869,11,5,11,672437,4007,116384,9872,0.031737105563299964,0.7112904387924202
6867,0.687,4,4,4,672441,4003,116388,9868,0.031705423900646304,0.711412299041165
6868,0.6871,3,5,3,672446,3998,116391,9865,0.031665821822329236,0.7116064343937099
6869,0.6872,6,6,6,672452,3992,116397,9859,0.03161829932834875,0.7117897624720236
6870,0.6873,5,2,5,672454,3990,116402,9854,0.031602458497021924,0.7117885004334008
6871,0.6874,5,6,5,672460,3984,116407,9849,0.03155493600304144,0.7119930600737367
6872,0.6875,2,5,2,672465,3979,116409,9847,0.031515333924724366,0.7122088818168668
6873,0.6876,9,2,9,672467,3977,116418,9838,0.03149949309339754,0.7121245023525153
6874,0.6877,8,3,8,672470,3974,116426,9830,0.0314757318464073,0.7121124311793683
6875,0.6878,6,1,6,672471,3973,116432,9824,0.03146781143074388,0.7120388490251504
6876,0.6879,3,3,3,672474,3970,116435,9821,0.031444050183753645,0.7121310999927489
6877,0.688,5,2,5,672476,3968,116440,9816,0.031428209352426816,0.7121300058038306
6878,0.6881,5,8,5,672484,3960,116445,9811,0.0313648460271195,0.7124391837920268
6879,0.6882,11,3,11,672487,3957,116456,9800,0.03134108478012926,0.7123646143781348
6880,0.6883,6,4,6,672491,3953,116462,9794,0.031309403117475605,0.7124463519313304
6881,0.6884,10,2,10,672493,3951,116472,9784,0.031293562286148775,0.712340735347652
6882,0.6885,5,4,5,672497,3947,116477,9779,0.03126188062349512,0.7124435378114528
6883,0.6886,4,2,4,672499,3945,116481,9775,0.031246039792168293,0.7124635568513119
6884,0.6887,4,2,4,672501,3943,116485,9771,0.031230198960841466,0.712483593408196
6885,0.6888,9,3,9,672504,3940,116494,9762,0.03120643771385122,0.7124507371186688
6886,0.6889,5,5,5,672509,3935,116499,9757,0.031166835635534153,0.712605901256208
6887,0.689,5,4,5,672513,3931,116504,9752,0.031135153972880497,0.7127092011985675
6888,0.6891,8,5,8,672518,3926,116512,9744,0.031095551894563426,0.7128017556693489
6889,0.6892,6,1,6,672519,3925,116518,9738,0.031087631478900014,0.7127278050208593
6890,0.6893,6,4,6,672523,3921,116524,9732,0.031055949816246358,0.7128103713469567
6891,0.6894,6,0,6,672523,3921,116530,9726,0.031055949816246358,0.7126841063970103
6892,0.6895,5,5,5,672528,3916,116535,9721,0.031016347737929287,0.7128400674635184
6893,0.6896,4,4,4,672532,3912,116539,9717,0.03098466607527563,0.7129650011005944
6894,0.6897,4,3,4,672535,3909,116543,9713,0.03096090482828539,0.713037733078843
6895,0.6898,3,2,3,672537,3907,116546,9710,0.03094506399695856,0.7130792391863112
6896,0.6899,4,0,4,672537,3907,116550,9706,0.03094506399695856,0.7129949313156542
6897,0.69,4,1,4,672538,3906,116554,9702,0.030937143581295148,0.7129629629629629
6898,0.6901,7,1,7,672539,3905,116561,9695,0.030929223165631733,0.7128676470588236
6899,0.6902,5,2,5,672541,3903,116566,9690,0.030913382334304903,0.7128669167954094
6900,0.6903,4,3,4,672544,3900,116570,9686,0.03088962108731466,0.7129397909612837
6901,0.6904,8,4,8,672548,3896,116578,9678,0.030857939424661005,0.7129806983939885
6902,0.6905,10,2,10,672550,3894,116588,9668,0.03084209859333418,0.7128742073440496
6903,0.6906,7,4,7,672554,3890,116595,9661,0.030810416930680522,0.7129363146631245
6904,0.6907,3,4,3,672558,3886,116598,9658,0.030778735268026866,0.7130832841110455
6905,0.6908,10,4,10,672562,3882,116608,9648,0.03074705360537321,0.7130820399113083
6906,0.6909,2,1,2,672563,3881,116610,9646,0.030739133189709795,0.7130923338508169
6907,0.691,6,3,6,672566,3878,116616,9640,0.030715371942719553,0.7131232430832963
6908,0.6911,3,4,3,672570,3874,116619,9637,0.030683690280065897,0.7132706683443121
6909,0.6912,8,5,8,672575,3869,116627,9629,0.03064408820174883,0.7133649429545118
6910,0.6913,6,4,6,672579,3865,116633,9623,0.030612406539095173,0.7134489916963227
6911,0.6914,5,2,5,672581,3863,116638,9618,0.030596565707768343,0.7134485572286923
6912,0.6915,5,2,5,672583,3861,116643,9613,0.030580724876441517,0.7134481223096334
6913,0.6916,7,2,7,672585,3859,116650,9606,0.030564884045114687,0.7134051243965838
6914,0.6917,9,2,9,672587,3857,116659,9597,0.03054904321378786,0.7133194588969823
6915,0.6918,3,0,3,672587,3857,116662,9594,0.03054904321378786,0.713255520035685
6916,0.6919,5,2,5,672589,3855,116667,9589,0.03053320238246103,0.7132549836358226
6917,0.692,7,3,7,672592,3852,116674,9582,0.03050944113547079,0.7132648503796337
6918,0.6921,6,3,6,672595,3849,116680,9576,0.030485679888480548,0.7132960893854748
6919,0.6922,4,4,4,672599,3845,116684,9572,0.03045399822582689,0.713423268987106
6920,0.6923,9,4,9,672603,3841,116693,9563,0.030422316563173235,0.7134437481348851
6921,0.6924,5,2,5,672605,3839,116698,9558,0.03040647573184641,0.7134433082033291
6922,0.6925,6,4,6,672609,3835,116704,9552,0.030374794069192752,0.7135280496003585
6923,0.6926,6,3,6,672612,3832,116710,9546,0.030351032822202507,0.7135595754223352
6924,0.6927,2,7,2,672619,3825,116712,9544,0.03029558991255861,0.713890343331588
6925,0.6928,4,1,4,672620,3824,116716,9540,0.0302876694968952,0.7138581263094882
6926,0.6929,9,1,9,672621,3823,116725,9531,0.030279749081231783,0.7137187359592632
6927,0.693,6,3,6,672624,3820,116731,9525,0.030255987834241542,0.7137504683402023
6928,0.6931,3,0,3,672624,3820,116734,9522,0.030255987834241542,0.713686104032379
6929,0.6932,6,2,6,672626,3818,116740,9516,0.030240147002914712,0.7136643167841608
6930,0.6933,8,2,8,672628,3816,116748,9508,0.030224306171587886,0.7135995196637647
6931,0.6934,7,6,7,672634,3810,116755,9501,0.0301767836776074,0.7137705656975434
6932,0.6935,4,5,4,672639,3805,116759,9497,0.03013718159929033,0.7139527890542775
6933,0.6936,10,3,10,672642,3802,116769,9487,0.03011342035230009,0.7138987132214614
6934,0.6937,1,2,1,672644,3800,116770,9486,0.03009757952097326,0.7139846454914948
6935,0.6938,6,2,6,672646,3798,116776,9480,0.030081738689646434,0.7139629462268414
6936,0.6939,7,1,7,672647,3797,116783,9473,0.03007381827398302,0.7138658628485305
6937,0.694,2,2,2,672649,3795,116785,9471,0.03005797744265619,0.7139303482587065
6938,0.6941,5,1,5,672650,3794,116790,9466,0.030050057026992778,0.7138763197586727
6939,0.6942,3,8,3,672658,3786,116793,9463,0.029986693701685465,0.7142425843459884
6940,0.6943,6,2,6,672660,3784,116799,9457,0.029970852870358635,0.7142209802884979
6941,0.6944,5,2,5,672662,3782,116804,9452,0.02995501203903181,0.7142209460480581
6942,0.6945,6,3,6,672665,3779,116810,9446,0.029931250792041567,0.7142533081285444
6943,0.6946,9,3,9,672668,3776,116819,9437,0.029907489545051326,0.7142208431090593
6944,0.6947,6,4,6,672672,3772,116825,9431,0.02987580788239767,0.7143073543891539
6945,0.6948,0,2,0,672674,3770,116825,9431,0.02985996705107084,0.7144155745776835
6946,0.6949,4,6,4,672680,3764,116829,9427,0.029812444557090357,0.7146539307103328
6947,0.695,9,1,9,672681,3763,116838,9418,0.029804524141426942,0.7145133146195282
6948,0.6951,6,1,6,672682,3762,116844,9412,0.029796603725763527,0.7144375284651586
6949,0.6952,2,3,2,672685,3759,116846,9410,0.029772842478773286,0.7145569139646138
6950,0.6953,6,1,6,672686,3758,116852,9404,0.02976492206310987,0.7144810819024464
6951,0.6954,4,3,4,672689,3755,116856,9400,0.02974116081611963,0.7145572025845686
6952,0.6955,1,3,1,672692,3752,116857,9399,0.029717399569129388,0.7146985020150559
6953,0.6956,7,0,7,672692,3752,116864,9392,0.029717399569129388,0.714546561168594
6954,0.6957,4,5,4,672697,3747,116868,9388,0.029677797490812317,0.7147316330414922
6955,0.6958,9,1,9,672698,3746,116877,9379,0.029669877075148905,0.7145904761904762
6956,0.6959,3,2,3,672700,3744,116880,9376,0.029654036243822075,0.7146341463414634
6957,0.696,11,7,11,672707,3737,116891,9365,0.029598593334178178,0.7147763700198443
6958,0.6961,3,1,3,672708,3736,116894,9362,0.029590672918514763,0.7147656130706979
6959,0.6962,7,6,7,672714,3730,116901,9355,0.02954315042453428,0.7149407718761941
6960,0.6963,7,3,7,672717,3727,116908,9348,0.02951938917754404,0.7149521988527725
6961,0.6964,7,7,7,672724,3720,116915,9341,0.02946394626790014,0.7151826047010184
6962,0.6965,7,1,7,672725,3719,116922,9334,0.029456025852236726,0.7150846548686126
6963,0.6966,8,3,8,672728,3716,116930,9326,0.029432264605246485,0.7150743750958442
6964,0.6967,6,4,6,672732,3712,116936,9320,0.029400582942592828,0.7151626764886433
6965,0.6968,13,1,13,672733,3711,116949,9307,0.029392662526929413,0.714933169457674
6966,0.6969,1,2,1,672735,3709,116950,9306,0.029376821695602587,0.7150211294660007
6967,0.697,8,1,8,672736,3708,116958,9298,0.029368901279939172,0.7149008150084576
6968,0.6971,8,5,8,672741,3703,116966,9290,0.0293292992016221,0.7150003848225968
6969,0.6972,7,5,7,672746,3698,116973,9283,0.02928969712330503,0.7151221015330098
6970,0.6973,10,2,10,672748,3696,116983,9273,0.029273856291978203,0.7150127226463104
6971,0.6974,6,3,6,672751,3693,116989,9267,0.02925009504498796,0.7150462962962963
6972,0.6975,9,3,9,672754,3690,116998,9258,0.02922633379799772,0.7150139017608897
6973,0.6976,3,3,3,672757,3687,117001,9255,0.029202572551007475,0.7151135836810385
6974,0.6977,2,3,2,672760,3684,117003,9253,0.029178811304017234,0.7152353714153205
6975,0.6978,6,3,6,672763,3681,117009,9247,0.029155050057026993,0.7152691831683168
6976,0.6979,8,4,8,672767,3677,117017,9239,0.029123368394373336,0.7153143388045835
6977,0.698,4,1,4,672768,3676,117021,9235,0.02911544797870992,0.7152815428704206
6978,0.6981,6,5,6,672773,3671,117027,9229,0.029075845900392853,0.7154263565891473
6979,0.6982,4,3,4,672776,3668,117031,9225,0.029052084653402612,0.7155045373458466
6980,0.6983,4,1,4,672777,3667,117035,9221,0.029044164237739197,0.715471756672874
6981,0.6984,4,4,4,672781,3663,117039,9217,0.02901248257508554,0.7156055900621118
6982,0.6985,5,2,5,672783,3661,117044,9212,0.02899664174375871,0.7156063077759652
6983,0.6986,4,3,4,672786,3658,117048,9208,0.02897288049676847,0.7156847505052075
6984,0.6987,5,2,5,672788,3656,117053,9203,0.028957039665441643,0.7156855120926977
6985,0.6988,3,3,3,672791,3653,117056,9200,0.028933278418451402,0.7157861977748385
6986,0.6989,4,1,4,672792,3652,117060,9196,0.028925358002787987,0.7157534246575342
6987,0.699,6,5,6,672797,3647,117066,9190,0.028885755924470916,0.7158993534314871
6988,0.6991,9,2,9,672799,3645,117075,9181,0.02886991509314409,0.7158116326212381
6989,0.6992,4,3,4,672802,3642,117079,9177,0.028846153846153848,0.715890475076059
6990,0.6993,2,2,2,672804,3640,117081,9175,0.028830313014827018,0.7159578618806086
6991,0.6994,5,1,5,672805,3639,117086,9170,0.028822392599163603,0.7159028807869466
6992,0.6995,5,2,5,672807,3637,117091,9165,0.028806551767836776,0.715903765036713
6993,0.6996,1,5,1,672812,3632,117092,9164,0.028766949689519705,0.716161300406377
6994,0.6997,9,1,9,672813,3631,117101,9155,0.02875902927385629,0.716017519161583
6995,0.6998,7,2,7,672815,3629,117108,9148,0.028743188442529464,0.715974015809658
6996,0.6999,2,2,2,672817,3627,117110,9146,0.028727347611202637,0.7160416503562201
6997,0.7,8,3,8,672820,3624,117118,9138,0.028703586364212393,0.7160319699106723
6998,0.7001,10,2,10,672822,3622,117128,9128,0.028687745532885566,0.7159215686274509
6999,0.7002,7,2,7,672824,3620,117135,9121,0.028671904701558736,0.7158778745781336
7000,0.7003,7,2,7,672826,3618,117142,9114,0.02865606387023191,0.7158341187558906
7001,0.7004,5,3,5,672829,3615,117147,9109,0.02863230262324167,0.715891229173216
7002,0.7005,5,6,5,672835,3609,117152,9104,0.028584780129261182,0.7161173601824904
7003,0.7006,8,2,8,672837,3607,117160,9096,0.028568939297934356,0.7160513264583169
7004,0.7007,5,3,5,672840,3604,117165,9091,0.028545178050944114,0.7161087042142575
7005,0.7008,0,4,0,672844,3600,117165,9091,0.028513496388290458,0.7163344102119612
7006,0.7009,7,4,7,672848,3596,117172,9084,0.028481814725636802,0.716403785488959
7007,0.701,5,2,5,672850,3594,117177,9079,0.028465973894309972,0.7164049554170283
7008,0.7011,4,2,4,672852,3592,117181,9075,0.028450133062983145,0.7164285150390779
7009,0.7012,9,1,9,672853,3591,117190,9066,0.02844221264731973,0.7162834794975113
7010,0.7013,4,2,4,672855,3589,117194,9062,0.028426371815992904,0.7163070113034543
7011,0.7014,1,5,1,672860,3584,117195,9061,0.028386769737675833,0.7165678133649664
7012,0.7015,7,2,7,672862,3582,117202,9054,0.028370928906349006,0.7165242165242165
7013,0.7016,7,0,7,672862,3582,117209,9047,0.028370928906349006,0.7163670916145379
7014,0.7017,7,0,7,672862,3582,117216,9040,0.028370928906349006,0.716209792425923
7015,0.7018,6,3,6,672865,3579,117222,9034,0.02834716765935876,0.7162451438991516
7016,0.7019,4,2,4,672867,3577,117226,9030,0.028331326828031935,0.7162687395891172
7017,0.702,7,4,7,672871,3573,117233,9023,0.02829964516537828,0.7163385201651318
7018,0.7021,5,2,5,672873,3571,117238,9018,0.028283804334051452,0.7163396616093415
7019,0.7022,6,1,6,672874,3570,117244,9012,0.028275883918388037,0.7162613257033857
7020,0.7023,5,5,5,672879,3565,117249,9007,0.028236281840070966,0.7164333439389119
7021,0.7024,11,4,11,672883,3561,117260,8996,0.02820460017741731,0.7164131560086008
7022,0.7025,6,3,6,672886,3558,117266,8990,0.02818083893042707,0.716448836467963
7023,0.7026,10,4,10,672890,3554,117276,8980,0.028149157267773412,0.7164512525929472
7024,0.7027,5,3,5,672893,3551,117281,8975,0.02812539602078317,0.7165096599073926
7025,0.7028,3,9,3,672902,3542,117284,8972,0.028054112279812443,0.716957008150871
7026,0.7029,5,4,5,672906,3538,117289,8967,0.028022430617158787,0.7170731707317073
7027,0.703,6,3,6,672909,3535,117295,8961,0.027998669370168545,0.7171094750320103
7028,0.7031,3,0,3,672909,3535,117298,8958,0.027998669370168545,0.717041543264228
7029,0.7032,8,5,8,672914,3530,117306,8950,0.027959067291851478,0.7171474358974359
7030,0.7033,7,5,7,672919,3525,117313,8943,0.027919465213534406,0.7172762271414822
7031,0.7034,5,2,5,672921,3523,117318,8938,0.02790362438220758,0.7172779070700586
7032,0.7035,3,10,3,672931,3513,117321,8935,0.027824420225573437,0.7177859897172236
7033,0.7036,3,2,3,672933,3511,117324,8932,0.02780857939424661,0.7178333199389215
7034,0.7037,6,2,6,672935,3509,117330,8926,0.02779273856291978,0.7178126256533977
7035,0.7038,9,5,9,672940,3504,117339,8917,0.027753136484602713,0.7178971097335158
7036,0.7039,3,2,3,672942,3502,117342,8914,0.027737295653275883,0.7179445876288659
7037,0.704,8,3,8,672945,3499,117350,8906,0.027713534406285642,0.7179363160016122
7038,0.7041,5,5,5,672950,3494,117355,8901,0.02767393232796857,0.718112141992739
7039,0.7042,7,6,7,672956,3488,117362,8894,0.027626409833988088,0.718300759166532
7040,0.7043,8,2,8,672958,3486,117370,8886,0.027610569002661258,0.7182347235693501
7041,0.7044,8,3,8,672961,3483,117378,8878,0.027586807755671017,0.7182266806892647
7042,0.7045,7,4,7,672965,3479,117385,8871,0.02755512609301736,0.7182995951417004
7043,0.7046,11,6,11,672971,3473,117396,8860,0.027507603599036878,0.7183977945349874
7044,0.7047,3,4,3,672975,3469,117399,8857,0.02747592193638322,0.7185623884471848
7045,0.7048,8,3,8,672978,3466,117407,8849,0.02745216068939298,0.7185546082013804
7046,0.7049,11,2,11,672980,3464,117418,8838,0.02743631985806615,0.7184197691432287
7047,0.705,1,4,1,672984,3460,117419,8837,0.027404638195412494,0.71863056029926
7048,0.7051,4,5,4,672989,3455,117423,8833,0.027365036117095426,0.7188313802083334
7049,0.7052,7,6,7,672995,3449,117430,8826,0.02731751362311494,0.7190224032586559
7050,0.7053,5,5,5,673000,3444,117435,8821,0.027277911544797872,0.7192009783938035
7051,0.7054,5,2,5,673002,3442,117440,8816,0.027262070713471042,0.7192037852830805
7052,0.7055,5,1,5,673003,3441,117445,8811,0.02725415029780763,0.7191478942213516
7053,0.7056,5,5,5,673008,3436,117450,8806,0.02721454821949056,0.7193269073680771
7054,0.7057,10,0,10,673008,3436,117460,8796,0.02721454821949056,0.7190974493132767
7055,0.7058,10,3,10,673011,3433,117470,8786,0.027190786972500318,0.7190441116294296
7056,0.7059,6,1,6,673012,3432,117476,8780,0.027182866556836903,0.7189649525057321
7057,0.706,9,2,9,673014,3430,117485,8771,0.027167025725510073,0.7188755020080321
7058,0.7061,7,5,7,673019,3425,117492,8764,0.027127423647193005,0.7190089424891295
7059,0.7062,6,4,6,673023,3421,117498,8758,0.02709574198453935,0.7191066590032023
7060,0.7063,5,2,5,673025,3419,117503,8753,0.02707990115321252,0.7191094314820901
7061,0.7064,1,3,1,673028,3416,117504,8752,0.027056139906222278,0.7192636423405654
7062,0.7065,4,7,4,673035,3409,117508,8748,0.02700069699657838,0.719585424035535
7063,0.7066,6,7,6,673042,3402,117514,8742,0.026945254086934482,0.7198616600790514
7064,0.7067,7,1,7,673043,3401,117521,8735,0.026937333671271067,0.7197593935398814
7065,0.7068,4,3,4,673046,3398,117525,8731,0.026913572424280826,0.7198449995877648
7066,0.7069,6,0,6,673046,3398,117531,8725,0.026913572424280826,0.7197063433143611
7067,0.707,5,2,5,673048,3396,117536,8720,0.026897731592954,0.719709475074282
7068,0.7071,9,3,9,673051,3393,117545,8711,0.026873970345963755,0.7196794448116325
7069,0.7072,7,3,7,673054,3390,117552,8704,0.026850209098973513,0.7196957168844055
7070,0.7073,7,3,7,673057,3387,117559,8697,0.026826447851983272,0.7197120158887785
7071,0.7074,5,2,5,673059,3385,117564,8692,0.026810607020656445,0.7197151610499296
7072,0.7075,7,3,7,673062,3382,117571,8685,0.0267868457736662,0.7197314991298583
7073,0.7076,6,5,6,673067,3377,117577,8679,0.026747243695349133,0.7198905109489051
7074,0.7077,7,1,7,673068,3376,117584,8672,0.026739323279685718,0.7197875166002656
7075,0.7078,7,1,7,673069,3375,117591,8665,0.026731402864022303,0.7196843853820598
7076,0.7079,2,4,2,673073,3371,117593,8663,0.026699721201368647,0.7198770151238159
7077,0.708,7,2,7,673075,3369,117600,8656,0.02668388037004182,0.7198336798336799
7078,0.7081,5,6,5,673081,3363,117605,8651,0.026636357876061334,0.7200765773264525
7079,0.7082,3,3,3,673084,3360,117608,8648,0.026612596629071093,0.7201865423051299
7080,0.7083,4,2,4,673086,3358,117612,8644,0.026596755797744266,0.7202132977837027
7081,0.7084,4,3,4,673089,3355,117616,8640,0.026572994550754025,0.7203001250521051
7082,0.7085,2,1,2,673090,3354,117618,8638,0.02656507413509061,0.7203135423615744
7083,0.7086,5,1,5,673091,3353,117623,8633,0.026557153719427195,0.720256966460871
7084,0.7087,6,8,6,673099,3345,117629,8627,0.026493790394119882,0.720598062145005
7085,0.7088,10,3,10,673102,3342,117639,8617,0.02647002914712964,0.7205451960866294
7086,0.7089,4,2,4,673104,3340,117643,8613,0.026454188315802814,0.7205722412783402
7087,0.709,1,2,1,673106,3338,117644,8612,0.026438347484475985,0.7206694560669457
7088,0.7091,4,0,4,673106,3338,117648,8608,0.026438347484475985,0.7205759249958145
7089,0.7092,5,3,5,673109,3335,117653,8603,0.026414586237485743,0.72063997319484
7090,0.7093,5,4,5,673113,3331,117658,8598,0.026382904574832087,0.720764523430296
7091,0.7094,6,6,6,673119,3325,117664,8592,0.026335382080851604,0.7209868255433415
7092,0.7095,7,3,7,673122,3322,117671,8585,0.026311620833861363,0.7210044511631813
7093,0.7096,7,1,7,673123,3321,117678,8578,0.026303700418197948,0.720900916043365
7094,0.7097,5,3,5,673126,3318,117683,8573,0.026279939171207706,0.7209654360440669
7095,0.7098,5,1,5,673127,3317,117688,8568,0.02627201875554429,0.720908708456037
7096,0.7099,5,4,5,673131,3313,117693,8563,0.026240337092890635,0.7210340181879421
7097,0.71,9,3,9,673134,3310,117702,8554,0.026216575845900394,0.7210047201618341
7098,0.7101,2,3,2,673137,3307,117704,8552,0.026192814598910152,0.7211400623998651
7099,0.7102,7,3,7,673140,3304,117711,8545,0.026169053351919908,0.7211579036205586
7100,0.7103,3,1,3,673141,3303,117714,8542,0.026161132936256496,0.7211481637821866
7101,0.7104,7,8,7,673149,3295,117721,8535,0.026097769610949183,0.7214708368554522
7102,0.7105,5,2,5,673151,3293,117726,8530,0.026081928779622354,0.7214750909244693
7103,0.7106,7,0,7,673151,3293,117733,8523,0.026081928779622354,0.7213100880162492
7104,0.7107,4,1,4,673152,3292,117737,8519,0.026074008363958942,0.7212767758868851
7105,0.7108,6,3,6,673155,3289,117743,8513,0.026050247116968697,0.7213184206066768
7106,0.7109,3,2,3,673157,3287,117746,8510,0.02603440628564187,0.7213698397897771
7107,0.711,4,1,4,673158,3286,117750,8506,0.026026485869978456,0.721336499321574
7108,0.7111,3,2,3,673160,3284,117753,8503,0.02601064503865163,0.7213879697972343
7109,0.7112,5,4,5,673164,3280,117758,8498,0.025978963375997973,0.7215146884021056
7110,0.7113,9,2,9,673166,3278,117767,8489,0.025963122544671143,0.7214243222571598
7111,0.7114,8,4,8,673170,3274,117775,8481,0.025931440882017487,0.7214802211824756
7112,0.7115,7,3,7,673173,3271,117782,8474,0.025907679635027245,0.7214985100042571
7113,0.7116,5,4,5,673177,3267,117787,8469,0.02587599797237359,0.7216257668711656
7114,0.7117,7,4,7,673181,3263,117794,8462,0.025844316309719933,0.7217057569296376
7115,0.7118,4,1,4,673182,3262,117798,8458,0.02583639589405652,0.7216723549488054
7116,0.7119,12,4,12,673186,3258,117810,8446,0.025804714231402865,0.7216336295283664
7117,0.712,3,3,3,673189,3255,117813,8443,0.025780952984412624,0.7217473072320054
7118,0.7121,2,2,2,673191,3253,117815,8441,0.025765112153085794,0.7218231571746194
7119,0.7122,8,3,8,673194,3250,117823,8433,0.025741350906095552,0.7218180261919027
7120,0.7123,6,3,6,673197,3247,117829,8427,0.02571758965910531,0.7218605448004112
7121,0.7124,2,3,2,673200,3244,117831,8425,0.025693828412115066,0.7219984574513668
7122,0.7125,6,3,6,673203,3241,117837,8419,0.025670067165124825,0.722041166380789
7123,0.7126,4,0,4,673203,3241,117841,8415,0.025670067165124825,0.721945778997941
7124,0.7127,4,3,4,673206,3238,117845,8411,0.025646305918134583,0.7220362262855181
7125,0.7128,6,4,6,673210,3234,117851,8405,0.025614624255480927,0.7221410774121488
7126,0.7129,7,1,7,673211,3233,117858,8398,0.025606703839817512,0.7220359384403748
7127,0.713,7,1,7,673212,3232,117865,8391,0.0255987834241541,0.7219306547362987
7128,0.7131,4,5,4,673217,3227,117869,8387,0.02555918134583703,0.7221456862407439
7129,0.7132,8,7,8,673224,3220,117877,8379,0.02550373843619313,0.7223898611949306
7130,0.7133,5,2,5,673226,3218,117882,8374,0.025487897604866302,0.7223947550034506
7131,0.7134,2,5,2,673231,3213,117884,8372,0.025448295526549234,0.7226586102719034
7132,0.7135,6,2,6,673233,3211,117890,8366,0.025432454695222404,0.7226397166796233
7133,0.7136,8,3,8,673236,3208,117898,8358,0.025408693448232163,0.7226353103925298
7134,0.7137,7,2,7,673238,3206,117905,8351,0.025392852616905336,0.7225923682616596
7135,0.7138,4,3,4,673241,3203,117909,8347,0.02536909136991509,0.7226839826839827
7136,0.7139,8,2,8,673243,3201,117917,8339,0.025353250538588265,0.7226169844020798
7137,0.714,6,2,6,673245,3199,117923,8333,0.02533740970726144,0.722597988206729
7138,0.7141,3,2,3,673247,3197,117926,8330,0.02532156887593461,0.7226511668257135
7139,0.7142,4,8,4,673255,3189,117930,8326,0.025258205550627296,0.7230568823273991
7140,0.7143,4,2,4,673257,3187,117934,8322,0.02524236471930047,0.7230862803023721
7141,0.7144,6,2,6,673259,3185,117940,8316,0.02522652388797364,0.7230675593426659
7142,0.7145,6,1,6,673260,3184,117946,8310,0.02521860347231023,0.7229859056899252
7143,0.7146,12,0,12,673260,3184,117958,8298,0.02521860347231023,0.7226963943563839
7144,0.7147,3,4,3,673264,3180,117961,8295,0.025186921809656572,0.722875816993464
7145,0.7148,7,5,7,673269,3175,117968,8288,0.0251473197313395,0.7230218965366833
7146,0.7149,7,7,7,673276,3168,117975,8281,0.025091876821695603,0.7232946108830466
7147,0.715,8,2,8,673278,3166,117983,8273,0.025076035990368773,0.7232275548561937
7148,0.7151,4,1,4,673279,3165,117987,8269,0.02506811557470536,0.7231939828581424
7149,0.7152,10,2,10,673281,3163,117997,8259,0.02505227474337853,0.723078270005253
7150,0.7153,6,2,6,673283,3161,118003,8253,0.025036433912051705,0.7230594007359383
7151,0.7154,4,2,4,673285,3159,118007,8249,0.025020593080724875,0.7230890603085554
7152,0.7155,4,2,4,673287,3157,118011,8245,0.02500475224939805,0.7231187510962989
7153,0.7156,6,2,6,673289,3155,118017,8239,0.02498891141807122,0.7230998771283131
7154,0.7157,8,3,8,673292,3152,118025,8231,0.024965150171080978,0.7230958446806641
7155,0.7158,6,4,6,673296,3148,118031,8225,0.02493346850842732,0.7232040798382133
7156,0.7159,8,1,8,673297,3147,118039,8217,0.02492554809276391,0.7230728616684267
7157,0.716,4,3,4,673300,3144,118043,8213,0.024901786845773665,0.7231663291362156
7158,0.7161,6,2,6,673302,3142,118049,8207,0.02488594601444684,0.7231474138690633
7159,0.7162,3,3,3,673305,3139,118052,8204,0.024862184767456597,0.723265450057304
7160,0.7163,5,6,5,673311,3133,118057,8199,0.02481466227347611,0.7235262972114367
7161,0.7164,6,0,6,673311,3133,118063,8193,0.02481466227347611,0.723379834010242
7162,0.7165,10,4,10,673315,3129,118073,8183,0.024782980610822455,0.7233910891089109
7163,0.7166,3,3,3,673318,3126,118076,8180,0.024759219363832213,0.7235096408986379
7164,0.7167,4,7,4,673325,3119,118080,8176,0.024703776454188316,0.7238601150951749
7165,0.7168,4,2,4,673327,3117,118084,8172,0.02468793562286149,0.7238905128886527
7166,0.7169,4,1,4,673328,3116,118088,8168,0.024680015207198074,0.7238567883729174
7167,0.717,7,3,7,673331,3113,118095,8161,0.024656253960207833,0.7238779492637928
7168,0.7171,6,3,6,673334,3110,118101,8155,0.024632492713217588,0.7239236573457613
7169,0.7172,5,4,5,673338,3106,118106,8150,0.024600811050563935,0.7240582800284293
7170,0.7173,5,2,5,673340,3104,118111,8145,0.024584970219237105,0.7240643612765579
7171,0.7174,7,2,7,673342,3102,118118,8138,0.02456912938791028,0.7240213523131672
7172,0.7175,1,1,1,673343,3101,118119,8137,0.024561208972246864,0.7240612208578039
7173,0.7176,6,3,6,673346,3098,118125,8131,0.024537447725256623,0.7241072223706474
7174,0.7177,4,2,4,673348,3096,118129,8127,0.024521606893929793,0.7241379310344828
7175,0.7178,6,2,6,673350,3094,118135,8121,0.024505766062602966,0.7241194828354882
7176,0.7179,4,4,4,673354,3090,118139,8117,0.02447408439994931,0.7242794681895244
7177,0.718,3,4,3,673358,3086,118142,8114,0.024442402737295654,0.7244642857142857
7178,0.7181,7,3,7,673361,3083,118149,8107,0.024418641490305412,0.7244861483467382
7179,0.7182,4,4,4,673365,3079,118153,8103,0.024386959827651756,0.7246467537113218
7180,0.7183,6,1,6,673366,3078,118159,8097,0.02437903941198834,0.7245637583892618
7181,0.7184,7,0,7,673366,3078,118166,8090,0.02437903941198834,0.72439111747851
7182,0.7185,5,7,5,673373,3071,118171,8085,0.024323596502344443,0.7247221226245967
7183,0.7186,7,2,7,673375,3069,118178,8078,0.024307755671017613,0.724679285906522
7184,0.7187,5,3,5,673378,3066,118183,8073,0.024283994424027372,0.7247508753029895
7185,0.7188,10,2,10,673380,3064,118193,8063,0.024268153592700546,0.7246337737036038
7186,0.7189,4,5,4,673385,3059,118197,8059,0.024228551514383474,0.7248605864364094
7187,0.719,4,2,4,673387,3057,118201,8055,0.024212710683056648,0.7248920086393088
7188,0.7191,11,1,11,673388,3056,118212,8044,0.024204790267393233,0.7246846846846847
7189,0.7192,4,0,4,673388,3056,118216,8040,0.024204790267393233,0.7245854361932228
7190,0.7193,3,2,3,673390,3054,118219,8037,0.024188949436066406,0.72464160129835
7191,0.7194,7,5,7,673395,3049,118226,8030,0.024149347357749335,0.724794656557451
7192,0.7195,6,3,6,673398,3046,118232,8024,0.024125586110759094,0.7248419150858175
7193,0.7196,7,1,7,673399,3045,118239,8017,0.02411766569509568,0.7247333212800579
7194,0.7197,3,2,3,673401,3043,118242,8014,0.02410182486376885,0.7247897259654518
7195,0.7198,3,2,3,673403,3041,118245,8011,0.024085984032442023,0.7248461816865726
7196,0.7199,14,0,14,673403,3041,118259,7997,0.024085984032442023,0.724497191520203
7197,0.72,5,2,5,673405,3039,118264,7992,0.024070143201115196,0.7245036714713081
7198,0.7201,2,3,2,673408,3036,118266,7990,0.02404638195412495,0.7246508253219662
7199,0.7202,4,2,4,673410,3034,118270,7986,0.024030541122798125,0.7246823956442832
7200,0.7203,5,2,5,673412,3032,118275,7981,0.024014700291471295,0.7246890039044765
7201,0.7204,6,6,6,673418,3026,118281,7975,0.023967177797490812,0.7249340969002818
7202,0.7205,7,4,7,673422,3022,118288,7968,0.023935496134837156,0.7250227479526843
7203,0.7206,5,4,5,673426,3018,118293,7963,0.0239038144721835,0.7251616428376286
7204,0.7207,5,5,5,673431,3013,118298,7958,0.023864212393866432,0.7253668763102725
7205,0.7208,3,3,3,673434,3010,118301,7955,0.023840451146876187,0.7254901960784313
7206,0.7209,6,2,6,673436,3008,118307,7949,0.02382461031554936,0.7254723008122661
7207,0.721,7,4,7,673440,3004,118314,7942,0.023792928652895704,0.7255618490772885
7208,0.7211,9,1,9,673441,3003,118323,7933,0.02378500823723229,0.7254023408924652
7209,0.7212,3,3,3,673444,3000,118326,7930,0.023761246990242048,0.7255260750228728
7210,0.7213,5,2,5,673446,2998,118331,7925,0.02374540615891522,0.725533278403369
7211,0.7214,6,3,6,673449,2995,118337,7919,0.023721644911924977,0.7255818215136521
7212,0.7215,7,2,7,673451,2993,118344,7912,0.02370580408059815,0.7255387436955525
7213,0.7216,6,2,6,673453,2991,118350,7906,0.02368996324927132,0.7255207855373038
7214,0.7217,5,2,5,673455,2989,118355,7901,0.023674122417944494,0.7255280073461892
7215,0.7218,5,3,5,673458,2986,118360,7896,0.023650361170954252,0.7256019114133432
7216,0.7219,5,3,5,673461,2983,118365,7891,0.02362659992396401,0.725675924222917
7217,0.722,8,4,8,673465,2979,118373,7883,0.023594918261310355,0.7257411158166084
7218,0.7221,6,5,6,673470,2974,118379,7877,0.023555316182993283,0.725923877983596
7219,0.7222,5,3,5,673473,2971,118384,7872,0.023531554936003042,0.7259983399428203
7220,0.7223,5,2,5,673475,2969,118389,7867,0.023515714104676212,0.7260059062384644
7221,0.7224,7,3,7,673478,2966,118396,7860,0.02349195285768597,0.7260299279512286
7222,0.7225,9,5,9,673483,2961,118405,7851,0.0234523507793689,0.7261376248612652
7223,0.7226,10,2,10,673485,2959,118415,7841,0.023436509948042073,0.7260185185185185
7224,0.7227,5,2,5,673487,2957,118420,7836,0.023420669116715247,0.7260261280459557
7225,0.7228,8,1,8,673488,2956,118428,7828,0.023412748701051832,0.7258902077151336
7226,0.7229,5,3,5,673491,2953,118433,7823,0.02338898745406159,0.7259651076466221
7227,0.723,10,3,10,673494,2950,118443,7813,0.023365226207071346,0.7259128495772554
7228,0.7231,9,1,9,673495,2949,118452,7804,0.023357305791407934,0.7257509532223565
7229,0.7232,4,2,4,673497,2947,118456,7800,0.023341464960081104,0.7257839397041035
7230,0.7233,7,4,7,673501,2943,118463,7793,0.023309783297427448,0.7258755588673621
7231,0.7234,5,2,5,673503,2941,118468,7788,0.02329394246610062,0.7258831205144934
7232,0.7235,2,5,2,673508,2936,118470,7786,0.02325434038778355,0.7261704905801156
7233,0.7236,5,4,5,673512,2932,118475,7781,0.023222658725129894,0.7263138243255858
7234,0.7237,1,3,1,673515,2929,118476,7780,0.023198897478139652,0.7264917359230554
7235,0.7238,6,3,6,673518,2926,118482,7774,0.02317513623114941,0.7265420560747664
7236,0.7239,4,2,4,673520,2924,118486,7770,0.02315929539982258,0.7265756498971386
7237,0.724,10,0,10,673520,2924,118496,7760,0.02315929539982258,0.7263197304380382
7238,0.7241,7,5,7,673525,2919,118503,7753,0.023119693321505513,0.7264805097451275
7239,0.7242,2,4,2,673529,2915,118505,7751,0.023088011658851857,0.7267016688543034
7240,0.7243,0,2,0,673531,2913,118505,7751,0.023072170827525027,0.7268379594898725
7241,0.7244,3,1,3,673532,2912,118508,7748,0.023064250411861616,0.7268292682926829
7242,0.7245,0,3,0,673535,2909,118508,7748,0.02304048916487137,0.7270338744487191
7243,0.7246,4,2,4,673537,2907,118512,7744,0.023024648333544544,0.7270678809501455
7244,0.7247,7,2,7,673539,2905,118519,7737,0.023008807502217718,0.727024995301635
7245,0.7248,7,1,7,673540,2904,118526,7730,0.023000887086554303,0.7269136731239421
7246,0.7249,6,2,6,673542,2902,118532,7724,0.022985046255227473,0.7268962921136835
7247,0.725,2,3,2,673545,2899,118534,7722,0.022961285008237232,0.7270501835985312
7248,0.7251,3,7,3,673552,2892,118537,7719,0.022905842098593334,0.7274526434831778
7249,0.7252,5,2,5,673554,2890,118542,7714,0.022890001267266508,0.7274613353451528
7250,0.7253,5,2,5,673556,2888,118547,7709,0.022874160435939678,0.7274700386901953
7251,0.7254,4,2,4,673558,2886,118551,7705,0.02285831960461285,0.7275044849400434
7252,0.7255,3,3,3,673561,2883,118554,7702,0.022834558357622606,0.7276334435521965
7253,0.7256,1,0,1,673561,2883,118555,7701,0.022834558357622606,0.7276077097505669
7254,0.7257,6,3,6,673564,2880,118561,7695,0.022810797110632365,0.7276595744680852
7255,0.7258,5,1,5,673565,2879,118566,7690,0.022802876694968954,0.7275995836881446
7256,0.7259,6,2,6,673567,2877,118572,7684,0.022787035863642124,0.7275826152826437
7257,0.726,3,3,3,673570,2874,118575,7681,0.022763274616651882,0.7277119848413074
7258,0.7261,5,1,5,673571,2873,118580,7676,0.022755354200988467,0.7276519101336619
7259,0.7262,8,3,8,673574,2870,118588,7668,0.022731592953998226,0.7276523059404062
7260,0.7263,6,2,6,673576,2868,118594,7662,0.022715752122671396,0.7276353276353277
7261,0.7264,11,2,11,673578,2866,118605,7651,0.02269991129134457,0.727488827612437
7262,0.7265,3,1,3,673579,2865,118608,7648,0.022691990875681155,0.7274802625321031
7263,0.7266,5,3,5,673582,2862,118613,7643,0.022668229628690913,0.7275583055687768
7264,0.7267,6,4,6,673586,2858,118619,7637,0.022636547966037257,0.7276798475464507
7265,0.7268,3,3,3,673589,2855,118622,7634,0.022612786719047016,0.7278100867575555
7266,0.7269,6,4,6,673593,2851,118628,7628,0.02258110505639336,0.7279320545853611
7267,0.727,4,3,4,673596,2848,118632,7624,0.022557343809403118,0.7280366692131398
7268,0.7271,3,3,3,673599,2845,118635,7621,0.022533582562412877,0.7281673991974011
7269,0.7272,5,2,5,673601,2843,118640,7616,0.022517741731086047,0.7281766899321159
7270,0.7273,3,3,3,673604,2840,118643,7613,0.022493980484095805,0.7283076628719029
7271,0.7274,6,6,6,673610,2834,118649,7607,0.022446457990115323,0.728570060339048
7272,0.7275,4,5,4,673615,2829,118653,7603,0.02240685591179825,0.7288151840490797
7273,0.7276,2,0,2,673615,2829,118655,7601,0.02240685591179825,0.7287631831255992
7274,0.7277,5,2,5,673617,2827,118660,7596,0.02239101508047142,0.7287729060731075
7275,0.7278,6,4,6,673621,2823,118666,7590,0.02235933341781777,0.7288965715932008
7276,0.7279,11,3,11,673624,2820,118677,7579,0.022335572170827524,0.7288200788537359
7277,0.728,6,1,6,673625,2819,118683,7573,0.022327651755164112,0.7287336412625096
7278,0.7281,3,2,3,673627,2817,118686,7570,0.022311810923837282,0.7287956098969867
7279,0.7282,5,6,5,673633,2811,118691,7565,0.0222642884298568,0.7290863531225906
7280,0.7283,3,4,3,673637,2807,118694,7562,0.022232606767203143,0.7292892275050632
7281,0.7284,5,2,5,673639,2805,118699,7557,0.022216765935876313,0.7292993630573248
7282,0.7285,8,4,8,673643,2801,118707,7549,0.022185084273222657,0.7293719806763285
7283,0.7286,12,2,12,673645,2799,118719,7537,0.02216924344189583,0.7291989164086687
7284,0.7287,6,10,6,673655,2789,118725,7531,0.02209003928526169,0.7297480620155039
7285,0.7288,9,5,9,673660,2784,118734,7522,0.02205043720694462,0.7298660974189792
7286,0.7289,6,3,6,673663,2781,118740,7516,0.02202667595995438,0.7299213363115471
7287,0.729,4,5,4,673668,2776,118744,7512,0.021987073881637308,0.7301710730948678
7288,0.7291,9,2,9,673670,2774,118753,7503,0.02197123305031048,0.7300768706821057
7289,0.7292,8,2,8,673672,2772,118761,7495,0.02195539221898365,0.7300087659491575
7290,0.7293,4,4,4,673676,2768,118765,7491,0.021923710556329995,0.7301881274978068
7291,0.7294,3,4,3,673680,2764,118768,7488,0.02189202889367634,0.7303940694498634
7292,0.7295,6,1,6,673681,2763,118774,7482,0.021884108478012927,0.730307467057101
7293,0.7296,9,0,9,673681,2763,118783,7473,0.021884108478012927,0.7300703399765534
7294,0.7297,4,9,4,673690,2754,118787,7469,0.0218128247370422,0.7306074537806906
7295,0.7298,7,3,7,673693,2751,118794,7462,0.021789063490051958,0.7306374228923921
7296,0.7299,2,4,2,673697,2747,118796,7460,0.021757381827398302,0.7308709709023219
7297,0.73,1,2,1,673699,2745,118797,7459,0.021741540996071475,0.7309878479027833
7298,0.7301,9,2,9,673701,2743,118806,7450,0.021725700164744646,0.7308937506131659
7299,0.7302,8,3,8,673704,2740,118814,7442,0.021701938917754404,0.7308976625417404
7300,0.7303,5,1,5,673705,2739,118819,7437,0.02169401850209099,0.7308372641509434
7301,0.7304,4,4,4,673709,2735,118823,7433,0.021662336839437333,0.7310188827694729
7302,0.7305,3,5,3,673714,2730,118826,7430,0.021622734761120265,0.7312992125984252
7303,0.7306,9,2,9,673716,2728,118835,7421,0.021606893929793435,0.7312050448320031
7304,0.7307,3,1,3,673717,2727,118838,7418,0.02159897351413002,0.7311976343026121
7305,0.7308,7,4,7,673721,2723,118845,7411,0.021567291851476364,0.7313005723307677
7306,0.7309,4,0,4,673721,2723,118849,7407,0.021567291851476364,0.7311944718657453
7307,0.731,6,2,6,673723,2721,118855,7401,0.021551451020149538,0.7311796087729697
7308,0.7311,5,0,5,673723,2721,118860,7396,0.021551451020149538,0.7310467529900168
7309,0.7312,4,1,4,673724,2720,118864,7392,0.021543530604486123,0.7310126582278481
7310,0.7313,7,3,7,673727,2717,118871,7385,0.02151976935749588,0.7310433577509404
7311,0.7314,6,1,6,673728,2716,118877,7379,0.021511848941832466,0.7309559187716691
7312,0.7315,6,4,6,673732,2712,118883,7373,0.02148016727917881,0.7310857709469509
7313,0.7316,4,4,4,673736,2708,118887,7369,0.021448485616525154,0.731269226952466
7314,0.7317,4,0,4,673736,2708,118891,7365,0.021448485616525154,0.7311625136503525
7315,0.7318,4,3,4,673739,2705,118895,7361,0.021424724369534912,0.7312735942777667
7316,0.7319,5,1,5,673740,2704,118900,7356,0.0214168039538715,0.7312127236580517
7317,0.732,9,2,9,673742,2702,118909,7347,0.02140096312254467,0.7311175241317543
7318,0.7321,5,4,5,673746,2698,118914,7342,0.021369281459891015,0.7312749003984064
7319,0.7322,7,3,7,673749,2695,118921,7335,0.021345520212900773,0.7313060817547358
7320,0.7323,5,2,5,673751,2693,118926,7330,0.021329679381573943,0.7313179686720542
7321,0.7324,6,2,6,673753,2691,118932,7324,0.021313838550247117,0.7313030454318522
7322,0.7325,5,4,5,673757,2687,118937,7319,0.02128215688759346,0.7314611233260044
7323,0.7326,4,1,4,673758,2686,118941,7315,0.021274236471930046,0.7314268573142686
7324,0.7327,9,1,9,673759,2685,118950,7306,0.021266316056266634,0.7312581323190872
7325,0.7328,5,3,5,673762,2682,118955,7301,0.02124255480927639,0.7313432835820896
7326,0.7329,5,4,5,673766,2678,118960,7296,0.021210873146622736,0.7315019049528775
7327,0.733,6,2,6,673768,2676,118966,7290,0.021195032315295907,0.7314870559903672
7328,0.7331,4,5,4,673773,2671,118970,7286,0.021155430236978835,0.7317465099929698
7329,0.7332,8,4,8,673777,2667,118978,7278,0.02112374857432518,0.7318250377073906
7330,0.7333,5,4,5,673781,2663,118983,7273,0.021092066911671526,0.7319847020933977
7331,0.7334,6,2,6,673783,2661,118989,7267,0.021076226080344696,0.7319701853344077
7332,0.7335,3,3,3,673786,2658,118992,7264,0.021052464833354455,0.7321104616004838
7333,0.7336,8,2,8,673788,2656,119000,7256,0.021036624002027625,0.7320419693301049
7334,0.7337,10,2,10,673790,2654,119010,7246,0.0210207831707008,0.731919191919192
7335,0.7338,5,2,5,673792,2652,119015,7241,0.021004942339373972,0.7319316688567674
7336,0.7339,4,5,4,673797,2647,119019,7237,0.0209653402610569,0.7321934439498179
7337,0.734,6,3,6,673800,2644,119025,7231,0.02094157901406666,0.732253164556962
7338,0.7341,4,0,4,673800,2644,119029,7227,0.02094157901406666,0.7321446661939013
7339,0.7342,4,3,4,673803,2641,119033,7223,0.020917817767076415,0.7322587185725872
7340,0.7343,9,3,9,673806,2638,119042,7214,0.020894056520086173,0.7322371092164027
7341,0.7344,4,2,4,673808,2636,119046,7210,0.020878215688759347,0.7322770668291692
7342,0.7345,6,4,6,673812,2632,119052,7204,0.02084653402610569,0.7324115494103294
7343,0.7346,13,2,13,673814,2630,119065,7191,0.02083069319477886,0.7322064962834742
7344,0.7347,6,3,6,673817,2627,119071,7185,0.02080693194778862,0.7322666123114554
7345,0.7348,10,6,10,673823,2621,119081,7175,0.020759409453808136,0.7324418129848917
7346,0.7349,8,4,8,673827,2617,119089,7167,0.02072772779115448,0.7325224856909239
7347,0.735,8,0,8,673827,2617,119097,7159,0.02072772779115448,0.7323036006546645
7348,0.7351,5,5,5,673832,2612,119102,7154,0.02068812571283741,0.7325414704075364
7349,0.7352,4,2,4,673834,2610,119106,7150,0.020672284881510582,0.7325819672131147
7350,0.7353,6,2,6,673836,2608,119112,7144,0.020656444050183752,0.7325676784249385
7351,0.7354,2,3,2,673839,2605,119114,7142,0.02063268280319351,0.7327382784446497
7352,0.7355,6,3,6,673842,2602,119120,7136,0.02060892155620327,0.7327993427808585
7353,0.7356,4,2,4,673844,2600,119124,7132,0.02059308072487644,0.7328401150842582
7354,0.7357,4,2,4,673846,2598,119128,7128,0.020577239893549613,0.7328809376927823
7355,0.7358,6,6,6,673852,2592,119134,7122,0.02052971739956913,0.7331686226065472
7356,0.7359,5,2,5,673854,2590,119139,7117,0.0205138765682423,0.7331822396208921
7357,0.736,2,3,2,673857,2587,119141,7115,0.02049011532125206,0.7333539476396619
7358,0.7361,2,2,2,673859,2585,119143,7113,0.020474274489925233,0.7334501959166838
7359,0.7362,2,5,2,673864,2580,119145,7111,0.02043467241160816,0.7337736043751935
7360,0.7363,8,2,8,673866,2578,119153,7103,0.020418831580281332,0.7337051957442413
7361,0.7364,3,4,3,673870,2574,119156,7100,0.020387149917627675,0.7339259871821376
7362,0.7365,6,1,6,673871,2573,119162,7094,0.020379229501964264,0.7338367642495086
7363,0.7366,4,3,4,673874,2570,119166,7090,0.020355468254974023,0.7339544513457557
7364,0.7367,5,2,5,673876,2568,119171,7085,0.020339627423647193,0.733968714389309
7365,0.7368,3,4,3,673880,2564,119174,7082,0.020307945760993536,0.7341903379639229
7366,0.7369,3,1,3,673881,2563,119177,7079,0.02030002534533012,0.7341837792989007
7367,0.737,4,2,4,673883,2561,119181,7075,0.020284184514003295,0.7342258198422582
7368,0.7371,6,1,6,673884,2560,119187,7069,0.02027626409833988,0.7341364627687195
7369,0.7372,4,4,4,673888,2556,119191,7065,0.020244582435686224,0.7343311506080449
7370,0.7373,10,3,10,673891,2553,119201,7055,0.020220821188695982,0.7342839300582847
7371,0.7374,9,3,9,673894,2550,119210,7046,0.02019705994170574,0.7342642767819925
7372,0.7375,3,3,3,673897,2547,119213,7043,0.0201732986947155,0.7344108446298228
7373,0.7376,4,4,4,673901,2543,119217,7039,0.020141617032061843,0.7346065539553329
7374,0.7377,3,3,3,673904,2540,119220,7036,0.020117855785071602,0.7347535505430243
7375,0.7378,5,4,5,673908,2536,119225,7031,0.020086174122417946,0.7349221281488449
7376,0.7379,3,1,3,673909,2535,119228,7028,0.02007825370675453,0.7349158213949597
7377,0.738,4,2,4,673911,2533,119232,7024,0.0200624128754277,0.7349586690384011
7378,0.7381,7,3,7,673914,2530,119239,7017,0.02003865162843746,0.7349952864774275
7379,0.7382,6,2,6,673916,2528,119245,7011,0.020022810797110633,0.7349827025893699
7380,0.7383,5,3,5,673919,2525,119250,7006,0.01999904955012039,0.7350750183611373
7381,0.7384,7,1,7,673920,2524,119257,6999,0.019991129134456977,0.7349574713850677
7382,0.7385,8,2,8,673922,2522,119265,6991,0.019975288303130147,0.7348890991275098
7383,0.7386,3,3,3,673925,2519,119268,6988,0.019951527056139905,0.7350373409067004
7384,0.7387,7,4,7,673929,2515,119275,6981,0.01991984539348625,0.7351516427969671
7385,0.7388,4,4,4,673933,2511,119279,6977,0.019888163730832593,0.7353499156829679
7386,0.7389,10,5,10,673938,2506,119289,6967,0.019848561652515525,0.7354586720152011
7387,0.739,3,2,3,673940,2504,119292,6964,0.019832720821188695,0.7355302070130968
7388,0.7391,2,1,2,673941,2503,119294,6962,0.019824800405525284,0.7355520338087691
7389,0.7392,5,5,5,673946,2498,119299,6957,0.019785198327208212,0.7358011634056055
7390,0.7393,7,2,7,673948,2496,119306,6950,0.019769357495881382,0.7357611687486767
7391,0.7394,5,0,5,673948,2496,119311,6945,0.019769357495881382,0.7356212265649825
7392,0.7395,5,1,5,673949,2495,119316,6940,0.01976143708021797,0.735559088500265
7393,0.7396,2,2,2,673951,2493,119318,6938,0.01974559624889114,0.7356589969250344
7394,0.7397,1,1,1,673952,2492,119319,6937,0.019737675833227726,0.7357089829250185
7395,0.7398,8,1,8,673953,2491,119327,6929,0.019729755417564315,0.7355626326963907
7396,0.7399,6,0,6,673953,2491,119333,6923,0.019729755417564315,0.735394093902698
7397,0.74,5,1,5,673954,2490,119338,6918,0.0197218350019009,0.7353316326530612
7398,0.7401,6,1,6,673955,2489,119344,6912,0.019713914586237485,0.7352409318157643
7399,0.7402,4,3,4,673958,2486,119348,6908,0.019690153339247243,0.7353629976580797
7400,0.7403,7,0,7,673958,2486,119355,6901,0.019690153339247243,0.7351656546287418
7401,0.7404,10,3,10,673961,2483,119365,6891,0.019666392092257002,0.7351184126306806
7402,0.7405,7,3,7,673964,2480,119372,6884,0.01964263084526676,0.7351559162750961
7403,0.7406,5,4,5,673968,2476,119377,6879,0.019610949182613104,0.7353287012292892
7404,0.7407,2,1,2,673969,2475,119379,6877,0.01960302876694969,0.7353507271171942
7405,0.7408,11,3,11,673972,2472,119390,6866,0.019579267519959448,0.7352752195330906
7406,0.7409,2,2,2,673974,2470,119392,6864,0.019563426688632618,0.7353760445682451
7407,0.741,5,0,5,673974,2470,119397,6859,0.019563426688632618,0.7352342158859471
7408,0.7411,12,3,12,673977,2467,119409,6847,0.019539665441642377,0.7351299119604896
7409,0.7412,5,2,5,673979,2465,119414,6842,0.01952382461031555,0.735145589341356
7410,0.7413,3,2,3,673981,2463,119417,6839,0.01950798377898872,0.7352182326381423
7411,0.7414,5,2,5,673983,2461,119422,6834,0.019492142947661894,0.7352339967724583
7412,0.7415,4,1,4,673984,2460,119426,6830,0.01948422253199848,0.7351991388589881
7413,0.7416,5,3,5,673987,2457,119431,6825,0.019460461285008238,0.7352941176470589
7414,0.7417,3,2,3,673989,2455,119434,6822,0.019444620453681408,0.7353670367575725
7415,0.7418,2,4,2,673993,2451,119436,6820,0.019412938791027755,0.7356272246791069
7416,0.7419,3,2,3,673995,2449,119439,6817,0.019397097959700925,0.7357004101014462
7417,0.742,4,6,4,674001,2443,119443,6813,0.019349575465720442,0.7360630942091616
7418,0.7421,6,2,6,674003,2441,119449,6807,0.019333734634393612,0.7360510380622838
7419,0.7422,4,2,4,674005,2439,119453,6803,0.019317893803066786,0.7360960830988963
7420,0.7423,10,1,10,674006,2438,119463,6793,0.01930997338740337,0.7358899360849313
7421,0.7424,5,2,5,674008,2436,119468,6788,0.019294132556076544,0.735906331309627
7422,0.7425,5,3,5,674011,2433,119473,6783,0.0192703713090863,0.7360026041666666
7423,0.7426,1,3,1,674014,2430,119474,6782,0.019246610062096058,0.7362136343899262
7424,0.7427,7,3,7,674017,2427,119481,6775,0.019222848815105817,0.736252988480765
7425,0.7428,6,6,6,674023,2421,119487,6769,0.019175326321125334,0.7365614798694233
7426,0.7429,7,2,7,674025,2419,119494,6762,0.019159485489798504,0.7365210761354972
7427,0.743,3,4,3,674029,2415,119497,6759,0.019127803827144848,0.73675604970569
7428,0.7431,3,1,3,674030,2414,119500,6756,0.019119883411481433,0.7367502726281352
7429,0.7432,5,4,5,674034,2410,119505,6751,0.01908820174882778,0.7369282829385438
7430,0.7433,6,1,6,674035,2409,119511,6745,0.019080281333164365,0.736836355691501
7431,0.7434,2,2,2,674037,2407,119513,6743,0.019064440501837535,0.7369398907103825
7432,0.7435,3,3,3,674040,2404,119516,6740,0.019040679254847294,0.7370953630796151
7433,0.7436,5,3,5,674043,2401,119521,6735,0.019016918007857053,0.7371935201401051
7434,0.7437,3,8,3,674051,2393,119524,6732,0.01895355468254974,0.7377534246575342
7435,0.7438,6,0,6,674051,2393,119530,6726,0.01895355468254974,0.7375808750959535
7436,0.7439,5,0,5,674051,2393,119535,6721,0.01895355468254974,0.7374369102479702
7437,0.744,4,2,4,674053,2391,119539,6717,0.018937713851222913,0.7374835309617919
7438,0.7441,7,1,7,674054,2390,119546,6710,0.0189297934355595,0.7373626373626374
7439,0.7442,5,5,5,674059,2385,119551,6705,0.018890191357242427,0.7376237623762376
7440,0.7443,2,3,2,674062,2382,119553,6703,0.018866430110252186,0.7378095762245459
7441,0.7444,6,3,6,674065,2379,119559,6697,0.018842668863261944,0.7378801234023799
7442,0.7445,7,5,7,674070,2374,119566,6690,0.018803066784944873,0.7380847308031774
7443,0.7446,5,1,5,674071,2373,119571,6685,0.018795146369281458,0.7380216383307573
7444,0.7447,9,2,9,674073,2371,119580,6676,0.018779305537954632,0.7379241737592572
7445,0.7448,5,5,5,674078,2366,119585,6671,0.01873970345963756,0.7381874515879163
7446,0.7449,3,3,3,674081,2363,119588,6668,0.01871594221264732,0.7383456981508139
7447,0.745,10,1,10,674082,2362,119598,6658,0.018708021796983904,0.7381374722838138
7448,0.7451,4,0,4,674082,2362,119602,6654,0.018708021796983904,0.7380212954747116
7449,0.7452,4,1,4,674083,2361,119606,6650,0.018700101381320493,0.7379869048940184
7450,0.7453,8,3,8,674086,2358,119614,6642,0.018676340134330248,0.738
7451,0.7454,9,6,9,674092,2352,119623,6633,0.018628817640349765,0.7382303839732888
7452,0.7455,5,2,5,674094,2350,119628,6628,0.01861297680902294,0.7382490532412564
7453,0.7456,5,2,5,674096,2348,119633,6623,0.01859713597769611,0.7382677516441868
7454,0.7457,10,1,10,674097,2347,119643,6613,0.018589215562032694,0.7380580357142857
7455,0.7458,5,4,5,674101,2343,119648,6608,0.01855753389937904,0.7382415372584069
7456,0.7459,3,7,3,674108,2336,119651,6605,0.01850209098973514,0.7387316854937926
7457,0.746,3,0,3,674108,2336,119654,6602,0.01850209098973514,0.7386439919445066
7458,0.7461,12,1,12,674109,2335,119666,6590,0.01849417057407173,0.7383753501400561
7459,0.7462,1,1,1,674110,2334,119667,6589,0.018486250158408313,0.7384287795584444
7460,0.7463,8,2,8,674112,2332,119675,6581,0.018470409327081484,0.7383596993156064
7461,0.7464,11,1,11,674113,2331,119686,6570,0.018462488911418072,0.7381193124368048
7462,0.7465,6,3,6,674116,2328,119692,6564,0.01843872766442783,0.738191632928475
7463,0.7466,5,2,5,674118,2326,119697,6559,0.018422886833101,0.7382104670793472
7464,0.7467,4,2,4,674120,2324,119701,6555,0.018407046001774174,0.7382588129293839
7465,0.7468,2,4,2,674124,2320,119703,6553,0.018375364339120518,0.7385326270708892
7466,0.7469,2,3,2,674127,2317,119705,6551,0.018351603092130277,0.73872350022553
7467,0.747,4,1,4,674128,2316,119709,6547,0.018343682676466862,0.7386889315130317
7468,0.7471,4,2,4,674130,2314,119713,6543,0.018327841845140032,0.7387377215761545
7469,0.7472,4,1,4,674131,2313,119717,6539,0.01831992142947662,0.7387031179394488
7470,0.7473,6,1,6,674132,2312,119723,6533,0.018312001013813205,0.7386093838326738
7471,0.7474,8,2,8,674134,2310,119731,6525,0.018296160182486376,0.7385398981324278
7472,0.7475,6,5,6,674139,2305,119737,6519,0.018256558104169308,0.7387805983680871
7473,0.7476,8,5,8,674144,2300,119745,6511,0.018216956025852236,0.7389626603109749
7474,0.7477,4,2,4,674146,2298,119749,6507,0.01820111519452541,0.7390119250425894
7475,0.7478,4,2,4,674148,2296,119753,6503,0.01818527436319858,0.7390612569610183
7476,0.7479,6,2,6,674150,2294,119759,6497,0.018169433531871754,0.7390513024684336
7477,0.748,4,2,4,674152,2292,119763,6493,0.018153592700544924,0.7391007398975526
7478,0.7481,5,2,5,674154,2290,119768,6488,0.018137751869218097,0.7391205285942128
7479,0.7482,4,8,4,674162,2282,119772,6484,0.018074388543910785,0.7396760209901894
7480,0.7483,4,2,4,674164,2280,119776,6480,0.018058547712583955,0.7397260273972602
7481,0.7484,2,0,2,674164,2280,119778,6478,0.018058547712583955,0.7396665905457868
7482,0.7485,3,2,3,674166,2278,119781,6475,0.01804270688125713,0.7397463726722266
7483,0.7486,5,2,5,674168,2276,119786,6470,0.018026866049930302,0.7397667505145209
7484,0.7487,4,2,4,674170,2274,119790,6466,0.018011025218603472,0.7398169336384439
7485,0.7488,5,1,5,674171,2273,119795,6461,0.018003104802940057,0.7397526906343027
7486,0.7489,4,7,4,674178,2266,119799,6457,0.01794766189329616,0.7402269861286255
7487,0.749,6,2,6,674180,2264,119805,6451,0.017931821061969333,0.74021801491681
7488,0.7491,3,4,3,674184,2260,119808,6448,0.017900139399315677,0.7404685346807534
7489,0.7492,9,2,9,674186,2258,119817,6439,0.017884298567988847,0.740370242612395
7490,0.7493,3,3,3,674189,2255,119820,6436,0.017860537320998605,0.7405361868599701
7491,0.7494,8,2,8,674191,2253,119828,6428,0.01784469648967178,0.7404676880543716
7492,0.7495,4,3,4,674194,2250,119832,6424,0.017820935242681538,0.7406041042195066
7493,0.7496,5,2,5,674196,2248,119837,6419,0.017805094411354708,0.7406253605630553
7494,0.7497,5,1,5,674197,2247,119842,6414,0.017797173995691293,0.740561136127468
7495,0.7498,8,3,8,674200,2244,119850,6406,0.01777341274870105,0.7405780346820809
7496,0.7499,8,2,8,674202,2242,119858,6398,0.017757571917374225,0.7405092592592593
7497,0.75,4,3,4,674205,2239,119862,6394,0.01773381067038398,0.7406463570022008
7498,0.7501,5,0,5,674205,2239,119867,6389,0.01773381067038398,0.7404960593416783
7499,0.7502,3,2,3,674207,2237,119870,6386,0.017717969839057154,0.7405775252232402
7500,0.7503,7,0,7,674207,2237,119877,6379,0.017717969839057154,0.7403667595171773
7501,0.7504,4,3,4,674210,2234,119881,6375,0.017694208592066912,0.7405041235915902
7502,0.7505,6,5,6,674215,2229,119887,6369,0.01765460651374984,0.7407536636427076
7503,0.7506,6,1,6,674216,2228,119893,6363,0.017646686098086426,0.7406588290071004
7504,0.7507,11,4,11,674220,2224,119904,6352,0.01761500443543277,0.7406716417910447
7505,0.7508,7,6,7,674226,2218,119911,6345,0.017567481941452287,0.7409786289851688
7506,0.7509,10,1,10,674227,2217,119921,6335,0.017559561525788872,0.7407623947614593
7507,0.751,6,2,6,674229,2215,119927,6329,0.017543720694462046,0.740753745318352
7508,0.7511,6,3,6,674232,2212,119933,6323,0.017519959447471804,0.7408318687756298
7509,0.7512,8,2,8,674234,2210,119941,6315,0.017504118616144974,0.7407624633431085
7510,0.7513,4,2,4,674236,2208,119945,6311,0.017488277784818148,0.7408146496067614
7511,0.7514,6,1,6,674237,2207,119951,6305,0.017480357369154733,0.7407189849624061
7512,0.7515,5,1,5,674238,2206,119956,6300,0.017472436953491318,0.7406536562426522
7513,0.7516,6,0,6,674238,2206,119962,6294,0.017472436953491318,0.7404705882352941
7514,0.7517,3,2,3,674240,2204,119965,6291,0.01745659612216449,0.7405532666274279
7515,0.7518,8,3,8,674243,2201,119973,6283,0.01743283487517425,0.7405704856199906
7516,0.7519,5,1,5,674244,2200,119978,6278,0.017424914459510835,0.7405048360462373
7517,0.752,2,3,2,674247,2197,119980,6276,0.017401153212520594,0.7407057712734568
7518,0.7521,2,5,2,674252,2192,119982,6274,0.017361551134203523,0.7410819749586581
7519,0.7522,2,4,2,674256,2188,119984,6272,0.017329869471549866,0.741371158392435
7520,0.7523,2,1,2,674257,2187,119986,6270,0.01732194905588645,0.7413976587442356
7521,0.7524,4,2,4,674259,2185,119990,6266,0.017306108224559625,0.7414507158916105
7522,0.7525,6,1,6,674260,2184,119996,6260,0.01729818780889621,0.7413548081477973
7523,0.7526,8,4,8,674264,2180,120004,6252,0.017266506146242554,0.74146110056926
7524,0.7527,8,0,8,674264,2180,120012,6244,0.017266506146242554,0.7412155745489079
7525,0.7528,5,1,5,674265,2179,120017,6239,0.017258585730579142,0.7411499168448563
7526,0.7529,4,2,4,674267,2177,120021,6235,0.017242744899252312,0.7412030432715169
7527,0.753,11,5,11,674272,2172,120032,6224,0.01720314282093524,0.74130538351596
7528,0.7531,8,3,8,674275,2169,120040,6216,0.017179381573945,0.7413237924865832
7529,0.7532,5,2,5,674277,2167,120045,6211,0.017163540742618173,0.7413463833850561
7530,0.7533,6,3,6,674280,2164,120051,6205,0.017139779495627932,0.7414266937507468
7531,0.7534,3,2,3,674282,2162,120054,6202,0.017123938664301102,0.7415112386417981
7532,0.7535,4,2,4,674284,2160,120058,6198,0.017108097832974276,0.741564967695621
7533,0.7536,3,3,3,674287,2157,120061,6195,0.01708433658598403,0.7417385057471264
7534,0.7537,6,2,6,674289,2155,120067,6189,0.017068495754657204,0.7417305848513902
7535,0.7538,4,5,4,674294,2150,120071,6185,0.017028893676340133,0.7420515896820636
7536,0.7539,10,0,10,674294,2150,120081,6175,0.017028893676340133,0.7417417417417418
7537,0.754,9,2,9,674296,2148,120090,6166,0.017013052845013307,0.7416406062063988
7538,0.7541,6,1,6,674297,2147,120096,6160,0.01700513242934989,0.7415432767545443
7539,0.7542,4,1,4,674298,2146,120100,6156,0.016997212013686477,0.7415080703444953
7540,0.7543,2,1,2,674299,2145,120102,6154,0.016989291598023065,0.741535124713821
7541,0.7544,7,1,7,674300,2144,120109,6147,0.01698137118235965,0.7414063442286817
7542,0.7545,7,6,7,674306,2138,120116,6140,0.016933848688379168,0.7417250543609567
7543,0.7546,10,2,10,674308,2136,120126,6130,0.016918007857052338,0.7415920638761191
7544,0.7547,3,4,3,674312,2132,120129,6127,0.01688632619439868,0.7418573677200629
7545,0.7548,5,2,5,674314,2130,120134,6122,0.016870485363071855,0.7418807561803199
7546,0.7549,4,3,4,674317,2127,120138,6118,0.016846724116081613,0.7420254699818072
7547,0.755,4,3,4,674320,2124,120142,6114,0.01682296286909137,0.7421704297159505
7548,0.7551,4,1,4,674321,2123,120146,6110,0.016815042453427957,0.7421353091218268
7549,0.7552,6,1,6,674322,2122,120152,6104,0.016807122037764542,0.7420374422562607
7550,0.7553,6,2,6,674324,2120,120158,6098,0.016791281206437712,0.7420296909223656
7551,0.7554,5,5,5,674329,2115,120163,6093,0.016751679128120645,0.7423245614035088
7552,0.7555,3,2,3,674331,2113,120166,6090,0.016735838296793815,0.7424113129342923
7553,0.7556,7,3,7,674334,2110,120173,6083,0.016712077049803573,0.7424630782375198
7554,0.7557,2,0,2,674334,2110,120175,6081,0.016712077049803573,0.7424001953363447
7555,0.7558,7,3,7,674337,2107,120182,6074,0.016688315802813332,0.7424520229800757
7556,0.7559,3,2,3,674339,2105,120185,6071,0.016672474971486502,0.7425391389432485
7557,0.756,4,0,4,674339,2105,120189,6067,0.016672474971486502,0.7424131179637787
7558,0.7561,1,5,1,674344,2100,120190,6066,0.016632872893169434,0.742836149889787
7559,0.7562,3,4,3,674348,2096,120193,6063,0.016601191230515778,0.7431057727662703
7560,0.7563,6,1,6,674349,2095,120199,6057,0.016593270814852363,0.7430078508341511
7561,0.7564,8,1,8,674350,2094,120207,6049,0.016585350399188948,0.7428466167260224
7562,0.7565,6,2,6,674352,2092,120213,6043,0.01656950956786212,0.742839582052858
7563,0.7566,5,2,5,674354,2090,120218,6038,0.01655366873653529,0.7428641732283464
7564,0.7567,1,3,1,674357,2087,120219,6037,0.01652990748954505,0.7431068439192516
7565,0.7568,6,3,6,674360,2084,120225,6031,0.01650614624255481,0.7431916204559458
7566,0.7569,4,3,4,674363,2081,120229,6027,0.016482384995564568,0.743339911198816
7567,0.757,4,2,4,674365,2079,120233,6023,0.016466544164237738,0.7433966921747717
7568,0.7571,5,4,5,674369,2075,120238,6018,0.016434862501584085,0.7436055850735204
7569,0.7572,7,6,7,674375,2069,120245,6011,0.0163873400076036,0.7439356435643565
7570,0.7573,6,1,6,674376,2068,120251,6005,0.016379419591940184,0.7438374829679177
7571,0.7574,6,2,6,674378,2066,120257,5999,0.016363578760613357,0.7438313701177929
7572,0.7575,5,2,5,674380,2064,120262,5994,0.016347737929286527,0.7438570364854803
7573,0.7576,2,2,2,674382,2062,120264,5992,0.0163318970979597,0.7439781475043457
7574,0.7577,6,2,6,674384,2060,120270,5986,0.016316056266632874,0.7439721600795426
7575,0.7578,6,4,6,674388,2056,120276,5980,0.016284374603979218,0.7441513190642111
7576,0.7579,6,2,6,674390,2054,120282,5974,0.016268533772652388,0.7441454907822621
7577,0.758,5,1,5,674391,2053,120287,5969,0.016260613356988973,0.744078783345799
7578,0.7581,6,1,6,674392,2052,120293,5963,0.016252692941325562,0.7439800374298191
7579,0.7582,8,4,8,674396,2048,120301,5955,0.016221011278671905,0.744095964013495
7580,0.7583,1,2,1,674398,2046,120302,5954,0.016205170447345076,0.74425
7581,0.7584,7,2,7,674400,2044,120309,5947,0.01618932961601825,0.7442122387686146
7582,0.7585,7,3,7,674403,2041,120316,5940,0.016165568369028008,0.7442676356346323
7583,0.7586,5,3,5,674406,2038,120321,5935,0.016141807122037763,0.7443873071616707
7584,0.7587,1,1,1,674407,2037,120322,5934,0.01613388670637435,0.7444486262702296
7585,0.7588,5,3,5,674410,2034,120327,5929,0.01611012545938411,0.7445686299133493
7586,0.7589,5,2,5,674412,2032,120332,5924,0.01609428462805728,0.7445952740070387
7587,0.759,7,3,7,674415,2029,120339,5917,0.01607052338106704,0.7446513969292726
7588,0.7591,3,1,3,674416,2028,120342,5914,0.016062602965403624,0.7446487030974566
7589,0.7592,6,3,6,674419,2025,120348,5908,0.016038841718413382,0.7447371738308333
7590,0.7593,10,4,10,674423,2021,120358,5898,0.016007160055759726,0.7447910089657785
7591,0.7594,4,0,4,674423,2021,120362,5894,0.016007160055759726,0.7446620341124447
7592,0.7595,6,0,6,674423,2021,120368,5888,0.016007160055759726,0.744468327222152
7593,0.7596,4,3,4,674426,2018,120372,5884,0.015983398808769485,0.744621614781068
7594,0.7597,6,1,6,674427,2017,120378,5878,0.01597547839310607,0.744521849271691
7595,0.7598,4,0,4,674427,2017,120382,5874,0.01597547839310607,0.7443923457103029
7596,0.7599,3,2,3,674429,2015,120385,5871,0.015959637561779243,0.7444838955110322
7597,0.76,7,1,7,674430,2014,120392,5864,0.01595171714611583,0.7443513582127443
7598,0.7601,5,3,5,674433,2011,120397,5859,0.015927955899125587,0.7444726810673443
7599,0.7602,5,3,5,674436,2008,120402,5854,0.015904194652135346,0.7445942508267617
7600,0.7603,6,3,6,674439,2005,120408,5848,0.0158804334051451,0.7446835604227684
7601,0.7604,5,1,5,674440,2004,120413,5843,0.01587251298948169,0.7446157767299605
7602,0.7605,7,1,7,674441,2003,120420,5836,0.015864592573818274,0.7444827146319684
7603,0.7606,7,5,7,674446,1998,120427,5829,0.015824990495501203,0.7447297815254887
7604,0.7607,2,2,2,674448,1996,120429,5827,0.015809149664174377,0.7448549149942477
7605,0.7608,4,3,4,674451,1993,120433,5823,0.015785388417184135,0.7450102354145343
7606,0.7609,7,1,7,674452,1992,120440,5816,0.01577746800152072,0.7448770491803278
7607,0.761,5,3,5,674455,1989,120445,5811,0.01575370675453048,0.745
7608,0.7611,4,2,4,674457,1987,120449,5807,0.01573786592320365,0.7450603027970234
7609,0.7612,3,5,3,674462,1982,120452,5804,0.01569826384488658,0.7454405342923196
7610,0.7613,14,0,14,674462,1982,120466,5790,0.01569826384488658,0.744981986618631
7611,0.7614,3,1,3,674463,1981,120469,5787,0.015690343429223166,0.744979402677652
7612,0.7615,4,5,4,674468,1976,120473,5783,0.015650741350906095,0.7453280061863642
7613,0.7616,8,3,8,674471,1973,120481,5775,0.015626980103915854,0.7453536396489416
7614,0.7617,5,3,5,674474,1970,120486,5770,0.01560321885692561,0.7454780361757106
7615,0.7618,4,1,4,674475,1969,120490,5766,0.015595298441262197,0.745442792501616
7616,0.7619,5,3,5,674478,1966,120495,5761,0.015571537194271956,0.7455674906173159
7617,0.762,2,2,2,674480,1964,120497,5759,0.015555696362945128,0.7456946782338469
7618,0.7621,6,0,6,674480,1964,120503,5753,0.015555696362945128,0.7454969547751717
7619,0.7622,5,2,5,674482,1962,120508,5748,0.0155398555316183,0.7455252918287938
7620,0.7623,5,2,5,674484,1960,120513,5743,0.015524014700291472,0.7455536803842658
7621,0.7624,3,4,3,674488,1956,120516,5740,0.015492333037637815,0.7458419958419958
7622,0.7625,3,2,3,674490,1954,120519,5737,0.015476492206310987,0.7459368092575738
7623,0.7626,7,2,7,674492,1952,120526,5730,0.015460651374984159,0.7458995053371518
7624,0.7627,2,3,2,674495,1949,120528,5728,0.015436890127993918,0.7461247883287743
7625,0.7628,8,0,8,674495,1949,120536,5720,0.015436890127993918,0.745859955665667
7626,0.7629,5,2,5,674497,1947,120541,5715,0.01542104929666709,0.7458888018794049
7627,0.763,8,2,8,674499,1945,120549,5707,0.015405208465340261,0.7458180867746994
7628,0.7631,10,2,10,674501,1943,120559,5697,0.015389367634013433,0.7456806282722513
7629,0.7632,4,1,4,674502,1942,120563,5693,0.01538144721835002,0.7456450556647021
7630,0.7633,9,1,9,674503,1941,120572,5684,0.015373526802686605,0.7454426229508196
7631,0.7634,3,0,3,674503,1941,120575,5681,0.015373526802686605,0.7453424298084492
7632,0.7635,1,3,1,674506,1938,120576,5680,0.015349765555696364,0.7456025203465476
7633,0.7636,5,0,5,674506,1938,120581,5675,0.015349765555696364,0.7454354393800079
7634,0.7637,6,3,6,674509,1935,120587,5669,0.01532600430870612,0.7455286691215149
7635,0.7638,5,2,5,674511,1933,120592,5664,0.015310163477379292,0.7455574568908779
7636,0.7639,4,2,4,674513,1931,120596,5660,0.015294322646052464,0.745619812936372
7637,0.764,9,2,9,674515,1929,120605,5651,0.015278481814725638,0.7455145118733509
7638,0.7641,9,0,9,674515,1929,120614,5642,0.015278481814725638,0.7452119931316867
7639,0.7642,6,2,6,674517,1927,120620,5636,0.01526264098339881,0.7452069284675393
7640,0.7643,5,2,5,674519,1925,120625,5631,0.015246800152071981,0.7452355743779777
7641,0.7644,5,2,5,674521,1923,120630,5626,0.015230959320745153,0.7452642734136972
7642,0.7645,5,1,5,674522,1922,120635,5621,0.015223038905081738,0.7451942198064431
7643,0.7646,3,2,3,674524,1920,120638,5618,0.01520719807375491,0.7452905279915096
7644,0.7647,7,0,7,674524,1920,120645,5611,0.01520719807375491,0.7450537777187625
7645,0.7648,3,3,3,674527,1917,120648,5608,0.015183436826764669,0.7452491694352159
7646,0.7649,5,1,5,674528,1916,120653,5603,0.015175516411101254,0.7451788801702354
7647,0.765,6,4,6,674532,1912,120659,5597,0.0151438347484476,0.7453722200026635
7648,0.7651,1,1,1,674533,1911,120660,5596,0.015135914332784184,0.7454375915811909
7649,0.7652,5,1,5,674534,1910,120665,5591,0.015127993917120771,0.7453672843620851
7650,0.7653,8,1,8,674535,1909,120673,5583,0.015120073501457356,0.7451948745328351
7651,0.7654,8,1,8,674536,1908,120681,5575,0.015112153085793943,0.7450220499799546
7652,0.7655,3,3,3,674539,1905,120684,5572,0.0150883918388037,0.7452186705898087
7653,0.7656,8,1,8,674540,1904,120692,5564,0.015080471423140287,0.7450455275843599
7654,0.7657,8,1,8,674541,1903,120700,5556,0.015072551007476872,0.7448719667515753
7655,0.7658,6,1,6,674542,1902,120706,5550,0.015064630591813458,0.7447665056360708
7656,0.7659,6,0,6,674542,1902,120712,5544,0.015064630591813458,0.7445608380338437
7657,0.766,5,2,5,674544,1900,120717,5539,0.01504878976048663,0.7445893265223821
7658,0.7661,6,1,6,674545,1899,120723,5533,0.015040869344823217,0.7444833153928956
7659,0.7662,7,1,7,674546,1898,120730,5526,0.015032948929159802,0.7443426724137931
7660,0.7663,3,3,3,674549,1895,120733,5523,0.01500918768216956,0.7445403073604745
7661,0.7664,7,2,7,674551,1893,120740,5516,0.014993346850842732,0.7444999325145094
7662,0.7665,4,4,4,674555,1889,120744,5512,0.014961665188189076,0.7447642210512093
7663,0.7666,4,9,4,674564,1880,120748,5508,0.01489038144721835,0.7455332972387656
7664,0.7667,3,1,3,674565,1879,120751,5505,0.014882461031554935,0.7455308775731311
7665,0.7668,5,3,5,674568,1876,120756,5500,0.014858699784564694,0.7456616052060737
7666,0.7669,6,0,6,674568,1876,120762,5494,0.014858699784564694,0.7454545454545455
7667,0.767,1,1,1,674569,1875,120763,5493,0.01485077936890128,0.7455211726384365
7668,0.7671,7,0,7,674569,1875,120770,5486,0.01485077936890128,0.7452791740252683
7669,0.7672,3,3,3,674572,1872,120773,5483,0.014827018121911038,0.7454792658055744
7670,0.7673,5,2,5,674574,1870,120778,5478,0.01481117729058421,0.7455089820359282
7671,0.7674,6,0,6,674574,1870,120784,5472,0.01481117729058421,0.7453010078997548
7672,0.7675,8,1,8,674575,1869,120792,5464,0.014803256874920796,0.7451247783990181
7673,0.7676,5,1,5,674576,1868,120797,5459,0.014795336459257381,0.745052545380101
7674,0.7677,2,2,2,674578,1866,120799,5457,0.014779495627930553,0.7451863990167964
7675,0.7678,7,3,7,674581,1863,120806,5450,0.014755734380940312,0.7452481881580747
7676,0.7679,5,1,5,674582,1862,120811,5445,0.014747813965276899,0.7451758587655672
7677,0.768,3,1,3,674583,1861,120814,5442,0.014739893549613484,0.7451732164863755
7678,0.7681,5,4,5,674587,1857,120819,5437,0.014708211886959827,0.7454071839868385
7679,0.7682,6,3,6,674590,1854,120825,5431,0.014684450639969586,0.7455044612216885
7680,0.7683,4,2,4,674592,1852,120829,5427,0.014668609808642758,0.745569446352521
7681,0.7684,12,2,12,674594,1850,120841,5415,0.01465276897731593,0.7453544390915348
7682,0.7685,7,2,7,674596,1848,120848,5408,0.014636928145989101,0.7453142227122381
7683,0.7686,8,2,8,674598,1846,120856,5400,0.014621087314662273,0.7452387524151256
7684,0.7687,5,4,5,674602,1842,120861,5395,0.014589405652008617,0.7454746441895813
7685,0.7688,8,1,8,674603,1841,120869,5387,0.014581485236345204,0.7452960708356392
7686,0.7689,7,2,7,674605,1839,120876,5380,0.014565644405018376,0.7452555755644826
7687,0.769,5,1,5,674606,1838,120881,5375,0.01455772398935496,0.7451823097185637
7688,0.7691,4,3,4,674609,1835,120885,5371,0.01453396274236472,0.7453510963086317
7689,0.7692,3,1,3,674610,1834,120888,5368,0.014526042326701306,0.7453485143015829
7690,0.7693,3,4,3,674614,1830,120891,5365,0.01449436066404765,0.7456567060458652
7691,0.7694,2,3,2,674617,1827,120893,5363,0.014470599417057407,0.7458970792767733
7692,0.7695,1,1,1,674618,1826,120894,5362,0.014462679001393993,0.7459654980523094
7693,0.7696,5,1,5,674619,1825,120899,5357,0.014454758585730578,0.7458925090504038
7694,0.7697,5,2,5,674621,1823,120904,5352,0.01443891775440375,0.7459233449477352
7695,0.7698,9,0,9,674621,1823,120913,5343,0.01443891775440375,0.7456042422550935
7696,0.7699,5,1,5,674622,1822,120918,5338,0.014430997338740337,0.7455307262569832
7697,0.77,7,3,7,674625,1819,120925,5331,0.014407236091750096,0.7455944055944056
7698,0.7701,1,2,1,674627,1817,120926,5330,0.014391395260423268,0.7457674548761718
7699,0.7702,7,4,7,674631,1813,120933,5323,0.014359713597769611,0.7459360986547086
7700,0.7703,6,3,6,674634,1810,120939,5317,0.014335952350779368,0.7460362003648099
7701,0.7704,7,3,7,674637,1807,120946,5310,0.014312191103789127,0.7461008852044401
7702,0.7705,2,2,2,674639,1805,120948,5308,0.014296350272462299,0.7462392801911992
7703,0.7706,3,4,3,674643,1801,120951,5305,0.014264668609808642,0.7465522094005066
7704,0.7707,8,1,8,674644,1800,120959,5297,0.014256748194145229,0.7463717063547978
7705,0.7708,6,2,6,674646,1798,120965,5291,0.014240907362818401,0.7463676117929187
7706,0.7709,10,1,10,674647,1797,120975,5281,0.014232986947154986,0.7461147216727889
7707,0.771,6,2,6,674649,1795,120981,5275,0.01421714611582816,0.7461103253182461
7708,0.7711,3,2,3,674651,1793,120984,5272,0.014201305284501331,0.7462137296532201
7709,0.7712,6,2,6,674653,1791,120990,5266,0.014185464453174503,0.7462094374380048
7710,0.7713,2,4,2,674657,1787,120992,5264,0.014153782790520847,0.7465607715217699
7711,0.7714,8,4,8,674661,1783,121000,5256,0.01412210112786719,0.7466969740019889
7712,0.7715,5,1,5,674662,1782,121005,5251,0.014114180712203776,0.7466230627043936
7713,0.7716,7,3,7,674665,1779,121012,5244,0.014090419465213534,0.7466894489534387
7714,0.7717,4,1,4,674666,1778,121016,5240,0.014082499049550121,0.7466514676546024
7715,0.7718,4,3,4,674669,1775,121020,5236,0.014058737802559878,0.7468264156325773
7716,0.7719,4,2,4,674671,1773,121024,5232,0.01404289697123305,0.7468950749464668
7717,0.772,9,2,9,674673,1771,121033,5223,0.014027056139906222,0.7467829568201315
7718,0.7721,5,2,5,674675,1769,121038,5218,0.014011215308579393,0.7468155145269787
7719,0.7722,9,4,9,674679,1765,121047,5209,0.013979533645925739,0.7469171207341554
7720,0.7723,6,4,6,674683,1761,121053,5203,0.013947851983272083,0.7471280873061459
7721,0.7724,6,0,6,674683,1761,121059,5197,0.013947851983272083,0.7469100316182811
7722,0.7725,8,3,8,674686,1758,121067,5189,0.01392409073628184,0.746941125665755
7723,0.7726,8,2,8,674688,1756,121075,5181,0.013908249904955011,0.7468646388928932
7724,0.7727,4,0,4,674688,1756,121079,5177,0.013908249904955011,0.7467185922400116
7725,0.7728,8,3,8,674691,1753,121087,5169,0.01388448865796477,0.7467494943657902
7726,0.7729,3,6,3,674697,1747,121090,5166,0.013836966163984285,0.7472877187906842
7727,0.773,1,2,1,674699,1745,121091,5165,0.013821125332657457,0.7474674384949349
7728,0.7731,6,1,6,674700,1744,121097,5159,0.013813204916994044,0.7473562219324931
7729,0.7732,4,2,4,674702,1742,121101,5155,0.013797364085667216,0.7474264172828766
7730,0.7733,5,5,5,674707,1737,121106,5150,0.013757762007350146,0.7477856831711921
7731,0.7734,1,3,1,674710,1734,121107,5149,0.013734000760359903,0.7480749673107656
7732,0.7735,5,0,5,674710,1734,121112,5144,0.013734000760359903,0.747891829020064
7733,0.7736,7,3,7,674713,1731,121119,5137,0.013710239513369662,0.7479615608619685
7734,0.7737,2,4,2,674717,1727,121121,5135,0.013678557850716005,0.7483241037598368
7735,0.7738,3,7,3,674724,1720,121124,5132,0.013623114941072108,0.7489784004670169
7736,0.7739,3,1,3,674725,1719,121127,5129,0.013615194525408693,0.7489778037383178
7737,0.774,5,1,5,674726,1718,121132,5124,0.01360727410974528,0.7489038292896814
7738,0.7741,3,2,3,674728,1716,121135,5121,0.013591433278418451,0.749012724879333
7739,0.7742,3,1,3,674729,1715,121138,5118,0.013583512862755037,0.7490121469339968
7740,0.7743,7,2,7,674731,1713,121145,5111,0.01356767203142821,0.7489742086752638
7741,0.7744,2,3,2,674734,1710,121147,5109,0.013543910784437967,0.7492300923889134
7742,0.7745,2,0,2,674734,1710,121149,5107,0.013543910784437967,0.749156520463547
7743,0.7746,7,2,7,674736,1708,121156,5100,0.013528069953111139,0.7491186839012925
7744,0.7747,5,3,5,674739,1705,121161,5095,0.013504308706120897,0.7492647058823529
7745,0.7748,8,2,8,674741,1703,121169,5087,0.01348846787479407,0.7491899852724595
7746,0.7749,5,2,5,674743,1701,121174,5082,0.013472627043467241,0.7492260061919505
7747,0.775,6,0,6,674743,1701,121180,5076,0.013472627043467241,0.749003984063745
7748,0.7751,0,4,0,674747,1697,121180,5076,0.013440945380813585,0.7494463310202274
7749,0.7752,5,2,5,674749,1695,121185,5071,0.013425104549486757,0.7494827076559267
7750,0.7753,5,4,5,674753,1691,121190,5066,0.0133934228868331,0.7497410093236644
7751,0.7754,6,1,6,674754,1690,121196,5060,0.013385502471169687,0.7496296296296296
7752,0.7755,6,2,6,674756,1688,121202,5054,0.013369661639842859,0.7496291901512904
7753,0.7756,3,4,3,674760,1684,121205,5051,0.013337979977189203,0.7499628804751299
7754,0.7757,2,4,2,674764,1680,121207,5049,0.013306298314535546,0.7503343736067767
7755,0.7758,3,3,3,674767,1677,121210,5046,0.013282537067545305,0.7505577867023651
7756,0.7759,5,2,5,674769,1675,121215,5041,0.013266696236218477,0.7505955926146516
7757,0.776,4,3,4,674772,1672,121219,5037,0.013242934989228235,0.7507825309286034
7758,0.7761,5,0,5,674772,1672,121224,5032,0.013242934989228235,0.7505966587112172
7759,0.7762,2,4,2,674776,1668,121226,5030,0.013211253326574579,0.7509704389369961
7760,0.7763,4,4,4,674780,1664,121230,5026,0.013179571663920923,0.751270553064275
7761,0.7764,5,2,5,674782,1662,121235,5021,0.013163730832594095,0.7513092922340266
7762,0.7765,0,3,0,674785,1659,121235,5021,0.013139969585603853,0.7516467065868263
7763,0.7766,4,1,4,674786,1658,121239,5017,0.013132049169940438,0.7516104868913858
7764,0.7767,4,1,4,674787,1657,121243,5013,0.013124128754277025,0.7515742128935532
7765,0.7768,8,1,8,674788,1656,121251,5005,0.01311620833861361,0.7513886803783216
7766,0.7769,3,6,3,674794,1650,121254,5002,0.013068685844633126,0.7519542994588094
7767,0.777,9,1,9,674795,1649,121263,4993,0.013060765428969712,0.7517314062029509
7768,0.7771,7,2,7,674797,1647,121270,4986,0.013044924597642884,0.751696065128901
7769,0.7772,4,0,4,674797,1647,121274,4982,0.013044924597642884,0.7515462362347262
7770,0.7773,7,0,7,674797,1647,121281,4975,0.013044924597642884,0.7512836001208094
7771,0.7774,7,3,7,674800,1644,121288,4968,0.013021163350652643,0.7513611615245009
7772,0.7775,4,2,4,674802,1642,121292,4964,0.013005322519325815,0.7514380865879503
7773,0.7776,5,1,5,674803,1641,121297,4959,0.0129974021036624,0.7513636363636363
7774,0.7777,2,1,2,674804,1640,121299,4957,0.012989481687998987,0.7514021524935577
7775,0.7778,3,1,3,674805,1639,121302,4954,0.012981561272335572,0.7514030031851964
7776,0.7779,3,5,3,674810,1634,121305,4951,0.012941959194018502,0.7518602885345482
7777,0.778,7,3,7,674813,1631,121312,4944,0.01291819794702826,0.7519391634980989
7778,0.7781,3,3,3,674816,1628,121315,4941,0.012894436700038018,0.7521692799512864
7779,0.7782,5,3,5,674819,1625,121320,4936,0.012870675453047776,0.7523243408017071
7780,0.7783,3,4,3,674823,1621,121323,4933,0.01283899379039412,0.752670125114434
7781,0.7784,3,5,3,674828,1616,121326,4930,0.01279939171207705,0.7531316834708218
7782,0.7785,4,1,4,674829,1615,121330,4926,0.012791471296413635,0.7530958569026143
7783,0.7786,4,1,4,674830,1614,121334,4922,0.012783550880750222,0.7530599755201959
7784,0.7787,3,1,3,674831,1613,121337,4919,0.012775630465086807,0.7530618493570116
7785,0.7788,6,3,6,674834,1610,121343,4913,0.012751869218096566,0.753181051663345
7786,0.7789,5,4,5,674838,1606,121348,4908,0.01272018755544291,0.7534540988639853
7787,0.779,9,0,9,674838,1606,121357,4899,0.01272018755544291,0.7531129900076864
7788,0.7791,6,5,6,674843,1601,121363,4893,0.01268058547712584,0.7534647366800123
7789,0.7792,0,3,0,674846,1598,121363,4893,0.012656824230135597,0.7538129718071176
7790,0.7793,5,2,5,674848,1596,121368,4888,0.012640983398808769,0.7538556446637877
7791,0.7794,2,2,2,674850,1594,121370,4886,0.012625142567481942,0.7540123456790123
7792,0.7795,4,1,4,674851,1593,121374,4882,0.012617222151818527,0.753976833976834
7793,0.7796,5,2,5,674853,1591,121379,4877,0.0126013813204917,0.7540197897340755
7794,0.7797,5,2,5,674855,1589,121384,4872,0.012585540489164871,0.7540628385698809
7795,0.7798,7,2,7,674857,1587,121391,4865,0.012569699657838043,0.7540297582145071
7796,0.7799,1,3,1,674860,1584,121392,4864,0.012545938410847801,0.7543424317617866
7797,0.78,6,1,6,674861,1583,121398,4858,0.012538017995184387,0.7542307095171558
7798,0.7801,3,0,3,674861,1583,121401,4855,0.012538017995184387,0.7541161851506679
7799,0.7802,6,2,6,674863,1581,121407,4849,0.012522177163857558,0.7541213063763608
7800,0.7803,3,2,3,674865,1579,121410,4846,0.012506336332530732,0.7542412451361867
7801,0.7804,10,2,10,674867,1577,121420,4836,0.012490495501203904,0.7540932480898176
7802,0.7805,6,3,6,674870,1574,121426,4830,0.01246673425421366,0.7542161149281699
7803,0.7806,10,0,10,674870,1574,121436,4820,0.01246673425421366,0.7538317172349077
7804,0.7807,5,0,5,674870,1574,121441,4815,0.01246673425421366,0.7536390671466583
7805,0.7808,8,1,8,674871,1573,121449,4807,0.012458813838550247,0.753448275862069
7806,0.7809,4,1,4,674872,1572,121453,4803,0.012450893422886833,0.7534117647058823
7807,0.781,6,1,6,674873,1571,121459,4797,0.01244297300722342,0.7532977386934674
7808,0.7811,2,4,2,674877,1567,121461,4795,0.012411291344569763,0.7536938069789374
7809,0.7812,5,3,5,674880,1564,121466,4790,0.012387530097579522,0.7538558388416745
7810,0.7813,4,1,4,674881,1563,121470,4786,0.012379609681916107,0.7538194991337218
7811,0.7814,9,2,9,674883,1561,121479,4777,0.012363768850589279,0.7537077942568634
7812,0.7815,6,5,6,674888,1556,121485,4771,0.012324166772272209,0.7540698593330172
7813,0.7816,4,0,4,674888,1556,121489,4767,0.012324166772272209,0.753914281195635
7814,0.7817,8,3,8,674891,1553,121497,4759,0.012300405525281968,0.7539607097591888
7815,0.7818,6,0,6,674891,1553,121503,4753,0.012300405525281968,0.7537266095781795
7816,0.7819,4,3,4,674894,1550,121507,4749,0.012276644278291724,0.753929195110335
7817,0.782,6,2,6,674896,1548,121513,4743,0.012260803446964896,0.753934191702432
7818,0.7821,6,2,6,674898,1546,121519,4737,0.012244962615638068,0.7539392010186217
7819,0.7822,4,3,4,674901,1543,121523,4733,0.012221201368647827,0.7541427660930529
7820,0.7823,1,4,1,674905,1539,121524,4732,0.01218951970599417,0.7545845957582523
7821,0.7824,4,2,4,674907,1537,121528,4728,0.012173678874667342,0.7546687948922586
7822,0.7825,8,3,8,674910,1534,121536,4720,0.012149917627677101,0.7547169811320755
7823,0.7826,10,4,10,674914,1530,121546,4710,0.012118235965023445,0.7548076923076923
7824,0.7827,5,0,5,674914,1530,121551,4705,0.012118235965023445,0.7546110665597434
7825,0.7828,5,2,5,674916,1528,121556,4700,0.012102395133696616,0.7546563904945408
7826,0.7829,3,3,3,674919,1525,121559,4697,0.012078633886706375,0.7549019607843137
7827,0.783,6,2,6,674921,1523,121565,4691,0.012062793055379547,0.7549082716446733
7828,0.7831,3,3,3,674924,1520,121568,4688,0.012039031808389304,0.7551546391752577
7829,0.7832,8,6,8,674930,1514,121576,4680,0.01199150931440882,0.7555699063609945
7830,0.7833,4,2,4,674932,1512,121580,4676,0.011975668483081993,0.755656108597285
7831,0.7834,4,3,4,674935,1509,121584,4672,0.01195190723609175,0.7558647468047242
7832,0.7835,7,3,7,674938,1506,121591,4665,0.011928145989101508,0.7559552746718522
7833,0.7836,4,1,4,674939,1505,121595,4661,0.011920225573438093,0.7559195588712293
7834,0.7837,5,0,5,674939,1505,121600,4656,0.011920225573438093,0.7557214737867229
7835,0.7838,6,2,6,674941,1503,121606,4650,0.011904384742111265,0.7557289127254998
7836,0.7839,3,4,3,674945,1499,121609,4647,0.01187270307945761,0.7561015294500488
7837,0.784,2,1,2,674946,1498,121611,4645,0.011864782663794196,0.7561452059254435
7838,0.7841,3,6,3,674952,1492,121614,4642,0.011817260169813711,0.7567655689598957
7839,0.7842,3,5,3,674957,1487,121617,4639,0.011777658091496642,0.75726412014365
7840,0.7843,2,1,2,674958,1486,121619,4637,0.011769737675833229,0.7573085089008655
7841,0.7844,3,0,3,674958,1486,121622,4634,0.011769737675833229,0.7571895424836601
7842,0.7845,7,3,7,674961,1483,121629,4627,0.011745976428842985,0.7572831423895253
7843,0.7846,4,1,4,674962,1482,121633,4623,0.011738056013179572,0.7572481572481572
7844,0.7847,5,1,5,674963,1481,121638,4618,0.011730135597516157,0.7571733070995245
7845,0.7848,4,0,4,674963,1481,121642,4614,0.011730135597516157,0.75701394585726
7846,0.7849,7,1,7,674964,1480,121649,4607,0.011722215181852744,0.7568588795794315
7847,0.785,3,2,3,674966,1478,121652,4604,0.011706374350525916,0.7569878329496876
7848,0.7851,6,1,6,674967,1477,121658,4598,0.011698453934862501,0.756872427983539
7849,0.7852,5,4,5,674971,1473,121663,4593,0.011666772272208846,0.7571711177052424
7850,0.7853,8,1,8,674972,1472,121671,4585,0.011658851856545431,0.7569754003632161
7851,0.7854,3,2,3,674974,1470,121674,4582,0.011643011025218603,0.7571050892267019
7852,0.7855,4,2,4,674976,1468,121678,4578,0.011627170193891775,0.7571948395633477
7853,0.7856,8,1,8,674977,1467,121686,4570,0.011619249778228362,0.7569985091933079
7854,0.7857,5,3,5,674980,1464,121691,4565,0.011595488531238119,0.7571736606402388
7855,0.7858,7,2,7,674982,1462,121698,4558,0.01157964769991129,0.7571428571428571
7856,0.7859,5,5,5,674987,1457,121703,4553,0.011540045621594221,0.7575707154742096
7857,0.786,3,1,3,674988,1456,121706,4550,0.011532125205930808,0.7575757575757576
7858,0.7861,4,0,4,674988,1456,121710,4546,0.011532125205930808,0.7574141952682439
7859,0.7862,3,2,3,674990,1454,121713,4543,0.01151628437460398,0.7575454393863599
7860,0.7863,5,0,5,674990,1454,121718,4538,0.01151628437460398,0.757343124165554
7861,0.7864,6,3,6,674993,1451,121724,4532,0.011492523127613737,0.7574795253217449
7862,0.7865,4,5,4,674998,1446,121728,4528,0.011452921049296667,0.7579511215266154
7863,0.7866,1,2,1,675000,1444,121729,4527,0.011437080217969839,0.7581644615642271
7864,0.7867,5,0,5,675000,1444,121734,4522,0.011437080217969839,0.7579617834394905
7865,0.7868,4,0,4,675000,1444,121738,4518,0.011437080217969839,0.75779939617578
7866,0.7869,3,3,3,675003,1441,121741,4515,0.011413318970979597,0.7580591000671592
7867,0.787,4,3,4,675006,1438,121745,4511,0.011389557723989354,0.7582787023029081
7868,0.7871,4,1,4,675007,1437,121749,4507,0.011381637308325941,0.7582436069986541
7869,0.7872,7,2,7,675009,1435,121756,4500,0.011365796476999113,0.7582139848357203
7870,0.7873,5,2,5,675011,1433,121761,4495,0.011349955645672285,0.7582658569500674
7871,0.7874,5,3,5,675014,1430,121766,4490,0.011326194398682043,0.7584459459459459
7872,0.7875,5,3,5,675017,1427,121771,4485,0.0113024331516918,0.7586265223274695
7873,0.7876,4,1,4,675018,1426,121775,4481,0.011294512736028387,0.7585915016082614
7874,0.7877,7,2,7,675020,1424,121782,4474,0.011278671904701559,0.7585622244828756
7875,0.7878,5,2,5,675022,1422,121787,4469,0.01126283107337473,0.7586148361907995
7876,0.7879,5,0,5,675022,1422,121792,4464,0.01126283107337473,0.7584097859327217
7877,0.788,6,0,6,675022,1422,121798,4458,0.01126283107337473,0.7581632653061224
7878,0.7881,1,3,1,675025,1419,121799,4457,0.01123906982638449,0.7585091899251192
7879,0.7882,7,2,7,675027,1417,121806,4450,0.011223228995057661,0.7584796318391
7880,0.7883,5,2,5,675029,1415,121811,4445,0.011207388163730833,0.7585324232081911
7881,0.7884,2,2,2,675031,1413,121813,4443,0.011191547332404005,0.7587090163934426
7882,0.7885,6,1,6,675032,1412,121819,4437,0.01118362691674059,0.7585912121730211
7883,0.7886,4,1,4,675033,1411,121823,4433,0.011175706501077177,0.7585557837097878
7884,0.7887,4,1,4,675034,1410,121827,4429,0.011167786085413762,0.7585202945709881
7885,0.7888,5,1,5,675035,1409,121832,4424,0.011159865669750349,0.7584433396194068
7886,0.7889,1,1,1,675036,1408,121833,4423,0.011151945254086934,0.7585319842222603
7887,0.789,7,1,7,675037,1407,121840,4416,0.01114402483842352,0.7583719732096857
7888,0.7891,3,1,3,675038,1406,121843,4413,0.011136104422760107,0.7583777281319815
7889,0.7892,5,3,5,675041,1403,121848,4408,0.011112343175769864,0.758561349165376
7890,0.7893,6,5,6,675046,1398,121854,4402,0.011072741097452795,0.7589655172413793
7891,0.7894,7,1,7,675047,1397,121861,4395,0.01106482068178938,0.7588052486187845
7892,0.7895,3,3,3,675050,1394,121864,4392,0.011041059434799138,0.759073625993778
7893,0.7896,6,2,6,675052,1392,121870,4386,0.01102521860347231,0.7590861889927311
7894,0.7897,8,3,8,675055,1389,121878,4378,0.011001457356482069,0.7591468701231143
7895,0.7898,5,1,5,675056,1388,121883,4373,0.010993536940818654,0.7590696059711856
7896,0.7899,4,5,4,675061,1383,121887,4369,0.010953934862501584,0.7595618915159944
7897,0.79,5,3,5,675064,1380,121892,4364,0.010930173615511341,0.7597493036211699
7898,0.7901,4,2,4,675066,1378,121896,4360,0.010914332784184515,0.7598466364586964
7899,0.7902,3,3,3,675069,1375,121899,4357,0.010890571537194272,0.7601186322400558
7900,0.7903,4,6,4,675075,1369,121903,4353,0.010843049043213787,0.7607479902132122
7901,0.7904,6,2,6,675077,1367,121909,4347,0.010827208211886959,0.7607630381519076
7902,0.7905,6,2,6,675079,1365,121915,4341,0.010811367380560133,0.7607781282860148
7903,0.7906,1,3,1,675082,1362,121916,4340,0.01078760613356989,0.7611364433532094
7904,0.7907,7,4,7,675086,1358,121923,4333,0.010755924470916233,0.7613776137761378
7905,0.7908,7,0,7,675086,1358,121930,4326,0.010755924470916233,0.7610837438423645
7906,0.7909,3,1,3,675087,1357,121933,4323,0.01074800405525282,0.7610915492957746
7907,0.791,2,1,2,675088,1356,121935,4321,0.010740083639589405,0.7611414479478598
7908,0.7911,3,1,3,675089,1355,121938,4318,0.010732163223925992,0.7611493037193725
7909,0.7912,5,3,5,675092,1352,121943,4313,0.01070840197693575,0.7613415710503089
7910,0.7913,5,3,5,675095,1349,121948,4308,0.010684640729945507,0.7615343821813683
7911,0.7914,0,3,0,675098,1346,121948,4308,0.010660879482955266,0.7619384506544039
7912,0.7915,6,4,6,675102,1342,121954,4302,0.01062919782030161,0.7622253720765415
7913,0.7916,5,0,5,675102,1342,121959,4297,0.01062919782030161,0.7620145415853875
7914,0.7917,5,2,5,675104,1340,121964,4292,0.010613356988974781,0.7620738636363636
7915,0.7918,8,1,8,675105,1339,121972,4284,0.010605436573311368,0.7618708874266406
7916,0.7919,4,1,4,675106,1338,121976,4280,0.010597516157647953,0.7618369526521894
7917,0.792,5,2,5,675108,1336,121981,4275,0.010581675326321125,0.7618962751737658
7918,0.7921,6,2,6,675110,1334,121987,4269,0.010565834494994297,0.7619132607531679
7919,0.7922,8,2,8,675112,1332,121995,4261,0.010549993663667469,0.7618451635973539
7920,0.7923,4,1,4,675113,1331,121999,4257,0.010542073248004056,0.7618110236220472
7921,0.7924,2,0,2,675113,1331,122001,4255,0.010542073248004056,0.7617257429287504
7922,0.7925,4,2,4,675115,1329,122005,4251,0.010526232416677227,0.7618279569892473
7923,0.7926,2,0,2,675115,1329,122007,4249,0.010526232416677227,0.7617425600573682
7924,0.7927,4,2,4,675117,1327,122011,4245,0.0105103915853504,0.7618449389806173
7925,0.7928,5,1,5,675118,1326,122016,4240,0.010502471169686986,0.7617678763923823
7926,0.7929,4,1,4,675119,1325,122020,4236,0.010494550754023571,0.7617335011688545
7927,0.793,6,2,6,675121,1323,122026,4230,0.010478709922696743,0.7617504051863857
7928,0.7931,1,0,1,675121,1323,122027,4229,0.010478709922696743,0.7617074927953891
7929,0.7932,4,4,4,675125,1319,122031,4225,0.010447028260043087,0.762085137085137
7930,0.7933,10,1,10,675126,1318,122041,4215,0.010439107844379673,0.7617928790891018
7931,0.7934,7,2,7,675128,1316,122048,4208,0.010423267013052845,0.7617668356263577
7932,0.7935,4,3,4,675131,1313,122052,4204,0.010399505766062602,0.7620083378647816
7933,0.7936,2,2,2,675133,1311,122054,4202,0.010383664934735776,0.7621984400507891
7934,0.7937,3,2,3,675135,1309,122057,4199,0.010367824103408948,0.7623456790123457
7935,0.7938,7,2,7,675137,1307,122064,4192,0.01035198327208212,0.76232042189489
7936,0.7939,2,1,2,675138,1306,122066,4190,0.010344062856418704,0.762372634643377
7937,0.794,7,2,7,675140,1304,122073,4183,0.010328222025091876,0.7623473665026426
7938,0.7941,4,1,4,675141,1303,122077,4179,0.010320301609428463,0.7623130244436337
7939,0.7942,4,1,4,675142,1302,122081,4175,0.010312381193765048,0.7622786196823078
7940,0.7943,8,3,8,675145,1299,122089,4167,0.010288619946774807,0.7623490669593853
7941,0.7944,5,3,5,675148,1296,122094,4162,0.010264858699784565,0.762550384756321
7942,0.7945,2,1,2,675149,1295,122096,4160,0.01025693828412115,0.7626031164069661
7943,0.7946,4,3,4,675152,1292,122100,4156,0.010233177037130909,0.762848751835536
7944,0.7947,1,1,1,675153,1291,122101,4155,0.010225256621467494,0.7629452809401396
7945,0.7948,6,1,6,675154,1290,122107,4149,0.01021733620580408,0.7628240485383343
7946,0.7949,5,4,5,675158,1286,122112,4144,0.010185654543150425,0.7631675874769798
7947,0.795,3,0,3,675158,1286,122115,4141,0.010185654543150425,0.7630366685093053
7948,0.7951,8,2,8,675160,1284,122123,4133,0.010169813711823596,0.7629684327118331
7949,0.7952,6,0,6,675160,1284,122129,4127,0.010169813711823596,0.7627055997043061
7950,0.7953,9,0,9,675160,1284,122138,4118,0.010169813711823596,0.7623102554609404
7951,0.7954,4,3,4,675163,1281,122142,4114,0.010146052464833355,0.7625579240037071
7952,0.7955,3,0,3,675163,1281,122145,4111,0.010146052464833355,0.7624258160237388
7953,0.7956,3,1,3,675164,1280,122148,4108,0.01013813204916994,0.7624350408314774
7954,0.7957,5,2,5,675166,1278,122153,4103,0.010122291217843112,0.7624976770117079
7955,0.7958,6,2,6,675168,1276,122159,4097,0.010106450386516284,0.7625162851293504
7956,0.7959,3,2,3,675170,1274,122162,4094,0.010090609555189456,0.7626676602086438
7957,0.796,5,1,5,675171,1273,122167,4089,0.010082689139526042,0.7625885863483775
7958,0.7961,3,0,3,675171,1273,122170,4086,0.010082689139526042,0.7624556820302295
7959,0.7962,5,2,5,675173,1271,122175,4081,0.010066848308199214,0.7625186846038864
7960,0.7963,5,1,5,675174,1270,122180,4076,0.010058927892535801,0.7624392068836513
7961,0.7964,4,5,4,675179,1265,122184,4072,0.01001932581421873,0.7629754543751172
7962,0.7965,7,4,7,675183,1261,122191,4065,0.009987644151565073,0.7632369508073601
7963,0.7966,6,4,6,675187,1257,122197,4059,0.009955962488911419,0.7635440180586908
7964,0.7967,4,1,4,675188,1256,122201,4055,0.009948042073248004,0.7635096968555828
7965,0.7968,3,1,3,675189,1255,122204,4052,0.00994012165758459,0.76351987940456
7966,0.7969,3,4,3,675193,1251,122207,4049,0.009908439994930934,0.7639622641509434
7967,0.797,6,1,6,675194,1250,122213,4043,0.00990051957926752,0.7638390326846779
7968,0.7971,1,1,1,675195,1249,122214,4042,0.009892599163604106,0.7639387639387639
7969,0.7972,3,1,3,675196,1248,122217,4039,0.009884678747940691,0.7639493096273879
7970,0.7973,5,0,5,675196,1248,122222,4034,0.009884678747940691,0.7637258614161303
7971,0.7974,6,1,6,675197,1247,122228,4028,0.009876758332277278,0.7636018957345971
7972,0.7975,2,3,2,675200,1244,122230,4026,0.009852997085287037,0.7639468690702087
7973,0.7976,4,4,4,675204,1240,122234,4022,0.00982131542263338,0.7643481565944508
7974,0.7977,5,1,5,675205,1239,122239,4017,0.009813395006969965,0.764269406392694
7975,0.7978,4,0,4,675205,1239,122243,4013,0.009813395006969965,0.7640898705255141
7976,0.7979,5,2,5,675207,1237,122248,4008,0.009797554175643137,0.7641563393708294
7977,0.798,6,0,6,675207,1237,122254,4002,0.009797554175643137,0.7638862378316472
7978,0.7981,4,4,4,675211,1233,122258,3998,0.00976587251298948,0.7642898107436437
7979,0.7982,2,1,2,675212,1232,122260,3996,0.009757952097326068,0.764345830145371
7980,0.7983,3,2,3,675214,1230,122263,3993,0.00974211126599924,0.7645031591039633
7981,0.7984,9,3,9,675217,1227,122272,3984,0.009718350019008998,0.7645365572826712
7982,0.7985,2,1,2,675218,1226,122274,3982,0.009710429603345583,0.7645929339477726
7983,0.7986,6,0,6,675218,1226,122280,3976,0.009710429603345583,0.764321414840446
7984,0.7987,3,1,3,675219,1225,122283,3973,0.00970250918768217,0.7643324355521355
7985,0.7988,7,2,7,675221,1223,122290,3966,0.009686668356355342,0.7643091154365003
7986,0.7989,4,3,4,675224,1220,122294,3962,0.009662907109365099,0.764569664222308
7987,0.799,9,2,9,675226,1218,122303,3953,0.009647066278038272,0.7644556178688842
7988,0.7991,6,1,6,675227,1217,122309,3947,0.009639145862374857,0.7643299767621998
7989,0.7992,7,2,7,675229,1215,122316,3940,0.009623305031048029,0.7643064985451018
7990,0.7993,6,3,6,675232,1212,122322,3934,0.009599543784057788,0.7644772638942868
7991,0.7994,2,2,2,675234,1210,122324,3932,0.00958370295273096,0.764683002722676
7992,0.7995,2,1,2,675235,1209,122326,3930,0.009575782537067545,0.7647402218330415
7993,0.7996,1,2,1,675237,1207,122327,3929,0.009559941705740716,0.7649922118380063
7994,0.7997,6,2,6,675239,1205,122333,3923,0.00954410087441389,0.765015600624025
7995,0.7998,4,0,4,675239,1205,122337,3919,0.00954410087441389,0.764832162373146
7996,0.7999,6,0,6,675239,1205,122343,3913,0.00954410087441389,0.7645564673700664
7997,0.8,4,3,4,675242,1202,122347,3909,0.009520339627423647,0.764820974369008
7998,0.8001,4,0,4,675242,1202,122351,3905,0.009520339627423647,0.764636773056589
7999,0.8002,4,0,4,675242,1202,122355,3901,0.009520339627423647,0.7644522829708015
8000,0.8003,4,0,4,675242,1202,122359,3897,0.009520339627423647,0.7642675034320455
8001,0.8004,4,2,4,675244,1200,122363,3893,0.009504498796096819,0.7643824857647752
8002,0.8005,5,3,5,675247,1197,122368,3888,0.009480737549106577,0.7646017699115044
8003,0.8006,6,3,6,675250,1194,122374,3882,0.009456976302116334,0.764775413711584
8004,0.8007,9,1,9,675251,1193,122383,3873,0.009449055886452921,0.764508487958942
8005,0.8008,6,1,6,675252,1192,122389,3867,0.009441135470789508,0.7643803123146867
8006,0.8009,4,1,4,675253,1191,122393,3863,0.009433215055126093,0.7643450732093391
8007,0.801,5,2,5,675255,1189,122398,3858,0.009417374223799265,0.7644145036655439
8008,0.8011,3,2,3,675257,1187,122401,3855,0.009401533392472437,0.7645775485918287
8009,0.8012,4,3,4,675260,1184,122405,3851,0.009377772145482195,0.7648460774577954
8010,0.8013,3,1,3,675261,1183,122408,3848,0.00936985172981878,0.7648578811369509
8011,0.8014,5,1,5,675262,1182,122413,3843,0.009361931314155367,0.7647761194029851
8012,0.8015,8,4,8,675266,1178,122421,3835,0.00933024965150171,0.7650109714741672
8013,0.8016,4,2,4,675268,1176,122425,3831,0.009314408820174883,0.7651288196524865
8014,0.8017,5,0,5,675268,1176,122430,3826,0.009314408820174883,0.7648940423830468
8015,0.8018,2,0,2,675268,1176,122432,3824,0.009314408820174883,0.7648
8016,0.8019,3,0,3,675268,1176,122435,3821,0.009314408820174883,0.7646587952771663
8017,0.802,6,3,6,675271,1173,122441,3815,0.009290647573184641,0.7648356054530874
8018,0.8021,8,1,8,675272,1172,122449,3807,0.009282727157521226,0.764611367744527
8019,0.8022,3,1,3,675273,1171,122452,3804,0.009274806741857813,0.7646231155778894
8020,0.8023,8,1,8,675274,1170,122460,3796,0.009266886326194398,0.7643979057591623
8021,0.8024,5,4,5,675278,1166,122465,3791,0.009235204663540742,0.7647770829130522
8022,0.8025,4,1,4,675279,1165,122469,3787,0.009227284247877329,0.7647415185783522
8023,0.8026,4,2,4,675281,1163,122473,3783,0.0092114434165505,0.7648604933279418
8024,0.8027,5,2,5,675283,1161,122478,3778,0.009195602585223672,0.7649321725045556
8025,0.8028,4,2,4,675285,1159,122482,3774,0.009179761753896844,0.765051692681938
8026,0.8029,4,0,4,675285,1159,122486,3770,0.009179761753896844,0.7648610265773991
8027,0.803,1,1,1,675286,1158,122487,3769,0.009171841338233431,0.7649685406941343
8028,0.8031,4,4,4,675290,1154,122491,3765,0.009140159675579775,0.765399471437284
8029,0.8032,5,2,5,675292,1152,122496,3760,0.009124318844252946,0.7654723127035831
8030,0.8033,8,3,8,675295,1149,122504,3752,0.009100557597262705,0.765558049377678
8031,0.8034,7,2,7,675297,1147,122511,3745,0.009084716765935877,0.7655355682747342
8032,0.8035,4,1,4,675298,1146,122515,3741,0.009076796350272462,0.7655003069367711
8033,0.8036,3,2,3,675300,1144,122518,3738,0.009060955518945634,0.7656698074559607
8034,0.8037,4,4,4,675304,1140,122522,3734,0.009029273856291977,0.7661058678703324
8035,0.8038,5,1,5,675305,1139,122527,3729,0.009021353440628564,0.7660230073952342
8036,0.8039,1,2,1,675307,1137,122528,3728,0.009005512609301736,0.766289825282631
8037,0.804,1,3,1,675310,1134,122529,3727,0.008981751362311495,0.7667146677638346
8038,0.8041,5,2,5,675312,1132,122534,3722,0.008965910530984667,0.7667902760609806
8039,0.8042,4,4,4,675316,1128,122538,3718,0.00893422886833101,0.76723070573669
8040,0.8043,4,1,4,675317,1127,122542,3714,0.008926308452667595,0.7671968601528609
8041,0.8044,4,3,4,675320,1124,122546,3710,0.008902547205677354,0.7674803475382705
8042,0.8045,2,2,2,675322,1122,122548,3708,0.008886706374350526,0.7677018633540372
8043,0.8046,2,2,2,675324,1120,122550,3706,0.008870865543023698,0.7679237463738086
8044,0.8047,4,1,4,675325,1119,122554,3702,0.008862945127360284,0.7678904791537026
8045,0.8048,4,2,4,675327,1117,122558,3698,0.008847104296033456,0.7680166147455867
8046,0.8049,4,0,4,675327,1117,122562,3694,0.008847104296033456,0.7678237372687591
8047,0.805,9,0,9,675327,1117,122571,3685,0.008847104296033456,0.7673885880882966
8048,0.8051,6,1,6,675328,1116,122577,3679,0.008839183880370041,0.7672575599582899
8049,0.8052,5,1,5,675329,1115,122582,3674,0.008831263464706628,0.76717477552725
8050,0.8053,9,1,9,675330,1114,122591,3665,0.008823343049043213,0.7668968403431681
8051,0.8054,4,1,4,675331,1113,122595,3661,0.0088154226333798,0.7668621700879765
8052,0.8055,4,5,4,675336,1108,122599,3657,0.00877582055506273,0.7674711437565582
8053,0.8056,5,4,5,675340,1104,122604,3652,0.008744138892409074,0.7678721614802355
8054,0.8057,8,1,8,675341,1103,122612,3644,0.008736218476745659,0.7676427217189804
8055,0.8058,1,3,1,675344,1100,122613,3643,0.008712457229755418,0.768079274720641
8056,0.8059,5,4,5,675348,1096,122618,3638,0.008680775567101761,0.7684833122095479
8057,0.806,2,2,2,675350,1094,122620,3636,0.008664934735774933,0.7687103594080338
8058,0.8061,5,1,5,675351,1093,122625,3631,0.00865701432011152,0.7686282811176969
8059,0.8062,5,4,5,675355,1089,122630,3626,0.008625332657457864,0.769034994697773
8060,0.8063,9,1,9,675356,1088,122639,3617,0.008617412241794449,0.7687566418703506
8061,0.8064,4,1,4,675357,1087,122643,3613,0.008609491826131035,0.7687234042553192
8062,0.8065,3,0,3,675357,1087,122646,3610,0.008609491826131035,0.7685756866084735
8063,0.8066,4,1,4,675358,1086,122650,3606,0.00860157141046762,0.768542199488491
8064,0.8067,2,5,2,675363,1081,122652,3604,0.008561969332150551,0.7692636072572039
8065,0.8068,2,3,2,675366,1078,122654,3602,0.00853820808516031,0.7696581196581197
8066,0.8069,3,0,3,675366,1078,122657,3599,0.00853820808516031,0.769510369895232
8067,0.807,6,1,6,675367,1077,122663,3593,0.008530287669496895,0.7693790149892934
8068,0.8071,8,1,8,675368,1076,122671,3585,0.008522367253833481,0.7691482514481871
8069,0.8072,6,1,6,675369,1075,122677,3579,0.008514446838170067,0.7690159003008165
8070,0.8073,7,1,7,675370,1074,122684,3572,0.008506526422506653,0.7688334050796384
8071,0.8074,6,3,6,675373,1071,122690,3566,0.008482765175516412,0.7690317015311624
8072,0.8075,3,1,3,675374,1070,122693,3563,0.008474844759852997,0.7690481329592057
8073,0.8076,3,0,3,675374,1070,122696,3560,0.008474844759852997,0.7688984881209503
8074,0.8077,4,3,4,675377,1067,122700,3556,0.008451083512862756,0.7691974908068354
8075,0.8078,8,1,8,675378,1066,122708,3548,0.00844316309719934,0.7689640225400953
8076,0.8079,1,1,1,675379,1065,122709,3547,0.008435242681535927,0.7690806591500433
8077,0.808,3,4,3,675383,1061,122712,3544,0.008403561018882271,0.7695982627578719
8078,0.8081,5,2,5,675385,1059,122717,3539,0.008387720187555443,0.7696824706394084
8079,0.8082,6,2,6,675387,1057,122723,3533,0.008371879356228615,0.7697167755991285
8080,0.8083,4,2,4,675389,1055,122727,3529,0.008356038524901787,0.7698516579406631
8081,0.8084,5,2,5,675391,1053,122732,3524,0.008340197693574958,0.7699366397203409
8082,0.8085,3,1,3,675392,1052,122735,3521,0.008332277277911545,0.7699540782855894
8083,0.8086,7,1,7,675393,1051,122742,3514,0.00832435686224813,0.7697699890470975
8084,0.8087,8,2,8,675395,1049,122750,3506,0.008308516030921302,0.7697036223929747
8085,0.8088,7,0,7,675395,1049,122757,3499,0.008308516030921302,0.769349164467898
8086,0.8089,6,0,6,675395,1049,122763,3493,0.008308516030921302,0.7690444738000881
8087,0.809,5,2,5,675397,1047,122768,3488,0.008292675199594474,0.7691289966923925
8088,0.8091,5,1,5,675398,1046,122773,3483,0.00828475478393106,0.769043939059395
8089,0.8092,5,2,5,675400,1044,122778,3478,0.008268913952604233,0.7691287041132242
8090,0.8093,4,1,4,675401,1043,122782,3474,0.00826099353694082,0.7690945317688731
8091,0.8094,4,5,4,675406,1038,122786,3470,0.008221391458623748,0.7697426796805679
8092,0.8095,10,1,10,675407,1037,122796,3460,0.008213471042960335,0.7694018234378475
8093,0.8096,4,1,4,675408,1036,122800,3456,0.00820555062729692,0.7693677649154052
8094,0.8097,5,2,5,675410,1034,122805,3451,0.008189709795970092,0.769453734671126
8095,0.8098,2,1,2,675411,1033,122807,3449,0.008181789380306679,0.7695225345827755
8096,0.8099,3,2,3,675413,1031,122810,3446,0.00816594854897985,0.7697118606209515
8097,0.81,1,3,1,675416,1028,122811,3445,0.008142187301989609,0.7701766152470377
8098,0.8101,5,1,5,675417,1027,122816,3440,0.008134266886326194,0.7700917841952093
8099,0.8102,3,2,3,675419,1025,122819,3437,0.008118426054999366,0.7702823845809055
8100,0.8103,5,0,5,675419,1025,122824,3432,0.008118426054999366,0.770024680278214
8101,0.8104,3,1,3,675420,1024,122827,3429,0.008110505639335953,0.7700426678643612
8102,0.8105,6,0,6,675420,1024,122833,3423,0.008110505639335953,0.7697324038677761
8103,0.8106,4,0,4,675420,1024,122837,3419,0.008110505639335953,0.7695250956560882
8104,0.8107,5,2,5,675422,1022,122842,3414,0.008094664808009125,0.7696122633002705
8105,0.8108,2,3,2,675425,1019,122844,3412,0.008070903561018881,0.7700293387497179
8106,0.8109,5,1,5,675426,1018,122849,3407,0.008062983145355468,0.7699435028248588
8107,0.811,2,0,2,675426,1018,122851,3405,0.008062983145355468,0.7698394754691386
8108,0.8111,5,0,5,675426,1018,122856,3400,0.008062983145355468,0.7695789950203712
8109,0.8112,0,1,0,675427,1017,122856,3400,0.008055062729692055,0.7697532261716097
8110,0.8113,4,0,4,675427,1017,122860,3396,0.008055062729692055,0.769544527532291
8111,0.8114,5,0,5,675427,1017,122865,3391,0.008055062729692055,0.7692831215970962
8112,0.8115,2,2,2,675429,1015,122867,3389,0.008039221898365227,0.76952770208901
8113,0.8116,9,1,9,675430,1014,122876,3380,0.008031301482701812,0.7692307692307693
8114,0.8117,2,1,2,675431,1013,122878,3378,0.008023381067038399,0.7693008426326577
8115,0.8118,6,2,6,675433,1011,122884,3372,0.00800754023571157,0.7693360711841205
8116,0.8119,7,3,7,675436,1008,122891,3365,0.007983778988721327,0.7694946261147954
8117,0.812,5,1,5,675437,1007,122896,3360,0.007975858573057914,0.7694069155026334
8118,0.8121,3,2,3,675439,1005,122899,3357,0.007960017741731086,0.7696011004126547
8119,0.8122,5,0,5,675439,1005,122904,3352,0.007960017741731086,0.7693366995639201
8120,0.8123,6,0,6,675439,1005,122910,3346,0.007960017741731086,0.7690186164100207
8121,0.8124,5,1,5,675440,1004,122915,3341,0.007952097326067673,0.7689298043728423
8122,0.8125,4,2,4,675442,1002,122919,3337,0.007936256494740845,0.7690712145655682
8123,0.8126,5,2,5,675444,1000,122924,3332,0.007920415663414017,0.7691597414589104
8124,0.8127,7,0,7,675444,1000,122931,3325,0.007920415663414017,0.7687861271676301
8125,0.8128,7,3,7,675447,997,122938,3318,0.007896654416423773,0.7689455388180765
8126,0.8129,3,4,3,675451,993,122941,3315,0.007864972753770117,0.7694986072423399
8127,0.813,4,4,4,675455,989,122945,3311,0.007833291091116463,0.77
8128,0.8131,4,0,4,675455,989,122949,3307,0.007833291091116463,0.7697858472998138
8129,0.8132,2,3,2,675458,986,122951,3305,0.007809529844126219,0.7702167326963412
8130,0.8133,8,0,8,675458,986,122959,3297,0.007809529844126219,0.7697875321036657
8131,0.8134,6,0,6,675458,986,122965,3291,0.007809529844126219,0.7694645779752163
8132,0.8135,4,2,4,675460,984,122969,3287,0.007793689012799392,0.769608990868649
8133,0.8136,5,0,5,675460,984,122974,3282,0.007793689012799392,0.7693389592123769
8134,0.8137,5,2,5,675462,982,122979,3277,0.007777848181472564,0.7694294435313453
8135,0.8138,4,4,4,675466,978,122983,3273,0.007746166518818908,0.7699364855328158
8136,0.8139,3,3,3,675469,975,122986,3270,0.007722405271828665,0.7703180212014135
8137,0.814,4,1,4,675470,974,122990,3266,0.007714484856165251,0.7702830188679245
8138,0.8141,1,1,1,675471,973,122991,3265,0.007706564440501837,0.770410571024068
8139,0.8142,2,0,2,675471,973,122993,3263,0.007706564440501837,0.7703021718602455
8140,0.8143,5,2,5,675473,971,122998,3258,0.00769072360917501,0.7703948924095531
8141,0.8144,4,1,4,675474,970,123002,3254,0.007682803193511596,0.7703598484848485
8142,0.8145,5,1,5,675475,969,123007,3249,0.007674882777848182,0.7702702702702703
8143,0.8146,8,2,8,675477,967,123015,3241,0.007659041946521354,0.7701996197718631
8144,0.8147,7,3,7,675480,964,123022,3234,0.007635280699531111,0.7703668413530252
8145,0.8148,11,1,11,675481,963,123033,3223,0.007627360283867697,0.7699474438604873
8146,0.8149,5,0,5,675481,963,123038,3218,0.007627360283867697,0.7696723271944511
8147,0.815,1,1,1,675482,962,123039,3217,0.007619439868204283,0.7698013878918402
8148,0.8151,4,3,4,675485,959,123043,3213,0.007595678621214041,0.7701342281879194
8149,0.8152,6,3,6,675488,956,123049,3207,0.0075719173742238,0.7703579149651694
8150,0.8153,8,4,8,675492,952,123057,3199,0.007540235711570143,0.7706576728499157
8151,0.8155,4,2,4,675494,950,123061,3195,0.007524394880243315,0.7708082026537998
8152,0.8156,11,2,11,675496,948,123072,3184,0.007508554048916487,0.7705711519845111
8153,0.8157,8,2,8,675498,946,123080,3176,0.007492713217589659,0.7704997573993208
8154,0.8158,5,0,5,675498,946,123085,3171,0.007492713217589659,0.7702210347340296
8155,0.8159,3,1,3,675499,945,123088,3168,0.007484792801926245,0.7702407002188184
8156,0.816,4,2,4,675501,943,123092,3164,0.007468951970599417,0.7703920136352569
8157,0.8161,4,2,4,675503,941,123096,3160,0.007453111139272589,0.7705437698122409
8158,0.8162,6,1,6,675504,940,123102,3154,0.007445190723609175,0.7703957010258915
8159,0.8163,3,2,3,675506,938,123105,3151,0.007429349892282347,0.7706040596722915
8160,0.8164,5,1,5,675507,937,123110,3146,0.007421429476618933,0.7705118785206956
8161,0.8165,4,1,4,675508,936,123114,3142,0.007413509060955519,0.7704757233938205
8162,0.8166,3,0,3,675508,936,123117,3139,0.007413509060955519,0.7703067484662577
8163,0.8167,1,1,1,675509,935,123118,3138,0.007405588645292105,0.7704394794991407
8164,0.8168,6,2,6,675511,933,123124,3132,0.007389747813965277,0.770479704797048
8165,0.8169,4,2,4,675513,931,123128,3128,0.007373906982638449,0.7706331608770634
8166,0.817,11,1,11,675514,930,123139,3117,0.007365986566975035,0.7702001482579689
8167,0.8171,5,2,5,675516,928,123144,3112,0.007350145735648207,0.7702970297029703
8168,0.8172,4,1,4,675517,927,123148,3108,0.007342225319984793,0.7702602230483271
8169,0.8173,4,0,4,675517,927,123152,3104,0.007342225319984793,0.7700322500620194
8170,0.8174,2,3,2,675520,924,123154,3102,0.007318464072994551,0.7704918032786885
8171,0.8175,7,1,7,675521,923,123161,3095,0.007310543657331137,0.7702837232453957
8172,0.8177,4,3,4,675524,920,123165,3091,0.007286782410340894,0.7706307653951633
8173,0.8178,4,0,4,675524,920,123169,3087,0.007286782410340894,0.7704017968555029
8174,0.8179,8,0,8,675524,920,123177,3079,0.007286782410340894,0.7699424856214053
8175,0.818,6,3,6,675527,917,123183,3073,0.007263021163350653,0.7701754385964912
8176,0.8181,4,0,4,675527,917,123187,3069,0.007263021163350653,0.7699448068238836
8177,0.8182,4,1,4,675528,916,123191,3065,0.007255100747687239,0.769907058528008
8178,0.8183,5,1,5,675529,915,123196,3060,0.007247180332023825,0.769811320754717
8179,0.8184,3,2,3,675531,913,123199,3057,0.007231339500696997,0.7700251889168765
8180,0.8185,10,1,10,675532,912,123209,3047,0.007223419085033583,0.7696387976761808
8181,0.8186,4,0,4,675532,912,123213,3043,0.007223419085033583,0.7694058154235145
8182,0.8187,1,1,1,675533,911,123214,3042,0.0072154986693701685,0.76954211990893
8183,0.8188,6,1,6,675534,910,123220,3036,0.0072075782537067545,0.769386720729853
8184,0.8189,2,2,2,675536,908,123222,3034,0.007191737422379926,0.7696600710299341
8185,0.819,3,1,3,675537,907,123225,3031,0.007183817006716512,0.7696800406297613
8186,0.8191,5,2,5,675539,905,123230,3026,0.007167976175389684,0.7697786822691427
8187,0.8192,4,0,4,675539,905,123234,3022,0.007167976175389684,0.7695441813088872
8188,0.8193,5,0,5,675539,905,123239,3017,0.007167976175389684,0.7692503824579296
8189,0.8194,2,2,2,675541,903,123241,3015,0.007152135344062857,0.7695252679938744
8190,0.8195,1,3,1,675544,900,123242,3014,0.0071283740970726145,0.770056208482371
8191,0.8196,3,0,3,675544,900,123245,3011,0.0071283740970726145,0.7698798261314241
8192,0.8197,3,0,3,675544,900,123248,3008,0.0071283740970726145,0.7697031729785057
8193,0.8198,2,2,2,675546,898,123250,3006,0.007112533265745786,0.7699795081967213
8194,0.8199,3,0,3,675546,898,123253,3003,0.007112533265745786,0.7698026147141759
8195,0.82,4,1,4,675547,897,123257,2999,0.007104612850082372,0.7697638603696099
8196,0.8201,6,0,6,675547,897,123263,2993,0.007104612850082372,0.7694087403598971
8197,0.8202,3,1,3,675548,896,123266,2990,0.007096692434418958,0.7694287184765826
8198,0.8203,2,1,2,675549,895,123268,2988,0.007088772018755544,0.7695081122843163
8199,0.8204,2,2,2,675551,893,123270,2986,0.007072931187428716,0.7697860273266306
8200,0.8205,4,2,4,675553,891,123274,2982,0.007057090356101888,0.7699457784663052
8201,0.8206,4,3,4,675556,888,123278,2978,0.007033329109111646,0.7703052250387998
8202,0.8207,4,1,4,675557,887,123282,2974,0.007025408693448232,0.7702667702667703
8203,0.8208,3,1,3,675558,886,123285,2971,0.007017488277784818,0.7702877884366087
8204,0.8209,3,1,3,675559,885,123288,2968,0.007009567862121404,0.7703088502465611
8205,0.821,3,2,3,675561,883,123291,2965,0.006993727030794576,0.7705301455301455
8206,0.8211,5,0,5,675561,883,123296,2960,0.006993727030794576,0.7702315899037211
8207,0.8212,6,0,6,675561,883,123302,2954,0.006993727030794576,0.7698722960646338
8208,0.8213,8,1,8,675562,882,123310,2946,0.006985806615131162,0.7695924764890282
8209,0.8214,4,4,4,675566,878,123314,2942,0.006954124952477506,0.7701570680628272
8210,0.8215,1,1,1,675567,877,123315,2941,0.006946204536814092,0.7702985856469355
8211,0.8216,7,3,7,675570,874,123322,2934,0.00692244328982385,0.770483193277311
8212,0.8217,5,6,5,675576,868,123327,2929,0.006874920795843366,0.7713984724782723
8213,0.8218,7,4,7,675580,864,123334,2922,0.00684323913318971,0.7717908082408875
8214,0.8219,3,2,3,675582,862,123337,2919,0.006827398301862882,0.7720179846601428
8215,0.822,1,2,1,675584,860,123338,2918,0.006811557470536054,0.7723663313922711
8216,0.8221,7,0,7,675584,860,123345,2911,0.006811557470536054,0.7719437814903208
8217,0.8222,5,2,5,675586,858,123350,2906,0.006795716639209226,0.7720510095642933
8218,0.8223,5,3,5,675589,855,123355,2901,0.0067719553922189835,0.7723642172523961
8219,0.8224,2,1,2,675590,854,123357,2899,0.006764034976555569,0.7724487077005062
8220,0.8225,4,4,4,675594,850,123361,2895,0.006732353313901914,0.7730307076101469
8221,0.8226,4,1,4,675595,849,123365,2891,0.0067244328982385,0.7729946524064171
8222,0.8227,8,0,8,675595,849,123373,2883,0.0067244328982385,0.772508038585209
8223,0.8228,7,1,7,675596,848,123380,2876,0.006716512482575086,0.7722878625134264
8224,0.8229,5,1,5,675597,847,123385,2871,0.006708592066911672,0.772189349112426
8225,0.823,3,1,3,675598,846,123388,2868,0.006700671651248258,0.7722132471728594
8226,0.8231,7,2,7,675600,844,123395,2861,0.0066848308199214295,0.772199730094467
8227,0.8232,5,2,5,675602,842,123400,2856,0.006668989988594601,0.7723093564088697
8228,0.8233,8,1,8,675603,841,123408,2848,0.006661069572931187,0.7720249390078612
8229,0.8234,4,1,4,675604,840,123412,2844,0.006653149157267773,0.7719869706840391
8230,0.8235,3,3,3,675607,837,123415,2841,0.006629387910277532,0.7724306688417618
8231,0.8236,4,2,4,675609,835,123419,2837,0.006613547078950704,0.7726034858387799
8232,0.8237,5,0,5,675609,835,123424,2832,0.006613547078950704,0.7722934278701936
8233,0.8238,2,2,2,675611,833,123426,2830,0.0065977062476238755,0.7725907725907726
8234,0.8239,3,1,3,675612,832,123429,2827,0.006589785831960461,0.772615468707297
8235,0.824,7,0,7,675612,832,123436,2820,0.006589785831960461,0.7721796276013143
8236,0.8241,3,1,3,675613,831,123439,2817,0.006581865416297047,0.772203947368421
8237,0.8242,4,2,4,675615,829,123443,2813,0.006566024584970219,0.772377814387699
8238,0.8243,4,3,4,675618,826,123447,2809,0.006542263337979977,0.7727647867950481
8239,0.8244,2,2,2,675620,824,123449,2807,0.006526422506653149,0.7730652712751308
8240,0.8245,6,2,6,675622,822,123455,2801,0.0065105816753263214,0.7731162020425062
8241,0.8246,1,0,1,675622,822,123456,2800,0.0065105816753263214,0.7730535615681944
8242,0.8247,6,5,6,675627,817,123462,2794,0.006470979597009251,0.7737468845195237
8243,0.8248,5,1,5,675628,816,123467,2789,0.006463059181345837,0.7736477115117891
8244,0.8249,4,1,4,675629,815,123471,2785,0.006455138765682423,0.7736111111111111
8245,0.825,7,2,7,675631,813,123478,2778,0.006439297934355595,0.7736006683375104
8246,0.8251,2,0,2,675631,813,123480,2776,0.006439297934355595,0.7734745054332683
8247,0.8252,2,4,2,675635,809,123482,2774,0.006407616271701939,0.7742115545632152
8248,0.8253,4,1,4,675636,808,123486,2770,0.006399695856038525,0.7741755170486305
8249,0.8254,10,1,10,675637,807,123496,2760,0.006391775440375111,0.7737594617325484
8250,0.8255,6,2,6,675639,805,123502,2754,0.006375934609048283,0.7738128687833661
8251,0.8257,5,2,5,675641,803,123507,2749,0.006360093777721455,0.7739301801801802
8252,0.8258,6,1,6,675642,802,123513,2743,0.006352173362058041,0.7737658674188999
8253,0.8259,5,0,5,675642,802,123518,2738,0.006352173362058041,0.7734463276836158
8254,0.826,2,1,2,675643,801,123520,2736,0.006344252946394627,0.7735368956743003
8255,0.8261,6,0,6,675643,801,123526,2730,0.006344252946394627,0.7731520815632965
8256,0.8262,6,2,6,675645,799,123532,2724,0.0063284121150677984,0.7732046551234744
8257,0.8263,3,2,3,675647,797,123535,2721,0.006312571283740971,0.7734508243320068
8258,0.8264,3,1,3,675648,796,123538,2718,0.006304650868077557,0.7734775184974388
8259,0.8265,6,1,6,675649,795,123544,2712,0.006296730452414143,0.7733105218135158
8260,0.8266,4,1,4,675650,794,123548,2708,0.006288810036750729,0.7732724157624215
8261,0.8267,5,1,5,675651,793,123553,2703,0.006280889621087315,0.7731693363844394
8262,0.8268,1,3,1,675654,790,123554,2702,0.006257128374097073,0.7737686139747996
8263,0.8269,1,2,1,675656,788,123555,2701,0.006241287542770244,0.7741473201490399
8264,0.827,3,1,3,675657,787,123558,2698,0.00623336712710683,0.7741750358680057
8265,0.8271,7,0,7,675657,787,123565,2691,0.00623336712710683,0.773720529039678
8266,0.8272,2,0,2,675657,787,123567,2689,0.00623336712710683,0.773590333716916
8267,0.8273,2,0,2,675657,787,123569,2687,0.00623336712710683,0.7734599884858953
8268,0.8274,3,3,3,675660,784,123572,2684,0.006209605880116588,0.7739331026528259
8269,0.8275,4,0,4,675660,784,123576,2680,0.006209605880116588,0.7736720554272517
8270,0.8276,1,5,1,675665,779,123577,2679,0.0061700038017995186,0.7747252747252747
8271,0.8277,5,1,5,675666,778,123582,2674,0.0061620833861361045,0.7746234067207416
8272,0.8278,7,0,7,675666,778,123589,2667,0.0061620833861361045,0.7741654571843251
8273,0.8279,6,4,6,675670,774,123595,2661,0.006130401723482448,0.7746724890829695
8274,0.828,1,2,1,675672,772,123596,2660,0.00611456089215562,0.7750582750582751
8275,0.8281,6,2,6,675674,770,123602,2654,0.006098720060828793,0.7751168224299065
8276,0.8282,4,0,4,675674,770,123606,2650,0.006098720060828793,0.7748538011695907
8277,0.8283,7,0,7,675674,770,123613,2643,0.006098720060828793,0.7743920304717258
8278,0.8284,4,2,4,675676,768,123617,2639,0.0060828792295019645,0.7745817434693278
8279,0.8285,1,5,1,675681,763,123618,2638,0.006043277151184894,0.7756542193472508
8280,0.8286,2,2,2,675683,761,123620,2636,0.006027436319858066,0.7759788048277892
8281,0.8287,7,1,7,675684,760,123627,2629,0.006019515904194652,0.7757450575390971
8282,0.8288,3,1,3,675685,759,123630,2626,0.006011595488531238,0.7757754800590841
8283,0.8289,6,0,6,675685,759,123636,2620,0.006011595488531238,0.7753773305711749
8284,0.829,3,3,3,675688,756,123639,2617,0.0059878342415409964,0.7758671805514379
8285,0.8291,2,1,2,675689,755,123641,2615,0.005979913825877582,0.7759643916913946
8286,0.8292,6,1,6,675690,754,123647,2609,0.005971993410214168,0.7757954207552781
8287,0.8293,10,0,10,675690,754,123657,2599,0.005971993410214168,0.7751267521622428
8288,0.8294,8,3,8,675693,751,123665,2591,0.005948232163223926,0.7752842609216039
8289,0.8295,1,2,1,675695,749,123666,2590,0.005932391331897098,0.7756813417190775
8290,0.8296,3,1,3,675696,748,123669,2587,0.005924470916233684,0.775712143928036
8291,0.8297,5,0,5,675696,748,123674,2582,0.005924470916233684,0.7753753753753754
8292,0.8298,4,0,4,675696,748,123678,2578,0.005924470916233684,0.7751052315093205
8293,0.8299,6,1,6,675697,747,123684,2572,0.00591655050057027,0.7749322084965351
8294,0.83,3,1,3,675698,746,123687,2569,0.005908630084906856,0.7749622926093515
8295,0.8301,6,2,6,675700,744,123693,2563,0.0058927892535800275,0.7750226791654067
8296,0.8302,4,1,4,675701,743,123697,2559,0.005884868837916614,0.774984857662023
8297,0.8303,2,2,2,675703,741,123699,2557,0.005869028006589786,0.7753183747725895
8298,0.8304,1,2,1,675705,739,123700,2556,0.005853187175262958,0.775720789074355
8299,0.8305,2,0,2,675705,739,123702,2554,0.005853187175262958,0.7755845733373823
8300,0.8306,4,1,4,675706,738,123706,2550,0.005845266759599544,0.7755474452554745
8301,0.8307,1,1,1,675707,737,123707,2549,0.00583734634393613,0.7757151552038953
8302,0.8308,5,3,5,675710,734,123712,2544,0.0058135850969458875,0.7760829774252593
8303,0.8309,5,2,5,675712,732,123717,2539,0.005797744265619059,0.776215224701926
8304,0.831,2,1,2,675713,731,123719,2537,0.005789823849955645,0.7763157894736842
8305,0.8311,3,1,3,675714,730,123722,2534,0.005781903434292232,0.7763480392156863
8306,0.8312,4,0,4,675714,730,123726,2530,0.005781903434292232,0.7760736196319018
8307,0.8313,3,1,3,675715,729,123729,2527,0.005773983018628818,0.7761056511056511
8308,0.8314,2,1,2,675716,728,123731,2525,0.005766062602965404,0.7762065785428834
8309,0.8315,4,1,4,675717,727,123735,2521,0.00575814218730199,0.7761699507389163
8310,0.8316,1,3,1,675720,724,123736,2520,0.005734380940311748,0.7768187422934648
8311,0.8317,6,0,6,675720,724,123742,2514,0.005734380940311748,0.7764051883878937
8312,0.8318,4,0,4,675720,724,123746,2510,0.005734380940311748,0.7761286332714904
8313,0.8319,1,2,1,675722,722,123747,2509,0.0057185401089849194,0.7765397709687403
8314,0.832,3,3,3,675725,719,123750,2506,0.005694778861994677,0.7770542635658915
8315,0.8321,1,0,1,675725,719,123751,2505,0.005694778861994677,0.776985111662531
8316,0.8322,5,2,5,675727,717,123756,2500,0.005678938030667849,0.777121541809139
8317,0.8323,0,2,0,675729,715,123756,2500,0.005663097199341022,0.7776049766718507
8318,0.8324,4,1,4,675730,714,123760,2496,0.005655176783677608,0.7775700934579439
8319,0.8325,3,1,3,675731,713,123763,2493,0.005647256368014194,0.7776044915782907
8320,0.8326,3,2,3,675733,711,123766,2490,0.005631415536687365,0.7778819119025304
8321,0.8327,7,3,7,675736,708,123773,2483,0.005607654289697123,0.7781259793168286
8322,0.8328,7,0,7,675736,708,123780,2476,0.005607654289697123,0.7776381909547738
8323,0.8329,1,2,1,675738,706,123781,2475,0.005591813458370295,0.7780572147123546
8324,0.833,2,1,2,675739,705,123783,2473,0.005583893042706881,0.7781623662680931
8325,0.8331,4,0,4,675739,705,123787,2469,0.005583893042706881,0.777882797731569
8326,0.8332,6,2,6,675741,703,123793,2463,0.005568052211380054,0.7779532533164877
8327,0.8333,4,1,4,675742,702,123797,2459,0.0055601317957166396,0.7779183802594116
8328,0.8334,2,1,2,675743,701,123799,2457,0.0055522113800532255,0.7780240658644711
8329,0.8335,5,1,5,675744,700,123804,2452,0.005544290964389811,0.7779187817258884
8330,0.8336,3,1,3,675745,699,123807,2449,0.005536370548726397,0.7779542566709021
8331,0.8337,1,3,1,675748,696,123808,2448,0.005512609301736155,0.7786259541984732
8332,0.8338,8,1,8,675749,695,123816,2440,0.005504688886072741,0.7783094098883573
8333,0.8339,2,2,2,675751,693,123818,2438,0.005488848054745913,0.7786649632705206
8334,0.834,5,0,5,675751,693,123823,2433,0.005488848054745913,0.7783109404990403
8335,0.8341,0,2,0,675753,691,123823,2433,0.005473007223419085,0.778809218950064
8336,0.8342,3,0,3,675753,691,123826,2430,0.005473007223419085,0.7785966036526755
8337,0.8343,4,0,4,675753,691,123830,2426,0.005473007223419085,0.7783124799486686
8338,0.8344,3,1,3,675754,690,123833,2423,0.005465086807755671,0.7783488596209445
8339,0.8345,2,0,2,675754,690,123835,2421,0.005465086807755671,0.7782063645130183
8340,0.8346,3,1,3,675755,689,123838,2418,0.005457166392092257,0.7782426778242678
8341,0.8347,6,1,6,675756,688,123844,2412,0.005449245976428843,0.7780645161290323
8342,0.8348,7,1,7,675757,687,123851,2405,0.005441325560765429,0.7778137128072445
8343,0.8349,2,2,2,675759,685,123853,2403,0.005425484729438601,0.7781735751295337
8344,0.835,4,2,4,675761,683,123857,2399,0.005409643898111773,0.7783906554185593
8345,0.8351,6,2,6,675763,681,123863,2393,0.005393803066784945,0.7784645413142486
8346,0.8352,3,2,3,675765,679,123866,2390,0.0053779622354581166,0.7787552948843272
8347,0.8353,4,0,4,675765,679,123870,2386,0.0053779622354581166,0.7784665579119087
8348,0.8354,1,0,1,675765,679,123871,2385,0.0053779622354581166,0.7783942558746736
8349,0.8355,3,1,3,675766,678,123874,2382,0.0053700418197947025,0.7784313725490196
8350,0.8356,4,1,4,675767,677,123878,2378,0.005362121404131288,0.7783960720130932
8351,0.8357,5,2,5,675769,675,123883,2373,0.005346280572804461,0.7785433070866141
8352,0.8358,4,3,4,675772,672,123887,2369,0.005322519325814219,0.7790200591910555
8353,0.8359,0,2,0,675774,670,123887,2369,0.005306678494487391,0.7795327410332347
8354,0.836,2,1,2,675775,669,123889,2367,0.005298758078823977,0.7796442687747036
8355,0.8361,4,3,4,675778,666,123893,2363,0.005274996831833734,0.7801254539451964
8356,0.8362,8,0,8,675778,666,123901,2355,0.005274996831833734,0.7795431976166832
8357,0.8363,5,2,5,675780,664,123906,2350,0.005259156000506906,0.7796947577969475
8358,0.8364,4,3,4,675783,661,123910,2346,0.005235394753516665,0.7801795809777187
8359,0.8365,2,3,2,675786,658,123912,2344,0.005211633506526423,0.7808127914723517
8360,0.8366,2,2,2,675788,656,123914,2342,0.0051957926751995944,0.781187458305537
8361,0.8367,4,1,4,675789,655,123918,2338,0.00518787225953618,0.7811560307383896
8362,0.8368,6,5,6,675794,650,123924,2332,0.00514827018121911,0.7820254862508383
8363,0.8369,7,2,7,675796,648,123931,2325,0.005132429349892283,0.7820383451059536
8364,0.837,3,0,3,675796,648,123934,2322,0.005132429349892283,0.7818181818181819
8365,0.8371,6,4,6,675800,644,123940,2316,0.005100747687238626,0.7824324324324324
8366,0.8372,4,1,4,675801,643,123944,2312,0.005092827271575212,0.7824027072758037
8367,0.8373,6,0,6,675801,643,123950,2306,0.005092827271575212,0.78195998643608
8368,0.8374,7,1,7,675802,642,123957,2299,0.005084906855911798,0.7817069024141449
8369,0.8375,4,0,4,675802,642,123961,2295,0.005084906855911798,0.7814096016343207
8370,0.8376,2,4,2,675806,638,123963,2293,0.005053225193258142,0.7823268509041282
8371,0.8377,2,1,2,675807,637,123965,2291,0.005045304777594728,0.7824453551912568
8372,0.8378,7,3,7,675810,634,123972,2284,0.005021543530604486,0.7827278958190541
8373,0.8379,6,1,6,675811,633,123978,2278,0.005013623114941072,0.7825489522500859
8374,0.838,2,1,2,675812,632,123980,2276,0.005005702699277658,0.782668500687758
8375,0.8381,1,0,1,675812,632,123981,2275,0.005005702699277658,0.782593739250086
8376,0.8382,2,0,2,675812,632,123983,2273,0.005005702699277658,0.7824440619621342
8377,0.8383,5,0,5,675812,632,123988,2268,0.005005702699277658,0.7820689655172414
8378,0.8385,3,0,3,675812,632,123991,2265,0.005005702699277658,0.7818432861580946
8379,0.8386,9,0,9,675812,632,124000,2256,0.005005702699277658,0.7811634349030471
8380,0.8387,4,2,4,675814,630,124004,2252,0.00498986186795083,0.7814018043025677
8381,0.8388,7,2,7,675816,628,124011,2245,0.004974021036624002,0.7814131569787678
8382,0.8389,3,3,3,675819,625,124014,2242,0.00495025978963376,0.7820020927799093
8383,0.839,4,1,4,675820,624,124018,2238,0.004942339373970346,0.7819706498951782
8384,0.8391,3,3,3,675823,621,124021,2235,0.004918578126980104,0.782563025210084
8385,0.8392,4,0,4,675823,621,124025,2231,0.004918578126980104,0.782258064516129
8386,0.8393,6,0,6,675823,621,124031,2225,0.004918578126980104,0.7817990161630358
8387,0.8394,3,0,3,675823,621,124034,2222,0.004918578126980104,0.7815687653886739
8388,0.8395,6,1,6,675824,620,124040,2216,0.00491065771131669,0.7813822284908322
8389,0.8396,7,1,7,675825,619,124047,2209,0.004902737295653276,0.7811173974540311
8390,0.8397,8,2,8,675827,617,124055,2201,0.004886896464326448,0.7810503903477644
8391,0.8398,5,1,5,675828,616,124060,2196,0.004878976048663034,0.7809388335704125
8392,0.8399,0,2,0,675830,614,124060,2196,0.004863135217336206,0.7814946619217081
8393,0.84,5,0,5,675830,614,124065,2191,0.004863135217336206,0.7811051693404635
8394,0.8401,5,3,5,675833,611,124070,2186,0.004839373970345963,0.7815516624955309
8395,0.8402,4,0,4,675833,611,124074,2182,0.004839373970345963,0.7812388113139993
8396,0.8403,4,2,4,675835,609,124078,2178,0.004823533139019136,0.7814854682454252
8397,0.8404,2,1,2,675836,608,124080,2176,0.004815612723355722,0.7816091954022989
8398,0.8405,4,1,4,675837,607,124084,2172,0.004807692307692308,0.7815761065131342
8399,0.8406,7,2,7,675839,605,124091,2165,0.00479185147636548,0.7815884476534296
8400,0.8407,3,0,3,675839,605,124094,2162,0.00479185147636548,0.7813516443801951
8401,0.8408,5,0,5,675839,605,124099,2157,0.00479185147636548,0.780955829109341
8402,0.8409,3,3,3,675842,602,124102,2154,0.0047680902293752376,0.7815674891146589
8403,0.841,3,3,3,675845,599,124105,2151,0.004744328982384995,0.7821818181818182
8404,0.8411,5,0,5,675845,599,124110,2146,0.004744328982384995,0.7817850637522769
8405,0.8412,3,1,3,675846,598,124113,2143,0.004736408566721581,0.781831448376505
8406,0.8413,5,2,5,675848,596,124118,2138,0.004720567735394754,0.7820043891733723
8407,0.8414,5,0,5,675848,596,124123,2133,0.004720567735394754,0.7816049835104434
8408,0.8415,5,2,5,675850,594,124128,2128,0.004704726904067926,0.7817781043350478
8409,0.8416,5,2,5,675852,592,124133,2123,0.004688886072741098,0.7819521178637201
8410,0.8417,6,1,6,675853,591,124139,2117,0.0046809656570776835,0.7817577548005908
8411,0.8418,4,0,4,675853,591,124143,2113,0.0046809656570776835,0.7814349112426036
8412,0.8419,4,2,4,675855,589,124147,2109,0.004665124825750855,0.7816901408450704
8413,0.842,5,0,5,675855,589,124152,2104,0.004665124825750855,0.7812848124767917
8414,0.8421,5,0,5,675855,589,124157,2099,0.004665124825750855,0.7808779761904762
8415,0.8422,6,0,6,675855,589,124163,2093,0.004665124825750855,0.7803877703206562
8416,0.8423,2,1,2,675856,588,124165,2091,0.004657204410087441,0.780515117581187
8417,0.8424,6,1,6,675857,587,124171,2085,0.004649283994424027,0.780314371257485
8418,0.8425,5,1,5,675858,586,124176,2080,0.004641363578760613,0.7801950487621906
8419,0.8426,4,1,4,675859,585,124180,2076,0.004633443163097199,0.7801578354002254
8420,0.8427,3,1,3,675860,584,124183,2073,0.004625522747433785,0.7802032367331577
8421,0.8428,5,0,5,675860,584,124188,2068,0.004625522747433785,0.779788838612368
8422,0.8429,3,1,3,675861,583,124191,2065,0.004617602331770371,0.779833836858006
8423,0.843,3,0,3,675861,583,124194,2062,0.004617602331770371,0.7795841209829868
8424,0.8431,2,2,2,675863,581,124196,2060,0.004601761500443544,0.7800075728890572
8425,0.8432,6,3,6,675866,578,124202,2054,0.004578000253453301,0.7803951367781155
8426,0.8433,3,0,3,675866,578,124205,2051,0.004578000253453301,0.7801445416508178
8427,0.8434,1,1,1,675867,577,124206,2050,0.004570079837789887,0.7803578226113438
8428,0.8435,5,2,5,675869,575,124211,2045,0.004554239006463059,0.7805343511450382
8429,0.8436,3,2,3,675871,573,124214,2042,0.004538398175136231,0.7808795411089866
8430,0.8437,2,3,2,675874,570,124216,2040,0.004514636928145989,0.7816091954022989
8431,0.8438,5,1,5,675875,569,124221,2035,0.0045067165124825755,0.7814900153609831
8432,0.8439,4,1,4,675876,568,124225,2031,0.004498796096819161,0.7814544055405925
8433,0.844,2,2,2,675878,566,124227,2029,0.004482955265492333,0.7818882466281311
8434,0.8441,6,2,6,675880,564,124233,2023,0.004467114434165505,0.7819868573637417
8435,0.8442,3,1,3,675881,563,124236,2020,0.004459194018502091,0.7820363917924894
8436,0.8443,4,0,4,675881,563,124240,2016,0.004459194018502091,0.781698332687088
8437,0.8444,6,1,6,675882,562,124246,2010,0.004451273602838677,0.78149300155521
8438,0.8445,5,1,5,675883,561,124251,2005,0.004443353187175263,0.7813717848791893
8439,0.8446,4,2,4,675885,559,124255,2001,0.004427512355848435,0.781640625
8440,0.8447,7,2,7,675887,557,124262,1994,0.0044116715245216065,0.7816542532340258
8441,0.8448,4,1,4,675888,556,124266,1990,0.0044037511088581924,0.781618224666143
8442,0.8449,6,0,6,675888,556,124272,1984,0.0044037511088581924,0.7811023622047244
8443,0.845,3,1,3,675889,555,124275,1981,0.004395830693194779,0.7811514195583596
8444,0.8451,3,3,3,675892,552,124278,1978,0.004372069446204537,0.7818181818181819
8445,0.8452,3,3,3,675895,549,124281,1975,0.004348308199214295,0.7824881141045958
8446,0.8453,10,1,10,675896,548,124291,1965,0.004340387783550881,0.781933943493832
8447,0.8454,6,1,6,675897,547,124297,1959,0.004332467367887467,0.7817238627294493
8448,0.8455,5,0,5,675897,547,124302,1954,0.004332467367887467,0.7812874850059977
8449,0.8456,4,1,4,675898,546,124306,1950,0.0043245469522240525,0.78125
8450,0.8457,5,1,5,675899,545,124311,1945,0.004316626536560638,0.7811244979919679
8451,0.8458,6,1,6,675900,544,124317,1939,0.004308706120897224,0.7809101892871526
8452,0.8459,3,0,3,675900,544,124320,1936,0.004308706120897224,0.7806451612903226
8453,0.846,3,0,3,675900,544,124323,1933,0.004308706120897224,0.7803794913201454
8454,0.8461,3,0,3,675900,544,124326,1930,0.004308706120897224,0.7801131770412287
8455,0.8462,2,1,2,675901,543,124328,1928,0.00430078570523381,0.7802509105625253
8456,0.8463,2,3,2,675904,540,124330,1926,0.004277024458243569,0.781021897810219
8457,0.8464,2,1,2,675905,539,124332,1924,0.004269104042580155,0.781161185546082
8458,0.8465,1,1,1,675906,538,124333,1923,0.004261183626916741,0.7813896789922795
8459,0.8466,10,1,10,675907,537,124343,1913,0.004253263211253327,0.7808163265306123
8460,0.8467,2,0,2,675907,537,124345,1911,0.004253263211253327,0.7806372549019608
8461,0.8468,1,2,1,675909,535,124346,1910,0.0042374223799264985,0.7811860940695297
8462,0.8469,1,1,1,675910,534,124347,1909,0.004229501964263084,0.7814162914449447
8463,0.847,1,2,1,675912,532,124348,1908,0.004213661132936256,0.7819672131147541
8464,0.8471,0,1,0,675913,531,124348,1908,0.004205740717272842,0.7822878228782287
8465,0.8472,3,1,3,675914,530,124351,1905,0.004197820301609428,0.7823408624229979
8466,0.8473,3,0,3,675914,530,124354,1902,0.004197820301609428,0.7820723684210527
8467,0.8474,3,2,3,675916,528,124357,1899,0.004181979470282601,0.7824474660074165
8468,0.8475,5,1,5,675917,527,124362,1894,0.004174059054619187,0.7823213548120611
8469,0.8476,6,2,6,675919,525,124368,1888,0.0041582182232923585,0.7824285122254455
8470,0.8477,0,2,0,675921,523,124368,1888,0.00414237739196553,0.7830775611779345
8471,0.8478,3,0,3,675921,523,124371,1885,0.00414237739196553,0.7828073089700996
8472,0.8479,5,1,5,675922,522,124376,1880,0.004134456976302116,0.7826810990840966
8473,0.848,7,1,7,675923,521,124383,1873,0.004126536560638702,0.7823725981620718
8474,0.8481,5,1,5,675924,520,124388,1868,0.004118616144975288,0.7822445561139029
8475,0.8482,2,1,2,675925,519,124390,1866,0.004110695729311874,0.7823899371069183
8476,0.8483,2,0,2,675925,519,124392,1864,0.004110695729311874,0.7822073017205203
8477,0.8484,3,3,3,675928,516,124395,1861,0.004086934482321632,0.7829196466133782
8478,0.8485,6,1,6,675929,515,124401,1855,0.004079014066658219,0.7827004219409283
8479,0.8486,4,0,4,675929,515,124405,1851,0.004079014066658219,0.7823330515638208
8480,0.8487,3,1,3,675930,514,124408,1848,0.0040710936509948045,0.7823878069432684
8481,0.8488,4,0,4,675930,514,124412,1844,0.0040710936509948045,0.7820186598812553
8482,0.8489,1,0,1,675930,514,124413,1843,0.0040710936509948045,0.7819261773440814
8483,0.849,4,1,4,675931,513,124417,1839,0.0040631732353313904,0.7818877551020408
8484,0.8491,4,2,4,675933,511,124421,1835,0.004047332404004562,0.7821824381926684
8485,0.8492,3,0,3,675933,511,124424,1832,0.004047332404004562,0.7819035424669227
8486,0.8493,4,1,4,675934,510,124428,1828,0.004039411988341148,0.7818648417450813
8487,0.8494,4,0,4,675934,510,124432,1824,0.004039411988341148,0.781491002570694
8488,0.8495,8,1,8,675935,509,124440,1816,0.004031491572677734,0.7810752688172043
8489,0.8496,3,3,3,675938,506,124443,1813,0.004007730325687492,0.7818025010780509
8490,0.8497,2,2,2,675940,504,124445,1811,0.003991889494360664,0.7822894168466523
8491,0.8498,5,0,5,675940,504,124450,1806,0.003991889494360664,0.7818181818181819
8492,0.8499,1,2,1,675942,502,124451,1805,0.003976048663033836,0.7824013870827915
8493,0.85,4,1,4,675943,501,124455,1801,0.003968128247370422,0.7823631624674197
8494,0.8501,0,3,0,675946,498,124455,1801,0.00394436700038018,0.7833840800347978
8495,0.8502,2,2,2,675948,496,124457,1799,0.003928526169053352,0.7838779956427016
8496,0.8503,2,0,2,675948,496,124459,1797,0.003928526169053352,0.7836894897514174
8497,0.8504,5,0,5,675948,496,124464,1792,0.003928526169053352,0.7832167832167832
8498,0.8505,4,0,4,675948,496,124468,1788,0.003928526169053352,0.7828371278458844
8499,0.8506,4,1,4,675949,495,124472,1784,0.003920605753389938,0.782799473453269
8500,0.8507,3,2,3,675951,493,124475,1781,0.0039047649220631097,0.7832014072119613
8501,0.8508,4,1,4,675952,492,124479,1777,0.003896844506399696,0.7831643895989423
8502,0.8509,3,3,3,675955,489,124482,1774,0.003873083259409454,0.7839151568714097
8503,0.851,2,2,2,675957,487,124484,1772,0.0038572424280826256,0.7844178840194777
8504,0.8511,4,0,4,675957,487,124488,1768,0.0038572424280826256,0.7840354767184036
8505,0.8512,8,0,8,675957,487,124496,1760,0.0038572424280826256,0.783266577659101
8506,0.8513,2,1,2,675958,486,124498,1758,0.0038493220124192116,0.7834224598930482
8507,0.8514,1,1,1,675959,485,124499,1757,0.003841401596755798,0.7836752899197146
8508,0.8515,4,3,4,675962,482,124503,1753,0.0038176403497655557,0.7843400447427293
8509,0.8516,1,2,1,675964,480,124504,1752,0.0038017995184387275,0.7849462365591398
8510,0.8517,4,0,4,675964,480,124508,1748,0.0038017995184387275,0.7845601436265709
8511,0.8518,4,1,4,675965,479,124512,1744,0.0037938791027753134,0.7845254161043634
8512,0.8519,2,0,2,675965,479,124514,1742,0.0037938791027753134,0.7843313822602431
8513,0.852,5,0,5,675965,479,124519,1737,0.0037938791027753134,0.7838447653429603
8514,0.8521,3,0,3,675965,479,124522,1734,0.0037938791027753134,0.7835517397198373
8515,0.8522,2,1,2,675966,478,124524,1732,0.0037859586871119,0.783710407239819
8516,0.8523,2,1,2,675967,477,124526,1730,0.0037780382714484857,0.7838695061169008
8517,0.8524,2,0,2,675967,477,124528,1728,0.0037780382714484857,0.7836734693877551
8518,0.8525,6,0,6,675967,477,124534,1722,0.0037780382714484857,0.7830832196452933
8519,0.8526,0,1,0,675968,476,124534,1722,0.0037701178557850716,0.7834394904458599
8520,0.8527,1,0,1,675968,476,124535,1721,0.0037701178557850716,0.783340919435594
8521,0.8528,1,3,1,675971,473,124536,1720,0.0037463566087948294,0.7843137254901961
8522,0.8529,4,1,4,675972,472,124540,1716,0.0037384361931314157,0.7842778793418648
8523,0.853,5,0,5,675972,472,124545,1711,0.0037384361931314157,0.7837837837837838
8524,0.8531,2,1,2,675973,471,124547,1709,0.0037305157774680017,0.7839449541284403
8525,0.8532,4,1,4,675974,470,124551,1705,0.0037225953618045876,0.7839080459770115
8526,0.8533,1,1,1,675975,469,124552,1704,0.0037146749461411735,0.7841693511274735
8527,0.8534,7,1,7,675976,468,124559,1697,0.0037067545304777594,0.7838337182448037
8528,0.8535,6,0,6,675976,468,124565,1691,0.0037067545304777594,0.7832329782306623
8529,0.8536,4,0,4,675976,468,124569,1687,0.0037067545304777594,0.782830626450116
8530,0.8537,3,0,3,675976,468,124572,1684,0.0037067545304777594,0.7825278810408922
8531,0.8538,1,0,1,675976,468,124573,1683,0.0037067545304777594,0.7824267782426778
8532,0.8539,3,2,3,675978,466,124576,1680,0.0036909136991509313,0.782851817334576
8533,0.854,4,0,4,675978,466,124580,1676,0.0036909136991509313,0.7824463118580766
8534,0.8541,2,0,2,675978,466,124582,1674,0.0036909136991509313,0.7822429906542057
8535,0.8542,1,1,1,675979,465,124583,1673,0.0036829932834875176,0.7825070159027128
8536,0.8543,2,0,2,675979,465,124585,1671,0.0036829932834875176,0.7823033707865169
8537,0.8544,6,0,6,675979,465,124591,1665,0.0036829932834875176,0.7816901408450704
8538,0.8545,7,3,7,675982,462,124598,1658,0.0036592320364972754,0.7820754716981132
8539,0.8546,4,0,4,675982,462,124602,1654,0.0036592320364972754,0.781663516068053
8540,0.8547,3,2,3,675984,460,124605,1651,0.003643391205170447,0.7820937944102321
8541,0.8548,2,1,2,675985,459,124607,1649,0.003635470789507033,0.782258064516129
8542,0.8549,2,0,2,675985,459,124609,1647,0.003635470789507033,0.782051282051282
8543,0.855,6,1,6,675986,458,124615,1641,0.0036275503738436195,0.7818008575512149
8544,0.8551,2,1,2,675987,457,124617,1639,0.0036196299581802054,0.7819656488549618
8545,0.8552,0,1,0,675988,456,124617,1639,0.0036117095425167913,0.7823389021479714
8546,0.8553,3,1,3,675989,455,124620,1636,0.0036037891268533772,0.7824007651841224
8547,0.8554,2,1,2,675990,454,124622,1634,0.003595868711189963,0.7825670498084292
8548,0.8555,3,0,3,675990,454,124625,1631,0.003595868711189963,0.7822541966426858
8549,0.8556,2,0,2,675990,454,124627,1629,0.003595868711189963,0.7820451272203552
8550,0.8557,2,0,2,675990,454,124629,1627,0.003595868711189963,0.7818356559346468
8551,0.8558,3,0,3,675990,454,124632,1624,0.003595868711189963,0.7815206929740135
8552,0.8559,5,0,5,675990,454,124637,1619,0.003595868711189963,0.7809937288953208
8553,0.856,3,1,3,675991,453,124640,1616,0.003587948295526549,0.7810536491058483
8554,0.8561,1,0,1,675991,453,124641,1615,0.003587948295526549,0.7809477756286267
8555,0.8562,2,0,2,675991,453,124643,1613,0.003587948295526549,0.7807357212003873
8556,0.8563,4,3,4,675994,450,124647,1609,0.0035641870485363073,0.7814473045167557
8557,0.8564,2,1,2,675995,449,124649,1607,0.003556266632872893,0.7816147859922179
8558,0.8565,0,2,0,675997,447,124649,1607,0.003540425801546065,0.7823758519961052
8559,0.8566,2,2,2,675999,445,124651,1605,0.0035245849702192373,0.7829268292682927
8560,0.8567,3,0,3,675999,445,124654,1602,0.0035245849702192373,0.782608695652174
8561,0.8568,4,1,4,676000,444,124658,1598,0.003516664554555823,0.7825661116552399
8562,0.8569,5,1,5,676001,443,124663,1593,0.003508744138892409,0.7824165029469549
8563,0.857,3,1,3,676002,442,124666,1590,0.003500823723228995,0.78248031496063
8564,0.8571,4,1,4,676003,441,124670,1586,0.003492903307565581,0.7824370991613222
8565,0.8572,5,0,5,676003,441,124675,1581,0.003492903307565581,0.7818991097922848
8566,0.8573,1,0,1,676003,441,124676,1580,0.003492903307565581,0.7817911924789708
8567,0.8574,2,2,2,676005,439,124678,1578,0.003477062476238753,0.782350024789291
8568,0.8575,2,0,2,676005,439,124680,1576,0.003477062476238753,0.7821339950372208
8569,0.8576,2,2,2,676007,437,124682,1574,0.003461221644911925,0.78269517652909
8570,0.8577,5,3,5,676010,434,124687,1569,0.003437460397921683,0.7833250124812781
8571,0.8578,1,2,1,676012,432,124688,1568,0.003421619566594855,0.784
8572,0.8579,4,0,4,676012,432,124692,1564,0.003421619566594855,0.7835671342685371
8573,0.858,3,2,3,676014,430,124695,1561,0.003405778735268027,0.784028126569563
8574,0.8581,4,0,4,676014,430,124699,1557,0.003405778735268027,0.7835933568193256
8575,0.8582,5,1,5,676015,429,124704,1552,0.003397858319604613,0.7834427057041898
8576,0.8583,4,1,4,676016,428,124708,1548,0.003389937903941199,0.7834008097165992
8577,0.8584,5,1,5,676017,427,124713,1543,0.0033820174882777847,0.783248730964467
8578,0.8585,1,0,1,676017,427,124714,1542,0.0033820174882777847,0.7831386490604367
8579,0.8586,1,0,1,676017,427,124715,1541,0.0033820174882777847,0.7830284552845529
8580,0.8587,4,1,4,676018,426,124719,1537,0.0033740970726143706,0.782985226693836
8581,0.8588,6,5,6,676023,421,124725,1531,0.0033344949942973007,0.7843237704918032
8582,0.8589,1,2,1,676025,419,124726,1530,0.0033186541629704725,0.7850179579271421
8583,0.859,2,0,2,676025,419,124728,1528,0.0033186541629704725,0.7847971237801746
8584,0.8591,4,0,4,676025,419,124732,1524,0.0033186541629704725,0.784354091610911
8585,0.8592,4,1,4,676026,418,124736,1520,0.003310733747307059,0.7843137254901961
8586,0.8593,2,0,2,676026,418,124738,1518,0.003310733747307059,0.7840909090909091
8587,0.8594,2,2,2,676028,416,124740,1516,0.0032948929159802307,0.7846790890269151
8588,0.8595,0,1,0,676029,415,124740,1516,0.0032869725003168166,0.7850854479544278
8589,0.8596,3,0,3,676029,415,124743,1513,0.0032869725003168166,0.7847510373443983
8590,0.8597,6,2,6,676031,413,124749,1507,0.0032711316689899884,0.7848958333333333
8591,0.8598,4,1,4,676032,412,124753,1503,0.0032632112533265744,0.7848563968668407
8592,0.8599,3,2,3,676034,410,124756,1500,0.0032473704219997466,0.7853403141361257
8593,0.86,2,0,2,676034,410,124758,1498,0.0032473704219997466,0.7851153039832285
8594,0.8601,2,0,2,676034,410,124760,1496,0.0032473704219997466,0.7848898216159497
8595,0.8602,3,1,3,676035,409,124763,1493,0.0032394500063363326,0.7849631966351209
8596,0.8603,2,0,2,676035,409,124765,1491,0.0032394500063363326,0.7847368421052632
8597,0.8604,1,0,1,676035,409,124766,1490,0.0032394500063363326,0.784623486045287
8598,0.8605,1,0,1,676035,409,124767,1489,0.0032394500063363326,0.7845100105374078
8599,0.8606,5,4,5,676039,405,124772,1484,0.0032077683436826767,0.7856008470089995
8600,0.8607,5,1,5,676040,404,124777,1479,0.0031998479280192626,0.7854487519915029
8601,0.8608,4,0,4,676040,404,124781,1475,0.0031998479280192626,0.7849920170303353
8602,0.8609,4,1,4,676041,403,124785,1471,0.0031919275123558485,0.7849519743863393
8603,0.861,4,1,4,676042,402,124789,1467,0.0031840070966924344,0.7849117174959872
8604,0.8611,2,0,2,676042,402,124791,1465,0.0031840070966924344,0.7846813069094805
8605,0.8613,4,0,4,676042,402,124795,1461,0.0031840070966924344,0.784219001610306
8606,0.8614,4,0,4,676042,402,124799,1457,0.0031840070966924344,0.78375470683163
8607,0.8616,6,0,6,676042,402,124805,1451,0.0031840070966924344,0.7830545062061521
8608,0.8617,2,2,2,676044,400,124807,1449,0.0031681662653656063,0.7836668469442942
8609,0.8618,4,0,4,676044,400,124811,1445,0.0031681662653656063,0.7831978319783198
8610,0.8619,4,2,4,676046,398,124815,1441,0.0031523254340387785,0.7835780315388798
8611,0.862,5,0,5,676046,398,124820,1436,0.0031523254340387785,0.7829880043620502
8612,0.8621,2,1,2,676047,397,124822,1434,0.0031444050183753645,0.7831785909339158
8613,0.8622,7,0,7,676047,397,124829,1427,0.0031444050183753645,0.7823464912280702
8614,0.8623,2,2,2,676049,395,124831,1425,0.0031285641870485363,0.782967032967033
8615,0.8624,3,1,3,676050,394,124834,1422,0.003120643771385122,0.7830396475770925
8616,0.8625,3,0,3,676050,394,124837,1419,0.003120643771385122,0.782680639823497
8617,0.8626,1,1,1,676051,393,124838,1418,0.003112723355721708,0.7829928216454998
8618,0.8627,4,1,4,676052,392,124842,1414,0.003104802940058294,0.7829457364341085
8619,0.8628,6,0,6,676052,392,124848,1408,0.003104802940058294,0.7822222222222223
8620,0.8629,5,0,5,676052,392,124853,1403,0.003104802940058294,0.7816155988857939
8621,0.863,3,0,3,676052,392,124856,1400,0.003104802940058294,0.78125
8622,0.8631,1,1,1,676053,391,124857,1399,0.0030968825243948804,0.7815642458100559
8623,0.8632,3,0,3,676053,391,124860,1396,0.0030968825243948804,0.7811975377728035
8624,0.8633,3,1,3,676054,390,124863,1393,0.0030889621087314663,0.7812675266404936
8625,0.8634,5,1,5,676055,389,124868,1388,0.0030810416930680522,0.7810917276308385
8626,0.8635,6,1,6,676056,388,124874,1382,0.003073121277404638,0.7807909604519774
8627,0.8636,3,2,3,676058,386,124877,1379,0.00305728044607781,0.7813031161473087
8628,0.8637,4,2,4,676060,384,124881,1375,0.0030414396147509823,0.7816941444002274
8629,0.8638,2,2,2,676062,382,124883,1373,0.003025598783424154,0.7823361823361823
8630,0.8639,3,1,3,676063,381,124886,1370,0.00301767836776074,0.7824100513992005
8631,0.864,3,1,3,676064,380,124889,1367,0.003009757952097326,0.7824842587292501
8632,0.8641,4,0,4,676064,380,124893,1363,0.003009757952097326,0.7819850831899025
8633,0.8642,2,1,2,676065,379,124895,1361,0.003001837536433912,0.782183908045977
8634,0.8643,5,0,5,676065,379,124900,1356,0.003001837536433912,0.7815561959654179
8635,0.8644,4,0,4,676065,379,124904,1352,0.003001837536433912,0.78105141536684
8636,0.8645,3,0,3,676065,379,124907,1349,0.003001837536433912,0.7806712962962963
8637,0.8646,2,1,2,676066,378,124909,1347,0.0029939171207704982,0.7808695652173913
8638,0.8647,2,3,2,676069,375,124911,1345,0.002970155873780256,0.7819767441860465
8639,0.8648,2,0,2,676069,375,124913,1343,0.002970155873780256,0.7817229336437719
8640,0.8649,7,2,7,676071,373,124920,1336,0.002954315042453428,0.7817437097717964
8641,0.865,5,1,5,676072,372,124925,1331,0.0029463946267900137,0.7815619495008808
8642,0.8651,2,0,2,676072,372,124927,1329,0.0029463946267900137,0.781305114638448
8643,0.8652,2,3,2,676075,369,124929,1327,0.002922633379799772,0.7824292452830188
8644,0.8653,3,0,3,676075,369,124932,1324,0.002922633379799772,0.7820437093916125
8645,0.8654,3,0,3,676075,369,124935,1321,0.002922633379799772,0.7816568047337278
8646,0.8655,1,0,1,676075,369,124936,1320,0.002922633379799772,0.7815275310834814
8647,0.8656,3,1,3,676076,368,124939,1317,0.002914712964136358,0.7816023738872404
8648,0.8657,3,0,3,676076,368,124942,1314,0.002914712964136358,0.7812128418549346
8649,0.8658,5,3,5,676079,365,124947,1309,0.002890951717146116,0.7819593787335722
8650,0.8659,2,1,2,676080,364,124949,1307,0.002883031301482702,0.782166367444644
8651,0.866,1,0,1,676080,364,124950,1306,0.002883031301482702,0.7820359281437126
8652,0.8661,3,0,3,676080,364,124953,1303,0.002883031301482702,0.7816436712657469
8653,0.8662,8,1,8,676081,363,124961,1295,0.002875110885819288,0.7810615199034981
8654,0.8663,2,3,2,676084,360,124963,1293,0.0028513496388290456,0.7822141560798548
8655,0.8664,2,2,2,676086,358,124965,1291,0.002835508807502218,0.7828987265009096
8656,0.8665,4,0,4,676086,358,124969,1287,0.002835508807502218,0.782370820668693
8657,0.8666,5,2,5,676088,356,124974,1282,0.0028196679761753897,0.7826617826617827
8658,0.8667,4,0,4,676088,356,124978,1278,0.0028196679761753897,0.7821297429620563
8659,0.8668,5,0,5,676088,356,124983,1273,0.0028196679761753897,0.7814610190300798
8660,0.8669,4,1,4,676089,355,124987,1269,0.0028117475605119757,0.7814039408866995
8661,0.867,3,2,3,676091,353,124990,1266,0.0027959067291851475,0.781964175416924
8662,0.8671,6,0,6,676091,353,124996,1260,0.0027959067291851475,0.7811531308121513
8663,0.8672,5,2,5,676093,351,125001,1255,0.0027800658978583198,0.7814445828144458
8664,0.8673,4,1,4,676094,350,125005,1251,0.0027721454821949057,0.7813866333541537
8665,0.8674,6,0,6,676094,350,125011,1245,0.0027721454821949057,0.780564263322884
8666,0.8675,3,0,3,676094,350,125014,1242,0.0027721454821949057,0.7801507537688442
8667,0.8676,0,2,0,676096,348,125014,1242,0.0027563046508680775,0.7811320754716982
8668,0.8677,1,3,1,676099,345,125015,1241,0.0027325434038778353,0.7824716267339218
8669,0.8678,1,3,1,676102,342,125016,1240,0.0027087821568875935,0.7838179519595448
8670,0.8679,3,0,3,676102,342,125019,1237,0.0027087821568875935,0.7834072197593414
8671,0.868,5,1,5,676103,341,125024,1232,0.0027008617412241794,0.7832167832167832
8672,0.8681,2,0,2,676103,341,125026,1230,0.0027008617412241794,0.7829408020369192
8673,0.8682,3,0,3,676103,341,125029,1227,0.0027008617412241794,0.7825255102040817
8674,0.8683,2,1,2,676104,340,125031,1225,0.0026929413255607653,0.7827476038338658
8675,0.8684,3,1,3,676105,339,125034,1222,0.0026850209098973512,0.7828315182575273
8676,0.8685,2,0,2,676105,339,125036,1220,0.0026850209098973512,0.7825529185375241
8677,0.8686,4,3,4,676108,336,125040,1216,0.0026612596629071094,0.7835051546391752
8678,0.8687,4,1,4,676109,335,125044,1212,0.0026533392472436954,0.7834518422753717
8679,0.8688,5,0,5,676109,335,125049,1207,0.0026533392472436954,0.7827496757457847
8680,0.8689,0,1,0,676110,334,125049,1207,0.0026454188315802813,0.7832576249188838
8681,0.869,5,0,5,676110,334,125054,1202,0.0026454188315802813,0.7825520833333334
8682,0.8691,2,1,2,676111,333,125056,1200,0.002637498415916867,0.7827788649706457
8683,0.8692,4,2,4,676113,331,125060,1196,0.0026216575845900395,0.7832351015062213
8684,0.8693,3,1,3,676114,330,125063,1193,0.0026137371689266254,0.783322390019698
8685,0.8694,3,3,3,676117,327,125066,1190,0.002589975921936383,0.7844429795649308
8686,0.8695,1,0,1,676117,327,125067,1189,0.002589975921936383,0.7843007915567283
8687,0.8696,3,0,3,676117,327,125070,1186,0.002589975921936383,0.7838730998017185
8688,0.8697,2,2,2,676119,325,125072,1184,0.002574135090609555,0.7846255798542081
8689,0.8698,3,0,3,676119,325,125075,1181,0.002574135090609555,0.7841965471447543
8690,0.8699,3,1,3,676120,324,125078,1178,0.0025662146749461413,0.7842876165113183
8691,0.87,1,2,1,676122,322,125079,1177,0.002550373843619313,0.7851901267511674
8692,0.8701,4,3,4,676125,319,125083,1173,0.002526612596629071,0.7861930294906166
8693,0.8702,2,1,2,676126,318,125085,1171,0.0025186921809656573,0.7864338482202821
8694,0.8703,2,0,2,676126,318,125087,1169,0.0025186921809656573,0.7861466039004708
8695,0.8704,3,2,3,676128,316,125090,1166,0.002502851349638829,0.786774628879892
8696,0.8705,3,1,3,676129,315,125093,1163,0.002494930933975415,0.786874154262517
8697,0.8706,4,0,4,676129,315,125097,1159,0.002494930933975415,0.7862957937584804
8698,0.8707,4,0,4,676129,315,125101,1155,0.002494930933975415,0.7857142857142857
8699,0.8708,3,0,3,676129,315,125104,1152,0.002494930933975415,0.7852760736196319
8700,0.8709,6,2,6,676131,313,125110,1146,0.002479090102648587,0.7854694996572995
8701,0.871,3,0,3,676131,313,125113,1143,0.002479090102648587,0.7850274725274725
8702,0.8711,5,1,5,676132,312,125118,1138,0.002471169686985173,0.7848275862068965
8703,0.8712,4,0,4,676132,312,125122,1134,0.002471169686985173,0.7842323651452282
8704,0.8713,3,2,3,676134,310,125125,1131,0.002455328855658345,0.7848716169326856
8705,0.8714,2,1,2,676135,309,125127,1129,0.002447408439994931,0.7851182197496523
8706,0.8715,6,1,6,676136,308,125133,1123,0.002439488024331517,0.7847658979734451
8707,0.8716,2,3,2,676139,305,125135,1121,0.0024157267773412747,0.7861150070126227
8708,0.8717,4,0,4,676139,305,125139,1117,0.0024157267773412747,0.7855133614627285
8709,0.8718,1,0,1,676139,305,125140,1116,0.0024157267773412747,0.7853624208304011
8710,0.8719,4,0,4,676139,305,125144,1112,0.0024157267773412747,0.784756527875794
8711,0.872,3,0,3,676139,305,125147,1109,0.0024157267773412747,0.7842998585572843
8712,0.8721,1,0,1,676139,305,125148,1108,0.0024157267773412747,0.7841472045293701
8713,0.8722,2,1,2,676140,304,125150,1106,0.002407806361677861,0.7843971631205674
8714,0.8723,1,0,1,676140,304,125151,1105,0.002407806361677861,0.7842441447835344
8715,0.8724,7,1,7,676141,303,125158,1098,0.002399885946014447,0.7837259100642399
8716,0.8725,3,0,3,676141,303,125161,1095,0.002399885946014447,0.7832618025751072
8717,0.8726,1,0,1,676141,303,125162,1094,0.002399885946014447,0.7831066571224051
8718,0.8727,3,2,3,676143,301,125165,1091,0.0023840451146876188,0.7837643678160919
8719,0.8728,0,1,0,676144,300,125165,1091,0.0023761246990242047,0.7843278217109992
8720,0.8729,2,3,2,676147,297,125167,1089,0.002352363452033963,0.7857142857142857
8721,0.873,1,0,1,676147,297,125168,1088,0.002352363452033963,0.7855595667870036
8722,0.8731,1,0,1,676147,297,125169,1087,0.002352363452033963,0.7854046242774566
8723,0.8732,7,3,7,676150,294,125176,1080,0.0023286022050437206,0.7860262008733624
8724,0.8733,0,2,0,676152,292,125176,1080,0.0023127613737168925,0.7871720116618076
8725,0.8734,3,0,3,676152,292,125179,1077,0.0023127613737168925,0.7867056245434624
8726,0.8735,4,1,4,676153,291,125183,1073,0.002304840958053479,0.7866568914956011
8727,0.8736,2,1,2,676154,290,125185,1071,0.0022969205423900648,0.786921381337252
8728,0.8737,3,0,3,676154,290,125188,1068,0.0022969205423900648,0.7864506627393225
8729,0.8739,1,0,1,676154,290,125189,1067,0.0022969205423900648,0.7862932940309506
8730,0.874,2,0,2,676154,290,125191,1065,0.0022969205423900648,0.7859778597785978
8731,0.8741,3,1,3,676155,289,125194,1062,0.0022890001267266507,0.7860843819393042
8732,0.8742,4,0,4,676155,289,125198,1058,0.0022890001267266507,0.785449146250928
8733,0.8743,1,0,1,676155,289,125199,1057,0.0022890001267266507,0.7852897473997028
8734,0.8744,2,0,2,676155,289,125201,1055,0.0022890001267266507,0.7849702380952381
8735,0.8745,3,0,3,676155,289,125204,1052,0.0022890001267266507,0.7844891871737509
8736,0.8746,1,0,1,676155,289,125205,1051,0.0022890001267266507,0.7843283582089552
8737,0.8747,5,0,5,676155,289,125210,1046,0.0022890001267266507,0.7835205992509363
8738,0.8748,2,1,2,676156,288,125212,1044,0.0022810797110632366,0.7837837837837838
8739,0.8749,1,2,1,676158,286,125213,1043,0.0022652388797364084,0.7848006019563581
8740,0.875,2,1,2,676159,285,125215,1041,0.0022573184640729944,0.7850678733031674
8741,0.8751,4,2,4,676161,283,125219,1037,0.0022414776327461666,0.7856060606060606
8742,0.8752,1,0,1,676161,283,125220,1036,0.0022414776327461666,0.7854435178165277
8743,0.8753,2,0,2,676161,283,125222,1034,0.0022414776327461666,0.7851176917236142
8744,0.8754,0,2,0,676163,281,125222,1034,0.0022256368014193385,0.7863117870722434
8745,0.8755,4,0,4,676163,281,125226,1030,0.0022256368014193385,0.7856598016781083
8746,0.8756,1,0,1,676163,281,125227,1029,0.0022256368014193385,0.7854961832061069
8747,0.8757,4,1,4,676164,280,125231,1025,0.0022177163857559244,0.7854406130268199
8748,0.8758,4,2,4,676166,278,125235,1021,0.0022018755544290962,0.7859892224788299
8749,0.8759,5,2,5,676168,276,125240,1016,0.0021860347231022685,0.7863777089783281
8750,0.876,2,2,2,676170,274,125242,1014,0.0021701938917754403,0.7872670807453416
8751,0.8761,7,1,7,676171,273,125249,1007,0.0021622734761120263,0.78671875
8752,0.8762,3,0,3,676171,273,125252,1004,0.0021622734761120263,0.7862176977290525
8753,0.8763,5,0,5,676171,273,125257,999,0.0021622734761120263,0.785377358490566
8754,0.8764,2,1,2,676172,272,125259,997,0.002154353060448612,0.7856579984239559
8755,0.8765,3,0,3,676172,272,125262,994,0.002154353060448612,0.7851500789889415
8756,0.8766,6,0,6,676172,272,125268,988,0.002154353060448612,0.7841269841269841
8757,0.8767,3,0,3,676172,272,125271,985,0.002154353060448612,0.7836117740652346
8758,0.8768,3,1,3,676173,271,125274,982,0.0021464326447851985,0.7837190742218675
8759,0.8769,3,0,3,676173,271,125277,979,0.0021464326447851985,0.7832
8760,0.877,4,0,4,676173,271,125281,975,0.0021464326447851985,0.7825040128410915
8761,0.8771,2,0,2,676173,271,125283,973,0.0021464326447851985,0.7821543408360129
8762,0.8772,3,3,3,676176,268,125286,970,0.0021226713977949563,0.7835218093699515
8763,0.8773,1,1,1,676177,267,125287,969,0.002114750982131542,0.7839805825242718
8764,0.8774,3,1,3,676178,266,125290,966,0.002106830566468128,0.7840909090909091
8765,0.8775,1,0,1,676178,266,125291,965,0.002106830566468128,0.7839155158407799
8766,0.8776,4,0,4,676178,266,125295,961,0.002106830566468128,0.7832110839445803
8767,0.8777,1,0,1,676178,266,125296,960,0.002106830566468128,0.7830342577487766
8768,0.8778,5,0,5,676178,266,125301,955,0.002106830566468128,0.7821457821457821
8769,0.8779,3,1,3,676179,265,125304,952,0.002098910150804714,0.7822514379622021
8770,0.878,4,0,4,676179,265,125308,948,0.002098910150804714,0.7815333882934872
8771,0.8781,1,0,1,676179,265,125309,947,0.002098910150804714,0.7813531353135313
8772,0.8782,2,0,2,676179,265,125311,945,0.002098910150804714,0.78099173553719
8773,0.8783,2,1,2,676180,264,125313,943,0.0020909897351413004,0.7812758906379453
8774,0.8784,1,0,1,676180,264,125314,942,0.0020909897351413004,0.7810945273631841
8775,0.8785,1,0,1,676180,264,125315,941,0.0020909897351413004,0.7809128630705394
8776,0.8786,4,0,4,676180,264,125319,937,0.0020909897351413004,0.7801831806827644
8777,0.8787,1,0,1,676180,264,125320,936,0.0020909897351413004,0.78
8778,0.8788,5,0,5,676180,264,125325,931,0.0020909897351413004,0.7790794979079498
8779,0.8789,2,2,2,676182,262,125327,929,0.0020751489038144722,0.780016792611251
8780,0.879,2,3,2,676185,259,125329,927,0.00205138765682423,0.781618887015177
8781,0.8791,0,1,0,676186,258,125329,927,0.002043467241160816,0.7822784810126582
8782,0.8792,6,1,6,676187,257,125335,921,0.0020355468254974023,0.7818336162988115
8783,0.8793,6,1,6,676188,256,125341,915,0.002027626409833988,0.7813834329632793
8784,0.8794,1,0,1,676188,256,125342,914,0.002027626409833988,0.7811965811965812
8785,0.8795,2,1,2,676189,255,125344,912,0.002019705994170574,0.781491002570694
8786,0.8796,2,0,2,676189,255,125346,910,0.002019705994170574,0.7811158798283262
8787,0.8797,1,1,1,676190,254,125347,909,0.00201178557850716,0.7815993121238177
8788,0.8799,3,0,3,676190,254,125350,906,0.00201178557850716,0.7810344827586206
8789,0.88,1,3,1,676193,251,125351,905,0.001988024331516918,0.782871972318339
8790,0.8801,3,0,3,676193,251,125354,902,0.001988024331516918,0.782307025151778
8791,0.8802,2,0,2,676193,251,125356,900,0.001988024331516918,0.7819287576020851
8792,0.8803,3,0,3,676193,251,125359,897,0.001988024331516918,0.7813588850174216
8793,0.8804,2,0,2,676193,251,125361,895,0.001988024331516918,0.7809773123909249
8794,0.8805,2,2,2,676195,249,125363,893,0.00197218350019009,0.7819614711033275
8795,0.8806,2,0,2,676195,249,125365,891,0.00197218350019009,0.781578947368421
8796,0.8807,3,2,3,676197,247,125368,888,0.001956342668863262,0.7823788546255507
8797,0.8808,4,0,4,676197,247,125372,884,0.001956342668863262,0.7816091954022989
8798,0.8809,2,2,2,676199,245,125374,882,0.001940501837536434,0.782608695652174
8799,0.881,7,0,7,676199,245,125381,875,0.001940501837536434,0.78125
8800,0.8811,3,1,3,676200,244,125384,872,0.0019325814218730199,0.7813620071684588
8801,0.8812,4,1,4,676201,243,125388,868,0.0019246610062096058,0.7812781278127813
8802,0.8813,2,0,2,676201,243,125390,866,0.0019246610062096058,0.7808836789900812
8803,0.8814,2,1,2,676202,242,125392,864,0.001916740590546192,0.7811934900542495
8804,0.8815,0,1,0,676203,241,125392,864,0.0019088201748827778,0.7819004524886878
8805,0.8816,3,1,3,676204,240,125395,861,0.0019008997592193638,0.782016348773842
8806,0.8819,4,1,4,676205,239,125399,857,0.00189297934355595,0.781934306569343
8807,0.882,3,2,3,676207,237,125402,854,0.0018771385122291217,0.7827681026581118
8808,0.8821,1,0,1,676207,237,125403,853,0.0018771385122291217,0.7825688073394496
8809,0.8822,1,0,1,676207,237,125404,852,0.0018771385122291217,0.7823691460055097
8810,0.8823,2,1,2,676208,236,125406,850,0.0018692180965657079,0.7826887661141805
8811,0.8825,2,0,2,676208,236,125408,848,0.0018692180965657079,0.7822878228782287
8812,0.8826,2,0,2,676208,236,125410,846,0.0018692180965657079,0.7818853974121996
8813,0.8827,3,1,3,676209,235,125413,843,0.0018612976809022938,0.7820037105751392
8814,0.8828,1,1,1,676210,234,125414,842,0.0018533772652388797,0.7825278810408922
8815,0.8829,5,0,5,676210,234,125419,837,0.0018533772652388797,0.7815126050420168
8816,0.883,1,0,1,676210,234,125420,836,0.0018533772652388797,0.7813084112149533
8817,0.8831,0,2,0,676212,232,125420,836,0.0018375364339120518,0.7827715355805244
8818,0.8832,3,1,3,676213,231,125423,833,0.0018296160182486377,0.7828947368421053
8819,0.8833,3,0,3,676213,231,125426,830,0.0018296160182486377,0.7822808671065034
8820,0.8834,5,1,5,676214,230,125431,825,0.0018216956025852236,0.7819905213270142
8821,0.8835,4,1,4,676215,229,125435,821,0.0018137751869218097,0.7819047619047619
8822,0.8836,3,0,3,676215,229,125438,818,0.0018137751869218097,0.7812798471824259
8823,0.8837,7,0,7,676215,229,125445,811,0.0018137751869218097,0.7798076923076923
8824,0.8838,2,4,2,676219,225,125447,809,0.0017820935242681536,0.7823984526112185
8825,0.8839,3,1,3,676220,224,125450,806,0.0017741731086047396,0.7825242718446602
8826,0.884,2,3,2,676223,221,125452,804,0.0017504118616144975,0.784390243902439
8827,0.8841,2,0,2,676223,221,125454,802,0.0017504118616144975,0.7839687194525904
8828,0.8842,5,2,5,676225,219,125459,797,0.0017345710302876696,0.7844488188976378
8829,0.8843,4,1,4,676226,218,125463,793,0.0017266506146242555,0.7843719090009891
8830,0.8844,1,0,1,676226,218,125464,792,0.0017266506146242555,0.7841584158415842
8831,0.8845,4,1,4,676227,217,125468,788,0.0017187301989608414,0.7840796019900498
8832,0.8846,1,1,1,676228,216,125469,787,0.0017108097832974276,0.7846460618145563
8833,0.8847,3,1,3,676229,215,125472,784,0.0017028893676340135,0.7847847847847848
8834,0.8848,3,3,3,676232,212,125475,781,0.0016791281206437714,0.7865055387713998
8835,0.8849,3,1,3,676233,211,125478,778,0.0016712077049803574,0.7866531850353893
8836,0.885,2,0,2,676233,211,125480,776,0.0016712077049803574,0.7862208713272543
8837,0.8851,2,0,2,676233,211,125482,774,0.0016712077049803574,0.7857868020304568
8838,0.8852,3,1,3,676234,210,125485,771,0.0016632872893169433,0.7859327217125383
8839,0.8853,3,1,3,676235,209,125488,768,0.0016553668736535294,0.7860798362333674
8840,0.8854,2,0,2,676235,209,125490,766,0.0016553668736535294,0.7856410256410257
8841,0.8855,0,1,0,676236,208,125490,766,0.0016474464579901153,0.7864476386036962
8842,0.8856,4,0,4,676236,208,125494,762,0.0016474464579901153,0.7855670103092783
8843,0.8857,0,1,0,676237,207,125494,762,0.0016395260423267013,0.7863777089783281
8844,0.8858,2,1,2,676238,206,125496,760,0.0016316056266632872,0.7867494824016563
8845,0.8859,3,1,3,676239,205,125499,757,0.0016236852109998733,0.7869022869022869
8846,0.886,3,0,3,676239,205,125502,754,0.0016236852109998733,0.786235662148071
8847,0.8861,3,0,3,676239,205,125505,751,0.0016236852109998733,0.7855648535564853
8848,0.8862,2,0,2,676239,205,125507,749,0.0016236852109998733,0.7851153039832285
8849,0.8863,1,0,1,676239,205,125508,748,0.0016236852109998733,0.7848898216159497
8850,0.8865,2,0,2,676239,205,125510,746,0.0016236852109998733,0.7844374342797056
8851,0.8866,1,0,1,676239,205,125511,745,0.0016236852109998733,0.7842105263157895
8852,0.8867,3,0,3,676239,205,125514,742,0.0016236852109998733,0.7835269271383316
8853,0.8868,4,0,4,676239,205,125518,738,0.0016236852109998733,0.782608695652174
8854,0.8869,3,3,3,676242,202,125521,735,0.0015999239640096313,0.7844183564567769
8855,0.887,2,0,2,676242,202,125523,733,0.0015999239640096313,0.7839572192513369
8856,0.8871,0,2,0,676244,200,125523,733,0.0015840831326828031,0.7856377277599143
8857,0.8872,2,1,2,676245,199,125525,731,0.0015761627170193893,0.7860215053763441
8858,0.8873,2,3,2,676248,196,125527,729,0.001552401470029147,0.7881081081081082
8859,0.8874,2,0,2,676248,196,125529,727,0.001552401470029147,0.7876489707475623
8860,0.8875,1,1,1,676249,195,125530,726,0.0015444810543657332,0.7882736156351792
8861,0.8876,2,2,2,676251,193,125532,724,0.001528640223038905,0.7895310796074155
8862,0.8877,1,1,1,676252,192,125533,723,0.0015207198073754911,0.7901639344262295
8863,0.8878,2,1,2,676253,191,125535,721,0.001512799391712077,0.7905701754385965
8864,0.8879,2,1,2,676254,190,125537,719,0.001504878976048663,0.7909790979097909
8865,0.888,1,1,1,676255,189,125538,718,0.0014969585603852491,0.7916207276736494
8866,0.8881,2,1,2,676256,188,125540,716,0.001489038144721835,0.7920353982300885
8867,0.8882,2,0,2,676256,188,125542,714,0.001489038144721835,0.7915742793791575
8868,0.8883,6,1,6,676257,187,125548,708,0.001481117729058421,0.7910614525139665
8869,0.8884,1,0,1,676257,187,125549,707,0.001481117729058421,0.79082774049217
8870,0.8885,3,1,3,676258,186,125552,704,0.0014731973133950069,0.7910112359550562
8871,0.8886,2,1,2,676259,185,125554,702,0.001465276897731593,0.7914317925591883
8872,0.8887,5,0,5,676259,185,125559,697,0.001465276897731593,0.7902494331065759
8873,0.8888,6,3,6,676262,182,125565,691,0.001441515650741351,0.7915234822451317
8874,0.8889,0,1,0,676263,181,125565,691,0.001433595235077937,0.7924311926605505
8875,0.889,1,0,1,676263,181,125566,690,0.001433595235077937,0.7921928817451206
8876,0.8891,7,0,7,676263,181,125573,683,0.001433595235077937,0.7905092592592593
8877,0.8892,1,0,1,676263,181,125574,682,0.001433595235077937,0.7902665121668598
8878,0.8893,5,0,5,676263,181,125579,677,0.001433595235077937,0.789044289044289
8879,0.8894,0,1,0,676264,180,125579,677,0.0014256748194145228,0.7899649941656943
8880,0.8895,0,2,0,676266,178,125579,677,0.0014098339880876949,0.791812865497076
8881,0.8896,1,0,1,676266,178,125580,676,0.0014098339880876949,0.7915690866510539
8882,0.8897,1,1,1,676267,177,125581,675,0.0014019135724242808,0.7922535211267606
8883,0.8898,2,0,2,676267,177,125583,673,0.0014019135724242808,0.7917647058823529
8884,0.89,1,2,1,676269,175,125584,672,0.0013860727410974528,0.7933884297520661
8885,0.8901,4,0,4,676269,175,125588,668,0.0013860727410974528,0.7924080664294187
8886,0.8902,2,0,2,676269,175,125590,666,0.0013860727410974528,0.7919143876337693
8887,0.8903,3,0,3,676269,175,125593,663,0.0013860727410974528,0.7911694510739857
8888,0.8904,2,0,2,676269,175,125595,661,0.0013860727410974528,0.7906698564593302
8889,0.8905,1,0,1,676269,175,125596,660,0.0013860727410974528,0.7904191616766467
8890,0.8906,2,0,2,676269,175,125598,658,0.0013860727410974528,0.7899159663865546
8891,0.8907,1,1,1,676270,174,125599,657,0.0013781523254340388,0.7906137184115524
8892,0.8908,2,0,2,676270,174,125601,655,0.0013781523254340388,0.7901085645355851
8893,0.8909,3,0,3,676270,174,125604,652,0.0013781523254340388,0.7893462469733656
8894,0.891,2,0,2,676270,174,125606,650,0.0013781523254340388,0.7888349514563107
8895,0.8911,1,0,1,676270,174,125607,649,0.0013781523254340388,0.7885783718104495
8896,0.8912,1,0,1,676270,174,125608,648,0.0013781523254340388,0.7883211678832117
8897,0.8913,1,0,1,676270,174,125609,647,0.0013781523254340388,0.7880633373934226
8898,0.8914,2,1,2,676271,173,125611,645,0.0013702319097706247,0.7885085574572127
8899,0.8915,1,1,1,676272,172,125612,644,0.0013623114941072108,0.7892156862745098
8900,0.8916,2,0,2,676272,172,125614,642,0.0013623114941072108,0.7886977886977887
8901,0.8918,4,0,4,676272,172,125618,638,0.0013623114941072108,0.7876543209876543
8902,0.892,1,0,1,676272,172,125619,637,0.0013623114941072108,0.7873918417799752
8903,0.8921,4,2,4,676274,170,125623,633,0.0013464706627803827,0.788293897882939
8904,0.8922,0,1,0,676275,169,125623,633,0.0013385502471169688,0.7892768079800498
8905,0.8923,7,1,7,676276,168,125630,626,0.0013306298314535547,0.7884130982367759
8906,0.8924,1,0,1,676276,168,125631,625,0.0013306298314535547,0.7881462799495587
8907,0.8925,2,0,2,676276,168,125633,623,0.0013306298314535547,0.7876106194690266
8908,0.8926,2,2,2,676278,166,125635,621,0.0013147890001267266,0.7890724269377383
8909,0.8927,2,0,2,676278,166,125637,619,0.0013147890001267266,0.7885350318471338
8910,0.8928,5,0,5,676278,166,125642,614,0.0013147890001267266,0.7871794871794872
8911,0.8929,2,1,2,676279,165,125644,612,0.0013068685844633127,0.7876447876447876
8912,0.893,1,1,1,676280,164,125645,611,0.0012989481687998986,0.7883870967741935
8913,0.8931,1,2,1,676282,162,125646,610,0.0012831073374730707,0.7901554404145078
8914,0.8932,3,0,3,676282,162,125649,607,0.0012831073374730707,0.7893368010403121
8915,0.8933,4,2,4,676284,160,125653,603,0.0012672665061462425,0.7903014416775884
8916,0.8935,1,0,1,676284,160,125654,602,0.0012672665061462425,0.7900262467191601
8917,0.8936,4,1,4,676285,159,125658,598,0.0012593460904828286,0.7899603698811096
8918,0.8937,5,1,5,676286,158,125663,593,0.0012514256748194146,0.7896138482023968
8919,0.8938,2,1,2,676287,157,125665,591,0.0012435052591560005,0.7901069518716578
8920,0.8939,2,0,2,676287,157,125667,589,0.0012435052591560005,0.789544235924933
8921,0.894,1,0,1,676287,157,125668,588,0.0012435052591560005,0.789261744966443
8922,0.8941,4,0,4,676287,157,125672,584,0.0012435052591560005,0.7881241565452092
8923,0.8942,2,0,2,676287,157,125674,582,0.0012435052591560005,0.7875507442489851
8924,0.8943,2,0,2,676287,157,125676,580,0.0012435052591560005,0.7869742198100407
8925,0.8944,0,3,0,676290,154,125676,580,0.0012197440121657585,0.7901907356948229
8926,0.8945,2,0,2,676290,154,125678,578,0.0012197440121657585,0.7896174863387978
8927,0.8946,1,0,1,676290,154,125679,577,0.0012197440121657585,0.7893296853625171
8928,0.8947,1,0,1,676290,154,125680,576,0.0012197440121657585,0.7890410958904109
8929,0.8948,1,1,1,676291,153,125681,575,0.0012118235965023444,0.7898351648351648
8930,0.8952,3,1,3,676292,152,125684,572,0.0012039031808389305,0.7900552486187845
8931,0.8953,1,0,1,676292,152,125685,571,0.0012039031808389305,0.7897648686030428
8932,0.8954,5,0,5,676292,152,125690,566,0.0012039031808389305,0.7883008356545961
8933,0.8955,1,1,1,676293,151,125691,565,0.0011959827651755164,0.7891061452513967
8934,0.8956,4,2,4,676295,149,125695,561,0.0011801419338486885,0.7901408450704225
8935,0.8957,2,0,2,676295,149,125697,559,0.0011801419338486885,0.78954802259887
8936,0.8958,1,0,1,676295,149,125698,558,0.0011801419338486885,0.7892503536067893
8937,0.8959,1,1,1,676296,148,125699,557,0.0011722215181852744,0.7900709219858156
8938,0.896,3,1,3,676297,147,125702,554,0.0011643011025218603,0.7902995720399429
8939,0.8961,0,1,0,676298,146,125702,554,0.0011563806868584462,0.7914285714285715
8940,0.8962,5,0,5,676298,146,125707,549,0.0011563806868584462,0.7899280575539568
8941,0.8963,2,2,2,676300,144,125709,547,0.0011405398555316183,0.7916063675832128
8942,0.8964,1,1,1,676301,143,125710,546,0.0011326194398682042,0.7924528301886793
8943,0.8965,4,3,4,676304,140,125714,542,0.0011088581928779622,0.7947214076246334
8944,0.8966,1,0,1,676304,140,125715,541,0.0011088581928779622,0.7944199706314243
8945,0.8967,2,0,2,676304,140,125717,539,0.0011088581928779622,0.7938144329896907
8946,0.8968,2,1,2,676305,139,125719,537,0.0011009377772145481,0.7943786982248521
8947,0.8969,2,0,2,676305,139,125721,535,0.0011009377772145481,0.7937685459940653
8948,0.897,2,0,2,676305,139,125723,533,0.0011009377772145481,0.7931547619047619
8949,0.8971,1,0,1,676305,139,125724,532,0.0011009377772145481,0.7928464977645305
8950,0.8972,3,0,3,676305,139,125727,529,0.0011009377772145481,0.7919161676646707
8951,0.8973,1,1,1,676306,138,125728,528,0.0010930173615511342,0.7927927927927928
8952,0.8975,2,0,2,676306,138,125730,526,0.0010930173615511342,0.7921686746987951
8953,0.8976,3,1,3,676307,137,125733,523,0.0010850969458877202,0.7924242424242425
8954,0.8978,6,0,6,676307,137,125739,517,0.0010850969458877202,0.790519877675841
8955,0.8979,1,1,1,676308,136,125740,516,0.001077176530224306,0.7914110429447853
8956,0.898,1,1,1,676309,135,125741,515,0.0010692561145608922,0.7923076923076923
8957,0.8981,1,1,1,676310,134,125742,514,0.0010613356988974781,0.7932098765432098
8958,0.8982,2,1,2,676311,133,125744,512,0.001053415283234064,0.7937984496124031
8959,0.8983,2,0,2,676311,133,125746,510,0.001053415283234064,0.7931570762052877
8960,0.8984,1,1,1,676312,132,125747,509,0.0010454948675706502,0.7940717628705148
8961,0.8985,1,2,1,676314,130,125748,508,0.001029654036243822,0.7962382445141066
8962,0.8986,1,1,1,676315,129,125749,507,0.001021733620580408,0.7971698113207547
8963,0.8987,1,0,1,676315,129,125750,506,0.001021733620580408,0.7968503937007874
8964,0.8989,2,0,2,676315,129,125752,504,0.001021733620580408,0.7962085308056872
8965,0.899,1,0,1,676315,129,125753,503,0.001021733620580408,0.7958860759493671
8966,0.8991,4,0,4,676315,129,125757,499,0.001021733620580408,0.7945859872611465
8967,0.8992,3,1,3,676316,128,125760,496,0.001013813204916994,0.7948717948717948
8968,0.8993,2,0,2,676316,128,125762,494,0.001013813204916994,0.7942122186495176
8969,0.8994,2,1,2,676317,127,125764,492,0.00100589278925358,0.7948303715670436
8970,0.8995,3,1,3,676318,126,125767,489,0.000997972373590166,0.7951219512195122
8971,0.8996,1,0,1,676318,126,125768,488,0.000997972373590166,0.7947882736156352
8972,0.8998,1,0,1,676318,126,125769,487,0.000997972373590166,0.7944535073409462
8973,0.9,5,1,5,676319,125,125774,482,0.000990051957926752,0.7940691927512356
8974,0.9001,1,2,1,676321,123,125775,481,0.000974211126599924,0.7963576158940397
8975,0.9002,2,2,2,676323,121,125777,479,0.000958370295273096,0.7983333333333333
8976,0.9003,3,0,3,676323,121,125780,476,0.000958370295273096,0.7973199329983249
8977,0.9004,1,0,1,676323,121,125781,475,0.000958370295273096,0.7969798657718121
8978,0.9005,1,0,1,676323,121,125782,474,0.000958370295273096,0.7966386554621848
8979,0.9006,1,0,1,676323,121,125783,473,0.000958370295273096,0.7962962962962963
8980,0.9007,1,0,1,676323,121,125784,472,0.000958370295273096,0.7959527824620574
8981,0.9008,1,0,1,676323,121,125785,471,0.000958370295273096,0.7956081081081081
8982,0.9009,1,0,1,676323,121,125786,470,0.000958370295273096,0.7952622673434856
8983,0.9011,2,1,2,676324,120,125788,468,0.0009504498796096819,0.7959183673469388
8984,0.9012,1,1,1,676325,119,125789,467,0.0009425294639462679,0.7969283276450512
8985,0.9013,1,0,1,676325,119,125790,466,0.0009425294639462679,0.7965811965811965
8986,0.9014,2,1,2,676326,118,125792,464,0.0009346090482828539,0.7972508591065293
8987,0.9015,3,1,3,676327,117,125795,461,0.0009266886326194399,0.7975778546712803
8988,0.9016,2,0,2,676327,117,125797,459,0.0009266886326194399,0.796875
8989,0.9017,0,1,0,676328,116,125797,459,0.0009187682169560259,0.7982608695652174
8990,0.9018,2,0,2,676328,116,125799,457,0.0009187682169560259,0.7975567190226877
8991,0.9019,1,2,1,676330,114,125800,456,0.0009029273856291978,0.8
8992,0.902,2,0,2,676330,114,125802,454,0.0009029273856291978,0.7992957746478874
8993,0.9021,1,0,1,676330,114,125803,453,0.0009029273856291978,0.798941798941799
8994,0.9022,3,1,3,676331,113,125806,450,0.0008950069699657839,0.7992895204262878
8995,0.9023,1,0,1,676331,113,125807,449,0.0008950069699657839,0.798932384341637
8996,0.9024,2,0,2,676331,113,125809,447,0.0008950069699657839,0.7982142857142858
8997,0.9026,2,0,2,676331,113,125811,445,0.0008950069699657839,0.7974910394265233
8998,0.9027,2,0,2,676331,113,125813,443,0.0008950069699657839,0.7967625899280576
8999,0.9028,3,1,3,676332,112,125816,440,0.0008870865543023698,0.7971014492753623
9000,0.9029,2,0,2,676332,112,125818,438,0.0008870865543023698,0.7963636363636364
9001,0.9032,1,0,1,676332,112,125819,437,0.0008870865543023698,0.7959927140255009
9002,0.9033,2,0,2,676332,112,125821,435,0.0008870865543023698,0.7952468007312614
9003,0.9034,1,1,1,676333,111,125822,434,0.0008791661386389558,0.7963302752293578
9004,0.9035,2,0,2,676333,111,125824,432,0.0008791661386389558,0.7955801104972375
9005,0.9036,4,1,4,676334,110,125828,428,0.0008712457229755417,0.7955390334572491
9006,0.9037,2,0,2,676334,110,125830,426,0.0008712457229755417,0.7947761194029851
9007,0.9038,4,0,4,676334,110,125834,422,0.0008712457229755417,0.793233082706767
9008,0.9039,1,0,1,676334,110,125835,421,0.0008712457229755417,0.7928436911487758
9009,0.904,2,0,2,676334,110,125837,419,0.0008712457229755417,0.7920604914933838
9010,0.9041,1,1,1,676335,109,125838,418,0.0008633253073121277,0.793168880455408
9011,0.9042,3,2,3,676337,107,125841,415,0.0008474844759852997,0.7950191570881227
9012,0.9043,0,1,0,676338,106,125841,415,0.0008395640603218857,0.7965451055662188
9013,0.9044,3,1,3,676339,105,125844,412,0.0008316436446584716,0.7969052224371374
9014,0.9045,2,0,2,676339,105,125846,410,0.0008316436446584716,0.7961165048543689
9015,0.9046,0,2,0,676341,103,125846,410,0.0008158028133316436,0.7992202729044834
9016,0.9047,2,0,2,676341,103,125848,408,0.0008158028133316436,0.7984344422700587
9017,0.9048,2,1,2,676342,102,125850,406,0.0008078823976682296,0.7992125984251969
9018,0.9049,2,0,2,676342,102,125852,404,0.0008078823976682296,0.7984189723320159
9019,0.905,3,0,3,676342,102,125855,401,0.0008078823976682296,0.7972166998011928
9020,0.9051,1,0,1,676342,102,125856,400,0.0008078823976682296,0.796812749003984
9021,0.9052,3,0,3,676342,102,125859,397,0.0008078823976682296,0.7955911823647295
9022,0.9053,0,3,0,676345,99,125859,397,0.0007841211506779876,0.8004032258064516
9023,0.9054,3,0,3,676345,99,125862,394,0.0007841211506779876,0.7991886409736308
9024,0.9056,0,1,0,676346,98,125862,394,0.0007762007350145735,0.8008130081300813
9025,0.9057,2,1,2,676347,97,125864,392,0.0007682803193511595,0.8016359918200409
9026,0.9058,2,0,2,676347,97,125866,390,0.0007682803193511595,0.8008213552361396
9027,0.9059,1,0,1,676347,97,125867,389,0.0007682803193511595,0.8004115226337448
9028,0.906,1,1,1,676348,96,125868,388,0.0007603599036877456,0.8016528925619835
9029,0.9061,4,0,4,676348,96,125872,384,0.0007603599036877456,0.8
9030,0.9062,3,0,3,676348,96,125875,381,0.0007603599036877456,0.7987421383647799
9031,0.9063,1,1,1,676349,95,125876,380,0.0007524394880243315,0.8
9032,0.9064,2,0,2,676349,95,125878,378,0.0007524394880243315,0.7991543340380549
9033,0.9067,0,1,0,676350,94,125878,378,0.0007445190723609175,0.8008474576271186
9034,0.9069,2,0,2,676350,94,125880,376,0.0007445190723609175,0.8
9035,0.9072,2,0,2,676350,94,125882,374,0.0007445190723609175,0.7991452991452992
9036,0.9073,4,0,4,676350,94,125886,370,0.0007445190723609175,0.7974137931034483
9037,0.9074,3,1,3,676351,93,125889,367,0.0007365986566975034,0.7978260869565217
9038,0.9075,2,1,2,676352,92,125891,365,0.0007286782410340895,0.7986870897155361
9039,0.9077,1,0,1,676352,92,125892,364,0.0007286782410340895,0.7982456140350878
9040,0.9078,2,0,2,676352,92,125894,362,0.0007286782410340895,0.7973568281938326
9041,0.9079,3,1,3,676353,91,125897,359,0.0007207578253706755,0.7977777777777778
9042,0.9081,1,0,1,676353,91,125898,358,0.0007207578253706755,0.7973273942093542
9043,0.9083,1,0,1,676353,91,125899,357,0.0007207578253706755,0.796875
9044,0.9084,1,1,1,676354,90,125900,356,0.0007128374097072614,0.7982062780269058
9045,0.9086,2,1,2,676355,89,125902,354,0.0007049169940438474,0.7990970654627539
9046,0.9087,2,1,2,676356,88,125904,352,0.0006969965783804334,0.8
9047,0.9088,2,1,2,676357,87,125906,350,0.0006890761627170194,0.8009153318077803
9048,0.9089,3,0,3,676357,87,125909,347,0.0006890761627170194,0.7995391705069125
9049,0.9091,1,0,1,676357,87,125910,346,0.0006890761627170194,0.7990762124711316
9050,0.9092,1,0,1,676357,87,125911,345,0.0006890761627170194,0.7986111111111112
9051,0.9094,1,0,1,676357,87,125912,344,0.0006890761627170194,0.7981438515081206
9052,0.9095,3,0,3,676357,87,125915,341,0.0006890761627170194,0.7967289719626168
9053,0.9096,3,1,3,676358,86,125918,338,0.0006811557470536054,0.7971698113207547
9054,0.9098,1,0,1,676358,86,125919,337,0.0006811557470536054,0.7966903073286052
9055,0.9099,3,0,3,676358,86,125922,334,0.0006811557470536054,0.7952380952380952
9056,0.91,1,1,1,676359,85,125923,333,0.0006732353313901913,0.7966507177033493
9057,0.9101,1,0,1,676359,85,125924,332,0.0006732353313901913,0.7961630695443646
9058,0.9102,3,0,3,676359,85,125927,329,0.0006732353313901913,0.7946859903381642
9059,0.9103,2,0,2,676359,85,125929,327,0.0006732353313901913,0.7936893203883495
9060,0.9104,3,1,3,676360,84,125932,324,0.0006653149157267774,0.7941176470588235
9061,0.9105,1,0,1,676360,84,125933,323,0.0006653149157267774,0.7936117936117936
9062,0.9106,1,1,1,676361,83,125934,322,0.0006573945000633633,0.7950617283950617
9063,0.9107,1,0,1,676361,83,125935,321,0.0006573945000633633,0.7945544554455446
9064,0.9108,2,0,2,676361,83,125937,319,0.0006573945000633633,0.7935323383084577
9065,0.9109,2,0,2,676361,83,125939,317,0.0006573945000633633,0.7925
9066,0.911,0,1,0,676362,82,125939,317,0.0006494740843999493,0.7944862155388471
9067,0.9111,1,0,1,676362,82,125940,316,0.0006494740843999493,0.7939698492462312
9068,0.9112,4,1,4,676363,81,125944,312,0.0006415536687365353,0.7938931297709924
9069,0.9113,1,1,1,676364,80,125945,311,0.0006336332530731213,0.7953964194373402
9070,0.9114,1,1,1,676365,79,125946,310,0.0006257128374097073,0.7969151670951157
9071,0.9115,0,1,0,676366,78,125946,310,0.0006177924217462932,0.7989690721649485
9072,0.9116,0,1,0,676367,77,125946,310,0.0006098720060828792,0.8010335917312662
9073,0.9119,2,0,2,676367,77,125948,308,0.0006098720060828792,0.8
9074,0.912,1,1,1,676368,76,125949,307,0.0006019515904194653,0.8015665796344648
9075,0.9121,2,0,2,676368,76,125951,305,0.0006019515904194653,0.800524934383202
9076,0.9123,1,1,1,676369,75,125952,304,0.0005940311747560512,0.8021108179419525
9077,0.9124,1,0,1,676369,75,125953,303,0.0005940311747560512,0.8015873015873016
9078,0.9126,3,1,3,676370,74,125956,300,0.0005861107590926372,0.8021390374331551
9079,0.9127,2,0,2,676370,74,125958,298,0.0005861107590926372,0.8010752688172043
9080,0.9128,1,0,1,676370,74,125959,297,0.0005861107590926372,0.8005390835579514
9081,0.9129,2,1,2,676371,73,125961,295,0.0005781903434292231,0.8016304347826086
9082,0.913,1,0,1,676371,73,125962,294,0.0005781903434292231,0.8010899182561307
9083,0.9131,3,0,3,676371,73,125965,291,0.0005781903434292231,0.7994505494505495
9084,0.9132,0,1,0,676372,72,125965,291,0.0005702699277658091,0.8016528925619835
9085,0.9133,2,1,2,676373,71,125967,289,0.0005623495121023952,0.8027777777777778
9086,0.9134,2,0,2,676373,71,125969,287,0.0005623495121023952,0.8016759776536313
9087,0.9135,3,1,3,676374,70,125972,284,0.0005544290964389811,0.8022598870056498
9088,0.9136,2,0,2,676374,70,125974,282,0.0005544290964389811,0.8011363636363636
9089,0.9138,1,0,1,676374,70,125975,281,0.0005544290964389811,0.8005698005698005
9090,0.9139,2,0,2,676374,70,125977,279,0.0005544290964389811,0.7994269340974212
9091,0.914,4,0,4,676374,70,125981,275,0.0005544290964389811,0.7971014492753623
9092,0.9141,1,0,1,676374,70,125982,274,0.0005544290964389811,0.7965116279069767
9093,0.9142,2,0,2,676374,70,125984,272,0.0005544290964389811,0.7953216374269005
9094,0.9145,3,0,3,676374,70,125987,269,0.0005544290964389811,0.7935103244837758
9095,0.9146,7,0,7,676374,70,125994,262,0.0005544290964389811,0.7891566265060241
9096,0.9147,0,1,0,676375,69,125994,262,0.0005465086807755671,0.7915407854984894
9097,0.9148,2,0,2,676375,69,125996,260,0.0005465086807755671,0.790273556231003
9098,0.9149,3,1,3,676376,68,125999,257,0.000538588265112153,0.7907692307692308
9099,0.915,1,1,1,676377,67,126000,256,0.0005306678494487391,0.7925696594427245
9100,0.9151,0,1,0,676378,66,126000,256,0.0005227474337853251,0.7950310559006211
9101,0.9152,2,0,2,676378,66,126002,254,0.0005227474337853251,0.79375
9102,0.9154,0,1,0,676379,65,126002,254,0.000514827018121911,0.7962382445141066
9103,0.9155,3,0,3,676379,65,126005,251,0.000514827018121911,0.7943037974683544
9104,0.9156,3,1,3,676380,64,126008,248,0.000506906602458497,0.7948717948717948
9105,0.9157,2,0,2,676380,64,126010,246,0.000506906602458497,0.7935483870967742
9106,0.9158,2,0,2,676380,64,126012,244,0.000506906602458497,0.7922077922077922
9107,0.9159,2,1,2,676381,63,126014,242,0.000498986186795083,0.7934426229508197
9108,0.916,1,0,1,676381,63,126015,241,0.000498986186795083,0.7927631578947368
9109,0.9161,2,0,2,676381,63,126017,239,0.000498986186795083,0.7913907284768212
9110,0.9162,1,0,1,676381,63,126018,238,0.000498986186795083,0.7906976744186046
9111,0.9163,1,0,1,676381,63,126019,237,0.000498986186795083,0.79
9112,0.9164,1,0,1,676381,63,126020,236,0.000498986186795083,0.7892976588628763
9113,0.9166,1,0,1,676381,63,126021,235,0.000498986186795083,0.7885906040268457
9114,0.9167,1,0,1,676381,63,126022,234,0.000498986186795083,0.7878787878787878
9115,0.9168,1,1,1,676382,62,126023,233,0.000491065771131669,0.7898305084745763
9116,0.9169,2,1,2,676383,61,126025,231,0.00048314535546825497,0.791095890410959
9117,0.917,3,0,3,676383,61,126028,228,0.00048314535546825497,0.7889273356401384
9118,0.9171,3,1,3,676384,60,126031,225,0.00047522493980484094,0.7894736842105263
9119,0.9173,2,0,2,676384,60,126033,223,0.00047522493980484094,0.7879858657243817
9120,0.9174,2,0,2,676384,60,126035,221,0.00047522493980484094,0.7864768683274022
9121,0.9177,0,1,0,676385,59,126035,221,0.00046730452414142697,0.7892857142857143
9122,0.9178,1,2,1,676387,57,126036,220,0.0004514636928145989,0.7942238267148014
9123,0.9179,1,1,1,676388,56,126037,219,0.0004435432771511849,0.7963636363636364
9124,0.918,1,0,1,676388,56,126038,218,0.0004435432771511849,0.7956204379562044
9125,0.9181,0,1,0,676389,55,126038,218,0.00043562286148777086,0.7985347985347986
9126,0.9182,1,1,1,676390,54,126039,217,0.0004277024458243569,0.8007380073800738
9127,0.9184,3,0,3,676390,54,126042,214,0.0004277024458243569,0.7985074626865671
9128,0.9188,3,0,3,676390,54,126045,211,0.0004277024458243569,0.7962264150943397
9129,0.9189,1,0,1,676390,54,126046,210,0.0004277024458243569,0.7954545454545454
9130,0.9191,1,0,1,676390,54,126047,209,0.0004277024458243569,0.7946768060836502
9131,0.9193,3,2,3,676392,52,126050,206,0.00041186161449752884,0.7984496124031008
9132,0.9194,2,0,2,676392,52,126052,204,0.00041186161449752884,0.796875
9133,0.9197,0,1,0,676393,51,126052,204,0.0004039411988341148,0.8
9134,0.9198,1,1,1,676394,50,126053,203,0.0003960207831707008,0.8023715415019763
9135,0.9199,3,1,3,676395,49,126056,200,0.00038810036750728676,0.8032128514056225
9136,0.92,1,0,1,676395,49,126057,199,0.00038810036750728676,0.8024193548387096
9137,0.9201,1,0,1,676395,49,126058,198,0.00038810036750728676,0.8016194331983806
9138,0.9202,2,0,2,676395,49,126060,196,0.00038810036750728676,0.8
9139,0.9203,2,0,2,676395,49,126062,194,0.00038810036750728676,0.7983539094650206
9140,0.9204,0,3,0,676398,46,126062,194,0.00036433912051704473,0.8083333333333333
9141,0.9205,1,0,1,676398,46,126063,193,0.00036433912051704473,0.8075313807531381
9142,0.9206,2,0,2,676398,46,126065,191,0.00036433912051704473,0.8059071729957806
9143,0.9207,1,0,1,676398,46,126066,190,0.00036433912051704473,0.8050847457627118
9144,0.9209,1,0,1,676398,46,126067,189,0.00036433912051704473,0.8042553191489362
9145,0.921,1,0,1,676398,46,126068,188,0.00036433912051704473,0.8034188034188035
9146,0.9211,1,0,1,676398,46,126069,187,0.00036433912051704473,0.8025751072961373
9147,0.9214,1,0,1,676398,46,126070,186,0.00036433912051704473,0.8017241379310345
9148,0.9215,3,0,3,676398,46,126073,183,0.00036433912051704473,0.7991266375545851
9149,0.9218,2,0,2,676398,46,126075,181,0.00036433912051704473,0.7973568281938326
9150,0.9219,2,1,2,676399,45,126077,179,0.0003564187048536307,0.7991071428571429
9151,0.9221,0,1,0,676400,44,126077,179,0.0003484982891902167,0.8026905829596412
9152,0.9223,3,0,3,676400,44,126080,176,0.0003484982891902167,0.8
9153,0.9224,2,0,2,676400,44,126082,174,0.0003484982891902167,0.7981651376146789
9154,0.9225,1,0,1,676400,44,126083,173,0.0003484982891902167,0.7972350230414746
9155,0.9227,4,0,4,676400,44,126087,169,0.0003484982891902167,0.7934272300469484
9156,0.9228,2,0,2,676400,44,126089,167,0.0003484982891902167,0.7914691943127962
9157,0.9229,2,0,2,676400,44,126091,165,0.0003484982891902167,0.7894736842105263
9158,0.923,1,0,1,676400,44,126092,164,0.0003484982891902167,0.7884615384615384
9159,0.9232,1,0,1,676400,44,126093,163,0.0003484982891902167,0.7874396135265701
9160,0.9233,1,0,1,676400,44,126094,162,0.0003484982891902167,0.7864077669902912
9161,0.9234,1,1,1,676401,43,126095,161,0.0003405778735268027,0.7892156862745098
9162,0.9235,0,1,0,676402,42,126095,161,0.0003326574578633887,0.7931034482758621
9163,0.9237,1,0,1,676402,42,126096,160,0.0003326574578633887,0.7920792079207921
9164,0.9239,3,0,3,676402,42,126099,157,0.0003326574578633887,0.7889447236180904
9165,0.924,1,0,1,676402,42,126100,156,0.0003326574578633887,0.7878787878787878
9166,0.9241,4,0,4,676402,42,126104,152,0.0003326574578633887,0.7835051546391752
9167,0.9242,1,0,1,676402,42,126105,151,0.0003326574578633887,0.7823834196891192
9168,0.9243,1,0,1,676402,42,126106,150,0.0003326574578633887,0.78125
9169,0.9244,4,0,4,676402,42,126110,146,0.0003326574578633887,0.776595744680851
9170,0.9245,2,0,2,676402,42,126112,144,0.0003326574578633887,0.7741935483870968
9171,0.9249,1,0,1,676402,42,126113,143,0.0003326574578633887,0.772972972972973
9172,0.9251,1,0,1,676402,42,126114,142,0.0003326574578633887,0.7717391304347826
9173,0.9252,2,0,2,676402,42,126116,140,0.0003326574578633887,0.7692307692307693
9174,0.9253,0,1,0,676403,41,126116,140,0.00032473704219997465,0.7734806629834254
9175,0.9254,1,1,1,676404,40,126117,139,0.0003168166265365606,0.776536312849162
9176,0.9255,1,0,1,676404,40,126118,138,0.0003168166265365606,0.7752808988764045
9177,0.926,3,0,3,676404,40,126121,135,0.0003168166265365606,0.7714285714285715
9178,0.9261,1,0,1,676404,40,126122,134,0.0003168166265365606,0.7701149425287356
9179,0.9262,1,1,1,676405,39,126123,133,0.0003088962108731466,0.7732558139534884
9180,0.9263,2,0,2,676405,39,126125,131,0.0003088962108731466,0.7705882352941177
9181,0.9264,1,0,1,676405,39,126126,130,0.0003088962108731466,0.7692307692307693
9182,0.9266,0,1,0,676406,38,126126,130,0.00030097579520973263,0.7738095238095238
9183,0.9267,0,2,0,676408,36,126126,130,0.0002851349638829046,0.7831325301204819
9184,0.9268,1,0,1,676408,36,126127,129,0.0002851349638829046,0.7818181818181819
9185,0.9269,1,1,1,676409,35,126128,128,0.00027721454821949055,0.7852760736196319
9186,0.9272,1,2,1,676411,33,126129,127,0.00026137371689266255,0.79375
9187,0.9275,1,0,1,676411,33,126130,126,0.00026137371689266255,0.7924528301886793
9188,0.9277,1,0,1,676411,33,126131,125,0.00026137371689266255,0.7911392405063291
9189,0.9279,1,0,1,676411,33,126132,124,0.00026137371689266255,0.7898089171974523
9190,0.928,1,0,1,676411,33,126133,123,0.00026137371689266255,0.7884615384615384
9191,0.9283,2,0,2,676411,33,126135,121,0.00026137371689266255,0.7857142857142857
9192,0.9286,2,1,2,676412,32,126137,119,0.0002534533012292485,0.7880794701986755
9193,0.9287,2,1,2,676413,31,126139,117,0.0002455328855658345,0.7905405405405406
9194,0.9288,1,0,1,676413,31,126140,116,0.0002455328855658345,0.7891156462585034
9195,0.9289,1,0,1,676413,31,126141,115,0.0002455328855658345,0.7876712328767124
9196,0.929,2,0,2,676413,31,126143,113,0.0002455328855658345,0.7847222222222222
9197,0.9291,1,0,1,676413,31,126144,112,0.0002455328855658345,0.7832167832167832
9198,0.9292,1,0,1,676413,31,126145,111,0.0002455328855658345,0.7816901408450704
9199,0.9294,0,1,0,676414,30,126145,111,0.00023761246990242047,0.7872340425531915
9200,0.9295,1,0,1,676414,30,126146,110,0.00023761246990242047,0.7857142857142857
9201,0.9297,1,0,1,676414,30,126147,109,0.00023761246990242047,0.7841726618705036
9202,0.9298,1,0,1,676414,30,126148,108,0.00023761246990242047,0.782608695652174
9203,0.9303,0,1,0,676415,29,126148,108,0.00022969205423900647,0.7883211678832117
9204,0.9306,1,0,1,676415,29,126149,107,0.00022969205423900647,0.7867647058823529
9205,0.9307,1,0,1,676415,29,126150,106,0.00022969205423900647,0.7851851851851852
9206,0.9308,1,0,1,676415,29,126151,105,0.00022969205423900647,0.7835820895522388
9207,0.9309,1,1,1,676416,28,126152,104,0.00022177163857559244,0.7878787878787878
9208,0.931,1,0,1,676416,28,126153,103,0.00022177163857559244,0.7862595419847328
9209,0.9312,1,0,1,676416,28,126154,102,0.00022177163857559244,0.7846153846153846
9210,0.9313,1,0,1,676416,28,126155,101,0.00022177163857559244,0.7829457364341085
9211,0.9314,1,1,1,676417,27,126156,100,0.00021385122291217844,0.7874015748031497
9212,0.9315,3,0,3,676417,27,126159,97,0.00021385122291217844,0.782258064516129
9213,0.9317,2,1,2,676418,26,126161,95,0.00020593080724876442,0.7851239669421488
9214,0.9319,2,1,2,676419,25,126163,93,0.0001980103915853504,0.788135593220339
9215,0.9321,1,0,1,676419,25,126164,92,0.0001980103915853504,0.7863247863247863
9216,0.9324,1,0,1,676419,25,126165,91,0.0001980103915853504,0.7844827586206896
9217,0.9326,1,0,1,676419,25,126166,90,0.0001980103915853504,0.782608695652174
9218,0.9327,1,0,1,676419,25,126167,89,0.0001980103915853504,0.7807017543859649
9219,0.933,1,0,1,676419,25,126168,88,0.0001980103915853504,0.7787610619469026
9220,0.9331,1,0,1,676419,25,126169,87,0.0001980103915853504,0.7767857142857143
9221,0.9332,1,0,1,676419,25,126170,86,0.0001980103915853504,0.7747747747747747
9222,0.9337,1,1,1,676420,24,126171,85,0.0001900899759219364,0.7798165137614679
9223,0.9339,1,1,1,676421,23,126172,84,0.00018216956025852237,0.7850467289719626
9224,0.934,1,1,1,676422,22,126173,83,0.00017424914459510834,0.7904761904761904
9225,0.9342,1,0,1,676422,22,126174,82,0.00017424914459510834,0.7884615384615384
9226,0.9343,1,0,1,676422,22,126175,81,0.00017424914459510834,0.7864077669902912
9227,0.9344,2,0,2,676422,22,126177,79,0.00017424914459510834,0.7821782178217822
9228,0.9345,1,0,1,676422,22,126178,78,0.00017424914459510834,0.78
9229,0.9347,0,1,0,676423,21,126178,78,0.00016632872893169434,0.7878787878787878
9230,0.9349,0,1,0,676424,20,126178,78,0.0001584083132682803,0.7959183673469388
9231,0.9355,0,1,0,676425,19,126178,78,0.00015048789760486631,0.8041237113402062
9232,0.9356,1,0,1,676425,19,126179,77,0.00015048789760486631,0.8020833333333334
9233,0.9358,1,0,1,676425,19,126180,76,0.00015048789760486631,0.8
9234,0.9361,0,1,0,676426,18,126180,76,0.0001425674819414523,0.8085106382978723
9235,0.9363,0,1,0,676427,17,126180,76,0.00013464706627803826,0.8172043010752689
9236,0.9364,1,0,1,676427,17,126181,75,0.00013464706627803826,0.8152173913043478
9237,0.9367,1,1,1,676428,16,126182,74,0.00012672665061462426,0.8222222222222222
9238,0.9368,1,0,1,676428,16,126183,73,0.00012672665061462426,0.8202247191011236
9239,0.9369,2,0,2,676428,16,126185,71,0.00012672665061462426,0.8160919540229885
9240,0.937,1,0,1,676428,16,126186,70,0.00012672665061462426,0.813953488372093
9241,0.9371,1,0,1,676428,16,126187,69,0.00012672665061462426,0.8117647058823529
9242,0.9372,1,0,1,676428,16,126188,68,0.00012672665061462426,0.8095238095238095
9243,0.9373,1,0,1,676428,16,126189,67,0.00012672665061462426,0.8072289156626506
9244,0.9378,0,1,0,676429,15,126189,67,0.00011880623495121023,0.8170731707317073
9245,0.9382,2,0,2,676429,15,126191,65,0.00011880623495121023,0.8125
9246,0.9384,1,2,1,676431,13,126192,64,0.00010296540362438221,0.8311688311688312
9247,0.9385,2,0,2,676431,13,126194,62,0.00010296540362438221,0.8266666666666667
9248,0.9387,0,1,0,676432,12,126194,62,9.50449879609682e-05,0.8378378378378378
9249,0.9389,2,0,2,676432,12,126196,60,9.50449879609682e-05,0.8333333333333334
9250,0.9391,0,1,0,676433,11,126196,60,8.712457229755417e-05,0.8450704225352113
9251,0.9396,1,0,1,676433,11,126197,59,8.712457229755417e-05,0.8428571428571429
9252,0.9398,1,0,1,676433,11,126198,58,8.712457229755417e-05,0.8405797101449275
9253,0.94,1,0,1,676433,11,126199,57,8.712457229755417e-05,0.8382352941176471
9254,0.9405,1,0,1,676433,11,126200,56,8.712457229755417e-05,0.835820895522388
9255,0.9407,1,0,1,676433,11,126201,55,8.712457229755417e-05,0.8333333333333334
9256,0.9408,2,0,2,676433,11,126203,53,8.712457229755417e-05,0.828125
9257,0.9411,1,0,1,676433,11,126204,52,8.712457229755417e-05,0.8253968253968254
9258,0.9412,1,0,1,676433,11,126205,51,8.712457229755417e-05,0.8225806451612904
9259,0.9415,1,0,1,676433,11,126206,50,8.712457229755417e-05,0.819672131147541
9260,0.9416,2,0,2,676433,11,126208,48,8.712457229755417e-05,0.8135593220338984
9261,0.9425,0,1,0,676434,10,126208,48,7.920415663414016e-05,0.8275862068965517
9262,0.9426,1,0,1,676434,10,126209,47,7.920415663414016e-05,0.8245614035087719
9263,0.9429,1,0,1,676434,10,126210,46,7.920415663414016e-05,0.8214285714285714
9264,0.943,1,0,1,676434,10,126211,45,7.920415663414016e-05,0.8181818181818182
9265,0.9432,1,0,1,676434,10,126212,44,7.920415663414016e-05,0.8148148148148148
9266,0.9434,0,1,0,676435,9,126212,44,7.128374097072614e-05,0.8301886792452831
9267,0.9435,1,0,1,676435,9,126213,43,7.128374097072614e-05,0.8269230769230769
9268,0.9439,1,0,1,676435,9,126214,42,7.128374097072614e-05,0.8235294117647058
9269,0.9441,0,1,0,676436,8,126214,42,6.336332530731213e-05,0.84
9270,0.9446,1,0,1,676436,8,126215,41,6.336332530731213e-05,0.8367346938775511
9271,0.9451,1,0,1,676436,8,126216,40,6.336332530731213e-05,0.8333333333333334
9272,0.946,1,0,1,676436,8,126217,39,6.336332530731213e-05,0.8297872340425532
9273,0.9461,1,1,1,676437,7,126218,38,5.544290964389811e-05,0.8444444444444444
9274,0.9462,2,1,2,676438,6,126220,36,4.75224939804841e-05,0.8571428571428571
9275,0.9463,1,1,1,676439,5,126221,35,3.960207831707008e-05,0.875
9276,0.9464,1,0,1,676439,5,126222,34,3.960207831707008e-05,0.8717948717948718
9277,0.9465,0,1,0,676440,4,126222,34,3.1681662653656065e-05,0.8947368421052632
9278,0.9468,2,0,2,676440,4,126224,32,3.1681662653656065e-05,0.8888888888888888
9279,0.9473,0,1,0,676441,3,126224,32,2.376124699024205e-05,0.9142857142857143
9280,0.9474,1,1,1,676442,2,126225,31,1.5840831326828033e-05,0.9393939393939394
9281,0.9479,1,0,1,676442,2,126226,30,1.5840831326828033e-05,0.9375
9282,0.949,1,0,1,676442,2,126227,29,1.5840831326828033e-05,0.9354838709677419
9283,0.9493,1,0,1,676442,2,126228,28,1.5840831326828033e-05,0.9333333333333333
9284,0.9514,1,0,1,676442,2,126229,27,1.5840831326828033e-05,0.9310344827586207
9285,0.9518,1,0,1,676442,2,126230,26,1.5840831326828033e-05,0.9285714285714286
9286,0.9532,1,0,1,676442,2,126231,25,1.5840831326828033e-05,0.9259259259259259
9287,0.9536,1,0,1,676442,2,126232,24,1.5840831326828033e-05,0.9230769230769231
9288,0.9537,1,0,1,676442,2,126233,23,1.5840831326828033e-05,0.92
9289,0.9544,1,0,1,676442,2,126234,22,1.5840831326828033e-05,0.9166666666666666
9290,0.9548,1,0,1,676442,2,126235,21,1.5840831326828033e-05,0.9130434782608695
9291,0.9556,1,0,1,676442,2,126236,20,1.5840831326828033e-05,0.9090909090909091
9292,0.9566,1,0,1,676442,2,126237,19,1.5840831326828033e-05,0.9047619047619048
9293,0.9573,1,0,1,676442,2,126238,18,1.5840831326828033e-05,0.9
9294,0.9577,0,1,0,676443,1,126238,18,7.920415663414016e-06,0.9473684210526315
9295,0.9595,1,0,1,676443,1,126239,17,7.920415663414016e-06,0.9444444444444444
9296,0.9598,1,0,1,676443,1,126240,16,7.920415663414016e-06,0.9411764705882353
9297,0.96,1,0,1,676443,1,126241,15,7.920415663414016e-06,0.9375
9298,0.9608,1,0,1,676443,1,126242,14,7.920415663414016e-06,0.9333333333333333
9299,0.961,1,0,1,676443,1,126243,13,7.920415663414016e-06,0.9285714285714286
9300,0.9612,0,1,0,676444,0,126243,13,0.0,1.0
9301,0.9626,1,0,1,676444,0,126244,12,0.0,1.0
9302,0.9637,1,0,1,676444,0,126245,11,0.0,1.0
9303,0.9644,1,0,1,676444,0,126246,10,0.0,1.0
9304,0.965,1,0,1,676444,0,126247,9,0.0,1.0
9305,0.967,1,0,1,676444,0,126248,8,0.0,1.0
9306,0.9683,1,0,1,676444,0,126249,7,0.0,1.0
9307,0.9692,1,0,1,676444,0,126250,6,0.0,1.0
9308,0.9704,1,0,1,676444,0,126251,5,0.0,1.0
9309,0.9705,1,0,1,676444,0,126252,4,0.0,1.0
9310,0.9713,1,0,1,676444,0,126253,3,0.0,1.0
9311,0.9719,1,0,1,676444,0,126254,2,0.0,1.0
9312,0.9726,1,0,1,676444,0,126255,1,0.0,1.0
9313,0.9746,1,0,1,676444,0,126256,0,0.0,
