,y_proba,y_test,Neg,Pos,TN,FP,FN,TP,FP/P,Prec
0,0.0,0,474,0,474,605136,0,107956,5.605394790470192,0.15139140531656503
1,0.0085,0,1,0,475,605135,0,107956,5.605385527437104,0.1513916176196306
2,0.01,7,796,7,1271,604339,7,107949,5.598012153099411,0.15155246192551328
3,0.0185,0,3,0,1274,604336,7,107949,5.5979843640001485,0.15155310023375473
4,0.02,8,1025,8,2299,603311,15,107941,5.588489755085405,0.1517619634109992
5,0.0265,0,3,0,2302,603308,15,107941,5.588461965986142,0.15176260353265875
6,0.0274,0,2,0,2304,603306,15,107941,5.588443439919968,0.15176303028343177
7,0.0279,0,1,0,2305,603305,15,107941,5.58843417688688,0.1517632436597183
8,0.0285,0,6,0,2311,603299,15,107941,5.5883785986883545,0.15176452393003767
9,0.0292,0,1,0,2312,603298,15,107941,5.588369335655267,0.1517647373105243
10,0.0296,0,1,0,2313,603297,15,107941,5.588360072622179,0.15176495069161097
11,0.03,13,1554,13,3867,601743,28,107928,5.57396531920412,0.15208173928482352
12,0.0358,0,1,0,3868,601742,28,107928,5.573956056171033,0.1520819535840602
13,0.0374,0,4,0,3872,601738,28,107928,5.573919004038682,0.1520828107870463
14,0.0379,0,1,0,3873,601737,28,107928,5.573909741005595,0.1520830250893027
15,0.0385,1,9,1,3882,601728,29,107927,5.573826373707807,0.15208375900965962
16,0.0389,0,3,0,3885,601725,29,107927,5.573798584608544,0.15208440193221467
17,0.0392,0,3,0,3888,601722,29,107927,5.573770795509281,0.15208504486020555
18,0.04,15,2200,15,6088,599522,44,107912,5.553392122716662,0.1525400249351883
19,0.0457,0,1,0,6089,599521,44,107912,5.553382859683575,0.1525402405598834
20,0.0458,0,1,0,6090,599520,44,107912,5.553373596650487,0.1525404561851881
21,0.0465,0,1,0,6091,599519,44,107912,5.5533643336174,0.15254067181110242
22,0.0474,0,7,0,6098,599512,44,107912,5.553299492385787,0.15254218120957164
23,0.0477,0,2,0,6100,599510,44,107912,5.553280966319612,0.15254261247176368
24,0.0479,0,1,0,6101,599509,44,107912,5.553271703286524,0.15254282810377412
25,0.0485,0,14,0,6115,599495,44,107912,5.553142020823298,0.15254584701593282
26,0.0489,0,3,0,6118,599492,44,107912,5.553114231724035,0.15254649394122735
27,0.0492,0,6,0,6124,599486,44,107912,5.55305865352551,0.15254778780827766
28,0.0494,0,3,0,6127,599483,44,107912,5.553030864426248,0.15254843475003357
29,0.05,23,2720,23,8847,596763,67,107889,5.5278354144281,0.15310962006777815
30,0.0548,0,1,0,8848,596762,67,107889,5.527826151395013,0.15310983735210765
31,0.0558,0,2,0,8850,596760,67,107889,5.527807625328838,0.15311027192261678
32,0.0565,0,5,0,8855,596755,67,107889,5.5277613101634,0.15311135835968234
33,0.0574,1,17,1,8872,596738,68,107888,5.527603838600911,0.15311385046819165
34,0.0579,0,7,0,8879,596731,68,107888,5.527538997369299,0.15311537156960003
35,0.0585,1,33,1,8912,596698,69,107887,5.5272333172774095,0.15312134093118646
36,0.0589,1,2,1,8914,596696,70,107886,5.527214791211234,0.15312057361669756
37,0.0592,0,7,0,8921,596689,70,107886,5.527149949979622,0.15312209487989215
38,0.0594,0,1,0,8922,596688,70,107886,5.527140686946534,0.1531223122056732
39,0.06,36,3414,36,12336,593274,106,107850,5.495516691985624,0.1538244304859055
40,0.0658,0,1,0,12337,593273,106,107850,5.4955074289525365,0.1538246498831161
41,0.0659,0,1,0,12338,593272,106,107850,5.495498165919448,0.15382486928095254
42,0.0665,0,5,0,12343,593267,106,107850,5.495451850754011,0.15382596627952252
43,0.067,0,1,0,12344,593266,106,107850,5.495442587720923,0.1538261856811141
44,0.0674,1,20,1,12364,593246,107,107849,5.495257327059172,0.15382936691889115
45,0.0679,0,2,0,12366,593244,107,107849,5.495238800992997,0.1538298057461706
46,0.0685,2,30,2,12396,593214,109,107847,5.494960910000371,0.1538339745043584
47,0.0689,0,4,0,12400,593210,109,107847,5.49492385786802,0.15383485223027515
48,0.0692,0,20,0,12420,593190,109,107847,5.494738597206269,0.1538392410101036
49,0.0694,0,1,0,12421,593189,109,107847,5.494729334173182,0.15383946045566846
50,0.0696,0,3,0,12424,593186,109,107847,5.494701545073919,0.15384011879611945
51,0.0697,0,1,0,12425,593185,109,107847,5.494692282040831,0.15384033824418858
52,0.07,40,4055,40,16480,589130,149,107807,5.457130682870799,0.15468686552730018
53,0.0732,0,1,0,16481,589129,149,107807,5.457121419837712,0.15468708748005555
54,0.0758,0,2,0,16483,589127,149,107807,5.457102893771537,0.15468753138747715
55,0.0765,0,10,0,16493,589117,149,107807,5.457010263440661,0.15468975096280227
56,0.077,0,1,0,16494,589116,149,107807,5.4570010004075735,0.15468997292383807
57,0.0774,1,24,1,16518,589092,150,107806,5.456778687613472,0.15469408722653818
58,0.0779,0,8,0,16526,589084,150,107806,5.456704583348771,0.15469586304868774
59,0.0785,0,44,0,16570,589040,150,107806,5.4562970098929195,0.15470563079934446
60,0.0789,0,7,0,16577,589033,150,107806,5.456232168661306,0.1547071848734069
61,0.0792,0,29,0,16606,589004,150,107806,5.4559635407017675,0.15471362351286577
62,0.0793,0,2,0,16608,589002,150,107806,5.455945014635592,0.15471406757672126
63,0.0794,0,4,0,16612,588998,150,107806,5.455907962503242,0.15471495571207972
64,0.0796,0,2,0,16614,588996,150,107806,5.455889436437067,0.1547153997835827
65,0.08,69,4775,69,21389,584221,219,107737,5.411658453443995,0.15569875628289578
66,0.0828,0,1,0,21390,584220,219,107737,5.411649190410908,0.15569898129508047
67,0.0848,0,1,0,21391,584219,219,107737,5.411639927377821,0.15569920630791553
68,0.0853,0,1,0,21392,584218,219,107737,5.411630664344733,0.15569943132140096
69,0.0857,0,2,0,21394,584216,219,107737,5.411612138278558,0.15569988135032292
70,0.0858,0,1,0,21395,584215,219,107737,5.41160287524547,0.15570010636575948
71,0.0864,1,0,1,21395,584215,220,107736,5.41160287524547,0.15569888619280844
72,0.0865,0,7,0,21402,584208,220,107736,5.411538034013858,0.15570046130900767
73,0.0866,0,1,0,21403,584207,220,107736,5.41152877098077,0.1557006863282091
74,0.0869,0,1,0,21404,584206,220,107736,5.411519507947682,0.15570091134806097
75,0.0874,0,17,0,21421,584189,220,107736,5.411362036385194,0.1557047367850562
76,0.0877,0,1,0,21422,584188,220,107736,5.411352773352107,0.1557049618166157
77,0.0879,0,1,0,21423,584187,220,107736,5.411343510319019,0.15570518684882567
78,0.0881,0,3,0,21426,584184,220,107736,5.411315721219756,0.15570586194935832
79,0.0885,1,56,1,21482,584128,221,107735,5.410796991366853,0.155717244599003
80,0.0889,0,4,0,21486,584124,221,107735,5.410759939234503,0.15571814488212193
81,0.0892,0,21,0,21507,584103,221,107735,5.410565415539664,0.15572287153929099
82,0.0894,1,12,1,21519,584091,222,107734,5.410454259142614,0.15572435225671233
83,0.0896,0,2,0,21521,584089,222,107734,5.410435733076438,0.15572480244224318
84,0.0897,0,2,0,21523,584087,222,107734,5.410417207010264,0.15572525263037693
85,0.09,69,5430,69,26953,578657,291,107665,5.360118937344844,0.15687243014211988
86,0.0953,0,2,0,26955,578655,291,107665,5.360100411278669,0.1568728872829001
87,0.0958,0,1,0,26956,578654,291,107665,5.360091148245582,0.15687311585428934
88,0.0965,0,11,0,26967,578643,291,107665,5.359989254881619,0.15687563018353276
89,0.097,0,2,0,26969,578641,291,107665,5.359970728815443,0.15687608734296363
90,0.0974,0,37,0,27006,578604,291,107665,5.359627996591204,0.15688454527306347
91,0.0977,0,1,0,27007,578603,291,107665,5.359618733558117,0.1568847738784265
92,0.0979,0,15,0,27022,578588,291,107665,5.359479788061803,0.15688820303882095
93,0.0981,0,1,0,27023,578587,291,107665,5.359470525028716,0.15688843165484398
94,0.0985,2,83,2,27106,578504,293,107663,5.358701693282448,0.15690495171000646
95,0.0989,0,2,0,27108,578502,293,107663,5.358683167216273,0.15690540904884392
96,0.0992,0,30,0,27138,578472,293,107663,5.358405276223647,0.15691226945134704
97,0.0993,0,1,0,27139,578471,293,107663,5.358396013190559,0.1569124981417624
98,0.0994,0,12,0,27151,578459,293,107663,5.358284856793508,0.15691524247874286
99,0.0996,0,4,0,27155,578455,293,107663,5.358247804661159,0.1569161572790686
100,0.0997,0,1,0,27156,578454,293,107663,5.3582385416280705,0.15691638598081667
101,0.1,103,6117,103,33273,572337,396,107560,5.301576568231502,0.15820043330092645
102,0.1058,0,3,0,33276,572334,396,107560,5.301548779132239,0.15820113135282854
103,0.1059,0,1,0,33277,572333,396,107560,5.301539516099152,0.15820136403816482
104,0.1065,0,12,0,33289,572321,396,107560,5.301428359702101,0.1582041563155905
105,0.107,0,2,0,33291,572319,396,107560,5.301409833635926,0.15820462170474453
106,0.1074,1,40,1,33331,572279,397,107559,5.301039312312423,0.15821269184717535
107,0.1076,0,1,0,33332,572278,397,107559,5.301030049279336,0.15821292456868338
108,0.1077,0,2,0,33334,572276,397,107559,5.301011523213161,0.15821339001375334
109,0.1079,0,3,0,33337,572273,397,107559,5.300983734113898,0.15821408818649313
110,0.1085,2,88,2,33425,572185,399,107557,5.300168587202194,0.15823209394152488
111,0.1089,0,7,0,33432,572178,399,107557,5.30010374597058,0.15823372343633915
112,0.1092,0,30,0,33462,572148,399,107557,5.2998258549779536,0.1582407073656954
113,0.1093,0,1,0,33463,572147,399,107557,5.299816591944866,0.15824094017395807
114,0.1094,0,8,0,33471,572139,399,107557,5.299742487680166,0.1582428026647207
115,0.1096,0,4,0,33475,572135,399,107557,5.299705435547816,0.1582437339265432
116,0.11,95,6574,95,40049,565561,494,107462,5.238810256030234,0.15967062046913702
117,0.1138,0,1,0,40050,565560,494,107462,5.238800992997147,0.159670857713418
118,0.1139,0,2,0,40052,565558,494,107462,5.238782466930972,0.15967133220409496
119,0.1143,0,1,0,40053,565557,494,107462,5.2387732038978845,0.159671569450491
120,0.115,0,1,0,40054,565556,494,107462,5.238763940864796,0.15967180669759204
121,0.1153,0,1,0,40055,565555,494,107462,5.238754677831709,0.1596720439453981
122,0.1158,0,5,0,40060,565550,494,107462,5.238708362666271,0.15967323019500396
123,0.1164,0,2,0,40062,565548,494,107462,5.238689836600097,0.15967370469978157
124,0.1165,0,10,0,40072,565538,494,107462,5.238597206269221,0.15967607726597324
125,0.1166,0,1,0,40073,565537,494,107462,5.2385879432361335,0.15967631452647033
126,0.1167,0,1,0,40074,565536,494,107462,5.238578680203045,0.15967655178767248
127,0.1168,0,1,0,40075,565535,494,107462,5.238569417169958,0.15967678904957971
128,0.117,0,1,0,40076,565534,494,107462,5.238560154136871,0.15967702631219205
129,0.1174,1,48,1,40124,565486,495,107461,5.238115528548668,0.1596871670428726
130,0.1177,0,1,0,40125,565485,495,107461,5.23810626551558,0.15968740433853534
131,0.1179,0,3,0,40128,565482,495,107461,5.238078476416318,0.15968811622975498
132,0.1181,0,1,0,40129,565481,495,107461,5.2380692133832305,0.15968835352823868
133,0.1185,0,103,0,40232,565378,495,107461,5.237115120975212,0.1597127990499956
134,0.1186,0,1,0,40233,565377,495,107461,5.237105857942124,0.159713036421843
135,0.1189,0,4,0,40237,565373,495,107461,5.237068805809774,0.1597139859162884
136,0.1192,0,39,0,40276,565334,495,107461,5.23670754751936,0.1597232440788056
137,0.1193,0,1,0,40277,565333,495,107461,5.236698284486272,0.15972348148170168
138,0.1194,0,17,0,40294,565316,495,107461,5.236540812923784,0.15972751743891364
139,0.1196,0,3,0,40297,565313,495,107461,5.236513023824521,0.1597282296878298
140,0.12,105,7212,105,47509,558101,600,107356,5.16970802919708,0.16132672734677073
141,0.1231,0,1,0,47510,558100,600,107356,5.169698766163993,0.16132696977711525
142,0.125,0,1,0,47511,558099,600,107356,5.169689503130905,0.16132721220818838
143,0.1253,0,2,0,47513,558097,600,107356,5.16967097706473,0.16132769707252054
144,0.1254,0,1,0,47514,558096,600,107356,5.169661714031642,0.16132793950577953
145,0.1258,0,5,0,47519,558091,600,107356,5.169615398866204,0.16132915168300405
146,0.1259,0,3,0,47522,558088,600,107356,5.169587609766942,0.1613298789980825
147,0.1265,1,9,1,47531,558079,601,107355,5.169504242469154,0.1613308006504026
148,0.1268,0,1,0,47532,558078,601,107355,5.169494979436067,0.16133104309524776
149,0.127,0,1,0,47533,558077,601,107355,5.169485716402979,0.1613312855408216
150,0.1274,0,46,0,47579,558031,601,107355,5.1690596168809515,0.16134243882498278
151,0.1277,0,3,0,47582,558028,601,107355,5.169031827781689,0.16134316626664644
152,0.1278,0,2,0,47584,558026,601,107355,5.1690133017155135,0.16134365123139977
153,0.1279,0,8,0,47592,558018,601,107355,5.168939197450813,0.16134559111956753
154,0.1281,0,2,0,47594,558016,601,107355,5.1689206713846385,0.1613460760988982
155,0.1285,1,106,1,47700,557910,602,107354,5.167938789877358,0.16137052358161572
156,0.1286,1,2,1,47702,557908,603,107353,5.167920263811182,0.16136974811389815
157,0.1288,0,1,0,47703,557907,603,107353,5.167911000778095,0.1613699906803355
158,0.1289,1,4,1,47707,557903,604,107352,5.167873948645744,0.16136970034047093
159,0.1292,0,55,0,47762,557848,604,107352,5.1673644818259294,0.16138304269392664
160,0.1293,0,1,0,47763,557847,604,107352,5.167355218792841,0.16138328530259366
161,0.1294,0,15,0,47778,557832,604,107352,5.167216273296528,0.16138692452013279
162,0.1296,0,2,0,47780,557830,604,107352,5.167197747230353,0.16138740976153895
163,0.1297,0,5,0,47785,557825,604,107352,5.167151432064915,0.1613886228778205
164,0.13,151,7625,151,55410,550200,755,107201,5.0965208047723145,0.16306789919698936
165,0.133,0,1,0,55411,550199,755,107201,5.096511541739227,0.16306814724672955
166,0.1343,0,1,0,55412,550198,755,107201,5.096502278706139,0.16306839529722436
167,0.135,0,2,0,55414,550196,755,107201,5.096483752639965,0.16306889140047795
168,0.1353,0,1,0,55415,550195,755,107201,5.0964744896068765,0.1630691394532367
169,0.1358,0,4,0,55419,550191,755,107201,5.096437437474527,0.16307013167181833
170,0.1359,0,7,0,55426,550184,755,107201,5.096372596242913,0.16307186808339103
171,0.1364,0,1,0,55427,550183,755,107201,5.096363333209826,0.16307211614520584
172,0.1365,0,17,0,55444,550166,755,107201,5.096205861647338,0.16307633331152918
173,0.1366,0,3,0,55447,550163,755,107201,5.096178072548075,0.16307707753999306
174,0.1368,0,1,0,55448,550162,755,107201,5.096168809514988,0.16307732561765723
175,0.1369,0,1,0,55449,550161,755,107201,5.0961595464819,0.16307757369607614
176,0.137,0,3,0,55452,550158,755,107201,5.096131757382637,0.16307831793586153
177,0.1374,4,63,4,55515,550095,759,107197,5.095548186298122,0.1630888554858419
178,0.1377,0,2,0,55517,550093,759,107197,5.095529660231946,0.16308935173211217
179,0.1379,1,9,1,55526,550084,760,107196,5.095446292934159,0.16309031158714704
180,0.1381,0,2,0,55528,550082,760,107196,5.095427766867983,0.163090807846908
181,0.1382,0,1,0,55529,550081,760,107196,5.095418503834896,0.16309105597792103
182,0.1385,2,146,2,55675,549935,762,107194,5.094066101004112,0.16312474415221365
183,0.1389,0,7,0,55682,549928,762,107194,5.0940012597725,0.1631264818405106
184,0.139,0,1,0,55683,549927,762,107194,5.093991996739413,0.16312673008471804
185,0.1392,0,51,0,55734,549876,762,107194,5.093519582051947,0.1631393915412361
186,0.1393,0,1,0,55735,549875,762,107194,5.0935103190188595,0.16313963982473684
187,0.1394,0,18,0,55753,549857,762,107194,5.093343584423284,0.1631441090569834
188,0.1396,0,5,0,55758,549852,762,107194,5.093297269257846,0.1631453505538425
189,0.1397,0,2,0,55760,549850,762,107194,5.093278743191671,0.1631458471578768
190,0.14,167,8236,167,63996,541614,929,107027,5.016988402682574,0.16500190398078443
191,0.1453,0,2,0,63998,541612,929,107027,5.0169698766163995,0.1650024127442229
192,0.1458,1,0,1,63998,541612,930,107026,5.0169698766163995,0.16500112543514256
193,0.1459,0,3,0,64001,541609,930,107026,5.016942087517137,0.16500188858140558
194,0.1464,0,1,0,64002,541608,930,107026,5.016932824484049,0.16500214296506197
195,0.1465,0,41,0,64043,541567,930,107026,5.01655304012746,0.16501257337035707
196,0.1466,0,2,0,64045,541565,930,107026,5.016534514061284,0.16501308220434757
197,0.147,0,10,0,64055,541555,930,107026,5.016441883730408,0.16501562642137219
198,0.1474,1,65,1,64120,541490,931,107025,5.0158397865797175,0.16503087823720344
199,0.1477,0,1,0,64121,541489,931,107025,5.01583052354663,0.16503113271263226
200,0.1479,0,10,0,64131,541479,931,107025,5.015737893215754,0.16503367751008474
201,0.1485,2,117,2,64248,541362,933,107023,5.01465411834451,0.16506088203767824
202,0.1488,1,3,1,64251,541359,934,107022,5.014626329245248,0.16506035803023222
203,0.1489,0,10,0,64261,541349,934,107022,5.014533698914373,0.16506290380044758
204,0.1492,0,45,0,64306,541304,934,107022,5.014116862425433,0.16507436073827056
205,0.1494,1,20,1,64326,541284,935,107021,5.013931601763682,0.16507816536969483
206,0.1495,0,1,0,64327,541283,935,107021,5.013922338730594,0.1650784200004936
207,0.1496,0,1,0,64328,541282,935,107021,5.0139130756975065,0.1650786746320779
208,0.1497,0,1,0,64329,541281,935,107021,5.013903812664418,0.16507892926444775
209,0.15,169,8781,169,73110,532500,1104,106852,4.932565119122605,0.1671254645328395
210,0.1517,0,1,0,73111,532499,1104,106852,4.932555856089518,0.16712572593145236
211,0.1535,0,1,0,73112,532498,1104,106852,4.93254659305643,0.16712598733088294
212,0.1549,0,1,0,73113,532497,1104,106852,4.932537330023343,0.1671262487311312
213,0.1555,0,2,0,73115,532495,1104,106852,4.9325188039571675,0.16712677153408087
214,0.1558,0,5,0,73120,532490,1104,106852,4.93247248879173,0.16712807855576514
215,0.1559,0,5,0,73125,532485,1104,106852,4.932426173626292,0.1671293855978928
216,0.1564,0,2,0,73127,532483,1104,106852,4.932407647560117,0.16712990842046815
217,0.1565,0,22,0,73149,532461,1104,106852,4.932203860832191,0.1671356596846928
218,0.1566,0,2,0,73151,532459,1104,106852,4.932185334766015,0.16713618254652274
219,0.1569,0,1,0,73152,532458,1104,106852,4.932176071732928,0.1671364439786645
220,0.157,0,6,0,73158,532452,1104,106852,4.932120493534403,0.1671380125886902
221,0.1574,0,74,0,73232,532378,1104,106852,4.9314350290859235,0.16715736120019398
222,0.1577,0,4,0,73236,532374,1104,106852,4.931397976953574,0.16715840719870592
223,0.1579,0,18,0,73254,532356,1104,106852,4.931231242357998,0.1671631143540131
224,0.1581,0,1,0,73255,532355,1104,106852,4.93122197932491,0.16716337587041444
225,0.1585,2,163,2,73418,532192,1106,106850,4.929712104931639,0.16720340760075236
226,0.1588,0,4,0,73422,532188,1106,106850,4.929675052799289,0.16720445419521218
227,0.1589,0,9,0,73431,532179,1106,106850,4.9295916855015,0.16720680908065205
228,0.159,0,1,0,73432,532178,1106,106850,4.929582422468413,0.16720707073868438
229,0.1592,2,74,2,73506,532104,1108,106848,4.928896958019934,0.16722382902002028
230,0.1593,0,1,0,73507,532103,1108,106848,4.928887694986846,0.16722409073622235
231,0.1594,1,19,1,73526,532084,1109,106847,4.928711697358183,0.16722776011807222
232,0.1596,0,7,0,73533,532077,1109,106847,4.92864685612657,0.16722959225197362
233,0.1597,0,3,0,73536,532074,1109,106847,4.928619067027308,0.16723037746450656
234,0.16,208,8921,208,82457,523153,1317,106639,4.845983548853236,0.16932415781718407
235,0.1631,0,1,0,82458,523152,1317,106639,4.845974285820149,0.16932442667488104
236,0.1635,0,1,0,82459,523151,1317,106639,4.845965022787062,0.16932469553343177
237,0.1639,0,2,0,82461,523149,1317,106639,4.845946496720886,0.1693252332530947
238,0.1648,0,2,0,82463,523147,1317,106639,4.845927970654711,0.16932577097617285
239,0.165,0,3,0,82466,523144,1317,106639,4.845900181555448,0.16932657756719377
240,0.1653,0,3,0,82469,523141,1317,106639,4.845872392456186,0.1693273841658992
241,0.1657,0,1,0,82470,523140,1317,106639,4.8458631294230985,0.16932765303384203
242,0.1658,0,11,0,82481,523129,1317,106639,4.845761236059135,0.16933061063756813
243,0.1659,0,7,0,82488,523122,1317,106639,4.845696394827522,0.1693324928028252
244,0.1664,0,1,0,82489,523121,1317,106639,4.845687131794435,0.16933276168699188
245,0.1665,0,30,0,82519,523091,1317,106639,4.845409240801808,0.16934082860908645
246,0.1666,0,5,0,82524,523086,1317,106639,4.84536292563637,0.16934217317082853
247,0.1669,0,2,0,82526,523084,1317,106639,4.8453443995701955,0.16934271100150383
248,0.167,1,4,1,82530,523080,1318,106638,4.845307347437845,0.1693424675807266
249,0.1671,0,3,0,82533,523077,1318,106638,4.845279558338582,0.16934327433839116
250,0.1673,0,1,0,82534,523076,1318,106638,4.845270295305495,0.1693435432593209
251,0.1674,1,73,1,82607,523003,1319,106637,4.8445940938901035,0.16936185756940475
252,0.1677,0,3,0,82610,523000,1319,106637,4.844566304790841,0.1693626645193977
253,0.1679,1,18,1,82628,522982,1320,106636,4.8443995701952645,0.16936618711663262
254,0.1681,0,2,0,82630,522980,1320,106636,4.84438104412909,0.16936672511499073
255,0.1683,0,2,0,82632,522978,1320,106636,4.844362518062915,0.16936726311676678
256,0.1684,0,3,0,82635,522975,1320,106636,4.844334728963652,0.1693680701258396
257,0.1685,5,199,5,82834,522776,1325,106631,4.842491385379229,0.1694150208052977
258,0.1686,0,1,0,82835,522775,1325,106631,4.842482122346141,0.1694152899718147
259,0.1688,0,3,0,82838,522772,1325,106631,4.842454333246878,0.16941609747649758
260,0.1689,0,19,0,82857,522753,1325,106631,4.842278335618214,0.16942121185158823
261,0.1692,3,69,3,82926,522684,1328,106628,4.841639186335174,0.16943582833316384
262,0.1693,0,1,0,82927,522683,1328,106628,4.841629923302086,0.16943609757337788
263,0.1694,2,38,2,82965,522645,1330,106626,4.841277928044759,0.1694436896027308
264,0.1696,0,5,0,82970,522640,1330,106626,4.841231612879321,0.16944503596253413
265,0.1697,0,1,0,82971,522639,1330,106626,4.841222349846234,0.16944530523706228
266,0.17,235,9326,235,92297,513313,1565,106391,4.754835303271704,0.1716803506190052
267,0.1718,0,2,0,92299,513311,1565,106391,4.754816777205528,0.1716809046929008
268,0.1735,0,2,0,92301,513309,1565,106391,4.754798251139353,0.17168145877037277
269,0.1743,0,2,0,92303,513307,1565,106391,4.754779725073178,0.17168201285142118
270,0.1748,0,1,0,92304,513306,1565,106391,4.75477046204009,0.17168228989328657
271,0.1749,0,2,0,92306,513304,1565,106391,4.754751935973915,0.17168284397969968
272,0.175,0,1,0,92307,513303,1565,106391,4.754742672940828,0.17168312102424746
273,0.1753,0,3,0,92310,513300,1565,106391,4.754714883841565,0.17168395216325555
274,0.1754,0,1,0,92311,513299,1565,106391,4.754705620808478,0.17168422921137988
275,0.1757,0,1,0,92312,513298,1565,106391,4.75469635777539,0.17168450626039836
276,0.1758,0,7,0,92319,513291,1565,106391,4.754631516543777,0.17168644562856433
277,0.1759,0,5,0,92324,513286,1565,106391,4.754585201378339,0.17168783091836554
278,0.176,0,1,0,92325,513285,1565,106391,4.754575938345252,0.17168810797900838
279,0.1762,0,1,0,92326,513284,1565,106391,4.754566675312164,0.17168838504054545
280,0.1765,1,29,1,92355,513255,1566,106390,4.754298047352625,0.17169508347521564
281,0.1766,0,3,0,92358,513252,1566,106390,4.754270258253363,0.17169591473786477
282,0.177,0,13,0,92371,513239,1566,106390,4.754149838823224,0.17169951696902502
283,0.1771,0,1,0,92372,513238,1566,106390,4.754140575790137,0.1716997940699904
284,0.1774,0,78,0,92450,513160,1566,106390,4.753418059209308,0.17172141070131547
285,0.1777,0,3,0,92453,513157,1566,106390,4.753390270110045,0.17172224221891155
286,0.1779,0,15,0,92468,513142,1566,106390,4.753251324613731,0.17172639992768735
287,0.1781,0,1,0,92469,513141,1566,106390,4.753242061580644,0.17172667711543085
288,0.1784,0,5,0,92474,513136,1566,106390,4.753195746415206,0.17172806306757102
289,0.1785,1,193,1,92667,512943,1567,106389,4.751407981029308,0.17178024064637384
290,0.1788,0,1,0,92668,512942,1567,106389,4.751398717996221,0.17178051801056302
291,0.1789,0,10,0,92678,512932,1567,106389,4.751306087665345,0.1717832917017185
292,0.1792,0,89,0,92767,512843,1567,106389,4.750481677720553,0.1718079814996641
293,0.1793,0,1,0,92768,512842,1567,106389,4.750472414687465,0.17180825895344387
294,0.1794,0,28,0,92796,512814,1567,106389,4.7502130497610136,0.17181602802312004
295,0.1796,0,14,0,92810,512800,1567,106389,4.750083367297788,0.1718199128214487
296,0.1797,0,5,0,92815,512795,1567,106389,4.75003705213235,0.17182130029199721
297,0.18,284,9501,284,102316,503294,1851,106105,4.662028974767498,0.17411416822147724
298,0.1837,0,1,0,102317,503293,1851,106105,4.66201971173441,0.17411445393650785
299,0.1839,0,2,0,102319,503291,1851,106105,4.6620011856682355,0.17411502536938214
300,0.1848,0,2,0,102321,503289,1851,106105,4.66198265960206,0.17411559680600727
301,0.185,1,1,1,102322,503288,1852,106104,4.661973396568973,0.17411452726652138
302,0.1853,0,4,0,102326,503284,1852,106104,4.661936344436622,0.1741156701477548
303,0.1856,0,1,0,102327,503283,1852,106104,4.661927081403535,0.17411595587040749
304,0.1858,0,8,0,102335,503275,1852,106104,4.661852977138834,0.17411824168538792
305,0.1859,2,7,2,102342,503268,1854,106102,4.661788135907221,0.17411753122076898
306,0.1862,0,1,0,102343,503267,1854,106102,4.661778872874134,0.17411781695491566
307,0.1864,0,1,0,102344,503266,1854,106102,4.661769609841047,0.17411810269000014
308,0.1865,1,24,1,102368,503242,1855,106101,4.661547297046945,0.1741236052600916
309,0.1866,0,4,0,102372,503238,1855,106101,4.661510244914595,0.17412474829282223
310,0.1868,0,1,0,102373,503237,1855,106101,4.661500981881507,0.1741250340533497
311,0.187,0,3,0,102376,503234,1855,106101,4.661473192782244,0.17412589134055978
312,0.1871,0,1,0,102377,503233,1855,106101,4.661463929749157,0.17412617710483905
313,0.1874,3,80,3,102457,503153,1858,106098,4.660722887102152,0.1741449747312684
314,0.1877,0,7,0,102464,503146,1858,106098,4.66065804587054,0.17414697559598452
315,0.1879,0,17,0,102481,503129,1858,106098,4.660500574308052,0.1741518350302925
316,0.1881,0,2,0,102483,503127,1858,106098,4.660482048241876,0.174152406746276
317,0.1884,0,1,0,102484,503126,1858,106098,4.660472785208789,0.17415269260567542
318,0.1885,4,182,4,102666,502944,1862,106094,4.658786913186854,0.17419931104463104
319,0.1886,1,0,1,102666,502944,1863,106093,4.658786913186854,0.1741979551324468
320,0.1888,0,2,0,102668,502942,1863,106093,4.658768387120679,0.174198527178241
321,0.1889,0,16,0,102684,502926,1863,106093,4.658620178591278,0.17420310367985234
322,0.189,0,2,0,102686,502924,1863,106093,4.658601652525102,0.17420367575946155
323,0.1892,2,82,2,102768,502842,1865,106091,4.657842083811923,0.1742244220628542
324,0.1893,0,1,0,102769,502841,1865,106091,4.657832820778836,0.1742247081775962
325,0.1894,1,28,1,102797,502813,1866,106090,4.6575734558523845,0.17423136361620817
326,0.1896,0,7,0,102804,502806,1866,106090,4.657508614620771,0.17423336661761615
327,0.1897,0,1,0,102805,502805,1866,106090,4.657499351587684,0.17423365276443392
328,0.19,287,9842,287,112647,492963,2153,105803,4.566332579939975,0.1767017499323609
329,0.1931,0,1,0,112648,492962,2153,105803,4.566323316906888,0.17670204504271292
330,0.1932,0,1,0,112649,492961,2153,105803,4.566314053873801,0.17670234015405067
331,0.1937,0,1,0,112650,492960,2153,105803,4.566304790840713,0.17670263526637417
332,0.1947,0,3,0,112653,492957,2153,105803,4.56627700174145,0.17670352060925915
333,0.1948,0,1,0,112654,492956,2153,105803,4.566267738708363,0.17670381572552563
334,0.195,1,3,1,112657,492953,2154,105802,4.5662399496091,0.1767033260682583
335,0.1953,0,2,0,112659,492951,2154,105802,4.566221423542925,0.17670391630605609
336,0.1957,0,2,0,112661,492949,2154,105802,4.5662028974767495,0.17670450654779699
337,0.1958,1,6,1,112667,492943,2155,105801,4.566147319278224,0.17670490226206859
338,0.1959,0,9,0,112676,492934,2155,105801,4.5660639519804365,0.17670755843570193
339,0.1961,0,1,0,112677,492933,2155,105801,4.566054688947349,0.17670785357103488
340,0.1962,0,2,0,112679,492931,2155,105801,4.566036162881174,0.1767084438446584
341,0.1965,0,41,0,112720,492890,2155,105801,4.565656378524584,0.17672054532304646
342,0.1966,0,3,0,112723,492887,2155,105801,4.565628589425321,0.17672143086215192
343,0.1968,0,1,0,112724,492886,2155,105801,4.565619326392234,0.1767217260438259
344,0.197,0,7,0,112731,492879,2155,105801,4.565554485160621,0.17672379234315494
345,0.1971,0,3,0,112734,492876,2155,105801,4.565526696061358,0.17672467791480215
346,0.1974,1,98,1,112832,492778,2156,105800,4.564618918818778,0.17675223613296848
347,0.1977,0,9,0,112841,492769,2156,105800,4.56453555152099,0.17675489375493886
348,0.1979,2,17,2,112858,492752,2158,105798,4.564378079958502,0.17675716314426532
349,0.1981,0,3,0,112861,492749,2158,105798,4.564350290859239,0.1767580490755112
350,0.1984,0,1,0,112862,492748,2158,105798,4.564341027826152,0.1767583443879
351,0.1985,11,230,11,113092,492518,2169,105787,4.562210530216014,0.1768111581885493
352,0.1988,0,4,0,113096,492514,2169,105787,4.562173478083664,0.17681234027688406
353,0.1989,1,14,1,113110,492500,2170,105786,4.562043795620438,0.17681510180749674
354,0.1992,5,85,5,113195,492415,2175,105781,4.561256437807996,0.17683334559241454
355,0.1993,0,1,0,113196,492414,2175,105781,4.561247174774908,0.17683364120395523
356,0.1994,1,38,1,113234,492376,2176,105780,4.560895179517582,0.17684349902032245
357,0.1996,1,12,1,113246,492364,2177,105779,4.56078402312053,0.17684567068410062
358,0.1997,0,7,0,113253,492357,2177,105779,4.560719181888918,0.1768477403132398
359,0.2,334,9902,334,123155,482455,2511,105445,4.468996628255956,0.17935873447865283
360,0.2022,0,1,0,123156,482454,2511,105445,4.468987365222868,0.17935903956291813
361,0.2024,0,1,0,123157,482453,2511,105445,4.468978102189781,0.17935934464822129
362,0.2027,0,1,0,123158,482452,2511,105445,4.468968839156694,0.17935964973456234
363,0.2032,1,0,1,123158,482452,2512,105444,4.468968839156694,0.17935825384081538
364,0.2038,0,1,0,123159,482451,2512,105444,4.468959576123606,0.1793585589263389
365,0.2039,0,3,0,123162,482448,2512,105444,4.468931787024343,0.17935947418913678
366,0.2042,0,1,0,123163,482447,2512,105444,4.468922523991256,0.1793597792788119
367,0.2043,0,1,0,123164,482446,2512,105444,4.4689132609581685,0.1793600843695249
368,0.2044,0,1,0,123165,482445,2512,105444,4.46890399792508,0.17936038946127586
369,0.205,0,1,0,123166,482444,2512,105444,4.468894734891993,0.17936069455406473
370,0.2053,0,3,0,123169,482441,2512,105444,4.468866945792731,0.17936160983865893
371,0.2054,0,1,0,123170,482440,2512,105444,4.4688576827596425,0.17936191493559955
372,0.2057,0,1,0,123171,482439,2512,105444,4.468848419726555,0.1793622200335781
373,0.2058,0,8,0,123179,482431,2512,105444,4.468774315461855,0.17936466085477354
374,0.2059,0,6,0,123185,482425,2512,105444,4.4687187372633295,0.17936649151426592
375,0.206,0,1,0,123186,482424,2512,105444,4.468709474230242,0.1793667966278144
376,0.2061,0,1,0,123187,482423,2512,105444,4.468700211197154,0.17936710174240092
377,0.2062,0,1,0,123188,482422,2512,105444,4.468690948164067,0.17936740685802546
378,0.2063,0,1,0,123189,482421,2512,105444,4.46868168513098,0.17936771197468807
379,0.2065,2,41,2,123230,482380,2514,105442,4.46830190077439,0.17937743058272743
380,0.2066,0,2,0,123232,482378,2514,105442,4.468283374708214,0.1793780408968732
381,0.2069,0,4,0,123236,482374,2514,105442,4.468246322575864,0.179379261537624
382,0.207,0,6,0,123242,482368,2514,105442,4.468190744377339,0.17938109252989912
383,0.2071,0,1,0,123243,482367,2514,105442,4.468181481344251,0.1793813976989124
384,0.2073,0,1,0,123244,482366,2514,105442,4.468172218311164,0.17938170286896402
385,0.2074,1,109,1,123353,482257,2515,105441,4.46716254770462,0.1794135763606478
386,0.2077,0,4,0,123357,482253,2515,105441,4.467125495572271,0.17941479749665643
387,0.2079,1,15,1,123372,482238,2516,105440,4.466986550075957,0.17941798059481553
388,0.208,0,1,0,123373,482237,2516,105440,4.4669772870428694,0.17941828589514308
389,0.2081,0,4,0,123377,482233,2516,105440,4.466940234910519,0.17941950710684343
390,0.2084,0,4,0,123381,482229,2516,105440,4.466903182778169,0.17942072833516826
391,0.2085,2,231,2,123612,481998,2518,105438,4.4647634221349435,0.1794884889587972
392,0.2088,0,1,0,123613,481997,2518,105438,4.464754159101856,0.17948879450492394
393,0.2089,0,16,0,123629,481981,2518,105438,4.464605950572455,0.17949368338443258
394,0.2092,2,106,2,123735,481875,2520,105436,4.463624069065174,0.17952328493762248
395,0.2093,0,1,0,123736,481874,2520,105436,4.463614806032087,0.17952359060802642
396,0.2094,1,36,1,123772,481838,2521,105435,4.463281336840935,0.17953319835919582
397,0.2095,0,1,0,123773,481837,2521,105435,4.463272073807848,0.1795335040662589
398,0.2096,0,14,0,123787,481823,2521,105435,4.463142391344622,0.1795377840744613
399,0.21,337,10289,337,134076,471534,2858,105098,4.367835043906777,0.18226182383218414
400,0.2113,0,1,0,134077,471533,2858,105098,4.367825780873689,0.1822621399126998
401,0.2126,0,1,0,134078,471532,2858,105098,4.367816517840602,0.1822624559943118
402,0.2137,0,1,0,134079,471531,2858,105098,4.367807254807514,0.18226277207702005
403,0.2139,0,2,0,134081,471529,2858,105098,4.367788728741339,0.18226340424572557
404,0.2141,0,1,0,134082,471528,2858,105098,4.367779465708251,0.1822637203317228
405,0.2143,0,2,0,134084,471526,2858,105098,4.367760939642077,0.1822643525070063
406,0.2144,0,1,0,134085,471525,2858,105098,4.3677516766089886,0.18226466859629256
407,0.2147,0,4,0,134089,471521,2858,105098,4.367714624476639,0.1822659329644011
408,0.2148,0,2,0,134091,471519,2858,105098,4.367696098410463,0.1822665651550336
409,0.215,0,3,0,134094,471516,2858,105098,4.367668309311201,0.1822675134492052
410,0.2153,0,6,0,134100,471510,2858,105098,4.367612731112676,0.18226941006715133
411,0.2154,0,1,0,134101,471509,2858,105098,4.367603468079588,0.18226972617397985
412,0.2157,0,3,0,134104,471506,2858,105098,4.367575678980326,0.18227067450104403
413,0.2158,0,11,0,134115,471495,2858,105098,4.367473785616363,0.18227415178470777
414,0.2159,0,9,0,134124,471486,2858,105098,4.367390418318574,0.18227699693366448
415,0.216,0,2,0,134126,471484,2858,105098,4.367371892252399,0.18227762920105034
416,0.2164,0,1,0,134127,471483,2858,105098,4.367362629219311,0.1822779453363881
417,0.2165,0,41,0,134168,471442,2858,105098,4.366982844862722,0.18229090782946544
418,0.2166,0,7,0,134175,471435,2858,105098,4.366918003631109,0.18229312112229482
419,0.2168,0,1,0,134176,471434,2858,105098,4.366908740598022,0.18229343731137213
420,0.2169,0,3,0,134179,471431,2858,105098,4.366880951498759,0.18229438588518532
421,0.217,0,9,0,134188,471422,2858,105098,4.366797584200971,0.1822972316658572
422,0.2174,5,104,5,134292,471318,2863,105093,4.365834228759865,0.1823230299213582
423,0.2177,0,12,0,134304,471306,2863,105093,4.365723072362814,0.1823268256884554
424,0.2179,0,25,0,134329,471281,2863,105093,4.3654914965356255,0.18233473404421435
425,0.2181,0,3,0,134332,471278,2863,105093,4.365463707436363,0.1823356830930078
426,0.2184,0,4,0,134336,471274,2863,105093,4.365426655304013,0.18233694850676738
427,0.2185,8,221,8,134557,471053,2871,105085,4.363379524991664,0.18239553718032833
428,0.2186,0,2,0,134559,471051,2871,105085,4.363360998925488,0.18239617034866767
429,0.2188,0,2,0,134561,471049,2871,105085,4.363342472859313,0.182396803521403
430,0.2189,0,24,0,134585,471025,2871,105085,4.363120160065212,0.18240440193713006
431,0.219,0,1,0,134586,471024,2871,105085,4.363110897032124,0.1824047185515241
432,0.2192,2,100,2,134686,470924,2873,105083,4.362184593723369,0.18243354681453525
433,0.2193,0,1,0,134687,470923,2873,105083,4.362175330690281,0.18243386353614371
434,0.2194,0,30,0,134717,470893,2873,105083,4.361897439697654,0.1824433656957929
435,0.2196,1,8,1,134725,470885,2874,105082,4.3618233354329545,0.18244448032612978
436,0.2197,0,1,0,134726,470884,2874,105082,4.361814072399866,0.18244479708871705
437,0.22,394,10510,394,145236,460374,3268,104688,4.264459594649672,0.18526816526328085
438,0.2207,0,1,0,145237,460373,3268,104688,4.264450331616585,0.18526849313613927
439,0.2209,0,1,0,145238,460372,3268,104688,4.264441068583497,0.1852688210101582
440,0.223,0,1,0,145239,460371,3268,104688,4.26443180555041,0.18526914888533763
441,0.2232,0,2,0,145241,460369,3268,104688,4.264413279484234,0.185269804639178
442,0.2236,0,1,0,145242,460368,3268,104688,4.264404016451147,0.18527013251783894
443,0.2239,0,1,0,145243,460367,3268,104688,4.264394753418059,0.1852704603976604
444,0.2241,0,2,0,145245,460365,3268,104688,4.264376227351884,0.18527111616078493
445,0.2242,0,2,0,145247,460363,3268,104688,4.264357701285709,0.18527177192855157
446,0.2243,0,4,0,145251,460359,3268,104688,4.264320649153359,0.18527308347801155
447,0.2244,0,2,0,145253,460357,3268,104688,4.264302123087184,0.18527373925970497
448,0.2248,0,2,0,145255,460355,3268,104688,4.2642835970210085,0.18527439504604074
449,0.225,0,2,0,145257,460353,3268,104688,4.264265070954833,0.1852750508370189
450,0.2253,0,4,0,145261,460349,3268,104688,4.264228018822483,0.18527636243290263
451,0.2255,0,2,0,145263,460347,3268,104688,4.264209492756308,0.1852770182378083
452,0.2257,1,1,1,145264,460346,3269,104687,4.264200229723221,0.18527590423922144
453,0.2258,0,8,0,145272,460338,3269,104687,4.26412612545852,0.18527852749878324
454,0.2259,1,11,1,145283,460327,3270,104686,4.264024232094557,0.18528069265662914
455,0.2262,0,1,0,145284,460326,3270,104686,4.26401496906147,0.18528102058009388
456,0.2263,0,2,0,145286,460324,3270,104686,4.263996442995294,0.18528167643050567
457,0.2264,0,4,0,145290,460320,3270,104686,4.2639593908629445,0.18528298814525865
458,0.2265,2,44,2,145334,460276,3272,104684,4.263551817407092,0.18529453412630983
459,0.2266,0,1,0,145335,460275,3272,104684,4.263542554374005,0.1852948621050377
460,0.2268,0,1,0,145336,460274,3272,104684,4.2635332913409165,0.18529519008492668
461,0.2269,0,1,0,145337,460273,3272,104684,4.263524028307829,0.18529551806597672
462,0.227,0,7,0,145344,460266,3272,104684,4.263459187076216,0.1852978139658377
463,0.2274,2,107,2,145451,460159,3274,104682,4.262468042535848,0.18533003092905792
464,0.2277,3,15,3,145466,460144,3277,104679,4.262329097039535,0.18533062570044068
465,0.2279,0,23,0,145489,460121,3277,104679,4.2621160472785204,0.18533817280453257
466,0.2281,0,2,0,145491,460119,3277,104679,4.262097521212346,0.1853388291035025
467,0.2284,0,4,0,145495,460115,3277,104679,4.262060469079995,0.18534014171538649
468,0.2285,7,235,7,145730,459880,3284,104672,4.25988365630442,0.185407190125976
469,0.2288,0,8,0,145738,459872,3284,104672,4.2598095520397194,0.18540981748101124
470,0.2289,0,18,0,145756,459854,3284,104672,4.259642817444144,0.1854157293021048
471,0.229,0,2,0,145758,459852,3284,104672,4.2596242913779685,0.18541638619438677
472,0.2292,3,108,3,145866,459744,3287,104669,4.258623883804513,0.18544753575838968
473,0.2294,2,46,2,145912,459698,3289,104667,4.258197784282485,0.18545976451409993
474,0.2295,0,1,0,145913,459697,3289,104667,4.258188521249398,0.18546009313138329
475,0.2296,0,16,0,145929,459681,3289,104667,4.258040312719997,0.18546535116630164
476,0.2297,0,5,0,145934,459676,3289,104667,4.257993997554559,0.18546699436335704
477,0.23,425,10445,425,156379,449231,3714,104242,4.1612416169550555,0.18834161738693667
478,0.2321,0,1,0,156380,449230,3714,104242,4.161232353921968,0.18834195767807585
479,0.2335,0,1,0,156381,449229,3714,104242,4.161223090888881,0.18834229797044472
480,0.2338,0,1,0,156382,449228,3714,104242,4.161213827855793,0.1883426382640432
481,0.2344,1,1,1,156383,449227,3715,104241,4.161204564822706,0.1883415120657382
482,0.2345,1,1,1,156384,449226,3716,104240,4.161195301789618,0.18834038585929397
483,0.2348,1,0,1,156384,449226,3717,104239,4.161195301789618,0.1883389193535273
484,0.235,0,4,0,156388,449222,3717,104239,4.161158249657268,0.18834028052563775
485,0.2353,0,4,0,156392,449218,3717,104239,4.161121197524918,0.1883416417174234
486,0.2354,0,2,0,156394,449216,3717,104239,4.1611026714587425,0.18834232232069453
487,0.2357,0,1,0,156395,449215,3717,104239,4.161093408425655,0.18834266262417473
488,0.2358,0,3,0,156398,449212,3717,104239,4.161065619326393,0.18834368354199377
489,0.2359,0,6,0,156404,449206,3717,104239,4.1610100411278665,0.18834572541083577
490,0.2362,0,2,0,156406,449204,3717,104239,4.160991515061692,0.18834640604362146
491,0.2364,0,2,0,156408,449202,3717,104239,4.160972988995517,0.18834708668132646
492,0.2365,1,49,1,156457,449153,3718,104238,4.160519100374226,0.18836229718228162
493,0.2366,0,8,0,156465,449145,3718,104238,4.1604449961095264,0.18836502024818255
494,0.2368,0,1,0,156466,449144,3718,104238,4.160435733076438,0.18836536063695603
495,0.2369,0,3,0,156469,449141,3718,104238,4.160407943977176,0.1883663818106578
496,0.237,0,9,0,156478,449132,3718,104238,4.160324576679388,0.1883694453981965
497,0.2371,0,1,0,156479,449131,3718,104238,4.160315313646301,0.1883697858029633
498,0.2373,0,3,0,156482,449128,3718,104238,4.160287524547038,0.18837080702464554
499,0.2374,3,108,3,156590,449020,3721,104235,4.159287116973582,0.1884031775582688
500,0.2377,0,7,0,156597,449013,3721,104235,4.159222275741969,0.18840556133958009
501,0.2379,3,14,3,156611,448999,3724,104232,4.159092593278743,0.1884059280842903
502,0.2381,0,3,0,156614,448996,3724,104232,4.15906480417948,0.18840694975670066
503,0.2384,0,1,0,156615,448995,3724,104232,4.159055541146393,0.18840729031663314
504,0.2385,6,233,6,156848,448762,3730,104226,4.156897254436993,0.18847786932085325
505,0.2386,0,1,0,156849,448761,3730,104226,4.156887991403905,0.18847821015683913
506,0.2388,0,5,0,156854,448756,3730,104226,4.156841676238468,0.1884799143552593
507,0.2389,0,24,0,156878,448732,3730,104226,4.156619363444366,0.18848809493668597
508,0.239,0,2,0,156880,448730,3730,104226,4.156600837378191,0.1884887766838591
509,0.2392,5,113,5,156993,448617,3735,104221,4.155554114639298,0.18851996425716033
510,0.2393,0,1,0,156994,448616,3735,104221,4.15554485160621,0.18852030526176794
511,0.2394,1,49,1,157043,448567,3736,104220,4.15509096298492,0.18853554805015313
512,0.2395,0,1,0,157044,448566,3736,104220,4.1550816999518325,0.18853588911441319
513,0.2396,0,10,0,157054,448556,3736,104220,4.154989069620957,0.18853929982488385
514,0.2397,0,3,0,157057,448553,3736,104220,4.154961280521694,0.1885403230620888
515,0.24,460,10793,460,167850,437760,4196,103760,4.054985364407722,0.19160880484561973
516,0.2417,0,2,0,167852,437758,4196,103760,4.054966838341547,0.19160951251851277
517,0.2418,0,1,0,167853,437757,4196,103760,4.054957575308459,0.19160986635691954
518,0.2424,0,2,0,167855,437755,4196,103760,4.054939049242284,0.1916105740376536
519,0.2432,0,1,0,167856,437754,4196,103760,4.054929786209196,0.19161092787998094
520,0.2439,0,2,0,167858,437752,4196,103760,4.0549112601430215,0.1916116355685562
521,0.2442,0,1,0,167859,437751,4196,103760,4.054901997109933,0.19161198941480412
522,0.2443,0,4,0,167863,437747,4196,103760,4.0548649449775835,0.19161340481286485
523,0.2447,0,4,0,167867,437743,4196,103760,4.054827892845233,0.1916148202318362
524,0.2448,0,3,0,167870,437740,4196,103760,4.05480010374597,0.1916158818097876
525,0.245,1,0,1,167870,437740,4197,103759,4.05480010374597,0.19161438894623997
526,0.2453,0,3,0,167873,437737,4197,103759,4.054772314646708,0.1916154505296438
527,0.2455,0,1,0,167874,437736,4197,103759,4.05476305161362,0.19161580439339237
528,0.2457,0,3,0,167877,437733,4197,103759,4.054735262514358,0.19161686599248004
529,0.2458,0,10,0,167887,437723,4197,103759,4.054642632183482,0.19162040474106248
530,0.2459,1,10,1,167897,437713,4198,103758,4.054550001852607,0.19162245069449702
531,0.2464,1,0,1,167897,437713,4199,103757,4.054550001852607,0.1916209577631263
532,0.2465,1,44,1,167941,437669,4200,103756,4.054142428396754,0.19163503717042987
533,0.2466,0,2,0,167943,437667,4200,103756,4.054123902330579,0.19163574506439512
534,0.2468,0,2,0,167945,437665,4200,103756,4.054105376264404,0.19163645296359025
535,0.2469,0,1,0,167946,437664,4200,103756,4.054096113231316,0.19163680691514906
536,0.247,0,8,0,167954,437656,4200,103756,4.054022008966616,0.19163963857468988
537,0.2474,4,105,4,168059,437551,4204,103752,4.053049390492423,0.19167083869847387
538,0.2477,0,16,0,168075,437535,4204,103752,4.052901181963022,0.19167650433134364
539,0.2478,0,2,0,168077,437533,4204,103752,4.0528826558968465,0.1916772125590031
540,0.2479,2,23,2,168100,437510,4206,103750,4.052669606135833,0.19168237076451244
541,0.2481,0,7,0,168107,437503,4206,103750,4.0526047649042205,0.19168484978374253
542,0.2484,0,1,0,168108,437502,4206,103750,4.052595501871132,0.1916852039345813
543,0.2485,17,251,17,168359,437251,4223,103733,4.050270480566157,0.19174873933425018
544,0.2486,0,1,0,168360,437250,4223,103733,4.050261217533069,0.19174909377928698
545,0.2488,0,5,0,168365,437245,4223,103733,4.050214902367631,0.19175086602412666
546,0.2489,1,23,1,168388,437222,4224,103732,4.050001852606617,0.1917575246693804
547,0.249,0,3,0,168391,437219,4224,103732,4.049974063507355,0.19175858811611404
548,0.2492,0,126,0,168517,437093,4224,103732,4.048806921338323,0.191803263532566
549,0.2493,0,1,0,168518,437092,4224,103732,4.048797658305236,0.19180361818262504
550,0.2494,1,37,1,168555,437055,4225,103731,4.048454926080996,0.19181524669647512
551,0.2496,0,17,0,168572,437038,4225,103731,4.048297454518508,0.19182127673738694
552,0.2497,0,4,0,168576,437034,4225,103731,4.048260402386157,0.19182269562564144
553,0.25,466,10860,466,179436,426174,4691,103265,3.9476638630553187,0.19504607707403496
554,0.2504,0,1,0,179437,426173,4691,103265,3.9476546000222315,0.1950464454761464
555,0.2522,0,1,0,179438,426172,4691,103265,3.9476453369891438,0.1950468138796495
556,0.2531,0,1,0,179439,426171,4691,103265,3.947636073956056,0.19504718228454432
557,0.2535,0,1,0,179440,426170,4691,103265,3.9476268109229684,0.1950475506908308
558,0.2539,0,1,0,179441,426169,4691,103265,3.947617547889881,0.19504791909850897
559,0.2543,1,1,1,179442,426168,4692,103264,3.9476082848567935,0.19504676710134636
560,0.2546,0,1,0,179443,426167,4692,103264,3.947599021823706,0.19504713550963204
561,0.2547,0,3,0,179446,426164,4692,103264,3.947571232724443,0.19504824074283944
562,0.2548,0,2,0,179448,426162,4692,103264,3.9475527066582683,0.1950489775719364
563,0.2549,0,3,0,179451,426159,4692,103264,3.9475249175590057,0.19505008282602002
564,0.255,0,9,0,179460,426150,4692,103264,3.9474415502612175,0.19505339866342786
565,0.2553,0,5,0,179465,426145,4692,103264,3.94739523509578,0.19505524084403553
566,0.2554,0,2,0,179467,426143,4692,103264,3.9473767090296046,0.19505597772602176
567,0.2555,0,1,0,179468,426142,4692,103264,3.947367445996517,0.19505634616910272
568,0.2557,0,2,0,179470,426140,4692,103264,3.947348919930342,0.19505708305944042
569,0.2558,1,12,1,179482,426128,4693,103263,3.947237763533291,0.19505998401937322
570,0.2559,0,7,0,179489,426121,4693,103263,3.9471729223016783,0.19506256328109653
571,0.256,0,2,0,179491,426119,4693,103263,3.9471543962355033,0.19506330022554602
572,0.2563,0,1,0,179492,426118,4693,103263,3.9471451332024157,0.1950636686998589
573,0.2564,0,3,0,179495,426115,4693,103263,3.947117344103153,0.19506477413115014
574,0.2565,3,55,3,179550,426060,4696,103260,3.9466078772833377,0.1950804806166402
575,0.2566,0,3,0,179553,426057,4696,103260,3.946580088184075,0.1950815862706091
576,0.2568,0,1,0,179554,426056,4696,103260,3.9465708251509874,0.19508195482471719
577,0.2569,0,4,0,179558,426052,4696,103260,3.946533773018637,0.19508342905507528
578,0.257,2,12,2,179570,426040,4698,103258,3.9464226166215868,0.19508481044704495
579,0.2571,0,1,0,179571,426039,4698,103258,3.946413353588499,0.19508517902047431
580,0.2573,0,2,0,179573,426037,4698,103258,3.9463948275223237,0.19508591617151116
581,0.2574,4,119,4,179692,425918,4702,103254,3.945292526584905,0.1951237026902406
582,0.2577,0,9,0,179701,425909,4702,103254,3.945209159287117,0.1951270213525889
583,0.2579,0,18,0,179719,425891,4702,103254,3.945042424691541,0.19513365901595972
584,0.258,0,1,0,179720,425890,4702,103254,3.9450331616584533,0.1951340277882769
585,0.2581,1,6,1,179726,425884,4703,103253,3.944977583459928,0.19513471936379426
586,0.2582,0,2,0,179728,425882,4703,103253,3.944959057393753,0.19513545692498133
587,0.2584,0,4,0,179732,425878,4703,103253,3.944922005261403,0.19513693206408242
588,0.2585,12,295,12,180027,425583,4715,103241,3.9421894105005744,0.19522752371299337
589,0.2586,0,2,0,180029,425581,4715,103241,3.942170884434399,0.19522826206171454
590,0.2588,0,6,0,180035,425575,4715,103241,3.942115306235874,0.19523047714138755
591,0.2589,2,26,2,180061,425549,4717,103239,3.9418744673755977,0.19523703261042233
592,0.2591,0,1,0,180062,425548,4717,103239,3.94186520434251,0.19523740182720076
593,0.2592,1,114,1,180176,425434,4718,103238,3.9408092185705286,0.19527797954119
594,0.2593,0,1,0,180177,425433,4718,103238,3.9407999555374413,0.19527834891643386
595,0.2594,4,52,4,180229,425381,4722,103234,3.940318277816888,0.19529146921672674
596,0.2596,1,8,1,180237,425373,4723,103233,3.940244173552188,0.1952929024642172
597,0.2597,0,6,0,180243,425367,4723,103233,3.9401885953536624,0.1952951191827469
598,0.26,583,11061,583,191304,414306,5306,102650,3.8377301863722257,0.1985662222703673
599,0.2611,0,2,0,191306,414304,5306,102650,3.837711660306051,0.19856699048658102
600,0.2615,0,1,0,191307,414303,5306,102650,3.837702397272963,0.19856737459691692
601,0.2621,0,1,0,191308,414302,5306,102650,3.8376931342398755,0.1985677587087389
602,0.2624,0,1,0,191309,414301,5306,102650,3.8376838712067878,0.19856814282204696
603,0.2629,0,1,0,191310,414300,5306,102650,3.8376746081737005,0.1985685269368411
604,0.2632,0,1,0,191311,414299,5306,102650,3.837665345140613,0.1985689110531213
605,0.2634,0,2,0,191313,414297,5306,102650,3.837646819074438,0.19856967929014
606,0.2635,0,2,0,191315,414295,5306,102650,3.8376282930082626,0.19857044753310313
607,0.2637,0,2,0,191317,414293,5306,102650,3.8376097669420877,0.19857121578201078
608,0.2639,0,1,0,191318,414292,5306,102650,3.837600503909,0.19857159990869383
609,0.2642,0,1,0,191319,414291,5306,102650,3.8375912408759123,0.19857198403686302
610,0.2643,0,2,0,191321,414289,5306,102650,3.8375727148097374,0.1985727522976599
611,0.265,0,5,0,191326,414284,5306,102650,3.8375263996442994,0.19857467297566034
612,0.2651,0,1,0,191327,414283,5306,102650,3.837517136611212,0.19857505711571904
613,0.2653,0,3,0,191330,414280,5306,102650,3.837489347511949,0.19857620954481264
614,0.2655,0,1,0,191331,414279,5306,102650,3.837480084478862,0.19857659369081634
615,0.2658,1,13,1,191344,414266,5307,102649,3.8373596650487234,0.19858003733689292
616,0.2659,0,11,0,191355,414255,5307,102649,3.8372577716847607,0.19858426322876202
617,0.2663,0,1,0,191356,414254,5307,102649,3.837248508651673,0.19858464740966875
618,0.2664,0,3,0,191359,414251,5307,102649,3.8372207195524104,0.1985857999613078
619,0.2665,0,52,0,191411,414199,5307,102649,3.836739041831857,0.19860577964894902
620,0.2666,0,6,0,191417,414193,5307,102649,3.836683463633332,0.19860808525622917
621,0.2667,0,1,0,191418,414192,5307,102649,3.8366742006002443,0.19860846952931366
622,0.2668,0,1,0,191419,414191,5307,102649,3.836664937567157,0.19860885380388515
623,0.2669,0,2,0,191421,414189,5307,102649,3.8366464115009817,0.1986096223574892
624,0.267,0,8,0,191429,414181,5307,102649,3.8365723072362816,0.1986126966313875
625,0.2671,0,1,0,191430,414180,5307,102649,3.836563044203194,0.19861308092231666
626,0.2673,0,1,0,191431,414179,5307,102649,3.8365537811701063,0.19861346521473294
627,0.2674,5,127,5,191558,414052,5312,102644,3.835377375967987,0.1986545280009909
628,0.2677,0,13,0,191571,414039,5312,102644,3.8352569565378487,0.19865952624723476
629,0.2679,1,22,1,191593,414017,5313,102643,3.8350531698099224,0.19866643440560525
630,0.2681,0,6,0,191599,414011,5313,102643,3.834997591611397,0.19866874155624462
631,0.2684,0,2,0,191601,414009,5313,102643,3.8349790655452223,0.19866951061836594
632,0.2685,5,284,5,191885,413725,5318,102638,3.832348364148357,0.19877101961217206
633,0.2686,0,3,0,191888,413722,5318,102638,3.8323205750490943,0.19877217445193276
634,0.2688,0,1,0,191889,413721,5318,102638,3.8323113120160066,0.19877255940150168
635,0.2689,0,26,0,191915,413695,5318,102638,3.83207047315573,0.198782568613666
636,0.269,0,1,0,191916,413694,5318,102638,3.8320612101226423,0.19878295360349543
637,0.2692,9,131,9,192047,413563,5327,102629,3.830847752788173,0.1988194315293534
638,0.2694,3,40,3,192087,413523,5330,102626,3.8304772314646707,0.19883018275730457
639,0.2696,0,18,0,192105,413505,5330,102626,3.8303104968690946,0.19883711693349168
640,0.2697,0,4,0,192109,413501,5330,102626,3.830273444736745,0.19883865792721558
641,0.27,580,11203,580,203312,402298,5910,102046,3.7264996850568752,0.20233412115540186
642,0.273,1,0,1,203312,402298,5911,102045,3.7264996850568752,0.20233253956136993
643,0.2739,0,1,0,203313,402297,5911,102045,3.7264904220237876,0.20233294074259134
644,0.2742,0,1,0,203314,402296,5911,102045,3.7264811589907,0.20233334192540364
645,0.2743,0,1,0,203315,402295,5911,102045,3.726471895957612,0.20233374310980687
646,0.2747,0,3,0,203318,402292,5911,102045,3.7264441068583496,0.2023349466725622
647,0.275,0,5,0,203323,402287,5911,102045,3.726397791692912,0.20233695264230706
648,0.2753,0,3,0,203326,402284,5911,102045,3.7263700025936495,0.20233815624324597
649,0.2755,0,2,0,203328,402282,5911,102045,3.726351476527474,0.20233895865182708
650,0.2757,0,1,0,203329,402281,5911,102045,3.7263422134943864,0.2023393598585042
651,0.2758,1,12,1,203341,402269,5912,102044,3.726231057097336,0.2023425927945542
652,0.2759,0,21,0,203362,402248,5912,102044,3.7260365334024974,0.20235101885415593
653,0.2762,0,2,0,203364,402246,5912,102044,3.726018007336322,0.2023518213726229
654,0.2763,0,3,0,203367,402243,5912,102044,3.7259902182370594,0.20235302516225878
655,0.2764,1,4,1,203371,402239,5913,102043,3.725953166104709,0.20235304849270844
656,0.2765,1,49,1,203420,402190,5914,102042,3.725499277483419,0.2023711307493376
657,0.2766,0,3,0,203423,402187,5914,102042,3.7254714883841564,0.2023723347923265
658,0.2769,0,4,0,203427,402183,5914,102042,3.725434436251806,0.2023739402052655
659,0.277,0,17,0,203444,402166,5914,102042,3.725276964689318,0.20238076349443088
660,0.2771,0,2,0,203446,402164,5914,102042,3.725258438623143,0.20238156626458234
661,0.2774,6,140,6,203586,402024,5920,102036,3.7239616139908853,0.2024282823473396
662,0.2775,0,2,0,203588,402022,5920,102036,3.72394308792471,0.20242908554174321
663,0.2777,1,10,1,203598,402012,5921,102035,3.7238504575938345,0.20243151928292402
664,0.2779,2,23,2,203621,401989,5923,102033,3.723637407832821,0.20243759200987257
665,0.2781,0,8,0,203629,401981,5923,102033,3.7235633035681204,0.20244080521572813
666,0.2784,0,3,0,203632,401978,5923,102033,3.7235355144688578,0.20244201019422195
667,0.2785,16,286,16,203918,401692,5939,102017,3.720886287005817,0.2025316204395792
668,0.2786,0,2,0,203920,401690,5939,102017,3.720867760939642,0.20253242460398604
669,0.2788,0,2,0,203922,401688,5939,102017,3.7208492348734667,0.2025332287747789
670,0.2789,1,20,1,203942,401668,5940,102016,3.720663974211716,0.20253968758189658
671,0.279,0,1,0,203943,401667,5940,102016,3.720654711178628,0.20254008969927514
672,0.2791,0,1,0,203944,401666,5940,102016,3.720645448145541,0.2025404918182504
673,0.2792,0,113,0,204057,401553,5940,102016,3.719598725406647,0.20258594154922166
674,0.2793,0,1,0,204058,401552,5940,102016,3.7195894623735595,0.20258634385028437
675,0.2794,0,36,0,204094,401516,5940,102016,3.719255993182408,0.20260082775275454
676,0.2796,0,8,0,204102,401508,5940,102016,3.7191818889177073,0.20260404667900636
677,0.2797,0,9,0,204111,401499,5940,102016,3.719098521619919,0.20260766809330408
678,0.28,613,11139,613,215250,390360,6553,101403,3.615917596057653,0.20620298802471923
679,0.2815,0,1,0,215251,390359,6553,101403,3.6159083330245654,0.2062034073393227
680,0.2822,0,1,0,215252,390358,6553,101403,3.615899069991478,0.2062038266556315
681,0.2824,0,1,0,215253,390357,6553,101403,3.6158898069583905,0.20620424597364567
682,0.2827,0,1,0,215254,390356,6553,101403,3.615880543925303,0.20620466529336526
683,0.283,0,1,0,215255,390355,6553,101403,3.6158712808922155,0.2062050846147902
684,0.2831,0,1,0,215256,390354,6553,101403,3.615862017859128,0.20620550393792056
685,0.2832,0,1,0,215257,390353,6553,101403,3.61585275482604,0.20620592326275633
686,0.2835,0,1,0,215258,390352,6553,101403,3.6158434917929525,0.20620634258929751
687,0.2837,0,1,0,215259,390351,6553,101403,3.6158342287598653,0.20620676191754414
688,0.2847,0,3,0,215262,390348,6553,101403,3.6158064396606027,0.2062080199125167
689,0.2848,0,3,0,215265,390345,6553,101403,3.6157786505613396,0.20620927792283852
690,0.2849,0,1,0,215266,390344,6553,101403,3.6157693875282524,0.20620969726302346
691,0.285,1,6,1,215272,390338,6554,101402,3.6157138093297267,0.20621059909708384
692,0.2853,0,3,0,215275,390335,6554,101402,3.615686020230464,0.2062118571512821
693,0.2854,0,1,0,215276,390334,6554,101402,3.615676757197377,0.2062122765060927
694,0.2857,0,2,0,215278,390332,6554,101402,3.6156582311312015,0.20621311522083077
695,0.2858,0,4,0,215282,390328,6554,101402,3.6156211789988513,0.2062147926707746
696,0.2859,0,11,0,215293,390317,6554,101402,3.615519285634888,0.2062194057988404
697,0.286,0,3,0,215296,390314,6554,101402,3.6154914965356255,0.2062206639604975
698,0.2862,0,2,0,215298,390312,6554,101402,3.6154729704694506,0.2062215027434647
699,0.2863,0,1,0,215299,390311,6554,101402,3.615463707436363,0.20622192213750704
700,0.2864,0,2,0,215301,390309,6554,101402,3.615445181370188,0.2062227609307093
701,0.2865,0,51,0,215352,390258,6554,101402,3.6149727666827225,0.20624415246308425
702,0.2866,0,8,0,215360,390250,6554,101402,3.614898662418022,0.20624750840025058
703,0.2868,0,4,0,215364,390246,6554,101402,3.614861610285672,0.20624918640978912
704,0.2869,0,2,0,215366,390244,6554,101402,3.6148430842194967,0.2062500254247975
705,0.287,1,12,1,215378,390232,6555,101401,3.6147319278224463,0.2062534451511595
706,0.2871,0,3,0,215381,390229,6555,101401,3.6147041387231833,0.20625470374061794
707,0.2874,6,128,6,215509,390101,6561,101395,3.6135184704879766,0.2062987287790745
708,0.2877,1,5,1,215514,390096,6562,101394,3.6134721553225386,0.2062992125984252
709,0.2878,0,1,0,215515,390095,6562,101394,3.6134628922894514,0.20629963234172077
710,0.2879,0,26,0,215541,390069,6562,101394,3.613222053429175,0.2063105462669621
711,0.288,0,1,0,215542,390068,6562,101394,3.613212790396087,0.20631096605637872
712,0.2881,0,8,0,215550,390060,6562,101394,3.613138686131387,0.20631432443321246
713,0.2884,2,1,2,215551,390059,6564,101392,3.6131294230982993,0.20631151427100566
714,0.2885,12,306,12,215857,389753,6576,101380,3.6102949349735076,0.20642066405637577
715,0.2886,0,4,0,215861,389749,6576,101380,3.6102578828411573,0.20642234524941513
716,0.2888,0,4,0,215865,389745,6576,101380,3.6102208307088075,0.20642402646983965
717,0.2889,0,26,0,215891,389719,6576,101380,3.609979991848531,0.20643495507015897
718,0.2892,3,119,3,216010,389600,6579,101377,3.608877690911112,0.20648014061758493
719,0.2893,0,2,0,216012,389598,6579,101377,3.6088591648449366,0.20648098172004684
720,0.2894,8,65,8,216077,389533,6587,101369,3.608257067694246,0.20649539011859802
721,0.2896,0,18,0,216095,389515,6587,101369,3.6080903330986698,0.20650296200324314
722,0.2897,0,6,0,216101,389509,6587,101369,3.6080347549001446,0.206505486088193
723,0.29,682,11184,682,227285,378325,7269,100687,3.5044369928489383,0.21019723931759537
724,0.2912,0,1,0,227286,378324,7269,100687,3.504427729815851,0.2101976781326525
725,0.2929,0,1,0,227287,378323,7269,100687,3.5044184667827634,0.21019811694954177
726,0.293,0,1,0,227288,378322,7269,100687,3.5044092037496757,0.21019855576826324
727,0.2932,0,1,0,227289,378321,7269,100687,3.5043999407165884,0.21019899458881688
728,0.2938,0,1,0,227290,378320,7269,100687,3.5043906776835008,0.21019943341120276
729,0.2939,0,1,0,227291,378319,7269,100687,3.504381414650413,0.21019987223542086
730,0.2943,0,1,0,227292,378318,7269,100687,3.5043721516173254,0.21020031106147116
731,0.2944,0,1,0,227293,378317,7269,100687,3.504362888584238,0.21020074988935375
732,0.2946,0,1,0,227294,378316,7269,100687,3.5043536255511505,0.21020118871906857
733,0.2947,0,3,0,227297,378313,7269,100687,3.504325836451888,0.2102025052192067
734,0.2948,0,1,0,227298,378312,7269,100687,3.5043165734188,0.21020294405625065
735,0.2949,0,1,0,227299,378311,7269,100687,3.5043073103857125,0.2102033828951269
736,0.295,0,3,0,227302,378308,7269,100687,3.50427952128645,0.21020469942274972
737,0.2953,0,6,0,227308,378302,7269,100687,3.5042239430879247,0.21020733252746931
738,0.2957,0,4,0,227312,378298,7269,100687,3.5041868909555745,0.21020908796726412
739,0.2958,0,11,0,227323,378287,7269,100687,3.5040849975916113,0.21021391557788105
740,0.2959,0,9,0,227332,378278,7269,100687,3.5040016302938235,0.21021786560604638
741,0.296,0,1,0,227333,378277,7269,100687,3.503992367260736,0.2102183045072281
742,0.2961,0,1,0,227334,378276,7269,100687,3.503983104227648,0.21021874341024255
743,0.2962,0,1,0,227335,378275,7269,100687,3.503973841194561,0.2102191823150897
744,0.2963,0,2,0,227337,378273,7269,100687,3.5039553151283855,0.21022006013028227
745,0.2964,0,1,0,227338,378272,7269,100687,3.5039460520952983,0.2102204990406277
746,0.2965,2,43,2,227381,378229,7271,100685,3.5035477416725334,0.21023607578813733
747,0.2966,0,8,0,227389,378221,7271,100685,3.503473637407833,0.21023958772702786
748,0.2968,1,1,1,227390,378220,7272,100684,3.503464374374745,0.21023837762891937
749,0.2969,1,1,1,227391,378219,7273,100683,3.503455111341658,0.21023716752070362
750,0.297,1,12,1,227403,378207,7274,100682,3.503343954944607,0.2102407864870565
751,0.2971,0,1,0,227404,378206,7274,100682,3.5033346919115194,0.210241225505755
752,0.2974,7,135,7,227539,378071,7281,100675,3.5020841824446998,0.2102889632498235
753,0.2977,0,16,0,227555,378055,7281,100675,3.5019359739152986,0.21029599147745076
754,0.2979,2,23,2,227578,378032,7283,100673,3.501722924154285,0.21030279608527172
755,0.2981,0,7,0,227585,378025,7283,100673,3.501658082922672,0.2103058713426837
756,0.2984,0,3,0,227588,378022,7283,100673,3.5016302938234096,0.21030718933767847
757,0.2985,17,321,17,227909,377701,7300,100656,3.4986568602023045,0.21042025098409764
758,0.2986,0,3,0,227912,377698,7300,100656,3.498629071103042,0.21042157063597253
759,0.2988,0,2,0,227914,377696,7300,100656,3.498610545036867,0.21042245041308494
760,0.2989,2,23,2,227937,377673,7302,100654,3.498397495275853,0.21042926700771647
761,0.2992,11,127,11,228064,377546,7313,100643,3.497221090073734,0.21046699108511488
762,0.2993,0,4,0,228068,377542,7313,100643,3.4971840379413837,0.2104687516337819
763,0.2994,4,50,4,228118,377492,7317,100639,3.496720886287006,0.21048415601581993
764,0.2996,0,19,0,228137,377473,7317,100639,3.496544888658342,0.21049252058095175
765,0.2997,0,8,0,228145,377465,7317,100639,3.496470784393642,0.21049604270200625
766,0.2998,0,1,0,228146,377464,7317,100639,3.4964615213605543,0.2104964829754258
767,0.3,737,11414,737,239560,366050,8054,99902,3.3907332616992107,0.2144040587871712
768,0.3007,0,1,0,239561,366049,8054,99902,3.390723998666123,0.2144045189301021
769,0.3023,0,1,0,239562,366048,8054,99902,3.390714735633036,0.21440497907500805
770,0.3024,0,2,0,239564,366046,8054,99902,3.3906962095668605,0.21440589937074522
771,0.3026,0,1,0,239565,366045,8054,99902,3.3906869465337732,0.2144063595215765
772,0.3027,1,0,1,239565,366045,8055,99901,3.3906869465337732,0.2144046735029381
773,0.3029,0,1,0,239566,366044,8055,99901,3.3906776835006855,0.21440513365311356
774,0.3032,0,1,0,239567,366043,8055,99901,3.390668420467598,0.21440559380526414
775,0.3033,0,1,0,239568,366042,8055,99901,3.39065915743451,0.2144060539593899
776,0.3037,0,1,0,239569,366041,8055,99901,3.390649894401423,0.21440651411549078
777,0.3038,0,2,0,239571,366039,8055,99901,3.3906313683352476,0.21440743443361807
778,0.3039,0,1,0,239572,366038,8055,99901,3.3906221053021603,0.2144078945956445
779,0.3043,0,2,0,239574,366036,8055,99901,3.390603579235985,0.214408814925623
780,0.3044,0,1,0,239575,366035,8055,99901,3.3905943162028973,0.21440927509357507
781,0.3047,0,2,0,239577,366033,8055,99901,3.3905757901367224,0.21441019543540502
782,0.3048,0,1,0,239578,366032,8055,99901,3.3905665271036347,0.21441065560928288
783,0.305,0,9,0,239587,366023,8055,99901,3.390483159805847,0.21441479726307294
784,0.3053,2,3,2,239590,366020,8057,99899,3.3904553707065843,0.2144128056593528
785,0.3055,0,2,0,239592,366018,8057,99899,3.390436844640409,0.21441372604991876
786,0.3058,3,21,3,239613,365997,8060,99896,3.3902423209455703,0.2144183321062991
787,0.3059,2,8,2,239621,365989,8062,99894,3.39016821668087,0.21441864159027052
788,0.306,0,3,0,239624,365986,8062,99894,3.390140427581607,0.21442002232334506
789,0.3061,0,1,0,239625,365985,8062,99894,3.39013116454852,0.21442048257165486
790,0.3062,0,2,0,239627,365983,8062,99894,3.3901126384823446,0.214421403074202
791,0.3063,0,1,0,239628,365982,8062,99894,3.390103375449257,0.21442186332843932
792,0.3065,2,37,2,239665,365945,8064,99892,3.3897606432250176,0.21443552143775613
793,0.3066,0,11,0,239676,365934,8064,99892,3.3896587498610544,0.21444058511117886
794,0.3068,0,4,0,239680,365930,8064,99892,3.389621697728704,0.21444242650626205
795,0.3069,0,3,0,239683,365927,8064,99892,3.3895939086294415,0.21444380757332784
796,0.307,0,18,0,239701,365909,8064,99892,3.3894271740338655,0.21445209434930368
797,0.3071,0,1,0,239702,365908,8064,99892,3.3894179110007783,0.21445255474452554
798,0.3073,0,1,0,239703,365907,8064,99892,3.3894086479676906,0.2144530151417242
799,0.3074,11,133,11,239836,365774,8075,99881,3.388176664567046,0.21449571034349466
800,0.3076,0,1,0,239837,365773,8075,99881,3.3881674015339582,0.2144961709767338
801,0.3077,0,8,0,239845,365765,8075,99881,3.3880932972692577,0.2144998561138719
802,0.3079,1,24,1,239869,365741,8076,99880,3.3878709844751564,0.21450922531415034
803,0.3081,0,5,0,239874,365736,8076,99880,3.387824669309719,0.21451152881344285
804,0.3084,1,2,1,239876,365734,8077,99879,3.3878061432435436,0.21451076323040807
805,0.3085,18,302,18,240178,365432,8095,99861,3.385008707251102,0.21461960528097349
806,0.3088,1,5,1,240183,365427,8096,99860,3.3849623920856646,0.2146202236469104
807,0.3089,2,30,2,240213,365397,8098,99858,3.3846845010930378,0.21463068639778185
808,0.309,0,2,0,240215,365395,8098,99858,3.384665975026863,0.21463160903852313
809,0.3092,12,142,12,240357,365253,8110,99846,3.38335062432843,0.2146768752459154
810,0.3093,0,1,0,240358,365252,8110,99846,3.3833413612953427,0.214677336819337
811,0.3094,1,50,1,240408,365202,8111,99845,3.382878209640965,0.21469872937574053
812,0.3096,1,20,1,240428,365182,8112,99844,3.382692948979214,0.2147062744878781
813,0.3097,0,3,0,240431,365179,8112,99844,3.3826651598799513,0.21470765962113703
814,0.31,748,11262,748,251693,353917,8860,99096,3.2783448812479157,0.21874868933121125
815,0.3111,0,1,0,251694,353916,8860,99096,3.2783356182148284,0.21874917220735873
816,0.3117,0,1,0,251695,353915,8860,99096,3.2783263551817408,0.2187496550856381
817,0.3137,0,1,0,251696,353914,8860,99096,3.278317092148653,0.2187501379660493
818,0.3138,0,1,0,251697,353913,8860,99096,3.2783078291155654,0.21875062084859243
819,0.3139,0,1,0,251698,353912,8860,99096,3.278298566082478,0.2187511037332674
820,0.3143,1,2,1,251700,353910,8861,99095,3.278280040016303,0.21875034491893025
821,0.3144,0,1,0,251701,353909,8861,99095,3.2782707769832156,0.21875082780726
822,0.3148,0,1,0,251702,353908,8861,99095,3.278261513950128,0.21875131069772163
823,0.3149,0,1,0,251703,353907,8861,99095,3.27825225091704,0.21875179359031527
824,0.315,2,8,2,251711,353899,8863,99093,3.2781781466523396,0.21875220754450408
825,0.3153,1,5,1,251716,353894,8864,99092,3.278131831486902,0.218752897440539
826,0.3157,0,1,0,251717,353893,8864,99092,3.2781225684538144,0.2187533803547579
827,0.3158,1,10,1,251727,353883,8865,99091,3.278029938122939,0.21875648491966426
828,0.3159,0,13,0,251740,353870,8865,99091,3.277909518692801,0.21876276324010235
829,0.316,0,2,0,251742,353868,8865,99091,3.2778909926266255,0.21876372916754055
830,0.3162,0,1,0,251743,353867,8865,99091,3.2778817295935383,0.21876421213445837
831,0.3163,1,0,1,251743,353867,8866,99090,3.2778817295935383,0.2187624873884276
832,0.3164,0,6,0,251749,353861,8866,99090,3.2778261513950127,0.21876538521826863
833,0.3165,3,46,3,251795,353815,8869,99087,3.277400051872985,0.218782429753015
834,0.3166,0,4,0,251799,353811,8869,99087,3.2773629997406353,0.21878436204178425
835,0.3168,0,3,0,251802,353808,8869,99087,3.2773352106413722,0.21878581128076044
836,0.3169,0,1,0,251803,353807,8869,99087,3.277325947608285,0.21878629436468577
837,0.317,0,13,0,251816,353794,8869,99087,3.2772055281781465,0.21879257464985283
838,0.3171,0,2,0,251818,353792,8869,99087,3.2771870021119716,0.2187935408795727
839,0.3173,0,2,0,251820,353790,8869,99087,3.2771684760457966,0.2187945071178267
840,0.3174,11,127,11,251947,353663,8880,99076,3.275992070843677,0.21883690161439592
841,0.3177,1,10,1,251957,353653,8881,99075,3.2758994405128017,0.21884000989556643
842,0.3179,1,27,1,251984,353626,8882,99074,3.2756493386194374,0.2188513364258891
843,0.3181,1,5,1,251989,353621,8883,99073,3.275603023454,0.21885202808077864
844,0.3182,0,1,0,251990,353620,8883,99073,3.275593760420912,0.21885251152547092
845,0.3184,0,4,0,251994,353616,8883,99073,3.275556708288562,0.2188544453255988
846,0.3185,20,330,20,252324,353286,8903,99053,3.272499907369669,0.21897957063176068
847,0.3186,0,6,0,252330,353280,8903,99053,3.272444329171144,0.21898247530027656
848,0.3188,0,1,0,252331,353279,8903,99053,3.272435066138056,0.2189829594191877
849,0.3189,2,26,2,252357,353253,8905,99051,3.27219422727778,0.2189920938130107
850,0.319,0,2,0,252359,353251,8905,99051,3.2721757012116046,0.218993062157585
851,0.3192,9,131,9,252490,353120,8914,99042,3.2709622438771353,0.21904096319460725
852,0.3193,0,2,0,252492,353118,8914,99042,3.27094371781096,0.219041932059448
853,0.3194,3,48,3,252540,353070,8917,99039,3.2704990922227575,0.21906000544116574
854,0.3196,2,13,2,252553,353057,8919,99037,3.2703786727926194,0.21906284976133283
855,0.3197,0,9,0,252562,353048,8919,99037,3.270295305494831,0.21906721081212605
856,0.3198,0,1,0,252563,353047,8919,99037,3.2702860424617435,0.21906769538404366
857,0.32,825,11270,825,263833,341777,9744,98212,3.165891659565008,0.2232146712758728
858,0.3216,0,1,0,263834,341776,9744,98212,3.1658823965319205,0.22321517859577988
859,0.3217,1,0,1,263834,341776,9745,98211,3.1658823965319205,0.22321341312356957
860,0.3228,0,1,0,263835,341775,9745,98211,3.165873133498833,0.22321392044292318
861,0.3231,0,1,0,263836,341774,9745,98211,3.165863870465745,0.2232144277645829
862,0.3232,0,3,0,263839,341771,9745,98211,3.1658360813664825,0.2232159497433986
863,0.3235,0,1,0,263840,341770,9745,98211,3.1658268183333953,0.22321645707428275
864,0.3239,0,1,0,263841,341769,9745,98211,3.1658175553003076,0.22321696440747307
865,0.324,0,1,0,263842,341768,9745,98211,3.16580829226722,0.22321747174296955
866,0.3242,0,1,0,263843,341767,9745,98211,3.1657990292341323,0.22321797908077223
867,0.3243,0,5,0,263848,341762,9745,98211,3.1657527140686947,0.2232205158043789
868,0.3246,0,1,0,263849,341761,9745,98211,3.165743451035607,0.22322102315601902
869,0.3247,0,3,0,263852,341758,9745,98211,3.1657156619363445,0.2232225452247772
870,0.3249,0,1,0,263853,341757,9745,98211,3.165706398903257,0.2232230525856426
871,0.325,1,6,1,263859,341751,9746,98210,3.1656508207047316,0.2232243312475424
872,0.3253,0,3,0,263862,341748,9746,98210,3.165623031605469,0.22322585337691325
873,0.3255,1,0,1,263862,341748,9747,98209,3.165623031605469,0.2232240878085813
874,0.3256,0,1,0,263863,341747,9747,98209,3.1656137685723813,0.2232245951867914
875,0.3257,0,3,0,263866,341744,9747,98209,3.1655859794731187,0.22322611733526082
876,0.3258,1,16,1,263882,341728,9748,98208,3.165437770943718,0.22323247017748035
877,0.3259,1,10,1,263892,341718,9749,98207,3.165345140612842,0.22323577882593623
878,0.326,0,1,0,263893,341717,9749,98207,3.165335877579755,0.22323628626762804
879,0.3261,0,1,0,263894,341716,9749,98207,3.165326614546667,0.2232367937116268
880,0.3262,0,4,0,263898,341712,9749,98207,3.165289562414317,0.22323882351069174
881,0.3263,0,1,0,263899,341711,9749,98207,3.1652802993812292,0.22323933096622553
882,0.3265,3,49,3,263948,341662,9752,98204,3.164826410759939,0.22325890157457043
883,0.3266,0,5,0,263953,341657,9752,98204,3.1647800955945016,0.22326143940926793
884,0.3267,0,1,0,263954,341656,9752,98204,3.164770832561414,0.223261946983131
885,0.3268,1,2,1,263956,341654,9753,98203,3.164752306495239,0.2232611962524184
886,0.3269,1,4,1,263960,341650,9754,98202,3.1647152543628887,0.22326146067313551
887,0.327,1,13,1,263973,341637,9755,98201,3.16459483493275,0.22326629349897006
888,0.3271,1,1,1,263974,341636,9756,98200,3.164585571899663,0.2232650351494648
889,0.3272,0,1,0,263975,341635,9756,98200,3.1645763088665753,0.22326554276035332
890,0.3273,0,1,0,263976,341634,9756,98200,3.1645670458334876,0.22326605037355002
891,0.3274,5,146,5,264122,341488,9761,98195,3.163214643002705,0.2233313546350439
892,0.3277,4,10,4,264132,341478,9765,98191,3.1631220126718294,0.22332936822928157
893,0.3278,0,1,0,264133,341477,9765,98191,3.1631127496387417,0.22332987617929892
894,0.3279,2,18,2,264151,341459,9767,98189,3.1629460150431656,0.22333548657107505
895,0.3281,0,3,0,264154,341456,9767,98189,3.162918225943903,0.22333701054259686
896,0.3284,0,3,0,264157,341453,9767,98189,3.1628904368446404,0.22333853453491703
897,0.3285,16,327,16,264484,341126,9783,98173,3.15986142502501,0.22347649323126162
898,0.3286,0,3,0,264487,341123,9783,98173,3.1598336359257475,0.22347801937645687
899,0.3288,0,2,0,264489,341121,9783,98173,3.1598151098595726,0.22347903681816733
900,0.3289,2,26,2,264515,341095,9785,98171,3.159574270999296,0.22348872892507046
901,0.3291,0,1,0,264516,341094,9785,98171,3.1595650079662083,0.22348923770389173
902,0.3292,7,140,7,264656,340954,9792,98164,3.1582681833339508,0.2235481123524884
903,0.3293,0,2,0,264658,340952,9792,98164,3.158249657267776,0.22354913052587472
904,0.3294,3,40,3,264698,340912,9795,98161,3.1578791359442735,0.22356419092041643
905,0.3296,2,14,2,264712,340898,9797,98159,3.1577494534810477,0.22356778277080197
906,0.3297,0,7,0,264719,340891,9797,98159,3.157684612249435,0.2235713472269673
907,0.3299,0,1,0,264720,340890,9797,98159,3.157675349216347,0.22357185644426933
908,0.33,838,11217,838,275937,329673,10635,97321,3.053771907073252,0.2279212354271957
909,0.3315,0,1,0,275938,329672,10635,97321,3.0537626440401646,0.2279217692093313
910,0.3324,0,1,0,275939,329671,10635,97321,3.053753381007077,0.2279223029939671
911,0.333,0,1,0,275940,329670,10635,97321,3.0537441179739893,0.22792283678110312
912,0.3335,0,2,0,275942,329668,10635,97321,3.0537255919078143,0.22792390436287585
913,0.3338,0,1,0,275943,329667,10635,97321,3.0537163288747267,0.22792443815751262
914,0.3342,0,1,0,275944,329666,10635,97321,3.053707065841639,0.22792497195464967
915,0.3343,1,1,1,275945,329665,10636,97320,3.0536978028085517,0.22792369755377823
916,0.3344,0,3,0,275948,329662,10636,97320,3.053670013709289,0.2279252989587383
917,0.3346,0,2,0,275950,329660,10636,97320,3.053651487643114,0.22792636657454682
918,0.3347,0,2,0,275952,329658,10636,97320,3.053632961576939,0.22792743420035694
919,0.3348,0,1,0,275953,329657,10636,97320,3.053623698543851,0.22792796801701262
920,0.3349,0,1,0,275954,329656,10636,97320,3.0536144355107635,0.22792850183616878
921,0.335,0,7,0,275961,329649,10636,97320,3.0535495942791506,0.22793223864027598
922,0.3351,0,1,0,275962,329648,10636,97320,3.0535403312460634,0.22793277247943639
923,0.3353,1,5,1,275967,329643,10637,97319,3.0534940160806254,0.22793363343810455
924,0.3355,0,4,0,275971,329639,10637,97319,3.053456963948275,0.22793576885782676
925,0.3357,1,3,1,275974,329636,10638,97318,3.0534291748490126,0.22793556214486807
926,0.3358,0,5,0,275979,329631,10638,97318,3.0533828596835746,0.2279382314983757
927,0.3359,0,19,0,275998,329612,10638,97318,3.0532068620549113,0.22794837561192702
928,0.336,0,2,0,276000,329610,10638,97318,3.053188335988736,0.22794944346587714
929,0.3362,1,1,1,276001,329609,10639,97317,3.0531790729556487,0.22794816900352755
930,0.3363,1,0,1,276001,329609,10640,97316,3.0531790729556487,0.22794636060197926
931,0.3365,1,59,1,276060,329550,10641,97315,3.052632554003483,0.22797605800428708
932,0.3366,0,4,0,276064,329546,10641,97315,3.052595501871133,0.22797819430681182
933,0.3368,0,1,0,276065,329545,10641,97315,3.052586238838045,0.22797872838869887
934,0.3369,0,1,0,276066,329544,10641,97315,3.0525769758049575,0.2279792624730883
935,0.337,0,13,0,276079,329531,10641,97315,3.0524565563748194,0.22798620579787557
936,0.3371,0,1,0,276080,329530,10641,97315,3.0524472933417317,0.2279867399173002
937,0.3373,0,2,0,276082,329528,10641,97315,3.052428767275557,0.22798780816365735
938,0.3374,11,140,11,276222,329388,10652,97304,3.0511319426432992,0.22804270996409587
939,0.3377,2,17,2,276239,329371,10654,97302,3.050974471080811,0.22804817740986658
940,0.3378,0,1,0,276240,329370,10654,97302,3.050965208047723,0.22804871189110137
941,0.3379,0,34,0,276274,329336,10654,97302,3.0506502649227465,0.22806688574388592
942,0.3381,1,7,1,276281,329329,10655,97301,3.0505854236911336,0.22806881841408247
943,0.3383,0,1,0,276282,329328,10655,97301,3.050576160658046,0.2280693529975693
944,0.3384,0,3,0,276285,329325,10655,97301,3.0505483715587833,0.2280709567630665
945,0.3385,27,335,27,276620,328990,10682,97274,3.0474452554744524,0.22820130247921475
946,0.3388,0,4,0,276624,328986,10682,97274,3.047408203342102,0.22820344390747432
947,0.3389,4,26,4,276650,328960,10686,97270,3.047167364481826,0.2282101212960139
948,0.339,0,2,0,276652,328958,10686,97270,3.0471488384156507,0.22821119213191063
949,0.3392,12,136,12,276788,328822,10698,97258,3.0458890659157434,0.22826229815996996
950,0.3393,0,2,0,276790,328820,10698,97258,3.0458705398495685,0.22826336961776952
951,0.3394,2,69,2,276859,328751,10700,97256,3.045231390566527,0.22829671812904484
952,0.3396,0,18,0,276877,328733,10700,97256,3.0450646559709513,0.2283063647183378
953,0.3397,1,11,1,276888,328722,10701,97255,3.044962762606988,0.22831044868619668
954,0.3398,0,1,0,276889,328721,10701,97255,3.0449534995739005,0.22831098465641256
955,0.34,869,11034,869,287923,317687,11570,96386,2.9427451924858277,0.23277538018658545
956,0.3412,0,1,0,287924,317686,11570,96386,2.94273592945274,0.23277594234819066
957,0.3425,0,1,0,287925,317685,11570,96386,2.9427266664196523,0.23277650451251114
958,0.3426,0,1,0,287926,317684,11570,96386,2.942717403386565,0.23277706667954692
959,0.3427,0,2,0,287928,317682,11570,96386,2.9426988773203897,0.23277819102176453
960,0.3432,0,1,0,287929,317681,11570,96386,2.942689614287302,0.23277875319694638
961,0.3439,0,1,0,287930,317680,11570,96386,2.942680351254215,0.23277931537484362
962,0.3443,0,3,0,287933,317677,11570,96386,2.942652562154952,0.23278100192482787
963,0.3447,0,3,0,287936,317674,11570,96386,2.942624773055689,0.23278268849925132
964,0.3448,0,1,0,287937,317673,11570,96386,2.942615510022602,0.23278325069615682
965,0.345,0,5,0,287942,317668,11570,96386,2.942569194857164,0.23278606172141797
966,0.3453,0,6,0,287948,317662,11570,96386,2.9425136166586388,0.23278943504134786
967,0.3455,0,1,0,287949,317661,11570,96386,2.942504353625551,0.23278999727084124
968,0.3457,0,3,0,287952,317658,11570,96386,2.9424765645262885,0.23279168397561611
969,0.3458,0,12,0,287964,317646,11570,96386,2.9423654081292376,0.23279843103914674
970,0.3459,1,12,1,287976,317634,11571,96385,2.9422542517321872,0.2328033254512474
971,0.346,0,2,0,287978,317632,11571,96385,2.942235725666012,0.232804450058814
972,0.3462,0,4,0,287982,317628,11571,96385,2.942198673533662,0.23280669930654352
973,0.3463,0,2,0,287984,317626,11571,96385,2.9421801474674867,0.23280782394670674
974,0.3464,0,3,0,287987,317623,11571,96385,2.942152358368224,0.23280951092732508
975,0.3465,7,45,7,288032,317578,11578,96378,2.941735521879284,0.23282184580003673
976,0.3466,0,3,0,288035,317575,11578,96378,2.9417077327800216,0.23282353310641546
977,0.3469,0,5,0,288040,317570,11578,96378,2.9416614176145837,0.2328263453380618
978,0.347,0,14,0,288054,317556,11578,96378,2.941531735151358,0.23283421994810766
979,0.3473,0,1,0,288055,317555,11578,96378,2.9415224721182702,0.23283478244063652
980,0.3474,11,142,11,288197,317413,11589,96367,2.9402071214198378,0.232894291652569
981,0.3477,0,17,0,288214,317396,11589,96367,2.9400496498573494,0.2329038604225124
982,0.3479,3,23,3,288237,317373,11592,96364,2.9398366000963354,0.23291124554970913
983,0.3481,2,4,2,288241,317369,11594,96362,2.939799547963985,0.23290978921086405
984,0.3484,0,4,0,288245,317365,11594,96362,2.9397624958316353,0.23291204103188817
985,0.3485,25,327,25,288572,317038,11619,96337,2.936733484012005,0.23304989416389477
986,0.3486,0,3,0,288575,317035,11619,96337,2.9367056949127424,0.23305158549684063
987,0.3487,0,1,0,288576,317034,11619,96337,2.9366964318796547,0.23305214927994464
988,0.3488,1,7,1,288583,317027,11620,96336,2.936631590648042,0.2330542404617733
989,0.3489,8,26,8,288609,317001,11628,96328,2.936390751787765,0.23305405621187963
990,0.3492,5,126,5,288735,316875,11633,96323,2.9352236096187334,0.233115842767874
991,0.3493,1,3,1,288738,316872,11634,96322,2.935195820519471,0.2331156793177055
992,0.3494,3,47,3,288785,316825,11637,96319,2.934760457964356,0.2331366303274403
993,0.3496,1,24,1,288809,316801,11638,96318,2.9345381451702544,0.2331483180391122
994,0.3497,1,3,1,288812,316798,11639,96317,2.9345103560709918,0.23314815487213003
995,0.3498,0,2,0,288814,316796,11639,96317,2.934491830004817,0.23314928361005344
996,0.35,939,11272,939,300086,305524,12578,95378,2.830078921041906,0.23790851629575308
997,0.3524,0,1,0,300087,305523,12578,95378,2.8300696580088185,0.2379091097303324
998,0.353,0,3,0,300090,305520,12578,95378,2.830041868909556,0.23791089005183363
999,0.3532,0,1,0,300091,305519,12578,95378,2.830032605876468,0.23791148349825517
1000,0.3535,0,4,0,300095,305515,12578,95378,2.829995553744118,0.2379138573135475
1001,0.3538,0,1,0,300096,305514,12578,95378,2.8299862907110303,0.23791445077477225
1002,0.3539,0,4,0,300100,305510,12578,95378,2.8299492385786804,0.2379168246492786
1003,0.3541,0,1,0,300101,305509,12578,95378,2.8299399755455927,0.23791741812530715
1004,0.3542,1,1,1,300102,305508,12579,95377,2.829930712512505,0.2379161106052858
1005,0.3543,1,5,1,300107,305503,12580,95376,2.8298843973470675,0.23791717700353474
1006,0.3545,0,1,0,300108,305502,12580,95376,2.82987513431398,0.2379177704937662
1007,0.3546,0,1,0,300109,305501,12580,95376,2.829865871280892,0.2379183639869586
1008,0.3547,1,1,1,300110,305500,12581,95375,2.8298566082478045,0.2379170564390396
1009,0.3548,0,2,0,300112,305498,12581,95375,2.8298380821816296,0.23791824343370593
1010,0.3549,0,1,0,300113,305497,12581,95375,2.829828819148542,0.23791883693548066
1011,0.355,0,5,0,300118,305492,12581,95375,2.8297825039831044,0.2379218044887706
1012,0.3553,0,3,0,300121,305489,12581,95375,2.829754714883842,0.23792358505627845
1013,0.3555,0,1,0,300122,305488,12581,95375,2.829745451850754,0.2379241785847035
1014,0.3557,0,1,0,300123,305487,12581,95375,2.8297361888176664,0.23792477211608984
1015,0.3558,1,4,1,300127,305483,12582,95374,2.829699136685316,0.2379252451622399
1016,0.3559,2,15,2,300142,305468,12584,95372,2.829560191189003,0.23793034627282705
1017,0.356,0,1,0,300143,305467,12584,95372,2.8295509281559155,0.23793093985365696
1018,0.3562,1,1,1,300144,305466,12585,95371,2.829541665122828,0.23792963224452832
1019,0.3564,0,1,0,300145,305465,12585,95371,2.82953240208974,0.23793022582801943
1020,0.3565,1,50,1,300195,305415,12586,95370,2.8290692504353627,0.23795800741045697
1021,0.3566,0,5,0,300200,305410,12586,95370,2.8290229352699248,0.2379609760966116
1022,0.3568,0,1,0,300201,305409,12586,95370,2.829013672236837,0.23796156984273129
1023,0.3569,0,3,0,300204,305406,12586,95370,2.8289858831375745,0.2379633510988682
1024,0.357,1,19,1,300223,305387,12587,95369,2.828809885508911,0.23797273153739432
1025,0.3571,0,1,0,300224,305386,12587,95369,2.8288006224758235,0.23797332534840487
1026,0.3573,0,1,0,300225,305385,12587,95369,2.828791359442736,0.23797391916237892
1027,0.3574,5,126,5,300351,305259,12592,95364,2.827624217273704,0.23803925386210975
1028,0.3576,0,1,0,300352,305258,12592,95364,2.8276149542406164,0.23803984803630354
1029,0.3577,1,9,1,300361,305249,12593,95363,2.8275315869428286,0.23804329376054637
1030,0.3578,1,0,1,300361,305249,12594,95362,2.8275315869428286,0.2380413917740651
1031,0.3579,1,31,1,300392,305218,12595,95361,2.8272444329171145,0.23805791117357625
1032,0.3581,0,4,0,300396,305214,12595,95361,2.827207380784764,0.2380602883355177
1033,0.3582,0,1,0,300397,305213,12595,95361,2.8271981177516765,0.23806088263342104
1034,0.3583,1,2,1,300399,305211,12596,95360,2.8271795916855016,0.23806016910859748
1035,0.3584,1,5,1,300404,305206,12597,95359,2.8271332765200636,0.2380612385006179
1036,0.3585,38,353,38,300757,304853,12635,95321,2.823863425840157,0.23819888348568372
1037,0.3586,0,2,0,300759,304851,12635,95321,2.823844899773982,0.23820007396819368
1038,0.3588,0,4,0,300763,304847,12635,95321,2.823807847641632,0.23820245496891307
1039,0.3589,0,25,0,300788,304822,12635,95321,2.823576271814443,0.23821733730191458
1040,0.359,0,3,0,300791,304819,12635,95321,2.8235484827151804,0.2382191233068426
1041,0.3592,8,141,8,300932,304678,12643,95313,2.822242395049835,0.23828786147688322
1042,0.3593,0,1,0,300933,304677,12643,95313,2.8222331320167475,0.2382884572114303
1043,0.3594,4,43,4,300976,304634,12647,95309,2.8218348215939826,0.23830645867036052
1044,0.3596,1,15,1,300991,304619,12648,95308,2.8216958760976696,0.23831349221232875
1045,0.3597,0,8,0,300999,304611,12648,95308,2.821621771832969,0.23831825944753812
1046,0.36,985,11037,985,312036,293574,13633,94323,2.7193856756456336,0.2431650670152128
1047,0.3618,0,1,0,312037,293573,13633,94323,2.719376412612546,0.2431656938973333
1048,0.3627,0,1,0,312038,293572,13633,94323,2.7193671495794582,0.24316632078268605
1049,0.3628,0,1,0,312039,293571,13633,94323,2.7193578865463706,0.243166947671271
1050,0.363,0,1,0,312040,293570,13633,94323,2.7193486235132833,0.24316757456308827
1051,0.3632,1,3,1,312043,293567,13634,94322,2.7193208344140207,0.24316750410555596
1052,0.3633,0,1,0,312044,293566,13634,94322,2.719311571380933,0.24316813100688858
1053,0.3634,0,1,0,312045,293565,13634,94322,2.7193023083478454,0.2431687579114536
1054,0.364,0,1,0,312046,293564,13634,94322,2.7192930453147577,0.24316938481925102
1055,0.3641,0,1,0,312047,293563,13634,94322,2.7192837822816704,0.24317001173028088
1056,0.3642,0,1,0,312048,293562,13634,94322,2.7192745192485828,0.24317063864454322
1057,0.3643,1,0,1,312048,293562,13635,94321,2.7192745192485828,0.24316868746503456
1058,0.3645,0,1,0,312049,293561,13635,94321,2.719265256215495,0.2431693143791153
1059,0.3647,0,3,0,312052,293558,13635,94321,2.7192374671162325,0.24317119514075267
1060,0.3648,0,2,0,312054,293556,13635,94321,2.7192189410500576,0.2431724489980071
1061,0.365,2,8,2,312062,293548,13637,94319,2.719144836785357,0.24317356207153484
1062,0.3651,0,1,0,312063,293547,13637,94319,2.7191355737522693,0.2431741890240444
1063,0.3653,0,3,0,312066,293544,13637,94319,2.7191077846530067,0.24317606990097018
1064,0.3655,0,1,0,312067,293543,13637,94319,2.719098521619919,0.24317669686641125
1065,0.3657,3,0,3,312067,293543,13640,94316,2.719098521619919,0.24317084301253805
1066,0.3658,0,7,0,312074,293536,13640,94316,2.719033680388306,0.24317523178944545
1067,0.3659,0,6,0,312080,293530,13640,94316,2.718978102189781,0.24317899372431326
1068,0.3662,0,3,0,312083,293527,13640,94316,2.7189503130905184,0.2431808747353955
1069,0.3663,0,1,0,312084,293526,13640,94316,2.7189410500574307,0.24318150174555617
1070,0.3664,0,5,0,312089,293521,13640,94316,2.718894734891993,0.24318463684486008
1071,0.3665,3,45,3,312134,293476,13643,94313,2.7184778984030533,0.24320700174579474
1072,0.3666,0,5,0,312139,293471,13643,94313,2.7184315832376154,0.24321013760237659
1073,0.3668,0,2,0,312141,293469,13643,94313,2.71841305717144,0.24321139196765193
1074,0.3669,1,4,1,312145,293465,13644,94312,2.71837600503909,0.2432119491357146
1075,0.367,1,14,1,312159,293451,13645,94311,2.7182463225758644,0.24321877852909773
1076,0.3671,0,1,0,312160,293450,13645,94311,2.7182370595427767,0.24321940576798595
1077,0.3674,12,168,12,312328,293282,13657,94299,2.7166808699840677,0.24330140022343716
1078,0.3675,0,1,0,312329,293281,13657,94299,2.71667160695098,0.24330202796841943
1079,0.3677,3,14,3,312343,293267,13660,94296,2.7165419244877542,0.24330495945175365
1080,0.3679,6,21,6,312364,293246,13666,94290,2.7163474007929156,0.24330642830601545
1081,0.3681,0,9,0,312373,293237,13666,94290,2.716264033495128,0.24331207890030887
1082,0.3682,0,1,0,312374,293236,13666,94290,2.71625477046204,0.2433127067603206
1083,0.3684,1,2,1,312376,293234,13667,94289,2.716236244395865,0.24331200986780138
1084,0.3685,28,352,28,312728,292882,13695,94261,2.712975656749046,0.24347850794151
1085,0.3686,0,4,0,312732,292878,13695,94261,2.7129386046166957,0.24348102361167437
1086,0.3688,0,3,0,312735,292875,13695,94261,2.712910815517433,0.24348291039841297
1087,0.3689,5,25,5,312760,292850,13700,94256,2.712679239690244,0.24348886351541954
1088,0.3692,13,135,13,312895,292715,13713,94243,2.7114287302234246,0.2435483954330961
1089,0.3693,0,4,0,312899,292711,13713,94243,2.7113916780910743,0.243550913028422
1090,0.3694,10,49,10,312948,292662,13723,94233,2.710937789469784,0.24356220680029467
1091,0.3695,0,1,0,312949,292661,13723,94233,2.7109285264366965,0.24356283633243214
1092,0.3696,0,14,0,312963,292647,13723,94233,2.7107988439734707,0.24357165012406948
1093,0.3697,0,5,0,312968,292642,13723,94233,2.7107525288080327,0.24357479806138935
1094,0.37,1001,10704,1001,323672,281938,14724,93232,2.611601022638853,0.24850601060852415
1095,0.371,0,1,0,323673,281937,14724,93232,2.611591759605765,0.24850667299270462
1096,0.372,1,0,1,323673,281937,14725,93231,2.611591759605765,0.24850466990788128
1097,0.3725,0,2,0,323675,281935,14725,93231,2.6115732335395903,0.24850599467968845
1098,0.3731,0,1,0,323676,281934,14725,93231,2.6115639705065026,0.24850665707088881
1099,0.3732,0,1,0,323677,281933,14725,93231,2.611554707473415,0.24850731946562038
1100,0.3735,1,2,1,323679,281931,14726,93230,2.61153618140724,0.24850664114873347
1101,0.3739,0,3,0,323682,281928,14726,93230,2.6115083923079774,0.2485086283645824
1102,0.3742,0,1,0,323683,281927,14726,93230,2.6114991292748897,0.24850929077692807
1103,0.3743,0,3,0,323686,281924,14726,93230,2.611471340175627,0.24851127803515358
1104,0.3744,0,1,0,323687,281923,14726,93230,2.6114620771425394,0.248511940461625
1105,0.3746,0,1,0,323688,281922,14726,93230,2.611452814109452,0.24851260289162794
1106,0.3747,1,1,1,323689,281921,14727,93229,2.6114435510763645,0.24851126216180194
1107,0.3748,0,3,0,323692,281918,14727,93229,2.611415761977102,0.2485132494728733
1108,0.375,1,5,1,323697,281913,14728,93228,2.611369446811664,0.24851455852599422
1109,0.3753,2,5,2,323702,281908,14730,93226,2.6113231316462264,0.24851386437912854
1110,0.3754,0,2,0,323704,281906,14730,93226,2.611304605580051,0.24851518932002603
1111,0.3755,0,3,0,323707,281903,14730,93226,2.6112768164807885,0.24851717675786197
1112,0.3757,0,2,0,323709,281901,14730,93226,2.6112582904146135,0.24851850173407938
1113,0.3758,1,18,1,323727,281883,14731,93225,2.6110915558190375,0.24852842381394158
1114,0.3759,0,16,0,323743,281867,14731,93225,2.6109433472896364,0.24853902509251063
1115,0.376,1,0,1,323743,281867,14732,93224,2.6109433472896364,0.24853702168273833
1116,0.3762,0,1,0,323744,281866,14732,93224,2.610934084256549,0.24853768428910394
1117,0.3764,0,2,0,323746,281864,14732,93224,2.610915558190374,0.2485390095124344
1118,0.3765,2,42,2,323788,281822,14734,93222,2.6105265108006965,0.24856283529399217
1119,0.3766,0,6,0,323794,281816,14734,93222,2.6104709326021713,0.24856681189639449
1120,0.3767,0,1,0,323795,281815,14734,93222,2.6104616695690837,0.24856747467583198
1121,0.3768,0,6,0,323801,281809,14734,93222,2.6104060913705585,0.24857145142668205
1122,0.3769,0,1,0,323802,281808,14734,93222,2.6103968283374708,0.24857211423086154
1123,0.377,2,15,2,323817,281793,14736,93220,2.6102578828411573,0.24857804929429114
1124,0.3771,0,1,0,323818,281792,14736,93220,2.61024861980807,0.24857871214787794
1125,0.3773,1,0,1,323818,281792,14737,93219,2.61024861980807,0.2485767084165531
1126,0.3774,10,139,10,323957,281653,14747,93209,2.6089610582089,0.24864883610501998
1127,0.3775,0,1,0,323958,281652,14747,93209,2.6089517951758125,0.2486494994144496
1128,0.3777,4,16,4,323974,281636,14751,93205,2.6088035866464114,0.24865209515501238
1129,0.3779,1,25,1,323999,281611,14752,93204,2.6085720108192225,0.2486666755599429
1130,0.3781,1,4,1,324003,281607,14753,93203,2.6085349586868722,0.24866732477788747
1131,0.3784,0,3,0,324006,281604,14753,93203,2.6085071695876096,0.24866931514085916
1132,0.3785,40,329,40,324335,281275,14793,93163,2.6054596317018044,0.24880754624263562
1133,0.3786,0,6,0,324341,281269,14793,93163,2.605404053503279,0.2488115332022904
1134,0.3788,0,5,0,324346,281264,14793,93163,2.6053577383378412,0.24881485576627754
1135,0.3789,4,40,4,324386,281224,14797,93159,2.6049872170143393,0.24883341391035382
1136,0.379,0,2,0,324388,281222,14797,93159,2.604968690948164,0.24883474321613544
1137,0.3792,11,143,11,324531,281079,14808,93148,2.603644077216644,0.24890774850558617
1138,0.3793,0,5,0,324536,281074,14808,93148,2.603597762051206,0.2489110741752222
1139,0.3794,4,52,4,324588,281022,14812,93144,2.603116084330653,0.24893763730536714
1140,0.3796,6,18,6,324606,281004,14818,93138,2.602949349735077,0.24893756915823403
1141,0.3797,1,8,1,324614,280996,14819,93137,2.602875245470377,0.24894088465866415
1142,0.3798,0,1,0,324615,280995,14819,93137,2.6028659824372893,0.24894155004116195
1143,0.38,1049,10750,1049,335365,270245,15868,92088,2.503288376746082,0.2541529477028038
1144,0.3805,0,1,0,335366,270244,15868,92088,2.503279113712994,0.25415364913946326
1145,0.3814,0,1,0,335367,270243,15868,92088,2.5032698506799065,0.2541543505799945
1146,0.3815,0,1,0,335368,270242,15868,92088,2.5032605876468192,0.25415505202439764
1147,0.3822,0,1,0,335369,270241,15868,92088,2.5032513246137316,0.2541557534726726
1148,0.3824,1,0,1,335369,270241,15869,92087,2.5032513246137316,0.25415369499459056
1149,0.383,0,1,0,335370,270240,15869,92087,2.503242061580644,0.2541543964429921
1150,0.3832,0,2,0,335372,270238,15869,92087,2.503223535514469,0.254155799351411
1151,0.3837,0,1,0,335373,270237,15869,92087,2.5032142724813813,0.25415650081142843
1152,0.384,0,1,0,335374,270236,15869,92087,2.5032050094482936,0.2541572022753179
1153,0.3841,0,1,0,335375,270235,15869,92087,2.5031957464152064,0.25415790374307934
1154,0.3842,0,2,0,335377,270233,15869,92087,2.503177220349031,0.2541593066902186
1155,0.3843,0,1,0,335378,270232,15869,92087,2.5031679573159433,0.2541600081695964
1156,0.3845,0,1,0,335379,270231,15869,92087,2.503158694282856,0.2541607096528464
1157,0.3846,0,1,0,335380,270230,15869,92087,2.5031494312497684,0.2541614111399686
1158,0.3847,0,5,0,335385,270225,15869,92087,2.5031031160843304,0.2541649186336638
1159,0.3848,0,2,0,335387,270223,15869,92087,2.5030845900181555,0.2541663216582485
1160,0.385,2,6,2,335393,270217,15871,92085,2.5030290118196303,0.25416641365490666
1161,0.3853,0,1,0,335394,270216,15871,92085,2.5030197487865427,0.2541671151887519
1162,0.3854,0,1,0,335395,270215,15871,92085,2.503010485753455,0.25416781672646976
1163,0.3855,1,0,1,335395,270215,15872,92084,2.503010485753455,0.2541657581169145
1164,0.3857,0,1,0,335396,270214,15872,92084,2.5030012227203677,0.25416645965475937
1165,0.3858,1,11,1,335407,270203,15873,92083,2.5028993293564046,0.2541721181607901
1166,0.3859,1,15,1,335422,270188,15874,92082,2.502760383860091,0.25418058354266154
1167,0.3862,1,5,1,335427,270183,15875,92081,2.502714068694653,0.25418203299251374
1168,0.3864,1,7,1,335434,270176,15876,92080,2.5026492274630403,0.25418488582659776
1169,0.3865,0,43,0,335477,270133,15876,92080,2.502250917040276,0.254215061303708
1170,0.3866,0,7,0,335484,270126,15876,92080,2.502186075808663,0.2542199742687863
1171,0.3868,0,3,0,335487,270123,15876,92080,2.5021582867094003,0.2542220798833803
1172,0.3869,1,1,1,335488,270122,15877,92079,2.5021490236763126,0.2542207227478665
1173,0.387,2,11,2,335499,270111,15879,92077,2.5020471303123495,0.2542243254884204
1174,0.3871,0,2,0,335501,270109,15879,92077,2.5020286042461746,0.2542257293213984
1175,0.3872,0,1,0,335502,270108,15879,92077,2.502019341213087,0.2542264312437014
1176,0.3874,11,144,11,335646,269964,15890,92066,2.500685464448479,0.2543048918597906
1177,0.3875,0,1,0,335647,269963,15890,92066,2.5006762014153914,0.2543055943032188
1178,0.3876,0,1,0,335648,269962,15890,92066,2.5006669383823037,0.25430629675052757
1179,0.3877,0,26,0,335674,269936,15890,92066,2.5004260995220275,0.2543245617427528
1180,0.3879,2,22,2,335696,269914,15892,92064,2.5002223127941012,0.254335898866782
1181,0.388,0,1,0,335697,269913,15892,92064,2.5002130497610136,0.25433660149678017
1182,0.3881,0,3,0,335700,269910,15892,92064,2.500185260661751,0.25433870941006814
1183,0.3882,0,2,0,335702,269908,15892,92064,2.500166734595576,0.2543401147050048
1184,0.3884,0,4,0,335706,269904,15892,92064,2.5001296824632258,0.25434292534146663
1185,0.3885,37,329,37,336035,269575,15929,92027,2.4970821445774205,0.2544980392807562
1186,0.3886,0,5,0,336040,269570,15929,92027,2.4970358294119825,0.25450155836469884
1187,0.3888,0,5,0,336045,269565,15929,92027,2.496989514246545,0.2545050775459634
1188,0.3889,2,19,2,336064,269546,15931,92025,2.4968135166178813,0.25451432775305544
1189,0.389,0,1,0,336065,269545,15931,92025,2.4968042535847936,0.25451503166745026
1190,0.3892,6,128,6,336193,269417,15937,92019,2.495618585349587,0.25459279097820914
1191,0.3893,0,3,0,336196,269414,15937,92019,2.4955907962503243,0.2545949041731109
1192,0.3894,9,52,9,336248,269362,15946,92010,2.4951091185297716,0.2546129749952957
1193,0.3896,0,18,0,336266,269344,15946,92010,2.4949423839341955,0.2546256579420734
1194,0.3897,2,2,2,336268,269342,15948,92008,2.49492385786802,0.2546229417462294
1195,0.3899,0,1,0,336269,269341,15948,92008,2.494914594834933,0.2546236463917155
1196,0.39,1062,10386,1062,346655,258955,17010,90946,2.398708733187595,0.25991923429770136
1197,0.3908,1,0,1,346655,258955,17011,90945,2.398708733187595,0.2599171191769077
1198,0.3915,0,1,0,346656,258954,17011,90945,2.3986994701545075,0.25991786201160905
1199,0.3924,0,3,0,346659,258951,17011,90945,2.398671681055245,0.25992009054118936
1200,0.3928,0,1,0,346660,258950,17011,90945,2.398662418022157,0.25992083339287503
1201,0.3931,0,1,0,346661,258949,17011,90945,2.3986531549890695,0.2599215762488068
1202,0.3932,0,1,0,346662,258948,17011,90945,2.3986438919559823,0.2599223191089847
1203,0.3933,1,0,1,346662,258948,17012,90944,2.3986438919559823,0.259920203948647
1204,0.3935,0,1,0,346663,258947,17012,90944,2.3986346289228946,0.2599209468091491
1205,0.3936,0,1,0,346664,258946,17012,90944,2.398625365889807,0.2599216896738975
1206,0.3938,0,1,0,346665,258945,17012,90944,2.3986161028567192,0.25992243254289216
1207,0.3939,0,4,0,346669,258941,17012,90944,2.3985790507243694,0.25992540406133446
1208,0.3943,0,7,0,346676,258934,17012,90944,2.3985142094927565,0.2599306043820989
1209,0.3947,0,2,0,346678,258932,17012,90944,2.398495683426581,0.2599320902262516
1210,0.3948,0,1,0,346679,258931,17012,90944,2.3984864203934935,0.2599328331546981
1211,0.395,1,4,1,346683,258927,17013,90943,2.3984493682611436,0.259933689656158
1212,0.3953,0,1,0,346684,258926,17013,90943,2.398440105228056,0.25993443260191673
1213,0.3955,0,2,0,346686,258924,17013,90943,2.3984215791618806,0.2599359185061752
1214,0.3957,0,3,0,346689,258921,17013,90943,2.398393790062618,0.2599381473944161
1215,0.3958,2,9,2,346698,258912,17015,90941,2.39831042276483,0.259940603624951
1216,0.3959,1,14,1,346712,258898,17016,90940,2.3981807403016044,0.25994889062937704
1217,0.396,0,1,0,346713,258897,17016,90940,2.3981714772685168,0.25994963368654544
1218,0.3961,0,1,0,346714,258896,17016,90940,2.398162214235429,0.2599503767479619
1219,0.3962,0,3,0,346717,258893,17016,90940,2.3981344251361665,0.2599526059576998
1220,0.3963,0,1,0,346718,258892,17016,90940,2.3981251621030792,0.2599533490361088
1221,0.3964,0,4,0,346722,258888,17016,90940,2.398088109970729,0.259956321392227
1222,0.3965,4,41,4,346763,258847,17020,90936,2.397708325614139,0.2599783294213841
1223,0.3966,0,6,0,346769,258841,17020,90936,2.3976527474156137,0.25998278903415606
1224,0.3968,0,2,0,346771,258839,17020,90936,2.397634221349439,0.25998427560574655
1225,0.3969,0,4,0,346775,258835,17020,90936,2.3975971692170885,0.25998724879992907
1226,0.397,1,19,1,346794,258816,17021,90935,2.397421171588425,0.2599992566139911
1227,0.3971,0,2,0,346796,258814,17021,90935,2.39740264552225,0.26000074339025986
1228,0.3972,0,1,0,346797,258813,17021,90935,2.3973933824891622,0.26000148678477075
1229,0.3974,15,124,15,346921,258689,17036,90920,2.3962447663863053,0.26006195492678963
1230,0.3975,0,1,0,346922,258688,17036,90920,2.396235503353218,0.26006269879407795
1231,0.3977,3,24,3,346946,258664,17039,90917,2.396013190559117,0.26007420311744633
1232,0.3979,5,23,5,346969,258641,17044,90912,2.395800140798103,0.2600807316773136
1233,0.3981,0,5,0,346974,258636,17044,90912,2.3957538256326654,0.26008445192076624
1234,0.3982,0,3,0,346977,258633,17044,90912,2.3957260365334023,0.26008668411792474
1235,0.3984,0,2,0,346979,258631,17044,90912,2.3957075104672274,0.2600881722706505
1236,0.3985,42,331,42,347310,258300,17086,90870,2.392641446515247,0.2602457255777988
1237,0.3986,1,2,1,347312,258298,17087,90869,2.392622920449072,0.2602450976180452
1238,0.3987,0,1,0,347313,258297,17087,90869,2.392613657415984,0.2602458429514901
1239,0.3988,2,2,2,347315,258295,17089,90867,2.3925951313498093,0.2602430963277791
1240,0.3989,6,27,6,347342,258268,17095,90861,2.392345029456445,0.2602505091241346
1241,0.3991,0,1,0,347343,258267,17095,90861,2.3923357664233578,0.2602512545542036
1242,0.3992,13,158,13,347501,258109,17108,90848,2.390872207195524,0.26034153205122695
1243,0.3993,1,2,1,347503,258107,17109,90847,2.390853681129349,0.2603409045318294
1244,0.3994,3,45,3,347548,258062,17112,90844,2.390436844640409,0.26036812207299387
1245,0.3995,1,0,1,347548,258062,17113,90843,2.390436844640409,0.2603660022069045
1246,0.3996,0,19,0,347567,258043,17113,90843,2.3902608470117457,0.26038018149194864
1247,0.3997,2,8,2,347575,258035,17115,90841,2.390186742747045,0.26038191219803025
1248,0.3999,1,0,1,347575,258035,17116,90840,2.390186742747045,0.2603797921891795
1249,0.4,1149,10232,1149,357807,247803,18265,89691,2.2954073881951906,0.2657558356593006
1250,0.4005,1,0,1,357807,247803,18266,89690,2.2954073881951906,0.26575366007591267
1251,0.4029,0,1,0,357808,247802,18266,89690,2.295398125162103,0.26575444751282995
1252,0.4032,0,2,0,357810,247800,18266,89690,2.295379599095928,0.2657560224006637
1253,0.4034,0,1,0,357811,247799,18266,89690,2.2953703360628404,0.26575680985158034
1254,0.4035,0,4,0,357815,247795,18266,89690,2.29533328393049,0.2657599597019127
1255,0.4039,0,2,0,357817,247793,18266,89690,2.295314757864315,0.2657615346550789
1256,0.4042,0,2,0,357819,247791,18266,89690,2.29529623179814,0.26576310962691235
1257,0.4043,0,3,0,357822,247788,18266,89690,2.295268442698877,0.2657654721196641
1258,0.4044,1,0,1,357822,247788,18267,89689,2.295268442698877,0.2657632964616848
1259,0.4045,1,0,1,357822,247788,18268,89688,2.295268442698877,0.26576112079081177
1260,0.4047,0,2,0,357824,247786,18268,89688,2.2952499166327023,0.2657626957928611
1261,0.4048,0,1,0,357825,247785,18268,89688,2.2952406535996146,0.2657634833008863
1262,0.405,0,10,0,357835,247775,18268,89688,2.295148023268739,0.26577135863783585
1263,0.4051,0,1,0,357836,247774,18268,89688,2.2951387602356514,0.26577214619720146
1264,0.4053,1,9,1,357845,247765,18269,89687,2.2950553929378636,0.26577705866315804
1265,0.4054,0,1,0,357846,247764,18269,89687,2.295046129904776,0.2657778462650874
1266,0.4055,0,2,0,357848,247762,18269,89687,2.295027603838601,0.26577942148295003
1267,0.4057,0,4,0,357852,247758,18269,89687,2.2949905517062508,0.2657825719746922
1268,0.4058,2,8,2,357860,247750,18271,89685,2.29491644744155,0.26578452146339293
1269,0.4059,1,17,1,357877,247733,18272,89684,2.294758975879062,0.2657957364329598
1270,0.4062,0,1,0,357878,247732,18272,89684,2.294749712845974,0.26579652417194205
1271,0.4063,0,2,0,357880,247730,18272,89684,2.2947311867797993,0.2657980996639144
1272,0.4064,0,1,0,357881,247729,18272,89684,2.2947219237467116,0.2657988874169045
1273,0.4065,5,47,5,357928,247682,18277,89679,2.294286561191597,0.26582503608893737
1274,0.4066,2,2,2,357930,247680,18279,89677,2.2942680351254214,0.265822259505509
1275,0.4068,0,6,0,357936,247674,18279,89677,2.2942124569268962,0.2658269873218102
1276,0.4069,0,3,0,357939,247671,18279,89677,2.2941846678276336,0.26582935129302676
1277,0.407,2,10,2,357949,247661,18281,89675,2.2940920374967577,0.265832878791472
1278,0.4071,0,2,0,357951,247659,18281,89675,2.294073511430583,0.2658344548726188
1279,0.4073,0,1,0,357952,247658,18281,89675,2.294064248397495,0.2658352429202005
1280,0.4074,19,131,19,358083,247527,18300,89656,2.292850791063026,0.26589715377109757
1281,0.4075,1,1,1,358084,247526,18301,89655,2.292841528029938,0.2658957651824984
1282,0.4077,1,13,1,358097,247513,18302,89654,2.2927211085998,0.2659038399368859
1283,0.4079,3,32,3,358129,247481,18305,89651,2.2924246915409983,0.2659225466582822
1284,0.4081,2,6,2,358135,247475,18307,89649,2.292369113342473,0.26592292450255695
1285,0.4082,0,2,0,358137,247473,18307,89649,2.2923505872762977,0.2659245021090288
1286,0.4084,0,4,0,358141,247469,18307,89649,2.2923135351439474,0.26592765737812873
1287,0.4085,37,375,37,358516,247094,18344,89612,2.2888398977361146,0.2661431634719904
1288,0.4086,0,5,0,358521,247089,18344,89612,2.288793582570677,0.26614711569018207
1289,0.4088,0,8,0,358529,247081,18344,89612,2.2887194783059766,0.26615343948344633
1290,0.4089,2,22,2,358551,247059,18346,89610,2.2885156915780502,0.2661664721135596
1291,0.409,0,1,0,358552,247058,18346,89610,2.2885064285449626,0.26616726270391006
1292,0.4092,14,143,14,358695,246915,18360,89596,2.2871818148134424,0.26624984027268056
1293,0.4093,0,5,0,358700,246910,18360,89596,2.287135499648005,0.2662537963661866
1294,0.4094,5,60,5,358760,246850,18365,89591,2.2865797176627516,0.26629037483540946
1295,0.4096,1,22,1,358782,246828,18366,89590,2.2863759309348253,0.2663056079044522
1296,0.4097,1,7,1,358789,246821,18367,89589,2.2863110897032124,0.26630896822329897
1297,0.4098,1,1,1,358790,246820,18368,89588,2.2863018266701247,0.26630757889229745
1298,0.41,1224,10240,1224,369030,236580,19592,88364,2.19144836785357,0.2719360874489143
1299,0.4112,0,2,0,369032,236578,19592,88364,2.1914298417873947,0.27193776120046037
1300,0.4119,0,2,0,369034,236576,19592,88364,2.19141131572122,0.2719394349726103
1301,0.413,0,1,0,369035,236575,19592,88364,2.191402052688132,0.27194027186641184
1302,0.4131,0,1,0,369036,236574,19592,88364,2.1913927896550445,0.2719411087653645
1303,0.4132,0,1,0,369037,236573,19592,88364,2.1913835266219572,0.2719419456694682
1304,0.4133,0,1,0,369038,236572,19592,88364,2.1913742635888696,0.2719427825787232
1305,0.4135,0,2,0,369040,236570,19592,88364,2.1913557375226946,0.2719444564126869
1306,0.4136,0,1,0,369041,236569,19592,88364,2.191346474489607,0.2719452933373957
1307,0.4139,1,1,1,369042,236568,19593,88363,2.1913372114565193,0.27194388962579746
1308,0.4143,0,2,0,369044,236566,19593,88363,2.1913186853903444,0.2719455634923322
1309,0.4147,0,3,0,369047,236563,19593,88363,2.1912908962910818,0.2719480743307707
1310,0.4148,0,2,0,369049,236561,19593,88363,2.1912723702249064,0.2719497482488213
1311,0.415,0,3,0,369052,236558,19593,88363,2.191244581125644,0.27195225916453536
1312,0.4153,0,2,0,369054,236556,19593,88363,2.191226055059469,0.2719539331341042
1313,0.4154,0,1,0,369055,236555,19593,88363,2.191216792026381,0.27195477012661656
1314,0.4155,0,2,0,369057,236553,19593,88363,2.191198265960206,0.27195644412709746
1315,0.4157,0,1,0,369058,236552,19593,88363,2.1911890029271186,0.2719572811350661
1316,0.4158,2,9,2,369067,236543,19595,88361,2.1911056356293304,0.27196033289833305
1317,0.4159,1,12,1,369079,236531,19596,88360,2.19099447923228,0.2719681370059497
1318,0.416,0,2,0,369081,236529,19596,88360,2.1909759531661046,0.27196981122783476
1319,0.4161,1,1,1,369082,236528,19597,88359,2.1909666901330174,0.27196840747706125
1320,0.4163,1,2,1,369084,236526,19598,88358,2.190948164066842,0.27196784082934217
1321,0.4164,0,4,0,369088,236522,19598,88358,2.1909111119344917,0.27197118936222603
1322,0.4165,7,33,7,369121,236489,19605,88351,2.1906054318426027,0.2719831301563847
1323,0.4166,0,7,0,369128,236482,19605,88351,2.19054059061099,0.27198899126628145
1324,0.4168,0,2,0,369130,236480,19605,88351,2.1905220645448145,0.27199066591550686
1325,0.4169,0,6,0,369136,236474,19605,88351,2.1904664863462893,0.27199568998691603
1326,0.417,3,15,3,369151,236459,19608,88348,2.190327540849976,0.27200152706068526
1327,0.4171,0,2,0,369153,236457,19608,88348,2.190309014783801,0.2720032019211527
1328,0.4174,7,141,7,369294,236316,19615,88341,2.1890029271184557,0.27210563764218854
1329,0.4175,0,1,0,369295,236315,19615,88341,2.188993664085368,0.2721064757774383
1330,0.4177,3,6,3,369301,236309,19618,88338,2.188938085886843,0.27210477842086944
1331,0.4179,7,23,7,369324,236286,19625,88331,2.1887250361258292,0.27210836154606816
1332,0.418,0,1,0,369325,236285,19625,88331,2.1887157730927416,0.2721091997929862
1333,0.4181,0,4,0,369329,236281,19625,88331,2.1886787209603913,0.2721125528323044
1334,0.4182,0,2,0,369331,236279,19625,88331,2.1886601948942164,0.2721142293829518
1335,0.4184,0,3,0,369334,236276,19625,88331,2.1886324057949533,0.27211674424765947
1336,0.4185,30,326,30,369660,235950,19655,88301,2.1856126570084107,0.27232298435471286
1337,0.4186,0,2,0,369662,235948,19655,88301,2.1855941309422358,0.2723246640698969
1338,0.4188,0,6,0,369668,235942,19655,88301,2.1855385527437106,0.27232970333977913
1339,0.4189,2,27,2,369695,235915,19657,88299,2.1852884508503463,0.27234789367516515
1340,0.419,0,1,0,369696,235914,19657,88299,2.185279187817259,0.2723487337028435
1341,0.4192,24,149,24,369845,235765,19681,88275,2.1838989958872133,0.27242007159609927
1342,0.4193,1,3,1,369848,235762,19682,88274,2.1838712067879507,0.2724203483563555
1343,0.4194,3,61,3,369909,235701,19685,88271,2.1833061617696097,0.2724649043744521
1344,0.4195,0,1,0,369910,235700,19685,88271,2.1832968987365224,0.27246574539079116
1345,0.4196,2,14,2,369924,235686,19687,88269,2.1831672162732967,0.2724730286613882
1346,0.4197,1,7,1,369931,235679,19688,88268,2.183102375041684,0.27247667056648156
1347,0.42,1242,10092,1242,380023,225587,20930,87026,2.089619845122087,0.27838253687466613
1348,0.4212,1,0,1,380023,225587,20931,87025,2.089619845122087,0.27838022852609623
1349,0.4221,0,1,0,380024,225586,20931,87025,2.089610582088999,0.2783811190265218
1350,0.4224,0,1,0,380025,225585,20931,87025,2.0896013190559115,0.2783820095326445
1351,0.4228,0,1,0,380026,225584,20931,87025,2.0895920560228243,0.2783829000444645
1352,0.4232,0,1,0,380027,225583,20931,87025,2.0895827929897366,0.27838379056198176
1353,0.4235,1,0,1,380027,225583,20932,87024,2.0895827929897366,0.2783814821805014
1354,0.4239,0,4,0,380031,225579,20932,87024,2.0895457408573863,0.2783850442894022
1355,0.4241,0,1,0,380032,225578,20932,87024,2.0895364778242986,0.2783859348308712
1356,0.4242,0,1,0,380033,225577,20932,87024,2.0895272147912114,0.2783868253780378
1357,0.4243,1,2,1,380035,225575,20933,87023,2.089508688725036,0.2783862980569293
1358,0.4245,0,1,0,380036,225574,20933,87023,2.0894994256919484,0.2783871886166534
1359,0.4247,1,2,1,380038,225572,20934,87022,2.0894808996257734,0.2783866612922833
1360,0.4248,0,1,0,380039,225571,20934,87022,2.0894716365926858,0.2783875518645651
1361,0.425,1,6,1,380045,225565,20935,87021,2.0894160583941606,0.27839058691048224
1362,0.4253,0,8,0,380053,225557,20935,87021,2.08934195412946,0.278397711931102
1363,0.4257,0,4,0,380057,225553,20935,87021,2.0893049019971097,0.27840127457817987
1364,0.4258,1,20,1,380077,225533,20936,87020,2.0891196413353588,0.2784167805140248
1365,0.4259,0,12,0,380089,225521,20936,87020,2.0890084849383084,0.27842747031589454
1366,0.4261,1,0,1,380089,225521,20937,87019,2.0890084849383084,0.27842516157931785
1367,0.4262,0,1,0,380090,225520,20937,87019,2.0889992219052207,0.2784260524286569
1368,0.4263,0,4,0,380094,225516,20937,87019,2.0889621697728704,0.2784296158830211
1369,0.4264,0,2,0,380096,225514,20937,87019,2.0889436437066955,0.2784313976444088
1370,0.4265,3,44,3,380140,225470,20940,87016,2.088536070250843,0.27846367517264775
1371,0.4266,1,8,1,380148,225462,20941,87015,2.0884619659861423,0.2784684952812527
1372,0.4268,0,5,0,380153,225457,20941,87015,2.088415650820705,0.2784729511764254
1373,0.4269,0,2,0,380155,225455,20941,87015,2.0883971247545294,0.27847473357442315
1374,0.427,1,21,1,380176,225434,20942,87014,2.088202601059691,0.2784911409258501
1375,0.4271,0,2,0,380178,225432,20942,87014,2.088184074993516,0.27849292357719413
1376,0.4273,0,1,0,380179,225431,20942,87014,2.088174811960428,0.2784938149114244
1377,0.4274,10,145,10,380324,225286,20952,87004,2.086831672162733,0.27860001921291105
1378,0.4277,3,16,3,380340,225270,20955,87001,2.086683463633332,0.27860736347595516
1379,0.4278,0,1,0,380341,225269,20955,87001,2.0866742006002443,0.27860825567617764
1380,0.4279,3,28,3,380369,225241,20958,86998,2.086414835673793,0.2786263086930204
1381,0.4281,1,6,1,380375,225235,20959,86997,2.0863592574752676,0.2786293525327321
1382,0.4284,0,2,0,380377,225233,20959,86997,2.0863407314090927,0.27863113730262945
1383,0.4285,48,300,48,380677,224933,21007,86949,2.083561821482826,0.2787881314086738
1384,0.4286,1,3,1,380680,224930,21008,86948,2.0835340323835636,0.2787885006316573
1385,0.4287,0,1,0,380681,224929,21008,86948,2.083524769350476,0.27878939453694884
1386,0.4288,1,5,1,380686,224924,21009,86947,2.0834784541850384,0.2787915516351312
1387,0.4289,2,25,2,380711,224899,21011,86945,2.0832468783578495,0.27880927643308834
1388,0.429,1,1,1,380712,224898,21012,86944,2.083237615324762,0.27880785782543727
1389,0.4291,0,1,0,380713,224897,21012,86944,2.0832283522916746,0.2788087518959983
1390,0.4292,11,154,11,380867,224743,21023,86933,2.081801845196191,0.27892105904849906
1391,0.4293,1,2,1,380869,224741,21024,86932,2.081783319130016,0.2789205353046302
1392,0.4294,5,37,5,380906,224704,21029,86927,2.0814405869057766,0.27894208214202054
1393,0.4296,2,19,2,380925,224685,21031,86925,2.081264589277113,0.27895446230865506
1394,0.4297,0,8,0,380933,224677,21031,86925,2.0811904850124123,0.27896162412308007
1395,0.43,1249,9494,1249,390427,215183,22280,85676,1.993247248879173,0.2847712715923406
1396,0.4302,0,1,0,390428,215182,22280,85676,1.9932379858460854,0.2847722181228354
1397,0.4319,0,1,0,390429,215181,22280,85676,1.993228722812998,0.2847731646596223
1398,0.4327,0,1,0,390430,215180,22280,85676,1.9932194597799104,0.28477411120270163
1399,0.4328,0,1,0,390431,215179,22280,85676,1.9932101967468228,0.28477505775207324
1400,0.4331,0,1,0,390432,215178,22280,85676,1.9932009337137353,0.2847760043077373
1401,0.4332,0,7,0,390439,215171,22280,85676,1.9931360924821224,0.2847826303735786
1402,0.4335,0,2,0,390441,215169,22280,85676,1.9931175664159473,0.2847845235918829
1403,0.4343,0,2,0,390443,215167,22280,85676,1.9930990403497721,0.2847864168353593
1404,0.4345,0,2,0,390445,215165,22280,85676,1.993080514283597,0.2847883101040084
1405,0.4347,0,5,0,390450,215160,22280,85676,1.9930341991181593,0.284793043385765
1406,0.4348,0,1,0,390451,215159,22280,85676,1.9930249360850716,0.28479399006099687
1407,0.435,0,8,0,390459,215151,22280,85676,1.9929508318203712,0.2848015636894295
1408,0.4351,1,1,1,390460,215150,22281,85675,1.9929415687872838,0.28480013296767226
1409,0.4353,0,4,0,390464,215146,22281,85675,1.9929045166549335,0.2848039199391
1410,0.4354,1,0,1,390464,215146,22282,85674,1.9929045166549335,0.28480154245063494
1411,0.4355,1,1,1,390465,215145,22283,85673,1.9928952536218458,0.2848001116954438
1412,0.4358,0,4,0,390469,215141,22283,85673,1.9928582014894958,0.28480389875471224
1413,0.4359,0,10,0,390479,215131,22283,85673,1.99276557115862,0.28481336684352604
1414,0.436,0,1,0,390480,215130,22283,85673,1.9927563081255326,0.28481431368703103
1415,0.4362,0,1,0,390481,215129,22283,85673,1.9927470450924452,0.28481526053683154
1416,0.4363,0,4,0,390485,215125,22283,85673,1.9927099929600949,0.2848190479989893
1417,0.4364,0,6,0,390491,215119,22283,85673,1.9926544147615695,0.28482472938110054
1418,0.4365,4,50,4,390541,215069,22287,85669,1.9921912631071919,0.28486257140767046
1419,0.4366,1,7,1,390548,215062,22288,85668,1.992126421875579,0.2848668240614505
1420,0.4368,0,3,0,390551,215059,22288,85668,1.9920986327763164,0.28486966584310686
1421,0.4369,0,3,0,390554,215056,22288,85668,1.9920708436770536,0.28487250768146205
1422,0.437,1,16,1,390570,215040,22289,85667,1.9919226351476527,0.2848852870069536
1423,0.4371,0,1,0,390571,215039,22289,85667,1.9919133721145652,0.28488623439505695
1424,0.4373,0,2,0,390573,215037,22289,85667,1.99189484604839,0.2848881291901671
1425,0.4374,13,136,13,390709,214901,22302,85654,1.9906350735484828,0.2849861090316248
1426,0.4375,0,2,0,390711,214899,22302,85654,1.9906165474823077,0.2849880054432995
1427,0.4377,1,17,1,390728,214882,22303,85653,1.990459075919819,0.28500174688472224
1428,0.4379,7,27,7,390755,214855,22310,85646,1.9902089740264552,0.2850106987996712
1429,0.4381,0,5,0,390760,214850,22310,85646,1.9901626588610175,0.28501544113731964
1430,0.4384,0,3,0,390763,214847,22310,85646,1.9901348697617547,0.2850182866156616
1431,0.4385,37,337,37,391100,214510,22347,85609,1.987013227611249,0.28525018409364283
1432,0.4386,1,2,1,391102,214508,22348,85608,1.986994701545074,0.2852497034480001
1433,0.4388,1,3,1,391105,214505,22349,85607,1.9869669124458114,0.2852501732686464
1434,0.4389,9,22,9,391127,214483,22358,85598,1.986763125717885,0.2852496492613661
1435,0.439,2,3,2,391130,214480,22360,85596,1.9867353366186224,0.2852477372398992
1436,0.4392,16,119,16,391249,214361,22376,85580,1.9856330356812035,0.2853227801467622
1437,0.4393,0,1,0,391250,214360,22376,85580,1.9856237726481158,0.28532373141294926
1438,0.4394,6,46,6,391296,214314,22382,85574,1.9851976731260883,0.2853531985274502
1439,0.4396,2,10,2,391306,214304,22384,85572,1.9851050427952128,0.28535794795182007
1440,0.4397,2,7,2,391313,214297,22386,85570,1.9850402015636,0.28535984286366955
1441,0.4398,0,1,0,391314,214296,22386,85570,1.9850309385305125,0.2853607944882047
1442,0.44,1339,9377,1339,400691,204919,23725,84231,1.8981714772685168,0.2913055507522047
1443,0.4402,0,1,0,400692,204918,23725,84231,1.8981622142354293,0.2913065582104728
1444,0.4417,0,1,0,400693,204917,23725,84231,1.8981529512023416,0.2913075656757093
1445,0.442,0,1,0,400694,204916,23725,84231,1.8981436881692542,0.29130857314791436
1446,0.4424,0,2,0,400696,204914,23725,84231,1.898125162103079,0.2913105881132304
1447,0.4432,0,3,0,400699,204911,23725,84231,1.8980973730038164,0.2913136106134702
1448,0.4434,1,1,1,400700,204910,23726,84230,1.8980881099707287,0.29131216711627583
1449,0.4438,0,2,0,400702,204908,23726,84230,1.8980695839045536,0.29131418215523386
1450,0.4439,0,3,0,400705,204905,23726,84230,1.898041794805291,0.2913172047659398
1451,0.4443,2,1,2,400706,204904,23728,84228,1.8980325317722035,0.291313310183584
1452,0.4444,0,2,0,400708,204902,23728,84228,1.8980140057060284,0.29131532528620346
1453,0.4446,0,1,0,400709,204901,23728,84228,1.8980047426729407,0.29131633284796754
1454,0.4447,0,2,0,400711,204899,23728,84228,1.8979862166067658,0.29131834799240475
1455,0.4448,1,1,1,400712,204898,23729,84227,1.8979769535736781,0.2913169044530912
1456,0.445,0,5,0,400717,204893,23729,84227,1.8979306384082404,0.29132194244604315
1457,0.4451,0,1,0,400718,204892,23729,84227,1.897921375375153,0.29132295006554393
1458,0.4453,1,6,1,400724,204886,23730,84226,1.8978657971766275,0.29132654473007
1459,0.4454,1,2,1,400726,204884,23731,84225,1.8978472711104524,0.29132610883784316
1460,0.4455,1,1,1,400727,204883,23732,84224,1.897838008077365,0.2913246652623423
1461,0.4457,1,4,1,400731,204879,23733,84223,1.8978009559450146,0.2913262447163977
1462,0.4458,1,14,1,400745,204865,23734,84222,1.8976712734817889,0.2913379017389229
1463,0.4459,1,8,1,400753,204857,23735,84221,1.8975971692170885,0.2913435128235286
1464,0.446,0,1,0,400754,204856,23735,84221,1.8975879061840009,0.29134452066404454
1465,0.4461,0,1,0,400755,204855,23735,84221,1.8975786431509134,0.2913455285115333
1466,0.4463,0,1,0,400756,204854,23735,84221,1.8975693801178257,0.291346536365995
1467,0.4464,0,2,0,400758,204852,23735,84221,1.8975508540516506,0.2913485520958374
1468,0.4465,4,35,4,400793,204817,23739,84217,1.8972266478935862,0.2913740252011874
1469,0.4466,0,6,0,400799,204811,23739,84217,1.897171069695061,0.29138007390287446
1470,0.4469,0,5,0,400804,204806,23739,84217,1.8971247545296233,0.29138511467945455
1471,0.447,1,14,1,400818,204792,23740,84216,1.8969950720663975,0.29139677794386315
1472,0.4471,0,3,0,400821,204789,23740,84216,1.8969672829671347,0.29139980277157834
1473,0.4474,16,132,16,400953,204657,23756,84200,1.8957445625995777,0.29149371488314285
1474,0.4476,0,1,0,400954,204656,23756,84200,1.89573529956649,0.291494724014734
1475,0.4477,2,12,2,400966,204644,23758,84198,1.8956241431694394,0.2915019283899156
1476,0.4479,9,28,9,400994,204616,23767,84189,1.8953647782429879,0.2915081110091584
1477,0.4481,0,7,0,401001,204609,23767,84189,1.895299937011375,0.29151517669789956
1478,0.4482,0,2,0,401003,204607,23767,84189,1.8952814109451999,0.29151719552902394
1479,0.4484,0,4,0,401007,204603,23767,84189,1.8952443588128496,0.29152123327516
1480,0.4485,38,278,38,401285,204325,23805,84151,1.8926692356145096,0.29170884233003785
1481,0.4486,0,3,0,401288,204322,23805,84151,1.892641446515247,0.291711875981461
1482,0.4488,0,9,0,401297,204313,23805,84151,1.892558079217459,0.2917209773143269
1483,0.4489,4,19,4,401316,204294,23809,84147,1.8923820815887955,0.2917303712024296
1484,0.4492,12,145,12,401461,204149,23821,84135,1.8910389417911,0.2918476224833844
1485,0.4493,1,4,1,401465,204145,23822,84134,1.89100188965875,0.29184921551691245
1486,0.4494,4,38,4,401503,204107,23826,84130,1.8906498944014227,0.29187786439631275
1487,0.4496,3,11,3,401514,204096,23829,84127,1.8905480010374598,0.29188163331864564
1488,0.4497,1,4,1,401518,204092,23830,84126,1.8905109489051095,0.29188322727935107
1489,0.45,1394,9184,1394,410702,194908,25224,82732,1.8054392530290118,0.2979829995677856
1490,0.4509,0,1,0,410703,194907,25224,82732,1.8054299899959243,0.29798407284279227
1491,0.4519,0,1,0,410704,194906,25224,82732,1.8054207269628366,0.29798514612553034
1492,0.452,0,1,0,410705,194905,25224,82732,1.8054114639297492,0.297986219416
1493,0.4524,0,1,0,410706,194904,25224,82732,1.8054022008966617,0.2979872927142013
1494,0.4532,1,0,1,410706,194904,25225,82731,1.8054022008966617,0.2979847641687828
1495,0.4535,0,1,0,410707,194903,25225,82731,1.805392937863574,0.2979858374694742
1496,0.4539,1,3,1,410710,194900,25226,82730,1.8053651487643114,0.2979865288333393
1497,0.4541,0,1,0,410711,194899,25226,82730,1.8053558857312237,0.29798760215971676
1498,0.4543,1,4,1,410715,194895,25227,82729,1.8053188335988737,0.29798936691352335
1499,0.4544,0,1,0,410716,194894,25227,82729,1.805309570565786,0.2979904402733203
1500,0.4546,0,1,0,410717,194893,25227,82729,1.8053003075326985,0.2979915136408498
1501,0.4547,0,1,0,410718,194892,25227,82729,1.8052910444996109,0.2979925870161119
1502,0.4548,0,1,0,410719,194891,25227,82729,1.8052817814665234,0.2979936603991067
1503,0.455,0,8,0,410727,194883,25227,82729,1.805207677201823,0.2980022477414521
1504,0.4553,1,5,1,410732,194878,25228,82728,1.805161362036385,0.298005086345396
1505,0.4554,0,2,0,410734,194876,25228,82728,1.8051428359702102,0.2980072333251682
1506,0.4555,0,2,0,410736,194874,25228,82728,1.805124309904035,0.29800938033587654
1507,0.4557,0,2,0,410738,194872,25228,82728,1.80510578383786,0.2980115273775216
1508,0.4558,2,19,2,410757,194853,25230,82726,1.8049297862091964,0.29802686802675993
1509,0.4559,2,16,2,410773,194837,25232,82724,1.8047815776797955,0.2980389896275053
1510,0.4562,0,1,0,410774,194836,25232,82724,1.8047723146467078,0.29804006340971323
1511,0.4564,1,2,1,410776,194834,25233,82723,1.8047537885805327,0.29803968193920527
1512,0.4565,4,52,4,410828,194782,25237,82719,1.80427211085998,0.2980854123048205
1513,0.4566,1,7,1,410835,194775,25238,82718,1.804207269628367,0.2980904022804179
1514,0.4567,0,1,0,410836,194774,25238,82718,1.8041980065952796,0.29809147651103457
1515,0.4568,1,3,1,410839,194771,25239,82717,1.8041702174960168,0.2980921697514847
1516,0.4569,2,1,2,410840,194770,25241,82715,1.8041609544629293,0.29808818494693406
1517,0.457,1,22,1,410862,194748,25242,82714,1.8039571677350033,0.29810929064160135
1518,0.4571,0,1,0,410863,194747,25242,82714,1.8039479047019156,0.2981103650603148
1519,0.4573,0,1,0,410864,194746,25242,82714,1.8039386416688281,0.2981114394867729
1520,0.4574,12,107,12,410971,194639,25254,82702,1.8029474971284598,0.29819608352172955
1521,0.4577,1,9,1,410980,194630,25255,82701,1.8028641298306718,0.298203230075253
1522,0.4578,0,1,0,410981,194629,25255,82701,1.802854866797584,0.2982043053402084
1523,0.4579,3,34,3,411015,194595,25258,82698,1.8025399236726074,0.2982332767145222
1524,0.458,0,1,0,411016,194594,25258,82698,1.8025306606395197,0.2982343522351889
1525,0.4581,0,5,0,411021,194589,25258,82698,1.802484345474082,0.2982397299548843
1526,0.4583,0,1,0,411022,194588,25258,82698,1.8024750824409945,0.2982408055220963
1527,0.4584,1,2,1,411024,194586,25259,82697,1.8024565563748194,0.29824042584651783
1528,0.4585,42,299,42,411323,194287,25301,82655,1.7996869094816406,0.2984559943959385
1529,0.4586,0,4,0,411327,194283,25301,82655,1.7996498573492905,0.2984603051946645
1530,0.4588,0,5,0,411332,194278,25301,82655,1.7996035421838528,0.29846569386819194
1531,0.4589,5,25,5,411357,194253,25306,82650,1.7993719663566639,0.29847997313138536
1532,0.459,0,2,0,411359,194251,25306,82650,1.7993534402904887,0.2984821289919502
1533,0.4591,0,1,0,411360,194250,25306,82650,1.7993441772574013,0.29848320693391117
1534,0.4592,19,122,19,411482,194128,25325,82631,1.7982140872207195,0.2985666229463179
1535,0.4593,0,4,0,411486,194124,25325,82631,1.7981770350883692,0.2985709381944319
1536,0.4594,9,49,9,411535,194075,25334,82622,1.797723146467079,0.29860099675818674
1537,0.4596,0,20,0,411555,194055,25334,82622,1.7975378858053281,0.29862258156623067
1538,0.4597,0,6,0,411561,194049,25334,82622,1.7974823076068027,0.29862905761716985
1539,0.46,1359,9100,1359,420661,184949,26693,81263,1.7131887065100597,0.3052567126951452
1540,0.4601,0,1,0,420662,184948,26693,81263,1.713179443476972,0.3052578593671937
1541,0.4602,0,1,0,420663,184947,26693,81263,1.7131701804438846,0.30525900604785694
1542,0.4622,0,1,0,420664,184946,26693,81263,1.713160917410797,0.3052601527371351
1543,0.4626,1,0,1,420664,184946,26694,81262,1.713160917410797,0.3052575429739151
1544,0.4628,1,1,1,420665,184945,26695,81261,1.7131516543777094,0.30525607987798925
1545,0.4632,0,1,0,420666,184944,26695,81261,1.713142391344622,0.3052572265735054
1546,0.4634,0,1,0,420667,184943,26695,81261,1.7131331283115343,0.3052583732776367
1547,0.4635,0,1,0,420668,184942,26695,81261,1.7131238652784468,0.30525951999038325
1548,0.4636,0,1,0,420669,184941,26695,81261,1.7131146022453592,0.30526066671174523
1549,0.4638,1,1,1,420670,184940,26696,81260,1.7131053392122717,0.30525920360631104
1550,0.4639,0,1,0,420671,184939,26696,81260,1.713096076179184,0.30526035033940774
1551,0.4642,0,2,0,420673,184937,26696,81260,1.713077550113009,0.30526264383144813
1552,0.4643,0,3,0,420676,184934,26696,81260,1.7130497610137463,0.30526608413412776
1553,0.4647,1,2,1,420678,184932,26697,81259,1.7130312349475711,0.30526576781333703
1554,0.4649,1,1,1,420679,184931,26698,81258,1.7130219719144837,0.3052643046857684
1555,0.465,2,8,2,420687,184923,26700,81256,1.7129478676497834,0.30526825932924834
1556,0.4653,1,7,1,420694,184916,26701,81255,1.7128830264181705,0.3052736774479564
1557,0.4654,1,1,1,420695,184915,26702,81254,1.7128737633850828,0.30527221426988116
1558,0.4655,0,1,0,420696,184914,26702,81254,1.7128645003519953,0.3052733611854167
1559,0.4656,0,1,0,420697,184913,26702,81254,1.7128552373189077,0.3052745081095703
1560,0.4657,0,1,0,420698,184912,26702,81254,1.7128459742858202,0.305275655042342
1561,0.4658,0,9,0,420707,184903,26702,81254,1.7127626069880322,0.30528597782511824
1562,0.4659,1,15,1,420722,184888,26703,81253,1.7126236614917187,0.30530057375601655
1563,0.466,0,1,0,420723,184887,26703,81253,1.7126143984586313,0.30530172089877505
1564,0.4662,0,3,0,420726,184884,26703,81253,1.7125866093593687,0.30530516237877486
1565,0.4664,1,4,1,420730,184880,26704,81252,1.7125495572270184,0.3053071408173388
1566,0.4665,12,44,12,420774,184836,26716,81240,1.712141983771166,0.3053262977495152
1567,0.4666,1,7,1,420781,184829,26717,81239,1.7120771425395531,0.3053317197107506
1568,0.4668,0,3,0,420784,184826,26717,81239,1.7120493534402905,0.30533516246030107
1569,0.4669,0,3,0,420787,184823,26717,81239,1.712021564341028,0.3053386052874894
1570,0.467,3,16,3,420803,184807,26720,81236,1.711873355811627,0.30534913529015983
1571,0.4671,1,1,1,420804,184806,26721,81235,1.7118640927785393,0.3053476719753722
1572,0.4672,0,1,0,420805,184805,26721,81235,1.711854829745452,0.3053488197263569
1573,0.4673,0,3,0,420808,184802,26721,81235,1.7118270406461893,0.30535226303108215
1574,0.4674,17,113,17,420921,184689,26738,81218,1.7107803179072956,0.3054376154068904
1575,0.4677,1,11,1,420932,184678,26739,81217,1.7106784245433324,0.305447639105662
1576,0.4679,3,24,3,420956,184654,26742,81214,1.7104561117492312,0.30546737478748853
1577,0.468,0,3,0,420959,184651,26742,81214,1.7104283226499686,0.3054708216576082
1578,0.4681,0,8,0,420967,184643,26742,81214,1.710354218385268,0.305480013691571
1579,0.4682,0,1,0,420968,184642,26742,81214,1.7103449553521806,0.30548116273471354
1580,0.4684,0,10,0,420978,184632,26742,81214,1.710252325021305,0.30549265364158196
1581,0.4685,41,268,41,421246,184364,26783,81173,1.7077698321538404,0.3056937451277976
1582,0.4686,0,2,0,421248,184362,26783,81173,1.7077513060876655,0.305696047602011
1583,0.4688,1,5,1,421253,184357,26784,81172,1.7077049909222275,0.3056991891657785
1584,0.4689,3,31,3,421284,184326,26787,81169,1.7074178368965134,0.3057270381739769
1585,0.469,0,1,0,421285,184325,26787,81169,1.707408573863426,0.3057281897142685
1586,0.4691,0,1,0,421286,184324,26787,81169,1.7073993108303382,0.3057293412632348
1587,0.4692,14,139,14,421425,184185,26801,81155,1.7061117492311682,0.3058528680183915
1588,0.4693,0,5,0,421430,184180,26801,81155,1.7060654340657304,0.30585863154125914
1589,0.4694,6,55,6,421485,184125,26807,81149,1.705555967245915,0.3059063458914179
1590,0.4696,1,12,1,421497,184113,26808,81148,1.7054448108488645,0.3059175679802157
1591,0.4697,2,2,2,421499,184111,26810,81146,1.7054262847826893,0.30591464127242635
1592,0.47,1472,8793,1472,430292,175318,28282,79674,1.6239764348438253,0.31245686139172996
1593,0.4713,0,2,0,430294,175316,28282,79674,1.6239579087776501,0.3124593121298874
1594,0.4717,0,1,0,430295,175315,28282,79674,1.6239486457445627,0.31246053751338293
1595,0.472,1,0,1,430295,175315,28283,79673,1.6239486457445627,0.31245784115330916
1596,0.4723,0,1,0,430296,175314,28283,79673,1.623939382711475,0.31245906654064715
1597,0.4725,0,2,0,430298,175312,28283,79673,1.6239208566452998,0.3124615173441575
1598,0.4727,0,1,0,430299,175311,28283,79673,1.6239115936122124,0.31246274276033004
1599,0.4728,0,1,0,430300,175310,28283,79673,1.623902330579125,0.3124639681861144
1600,0.4729,0,1,0,430301,175309,28283,79673,1.6238930675460372,0.31246519362151054
1601,0.473,0,1,0,430302,175308,28283,79673,1.6238838045129498,0.3124664190665187
1602,0.4732,0,1,0,430303,175307,28283,79673,1.623874541479862,0.3124676445211389
1603,0.4735,0,1,0,430304,175306,28283,79673,1.6238652784467746,0.3124688699853713
1604,0.4738,0,1,0,430305,175305,28283,79673,1.623856015413687,0.3124700954592161
1605,0.4739,0,1,0,430306,175304,28283,79673,1.6238467523805995,0.31247132094267327
1606,0.4743,2,3,2,430309,175301,28285,79671,1.623818963281337,0.31246960450559275
1607,0.4746,0,1,0,430310,175300,28285,79671,1.6238097002482492,0.3124708300159626
1608,0.4747,1,1,1,430311,175299,28286,79670,1.6238004372151618,0.3124693590201162
1609,0.4748,0,1,0,430312,175298,28286,79670,1.623791174182074,0.3124705845439428
1610,0.4749,1,1,1,430313,175297,28287,79669,1.6237819111489866,0.3124691135288627
1611,0.475,1,4,1,430317,175293,28288,79668,1.6237448590166363,0.31247131914292775
1612,0.4751,0,2,0,430319,175291,28288,79668,1.6237263329504612,0.3124737702924784
1613,0.4752,1,0,1,430319,175291,28289,79667,1.6237263329504612,0.31247107366703536
1614,0.4753,0,3,0,430322,175288,28289,79667,1.6236985438511986,0.3124747504461572
1615,0.4755,1,2,1,430324,175286,28290,79666,1.6236800177850235,0.3124745050048637
1616,0.4757,0,4,0,430328,175282,28290,79666,1.6236429656526734,0.31247940756546433
1617,0.4758,1,10,1,430338,175272,28291,79665,1.6235503353217977,0.3124889678626484
1618,0.4759,1,9,1,430347,175263,28292,79664,1.6234669680240097,0.31249730314952906
1619,0.476,0,1,0,430348,175262,28292,79664,1.6234577049909222,0.3124985289848819
1620,0.4762,1,5,1,430353,175257,28293,79663,1.6234113898254845,0.3125019613996548
1621,0.4763,1,0,1,430353,175257,28294,79662,1.6234113898254845,0.31249926447224413
1622,0.4764,1,2,1,430355,175255,28295,79661,1.6233928637593094,0.312499019284784
1623,0.4765,6,47,6,430402,175208,28301,79655,1.6229575012041944,0.31254046291537024
1624,0.4766,1,5,1,430407,175203,28302,79654,1.6229111860387566,0.3125438971658616
1625,0.4769,1,2,1,430409,175201,28303,79653,1.6228926599725815,0.3125436524441445
1626,0.477,2,17,2,430426,175184,28305,79651,1.622735188410093,0.31255910687307475
1627,0.4771,0,2,0,430428,175182,28305,79651,1.622716662343918,0.3125615599235578
1628,0.4773,0,1,0,430429,175181,28305,79651,1.6227073993108303,0.31256278646323854
1629,0.4774,22,118,22,430547,175063,28327,79629,1.6216143614064988,0.3126482182400704
1630,0.4775,0,2,0,430549,175061,28327,79629,1.621595835340324,0.31265067336762337
1631,0.4777,2,18,2,430567,175043,28329,79627,1.6214291007447479,0.3126673734636981
1632,0.4779,7,17,7,430584,175026,28336,79620,1.6212716291822595,0.3126693527485215
1633,0.4781,1,7,1,430591,175019,28337,79619,1.6212067879506467,0.31267524878454905
1634,0.4783,0,1,0,430592,175018,28337,79619,1.621197524917559,0.3126764767099832
1635,0.4784,0,5,0,430597,175013,28337,79619,1.6211512097521212,0.31268261648182477
1636,0.4785,39,294,39,430891,174719,28376,79580,1.6184278780243804,0.3129387060114275
1637,0.4786,0,1,0,430892,174718,28376,79580,1.6184186149912927,0.31293993660980424
1638,0.4788,1,2,1,430894,174716,28377,79579,1.6184000889251176,0.3129396960223363
1639,0.4789,5,22,5,430916,174694,28382,79574,1.6181963021971915,0.3129532619126276
1640,0.479,2,0,2,430916,174694,28384,79572,1.6181963021971915,0.3129478577552642
1641,0.4792,22,108,22,431024,174586,28406,79550,1.6171958946237357,0.31302137438222055
1642,0.4793,2,7,2,431031,174579,28408,79548,1.6171310533921228,0.31302459006717115
1643,0.4794,7,50,7,431081,174529,28415,79541,1.616667901737745,0.3130672649269886
1644,0.4796,0,11,0,431092,174518,28415,79541,1.6165660083737818,0.3130808198095718
1645,0.4797,1,7,1,431099,174511,28416,79540,1.616501167142169,0.3130867424257334
1646,0.4798,0,2,0,431101,174509,28416,79540,1.6164826410759938,0.3130892072001858
1647,0.48,1473,8415,1473,439516,166094,29889,78067,1.5385342176442254,0.3197357481334038
1648,0.4815,0,1,0,439517,166093,29889,78067,1.538524954611138,0.31973705766710353
1649,0.4817,0,1,0,439518,166092,29889,78067,1.5385156915780502,0.3197383672115302
1650,0.4824,1,1,1,439519,166091,29890,78066,1.5385064285449628,0.31973689060727317
1651,0.4828,0,1,0,439520,166090,29890,78066,1.538497165511875,0.3197382001671063
1652,0.4832,0,3,0,439523,166087,29890,78066,1.5384693764126125,0.31974212891096976
1653,0.4835,0,3,0,439526,166084,29890,78066,1.53844158731335,0.3197460577513824
1654,0.4837,1,0,1,439526,166084,29891,78065,1.53844158731335,0.31974327152681353
1655,0.4838,1,0,1,439526,166084,29892,78064,1.53844158731335,0.31974048527942067
1656,0.4839,0,1,0,439527,166083,29892,78064,1.5384323242802622,0.3197417949022515
1657,0.4843,0,2,0,439529,166081,29892,78064,1.5384137982140873,0.3197444141800979
1658,0.4846,1,1,1,439530,166080,29893,78063,1.5384045351809996,0.3197429375407036
1659,0.4847,0,4,0,439534,166076,29893,78063,1.5383674830486493,0.3197481762438611
1660,0.4848,0,2,0,439536,166074,29893,78063,1.5383489569824744,0.31975079565981396
1661,0.4849,0,1,0,439537,166073,29893,78063,1.5383396939493867,0.3197521053838844
1662,0.485,1,4,1,439541,166069,29894,78062,1.5383026418170365,0.31975455800369473
1663,0.4853,0,2,0,439543,166067,29894,78062,1.5382841157508615,0.3197571775577666
1664,0.4854,0,1,0,439544,166066,29894,78062,1.5382748527177739,0.3197584873508979
1665,0.4855,0,3,0,439547,166063,29894,78062,1.5382470636185113,0.3197624167946749
1666,0.4856,1,0,1,439547,166063,29895,78061,1.5382470636185113,0.31975963035178845
1667,0.4857,1,2,1,439549,166061,29896,78060,1.5382285375523361,0.31975946354471757
1668,0.4858,1,5,1,439554,166056,29897,78059,1.5381822223868984,0.3197632263482375
1669,0.4859,2,13,2,439567,166043,29899,78057,1.53806180295676,0.3197746825071692
1670,0.4862,0,1,0,439568,166042,29899,78057,1.5380525399236726,0.319775992527622
1671,0.4863,0,2,0,439570,166040,29899,78057,1.5380340138574975,0.3197786126007284
1672,0.4864,1,4,1,439574,166036,29900,78056,1.5379969617251472,0.31978106615538404
1673,0.4865,7,36,7,439610,166000,29907,78049,1.5376634925339954,0.31980872693598417
1674,0.4866,2,3,2,439613,165997,29909,78047,1.5376357034347328,0.3198070839684647
1675,0.4867,0,3,0,439616,165994,29909,78047,1.53760791433547,0.31981101536217277
1676,0.4868,1,1,1,439617,165993,29910,78046,1.5375986513023825,0.3198095386393158
1677,0.4869,0,5,0,439622,165988,29910,78046,1.5375523361369448,0.3198160912004065
1678,0.487,3,19,3,439641,165969,29913,78043,1.5373763385082813,0.319832631182073
1679,0.4871,0,2,0,439643,165967,29913,78043,1.5373578124421061,0.31983525265357976
1680,0.4874,25,123,25,439766,165844,29938,78018,1.536218459372337,0.31992684387071374
1681,0.4877,1,14,1,439780,165830,29939,78017,1.5360887769091112,0.31994242291272806
1682,0.4879,1,19,1,439799,165811,29940,78016,1.5359127792804477,0.31996456503996684
1683,0.488,0,1,0,439800,165810,29940,78016,1.53590351624736,0.31996587730594767
1684,0.4881,1,3,1,439803,165807,29941,78015,1.5358757271480974,0.3199670251248862
1685,0.4884,0,4,0,439807,165803,29941,78015,1.5358386750157471,0.31997227440139775
1686,0.4885,42,304,42,440111,165499,29983,77973,1.5330227129571308,0.32025448511533156
1687,0.4886,0,1,0,440112,165498,29983,77973,1.533013449924043,0.32025580048547875
1688,0.4887,0,1,0,440113,165497,29983,77973,1.5330041868909556,0.3202571158664312
1689,0.4888,0,1,0,440114,165496,29983,77973,1.532994923857868,0.3202584312581889
1690,0.4889,3,27,3,440141,165469,29986,77970,1.5327448219645041,0.3202855746203361
1691,0.489,0,2,0,440143,165467,29986,77970,1.532726295898329,0.3202882059834783
1692,0.4891,0,1,0,440144,165466,29986,77970,1.5327170328652413,0.32028952168126323
1693,0.4892,19,129,19,440273,165337,30005,77951,1.531522101596947,0.3204062674690079
1694,0.4893,0,4,0,440277,165333,30005,77951,1.5314850494645966,0.3204115354893869
1695,0.4894,6,39,6,440316,165294,30011,77945,1.5311237911741822,0.32044614556053924
1696,0.4896,3,15,3,440331,165279,30014,77942,1.5309848456778687,0.3204575262826812
1697,0.4897,0,6,0,440337,165273,30014,77942,1.5309292674793433,0.3204654318195835
1698,0.4898,0,1,0,440338,165272,30014,77942,1.5309200044462559,0.32046674944698905
1699,0.49,1486,8287,1486,448625,156985,31500,76456,1.4541572492496944,0.3275174455215665
1700,0.4905,0,2,0,448627,156983,31500,76456,1.4541387231835192,0.3275202515432297
1701,0.4907,0,2,0,448629,156981,31500,76456,1.454120197117344,0.3275230576129748
1702,0.4909,0,1,0,448630,156980,31500,76456,1.4541109340842566,0.3275244606658784
1703,0.491,0,2,0,448632,156978,31500,76456,1.4540924080180815,0.32752726680774863
1704,0.4914,0,1,0,448633,156977,31500,76456,1.4540831449849938,0.32752866989671553
1705,0.4915,1,0,1,448633,156977,31501,76455,1.4540831449849938,0.327525789094897
1706,0.4924,0,1,0,448634,156976,31501,76455,1.4540738819519063,0.32752719218955495
1707,0.4928,0,1,0,448635,156975,31501,76455,1.4540646189188189,0.3275285952962344
1708,0.4929,0,1,0,448636,156974,31501,76455,1.4540553558857312,0.3275299984149356
1709,0.493,0,1,0,448637,156973,31501,76455,1.4540460928526437,0.32753140154565863
1710,0.4931,0,1,0,448638,156972,31501,76455,1.454036829819556,0.3275328046884037
1711,0.4932,0,1,0,448639,156971,31501,76455,1.4540275667864686,0.32753420784317083
1712,0.4934,0,1,0,448640,156970,31501,76455,1.454018303753381,0.32753561100996037
1713,0.4935,0,1,0,448641,156969,31501,76455,1.4540090407202935,0.32753701418877235
1714,0.4938,1,1,1,448642,156968,31502,76454,1.453999777687206,0.3275355364961315
1715,0.4939,0,2,0,448644,156966,31502,76454,1.4539812516210309,0.32753834290120815
1716,0.4942,0,1,0,448645,156965,31502,76454,1.4539719885879432,0.327539746121781
1717,0.4943,1,6,1,448651,156959,31503,76453,1.453916410389418,0.3275452847325759
1718,0.4944,0,1,0,448652,156958,31503,76453,1.4539071473563303,0.32754668803098397
1719,0.4947,0,3,0,448655,156955,31503,76453,1.4538793582570677,0.3275508979983548
1720,0.4948,0,1,0,448656,156954,31503,76453,1.45387009522398,0.32755230134486113
1721,0.495,1,2,1,448658,156952,31504,76452,1.4538515691578051,0.3275522270398108
1722,0.4953,1,6,1,448664,156946,31505,76451,1.4537959909592797,0.3275577663808875
1723,0.4955,1,1,1,448665,156945,31506,76450,1.4537867279261922,0.3275562886951306
1724,0.4957,0,2,0,448667,156943,31506,76450,1.453768201860017,0.32755909560269586
1725,0.4958,2,12,2,448679,156931,31508,76448,1.4536570454629665,0.32757017555135637
1726,0.4959,2,11,2,448690,156920,31510,76446,1.4535551520990033,0.3275798531062794
1727,0.496,0,2,0,448692,156918,31510,76446,1.4535366260328282,0.3275826605646115
1728,0.4962,1,1,1,448693,156917,31511,76445,1.4535273629997407,0.3275811828832458
1729,0.4963,0,3,0,448696,156914,31511,76445,1.453499573900478,0.327585394178069
1730,0.4964,0,3,0,448699,156911,31511,76445,1.4534717848012153,0.3275896055811721
1731,0.4965,3,47,3,448746,156864,31514,76442,1.4530364222461003,0.32764695292877166
1732,0.4966,2,4,2,448750,156860,31516,76440,1.45299937011375,0.3276468066866695
1733,0.4969,1,2,1,448752,156858,31517,76439,1.4529808440475749,0.3276467335627976
1734,0.497,3,20,3,448772,156838,31520,76436,1.452795583385824,0.32766617797096975
1735,0.4974,19,133,19,448905,156705,31539,76417,1.4515635999851793,0.32779832019286037
1736,0.4977,3,8,3,448913,156697,31542,76414,1.4514894957204787,0.3278009188755571
1737,0.4979,2,30,2,448943,156667,31544,76412,1.451211604727852,0.32783734270354686
1738,0.4981,1,2,1,448945,156665,31545,76411,1.451193078661677,0.3278372719627933
1739,0.4982,0,1,0,448946,156664,31545,76411,1.4511838156285894,0.32783867853695164
1740,0.4984,0,2,0,448948,156662,31545,76411,1.4511652895624143,0.3278414917214778
1741,0.4985,39,266,39,449214,156396,31584,76372,1.448701322761125,0.32810351938410776
1742,0.4986,0,4,0,449218,156392,31584,76372,1.4486642706287747,0.3281091577735389
1743,0.4988,0,3,0,449221,156389,31584,76372,1.448636481529512,0.3281133866927879
1744,0.4989,1,20,1,449241,156369,31585,76371,1.448451220867761,0.3281386955400877
1745,0.499,0,1,0,449242,156368,31585,76371,1.4484419578346734,0.32814010543999933
1746,0.4992,22,106,22,449348,156262,31607,76349,1.4474600763273926,0.32822609420878635
1747,0.4994,11,51,11,449399,156211,31618,76338,1.4469876616399273,0.32826630086562403
1748,0.4996,0,10,0,449409,156201,31618,76338,1.4468950313090518,0.32828041747835845
1749,0.4997,2,8,2,449417,156193,31620,76336,1.4468209270443515,0.3282859342275587
1750,0.5,1581,7884,1581,457301,148309,33201,74755,1.373791174182074,0.3351280350034071
1751,0.5002,0,1,0,457302,148308,33201,74755,1.3737819111489866,0.335129537395265
1752,0.5009,0,1,0,457303,148307,33201,74755,1.3737726481158992,0.33513103980059356
1753,0.5012,0,1,0,457304,148306,33201,74755,1.3737633850828115,0.3351325422193929
1754,0.5024,0,1,0,457305,148305,33201,74755,1.373754122049724,0.33513404465166324
1755,0.5029,0,3,0,457308,148302,33201,74755,1.3737263329504612,0.33513855202930193
1756,0.5035,0,1,0,457309,148301,33201,74755,1.3737170699173737,0.335140054515458
1757,0.5038,0,2,0,457311,148299,33201,74755,1.3736985438511986,0.335143059528186
1758,0.5039,0,1,0,457312,148298,33201,74755,1.3736892808181111,0.3351445620547583
1759,0.5041,0,2,0,457314,148296,33201,74755,1.373670754751936,0.33514756714832034
1760,0.5043,0,2,0,457316,148294,33201,74755,1.3736522286857609,0.33515057229577355
1761,0.5044,0,1,0,457317,148293,33201,74755,1.3736429656526734,0.33515207488970983
1762,0.5047,2,4,2,457321,148289,33203,74753,1.3736059135203231,0.33515212381524556
1763,0.505,1,8,1,457329,148281,33204,74752,1.3735318092556226,0.3351611644913533
1764,0.5053,0,3,0,457332,148278,33204,74752,1.37350402015636,0.3351656727794467
1765,0.5055,0,2,0,457334,148276,33204,74752,1.3734854940901848,0.3351686783722223
1766,0.5057,0,5,0,457339,148271,33204,74752,1.373439178924747,0.3351761925900019
1767,0.5058,1,6,1,457345,148265,33205,74751,1.373383600726222,0.3351822290777343
1768,0.5059,0,11,0,457356,148254,33205,74751,1.3732817073622587,0.33519876235958834
1769,0.5062,0,4,0,457360,148250,33205,74751,1.3732446552299085,0.3352047748664804
1770,0.5063,0,5,0,457365,148245,33205,74751,1.3731983400644707,0.33521229080342246
1771,0.5064,0,3,0,457368,148242,33205,74751,1.3731705509652081,0.3352168005273708
1772,0.5065,5,48,5,457416,148194,33210,74746,1.3727259253770054,0.33527406477079036
1773,0.5066,1,6,1,457422,148188,33211,74745,1.37267034717848,0.33528010657910673
1774,0.5068,0,4,0,457426,148184,33211,74745,1.37263329504613,0.33528612248742873
1775,0.5069,1,3,1,457429,148181,33212,74744,1.3726055059468671,0.33528765279802625
1776,0.507,1,11,1,457440,148170,33213,74743,1.3725036125829042,0.335301216169537
1777,0.5071,0,1,0,457441,148169,33213,74743,1.3724943495498165,0.33530272035601494
1778,0.5073,0,1,0,457442,148168,33213,74743,1.372485086516729,0.33530422455598874
1779,0.5074,27,100,27,457542,148068,33240,74716,1.3715587832079736,0.33537417408790576
1780,0.5077,1,9,1,457551,148059,33241,74715,1.3714754159101856,0.3353847396913464
1781,0.5078,0,1,0,457552,148058,33241,74715,1.3714661528770982,0.3353862451912934
1782,0.5079,5,29,5,457581,148029,33246,74710,1.371197524917559,0.3354149924350922
1783,0.5081,1,1,1,457582,148028,33247,74709,1.3711882618844715,0.33541351459344426
1784,0.5084,0,3,0,457585,148025,33247,74709,1.3711604727852087,0.3354180322716783
1785,0.5085,51,257,51,457842,147768,33298,74658,1.3687798732817074,0.33565320601008874
1786,0.5086,2,1,2,457843,147767,33300,74656,1.36877061024862,0.33564874136217926
1787,0.5088,1,6,1,457849,147761,33301,74655,1.3687150320500945,0.3356548090065463
1788,0.5089,4,25,4,457874,147736,33305,74651,1.3684834562229056,0.33568059284040885
1789,0.509,0,2,0,457876,147734,33305,74651,1.3684649301567304,0.33568361175438993
1790,0.5092,18,103,18,457979,147631,33323,74633,1.3675108377487124,0.3357853723499982
1791,0.5093,0,2,0,457981,147629,33323,74633,1.3674923116825373,0.3357883938774959
1792,0.5094,8,45,8,458026,147584,33331,74625,1.3670754751935974,0.33583248203268096
1793,0.5096,2,8,2,458034,147576,33333,74623,1.367001370928897,0.3358385951331914
1794,0.5097,1,6,1,458040,147570,33334,74622,1.3669457927303716,0.3358446748757831
1795,0.51,1597,7629,1597,465669,139941,34931,73025,1.2962781133054206,0.3428951100175615
1796,0.5105,0,1,0,465670,139940,34931,73025,1.2962688502723332,0.3428967201183293
1797,0.5108,1,0,1,465670,139940,34932,73024,1.2962688502723332,0.34289363460490974
1798,0.5118,0,1,0,465671,139939,34932,73024,1.2962595872392457,0.3428952447138705
1799,0.5121,1,1,1,465672,139938,34933,73023,1.296250324206158,0.34289376928169946
1800,0.5122,0,1,0,465673,139937,34933,73023,1.2962410611730706,0.34289537941397447
1801,0.5123,0,1,0,465674,139936,34933,73023,1.296231798139983,0.342896989561371
1802,0.5127,0,1,0,465675,139935,34933,73023,1.2962225351068954,0.3428985997238892
1803,0.5135,1,1,1,465676,139934,34934,73022,1.2962132720738078,0.34289712428858543
1804,0.5137,0,2,0,465678,139932,34934,73022,1.2961947460076328,0.3429003446753759
1805,0.5138,0,1,0,465679,139931,34934,73022,1.2961854829745452,0.3429019548914549
1806,0.5139,0,2,0,465681,139929,34934,73022,1.29616695690837,0.3429051753689816
1807,0.514,0,1,0,465682,139928,34934,73022,1.2961576938752826,0.3429067856304297
1808,0.5142,0,1,0,465683,139927,34934,73022,1.2961484308421949,0.34290839590700123
1809,0.5143,0,3,0,465686,139924,34934,73022,1.2961206417429323,0.3429132268274586
1810,0.5144,0,3,0,465689,139921,34934,73022,1.2960928526436697,0.3429180578840347
1811,0.5145,0,2,0,465691,139919,34934,73022,1.2960743265774946,0.3429212786640431
1812,0.5147,0,2,0,465693,139917,34934,73022,1.2960558005113194,0.34292449950455295
1813,0.5148,0,1,0,465694,139916,34934,73022,1.296046537478232,0.34292610994749645
1814,0.5149,1,0,1,465694,139916,34935,73021,1.296046537478232,0.342923024180861
1815,0.515,2,9,2,465703,139907,34937,73019,1.295963170180444,0.34293134704075595
1816,0.5153,2,4,2,465707,139903,34939,73017,1.2959261180480937,0.34293161750892354
1817,0.5154,0,2,0,465709,139901,34939,73017,1.2959075919819185,0.3429348387642191
1818,0.5155,1,2,1,465711,139899,34940,73016,1.2958890659157434,0.3429349740506775
1819,0.5157,1,2,1,465713,139897,34941,73015,1.2958705398495682,0.3429351093409484
1820,0.5158,3,6,3,465719,139891,34944,73012,1.295814961651043,0.3429355152346374
1821,0.5159,2,8,2,465727,139883,34946,73010,1.2957408573863425,0.3429422291949477
1822,0.5161,1,0,1,465727,139883,34947,73009,1.2957408573863425,0.3429391428517746
1823,0.5164,0,3,0,465730,139880,34947,73009,1.2957130682870799,0.34294397549896893
1824,0.5165,4,34,4,465764,139846,34951,73005,1.2953981251621032,0.3429864083325895
1825,0.5166,0,6,0,465770,139840,34951,73005,1.2953425469635778,0.3429960769574103
1826,0.5168,0,4,0,465774,139836,34951,73005,1.2953054948312275,0.34300252301013434
1827,0.5169,0,4,0,465778,139832,34951,73005,1.2952684426988774,0.343008969305149
1828,0.517,2,15,2,465793,139817,34953,73003,1.295129497202564,0.34302697114932806
1829,0.5171,0,2,0,465795,139815,34953,73003,1.2951109711363888,0.34303019481434843
1830,0.5172,0,1,0,465796,139814,34953,73003,1.2951017081033014,0.34303180666957994
1831,0.5173,0,1,0,465797,139813,34953,73003,1.2950924450702137,0.3430334185399594
1832,0.5174,19,110,19,465907,139703,34972,72984,1.2940735114305828,0.34315214376054953
1833,0.5177,4,14,4,465921,139689,34976,72980,1.293943828967357,0.3431623790961541
1834,0.5179,3,18,3,465939,139671,34979,72977,1.293777094371781,0.3431821601896091
1835,0.5181,1,5,1,465944,139666,34980,72976,1.2937307792063433,0.34318714082824653
1836,0.5184,0,4,0,465948,139662,34980,72976,1.2936937270739932,0.34319359662901266
1837,0.5185,53,242,53,466190,139420,35033,72923,1.291452073066805,0.3434207861808489
1838,0.5186,0,1,0,466191,139419,35033,72923,1.2914428100337174,0.3434224034811766
1839,0.5188,3,2,3,466193,139417,35036,72920,1.2914242839675423,0.34341636172687756
1840,0.5189,3,13,3,466206,139404,35039,72917,1.2913038645374042,0.3434281112089713
1841,0.519,1,0,1,466206,139404,35040,72916,1.2913038645374042,0.34342501883948756
1842,0.5192,15,90,15,466296,139314,35055,72901,1.2904701915595242,0.3435242560610701
1843,0.5194,10,39,10,466335,139275,35065,72891,1.2901089332691096,0.34355646050733857
1844,0.5196,3,20,3,466355,139255,35068,72888,1.2899236726073586,0.3435795666130865
1845,0.5197,1,4,1,466359,139251,35069,72887,1.2898866204750083,0.34358295072075723
1846,0.52,1573,7461,1573,473820,131790,36642,71314,1.2207751306087666,0.35112060816133606
1847,0.523,0,1,0,473821,131789,36642,71314,1.220765867575679,0.3511223369423396
1848,0.5234,0,2,0,473823,131787,36642,71314,1.2207473415095038,0.35112579455541826
1849,0.5236,1,0,1,473823,131787,36643,71313,1.2207473415095038,0.35112259970457904
1850,0.5237,0,2,0,473825,131785,36643,71313,1.2207288154433287,0.3511260573713183
1851,0.5239,1,2,1,473827,131783,36644,71312,1.2207102893771538,0.35112632019498263
1852,0.5242,0,2,0,473829,131781,36644,71312,1.2206917633109786,0.3511297779834854
1853,0.5244,0,1,0,473830,131780,36644,71312,1.220682500277891,0.3511315069032754
1854,0.5246,0,2,0,473832,131778,36644,71312,1.2206639742117158,0.35113496479393375
1855,0.5247,0,1,0,473833,131777,36644,71312,1.2206547111786283,0.3511366937648026
1856,0.525,1,4,1,473837,131773,36645,71311,1.220617659046278,0.35114041480372654
1857,0.5253,1,2,1,473839,131771,36646,71310,1.220599132980103,0.3511406778576036
1858,0.5257,0,4,0,473843,131767,36646,71310,1.2205620808477529,0.3511475942622749
1859,0.5258,3,9,3,473852,131758,36649,71307,1.2204787135499648,0.3511535715165095
1860,0.5259,2,13,2,473865,131745,36651,71305,1.2203582941198265,0.3511696626446688
1861,0.526,0,2,0,473867,131743,36651,71305,1.2203397680536514,0.35117312162641345
1862,0.5262,0,2,0,473869,131741,36651,71305,1.2203212419874763,0.3511765806763
1863,0.5264,1,5,1,473874,131736,36652,71304,1.2202749268220385,0.3511820330969267
1864,0.5265,7,28,7,473902,131708,36659,71297,1.220015561895587,0.3512080983227014
1865,0.5266,1,4,1,473906,131704,36660,71296,1.219978509763237,0.35121182266009854
1866,0.5267,0,1,0,473907,131703,36660,71296,1.2199692467301493,0.35121355277612204
1867,0.5269,0,5,0,473912,131698,36660,71296,1.2199229315647115,0.3512222036119294
1868,0.527,3,18,3,473930,131680,36663,71293,1.2197561969691355,0.3512437614855178
1869,0.5271,0,2,0,473932,131678,36663,71293,1.2197376709029604,0.3512472225096196
1870,0.5274,20,112,20,474044,131566,36683,71273,1.2187002111971543,0.3513772006369584
1871,0.5277,1,15,1,474059,131551,36684,71272,1.2185612657008411,0.35139998915310394
1872,0.5278,0,2,0,474061,131549,36684,71272,1.218542739634666,0.35140345427741704
1873,0.5279,7,20,7,474081,131529,36691,71265,1.2183574789729148,0.35141572235864965
1874,0.528,1,0,1,474081,131529,36692,71264,1.2183574789729148,0.3514125241009305
1875,0.5281,0,6,0,474087,131523,36692,71264,1.2183019007743896,0.35142292158767574
1876,0.5284,1,2,1,474089,131521,36693,71263,1.2182833747082145,0.351423189206249
1877,0.5285,57,261,57,474350,131260,36750,71206,1.2158657230723628,0.351693617693835
1878,0.5286,0,4,0,474354,131256,36750,71206,1.2158286709400126,0.3517005660321443
1879,0.5288,0,4,0,474358,131252,36750,71206,1.2157916188076623,0.3517075146450128
1880,0.5289,5,25,5,474383,131227,36755,71201,1.2155600429804736,0.35173493785444704
1881,0.5292,10,112,10,474495,131115,36765,71191,1.2145225832746676,0.3518976204363687
1882,0.5293,1,1,1,474496,131114,36766,71190,1.2145133202415799,0.3518961562796583
1883,0.5294,10,35,10,474531,131079,36776,71180,1.2141891140835155,0.35192500704542196
1884,0.5296,2,11,2,474542,131068,36778,71178,1.2140872207195523,0.3519377391889086
1885,0.5297,0,8,0,474550,131060,36778,71178,1.214013116454852,0.35195166091436825
1886,0.5298,0,1,0,474551,131059,36778,71178,1.2140038534217643,0.3519534012074942
1887,0.53,1627,7326,1627,481877,123733,38405,69551,1.1461428730223424,0.359838372550237
1888,0.5304,0,1,0,481878,123732,38405,69551,1.146133609989255,0.35984023426788697
1889,0.5309,0,1,0,481879,123731,38405,69551,1.1461243469561673,0.35984209600480127
1890,0.5311,0,2,0,481881,123729,38405,69551,1.1461058208899921,0.35984581953642386
1891,0.532,0,1,0,481882,123728,38405,69551,1.1460965578569047,0.3598476813311327
1892,0.5324,1,1,1,481883,123727,38406,69550,1.1460872948238172,0.3598462310569804
1893,0.5326,1,0,1,481883,123727,38407,69549,1.1460872948238172,0.3598429189345806
1894,0.533,0,2,0,481885,123725,38407,69549,1.146068768757642,0.3598466425903122
1895,0.5332,2,2,2,481887,123723,38409,69547,1.146050242691467,0.35984374191545504
1896,0.5335,1,1,1,481888,123722,38410,69546,1.1460409796583793,0.3598422915330008
1897,0.5338,0,1,0,481889,123721,38410,69546,1.1460317166252918,0.35984415342505444
1898,0.5339,1,0,1,481889,123721,38411,69545,1.1460317166252918,0.35984084112052817
1899,0.5341,0,1,0,481890,123720,38411,69545,1.1460224535922043,0.3598427030243448
1900,0.5343,0,1,0,481891,123719,38411,69545,1.1460131905591167,0.35984456494742945
1901,0.5344,0,2,0,481893,123717,38411,69545,1.1459946644929415,0.3598482888514038
1902,0.5345,0,1,0,481894,123716,38411,69545,1.145985401459854,0.35985015083229416
1903,0.5347,0,2,0,481896,123714,38411,69545,1.145966875393679,0.3598538748518827
1904,0.5348,0,2,0,481898,123712,38411,69545,1.1459483493275038,0.35985759894855035
1905,0.535,1,4,1,481902,123708,38412,69544,1.1459112971951535,0.3598617349367665
1906,0.5353,2,3,2,481905,123705,38414,69542,1.145883508095891,0.35986069641443336
1907,0.5354,1,1,1,481906,123704,38415,69541,1.1458742450628034,0.3598592460348263
1908,0.5355,1,1,1,481907,123703,38416,69540,1.1458649820297158,0.35985779562519726
1909,0.5357,0,4,0,481911,123699,38416,69540,1.1458279298973655,0.3598652445934827
1910,0.5358,4,11,4,481922,123688,38420,69536,1.1457260365334025,0.3598724796091583
1911,0.5359,3,7,3,481929,123681,38423,69533,1.1456611953017897,0.3598755783742379
1912,0.536,0,1,0,481930,123680,38423,69533,1.145651932268702,0.3598774409589417
1913,0.5361,0,2,0,481932,123678,38423,69533,1.1456334062025268,0.3598811661861902
1914,0.5362,0,1,0,481933,123677,38423,69533,1.1456241431694394,0.3598830288287356
1915,0.5363,0,2,0,481935,123675,38423,69533,1.1456056171032643,0.35988675417166993
1916,0.5364,1,2,1,481937,123673,38424,69532,1.1455870910370891,0.35988716648119873
1917,0.5365,4,33,4,481970,123640,38428,69528,1.1452814109451999,0.35993539302575994
1918,0.5366,0,2,0,481972,123638,38428,69528,1.1452628848790247,0.35993911972086184
1919,0.5367,1,0,1,481972,123638,38429,69527,1.1452628848790247,0.3599358061760671
1920,0.5368,0,1,0,481973,123637,38429,69527,1.1452536218459373,0.3599376695450498
1921,0.5369,0,1,0,481974,123636,38429,69527,1.1452443588128496,0.35993953293332576
1922,0.537,5,16,5,481990,123620,38434,69522,1.145096150283449,0.35995278085553634
1923,0.5371,0,2,0,481992,123618,38434,69522,1.1450776242172738,0.3599565082323703
1924,0.5373,0,1,0,481993,123617,38434,69522,1.145068361184186,0.3599583719497357
1925,0.5374,28,84,28,482077,123533,38462,69494,1.1442902664048316,0.3600221730638719
1926,0.5377,1,9,1,482086,123524,38463,69493,1.1442068991070435,0.3600356445287203
1927,0.5378,0,1,0,482087,123523,38463,69493,1.144197636073956,0.3600375098437435
1928,0.5379,5,22,5,482109,123501,38468,69488,1.1439938493460298,0.3600619724440253
1929,0.5381,2,2,2,482111,123499,38470,69486,1.1439753232798548,0.36005907194859704
1930,0.5384,1,2,1,482113,123497,38471,69485,1.1439567972136797,0.3600594874133339
1931,0.5385,61,248,61,482361,123249,38532,69424,1.1416595650079662,0.36032033549070186
1932,0.5386,0,1,0,482362,123248,38532,69424,1.1416503019748787,0.36032220561368544
1933,0.5388,1,4,1,482366,123244,38533,69423,1.1416132498425284,0.3603263662173595
1934,0.5389,8,29,8,482395,123215,38541,69415,1.1413446218829895,0.36035404661786846
1935,0.539,1,2,1,482397,123213,38542,69414,1.1413260958168143,0.36035446744225885
1936,0.5392,20,86,20,482483,123127,38562,69394,1.1405294749712847,0.3604489899803138
1937,0.5393,0,1,0,482484,123126,38562,69394,1.140520211938197,0.3604508622480781
1938,0.5394,4,32,4,482516,123094,38566,69390,1.1402237948793954,0.36049749589576274
1939,0.5395,1,0,1,482516,123094,38567,69389,1.1402237948793954,0.360494173511427
1940,0.5396,3,22,3,482538,123072,38570,69386,1.140020008151469,0.36052541333693583
1941,0.5397,0,1,0,482539,123071,38570,69386,1.1400107451183816,0.36052728661467237
1942,0.5398,0,1,0,482540,123070,38570,69386,1.140001482085294,0.36052915991187595
1943,0.54,1673,6838,1673,489378,116232,40243,67713,1.0766608618325986,0.36811546929788797
1944,0.5417,0,1,0,489379,116231,40243,67713,1.076651598799511,0.3681174705345105
1945,0.5423,0,2,0,489381,116229,40243,67713,1.0766330727333357,0.3681214730730339
1946,0.5424,1,1,1,489382,116228,40244,67712,1.0766238097002483,0.36812003914319885
1947,0.5427,0,1,0,489383,116227,40244,67712,1.0766145466671606,0.3681220404590652
1948,0.5428,0,1,0,489384,116226,40244,67712,1.0766052836340732,0.36812404179669234
1949,0.5429,1,0,1,489384,116226,40245,67711,1.0766052836340732,0.3681206065120123
1950,0.5431,0,1,0,489385,116225,40245,67711,1.0765960206009857,0.36812260786360473
1951,0.5432,0,1,0,489386,116224,40245,67711,1.076586757567898,0.3681246092369587
1952,0.5435,0,2,0,489388,116222,40245,67711,1.0765682315017229,0.3681286120489526
1953,0.5439,0,2,0,489390,116220,40245,67711,1.0765497054355477,0.3681326149479968
1954,0.5443,0,1,0,489391,116219,40245,67711,1.0765404424024603,0.36813461643016365
1955,0.5444,1,2,1,489393,116217,40246,67710,1.0765219163362851,0.36813518406759205
1956,0.5447,1,3,1,489396,116214,40247,67709,1.0764941272370225,0.3681377532989349
1957,0.5448,1,1,1,489397,116213,40248,67708,1.0764848642039349,0.3681363193980024
1958,0.545,2,6,2,489403,116207,40250,67706,1.0764292860054097,0.36814145818947
1959,0.5451,0,1,0,489404,116206,40250,67706,1.076420022972322,0.3681434599156118
1960,0.5453,0,6,0,489410,116200,40250,67706,1.0763644447737968,0.36815547072961186
1961,0.5454,0,2,0,489412,116198,40250,67706,1.0763459187076216,0.36815947450843917
1962,0.5458,2,9,2,489421,116189,40252,67704,1.0762625514098336,0.3681706209589272
1963,0.5459,3,5,3,489426,116184,40255,67701,1.0762162362443959,0.3681703238437067
1964,0.546,0,1,0,489427,116183,40255,67701,1.0762069732113082,0.36817232603162864
1965,0.5462,0,3,0,489430,116180,40255,67701,1.0761791841120456,0.36817833272605655
1966,0.5463,0,2,0,489432,116178,40255,67701,1.0761606580458705,0.368182337297897
1967,0.5465,6,28,6,489460,116150,40261,67695,1.075901293119419,0.3682177921618755
1968,0.5466,0,8,0,489468,116142,40261,67695,1.0758271888547186,0.36823381582597625
1969,0.5468,0,1,0,489469,116141,40261,67695,1.075817925821631,0.36823581888204704
1970,0.5469,1,0,1,489469,116141,40262,67694,1.075817925821631,0.3682323822993445
1971,0.547,4,14,4,489483,116127,40266,67690,1.0756882433584052,0.36824668012207795
1972,0.5474,16,102,16,489585,116025,40282,67674,1.0747434139834748,0.36839612627178153
1973,0.5475,0,1,0,489586,116024,40282,67674,1.0747341509503872,0.36839813171618635
1974,0.5477,2,8,2,489594,116016,40284,67672,1.0746600466856868,0.36840729933365274
1975,0.5478,0,2,0,489596,116014,40284,67672,1.0746415206195117,0.36841131060614307
1976,0.5479,6,20,6,489616,115994,40290,67666,1.0744562599577605,0.36843079603615375
1977,0.5481,0,11,0,489627,115983,40290,67666,1.0743543665937976,0.368452863887089
1978,0.5484,0,4,0,489631,115979,40290,67666,1.0743173144614473,0.3684608892156062
1979,0.5485,57,231,57,489862,115748,40347,67609,1.0721775538182223,0.36872876410499733
1980,0.5486,1,2,1,489864,115746,40348,67608,1.0721590277520472,0.36872934323767137
1981,0.5488,2,6,2,489870,115740,40350,67606,1.0721034495535218,0.3687345237965377
1982,0.5489,2,19,2,489889,115721,40352,67604,1.0719274519248583,0.3687658529933179
1983,0.549,2,2,2,489891,115719,40354,67602,1.0719089258586831,0.3687629895102034
1984,0.5491,0,1,0,489892,115718,40354,67602,1.0718996628255957,0.3687650010909884
1985,0.5492,18,118,18,490010,115600,40372,67584,1.0708066249212642,0.3689405188226046
1986,0.5493,0,3,0,490013,115597,40372,67584,1.0707788358220016,0.3689465610516375
1987,0.5494,10,36,10,490049,115561,40382,67574,1.0704453666308495,0.36898462882572963
1988,0.5496,1,15,1,490064,115546,40383,67573,1.0703064211345363,0.369011407882306
1989,0.5497,2,5,2,490069,115541,40385,67571,1.0702601059690986,0.36901459216217397
1990,0.5498,0,3,0,490072,115538,40385,67571,1.0702323168698358,0.3690206379806563
1991,0.55,1735,6620,1735,496692,108918,42120,65836,1.008911037830227,0.37673529647390047
1992,0.5502,0,1,0,496693,108917,42120,65836,1.0089017747971396,0.3767374522898033
1993,0.5504,0,1,0,496694,108916,42120,65836,1.008892511764052,0.37673960813037904
1994,0.5506,0,1,0,496695,108915,42120,65836,1.0088832487309645,0.3767417639956281
1995,0.5513,0,1,0,496696,108914,42120,65836,1.008873985697877,0.3767439198855508
1996,0.5521,1,0,1,496696,108914,42121,65835,1.008873985697877,0.3767403533067428
1997,0.5524,0,1,0,496697,108913,42121,65835,1.0088647226647893,0.37674250921326713
1998,0.5525,1,0,1,496697,108913,42122,65834,1.0088647226647893,0.37673894258556656
1999,0.5527,0,1,0,496698,108912,42122,65834,1.0088554596317019,0.37674109850869264
2000,0.5528,0,1,0,496699,108911,42122,65834,1.0088461965986142,0.37674325445649376
2001,0.5532,1,0,1,496699,108911,42123,65833,1.0088461965986142,0.3767396877718262
2002,0.5537,0,1,0,496700,108910,42123,65833,1.0088369335655267,0.37674184373622976
2003,0.5538,1,1,1,496701,108909,42124,65832,1.008827670532439,0.376740432983673
2004,0.5539,2,1,2,496702,108908,42126,65830,1.0088184074993516,0.37673545536746444
2005,0.5542,0,1,0,496703,108907,42126,65830,1.0088091444662641,0.37673761138167644
2006,0.5543,0,2,0,496705,108905,42126,65830,1.008790618400089,0.3767419234841331
2007,0.5544,1,0,1,496705,108905,42127,65829,1.008790618400089,0.37673835658772764
2008,0.5545,0,1,0,496706,108904,42127,65829,1.0087813553670013,0.37674051266789904
2009,0.5546,0,1,0,496707,108903,42127,65829,1.0087720923339139,0.37674266877274915
2010,0.5547,0,8,0,496715,108895,42127,65829,1.0086979880692133,0.3767599185000343
2011,0.5548,1,1,1,496716,108894,42128,65828,1.0086887250361258,0.3767585078009638
2012,0.555,2,3,2,496719,108891,42130,65826,1.0086609359368632,0.3767578426827384
2013,0.5552,1,0,1,496719,108891,42131,65825,1.0086609359368632,0.3767542755099705
2014,0.5553,1,2,1,496721,108889,42132,65824,1.008642409870688,0.3767550210917333
2015,0.5555,0,1,0,496722,108888,42132,65824,1.0086331468376004,0.3767571775264435
2016,0.5556,1,0,1,496722,108888,42133,65823,1.0086331468376004,0.37675361024778065
2017,0.5558,3,8,3,496730,108880,42136,65820,1.0085590425729,0.37676016027475673
2018,0.5559,2,15,2,496745,108865,42138,65818,1.0084200970765869,0.37678537693994263
2019,0.5562,2,1,2,496746,108864,42140,65816,1.0084108340434992,0.376780398442867
2020,0.5563,0,5,0,496751,108859,42140,65816,1.0083645188780614,0.37679118362673536
2021,0.5564,0,1,0,496752,108858,42140,65816,1.008355255844974,0.3767933407376026
2022,0.5565,5,34,5,496786,108824,42145,65811,1.008040312719997,0.37684885618575886
2023,0.5566,1,6,1,496792,108818,42146,65810,1.0079847345214716,0.37685823579265637
2024,0.5568,0,1,0,496793,108817,42146,65810,1.0079754714883842,0.3768603938680731
2025,0.5569,3,3,3,496796,108814,42149,65807,1.0079476823891216,0.3768561627753821
2026,0.557,3,15,3,496811,108799,42152,65804,1.0078087368928081,0.37687783142328596
2027,0.5571,0,3,0,496814,108796,42152,65804,1.0077809477935455,0.3768843069873998
2028,0.5574,28,87,28,496901,108709,42180,65776,1.0069750639149284,0.37697223257013496
2029,0.5576,0,2,0,496903,108707,42180,65776,1.0069565378487533,0.376976553589748
2030,0.5577,9,8,9,496911,108699,42189,65767,1.0068824335840527,0.3769617002739789
2031,0.5579,1,28,1,496939,108671,42190,65766,1.0066230686576012,0.37701863710107375
2032,0.5581,0,5,0,496944,108666,42190,65766,1.0065767534921635,0.37702944413869016
2033,0.5583,0,1,0,496945,108665,42190,65766,1.006567490459076,0.37703160562056054
2034,0.5584,0,1,0,496946,108664,42190,65766,1.0065582274259883,0.37703376712721437
2035,0.5585,54,223,54,497169,108441,42244,65712,1.0044925710474637,0.37732338805533067
2036,0.5588,1,4,1,497173,108437,42245,65711,1.0044555189151136,0.37732847922456764
2037,0.5589,7,18,7,497191,108419,42252,65704,1.0042887843195376,0.3773424533232255
2038,0.559,0,1,0,497192,108418,42252,65704,1.00427952128645,0.3773446204385431
2039,0.5592,21,103,21,497295,108315,42273,65683,1.003325428878432,0.3774928447453419
2040,0.5593,0,3,0,497298,108312,42273,65683,1.0032976397791693,0.37749935342969626
2041,0.5594,13,26,13,497324,108286,42286,65670,1.003056800918893,0.37750925521396217
2042,0.5595,0,1,0,497325,108285,42286,65670,1.0030475378858053,0.3775114253686298
2043,0.5596,2,13,2,497338,108272,42288,65668,1.0029271184556672,0.37753248246521787
2044,0.5597,2,6,2,497344,108266,42290,65666,1.0028715402571418,0.37753834832003313
2045,0.56,1694,6328,1694,503672,101938,43984,63972,0.9442550668790989,0.38558254475317943
2046,0.5603,0,1,0,503673,101937,43984,63972,0.9442458038460113,0.38558486881362675
2047,0.5609,0,1,0,503674,101936,43984,63972,0.9442365408129237,0.3855871929020903
2048,0.5616,1,0,1,503674,101936,43985,63971,0.9442365408129237,0.3855834895453477
2049,0.5624,1,0,1,503674,101936,43986,63970,0.9442365408129237,0.38557978614396105
2050,0.5629,0,1,0,503675,101935,43986,63970,0.9442272777798363,0.3855821102438142
2051,0.563,0,1,0,503676,101934,43986,63970,0.9442180147467487,0.3855844343716848
2052,0.5635,0,1,0,503677,101933,43986,63970,0.9442087517136611,0.38558675852757335
2053,0.5636,0,1,0,503678,101932,43986,63970,0.9441994886805736,0.3855890827114803
2054,0.5639,1,0,1,503678,101932,43987,63969,0.9441994886805736,0.3855853792321927
2055,0.5643,1,2,1,503680,101930,43988,63968,0.9441809626143984,0.38558632412687316
2056,0.5644,0,1,0,503681,101929,43988,63968,0.9441716995813109,0.38558864837821055
2057,0.5647,1,3,1,503684,101926,43989,63967,0.9441439104820483,0.3855919176818793
2058,0.5648,1,4,1,503688,101922,43990,63966,0.944106858349698,0.38559751157407407
2059,0.5649,1,1,1,503689,101921,43991,63965,0.9440975953166104,0.38559613228361644
2060,0.565,2,5,2,503694,101916,43993,63963,0.9440512801511727,0.38560034724106124
2061,0.5651,0,1,0,503695,101915,43993,63963,0.9440420171180851,0.3856026718431618
2062,0.5653,3,1,3,503696,101914,43996,63960,0.9440327540849975,0.3855938845147522
2063,0.5654,0,1,0,503697,101913,43996,63960,0.9440234910519101,0.3855962091479626
2064,0.5655,0,4,0,503701,101909,43996,63960,0.9439864389195598,0.3856055079611018
2065,0.5657,0,1,0,503702,101908,43996,63960,0.9439771758864722,0.38560783273446353
2066,0.5658,2,9,2,503711,101899,43998,63958,0.9438938085886843,0.3856213485110668
2067,0.5659,2,10,2,503721,101889,44000,63956,0.9438011782578087,0.3856371913533721
2068,0.566,0,1,0,503722,101888,44000,63956,0.9437919152247212,0.38563951665420515
2069,0.5662,0,1,0,503723,101887,44000,63956,0.9437826521916336,0.3856418419830804
2070,0.5663,1,0,1,503723,101887,44001,63955,0.9437826521916336,0.38563813750437165
2071,0.5664,0,2,0,503725,101885,44001,63955,0.9437641261254586,0.3856427882296189
2072,0.5665,7,29,7,503754,101856,44008,63948,0.9434954981659195,0.38568430194687703
2073,0.5666,0,5,0,503759,101851,44008,63948,0.9434491830004816,0.38569593302734034
2074,0.5667,0,1,0,503760,101850,44008,63948,0.9434399199673941,0.38569825932761553
2075,0.5668,0,3,0,503763,101847,44008,63948,0.9434121308681315,0.38570523839681536
2076,0.567,1,14,1,503777,101833,44009,63947,0.9432824484049057,0.38573410544094583
2077,0.5671,0,3,0,503780,101830,44009,63947,0.943254659305643,0.38574108591662293
2078,0.5672,0,3,0,503783,101827,44009,63947,0.9432268702063804,0.38574806664495037
2079,0.5674,15,97,15,503880,101730,44024,63932,0.9423283559968876,0.3859183156064758
2080,0.5675,0,1,0,503881,101729,44024,63932,0.9423190929638001,0.3859206451729737
2081,0.5677,3,9,3,503890,101720,44027,63929,0.9422357256660121,0.38593049158159726
2082,0.5679,4,16,4,503906,101704,44031,63925,0.9420875171366112,0.38595294302326283
2083,0.5681,1,2,1,503908,101702,44032,63924,0.9420689910704361,0.3859538961274196
2084,0.5684,0,5,0,503913,101697,44032,63924,0.9420226759049983,0.3859655478471933
2085,0.5685,65,246,65,504159,101451,44097,63859,0.93974396976546,0.3862984695420725
2086,0.5686,0,5,0,504164,101446,44097,63859,0.9396976546000222,0.3863101539578355
2087,0.5687,1,0,1,504164,101446,44098,63858,0.9396976546000222,0.38630644146542126
2088,0.5688,1,1,1,504165,101445,44099,63857,0.9396883915669346,0.3863050658794207
2089,0.5689,0,15,0,504180,101430,44099,63857,0.9395494460706214,0.3863401235426864
2090,0.569,0,2,0,504182,101428,44099,63857,0.9395309200044463,0.38634479837855823
2091,0.5692,20,66,20,504248,101362,44119,63837,0.9389195598206677,0.38642485729332504
2092,0.5693,1,3,1,504251,101359,44120,63836,0.9388917707214051,0.38642816065861557
2093,0.5694,6,29,6,504280,101330,44126,63830,0.938623142761866,0.3864737224509566
2094,0.5696,3,8,3,504288,101322,44129,63827,0.9385490384971655,0.386481298706017
2095,0.5697,2,4,2,504292,101318,44131,63825,0.9385119863648153,0.38648322968578747
2096,0.5698,0,1,0,504293,101317,44131,63825,0.9385027233317278,0.38648556999430794
2097,0.57,1770,6067,1770,510360,95250,45901,62055,0.8823039015895365,0.3944884142271384
2098,0.5707,0,1,0,510361,95249,45901,62055,0.882294638556449,0.39449092203631186
2099,0.5714,1,0,1,510361,95249,45902,62054,0.882294638556449,0.39448707271952854
2100,0.5716,0,1,0,510362,95248,45902,62054,0.8822853755233614,0.39448958055205907
2101,0.5717,0,1,0,510363,95247,45902,62054,0.8822761124902738,0.39449208841647543
2102,0.572,1,0,1,510363,95247,45903,62053,0.8822761124902738,0.39448823903369357
2103,0.5721,1,0,1,510363,95247,45904,62052,0.8822761124902738,0.39448438960196824
2104,0.5724,0,1,0,510364,95246,45904,62052,0.8822668494571863,0.394486897481214
2105,0.5732,0,2,0,510366,95244,45904,62052,0.8822483233910111,0.3944919133353677
2106,0.5734,0,2,0,510368,95242,45904,62052,0.8822297973248361,0.39449692931707503
2107,0.5735,0,2,0,510370,95240,45904,62052,0.882211271258661,0.3945019454263408
2108,0.5739,2,3,2,510373,95237,45906,62050,0.8821834821593982,0.3945017706485596
2109,0.5742,0,2,0,510375,95235,45906,62050,0.8821649560932232,0.39450678704262965
2110,0.5743,1,0,1,510375,95235,45907,62049,0.8821649560932232,0.3945029373617151
2111,0.5744,1,0,1,510375,95235,45908,62048,0.8821649560932232,0.3944990876318483
2112,0.5746,0,1,0,510376,95234,45908,62048,0.8821556930601356,0.3945015958596661
2113,0.575,2,4,2,510380,95230,45910,62046,0.8821186409277854,0.39450392939800094
2114,0.5752,0,1,0,510381,95229,45910,62046,0.8821093778946978,0.39450643776824035
2115,0.5753,1,4,1,510385,95225,45911,62045,0.8820723257623476,0.394512621606155
2116,0.5754,1,0,1,510385,95225,45912,62044,0.8820723257623476,0.39450877159516495
2117,0.5755,0,2,0,510387,95223,45912,62044,0.8820537996961725,0.39451378865241915
2118,0.5757,0,3,0,510390,95220,45912,62044,0.8820260105969099,0.3945213144775664
2119,0.5758,1,6,1,510396,95214,45913,62043,0.8819704323983846,0.39453251683549856
2120,0.5759,1,9,1,510405,95205,45914,62042,0.8818870651005966,0.39455124740058634
2121,0.576,0,1,0,510406,95204,45914,62042,0.881877802067509,0.39455375653434743
2122,0.5762,1,3,1,510409,95201,45915,62041,0.8818500129682463,0.39455743376451585
2123,0.5763,1,0,1,510409,95201,45916,62040,0.8818500129682463,0.39455358335294227
2124,0.5764,0,2,0,510411,95199,45916,62040,0.8818314869020712,0.394558601873581
2125,0.5765,12,26,12,510437,95173,45928,62028,0.8815906480417948,0.3945776426358611
2126,0.5766,3,2,3,510439,95171,45931,62025,0.8815721219756197,0.39457110867961015
2127,0.5768,1,1,1,510440,95170,45932,62024,0.8815628589425322,0.3945697672939171
2128,0.5769,1,1,1,510441,95169,45933,62023,0.8815535959094446,0.3945684258740903
2129,0.577,2,13,2,510454,95156,45935,62021,0.8814331764793064,0.394593356534353
2130,0.5773,0,1,0,510455,95155,45935,62021,0.8814239134462188,0.3945958670534942
2131,0.5774,23,92,23,510547,95063,45958,61998,0.8805717144021639,0.39473835006780805
2132,0.5775,0,2,0,510549,95061,45958,61998,0.8805531883359887,0.39474337669283516
2133,0.5777,3,8,3,510557,95053,45961,61995,0.8804790840712883,0.39475192297896183
2134,0.5779,2,13,2,510570,95040,45963,61993,0.8803586646411501,0.3947768940286437
2135,0.5781,2,6,2,510576,95034,45965,61991,0.8803030864426248,0.3947842700206973
2136,0.5782,1,0,1,510576,95034,45966,61990,0.8803030864426248,0.39478041573262684
2137,0.5784,2,2,2,510578,95032,45968,61988,0.8802845603764496,0.3947777353203414
2138,0.5785,54,210,54,510788,94822,46022,61934,0.8783393234280633,0.3950981142667585
2139,0.5786,3,0,3,510788,94822,46025,61931,0.8783393234280633,0.3950865374187416
2140,0.5787,0,1,0,510789,94821,46025,61931,0.8783300603949757,0.39508905787485965
2141,0.5788,0,1,0,510790,94820,46025,61931,0.8783207973618882,0.39509157836313646
2142,0.5789,4,15,4,510805,94805,46029,61927,0.8781818518655748,0.3951139524793916
2143,0.579,0,1,0,510806,94804,46029,61927,0.8781725888324873,0.3951164734481373
2144,0.5791,0,2,0,510808,94802,46029,61927,0.8781540627663122,0.395121515482138
2145,0.5792,29,89,29,510897,94713,46058,61898,0.8773296528215199,0.39523405124799665
2146,0.5793,0,4,0,510901,94709,46058,61898,0.8772926006891697,0.3952441461748198
2147,0.5794,10,36,10,510937,94673,46068,61888,0.8769591314980177,0.39529640204137684
2148,0.5795,0,1,0,510938,94672,46068,61888,0.8769498684649302,0.3952989269289729
2149,0.5796,4,11,4,510949,94661,46072,61884,0.876847975100967,0.3953112523555527
2150,0.5797,0,3,0,510952,94658,46072,61884,0.8768201860017044,0.3953188281739086
2151,0.5798,0,1,0,510953,94657,46072,61884,0.8768109229686168,0.3953213535112207
2152,0.5799,0,1,0,510954,94656,46072,61884,0.8768016599355293,0.39532387888079723
2153,0.58,1726,5770,1726,516724,88886,47798,60158,0.8233539590203416,0.4036257749389442
2154,0.5817,0,1,0,516725,88885,47798,60158,0.823344695987254,0.4036284830552257
2155,0.5821,0,1,0,516726,88884,47798,60158,0.8233354329541666,0.40363119120784746
2156,0.5823,1,0,1,516726,88884,47799,60157,0.8233354329541666,0.4036271898336699
2157,0.5824,0,1,0,516727,88883,47799,60157,0.823326169921079,0.403629898013956
2158,0.5827,0,1,0,516728,88882,47799,60157,0.8233169068879914,0.40363260623058395
2159,0.5828,0,1,0,516729,88881,47799,60157,0.8233076438549038,0.40363531448355455
2160,0.583,0,3,0,516732,88878,47799,60157,0.8232798547556411,0.4036434394605294
2161,0.5831,1,0,1,516732,88878,47800,60156,0.8232798547556411,0.40363943798059504
2162,0.5836,2,0,2,516732,88878,47802,60154,0.8232798547556411,0.40363143485962744
2163,0.5839,0,1,0,516733,88877,47802,60154,0.8232705917225537,0.403634143231945
2164,0.5842,0,2,0,516735,88875,47802,60154,0.8232520656563785,0.4036395600856209
2165,0.5843,0,1,0,516736,88874,47802,60154,0.823242802623291,0.4036422685669807
2166,0.5844,1,0,1,516736,88874,47803,60153,0.823242802623291,0.4036382668912345
2167,0.5845,1,1,1,516737,88873,47804,60152,0.8232335395902034,0.40363697366213724
2168,0.5847,0,1,0,516738,88872,47804,60152,0.8232242765571158,0.40363968219884044
2169,0.5849,0,2,0,516740,88870,47804,60152,0.8232057504909408,0.4036450993812994
2170,0.585,1,5,1,516745,88865,47805,60151,0.823159435325503,0.40365464111236377
2171,0.5857,0,2,0,516747,88863,47805,60151,0.8231409092593279,0.40366005878642275
2172,0.5858,0,11,0,516758,88852,47805,60151,0.8230390158953648,0.40368985859345113
2173,0.5859,2,7,2,516765,88845,47807,60149,0.8229741746637519,0.40370082016725506
2174,0.586,0,2,0,516767,88843,47807,60149,0.8229556485975767,0.4037062392611684
2175,0.5861,0,1,0,516768,88842,47807,60149,0.8229463855644893,0.403708948862683
2176,0.5864,1,1,1,516769,88841,47808,60148,0.8229371225314017,0.40370765626992594
2177,0.5865,10,28,10,516797,88813,47818,60138,0.8226777576049502,0.40374351296735167
2178,0.5866,3,2,3,516799,88811,47821,60135,0.8226592315387751,0.40373692479153517
2179,0.5867,0,1,0,516800,88810,47821,60135,0.8226499685056875,0.40373963543589914
2180,0.5868,0,2,0,516802,88808,47821,60135,0.8226314424395124,0.40374505683382234
2181,0.5869,1,0,1,516802,88808,47822,60134,0.8226314424395124,0.40374105356447476
2182,0.587,3,8,3,516810,88800,47825,60131,0.8225573381748119,0.40375073020391994
2183,0.5871,0,2,0,516812,88798,47825,60131,0.8225388121086369,0.4037561522604731
2184,0.5872,1,0,1,516812,88798,47826,60130,0.8225388121086369,0.40375214868929954
2185,0.5873,0,2,0,516814,88796,47826,60130,0.8225202860424617,0.4037575708741254
2186,0.5874,23,76,23,516890,88720,47849,60107,0.8218162955278077,0.40387160931820165
2187,0.5877,1,8,1,516898,88712,47850,60106,0.8217421912631072,0.4038893144646481
2188,0.5879,9,10,9,516908,88702,47859,60097,0.8216495609322316,0.4038804024220593
2189,0.5881,0,11,0,516919,88691,47859,60097,0.8215476675682686,0.40391026158023496
2190,0.5884,0,1,0,516920,88690,47859,60097,0.821538404535181,0.4039129762680879
2191,0.5885,47,184,47,517104,88506,47906,60050,0.819834006447071,0.40422466948490804
2192,0.5886,1,0,1,517104,88506,47907,60049,0.819834006447071,0.40422065901517956
2193,0.5888,1,1,1,517105,88505,47908,60048,0.8198247434139835,0.40421936951794984
2194,0.5889,7,21,7,517126,88484,47915,60041,0.8196302197191448,0.40424844302306007
2195,0.5892,29,81,29,517207,88403,47944,60012,0.8188799140390529,0.4043526597715864
2196,0.5893,2,2,2,517209,88401,47946,60010,0.8188613879728779,0.404350081867247
2197,0.5894,11,39,11,517248,88362,47957,59999,0.8185001296824632,0.40441221075619604
2198,0.5895,0,1,0,517249,88361,47957,59999,0.8184908666493756,0.40441493664060396
2199,0.5896,2,5,2,517254,88356,47959,59997,0.8184445514839379,0.40442053750176943
2200,0.5897,2,7,2,517261,88349,47961,59995,0.818379710252325,0.40443159143612145
2201,0.5898,0,1,0,517262,88348,47961,59995,0.8183704472192375,0.4044343177635615
2202,0.59,1665,5556,1665,522818,82792,49626,58330,0.7669050353847864,0.41333030994458697
2203,0.5902,0,1,0,522819,82791,49626,58330,0.7668957723516988,0.4133332388517655
2204,0.5904,0,1,0,522820,82790,49626,58330,0.7668865093186112,0.4133361678004535
2205,0.5907,1,0,1,522820,82790,49627,58329,0.7668865093186112,0.4133320105726373
2206,0.5919,0,1,0,522821,82789,49627,58329,0.7668772462855238,0.41333493955413203
2207,0.5924,1,3,1,522824,82786,49628,58328,0.7668494571862611,0.41333956942613775
2208,0.5928,0,1,0,522825,82785,49628,58328,0.7668401941531735,0.41334249856497984
2209,0.593,0,1,0,522826,82784,49628,58328,0.7668309311200859,0.41334542774533706
2210,0.5931,0,3,0,522829,82781,49628,58328,0.7668031420208233,0.413354215535508
2211,0.5932,0,1,0,522830,82780,49628,58328,0.7667938789877358,0.4133571448819344
2212,0.5935,0,1,0,522831,82779,49628,58328,0.7667846159546482,0.4133600742698803
2213,0.5938,0,1,0,522832,82778,49628,58328,0.7667753529215606,0.4133630036993466
2214,0.5939,1,2,1,522834,82776,49629,58327,0.7667568268553855,0.41336470521533913
2215,0.5941,0,3,0,522837,82773,49629,58327,0.7667290377561229,0.4133734939759036
2216,0.5943,1,0,1,522837,82773,49630,58326,0.7667290377561229,0.4133693364233623
2217,0.5947,0,3,0,522840,82770,49630,58326,0.7667012486568602,0.413378125531553
2218,0.5949,0,1,0,522841,82769,49630,58326,0.7666919856237726,0.4133810553173394
2219,0.595,0,4,0,522845,82765,49630,58326,0.7666549334914224,0.4133927748757894
2220,0.5952,0,1,0,522846,82764,49630,58326,0.7666456704583349,0.4133957048692324
2221,0.5953,0,6,0,522852,82758,49630,58326,0.7665900922598096,0.4134132857021349
2222,0.5955,1,1,1,522853,82757,49631,58325,0.766580829226722,0.41341205823563604
2223,0.5957,0,3,0,522856,82754,49631,58325,0.7665530401274593,0.41342084931137874
2224,0.5958,1,5,1,522861,82749,49632,58324,0.7665067249620215,0.4134313440559143
2225,0.5959,3,8,3,522869,82741,49635,58321,0.7664326206973211,0.41344231614467397
2226,0.596,0,2,0,522871,82739,49635,58321,0.7664140946311461,0.41344817808024953
2227,0.5964,0,1,0,522872,82738,49635,58321,0.7664048315980585,0.41345110911037225
2228,0.5965,7,31,7,522903,82707,49642,58314,0.7661176775723443,0.4135128810602676
2229,0.5966,0,4,0,522907,82703,49642,58314,0.7660806254399941,0.4135246105079529
2230,0.5968,1,3,1,522910,82700,49643,58313,0.7660528363407314,0.4135292490763263
2231,0.5969,2,1,2,522911,82699,49645,58311,0.7660435733076438,0.4135238635557762
2232,0.597,0,9,0,522920,82690,49645,58311,0.7659602060098558,0.4135502585088049
2233,0.5971,0,3,0,522923,82687,49645,58311,0.7659324169105932,0.41355905757528477
2234,0.5973,0,1,0,522924,82686,49645,58311,0.7659231538775056,0.4135619906806528
2235,0.5974,32,71,32,522995,82615,49677,58279,0.7652654785282893,0.41363720243587376
2236,0.5975,0,1,0,522996,82614,49677,58279,0.7652562154952017,0.4136401382609498
2237,0.5976,0,1,0,522997,82613,49677,58279,0.7652469524621142,0.4136430741277006
2238,0.5977,1,10,1,523007,82603,49678,58278,0.7651543221312387,0.4136682732235007
2239,0.5979,6,17,6,523024,82586,49684,58272,0.7649968505687502,0.41369322296213207
2240,0.5981,0,6,0,523030,82580,49684,58272,0.7649412723702249,0.413710845426405
2241,0.5984,0,1,0,523031,82579,49684,58272,0.7649320093371373,0.41371378264975045
2242,0.5985,52,189,52,523220,82390,49736,58220,0.7631812960835896,0.4140530545480407
2243,0.5986,0,3,0,523223,82387,49736,58220,0.7631535069843269,0.41406188881065664
2244,0.5987,0,1,0,523224,82386,49736,58220,0.7631442439512394,0.41406483364863517
2245,0.5988,2,3,2,523227,82383,49738,58218,0.7631164548519768,0.4140653338169714
2246,0.5989,7,7,7,523234,82376,49745,58211,0.7630516136203639,0.4140567762310882
2247,0.5992,27,92,27,523326,82284,49772,58184,0.7621994145763089,0.4142153373010223
2248,0.5993,1,1,1,523327,82283,49773,58183,0.7621901515432213,0.41421411587145646
2249,0.5994,10,31,10,523358,82252,49783,58173,0.7619029975175071,0.4142638419084921
2250,0.5996,0,15,0,523373,82237,49783,58173,0.7617640520211938,0.41430809771383803
2251,0.5997,0,4,0,523377,82233,49783,58173,0.7617269998888436,0.41431990085893766
2252,0.6,1689,5304,1689,528681,76929,51472,56484,0.7125958723924561,0.42337703222324663
2253,0.6013,0,1,0,528682,76928,51472,56484,0.7125866093593687,0.4233802056786496
2254,0.6017,0,1,0,528683,76927,51472,56484,0.7125773463262811,0.4233833791816267
2255,0.6018,1,0,1,528683,76927,51473,56483,0.7125773463262811,0.42337905704220075
2256,0.6024,0,1,0,528684,76926,51473,56483,0.7125680832931935,0.4233822305841435
2257,0.6032,0,1,0,528685,76925,51473,56483,0.712558820260106,0.42338540417366277
2258,0.6033,1,2,1,528687,76923,51474,56482,0.7125402941939308,0.4233874292567745
2259,0.6035,1,2,1,528689,76921,51475,56481,0.7125217681277558,0.42338945443096804
2260,0.6036,1,1,1,528690,76920,51476,56480,0.7125125050946682,0.4233883058470765
2261,0.6037,0,2,0,528692,76918,51476,56480,0.7124939790284931,0.4233946535930074
2262,0.6038,0,1,0,528693,76917,51476,56480,0.7124847159954055,0.4233978275373509
2263,0.6039,0,6,0,528699,76911,51476,56480,0.7124291377968802,0.4234168722027723
2264,0.604,0,1,0,528700,76910,51476,56480,0.7124198747637926,0.4234200464802459
2265,0.6041,0,1,0,528701,76909,51476,56480,0.7124106117307051,0.4234232208053138
2266,0.6043,0,4,0,528705,76905,51476,56480,0.7123735595983549,0.42343591858154966
2267,0.6044,0,1,0,528706,76904,51476,56480,0.7123642965652673,0.42343909314460504
2268,0.6045,0,1,0,528707,76903,51476,56480,0.7123550335321798,0.42344226775526117
2269,0.6047,1,1,1,528708,76902,51477,56479,0.7123457704990922,0.42344111979967164
2270,0.6048,0,1,0,528709,76901,51477,56479,0.7123365074660046,0.42344429449692605
2271,0.605,1,3,1,528712,76898,51478,56478,0.712308718366742,0.4234494961612284
2272,0.6051,0,1,0,528713,76897,51478,56478,0.7122994553336545,0.42345267104029993
2273,0.6053,0,2,0,528715,76895,51478,56478,0.7122809292674793,0.42345902094126997
2274,0.6054,1,1,1,528716,76894,51479,56477,0.7122716662343918,0.4234578731508349
2275,0.6055,0,2,0,528718,76892,51479,56477,0.7122531401682167,0.42346422332026185
2276,0.6058,3,7,3,528725,76885,51482,56474,0.7121882989366038,0.4234734813548392
2277,0.6059,2,5,2,528730,76880,51484,56472,0.712141983771166,0.423480712700222
2278,0.606,0,1,0,528731,76879,51484,56472,0.7121327207380784,0.423483888384789
2279,0.6062,0,1,0,528732,76878,51484,56472,0.712123457704991,0.4234870641169854
2280,0.6063,1,1,1,528733,76877,51485,56471,0.7121141946719034,0.4234859165491796
2281,0.6064,1,3,1,528736,76874,51486,56470,0.7120864055726407,0.42349112071034317
2282,0.6065,3,22,3,528758,76852,51489,56467,0.7118826188447145,0.42354803141337694
2283,0.6066,0,8,0,528766,76844,51489,56467,0.711808514580014,0.42357344855263257
2284,0.6068,0,2,0,528768,76842,51489,56467,0.711789988513839,0.42357980331410483
2285,0.6069,0,1,0,528769,76841,51489,56467,0.7117807254807514,0.4235829807663456
2286,0.607,4,11,4,528780,76830,51493,56463,0.7116788321167883,0.423600639193356
2287,0.6071,0,1,0,528781,76829,51493,56463,0.7116695690837007,0.42360381718332685
2288,0.6072,0,1,0,528782,76828,51493,56463,0.7116603060506133,0.42360699522098266
2289,0.6073,0,2,0,528784,76826,51493,56463,0.7116417799844381,0.4236133514393536
2290,0.6074,32,58,32,528842,76768,51525,56431,0.71110452406536,0.42365933678180767
2291,0.6077,1,7,1,528849,76761,51526,56430,0.7110396828337471,0.4236772754915873
2292,0.6079,4,15,4,528864,76746,51530,56426,0.7109007373374338,0.4237076863004235
2293,0.6081,0,1,0,528865,76745,51530,56426,0.7108914743043462,0.4237108679817678
2294,0.6082,0,1,0,528866,76744,51530,56426,0.7108822112712586,0.4237140497108958
2295,0.6084,1,4,1,528870,76740,51531,56425,0.7108451591389084,0.4237224495926107
2296,0.6085,65,158,65,529028,76582,51596,56360,0.7093815999110749,0.4239442764513848
2297,0.6086,1,1,1,529029,76581,51597,56359,0.7093723368779873,0.4239431322401083
2298,0.6087,0,2,0,529031,76579,51597,56359,0.7093538108118123,0.4239495102980337
2299,0.6088,0,5,0,529036,76574,51597,56359,0.7093074956463744,0.42396545628248816
2300,0.6089,9,8,9,529044,76566,51606,56350,0.709233391381674,0.4239519696650516
2301,0.609,0,1,0,529045,76565,51606,56350,0.7092241283485865,0.42395515931234246
2302,0.6092,29,75,29,529120,76490,51635,56321,0.7085294008670199,0.42406878948279886
2303,0.6093,1,2,1,529122,76488,51636,56320,0.7085108748008447,0.42407083910607796
2304,0.6094,10,21,10,529143,76467,51646,56310,0.7083163511060061,0.42409453444497164
2305,0.6096,4,5,4,529148,76462,51650,56306,0.7082700359405684,0.4240931549771029
2306,0.6097,0,3,0,529151,76459,51650,56306,0.7082422468413058,0.42410273792038566
2307,0.61,1703,5065,1703,534216,71394,53353,54603,0.6613249842528438,0.4333674611300269
2308,0.6111,0,1,0,534217,71393,53353,54603,0.6613157212197562,0.43337090066351314
2309,0.6115,0,1,0,534218,71392,53353,54603,0.6613064581866687,0.43337434025159727
2310,0.6119,0,1,0,534219,71391,53353,54603,0.6612971951535811,0.43337777989428067
2311,0.612,1,1,1,534220,71390,53354,54602,0.6612879321204935,0.4333767223315766
2312,0.6121,0,2,0,534222,71388,53354,54602,0.6612694060543184,0.43338360187316455
2313,0.6123,0,1,0,534223,71387,53354,54602,0.6612601430212308,0.43338704172586495
2314,0.6124,0,2,0,534225,71385,53354,54602,0.6612416169550558,0.4333939215950852
2315,0.6126,0,2,0,534227,71383,53354,54602,0.6612230908888806,0.43340080168274003
2316,0.6127,0,1,0,534228,71382,53354,54602,0.6612138278557931,0.43340424180848364
2317,0.6131,1,0,1,534228,71382,53355,54601,0.6612138278557931,0.4333997444099601
2318,0.6135,0,1,0,534229,71381,53355,54601,0.6612045648227055,0.4334031845819244
2319,0.6136,0,2,0,534231,71379,53355,54601,0.6611860387565305,0.43341006508969676
2320,0.6139,0,1,0,534232,71378,53355,54601,0.6611767757234429,0.43341350542550744
2321,0.6142,1,0,1,534232,71378,53356,54600,0.6611767757234429,0.43340900792201814
2322,0.6144,0,1,0,534233,71377,53356,54600,0.6611675126903553,0.4334124483040555
2323,0.6147,0,1,0,534234,71376,53356,54600,0.6611582496572678,0.4334158887407125
2324,0.6148,0,1,0,534235,71375,53356,54600,0.6611489866241802,0.43341932923199045
2325,0.615,0,5,0,534240,71370,53356,54600,0.6611026714587425,0.43343653250773995
2326,0.6153,0,2,0,534242,71368,53356,54600,0.6610841453925673,0.43344341420043186
2327,0.6154,0,1,0,534243,71367,53356,54600,0.6610748823594798,0.43344685512872416
2328,0.6155,0,2,0,534245,71365,53356,54600,0.6610563562933047,0.4334537371492081
2329,0.6156,1,0,1,534245,71365,53357,54599,0.6610563562933047,0.43344923946524405
2330,0.6157,0,1,0,534246,71364,53357,54599,0.6610470932602172,0.4334526805490501
2331,0.6158,4,7,4,534253,71357,53361,54595,0.6609822520286043,0.4334587779471545
2332,0.6159,5,4,5,534257,71353,53366,54590,0.660945199896254,0.43345005280166427
2333,0.616,0,1,0,534258,71352,53366,54590,0.6609359368631664,0.4334534944657064
2334,0.6162,2,4,2,534262,71348,53368,54588,0.6608988847308163,0.4334582645153094
2335,0.6163,0,2,0,534264,71346,53368,54588,0.6608803586646411,0.4334651484110725
2336,0.6164,1,2,1,534266,71344,53369,54587,0.6608618325984661,0.4334675338081965
2337,0.6165,7,20,7,534286,71324,53376,54580,0.6606765719367149,0.43350489261659675
2338,0.6166,5,9,5,534295,71315,53381,54575,0.660593204638927,0.43351338470092937
2339,0.6168,0,1,0,534296,71314,53381,54575,0.6605839416058394,0.43351682831700944
2340,0.6169,1,1,1,534297,71313,53382,54574,0.6605746785727519,0.43351577208131103
2341,0.617,4,11,4,534308,71302,53386,54570,0.6604727852087887,0.4335356552688445
2342,0.6171,0,3,0,534311,71299,53386,54570,0.6604449961095261,0.433545988289412
2343,0.6172,0,1,0,534312,71298,53386,54570,0.6604357330764385,0.43354943273906
2344,0.6173,1,1,1,534313,71297,53387,54569,0.660426470043351,0.43354837684521635
2345,0.6174,21,60,21,534373,71237,53408,54548,0.6598706880580978,0.4336606113606551
2346,0.6177,5,4,5,534377,71233,53413,54543,0.6598336359257475,0.4336518890726371
2347,0.6179,2,8,2,534385,71225,53415,54541,0.6597595316610471,0.43367046737592035
2348,0.6181,0,5,0,534390,71220,53415,54541,0.6597132164956093,0.43368770922623073
2349,0.6184,0,1,0,534391,71219,53415,54541,0.6597039534625218,0.43369115776081424
2350,0.6185,55,177,55,534568,71042,53470,54486,0.6580643966060247,0.4340545535657383
2351,0.6186,2,2,2,534570,71040,53472,54484,0.6580458705398495,0.43405245212071
2352,0.6187,0,2,0,534572,71038,53472,54484,0.6580273444736745,0.4340593680789025
2353,0.6188,1,2,1,534574,71036,53473,54483,0.6580088184074994,0.4340617755080904
2354,0.6189,10,11,10,534585,71025,53483,54473,0.6579069250435362,0.4340547259717286
2355,0.6192,33,60,33,534645,70965,53516,54440,0.657351143058283,0.43411347234958736
2356,0.6193,2,2,2,534647,70963,53518,54438,0.6573326169921079,0.4341113707227215
2357,0.6194,12,26,12,534673,70937,53530,54426,0.6570917781318315,0.4341472364254206
2358,0.6196,4,9,4,534682,70928,53534,54422,0.6570084108340435,0.434160351017152
2359,0.6197,1,3,1,534685,70925,53535,54421,0.6569806217347809,0.4341662278812248
2360,0.62,1676,4732,1676,539417,66193,55211,52745,0.6131479491644745,0.44346634380937966
2361,0.6205,0,1,0,539418,66192,55211,52745,0.6131386861313869,0.44347007239126596
2362,0.6207,0,1,0,539419,66191,55211,52745,0.6131294230982993,0.4434738010358512
2363,0.6209,0,1,0,539420,66190,55211,52745,0.6131201600652118,0.44347752974313703
2364,0.621,0,1,0,539421,66189,55211,52745,0.6131108970321242,0.4434812585131249
2365,0.6211,0,1,0,539422,66188,55211,52745,0.6131016339990366,0.44348498734581654
2366,0.622,0,1,0,539423,66187,55211,52745,0.613092370965949,0.44348871624121344
2367,0.6226,0,1,0,539424,66186,55211,52745,0.6130831079328616,0.44349244519931724
2368,0.623,0,1,0,539425,66185,55211,52745,0.613073844899774,0.4434961742201295
2369,0.6231,0,1,0,539426,66184,55211,52745,0.6130645818666864,0.44349990330365174
2370,0.6238,1,2,1,539428,66182,55212,52744,0.6130460558005113,0.44350268234027884
2371,0.6239,0,1,0,539429,66181,55212,52744,0.6130367927674237,0.44350641160395204
2372,0.6243,0,1,0,539430,66180,55212,52744,0.6130275297343362,0.4435101409303421
2373,0.6246,0,1,0,539431,66179,55212,52744,0.6130182667012487,0.4435138703194504
2374,0.6247,1,1,1,539432,66178,55213,52743,0.6130090036681611,0.44351292034207584
2375,0.6248,0,1,0,539433,66177,55213,52743,0.6129997406350736,0.44351664984863776
2376,0.625,2,3,2,539436,66174,55215,52741,0.6129719515358109,0.4435184795862591
2377,0.6253,1,0,1,539436,66174,55216,52740,0.6129719515358109,0.4435137998889954
2378,0.6255,0,1,0,539437,66173,55216,52740,0.6129626885027233,0.44351752962249713
2379,0.6257,0,2,0,539439,66171,55216,52740,0.6129441624365483,0.44352498927769507
2380,0.6258,1,7,1,539446,66164,55217,52739,0.6128793212049354,0.44354642019124835
2381,0.6259,5,5,5,539451,66159,55222,52734,0.6128330060394975,0.44354167192349425
2382,0.626,0,2,0,539453,66157,55222,52734,0.6128144799733225,0.44354913323969014
2383,0.6264,1,3,1,539456,66154,55223,52733,0.6127866908740598,0.4435556452766072
2384,0.6265,13,26,13,539482,66128,55236,52720,0.6125458520137834,0.44359181475498116
2385,0.6266,1,3,1,539485,66125,55237,52719,0.6125180629145207,0.44359833058463194
2386,0.6267,0,1,0,539486,66124,55237,52719,0.6125087998814331,0.4436020632262733
2387,0.6268,0,1,0,539487,66123,55237,52719,0.6124995368483456,0.4436057959307316
2388,0.6269,0,2,0,539489,66121,55237,52719,0.6124810107821705,0.44361326152810504
2389,0.627,3,7,3,539496,66114,55240,52716,0.6124161695505577,0.443625347134562
2390,0.6274,18,67,18,539563,66047,55258,52698,0.6117955463336915,0.4437913175291591
2391,0.6275,0,2,0,539565,66045,55258,52698,0.6117770202675163,0.44379879234986486
2392,0.6277,0,12,0,539577,66033,55258,52698,0.6116658638704657,0.44384364656239733
2393,0.6278,1,0,1,539577,66033,55259,52697,0.6116658638704657,0.44383896235155396
2394,0.6279,2,10,2,539587,66023,55261,52695,0.6115732335395903,0.44386697889115384
2395,0.628,0,1,0,539588,66022,55261,52695,0.6115639705065027,0.4438707177573557
2396,0.6281,0,1,0,539589,66021,55261,52695,0.6115547074734151,0.443874456686546
2397,0.6284,1,5,1,539594,66016,55262,52694,0.6115083923079774,0.4438884676943813
2398,0.6285,61,176,61,539770,65840,55323,52633,0.6098780984845678,0.44426156170604275
2399,0.6288,1,4,1,539774,65836,55324,52632,0.6098410463522176,0.4442718708849647
2400,0.6289,6,8,6,539782,65828,55330,52626,0.6097669420875171,0.4442737265098688
2401,0.629,0,1,0,539783,65827,55330,52626,0.6097576790544296,0.444277477142833
2402,0.6291,0,1,0,539784,65826,55330,52626,0.609748416021342,0.4442812278391247
2403,0.6292,17,60,17,539844,65766,55347,52609,0.6091926340360888,0.44442661034846886
2404,0.6293,0,1,0,539845,65765,55347,52609,0.6091833710030012,0.4444303647760488
2405,0.6294,9,16,9,539861,65749,55356,52600,0.6090351624736003,0.444448199815799
2406,0.6296,1,5,1,539866,65744,55357,52599,0.6089888473081626,0.44446228336276755
2407,0.6297,3,5,3,539871,65739,55360,52596,0.6089425321427249,0.4444669793383192
2408,0.6299,0,1,0,539872,65738,55360,52596,0.6089332691096373,0.44447073537613874
2409,0.63,1780,4488,1780,544360,61250,57140,50816,0.567360776612694,0.4534470758303143
2410,0.631,0,1,0,544361,61249,57140,50816,0.5673515135796066,0.45345112211662875
2411,0.6313,1,1,1,544362,61248,57141,50815,0.567342250546519,0.4534502913539705
2412,0.6314,0,1,0,544363,61247,57141,50815,0.5673329875134314,0.4534543377773019
2413,0.6316,1,0,1,544363,61247,57142,50814,0.5673329875134314,0.45344946056165836
2414,0.6321,1,0,1,544363,61247,57143,50813,0.5673329875134314,0.4534445832589684
2415,0.6322,0,1,0,544364,61246,57143,50813,0.5673237244803438,0.4534486297396907
2416,0.6324,0,2,0,544366,61244,57143,50813,0.5673051984141687,0.45345672291780076
2417,0.6328,2,0,2,544366,61244,57145,50811,0.5673051984141687,0.45344696800678236
2418,0.6331,0,1,0,544367,61243,57145,50811,0.5672959353810811,0.45345101468934623
2419,0.6332,0,1,0,544368,61242,57145,50811,0.5672866723479937,0.45345506144413805
2420,0.6335,1,1,1,544369,61241,57146,50810,0.5672774093149061,0.4534542306628232
2421,0.6336,1,0,1,544369,61241,57147,50809,0.5672774093149061,0.4534493529674253
2422,0.6339,0,4,0,544373,61237,57147,50809,0.5672403571825558,0.4534655409385431
2423,0.6342,0,1,0,544374,61236,57147,50809,0.5672310941494683,0.45346958811191934
2424,0.6343,1,5,1,544379,61231,57148,50808,0.5671847789840305,0.45348494720588367
2425,0.6347,1,5,1,544384,61226,57149,50807,0.5671384638185928,0.4535003079449805
2426,0.6349,2,1,2,544385,61225,57151,50805,0.5671292007855052,0.45349459966080513
2427,0.635,1,6,1,544391,61219,57152,50804,0.5670736225869799,0.4535140105156977
2428,0.6352,1,0,1,544391,61219,57153,50803,0.5670736225869799,0.45350913213475924
2429,0.6353,1,1,1,544392,61218,57154,50802,0.5670643595538923,0.4535083020889127
2430,0.6355,1,1,1,544393,61217,57155,50801,0.5670550965208048,0.4535074720134264
2431,0.6357,1,1,1,544394,61216,57156,50800,0.5670458334877172,0.4535066419082988
2432,0.6358,2,8,2,544402,61208,57158,50798,0.5669717292230168,0.45352927521739905
2433,0.6359,3,7,3,544409,61201,57161,50795,0.5669068879914039,0.4535429836779885
2434,0.636,1,1,1,544410,61200,57162,50794,0.5668976249583163,0.45354215404396664
2435,0.6363,0,1,0,544411,61199,57162,50794,0.5668883619252288,0.4535462037805934
2436,0.6364,0,3,0,544414,61196,57162,50794,0.5668605728259661,0.4535583534244129
2437,0.6365,1,21,1,544435,61175,57163,50793,0.5666660491311275,0.4536385395827379
2438,0.6366,2,2,2,544437,61173,57165,50791,0.5666475230649524,0.45363688328391266
2439,0.6368,0,1,0,544438,61172,57165,50791,0.5666382600318648,0.45364093495172514
2440,0.6369,0,2,0,544440,61170,57165,50791,0.5666197339656898,0.45364903850447924
2441,0.637,3,11,3,544451,61159,57168,50788,0.5665178406017266,0.45367897308547794
2442,0.6373,0,1,0,544452,61158,57168,50788,0.566508577568639,0.45368302574455543
2443,0.6374,13,65,13,544517,61093,57181,50775,0.565906480417948,0.4538831479958523
2444,0.6375,1,1,1,544518,61092,57182,50774,0.5658972173848605,0.45388232349418056
2445,0.6376,0,1,0,544519,61091,57182,50774,0.565887954351773,0.45388638090555583
2446,0.6377,4,7,4,544526,61084,57186,50770,0.5658231131201601,0.4538952563162694
2447,0.6379,4,8,4,544534,61076,57190,50766,0.5657490088554596,0.4539081919135924
2448,0.6381,0,2,0,544536,61074,57190,50766,0.5657304827892845,0.45391630901287555
2449,0.6382,1,0,1,544536,61074,57191,50765,0.5657304827892845,0.45391142624665815
2450,0.6384,0,2,0,544538,61072,57191,50765,0.5657119567231094,0.4539195436215206
2451,0.6385,66,139,66,544677,60933,57257,50699,0.5644243951239394,0.4541618890640676
2452,0.6386,0,1,0,544678,60932,57257,50699,0.5644151320908518,0.454165957484928
2453,0.6388,0,2,0,544680,60930,57257,50699,0.5643966060246767,0.45417409454532426
2454,0.6389,4,12,4,544692,60918,57261,50695,0.5642854496276261,0.45420336340748835
2455,0.6392,23,52,23,544744,60866,57284,50672,0.5638037719070732,0.4543025695278739
2456,0.6393,0,2,0,544746,60864,57284,50672,0.5637852458408982,0.454310715822694
2457,0.6394,6,20,6,544766,60844,57290,50666,0.5635999851791471,0.4543628374136849
2458,0.6396,2,9,2,544775,60835,57292,50664,0.5635166178813591,0.45438972546838985
2459,0.6397,3,5,3,544780,60830,57295,50661,0.5634703027159214,0.45439542205200417
2460,0.6398,0,1,0,544781,60829,57295,50661,0.5634610396828338,0.45439949771279936
2461,0.64,1766,4333,1766,549114,56496,59061,48895,0.5233243173144615,0.46393904602859826
2462,0.6403,0,1,0,549115,56495,59061,48895,0.5233150542813739,0.4639434481449853
2463,0.6415,0,1,0,549116,56494,59061,48895,0.5233057912482864,0.46394785034491265
2464,0.6416,0,1,0,549117,56493,59061,48895,0.5232965282151988,0.46395225262838274
2465,0.6417,1,0,1,549117,56493,59062,48894,0.5232965282151988,0.46394716615901394
2466,0.6421,1,0,1,549117,56493,59063,48893,0.5232965282151988,0.46394207959311484
2467,0.6426,0,1,0,549118,56492,59063,48893,0.5232872651821112,0.46394648194714616
2468,0.6428,0,1,0,549119,56491,59063,48893,0.5232780021490236,0.4639508843847263
2469,0.6432,0,2,0,549121,56489,59063,48893,0.5232594760828486,0.4639596895105426
2470,0.6435,1,0,1,549121,56489,59064,48892,0.5232594760828486,0.4639546028221406
2471,0.6437,0,1,0,549122,56488,59064,48892,0.523250213049761,0.4639590055038907
2472,0.6439,0,3,0,549125,56485,59064,48892,0.5232224239504983,0.4639722140505044
2473,0.6447,1,3,1,549128,56482,59065,48891,0.5231946348512357,0.4639803365188426
2474,0.6448,0,1,0,549129,56481,59065,48891,0.5231853718181482,0.46398473977906846
2475,0.645,0,5,0,549134,56476,59065,48891,0.5231390566527103,0.46400675733389013
2476,0.6452,0,1,0,549135,56475,59065,48891,0.5231297936196229,0.4640111610956096
2477,0.6453,1,4,1,549139,56471,59066,48890,0.5230927414872726,0.4640236899801634
2478,0.6457,1,0,1,549139,56471,59067,48889,0.5230927414872726,0.46401860288534547
2479,0.6458,4,6,4,549145,56465,59071,48885,0.5230371632887473,0.46402467963929755
2480,0.6459,2,10,2,549155,56455,59073,48883,0.5229445329578717,0.4640585543678445
2481,0.6462,1,0,1,549155,56455,59074,48882,0.5229445329578717,0.46405346649325496
2482,0.6464,0,3,0,549158,56452,59074,48882,0.5229167438586091,0.46406668312225874
2483,0.6465,2,23,2,549181,56429,59076,48880,0.5227036940975953,0.46415785925229563
2484,0.6466,2,3,2,549184,56426,59078,48878,0.5226759049983326,0.46416090556863937
2485,0.6468,0,1,0,549185,56425,59078,48878,0.5226666419652451,0.4641653134288672
2486,0.6469,2,1,2,549186,56424,59080,48876,0.5226573789321576,0.46415954415954414
2487,0.647,2,12,2,549198,56412,59082,48874,0.5225462225351069,0.4642022681078206
2488,0.6472,0,1,0,549199,56411,59082,48874,0.5225369595020194,0.46420667711449876
2489,0.6473,0,2,0,549201,56409,59082,48874,0.5225184334358443,0.46421549537912105
2490,0.6474,22,59,22,549260,56350,59104,48852,0.5219719144836785,0.46436379536510713
2491,0.6475,0,2,0,549262,56348,59104,48852,0.5219533884175034,0.4643726235741445
2492,0.6476,0,1,0,549263,56347,59104,48852,0.5219441253844159,0.46437703780454187
2493,0.6477,4,4,4,549267,56343,59108,48848,0.5219070732520656,0.46437432860225686
2494,0.6479,4,7,4,549274,56336,59112,48844,0.5218422320204528,0.46438486404259366
2495,0.648,0,1,0,549275,56335,59112,48844,0.5218329689873652,0.4643892792287434
2496,0.6481,1,1,1,549276,56334,59113,48843,0.5218237059542776,0.46438860207079496
2497,0.6484,3,1,3,549277,56333,59116,48840,0.5218144429211902,0.4643777395339108
2498,0.6485,57,107,57,549384,56226,59173,48783,0.5208232983808219,0.46456018055595233
2499,0.6486,0,2,0,549386,56224,59173,48783,0.5208047723146467,0.4645690287314179
2500,0.6488,0,3,0,549389,56221,59173,48783,0.520776983215384,0.4645823016266047
2501,0.6489,7,10,7,549399,56211,59180,48776,0.5206843528845085,0.4645908541057464
2502,0.6492,21,62,21,549461,56149,59201,48755,0.5201100448330801,0.46475825516662855
2503,0.6494,11,20,11,549481,56129,59212,48744,0.519924784171329,0.46479074690339744
2504,0.6495,1,0,1,549481,56129,59213,48743,0.519924784171329,0.46478564345106416
2505,0.6496,1,8,1,549489,56121,59214,48742,0.5198506799066286,0.46481599801645956
2506,0.6497,1,3,1,549492,56118,59215,48741,0.519822890807366,0.46482419248705403
2507,0.65,1649,4057,1649,553549,52061,60864,47092,0.48224276557115864,0.4749427652214255
2508,0.6504,0,1,0,553550,52060,60864,47092,0.48223350253807107,0.4749475552686784
2509,0.6505,0,1,0,553551,52059,60864,47092,0.4822242395049835,0.47495234541255255
2510,0.6511,1,0,1,553551,52059,60865,47091,0.4822242395049835,0.47494704992435705
2511,0.6524,0,4,0,553555,52055,60865,47091,0.4821871873726333,0.4749662114457467
2512,0.6527,0,1,0,553556,52054,60865,47091,0.48217792433954576,0.47497100206767867
2513,0.6531,0,1,0,553557,52053,60865,47091,0.4821686613064582,0.4749757927862503
2514,0.6535,1,0,1,553557,52053,60866,47090,0.4821686613064582,0.4749704971606669
2515,0.6539,2,1,2,553558,52052,60868,47088,0.4821593982733706,0.47496469638894495
2516,0.6542,1,1,1,553559,52051,60869,47087,0.48215013524028305,0.4749641913292582
2517,0.6543,1,5,1,553564,52046,60870,47086,0.4821038200748453,0.47498285114796435
2518,0.6547,0,1,0,553565,52045,60870,47086,0.48209455704175774,0.4749876426143184
2519,0.6548,1,0,1,553565,52045,60871,47085,0.48209455704175774,0.47498234641380005
2520,0.6549,0,1,0,553566,52044,60871,47085,0.4820852940086702,0.4749871379717338
2521,0.655,2,7,2,553573,52037,60873,47083,0.4820204527770573,0.4750100887812752
2522,0.6551,0,1,0,553574,52036,60873,47083,0.4820111897439698,0.47501488110251316
2523,0.6553,0,1,0,553575,52035,60873,47083,0.4820019267108822,0.4750196735204504
2524,0.6555,0,1,0,553576,52034,60873,47083,0.48199266367779464,0.47502446603508985
2525,0.6556,1,1,1,553577,52033,60874,47082,0.4819834006447071,0.4750239620642688
2526,0.6557,1,1,1,553578,52032,60875,47081,0.48197413761161956,0.4750234580731085
2527,0.6558,3,6,3,553584,52026,60878,47078,0.48191855941309425,0.47503632547626734
2528,0.6559,1,7,1,553591,52019,60879,47077,0.48185371818148137,0.47506458383789457
2529,0.656,1,4,1,553595,52015,60880,47076,0.48181666604913115,0.4750784632307677
2530,0.6562,0,1,0,553596,52014,60880,47076,0.4818074030160436,0.47508325764456555
2531,0.6563,1,1,1,553597,52013,60881,47075,0.481798139982956,0.47508275472307443
2532,0.6564,2,1,2,553598,52012,60883,47073,0.48178887694986844,0.47507695413029216
2533,0.6565,10,9,10,553607,52003,60893,47063,0.4817055096520805,0.4750671269658611
2534,0.6566,1,3,1,553610,52000,60894,47062,0.4816777205528178,0.4750762148957219
2535,0.6567,0,1,0,553611,51999,60894,47062,0.48166845751973025,0.4750810106903827
2536,0.6569,1,0,1,553611,51999,60895,47061,0.48166845751973025,0.47507571168988494
2537,0.657,6,6,6,553617,51993,60901,47055,0.48161287932120495,0.4750726920281076
2538,0.6571,3,0,3,553617,51993,60904,47052,0.48161287932120495,0.47505679236710585
2539,0.6573,1,0,1,553617,51993,60905,47051,0.48161287932120495,0.4750514922660636
2540,0.6574,19,40,19,553657,51953,60924,47032,0.48124235799770276,0.47514269838864476
2541,0.6577,1,5,1,553662,51948,60925,47031,0.48119604283226497,0.47516139787227596
2542,0.6578,0,1,0,553663,51947,60925,47031,0.48118677979917746,0.4751661985491725
2543,0.6579,4,10,4,553673,51937,60929,47027,0.4810941494683019,0.4751929994745564
2544,0.6581,0,1,0,553674,51936,60929,47027,0.48108488643521435,0.4751978011984277
2545,0.6583,1,0,1,553674,51936,60930,47026,0.48108488643521435,0.4751924981305956
2546,0.6585,56,119,56,553793,51817,60986,46970,0.4799825854977954,0.4754674198022007
2547,0.6586,0,1,0,553794,51816,60986,46970,0.47997332246470786,0.475472232907497
2548,0.6589,3,16,3,553810,51800,60989,46967,0.47982511393530697,0.4755333259084512
2549,0.659,0,1,0,553811,51799,60989,46967,0.4798158509022194,0.4755381406556912
2550,0.6592,22,66,22,553877,51733,61011,46945,0.47920449071844085,0.47573927319159287
2551,0.6593,0,2,0,553879,51731,61011,46945,0.47918596465226576,0.47574891564311483
2552,0.6594,12,22,12,553901,51709,61023,46933,0.47898217792433956,0.47579124510857446
2553,0.6595,0,1,0,553902,51708,61023,46933,0.478972914891252,0.475796068571892
2554,0.6596,1,5,1,553907,51703,61024,46932,0.4789265997258142,0.47581487301667763
2555,0.6597,3,1,3,553908,51702,61027,46929,0.4789173366927267,0.4758037533838246
2556,0.66,1662,3744,1662,557652,47958,62689,45267,0.4442365408129238,0.4855671761866452
2557,0.6603,0,1,0,557653,47957,62689,45267,0.4442272777798362,0.48557238479361536
2558,0.6616,0,1,0,557654,47956,62689,45267,0.44421801474674866,0.48557759351233065
2559,0.6618,1,2,1,557656,47954,62690,45266,0.4441994886805736,0.4855824930272474
2560,0.6622,0,2,0,557658,47952,62690,45266,0.44418096261439843,0.4855929112403184
2561,0.6624,2,1,2,557659,47951,62692,45264,0.4441716995813109,0.48558708362388026
2562,0.6626,0,1,0,557660,47950,62692,45264,0.44416243654822335,0.48559229300319695
2563,0.6628,1,1,1,557661,47949,62693,45263,0.4441531735151358,0.48559198386473845
2564,0.6631,2,0,2,557661,47949,62695,45261,0.4441531735151358,0.4855809462504023
2565,0.6632,0,1,0,557662,47948,62695,45261,0.44414391048204827,0.4855861558433199
2566,0.6634,0,2,0,557664,47946,62695,45261,0.4441253844158731,0.48559657536451123
2567,0.6635,0,1,0,557665,47945,62695,45261,0.44411612138278556,0.4856017852927923
2568,0.6638,1,0,1,557665,47945,62696,45260,0.44411612138278556,0.4855962662947267
2569,0.6639,0,1,0,557666,47944,62696,45260,0.44410685834969804,0.4856014763314879
2570,0.6641,0,1,0,557667,47943,62696,45260,0.44409759531661047,0.4856066864800489
2571,0.6642,0,1,0,557668,47942,62696,45260,0.4440883322835229,0.4856118967404133
2572,0.6643,0,3,0,557671,47939,62696,45260,0.44406054318426025,0.4856275281923626
2573,0.6646,0,1,0,557672,47938,62696,45260,0.4440512801511727,0.4856327388999764
2574,0.6647,0,1,0,557673,47937,62696,45260,0.44404201711808516,0.48563794971941154
2575,0.6648,2,1,2,557674,47936,62698,45258,0.4440327540849976,0.48563212223962915
2576,0.665,4,5,4,557679,47931,62702,45254,0.4439864389195598,0.48563610023072384
2577,0.6651,0,1,0,557680,47930,62702,45254,0.4439771758864723,0.4856413118131868
2578,0.6653,2,3,2,557683,47927,62704,45252,0.4439493867872096,0.48564590733963664
2579,0.6658,2,5,2,557688,47922,62706,45250,0.44390307162177184,0.48566092817584683
2580,0.6659,3,4,3,557692,47918,62709,45247,0.4438660194894216,0.48566521762464443
2581,0.6663,0,1,0,557693,47917,62709,45247,0.44385675645633405,0.48567043063844406
2582,0.6664,1,1,1,557694,47916,62710,45246,0.44384749342324653,0.4856701230115283
2583,0.6665,5,18,5,557712,47898,62715,45241,0.44368075882767055,0.4857363725184939
2584,0.6666,2,2,2,557714,47896,62717,45239,0.4436622327614954,0.485735759918398
2585,0.6669,2,1,2,557715,47895,62719,45237,0.44365296972840784,0.4857299317098312
2586,0.667,2,10,2,557725,47885,62721,45235,0.4435603393975323,0.48577104810996563
2587,0.6673,0,1,0,557726,47884,62721,45235,0.4435510763644448,0.4857762647794757
2588,0.6674,28,39,28,557765,47845,62749,45207,0.4431898180740302,0.48582513003481925
2589,0.6677,4,5,4,557770,47840,62753,45203,0.4431435029085924,0.4858291327665703
2590,0.6678,0,1,0,557771,47839,62753,45203,0.4431342398755048,0.4858343543775929
2591,0.6679,2,8,2,557779,47831,62755,45201,0.44306013561080443,0.4858650786826038
2592,0.6681,0,5,0,557784,47826,62755,45201,0.44301382044536664,0.4858911928794866
2593,0.6682,0,1,0,557785,47825,62755,45201,0.44300455741227907,0.48589641605572637
2594,0.6684,0,1,0,557786,47824,62755,45201,0.4429952943791915,0.4859016393442623
2595,0.6685,45,119,45,557905,47705,62800,45156,0.4418929934417726,0.4862751854922949
2596,0.6686,3,1,3,557906,47704,62803,45153,0.441883730408685,0.48626382502126925
2597,0.6688,2,3,2,557909,47701,62805,45151,0.44185594130942235,0.48626847025373715
2598,0.6689,5,15,5,557924,47686,62810,45146,0.441716995813109,0.48631937263012753
2599,0.6692,23,55,23,557979,47631,62833,45123,0.4412075289932936,0.48648036742350736
2600,0.6693,1,3,1,557982,47628,62834,45122,0.4411797398940309,0.4864905660377358
2601,0.6694,13,18,13,558000,47610,62847,45109,0.44101300529845494,0.48651301243542316
2602,0.6696,2,9,2,558009,47601,62849,45107,0.4409296380006669,0.4865491651205937
2603,0.6697,1,2,1,558011,47599,62850,45106,0.44091111193449184,0.4865541232943207
2604,0.6698,0,1,0,558012,47598,62850,45106,0.44090184890140427,0.4865593717638937
2605,0.67,1650,3496,1650,561508,44102,64500,43456,0.4085182852273148,0.4963110166975034
2606,0.6705,1,2,1,561510,44100,64501,43455,0.40849975916113973,0.49631660099366115
2607,0.6706,1,0,1,561510,44100,64502,43454,0.40849975916113973,0.496310848162277
2608,0.6707,0,2,0,561512,44098,64502,43454,0.4084812330949646,0.4963221856725146
2609,0.6708,1,1,1,561513,44097,64503,43453,0.4084719700618771,0.49632210165619645
2610,0.6714,0,1,0,561514,44096,64503,43453,0.4084627070287895,0.49632777073410317
2611,0.6715,1,0,1,561514,44096,64504,43452,0.4084627070287895,0.49632201763603967
2612,0.6716,0,3,0,561517,44093,64504,43452,0.40843491792952685,0.49633902564395455
2613,0.6718,0,1,0,561518,44092,64504,43452,0.4084256548964393,0.49634469523896557
2614,0.6721,0,1,0,561519,44091,64504,43452,0.4084163918633517,0.49635036496350365
2615,0.6723,2,0,2,561519,44091,64506,43450,0.4084163918633517,0.49633885836350966
2616,0.6726,0,1,0,561520,44090,64506,43450,0.4084071288302642,0.4963445282156728
2617,0.6727,1,0,1,561520,44090,64507,43449,0.4084071288302642,0.49633877471755444
2618,0.6732,0,1,0,561521,44089,64507,43449,0.40839786579717663,0.49634444469830247
2619,0.6735,0,3,0,561524,44086,64507,43449,0.408370076697914,0.4963614554178329
2620,0.6738,1,0,1,561524,44086,64508,43448,0.408370076697914,0.4963557017844495
2621,0.6739,3,0,3,561524,44086,64511,43445,0.408370076697914,0.49633844009550904
2622,0.6743,2,0,2,561524,44086,64513,43443,0.408370076697914,0.4963269316455118
2623,0.6744,0,2,0,561526,44084,64513,43443,0.40835155063173884,0.49633827276154785
2624,0.6747,0,4,0,561530,44080,64513,43443,0.40831449849938867,0.4963609565485644
2625,0.6748,0,1,0,561531,44079,64513,43443,0.4083052354663011,0.49636662781929114
2626,0.6749,0,2,0,561533,44077,64513,43443,0.40828670940012596,0.496377970749543
2627,0.675,2,2,2,561535,44075,64515,43441,0.4082681833339509,0.4963778052013346
2628,0.6752,0,2,0,561537,44073,64515,43441,0.40824965726777573,0.49638914916470506
2629,0.6753,1,2,1,561539,44071,64516,43440,0.40823113120160065,0.4963947389471038
2630,0.6754,0,1,0,561540,44070,64516,43440,0.4082218681685131,0.4964004113815564
2631,0.6756,2,0,2,561540,44070,64518,43438,0.4082218681685131,0.4963889015861407
2632,0.6757,1,2,1,561542,44068,64519,43437,0.408203342102338,0.49639449174332895
2633,0.6758,3,4,3,561546,44064,64522,43434,0.40816628996998777,0.4963999177124049
2634,0.6759,3,1,3,561547,44063,64525,43431,0.4081570269369002,0.49638832377077285
2635,0.676,0,2,0,561549,44061,64525,43431,0.4081385008707251,0.49639967082704706
2636,0.6762,1,0,1,561549,44061,64526,43430,0.4081385008707251,0.4963939148026654
2637,0.6763,0,2,0,561551,44059,64526,43430,0.40811997480455,0.49640526237584154
2638,0.6764,2,1,2,561552,44058,64528,43428,0.40811071177146246,0.49639942390782527
2639,0.6765,3,15,3,561567,44043,64531,43425,0.40797176627514914,0.4964672794622033
2640,0.6766,0,4,0,561571,44039,64531,43425,0.4079347141427989,0.49648998445074544
2641,0.6768,0,1,0,561572,44038,64531,43425,0.40792545110971135,0.4964956610223752
2642,0.6769,0,1,0,561573,44037,64531,43425,0.40791618807662383,0.4965013377238115
2643,0.677,5,6,5,561579,44031,64536,43420,0.40786060987809847,0.49650661513304595
2644,0.6772,1,0,1,561579,44031,64537,43419,0.40786060987809847,0.4965008576329331
2645,0.6773,0,2,0,561581,44029,64537,43419,0.4078420838119234,0.49651221297228065
2646,0.6774,22,44,22,561625,43985,64559,43397,0.407434510356071,0.49663546268110137
2647,0.6775,1,0,1,561625,43985,64560,43396,0.407434510356071,0.49662970210915414
2648,0.6777,2,11,2,561636,43974,64562,43394,0.4073326169921079,0.496680706894973
2649,0.6778,0,1,0,561637,43973,64562,43394,0.40732335395902036,0.49668639188709696
2650,0.6779,3,5,3,561642,43968,64565,43391,0.40727703879358257,0.49669753545713663
2651,0.6781,1,4,1,561646,43964,64566,43390,0.40723998666123234,0.4967145179385031
2652,0.6783,0,1,0,561647,43963,64566,43390,0.4072307236281448,0.4967202042288187
2653,0.6784,1,3,1,561650,43960,64567,43389,0.4072029345288821,0.4967315023640797
2654,0.6785,58,105,58,561755,43855,64625,43331,0.40623031605468896,0.49699493037873055
2655,0.6786,0,1,0,561756,43854,64625,43331,0.4062210530216014,0.49700063084246143
2656,0.6788,2,3,2,561759,43851,64627,43329,0.40619326392233873,0.49700619408121127
2657,0.6789,2,4,2,561763,43847,64629,43327,0.4061562117899885,0.49701745933420516
2658,0.679,0,2,0,561765,43845,64629,43327,0.4061376857238134,0.4970288624787776
2659,0.6792,16,38,16,561803,43807,64645,43311,0.4057856904664863,0.49715328634725314
2660,0.6794,5,25,5,561828,43782,64650,43306,0.40555411463929747,0.49726713209627044
2661,0.6796,4,3,4,561831,43779,64654,43302,0.4055263255400348,0.4972611706342371
2662,0.6797,2,1,2,561832,43778,64656,43300,0.4055170625069473,0.49725533429798574
2663,0.6799,0,2,0,561834,43776,64656,43300,0.40549853644077216,0.4972667554779733
2664,0.68,1636,3270,1636,565104,40506,66292,41664,0.37520841824447,0.5070463672873311
2665,0.6802,1,0,1,565104,40506,66293,41663,0.37520841824447,0.5070403680220035
2666,0.6803,0,1,0,565105,40505,66293,41663,0.3751991552113824,0.5070465387985591
2667,0.6805,0,1,0,565106,40504,66293,41663,0.37518989217829485,0.5070527097253155
2668,0.6811,1,1,1,565107,40503,66294,41662,0.37518062914520733,0.5070528813971886
2669,0.6814,0,1,0,565108,40502,66294,41662,0.37517136611211976,0.5070590526264545
2670,0.6816,0,1,0,565109,40501,66294,41662,0.3751621030790322,0.5070652240059395
2671,0.682,1,1,1,565110,40500,66295,41661,0.3751528400459446,0.5070653959907986
2672,0.6824,0,1,0,565111,40499,66295,41661,0.3751435770128571,0.5070715676728335
2673,0.6829,0,1,0,565112,40498,66295,41661,0.37513431397976954,0.5070777395051059
2674,0.683,0,1,0,565113,40497,66295,41661,0.37512505094668197,0.5070839114876214
2675,0.6833,1,1,1,565114,40496,66296,41660,0.3751157879135944,0.5070840839378743
2676,0.6834,0,1,0,565115,40495,66296,41660,0.3751065248805069,0.5070902562229931
2677,0.6835,1,1,1,565116,40494,66297,41659,0.3750972618474193,0.5070904288340048
2678,0.6836,0,1,0,565117,40493,66297,41659,0.37508799881433175,0.5070966014217548
2679,0.6838,0,1,0,565118,40492,66297,41659,0.37507873578124423,0.5071027741597789
2680,0.6839,0,3,0,565121,40489,66297,41659,0.3750509466819815,0.5071212932755514
2681,0.6843,0,1,0,565122,40488,66297,41659,0.375041683648894,0.5071274666147273
2682,0.6847,2,2,2,565124,40486,66299,41657,0.37502315758271887,0.5071278136907588
2683,0.6849,0,1,0,565125,40485,66299,41657,0.37501389454963135,0.5071339874850868
2684,0.685,0,3,0,565128,40482,66299,41657,0.37498610545036865,0.507152509770024
2685,0.6853,1,1,1,565129,40481,66300,41656,0.37497684241728113,0.5071526839305064
2686,0.6855,2,2,2,565131,40479,66302,41654,0.374958316351106,0.5071530322769167
2687,0.6857,0,1,0,565132,40478,66302,41654,0.3749490533180185,0.5071592071299859
2688,0.6858,4,5,4,565137,40473,66306,41650,0.3749027381525807,0.5071660801480706
2689,0.6859,2,8,2,565145,40465,66308,41648,0.37482863388788024,0.507203487876463
2690,0.6862,1,0,1,565145,40465,66309,41647,0.37482863388788024,0.5071974863600935
2691,0.6864,0,2,0,565147,40463,66309,41647,0.37481010782170515,0.5072098404579223
2692,0.6865,2,15,2,565162,40448,66311,41645,0.3746711623253918,0.507290511980315
2693,0.6866,1,3,1,565165,40445,66312,41644,0.3746433732261292,0.5073030491296032
2694,0.6868,1,0,1,565165,40445,66313,41643,0.3746433732261292,0.5072970470714355
2695,0.687,1,6,1,565171,40439,66314,41642,0.37458779502760386,0.5073281270939681
2696,0.6871,0,1,0,565172,40438,66314,41642,0.3745785319945163,0.5073343079922027
2697,0.6872,0,2,0,565174,40436,66314,41642,0.37456000592834116,0.507346670240503
2698,0.6873,1,0,1,565174,40436,66315,41641,0.37456000592834116,0.5073406679094021
2699,0.6874,23,32,23,565206,40404,66338,41618,0.3742635888695394,0.5074004535368559
2700,0.6877,3,5,3,565211,40399,66341,41615,0.3742172737041017,0.5074133684492892
2701,0.6878,1,0,1,565211,40399,66342,41614,0.3742172737041017,0.5074073622474485
2702,0.6879,4,21,4,565232,40378,66346,41610,0.37402275000926305,0.5075132946284823
2703,0.6881,0,3,0,565235,40375,66346,41610,0.3739949609100004,0.507531865585168
2704,0.6882,0,1,0,565236,40374,66346,41610,0.3739856978769128,0.5075380562060889
2705,0.6883,0,1,0,565237,40373,66346,41610,0.37397643484382526,0.507544246978032
2706,0.6884,1,0,1,565237,40373,66347,41609,0.37397643484382526,0.5075382401014857
2707,0.6885,62,115,62,565352,40258,66409,41547,0.3729111860387565,0.5078784915347473
2708,0.6886,1,2,1,565354,40256,66410,41546,0.3728926599725814,0.5078848927899073
2709,0.6888,0,2,0,565356,40254,66410,41546,0.37287413390640634,0.5078973105134474
2710,0.6889,1,9,1,565365,40245,66411,41545,0.3727907666086183,0.5079471818070669
2711,0.6892,27,48,27,565413,40197,66438,41518,0.37234614102041574,0.5080829713026984
2712,0.6893,0,1,0,565414,40196,66438,41518,0.3723368779873282,0.5080891891230389
2713,0.6894,7,20,7,565434,40176,66445,41511,0.3721516173255771,0.5081714348672371
2714,0.6896,2,9,2,565443,40167,66447,41509,0.3720682500277891,0.508215387629169
2715,0.6897,0,1,0,565444,40166,66447,41509,0.3720589869947015,0.5082216100397918
2716,0.69,1599,3116,1599,568560,37050,68046,39910,0.3431953758938827,0.518581081081081
2717,0.6901,0,1,0,568561,37049,68046,39910,0.34318611286079514,0.518587819488299
2718,0.6903,1,0,1,568561,37049,68047,39909,0.34318611286079514,0.5185815639699577
2719,0.6907,0,1,0,568562,37048,68047,39909,0.3431768498277076,0.5185883025585717
2720,0.6909,0,1,0,568563,37047,68047,39909,0.34316758679462,0.518595041322314
2721,0.691,0,1,0,568564,37046,68047,39909,0.3431583237615325,0.5186017802611916
2722,0.6911,1,0,1,568564,37046,68048,39908,0.3431583237615325,0.5185955245991112
2723,0.6912,0,1,0,568565,37045,68048,39908,0.3431490607284449,0.5186022637194132
2724,0.6916,1,0,1,568565,37045,68049,39907,0.3431490607284449,0.5185960079010292
2725,0.6917,1,0,1,568565,37045,68050,39906,0.3431490607284449,0.518589751920053
2726,0.6919,0,1,0,568566,37044,68050,39906,0.34313979769535735,0.5185964912280702
2727,0.6921,0,2,0,568568,37042,68050,39906,0.34312127162918227,0.5186099703696002
2728,0.6922,0,1,0,568569,37041,68050,39906,0.3431120085960947,0.5186167102031268
2729,0.6924,0,1,0,568570,37040,68050,39906,0.3431027455630071,0.5186234502118369
2730,0.6925,1,1,1,568571,37039,68051,39905,0.3430934825299196,0.5186239342898732
2731,0.6926,0,1,0,568572,37038,68051,39905,0.34308421949683204,0.5186306746552642
2732,0.6927,1,0,1,568572,37038,68052,39904,0.34308421949683204,0.5186244183930753
2733,0.693,0,2,0,568574,37036,68052,39904,0.34306569343065696,0.5186378996620743
2734,0.6932,0,2,0,568576,37034,68052,39904,0.3430471673644818,0.5186513816319634
2735,0.6933,0,1,0,568577,37033,68052,39904,0.34303790433139425,0.5186581228797588
2736,0.6934,0,2,0,568579,37031,68052,39904,0.34301937826521917,0.5186716059010853
2737,0.6937,0,1,0,568580,37030,68052,39904,0.3430101152321316,0.5186783476746302
2738,0.6939,0,2,0,568582,37028,68052,39904,0.3429915891659565,0.5186918317475173
2739,0.6941,0,1,0,568583,37027,68052,39904,0.34298232613286894,0.5186985740468731
2740,0.6943,0,1,0,568584,37026,68052,39904,0.3429730630997814,0.5187053165215131
2741,0.6947,3,2,3,568586,37024,68055,39901,0.3429545370336063,0.5187000324991875
2742,0.695,2,4,2,568590,37020,68057,39899,0.34291748490125606,0.5187144918680691
2743,0.6952,0,1,0,568591,37019,68057,39899,0.3429082218681685,0.5187212356015497
2744,0.6953,0,1,0,568592,37018,68057,39899,0.342898958835081,0.5187279795103813
2745,0.6955,1,2,1,568594,37016,68058,39898,0.34288043276890584,0.5187352107548691
2746,0.6957,0,2,0,568596,37014,68058,39898,0.34286190670273076,0.518748699812773
2747,0.6958,2,8,2,568604,37006,68060,39896,0.3427878024380303,0.5187901485006892
2748,0.6959,4,4,4,568608,37002,68064,39892,0.3427507503056801,0.5187921034150909
2749,0.696,0,1,0,568609,37001,68064,39892,0.3427414872725925,0.518798850350487
2750,0.6962,0,1,0,568610,37000,68064,39892,0.342732224239505,0.5188055974613744
2751,0.6963,0,1,0,568611,36999,68064,39892,0.34272296120641743,0.5188123447477598
2752,0.6964,0,1,0,568612,36998,68064,39892,0.34271369817332986,0.5188190922096502
2753,0.6965,3,14,3,568626,36984,68067,39889,0.3425840157101041,0.5188948005151354
2754,0.6966,1,4,1,568630,36980,68068,39888,0.3425469635777539,0.5189155435291669
2755,0.6969,2,1,2,568631,36979,68070,39886,0.34253770054466637,0.5189097768815456
2756,0.697,2,6,2,568637,36973,68072,39884,0.342482122346141,0.5189377675423189
2757,0.6971,1,1,1,568638,36972,68073,39883,0.3424728593130535,0.518938260360419
2758,0.6972,0,1,0,568639,36971,68073,39883,0.3424635962799659,0.518945012621334
2759,0.6973,1,1,1,568640,36970,68074,39882,0.34245433324687835,0.518945505647218
2760,0.6974,24,40,24,568680,36930,68098,39858,0.34208381192337617,0.5190654789810908
2761,0.6976,1,1,1,568681,36929,68099,39857,0.34207454889028865,0.519065975568463
2762,0.6977,4,3,4,568684,36926,68103,39853,0.342046759791026,0.5190612016306542
2763,0.6978,0,1,0,568685,36925,68103,39853,0.34203749675793843,0.5190679621766652
2764,0.6979,5,9,5,568694,36916,68108,39848,0.3419541294601504,0.5190974936167996
2765,0.698,1,0,1,568694,36916,68109,39847,0.3419541294601504,0.5190912288472311
2766,0.6981,0,3,0,568697,36913,68109,39847,0.34192634036088776,0.5191115164147994
2767,0.6984,1,2,1,568699,36911,68110,39846,0.3419078142947127,0.5191187774404941
2768,0.6985,60,95,60,568794,36816,68170,39786,0.341027826151395,0.5193859168167932
2769,0.6988,1,0,1,568794,36816,68171,39785,0.341027826151395,0.519379642563413
2770,0.6989,8,2,8,568796,36814,68179,39777,0.3410093000852199,0.5193430037471766
2771,0.699,0,1,0,568797,36813,68179,39777,0.34100003705213233,0.5193497845671758
2772,0.6992,24,45,24,568842,36768,68203,39753,0.3405832005631924,0.5195044497588898
2773,0.6993,0,2,0,568844,36766,68203,39753,0.34056467449701733,0.5195180282021459
2774,0.6994,6,17,6,568861,36749,68209,39747,0.34040720293452886,0.5195957958586069
2775,0.6996,3,5,3,568866,36744,68212,39744,0.3403608877690911,0.5196109193598996
2776,0.6997,2,2,2,568868,36742,68214,39742,0.340342361702916,0.5196119449819571
2777,0.6998,1,0,1,568868,36742,68215,39741,0.340342361702916,0.5196056640037655
2778,0.6999,0,1,0,568869,36741,68215,39741,0.34033309866982847,0.5196124578332156
2779,0.7,1617,2941,1617,571810,33800,69832,38124,0.3130905183593316,0.5300595072576608
2780,0.7003,0,1,0,571811,33799,69832,38124,0.31308125532624403,0.5300668770768738
2781,0.7009,1,0,1,571811,33799,69833,38123,0.31308125532624403,0.5300603431495231
2782,0.7012,0,2,0,571813,33797,69833,38123,0.3130627292600689,0.5300750834260289
2783,0.7017,1,0,1,571813,33797,69834,38122,0.3130627292600689,0.53006854934023
2784,0.7021,1,0,1,571813,33797,69835,38121,0.3130627292600689,0.5300620150727217
2785,0.7026,1,0,1,571813,33797,69836,38120,0.3130627292600689,0.5300554806234965
2786,0.7027,0,1,0,571814,33796,69836,38120,0.3130534662269814,0.5300628511040658
2787,0.7028,0,1,0,571815,33795,69836,38120,0.3130442031938938,0.5300702217896127
2788,0.7032,0,1,0,571816,33794,69836,38120,0.31303494016080624,0.5300775926801458
2789,0.7033,1,1,1,571817,33793,69837,38119,0.3130256771277187,0.5300784291912337
2790,0.7035,0,1,0,571818,33792,69837,38119,0.31301641409463116,0.5300858005034
2791,0.7039,0,4,0,571822,33788,69837,38119,0.31297936196228093,0.5301152878023002
2792,0.7042,0,1,0,571823,33787,69837,38119,0.31297009892919336,0.5301226601396267
2793,0.7043,0,2,0,571825,33785,69837,38119,0.3129515728630183,0.5301374054294615
2794,0.7044,1,3,1,571828,33782,69838,38118,0.3129237837637556,0.5301529902642559
2795,0.7046,0,1,0,571829,33781,69838,38118,0.31291452073066806,0.5301603638437252
2796,0.7047,2,0,2,571829,33781,69840,38116,0.31291452073066806,0.5301472940456486
2797,0.705,0,4,0,571833,33777,69840,38116,0.31287746859831783,0.5301767905081163
2798,0.7053,0,2,0,571835,33775,69840,38116,0.31285894253214275,0.5301915399702327
2799,0.7057,1,1,1,571836,33774,69841,38115,0.3128496794990552,0.5301923799190419
2800,0.7058,1,2,1,571838,33772,69842,38114,0.31283115343288004,0.5302005953871407
2801,0.7059,8,4,8,571842,33768,69850,38106,0.31279410130052987,0.5301778111695467
2802,0.7061,0,1,0,571843,33767,69850,38106,0.3127848382674423,0.5301851877617464
2803,0.7063,2,0,2,571843,33767,69852,38104,0.3127848382674423,0.5301721139263402
2804,0.7064,1,2,1,571845,33765,69853,38103,0.31276631220126716,0.5301803306061112
2805,0.7065,8,11,8,571856,33754,69861,38095,0.3126644188373041,0.5302091887152222
2806,0.7066,1,1,1,571857,33753,69862,38094,0.31265515580421654,0.5302100296463318
2807,0.7068,0,2,0,571859,33751,69862,38094,0.3126366297380414,0.5302247894773471
2808,0.7069,0,1,0,571860,33750,69862,38094,0.3126273667049539,0.5302321697010188
2809,0.707,7,5,7,571865,33745,69869,38087,0.3125810515395161,0.5302232988083305
2810,0.7072,1,0,1,571865,33745,69870,38086,0.3125810515395161,0.5302167587810277
2811,0.7074,23,40,23,571905,33705,69893,38063,0.3122105302160139,0.5303617211013265
2812,0.7076,0,1,0,571906,33704,69893,38063,0.3122012671829264,0.5303691111513649
2813,0.7077,2,2,2,571908,33702,69895,38061,0.31218274111675126,0.5303708038961582
2814,0.7078,0,2,0,571910,33700,69895,38061,0.3121642150505762,0.5303855854851521
2815,0.7079,1,8,1,571918,33692,69896,38060,0.31209011078587573,0.5304381759393466
2816,0.7081,0,2,0,571920,33690,69896,38060,0.31207158471970065,0.5304529616724739
2817,0.7084,1,0,1,571920,33690,69897,38059,0.31207158471970065,0.5304464173716706
2818,0.7085,59,91,59,572011,33599,69956,38000,0.3112286487087332,0.5307336694646573
2819,0.7086,0,1,0,572012,33598,69956,38000,0.3112193856756456,0.5307410821531328
2820,0.7088,1,4,1,572016,33594,69957,37999,0.31118233354329544,0.5307641808556702
2821,0.7089,5,10,5,572026,33584,69962,37994,0.31108970321241985,0.5308055547794015
2822,0.709,0,1,0,572027,33583,69962,37994,0.31108044017933234,0.5308129706469955
2823,0.7091,1,0,1,572027,33583,69963,37993,0.31108044017933234,0.5308064155582877
2824,0.7092,20,36,20,572063,33547,69983,37973,0.3107469709881804,0.5309423937360179
2825,0.7094,9,13,9,572076,33534,69992,37964,0.31062655155804214,0.530979887549302
2826,0.7095,1,0,1,572076,33534,69993,37963,0.31062655155804214,0.5309733275522049
2827,0.7096,5,7,5,572083,33527,69998,37958,0.31056171032642926,0.5309925159124291
2828,0.7097,3,1,3,572084,33526,70001,37955,0.31055244729334175,0.5309802604888012
2829,0.7098,1,0,1,572084,33526,70002,37954,0.31055244729334175,0.5309736989367655
2830,0.7099,1,0,1,572084,33526,70003,37953,0.31055244729334175,0.530967137201136
2831,0.71,1570,2761,1570,574845,30765,71573,36383,0.2849772129386046,0.5418329659855841
2832,0.7101,0,2,0,574847,30763,71573,36383,0.28495868687242953,0.5418491049355136
2833,0.7104,1,0,1,574847,30763,71574,36382,0.28495868687242953,0.5418422816293097
2834,0.7105,1,0,1,574847,30763,71575,36381,0.28495868687242953,0.5418354581198618
2835,0.7108,0,1,0,574848,30762,71575,36381,0.28494942383934196,0.5418435279924936
2836,0.7109,0,1,0,574849,30761,71575,36381,0.2849401608062544,0.5418515981055078
2837,0.7113,1,1,1,574850,30760,71576,36380,0.2849308977731668,0.5418528448019064
2838,0.7115,1,0,1,574850,30760,71577,36379,0.2849308977731668,0.5418460209416286
2839,0.7118,0,1,0,574851,30759,71577,36379,0.2849216347400793,0.5418540915725818
2840,0.7124,2,2,2,574853,30757,71579,36377,0.28490310867390417,0.5418565853367892
2841,0.7126,1,0,1,574853,30757,71580,36376,0.28490310867390417,0.5418497609223482
2842,0.7127,0,1,0,574854,30756,71580,36376,0.28489384564081666,0.5418578323303342
2843,0.7128,1,1,1,574855,30755,71581,36375,0.2848845826077291,0.5418590793981827
2844,0.7129,0,1,0,574856,30754,71581,36375,0.2848753195746415,0.541867151305695
2845,0.713,0,1,0,574857,30753,71581,36375,0.28486605654155395,0.5418752234537004
2846,0.7131,0,2,0,574859,30751,71581,36375,0.28484753047537886,0.5418913684712332
2847,0.7134,2,1,2,574860,30750,71583,36373,0.2848382674422913,0.541885791755434
2848,0.7138,2,0,2,574860,30750,71585,36371,0.2848382674422913,0.5418721413566544
2849,0.7139,0,1,0,574861,30749,71585,36371,0.2848290044092037,0.5418802145411203
2850,0.7143,1,0,1,574861,30749,71586,36370,0.2848290044092037,0.5418733890552601
2851,0.7145,1,0,1,574861,30749,71587,36369,0.2848290044092037,0.5418665633660121
2852,0.7147,0,4,0,574865,30745,71587,36369,0.28479195227685355,0.5418988586584021
2853,0.7148,1,1,1,574866,30744,71588,36368,0.284782689243766,0.5419001072833473
2854,0.7149,0,2,0,574868,30742,71588,36368,0.28476416317759085,0.5419162568916704
2855,0.715,2,2,2,574870,30740,71590,36366,0.28474563711141576,0.5419187554019015
2856,0.7153,1,2,1,574872,30738,71591,36365,0.2847271110452407,0.5419280807117417
2857,0.7155,0,1,0,574873,30737,71591,36365,0.2847178480121531,0.5419361568954726
2858,0.7156,0,1,0,574874,30736,71591,36365,0.28470858497906554,0.5419442333199207
2859,0.7157,1,0,1,574874,30736,71592,36364,0.28470858497906554,0.5419374068554397
2860,0.7158,1,1,1,574875,30735,71593,36363,0.28469932194597797,0.5419386568899222
2861,0.7159,3,3,3,574878,30732,71596,36360,0.2846715328467153,0.5419424074405295
2862,0.7163,0,1,0,574879,30731,71596,36360,0.2846622698136278,0.5419504851619442
2863,0.7165,2,9,2,574888,30722,71598,36358,0.2845789025158398,0.5420095408467501
2864,0.7167,0,1,0,574889,30721,71598,36358,0.2845696394827522,0.5420176210140283
2865,0.7168,0,1,0,574890,30720,71598,36358,0.2845603764496647,0.5420257014222248
2866,0.7169,1,1,1,574891,30719,71599,36357,0.28455111341657713,0.5420269544993739
2867,0.717,6,3,6,574894,30716,71605,36351,0.2845233243173145,0.5420102285773928
2868,0.7171,0,1,0,574895,30715,71605,36351,0.2845140612842269,0.5420183103211762
2869,0.7172,0,2,0,574897,30713,71605,36351,0.2844955352180518,0.5420344745317905
2870,0.7173,1,2,1,574899,30711,71606,36350,0.2844770091518767,0.5420438108587704
2871,0.7174,14,34,14,574933,30677,71620,36336,0.28416206602689986,0.5422231507319475
2872,0.7176,0,1,0,574934,30676,71620,36336,0.2841528029938123,0.5422312421655823
2873,0.7177,4,4,4,574938,30672,71624,36332,0.28411575086146207,0.5422362844009313
2874,0.7178,0,1,0,574939,30671,71624,36332,0.2841064878283745,0.5422443771174426
2875,0.7179,2,7,2,574946,30664,71626,36330,0.2840416465967616,0.542287369018121
2876,0.718,0,1,0,574947,30663,71626,36330,0.2840323835636741,0.5422954637051632
2877,0.7181,2,0,2,574947,30663,71628,36328,0.2840323835636741,0.5422817990476333
2878,0.7184,0,1,0,574948,30662,71628,36328,0.28402312053058654,0.5422898940140319
2879,0.7185,50,80,50,575028,30582,71678,36278,0.2832820778835822,0.5425964702363146
2880,0.7188,1,2,1,575030,30580,71679,36277,0.2832635518174071,0.5426058602689322
2881,0.7189,7,8,7,575038,30572,71686,36270,0.28318944755270664,0.5426229017683493
2882,0.7191,1,0,1,575038,30572,71687,36269,0.28318944755270664,0.5426160590057001
2883,0.7192,26,28,26,575066,30544,71713,36243,0.28293008262625513,0.5426654887927291
2884,0.7193,0,2,0,575068,30542,71713,36243,0.28291155656008005,0.5426817399116568
2885,0.7194,11,13,11,575081,30529,71724,36232,0.2827911371299418,0.5427120624316591
2886,0.7196,6,3,6,575084,30526,71730,36226,0.28276334803067915,0.5426953499520614
2887,0.7197,2,3,2,575087,30523,71732,36224,0.2827355589314165,0.5427060392227366
2888,0.7199,0,1,0,575088,30522,71732,36224,0.2827262958983289,0.5427141701375363
2889,0.72,1591,2544,1591,577632,27978,73323,34633,0.2591611397235911,0.5531456133906183
2890,0.7202,0,2,0,577634,27976,73323,34633,0.259142613657416,0.5531632832340398
2891,0.7203,1,0,1,577634,27976,73324,34632,0.259142613657416,0.553156146179402
2892,0.7209,1,1,1,577635,27975,73325,34631,0.2591333506243284,0.5531578442960738
2893,0.7212,1,1,1,577636,27974,73326,34630,0.2591240875912409,0.5531595425212447
2894,0.7215,0,1,0,577637,27973,73326,34630,0.2591148245581533,0.5531683785122119
2895,0.7218,0,1,0,577638,27972,73326,34630,0.25910556152506575,0.5531772147854701
2896,0.7219,0,1,0,577639,27971,73326,34630,0.25909629849197824,0.5531860513410329
2897,0.722,0,1,0,577640,27970,73326,34630,0.25908703545889067,0.5531948881789137
2898,0.7221,0,1,0,577641,27969,73326,34630,0.2590777724258031,0.5532037252991262
2899,0.7222,0,1,0,577642,27968,73326,34630,0.25906850939271553,0.5532125627016837
2900,0.7223,0,2,0,577644,27966,73326,34630,0.25904998332654045,0.5532302383538884
2901,0.7227,1,2,1,577646,27964,73327,34629,0.25903145726036536,0.5532407777227486
2902,0.7228,1,0,1,577646,27964,73328,34628,0.25903145726036536,0.5532336400817995
2903,0.7232,0,1,0,577647,27963,73328,34628,0.2590221942272778,0.5532424789506478
2904,0.7233,0,1,0,577648,27962,73328,34628,0.2590129311941902,0.5532513181019332
2905,0.7237,0,1,0,577649,27961,73328,34628,0.25900366816110265,0.5532601575356693
2906,0.7239,0,1,0,577650,27960,73328,34628,0.25899440512801514,0.5532689972518694
2907,0.724,1,0,1,577650,27960,73329,34627,0.25899440512801514,0.5532618594915877
2908,0.7242,1,0,1,577650,27960,73330,34626,0.25899440512801514,0.5532547215032115
2909,0.7243,1,2,1,577652,27958,73331,34625,0.25897587906184,0.5532652637297669
2910,0.7245,1,0,1,577652,27958,73332,34624,0.25897587906184,0.5532581253395545
2911,0.7246,1,0,1,577652,27958,73333,34623,0.25897587906184,0.5532509867212093
2912,0.725,0,2,0,577654,27956,73333,34623,0.2589573529956649,0.5532686684031385
2913,0.7251,1,0,1,577654,27956,73334,34622,0.2589573529956649,0.5532615296110455
2914,0.7253,0,2,0,577656,27954,73334,34622,0.2589388269294898,0.5532792124776272
2915,0.7254,1,0,1,577656,27954,73335,34621,0.2589388269294898,0.5532720735117859
2916,0.7255,1,1,1,577657,27953,73336,34620,0.25892956389640226,0.5532737762293641
2917,0.7256,0,1,0,577658,27952,73336,34620,0.2589203008633147,0.5532826184235761
2918,0.7257,2,0,2,577658,27952,73338,34618,0.2589203008633147,0.553268339459805
2919,0.7258,2,1,2,577659,27951,73340,34616,0.2589110378302271,0.553262902168875
2920,0.7259,5,2,5,577661,27949,73345,34611,0.25889251176405204,0.553244884910486
2921,0.726,2,0,2,577661,27949,73347,34609,0.25889251176405204,0.5532306020013428
2922,0.7261,1,0,1,577661,27949,73348,34608,0.25889251176405204,0.5532234602042937
2923,0.7262,3,1,3,577662,27948,73351,34605,0.25888324873096447,0.5532108771761546
2924,0.7263,0,1,0,577663,27947,73351,34605,0.2588739856978769,0.5532197211919683
2925,0.7265,9,11,9,577674,27936,73360,34596,0.2587720923339138,0.5532527345998849
2926,0.7267,0,2,0,577676,27934,73360,34596,0.2587535662677387,0.5532704301935071
2927,0.7268,0,1,0,577677,27933,73360,34596,0.25874430323465114,0.5532792784148155
2928,0.7269,1,1,1,577678,27932,73361,34595,0.2587350402015636,0.5532809826155101
2929,0.727,4,4,4,577682,27928,73365,34591,0.2586979880692134,0.5532878005086453
2930,0.7271,0,1,0,577683,27927,73365,34591,0.25868872503612583,0.5532966505646374
2931,0.7273,1,0,1,577683,27927,73366,34590,0.25868872503612583,0.5532895052545708
2932,0.7274,24,30,24,577713,27897,73390,34566,0.2584108340434992,0.553383603093031
2933,0.7276,0,1,0,577714,27896,73390,34566,0.25840157101041167,0.5533924626172713
2934,0.7277,4,3,4,577717,27893,73394,34562,0.258373781911149,0.5533904411176047
2935,0.7278,1,0,1,577717,27893,73395,34561,0.258373781911149,0.5533832901015148
2936,0.7279,3,8,3,577725,27885,73398,34558,0.25829967764644857,0.5534327306503531
2937,0.728,0,1,0,577726,27884,73398,34558,0.258290414613361,0.5534415937990456
2938,0.7281,1,1,1,577727,27883,73399,34557,0.2582811515802734,0.5534433055733504
2939,0.7284,1,0,1,577727,27883,73400,34556,0.2582811515802734,0.5534361536859975
2940,0.7285,45,65,45,577792,27818,73445,34511,0.25767905442958244,0.5536908982977427
2941,0.7286,2,0,2,577792,27818,73447,34509,0.25767905442958244,0.5536765767644841
2942,0.7288,2,3,2,577795,27815,73449,34507,0.25765126533031973,0.5536889060043002
2943,0.7289,1,6,1,577801,27809,73450,34506,0.2575956871317944,0.5537350557650645
2944,0.729,0,1,0,577802,27808,73450,34506,0.25758642409870686,0.5537439419713066
2945,0.7292,22,34,22,577836,27774,73472,34484,0.25727148097373004,0.5538886568794372
2946,0.7293,1,2,1,577838,27772,73473,34483,0.25725295490755495,0.553899285197976
2947,0.7294,9,15,9,577853,27757,73482,34474,0.25711400941124163,0.5539682794748598
2948,0.7295,0,3,0,577856,27754,73482,34474,0.257086220311979,0.5539949861798548
2949,0.7296,3,2,3,577858,27752,73485,34471,0.25706769424580383,0.5539912893945969
2950,0.7297,0,5,0,577863,27747,73485,34471,0.2570213790803661,0.5540358095727924
2951,0.73,1557,2278,1557,580141,25469,75042,32914,0.23592018970691764,0.5637599986297381
2952,0.7306,0,1,0,580142,25468,75042,32914,0.23591092667383007,0.5637696550306601
2953,0.7307,0,1,0,580143,25467,75042,32914,0.23590166364074253,0.5637793117623885
2954,0.731,0,1,0,580144,25466,75042,32914,0.23589240060765498,0.56378896882494
2955,0.7311,0,1,0,580145,25465,75042,32914,0.23588313757456741,0.563798626218332
2956,0.7312,1,0,1,580145,25465,75043,32913,0.23588313757456741,0.5637911542019254
2957,0.7313,0,1,0,580146,25464,75043,32913,0.23587387454147987,0.5638008119636158
2958,0.7316,0,1,0,580147,25463,75043,32913,0.2358646115083923,0.5638104700561875
2959,0.7317,0,1,0,580148,25462,75043,32913,0.23585534847530476,0.5638201284796573
2960,0.7323,1,0,1,580148,25462,75044,32912,0.23585534847530476,0.5638126563195943
2961,0.7325,0,1,0,580149,25461,75044,32912,0.2358460854422172,0.5638223151114385
2962,0.7326,0,1,0,580150,25460,75044,32912,0.23583682240912965,0.5638319742342219
2963,0.7328,0,1,0,580151,25459,75044,32912,0.23582755937604208,0.5638416336879615
2964,0.7329,0,1,0,580152,25458,75044,32912,0.23581829634295454,0.5638512934726743
2965,0.733,1,1,1,580153,25457,75045,32911,0.235809033309867,0.5638534813596491
2966,0.7332,0,2,0,580155,25455,75045,32911,0.23579050724369188,0.5638728026590824
2967,0.7334,1,0,1,580155,25455,75046,32910,0.23579050724369188,0.5638653302492932
2968,0.7335,0,1,0,580156,25454,75046,32910,0.2357812442106043,0.5638749914330752
2969,0.7338,2,0,2,580156,25454,75048,32908,0.2357812442106043,0.5638600459202906
2970,0.734,1,1,1,580157,25453,75049,32907,0.23577198117751677,0.5638622344071281
2971,0.7343,0,2,0,580159,25451,75049,32907,0.23575345511134166,0.5638815586551972
2972,0.7346,0,2,0,580161,25449,75049,32907,0.23573492904516655,0.5639008842278429
2973,0.7347,1,0,1,580161,25449,75050,32906,0.23573492904516655,0.5638934110187644
2974,0.7348,1,0,1,580161,25449,75051,32905,0.23573492904516655,0.5638859375535524
2975,0.7349,0,1,0,580162,25448,75051,32905,0.235725666012079,0.5638956009116927
2976,0.735,1,4,1,580166,25444,75052,32904,0.23568861387972878,0.5639267841228491
2977,0.7352,0,1,0,580167,25443,75052,32904,0.2356793508466412,0.5639364491747648
2978,0.7353,3,1,3,580168,25442,75055,32901,0.23567008781355367,0.5639236926452188
2979,0.7355,1,2,1,580170,25440,75056,32900,0.23565156174737856,0.5639355502228317
2980,0.7356,1,0,1,580170,25440,75057,32899,0.23565156174737856,0.5639280755583743
2981,0.7357,0,1,0,580171,25439,75057,32899,0.23564229871429102,0.5639377421234872
2982,0.7358,1,0,1,580171,25439,75058,32898,0.23564229871429102,0.5639302672403449
2983,0.7359,1,2,1,580173,25437,75059,32897,0.2356237726481159,0.5639421263756985
2984,0.7364,0,1,0,580174,25436,75059,32897,0.23561450961502833,0.5639517940102515
2985,0.7365,9,8,9,580182,25428,75068,32888,0.2355404053503279,0.5639618629535633
2986,0.7366,1,2,1,580184,25426,75069,32887,0.2355218792841528,0.5639737279851834
2987,0.7368,0,1,0,580185,25425,75069,32887,0.23551261625106526,0.5639833996432981
2988,0.7369,0,3,0,580188,25422,75069,32887,0.23548482715180258,0.5640124166080708
2989,0.737,4,4,4,580192,25418,75073,32883,0.23544777501945238,0.5640212003224645
2990,0.7371,1,0,1,580192,25418,75074,32882,0.23544777501945238,0.5640137221269297
2991,0.7373,0,2,0,580194,25416,75074,32882,0.23542924895327727,0.5640330714604275
2992,0.7374,25,29,25,580223,25387,75099,32857,0.2351606209937382,0.5641267770070737
2993,0.7377,1,5,1,580228,25382,75100,32856,0.23511430582830042,0.5641677255400254
2994,0.7378,0,1,0,580229,25381,75100,32856,0.23510504279521285,0.5641774129848721
2995,0.7379,3,5,3,580234,25376,75103,32853,0.2350587276297751,0.5642034038022291
2996,0.738,0,1,0,580235,25375,75103,32853,0.23504946459668755,0.5642130933571478
2997,0.7382,2,0,2,580235,25375,75105,32851,0.23504946459668755,0.5641981245491705
2998,0.7384,0,1,0,580236,25374,75105,32851,0.23504020156359998,0.5642078145126663
2999,0.7385,49,73,49,580309,25301,75154,32802,0.23436400014820852,0.5645491626938368
3000,0.7386,1,0,1,580309,25301,75155,32801,0.23436400014820852,0.564541668100926
3001,0.7388,1,1,1,580310,25300,75156,32800,0.23435473711512098,0.5645438898450946
3002,0.7389,3,5,3,580315,25295,75159,32797,0.2343084219496832,0.5645699924258073
3003,0.7391,0,1,0,580316,25294,75159,32797,0.23429915891659564,0.5645797111428621
3004,0.7392,19,23,19,580339,25271,75178,32778,0.2340861091555819,0.5646608899378112
3005,0.7393,1,0,1,580339,25271,75179,32777,0.2340861091555819,0.5646533902976847
3006,0.7394,5,13,5,580352,25258,75184,32772,0.2339656897254437,0.56474237463381
3007,0.7395,0,2,0,580354,25256,75184,32772,0.2339471636592686,0.5647618391121527
3008,0.7396,3,4,3,580358,25252,75187,32769,0.23391011152691837,0.5647782699367471
3009,0.7397,1,1,1,580359,25251,75188,32768,0.23390084849383083,0.5647805029386925
3010,0.7398,0,1,0,580360,25250,75188,32768,0.23389158546074326,0.5647902375124961
3011,0.7399,0,1,0,580361,25249,75188,32768,0.23388232242765572,0.5647999724218763
3012,0.74,1523,2205,1523,582566,23044,76711,31245,0.21345733446959872,0.5755309547053731
3013,0.7402,2,0,2,582566,23044,76713,31243,0.21345733446959872,0.5755153167424982
3014,0.7403,0,1,0,582567,23043,76713,31243,0.21344807143651118,0.5755259182846406
3015,0.7404,1,0,1,582567,23043,76714,31242,0.21344807143651118,0.5755180989223543
3016,0.7405,0,1,0,582568,23042,76714,31242,0.2134388084034236,0.5755287009063444
3017,0.7407,0,1,0,582569,23041,76714,31242,0.21342954537033607,0.5755393032809535
3018,0.7408,0,1,0,582570,23040,76714,31242,0.2134202823372485,0.5755499060462032
3019,0.741,1,0,1,582570,23040,76715,31241,0.2134202823372485,0.5755420865496215
3020,0.7414,0,1,0,582571,23039,76715,31241,0.21341101930416095,0.5755526897568165
3021,0.7417,1,0,1,582571,23039,76716,31240,0.21341101930416095,0.5755448700233976
3022,0.7418,1,0,1,582571,23039,76717,31239,0.21341101930416095,0.5755370500018424
3023,0.742,0,1,0,582572,23038,76717,31239,0.2134017562710734,0.5755476537023049
3024,0.7421,1,0,1,582572,23038,76718,31238,0.2134017562710734,0.5755398334438794
3025,0.7422,0,1,0,582573,23037,76718,31238,0.21339249323798584,0.5755504375863657
3026,0.7423,0,2,0,582575,23035,76718,31238,0.21337396717181073,0.5755716470436497
3027,0.7425,0,1,0,582576,23034,76718,31238,0.2133647041387232,0.5755822523584906
3028,0.7432,1,0,1,582576,23034,76719,31237,0.2133647041387232,0.5755744320170993
3029,0.7436,0,1,0,582577,23033,76719,31237,0.21335544110563562,0.5755850377740925
3030,0.744,0,1,0,582578,23032,76719,31237,0.21334617807254808,0.5755956439219444
3031,0.7443,0,1,0,582579,23031,76719,31237,0.21333691503946053,0.5756062504606766
3032,0.7445,1,1,1,582580,23030,76720,31236,0.21332765200637296,0.5756090369660561
3033,0.7447,0,2,0,582582,23028,76720,31236,0.21330912594019785,0.5756302521008403
3034,0.7449,0,2,0,582584,23026,76720,31236,0.21329059987402274,0.5756514687995282
3035,0.745,2,1,2,582585,23025,76722,31234,0.2132813368409352,0.5756464365358742
3036,0.7453,0,1,0,582586,23024,76722,31234,0.21327207380784763,0.5756570459655719
3037,0.7455,1,1,1,582587,23023,76723,31233,0.2132628107747601,0.5756598348569744
3038,0.7457,1,1,1,582588,23022,76724,31232,0.21325354774167254,0.5756626239539941
3039,0.7458,1,3,1,582591,23019,76725,31231,0.21322575864240986,0.5756866359447005
3040,0.7459,3,4,3,582595,23015,76728,31228,0.21318870651005967,0.5757056210017882
3041,0.7461,0,1,0,582596,23014,76728,31228,0.2131794434769721,0.5757162346521146
3042,0.7462,0,1,0,582597,23013,76728,31228,0.21317018044388455,0.5757268486937925
3043,0.7463,1,1,1,582598,23012,76729,31227,0.21316091741079699,0.5757296410332049
3044,0.7464,1,0,1,582598,23012,76730,31226,0.21316091741079699,0.5757218186511303
3045,0.7465,2,7,2,582605,23005,76732,31224,0.2130960761791841,0.5757804864555865
3046,0.7466,0,2,0,582607,23003,76732,31224,0.213077550113009,0.5758017223892157
3047,0.7468,1,1,1,582608,23002,76733,31223,0.21306828707992145,0.5758045182111572
3048,0.7469,0,1,0,582609,23001,76733,31223,0.21305902404683388,0.5758151372086161
3049,0.747,2,6,2,582615,22995,76735,31221,0.21300344584830858,0.575863213811421
3050,0.7471,0,1,0,582616,22994,76735,31221,0.212994182815221,0.5758738356543393
3051,0.7472,0,1,0,582617,22993,76735,31221,0.21298491978213346,0.5758844578891061
3052,0.7473,0,1,0,582618,22992,76735,31221,0.2129756567490459,0.5758950805157435
3053,0.7474,13,25,13,582643,22967,76748,31208,0.21274408092185706,0.5760590678357176
3054,0.7477,1,0,1,582643,22967,76749,31207,0.21274408092185706,0.576051242293351
3055,0.7479,8,6,8,582649,22961,76757,31199,0.21268850272333173,0.5760524372230429
3056,0.7481,1,1,1,582650,22960,76758,31198,0.2126792396902442,0.5760552457623989
3057,0.7484,1,2,1,582652,22958,76759,31197,0.21266071362406908,0.5760686917182163
3058,0.7485,48,61,48,582713,22897,76807,31149,0.21209566860572826,0.5763423750138771
3059,0.7488,1,0,1,582713,22897,76808,31148,0.21209566860572826,0.5763345360347858
3060,0.7489,4,5,4,582718,22892,76812,31144,0.2120493534402905,0.576356503072026
3061,0.749,1,0,1,582718,22892,76813,31143,0.2120493534402905,0.5763486629036736
3062,0.7491,1,1,1,582719,22891,76814,31142,0.21204009040720292,0.5763514889049285
3063,0.7492,30,23,30,582742,22868,76844,31112,0.21182704064618918,0.5763616154131159
3064,0.7493,1,0,1,582742,22868,76845,31111,0.21182704064618918,0.5763537672057653
3065,0.7494,12,10,12,582752,22858,76857,31099,0.21173441031531365,0.5763663658098115
3066,0.7495,0,1,0,582753,22857,76857,31099,0.21172514728222608,0.5763770479650085
3067,0.7496,4,3,4,582756,22854,76861,31095,0.21169735818296342,0.5763776900405939
3068,0.7497,3,4,3,582760,22850,76864,31092,0.2116603060506132,0.5763968707129881
3069,0.7499,0,1,0,582761,22849,76864,31092,0.21165104301752566,0.5764075564042195
3070,0.75,1575,2021,1575,584782,20828,78439,29517,0.19293045314757865,0.5862945674843579
3071,0.7503,1,0,1,584782,20828,78440,29516,0.19293045314757865,0.5862863499126013
3072,0.7504,0,2,0,584784,20826,78440,29516,0.19291192708140353,0.586309642048389
3073,0.7505,0,1,0,584785,20825,78440,29516,0.192902664048316,0.5863212888103136
3074,0.7506,0,1,0,584786,20824,78440,29516,0.19289340101522842,0.5863329360349623
3075,0.7507,1,0,1,584786,20824,78441,29515,0.19289340101522842,0.5863247184091858
3076,0.7509,1,1,1,584787,20823,78442,29514,0.19288413798214088,0.5863281482805889
3077,0.7516,0,1,0,584788,20822,78442,29514,0.1928748749490533,0.5863397965670692
3078,0.7517,0,2,0,584790,20820,78442,29514,0.1928563488828782,0.5863630945285493
3079,0.7518,1,0,1,584790,20820,78443,29513,0.1928563488828782,0.5863548765223611
3080,0.7519,0,1,0,584791,20819,78443,29513,0.19284708584979066,0.5863665262655965
3081,0.752,0,1,0,584792,20818,78443,29513,0.1928378228167031,0.5863781764717569
3082,0.7521,0,1,0,584793,20817,78443,29513,0.19282855978361554,0.5863898271408703
3083,0.7522,0,1,0,584794,20816,78443,29513,0.192819296750528,0.5864014782729638
3084,0.7526,1,1,1,584795,20815,78444,29512,0.19281003371744043,0.5864049118763288
3085,0.7529,0,4,0,584799,20811,78444,29512,0.1927729815850902,0.586451523160384
3086,0.7531,1,0,1,584799,20811,78445,29511,0.1927729815850902,0.586443305115059
3087,0.7532,0,1,0,584800,20810,78445,29511,0.19276371855200267,0.5864549591621788
3088,0.7541,0,3,0,584803,20807,78445,29511,0.19273592945274,0.5864899240828332
3089,0.7542,0,2,0,584805,20805,78445,29511,0.1927174033865649,0.5865132363462915
3090,0.7544,0,1,0,584806,20804,78445,29511,0.19270814035347733,0.58652489317301
3091,0.7545,0,1,0,584807,20803,78445,29511,0.1926988773203898,0.5865365504630918
3092,0.7548,1,0,1,584807,20803,78446,29510,0.1926988773203898,0.5865283326376881
3093,0.7549,0,1,0,584808,20802,78446,29510,0.19268961428730225,0.5865399904595325
3094,0.755,0,1,0,584809,20801,78446,29510,0.19268035125421468,0.5865516487448073
3095,0.7551,0,2,0,584811,20799,78446,29510,0.19266182518803956,0.5865749667057584
3096,0.7552,0,1,0,584812,20798,78446,29510,0.19265256215495202,0.5865866263814901
3097,0.7553,0,1,0,584813,20797,78446,29510,0.19264329912186445,0.5865982865207625
3098,0.7554,1,0,1,584813,20797,78447,29509,0.19264329912186445,0.586590068779072
3099,0.7555,0,1,0,584814,20796,78447,29509,0.1926340360887769,0.5866017294503528
3100,0.7557,0,1,0,584815,20795,78447,29509,0.19262477305568934,0.5866133905852418
3101,0.7558,7,2,7,584817,20793,78454,29502,0.19260624698951426,0.586579182821354
3102,0.7559,5,1,5,584818,20792,78459,29497,0.1925969839564267,0.586549742488417
3103,0.7561,0,1,0,584819,20791,78459,29497,0.19258772092333915,0.5865614062997137
3104,0.7562,1,0,1,584819,20791,78460,29496,0.19258772092333915,0.5865531847197089
3105,0.7563,0,1,0,584820,20790,78460,29496,0.19257845789025158,0.5865648490633576
3106,0.7564,2,0,2,584820,20790,78462,29494,0.19257845789025158,0.5865484050592634
3107,0.7565,7,9,7,584829,20781,78469,29487,0.19249509059246359,0.5865958462640248
3108,0.7566,0,5,0,584834,20776,78469,29487,0.19244877542702582,0.5866541989137138
3109,0.757,7,5,7,584839,20771,78476,29480,0.19240246026158805,0.5866549919404589
3110,0.7571,1,0,1,584839,20771,78477,29479,0.19240246026158805,0.5866467661691542
3111,0.7572,1,0,1,584839,20771,78478,29478,0.19240246026158805,0.5866385400704491
3112,0.7573,1,0,1,584839,20771,78479,29477,0.19240246026158805,0.5866303136443242
3113,0.7574,15,24,15,584863,20747,78494,29462,0.19218014746748677,0.5867872293811867
3114,0.7575,0,1,0,584864,20746,78494,29462,0.1921708844343992,0.5867989165073295
3115,0.7577,0,1,0,584865,20745,78494,29462,0.19216162140131166,0.58681060409903
3116,0.7579,7,12,7,584877,20733,78501,29455,0.19205046500426098,0.5868932812624532
3117,0.7584,0,1,0,584878,20732,78501,29455,0.19204120197117344,0.5869049753920338
3118,0.7585,38,62,38,584940,20670,78539,29417,0.19146689391974508,0.5873180665641783
3119,0.7586,1,1,1,584941,20669,78540,29416,0.19145763088665751,0.5873215533592893
3120,0.7587,0,1,0,584942,20668,78540,29416,0.19144836785356997,0.5873332800894497
3121,0.7589,2,4,2,584946,20664,78542,29414,0.19141131572121975,0.587363712608331
3122,0.759,0,1,0,584947,20663,78542,29414,0.1914020526881322,0.5873754418195978
3123,0.7592,22,20,22,584967,20643,78564,29392,0.19121679202638112,0.5874287998401119
3124,0.7593,1,0,1,584967,20643,78565,29391,0.19121679202638112,0.5874205540232642
3125,0.7594,10,15,10,584982,20628,78575,29381,0.19107784653006782,0.5875142474354617
3126,0.7596,2,7,2,584989,20621,78577,29379,0.1910130052984549,0.58758
3127,0.7597,0,3,0,584992,20618,78577,29379,0.19098521619919226,0.5876152569154149
3128,0.76,1482,1845,1482,586837,18773,80059,27897,0.17389492015265479,0.597750160702807
3129,0.7607,0,1,0,586838,18772,80059,27897,0.17388565711956724,0.5977629689944074
3130,0.7611,0,1,0,586839,18771,80059,27897,0.17387639408647967,0.597775777834919
3131,0.7612,0,1,0,586840,18770,80059,27897,0.17386713105339213,0.597788587224377
3132,0.7613,0,1,0,586841,18769,80059,27897,0.17385786802030456,0.5978013971628167
3133,0.7614,0,2,0,586843,18767,80059,27897,0.17383934195412945,0.5978270186867821
3134,0.7615,0,1,0,586844,18766,80059,27897,0.1738300789210419,0.5978398302723785
3135,0.7616,0,1,0,586845,18765,80059,27897,0.17382081588795434,0.5978526424070979
3136,0.7619,0,2,0,586847,18763,80059,27897,0.17380228982177925,0.5978782683240463
3137,0.762,0,1,0,586848,18762,80059,27897,0.17379302678869168,0.597891082106346
3138,0.7621,0,1,0,586849,18761,80059,27897,0.17378376375560414,0.5979038964379099
3139,0.7623,1,0,1,586849,18761,80060,27896,0.17378376375560414,0.5978952783076494
3140,0.7624,0,2,0,586851,18759,80060,27896,0.17376523768942903,0.5979209087986282
3141,0.7627,0,1,0,586852,18758,80060,27896,0.17375597465634146,0.5979337248681785
3142,0.7629,0,1,0,586853,18757,80060,27896,0.17374671162325392,0.5979465414871498
3143,0.7632,0,1,0,586854,18756,80060,27896,0.17373744859016638,0.5979593586555775
3144,0.7634,0,1,0,586855,18755,80060,27896,0.1737281855570788,0.5979721763734969
3145,0.7639,2,0,2,586855,18755,80062,27894,0.1737281855570788,0.5979549400844606
3146,0.7641,0,1,0,586856,18754,80062,27894,0.17371892252399126,0.5979677585319843
3147,0.7642,0,2,0,586858,18752,80062,27894,0.17370039645781615,0.5979933970758479
3148,0.7643,0,1,0,586859,18751,80062,27894,0.17369113342472858,0.5980062171722585
3149,0.7648,0,1,0,586860,18750,80062,27894,0.17368187039164104,0.598019037818369
3150,0.7649,0,1,0,586861,18749,80062,27894,0.17367260735855347,0.5980318590142144
3151,0.765,0,3,0,586864,18746,80062,27894,0.17364481825929082,0.5980703259005146
3152,0.7651,0,1,0,586865,18745,80062,27894,0.17363555522620328,0.5980831492956539
3153,0.7652,0,1,0,586866,18744,80062,27894,0.1736262921931157,0.598095973240705
3154,0.7653,1,0,1,586866,18744,80063,27893,0.1736262921931157,0.5980873555331604
3155,0.7655,0,1,0,586867,18743,80063,27893,0.17361702916002816,0.5981001801183635
3156,0.7657,1,0,1,586867,18743,80064,27892,0.17361702916002816,0.5980915621314463
3157,0.7658,0,3,0,586870,18740,80064,27892,0.1735892400607655,0.598130039457883
3158,0.7659,4,1,4,586871,18739,80068,27888,0.17357997702767794,0.5981083921333133
3159,0.7664,0,1,0,586872,18738,80068,27888,0.1735707139945904,0.5981212199202162
3160,0.7665,3,8,3,586880,18730,80071,27885,0.17349660972988995,0.5981980049340341
3161,0.7666,0,2,0,586882,18728,80071,27885,0.17347808366371484,0.5982236715079484
3162,0.7668,0,1,0,586883,18727,80071,27885,0.1734688206306273,0.5982365056208702
3163,0.7669,1,2,1,586885,18725,80072,27884,0.17345029456445218,0.5982535561801369
3164,0.767,3,2,3,586887,18723,80075,27881,0.17343176849827707,0.5982533688095443
3165,0.7674,13,15,13,586902,18708,80088,27868,0.17329282300196377,0.59833390587427
3166,0.7675,3,0,3,586902,18708,80091,27865,0.17329282300196377,0.5983080325510489
3167,0.7676,0,1,0,586903,18707,80091,27865,0.1732835599688762,0.5983208794984111
3168,0.7677,2,1,2,586904,18706,80093,27863,0.17327429693578866,0.5983164766260818
3169,0.7679,3,10,3,586914,18696,80096,27860,0.1731816666049131,0.598419108170805
3170,0.768,0,2,0,586916,18694,80096,27860,0.173163140538738,0.5984448167719207
3171,0.7681,1,3,1,586919,18691,80097,27859,0.17313535143947534,0.5984747583243823
3172,0.7683,0,3,0,586922,18688,80097,27859,0.17310756234021268,0.5985133306120696
3173,0.7685,52,58,52,586980,18630,80149,27807,0.17257030642113452,0.5988112927191679
3174,0.7686,1,1,1,586981,18629,80150,27806,0.17256104338804698,0.5988155486163454
3175,0.7688,1,0,1,586981,18629,80151,27805,0.17256104338804698,0.5988069087306714
3176,0.7689,3,3,3,586984,18626,80154,27802,0.17253325428878433,0.5988196777806496
3177,0.7692,17,23,17,587007,18603,80171,27785,0.17232020452777058,0.5989695610933862
3178,0.7693,0,1,0,587008,18602,80171,27785,0.172310941494683,0.5989824735378446
3179,0.7694,10,4,10,587012,18598,80181,27775,0.17227388936233282,0.5989476635110949
3180,0.7695,0,2,0,587014,18596,80181,27775,0.1722553632961577,0.5989734963662634
3181,0.7696,1,2,1,587016,18594,80182,27774,0.1722368372299826,0.5989906832298136
3182,0.7697,3,2,3,587018,18592,80185,27771,0.17221831116380748,0.5989905743804327
3183,0.77,1474,1723,1474,588741,16869,81659,26297,0.1562581051539516,0.6092063197887226
3184,0.7702,1,0,1,588741,16869,81660,26296,0.1562581051539516,0.6091972663037183
3185,0.7703,1,0,1,588741,16869,81661,26295,0.1562581051539516,0.6091882123992216
3186,0.7705,0,1,0,588742,16868,81661,26295,0.15624884212086407,0.6092023260663068
3187,0.7706,0,1,0,588743,16867,81661,26295,0.1562395790877765,0.6092164403873778
3188,0.7709,0,1,0,588744,16866,81661,26295,0.15623031605468896,0.60923055536248
3189,0.7714,1,0,1,588744,16866,81662,26294,0.15623031605468896,0.6092215013901761
3190,0.7715,1,1,1,588745,16865,81663,26293,0.15622105302160139,0.6092265628620418
3191,0.7719,0,1,0,588746,16864,81663,26293,0.15621178998851384,0.6092406793799383
3192,0.772,0,1,0,588747,16863,81663,26293,0.15620252695542627,0.6092547965520437
3193,0.7721,0,3,0,588750,16860,81663,26293,0.15617473785616362,0.6092971519940676
3194,0.7728,1,0,1,588750,16860,81664,26292,0.15617473785616362,0.6092880978865406
3195,0.7731,1,1,1,588751,16859,81665,26291,0.15616547482307608,0.6092931633835458
3196,0.7734,0,1,0,588752,16858,81665,26291,0.1561562117899885,0.609307284062203
3197,0.7735,1,2,1,588754,16856,81666,26290,0.1561376857238134,0.6093264729059472
3198,0.7736,1,0,1,588754,16856,81667,26289,0.1561376857238134,0.6093174180090393
3199,0.7738,0,1,0,588755,16855,81667,26289,0.15612842269072585,0.6093315408863341
3200,0.7739,0,2,0,588757,16853,81667,26289,0.15610989662455074,0.6093597886050717
3201,0.7741,2,0,2,588757,16853,81669,26287,0.15610989662455074,0.6093416782568382
3202,0.7742,1,1,1,588758,16852,81670,26286,0.1561006335914632,0.6093467476470861
3203,0.7743,2,1,2,588759,16851,81672,26284,0.15609137055837563,0.6093427610988756
3204,0.7746,1,1,1,588760,16850,81673,26283,0.1560821075252881,0.6093478311269793
3205,0.7747,1,0,1,588760,16850,81674,26282,0.1560821075252881,0.609338773996105
3206,0.7748,0,1,0,588761,16849,81674,26282,0.15607284449220052,0.6093529016252811
3207,0.7749,1,1,1,588762,16848,81675,26281,0.15606358145911298,0.6093579725938464
3208,0.7751,0,1,0,588763,16847,81675,26281,0.1560543184260254,0.6093721016508996
3209,0.7753,3,0,3,588763,16847,81678,26278,0.1560543184260254,0.6093449275362319
3210,0.7755,1,0,1,588763,16847,81679,26277,0.1560543184260254,0.609335868657824
3211,0.7757,3,0,3,588763,16847,81682,26274,0.1560543184260254,0.609308689501635
3212,0.7758,1,0,1,588763,16847,81683,26273,0.1560543184260254,0.6092996289424861
3213,0.7759,3,1,3,588764,16846,81686,26270,0.15604505539293786,0.6092865757491418
3214,0.776,1,0,1,588764,16846,81687,26269,0.15604505539293786,0.6092775136263482
3215,0.7761,1,1,1,588765,16845,81688,26268,0.15603579235985032,0.6092825829796117
3216,0.7762,1,0,1,588765,16845,81689,26267,0.15603579235985032,0.6092735201336055
3217,0.7764,0,1,0,588766,16844,81689,26267,0.15602652932676275,0.6092876528032288
3218,0.7765,7,9,7,588775,16835,81696,26260,0.15594316202897476,0.6093514328808446
3219,0.7767,0,1,0,588776,16834,81696,26260,0.15593389899588722,0.6093655729335871
3220,0.7769,0,1,0,588777,16833,81696,26260,0.15592463596279965,0.6093797136425869
3221,0.777,2,5,2,588782,16828,81698,26258,0.15587832079736189,0.6094322981943091
3222,0.7771,1,1,1,588783,16827,81699,26257,0.15586905776427434,0.6094373781450191
3223,0.7772,0,3,0,588786,16824,81699,26257,0.15584126866501166,0.6094798170887398
3224,0.7773,0,1,0,588787,16823,81699,26257,0.15583200563192412,0.609493964716806
3225,0.7774,23,16,23,588803,16807,81722,26234,0.15568379710252325,0.6095118607839037
3226,0.7777,1,1,1,588804,16806,81723,26233,0.15567453406943568,0.6095169497432561
3227,0.7779,5,2,5,588806,16804,81728,26228,0.1556560080032606,0.6094999070459193
3228,0.778,1,2,1,588808,16802,81729,26227,0.1556374819370855,0.6095191614957355
3229,0.7781,3,1,3,588809,16801,81732,26224,0.15562821890399792,0.6095061011040093
3230,0.7784,1,2,1,588811,16799,81733,26223,0.1556096928378228,0.6095253591185905
3231,0.7785,41,51,41,588862,16748,81774,26182,0.15513727815035755,0.6098765432098765
3232,0.7786,0,1,0,588863,16747,81774,26182,0.15512801511727,0.6098907498427636
3233,0.7787,1,0,1,588863,16747,81775,26181,0.15512801511727,0.6098816623183004
3234,0.7788,2,0,2,588863,16747,81777,26179,0.15512801511727,0.6098634859991613
3235,0.7789,6,5,6,588868,16742,81783,26173,0.15508169995183224,0.6098799953396249
3236,0.7792,18,17,18,588885,16725,81801,26155,0.1549242283893438,0.6099580223880597
3237,0.7793,1,1,1,588886,16724,81802,26154,0.15491496535625626,0.6099631512663837
3238,0.7794,10,10,10,588896,16714,81812,26144,0.1548223350253807,0.6100144663773391
3239,0.7796,3,2,3,588898,16712,81815,26141,0.1548038089592056,0.6100156348447017
3240,0.7797,2,1,2,588899,16711,81817,26139,0.15479454592611805,0.6100116686114352
3241,0.7799,0,1,0,588900,16710,81817,26139,0.1547852828930305,0.6100259049219352
3242,0.78,1549,1623,1549,590523,15087,83366,24590,0.13975138019193004,0.6197545177306752
3243,0.7801,2,0,2,590523,15087,83368,24588,0.13975138019193004,0.6197353497164462
3244,0.7803,1,1,1,590524,15086,83369,24587,0.1397421171588425,0.6197413858291533
3245,0.7804,1,1,1,590525,15085,83370,24586,0.13973285412575492,0.6197474225504777
3246,0.7805,0,1,0,590526,15084,83370,24586,0.13972359109266738,0.6197630451222587
3247,0.7806,0,1,0,590527,15083,83370,24586,0.13971432805957984,0.619778668481686
3248,0.7807,1,1,1,590528,15082,83371,24585,0.13970506502649227,0.619784707691532
3249,0.7809,1,0,1,590528,15082,83372,24584,0.13970506502649227,0.6197751222709625
3250,0.7811,0,1,0,590529,15081,83372,24584,0.13969580199340473,0.6197907475103996
3251,0.7814,1,0,1,590529,15081,83373,24583,0.13969580199340473,0.6197811617587737
3252,0.7815,0,1,0,590530,15080,83373,24583,0.13968653896031716,0.6197967879383809
3253,0.7816,0,1,0,590531,15079,83373,24583,0.13967727592722962,0.6198124149059553
3254,0.7817,0,1,0,590532,15078,83373,24583,0.13966801289414205,0.6198280426615567
3255,0.7823,1,1,1,590533,15077,83374,24582,0.1396587498610545,0.6198340855795658
3256,0.7824,0,1,0,590534,15076,83374,24582,0.13964948682796696,0.6198497150637955
3257,0.7828,1,0,1,590534,15076,83375,24581,0.13964948682796696,0.6198401291070933
3258,0.7832,3,1,3,590535,15075,83378,24578,0.1396402237948794,0.619826999218218
3259,0.7838,2,0,2,590535,15075,83380,24576,0.1396402237948794,0.6198078232579254
3260,0.7839,2,1,2,590536,15074,83382,24574,0.13963096076179185,0.6198042776432607
3261,0.7843,1,1,1,590537,15073,83383,24573,0.13962169772870428,0.6198103213438935
3262,0.7844,1,0,1,590537,15073,83384,24572,0.13962169772870428,0.6198007314919914
3263,0.7845,0,1,0,590538,15072,83384,24572,0.13961243469561674,0.6198163656543235
3264,0.7848,1,0,1,590538,15072,83385,24571,0.13961243469561674,0.6198067754710794
3265,0.7849,0,1,0,590539,15071,83385,24571,0.13960317166252917,0.619822410574643
3266,0.785,2,1,2,590540,15070,83387,24569,0.13959390862944163,0.6198188652589621
3267,0.7851,0,1,0,590541,15069,83387,24569,0.13958464559635406,0.6198345022453201
3268,0.7852,0,1,0,590542,15068,83387,24569,0.13957538256326651,0.6198501400206877
3269,0.7853,1,0,1,590542,15068,83388,24568,0.13957538256326651,0.6198405489958624
3270,0.7856,0,1,0,590543,15067,83388,24568,0.13956611953017897,0.61985618771288
3271,0.7857,0,2,0,590545,15065,83388,24568,0.13954759346400386,0.619887467514445
3272,0.7858,0,2,0,590547,15063,83388,24568,0.13952906739782875,0.6199187504731145
3273,0.7859,4,2,4,590549,15061,83392,24564,0.13951054133165364,0.6199116719242902
3274,0.786,0,1,0,590550,15060,83392,24564,0.1395012782985661,0.6199273167777105
3275,0.7861,0,1,0,590551,15059,83392,24564,0.13949201526547853,0.6199429624208161
3276,0.7863,0,3,0,590554,15056,83392,24564,0.13946422616621587,0.619989904088844
3277,0.7864,0,1,0,590555,15055,83392,24564,0.1394549631331283,0.6200055528912896
3278,0.7865,5,2,5,590557,15053,83397,24559,0.1394364370669532,0.6199888922548723
3279,0.7866,2,1,2,590558,15052,83399,24557,0.13942717403386565,0.6199853568633391
3280,0.7868,0,1,0,590559,15051,83399,24557,0.1394179110007781,0.6200010098969905
3281,0.7869,2,1,2,590560,15050,83401,24555,0.13940864796769054,0.6199974750662796
3282,0.787,4,1,4,590561,15049,83405,24551,0.139399384934603,0.6199747474747475
3283,0.7872,0,1,0,590562,15048,83405,24551,0.13939012190151542,0.6199904037980757
3284,0.7873,1,1,1,590563,15047,83406,24550,0.13938085886842788,0.6199964643786146
3285,0.7874,15,10,15,590573,15037,83421,24535,0.13928822853755235,0.6200090973415546
3286,0.7877,1,2,1,590575,15035,83422,24534,0.13926970247137724,0.6200308322171397
3287,0.7878,1,0,1,590575,15035,83423,24533,0.13926970247137724,0.6200212292761828
3288,0.7879,3,1,3,590576,15034,83426,24530,0.13926043943828967,0.6200080881609544
3289,0.7881,0,3,0,590579,15031,83426,24530,0.13923265033902701,0.6200551047749046
3290,0.7884,2,0,2,590579,15031,83428,24528,0.13923265033902701,0.6200358957506509
3291,0.7885,51,48,51,590627,14983,83479,24477,0.1387880247508244,0.6202990369994932
3292,0.7886,2,0,2,590627,14983,83481,24475,0.1387880247508244,0.6202797911703584
3293,0.7887,0,1,0,590628,14982,83481,24475,0.13877876171773684,0.6202955115695568
3294,0.7888,0,2,0,590630,14980,83481,24475,0.13876023565156176,0.6203269547585857
3295,0.7889,1,0,1,590630,14980,83482,24474,0.13876023565156176,0.6203173315760125
3296,0.789,0,1,0,590631,14979,83482,24474,0.1387509726184742,0.6203330545205687
3297,0.7892,18,14,18,590645,14965,83500,24456,0.13862129015524843,0.6203800005073438
3298,0.7893,1,0,1,590645,14965,83501,24455,0.13862129015524843,0.6203703703703703
3299,0.7894,9,13,9,590658,14952,83510,24446,0.13850087072511022,0.6204883496624194
3300,0.7896,4,3,4,590661,14949,83514,24442,0.13847308162584757,0.6204970678581402
3301,0.7897,2,3,2,590664,14946,83516,24440,0.1384452925265849,0.6205250596658711
3302,0.79,1522,1513,1522,592177,13433,85038,22918,0.12443032346511541,0.6304640862699789
3303,0.7904,0,1,0,592178,13432,85038,22918,0.12442106043202786,0.6304814305364511
3304,0.7906,1,0,1,592178,13432,85039,22917,0.12442106043202786,0.6304712646840354
3305,0.7907,1,0,1,592178,13432,85040,22916,0.12442106043202786,0.630461098272257
3306,0.7909,1,1,1,592179,13431,85041,22915,0.12441179739894032,0.6304682771144005
3307,0.7912,0,1,0,592180,13430,85041,22915,0.12440253436585276,0.6304856238822396
3308,0.7914,1,0,1,592180,13430,85042,22914,0.12440253436585276,0.6304754567466432
3309,0.7917,1,0,1,592180,13430,85043,22913,0.12440253436585276,0.6304652890515368
3310,0.7923,0,2,0,592182,13428,85043,22913,0.12438400829967765,0.6304999862414353
3311,0.7924,1,1,1,592183,13427,85044,22912,0.12437474526659009,0.6305071686067311
3312,0.7927,1,2,1,592185,13425,85045,22911,0.12435621920041498,0.6305317040951123
3313,0.7932,1,1,1,592186,13424,85046,22910,0.12434695616732742,0.6305388891946937
3314,0.7943,2,0,2,592186,13424,85048,22908,0.12434695616732742,0.6305185511394914
3315,0.7945,1,0,1,592186,13424,85049,22907,0.12434695616732742,0.6305083812721918
3316,0.7946,0,1,0,592187,13423,85049,22907,0.12433769313423988,0.6305257363060831
3317,0.7949,0,1,0,592188,13422,85049,22907,0.12432843010115233,0.6305430922954114
3318,0.7951,0,1,0,592189,13421,85049,22907,0.12431916706806477,0.6305604492402554
3319,0.7954,1,0,1,592189,13421,85050,22906,0.12431916706806477,0.6305502794065021
3320,0.7956,0,2,0,592191,13419,85050,22906,0.12430064100188966,0.6305849965588438
3321,0.7957,1,0,1,592191,13419,85051,22905,0.12430064100188966,0.6305748265609514
3322,0.7959,2,2,2,592193,13417,85053,22903,0.12428211493571455,0.6305892070484581
3323,0.796,0,1,0,592194,13416,85053,22903,0.12427285190262699,0.63060656956414
3324,0.7962,1,3,1,592197,13413,85054,22902,0.12424506280336434,0.6306484923585295
3325,0.7963,0,2,0,592199,13411,85054,22902,0.12422653673718922,0.6306832263927519
3326,0.7964,1,2,1,592201,13409,85055,22901,0.12420801067101411,0.6307077939961443
3327,0.7965,4,4,4,592205,13405,85059,22897,0.1241709585386639,0.630736598534516
3328,0.7966,2,2,2,592207,13403,85061,22895,0.12415243247248879,0.6307510055650449
3329,0.7967,0,2,0,592209,13401,85061,22895,0.12413390640631368,0.6307857615164205
3330,0.7969,0,2,0,592211,13399,85061,22895,0.12411538034013858,0.6308205212982863
3331,0.797,4,4,4,592215,13395,85065,22891,0.12407832820778836,0.6308493633908394
3332,0.7971,0,1,0,592216,13394,85065,22891,0.1240690651747008,0.6308667493454596
3333,0.7972,1,1,1,592217,13393,85066,22890,0.12405980214161325,0.6308739630129813
3334,0.7973,1,1,1,592218,13392,85067,22889,0.12405053910852569,0.6308811774758137
3335,0.7974,19,13,19,592231,13379,85086,22870,0.12393011967838749,0.6309139562470689
3336,0.7977,2,4,2,592235,13375,85088,22868,0.12389306754603728,0.6309632204839555
3337,0.7979,4,6,4,592241,13369,85092,22864,0.12383748934751194,0.6310269643694975
3338,0.7981,2,2,2,592243,13367,85094,22862,0.12381896328133685,0.6310414308978994
3339,0.7983,0,1,0,592244,13366,85094,22862,0.12380970024824929,0.6310588495086673
3340,0.7984,0,1,0,592245,13365,85094,22862,0.12380043721516173,0.6310762690810722
3341,0.7985,49,42,49,592287,13323,85143,22813,0.12341138982548445,0.6313094974540624
3342,0.7986,2,0,2,592287,13323,85145,22811,0.12341138982548445,0.6312890906071844
3343,0.7987,0,1,0,592288,13322,85145,22811,0.1234021267923969,0.631306561868652
3344,0.7988,1,0,1,592288,13322,85146,22810,0.1234021267923969,0.6312963577991808
3345,0.7989,4,8,4,592296,13314,85150,22806,0.12332802252769647,0.6313953488372093
3346,0.7991,3,0,3,592296,13314,85153,22803,0.12332802252769647,0.6313647312899743
3347,0.7992,21,23,21,592319,13291,85174,22782,0.12311497276668272,0.631552684833532
3348,0.7993,1,1,1,592320,13290,85175,22781,0.12310570973359516,0.6315599789304427
3349,0.7994,9,5,9,592325,13285,85184,22772,0.1230593945681574,0.6315555925340434
3350,0.7995,0,2,0,592327,13283,85184,22772,0.12304086850198229,0.6315906254333656
3351,0.7996,1,4,1,592331,13279,85185,22771,0.12300381636963208,0.6316504854368932
3352,0.7997,2,1,2,592332,13278,85187,22769,0.12299455333654452,0.6316475712264543
3353,0.7998,1,0,1,592332,13278,85188,22768,0.12299455333654452,0.6316373522720967
3354,0.7999,0,1,0,592333,13277,85188,22768,0.12298529030345696,0.6316548758496324
3355,0.8,1416,1420,1416,593753,11857,86604,21352,0.10983178331913002,0.6429582342136168
3356,0.8006,0,1,0,593754,11856,86604,21352,0.10982252028604246,0.6429775957600579
3357,0.8009,0,1,0,593755,11855,86604,21352,0.1098132572529549,0.6429969584726112
3358,0.801,1,0,1,593755,11855,86605,21351,0.1098132572529549,0.6429862073119316
3359,0.8013,0,1,0,593756,11854,86605,21351,0.10980399421986735,0.6430055714500829
3360,0.8018,1,1,1,593757,11853,86606,21350,0.10979473118677979,0.6430141854651689
3361,0.8021,1,0,1,593757,11853,86607,21349,0.10979473118677979,0.6430034335281007
3362,0.8024,2,0,2,593757,11853,86609,21347,0.10979473118677979,0.6429819277108434
3363,0.8028,0,1,0,593758,11852,86609,21347,0.10978546815369225,0.6430012952197355
3364,0.8034,0,1,0,593759,11851,86609,21347,0.1097762051206047,0.6430206638954153
3365,0.8036,1,0,1,593759,11851,86610,21346,0.1097762051206047,0.6430099105340844
3366,0.8038,0,1,0,593760,11850,86610,21346,0.10976694208751714,0.6430292806362212
3367,0.8039,2,2,2,593762,11848,86612,21344,0.10974841602134203,0.6430465172330682
3368,0.8042,1,1,1,593763,11847,86613,21343,0.10973915298825447,0.6430551370894848
3369,0.8044,1,1,1,593764,11846,86614,21342,0.10972988995516691,0.6430637579848137
3370,0.8045,1,0,1,593764,11846,86615,21341,0.10972988995516691,0.643053002681773
3371,0.8048,1,0,1,593764,11846,86616,21340,0.10972988995516691,0.643042246730549
3372,0.8053,1,1,1,593765,11845,86617,21339,0.10972062692207936,0.6430508678881388
3373,0.8055,1,0,1,593765,11845,86618,21338,0.10972062692207936,0.6430401109001597
3374,0.8056,1,0,1,593765,11845,86619,21337,0.10972062692207936,0.6430293532638177
3375,0.8058,1,0,1,593765,11845,86620,21336,0.10972062692207936,0.6430185949790542
3376,0.8059,1,5,1,593770,11840,86621,21335,0.1096743117566416,0.6431047475508667
3377,0.806,0,1,0,593771,11839,86621,21335,0.10966504872355404,0.6431241333574486
3378,0.8062,1,0,1,593771,11839,86622,21334,0.10966504872355404,0.6431133753353631
3379,0.8065,2,4,2,593775,11835,86624,21332,0.10962799659120383,0.64316941538276
3380,0.8066,0,2,0,593777,11833,86624,21332,0.10960947052502872,0.6432082014171566
3381,0.8067,0,1,0,593778,11832,86624,21332,0.10960020749194116,0.6432275961886382
3382,0.8068,2,1,2,593779,11831,86626,21330,0.1095909444588536,0.6432254757094177
3383,0.8069,2,2,2,593781,11829,86628,21328,0.1095724183926785,0.643242754169557
3384,0.807,4,6,4,593787,11823,86632,21324,0.10951684019415317,0.6433161372069871
3385,0.8071,1,1,1,593788,11822,86633,21323,0.10950757716106561,0.6433247850354503
3386,0.8072,0,1,0,593789,11821,86633,21323,0.10949831412797807,0.6433441950277576
3387,0.8073,0,1,0,593790,11820,86633,21323,0.10948905109489052,0.6433636061913526
3388,0.8074,13,8,13,593798,11812,86646,21310,0.10941494683019008,0.6433790230058571
3389,0.8076,1,0,1,593798,11812,86647,21309,0.10941494683019008,0.6433682557893783
3390,0.8077,5,1,5,593799,11811,86652,21304,0.10940568379710253,0.643333836629926
3391,0.8078,1,1,1,593800,11810,86653,21303,0.10939642076401497,0.6433424938845771
3392,0.8079,5,2,5,593802,11808,86658,21298,0.10937789469783986,0.643327493505709
3393,0.8081,0,2,0,593804,11806,86658,21298,0.10935936863166475,0.6433663605606573
3394,0.8084,1,1,1,593805,11805,86659,21297,0.1093501055985772,0.6433750226572412
3395,0.8085,50,36,50,593841,11769,86709,21247,0.10901663640742525,0.643536467167434
3396,0.8086,0,1,0,593842,11768,86709,21247,0.10900737337433769,0.6435559594123883
3397,0.8089,3,2,3,593844,11766,86712,21244,0.10898884730816258,0.6435625568009694
3398,0.8092,14,11,14,593855,11755,86726,21230,0.10888695394419949,0.6436258905563135
3399,0.8093,2,0,2,593855,11755,86728,21228,0.10888695394419949,0.643604280993239
3400,0.8094,2,3,2,593858,11752,86730,21226,0.10885916484493682,0.6436412153556916
3401,0.8096,5,2,5,593860,11750,86735,21221,0.10884063877876171,0.6436262169785569
3402,0.8097,2,3,2,593863,11747,86737,21219,0.10881284967949906,0.6436631681126008
3403,0.81,1442,1220,1442,595083,10527,88179,19777,0.09751194931268295,0.652620116156283
3404,0.8101,3,2,3,595085,10525,88182,19774,0.09749342324650784,0.6526287996303508
3405,0.8105,1,0,1,595085,10525,88183,19773,0.09749342324650784,0.6526173344775232
3406,0.8107,0,1,0,595086,10524,88183,19773,0.09748416021342028,0.652638875136152
3407,0.8112,0,1,0,595087,10523,88183,19773,0.09747489718033273,0.6526604172167942
3408,0.8115,0,1,0,595088,10522,88183,19773,0.09746563414724517,0.6526819607195907
3409,0.8116,2,0,2,595088,10522,88185,19771,0.09746563414724517,0.652659030138976
3410,0.8121,0,1,0,595089,10521,88185,19771,0.09745637111415761,0.6526805757295656
3411,0.8122,1,0,1,595089,10521,88186,19770,0.09745637111415761,0.6526691096365257
3412,0.8123,0,1,0,595090,10520,88186,19770,0.09744710808107007,0.6526906569825025
3413,0.8126,1,2,1,595092,10518,88187,19769,0.09742858201489496,0.6527222900914584
3414,0.8127,1,1,1,595093,10517,88188,19768,0.0974193189818074,0.6527323757635793
3415,0.8128,1,0,1,595093,10517,88189,19767,0.0974193189818074,0.6527209087306829
3416,0.8131,1,0,1,595093,10517,88190,19766,0.0974193189818074,0.6527094409404617
3417,0.8133,1,0,1,595093,10517,88191,19765,0.0974193189818074,0.6526979723928407
3418,0.8135,1,0,1,595093,10517,88192,19764,0.0974193189818074,0.6526865030877448
3419,0.8139,1,0,1,595093,10517,88193,19763,0.0974193189818074,0.6526750330250991
3420,0.8144,0,1,0,595094,10516,88193,19763,0.09741005594871985,0.6526965883945969
3421,0.8146,0,2,0,595096,10514,88193,19763,0.09739152988254474,0.6527397034052251
3422,0.8147,2,0,2,595096,10514,88195,19761,0.09739152988254474,0.6527167630057803
3423,0.8151,2,1,2,595097,10513,88197,19759,0.09738226684945718,0.6527153805496829
3424,0.8152,1,0,1,595097,10513,88198,19758,0.09738226684945718,0.6527039080307886
3425,0.8153,1,1,1,595098,10512,88199,19757,0.09737300381636964,0.6527139978195513
3426,0.8154,1,0,1,595098,10512,88200,19756,0.09737300381636964,0.6527025241178803
3427,0.8155,0,1,0,595099,10511,88200,19756,0.09736374078328208,0.6527240889417517
3428,0.8158,3,1,3,595100,10510,88203,19753,0.09735447775019453,0.6527112315368602
3429,0.8159,3,1,3,595101,10509,88206,19750,0.09734521471710697,0.6526983707326746
3430,0.816,1,1,1,595102,10508,88207,19749,0.09733595168401941,0.6527084641570545
3431,0.8162,0,1,0,595103,10507,88207,19749,0.09732668865093186,0.6527300370174511
3432,0.8163,1,0,1,595103,10507,88208,19748,0.09732668865093186,0.6527185589158817
3433,0.8165,2,1,2,595104,10506,88210,19746,0.0973174256178443,0.6527171757239191
3434,0.8166,0,3,0,595107,10503,88210,19746,0.09728963651858165,0.6527819101457899
3435,0.8168,0,2,0,595109,10501,88210,19746,0.09727111045240654,0.6528250735610143
3436,0.8169,1,0,1,595109,10501,88211,19745,0.09727111045240654,0.6528135951861403
3437,0.817,4,3,4,595112,10498,88215,19741,0.09724332135314387,0.6528324349350177
3438,0.8171,0,1,0,595113,10497,88215,19741,0.09723405832005631,0.6528540247370858
3439,0.8173,1,1,1,595114,10496,88216,19740,0.09722479528696877,0.6528641354676544
3440,0.8174,13,13,13,595127,10483,88229,19727,0.09710437585683056,0.6529956967891427
3441,0.8176,1,1,1,595128,10482,88230,19726,0.097095112823743,0.6530058262711864
3442,0.8177,4,2,4,595130,10480,88234,19722,0.0970765867575679,0.6530031123766638
3443,0.8179,3,1,3,595131,10479,88237,19719,0.09706732372448035,0.652990264255911
3444,0.8181,1,0,1,595131,10479,88238,19718,0.09706732372448035,0.6529787727257674
3445,0.8182,0,1,0,595132,10478,88238,19718,0.09705806069139279,0.6530003974036296
3446,0.8185,37,30,37,595162,10448,88275,19681,0.09678016969876617,0.6532244681204156
3447,0.8188,0,2,0,595164,10446,88275,19681,0.09676164363259106,0.6532678328409732
3448,0.8189,6,1,6,595165,10445,88281,19675,0.0967523805995035,0.6532204515272244
3449,0.8192,17,10,17,595175,10435,88298,19658,0.09665975026862796,0.6532416176519457
3450,0.8194,5,3,5,595178,10432,88303,19653,0.0966319611693653,0.6532491274721622
3451,0.8195,1,0,1,595178,10432,88304,19652,0.0966319611693653,0.6532376013827949
3452,0.8196,1,3,1,595181,10429,88305,19651,0.09660417207010263,0.6532912234042553
3453,0.8197,1,1,1,595182,10428,88306,19650,0.09659490903701508,0.6533014163175743
3454,0.8198,2,1,2,595183,10427,88308,19648,0.09658564600392752,0.6533000831255196
3455,0.82,1461,1156,1461,596339,9271,89769,18187,0.08587757975471488,0.6623570544103722
3456,0.8202,0,1,0,596340,9270,89769,18187,0.08586831672162733,0.6623811778417161
3457,0.8207,1,1,1,596341,9269,89770,18186,0.08585905368853977,0.662393006738299
3458,0.8209,0,1,0,596342,9268,89770,18186,0.08584979065545222,0.6624171341152473
3459,0.8212,2,0,2,596342,9268,89772,18184,0.08584979065545222,0.662392539705668
3460,0.8215,1,1,1,596343,9267,89773,18183,0.08584052762236467,0.6624043715846994
3461,0.8218,1,0,1,596343,9267,89774,18182,0.08584052762236467,0.6623920725709498
3462,0.8222,1,0,1,596343,9267,89775,18181,0.08584052762236467,0.6623797726610318
3463,0.8224,0,2,0,596345,9265,89775,18181,0.08582200155618956,0.6624280405159222
3464,0.8227,0,1,0,596346,9264,89775,18181,0.085812738523102,0.6624521770814356
3465,0.8229,0,1,0,596347,9263,89775,18181,0.08580347549001445,0.6624763154059176
3466,0.823,1,1,1,596348,9262,89776,18180,0.0857942124569269,0.6624881568398805
3467,0.8237,1,0,1,596348,9262,89777,18179,0.0857942124569269,0.6624758572938304
3468,0.8239,0,1,0,596349,9261,89777,18179,0.08578494942383934,0.6625
3469,0.8243,0,1,0,596350,9260,89777,18179,0.08577568639075178,0.6625241444659062
3470,0.8244,2,0,2,596350,9260,89779,18177,0.08577568639075178,0.6624995444108321
3471,0.8248,1,1,1,596351,9259,89780,18176,0.08576642335766424,0.6625113905595043
3472,0.825,3,1,3,596352,9258,89783,18173,0.08575716032457668,0.6624986329335424
3473,0.8253,1,0,1,596352,9258,89784,18172,0.08575716032457668,0.6624863288370397
3474,0.8257,1,0,1,596352,9258,89785,18171,0.08575716032457668,0.6624740238433775
3475,0.8258,2,1,2,596353,9257,89787,18169,0.08574789729148913,0.6624735652300736
3476,0.8259,2,0,2,596353,9257,89789,18167,0.08574789729148913,0.6624489498249708
3477,0.826,1,0,1,596353,9257,89790,18166,0.08574789729148913,0.662436640775991
3478,0.8263,0,2,0,596355,9255,89790,18166,0.08572937122531402,0.6624849567849459
3479,0.8264,2,0,2,596355,9255,89792,18164,0.08572937122531402,0.6624603377220176
3480,0.8265,5,4,5,596359,9251,89797,18159,0.0856923190929638,0.6624954396205764
3481,0.8266,1,3,1,596362,9248,89798,18158,0.08566452999370114,0.6625556447493249
3482,0.8268,0,1,0,596363,9247,89798,18158,0.08565526696061358,0.6625798212005108
3483,0.827,3,3,3,596366,9244,89801,18155,0.08562747786135091,0.662615423920581
3484,0.8273,1,0,1,596366,9244,89802,18154,0.08562747786135091,0.6626031097160376
3485,0.8274,13,13,13,596379,9231,89815,18141,0.08550705843121272,0.6627575624725998
3486,0.8275,1,0,1,596379,9231,89816,18140,0.08550705843121272,0.6627452413137993
3487,0.8277,1,2,1,596381,9229,89817,18139,0.0854885323650376,0.6627813504823151
3488,0.8278,1,0,1,596381,9229,89818,18138,0.0854885323650376,0.6627690283918588
3489,0.8279,1,2,1,596383,9227,89819,18137,0.0854700062988625,0.6628051454465721
3490,0.8281,1,0,1,596383,9227,89820,18136,0.0854700062988625,0.6627928224244418
3491,0.8283,1,0,1,596383,9227,89821,18135,0.0854700062988625,0.6627804985015715
3492,0.8285,39,27,39,596410,9200,89860,18096,0.08521990440549854,0.6629542790152403
3493,0.8286,1,0,1,596410,9200,89861,18095,0.08521990440549854,0.6629419307565488
3494,0.8287,1,1,1,596411,9199,89862,18094,0.08521064137241098,0.6629538709559227
3495,0.8288,1,0,1,596411,9199,89863,18093,0.08521064137241098,0.6629415213249303
3496,0.8289,5,5,5,596416,9194,89868,18088,0.08516432620697321,0.6630012462429441
3497,0.829,0,2,0,596418,9192,89868,18088,0.0851458001407981,0.663049853372434
3498,0.8292,13,13,13,596431,9179,89881,18075,0.0850253807106599,0.6632054010420488
3499,0.8294,2,5,2,596436,9174,89883,18073,0.08497906554522212,0.6633023819136051
3500,0.8296,3,1,3,596437,9173,89886,18070,0.08496980251213457,0.6632896523877694
3501,0.8297,0,4,0,596441,9169,89886,18070,0.08493275037978436,0.6633870553250854
3502,0.8298,0,1,0,596442,9168,89886,18070,0.0849234873466968,0.6634114105294074
3503,0.83,1348,1069,1348,597511,8099,91234,16722,0.07502130497610138,0.6737037186253576
3504,0.8301,1,0,1,597511,8099,91235,16721,0.07502130497610138,0.6736905721192586
3505,0.8302,1,0,1,597511,8099,91236,16720,0.07502130497610138,0.6736774245537693
3506,0.8309,1,0,1,597511,8099,91237,16719,0.07502130497610138,0.6736642759287614
3507,0.832,1,0,1,597511,8099,91238,16718,0.07502130497610138,0.6736511262441068
3508,0.8324,1,0,1,597511,8099,91239,16717,0.07502130497610138,0.6736379754996776
3509,0.8331,0,1,0,597512,8098,91239,16717,0.07501204194301382,0.6736651219020754
3510,0.8332,0,1,0,597513,8097,91239,16717,0.07500277890992627,0.6736922704924639
3511,0.8334,1,0,1,597513,8097,91240,16716,0.07500277890992627,0.6736791198162254
3512,0.8336,0,1,0,597514,8096,91240,16716,0.07499351587683871,0.6737062711591165
3513,0.8339,1,0,1,597514,8096,91241,16715,0.07499351587683871,0.6736931199871025
3514,0.8343,2,0,2,597514,8096,91243,16713,0.07499351587683871,0.6736668144624934
3515,0.8344,0,1,0,597515,8095,91243,16713,0.07498425284375115,0.6736939696871976
3516,0.8345,1,1,1,597516,8094,91244,16712,0.0749749898106636,0.6737079738772878
3517,0.8346,1,0,1,597516,8094,91245,16711,0.0749749898106636,0.6736948195928241
3518,0.8347,1,0,1,597516,8094,91246,16710,0.0749749898106636,0.673681664247702
3519,0.8349,1,1,1,597517,8093,91247,16709,0.07496572677757606,0.6736956697040561
3520,0.835,2,0,2,597517,8093,91249,16707,0.07496572677757606,0.6736693548387097
3521,0.8353,1,3,1,597520,8090,91250,16706,0.07493793767831339,0.6737376996289725
3522,0.8357,1,1,1,597521,8089,91251,16705,0.07492867464522583,0.673751714124385
3523,0.8358,3,0,3,597521,8089,91254,16702,0.07492867464522583,0.6737122342785689
3524,0.8359,0,1,0,597522,8088,91254,16702,0.07491941161213828,0.6737394110528439
3525,0.836,0,1,0,597523,8087,91254,16702,0.07491014857905072,0.6737665900197668
3526,0.8361,2,0,2,597523,8087,91256,16700,0.07491014857905072,0.6737402670754831
3527,0.8362,2,0,2,597523,8087,91258,16698,0.07491014857905072,0.6737139398829938
3528,0.8363,0,1,0,597524,8086,91258,16698,0.07490088554596316,0.6737411233053583
3529,0.8364,2,0,2,597524,8086,91260,16696,0.07490088554596316,0.6737147929949157
3530,0.8365,5,1,5,597525,8085,91265,16691,0.07489162251287562,0.6736761381982563
3531,0.8366,2,3,2,597528,8082,91267,16689,0.07486383341361295,0.6737313794356303
3532,0.837,4,1,4,597529,8081,91271,16685,0.0748545703805254,0.6737058871032867
3533,0.8374,16,6,16,597535,8075,91287,16669,0.07479899218200008,0.6736582605884255
3534,0.8377,1,1,1,597536,8074,91288,16668,0.07478972914891252,0.6736722981165629
3535,0.8379,4,2,4,597538,8072,91292,16664,0.07477120308273741,0.6736739974126779
3536,0.8381,0,3,0,597541,8069,91292,16664,0.07474341398347475,0.6737557109934096
3537,0.8382,0,1,0,597542,8068,91292,16664,0.0747341509503872,0.6737829532589358
3538,0.8384,1,0,1,597542,8068,91293,16663,0.0747341509503872,0.6737697626460717
3539,0.8385,24,28,24,597570,8040,91317,16639,0.07447478602393567,0.6742169455812634
3540,0.8386,0,1,0,597571,8039,91317,16639,0.07446552299084812,0.674244266147986
3541,0.8388,1,0,1,597571,8039,91318,16638,0.07446552299084812,0.6742310653645095
3542,0.839,1,0,1,597571,8039,91319,16637,0.07446552299084812,0.6742178635111039
3543,0.8392,20,6,20,597577,8033,91339,16617,0.0744099447923228,0.6741176470588235
3544,0.8394,8,3,8,597580,8030,91347,16609,0.07438215569306014,0.6740939161491943
3545,0.8396,1,2,1,597582,8028,91348,16608,0.07436362962688503,0.674135411592791
3546,0.8397,1,4,1,597586,8024,91349,16607,0.0743265774945348,0.6742316592911372
3547,0.8398,0,1,0,597587,8023,91349,16607,0.07431731446144725,0.6742590336987414
3548,0.84,1421,980,1421,598567,7043,92770,15186,0.06523954203564415,0.6831616357011112
3549,0.8409,1,1,1,598568,7042,92771,15185,0.0652302790025566,0.6831781167049085
3550,0.8413,1,0,1,598568,7042,92772,15184,0.0652302790025566,0.6831638621434356
3551,0.8416,0,1,0,598569,7041,92772,15184,0.06522101596946904,0.6831946006749157
3552,0.8418,1,0,1,598569,7041,92773,15183,0.06522101596946904,0.6831803455723542
3553,0.8419,1,0,1,598569,7041,92774,15182,0.06522101596946904,0.6831660891868785
3554,0.842,0,1,0,598570,7040,92774,15182,0.06521175293638148,0.6831968319683197
3555,0.8427,0,1,0,598571,7039,92774,15182,0.06520248990329393,0.6832275775167634
3556,0.8431,1,0,1,598571,7039,92775,15181,0.06520248990329393,0.6832133213321332
3557,0.8433,0,3,0,598574,7036,92775,15181,0.06517470080403127,0.6833055768105505
3558,0.8435,0,1,0,598575,7035,92775,15181,0.06516543777094372,0.6833363341735686
3559,0.8436,0,1,0,598576,7034,92775,15181,0.06515617473785616,0.6833670943056493
3560,0.8439,1,0,1,598576,7034,92776,15180,0.06515617473785616,0.6833528405510039
3561,0.8441,1,0,1,598576,7034,92777,15179,0.06515617473785616,0.6833385855129879
3562,0.8442,3,0,3,598576,7034,92780,15176,0.06515617473785616,0.6832958126969834
3563,0.8443,1,0,1,598576,7034,92781,15175,0.06515617473785616,0.6832815525237517
3564,0.8444,1,1,1,598577,7033,92782,15174,0.0651469117047686,0.6832980591705318
3565,0.8445,1,0,1,598577,7033,92783,15173,0.0651469117047686,0.6832837971719355
3566,0.8446,0,1,0,598578,7032,92783,15173,0.06513764867168105,0.6833145687908129
3567,0.8449,1,0,1,598578,7032,92784,15172,0.06513764867168105,0.6833003062511259
3568,0.845,1,0,1,598578,7032,92785,15171,0.06513764867168105,0.6832860424266991
3569,0.8453,1,0,1,598578,7032,92786,15170,0.06513764867168105,0.6832717773173588
3570,0.8455,2,1,2,598579,7031,92788,15168,0.0651283856385935,0.6832740213523132
3571,0.8458,3,1,3,598580,7030,92791,15165,0.06511912260550595,0.6832619959450327
3572,0.8459,2,1,2,598581,7029,92793,15163,0.0651098595724184,0.6832642393655372
3573,0.846,1,0,1,598581,7029,92794,15162,0.0651098595724184,0.6832499662025145
3574,0.8462,0,2,0,598583,7027,92794,15162,0.06509133350624328,0.6833115507683988
3575,0.8463,1,0,1,598583,7027,92795,15161,0.06509133350624328,0.683297277807824
3576,0.8464,1,0,1,598583,7027,92796,15160,0.06509133350624328,0.6832830035606436
3577,0.8465,2,3,2,598586,7024,92798,15158,0.06506354440698062,0.6833468578126409
3578,0.8466,0,1,0,598587,7023,92798,15158,0.06505428137389306,0.6833776655696316
3579,0.847,0,1,0,598588,7022,92798,15158,0.06504501834080552,0.6834084761045988
3580,0.8472,0,1,0,598589,7021,92798,15158,0.06503575530771796,0.6834392894179179
3581,0.8474,13,15,13,598604,7006,92811,15145,0.06489680981140465,0.6837163107760372
3582,0.8477,3,0,3,598604,7006,92814,15142,0.06489680981140465,0.6836734693877551
3583,0.8479,5,6,5,598610,7000,92819,15137,0.06484123161287932,0.6837873243890319
3584,0.8483,1,0,1,598610,7000,92820,15136,0.06484123161287932,0.6837730393928443
3585,0.8484,1,0,1,598610,7000,92821,15135,0.06484123161287932,0.6837587531059408
3586,0.8485,47,24,47,598634,6976,92868,15088,0.06461891881877802,0.6838288614938361
3587,0.8489,6,0,6,598634,6976,92874,15082,0.06461891881877802,0.6837428597334301
3588,0.8492,7,5,7,598639,6971,92881,15075,0.06457260365334025,0.6837975142883063
3589,0.8494,6,5,6,598644,6966,92887,15069,0.06452628848790248,0.6838665759019741
3590,0.8495,0,1,0,598645,6965,92887,15069,0.06451702545481493,0.6838976127802487
3591,0.8496,1,2,1,598647,6963,92888,15068,0.06449849938863982,0.6839453497344651
3592,0.8497,0,1,0,598648,6962,92888,15068,0.06448923635555226,0.6839763958238765
3593,0.8498,0,1,0,598649,6961,92888,15068,0.0644799733224647,0.6840074447319443
3594,0.85,1318,940,1318,599589,6021,94206,13750,0.05577272222016377,0.6954630519447675
3595,0.8502,1,0,1,599589,6021,94207,13749,0.05577272222016377,0.6954476479514415
3596,0.8505,0,1,0,599590,6020,94207,13749,0.05576345918707622,0.6954828266477818
3597,0.8506,1,0,1,599590,6020,94208,13748,0.05576345918707622,0.6954674220963173
3598,0.8509,0,2,0,599592,6018,94208,13748,0.055744933120901105,0.69553779216837
3599,0.8513,1,0,1,599592,6018,94209,13747,0.055744933120901105,0.6955223880597015
3600,0.8518,0,2,0,599594,6016,94209,13747,0.055726407054726,0.6955927743763599
3601,0.852,1,0,1,599594,6016,94210,13746,0.055726407054726,0.6955773707114664
3602,0.8528,0,1,0,599595,6015,94210,13746,0.055717144021638444,0.695612570214058
3603,0.8529,0,1,0,599596,6014,94210,13746,0.05570788098855089,0.6956477732793522
3604,0.8533,2,0,2,599596,6014,94212,13744,0.05570788098855089,0.6956169652798866
3605,0.8535,1,0,1,599596,6014,94213,13743,0.05570788098855089,0.6956015589411347
3606,0.8538,0,1,0,599597,6013,94213,13743,0.05569861795546334,0.6956367685766349
3607,0.8539,1,1,1,599598,6012,94214,13742,0.05568935492237578,0.6956565758833654
3608,0.8541,1,1,1,599599,6011,94215,13741,0.05568009188928823,0.6956763872012961
3609,0.8542,1,1,1,599600,6010,94216,13740,0.05567082885620067,0.6956962025316455
3610,0.8543,0,1,0,599601,6009,94216,13740,0.05566156582311312,0.6957314294394653
3611,0.8546,2,0,2,599601,6009,94218,13738,0.05566156582311312,0.695700612751304
3612,0.8547,1,0,1,599601,6009,94219,13737,0.05566156582311312,0.6956852020662413
3613,0.8549,1,0,1,599601,6009,94220,13736,0.05566156582311312,0.6956697898202077
3614,0.855,1,0,1,599601,6009,94221,13735,0.05566156582311312,0.695654376012966
3615,0.8553,2,0,2,599601,6009,94223,13733,0.05566156582311312,0.6956235437139094
3616,0.8555,1,1,1,599602,6008,94224,13732,0.055652302790025567,0.6956433637284701
3617,0.8557,0,1,0,599603,6007,94224,13732,0.05564303975693801,0.6956786058057652
3618,0.8558,6,3,6,599606,6004,94230,13726,0.05561525065767535,0.6956918398378105
3619,0.8559,3,1,3,599607,6003,94233,13723,0.055605987624587794,0.6956808273344824
3620,0.8563,0,1,0,599608,6002,94233,13723,0.05559672459150024,0.6957160963244613
3621,0.8564,1,0,1,599608,6002,94234,13722,0.05559672459150024,0.6957006692354492
3622,0.8565,7,3,7,599611,5999,94241,13715,0.05556893549223758,0.6956984883838896
3623,0.8566,0,1,0,599612,5998,94241,13715,0.05555967245915002,0.6957337797392583
3624,0.8568,1,1,1,599613,5997,94242,13714,0.05555040942606247,0.6957536400994369
3625,0.8569,1,0,1,599613,5997,94243,13713,0.05555040942606247,0.6957382039573821
3626,0.857,1,0,1,599613,5997,94244,13712,0.05555040942606247,0.6957227662489218
3627,0.8574,17,4,17,599617,5993,94261,13695,0.055513357293712255,0.6956013815522145
3628,0.8577,1,2,1,599619,5991,94262,13694,0.05549483122753714,0.6956565913131826
3629,0.8578,0,1,0,599620,5990,94262,13694,0.05548556819444959,0.6956919325340378
3630,0.8579,1,3,1,599623,5987,94263,13693,0.055457779095186926,0.6957825203252033
3631,0.858,0,1,0,599624,5986,94263,13693,0.05544851606209937,0.6958178769246405
3632,0.8581,2,2,2,599626,5984,94265,13691,0.055429989995924266,0.6958576874205845
3633,0.8583,1,0,1,599626,5984,94266,13690,0.055429989995924266,0.6958422283216428
3634,0.8585,41,22,41,599648,5962,94307,13649,0.05522620326799808,0.6959869461016777
3635,0.8586,1,1,1,599649,5961,94308,13648,0.05521694023491052,0.6960069355908002
3636,0.8587,0,1,0,599650,5960,94308,13648,0.055207677201822965,0.6960424316605467
3637,0.8589,1,0,1,599650,5960,94309,13647,0.055207677201822965,0.6960269291579538
3638,0.8592,14,8,14,599658,5952,94323,13633,0.05513357293712253,0.6960939494511106
3639,0.8594,5,1,5,599659,5951,94328,13628,0.055124309904034975,0.6960518923336227
3640,0.8596,4,4,4,599663,5947,94332,13624,0.05508725777168476,0.6961320320882939
3641,0.8597,1,1,1,599664,5946,94333,13623,0.05507799473859721,0.6961520772650621
3642,0.8599,0,1,0,599665,5945,94333,13623,0.05506873170550965,0.696187653311529
3643,0.86,1401,850,1401,600515,5095,95734,12222,0.04719515358108859,0.705780446959635
3644,0.8604,0,1,0,600516,5094,95734,12222,0.047185890548001035,0.7058212058212058
3645,0.8608,2,0,2,600516,5094,95736,12220,0.047185890548001035,0.7057872242116207
3646,0.8612,0,1,0,600517,5093,95736,12220,0.047176627514913486,0.7058279905273493
3647,0.8613,1,0,1,600517,5093,95737,12219,0.047176627514913486,0.7058109981515711
3648,0.8621,0,1,0,600518,5092,95737,12219,0.04716736448182593,0.7058517705505171
3649,0.8626,0,1,0,600519,5091,95737,12219,0.047158101448738374,0.705892547660312
3650,0.863,0,2,0,600521,5089,95737,12219,0.04713957538256327,0.7059741160157152
3651,0.8634,1,1,1,600522,5088,95738,12218,0.04713031234947571,0.7059979197966023
3652,0.8635,1,0,1,600522,5088,95739,12217,0.04713031234947571,0.705980930366946
3653,0.8643,0,4,0,600526,5084,95739,12217,0.047093260217125496,0.7061441535171378
3654,0.8646,0,1,0,600527,5083,95739,12217,0.04708399718403794,0.706184971098266
3655,0.8647,3,0,3,600527,5083,95742,12214,0.04708399718403794,0.7061340116783257
3656,0.8649,1,0,1,600527,5083,95743,12213,0.04708399718403794,0.7061170212765957
3657,0.865,7,2,7,600529,5081,95750,12206,0.047065471117862835,0.7060797130791925
3658,0.8651,0,1,0,600530,5080,95750,12206,0.04705620808477528,0.706120559990744
3659,0.8655,1,0,1,600530,5080,95751,12205,0.04705620808477528,0.7061035579982644
3660,0.8656,0,2,0,600532,5078,95751,12205,0.04703768201860017,0.7061852687612105
3661,0.8658,0,1,0,600533,5077,95751,12205,0.04702841898551262,0.7062261312348108
3662,0.8659,0,1,0,600534,5076,95751,12205,0.04701915595242506,0.7062669984375904
3663,0.8662,0,1,0,600535,5075,95751,12205,0.047009892919337506,0.7063078703703703
3664,0.8665,5,3,5,600538,5072,95756,12200,0.046982103820074846,0.7063455303381195
3665,0.8666,1,0,1,600538,5072,95757,12199,0.046982103820074846,0.7063285275896011
3666,0.8667,0,1,0,600539,5071,95757,12199,0.04697284078698729,0.7063694267515923
3667,0.867,1,0,1,600539,5071,95758,12198,0.04697284078698729,0.7063524234176849
3668,0.8671,1,0,1,600539,5071,95759,12197,0.04697284078698729,0.7063354181144313
3669,0.8674,10,8,10,600547,5063,95769,12187,0.046898736522286856,0.7064927536231884
3670,0.8678,1,0,1,600547,5063,95770,12186,0.046898736522286856,0.706475737723926
3671,0.8679,3,2,3,600549,5061,95773,12183,0.04688021045611175,0.7065066109951288
3672,0.8681,0,1,0,600550,5060,95773,12183,0.046870947423024195,0.7065475845270545
3673,0.8682,1,0,1,600550,5060,95774,12182,0.046870947423024195,0.7065305648996636
3674,0.8684,1,0,1,600550,5060,95775,12181,0.046870947423024195,0.7065135432979526
3675,0.8685,31,13,31,600563,5047,95806,12150,0.04675052799288599,0.7065185788218875
3676,0.8687,0,1,0,600564,5046,95806,12150,0.04674126495979844,0.706559665038381
3677,0.8688,2,0,2,600564,5046,95808,12148,0.04674126495979844,0.7065255321623822
3678,0.8689,2,2,2,600566,5044,95810,12146,0.04672273889362333,0.7065735892961024
3679,0.869,1,3,1,600569,5041,95811,12145,0.04669494979436067,0.7066798556964972
3680,0.8691,0,1,0,600570,5040,95811,12145,0.04668568676127311,0.7067209775967414
3681,0.8692,14,4,14,600574,5036,95825,12131,0.046648634628922894,0.7066464728840217
3682,0.8694,4,3,4,600577,5033,95829,12127,0.04662084552966023,0.7067016317016317
3683,0.8696,5,0,5,600577,5033,95834,12122,0.04662084552966023,0.7066161468959486
3684,0.8697,1,1,1,600578,5032,95835,12121,0.04661158249657268,0.7066402378592666
3685,0.8698,1,0,1,600578,5032,95836,12120,0.04661158249657268,0.7066231343283582
3686,0.87,1345,708,1345,601286,4324,97181,10775,0.040053355070584315,0.7136234187694549
3687,0.8701,1,0,1,601286,4324,97182,10774,0.040053355070584315,0.7136044509206517
3688,0.8702,0,1,0,601287,4323,97182,10774,0.04004409203749676,0.7136517188845466
3689,0.8703,1,0,1,601287,4323,97183,10773,0.04004409203749676,0.7136327503974563
3690,0.8705,1,1,1,601288,4322,97184,10772,0.0400348290044092,0.7136610573737909
3691,0.8706,2,0,2,601288,4322,97186,10770,0.0400348290044092,0.7136231115822953
3692,0.8713,0,1,0,601289,4321,97186,10770,0.04002556597132165,0.7136703995759062
3693,0.8714,0,2,0,601291,4319,97186,10770,0.04000703990514654,0.7137649943667572
3694,0.872,1,0,1,601291,4319,97187,10769,0.04000703990514654,0.7137460233297985
3695,0.8728,1,1,1,601292,4318,97188,10768,0.039997776872058986,0.7137743603340846
3696,0.8729,0,1,0,601293,4317,97188,10768,0.03998851383897143,0.7138216771627445
3697,0.8731,1,0,1,601293,4317,97189,10767,0.03998851383897143,0.7138027048528242
3698,0.8732,0,1,0,601294,4316,97189,10767,0.03997925080588388,0.7138500298349135
3699,0.8735,1,0,1,601294,4316,97190,10766,0.03997925080588388,0.7138310568890067
3700,0.8737,1,0,1,601294,4316,97191,10765,0.03997925080588388,0.7138120814269611
3701,0.874,0,1,0,601295,4315,97191,10765,0.039969987772796325,0.7138594164456233
3702,0.8742,0,1,0,601296,4314,97191,10765,0.03996072473970877,0.7139067577425559
3703,0.8745,1,1,1,601297,4313,97192,10764,0.039951461706621214,0.7139351329840153
3704,0.8752,0,1,0,601298,4312,97192,10764,0.039942198673533665,0.7139824887237994
3705,0.8753,1,0,1,601298,4312,97193,10763,0.039942198673533665,0.7139635157545605
3706,0.8754,0,1,0,601299,4311,97193,10763,0.03993293564044611,0.7140108796603423
3707,0.8756,1,0,1,601299,4311,97194,10762,0.03993293564044611,0.7139919060571883
3708,0.8757,0,1,0,601300,4310,97194,10762,0.03992367260735855,0.7140392781316348
3709,0.8758,1,0,1,601300,4310,97195,10761,0.03992367260735855,0.7140203038948975
3710,0.8759,3,0,3,601300,4310,97198,10758,0.03992367260735855,0.7139633660737987
3711,0.876,1,1,1,601301,4309,97199,10757,0.039914409574271,0.7139917695473251
3712,0.8762,1,3,1,601304,4306,97200,10756,0.039886620475008336,0.7141149913690081
3713,0.8763,1,0,1,601304,4306,97201,10755,0.039886620475008336,0.7140960095611181
3714,0.8764,1,0,1,601304,4306,97202,10754,0.039886620475008336,0.7140770252324037
3715,0.8765,3,3,3,601307,4303,97205,10751,0.039858831375745675,0.7141623488773747
3716,0.8766,0,1,0,601308,4302,97205,10751,0.03984956834265812,0.7142097920680263
3717,0.8769,0,1,0,601309,4301,97205,10751,0.03984030530957056,0.7142572415625831
3718,0.8773,1,1,1,601310,4300,97206,10750,0.039831042276483014,0.7142857142857143
3719,0.8774,8,6,8,601316,4294,97214,10742,0.039775464077957685,0.7144187283852088
3720,0.8776,0,1,0,601317,4293,97214,10742,0.03976620104487013,0.7144662454273362
3721,0.8777,2,1,2,601318,4292,97216,10740,0.03975693801178258,0.714475784992017
3722,0.8779,6,2,6,601320,4290,97222,10734,0.03973841194560747,0.7144568690095847
3723,0.8784,1,1,1,601321,4289,97223,10733,0.03972914891251991,0.7144854213819731
3724,0.8785,22,13,22,601334,4276,97245,10711,0.03960872948238171,0.714686061253086
3725,0.8788,1,0,1,601334,4276,97246,10710,0.03960872948238171,0.7146670225543841
3726,0.8789,1,2,1,601336,4274,97247,10709,0.0395902034162066,0.7147433758259361
3727,0.879,0,2,0,601338,4272,97247,10709,0.039571677350031496,0.7148387958080235
3728,0.8791,1,2,1,601340,4270,97248,10708,0.039553151283856385,0.7149152089731606
3729,0.8792,11,4,11,601344,4266,97259,10697,0.03951609915150617,0.7148967453050858
3730,0.8794,7,3,7,601347,4263,97266,10690,0.03948831005224351,0.7149067076840768
3731,0.8796,0,2,0,601349,4261,97266,10690,0.039469783986068395,0.7150023409805364
3732,0.8797,1,0,1,601349,4261,97267,10689,0.039469783986068395,0.7149832775919732
3733,0.88,1314,635,1314,601984,3626,98581,9375,0.03358775797547149,0.7210983770479193
3734,0.8805,0,1,0,601985,3625,98581,9375,0.033578494942383935,0.7211538461538461
3735,0.8809,0,1,0,601986,3624,98581,9375,0.03356923190929638,0.721209323794138
3736,0.8815,0,1,0,601987,3623,98581,9375,0.03355996887620882,0.7212648099707647
3737,0.8817,1,2,1,601989,3621,98582,9374,0.03354144281003372,0.7213543670642555
3738,0.8824,1,0,1,601989,3621,98583,9373,0.03354144281003372,0.7213329228874865
3739,0.8828,0,1,0,601990,3620,98583,9373,0.03353217977694616,0.7213884399291927
3740,0.883,2,0,2,601990,3620,98585,9371,0.03353217977694616,0.7213455469170964
3741,0.8832,1,0,1,601990,3620,98586,9370,0.03353217977694616,0.7213240954580447
3742,0.8837,0,1,0,601991,3619,98586,9370,0.033522916743858606,0.7213796289167758
3743,0.8839,1,0,1,601991,3619,98587,9369,0.033522916743858606,0.7213581767785648
3744,0.8841,0,1,0,601992,3618,98587,9369,0.03351365371077106,0.7214137214137214
3745,0.8847,1,0,1,601992,3618,98588,9368,0.03351365371077106,0.7213922685969506
3746,0.8849,2,0,2,601992,3618,98590,9366,0.03351365371077106,0.7213493530499075
3747,0.885,1,1,1,601993,3617,98591,9365,0.0335043906776835,0.7213834540132491
3748,0.8853,1,0,1,601993,3617,98592,9364,0.0335043906776835,0.7213619906016485
3749,0.8855,2,0,2,601993,3617,98594,9362,0.0335043906776835,0.7213190538562293
3750,0.8856,1,0,1,601993,3617,98595,9361,0.0335043906776835,0.7212975805208814
3751,0.8857,1,1,1,601994,3616,98596,9360,0.033495127644595946,0.7213316892725031
3752,0.8858,3,0,3,601994,3616,98599,9357,0.033495127644595946,0.7212672473599013
3753,0.8859,0,2,0,601996,3614,98599,9357,0.03347660157842084,0.721378459640737
3754,0.8864,0,1,0,601997,3613,98599,9357,0.033467338545333285,0.7214340786430223
3755,0.8865,2,4,2,602001,3609,98601,9355,0.03343028641298307,0.7216136994754705
3756,0.8866,1,0,1,602001,3609,98602,9354,0.03343028641298307,0.7215922240222171
3757,0.8868,2,0,2,602001,3609,98604,9352,0.03343028641298307,0.7215492631741378
3758,0.887,1,4,1,602005,3605,98605,9351,0.03339323428063285,0.721750540290213
3759,0.8873,1,0,1,602005,3605,98606,9350,0.03339323428063285,0.7217290621381706
3760,0.8874,14,2,14,602007,3603,98620,9336,0.03337470821445774,0.7215395316485045
3761,0.8877,2,0,2,602007,3603,98622,9334,0.03337470821445774,0.721496482955863
3762,0.8879,2,1,2,602008,3602,98624,9332,0.03336544518137019,0.7215092005566723
3763,0.8881,2,2,2,602010,3600,98626,9330,0.03334691911519508,0.7215777262180975
3764,0.8883,0,1,0,602011,3599,98626,9330,0.03333765608210752,0.7216335370098229
3765,0.8884,1,0,1,602011,3599,98627,9329,0.03333765608210752,0.721612004950495
3766,0.8885,24,10,24,602021,3589,98651,9305,0.033245025751231984,0.7216534822398014
3767,0.8887,2,0,2,602021,3589,98653,9303,0.033245025751231984,0.7216103009618368
3768,0.8888,4,0,4,602021,3589,98657,9299,0.033245025751231984,0.7215238981998758
3769,0.8889,3,3,3,602024,3586,98660,9296,0.03321723665196932,0.7216270765409099
3770,0.8892,7,5,7,602029,3581,98667,9289,0.03317092148653155,0.7217560217560217
3771,0.8894,5,1,5,602030,3580,98672,9284,0.033161658453443994,0.7217039800995025
3772,0.8896,0,3,0,602033,3577,98672,9284,0.03313386935418133,0.7218723271907317
3773,0.8897,0,1,0,602034,3576,98672,9284,0.03312460632109378,0.7219284603421462
3774,0.89,1227,599,1227,602633,2977,99899,8057,0.02757604950164882,0.7301975711437375
3775,0.8903,0,1,0,602634,2976,99899,8057,0.027566786468561266,0.7302637541919695
3776,0.8904,1,0,1,602634,2976,99900,8056,0.027566786468561266,0.7302393038433648
3777,0.8909,0,1,0,602635,2975,99900,8056,0.027557523435473713,0.7303055026742815
3778,0.8916,1,0,1,602635,2975,99901,8055,0.027557523435473713,0.7302810516772439
3779,0.8919,0,1,0,602636,2974,99901,8055,0.027548260402386157,0.7303472662979418
3780,0.8922,0,1,0,602637,2973,99901,8055,0.027538997369298605,0.7304134929270947
3781,0.8947,1,0,1,602637,2973,99902,8054,0.027538997369298605,0.7303890450711888
3782,0.8951,1,0,1,602637,2973,99903,8053,0.027538997369298605,0.7303645927807002
3783,0.8953,1,0,1,602637,2973,99904,8052,0.027538997369298605,0.7303401360544217
3784,0.8964,1,0,1,602637,2973,99905,8051,0.027538997369298605,0.7303156748911466
3785,0.8965,3,1,3,602638,2972,99908,8048,0.02752973433621105,0.7303085299455535
3786,0.8969,0,1,0,602639,2971,99908,8048,0.027520471303123496,0.7303748071512841
3787,0.8971,1,0,1,602639,2971,99909,8047,0.027520471303123496,0.7303503358141223
3788,0.8972,1,1,1,602640,2970,99910,8046,0.02751120827003594,0.7303921568627451
3789,0.8974,11,2,11,602642,2968,99921,8035,0.027492682203860832,0.7302553848950286
3790,0.8975,0,1,0,602643,2967,99921,8035,0.02748341917077328,0.7303217596800582
3791,0.8979,3,1,3,602644,2966,99924,8032,0.027474156137685724,0.7303146026550282
3792,0.8981,1,0,1,602644,2966,99925,8031,0.027474156137685724,0.7302900791124852
3793,0.8985,33,7,33,602651,2959,99958,7998,0.027409314906072846,0.72994432782696
3794,0.8989,3,1,3,602652,2958,99961,7995,0.02740005187298529,0.7299370035606683
3795,0.899,0,1,0,602653,2957,99961,7995,0.027390788839897737,0.7300036523009495
3796,0.8991,1,0,1,602653,2957,99962,7994,0.027390788839897737,0.72997899735184
3797,0.8992,12,3,12,602656,2954,99974,7982,0.027362999740635073,0.7298829553767374
3798,0.8993,1,1,1,602657,2953,99975,7981,0.02735373670754752,0.7299250045728919
3799,0.8994,1,2,1,602659,2951,99976,7980,0.027335210641372412,0.7300338486872199
3800,0.8995,0,1,0,602660,2950,99976,7980,0.027325947608284856,0.7301006404391582
3801,0.8996,2,0,2,602660,2950,99978,7978,0.027325947608284856,0.7300512445095169
3802,0.8999,0,1,0,602661,2949,99978,7978,0.027316684575197304,0.7301180561910863
3803,0.9,1245,530,1245,603191,2419,101223,6733,0.022407277038793583,0.7356861888111889
3804,0.9002,1,0,1,603191,2419,101224,6732,0.022407277038793583,0.7356573052125451
3805,0.9003,1,2,1,603193,2417,101225,6731,0.022388750972618474,0.7357892435505028
3806,0.9004,0,2,0,603195,2415,101225,6731,0.022370224906443366,0.7359501421386399
3807,0.9008,1,0,1,603195,2415,101226,6730,0.022370224906443366,0.7359212684527064
3808,0.901,0,1,0,603196,2414,101226,6730,0.02236096187335581,0.7360017497812773
3809,0.9024,1,2,1,603198,2412,101227,6729,0.0223424358071807,0.7361339021988842
3810,0.9027,0,1,0,603199,2411,101227,6729,0.02233317277409315,0.7362144420131291
3811,0.9046,0,2,0,603201,2409,101227,6729,0.02231464670791804,0.7363755745239658
3812,0.9049,2,0,2,603201,2409,101229,6727,0.02231464670791804,0.7363178633975481
3813,0.9052,0,1,0,603202,2408,101229,6727,0.022305383674830488,0.7363984674329502
3814,0.9058,1,2,1,603204,2406,101230,6726,0.02228685760865538,0.7365308804204993
3815,0.9062,1,0,1,603204,2406,101231,6725,0.02228685760865538,0.7365020260650531
3816,0.9065,1,3,1,603207,2403,101232,6724,0.022259068509392715,0.736715240495234
3817,0.9066,1,0,1,603207,2403,101233,6723,0.022259068509392715,0.7366863905325444
3818,0.9067,0,1,0,603208,2402,101233,6723,0.022249805476305163,0.7367671232876712
3819,0.9069,0,2,0,603210,2400,101233,6723,0.022231279410130055,0.7369286418941138
3820,0.907,4,2,4,603212,2398,101237,6719,0.022212753343954946,0.7369748820884062
3821,0.9071,1,1,1,603213,2397,101238,6718,0.02220349031086739,0.7370268787712562
3822,0.9074,6,5,6,603218,2392,101244,6712,0.02215717514542962,0.7372583479789103
3823,0.9077,2,1,2,603219,2391,101246,6710,0.022147912112342065,0.7372816174046808
3824,0.9079,1,1,1,603220,2390,101247,6709,0.022138649079254513,0.7373337729420816
3825,0.9081,1,0,1,603220,2390,101248,6708,0.022138649079254513,0.7373049021763025
3826,0.9082,1,0,1,603220,2390,101249,6707,0.022138649079254513,0.7372760250632077
3827,0.9085,28,6,28,603226,2384,101277,6679,0.022083070880729187,0.7369524440030895
3828,0.9086,1,0,1,603226,2384,101278,6678,0.022083070880729187,0.7369234164643567
3829,0.9089,3,0,3,603226,2384,101281,6675,0.022083070880729187,0.7368362953968429
3830,0.9092,9,2,9,603228,2382,101290,6666,0.02206454481455408,0.736737400530504
3831,0.9094,8,2,8,603230,2380,101298,6658,0.02204601874837897,0.7366674042929852
3832,0.9096,4,0,4,603230,2380,101302,6654,0.02204601874837897,0.7365508080584459
3833,0.9098,0,1,0,603231,2379,101302,6654,0.022036755715291415,0.7366323480571239
3834,0.91,1172,486,1172,603717,1893,102474,5482,0.01753492163474008,0.7433220338983051
3835,0.9101,0,2,0,603719,1891,102474,5482,0.01751639556856497,0.7435236674352367
3836,0.9106,1,0,1,603719,1891,102475,5481,0.01751639556856497,0.7434888768312534
3837,0.9118,0,1,0,603720,1890,102475,5481,0.017507132535477418,0.7435897435897436
3838,0.9122,1,0,1,603720,1890,102476,5480,0.017507132535477418,0.7435549525101763
3839,0.9123,1,0,1,603720,1890,102477,5479,0.017507132535477418,0.7435201519880581
3840,0.9129,1,0,1,603720,1890,102478,5478,0.017507132535477418,0.743485342019544
3841,0.9137,0,2,0,603722,1888,102478,5478,0.01748860646930231,0.7436872115123541
3842,0.9153,1,0,1,603722,1888,102479,5477,0.01748860646930231,0.743652410047522
3843,0.9155,1,0,1,603722,1888,102480,5476,0.01748860646930231,0.7436175991309071
3844,0.9157,0,1,0,603723,1887,102480,5476,0.017479343436214753,0.7437185929648241
3845,0.9158,1,0,1,603723,1887,102481,5475,0.017479343436214753,0.743683781581092
3846,0.9159,2,0,2,603723,1887,102483,5473,0.017479343436214753,0.7436141304347826
3847,0.9163,0,2,0,603725,1885,102483,5473,0.017460817370039645,0.7438162544169611
3848,0.9164,1,0,1,603725,1885,102484,5472,0.017460817370039645,0.7437814326491776
3849,0.9165,1,3,1,603728,1882,102485,5471,0.017433028270776984,0.7440500475996192
3850,0.9166,3,1,3,603729,1881,102488,5468,0.017423765237689428,0.744046809089672
3851,0.9167,1,1,1,603730,1880,102489,5467,0.017414502204601875,0.7441132435007486
3852,0.9171,0,1,0,603731,1879,102489,5467,0.01740523917151432,0.744214538524367
3853,0.9174,10,5,10,603736,1874,102499,5457,0.01735892400607655,0.7443732096576183
3854,0.9177,3,0,3,603736,1874,102502,5454,0.01735892400607655,0.7442685589519651
3855,0.9179,2,2,2,603738,1872,102504,5452,0.017340397939901442,0.744401966138722
3856,0.918,1,0,1,603738,1872,102505,5451,0.017340397939901442,0.7443670626792298
3857,0.9181,0,1,0,603739,1871,102505,5451,0.017331134906813886,0.7444687243922425
3858,0.9182,2,0,2,603739,1871,102507,5449,0.017331134906813886,0.7443989071038252
3859,0.9185,20,9,20,603748,1862,102527,5429,0.0172477676090259,0.7446166506652037
3860,0.9187,0,3,0,603751,1859,102527,5429,0.017219978509763235,0.7449231613611416
3861,0.9189,2,1,2,603752,1858,102529,5427,0.017210715476675683,0.744955387783116
3862,0.9192,5,6,5,603758,1852,102534,5422,0.017155137278150358,0.7453945559527083
3863,0.9193,1,0,1,603758,1852,102535,5421,0.017155137278150358,0.7453595490169118
3864,0.9194,4,2,4,603760,1850,102539,5417,0.01713661121197525,0.7454245218109261
3865,0.92,1043,413,1043,604173,1437,103582,4374,0.013310978546815368,0.7527103768714507
3866,0.9208,0,1,0,604174,1436,103582,4374,0.013301715513727814,0.7528399311531841
3867,0.9212,0,1,0,604175,1435,103582,4374,0.013292452480640262,0.7529695300395938
3868,0.9216,0,1,0,604176,1434,103582,4374,0.013283189447552708,0.753099173553719
3869,0.9225,0,2,0,604178,1432,103582,4374,0.013264663381377599,0.7533585945573544
3870,0.9226,2,1,2,604179,1431,103584,4372,0.013255400348290045,0.7534034120282612
3871,0.9228,0,1,0,604180,1430,103584,4372,0.01324613731520249,0.7535332643915891
3872,0.9236,1,0,1,604180,1430,103585,4371,0.01324613731520249,0.7534907774521634
3873,0.9243,2,2,2,604182,1428,103587,4369,0.013227611249027382,0.7536656891495601
3874,0.9246,1,0,1,604182,1428,103588,4368,0.013227611249027382,0.7536231884057971
3875,0.9247,1,0,1,604182,1428,103589,4367,0.013227611249027382,0.7535806729939604
3876,0.925,1,0,1,604182,1428,103590,4366,0.013227611249027382,0.7535381429064549
3877,0.9251,0,1,0,604183,1427,103590,4366,0.013218348215939828,0.7536682202658381
3878,0.9253,2,0,2,604183,1427,103592,4364,0.013218348215939828,0.7535831462614402
3879,0.9256,0,1,0,604184,1426,103592,4364,0.013209085182852274,0.753713298791019
3880,0.9264,1,0,1,604184,1426,103593,4363,0.013209085182852274,0.7536707548799447
3881,0.9265,1,2,1,604186,1424,103594,4362,0.013190559116677165,0.7538886968544763
3882,0.927,2,0,2,604186,1424,103596,4360,0.013190559116677165,0.7538035961272476
3883,0.9274,11,4,11,604190,1420,103607,4349,0.013153506984326949,0.7538568209395042
3884,0.9279,4,2,4,604192,1418,103611,4345,0.01313498091815184,0.7539475967378102
3885,0.9285,22,5,22,604197,1413,103633,4323,0.01308866575271407,0.7536610878661087
3886,0.9286,2,0,2,604197,1413,103635,4321,0.01308866575271407,0.7535751656784095
3887,0.9292,8,1,8,604198,1412,103643,4313,0.013079402719626515,0.7533624454148472
3888,0.9294,4,2,4,604200,1410,103647,4309,0.013060876653451407,0.753453400944221
3889,0.9296,1,0,1,604200,1410,103648,4308,0.013060876653451407,0.7534102833158447
3890,0.9297,1,0,1,604200,1410,103649,4307,0.013060876653451407,0.7533671506034634
3891,0.9299,1,0,1,604200,1410,103650,4306,0.013060876653451407,0.7533240027991602
3892,0.93,1011,389,1011,604589,1021,104661,3295,0.009457556782392827,0.7634383688600556
3893,0.9308,1,0,1,604589,1021,104662,3294,0.009457556782392827,0.7633835457705678
3894,0.9315,1,0,1,604589,1021,104663,3293,0.009457556782392827,0.7633286972647195
3895,0.9322,1,0,1,604589,1021,104664,3292,0.009457556782392827,0.763273823324832
3896,0.9324,0,1,0,604590,1020,104664,3292,0.009448293749305272,0.7634508348794063
3897,0.9325,0,1,0,604591,1019,104664,3292,0.009439030716217718,0.7636279285548596
3898,0.9327,1,0,1,604591,1019,104665,3291,0.009439030716217718,0.7635730858468678
3899,0.9328,0,1,0,604592,1018,104665,3291,0.009429767683130164,0.7637502900905082
3900,0.9334,0,1,0,604593,1017,104665,3291,0.00942050465004261,0.7639275766016713
3901,0.935,1,0,1,604593,1017,104666,3290,0.00942050465004261,0.7638727652658462
3902,0.9357,1,0,1,604593,1017,104667,3289,0.00942050465004261,0.7638179284718997
3903,0.9358,2,1,2,604594,1016,104669,3287,0.009411241616955055,0.7638856611666279
3904,0.9363,0,1,0,604595,1015,104669,3287,0.009401978583867501,0.7640632264063226
3905,0.9365,2,1,2,604596,1014,104671,3285,0.009392715550779947,0.7641311933007676
3906,0.9366,1,1,1,604597,1013,104672,3284,0.009383452517692393,0.7642541307889225
3907,0.9367,0,1,0,604598,1012,104672,3284,0.009374189484604839,0.7644320297951583
3908,0.937,1,2,1,604600,1010,104673,3283,0.00935566341842973,0.7647332867458654
3909,0.9373,1,0,1,604600,1010,104674,3282,0.00935566341842973,0.7646784715750233
3910,0.9374,6,2,6,604602,1008,104680,3276,0.009337137352254622,0.7647058823529411
3911,0.9376,1,0,1,604602,1008,104681,3275,0.009337137352254622,0.7646509455988793
3912,0.9377,1,2,1,604604,1006,104682,3274,0.009318611286079513,0.7649532710280373
3913,0.9379,0,1,0,604605,1005,104682,3274,0.00930934825299196,0.7651320401963075
3914,0.9381,0,1,0,604606,1004,104682,3274,0.009300085219904405,0.7653108929406265
3915,0.9385,23,6,23,604612,998,104705,3251,0.00924450702137908,0.7651212049894093
3916,0.9386,0,2,0,604614,996,104705,3251,0.009225980955203971,0.7654815163644926
3917,0.9387,1,0,1,604614,996,104706,3250,0.009225980955203971,0.7654262835609986
3918,0.9388,1,0,1,604614,996,104707,3249,0.009225980955203971,0.7653710247349823
3919,0.9389,2,0,2,604614,996,104709,3247,0.009225980955203971,0.7652604289417865
3920,0.9391,1,0,1,604614,996,104710,3246,0.009225980955203971,0.7652050919377652
3921,0.9392,12,4,12,604618,992,104722,3234,0.009188928822853755,0.7652626597255088
3922,0.9394,3,1,3,604619,991,104725,3231,0.0091796657897662,0.7652771198484131
3923,0.9395,1,2,1,604621,989,104726,3230,0.009161139723591092,0.7655842616733823
3924,0.9396,1,0,1,604621,989,104727,3229,0.009161139723591092,0.7655286865813181
3925,0.94,831,288,831,604909,701,105558,2398,0.0064933861943754865,0.7737979993546306
3926,0.9405,0,1,0,604910,700,105558,2398,0.006484123161287932,0.7740477727566172
3927,0.9417,0,1,0,604911,699,105558,2398,0.006474860128200378,0.7742977074588311
3928,0.9424,0,1,0,604912,698,105558,2398,0.006465597095112824,0.774547803617571
3929,0.9434,1,0,1,604912,698,105559,2397,0.006465597095112824,0.7744749596122779
3930,0.9436,0,1,0,604913,697,105559,2397,0.00645633406202527,0.7747252747252747
3931,0.9443,0,1,0,604914,696,105559,2397,0.0064470710289377155,0.7749757516973812
3932,0.9448,1,0,1,604914,696,105560,2396,0.0064470710289377155,0.7749029754204398
3933,0.9449,1,0,1,604914,696,105561,2395,0.0064470710289377155,0.7748301520543514
3934,0.945,0,1,0,604915,695,105561,2395,0.006437807995850161,0.7750809061488673
3935,0.9452,1,0,1,604915,695,105562,2394,0.006437807995850161,0.7750080932340563
3936,0.9453,1,0,1,604915,695,105563,2393,0.006437807995850161,0.7749352331606217
3937,0.9454,0,1,0,604916,694,105563,2393,0.006428544962762607,0.7751862649821833
3938,0.9458,1,1,1,604917,693,105564,2392,0.006419281929675053,0.7753646677471637
3939,0.9459,0,1,0,604918,692,105564,2392,0.006410018896587499,0.7756160830090791
3940,0.9464,1,0,1,604918,692,105565,2391,0.006410018896587499,0.7755433019785922
3941,0.9465,1,0,1,604918,692,105566,2390,0.006410018896587499,0.7754704737183648
3942,0.947,0,1,0,604919,691,105566,2390,0.0064007558634999445,0.7757221681272314
3943,0.9474,3,1,3,604920,690,105569,2387,0.00639149283041239,0.7757556061098473
3944,0.9479,2,1,2,604921,689,105571,2385,0.006382229797324836,0.7758620689655172
3945,0.9481,1,0,1,604921,689,105572,2384,0.006382229797324836,0.7757891311422063
3946,0.9485,10,3,10,604924,686,105582,2374,0.006354440698062173,0.7758169934640523
3947,0.9486,1,0,1,604924,686,105583,2373,0.006354440698062173,0.7757437070938215
3948,0.9489,2,1,2,604925,685,105585,2371,0.006345177664974619,0.7758507853403142
3949,0.9492,4,4,4,604929,681,105589,2367,0.006308125532624402,0.7765748031496063
3950,0.9493,0,1,0,604930,680,105589,2367,0.006298862499536848,0.7768296685264194
3951,0.9494,4,0,4,604930,680,105593,2363,0.006298862499536848,0.776536312849162
3952,0.95,683,235,683,605165,445,106276,1680,0.004122049723961614,0.7905882352941176
3953,0.9503,0,1,0,605166,444,106276,1680,0.00411278669087406,0.7909604519774012
3954,0.9506,1,0,1,605166,444,106277,1679,0.00411278669087406,0.7908619877531795
3955,0.9508,1,0,1,605166,444,106278,1678,0.00411278669087406,0.7907634307257304
3956,0.9526,0,2,0,605168,442,106278,1678,0.004094260624698951,0.7915094339622641
3957,0.9532,1,0,1,605168,442,106279,1677,0.004094260624698951,0.7914110429447853
3958,0.9547,1,0,1,605168,442,106280,1676,0.004094260624698951,0.7913125590179415
3959,0.9555,2,0,2,605168,442,106282,1674,0.004094260624698951,0.7911153119092628
3960,0.9558,1,0,1,605168,442,106283,1673,0.004094260624698951,0.791016548463357
3961,0.9559,2,1,2,605169,441,106285,1671,0.004084997591611397,0.7911931818181818
3962,0.9563,2,0,2,605169,441,106287,1669,0.004084997591611397,0.7909952606635071
3963,0.9565,4,1,4,605170,440,106291,1665,0.004075734558523843,0.7909738717339667
3964,0.9568,0,1,0,605171,439,106291,1665,0.0040664715254362886,0.7913498098859315
3965,0.957,1,0,1,605171,439,106292,1664,0.0040664715254362886,0.7912505943889682
3966,0.9573,1,0,1,605171,439,106293,1663,0.0040664715254362886,0.791151284490961
3967,0.9574,1,3,1,605174,436,106294,1662,0.004038682426173626,0.792183031458532
3968,0.9577,1,0,1,605174,436,106295,1661,0.004038682426173626,0.7920839294229852
3969,0.9579,0,1,0,605175,435,106295,1661,0.004029419393086072,0.7924618320610687
3970,0.9581,1,0,1,605175,435,106296,1660,0.004029419393086072,0.7923627684964201
3971,0.9585,13,3,13,605178,432,106309,1647,0.004001630293823409,0.7922077922077922
3972,0.9588,1,0,1,605178,432,106310,1646,0.004001630293823409,0.7921077959576516
3973,0.9589,1,0,1,605178,432,106311,1645,0.004001630293823409,0.7920077034183919
3974,0.959,0,1,0,605179,431,106311,1645,0.003992367260735855,0.7923892100192679
3975,0.9592,4,1,4,605180,430,106315,1641,0.003983104227648302,0.7923708353452439
3976,0.9594,1,1,1,605181,429,106316,1640,0.003973841194560747,0.7926534557757371
3977,0.96,572,174,572,605355,255,106888,1068,0.002362073437326318,0.8072562358276644
3978,0.9601,1,0,1,605355,255,106889,1067,0.002362073437326318,0.8071104387291982
3979,0.9611,1,0,1,605355,255,106890,1066,0.002362073437326318,0.8069644208932627
3980,0.9619,0,1,0,605356,254,106890,1066,0.002352810404238764,0.8075757575757576
3981,0.9639,1,0,1,605356,254,106891,1065,0.002352810404238764,0.8074298711144806
3982,0.9665,0,1,0,605357,253,106891,1065,0.0023435473711512097,0.8080424886191199
3983,0.9674,2,0,2,605357,253,106893,1063,0.0023435473711512097,0.8077507598784195
3984,0.9678,1,0,1,605357,253,106894,1062,0.0023435473711512097,0.8076045627376426
3985,0.9679,0,1,0,605358,252,106894,1062,0.0023342843380636555,0.8082191780821918
3986,0.9684,1,0,1,605358,252,106895,1061,0.0023342843380636555,0.8080731150038081
3987,0.9685,5,3,5,605361,249,106900,1056,0.002306495238800993,0.8091954022988506
3988,0.9692,3,1,3,605362,248,106903,1053,0.0022972322057134387,0.8093774019984628
3989,0.9694,2,0,2,605362,248,106905,1051,0.0022972322057134387,0.8090839107005389
3990,0.9696,1,0,1,605362,248,106906,1050,0.0022972322057134387,0.8089368258859785
3991,0.9697,2,0,2,605362,248,106908,1048,0.0022972322057134387,0.808641975308642
3992,0.97,418,112,418,605474,136,107326,630,0.0012597724999073698,0.8224543080939948
3993,0.9738,1,0,1,605474,136,107327,629,0.0012597724999073698,0.8222222222222222
3994,0.9744,1,0,1,605474,136,107328,628,0.0012597724999073698,0.8219895287958116
3995,0.9758,1,0,1,605474,136,107329,627,0.0012597724999073698,0.8217562254259502
3996,0.9768,1,0,1,605474,136,107330,626,0.0012597724999073698,0.821522309711286
3997,0.9774,2,0,2,605474,136,107332,624,0.0012597724999073698,0.8210526315789474
3998,0.9778,0,1,0,605475,135,107332,624,0.0012505094668198156,0.8221343873517787
3999,0.9779,2,0,2,605475,135,107334,622,0.0012505094668198156,0.821664464993395
4000,0.9782,1,0,1,605475,135,107335,621,0.0012505094668198156,0.8214285714285714
4001,0.9785,4,1,4,605476,134,107339,617,0.0012412464337322614,0.8215712383488681
4002,0.9792,1,0,1,605476,134,107340,616,0.0012412464337322614,0.8213333333333334
4003,0.9794,1,0,1,605476,134,107341,615,0.0012412464337322614,0.8210947930574098
4004,0.9796,1,0,1,605476,134,107342,614,0.0012412464337322614,0.820855614973262
4005,0.98,307,78,307,605554,56,107649,307,0.0005187298529030345,0.8457300275482094
4006,0.9838,1,0,1,605554,56,107650,306,0.0005187298529030345,0.8453038674033149
4007,0.9859,0,1,0,605555,55,107650,306,0.0005094668198154803,0.8476454293628809
4008,0.9865,1,0,1,605555,55,107651,305,0.0005094668198154803,0.8472222222222222
4009,0.9874,2,0,2,605555,55,107653,303,0.0005094668198154803,0.8463687150837989
4010,0.9885,5,0,5,605555,55,107658,298,0.0005094668198154803,0.8441926345609065
4011,0.9892,1,0,1,605555,55,107659,297,0.0005094668198154803,0.84375
4012,0.99,170,41,170,605596,14,107829,127,0.00012968246322575864,0.900709219858156
4013,0.9929,1,1,1,605597,13,107830,126,0.00012041943013820446,0.9064748201438849
4014,0.9941,1,1,1,605598,12,107831,125,0.00011115639705065027,0.9124087591240876
4015,0.9955,0,1,0,605599,11,107831,125,0.00010189336396309608,0.9191176470588235
4016,0.9985,2,0,2,605599,11,107833,123,0.00010189336396309608,0.917910447761194
4017,0.9988,1,0,1,605599,11,107834,122,0.00010189336396309608,0.9172932330827067
4018,0.9994,2,0,2,605599,11,107836,120,0.00010189336396309608,0.916030534351145
4019,1.0,120,11,120,605610,0,107956,0,0.0,
