,y_proba,y_test,Neg,Pos,TN,FP,FN,TP,FP/P,Prec
0,0.0001,0,4,0,4,676440,0,126256,5.357685971359777,0.15728993292603924
1,0.0002,0,11,0,15,676429,0,126256,5.3575988467874796,0.15729208842821282
2,0.0003,0,21,0,36,676408,0,126256,5.357432518058547,0.15729620364187255
3,0.0004,0,27,0,63,676381,0,126256,5.357218666835635,0.15730149494728002
4,0.0005,0,43,0,106,676338,0,126256,5.356878088962109,0.15730992257604717
5,0.0006,0,60,0,166,676278,0,126256,5.356402864022304,0.15732168356730059
6,0.0007,0,60,0,226,676218,0,126256,5.355927639082499,0.15733344631726387
7,0.0008,0,58,0,284,676160,0,126256,5.355468254974021,0.157344818647684
8,0.0009,0,84,0,368,676076,0,126256,5.354802940058295,0.157361291834303
9,0.001,1,75,1,443,676001,1,126255,5.354208908883538,0.15737495263357332
10,0.0011,0,83,0,526,675918,1,126255,5.353551514383475,0.15739123605506544
11,0.0012,1,85,1,611,675833,2,126254,5.352878279052085,0.15740686484134514
12,0.0013,0,110,0,721,675723,2,126254,5.352007033329109,0.1574284549307524
13,0.0014,1,100,1,821,675623,3,126253,5.351214991762768,0.15744703669894097
14,0.0015,0,100,0,921,675523,3,126253,5.350422950196426,0.15746667398375605
15,0.0016,1,111,1,1032,675412,4,126252,5.349543784057787,0.1574874261536005
16,0.0017,0,130,0,1162,675282,4,126252,5.3485141300215435,0.15751296888216845
17,0.0018,0,135,0,1297,675147,4,126252,5.347444873906983,0.15753950279448814
18,0.0019,0,140,0,1437,675007,4,126252,5.346336015714105,0.15756702888828705
19,0.002,0,141,0,1578,674866,4,126252,5.345219237105563,0.15759476132105382
20,0.0021,2,151,2,1729,674715,6,126250,5.344023254340388,0.1576223680185776
21,0.0022,4,137,4,1866,674578,10,126246,5.3429381573945,0.15764512552071366
22,0.0023,1,141,1,2007,674437,11,126245,5.3418213787859585,0.15767183476086635
23,0.0024,1,186,1,2193,674251,12,126244,5.340348181472564,0.1577074185347816
24,0.0025,0,176,0,2369,674075,12,126244,5.338954188315803,0.15774210033749042
25,0.0026,1,157,1,2526,673918,13,126243,5.337710683056647,0.15777199838532496
26,0.0027,0,163,0,2689,673755,13,126243,5.33641965530351,0.1578041445103613
27,0.0028,2,189,2,2878,673566,15,126241,5.334922696743125,0.15783932873805806
28,0.0029,4,187,4,3065,673379,19,126237,5.333441579014067,0.15787202857371538
29,0.003,0,170,0,3235,673209,19,126237,5.332095108351286,0.1579055996277422
30,0.0031,1,214,1,3449,672995,20,126236,5.330400139399316,0.1579468263868644
31,0.0032,1,204,1,3653,672791,21,126235,5.32878437460398,0.15798609807440558
32,0.0033,1,204,1,3857,672587,22,126234,5.327168609808643,0.15802538991839224
33,0.0034,1,211,1,4068,672376,23,126233,5.325497402103663,0.15806608740948325
34,0.0035,0,211,0,4279,672165,23,126233,5.323826194398682,0.15810786099163576
35,0.0036,2,205,2,4484,671960,25,126231,5.322202509187682,0.15814635845305197
36,0.0037,1,209,1,4693,671751,26,126230,5.3205471423140285,0.15818672374404905
37,0.0038,0,239,0,4932,671512,26,126230,5.318654162970473,0.15823411579182242
38,0.0039,3,211,3,5143,671301,29,126227,5.316982955265492,0.15827281299214574
39,0.004,1,216,1,5359,671085,30,126226,5.3152721454821945,0.15831463506711935
40,0.0041,2,245,2,5604,670840,32,126224,5.313331643644658,0.15836118555097206
41,0.0042,2,263,2,5867,670577,34,126222,5.31124857432518,0.15841134338773016
42,0.0043,2,260,2,6127,670317,36,126220,5.309189266252693,0.15846093778443437
43,0.0044,2,253,2,6380,670064,38,126218,5.307185401089849,0.15850917137396048
44,0.0045,2,258,2,6638,669806,40,126216,5.305141933848688,0.15855843180213613
45,0.0046,2,269,2,6907,669537,42,126214,5.30301134203523,0.15860991692124798
46,0.0047,0,233,0,7140,669304,42,126214,5.301165885185655,0.15865637232595617
47,0.0048,2,278,2,7418,669026,44,126212,5.298964009631225,0.15870971960595445
48,0.0049,3,272,3,7690,668754,47,126209,5.296809656570777,0.1587608479891517
49,0.005,0,255,0,7945,668499,47,126209,5.2947899505766065,0.15881178999078907
50,0.0051,3,283,3,8228,668216,50,126206,5.29254847294386,0.15886518751998308
51,0.0052,3,270,3,8498,667946,53,126203,5.290409960714738,0.15891602205631436
52,0.0053,2,263,2,8761,667683,55,126201,5.28832689139526,0.15896654926916276
53,0.0054,1,273,1,9034,667410,56,126200,5.286164617919148,0.15902017363692494
54,0.0055,2,288,2,9322,667122,58,126198,5.2838835382080855,0.1590757827862653
55,0.0056,2,295,2,9617,666827,60,126196,5.281547015587378,0.15913283725692698
56,0.0057,2,295,2,9912,666532,62,126194,5.279210492966671,0.15918993447925261
57,0.0058,3,298,3,10210,666234,65,126191,5.276850209098973,0.1592466163990283
58,0.0059,2,281,2,10491,665953,67,126189,5.274624572297554,0.15930098391450018
59,0.006,1,321,1,10812,665632,68,126188,5.272082118869598,0.1593645020332904
60,0.0061,4,315,4,11127,665317,72,126184,5.269587187935623,0.15942367729162693
61,0.0062,1,307,1,11434,665010,73,126183,5.267155620326955,0.15948447471097443
62,0.0063,4,327,4,11761,664683,77,126179,5.264565644405018,0.15954616608207248
63,0.0064,3,316,3,12077,664367,80,126176,5.26206279305538,0.15960675130891044
64,0.0065,2,283,2,12360,664084,82,126174,5.259821315422633,0.1596617813422958
65,0.0066,0,325,0,12685,663759,82,126174,5.2572471803320235,0.15972747055762956
66,0.0067,2,326,2,13011,663433,84,126172,5.254665124825751,0.15979128804908785
67,0.0068,4,321,4,13332,663112,88,126168,5.252122671397795,0.15985201702817758
68,0.0069,8,301,8,13633,662811,96,126160,5.249738626283107,0.1599044831812576
69,0.007,3,285,3,13918,662526,99,126157,5.247481307819035,0.15995907100825046
70,0.0071,1,331,1,14249,662195,100,126156,5.244859650234444,0.1600251664550435
71,0.0072,3,320,3,14569,661875,103,126153,5.242325117222152,0.16008695122508337
72,0.0073,3,324,3,14893,661551,106,126150,5.239758902547206,0.1601495999116416
73,0.0074,0,349,0,15242,661202,106,126150,5.236994677480674,0.16022058748818827
74,0.0075,4,346,4,15588,660856,110,126146,5.234254213661133,0.16028675911878243
75,0.0076,7,327,7,15915,660529,117,126139,5.231664237739197,0.16034591466794124
76,0.0077,5,328,5,16243,660201,122,126134,5.229066341401596,0.1604074599248412
77,0.0078,6,342,6,16585,659859,128,126128,5.226357559244709,0.16047084748221027
78,0.0079,1,337,1,16922,659522,129,126127,5.223688379166139,0.1605386120264902
79,0.008,3,351,3,17273,659171,132,126124,5.22090831326828,0.16060716036648648
80,0.0081,5,365,5,17638,658806,137,126119,5.2180173615511345,0.16067649775456253
81,0.0082,5,361,5,17999,658445,142,126114,5.215158091496642,0.16074508099454599
82,0.0083,2,361,2,18360,658084,144,126112,5.2122988214421495,0.16081693862248725
83,0.0084,2,351,2,18711,657733,146,126110,5.209518755544291,0.16088681024133658
84,0.0085,5,345,5,19056,657388,151,126105,5.206786212140413,0.16095229951001477
85,0.0086,3,357,3,19413,657031,154,126102,5.203958623748575,0.1610224572326795
86,0.0087,4,375,4,19788,656656,158,126098,5.200988467874794,0.1610953121925918
87,0.0088,6,369,6,20157,656287,164,126092,5.198065834494995,0.16116485744121456
88,0.0089,3,350,3,20507,655937,167,126089,5.195293689012799,0.1612337697212113
89,0.009,7,312,7,20819,655625,174,126082,5.192822519325814,0.16129061144392975
90,0.0091,11,366,11,21185,655259,185,126071,5.189923647193004,0.16135435731381106
91,0.0092,2,380,2,21565,654879,187,126069,5.186913889240907,0.16143072266015152
92,0.0093,6,373,6,21938,654506,193,126063,5.183959574198454,0.16150141755565492
93,0.0094,4,380,4,22318,654126,197,126059,5.180949816246357,0.161575780103437
94,0.0095,6,353,6,22671,653773,203,126053,5.178153909517172,0.16164246896102463
95,0.0096,2,381,2,23052,653392,205,126051,5.175136231149411,0.16171933034230854
96,0.0097,5,367,5,23419,653025,210,126046,5.1722294386009375,0.16179013209322385
97,0.0098,5,402,5,23821,652623,215,126041,5.169045431504245,0.16186827694615394
98,0.0099,8,413,8,24234,652210,223,126033,5.165774299835255,0.1619455619902781
99,0.01,3,375,3,24609,651835,226,126030,5.162804143961475,0.16202040199777595
100,0.0101,8,374,8,24983,651461,234,126022,5.159841908503358,0.16208971771730057
101,0.0102,2,409,2,25392,651052,236,126020,5.156602458497022,0.162172874585624
102,0.0103,4,343,4,25735,650709,240,126016,5.153885755924471,0.1622401750941453
103,0.0104,12,377,12,26112,650332,252,126004,5.150899759219364,0.16230601182992932
104,0.0105,5,434,5,26546,649898,257,125999,5.147462298821442,0.1623913998894183
105,0.0106,8,385,8,26931,649513,265,125991,5.144412938791028,0.16246337865439767
106,0.0107,8,411,8,27342,649102,273,125983,5.1411576479533645,0.16254088261287472
107,0.0108,4,401,4,27743,648701,277,125979,5.137981561272335,0.16262069499664378
108,0.0109,6,420,6,28163,648281,283,125973,5.134654986693702,0.16270242065265403
109,0.011,7,423,7,28586,647858,290,125966,5.131304650868078,0.1627837854602597
110,0.0111,8,424,8,29010,647434,298,125958,5.12794639462679,0.16286436890994477
111,0.0112,6,394,6,29404,647040,304,125952,5.124825750855405,0.16294088425235967
112,0.0113,7,427,7,29831,646613,311,125945,5.121443733367127,0.16302335876400217
113,0.0114,4,397,4,30228,646216,315,125941,5.118299328348752,0.16310284048451287
114,0.0115,4,434,4,30662,645782,319,125937,5.11486186795083,0.16319022856765222
115,0.0116,4,423,4,31085,645359,323,125933,5.111511532125206,0.16327538727226523
116,0.0117,6,380,6,31465,644979,329,125927,5.108501774173108,0.16334935776865142
117,0.0118,3,446,3,31911,644533,332,125924,5.104969268787226,0.1634406592450974
118,0.0119,8,377,8,32288,644156,340,125916,5.101983272082119,0.16351198329506852
119,0.012,10,422,10,32710,643734,350,125906,5.098640856672158,0.163590769710514
120,0.0121,6,431,6,33141,643303,356,125900,5.095227157521227,0.16367590870030407
121,0.0122,8,402,8,33543,642901,364,125892,5.0920431504245345,0.1637527917137643
122,0.0123,10,449,10,33992,642452,374,125882,5.088486883791662,0.16383760187626736
123,0.0124,10,420,10,34412,642032,384,125872,5.085160309213028,0.16391632287369254
124,0.0125,7,431,7,34843,641601,391,125865,5.081746610062096,0.16400075052184723
125,0.0126,6,400,6,35243,641201,397,125859,5.07857844379673,0.16407973300654446
126,0.0127,9,436,9,35679,640765,406,125850,5.075125142567482,0.16416323708771677
127,0.0128,5,423,5,36102,640342,411,125845,5.071774806741858,0.164248414551539
128,0.0129,5,438,5,36540,639904,416,125840,5.068305664681282,0.16433690632900813
129,0.013,12,434,12,36974,639470,428,125828,5.064868204283361,0.16441699834574244
130,0.0131,6,428,6,37402,639042,434,125822,5.06147826637942,0.16450244749393356
131,0.0132,4,441,4,37843,638601,438,125818,5.057985363071854,0.16459297845814927
132,0.0133,10,458,10,38301,638143,448,125808,5.054357812698011,0.16468071905135276
133,0.0134,7,431,7,38732,637712,455,125801,5.050944113547079,0.16476602232051057
134,0.0135,5,423,5,39155,637289,460,125796,5.047593777721455,0.1648518841282426
135,0.0136,10,440,10,39595,636849,470,125786,5.044108794829553,0.1649360441102231
136,0.0137,5,416,5,40011,636433,475,125781,5.040813901913572,0.1650205847701564
137,0.0138,6,427,6,40438,636006,481,125775,5.0374318844252945,0.1651065069882289
138,0.0139,10,426,10,40864,635580,491,125765,5.034057787352681,0.1651879240029159
139,0.014,6,401,6,41265,635179,497,125759,5.030881700671651,0.16526839243144645
140,0.0141,6,435,6,41700,634744,503,125753,5.027436319858066,0.16535633934124658
141,0.0142,9,422,9,42122,634322,512,125744,5.024093904448105,0.16543826457176086
142,0.0143,5,437,5,42559,633885,517,125739,5.0206326828031935,0.16552794540456858
143,0.0144,5,453,5,43012,633432,522,125734,5.0170447345076665,0.16562122118219202
144,0.0145,13,433,13,43445,632999,535,125721,5.013615194525409,0.16570144453816954
145,0.0146,13,415,13,43860,632584,548,125708,5.010328222025092,0.1657778270112305
146,0.0147,9,433,9,44293,632151,557,125699,5.006898682042833,0.1658626377251435
147,0.0148,3,440,3,44733,631711,560,125696,5.003413699150931,0.1659556882891233
148,0.0149,10,411,10,45144,631300,570,125686,5.000158408313268,0.1660347747514485
149,0.015,7,439,7,45583,630861,577,125679,4.99668134583703,0.16612340391783648
150,0.0151,6,460,6,46043,630401,583,125673,4.993037954631859,0.16621785698225305
151,0.0152,6,453,6,46496,629948,589,125667,4.989450006336333,0.16631088583471743
152,0.0153,10,436,10,46932,629512,599,125657,4.985996705107084,0.16639586635574288
153,0.0154,13,442,13,47374,629070,612,125644,4.982495881383855,0.1664789575918825
154,0.0155,9,449,9,47823,628621,621,125635,4.978939614750982,0.1665681148045226
155,0.0156,9,434,9,48257,628187,630,125626,4.975502154353061,0.16665406407159336
156,0.0157,5,407,5,48664,627780,635,125621,4.972278545178051,0.1667385628636012
157,0.0158,7,461,7,49125,627319,642,125614,4.968627233557217,0.16683290545108262
158,0.0159,12,430,12,49555,626889,654,125602,4.965221454821949,0.16691495313565213
159,0.016,11,454,11,50009,626435,665,125591,4.961625586110759,0.1670035344522663
160,0.0161,7,431,7,50440,626004,672,125584,4.958211886959828,0.16709154483573446
161,0.0162,11,463,11,50903,625541,683,125573,4.9545447345076665,0.16718234515666064
162,0.0163,15,454,15,51357,625087,698,125558,4.950948865796477,0.16726681720387135
163,0.0164,10,439,10,51796,624648,708,125548,4.947471803320238,0.16735359825965482
164,0.0165,14,441,14,52237,624207,722,125534,4.943978900012673,0.16743648806721254
165,0.0166,9,418,9,52655,623789,731,125525,4.9406681662653655,0.16751989152745045
166,0.0167,12,458,12,53113,623331,743,125513,4.937040615891522,0.16760900801769127
167,0.0168,5,502,5,53615,622829,748,125508,4.933064567228488,0.16771588201572285
168,0.0169,7,479,7,54094,622350,755,125501,4.929270688125713,0.167815514052933
169,0.017,7,455,7,54549,621895,762,125494,4.92566689899886,0.16790988360813444
170,0.0171,5,398,5,54947,621497,767,125489,4.922514573564821,0.167993777661161
171,0.0172,6,474,6,55421,621023,773,125483,4.918760296540363,0.1680937594607411
172,0.0173,7,465,7,55886,620558,780,125476,4.915077303256875,0.16819072589184944
173,0.0174,10,501,10,56387,620057,790,125466,4.911109175009504,0.1682925945946671
174,0.0175,15,445,15,56832,619612,805,125451,4.907584590039285,0.168376365488556
175,0.0176,10,473,10,57305,619139,815,125441,4.90383823343049,0.16847215880093475
176,0.0177,11,457,11,57762,618682,826,125430,4.90021860347231,0.1685633345517879
177,0.0178,7,461,7,58223,618221,833,125423,4.896567291851476,0.16866000398039924
178,0.0179,9,495,9,58718,617726,842,125414,4.892646686098087,0.168762278978389
179,0.018,9,448,9,59166,617278,851,125405,4.889098339880877,0.16885400635264305
180,0.0181,11,428,11,59594,616850,862,125394,4.8857084019769355,0.16893905508161736
181,0.0182,11,486,11,60080,616364,873,125383,4.881859079964516,0.16903742111528594
182,0.0183,12,462,12,60542,615902,885,125371,4.878199847928019,0.16912932212558665
183,0.0184,11,443,11,60985,615459,896,125360,4.874691103789127,0.16921812210539958
184,0.0185,13,484,13,61469,614975,909,125347,4.8708576226080345,0.16931416329651153
185,0.0186,18,465,18,61934,614510,927,125329,4.867174629324547,0.16940036953985935
186,0.0187,10,482,10,62416,614028,937,125319,4.863356988974782,0.16949957191954523
187,0.0188,8,506,8,62922,613522,945,125311,4.859349258649094,0.16960666348146333
188,0.0189,15,478,15,63400,613044,960,125296,4.855563299961982,0.16969959639190615
189,0.019,17,450,17,63850,612594,977,125279,4.851999112913446,0.16978396011237706
190,0.0191,14,484,14,64334,612110,991,125265,4.848165631732353,0.16987964061705374
191,0.0192,14,467,14,64801,611643,1005,125251,4.844466797617539,0.16997152914801858
192,0.0193,14,459,14,65260,611184,1019,125237,4.840831326828032,0.1700616902559813
193,0.0194,9,449,9,65709,610735,1028,125228,4.837275060195159,0.17015529313294284
194,0.0195,10,458,10,66167,610277,1038,125218,4.833647509821316,0.17024996770882195
195,0.0196,9,478,9,66645,609799,1047,125209,4.829861551134203,0.17035052679698726
196,0.0197,13,460,13,67105,609339,1060,125196,4.8262181599290335,0.17044252486266823
197,0.0198,14,488,14,67593,608851,1074,125182,4.822352997085287,0.17054001659325943
198,0.0199,10,489,10,68082,608362,1084,125172,4.818479913825877,0.17064239694410893
199,0.02,13,469,13,68551,607893,1097,125159,4.814765238879737,0.17073686450620146
200,0.0201,16,450,16,69001,607443,1113,125143,4.8112010518312,0.1708236302632046
201,0.0202,10,467,10,69468,606976,1123,125133,4.807502217716386,0.17092126992018947
202,0.0203,5,452,5,69920,606524,1128,125128,4.8039221898365225,0.17102119586907436
203,0.0204,16,437,16,70357,606087,1144,125112,4.800460968191611,0.171105266828866
204,0.0205,13,507,13,70864,605580,1157,125099,4.79644531745026,0.17120924509942123
205,0.0206,15,475,15,71339,605105,1172,125084,4.792683120010138,0.17130359400100523
206,0.0207,12,431,12,71770,604674,1184,125072,4.789269420859207,0.17139114157528784
207,0.0208,13,448,13,72218,604226,1197,125059,4.785721074641997,0.17148165669114268
208,0.0209,11,443,11,72661,603783,1208,125048,4.782212330503105,0.17157338258114707
209,0.021,18,461,18,73122,603322,1226,125030,4.778561018882271,0.17166150432757787
210,0.0211,16,492,16,73614,602830,1242,125014,4.7746641743758715,0.171759333043894
211,0.0212,10,470,10,74084,602360,1252,125004,4.770941579014067,0.17185893170407113
212,0.0213,10,451,10,74535,601909,1262,124994,4.767369471549867,0.17195416719975018
213,0.0214,10,450,10,74985,601459,1272,124984,4.763805284501331,0.17204928672999809
214,0.0215,14,486,14,75471,600973,1286,124970,4.759955962488911,0.17214850201737603
215,0.0216,14,430,14,75901,600543,1300,124956,4.756550183753643,0.1722345585590056
216,0.0217,14,484,14,76385,600059,1314,124942,4.752716702572551,0.17233355540199255
217,0.0218,13,502,13,76887,599557,1327,124929,4.748740653909517,0.17243811474617868
218,0.0219,14,443,14,77330,599114,1341,124915,4.745231909770625,0.17252761975003764
219,0.022,20,488,20,77818,598626,1361,124895,4.741366746926879,0.1726211125869187
220,0.0221,15,450,15,78268,598176,1376,124880,4.737802559878342,0.17271138058462968
221,0.0222,11,456,11,78724,597720,1387,124869,4.734190850335826,0.17280777869577313
222,0.0223,11,459,11,79183,597261,1398,124858,4.730555379546319,0.17290501980975434
223,0.0224,15,453,15,79636,596808,1413,124843,4.726967431250792,0.17299636527906148
224,0.0225,9,463,9,80099,596345,1422,124834,4.723300278798631,0.17309710903950337
225,0.0226,10,401,10,80500,595944,1432,124824,4.720124192117602,0.17318193926478423
226,0.0227,12,457,12,80957,595487,1444,124812,4.716504562159422,0.1732780414799965
227,0.0228,13,427,13,81384,595060,1457,124799,4.713122544671144,0.17336589526560062
228,0.0229,9,485,9,81869,594575,1466,124790,4.709281143074389,0.17347243749695912
229,0.023,10,463,10,82332,594112,1476,124780,4.705613990622228,0.17357266460052415
230,0.0231,20,443,20,82775,593669,1496,124760,4.7021052464833355,0.17365668702126447
231,0.0232,8,460,8,83235,593209,1504,124752,4.698461855278165,0.17375874177009615
232,0.0233,11,469,11,83704,592740,1515,124741,4.6947471803320235,0.17385965621389277
233,0.0234,12,448,12,84152,592292,1527,124729,4.6911988341148145,0.17395445879548854
234,0.0235,21,471,21,84623,591821,1548,124708,4.687468318337347,0.1740445955432369
235,0.0236,16,503,16,85126,591318,1564,124692,4.6834843492586495,0.17414840574852306
236,0.0237,6,474,6,85600,590844,1570,124686,4.679730072234191,0.1742568445767473
237,0.0238,21,475,21,86075,590369,1591,124665,4.675967874794069,0.17434835266574736
238,0.0239,11,457,11,86532,589912,1602,124654,4.672348244835889,0.17444714693954091
239,0.024,15,434,15,86966,589478,1617,124639,4.668910784437967,0.1745358253619505
240,0.0241,15,491,15,87457,588987,1632,124624,4.665021860347231,0.17463856358716442
241,0.0242,17,465,17,87922,588522,1649,124607,4.661338867063743,0.17473276223516362
242,0.0243,11,486,11,88408,588036,1660,124596,4.657489545051324,0.17483918768733372
243,0.0244,11,493,11,88901,587543,1671,124585,4.653584780129261,0.17494748135166713
244,0.0245,13,496,13,89397,587047,1684,124572,4.649656253960208,0.17505434790245905
245,0.0246,14,485,14,89882,586562,1698,124558,4.645814852363452,0.17515749803127462
246,0.0247,19,450,19,90332,586112,1717,124539,4.642250665314916,0.17524635862047616
247,0.0248,18,427,18,90759,585685,1735,124521,4.638868647826638,0.17533081950870594
248,0.0249,14,437,14,91196,585248,1749,124507,4.635407426181726,0.1754225049488908
249,0.025,18,429,18,91625,584819,1767,124489,4.632009567862122,0.17550767790578986
250,0.0251,16,469,16,92094,584350,1783,124473,4.628294892915981,0.17560519339806976
251,0.0252,9,459,9,92553,583891,1792,124464,4.624659422126474,0.17570850773976326
252,0.0253,12,480,12,93033,583411,1804,124452,4.6208576226080345,0.17581368146096066
253,0.0254,11,431,11,93464,582980,1815,124441,4.617443923457103,0.17590798124454887
254,0.0255,9,453,9,93917,582527,1824,124432,4.613855975161576,0.17601020709829
255,0.0256,17,473,17,94390,582054,1841,124415,4.610109618552782,0.176108222724564
256,0.0257,15,428,15,94818,581626,1856,124400,4.60671968064884,0.17619747714673398
257,0.0258,14,460,14,95278,581166,1870,124386,4.60307628944367,0.17629600653105654
258,0.0259,12,458,12,95736,580708,1882,124374,4.599448739069826,0.1763965042363867
259,0.026,11,433,11,96169,580275,1893,124363,4.596019199087568,0.17649204272264624
260,0.0261,7,465,7,96634,579810,1900,124356,4.592336205804081,0.17660040388203918
261,0.0262,12,425,12,97059,579385,1912,124344,4.58897002914713,0.1766930167720813
262,0.0263,11,451,11,97510,578934,1923,124333,4.5853979216829295,0.17679345113591283
263,0.0264,12,457,12,97967,578477,1935,124321,4.58177829172475,0.1768943565576453
264,0.0265,16,505,16,98472,577972,1951,124305,4.577778481814725,0.17700280658486608
265,0.0266,19,459,19,98931,577513,1970,124286,4.574143011025218,0.1770962911032931
266,0.0267,18,469,18,99400,577044,1988,124268,4.570428336079077,0.1771936028472349
267,0.0268,11,482,11,99882,576562,1999,124257,4.566610695729312,0.17730255600946893
268,0.0269,7,486,7,100368,576076,2006,124250,4.562761373716893,0.17741737419430378
269,0.027,21,456,21,100824,575620,2027,124229,4.559149664174376,0.17750829107421745
270,0.0271,21,470,21,101294,575150,2048,124208,4.5554270688125715,0.17760288721942125
271,0.0272,19,460,19,101754,574690,2067,124189,4.551783677607401,0.17769742687933104
272,0.0273,14,460,14,102214,574230,2081,124175,4.54814028640223,0.17779798254594398
273,0.0274,13,440,13,102654,573790,2094,124162,4.5446553035103285,0.1778947549401678
274,0.0275,11,440,11,103094,573350,2105,124151,4.541170320618426,0.17799401004443005
275,0.0276,17,437,17,103531,572913,2122,124134,4.537709098973514,0.17808555233721685
276,0.0277,15,466,15,103997,572447,2137,124119,4.5340181852743635,0.1781869916131422
277,0.0278,5,475,5,104472,571972,2142,124114,4.530255987834241,0.17830268099056726
278,0.0279,27,487,27,104959,571485,2169,124087,4.5263987454061585,0.17839562259550412
279,0.028,12,461,12,105420,571024,2181,124075,4.522747433785325,0.17849975327255543
280,0.0281,6,496,6,105916,570528,2187,124069,4.5188189076162715,0.1786201207318776
281,0.0282,14,465,14,106381,570063,2201,124055,4.5151359143327845,0.17872321420853515
282,0.0283,13,500,13,106881,569563,2214,124042,4.511175706501077,0.17883665775189048
283,0.0284,15,432,15,107313,569131,2229,124027,4.507754086934482,0.1789303448852931
284,0.0285,15,435,15,107748,568696,2244,124012,4.504308706120897,0.17902492825259705
285,0.0286,18,414,18,108162,568282,2262,123994,4.501029654036244,0.17911064373169083
286,0.0287,16,473,16,108635,567809,2278,123978,4.497283297427449,0.1792141222659576
287,0.0288,13,465,13,109100,567344,2291,123965,4.493600304143961,0.17931923351207638
288,0.0289,23,406,23,109506,566938,2314,123942,4.490384615384615,0.17939729041222788
289,0.029,16,462,16,109968,566476,2330,123926,4.486725383348118,0.179498321267899
290,0.0291,18,446,18,110414,566030,2348,123908,4.483192877962235,0.17959294893164313
291,0.0292,9,430,9,110844,565600,2357,123899,4.479787099226967,0.17969424176104679
292,0.0293,15,460,15,111304,565140,2372,123884,4.476143708021797,0.17979634961917146
293,0.0294,12,449,12,111753,564691,2384,123872,4.472587441388924,0.17989929752252154
294,0.0295,16,445,16,112198,564246,2400,123856,4.469062856418705,0.1799965702759184
295,0.0296,15,472,15,112670,563774,2415,123841,4.465324420225573,0.18010223744391848
296,0.0297,13,468,13,113138,563306,2428,123828,4.461617665695096,0.18020939147240567
297,0.0298,12,465,12,113603,562841,2440,123816,4.457934672411608,0.1803171015514296
298,0.0299,16,476,16,114079,562365,2456,123800,4.454164554555823,0.18042307608228342
299,0.03,18,473,18,114552,561892,2474,123782,4.4504181979470285,0.1805260225704927
300,0.0301,13,452,13,115004,561440,2487,123769,4.446838170067165,0.18062955974016687
301,0.0302,18,461,18,115465,560979,2505,123751,4.443186858446332,0.18072963065733938
302,0.0303,9,468,9,115933,560511,2514,123742,4.439480103915853,0.1808424661638312
303,0.0304,9,456,9,116389,560055,2523,123733,4.435868394373337,0.18095228345627593
304,0.0305,10,442,10,116831,559613,2533,123723,4.432367570650108,0.18105734221524988
305,0.0306,18,466,18,117297,559147,2551,123705,4.428676656950957,0.18115931417056697
306,0.0307,20,473,20,117770,558674,2571,123685,4.424930300342162,0.1812608905282996
307,0.0308,16,437,16,118207,558237,2587,123669,4.42146907869725,0.18135784111006503
308,0.0309,12,472,12,118679,557765,2599,123657,4.417730642504119,0.18146904561343777
309,0.031,17,439,17,119118,557326,2616,123640,4.4142535800278795,0.18156559945724163
310,0.0311,18,434,18,119552,556892,2634,123622,4.410816119629958,0.18165974542772081
311,0.0312,14,413,14,119965,556479,2648,123608,4.407544987960968,0.1817532168678419
312,0.0313,20,419,20,120384,556060,2668,123588,4.404226333797998,0.18184118837986724
313,0.0314,10,438,10,120822,555622,2678,123578,4.400757191737422,0.18194640753828034
314,0.0315,10,453,10,121275,555169,2688,123568,4.397169243441896,0.18205578891382082
315,0.0316,19,444,19,121719,554725,2707,123549,4.39365257888734,0.18215205064619902
316,0.0317,21,457,21,122176,554268,2728,123528,4.39003294892916,0.1822495264061753
317,0.0318,10,464,10,122640,553804,2738,123518,4.386357876061336,0.1823623033062561
318,0.0319,15,459,15,123099,553345,2753,123503,4.382722405271829,0.18246785097983595
319,0.032,23,481,23,123580,552864,2776,123480,4.378912685337727,0.18256981654306093
320,0.0321,12,422,12,124002,552442,2788,123468,4.375570269927766,0.18266929029012738
321,0.0322,16,447,16,124449,551995,2804,123452,4.37202984412622,0.18277081695529035
322,0.0323,15,490,15,124939,551505,2819,123437,4.368148840451147,0.1828853442221702
323,0.0324,20,456,20,125395,551049,2839,123417,4.36453713090863,0.18298476127781088
324,0.0325,11,475,11,125870,550574,2850,123406,4.360774933468509,0.1831003887355708
325,0.0326,22,447,22,126317,550127,2872,123384,4.357234507666963,0.18319522621011386
326,0.0327,11,501,11,126818,549626,2883,123373,4.353266379419592,0.18331825158729806
327,0.0328,22,476,22,127294,549150,2905,123351,4.349496261563807,0.18342128859287943
328,0.0329,14,437,14,127731,548713,2919,123337,4.3460350399188945,0.1835235473551075
329,0.033,18,469,18,128200,548244,2937,123319,4.342320364972754,0.18362983070836245
330,0.0331,17,438,17,128638,547806,2954,123302,4.3388512229121785,0.18372899741919332
331,0.0332,26,429,26,129067,547377,2980,123276,4.335453364592574,0.1838148789314295
332,0.0333,21,450,21,129517,546927,3001,123255,4.331889177544038,0.18391272818428428
333,0.0334,14,475,14,129992,546452,3015,123241,4.3281269801039155,0.1840261134579576
334,0.0335,20,452,20,130444,546000,3035,123221,4.324546952224052,0.1841260211499639
335,0.0336,14,470,14,130914,545530,3049,123207,4.320824356862248,0.18423834781087334
336,0.0337,22,442,22,131356,545088,3071,123185,4.317323533139019,0.18433334879607585
337,0.0338,16,409,16,131765,544679,3087,123169,4.314084083132683,0.1844266958948743
338,0.0339,29,464,29,132229,544215,3116,123140,4.310409010264859,0.18451948363314877
339,0.034,14,445,14,132674,543770,3130,123126,4.30688442529464,0.18462548883184185
340,0.0341,26,487,26,133161,543283,3156,123100,4.303027182866557,0.1847286020201596
341,0.0342,17,475,17,133636,542808,3173,123083,4.2992649854264355,0.18483956082902456
342,0.0343,20,459,20,134095,542349,3193,123063,4.2956295146369285,0.18494256190149863
343,0.0344,23,473,23,134568,541876,3216,123040,4.291883158028133,0.18504593061379182
344,0.0345,14,468,14,135036,541408,3230,123026,4.288176403497656,0.18515909781859446
345,0.0346,13,436,13,135472,540972,3243,123013,4.284723102268407,0.18526472736582905
346,0.0347,27,454,27,135926,540518,3270,122986,4.281127233557217,0.18535833996479298
347,0.0348,17,401,17,136327,540117,3287,122969,4.277951146876188,0.18544954953052847
348,0.0349,17,448,17,136775,539669,3304,122952,4.2744028006589785,0.18555403465933015
349,0.035,13,470,13,137245,539199,3317,122939,4.270680205297174,0.18566975464329188
350,0.0351,15,434,15,137679,538765,3332,122924,4.267242744899252,0.18577307466196355
351,0.0352,21,452,21,138131,538313,3353,122903,4.263662717019389,0.18587420752068914
352,0.0353,20,445,20,138576,537868,3373,122883,4.26013813204917,0.1859747469167659
353,0.0354,16,461,16,139037,537407,3389,122867,4.256486820428336,0.1860848677973084
354,0.0355,17,478,17,139515,536929,3406,122850,4.252700861741224,0.1861987119929552
355,0.0356,11,404,11,139919,536525,3417,122839,4.249501013813205,0.1862992216742194
356,0.0357,30,429,30,140348,536096,3447,122809,4.2461031554936,0.18638346954416798
357,0.0358,12,460,12,140808,535636,3459,122797,4.24245976428843,0.18649885409753156
358,0.0359,24,438,24,141246,535198,3483,122773,4.238990622227854,0.18659333010117468
359,0.036,19,431,19,141677,534767,3502,122754,4.235576923076923,0.1866921360686579
360,0.0361,20,440,20,142117,534327,3522,122734,4.232091940185021,0.18679239827048022
361,0.0362,17,448,17,142565,533879,3539,122717,4.228543593967811,0.1868987931696203
362,0.0363,15,432,15,142997,533447,3554,122702,4.225121974401216,0.18700325688220207
363,0.0364,25,404,25,143401,533043,3579,122677,4.221922126473197,0.18708747636186177
364,0.0365,18,448,18,143849,532595,3597,122659,4.2183737802559875,0.1871930579592036
365,0.0366,26,429,26,144278,532166,3623,122633,4.214975921936383,0.18728342590627048
366,0.0367,19,458,19,144736,531708,3642,122614,4.21134837156254,0.18739091762159915
367,0.0368,15,420,15,145156,531288,3657,122599,4.208021796983906,0.18749264016565553
368,0.0369,19,457,19,145613,530831,3676,122580,4.204402167025726,0.18760014753348198
369,0.037,29,447,29,146060,530384,3705,122551,4.2008617412241795,0.18769249619027928
370,0.0371,18,449,18,146509,529935,3723,122533,4.197305474591307,0.1877992483922583
371,0.0372,27,458,27,146967,529477,3750,122506,4.193677924217463,0.1878975372057247
372,0.0373,16,449,16,147416,529028,3766,122490,4.19012165758459,0.18800708499227956
373,0.0374,19,437,19,147853,528591,3785,122471,4.186660435939678,0.1881095809615674
374,0.0375,16,462,16,148315,528129,3801,122455,4.1830012039031805,0.18822319638970525
375,0.0376,21,394,21,148709,527735,3822,122434,4.179880560131796,0.18831103912982625
376,0.0377,25,486,25,149195,527249,3847,122409,4.176031238119377,0.1884206767252924
377,0.0378,25,436,25,149631,526813,3872,122384,4.172577936890128,0.18851596664802825
378,0.0379,26,458,26,150089,526355,3898,122358,4.1689503865162845,0.1886165376676589
379,0.038,15,430,15,150519,525925,3913,122343,4.165544607781016,0.18872287387315123
380,0.0381,19,412,19,150931,525513,3932,122324,4.16228139652769,0.18881910110104858
381,0.0382,22,433,22,151364,525080,3954,122302,4.158851856545431,0.18891782595129306
382,0.0383,23,425,23,151789,524655,3977,122279,4.15548567988848,0.18901309870867816
383,0.0384,9,440,9,152229,524215,3986,122270,4.152000696996579,0.18913045159593803
384,0.0385,14,422,14,152651,523793,4000,122256,4.148658281586617,0.1892364201476978
385,0.0386,24,448,24,153099,523345,4024,122232,4.145109935369408,0.1893376003172356
386,0.0387,17,404,17,153503,522941,4041,122215,4.1419100874413886,0.1894348033653876
387,0.0388,18,441,18,153944,522500,4059,122197,4.138417184133823,0.1895417537230668
388,0.0389,18,485,18,154429,522015,4077,122179,4.134575782537068,0.18966180995166051
389,0.039,15,389,15,154818,521626,4092,122164,4.1314947408439995,0.18975752962922693
390,0.0391,19,440,19,155258,521186,4111,122145,4.128009757952097,0.18986338292418678
391,0.0392,21,433,21,155691,520753,4132,122124,4.124580217969839,0.18996479886510173
392,0.0393,21,407,21,156098,520346,4153,122103,4.121356608794829,0.1900586661353664
393,0.0394,16,445,16,156543,519901,4169,122087,4.117832023824611,0.19017022125024144
394,0.0395,23,420,23,156963,519481,4192,122064,4.114505449245977,0.19026568674060276
395,0.0396,12,459,12,157422,519022,4204,122052,4.11086997845647,0.1903867572230351
396,0.0397,25,399,25,157821,518623,4229,122027,4.107709732606767,0.1904737376102396
397,0.0398,18,440,18,158261,518183,4247,122009,4.104224749714865,0.1905818879336199
398,0.0399,25,429,25,158690,517754,4272,121984,4.10082689139526,0.19067805883033367
399,0.04,23,439,23,159129,517315,4295,121961,4.097349828919022,0.19077988224178602
400,0.0401,22,434,22,159563,516881,4317,121939,4.0939123685211,0.1908816254970101
401,0.0402,16,438,16,160001,516443,4333,121923,4.090443226460525,0.19099231475360529
402,0.0403,22,462,22,160463,515981,4355,121901,4.086783994424027,0.19110274314058087
403,0.0404,25,457,25,160920,515524,4380,121876,4.083164364465847,0.1912080326325698
404,0.0405,28,462,28,161382,515062,4408,121848,4.07950513242935,0.1913111742632397
405,0.0406,21,410,21,161792,514652,4429,121827,4.076257762007351,0.19140772908454168
406,0.0407,21,402,21,162194,514250,4450,121806,4.0730737549106575,0.19150200611266932
407,0.0408,30,476,30,162670,513774,4480,121776,4.0693036370548725,0.19160726929431202
408,0.0409,17,461,17,163131,513313,4497,121759,4.065652325434039,0.19172471782727
409,0.041,15,455,15,163586,512858,4512,121744,4.062048536307185,0.19184307644791537
410,0.0411,16,456,16,164042,512402,4528,121728,4.058436826764669,0.19196063898569693
411,0.0412,24,442,24,164484,511960,4552,121704,4.05493600304144,0.19206393293606708
412,0.0413,32,452,32,164936,511508,4584,121672,4.051355975161576,0.1921602072080609
413,0.0414,26,415,26,165351,511093,4610,121646,4.04806900266126,0.19225304588463807
414,0.0415,26,416,26,165767,510677,4636,121620,4.04477410974528,0.19234631826499257
415,0.0416,26,420,26,166187,510257,4662,121594,4.041447535166646,0.19244093939868734
416,0.0417,24,434,24,166621,509823,4686,121570,4.0380100747687235,0.1925425210605756
417,0.0418,29,414,29,167035,509409,4715,121541,4.0347310226840705,0.19263174578017275
418,0.0419,29,441,29,167476,508968,4744,121512,4.031238119376505,0.19272934906737724
419,0.042,17,433,17,167909,508535,4761,121495,4.027808579394247,0.19284002349094487
420,0.0421,14,392,14,168301,508143,4775,121481,4.024703776454189,0.19294213689440046
421,0.0422,15,444,15,168745,507699,4790,121466,4.021187111899632,0.1930590544610714
422,0.0423,21,415,21,169160,507284,4811,121445,4.017900139399316,0.19315953296253235
423,0.0424,18,419,18,169579,506865,4829,121427,4.014581485236345,0.1932652333628313
424,0.0425,21,451,21,170030,506414,4850,121406,4.011009377772146,0.19337708260329395
425,0.0426,21,397,21,170427,506017,4871,121385,4.0078649727537705,0.19347244669286998
426,0.0427,16,447,16,170874,505570,4887,121369,4.004324546952224,0.1935898069828165
427,0.0428,22,404,22,171278,505166,4909,121347,4.001124699024205,0.19368632414650613
428,0.0429,23,403,23,171681,504763,4932,121324,3.997932771511849,0.19378137543184892
429,0.043,21,405,21,172086,504358,4953,121303,3.9947250031681665,0.19387975277346678
430,0.0431,26,453,26,172539,503905,4979,121277,3.99113705487264,0.1939867110697365
431,0.0432,26,430,26,172969,503475,5005,121251,3.9877312761373718,0.19408668760384554
432,0.0433,22,424,22,173393,503051,5027,121229,3.984373019896084,0.19419010700326778
433,0.0434,26,392,26,173785,502659,5053,121203,3.981268216956026,0.1942785423699472
434,0.0435,31,463,31,174248,502196,5084,121172,3.9776010645038653,0.19438277229501674
435,0.0436,19,451,19,174699,501745,5103,121153,3.9740289570396654,0.1944989388310767
436,0.0437,27,419,27,175118,501326,5130,121126,3.970710302876695,0.19459492458856265
437,0.0438,13,419,13,175537,500907,5143,121113,3.9673916487137246,0.19470917333847787
438,0.0439,17,414,17,175951,500493,5160,121096,3.964112596629071,0.19481683234420172
439,0.044,33,399,33,176350,500094,5193,121063,3.960952350779369,0.19489919617745594
440,0.0441,19,425,19,176775,499669,5212,121044,3.957586174122418,0.19500799886582043
441,0.0442,18,459,18,177234,499210,5230,121026,3.953950703332911,0.19512895091545798
442,0.0443,28,431,28,177665,498779,5258,120998,3.9505370041819794,0.19522828372140302
443,0.0444,20,425,20,178090,498354,5278,120978,3.9471708275250283,0.19533626552479122
444,0.0445,20,409,20,178499,497945,5298,120958,3.9439313775186924,0.19543934994659906
445,0.0446,28,404,28,178903,497541,5326,120930,3.940731529590673,0.19553059076335028
446,0.0447,22,417,22,179320,497124,5348,120908,3.937428716259029,0.19563388303518264
447,0.0448,20,436,20,179756,496688,5368,120888,3.9339754150297805,0.19574594867676204
448,0.0449,24,442,24,180198,496246,5392,120864,3.930474591306552,0.19585487190290224
449,0.045,22,406,22,180604,495840,5414,120842,3.9272589025472056,0.1959551276022326
450,0.0451,20,394,20,180998,495446,5434,120822,3.9241382587758205,0.19605431403220677
451,0.0452,22,404,22,181402,495042,5456,120800,3.920938410847801,0.19615420838461814
452,0.0453,22,394,22,181796,494648,5478,120778,3.917817767076416,0.19625105211674515
453,0.0454,20,376,20,182172,494272,5498,120758,3.9148396907869727,0.19634489374502057
454,0.0455,21,421,21,182593,493851,5519,120737,3.9115051957926754,0.19645193202600766
455,0.0456,21,422,21,183015,493429,5540,120716,3.9081627803827144,0.19655944443087545
456,0.0457,19,405,19,183420,493024,5559,120697,3.9049550120390317,0.19666428230417404
457,0.0458,32,420,32,183840,492604,5591,120665,3.901628437460398,0.19675705114721273
458,0.0459,24,396,24,184236,492208,5615,120641,3.898491952857686,0.19685273207592735
459,0.046,19,412,19,184648,491796,5634,120622,3.8952287416043596,0.19696024610641752
460,0.0461,18,448,18,185096,491348,5652,120604,3.8916803953871497,0.19708081679608858
461,0.0462,24,387,24,185483,490961,5676,120580,3.888615194525409,0.19717402430908149
462,0.0463,27,451,27,185934,490510,5703,120553,3.885043087061209,0.19728407709188742
463,0.0464,19,376,19,186310,490134,5722,120534,3.882065010771765,0.19738057340486156
464,0.0465,20,443,20,186753,489691,5742,120514,3.878556266632873,0.1974975622946387
465,0.0466,30,450,30,187203,489241,5772,120484,3.8749920795843367,0.19760383779572757
466,0.0467,20,443,20,187646,488798,5792,120464,3.8714833354454443,0.1977211774244906
467,0.0468,21,400,21,188046,488398,5813,120443,3.868315169180079,0.1978234054539691
468,0.0469,27,408,27,188454,487990,5840,120416,3.8650836395894057,0.19792046758250248
469,0.047,17,398,17,188852,487592,5857,120399,3.861931314155367,0.1980276023822721
470,0.0471,24,434,24,189286,487158,5881,120375,3.8584938537574454,0.19813738512969667
471,0.0472,20,428,20,189714,486730,5901,120355,3.855103915853504,0.19825065682729767
472,0.0473,28,378,28,190092,486352,5929,120327,3.8521099987327334,0.19833717666179315
473,0.0474,18,418,18,190510,485934,5947,120309,3.8487992649854266,0.19845012643444956
474,0.0475,27,392,27,190902,485542,5974,120282,3.845694462045368,0.1985428111134587
475,0.0476,21,402,21,191304,485140,5995,120261,3.8425104549486755,0.19864684729625487
476,0.0477,30,403,30,191707,484737,6025,120231,3.83931852743632,0.198739437457849
477,0.0478,22,419,22,192126,484318,6047,120209,3.8359998732733493,0.19884802498482285
478,0.0479,22,395,22,192521,483923,6069,120187,3.832871309086301,0.19894886692820843
479,0.048,36,397,36,192918,483526,6105,120151,3.8297269040679254,0.1990319326394744
480,0.0481,20,400,20,193318,483126,6125,120131,3.82655873780256,0.19913734942155664
481,0.0482,20,405,20,193723,482721,6145,120111,3.823350969458877,0.19924456565013138
482,0.0483,31,395,31,194118,482326,6176,120080,3.8202224052718288,0.19933400397738402
483,0.0484,19,405,19,194523,481921,6195,120061,3.817014636928146,0.1994428404836025
484,0.0485,27,429,27,194952,481492,6222,120034,3.8136167786085413,0.19954914667030185
485,0.0486,27,413,27,195365,481079,6249,120007,3.8103456469395516,0.1996502996243466
486,0.0487,25,439,25,195804,480640,6274,119982,3.8068685844633126,0.1997629124474295
487,0.0488,27,411,27,196215,480229,6301,119955,3.8036132936256495,0.1998637084627381
488,0.0489,20,368,20,196583,479861,6321,119935,3.8006985806615132,0.19995965294866921
489,0.049,24,385,24,196968,479476,6345,119911,3.7976492206310986,0.20005605727184608
490,0.0491,21,424,21,197392,479052,6366,119890,3.7942909643898113,0.20016963245189018
491,0.0492,27,418,27,197810,478634,6393,119863,3.790980230642504,0.2002733514119536
492,0.0493,22,394,22,198204,478240,6415,119841,3.787859586871119,0.20037586882044406
493,0.0494,20,406,20,198610,477834,6435,119821,3.784643898111773,0.2004852297730296
494,0.0495,23,398,23,199008,477436,6458,119798,3.781491572677734,0.20058804421717452
495,0.0496,25,428,25,199436,477008,6483,119773,3.778101634773793,0.20069841365593075
496,0.0497,26,388,26,199824,476620,6509,119747,3.7750285134963883,0.20079414186230962
497,0.0498,18,429,18,200253,476191,6527,119729,3.7716306551767835,0.20091455228889785
498,0.0499,27,424,27,200677,475767,6554,119702,3.7682723989354963,0.2010213797863533
499,0.05,17,434,17,201111,475333,6571,119685,3.7648349385375743,0.2011451754400707
500,0.0501,24,392,24,201503,474941,6595,119661,3.7617301355975163,0.20124553903283204
501,0.0502,21,402,21,201905,474539,6616,119640,3.7585461285008237,0.20135346419176714
502,0.0503,19,395,19,202300,474144,6635,119621,3.7554175643137753,0.20146185780569753
503,0.0504,31,419,31,202719,473725,6666,119590,3.7520989101508047,0.20156240782720813
504,0.0505,29,408,29,203127,473317,6695,119561,3.7488673805601316,0.20166206200938472
505,0.0506,21,423,21,203550,472894,6716,119540,3.7455170447345076,0.20177775077054996
506,0.0507,28,406,28,203956,472488,6744,119512,3.7423013559751617,0.20187837837837838
507,0.0508,22,386,22,204342,472102,6766,119490,3.7392440755290837,0.20198041893737576
508,0.0509,22,389,22,204731,471713,6788,119468,3.7361630338360157,0.2020836258269464
509,0.051,28,400,28,205131,471313,6816,119440,3.73299486757065,0.20218263809070797
510,0.0511,27,415,27,205546,470898,6843,119413,3.7297078950703333,0.20228828532756463
511,0.0512,24,405,24,205951,470493,6867,119389,3.7265001267266507,0.20239471623138186
512,0.0513,20,382,20,206333,470111,6887,119369,3.7234745279432264,0.2024988125127231
513,0.0514,29,386,29,206719,469725,6916,119340,3.720417247497149,0.20259224364034528
514,0.0515,25,422,25,207141,469303,6941,119315,3.717074832087188,0.20270362102416167
515,0.0516,23,428,23,207569,468875,6964,119292,3.7136848941832468,0.20281994739589265
516,0.0517,29,399,29,207968,468476,6993,119263,3.7105246483335446,0.20291830217154214
517,0.0518,26,418,26,208386,468058,7019,119237,3.7072139145862373,0.20302743936181986
518,0.0519,25,395,25,208781,467663,7044,119212,3.704085350399189,0.20313013844515443
519,0.052,27,386,27,209167,467277,7071,119185,3.7010280699531113,0.20322714856205518
520,0.0521,21,433,21,209600,466844,7092,119164,3.6975985299708527,0.20334875974389427
521,0.0522,21,401,21,210001,466443,7113,119143,3.694422443289824,0.20345944062870355
522,0.0523,16,347,16,210348,466096,7129,119127,3.6916740590546193,0.20355830170721245
523,0.0524,27,371,27,210719,465725,7156,119100,3.6887355848434926,0.203650664728765
524,0.0525,27,396,27,211115,465329,7183,119073,3.685599100240781,0.2037518694323428
525,0.0526,27,375,27,211490,464954,7210,119046,3.6826289443670004,0.2038458904109589
526,0.0527,28,415,28,211905,464539,7238,119018,3.6793419718666835,0.20395265586737885
527,0.0528,25,385,25,212290,464154,7263,118993,3.6762926118362693,0.20405318041591572
528,0.0529,39,418,39,212708,463736,7302,118954,3.672981878088962,0.2041462870480015
529,0.053,23,396,23,213104,463340,7325,118931,3.6698453934862503,0.20425368943327077
530,0.0531,33,416,33,213520,462924,7358,118898,3.66655050057027,0.20435459642296097
531,0.0532,18,375,18,213895,462549,7376,118880,3.6635803446964896,0.2044617657529982
532,0.0533,31,397,31,214292,462152,7407,118849,3.660435939678114,0.20455902829771377
533,0.0534,21,368,21,214660,461784,7428,118828,3.657521226713978,0.2046599105771152
534,0.0535,22,424,22,215084,461360,7450,118806,3.6541629704726906,0.20477932178031805
535,0.0536,29,386,29,215470,460974,7479,118777,3.6511056900266126,0.20487588637190793
536,0.0537,25,415,25,215885,460559,7504,118752,3.6478187175262957,0.20498833959652069
537,0.0538,27,407,27,216292,460152,7531,118725,3.6445951083512864,0.20509538295700122
538,0.0539,30,393,30,216685,459759,7561,118695,3.6414823849955646,0.2051934985322947
539,0.054,25,438,25,217123,459321,7586,118670,3.6380132429349894,0.20531461562550282
540,0.0541,27,376,27,217499,458945,7613,118643,3.6350351666455456,0.2054111234997957
541,0.0542,16,381,16,217880,458564,7629,118627,3.6320174882777847,0.20552468766838014
542,0.0543,31,350,31,218230,458214,7660,118596,3.6292453427955897,0.20560669891298694
543,0.0544,26,387,26,218617,457827,7686,118570,3.626180141933849,0.2057089124336178
544,0.0545,22,410,22,219027,457417,7708,118548,3.622932771511849,0.20582500672783938
545,0.0546,21,361,21,219388,457056,7729,118527,3.6200735014573566,0.205925122875415
546,0.0547,26,400,26,219788,456656,7755,118501,3.616905335191991,0.20603243983816594
547,0.0548,24,410,24,220198,456246,7779,118477,3.6136579647699913,0.2061462652443003
548,0.0549,34,375,34,220573,455871,7813,118443,3.610687808896211,0.2062338720630178
549,0.055,27,401,27,220974,455470,7840,118416,3.607511722215182,0.20634063211160406
550,0.0551,24,389,24,221363,455081,7864,118392,3.604430680522114,0.20644738287591569
551,0.0552,26,411,26,221774,454670,7890,118366,3.6011753896844505,0.20655944827201084
552,0.0553,25,373,25,222147,454297,7915,118341,3.598221074641997,0.206659355474139
553,0.0554,20,394,20,222541,453903,7935,118321,3.595100430870612,0.2067739207023823
554,0.0555,31,411,31,222952,453492,7966,118290,3.591845140032949,0.20687954500141661
555,0.0556,24,365,24,223317,453127,7990,118266,3.5889541883158027,0.20697838440442917
556,0.0557,18,378,18,223695,452749,8008,118248,3.5859602711950322,0.2070904050283977
557,0.0558,23,401,23,224096,452348,8031,118225,3.5827841845140034,0.20720398616829047
558,0.0559,20,403,20,224499,451945,8051,118205,3.5795922570016474,0.2073226343944576
559,0.056,29,367,29,224866,451578,8080,118176,3.5766854644531745,0.2074158320959572
560,0.0561,29,361,29,225227,451217,8109,118147,3.573826194398682,0.20750697269233742
561,0.0562,32,372,32,225599,450845,8141,118115,3.570879799771892,0.20759807367829022
562,0.0563,25,401,25,226000,450444,8166,118090,3.567703713090863,0.20770965324853044
563,0.0564,30,358,30,226358,450086,8196,118060,3.5648682042833606,0.20779869963002467
564,0.0565,32,417,32,226775,449669,8228,118028,3.561565390951717,0.207906682614141
565,0.0566,18,370,18,227145,449299,8246,118010,3.558634837156254,0.20801714762149023
566,0.0567,31,377,31,227522,448922,8277,117979,3.555648840451147,0.20811217478889613
567,0.0568,29,365,29,227887,448557,8306,117950,3.552757888734001,0.20820572384807248
568,0.0569,24,376,24,228263,448181,8330,117926,3.549779812444557,0.20831044307878194
569,0.057,23,390,23,228653,447791,8353,117903,3.5466908503358257,0.20842186765282997
570,0.0571,23,390,23,229043,447401,8376,117880,3.5436018882270943,0.20853345504271328
571,0.0572,30,408,30,229451,446993,8406,117850,3.5403703586364212,0.20864204743619022
572,0.0573,35,395,35,229846,446598,8441,117815,3.537241794449373,0.20873899077448607
573,0.0574,16,403,16,230249,446195,8457,117799,3.534049866937017,0.2088656971528066
574,0.0575,29,370,29,230619,445825,8486,117770,3.5311193131415535,0.2089621093160869
575,0.0576,25,376,25,230995,445449,8511,117745,3.52814123685211,0.20906650283916378
576,0.0577,32,380,32,231375,445069,8543,117713,3.5251314789000125,0.20916269532429965
577,0.0578,36,351,36,231726,444718,8579,117677,3.5223514130021543,0.20924261417686857
578,0.0579,31,414,31,232140,444304,8610,117646,3.5190723609175008,0.20935314529762433
579,0.058,26,345,26,232485,443959,8636,117620,3.516339817513623,0.20944515375396872
580,0.0581,26,380,26,232865,443579,8662,117594,3.5133300595615258,0.2095503525650735
581,0.0582,26,405,26,233270,443174,8688,117568,3.510122291217843,0.20966505095034793
582,0.0583,27,370,27,233640,442804,8715,117541,3.5071917374223798,0.20976541237987312
583,0.0584,30,376,30,234016,442428,8745,117511,3.5042136611329364,0.20986393160683575
584,0.0585,29,342,29,234358,442086,8774,117482,3.5015048789760486,0.20995124810568153
585,0.0586,23,390,23,234748,441696,8797,117459,3.4984159168673172,0.2100651876492207
586,0.0587,26,407,26,235155,441289,8823,117433,3.4951923076923075,0.2101814498086705
587,0.0588,21,376,21,235531,440913,8844,117412,3.492214231402864,0.2102932879595218
588,0.0589,22,370,22,235901,440543,8866,117390,3.4892836776074008,0.21040160736145738
589,0.059,14,357,14,236258,440186,8880,117376,3.486456089215562,0.2105164986136071
590,0.0591,30,377,30,236635,439809,8910,117346,3.483470092510455,0.21061643528282076
591,0.0592,25,394,25,237029,439415,8935,117321,3.48034944873907,0.21073004080928842
592,0.0593,20,405,20,237434,439010,8955,117301,3.477141680395387,0.21085507926321786
593,0.0594,20,378,20,237812,438632,8975,117281,3.4741477632746167,0.21097006186219786
594,0.0595,32,364,32,238176,438268,9007,117249,3.471264731973134,0.21106284776163467
595,0.0596,27,358,27,238534,437910,9034,117222,3.4684292231656317,0.2111605888329262
596,0.0597,36,364,36,238898,437546,9070,117186,3.4655461918641493,0.2112479539669606
597,0.0598,31,382,31,239280,437164,9101,117155,3.462520593080725,0.21134942154246922
598,0.0599,27,374,27,239654,436790,9128,117128,3.459558357622608,0.21145368086973163
599,0.06,22,394,22,240048,436396,9150,117106,3.456437713851223,0.21157285791198585
600,0.0601,26,340,26,240388,436056,9176,117080,3.453744772525662,0.21166584709727806
601,0.0602,36,345,36,240733,435711,9212,117044,3.451012229121784,0.2117466146846252
602,0.0603,27,367,27,241100,435344,9239,117017,3.4481054365733113,0.21184877281343178
603,0.0604,31,381,31,241481,434963,9270,116986,3.445087758205551,0.21195074182578463
604,0.0605,26,350,26,241831,434613,9296,116960,3.442315612723356,0.21204808792308544
605,0.0606,20,376,20,242207,434237,9316,116940,3.439337536433912,0.2121641505360347
606,0.0607,28,347,28,242554,433890,9344,116912,3.4365891521987075,0.2122577623174934
607,0.0608,34,374,34,242928,433516,9378,116878,3.4336269167405904,0.21235333234010545
608,0.0609,31,345,31,243273,433171,9409,116847,3.4308943733367125,0.2124421382572934
609,0.061,27,340,27,243613,432831,9436,116820,3.428201432011152,0.21253486303126892
610,0.0611,29,352,29,243965,432479,9465,116791,3.42541344569763,0.21262949005043058
611,0.0612,19,381,19,244346,432098,9484,116772,3.4223957673298693,0.21274983147193324
612,0.0613,22,356,22,244702,431742,9506,116750,3.419576099353694,0.2128563406576577
613,0.0614,31,355,31,245057,431387,9537,116719,3.4167643517931823,0.21294968491496172
614,0.0615,24,360,24,245417,431027,9561,116695,3.413913002154353,0.21305516302065647
615,0.0616,34,359,34,245776,430668,9595,116661,3.4110695729311873,0.2131460236895907
616,0.0617,23,340,23,246116,430328,9618,116638,3.4083766316056265,0.21324543024612133
617,0.0618,23,339,23,246455,429989,9641,116615,3.405691610695729,0.21334457852485528
618,0.0619,25,365,25,246820,429624,9666,116590,3.4028006589785833,0.2134511381985815
619,0.062,20,371,20,247191,429253,9686,116570,3.3998621847674566,0.2135674018866922
620,0.0621,31,387,31,247578,428866,9717,116539,3.3967969839057153,0.21367424207698865
621,0.0622,36,384,36,247962,428482,9753,116503,3.3937555442909644,0.21377285613365504
622,0.0623,37,381,37,248343,428101,9790,116466,3.3907378659232035,0.213869000508661
623,0.0624,25,357,25,248700,427744,9815,116441,3.3879102775313648,0.2139731892646802
624,0.0625,33,372,33,249072,427372,9848,116408,3.3849638829045747,0.21407186729927544
625,0.0626,24,332,24,249404,427040,9872,116384,3.3823343049043215,0.21416794252738194
626,0.0627,25,334,25,249738,426706,9897,116359,3.379688886072741,0.21426348595471997
627,0.0628,22,377,22,250115,426329,9919,116337,3.376702889367634,0.2143804844969097
628,0.0629,28,364,28,250479,425965,9947,116309,3.373819858066151,0.2144838218317677
629,0.063,33,341,33,250820,425624,9980,116276,3.371118996324927,0.21457095405056284
630,0.0631,26,352,26,251172,425272,10006,116250,3.3683310100114054,0.21467271874457547
631,0.0632,21,372,21,251544,424900,10027,116229,3.3653846153846154,0.21478981906347655
632,0.0633,18,407,18,251951,424493,10045,116211,3.3621610062096057,0.21492535657217257
633,0.0634,21,382,21,252333,424111,10066,116190,3.359135407426182,0.2150467979885286
634,0.0635,24,362,24,252695,423749,10090,116166,3.356268216956026,0.21515608938444014
635,0.0636,20,362,20,253057,423387,10110,116146,3.35340102648587,0.21527135504223097
636,0.0637,28,412,28,253469,422975,10138,116118,3.3501378152325434,0.21539511735451952
637,0.0638,25,398,25,253867,422577,10163,116093,3.3469854897985045,0.21551784951825792
638,0.0639,29,359,29,254226,422218,10192,116064,3.344142060575339,0.2156193222140068
639,0.064,27,365,27,254591,421853,10219,116037,3.341251108858193,0.21572626373422074
640,0.0641,31,350,31,254941,421503,10250,116006,3.338478963375998,0.21582150252367868
641,0.0642,15,388,15,255329,421115,10265,115991,3.3354058420985933,0.2159555097131665
642,0.0643,25,354,25,255683,420761,10290,115966,3.332602014953745,0.21606142415045265
643,0.0644,27,360,27,256043,420401,10317,115939,3.329750665314916,0.21616698362978706
644,0.0645,33,353,33,256396,420048,10350,115906,3.3269547585857304,0.216261097034447
645,0.0646,30,362,30,256758,419686,10380,115876,3.3240875681155746,0.2163633715610891
646,0.0647,25,378,25,257136,419308,10405,115851,3.321093650994804,0.21647958830926883
647,0.0648,25,351,25,257487,418957,10430,115826,3.318313585096946,0.2165850447751705
648,0.0649,31,325,31,257812,418632,10461,115795,3.3157394500063364,0.21667131338798376
649,0.065,37,343,37,258155,418289,10498,115758,3.313022747433785,0.21675620310571916
650,0.0651,29,353,29,258508,417936,10527,115729,3.3102268407046003,0.2168570170425267
651,0.0652,22,366,22,258874,417570,10549,115707,3.3073279685717907,0.21697354283046147
652,0.0653,28,357,28,259231,417213,10577,115679,3.304500380179952,0.21707775684378824
653,0.0654,29,341,29,259572,416872,10606,115650,3.301799518438728,0.21717412613938955
654,0.0655,25,349,25,259921,416523,10631,115625,3.2990352933721963,0.2172797793095154
655,0.0656,24,379,24,260300,416144,10655,115601,3.2960334558357625,0.21739931734195903
656,0.0657,32,345,32,260645,415799,10687,115569,3.2933009124318846,0.21749333795034703
657,0.0658,35,342,35,260987,415457,10722,115534,3.2905921302749968,0.21758184225344684
658,0.0659,31,350,31,261337,415107,10753,115503,3.287819984792802,0.21767965172160345
659,0.066,29,347,29,261684,414760,10782,115474,3.2850716005575973,0.21777932007377876
660,0.0661,26,307,26,261991,414453,10808,115448,3.282640032948929,0.21786711102639927
661,0.0662,16,347,16,262338,414106,10824,115432,3.2798916487137246,0.21798624461322888
662,0.0663,30,372,30,262710,413734,10854,115402,3.2769452540869346,0.21809515890054731
663,0.0664,22,340,22,263050,413394,10876,115380,3.274252312761374,0.21820286171407824
664,0.0665,20,360,20,263410,413034,10896,115360,3.2714009631225447,0.21832193401136274
665,0.0666,39,379,39,263789,412655,10935,115321,3.268399125586111,0.2184209130718063
666,0.0667,26,358,26,264147,412297,10961,115295,3.2655636167786084,0.21853060698418475
667,0.0668,30,375,30,264522,411922,10991,115265,3.2625934609048284,0.21864158258834152
668,0.0669,29,356,29,264878,411566,11020,115236,3.259773792928653,0.21874632214760004
669,0.067,30,315,30,265193,411251,11050,115206,3.2572788619946773,0.2188326871900269
670,0.0671,28,353,28,265546,410898,11078,115178,3.2544829552654924,0.21893794812916764
671,0.0672,26,366,26,265912,410532,11104,115152,3.2515840831326828,0.2190517497203643
672,0.0673,25,340,25,266252,410192,11129,115127,3.248891141807122,0.2191563602306408
673,0.0674,34,341,34,266593,409851,11163,115093,3.246190280065898,0.2192481483739218
674,0.0675,29,351,29,266944,409500,11192,115064,3.2434102141680397,0.219351690165547
675,0.0676,24,376,24,267320,409124,11216,115040,3.240432137878596,0.21947329461771506
676,0.0677,26,366,26,267686,408758,11242,115014,3.2375332657457863,0.21958791229771732
677,0.0678,35,368,35,268054,408390,11277,114979,3.23461855278165,0.21969012302983174
678,0.0679,35,356,35,268410,408034,11312,114944,3.2317988848054746,0.21978744803796718
679,0.068,33,320,33,268730,407714,11345,114911,3.2292643517931823,0.21987275771346568
680,0.0681,26,342,26,269072,407372,11371,114885,3.2265555696362944,0.21997790359918584
681,0.0682,25,358,25,269430,407014,11396,114860,3.2237200608287924,0.22009143969617187
682,0.0683,34,361,34,269791,406653,11430,114826,3.2208607907743,0.2201929512022536
683,0.0684,21,356,21,270147,406297,11451,114805,3.2180411227981245,0.22031195428150344
684,0.0685,40,365,40,270512,405932,11491,114765,3.2151501710809782,0.2204064936037657
685,0.0686,20,360,20,270872,405572,11511,114745,3.212298821442149,0.22052902365288854
686,0.0687,41,345,41,271217,405227,11552,114704,3.2095662780382717,0.22061388915067576
687,0.0688,30,369,30,271586,404858,11582,114674,3.2066436446584716,0.22072557609540894
688,0.0689,28,381,28,271967,404477,11610,114646,3.2036259662907107,0.22084554142274568
689,0.069,43,325,43,272292,404152,11653,114603,3.2010518312001013,0.22091931644032348
690,0.0691,22,356,22,272648,403796,11675,114581,3.198232163223926,0.22103797043464504
691,0.0692,31,335,31,272983,403461,11706,114550,3.1955788239766822,0.22113430023686756
692,0.0693,39,354,39,273337,403107,11745,114511,3.1927749968318335,0.22122685068911824
693,0.0694,34,316,34,273653,402791,11779,114477,3.190272145482195,0.22131080987031868
694,0.0695,30,370,30,274023,402421,11809,114447,3.1873415916867316,0.22142403863268764
695,0.0696,30,358,30,274381,402063,11839,114417,3.1845060828792295,0.22153229553903345
696,0.0697,33,343,33,274724,401720,11872,114384,3.1817893803066783,0.2216297490428286
697,0.0698,31,350,31,275074,401370,11903,114353,3.1790172348244834,0.2217333723723782
698,0.0699,36,312,36,275386,401058,11939,114317,3.1765460651374986,0.2218132427843803
699,0.07,25,392,25,275778,400666,11964,114292,3.17344126219744,0.2219443139052117
700,0.0701,35,357,35,276135,400309,11999,114257,3.1706136738056014,0.2220453741599717
701,0.0702,32,336,32,276471,399973,12031,114225,3.167952414142694,0.2221420542281378
702,0.0703,27,351,27,276822,399622,12058,114198,3.1651723482448357,0.2222529290412985
703,0.0704,23,358,23,277180,399264,12081,114175,3.1623368394373337,0.22237305697463575
704,0.0705,26,316,26,277496,398948,12107,114149,3.1598339880876947,0.22247060497332863
705,0.0706,25,350,25,277846,398598,12132,114124,3.1570618426055,0.22258455849368664
706,0.0707,30,321,30,278167,398277,12162,114094,3.154519389177544,0.2226784888293834
707,0.0708,30,319,30,278486,397958,12192,114064,3.151992776580915,0.2227716777794704
708,0.0709,23,388,23,278874,397570,12215,114041,3.1489196553035104,0.2229056842014734
709,0.071,32,320,32,279194,397250,12247,114009,3.146385122291218,0.22299656338568122
710,0.0711,26,363,26,279557,396887,12273,113983,3.1435100114053984,0.22311546968896195
711,0.0712,29,354,29,279911,396533,12302,113954,3.14070618426055,0.2232260566870459
712,0.0713,31,317,31,280228,396216,12333,113923,3.138195412495248,0.22331756638876854
713,0.0714,32,302,32,280530,395914,12365,113891,3.1358034469648968,0.22340110434381774
714,0.0715,28,346,28,280876,395568,12393,113863,3.1330629831453556,0.2235101515219922
715,0.0716,34,330,34,281206,395238,12427,113829,3.130449245976429,0.22360317993505766
716,0.0717,37,307,37,281513,394931,12464,113792,3.128017678367761,0.22368164993523
717,0.0718,27,326,27,281839,394605,12491,113765,3.1254356228614877,0.2237838582135059
718,0.0719,35,341,35,282180,394264,12526,113730,3.1227347611202636,0.22388059701492538
719,0.072,28,341,28,282521,393923,12554,113702,3.1200338993790395,0.22398818025116965
720,0.0721,34,319,34,282840,393604,12588,113668,3.1175072867824105,0.2240770237663423
721,0.0722,36,325,36,283165,393279,12624,113632,3.1149331516918006,0.22416558330752342
722,0.0723,25,323,25,283488,392956,12649,113607,3.112374857432518,0.22427022897448096
723,0.0724,31,314,31,283802,392642,12680,113576,3.109887846914206,0.22436183620495517
724,0.0725,29,338,29,284140,392304,12709,113547,3.1072107464199723,0.22446728384445222
725,0.0726,30,335,30,284475,391969,12739,113517,3.104557407172728,0.22457001776508154
726,0.0727,23,275,23,284750,391694,12762,113494,3.1023792928652894,0.22465695938937583
727,0.0728,28,325,28,285075,391369,12790,113466,3.09980515777468,0.22475858448800104
728,0.0729,29,306,29,285381,391063,12819,113437,3.0973815105816755,0.22485034687809713
729,0.073,26,340,26,285721,390723,12845,113411,3.0946885692561144,0.22496201406768834
730,0.0731,44,333,44,286054,390390,12889,113367,3.092051070840198,0.22504302669739576
731,0.0732,35,342,35,286396,390048,12924,113332,3.08934228868331,0.22514203981087846
732,0.0733,29,324,29,286720,389724,12953,113303,3.086776074008364,0.2252423826156449
733,0.0734,24,338,24,287058,389386,12977,113279,3.08409897351413,0.22535684800015915
734,0.0735,23,292,23,287350,389094,13000,113256,3.081786212140413,0.2254523738429382
735,0.0736,39,327,39,287677,388767,13039,113217,3.079196236218477,0.22553906100592847
736,0.0737,25,325,25,288002,388442,13064,113192,3.0766221011278674,0.22564658695383485
737,0.0738,25,304,25,288306,388138,13089,113167,3.0742142947661892,0.22574480605619335
738,0.0739,31,343,31,288649,387795,13120,113136,3.0714975921936385,0.22585146457296515
739,0.074,28,325,28,288974,387470,13148,113108,3.0689234571030286,0.2259547962555286
740,0.0741,30,331,30,289305,387139,13178,113078,3.0663017995184387,0.2260578908753601
741,0.0742,21,343,21,289648,386796,13199,113057,3.0635850969458875,0.22618049706613744
742,0.0743,31,317,31,289965,386479,13230,113026,3.0610743251805856,0.22627601325312058
743,0.0744,37,341,37,290306,386138,13267,112989,3.058373463439361,0.22637324769046754
744,0.0745,34,319,34,290625,385819,13301,112955,3.055846850842732,0.22646529289818634
745,0.0746,30,332,30,290957,385487,13331,112925,3.053217272842479,0.22656958500196625
746,0.0747,29,320,29,291277,385167,13360,112896,3.050682739830186,0.22667012004505455
747,0.0748,22,313,22,291590,384854,13382,112874,3.0482036497275375,0.22677848141957052
748,0.0749,23,331,23,291921,384523,13405,112851,3.0455819921429477,0.22689364542577617
749,0.075,29,325,29,292246,384198,13434,112822,3.0430078570523382,0.2269969015331375
750,0.0751,35,336,35,292582,383862,13469,112787,3.040346597389431,0.22709599737440325
751,0.0752,30,326,30,292908,383536,13499,112757,3.037764541883158,0.22719844930313343
752,0.0753,23,328,23,293236,383208,13522,112734,3.035166645545558,0.2273128712631719
753,0.0754,26,342,26,293578,382866,13548,112708,3.0324578633886707,0.22742920330767957
754,0.0755,29,328,29,293906,382538,13577,112679,3.029859967051071,0.22753459594480804
755,0.0756,27,320,27,294226,382218,13604,112652,3.0273254340387785,0.22763958211247398
756,0.0757,22,328,22,294554,381890,13626,112630,3.0247275377011786,0.2277562080401197
757,0.0758,30,337,30,294891,381553,13656,112600,3.022058357622608,0.22786464920783644
758,0.0759,25,338,25,295229,381215,13681,112575,3.0193812571283742,0.22798153061017842
759,0.076,30,343,30,295572,380872,13711,112545,3.016664554555823,0.2280930734044429
760,0.0761,20,325,20,295897,380547,13731,112525,3.0140904194652136,0.228212106953954
761,0.0762,20,299,20,296196,380248,13751,112505,3.0117222151818526,0.22831925934494565
762,0.0763,27,335,27,296531,379913,13778,112478,3.009068875934609,0.2284322824747
763,0.0764,40,325,40,296856,379588,13818,112438,3.0064947408439995,0.22852044404157504
764,0.0765,30,314,30,297170,379274,13848,112408,3.0040077303256876,0.22861931085539028
765,0.0766,30,326,30,297496,378948,13878,112378,3.0014256748194144,0.22872390225634304
766,0.0767,32,315,32,297811,378633,13910,112346,2.998930743885439,0.22882037724627732
767,0.0768,30,316,30,298127,378317,13940,112316,2.9964278925358,0.228920598492152
768,0.0769,26,331,26,298458,377986,13966,112290,2.9938062349512102,0.2290342582545342
769,0.077,37,361,37,298819,377625,14003,112253,2.9909469648967177,0.22914480748267937
770,0.0771,24,311,24,299130,377314,14027,112229,2.988483715625396,0.2292525886387917
771,0.0772,34,307,34,299437,377007,14061,112195,2.986052148016728,0.2293428890315248
772,0.0773,36,307,36,299744,376700,14097,112159,2.98362058040806,0.22943016288950394
773,0.0774,25,311,25,300055,376389,14122,112134,2.981157331136738,0.229536787418402
774,0.0775,27,326,27,300381,376063,14149,112107,2.978575275630465,0.22964745887703053
775,0.0776,31,318,31,300699,375745,14180,112076,2.9760565834494996,0.22974820682176453
776,0.0777,31,310,31,301009,375435,14211,112045,2.973601254593841,0.22984532698777385
777,0.0778,25,305,25,301314,375130,14236,112020,2.9711855278165,0.22994970748229498
778,0.0779,23,320,23,301634,374810,14259,111997,2.9686509948042072,0.230064481406389
779,0.078,25,333,25,301967,374477,14284,111972,2.9660134963882903,0.23018240349964744
780,0.0781,34,307,34,302274,374170,14318,111938,2.9635819287796226,0.2302739308960149
781,0.0782,37,318,37,302592,373852,14355,111901,2.961063236598657,0.2303660502354077
782,0.0783,36,295,36,302887,373557,14391,111865,2.9587267139779496,0.23044897017440494
783,0.0784,27,308,27,303195,373249,14418,111838,2.956287225953618,0.2305524576003892
784,0.0785,37,310,37,303505,372939,14455,111801,2.9538318970979596,0.23064116846144325
785,0.0786,39,298,39,303803,372641,14494,111762,2.9514716132302623,0.23072111444396504
786,0.0787,33,329,33,304132,372312,14527,111729,2.948865796476999,0.23082548792354365
787,0.0788,37,309,37,304441,372003,14564,111692,2.9464183880370043,0.23091410909767518
788,0.0789,37,359,37,304800,371644,14601,111655,2.9435749588138385,0.2310267556936803
789,0.079,31,327,31,305127,371317,14632,111624,2.9409849828919024,0.23113382380042283
790,0.0791,27,311,27,305438,371006,14659,111597,2.9385217336205804,0.2312397560727969
791,0.0792,32,288,32,305726,370718,14691,111565,2.9362406539095174,0.23132683507401255
792,0.0793,20,323,20,306049,370395,14711,111545,2.9336823596502346,0.23144997302568784
793,0.0794,33,314,33,306363,370081,14744,111512,2.9311953491319223,0.23154821602473458
794,0.0795,37,304,37,306667,369777,14781,111475,2.9287875427702446,0.23163540099573612
795,0.0796,36,319,36,306986,369458,14817,111439,2.9262609301736155,0.23173153502725116
796,0.0797,25,309,25,307295,369149,14842,111414,2.9238135217336207,0.2318405703310492
797,0.0798,34,312,34,307607,368837,14876,111380,2.9213423520466355,0.23193681189962037
798,0.0799,31,333,31,307940,368504,14907,111349,2.9187048536307185,0.23204814807868243
799,0.08,23,319,23,308259,368185,14930,111326,2.9161782410340895,0.23216568545872773
800,0.0801,20,329,20,308588,367856,14950,111306,2.9135724242808263,0.23229304494095943
801,0.0802,37,287,37,308875,367569,14987,111269,2.9112992649854266,0.23237295285670728
802,0.0803,31,313,31,309188,367256,15018,111238,2.908820174882778,0.2324752243497306
803,0.0804,37,337,37,309525,366919,15055,111201,2.9061509948042072,0.23257968710783902
804,0.0805,28,314,28,309839,366605,15083,111173,2.9036639842858953,0.23268756619182968
805,0.0806,29,313,29,310152,366292,15112,111144,2.9011848941832468,0.23279350530751766
806,0.0807,20,309,20,310461,365983,15132,111124,2.898737485743252,0.2329121140540801
807,0.0808,34,310,34,310771,365673,15166,111090,2.8962821568875934,0.23300885345549047
808,0.0809,23,311,23,311082,365362,15189,111067,2.893818907616272,0.23312392822435243
809,0.081,26,329,26,311411,365033,15215,111041,2.8912130908630087,0.23324315127480183
810,0.0811,35,296,35,311707,364737,15250,111006,2.888868647826638,0.23333186195067504
811,0.0812,34,349,34,312056,364388,15284,110972,2.8861044227601065,0.2334483338943117
812,0.0813,32,315,32,312371,364073,15316,110940,2.8836094918261312,0.23355150280097597
813,0.0814,29,304,29,312675,363769,15345,110911,2.881201685464453,0.23365425128507628
814,0.0815,32,317,32,312992,363452,15377,110879,2.8786909136991508,0.2337587043646736
815,0.0816,30,296,30,313288,363156,15407,110849,2.8763464706627806,0.23385618295165664
816,0.0817,29,297,29,313585,362859,15436,110820,2.873994107210746,0.23395590684830866
817,0.0818,37,297,37,313882,362562,15473,110783,2.8716417437587123,0.23404282288816824
818,0.0819,31,306,31,314188,362256,15504,110752,2.869218096565708,0.2341440313905896
819,0.082,30,318,30,314506,361938,15534,110722,2.8666994043847422,0.23425295138154276
820,0.0821,20,331,20,314837,361607,15554,110702,2.864077746800152,0.2343846930716967
821,0.0822,27,295,27,315132,361312,15581,110675,2.861741224179445,0.23448739054253612
822,0.0823,30,296,30,315428,361016,15611,110645,2.8593967811430745,0.2345858572152457
823,0.0824,33,323,33,315751,360693,15644,110612,2.8568384868837917,0.23469303317384707
824,0.0825,25,296,25,316047,360397,15669,110587,2.854494043847421,0.23479990827713892
825,0.0826,24,292,24,316339,360105,15693,110563,2.8521812824737043,0.23490655833836166
826,0.0827,31,280,31,316619,359825,15724,110532,2.8499635660879483,0.23499597114532153
827,0.0828,31,298,31,316917,359527,15755,110501,2.847603282220251,0.23509450500821227
828,0.0829,37,293,37,317210,359234,15792,110464,2.8452826004308704,0.23518090347414722
829,0.083,31,329,31,317539,358905,15823,110433,2.8426767836776072,0.23529524564386434
830,0.0831,44,309,44,317848,358596,15867,110389,2.8402293752376124,0.23537853023017793
831,0.0832,34,316,34,318164,358280,15901,110355,2.837726523887974,0.2354817715279482
832,0.0833,35,308,35,318472,357972,15936,110320,2.835287035863642,0.23557951022011908
833,0.0834,18,287,18,318759,357685,15954,110302,2.833013876568242,0.23569458125973586
834,0.0835,24,302,24,319061,357383,15978,110278,2.830621911037891,0.23580756146011747
835,0.0836,23,293,23,319354,357090,16001,110255,2.828301229248511,0.23591779092533352
836,0.0837,28,315,28,319669,356775,16029,110227,2.8258062983145353,0.23603110907447933
837,0.0838,21,304,21,319973,356471,16050,110206,2.8233984919528576,0.23615048523925541
838,0.0839,32,259,32,320232,356212,16082,110174,2.8213471042960334,0.23622921785816897
839,0.084,41,294,41,320526,355918,16123,110133,2.81901850209099,0.23631104750338483
840,0.0841,34,323,34,320849,355595,16157,110099,2.816460207831707,0.23641919371948103
841,0.0842,36,317,36,321166,355278,16193,110063,2.813949436066405,0.23652117479439808
842,0.0843,31,323,31,321489,354955,16224,110032,2.811391141807122,0.23663457257944845
843,0.0844,30,310,30,321799,354645,16254,110002,2.808935812951464,0.23674316201331333
844,0.0845,37,302,37,322101,354343,16291,109965,2.806543847421113,0.23683632416413242
845,0.0846,29,298,29,322399,354045,16320,109936,2.804183563553415,0.23694073679741195
846,0.0847,24,306,24,322705,353739,16344,109912,2.8017599163604108,0.2370576144557005
847,0.0848,35,278,35,322983,353461,16379,109877,2.7995580408059815,0.23714221583379735
848,0.0849,24,321,24,323304,353140,16403,109853,2.797015587378026,0.23726708611145308
849,0.085,33,310,33,323614,352830,16436,109820,2.7945602585223672,0.2373716632443532
850,0.0851,31,287,31,323901,352543,16467,109789,2.7922870992269675,0.2374678802246005
851,0.0852,37,275,37,324176,352268,16504,109752,2.7901089849195286,0.23754815808839444
852,0.0853,25,309,25,324485,351959,16529,109727,2.787661576479534,0.23766585948025282
853,0.0854,26,309,26,324794,351650,16555,109701,2.7852141680395386,0.23778207915448324
854,0.0855,33,259,33,325053,351391,16588,109668,2.7831627803827144,0.23786109803734445
855,0.0856,24,326,24,325379,351065,16612,109644,2.7805807248764416,0.2379897071687334
856,0.0857,30,301,30,325680,350764,16642,109614,2.778196679761754,0.23809565183392778
857,0.0858,28,291,28,325971,350473,16670,109586,2.7758918388037004,0.23819988305847728
858,0.0859,24,283,24,326254,350190,16694,109562,2.7736503611709544,0.23830673928552784
859,0.086,22,274,22,326528,349916,16716,109540,2.771480167279179,0.2384123833402981
860,0.0861,24,296,24,326824,349620,16740,109516,2.7691357242428083,0.23852627543908558
861,0.0862,32,316,32,327140,349304,16772,109484,2.7666328728931693,0.2386374534643452
862,0.0863,26,298,26,327438,349006,16798,109458,2.764272589025472,0.2387493892650241
863,0.0864,30,267,30,327705,348739,16828,109428,2.7621578380433407,0.23883867672704495
864,0.0865,32,324,32,328029,348415,16860,109396,2.7595916233683946,0.23895450305912266
865,0.0866,46,330,46,328359,348085,16906,109350,2.7569778861994676,0.23905035688130555
866,0.0867,22,299,22,328658,347786,16928,109328,2.754609681916107,0.23917009761241179
867,0.0868,26,268,26,328926,347518,16954,109302,2.752487010518312,0.23926710739459744
868,0.0869,35,289,35,329215,347229,16989,109267,2.7501980103915855,0.2393602572640286
869,0.087,28,295,28,329510,346934,17017,109239,2.7478614877708782,0.23946835959164614
870,0.0871,32,315,32,329825,346619,17049,109207,2.745366556836903,0.23958045394514574
871,0.0872,36,291,36,330116,346328,17085,109171,2.7430617158788495,0.2396734131139695
872,0.0873,30,258,30,330374,346070,17115,109141,2.7410182486376886,0.23975914466038825
873,0.0874,29,285,29,330659,345785,17144,109112,2.7387609301736155,0.23986089158644705
874,0.0875,33,305,33,330964,345480,17177,109079,2.736345203396274,0.23996664899385997
875,0.0876,32,301,32,331265,345179,17209,109047,2.733961158281587,0.240072122687825
876,0.0877,36,288,36,331553,344891,17245,109011,2.7316800785705233,0.24016417640812335
877,0.0878,22,272,22,331825,344619,17267,108989,2.729525725510075,0.24027133560254668
878,0.0879,39,312,39,332137,344307,17306,108950,2.7270545558230896,0.24037135664755316
879,0.088,31,295,31,332432,344012,17337,108919,2.7247180332023824,0.24047592238111323
880,0.0881,35,278,35,332710,343734,17372,108884,2.7225161576479535,0.24056489136534562
881,0.0882,42,276,42,332986,343458,17414,108842,2.720330122924851,0.24064116736679195
882,0.0883,26,287,26,333273,343171,17440,108816,2.718056963629451,0.24075028706577845
883,0.0884,51,274,51,333547,342897,17491,108765,2.7158867697376756,0.24081060616124447
884,0.0885,26,306,26,333853,342591,17517,108739,2.7134631225446713,0.24093013980900893
885,0.0886,34,301,34,334154,342290,17551,108705,2.7110790774299836,0.24103371434273108
886,0.0887,35,262,35,334416,342028,17586,108670,2.709003928526169,0.24111489289945817
887,0.0888,33,271,33,334687,341757,17619,108637,2.706857495881384,0.24120436773136408
888,0.0889,24,274,24,334961,341483,17643,108613,2.7046873019896083,0.24131074259713484
889,0.089,29,293,29,335254,341190,17672,108584,2.702366620200228,0.24141902377638547
890,0.0891,18,306,18,335560,340884,17690,108566,2.6999429730072233,0.24155300923350762
891,0.0892,22,280,22,335840,340604,17712,108544,2.6977252566214673,0.2416664440229056
892,0.0893,41,268,41,336108,340336,17753,108503,2.6956025852236727,0.2417414707723705
893,0.0894,38,282,38,336390,340054,17791,108465,2.6933690280065896,0.24182922016681568
894,0.0895,31,303,31,336693,339751,17822,108434,2.6909691420605752,0.2419402702009215
895,0.0896,29,318,29,337011,339433,17851,108405,2.6884504498796096,0.2420629781304847
896,0.0897,28,273,28,337284,339160,17879,108377,2.686288176403498,0.24216321778981403
897,0.0898,28,312,28,337596,338848,17907,108349,2.6838170067165126,0.24228472015688834
898,0.0899,32,296,32,337892,338552,17939,108317,2.681472563680142,0.24239094678753728
899,0.09,37,265,37,338157,338287,17976,108280,2.6793736535293373,0.24247201427781273
900,0.0901,32,284,32,338441,338003,18008,108248,2.6771242554809276,0.24257200544088417
901,0.0902,24,287,24,338728,337716,18032,108224,2.674851096185528,0.24268735704354846
902,0.0903,30,305,30,339033,337411,18062,108194,2.6724353694081864,0.24280248201882834
903,0.0904,26,272,26,339305,337139,18088,108168,2.670281016347738,0.24290657905669572
904,0.0905,29,290,29,339595,336849,18117,108139,2.667984095805348,0.24301554199214362
905,0.0906,36,283,36,339878,336566,18153,108103,2.665742618172602,0.2431089192185648
906,0.0907,28,306,28,340184,336260,18181,108075,2.663318970979597,0.2432286450538445
907,0.0908,24,290,24,340474,335970,18205,108051,2.661022050437207,0.2433465984716939
908,0.0909,34,300,34,340774,335670,18239,108017,2.658645925738183,0.24345315503947604
909,0.091,38,302,38,341076,335368,18277,107979,2.656253960207832,0.24355414607519618
910,0.0911,41,273,41,341349,335095,18318,107938,2.6540916867317197,0.2436342213785429
911,0.0912,35,269,35,341618,334826,18353,107903,2.6519610949182613,0.24372245775632498
912,0.0913,32,289,32,341907,334537,18385,107871,2.649672094791535,0.24382696515433716
913,0.0914,28,271,28,342178,334266,18413,107843,2.6475256621467493,0.24392853346120527
914,0.0915,31,282,31,342460,333984,18444,107812,2.6452921049296667,0.2440311818124202
915,0.0916,28,275,28,342735,333709,18472,107784,2.643113990622228,0.24413524110235044
916,0.0917,25,282,25,343017,333427,18497,107759,2.6408804334051452,0.2442484575666499
917,0.0918,30,291,30,343308,333136,18527,107729,2.6385755924470917,0.2443582502580155
918,0.0919,33,285,33,343593,332851,18560,107696,2.6363182739830187,0.24445972847391992
919,0.092,27,265,27,343858,332586,18587,107669,2.634219363832214,0.24456053877866238
920,0.0921,30,287,30,344145,332299,18617,107639,2.6319462045368143,0.24466856693443167
921,0.0922,35,274,35,344419,332025,18652,107604,2.6297760106450387,0.24476092341497035
922,0.0923,32,296,32,344715,331729,18684,107572,2.627431567608668,0.24487082888497863
923,0.0924,26,301,26,345016,331428,18710,107546,2.6250475224939804,0.24499400875678287
924,0.0925,36,296,36,345312,331132,18746,107510,2.62270307945761,0.245097368697024
925,0.0926,36,278,36,345590,330854,18782,107474,2.620501203903181,0.24519081600992865
926,0.0927,31,288,31,345878,330566,18813,107443,2.6182201241921175,0.24529861258558613
927,0.0928,32,294,32,346172,330272,18845,107411,2.615891521987074,0.24540820639595323
928,0.0929,35,287,35,346459,329985,18880,107376,2.6136183626916742,0.24550885881457193
929,0.093,33,274,33,346733,329711,18913,107343,2.6114481687998987,0.24560580614752411
930,0.0931,26,262,26,346995,329449,18939,107317,2.609373019896084,0.24570822820457636
931,0.0932,28,263,28,347258,329186,18967,107289,2.607289950576606,0.24580789277736412
932,0.0933,25,260,25,347518,328926,18992,107264,2.6052306425041185,0.24591118549256058
933,0.0934,26,255,26,347773,328671,19018,107238,2.603210936509948,0.24601006173306814
934,0.0935,36,279,36,348052,328392,19054,107202,2.6010011405398554,0.2461053182550724
935,0.0936,33,248,33,348300,328144,19087,107169,2.5990368774553287,0.24618837480157954
936,0.0937,23,304,23,348604,327840,19110,107146,2.596629071093651,0.24632057123677545
937,0.0938,30,274,30,348878,327566,19140,107116,2.5944588772018755,0.24642382247252015
938,0.0939,29,263,29,349141,327303,19169,107087,2.5923758078823975,0.24652271000713644
939,0.094,27,312,27,349453,326991,19196,107060,2.5899046381954123,0.24665304307558328
940,0.0941,34,258,34,349711,326733,19230,107026,2.587861170954252,0.24674070163385659
941,0.0942,28,244,28,349955,326489,19258,106998,2.5859285895323785,0.24683093149275526
942,0.0943,34,298,34,350253,326191,19292,106964,2.583568305664681,0.24694162597684433
943,0.0944,36,286,36,350539,325905,19328,106928,2.581303066784945,0.24704216175753696
944,0.0945,35,286,35,350825,325619,19363,106893,2.5790378279052084,0.24714458789582716
945,0.0946,28,260,28,351085,325359,19391,106865,2.576978519832721,0.24724448434145258
946,0.0947,34,299,34,351384,325060,19425,106831,2.57461031554936,0.24735639316401592
947,0.0948,41,299,41,351683,324761,19466,106790,2.572242111265999,0.24745626820468497
948,0.0949,19,263,19,351946,324498,19485,106771,2.5701590419465212,0.247574019927238
949,0.095,38,268,38,352214,324230,19523,106733,2.5680363705487266,0.2476616322050849
950,0.0951,29,289,29,352503,323941,19552,106704,2.5657473704219997,0.24777717145212413
951,0.0952,34,271,34,352774,323670,19586,106670,2.5636009377772147,0.24787377422503137
952,0.0953,39,282,39,353056,323388,19625,106631,2.5613673805601316,0.2479681130368658
953,0.0954,26,285,26,353341,323103,19651,106605,2.559110062096059,0.24808707308218605
954,0.0955,30,278,30,353619,322825,19681,106575,2.5569081865416297,0.2481951560316721
955,0.0956,35,284,35,353903,322541,19716,106540,2.55465878849322,0.24829810688424797
956,0.0957,24,284,24,354187,322257,19740,106516,2.5524093904448106,0.2484204928948418
957,0.0958,38,277,38,354464,321980,19778,106478,2.5502154353060447,0.24851444015516105
958,0.0959,25,265,25,354729,321715,19803,106453,2.54811652515524,0.24862437174193308
959,0.096,28,254,28,354983,321461,19831,106425,2.546104739576733,0.24872279064984598
960,0.0961,28,261,28,355244,321200,19859,106397,2.544037511088582,0.24882541271337263
961,0.0962,29,283,29,355527,320917,19888,106368,2.5417960334558356,0.24893923259651052
962,0.0963,31,228,31,355755,320689,19919,106337,2.5399901786845773,0.24901762421960255
963,0.0964,20,251,20,356006,320438,19939,106317,2.5380021543530606,0.2491288912842263
964,0.0965,26,277,26,356283,320161,19965,106291,2.5358081992142947,0.24924493260671776
965,0.0966,37,237,37,356520,319924,20002,106254,2.5339310607020655,0.24931835993411203
966,0.0967,30,273,30,356793,319651,20032,106224,2.5317687872259538,0.24942530085118872
967,0.0968,24,246,24,357039,319405,20056,106200,2.5298203649727538,0.24952714371306728
968,0.0969,32,272,32,357311,319133,20088,106168,2.5276660119123053,0.2496302618615992
969,0.097,35,271,35,357582,318862,20123,106133,2.52551957926752,0.24972764385463359
970,0.0971,30,277,30,357859,318585,20153,106103,2.5233256241287543,0.24983752778510343
971,0.0972,29,253,29,358112,318332,20182,106074,2.5213217589659105,0.24993520355508642
972,0.0973,46,243,46,358355,318089,20228,106028,2.519397097959701,0.2499970527000804
973,0.0974,26,279,26,358634,317810,20254,106002,2.5171873019896083,0.25011561730201126
974,0.0975,32,260,32,358894,317550,20286,105970,2.5151279939171207,0.25021250472232714
975,0.0976,29,247,29,359141,317303,20315,105941,2.5131716512482574,0.25030715143038057
976,0.0977,26,260,26,359401,317043,20341,105915,2.51111234317577,0.2504149348162229
977,0.0978,38,290,38,359691,316753,20379,105877,2.5088154226333796,0.2505193668220429
978,0.0979,33,247,33,359938,316506,20412,105844,2.5068590799645167,0.2506073162069374
979,0.098,23,276,23,360214,316230,20435,105821,2.504673045241414,0.25073036197047277
980,0.0981,25,266,25,360480,315964,20460,105796,2.502566214674946,0.25084408194233687
981,0.0982,36,250,36,360730,315714,20496,105760,2.5005861107590928,0.2509288829204174
982,0.0983,31,247,31,360977,315467,20527,105729,2.4986297680902294,0.25102090238273866
983,0.0984,29,260,29,361237,315207,20556,105700,2.496570460017742,0.25112435763719776
984,0.0985,28,252,28,361489,314955,20584,105672,2.4945745152705614,0.2512249570284361
985,0.0986,35,230,35,361719,314725,20619,105637,2.492752819667976,0.25130006993971865
986,0.0987,37,265,37,361984,314460,20656,105600,2.4906539095171714,0.2513926581916869
987,0.0988,29,255,29,362239,314205,20685,105571,2.488634203523001,0.2514936537581948
988,0.0989,27,274,27,362513,313931,20712,105544,2.4864640096312254,0.25160975028309196
989,0.099,31,246,31,362759,313685,20743,105513,2.484515587378026,0.25170205964723114
990,0.0991,37,271,37,363030,313414,20780,105476,2.4823691547332403,0.25179880159469076
991,0.0992,39,251,39,363281,313163,20819,105437,2.4803811304017236,0.2518800764452938
992,0.0993,27,257,27,363538,312906,20846,105410,2.478345583576226,0.25198653649394237
993,0.0994,37,266,37,363804,312640,20883,105373,2.476238753009758,0.2520806769167466
994,0.0995,39,274,39,364078,312366,20922,105334,2.4740685591179825,0.25217620301651905
995,0.0996,29,251,29,364329,312115,20951,105305,2.4720805347864654,0.2522758851995592
996,0.0997,39,259,39,364588,311856,20990,105266,2.470029147129641,0.25236261813090655
997,0.0998,29,268,29,364856,311588,21019,105237,2.4679064757318465,0.252472860313081
998,0.0999,29,264,29,365120,311324,21048,105208,2.465815485996705,0.2525808341255894
999,0.1,33,263,33,365383,311061,21081,105175,2.463732416677227,0.2526811712586129
1000,0.1001,37,247,37,365630,310814,21118,105138,2.461776074008364,0.25276474208562527
1001,0.1002,36,251,36,365881,310563,21154,105102,2.459788049676847,0.25285265778932553
1002,0.1003,32,257,32,366138,310306,21186,105070,2.4577525028513496,0.2529515426986634
1003,0.1004,34,272,34,366410,310034,21220,105036,2.455598149790901,0.25305611101741876
1004,0.1005,19,253,19,366663,309781,21239,105017,2.4535942846280574,0.2531762448227812
1005,0.1006,26,279,26,366942,309502,21265,104991,2.4513844886579648,0.25329981447213823
1006,0.1007,41,262,41,367204,309240,21306,104950,2.44930933975415,0.2533861271397185
1007,0.1008,22,289,22,367493,308951,21328,104928,2.4470203396274237,0.2535233727732018
1008,0.1009,38,248,38,367741,308703,21366,104890,2.445056076542897,0.2536068066916026
1009,0.101,34,271,34,368012,308432,21400,104856,2.442909643898112,0.2537116974119742
1010,0.1011,25,237,25,368249,308195,21425,104831,2.441032505385883,0.25381210868080945
1011,0.1012,25,257,25,368506,307938,21450,104806,2.4389969585603852,0.2539249510592522
1012,0.1013,30,245,30,368751,307693,21480,104776,2.437056456722849,0.2540215143441083
1013,0.1014,27,274,27,369025,307419,21507,104749,2.4348862628310735,0.25414151511034333
1014,0.1015,41,231,41,369256,307188,21548,104708,2.4330566468128247,0.2542098005321732
1015,0.1016,24,261,24,369517,306927,21572,104684,2.430989418324674,0.25432750825415257
1016,0.1017,38,253,38,369770,306674,21610,104646,2.42898555316183,0.2544150539725761
1017,0.1018,36,252,36,370022,306422,21646,104610,2.4269896084146496,0.2545057319138169
1018,0.1019,34,248,34,370270,306174,21680,104576,2.425025345330123,0.2545976871576385
1019,0.102,37,260,37,370530,305914,21717,104539,2.4229660372576354,0.2546917673887144
1020,0.1021,35,255,35,370785,305659,21752,104504,2.420946331263465,0.25478651170388356
1021,0.1022,23,243,23,371028,305416,21775,104481,2.419021670257255,0.2548957421010644
1022,0.1023,26,238,26,371266,305178,21801,104455,2.4171366113293624,0.2549965456884577
1023,0.1024,29,259,29,371525,304919,21830,104426,2.415085223672538,0.25510510693913446
1024,0.1025,31,228,31,371753,304691,21861,104395,2.41327936890128,0.2551908400678586
1025,0.1026,37,302,37,372055,304389,21898,104358,2.410887403370929,0.25531196559240804
1026,0.1027,32,241,32,372296,304148,21930,104326,2.408978583196046,0.25540426073630146
1027,0.1028,39,261,39,372557,303887,21969,104287,2.406911354707895,0.2554964304438793
1028,0.1029,33,243,33,372800,303644,22002,104254,2.4049866937016855,0.255588406905648
1029,0.103,30,248,30,373048,303396,22032,104224,2.403022430617159,0.25568912222167706
1030,0.1031,28,263,28,373311,303133,22060,104196,2.400939361297681,0.25580304864127035
1031,0.1032,29,266,29,373577,302867,22089,104167,2.398832530731213,0.25591719610646774
1032,0.1033,37,262,37,373839,302605,22126,104130,2.396757381827398,0.2560143582430821
1033,0.1034,38,233,38,374072,302372,22164,104092,2.394911924977823,0.25609156038419145
1034,0.1035,37,248,37,374320,302124,22201,104055,2.392947661893296,0.2561801570243661
1035,0.1036,34,245,34,374565,301879,22235,104021,2.39100716005576,0.25627248090662724
1036,0.1037,32,253,32,374818,301626,22267,103989,2.389003294892916,0.2563736548204578
1037,0.1038,34,261,34,375079,301365,22301,103955,2.3869360664047647,0.2564763643540906
1038,0.1039,27,275,27,375354,301090,22328,103928,2.384757952097326,0.25660094119273713
1039,0.104,31,252,31,375606,300838,22359,103897,2.382762007350146,0.25670376913288945
1040,0.1041,36,245,36,375851,300593,22395,103861,2.380821505512609,0.2567931087342442
1041,0.1042,32,244,32,376095,300349,22427,103829,2.3788889240907363,0.25688929135183014
1042,0.1043,27,245,27,376340,300104,22454,103802,2.3769484222532,0.2569954395329606
1043,0.1044,34,262,34,376602,299842,22488,103768,2.3748732733493854,0.257099675429251
1044,0.1045,36,241,36,376843,299601,22524,103732,2.3729644531745024,0.25718698941073503
1045,0.1046,30,252,30,377095,299349,22554,103702,2.3709685084273224,0.25729250144522653
1046,0.1047,32,282,32,377377,299067,22586,103670,2.3687349512102394,0.25741364711958425
1047,0.1048,30,260,30,377637,298807,22616,103640,2.366675643137752,0.2575245933004843
1048,0.1049,31,236,31,377873,298571,22647,103609,2.364806425041186,0.25761847928788106
1049,0.105,21,230,21,378103,298341,22668,103588,2.362984729438601,0.25772711100716794
1050,0.1051,32,280,32,378383,298061,22700,103556,2.360767013052845,0.2578476508713526
1051,0.1052,37,246,37,378629,297815,22737,103519,2.358818590799645,0.25793727917395487
1052,0.1053,28,246,28,378875,297569,22765,103491,2.3568701685464455,0.25804368423677254
1053,0.1054,24,223,24,379098,297346,22789,103467,2.355103915853504,0.2581428247087794
1054,0.1055,26,240,26,379338,297106,22815,103441,2.3532030160942847,0.25824934402204985
1055,0.1056,40,229,40,379567,296877,22855,103401,2.3513892409073627,0.25832296553895046
1056,0.1057,27,260,27,379827,296617,22882,103374,2.349329932834875,0.25844081491833565
1057,0.1058,28,270,28,380097,296347,22910,103346,2.3471914206057534,0.25856344744591475
1058,0.1059,27,229,27,380326,296118,22937,103319,2.3453776454188318,0.25866156615436225
1059,0.106,33,259,33,380585,295859,22970,103286,2.3433262577620075,0.25876811684976636
1060,0.1061,40,247,40,380832,295612,23010,103246,2.341369915093144,0.2588540282506556
1061,0.1062,31,265,31,381097,295347,23041,103215,2.3392710049423395,0.2589684917277613
1062,0.1063,37,263,37,381360,295084,23078,103178,2.3371879356228615,0.25907066202650514
1063,0.1064,33,225,33,381585,294859,23111,103145,2.3354058420985933,0.25915568687751883
1064,0.1065,35,244,35,381829,294615,23146,103110,2.3334732606767203,0.25924948142560816
1065,0.1066,28,240,28,382069,294375,23174,103082,2.3315723609175008,0.2593538420508382
1066,0.1067,37,223,37,382292,294152,23211,103045,2.3298061082245596,0.2594304589410293
1067,0.1068,39,216,39,382508,293936,23250,103006,2.328095298441262,0.25949886885237644
1068,0.1069,27,248,27,382756,293688,23277,102979,2.3261310353567355,0.25961070620949056
1069,0.107,24,234,24,382990,293454,23301,102955,2.324277658091497,0.25971912847589235
1070,0.1071,22,238,22,383228,293216,23323,102933,2.3223925991636043,0.2598340523388927
1071,0.1072,31,246,31,383474,292970,23354,102902,2.3204441769104043,0.2599375555735187
1072,0.1073,32,247,32,383721,292723,23386,102870,2.318487834241541,0.26003999059639576
1073,0.1074,34,236,34,383957,292487,23420,102836,2.316618616144975,0.26013158859970203
1074,0.1075,26,226,26,384183,292261,23446,102810,2.314828602205044,0.26023170518716887
1075,0.1076,25,268,25,384451,291993,23471,102785,2.312705930807249,0.26036151963888565
1076,0.1077,36,252,36,384703,291741,23507,102749,2.3107099860600684,0.2604603412000304
1077,0.1078,42,231,42,384934,291510,23549,102707,2.3088803700418197,0.26053417280330377
1078,0.1079,37,255,37,385189,291255,23586,102670,2.3068606640476492,0.2606333692961858
1079,0.108,35,224,35,385413,291031,23621,102635,2.3050864909390443,0.26071593686018096
1080,0.1081,41,235,41,385648,290796,23662,102594,2.3032251932581422,0.260794631281934
1081,0.1082,27,226,27,385874,290570,23689,102567,2.3014351793182106,0.2608937851181649
1082,0.1083,32,230,32,386104,290340,23721,102535,2.2996134837156252,0.2609863188036907
1083,0.1084,25,238,25,386342,290102,23746,102510,2.2977284247877328,0.26109747027599767
1084,0.1085,25,236,25,386578,289866,23771,102485,2.295859206691167,0.26120743925719575
1085,0.1086,24,239,24,386817,289627,23795,102461,2.293966227347611,0.2613214380445206
1086,0.1087,26,231,26,387048,289396,23821,102435,2.2921366113293624,0.2614264823354967
1087,0.1088,32,263,32,387311,289133,23853,102403,2.290053542009885,0.26154172285562505
1088,0.1089,33,259,33,387570,288874,23886,102370,2.2880021543530606,0.26165257486376786
1089,0.109,26,216,26,387786,288658,23912,102344,2.2862913445697632,0.2617480217492494
1090,0.1091,30,231,30,388017,288427,23942,102314,2.2844617285515145,0.2618460821874336
1091,0.1092,24,268,24,388285,288159,23966,102290,2.2823390571537194,0.261980437906103
1092,0.1093,33,234,33,388519,287925,23999,102257,2.2804856798884807,0.2620751341681574
1093,0.1094,33,243,33,388762,287682,24032,102224,2.278561018882271,0.262176011654091
1094,0.1095,30,243,30,389005,287439,24062,102194,2.2766363578760616,0.26228271219326904
1095,0.1096,30,234,30,389239,287205,24092,102164,2.2747829806108224,0.2623834974022072
1096,0.1097,32,257,32,389496,286948,24124,102132,2.272747433785325,0.262496144751722
1097,0.1098,29,250,29,389746,286698,24153,102103,2.2707673298694715,0.26260992127077865
1098,0.1099,29,257,29,390003,286441,24182,102074,2.268731783043974,0.2627285947775504
1099,0.11,31,204,31,390207,286237,24213,102043,2.267116018248638,0.2628077675903987
1100,0.1101,27,247,27,390454,285990,24240,102016,2.2651596755797745,0.2629237692200636
1101,0.1102,24,204,24,390658,285786,24264,101992,2.263543910784438,0.26301646818540503
1102,0.1103,19,222,19,390880,285564,24283,101973,2.26178557850716,0.26313100426539915
1103,0.1104,35,243,35,391123,285321,24318,101938,2.2598609175009505,0.26322951822940205
1104,0.1105,24,227,24,391350,285094,24342,101914,2.2580629831453556,0.2633382255663966
1105,0.1106,27,246,27,391596,284848,24369,101887,2.2561145608921556,0.2634543033343245
1106,0.1107,25,230,25,391826,284618,24394,101862,2.25429286528957,0.26356344442144486
1107,0.1108,22,244,22,392070,284374,24416,101840,2.2523602838676973,0.263688007167011
1108,0.1109,29,269,29,392339,284105,24445,101811,2.250229692054239,0.2638164781973279
1109,0.111,42,253,42,392592,283852,24487,101769,2.248225826891395,0.26390938252844115
1110,0.1111,32,244,32,392836,283608,24519,101737,2.246293245469522,0.26401536285666094
1111,0.1112,41,234,41,393070,283374,24560,101696,2.2444398682042834,0.26409743682966735
1112,0.1113,26,249,26,393319,283125,24586,101670,2.2424676847040934,0.2642186099091724
1113,0.1114,39,247,39,393566,282878,24625,101631,2.24051134203523,0.26431370917195696
1114,0.1115,30,253,30,393819,282625,24655,101601,2.2385074768723863,0.2644303092450797
1115,0.1116,26,216,26,394035,282409,24681,101575,2.236796667089089,0.2645292512188008
1116,0.1117,26,236,26,394271,282173,24707,101549,2.234927448992523,0.2646421106947217
1117,0.1118,24,220,24,394491,281953,24731,101525,2.233184957546572,0.26474791252692464
1118,0.1119,34,243,34,394734,281710,24765,101491,2.2312602965403623,0.2648505614546935
1119,0.112,34,274,34,395008,281436,24799,101457,2.229090102648587,0.26497481019501534
1120,0.1121,30,246,30,395254,281190,24829,101427,2.227141680395387,0.26508754184994393
1121,0.1122,25,251,25,395505,280939,24854,101402,2.22515365606387,0.2652135135912706
1122,0.1123,41,239,41,395744,280700,24895,101361,2.2232606767203142,0.2653005671869152
1123,0.1124,24,237,24,395981,280463,24919,101337,2.221383538208085,0.2654190675746464
1124,0.1125,36,232,36,396213,280231,24955,101301,2.219546001774173,0.2655111497856012
1125,0.1126,27,230,27,396443,280001,24982,101274,2.2177243061715877,0.26561930365221953
1126,0.1127,36,256,36,396699,279745,25018,101238,2.215696679761754,0.26572839208048654
1127,0.1128,37,216,37,396915,279529,25055,101201,2.2139858699784565,0.2658077902975862
1128,0.1129,27,239,27,397154,279290,25082,101174,2.2120928906349007,0.2659226628537785
1129,0.113,33,228,33,397382,279062,25115,101141,2.210287035863642,0.26601841647751334
1130,0.1131,47,205,47,397587,278857,25162,101094,2.208663350652642,0.2660711512800335
1131,0.1132,28,197,28,397784,278660,25190,101066,2.2071030287669497,0.266155069708158
1132,0.1133,26,239,26,398023,278421,25216,101040,2.205210049423394,0.2662724232529825
1133,0.1134,37,261,37,398284,278160,25253,101003,2.2031428209352426,0.26638411448374444
1134,0.1135,43,218,43,398502,277942,25296,100960,2.2014161703206185,0.2664541227019124
1135,0.1136,27,230,27,398732,277712,25323,100933,2.199594474718033,0.2665636678155
1136,0.1137,35,207,35,398939,277505,25358,100898,2.1979549486757066,0.26664164924696687
1137,0.1138,31,223,31,399162,277282,25389,100867,2.196188695982765,0.26673877228288323
1138,0.1139,34,237,34,399399,277045,25423,100833,2.194311557470536,0.2668400912463811
1139,0.114,41,235,41,399634,276810,25464,100792,2.192450259789634,0.26692655229580353
1140,0.1141,37,221,37,399855,276589,25501,100755,2.1906998479280193,0.26701100322252375
1141,0.1142,27,210,27,400065,276379,25528,100728,2.1890365606387023,0.2671072136025054
1142,0.1143,31,206,31,400271,276173,25559,100697,2.187404955012039,0.2671929312495025
1143,0.1144,35,226,35,400497,275947,25594,100662,2.1856149410721075,0.2672851684372917
1144,0.1145,35,207,35,400704,275740,25629,100627,2.1839754150297805,0.2673640356354303
1145,0.1146,34,209,34,400913,275531,25663,100593,2.1823200481561273,0.2674463740681265
1146,0.1147,41,247,41,401160,275284,25704,100552,2.180363705487264,0.2675422258644728
1147,0.1148,30,255,30,401415,275029,25734,100522,2.1783439994930935,0.2676653770060524
1148,0.1149,32,245,32,401660,274784,25766,100490,2.176403497655557,0.2677776771105912
1149,0.115,26,228,26,401888,274556,25792,100464,2.1745976428842986,0.26788971254866406
1150,0.1151,29,228,29,402116,274328,25821,100435,2.1727917881130403,0.2679960401640503
1151,0.1152,38,222,38,402338,274106,25859,100397,2.1710334558357625,0.2680806295276673
1152,0.1153,42,212,42,402550,273894,25901,100355,2.1693543277151184,0.2681503490991292
1153,0.1154,34,235,34,402785,273659,25935,100321,2.1674930300342163,0.2682523129579122
1154,0.1155,37,205,37,402990,273454,25972,100284,2.1658693448232165,0.26832700983041596
1155,0.1156,29,225,29,403215,273229,26001,100255,2.164087251298948,0.2684318471474012
1156,0.1157,35,246,35,403461,272983,26036,100220,2.162138829045748,0.2685401778656656
1157,0.1158,21,210,21,403671,272773,26057,100199,2.160475541756431,0.26865019358021514
1158,0.1159,26,250,26,403921,272523,26083,100173,2.158495437840578,0.2687793805138773
1159,0.116,32,231,32,404152,272292,26115,100141,2.156665821822329,0.2688832622243464
1160,0.1161,30,215,30,404367,272077,26145,100111,2.154962932454695,0.26897965544294816
1161,0.1162,41,190,41,404557,271887,26186,100070,2.1534580534786465,0.2690364746462629
1162,0.1163,33,247,33,404804,271640,26219,100037,2.151501710809783,0.26915036442932977
1163,0.1164,35,231,35,405035,271409,26254,100002,2.149672094791535,0.2692488913898619
1164,0.1165,18,225,18,405260,271184,26272,99984,2.1478900012672666,0.2693766704026209
1165,0.1166,35,206,35,405466,270978,26307,99949,2.1462583956406034,0.2694573325748732
1166,0.1167,41,221,41,405687,270757,26348,99908,2.144507983778989,0.2695371831707876
1167,0.1168,24,210,24,405897,270547,26372,99884,2.142844696489672,0.2696426594966404
1168,0.1169,37,221,37,406118,270326,26409,99847,2.1410942846280574,0.26973063945776704
1169,0.117,35,256,35,406374,270070,26444,99812,2.139066658218223,0.2698482218653517
1170,0.1171,35,207,35,406581,269863,26479,99777,2.1374271321758966,0.2699302023590521
1171,0.1172,27,232,27,406813,269631,26506,99750,2.1355895957419846,0.2700463748812202
1172,0.1173,25,227,25,407040,269404,26531,99725,2.1337916613863896,0.27016300534501486
1173,0.1174,33,228,33,407268,269176,26564,99692,2.1319858066151314,0.2702647017361224
1174,0.1175,32,229,32,407497,268947,26596,99660,2.1301720314282093,0.27036925506026743
1175,0.1176,36,245,36,407742,268702,26632,99624,2.128231529590673,0.27047778326808314
1176,0.1177,40,226,40,407968,268476,26672,99584,2.1264415156507415,0.270564581861653
1177,0.1178,32,223,32,408191,268253,26704,99552,2.1246752629578,0.270665162246299
1178,0.1179,30,197,30,408388,268056,26734,99522,2.1231149410721075,0.27075069781107686
1179,0.118,32,222,32,408610,267834,26766,99490,2.1213566087948297,0.27085080201674816
1180,0.1181,34,184,34,408794,267650,26800,99456,2.1198992523127616,0.270919026112349
1181,0.1182,30,217,30,409011,267433,26830,99426,2.1181805221138004,0.27101965605314304
1182,0.1183,32,220,32,409231,267213,26862,99394,2.1164380306678496,0.2711186638553001
1183,0.1184,31,207,31,409438,267006,26893,99363,2.1147985046255227,0.27121017334981945
1184,0.1185,25,223,25,409661,266783,26918,99338,2.1130322519325815,0.2713256000065552
1185,0.1186,36,231,36,409892,266552,26954,99302,2.1112026359143328,0.2714252133364676
1186,0.1187,34,194,34,410086,266358,26988,99268,2.1096660752756304,0.27150147965407273
1187,0.1188,23,233,23,410319,266125,27011,99245,2.107820618426055,0.2716287598872376
1188,0.1189,37,240,37,410559,265885,27048,99208,2.1059197186668355,0.2717335035182816
1189,0.119,29,215,29,410774,265670,27077,99179,2.104216829299202,0.27183574574687064
1190,0.1191,32,219,32,410993,265451,27109,99147,2.102482258268914,0.2719351175815556
1191,0.1192,27,200,27,411193,265251,27136,99120,2.1008981751362312,0.27203043052273645
1192,0.1193,36,217,36,411410,265034,27172,99084,2.0991794449372705,0.272120576296695
1193,0.1194,33,222,33,411632,264812,27205,99051,2.097421112659992,0.272220588518206
1194,0.1195,32,235,32,411867,264577,27237,99019,2.09555981497909,0.2723324789051585
1195,0.1196,27,227,27,412094,264350,27264,98992,2.093761880623495,0.27244854709887656
1196,0.1197,31,222,31,412316,264128,27295,98961,2.0920035483462174,0.2725530104189331
1197,0.1198,40,226,40,412542,263902,27335,98921,2.0902135344062858,0.27264258329819224
1198,0.1199,31,222,31,412764,263680,27366,98890,2.088455202129008,0.2727473315497697
1199,0.12,27,214,27,412978,263466,27393,98863,2.086760233177037,0.27285422916741414
1200,0.1201,28,213,28,413191,263253,27421,98835,2.0850731846407298,0.27295850732418636
1201,0.1202,39,212,39,413403,263041,27460,98796,2.083394056520086,0.2730400705289951
1202,0.1203,32,220,32,413623,262821,27492,98764,2.081651565074135,0.27314186152633546
1203,0.1204,37,229,37,413852,262592,27529,98727,2.0798377898872134,0.27324054367470296
1204,0.1205,38,209,38,414061,262383,27567,98689,2.0781824230135597,0.2733222182833341
1205,0.1206,36,205,36,414266,262178,27603,98653,2.07655873780256,0.27340500123326433
1206,0.1207,24,236,24,414502,261942,27627,98629,2.074689519705994,0.27353558661123606
1207,0.1208,38,257,38,414759,261685,27665,98591,2.072653972880497,0.2736540874218655
1208,0.1209,29,215,29,414974,261470,27694,98562,2.070951083512863,0.27375899920007113
1209,0.121,27,209,27,415183,261261,27721,98535,2.069295716639209,0.27386352266284225
1210,0.1211,28,203,28,415386,261058,27749,98507,2.067687872259536,0.273961592479802
1211,0.1212,32,211,32,415597,260847,27781,98475,2.0660166645545557,0.2740578088733782
1212,0.1213,27,217,27,415814,260630,27808,98448,2.064297934355595,0.2741688435381728
1213,0.1214,35,212,35,416026,260418,27843,98413,2.0626188062349513,0.2742600277010626
1214,0.1215,35,176,35,416202,260242,27878,98378,2.0612248130781903,0.27432379677653224
1215,0.1216,24,223,24,416425,260019,27902,98354,2.059458560385249,0.27444589854704454
1216,0.1217,30,245,30,416670,259774,27932,98324,2.0575180585477124,0.2745728822836207
1217,0.1218,29,210,29,416880,259564,27961,98295,2.0558547712583954,0.2746752212463568
1218,0.1219,36,197,36,417077,259367,27997,98259,2.054294449372703,0.2747535134470089
1219,0.122,38,201,38,417278,259166,28035,98221,2.052702445824357,0.274830925579274
1220,0.1221,34,199,34,417477,258967,28069,98187,2.0511262831073376,0.2749150226512933
1221,0.1222,31,217,31,417694,258750,28100,98156,2.049407552908377,0.27501919272861763
1222,0.1223,23,232,23,417926,258518,28123,98133,2.047570016474465,0.27515133842327655
1223,0.1224,35,203,35,418129,258315,28158,98098,2.0459621720947916,0.27523687407586145
1224,0.1225,32,200,32,418329,258115,28190,98066,2.044378088962109,0.2753263088149003
1225,0.1226,23,216,23,418545,257899,28213,98043,2.0426672791788114,0.27544656151844965
1226,0.1227,32,245,32,418790,257654,28245,98011,2.0407267773412747,0.2755711132666976
1227,0.1228,24,226,24,419016,257428,28269,97987,2.038936763401343,0.27569742413797954
1228,0.1229,35,187,35,419203,257241,28304,97952,2.037455645672285,0.2757712004459547
1229,0.123,31,196,31,419399,257045,28335,97921,2.0359032442022555,0.27586022323264764
1230,0.1231,22,203,22,419602,256842,28357,97899,2.034295399822583,0.2759731747951322
1231,0.1232,35,209,35,419811,256633,28392,97864,2.032640032948929,0.27606439546738054
1232,0.1233,41,214,41,420025,256419,28433,97823,2.0309450639969584,0.27614737947504814
1233,0.1234,31,216,31,420241,256203,28464,97792,2.029234254213661,0.27625248944194125
1234,0.1235,30,217,30,420458,255986,28494,97762,2.0275155240147003,0.27636057306331063
1235,0.1236,32,203,32,420661,255783,28526,97730,2.025907679635027,0.27645376549094375
1236,0.1237,29,206,29,420867,255577,28555,97701,2.024276074008364,0.27655557379740603
1237,0.1238,22,203,22,421070,255374,28577,97679,2.022668229628691,0.276669508544043
1238,0.1239,37,207,37,421277,255167,28614,97642,2.021028703586364,0.27675597844726185
1239,0.124,36,227,36,421504,254940,28650,97606,2.019230769230769,0.2768603246101218
1240,0.1241,41,176,41,421680,254764,28691,97565,2.0178367760740086,0.2769144748232476
1241,0.1242,35,202,35,421882,254562,28726,97530,2.0162368521099987,0.2770014655260557
1242,0.1243,40,173,40,422055,254389,28766,97490,2.014866620200228,0.27705546508885154
1243,0.1244,29,211,29,422266,254178,28795,97461,2.013195412495248,0.2771620895293184
1244,0.1245,22,223,22,422489,253955,28817,97439,2.0114291598023066,0.2772927255445454
1245,0.1246,23,218,23,422707,253737,28840,97416,2.009702509187682,0.27741753594586976
1246,0.1247,31,215,31,422922,253522,28871,97385,2.007999619820048,0.27752367436386277
1247,0.1248,19,210,19,423132,253312,28890,97366,2.006336332530731,0.2776507223150583
1248,0.1249,29,220,29,423352,253092,28919,97337,2.0045938410847803,0.2777652534464899
1249,0.125,31,212,31,423564,252880,28950,97306,2.0029147129641363,0.27786947507895804
1250,0.1251,39,213,39,423777,252667,28989,97267,2.0012276644278293,0.27795812924722946
1251,0.1252,29,185,29,423962,252482,29018,97238,1.9997623875300976,0.2780452933775592
1252,0.1253,26,235,26,424197,252247,29044,97212,1.9979010898491953,0.27817855599655467
1253,0.1254,32,206,32,424403,252041,29076,97180,1.996269484222532,0.2782765068538261
1254,0.1255,46,216,46,424619,251825,29122,97134,1.9945586744392345,0.27835361747368603
1255,0.1256,24,221,24,424840,251604,29146,97110,1.99280826257762,0.27848035926289166
1256,0.1257,39,196,39,425036,251408,29185,97071,1.991255861107591,0.2785562401177689
1257,0.1258,22,212,22,425248,251196,29207,97049,1.9895767329869471,0.27868023948656834
1258,0.1259,27,201,27,425449,250995,29234,97022,1.9879847294386008,0.27878523175591996
1259,0.126,37,210,37,425659,250785,29271,96985,1.986321442149284,0.2788768438910774
1260,0.1261,28,223,28,425882,250562,29299,96957,1.9845551894563427,0.2789976950900526
1261,0.1262,29,225,29,426107,250337,29328,96928,1.9827730959320746,0.2791182526312758
1262,0.1263,30,211,30,426318,250126,29358,96898,1.981101888227094,0.27922564433583846
1263,0.1264,28,195,28,426513,249931,29386,96870,1.9795574071727284,0.2793244540817356
1264,0.1265,42,208,42,426721,249723,29428,96828,1.9779099607147383,0.2794047629353255
1265,0.1266,36,201,36,426922,249522,29464,96792,1.976317957166392,0.2794920216912975
1266,0.1267,39,181,39,427103,249341,29503,96753,1.9748843619313141,0.27955699896559894
1267,0.1268,27,211,27,427314,249130,29530,96726,1.9732131542263338,0.27967130829015546
1268,0.1269,28,201,28,427515,248929,29558,96698,1.9716211506779875,0.27977559623524784
1269,0.127,36,194,36,427709,248735,29594,96662,1.9700845900392852,0.27985767102783177
1270,0.1271,30,185,30,427894,248550,29624,96632,1.9686193131415537,0.2799450724545312
1271,0.1272,35,215,35,428109,248335,29659,96597,1.9669164237739196,0.28004650191921887
1272,0.1273,20,186,20,428295,248149,29679,96577,1.9654432264605246,0.2801558339086695
1273,0.1274,25,198,25,428493,247951,29704,96552,1.9638749841591687,0.2802646130802925
1274,0.1275,27,215,27,428708,247736,29731,96525,1.9621720947915346,0.2803831976320292
1275,0.1276,22,203,22,428911,247533,29753,96503,1.9605642504118617,0.2805026218186469
1276,0.1277,30,195,30,429106,247338,29783,96473,1.9590197693574958,0.2805989337164896
1277,0.1278,33,233,33,429339,247105,29816,96440,1.9571743125079204,0.28072013855535666
1278,0.1279,37,201,37,429540,246904,29853,96403,1.9555823089595743,0.2808069745155211
1279,0.128,24,212,24,429752,246692,29877,96379,1.9539031808389304,0.28093018646286044
1280,0.1281,39,230,39,429982,246462,29916,96340,1.9520814852363453,0.28103686676273765
1281,0.1282,36,223,36,430205,246239,29952,96304,1.9503152325434039,0.28114426509956414
1282,0.1283,23,187,23,430392,246052,29975,96281,1.9488341148143455,0.2812495435730707
1283,0.1284,34,189,34,430581,245863,30009,96247,1.9473371562539603,0.2813334892286107
1284,0.1285,28,199,28,430780,245664,30037,96219,1.9457609935369409,0.2814383868165425
1285,0.1286,30,182,30,430962,245482,30067,96189,1.9443194778861994,0.2815252099241668
1286,0.1287,24,188,24,431150,245294,30091,96165,1.9428304397414777,0.2816297124984259
1287,0.1288,36,192,36,431342,245102,30127,96129,1.941309719934102,0.28171238838206375
1288,0.1289,20,214,20,431556,244888,30147,96109,1.9396147509821315,0.28184705437291235
1289,0.129,32,217,32,431773,244671,30179,96077,1.9378960207831708,0.28195910174087596
1290,0.1291,30,206,30,431979,244465,30209,96047,1.9362644151565074,0.282066417629922
1291,0.1292,40,214,40,432193,244251,30249,96007,1.9345694462045369,0.2821594202046682
1292,0.1293,36,186,36,432379,244065,30285,95971,1.9330962488911418,0.28223776306038184
1293,0.1294,36,220,36,432599,243845,30321,95935,1.9313537574451907,0.2823444581788216
1294,0.1295,39,190,39,432789,243655,30360,95896,1.929848878469142,0.2824200193785322
1295,0.1296,40,172,40,432961,243483,30400,95856,1.9284865669750348,0.2824785833635391
1296,0.1297,30,205,30,433166,243278,30430,95826,1.926862881764035,0.282585873360385
1297,0.1298,31,215,31,433381,243063,30461,95795,1.925159992396401,0.2826995378595164
1298,0.1299,31,199,31,433580,242864,30492,95764,1.9235838296793817,0.28280000472494893
1299,0.13,34,185,34,433765,242679,30526,95730,1.92211855278165,0.28288254744997915
1300,0.1301,23,192,23,433957,242487,30549,95707,1.9205978329742746,0.2829943760090362
1301,0.1302,30,191,30,434148,242296,30579,95677,1.9190850335825624,0.28309066108831177
1302,0.1303,28,209,28,434357,242087,30607,95649,1.9174296667089088,0.2832064097401521
1303,0.1304,26,180,26,434537,241907,30633,95623,1.9160039918894944,0.28330222498740854
1304,0.1305,40,198,40,434735,241709,30673,95583,1.9144357495881383,0.2833835371132431
1305,0.1306,38,189,38,434924,241520,30711,95545,1.912938791027753,0.2834616468633646
1306,0.1307,30,189,30,435113,241331,30741,95515,1.9114418324673679,0.2835568776236025
1307,0.1308,29,195,29,435308,241136,30770,95486,1.9098973514130022,0.28365941619977303
1308,0.1309,31,210,31,435518,240926,30801,95455,1.9082340641236852,0.2837704864424566
1309,0.131,31,200,31,435718,240726,30832,95424,1.9066499809910025,0.28387327086122266
1310,0.1311,28,195,28,435913,240531,30860,95396,1.9051054999366366,0.28397836434701584
1311,0.1312,26,170,26,436083,240361,30886,95370,1.9037590292738562,0.2840667081681465
1312,0.1313,32,215,32,436298,240146,30918,95338,1.9020561399062224,0.28418046762289706
1313,0.1314,31,168,31,436466,239978,30949,95307,1.9007255100747686,0.284256677155256
1314,0.1315,30,191,30,436657,239787,30979,95277,1.8992127106830567,0.2843546307571091
1315,0.1316,29,177,29,436834,239610,31008,95248,1.8978107971106324,0.28444295791051727
1316,0.1317,31,208,31,437042,239402,31039,95217,1.8961633506526423,0.2845534772382919
1317,0.1318,22,199,22,437241,239203,31061,95195,1.8945871879356229,0.2846757456683353
1318,0.1319,29,181,29,437422,239022,31090,95166,1.893153592700545,0.28476785521921794
1319,0.132,28,205,28,437627,238817,31118,95138,1.891529907489545,0.28488269377610753
1320,0.1321,23,216,23,437843,238601,31141,95115,1.8898190977062477,0.28501779956609813
1321,0.1322,33,229,33,438072,238372,31174,95082,1.8880053225193258,0.2851427783142502
1322,0.1323,34,200,34,438272,238172,31208,95048,1.886421239386643,0.2852409819338575
1323,0.1324,33,202,33,438474,237970,31241,95015,1.8848213154226334,0.2853431836268901
1324,0.1325,34,198,34,438672,237772,31275,94981,1.8832530731212773,0.285439950954612
1325,0.1326,37,188,37,438860,237584,31312,94944,1.8817640349765556,0.28552182071885673
1326,0.1327,24,183,24,439043,237401,31336,94920,1.8803145989101508,0.2856274505673731
1327,0.1328,36,179,36,439222,237222,31372,94884,1.8788968445063996,0.28570396198804
1328,0.1329,33,204,33,439426,237018,31405,94851,1.8772810797110633,0.28580855699086083
1329,0.133,34,177,34,439603,236841,31439,94817,1.875879166138639,0.2858878724469182
1330,0.1331,34,188,34,439791,236653,31473,94783,1.874390127993917,0.2859767798307969
1331,0.1332,41,188,41,439979,236465,31514,94742,1.8729010898491953,0.2860507175271054
1332,0.1333,31,169,31,440148,236296,31545,94711,1.8715625396020783,0.28612990057612075
1333,0.1334,41,194,41,440342,236102,31586,94670,1.870025978963376,0.2862092317366645
1334,0.1335,44,193,44,440535,235909,31630,94626,1.8684973387403372,0.2862813317802956
1335,0.1336,26,204,26,440739,235705,31656,94600,1.8668815739450006,0.28640196182316346
1336,0.1337,36,187,36,440926,235518,31692,94564,1.8654004562159423,0.28648638823080325
1337,0.1338,34,187,34,441113,235331,31726,94530,1.8639193384868837,0.28657525442534887
1338,0.1339,43,181,43,441294,235150,31769,94487,1.8624857432518058,0.28663954592475965
1339,0.134,31,189,31,441483,234961,31800,94456,1.8609887846914206,0.2867368715032922
1340,0.1341,25,183,25,441666,234778,31825,94431,1.8595393486250158,0.2868420972695157
1341,0.1342,31,185,31,441851,234593,31856,94400,1.8580740717272843,0.28693619621086164
1342,0.1343,28,197,28,442048,234396,31884,94372,1.8565137498415918,0.2870474012069301
1343,0.1344,33,182,33,442230,234214,31917,94339,1.8550722341908503,0.2871348001692269
1344,0.1345,26,191,26,442421,234023,31943,94313,1.8535594347991382,0.28724538277861705
1345,0.1346,36,175,36,442596,233848,31979,94277,1.8521733620580407,0.28732038095238094
1346,0.1347,39,174,39,442770,233674,32018,94238,1.8507952097326068,0.2873880797287077
1347,0.1348,26,193,26,442963,233481,32044,94212,1.8492665695095678,0.28750080105464565
1348,0.1349,27,183,27,443146,233298,32071,94185,1.847817133443163,0.2876027152554484
1349,0.135,30,184,30,443330,233114,32101,94155,1.8463597769610949,0.28769910990652947
1350,0.1351,32,199,32,443529,232915,32133,94123,1.8447836142440754,0.28780447532091075
1351,0.1352,28,208,28,443737,232707,32161,94095,1.8431361677860854,0.2879266344759212
1352,0.1353,32,180,32,443917,232527,32193,94063,1.841710492966671,0.2880155546709942
1353,0.1354,30,179,30,444096,232348,32223,94033,1.8402927385629197,0.2881080700163306
1354,0.1355,30,201,30,444297,232147,32253,94003,1.8387007350145737,0.2882201441054729
1355,0.1356,31,186,31,444483,231961,32284,93972,1.8372275377011786,0.2883169240303989
1356,0.1357,37,175,37,444658,231786,32321,93935,1.8358414649600812,0.2883909849226792
1357,0.1358,34,195,34,444853,231591,32355,93901,1.8342969839057153,0.28848942523933
1358,0.1359,26,187,26,445040,231404,32381,93875,1.832815866176657,0.2885984032169307
1359,0.136,30,194,30,445234,231210,32411,93845,1.8312793055379546,0.2887049883865807
1360,0.1361,28,207,28,445441,231003,32439,93817,1.8296397794956278,0.288827658395419
1361,0.1362,36,165,36,445606,230838,32475,93781,1.8283329109111646,0.2888955976082731
1362,0.1363,38,168,38,445774,230670,32513,93743,1.827002281079711,0.28896190966453256
1363,0.1364,31,195,31,445969,230475,32544,93712,1.8254578000253454,0.28906772942776854
1364,0.1365,28,174,28,446143,230301,32572,93684,1.8240796476999113,0.28916153525626187
1365,0.1366,25,192,25,446335,230109,32597,93659,1.8225589278925358,0.2892781250772158
1366,0.1367,23,176,23,446511,229933,32620,93636,1.821164934735775,0.28938495344115167
1367,0.1368,46,202,46,446713,229731,32666,93590,1.8195650107717654,0.2894646496825137
1368,0.1369,29,225,29,446938,229506,32695,93561,1.817782917247497,0.2896024663614668
1369,0.137,22,178,22,447116,229328,32717,93539,1.8163730832594094,0.28971372112975313
1370,0.1371,29,201,29,447317,229127,32746,93510,1.8147810797110633,0.2898303666349489
1371,0.1372,30,178,30,447495,228949,32776,93480,1.8133712457229756,0.2899242934103322
1372,0.1373,38,162,38,447657,228787,32814,93442,1.8120881383855025,0.2899863140809797
1373,0.1374,26,188,26,447845,228599,32840,93416,1.8105991002407806,0.2900982873468627
1374,0.1375,27,167,27,448012,228432,32867,93389,1.8092763908249905,0.2901892667041616
1375,0.1376,36,181,36,448193,228251,32903,93353,1.8078427955899126,0.2902731309312073
1376,0.1377,22,192,22,448385,228059,32925,93331,1.8063220757825371,0.29039795886617503
1377,0.1378,36,189,36,448574,227870,32961,93295,1.8048251172221519,0.29048931234723585
1378,0.1379,38,181,38,448755,227689,32999,93257,1.803391521987074,0.2905691300094097
1379,0.138,18,171,18,448926,227518,33017,93239,1.80203713090863,0.29068422512992703
1380,0.1381,39,173,39,449099,227345,33056,93200,1.8006668989988595,0.29075480821725497
1381,0.1382,27,186,27,449285,227159,33083,93173,1.7991937016854644,0.29086385375173257
1382,0.1383,41,188,41,449473,226971,33124,93132,1.7977046635407425,0.2909438524474935
1383,0.1384,29,175,29,449648,226796,33153,93103,1.796318590799645,0.29103873410045045
1384,0.1385,25,185,25,449833,226611,33178,93078,1.7948533139019136,0.291151713071141
1385,0.1386,35,192,35,450025,226419,33213,93043,1.7933325940945382,0.29124903744420305
1386,0.1387,31,187,31,450212,226232,33244,93012,1.7918514763654796,0.29135081630351706
1387,0.1388,41,165,41,450377,226067,33285,92971,1.7905446077810163,0.29141042759796637
1388,0.1389,28,177,28,450554,225890,33313,92943,1.7891426942085922,0.2915099754416889
1389,0.139,30,161,30,450715,225729,33343,92913,1.7878675072867825,0.29159056244939463
1390,0.1391,22,196,22,450911,225533,33365,92891,1.7863151058167532,0.29172110142451574
1391,0.1392,36,159,36,451070,225374,33401,92855,1.7850557597262704,0.2917867321959972
1392,0.1393,37,159,37,451229,225215,33438,92818,1.7837964136357876,0.2918502168014011
1393,0.1394,21,191,21,451420,225024,33459,92797,1.7822836142440754,0.2919788182656275
1394,0.1395,34,181,34,451601,224843,33493,92763,1.7808500190089975,0.2920694193434633
1395,0.1396,38,196,38,451797,224647,33531,92725,1.7792976175389685,0.29216503031143265
1396,0.1397,30,165,30,451962,224482,33561,92695,1.777990748954505,0.2922500685736986
1397,0.1398,25,176,25,452138,224306,33586,92670,1.7765967557977442,0.29235651910554744
1398,0.1399,25,170,25,452308,224136,33611,92645,1.7752502851349639,0.29245756532115247
1399,0.14,32,205,32,452513,223931,33643,92613,1.773626599923964,0.29257543974929234
1400,0.1401,35,191,35,452704,223740,33678,92578,1.7721138005322519,0.29267382823614213
1401,0.1402,28,201,28,452905,223539,33706,92550,1.7705217969839058,0.29279728177823333
1402,0.1403,30,164,30,453069,223375,33736,92520,1.7692228488151058,0.29288212855537443
1403,0.1404,43,169,43,453238,223206,33779,92477,1.7678842985679888,0.29294260381458614
1404,0.1405,30,156,30,453394,223050,33809,92447,1.7666487137244962,0.29302021889273117
1405,0.1406,31,198,31,453592,222852,33840,92416,1.7650804714231403,0.2931347298171714
1406,0.1407,34,177,34,453769,222675,33874,92382,1.763678557850716,0.2932231310524762
1407,0.1408,30,175,30,453944,222500,33904,92352,1.7622924851096184,0.29331876564227
1408,0.1409,28,193,28,454137,222307,33932,92324,1.7607638448865797,0.29343580257508
1409,0.141,33,170,33,454307,222137,33965,92291,1.7594173742237993,0.29352029717455186
1410,0.1411,32,197,32,454504,221940,33997,92259,1.7578570523381067,0.29363237947924725
1411,0.1412,20,207,20,454711,221733,34017,92239,1.75621752629578,0.29378097409960124
1412,0.1413,25,184,25,454895,221549,34042,92214,1.7547601698137119,0.29389698594161834
1413,0.1414,26,154,26,455049,221395,34068,92188,1.7535404258015461,0.2939827733008486
1414,0.1415,41,188,41,455237,221207,34109,92147,1.7520513876568242,0.29406677431914063
1415,0.1416,38,171,38,455408,221036,34147,92109,1.7506969965783805,0.2941416915486436
1416,0.1417,37,157,37,455565,220879,34184,92072,1.7494534913192243,0.2942058021862847
1417,0.1418,32,171,32,455736,220708,34216,92040,1.7480991002407806,0.2942944479261258
1418,0.1419,28,177,28,455913,220531,34244,92012,1.7466971866683563,0.294397890850219
1419,0.142,39,180,39,456093,220351,34283,91973,1.745271511848942,0.2944794508267056
1420,0.1421,23,200,23,456293,220151,34306,91950,1.743687428716259,0.2946161659206475
1421,0.1422,31,169,31,456462,219982,34337,91919,1.742348878469142,0.29470569187017676
1422,0.1423,41,170,41,456632,219812,34378,91878,1.7410024078063617,0.2947736533093779
1423,0.1424,41,172,41,456804,219640,34419,91837,1.7396400963122545,0.2948436000089894
1424,0.1425,39,173,39,456977,219467,34458,91798,1.7382698644024839,0.29491912036367723
1425,0.1426,29,176,29,457153,219291,34487,91769,1.736875871245723,0.29502025332733234
1426,0.1427,26,181,26,457334,219110,34513,91743,1.735442276010645,0.2951330693285894
1427,0.1428,23,177,23,457511,218933,34536,91720,1.7340403624382208,0.2952490399255761
1428,0.1429,35,205,35,457716,218728,34571,91685,1.732416677227221,0.29536456269550565
1429,0.143,32,181,32,457897,218547,34603,91653,1.730983081992143,0.2954642166344294
1430,0.1431,42,178,42,458075,218369,34645,91611,1.7295732480040553,0.2955384218336667
1431,0.1432,29,169,29,458244,218200,34674,91582,1.7282346977569383,0.29563370370131253
1432,0.1433,32,182,32,458426,218018,34706,91550,1.726793182106197,0.2957347012611123
1433,0.1434,35,182,35,458608,217836,34741,91515,1.7253516664554556,0.29582900976560605
1434,0.1435,36,184,36,458792,217652,34777,91479,1.7238943099733874,0.29592308762304653
1435,0.1436,25,180,25,458972,217472,34802,91454,1.7224686351539729,0.29603853349993203
1436,0.1437,27,163,27,459135,217309,34829,91427,1.7211776074008365,0.2961332659618574
1437,0.1438,27,158,27,459293,217151,34856,91400,1.719926181726017,0.29622331478426583
1438,0.1439,34,175,34,459468,216976,34890,91366,1.7185401089849195,0.29631383334090067
1439,0.144,37,173,37,459641,216803,34927,91329,1.717169877075149,0.2963957005439227
1440,0.1441,26,183,26,459824,216620,34953,91303,1.715720441008744,0.29651243979826125
1441,0.1442,34,160,34,459984,216460,34987,91269,1.714453174502598,0.29658888177584825
1442,0.1443,33,154,33,460138,216306,35020,91236,1.7132334304904322,0.2966619193476013
1443,0.1444,29,172,29,460310,216134,35049,91207,1.711871118996325,0.2967615775311462
1444,0.1445,30,172,30,460482,215962,35079,91177,1.7105088075022177,0.2968590768349184
1445,0.1446,44,185,44,460667,215777,35123,91133,1.7090435306044862,0.29693721286370595
1446,0.1447,27,182,27,460849,215595,35150,91106,1.7076020149537448,0.297051525753095
1447,0.1448,39,169,39,461018,215426,35189,91067,1.7062634647066277,0.2971258723690264
1448,0.1449,20,157,20,461175,215269,35209,91047,1.7050199594474718,0.2972322699434571
1449,0.145,34,166,34,461341,215103,35243,91013,1.7037051704473452,0.29731539677769214
1450,0.1451,28,144,28,461485,214959,35271,90985,1.7025646305918134,0.29739102580864474
1451,0.1452,25,173,25,461658,214786,35296,90960,1.7011943986820428,0.29750184793913903
1452,0.1453,17,174,17,461832,214612,35313,90943,1.6998162463566089,0.29763217751305004
1453,0.1454,29,156,29,461988,214456,35342,90914,1.6985806615131163,0.2977175230048793
1454,0.1455,27,173,27,462161,214283,35369,90887,1.6972104296033457,0.29782416358095487
1455,0.1456,40,181,40,462342,214102,35409,90847,1.6957768343682675,0.2979088306569295
1456,0.1457,40,170,40,462512,213932,35449,90807,1.6944303637054872,0.29798286402462437
1457,0.1458,34,178,34,462690,213754,35483,90773,1.6930205297173995,0.29807865969191566
1458,0.1459,30,161,30,462851,213593,35513,90743,1.69174534279559,0.29816715735239996
1459,0.146,29,184,29,463035,213409,35542,90714,1.6902879863135218,0.2982806298767275
1460,0.1461,35,170,35,463205,213239,35577,90679,1.6889415156507412,0.29836666469244993
1461,0.1462,34,158,34,463363,213081,35611,90645,1.687690089975922,0.2984433337942751
1462,0.1463,32,162,32,463525,212919,35643,90613,1.686406982638449,0.29852865595719724
1463,0.1464,36,176,36,463701,212743,35679,90577,1.685012989481688,0.29861862059870764
1464,0.1465,37,169,37,463870,212574,35716,90540,1.683674439234571,0.29869949919832145
1465,0.1466,27,165,27,464035,212409,35743,90513,1.6823675706501078,0.2987996910095668
1466,0.1467,26,172,26,464207,212237,35769,90487,1.6810052591560005,0.29890923745722175
1467,0.1468,34,155,34,464362,212082,35803,90453,1.6797775947281712,0.2989835886756904
1468,0.1469,38,162,38,464524,211920,35841,90415,1.6784944873906982,0.2990556832652521
1469,0.147,21,167,21,464691,211753,35862,90394,1.677171777974908,0.29917225721254886
1470,0.1471,37,178,37,464869,211575,35899,90357,1.6757619439868203,0.29926274790350144
1471,0.1472,26,168,26,465037,211407,35925,90331,1.6744313141553668,0.29936898899044867
1472,0.1473,33,181,33,465218,211226,35958,90298,1.672997718920289,0.29947201549462066
1473,0.1474,34,184,34,465402,211042,35992,90264,1.6715403624382208,0.29957584648164987
1474,0.1475,32,146,32,465548,210896,36024,90232,1.6703839817513624,0.29964666188464706
1475,0.1476,27,169,27,465717,210727,36051,90205,1.6690454315042453,0.2997521034652347
1476,0.1477,24,164,24,465881,210563,36075,90181,1.6677464833354454,0.2998596813236507
1477,0.1478,35,176,35,466057,210387,36110,90146,1.6663524901786846,0.2999537488395617
1478,0.1479,29,173,29,466230,210214,36139,90117,1.664982258268914,0.3000589349750775
1479,0.148,28,151,28,466381,210063,36167,90089,1.6637862755037385,0.30014459340600763
1480,0.1481,36,176,36,466557,209887,36203,90053,1.6623922823469777,0.30023671400946855
1481,0.1482,30,165,30,466722,209722,36233,90023,1.6610854137625142,0.3003319488231664
1482,0.1483,40,158,40,466880,209564,36273,89983,1.659833988087695,0.3003969327017129
1483,0.1484,20,188,20,467068,209376,36293,89963,1.658344949942973,0.3005388539415178
1484,0.1485,39,188,39,467256,209188,36332,89924,1.656855911798251,0.300636550857204
1485,0.1486,26,160,26,467416,209028,36358,89898,1.655588645292105,0.3007366371610365
1486,0.1487,32,157,32,467573,208871,36390,89866,1.654345140032949,0.30081978462661135
1487,0.1488,27,176,27,467749,208695,36417,89839,1.6529511468761882,0.30093389697655876
1488,0.1489,28,161,28,467910,208534,36445,89811,1.6516759599543784,0.3010306859508287
1489,0.149,30,190,30,468100,208344,36475,89781,1.6501710809783297,0.30115220125786163
1490,0.1491,31,186,31,468286,208158,36506,89750,1.6486978836649346,0.30126750540435304
1491,0.1492,21,164,21,468450,207994,36527,89729,1.647398935496135,0.3013841725362166
1492,0.1493,26,181,26,468631,207813,36553,89703,1.645965340261057,0.30150647360141974
1493,0.1494,37,164,37,468795,207649,36590,89666,1.644666392092257,0.3015858601146932
1494,0.1495,33,161,33,468956,207488,36623,89633,1.6433912051704473,0.301671709505555
1495,0.1496,31,180,31,469136,207308,36654,89602,1.6419655303510328,0.30178168468559496
1496,0.1497,25,164,25,469300,207144,36679,89577,1.6406665821822328,0.30188965391731626
1497,0.1498,23,180,23,469480,206964,36702,89554,1.6392409073628185,0.30201876445949316
1498,0.1499,26,144,26,469624,206820,36728,89528,1.6381003675072867,0.30210428280265095
1499,0.15,36,160,36,469784,206660,36764,89492,1.6368331010011405,0.30218266295685997
1500,0.1501,35,173,35,469957,206487,36799,89457,1.63546286909137,0.3022767820939097
1501,0.1502,35,161,35,470118,206326,36834,89422,1.6341876821695602,0.30235876489443714
1502,0.1503,35,157,35,470275,206169,36869,89387,1.6329441769104043,0.3024367632529876
1503,0.1504,26,173,26,470448,205996,36895,89361,1.6315739450006337,0.3025525042575595
1504,0.1505,32,165,32,470613,205831,36927,89329,1.6302670764161704,0.3026460224962732
1505,0.1506,31,184,31,470797,205647,36958,89298,1.628809719934102,0.3027615318110156
1506,0.1507,32,179,32,470976,205468,36990,89266,1.627391965530351,0.30286970624359594
1507,0.1508,32,154,32,471130,205314,37022,89234,1.6261722215181853,0.30295232016513435
1508,0.1509,32,173,32,471303,205141,37054,89202,1.6248019896084147,0.30305459956581265
1509,0.151,28,165,28,471468,204976,37082,89174,1.6234951210239514,0.30315825259221485
1510,0.1511,25,167,25,471635,204809,37107,89149,1.6221724116081613,0.30327121561583625
1511,0.1512,31,166,31,471801,204643,37138,89118,1.6208576226080345,0.30336906532861746
1512,0.1513,19,175,19,471976,204468,37157,89099,1.619471549866937,0.30350482172723775
1513,0.1514,42,173,42,472149,204295,37199,89057,1.6181013179571664,0.3035840901033571
1514,0.1515,34,171,34,472320,204124,37233,89023,1.6167469268787227,0.30368040607613245
1515,0.1516,28,163,28,472483,203961,37261,88995,1.615455899125586,0.30378282062835377
1516,0.1517,36,174,36,472657,203787,37297,88959,1.6140777468001521,0.3038777643417843
1517,0.1518,38,177,38,472834,203610,37335,88921,1.6126758332277278,0.3039712030519842
1518,0.1519,34,163,34,472997,203447,37369,88887,1.6113848054745914,0.3040597398865681
1519,0.152,27,163,27,473160,203284,37396,88860,1.6100937777214548,0.3041650692809026
1520,0.1521,35,148,35,473308,203136,37431,88825,1.6089215562032695,0.3042358397183185
1521,0.1522,30,149,30,473457,202987,37461,88795,1.6077414142694209,0.3043196633102796
1522,0.1523,38,142,38,473599,202845,37499,88757,1.606616715245216,0.30437719905899135
1523,0.1524,22,155,22,473754,202690,37521,88735,1.605389050817387,0.30448657459037487
1524,0.1525,23,174,23,473928,202516,37544,88712,1.6040108984919528,0.3046135673767632
1525,0.1526,22,165,22,474093,202351,37566,88690,1.6027040299074895,0.30473369731412414
1526,0.1527,24,144,24,474237,202207,37590,88666,1.601563490051958,0.3048271926235849
1527,0.1528,40,155,40,474392,202052,37630,88626,1.6003358256241287,0.30489407523101164
1528,0.1529,38,151,38,474543,201901,37668,88588,1.5991398428589532,0.30496163365910584
1529,0.153,23,172,23,474715,201729,37691,88565,1.5977775313648461,0.3050872563676824
1530,0.1531,23,171,23,474886,201558,37714,88542,1.5964231402864022,0.30521199586349534
1531,0.1532,36,172,36,475058,201386,37750,88506,1.595060828792295,0.30530680391318143
1532,0.1533,37,161,37,475219,201225,37787,88469,1.5937856418704854,0.3053877539748838
1533,0.1534,26,158,26,475377,201067,37813,88443,1.592534216195666,0.3054920382715623
1534,0.1535,30,201,30,475578,200866,37843,88413,1.5909422126473198,0.30563227887264544
1535,0.1536,29,138,29,475716,200728,37872,88384,1.5898491952857685,0.30570851434738094
1536,0.1537,40,132,40,475848,200596,37912,88344,1.5888037004181979,0.3057520592510556
1537,0.1538,31,168,31,476016,200428,37943,88313,1.5874730705867444,0.3058554206018543
1538,0.1539,37,134,37,476150,200294,37980,88276,1.5864117348878468,0.3059084450913123
1539,0.154,24,171,24,476321,200123,38004,88252,1.585057343809403,0.30603207628955353
1540,0.1541,27,140,27,476461,199983,38031,88225,1.5839484856165251,0.306115721978571
1541,0.1542,23,158,23,476619,199825,38054,88202,1.5826970599417058,0.3062282355473619
1542,0.1543,34,180,34,476799,199645,38088,88168,1.5812713851222913,0.30633779572152753
1543,0.1544,31,155,31,476954,199490,38119,88137,1.580043720694462,0.3064281169709381
1544,0.1545,22,156,22,477110,199334,38141,88115,1.5788081358509694,0.30654133428886515
1545,0.1546,35,179,35,477289,199155,38176,88080,1.5773903814472183,0.30664786672933314
1546,0.1547,30,172,30,477461,198983,38206,88050,1.576028069953111,0.3067591531287343
1547,0.1548,26,168,26,477629,198815,38232,88024,1.5746974401216576,0.3068759826941246
1548,0.1549,31,145,31,477774,198670,38263,87993,1.5735489798504625,0.30695625176601093
1549,0.155,25,143,25,477917,198527,38288,87968,1.5724163604105943,0.3070489886385452
1550,0.1551,22,151,22,478068,198376,38310,87946,1.5712203776454188,0.30715767562394786
1551,0.1552,32,163,32,478231,198213,38342,87914,1.5699293498922824,0.30725516990706925
1552,0.1553,29,156,29,478387,198057,38371,87885,1.5686937650487898,0.3073525400255996
1553,0.1554,23,174,23,478561,197883,38394,87862,1.5673156127233556,0.30748394547586133
1554,0.1555,37,173,37,478734,197710,38431,87825,1.565945380813585,0.3075805067679969
1555,0.1556,47,166,47,478900,197544,38478,87778,1.5646305918134584,0.30764539713025985
1556,0.1557,37,148,37,479048,197396,38515,87741,1.5634583702952731,0.30771523863967143
1557,0.1558,36,162,36,479210,197234,38551,87705,1.5621752629578,0.30780272268801395
1558,0.1559,29,151,29,479361,197083,38580,87676,1.5609792801926246,0.3078954484318318
1559,0.156,27,149,27,479510,196934,38607,87649,1.559799138258776,0.3079909903261966
1560,0.1561,32,170,32,479680,196764,38639,87617,1.5584526675959955,0.3080972357506303
1561,0.1562,20,141,20,479821,196623,38659,87597,1.557335888987454,0.30820139328689045
1562,0.1563,27,168,27,479989,196455,38686,87570,1.5560052591560005,0.30831792975970423
1563,0.1564,32,155,32,480144,196300,38718,87538,1.5547775947281712,0.3084083174205004
1564,0.1565,28,155,28,480299,196145,38746,87510,1.5535499303003422,0.3085085755583367
1565,0.1566,29,163,29,480462,195982,38775,87481,1.5522589025472058,0.3086152337342087
1566,0.1567,37,141,37,480603,195841,38812,87444,1.5511421239386642,0.30867853928023015
1567,0.1568,29,161,29,480764,195680,38841,87415,1.5498669370168547,0.3087832706335329
1568,0.1569,28,159,28,480923,195521,38869,87387,1.548607590926372,0.30888840188329775
1569,0.157,27,149,27,481072,195372,38896,87360,1.547427448992523,0.3089851873859344
1570,0.1571,27,166,27,481238,195206,38923,87333,1.5461126599923964,0.30910069052414
1571,0.1572,33,159,33,481397,195047,38956,87300,1.5448533139019136,0.3091940059572087
1572,0.1573,24,158,24,481555,194889,38980,87276,1.543601888227094,0.3093083833926958
1573,0.1574,37,179,37,481734,194710,39017,87239,1.542184133823343,0.30941411390003154
1574,0.1575,40,143,40,481877,194567,39057,87199,1.5410515143834749,0.30947310889177543
1575,0.1576,20,176,20,482053,194391,39077,87179,1.539657521226714,0.30961750186454523
1576,0.1577,33,159,33,482212,194232,39110,87146,1.5383981751362312,0.30971149130351344
1577,0.1578,34,141,34,482353,194091,39144,87112,1.5372813965276897,0.309783323790998
1578,0.1579,36,173,36,482526,193918,39180,87076,1.535911164617919,0.30988562033353023
1579,0.158,26,158,26,482684,193760,39206,87050,1.5346597389430998,0.30999608276058543
1580,0.1581,25,153,25,482837,193607,39231,87025,1.5334479153465974,0.3101036232503777
1581,0.1582,31,146,31,482983,193461,39262,86994,1.532291534659739,0.3101888003423009
1582,0.1583,35,145,35,483128,193316,39297,86959,1.531143074388544,0.3102631344215503
1583,0.1584,30,143,30,483271,193173,39327,86929,1.5300104549486757,0.31034765906705414
1584,0.1585,28,141,28,483412,193032,39355,86901,1.5288936763401344,0.3104349969456977
1585,0.1586,37,158,37,483570,192874,39392,86864,1.527642250665315,0.31051912861320236
1586,0.1587,36,169,36,483739,192705,39428,86828,1.5263037004181979,0.31061806656101426
1587,0.1588,19,127,19,483866,192578,39447,86809,1.5252978076289443,0.31071238103419274
1588,0.1589,26,135,26,484001,192443,39473,86783,1.5242285515143834,0.31079842135044733
1589,0.159,33,182,33,484183,192261,39506,86750,1.5227870358636422,0.31091964116110116
1590,0.1591,25,172,25,484355,192089,39531,86725,1.521424724369535,0.3110496603470414
1591,0.1592,32,140,32,484495,191949,39563,86693,1.520315866176657,0.31112682223067595
1592,0.1593,40,153,40,484648,191796,39603,86653,1.5191040425801545,0.3111988191733495
1593,0.1594,38,150,38,484798,191646,39641,86615,1.5179159802306426,0.3112725103410108
1594,0.1595,26,147,26,484945,191499,39667,86589,1.5167516791281206,0.3113726590144127
1595,0.1596,29,160,29,485105,191339,39696,86560,1.5154844126219744,0.31148007009740947
1596,0.1597,34,175,34,485280,191164,39730,86526,1.514098339880877,0.31159206309193704
1597,0.1598,26,146,26,485426,191018,39756,86500,1.5129419591940185,0.3116914938850813
1598,0.1599,35,139,35,485565,190879,39791,86465,1.5118410214168039,0.31176084573670243
1599,0.16,35,165,35,485730,190714,39826,86430,1.5105341528323406,0.31185953872355165
1600,0.1601,35,167,35,485897,190547,39861,86395,1.5092114434165504,0.31196062713492356
1601,0.1602,29,171,29,486068,190376,39890,86366,1.5078570523381067,0.3120812887093394
1602,0.1603,31,137,31,486205,190239,39921,86335,1.506771955392219,0.31215877125109376
1603,0.1604,38,151,38,486356,190088,39959,86297,1.5055759726270435,0.3122347450114876
1604,0.1605,33,152,33,486508,189936,39992,86264,1.5043720694462046,0.31232440260680666
1605,0.1606,23,157,23,486665,189779,40015,86241,1.5031285641870484,0.3124447503804072
1606,0.1607,24,134,24,486799,189645,40039,86217,1.502067228488151,0.3125367031341758
1607,0.1608,28,156,28,486955,189489,40067,86189,1.5008316436446585,0.31264373653320177
1608,0.1609,27,161,27,487116,189328,40094,86162,1.4995564567228488,0.3127590838142945
1609,0.161,39,136,39,487252,189192,40133,86123,1.4984792801926246,0.312816228683508
1610,0.1611,24,141,24,487393,189051,40157,86099,1.4973625015840832,0.3129165909503907
1611,0.1612,26,166,26,487559,188885,40183,86073,1.4960477125839564,0.3130405371002117
1612,0.1613,27,148,27,487707,188737,40210,86046,1.4948754910657711,0.3131416426780405
1613,0.1614,35,147,35,487854,188590,40245,86011,1.4937111899632494,0.313221728981322
1614,0.1615,30,151,30,488005,188439,40275,85981,1.4925152071980738,0.313319000072881
1615,0.1616,34,162,34,488167,188277,40309,85947,1.4912320998606008,0.3134189567652722
1616,0.1617,35,153,35,488320,188124,40344,85912,1.4900202762640984,0.31350625465267334
1617,0.1618,29,151,29,488471,187973,40373,85883,1.4888242934989229,0.31360642089273194
1618,0.1619,32,136,32,488607,187837,40405,85851,1.4877471169686984,0.3136820028645757
1619,0.162,35,167,35,488774,187670,40440,85816,1.4864244075529083,0.3137857148080706
1620,0.1621,29,148,29,488922,187522,40469,85787,1.4852521860347232,0.31388282127555256
1621,0.1622,37,157,37,489079,187365,40506,85750,1.484008680775567,0.31397030554894456
1622,0.1623,29,146,29,489225,187219,40535,85721,1.4828523000887086,0.31406536235069976
1623,0.1624,24,156,24,489381,187063,40559,85697,1.481616715245216,0.31418463117759204
1624,0.1625,25,153,25,489534,186910,40584,85672,1.4804048916487138,0.31429808277876015
1625,0.1626,38,154,38,489688,186756,40622,85634,1.479185147636548,0.3143801167443739
1626,0.1627,28,151,28,489839,186605,40650,85606,1.4779891648713726,0.3144839848499877
1627,0.1628,28,154,28,489993,186451,40678,85578,1.4767694208592066,0.31459145899885677
1628,0.1629,23,140,23,490133,186311,40701,85555,1.4756605626663288,0.3146954749766429
1629,0.163,34,166,34,490299,186145,40735,85521,1.474345773666202,0.31480199951410925
1630,0.1631,26,164,26,490463,185981,40761,85495,1.473046825497402,0.31492654967658285
1631,0.1632,33,149,33,490612,185832,40794,85462,1.4718666835635534,0.31501618170693046
1632,0.1633,29,123,29,490735,185709,40823,85433,1.4708924724369534,0.31508582218911124
1633,0.1634,31,140,31,490875,185569,40854,85402,1.4697836142440754,0.31517025807189697
1634,0.1635,30,155,30,491030,185414,40884,85372,1.4685559498162464,0.31527479264068303
1635,0.1636,34,145,34,491175,185269,40918,85338,1.4674074895450513,0.31535769584674456
1636,0.1637,28,140,28,491315,185129,40946,85310,1.4662986313521733,0.31545006452471724
1637,0.1638,35,143,35,491458,184986,40981,85275,1.465166011912305,0.3155283226214659
1638,0.1639,30,160,30,491618,184826,41011,85245,1.463898745406159,0.315639220797494
1639,0.164,28,156,28,491774,184670,41039,85217,1.4626631605626663,0.3157506660194822
1640,0.1641,31,158,31,491932,184512,41070,85186,1.4614117348878468,0.3158569956024887
1641,0.1642,33,168,33,492100,184344,41103,85153,1.4600811050563933,0.3159701221163872
1642,0.1643,29,165,29,492265,184179,41132,85124,1.45877423647193,0.3160900546967542
1643,0.1644,36,135,36,492400,184044,41168,85088,1.4577049803573692,0.31615712735757917
1644,0.1645,36,167,36,492567,183877,41204,85052,1.456382270941579,0.3162619129956234
1645,0.1646,15,137,15,492704,183740,41219,85037,1.4552971739956913,0.3163849585343984
1646,0.1647,33,139,33,492843,183601,41252,85004,1.4541962362184768,0.31646469723199494
1647,0.1648,38,152,38,492995,183449,41290,84966,1.4529923330376378,0.3165471378276177
1648,0.1649,34,135,34,493130,183314,41324,84932,1.4519230769230769,0.31661981912125436
1649,0.165,31,146,31,493276,183168,41355,84901,1.4507666962362185,0.3167132342792341
1650,0.1651,31,166,31,493442,183002,41386,84870,1.4494519072360919,0.316830426472345
1651,0.1652,34,146,34,493588,182856,41420,84836,1.4482955265492332,0.31691645622581177
1652,0.1653,37,151,37,493739,182705,41457,84799,1.4470995437840577,0.317000867276751
1653,0.1654,31,151,31,493890,182554,41488,84768,1.4459035610188822,0.3171007249683902
1654,0.1655,28,146,28,494036,182408,41516,84740,1.4447471803320238,0.3172024495785108
1655,0.1656,36,164,36,494200,182244,41552,84704,1.4434482321632238,0.3173052429686681
1656,0.1657,34,166,34,494366,182078,41586,84670,1.4421334431630972,0.3174156882150944
1657,0.1658,37,147,37,494513,181931,41623,84633,1.4409691420605752,0.3174959859545925
1658,0.1659,40,132,40,494645,181799,41663,84593,1.4399236471930046,0.3175508273521727
1659,0.166,21,141,21,494786,181658,41684,84572,1.4388068685844633,0.31766517672689026
1660,0.1661,23,145,23,494931,181513,41707,84549,1.4376584083132682,0.3177793145958461
1661,0.1662,29,145,29,495076,181368,41736,84520,1.4365099480420733,0.31787820435672165
1662,0.1663,33,170,33,495246,181198,41769,84487,1.435163477379293,0.31799687599977416
1663,0.1664,23,140,23,495386,181058,41792,84464,1.434054619186415,0.3181054677201889
1664,0.1665,35,169,35,495555,180889,41827,84429,1.432716068939298,0.31821813823411904
1665,0.1666,33,131,33,495686,180758,41860,84396,1.4316784944873906,0.31829050287757304
1666,0.1667,28,151,28,495837,180607,41888,84368,1.430482511722215,0.31839984904236246
1667,0.1668,33,154,33,495991,180453,41921,84335,1.4292627677100493,0.31850008308533617
1668,0.1669,37,149,37,496140,180304,41958,84298,1.4280826257762007,0.3185841376860341
1669,0.167,28,150,28,496290,180154,41986,84270,1.4268945634266885,0.3186927056545548
1670,0.1671,30,155,30,496445,179999,42016,84240,1.4256668989988595,0.31880229640590524
1671,0.1672,31,146,31,496591,179853,42047,84209,1.424510518312001,0.31889859199733395
1672,0.1673,32,161,32,496752,179692,42079,84177,1.4232353313901913,0.31901056963872226
1673,0.1674,28,147,28,496899,179545,42107,84149,1.4220710302876696,0.31911609668782753
1674,0.1675,32,139,32,497038,179406,42139,84117,1.420970092510455,0.3192017395066085
1675,0.1676,30,153,30,497191,179253,42169,84087,1.4197582689139525,0.3193096377306904
1676,0.1677,30,146,30,497337,179107,42199,84057,1.418601888227094,0.3194091897067988
1677,0.1678,30,139,30,497476,178968,42229,84027,1.4175009504498797,0.31950037072948156
1678,0.1679,33,149,33,497625,178819,42262,83994,1.4163208085160308,0.31959606259964307
1679,0.168,32,156,32,497781,178663,42294,83962,1.4150852236725384,0.31970299857210854
1680,0.1681,46,144,46,497925,178519,42340,83916,1.4139446838170067,0.31975917846323854
1681,0.1682,25,141,25,498066,178378,42365,83891,1.4128279052084654,0.3198662441996576
1682,0.1683,39,136,39,498202,178242,42404,83852,1.4117507286782411,0.31993101711599653
1683,0.1684,33,141,33,498343,178101,42437,83819,1.4106339500696996,0.3200175626145388
1684,0.1685,25,126,25,498469,177975,42462,83794,1.4096359776961096,0.3201066589244716
1685,0.1686,34,132,34,498601,177843,42496,83760,1.408590482828539,0.32017981445166915
1686,0.1687,37,149,37,498750,177694,42533,83723,1.40741034089469,0.3202660882804102
1687,0.1688,28,151,28,498901,177543,42561,83695,1.4062143581295146,0.3203783523070916
1688,0.1689,33,138,33,499039,177405,42594,83662,1.4051213407679635,0.32046179716318035
1689,0.169,31,149,31,499188,177256,42625,83631,1.4039411988341148,0.32056407563427847
1690,0.1691,28,156,28,499344,177100,42653,83603,1.4027056139906222,0.3206829227128188
1691,0.1692,24,141,24,499485,176959,42677,83579,1.401588835382081,0.3207938957081117
1692,0.1693,32,142,32,499627,176817,42709,83547,1.400464136357876,0.3208853758584136
1693,0.1694,24,149,24,499776,176668,42733,83523,1.3992839944240274,0.32100649138517473
1694,0.1695,33,149,33,499925,176519,42766,83490,1.3981038524901788,0.32110426946759535
1695,0.1696,37,152,37,500077,176367,42803,83453,1.3968999493093397,0.3211954429989993
1696,0.1697,39,152,39,500229,176215,42842,83414,1.3956960461285008,0.3212815209394944
1697,0.1698,35,134,35,500363,176081,42877,83379,1.3946347104296033,0.3213558930085562
1698,0.1699,29,144,29,500507,175937,42906,83350,1.3934941705740718,0.3214584610875208
1699,0.17,35,144,35,500651,175793,42941,83315,1.39235363071854,0.32154545594887074
1700,0.1701,27,115,27,500766,175678,42968,83288,1.3914427829172475,0.3216175096344694
1701,0.1702,31,127,31,500893,175551,42999,83257,1.390436890127994,0.32169407437173503
1702,0.1703,32,166,32,501059,175385,43031,83225,1.3891221011278672,0.3218166350875836
1703,0.1704,32,135,32,501194,175250,43063,83193,1.3880528450133063,0.3219007672871774
1704,0.1705,30,149,30,501343,175101,43093,83163,1.3868727030794576,0.3220077130378218
1705,0.1706,36,137,36,501480,174964,43129,83127,1.3857876061335699,0.3220840711222011
1706,0.1707,28,158,28,501638,174806,43157,83099,1.3845361804587504,0.32220778969000213
1707,0.1708,35,138,35,501776,174668,43192,83064,1.3834431630971993,0.32228826843387703
1708,0.1709,26,157,26,501933,174511,43218,83038,1.3821996578380433,0.32241631689503747
1709,0.171,25,142,25,502075,174369,43243,83013,1.3810749588138385,0.3225283819381309
1710,0.1711,27,135,27,502210,174234,43270,82986,1.3800057026992776,0.3226265453697224
1711,0.1712,34,145,34,502355,174089,43304,82952,1.3788572424280827,0.322718943670465
1712,0.1713,37,158,37,502513,173931,43341,82915,1.3776058167532632,0.32281989986217424
1713,0.1714,28,143,28,502656,173788,43369,82887,1.376473197313395,0.3229258790299016
1714,0.1715,21,139,21,502795,173649,43390,82866,1.3753722595361804,0.32304543593941876
1715,0.1716,26,141,26,502936,173508,43416,82840,1.374255480927639,0.3231544619033501
1716,0.1717,21,130,21,503066,173378,43437,82819,1.3732258268913953,0.3232629578020039
1717,0.1718,23,135,23,503201,173243,43460,82796,1.3721565707768344,0.32337261120376193
1718,0.1719,32,131,32,503332,173112,43492,82764,1.371118996324927,0.3234535478122215
1719,0.172,33,143,33,503475,172969,43525,82731,1.3699863768850589,0.32354712553773957
1720,0.1721,27,135,27,503610,172834,43552,82704,1.368917120770498,0.3236465809390384
1721,0.1722,33,138,33,503748,172696,43585,82671,1.367824103408947,0.3237340768384325
1722,0.1723,27,111,27,503859,172585,43612,82644,1.366944937270308,0.3238033295589451
1723,0.1724,34,122,34,503981,172463,43646,82610,1.3659786465593715,0.32386806914099103
1724,0.1725,23,143,23,504124,172320,43669,82587,1.3648460271195033,0.3239887488378114
1725,0.1726,23,138,23,504262,172182,43692,82564,1.363753009757952,0.32410322438821415
1726,0.1727,31,123,31,504385,172059,43723,82533,1.3627787986313522,0.3241775075414781
1727,0.1728,19,169,19,504554,171890,43742,82514,1.3614402483842352,0.324342384553702
1728,0.1729,29,112,29,504666,171778,43771,82485,1.360553161829933,0.32440819151823114
1729,0.173,26,165,26,504831,171613,43797,82459,1.3592462932454694,0.3245497339336881
1730,0.1731,34,161,34,504992,171452,43831,82425,1.35797110632366,0.3246650937264896
1731,0.1732,24,135,24,505127,171317,43855,82401,1.356901850209099,0.3247739616424534
1732,0.1733,27,152,27,505279,171165,43882,82374,1.35569794702826,0.3248967614449848
1733,0.1734,22,137,22,505416,171028,43904,82352,1.3546128500823724,0.32501381324492856
1734,0.1735,21,141,21,505557,170887,43925,82331,1.3534960714738309,0.3251388131965342
1735,0.1736,32,141,32,505698,170746,43957,82299,1.3523792928652896,0.3252346420597127
1736,0.1737,29,155,29,505853,170591,43986,82270,1.3511516284374605,0.3253566188538367
1737,0.1738,28,155,28,506008,170436,44014,82242,1.3499239640096312,0.3254814427848883
1738,0.1739,34,140,34,506148,170296,44048,82208,1.3488151058167532,0.325571080062098
1739,0.174,37,112,37,506260,170184,44085,82171,1.347928019262451,0.3256166907729191
1740,0.1741,32,157,32,506417,170027,44117,82139,1.3466845140032948,0.3257338419929729
1741,0.1742,28,125,28,506542,169902,44145,82111,1.3456944620453681,0.3258204933872459
1742,0.1743,28,135,28,506677,169767,44173,82083,1.3446252059308073,0.32592019058963667
1743,0.1744,23,155,23,506832,169612,44196,82060,1.343397541502978,0.32605931529927845
1744,0.1745,42,136,42,506968,169476,44238,82018,1.3423203649727538,0.3261230884235807
1745,0.1746,43,159,43,507127,169317,44281,81975,1.341061018882271,0.32621412539993316
1746,0.1747,29,129,29,507256,169188,44310,81946,1.3400392852616905,0.32630388557503165
1747,0.1748,30,130,30,507386,169058,44340,81916,1.3390096312254467,0.32639237530580856
1748,0.1749,30,148,30,507534,168910,44370,81886,1.3378374097072614,0.3265044099586915
1749,0.175,31,127,31,507661,168783,44401,81855,1.3368315169180078,0.32658655112153784
1750,0.1751,32,156,32,507817,168627,44433,81823,1.3355959320745152,0.3267039329207427
1751,0.1752,22,144,22,507961,168483,44455,81801,1.3344553922189837,0.3268327180323153
1752,0.1753,32,130,32,508091,168353,44487,81769,1.33342573818274,0.3269164647651946
1753,0.1754,23,126,23,508217,168227,44510,81746,1.3324277658091497,0.3270193180863533
1754,0.1755,37,130,37,508347,168097,44547,81709,1.331398111772906,0.32708982170164047
1755,0.1756,40,131,40,508478,167966,44587,81669,1.3303605373209986,0.32715364432070826
1756,0.1757,30,127,30,508605,167839,44617,81639,1.329354644531745,0.3272392756074684
1757,0.1758,21,126,21,508731,167713,44638,81618,1.3283566721581548,0.32734798320305136
1758,0.1759,24,139,24,508870,167574,44662,81594,1.3272557343809404,0.3274658062030437
1759,0.176,25,142,25,509012,167432,44687,81569,1.3261310353567355,0.3275850297789969
1760,0.1761,34,154,34,509166,167278,44721,81535,1.3249112913445698,0.3276959001338354
1761,0.1762,20,126,20,509292,167152,44741,81515,1.3239133189709795,0.3278078715712177
1762,0.1763,31,120,31,509412,167032,44772,81484,1.32296286909137,0.3278823093885303
1763,0.1764,27,134,27,509546,166898,44799,81457,1.3219015333924724,0.3279861488594955
1764,0.1765,21,155,21,509701,166743,44820,81436,1.3206738689646433,0.32813412899560396
1765,0.1766,30,151,30,509852,166592,44850,81406,1.3194778861994678,0.32825264719876773
1766,0.1767,23,153,23,510005,166439,44873,81383,1.3182660626029654,0.32839295946284025
1767,0.1768,27,128,27,510133,166311,44900,81356,1.3172522493980483,0.32848946367501525
1768,0.1769,26,115,26,510248,166196,44926,81330,1.3163414015967558,0.32857154399941824
1769,0.177,31,127,31,510375,166069,44957,81299,1.3153355088075023,0.3286560913295172
1770,0.1771,18,126,18,510501,165943,44975,81281,1.314337536433912,0.32877471442901984
1771,0.1772,18,163,18,510664,165780,44993,81263,1.3130465086807757,0.328942734665625
1772,0.1773,31,110,31,510774,165670,45024,81232,1.3121752629578,0.32900503033592277
1773,0.1774,25,136,25,510910,165534,45049,81207,1.3110980864275756,0.3291183872968011
1774,0.1775,29,131,29,511041,165403,45078,81178,1.3100605119756685,0.32921433524886345
1775,0.1776,35,135,35,511176,165268,45113,81143,1.3089912558611076,0.3292994225095471
1776,0.1777,29,144,29,511320,165124,45142,81114,1.307850716005576,0.3294130069282564
1777,0.1778,39,128,39,511448,164996,45181,81075,1.306836902800659,0.32947807746544694
1778,0.1779,32,148,32,511596,164848,45213,81043,1.3056646812824737,0.32958912688955677
1779,0.178,31,117,31,511713,164731,45244,81012,1.3047379926498544,0.3296614756066297
1780,0.1781,26,129,26,511842,164602,45270,80986,1.303716259029274,0.32976366923465317
1781,0.1782,32,127,32,511969,164475,45302,80954,1.3027103662400203,0.32984692110549285
1782,0.1783,38,129,38,512098,164346,45340,80916,1.30168863261944,0.32991657900530863
1783,0.1784,23,129,23,512227,164217,45363,80893,1.3006668989988595,0.3300273346660683
1784,0.1785,25,116,25,512343,164101,45388,80868,1.2997481307819034,0.33011523907106616
1785,0.1786,24,129,24,512472,163972,45412,80844,1.298726397161323,0.33022351480295403
1786,0.1787,32,137,32,512609,163835,45444,80812,1.2976413002154352,0.3303208296034695
1787,0.1788,36,121,36,512730,163714,45480,80776,1.2966829299201623,0.3303857008466604
1788,0.1789,31,139,31,512869,163575,45511,80745,1.2955819921429477,0.3304887033398821
1789,0.179,28,126,28,512995,163449,45539,80717,1.2945840197693574,0.3305824725801299
1790,0.1791,32,134,32,513129,163315,45571,80685,1.2935226840704601,0.3306762295081967
1791,0.1792,30,146,30,513275,163169,45601,80655,1.2923663033836015,0.3307918826694665
1792,0.1793,23,122,23,513397,163047,45624,80632,1.291400012672665,0.330894332297818
1793,0.1794,30,127,30,513524,162920,45654,80602,1.2903941198834115,0.3309844695756441
1794,0.1795,31,151,31,513675,162769,45685,80571,1.289198137118236,0.33110462727048573
1795,0.1796,21,122,21,513797,162647,45706,80550,1.2882318464072995,0.3312129672652212
1796,0.1797,36,160,36,513957,162487,45742,80514,1.2869645799011533,0.33133196982728463
1797,0.1798,27,122,27,514079,162365,45769,80487,1.2859982891902166,0.3314240772157528
1798,0.1799,28,112,28,514191,162253,45797,80459,1.2851112026359144,0.33149988463693597
1799,0.18,28,140,28,514331,162113,45825,80431,1.2840023444430364,0.33161405765551816
1800,0.1801,29,115,29,514446,161998,45854,80402,1.2830914966417437,0.3316914191419142
1801,0.1802,25,126,25,514572,161872,45879,80377,1.2820935242681535,0.3317949712898712
1802,0.1803,38,133,38,514705,161739,45917,80339,1.2810401089849195,0.3318723717149018
1803,0.1804,25,131,25,514836,161608,45942,80314,1.2800025345330124,0.33198303585453165
1804,0.1805,31,127,31,514963,161481,45973,80283,1.2789966417437588,0.3320717724723284
1805,0.1806,25,116,25,515079,161365,45998,80258,1.2780778735268026,0.3321620872185181
1806,0.1807,28,131,28,515210,161234,46026,80230,1.2770402990748955,0.3322648510751085
1807,0.1808,26,143,26,515353,161091,46052,80204,1.2759076796350273,0.33238981329907374
1808,0.1809,31,125,31,515478,160966,46083,80173,1.2749176276771006,0.33247628960889775
1809,0.181,29,105,29,515583,160861,46112,80144,1.274085984032442,0.3325408186552146
1810,0.1811,34,132,34,515715,160729,46146,80110,1.2730404891648714,0.332628851639477
1811,0.1812,27,140,27,515855,160589,46173,80083,1.2719316309719935,0.33274747374019414
1812,0.1813,34,112,34,515967,160477,46207,80049,1.271044544417691,0.3328080955904975
1813,0.1814,28,131,28,516098,160346,46235,80021,1.2700069699657839,0.3329117557734631
1814,0.1815,24,132,24,516230,160214,46259,79997,1.2689614750982132,0.3330280461760702
1815,0.1816,32,115,32,516345,160099,46291,79965,1.2680506272969205,0.3330986736870168
1816,0.1817,29,104,29,516449,159995,46320,79936,1.2672269040679254,0.33316245087129215
1817,0.1818,23,123,23,516572,159872,46343,79913,1.2662526929413256,0.33326938715933024
1818,0.1819,26,112,26,516684,159760,46369,79887,1.2653656063870231,0.3333528064194419
1819,0.182,29,124,29,516808,159636,46398,79858,1.2643834748447598,0.3334446791986438
1820,0.1821,24,119,24,516927,159517,46422,79834,1.2634409453808135,0.3335436242171539
1821,0.1822,26,138,26,517065,159379,46448,79808,1.2623479280192624,0.33366361884216117
1822,0.1823,31,117,31,517182,159262,46479,79777,1.261421239386643,0.3337405193294818
1823,0.1824,25,107,25,517289,159155,46504,79752,1.2605737549106577,0.33382027316068597
1824,0.1825,24,116,24,517405,159039,46528,79728,1.2596549866937017,0.3339154908341605
1825,0.1826,38,121,38,517526,158918,46566,79690,1.2586966163984286,0.33397874337826056
1826,0.1827,41,123,41,517649,158795,46607,79649,1.2577224052718288,0.33403650332992235
1827,0.1828,31,119,31,517768,158676,46638,79618,1.2567798758078823,0.3341166793960402
1828,0.1829,21,148,21,517916,158528,46659,79597,1.2556076542896972,0.3342656167979003
1829,0.183,28,123,28,518039,158405,46687,79569,1.2546334431630972,0.3343600561405868
1830,0.1831,30,120,30,518159,158285,46717,79539,1.2536829932834874,0.3344447995156082
1831,0.1832,35,120,35,518279,158165,46752,79504,1.2527325434038779,0.3345156499164805
1832,0.1833,22,125,22,518404,158040,46774,79482,1.2517424914459512,0.3346300553211913
1833,0.1834,20,135,20,518539,157905,46794,79462,1.2506732353313903,0.33476431011892976
1834,0.1835,33,113,33,518652,157792,46827,79429,1.2497782283614245,0.33483123332251363
1835,0.1836,24,138,24,518790,157654,46851,79405,1.2486852109998732,0.33495880772297193
1836,0.1837,31,140,31,518930,157514,46882,79374,1.2475763528069954,0.33506973759751446
1837,0.1838,41,118,41,519048,157396,46923,79333,1.2466417437587125,0.3351215947349078
1838,0.1839,33,129,33,519177,157267,46956,79300,1.245620010138132,0.3352115891058347
1839,0.184,26,119,26,519296,157148,46982,79274,1.2446774806741858,0.33530720491324834
1840,0.1841,34,152,34,519448,156996,47016,79240,1.2434735774933467,0.33542728457982696
1841,0.1842,31,131,31,519579,156865,47047,79209,1.2424360030414396,0.3355261485805298
1842,0.1843,31,109,31,519688,156756,47078,79178,1.2415726777341274,0.3355938525180771
1843,0.1844,31,136,31,519824,156620,47109,79147,1.2404955012039032,0.33570007677071007
1844,0.1845,38,115,38,519939,156505,47147,79109,1.2395846534026105,0.33575678864583597
1845,0.1846,38,128,38,520067,156377,47185,79071,1.2385708401976936,0.33583211579626926
1846,0.1847,28,130,28,520197,156247,47213,79043,1.2375411861614498,0.3359386289260062
1847,0.1848,24,140,24,520337,156107,47237,79019,1.2364323279685718,0.3360708726385002
1848,0.1849,32,114,32,520451,155993,47269,78987,1.2355294005829427,0.3361435015746021
1849,0.185,28,129,28,520580,155864,47297,78959,1.2345076669623622,0.3362490045693991
1850,0.1851,26,132,26,520712,155732,47323,78933,1.2334621720947916,0.33636460486225045
1851,0.1852,21,115,21,520827,155617,47344,78912,1.232551324293499,0.3364701167019857
1852,0.1853,22,132,22,520959,155485,47366,78890,1.2315058294259282,0.33659733333333336
1853,0.1854,29,145,29,521104,155340,47395,78861,1.2303573691547331,0.33672358358845605
1854,0.1855,25,140,25,521244,155200,47420,78836,1.2292485109618552,0.33685415918918454
1855,0.1856,31,111,31,521355,155089,47451,78805,1.2283693448232162,0.33692612893019913
1856,0.1857,31,107,31,521462,154982,47482,78774,1.227521860347231,0.33699241944591796
1857,0.1858,34,128,34,521590,154854,47516,78740,1.226508047142314,0.33708057569971833
1858,0.1859,38,114,38,521704,154740,47554,78702,1.2256051197566848,0.3371372760685738
1859,0.186,37,115,37,521819,154625,47591,78665,1.2246942719553922,0.3371983368339835
1860,0.1861,31,136,31,521955,154489,47622,78634,1.223617095425168,0.33730691523358913
1861,0.1862,31,123,31,522078,154366,47653,78603,1.222642884298568,0.3373968210362752
1862,0.1863,25,106,25,522184,154260,47678,78578,1.2218033202382461,0.3374792774375317
1863,0.1864,26,127,26,522311,154133,47704,78552,1.2207974274489926,0.33758944495777554
1864,0.1865,32,131,32,522442,154002,47736,78520,1.2197598529970852,0.33768847678929304
1865,0.1866,28,125,28,522567,153877,47764,78492,1.2187698010391586,0.33779032487121774
1866,0.1867,26,134,26,522701,153743,47790,78466,1.217708465340261,0.3379111059433528
1867,0.1868,25,131,25,522832,153612,47815,78441,1.216670890888354,0.3380305361275226
1868,0.1869,22,137,22,522969,153475,47837,78419,1.2155857939424661,0.3381674385710713
1869,0.187,30,98,30,523067,153377,47867,78389,1.2148095932074516,0.33822476118153655
1870,0.1871,24,120,24,523187,153257,47891,78365,1.2138591433278418,0.33833141929523103
1871,0.1872,27,120,27,523307,153137,47918,78338,1.2129086934482323,0.33842963602980886
1872,0.1873,38,131,38,523438,153006,47956,78300,1.211871118996325,0.33851261964670176
1873,0.1874,23,101,23,523539,152905,47979,78277,1.2110711570143202,0.3385947002794335
1874,0.1875,30,118,30,523657,152787,48009,78247,1.2101365479660373,0.3386817524693335
1875,0.1876,32,110,32,523767,152677,48041,78215,1.2092653022430617,0.33875145089479064
1876,0.1877,24,121,24,523888,152556,48065,78191,1.2083069319477886,0.33886031020988355
1877,0.1878,22,115,22,524003,152441,48087,78169,1.207396084146496,0.3389662200251507
1878,0.1879,24,154,24,524157,152287,48111,78145,1.2061763401343302,0.3391239064018886
1879,0.188,30,125,30,524282,152162,48141,78115,1.2051862881764035,0.33922189363245137
1880,0.1881,37,141,37,524423,152021,48178,78078,1.2040695095678622,0.33932350857674304
1881,0.1882,29,115,29,524538,151906,48207,78049,1.2031586617665695,0.3394098845426279
1882,0.1883,24,134,24,524672,151772,48231,78025,1.202097326067672,0.33953881034130123
1883,0.1884,36,115,36,524787,151657,48267,77989,1.2011864782663795,0.339605305557249
1884,0.1885,22,106,22,524893,151551,48289,77967,1.2003469142060574,0.3396988471492432
1885,0.1886,35,133,35,525026,151418,48324,77932,1.1992934989228234,0.33979507303248313
1886,0.1887,23,122,23,525148,151296,48347,77909,1.198327208211887,0.339909687834035
1887,0.1888,31,106,31,525254,151190,48378,77878,1.1974876441515652,0.33997764855850665
1888,0.1889,31,114,31,525368,151076,48409,77847,1.1965847167659358,0.34005757394407726
1889,0.189,38,123,38,525491,150953,48447,77809,1.195610505639336,0.3401307909530429
1890,0.1891,33,120,33,525611,150833,48480,77776,1.1946600557597262,0.340214077311042
1891,0.1892,29,121,29,525732,150712,48509,77747,1.193701685464453,0.34031051523468103
1892,0.1893,31,94,31,525826,150618,48540,77716,1.1929571663920921,0.3403610500407298
1893,0.1894,29,128,29,525954,150490,48569,77687,1.1919433531871753,0.34046814534330805
1894,0.1895,23,139,23,526093,150351,48592,77664,1.1908424154099606,0.34060917044931255
1895,0.1896,26,107,26,526200,150244,48618,77638,1.1899949309339755,0.34069386787899003
1896,0.1897,26,110,26,526310,150134,48644,77612,1.1891236852109999,0.34078315316185576
1897,0.1898,31,134,31,526444,150000,48675,77581,1.1880623495121023,0.34089401136298725
1898,0.1899,34,132,34,526576,149868,48709,77547,1.1870168546445317,0.3409933381703054
1899,0.19,23,121,23,526697,149747,48732,77524,1.1860584843492588,0.3411081924222624
1900,0.1901,30,130,30,526827,149617,48762,77494,1.1850288303130148,0.3412164095970693
1901,0.1902,29,116,29,526943,149501,48791,77465,1.1841100620960587,0.34130662742437196
1902,0.1903,18,117,18,527060,149384,48809,77447,1.1831833734634394,0.3414304041334738
1903,0.1904,30,121,30,527181,149263,48839,77417,1.1822250031681663,0.34152549850008823
1904,0.1905,39,109,39,527290,149154,48878,77378,1.1813616778608542,0.34157646601804603
1905,0.1906,25,108,25,527398,149046,48903,77353,1.1805062729692055,0.3416667034748387
1906,0.1907,30,117,30,527515,148929,48933,77323,1.179579584336586,0.3417560949737461
1907,0.1908,21,132,21,527647,148797,48954,77302,1.1785340894690153,0.34189447985174637
1908,0.1909,22,101,22,527748,148696,48976,77280,1.1777341274870106,0.3419832194569335
1909,0.191,32,115,32,527863,148581,49008,77248,1.1768232796857179,0.342064128167773
1910,0.1911,26,107,26,527970,148474,49034,77222,1.1759757952097325,0.3421505033319155
1911,0.1912,24,127,24,528097,148347,49058,77198,1.174969902420479,0.3422731605666275
1912,0.1913,27,125,27,528222,148222,49085,77171,1.1739798504625523,0.3423841911683149
1913,0.1914,28,138,28,528360,148084,49113,77143,1.1728868331010012,0.3425122210036985
1914,0.1915,32,154,32,528514,147930,49145,77111,1.1716670890888354,0.3426531165432077
1915,0.1916,26,110,26,528624,147820,49171,77085,1.1707958433658598,0.34274471443498367
1916,0.1917,25,113,25,528737,147707,49196,77060,1.169900836395894,0.34284392281785137
1917,0.1918,20,126,20,528863,147581,49216,77040,1.1689028640223038,0.3429777269266898
1918,0.1919,29,132,29,528995,147449,49245,77011,1.1678573691547331,0.34309453800231665
1919,0.192,22,125,22,529120,147324,49267,76989,1.1668673171968065,0.3432213023765899
1920,0.1921,21,126,21,529246,147198,49288,76968,1.1658693448232162,0.343352693985707
1921,0.1922,24,112,24,529358,147086,49312,76944,1.164982258268914,0.3434540016962014
1922,0.1923,33,114,33,529472,146972,49345,76911,1.1640793308832849,0.3435321127553231
1923,0.1924,12,119,12,529591,146853,49357,76899,1.1631368014193384,0.3436796095677357
1924,0.1925,34,109,34,529700,146744,49391,76865,1.1622734761120264,0.34374734469542817
1925,0.1926,25,114,25,529814,146630,49416,76840,1.1613705487263972,0.3438492862576632
1926,0.1927,19,125,19,529939,146505,49435,76821,1.1603804967684703,0.3439859219257946
1927,0.1928,36,132,36,530071,146373,49471,76785,1.1593350019008997,0.34408356411152635
1928,0.1929,22,116,22,530187,146257,49493,76763,1.1584162336839436,0.3441978297910501
1929,0.193,23,117,23,530304,146140,49516,76740,1.1574895450513243,0.34431083991385497
1930,0.1931,30,124,30,530428,146016,49546,76710,1.156507413509061,0.3444142129791762
1931,0.1932,22,114,22,530542,145902,49568,76688,1.1556044861234318,0.3445258097848061
1932,0.1933,24,111,24,530653,145791,49592,76664,1.1547253199847929,0.3446270032141332
1933,0.1934,32,103,32,530756,145688,49624,76632,1.153909517171461,0.34469233537243615
1934,0.1935,28,121,28,530877,145567,49652,76604,1.1529511468761882,0.3447974758181761
1935,0.1936,28,117,28,530994,145450,49680,76576,1.1520244582435686,0.34489654364804123
1936,0.1937,26,114,26,531108,145336,49706,76550,1.1511215308579394,0.3449969804313927
1937,0.1938,28,114,28,531222,145222,49734,76522,1.1502186034723103,0.3450916372032614
1938,0.1939,31,112,31,531334,145110,49765,76491,1.1493315169180078,0.34517443513341545
1939,0.194,32,107,32,531441,145003,49797,76459,1.1484840324420225,0.34524658857953056
1940,0.1941,34,132,34,531573,144871,49831,76425,1.1474385375744518,0.3453519268310317
1941,0.1942,35,128,35,531701,144743,49866,76390,1.146424724369535,0.3454482144229943
1942,0.1943,28,125,28,531826,144618,49894,76362,1.1454346724116082,0.3455606842248167
1943,0.1944,32,112,32,531938,144506,49926,76330,1.1445475858573058,0.3456411092394356
1944,0.1945,22,116,22,532054,144390,49948,76308,1.1436288176403497,0.3457575510426012
1945,0.1946,25,125,25,532179,144265,49973,76283,1.142638765682423,0.3458793550610298
1946,0.1947,25,114,25,532293,144151,49998,76258,1.141735838296794,0.34598405691237655
1947,0.1948,28,116,28,532409,144035,50026,76230,1.1408170700798377,0.3460831271423059
1948,0.1949,23,109,23,532518,143926,50049,76207,1.1399537447725256,0.34618616927039564
1949,0.195,36,113,36,532631,143813,50085,76171,1.1390587378025598,0.34625700050912794
1950,0.1951,28,119,28,532750,143694,50113,76143,1.1381162083386136,0.3463611675923525
1951,0.1952,26,120,26,532870,143574,50139,76117,1.137165758459004,0.3464730007146401
1952,0.1953,23,121,23,532991,143453,50162,76094,1.136207388163731,0.3465954898040055
1953,0.1954,24,116,24,533107,143337,50186,76070,1.1352886199467749,0.346707260935157
1954,0.1955,29,110,29,533217,143227,50215,76041,1.1344173742237993,0.3467947899374282
1955,0.1956,34,102,34,533319,143125,50249,76007,1.133609491826131,0.3468548637351003
1956,0.1957,26,122,26,533441,143003,50275,75981,1.1326432011151946,0.34697055492638734
1957,0.1958,24,113,24,533554,142890,50299,75957,1.1317481941452288,0.34707809565586917
1958,0.1959,28,138,28,533692,142752,50327,75929,1.1306551767836777,0.3472135210649302
1959,0.196,27,108,27,533800,142644,50354,75902,1.129799771892029,0.34730445764278456
1960,0.1961,37,110,37,533910,142534,50391,75865,1.1289285261690534,0.34736880663373
1961,0.1962,27,95,27,534005,142439,50418,75838,1.128176086681029,0.34743926295486927
1962,0.1963,31,131,31,534136,142308,50449,75807,1.1271385122291218,0.34755518877656283
1963,0.1964,29,104,29,534240,142204,50478,75778,1.1263147890001268,0.3476342083291281
1964,0.1965,27,132,27,534372,142072,50505,75751,1.1252692941325562,0.34776401022848824
1965,0.1966,26,138,26,534510,141934,50531,75725,1.1241762767710048,0.3479065878277489
1966,0.1967,33,111,33,534621,141823,50564,75692,1.123297110632366,0.34798519642323517
1967,0.1968,23,119,23,534740,141704,50587,75669,1.1223545811684197,0.3481067105850313
1968,0.1969,27,137,27,534877,141567,50614,75642,1.121269484222532,0.34824523845697003
1969,0.197,24,114,24,534991,141453,50638,75618,1.1203665568369028,0.34835606783034123
1970,0.1971,24,109,24,535100,141344,50662,75594,1.1195032315295907,0.34845900672081426
1971,0.1972,21,138,21,535238,141206,50683,75573,1.1184102141680394,0.34861771666074665
1972,0.1973,32,112,32,535350,141094,50715,75541,1.1175231276137372,0.34870173333025595
1973,0.1974,32,136,32,535486,140958,50747,75509,1.116445951083513,0.3488245321457774
1974,0.1975,31,130,31,535616,140828,50778,75478,1.115416297047269,0.3489408523110778
1975,0.1976,31,118,31,535734,140710,50809,75447,1.1144816879989863,0.34903796777342394
1976,0.1977,27,107,27,535841,140603,50836,75420,1.113634203523001,0.349129490841253
1977,0.1978,28,116,28,535957,140487,50864,75392,1.1127154353060449,0.3492326720060775
1978,0.1979,28,131,28,536088,140356,50892,75364,1.1116778608541376,0.3493602818468385
1979,0.198,29,134,29,536222,140222,50921,75335,1.1106165251552402,0.3494899260984334
1980,0.1981,31,106,31,536328,140116,50952,75304,1.1097769610949182,0.3495682852102869
1981,0.1982,35,111,35,536439,140005,50987,75269,1.1088977949562793,0.34964278082815387
1982,0.1983,35,116,35,536555,139889,51022,75234,1.1079790267393232,0.3497255058733841
1983,0.1984,36,107,36,536662,139782,51058,75198,1.1071315422633379,0.3497906782026235
1984,0.1985,43,113,43,536775,139669,51101,75155,1.1062365352933723,0.34984452388932336
1985,0.1986,32,117,32,536892,139552,51133,75123,1.1053098466607527,0.34993827879352507
1986,0.1987,31,110,31,537002,139442,51164,75092,1.1044386009377771,0.35002377245564803
1987,0.1988,25,115,25,537117,139327,51189,75067,1.1035277531364847,0.35013573141039395
1988,0.1989,26,100,26,537217,139227,51215,75041,1.1027357115701433,0.35022028487688317
1989,0.199,20,109,20,537326,139118,51235,75021,1.101872386262831,0.3503378646580025
1990,0.1991,22,100,22,537426,139018,51257,74999,1.1010803446964896,0.35043477854562954
1991,0.1992,27,105,27,537531,138913,51284,74972,1.1002487010518311,0.35052481473689134
1992,0.1993,41,106,41,537637,138807,51325,74931,1.0994091369915093,0.35057406731605983
1993,0.1994,35,115,35,537752,138692,51360,74896,1.0984982891902166,0.3506564039178231
1994,0.1995,22,102,22,537854,138590,51382,74874,1.0976904067925484,0.3507570363152569
1995,0.1996,39,131,39,537985,138459,51421,74835,1.0966528323406413,0.3508537511603702
1996,0.1997,33,109,33,538094,138350,51454,74802,1.095789507033329,0.35093266776760246
1997,0.1998,24,115,24,538209,138235,51478,74778,1.0948786592320365,0.3510489970095722
1998,0.1999,33,108,33,538317,138127,51511,74745,1.0940232543403878,0.3511264985531211
1999,0.2,25,100,25,538417,138027,51536,74720,1.0932312127740464,0.35121529328263146
2000,0.2001,31,111,31,538528,137916,51567,74689,1.0923520466354075,0.3513040615225418
2001,0.2002,25,115,25,538643,137801,51592,74664,1.0914411988341148,0.3514178805920975
2002,0.2003,34,89,34,538732,137712,51626,74630,1.090736281840071,0.3514613218298782
2003,0.2004,30,94,30,538826,137618,51656,74600,1.08999176276771,0.3515253183047621
2004,0.2005,20,93,20,538919,137525,51676,74580,1.0892551641110126,0.35161830225595814
2005,0.2006,27,113,27,539032,137412,51703,74553,1.0883601571410468,0.35172316184275704
2006,0.2007,23,111,23,539143,137301,51726,74530,1.087480991002408,0.35183707767040706
2007,0.2008,31,103,31,539246,137198,51757,74499,1.086665188189076,0.3519133478509379
2008,0.2009,34,129,34,539375,137069,51791,74465,1.0856434545684956,0.3520237881380771
2009,0.201,34,117,34,539492,136952,51825,74431,1.0847167659358763,0.35211440844344155
2010,0.2011,32,105,32,539597,136847,51857,74399,1.0838851222912178,0.35219128409532013
2011,0.2012,29,109,29,539706,136738,51886,74370,1.0830217969839058,0.35228413892415256
2012,0.2013,28,115,28,539821,136623,51914,74342,1.082110949182613,0.35239020690635886
2013,0.2014,25,108,25,539929,136515,51939,74317,1.0812555442909644,0.3524939288153601
2014,0.2015,41,114,41,540043,136401,51980,74276,1.0803526169053352,0.35255865614186643
2015,0.2016,18,117,18,540160,136284,51998,74258,1.0794259282727157,0.3526992239078189
2016,0.2017,22,117,22,540277,136167,52020,74236,1.0784992396400963,0.3528276688070037
2017,0.2018,26,95,26,540372,136072,52046,74210,1.077746800152072,0.35290704862993505
2018,0.2019,27,122,27,540494,135950,52073,74183,1.0767805094411356,0.3530287960482171
2019,0.202,30,128,30,540622,135822,52103,74153,1.0757666962362185,0.3531515656625789
2020,0.2021,36,124,36,540746,135698,52139,74117,1.0747845646939551,0.3532492910421085
2021,0.2022,31,146,31,540892,135552,52170,74086,1.0736281840070967,0.3533996699071733
2022,0.2023,28,107,28,540999,135445,52198,74058,1.0727806995311113,0.353493744719646
2023,0.2024,26,119,26,541118,135326,52224,74032,1.071838170067165,0.3536143830185615
2024,0.2025,24,111,24,541229,135215,52248,74008,1.0709590039285262,0.3537278406293763
2025,0.2026,26,120,26,541349,135095,52274,73982,1.0700085540489166,0.3538504952720768
2026,0.2027,25,120,25,541469,134975,52299,73957,1.0690581041693068,0.3539764133785155
2027,0.2028,18,122,18,541591,134853,52317,73939,1.0680918134583703,0.3541275527798
2028,0.2029,28,133,28,541724,134720,52345,73911,1.0670383981751361,0.3542666238478462
2029,0.203,28,96,28,541820,134624,52373,73883,1.0662780382714485,0.35434301965881243
2030,0.2031,31,100,31,541920,134524,52404,73852,1.0654859967051071,0.35441701539524706
2031,0.2032,25,92,25,542012,134432,52429,73827,1.064757318464073,0.35449608420284356
2032,0.2033,27,111,27,542123,134321,52456,73800,1.0638781523254341,0.35460140975682414
2033,0.2034,33,136,33,542259,134185,52489,73767,1.0628009757952097,0.3547308994383319
2034,0.2035,26,111,26,542370,134074,52515,73741,1.0619218096565708,0.3548396410268749
2035,0.2036,30,85,30,542455,133989,52545,73711,1.0612485743251805,0.35489167067886374
2036,0.2037,27,117,27,542572,133872,52572,73684,1.0603218856925611,0.355007805122473
2037,0.2038,33,109,33,542681,133763,52605,73651,1.059458560385249,0.3550917488694109
2038,0.2039,30,98,30,542779,133665,52635,73621,1.0586823596502344,0.3551662919830572
2039,0.204,36,109,36,542888,133556,52671,73585,1.0578190343429223,0.3552411159548327
2040,0.2041,29,124,29,543012,133432,52700,73556,1.056836902800659,0.3553635959572536
2041,0.2042,34,118,34,543130,133314,52734,73522,1.055902293752376,0.35546036473341197
2042,0.2043,19,125,19,543255,133189,52753,73503,1.0549122417944494,0.35561608577013143
2043,0.2044,24,116,24,543371,133073,52777,73479,1.0539934735774934,0.35574092722413725
2044,0.2045,29,96,29,543467,132977,52806,73450,1.0532331136738056,0.355815857421752
2045,0.2046,21,111,21,543578,132866,52827,73429,1.0523539475351666,0.35594173392471945
2046,0.2047,25,92,25,543670,132774,52852,73404,1.0516252692941326,0.3560224660245031
2047,0.2048,26,101,26,543771,132673,52878,73378,1.0508253073121276,0.3561157189239557
2048,0.2049,26,100,26,543871,132573,52904,73352,1.0500332657457863,0.35620735704746875
2049,0.205,24,110,24,543981,132463,52928,73328,1.049162020022811,0.35632267689063174
2050,0.2051,24,109,24,544090,132354,52952,73304,1.0482986947154986,0.35643641385212343
2051,0.2052,28,119,28,544209,132235,52980,73276,1.0473561652515524,0.3565551235700279
2052,0.2053,21,94,21,544303,132141,53001,73255,1.0466116461791914,0.3566525151414828
2053,0.2054,29,102,29,544405,132039,53030,73226,1.0458037637815232,0.3567388497795533
2054,0.2055,33,107,33,544512,131932,53063,73193,1.044956279305538,0.3568214503351615
2055,0.2056,32,109,32,544621,131823,53095,73161,1.0440929539982258,0.3569107832806463
2056,0.2057,20,102,20,544723,131721,53115,73141,1.0432850716005575,0.35702570510880494
2057,0.2058,30,87,30,544810,131634,53145,73111,1.0425959954378405,0.3570832010549708
2058,0.2059,22,103,22,544913,131531,53167,73089,1.041780192624509,0.3571938226957287
2059,0.206,22,112,22,545025,131419,53189,73067,1.0408931060702065,0.35732030554659
2060,0.2061,22,113,22,545138,131306,53211,73045,1.0399980991002409,0.357448703456308
2061,0.2062,33,102,33,545240,131204,53244,73012,1.0391902167025726,0.35752340658910176
2062,0.2063,33,110,33,545350,131094,53277,72979,1.038318970979597,0.35761222699720197
2063,0.2064,25,86,25,545436,131008,53302,72954,1.0376378152325434,0.35768427452172463
2064,0.2065,31,100,31,545536,130908,53333,72923,1.036845773666202,0.3577620675952137
2065,0.2066,18,103,18,545639,130805,53351,72905,1.0360299708528704,0.35788621078984834
2066,0.2067,42,102,42,545741,130703,53393,72863,1.0352220884552021,0.3579330536533606
2067,0.2068,35,106,35,545847,130597,53428,72828,1.0343825243948803,0.3580090942607841
2068,0.2069,43,107,43,545954,130490,53471,72785,1.033535039918895,0.35806173902349037
2069,0.207,23,117,23,546071,130373,53494,72762,1.0326083512862756,0.35819528884731827
2070,0.2071,33,119,33,546190,130254,53527,72729,1.0316658218223291,0.35830094145815167
2071,0.2072,30,100,30,546290,130154,53557,72699,1.0308737802559877,0.35838267119539763
2072,0.2073,27,116,27,546406,130038,53584,72672,1.0299550120390317,0.35850229391741895
2073,0.2074,22,101,22,546507,129937,53606,72650,1.029155050057027,0.3586113620321146
2074,0.2075,26,84,26,546591,129853,53632,72624,1.0284897351413003,0.3586777757473688
2075,0.2076,25,94,25,546685,129759,53657,72599,1.0277452160689393,0.3587651587780073
2076,0.2077,29,115,29,546800,129644,53686,72570,1.0268343682676466,0.35887722907414915
2077,0.2078,28,117,28,546917,129527,53714,72542,1.0259076796350273,0.3589961844716409
2078,0.2079,19,100,19,547017,129427,53733,72523,1.0251156380686859,0.3591136419905917
2079,0.208,33,99,33,547116,129328,53766,72490,1.0243315169180078,0.3591850082747822
2080,0.2081,23,110,23,547226,129218,53789,72467,1.0234602711950322,0.3593078315194487
2081,0.2082,29,106,29,547332,129112,53818,72438,1.0226207071347104,0.35940461423964276
2082,0.2083,36,112,36,547444,129000,53854,72402,1.021733620580408,0.35948997527333393
2083,0.2084,30,119,30,547563,128881,53884,72372,1.0207910911164617,0.3596070617580856
2084,0.2085,19,101,19,547664,128780,53903,72353,1.019991129134457,0.35972714571949904
2085,0.2086,21,110,21,547774,128670,53924,72332,1.0191198834114814,0.3598571158495935
2086,0.2087,23,86,23,547860,128584,53947,72309,1.0184387276644278,0.35993787737750943
2087,0.2088,30,97,30,547957,128487,53977,72279,1.0176704473450766,0.36001613819072953
2088,0.2089,25,102,25,548059,128385,54002,72254,1.0168625649474083,0.3601194184580266
2089,0.209,28,106,28,548165,128279,54030,72226,1.0160230008870865,0.36022044338046433
2090,0.2091,24,98,24,548263,128181,54054,72202,1.015246800152072,0.3603199872244652
2091,0.2092,21,79,21,548342,128102,54075,72181,1.0146210873146624,0.360395041016961
2092,0.2093,37,132,37,548474,127970,54112,72144,1.0135755924470917,0.36051450673116325
2093,0.2094,27,103,27,548577,127867,54139,72117,1.01275978963376,0.36061384910792865
2094,0.2095,29,93,29,548670,127774,54168,72088,1.0120231909770625,0.36068887532397353
2095,0.2096,24,100,24,548770,127674,54192,72064,1.0112311494107211,0.3607926383562467
2096,0.2097,40,104,40,548874,127570,54232,72024,1.010407426181726,0.3608525306371935
2097,0.2098,24,86,24,548960,127484,54256,72000,1.0097262704346723,0.36093120250245636
2098,0.2099,27,99,27,549059,127385,54283,71973,1.0089421492839945,0.3610238866762307
2099,0.21,23,98,23,549157,127287,54306,71950,1.0081659485489798,0.36112770218383133
2100,0.2101,32,104,32,549261,127183,54338,71918,1.0073422253199849,0.3612136553809373
2101,0.2102,38,105,38,549366,127078,54376,71880,1.0065105816753264,0.3612822806823551
2102,0.2103,21,98,21,549464,126980,54397,71859,1.0057343809403116,0.3613928857014972
2103,0.2104,24,114,24,549578,126866,54421,71835,1.0048314535546825,0.3615230924856946
2104,0.2105,18,88,18,549666,126778,54439,71817,1.0041344569763022,0.3616254185654221
2105,0.2106,33,107,33,549773,126671,54472,71784,1.0032869725003168,0.361714242523494
2106,0.2107,32,114,32,549887,126557,54504,71752,1.0023840451146877,0.36181918117685025
2107,0.2108,28,87,28,549974,126470,54532,71724,1.0016949689519705,0.36188784726076473
2108,0.2109,37,113,37,550087,126357,54569,71687,1.0007999619820047,0.3619751166407465
2109,0.211,41,95,41,550182,126262,54610,71646,1.0000475224939804,0.36201669462578573
2110,0.2111,27,113,27,550295,126149,54637,71619,0.9991525155240147,0.362136442700538
2111,0.2112,30,98,30,550393,126051,54667,71589,0.9983763147890001,0.3622191863995143
2112,0.2113,23,77,23,550470,125974,54690,71566,0.9977664427829173,0.3622861192669839
2113,0.2114,29,103,29,550573,125871,54719,71537,0.9969506399695856,0.3623814637704652
2114,0.2115,14,91,14,550664,125780,54733,71523,0.9962298821442149,0.3625033577796587
2115,0.2116,24,99,24,550763,125681,54757,71499,0.995445760993537,0.36260776955066437
2116,0.2117,16,111,16,550874,125570,54773,71483,0.994566594854898,0.36276027261701166
2117,0.2118,33,104,33,550978,125466,54806,71450,0.9937428716259029,0.3628450709947389
2118,0.2119,27,85,27,551063,125381,54833,71423,0.9930696362945127,0.3629143716591126
2119,0.212,32,104,32,551167,125277,54865,71391,0.9922459130655177,0.3630026237110257
2120,0.2121,34,108,34,551275,125169,54899,71357,0.991390508173869,0.36309190641441846
2121,0.2122,21,107,21,551382,125062,54920,71336,0.9905430236978837,0.36322162140143993
2122,0.2123,34,108,34,551490,124954,54954,71302,0.9896876188062349,0.3633111853905103
2123,0.2124,28,99,28,551589,124855,54982,71274,0.988903497655557,0.36340367819139446
2124,0.2125,19,96,19,551685,124759,55001,71255,0.9881431377518692,0.3635199526564429
2125,0.2126,30,105,30,551790,124654,55031,71225,0.9873114941072108,0.3636173351916234
2126,0.2127,23,102,23,551892,124552,55054,71202,0.9865036117095425,0.36373203101852325
2127,0.2128,31,100,31,551992,124452,55085,71171,0.9857115701432011,0.3638171380665873
2128,0.2129,24,83,24,552075,124369,55109,71147,0.9850541756431378,0.36389349209271876
2129,0.213,30,92,30,552167,124277,55139,71117,0.9843254974021036,0.3639671637818971
2130,0.2131,37,87,37,552254,124190,55176,71080,0.9836364212393867,0.3640088083166897
2131,0.2132,13,110,13,552364,124080,55189,71067,0.9827651755164111,0.36417162446770895
2132,0.2133,36,84,36,552448,123996,55225,71031,0.9820998606006843,0.36421110923102956
2133,0.2134,25,83,25,552531,123913,55250,71006,0.9814424661006209,0.3642846515732176
2134,0.2135,22,105,22,552636,123808,55272,70984,0.9806108224559625,0.3644092159842293
2135,0.2136,26,102,26,552738,123706,55298,70958,0.9798029400582943,0.3645152673324292
2136,0.2137,24,108,24,552846,123598,55322,70934,0.9789475351666456,0.36463923673226
2137,0.2138,27,111,27,552957,123487,55349,70907,0.9780683690280065,0.36475920038684323
2138,0.2139,23,91,23,553048,123396,55372,70884,0.9773476112026359,0.3648548486720198
2139,0.214,26,87,26,553135,123309,55398,70858,0.9766585350399188,0.3649332790844994
2140,0.2141,25,105,25,553240,123204,55423,70833,0.9758268913952605,0.3650489339662023
2141,0.2142,15,96,15,553336,123108,55438,70818,0.9750665314915726,0.36518053278054513
2142,0.2143,27,107,27,553443,123001,55465,70791,0.9742190470155874,0.36529371697490093
2143,0.2144,27,95,27,553538,122906,55492,70764,0.9734666075275631,0.3653844167914494
2144,0.2145,21,103,21,553641,122803,55513,70743,0.9726508047142314,0.3655100079567648
2145,0.2146,28,101,28,553742,122702,55541,70715,0.9718508427322265,0.36560902092370373
2146,0.2147,37,108,37,553850,122594,55578,70678,0.9709954378405778,0.3656918746636864
2147,0.2148,26,119,26,553969,122475,55604,70652,0.9700529083766316,0.36583181015601135
2148,0.2149,29,91,29,554060,122384,55633,70623,0.969332150551261,0.36590900848155766
2149,0.215,28,95,28,554155,122289,55661,70595,0.9685797110632366,0.36599717965201883
2150,0.2151,33,86,33,554241,122203,55694,70562,0.967898555316183,0.3660519285139937
2151,0.2152,22,91,22,554332,122112,55716,70540,0.9671777974908123,0.366152440670224
2152,0.2153,31,94,31,554426,122018,55747,70509,0.9664332784184514,0.3662291522747459
2153,0.2154,27,92,27,554518,121926,55774,70482,0.9657046001774173,0.3663153299239117
2154,0.2155,20,101,20,554619,121825,55794,70462,0.9649046381954125,0.3664418291408156
2155,0.2156,31,93,31,554712,121732,55825,70431,0.964168039538715,0.36651696736624634
2156,0.2157,28,98,28,554810,121634,55853,70403,0.9633918388037004,0.3666116425480506
2157,0.2158,28,96,28,554906,121538,55881,70375,0.9626314789000127,0.3667026204582285
2158,0.2159,28,92,28,554998,121446,55909,70347,0.9619028006589786,0.3667860662276517
2159,0.216,29,81,29,555079,121365,55938,70318,0.9612612469902421,0.3668452601430487
2160,0.2161,23,96,23,555175,121269,55961,70295,0.9605008870865543,0.3669530809546679
2161,0.2162,28,91,28,555266,121178,55989,70267,0.9597801292611836,0.3670349186450417
2162,0.2163,21,95,21,555361,121083,56010,70246,0.9590276897731593,0.36714768801384
2163,0.2164,29,89,29,555450,120994,56039,70217,0.9583227727791155,0.3672225970263217
2164,0.2165,31,87,31,555537,120907,56070,70186,0.9576336966163984,0.36728713244336525
2165,0.2166,24,91,24,555628,120816,56094,70162,0.9569129387910278,0.367382630460053
2166,0.2167,21,97,21,555725,120719,56115,70141,0.9561446584716766,0.36749973802787383
2167,0.2168,37,96,37,555821,120623,56152,70104,0.9553842985679889,0.36756201271975125
2168,0.2169,18,99,18,555920,120524,56170,70086,0.9546001774173108,0.36769319553014007
2169,0.217,29,100,29,556020,120424,56199,70057,0.9538081358509695,0.3677899633034266
2170,0.2171,24,88,24,556108,120336,56223,70033,0.9531111392725891,0.367880274624545
2171,0.2172,19,84,19,556192,120252,56242,70014,0.9524458243568622,0.3679795654504746
2172,0.2173,27,109,27,556301,120143,56269,69987,0.9515824990495502,0.3681007731552096
2173,0.2174,22,97,22,556398,120046,56291,69965,0.950814218730199,0.3682155243643789
2174,0.2175,26,100,26,556498,119946,56317,69939,0.9500221771638575,0.3683229323011296
2175,0.2176,22,92,22,556590,119854,56339,69917,0.9492934989228234,0.3684282635386861
2176,0.2177,37,99,37,556689,119755,56376,69880,0.9485093777721455,0.368497376539141
2177,0.2178,31,94,31,556783,119661,56407,69849,0.9477648586997846,0.36857685610258034
2178,0.2179,22,94,22,556877,119567,56429,69827,0.9470203396274236,0.36868644202033857
2179,0.218,27,100,27,556977,119467,56456,69800,0.9462282980610822,0.3687911785995446
2180,0.2181,31,96,31,557073,119371,56487,69769,0.9454679381573945,0.36887490747594376
2181,0.2182,25,96,25,557169,119275,56512,69744,0.9447075782537068,0.36897877991101424
2182,0.2183,22,98,22,557267,119177,56534,69722,0.9439313775186922,0.369096713058301
2183,0.2184,29,98,29,557365,119079,56563,69693,0.9431551767836777,0.3691914055050537
2184,0.2185,32,103,32,557468,118976,56595,69661,0.942339373970346,0.3692859831316232
2185,0.2186,18,100,18,557568,118876,56613,69643,0.9415473324040046,0.36942164980718123
2186,0.2187,20,76,20,557644,118800,56633,69623,0.9409453808135851,0.36950372300621476
2187,0.2188,27,93,27,557737,118707,56660,69596,0.9402087821568876,0.3695958110067285
2188,0.2189,34,86,34,557823,118621,56694,69562,0.939527626409834,0.3696508186180473
2189,0.219,36,108,36,557931,118513,56730,69526,0.9386722215181853,0.3697424470455597
2190,0.2191,18,89,18,558020,118424,56748,69508,0.9379673045241415,0.369857182385118
2191,0.2192,24,96,24,558116,118328,56772,69484,0.9372069446204537,0.3699657103912423
2192,0.2193,28,87,28,558203,118241,56800,69456,0.9365178684577367,0.37004320793619505
2193,0.2194,36,83,36,558286,118158,56836,69420,0.9358604739576732,0.3700860442056105
2194,0.2195,22,103,22,558389,118055,56858,69398,0.9350446711443416,0.37021546734381416
2195,0.2196,35,100,35,558489,117955,56893,69363,0.9342526295780003,0.3702954334340533
2196,0.2197,35,87,35,558576,117868,56928,69328,0.9335635534152832,0.3703497937990128
2197,0.2198,33,101,33,558677,117767,56961,69295,0.9327635914332785,0.3704386780853407
2198,0.2199,20,78,20,558755,117689,56981,69275,0.9321457990115322,0.37052587663935305
2199,0.22,27,83,27,558838,117606,57008,69248,0.9314884045114687,0.3705995054962698
2200,0.2201,26,85,26,558923,117521,57034,69222,0.9308151691800786,0.37068056098488295
2201,0.2202,26,98,26,559021,117423,57060,69196,0.930038968445064,0.3707875403897781
2202,0.2203,28,99,28,559120,117324,57088,69168,0.929254847294386,0.37088990412457373
2203,0.2204,26,93,26,559213,117231,57114,69142,0.9285182486376885,0.37098721381315963
2204,0.2205,24,94,24,559307,117137,57138,69118,0.9277737295653276,0.3710933934659472
2205,0.2206,31,80,31,559387,117057,57169,69087,0.9271400963122545,0.3711481433728726
2206,0.2207,36,92,36,559479,116965,57205,69051,0.9264114180712204,0.37121000344056426
2207,0.2208,23,107,23,559586,116858,57228,69028,0.925563933595235,0.3713458786568112
2208,0.2209,34,101,34,559687,116757,57262,68994,0.9247639716132303,0.3714327244537042
2209,0.221,19,92,19,559779,116665,57281,68975,0.9240352933721961,0.37155246714070245
2210,0.2211,35,87,35,559866,116578,57316,68940,0.9233462172094792,0.37160814584029583
2211,0.2212,39,99,39,559965,116479,57355,68901,0.9225620960588011,0.37167439853274353
2212,0.2213,17,80,17,560045,116399,57372,68884,0.921928462805728,0.3717772272685568
2213,0.2214,33,113,33,560158,116286,57405,68851,0.9210334558357622,0.3718921663416821
2214,0.2215,27,88,27,560246,116198,57432,68824,0.9203364592573818,0.37197738647295997
2215,0.2216,27,75,27,560321,116123,57459,68797,0.9197424280826257,0.3720365563486913
2216,0.2217,21,80,21,560401,116043,57480,68776,0.9191087948295527,0.3721262424317846
2217,0.2218,28,107,28,560508,115936,57508,68748,0.9182613103535674,0.3722466483290377
2218,0.2219,28,88,28,560596,115848,57536,68720,0.9175643137751869,0.3723288977504226
2219,0.222,33,86,33,560682,115762,57569,68687,0.9168831580281334,0.3723902000010843
2220,0.2221,26,91,26,560773,115671,57595,68661,0.9161624002027626,0.3724855152659332
2221,0.2222,31,88,31,560861,115583,57626,68630,0.9154654036243822,0.37255785422310045
2222,0.2223,25,108,25,560969,115475,57651,68605,0.9146099987327335,0.3726912212081704
2223,0.2224,19,97,19,561066,115378,57670,68586,0.9138417184133824,0.3728229436194038
2224,0.2225,27,83,27,561149,115295,57697,68559,0.9131843239133189,0.3728991482371882
2225,0.2226,26,86,26,561235,115209,57723,68533,0.9125031681662653,0.3729849462833756
2226,0.2227,36,78,36,561313,115131,57759,68497,0.9118853757445191,0.37302045439693293
2227,0.2228,20,78,20,561391,115053,57779,68477,0.9112675833227728,0.37311066310684904
2228,0.2229,24,80,24,561471,114973,57803,68453,0.9106339500696996,0.37319136872635283
2229,0.223,26,87,26,561558,114886,57829,68427,0.9099448739069826,0.3732795819172672
2230,0.2231,23,83,23,561641,114803,57852,68404,0.9092874794069192,0.37337001315451923
2231,0.2232,23,88,23,561729,114715,57875,68381,0.9085904828285388,0.3734707475859658
2232,0.2233,24,93,24,561822,114622,57899,68357,0.9078538841718413,0.3735783887768542
2233,0.2234,20,100,20,561922,114522,57919,68337,0.9070618426054999,0.37371417321542827
2234,0.2235,28,87,28,562009,114435,57947,68309,0.9063727664427829,0.3737961301055028
2235,0.2236,30,81,30,562090,114354,57977,68279,0.9057312127740463,0.3738590506644473
2236,0.2237,30,97,30,562187,114257,58007,68249,0.9049629324546952,0.3739548288823381
2237,0.2238,19,96,19,562283,114161,58026,68230,0.9042025725510074,0.37408644066867336
2238,0.2239,33,74,33,562357,114087,58059,68197,0.9036164617919148,0.3741249917710825
2239,0.224,22,97,22,562454,113990,58081,68175,0.9028481814725636,0.3742486207559081
2240,0.2241,31,72,31,562526,113918,58112,68144,0.9022779115447979,0.37429007700673395
2241,0.2242,31,91,31,562617,113827,58143,68113,0.9015571537194272,0.3743706716499945
2242,0.2243,26,100,26,562717,113727,58169,68087,0.9007651121530857,0.37448711320360367
2243,0.2244,32,100,32,562817,113627,58201,68055,0.8999730705867444,0.3745830627139728
2244,0.2245,24,82,24,562899,113545,58225,68031,0.8993235965023444,0.3746695598537252
2245,0.2246,34,94,34,562993,113451,58259,67997,0.8985790774299836,0.3747464838411005
2246,0.2247,27,104,27,563097,113347,58286,67970,0.8977553542009885,0.3748683245365851
2247,0.2248,21,73,21,563170,113274,58307,67949,0.8971771638575592,0.3749468886399629
2248,0.2249,30,93,30,563263,113181,58337,67919,0.8964405652008618,0.3750358917725014
2249,0.225,30,83,30,563346,113098,58367,67889,0.8957831707007984,0.37510428925834455
2250,0.2251,41,79,41,563425,113019,58408,67848,0.8951574578633886,0.37512647414951317
2251,0.2252,27,102,27,563527,112917,58435,67821,0.8943495754657205,0.3752448295322511
2252,0.2253,25,100,25,563627,112817,58460,67796,0.8935575338993791,0.37536611428856176
2253,0.2254,29,95,29,563722,112722,58489,67767,0.8928050944113547,0.3754633246347423
2254,0.2255,23,80,23,563802,112642,58512,67744,0.8921714611582816,0.37555020899626357
2255,0.2256,29,89,29,563891,112553,58541,67715,0.8914665441642378,0.3756351654203741
2256,0.2257,23,79,23,563970,112474,58564,67692,0.890840831326828,0.37572016917731427
2257,0.2258,24,93,24,564063,112381,58588,67668,0.8901042326701305,0.37583102377686073
2258,0.2259,19,94,19,564157,112287,58607,67649,0.8893597135977697,0.3759614529610528
2259,0.226,26,95,26,564252,112192,58633,67623,0.8886072741097453,0.37606984956761114
2260,0.2261,22,87,22,564339,112105,58655,67601,0.8879181979470283,0.3761755311453151
2261,0.2262,25,100,25,564439,112005,58680,67576,0.8871261563806868,0.37629816071856154
2262,0.2263,24,90,24,564529,111915,58704,67552,0.8864133189709796,0.3764034613605844
2263,0.2264,21,72,21,564601,111843,58725,67531,0.8858430490432138,0.3764815413605093
2264,0.2265,26,80,26,564681,111763,58751,67505,0.8852094157901407,0.3765591181917576
2265,0.2266,27,95,27,564776,111668,58778,67478,0.8844569763021163,0.376664843200518
2266,0.2267,25,89,25,564865,111579,58803,67453,0.8837520593080724,0.3767650475892578
2267,0.2268,22,86,22,564951,111493,58825,67431,0.8830709035610189,0.37686950884174286
2268,0.2269,21,101,21,565052,111392,58846,67410,0.8822709415790141,0.3770092057135826
2269,0.227,31,82,31,565134,111310,58877,67379,0.8816214674946141,0.37707413438991766
2270,0.2271,26,89,26,565223,111221,58903,67353,0.8809165505005703,0.37717136873229024
2271,0.2272,28,83,28,565306,111138,58931,67325,0.8802591560005069,0.37724906563265215
2272,0.2273,35,104,35,565410,111034,58966,67290,0.8794354327715118,0.3773468517978511
2273,0.2274,32,76,32,565486,110958,58998,67258,0.8788334811810924,0.37739596893657135
2274,0.2275,29,79,29,565565,110879,59027,67229,0.8782077683436826,0.3774619893547735
2275,0.2276,24,93,24,565658,110786,59051,67205,0.8774711696869851,0.37757527065975244
2276,0.2277,23,93,23,565751,110693,59074,67182,0.8767345710302876,0.3776921995783556
2277,0.2278,19,77,19,565828,110616,59093,67163,0.8761246990242048,0.37778927769871584
2278,0.2279,22,98,22,565926,110518,59115,67141,0.8753484982891903,0.3779206232163865
2279,0.228,28,83,28,566009,110435,59143,67113,0.8746911037891268,0.3779991889517201
2280,0.2281,23,104,23,566113,110331,59166,67090,0.8738673805601318,0.37814012997334023
2281,0.2282,19,100,19,566213,110231,59185,67071,0.8730753389937904,0.37828676495471003
2282,0.2283,23,86,23,566299,110145,59208,67048,0.8723941832467368,0.3783896655059737
2283,0.2284,26,74,26,566373,110071,59234,67022,0.8718080724876441,0.3784565171971789
2284,0.2285,22,88,22,566461,109983,59256,67000,0.8711110759092637,0.37856743303029106
2285,0.2286,29,76,29,566537,109907,59285,66971,0.8705091243188443,0.37862820701274325
2286,0.2287,19,101,19,566638,109806,59304,66952,0.8697091623368395,0.3787777639484493
2287,0.2288,23,93,23,566731,109713,59327,66929,0.868972563680142,0.3788962987285017
2288,0.2289,30,78,30,566809,109635,59357,66899,0.8683547712583957,0.37895816103413504
2289,0.229,19,75,19,566884,109560,59376,66880,0.8677607400836396,0.3790523690773067
2290,0.2291,24,85,24,566969,109475,59400,66856,0.8670875047522494,0.37915057477131076
2291,0.2292,17,91,17,567060,109384,59417,66839,0.8663667469268788,0.37928647225390555
2292,0.2293,28,70,28,567130,109314,59445,66811,0.8658123178304398,0.3793385379701916
2293,0.2294,22,82,22,567212,109232,59467,66789,0.8651628437460398,0.37943768073127637
2294,0.2295,33,85,33,567297,109147,59500,66756,0.8644896084146496,0.37950461333803287
2295,0.2296,23,78,23,567375,109069,59523,66733,0.8638718159929033,0.3795918135174799
2296,0.2297,26,88,26,567463,108981,59549,66707,0.8631748194145229,0.3796901325076272
2297,0.2298,26,82,26,567545,108899,59575,66681,0.8625253453301229,0.3797756008657022
2298,0.2299,22,85,22,567630,108814,59597,66659,0.8618521099987327,0.3798818051780046
2299,0.23,28,87,28,567717,108727,59625,66631,0.8611630338360157,0.379971258796291
2300,0.2301,28,93,28,567810,108634,59653,66603,0.8604264351793182,0.3800738428528222
2301,0.2302,27,96,27,567906,108538,59680,66576,0.8596660752756304,0.38018662128670466
2302,0.2303,27,105,27,568011,108433,59707,66549,0.858834431630972,0.38031911853790673
2303,0.2304,28,87,28,568098,108346,59735,66521,0.858145355468255,0.38040911092430246
2304,0.2305,23,87,23,568185,108259,59758,66498,0.8574562793055379,0.3805169463884136
2305,0.2306,26,78,26,568263,108181,59784,66472,0.8568384868837917,0.3805946648497306
2306,0.2307,26,90,26,568353,108091,59810,66446,0.8561256494740844,0.3806986484241164
2307,0.2308,30,81,30,568434,108010,59840,66416,0.8554840958053479,0.38076892206437113
2308,0.2309,33,89,33,568523,107921,59873,66383,0.854779178811304,0.3808461079493299
2309,0.231,25,62,25,568585,107859,59898,66358,0.8542881130401724,0.380892794618206
2310,0.2311,31,82,31,568667,107777,59929,66327,0.8536386389557724,0.38096195377475534
2311,0.2312,29,79,29,568746,107698,59958,66298,0.8530129261183627,0.3810317478562726
2312,0.2313,31,74,31,568820,107624,59989,66267,0.85242681535927,0.38108355234025915
2313,0.2314,20,79,20,568899,107545,60009,66247,0.8518011025218604,0.38118555514638186
2314,0.2315,24,84,24,568983,107461,60033,66223,0.8511357876061336,0.3812844015568504
2315,0.2316,26,83,26,569066,107378,60059,66197,0.8504783931060702,0.38137404580152673
2316,0.2317,28,85,28,569151,107293,60087,66169,0.84980515777468,0.38146106928318596
2317,0.2318,26,87,26,569238,107206,60113,66143,0.849116081611963,0.38155974363855577
2318,0.2319,31,77,31,569315,107129,60144,66112,0.8485062096058801,0.3816186699453363
2319,0.232,30,65,30,569380,107064,60174,66082,0.8479913825877582,0.3816547884444342
2320,0.2321,25,89,25,569469,106975,60199,66057,0.8472864655937143,0.38176175505108884
2321,0.2322,25,103,25,569572,106872,60224,66032,0.8464706627803827,0.38189978253828716
2322,0.2323,16,93,16,569665,106779,60240,66016,0.8457340641236852,0.38204809166931913
2323,0.2324,36,63,36,569728,106716,60276,65980,0.8452350779368901,0.3820586464075601
2324,0.2325,17,70,17,569798,106646,60293,65963,0.8446806488404511,0.38215272668284966
2325,0.2326,29,99,29,569897,106547,60322,65934,0.8438965276897732,0.38226819185881344
2326,0.2327,25,91,25,569988,106456,60347,65909,0.8431757698644025,0.38238041365706493
2327,0.2328,26,71,26,570059,106385,60373,65883,0.8426134203523001,0.38244479531892167
2328,0.2329,22,71,22,570130,106314,60395,65861,0.8420510708401977,0.3825235951793234
2329,0.233,20,82,20,570212,106232,60415,65841,0.8414015967557977,0.38263411459090035
2330,0.2331,22,82,22,570294,106150,60437,65819,0.8407521226713978,0.3827375864254604
2331,0.2332,24,82,24,570376,106068,60461,65795,0.8401026485869978,0.38283400150119573
2332,0.2333,35,74,35,570450,105994,60496,65760,0.8395165378279053,0.38287317908170987
2333,0.2334,27,73,27,570523,105921,60523,65733,0.8389383474844759,0.3829389353000804
2334,0.2335,19,85,19,570608,105836,60542,65714,0.8382651121530857,0.38306033226464586
2335,0.2336,23,87,23,570695,105749,60565,65691,0.8375760359903688,0.38317195520298647
2336,0.2337,22,91,22,570786,105658,60587,65669,0.836855278164998,0.38329626970646774
2337,0.2338,24,89,24,570875,105569,60611,65645,0.8361503611709542,0.3834090670155478
2338,0.2339,31,80,31,570955,105489,60642,65614,0.8355167279178811,0.3834766193462417
2339,0.234,36,87,36,571042,105402,60678,65578,0.8348276517551642,0.3835419347292081
2340,0.2341,23,90,23,571132,105312,60701,65555,0.8341148143454569,0.3836609760808114
2341,0.2342,24,80,24,571212,105232,60725,65531,0.8334811810923838,0.3837540919285794
2342,0.2343,19,72,19,571284,105160,60744,65512,0.8329109111646179,0.3838473797693822
2343,0.2344,23,99,23,571383,105061,60767,65489,0.83212679001394,0.3839871005570214
2344,0.2345,33,90,33,571473,104971,60800,65456,0.8314139526042327,0.3840705991421547
2345,0.2346,33,101,33,571574,104870,60833,65423,0.8306139906222278,0.38417903260850417
2346,0.2347,17,92,17,571666,104778,60850,65406,0.8298853123811938,0.38432520095896205
2347,0.2348,26,87,26,571753,104691,60876,65380,0.8291962362184767,0.38442768020415
2348,0.2349,27,80,27,571833,104611,60903,65353,0.8285626029654036,0.3845108375891365
2349,0.235,18,73,18,571906,104538,60921,65335,0.8279844126219744,0.3846108563456229
2350,0.2351,30,92,30,571998,104446,60951,65305,0.8272557343809404,0.38471054662417303
2351,0.2352,28,82,28,572080,104364,60979,65277,0.8266062602965404,0.3847949493341822
2352,0.2353,23,100,23,572180,104264,61002,65254,0.825814218730199,0.38493847261057823
2353,0.2354,17,87,17,572267,104177,61019,65237,0.8251251425674819,0.38507443304567507
2354,0.2355,22,80,22,572347,104097,61041,65215,0.8244915093144088,0.38517647892647894
2355,0.2356,22,84,22,572431,104013,61063,65193,0.823826194398682,0.38528775575334206
2356,0.2357,16,83,16,572514,103930,61079,65177,0.8231687998986187,0.38541869940333634
2357,0.2358,30,90,30,572604,103840,61109,65147,0.8224559624889114,0.38551486208998326
2358,0.2359,32,78,32,572682,103762,61141,65115,0.8218381700671651,0.3855764846604333
2359,0.236,32,88,32,572770,103674,61173,65083,0.8211411734887847,0.38566103924577944
2360,0.2361,34,67,34,572837,103607,61207,65049,0.8206105056393359,0.385690399392847
2361,0.2362,24,81,24,572918,103526,61231,65025,0.8199689519705994,0.38578827773196245
2362,0.2363,14,87,14,573005,103439,61245,65011,0.8192798758078824,0.3859364796675571
2363,0.2364,37,104,37,573109,103335,61282,64974,0.8184561525788874,0.3860399622123594
2364,0.2365,25,81,25,573190,103254,61307,64949,0.8178145989101508,0.3861346111543789
2365,0.2366,33,65,33,573255,103189,61340,64916,0.8172997718920288,0.3861634097736534
2366,0.2367,36,74,36,573329,103115,61376,64880,0.8167136611329363,0.38620197029673503
2367,0.2368,25,75,25,573404,103040,61401,64855,0.8161196299581802,0.38628309360016677
2368,0.2369,23,87,23,573491,102953,61424,64832,0.8154305537954631,0.3863992609589653
2369,0.237,28,101,28,573592,102852,61452,64804,0.8146305918134583,0.38652956052870163
2370,0.2371,22,64,22,573656,102788,61474,64782,0.8141236852109999,0.3865966461777168
2371,0.2372,17,89,17,573745,102699,61491,64765,0.813418768216956,0.3867398366216023
2372,0.2373,21,75,21,573820,102624,61512,64744,0.8128247370421999,0.3868361932985995
2373,0.2374,20,85,20,573905,102539,61532,64724,0.8121515017108097,0.38695945905549944
2374,0.2375,20,81,20,573986,102458,61552,64704,0.8115099480420732,0.3870736172096529
2375,0.2376,20,89,20,574075,102369,61572,64684,0.8108050310480294,0.38720645543629867
2376,0.2377,25,52,25,574127,102317,61597,64659,0.8103931694335319,0.3872352912993484
2377,0.2378,20,61,20,574188,102256,61617,64639,0.8099100240780636,0.38730339434974087
2378,0.2379,22,87,22,574275,102169,61639,64617,0.8092209479153466,0.3874246039835478
2379,0.238,26,81,26,574356,102088,61665,64591,0.8085793942466101,0.38751732371804487
2380,0.2381,21,89,21,574445,101999,61686,64570,0.8078744772525662,0.38764716123648457
2381,0.2382,23,75,23,574520,101924,61709,64547,0.8072804460778101,0.38773720347688184
2382,0.2383,26,87,26,574607,101837,61735,64521,0.8065913699150932,0.38784428762067347
2383,0.2384,20,95,20,574702,101742,61755,64501,0.8058389304270688,0.3879922763665237
2384,0.2385,17,71,17,574773,101671,61772,64484,0.8052765809149665,0.38809545304083537
2385,0.2386,18,69,18,574842,101602,61790,64466,0.8047300722341908,0.3881903798444011
2386,0.2387,23,79,23,574921,101523,61813,64443,0.8041043593967812,0.38829037272694406
2387,0.2388,26,89,26,575010,101434,61839,64417,0.8033994424027373,0.3884028435161681
2388,0.2389,18,64,18,575074,101370,61857,64399,0.8028925358002788,0.3884863876840664
2389,0.239,22,90,22,575164,101280,61879,64377,0.8021796983905716,0.388616237164744
2390,0.2391,25,90,25,575254,101190,61904,64352,0.8014668609808643,0.3887351850285728
2391,0.2392,22,92,22,575346,101098,61926,64330,0.8007381827398302,0.38887008245278915
2392,0.2393,32,54,32,575400,101044,61958,64298,0.8003104802940059,0.38887880877212083
2393,0.2394,28,78,28,575478,100966,61986,64270,0.7996926878722596,0.38895882253262
2394,0.2395,27,79,27,575557,100887,62013,64243,0.7990669750348498,0.3890449948525404
2395,0.2396,27,81,27,575638,100806,62040,64216,0.7984254213661133,0.3891359939886803
2396,0.2397,27,92,27,575730,100714,62067,64189,0.7976967431250792,0.38925307605076925
2397,0.2398,24,90,24,575820,100624,62091,64165,0.7969839057153719,0.3893767181061843
2398,0.2399,29,91,29,575911,100533,62120,64136,0.7962631478900013,0.3894843595333669
2399,0.24,27,76,27,575987,100457,62147,64109,0.7956611962995818,0.38956406548132666
2400,0.2401,23,80,23,576067,100377,62170,64086,0.7950275630465087,0.3896681928458073
2401,0.2402,21,87,21,576154,100290,62191,64065,0.7943384868837917,0.3897964771379027
2402,0.2403,25,92,25,576246,100198,62216,64040,0.7936098086427575,0.38992194254679186
2403,0.2404,28,99,28,576345,100099,62244,64012,0.7928256874920796,0.3900530738341732
2404,0.2405,24,84,24,576429,100015,62268,63988,0.7921603725763529,0.39016359456839206
2405,0.2406,27,70,27,576499,99945,62295,63961,0.7916059434799139,0.3902297658413969
2406,0.2407,28,79,28,576578,99866,62323,63933,0.7909802306425041,0.39031373817910975
2407,0.2408,26,72,26,576650,99794,62349,63907,0.7904099607147383,0.3903885742909329
2408,0.2409,31,94,31,576744,99700,62380,63876,0.7896654416423774,0.390497383479239
2409,0.241,16,82,16,576826,99618,62396,63860,0.7890159675579774,0.39063360207489695
2410,0.2411,31,82,31,576908,99536,62427,63829,0.7883664934735775,0.3907140452361277
2411,0.2412,19,70,19,576978,99466,62446,63810,0.7878120643771385,0.3908106519023004
2412,0.2413,18,83,18,577061,99383,62464,63792,0.7871546698770752,0.3909422399264593
2413,0.2414,32,71,32,577132,99312,62496,63760,0.7865923203649727,0.3909929356357928
2414,0.2415,32,78,32,577210,99234,62528,63728,0.7859745279432264,0.3910604926301837
2415,0.2416,27,73,27,577283,99161,62555,63701,0.7853963375997972,0.39113482580344094
2416,0.2417,27,60,27,577343,99101,62582,63674,0.7849211126599924,0.391178006450622
2417,0.2418,25,62,25,577405,99039,62607,63649,0.7844300468888608,0.3912335267505901
2418,0.2419,18,77,18,577482,98962,62625,63631,0.7838201748827779,0.3913514111923638
2419,0.242,20,66,20,577548,98896,62645,63611,0.7832974274489926,0.3914354458577169
2420,0.2421,16,74,16,577622,98822,62661,63595,0.7827113166898999,0.3915538398074093
2421,0.2422,32,77,32,577699,98745,62693,63563,0.782101444683817,0.39161963674002515
2422,0.2423,17,78,17,577777,98667,62710,63546,0.7814836522620707,0.39174418819700024
2423,0.2424,27,76,27,577853,98591,62737,63519,0.7808817006716513,0.3918265375362408
2424,0.2425,28,64,28,577917,98527,62765,63491,0.7803747940691927,0.39187621128516587
2425,0.2426,30,79,30,577996,98448,62795,63461,0.779749081231783,0.39195474000827624
2426,0.2427,32,61,32,578057,98387,62827,63429,0.7792659358763148,0.3919822514460869
2427,0.2428,27,75,27,578132,98312,62854,63402,0.7786719047015588,0.392062530145813
2428,0.2429,26,75,26,578207,98237,62880,63376,0.7780778735268027,0.3921466713692587
2429,0.243,19,82,19,578289,98155,62899,63357,0.7774283994424027,0.3922742582594482
2430,0.2431,23,75,23,578364,98080,62922,63334,0.7768343682676467,0.3923699307371108
2431,0.2432,26,58,26,578422,98022,62948,63308,0.7763749841591687,0.39241306638566914
2432,0.2433,22,78,22,578500,97944,62970,63286,0.7757571917374224,0.3925200024809279
2433,0.2434,20,86,20,578586,97858,62990,63266,0.7750760359903688,0.39265410491298625
2434,0.2435,24,64,24,578650,97794,63014,63242,0.7745691293879102,0.3927196403288706
2435,0.2436,24,75,24,578725,97719,63038,63218,0.7739750982131542,0.39281209417349644
2436,0.2437,26,78,26,578803,97641,63064,63192,0.7733573057914079,0.392904441252728
2437,0.2438,26,71,26,578874,97570,63090,63166,0.7727949562793055,0.39297979295241886
2438,0.2439,30,65,30,578939,97505,63120,63136,0.7722801292611836,0.3930254418236938
2439,0.244,32,85,32,579024,97420,63152,63104,0.7716068939297934,0.3931125563778625
2440,0.2441,22,65,22,579089,97355,63174,63082,0.7710920669116715,0.39318860362634556
2441,0.2442,18,82,18,579171,97273,63192,63064,0.7704425928272716,0.3933215664506633
2442,0.2443,28,54,28,579225,97219,63220,63036,0.7700148903814472,0.39334810146329285
2443,0.2444,19,88,19,579313,97131,63239,63017,0.7693178938030668,0.3934922696505732
2444,0.2445,32,71,32,579384,97060,63271,62985,0.7687555442909644,0.39354556530975665
2445,0.2446,20,82,20,579466,96978,63291,62965,0.7681060702065644,0.39367149547026126
2446,0.2447,24,72,24,579538,96906,63315,62941,0.7675358002787986,0.39375778087796454
2447,0.2448,28,69,28,579607,96837,63343,62913,0.7669892915980231,0.39382159624413143
2448,0.2449,34,97,34,579704,96740,63377,62879,0.7662210112786719,0.3939318000989857
2449,0.245,22,89,22,579793,96651,63399,62857,0.7655160942846281,0.39406800912806883
2450,0.2451,22,75,22,579868,96576,63421,62835,0.764922063109872,0.3941697875303461
2451,0.2452,20,78,20,579946,96498,63441,62815,0.7643042706881257,0.3942867185979801
2452,0.2453,28,67,28,580013,96431,63469,62787,0.763773602838677,0.39434611664510294
2453,0.2454,28,81,28,580094,96350,63497,62759,0.7631320491699405,0.3944402893613812
2454,0.2455,26,92,26,580186,96258,63523,62733,0.7624033709289063,0.39456950393418494
2455,0.2456,30,65,30,580251,96193,63553,62703,0.7618885439107844,0.3946166045715436
2456,0.2457,31,61,31,580312,96132,63584,62672,0.7614053985553162,0.39465000881589885
2457,0.2458,25,94,25,580406,96038,63609,62647,0.7606608794829552,0.3947884173047232
2458,0.2459,32,91,32,580497,95947,63641,62615,0.7599401216575846,0.3948928494847441
2459,0.246,34,73,34,580570,95874,63675,62581,0.7593619313141554,0.39494493704837336
2460,0.2461,22,77,22,580647,95797,63697,62559,0.7587520593080724,0.39505291874005405
2461,0.2462,26,68,26,580715,95729,63723,62533,0.7582134710429603,0.3951232765919804
2462,0.2463,19,78,19,580793,95651,63742,62514,0.757595678621214,0.3952454715012803
2463,0.2464,26,70,26,580863,95581,63768,62488,0.757041249524775,0.39532103068912944
2464,0.2465,20,84,20,580947,95497,63788,62468,0.7563759346090483,0.39545468932991484
2465,0.2466,25,60,25,581007,95437,63813,62443,0.7559007096692434,0.39550924752976946
2466,0.2467,31,82,31,581089,95355,63844,62412,0.7552512355848435,0.39559603719409003
2467,0.2468,25,85,25,581174,95270,63869,62387,0.7545780002534533,0.39571347926194206
2468,0.2469,26,69,26,581243,95201,63895,62361,0.7540314915726777,0.3957870552544395
2469,0.247,30,70,30,581313,95131,63925,62331,0.7534770624762388,0.3958478871092708
2470,0.2471,26,66,26,581379,95065,63951,62305,0.7529543150424535,0.3959140878185169
2471,0.2472,23,76,23,581455,94989,63974,62282,0.7523523634520339,0.3960170660833847
2472,0.2473,29,87,29,581542,94902,64003,62253,0.751663287289317,0.39612484489834876
2473,0.2474,22,67,22,581609,94835,64025,62231,0.7511326194398682,0.39620923688131104
2474,0.2475,27,70,27,581679,94765,64052,62204,0.7505781903434292,0.3962820684338946
2475,0.2476,24,80,24,581759,94685,64076,62180,0.7499445570903561,0.39639180186784817
2476,0.2477,27,71,27,581830,94614,64103,62153,0.7493822075782537,0.3964673687702131
2477,0.2478,28,78,28,581908,94536,64131,62125,0.7487644151565074,0.3965568967388182
2478,0.2479,24,72,24,581980,94464,64155,62101,0.7481941452287416,0.39664676013157474
2479,0.248,27,87,27,582067,94377,64182,62074,0.7475050690660245,0.3967632038146129
2480,0.2481,16,67,16,582134,94310,64198,62058,0.7469744012165759,0.39687148265629796
2481,0.2482,27,80,27,582214,94230,64225,62031,0.7463407679635027,0.39697045328008906
2482,0.2483,26,81,26,582295,94149,64251,62005,0.7456992142947662,0.39707596347195717
2483,0.2484,29,81,29,582376,94068,64280,61976,0.7450576606260296,0.397170028966189
2484,0.2485,23,65,23,582441,94003,64303,61953,0.7445428336079077,0.39724665931416553
2485,0.2486,13,84,13,582525,93919,64316,61940,0.743877518692181,0.39741047998511475
2486,0.2487,23,73,23,582598,93846,64339,61917,0.7432993283487518,0.39750775216193834
2487,0.2488,24,71,24,582669,93775,64363,61893,0.7427369788366494,0.39759616619986127
2488,0.2489,21,61,21,582730,93714,64384,61872,0.7422538334811811,0.39767074158343296
2489,0.249,26,71,26,582801,93643,64410,61846,0.7416914839690787,0.3977516094386098
2490,0.2491,17,57,17,582858,93586,64427,61829,0.7412400202762641,0.39783161213525076
2491,0.2492,20,79,20,582937,93507,64447,61809,0.7406143074388544,0.3979564243220273
2492,0.2493,32,80,32,583017,93427,64479,61777,0.7399806741857813,0.39803742171593515
2493,0.2494,26,87,26,583104,93340,64505,61751,0.7392915980230642,0.3981597900587397
2494,0.2495,21,81,21,583185,93259,64526,61730,0.7386500443543277,0.3982863299976127
2495,0.2496,17,76,17,583261,93183,64543,61713,0.7380480927639083,0.39841571118686087
2496,0.2497,24,66,24,583327,93117,64567,61689,0.7375253453301229,0.3984923064997481
2497,0.2498,25,66,25,583393,93051,64592,61664,0.7370025978963376,0.3985651035775458
2498,0.2499,31,72,31,583465,92979,64623,61633,0.7364323279685718,0.3986301192662924
2499,0.25,25,71,25,583536,92908,64648,61608,0.7358699784564694,0.3987159905770276
2500,0.2501,20,70,20,583606,92838,64668,61588,0.7353155493600304,0.39881885174776266
2501,0.2502,27,65,27,583671,92773,64695,61561,0.7348007223419085,0.398881646299584
2502,0.2503,17,68,17,583739,92705,64712,61544,0.7342621340767963,0.39899124143430426
2503,0.2504,25,70,25,583809,92635,64737,61519,0.7337077049803574,0.39907495102300294
2504,0.2505,22,57,22,583866,92578,64759,61497,0.7332562412875427,0.3991367840337498
2505,0.2506,19,76,19,583942,92502,64778,61478,0.7326542896971233,0.3992596441096246
2506,0.2507,18,85,18,584027,92417,64796,61460,0.7319810543657331,0.39940991831137856
2507,0.2508,24,78,24,584105,92339,64820,61436,0.7313632619439868,0.3995187774345635
2508,0.2509,24,60,24,584165,92279,64844,61412,0.730888037004182,0.39958097741572374
2509,0.251,22,75,22,584240,92204,64866,61390,0.7302940058294259,0.3996900920608878
2510,0.2511,28,65,28,584305,92139,64894,61362,0.729779178811304,0.39974983876326536
2511,0.2512,28,58,28,584363,92081,64922,61334,0.729319794702826,0.3997914154417756
2512,0.2513,27,71,27,584434,92010,64949,61307,0.7287574451907236,0.3998708558085535
2513,0.2514,18,68,18,584502,91942,64967,61289,0.7282188569256115,0.39997781127839666
2514,0.2515,19,73,19,584575,91869,64986,61270,0.7276406665821822,0.40009403221909506
2515,0.2516,18,63,18,584638,91806,65004,61252,0.7271416803953872,0.4001881639639875
2516,0.2517,19,85,19,584723,91721,65023,61233,0.726468445063997,0.400336048746682
2517,0.2518,23,82,23,584805,91639,65046,61210,0.725818970979597,0.4004605852835151
2518,0.2519,27,74,27,584879,91565,65073,61183,0.7252328602205044,0.40054861602115904
2519,0.252,25,64,25,584943,91501,65098,61158,0.7247259536180459,0.4006183716649526
2520,0.2521,31,66,31,585009,91435,65129,61127,0.7242032061842606,0.4006698915850605
2521,0.2522,15,70,15,585079,91365,65144,61112,0.7236487770878216,0.40079487398099384
2522,0.2523,29,84,29,585163,91281,65173,61083,0.7229834621720947,0.4009017878238954
2523,0.2524,26,72,26,585235,91209,65199,61057,0.722413192244329,0.4009890586210973
2524,0.2525,24,72,24,585307,91137,65223,61033,0.7218429223165632,0.4010843135966353
2525,0.2526,21,73,21,585380,91064,65244,61012,0.7212647319731339,0.4011941397722191
2526,0.2527,31,76,31,585456,90988,65275,60981,0.7206627803827145,0.40127262797017815
2527,0.2528,23,69,23,585525,90919,65298,60958,0.7201162717019389,0.40136426186980256
2528,0.2529,26,69,26,585594,90850,65324,60932,0.7195697630211634,0.4014441765163195
2529,0.253,25,61,25,585655,90789,65349,60907,0.7190866176656951,0.40150696129100305
2530,0.2531,23,68,23,585723,90721,65372,60884,0.7185480294005829,0.4015962534217209
2531,0.2532,20,91,20,585814,90630,65392,60864,0.7178272715752123,0.40175848548457366
2532,0.2533,15,81,15,585895,90549,65407,60849,0.7171857179064758,0.4019141600285341
2533,0.2534,30,72,30,585967,90477,65437,60819,0.7166154479787099,0.4019868337563452
2534,0.2535,20,59,20,586026,90418,65457,60799,0.7161481434545685,0.40206458268580914
2535,0.2536,22,70,22,586096,90348,65479,60777,0.7155937143581295,0.40216377171215884
2536,0.2537,20,58,20,586154,90290,65499,60757,0.7151343302496515,0.4022390381801691
2537,0.2538,26,64,26,586218,90226,65525,60731,0.714627423647193,0.4023066171161324
2538,0.2539,24,87,24,586305,90139,65549,60707,0.7139383474844759,0.40244355170173557
2539,0.254,27,81,27,586386,90058,65576,60680,0.7132967938157394,0.4025527736867943
2540,0.2541,24,63,24,586449,89995,65600,60656,0.7127978076289444,0.40262593676776126
2541,0.2542,25,64,25,586513,89931,65625,60631,0.7122909010264858,0.40269789189835414
2542,0.2543,22,70,22,586583,89861,65647,60609,0.7117364719300469,0.40279789991360404
2543,0.2544,16,68,16,586651,89793,65663,60593,0.7111978836649347,0.4029164948864921
2544,0.2545,22,63,22,586714,89730,65685,60571,0.7106988974781396,0.402997984045349
2545,0.2546,20,75,20,586789,89655,65705,60551,0.7101048663033837,0.4031197155905889
2546,0.2547,20,75,20,586864,89580,65725,60531,0.7095108351286276,0.40324160121510083
2547,0.2548,30,74,30,586938,89506,65755,60501,0.7089247243695349,0.4033211783450106
2548,0.2549,24,62,24,587000,89444,65779,60477,0.7084336585984032,0.40339245335876894
2549,0.255,25,57,25,587057,89387,65804,60452,0.7079821949055887,0.4034463657659221
2550,0.2551,22,66,22,587123,89321,65826,60430,0.7074594474718033,0.40353653731861555
2551,0.2552,29,76,29,587199,89245,65855,60401,0.7068574958813838,0.4036258904347594
2552,0.2553,26,63,26,587262,89182,65881,60375,0.7063585096945888,0.40369223774213175
2553,0.2554,31,73,31,587335,89109,65912,60344,0.7057803193511596,0.40376573237071184
2554,0.2555,23,68,23,587403,89041,65935,60321,0.7052417310860474,0.40385774159424753
2555,0.2556,22,88,22,587491,88953,65957,60299,0.704544734507667,0.4040079864926433
2556,0.2557,17,65,17,587556,88888,65974,60282,0.7040299074895451,0.404116109137226
2557,0.2558,28,71,28,587627,88817,66002,60254,0.7034675579774426,0.40419665796835064
2558,0.2559,24,78,24,587705,88739,66026,60230,0.7028497655556963,0.40431230658727657
2559,0.256,23,67,23,587772,88672,66049,60207,0.7023190977062477,0.40440223268560377
2560,0.2561,23,70,23,587842,88602,66072,60184,0.7017646686098087,0.4045004234269353
2561,0.2562,27,70,27,587912,88532,66099,60157,0.7012102395133697,0.40458271963628784
2562,0.2563,24,62,24,587974,88470,66123,60133,0.700719173742238,0.4046553568905069
2563,0.2564,20,69,20,588043,88401,66143,60113,0.7001726650614625,0.40476318730894056
2564,0.2565,24,67,24,588110,88334,66167,60089,0.6996419972120137,0.40484965268186196
2565,0.2566,21,65,21,588175,88269,66188,60068,0.6991271701938918,0.4049427991667622
2566,0.2567,31,75,31,588250,88194,66219,60037,0.6985331390191357,0.4050232407526091
2567,0.2568,24,62,24,588312,88132,66243,60013,0.698042073248004,0.4050963582976138
2568,0.2569,24,67,24,588379,88065,66267,59989,0.6975114053985553,0.4051832439515312
2569,0.257,31,75,31,588454,87990,66298,59958,0.6969173742237993,0.4052640116797794
2570,0.2571,33,91,33,588545,87899,66331,59925,0.6961966163984286,0.4053807230219721
2571,0.2572,19,66,19,588611,87833,66350,59906,0.6956738689646432,0.40548534916305107
2572,0.2573,25,69,25,588680,87764,66375,59881,0.6951273602838677,0.40557418131328526
2573,0.2574,13,67,13,588747,87697,66388,59868,0.6945966924344189,0.4057059600853861
2574,0.2575,24,72,24,588819,87625,66412,59844,0.6940264225066531,0.4058073222168727
2575,0.2576,19,66,19,588885,87559,66431,59825,0.6935036750728678,0.4059124463985236
2576,0.2577,28,76,28,588961,87483,66459,59797,0.6929017234824484,0.4060089625203694
2577,0.2578,23,56,23,589017,87427,66482,59774,0.6924581802052971,0.4060706109333496
2578,0.2579,25,67,25,589084,87360,66507,59749,0.6919275123558485,0.4061546200436411
2579,0.258,26,67,26,589151,87293,66533,59723,0.6913968445063997,0.40623469554334224
2580,0.2581,25,79,25,589230,87214,66558,59698,0.69077113166899,0.40635210193857546
2581,0.2582,28,67,28,589297,87147,66586,59670,0.6902404638195413,0.4064243241586465
2582,0.2583,18,60,18,589357,87087,66604,59652,0.6897652388797364,0.4065176946823953
2583,0.2584,18,60,18,589417,87027,66622,59634,0.6892900139399316,0.40661116452226564
2584,0.2585,33,76,33,589493,86951,66655,59601,0.6886880623495121,0.4066884109394618
2585,0.2586,27,56,27,589549,86895,66682,59574,0.688244519072361,0.4067345308563587
2586,0.2587,23,56,23,589605,86839,66705,59551,0.6878009757952097,0.40679691235740145
2587,0.2588,23,63,23,589668,86776,66728,59528,0.6873019896084146,0.4068788276465442
2588,0.2589,24,58,24,589726,86718,66752,59504,0.6868426054999366,0.4069428676943278
2589,0.259,21,77,21,589803,86641,66773,59483,0.6862327334938537,0.40707207577126275
2590,0.2591,17,55,17,589858,86586,66790,59466,0.685797110632366,0.40715635527072547
2591,0.2592,24,69,24,589927,86517,66814,59442,0.6852506019515904,0.40725135140690194
2592,0.2593,30,67,30,589994,86450,66844,59412,0.6847199341021417,0.40731650464137337
2593,0.2594,16,60,16,590054,86390,66860,59396,0.6842447091623368,0.4074190937401397
2594,0.2595,24,73,24,590127,86317,66884,59372,0.6836665188189076,0.4075256196418398
2595,0.2596,20,73,20,590200,86244,66904,59352,0.6830883284754784,0.4076485617736751
2596,0.2597,27,58,27,590258,86186,66931,59325,0.6826289443670004,0.4077011359965913
2597,0.2598,22,84,22,590342,86102,66953,59303,0.6819636294512736,0.40784704790069115
2598,0.2599,23,76,23,590418,86026,66976,59280,0.6813616778608541,0.4079666359269404
2599,0.26,20,72,20,590490,85954,66996,59260,0.6807914079330883,0.40808737449557203
2600,0.2601,30,64,30,590554,85890,67026,59230,0.6802845013306298,0.40814498346196254
2601,0.2602,31,54,31,590608,85836,67057,59199,0.6798567988848054,0.40817044161754057
2602,0.2603,20,61,20,590669,85775,67077,59179,0.6793736535293372,0.40826055162327357
2603,0.2604,25,69,25,590738,85706,67102,59154,0.6788271448485617,0.4083528924478807
2604,0.2605,24,58,24,590796,85648,67126,59130,0.6783677607400836,0.40841840611142577
2605,0.2606,17,61,17,590857,85587,67143,59113,0.6778846153846154,0.4085210780926054
2606,0.2607,29,72,29,590929,85515,67172,59084,0.6773143454568495,0.40860586864362824
2607,0.2608,21,64,21,590993,85451,67193,59063,0.6768074388543911,0.40870088711128333
2608,0.2609,20,71,20,591064,85380,67213,59043,0.6762450893422887,0.4088199248042209
2609,0.261,16,73,16,591137,85307,67229,59027,0.6756668989988595,0.4089611595327504
2610,0.2611,25,65,25,591202,85242,67254,59002,0.6751520719807376,0.40904301045450764
2611,0.2612,22,60,22,591262,85182,67276,58980,0.6746768470409327,0.40912306987971864
2612,0.2613,19,77,19,591339,85105,67295,58961,0.6740669750348498,0.4092638096428026
2613,0.2614,28,58,28,591397,85047,67323,58933,0.6736075909263718,0.409313793582442
2614,0.2615,17,63,17,591460,84984,67340,58916,0.6731086047395768,0.4094232105628909
2615,0.2616,27,55,27,591515,84929,67367,58889,0.672672981878089,0.409468912097234
2616,0.2617,29,56,29,591571,84873,67396,58860,0.6722294386009378,0.40950929849095197
2617,0.2618,18,82,18,591653,84791,67414,58842,0.6715799645165378,0.4096690871874848
2618,0.2619,26,64,26,591717,84727,67440,58816,0.6710730579140793,0.40974481514250083
2619,0.262,19,55,19,591772,84672,67459,58797,0.6706374350525915,0.40982372498588543
2620,0.2621,12,59,12,591831,84613,67471,58785,0.6701701305284501,0.4099429559687025
2621,0.2622,21,71,21,591902,84542,67492,58764,0.6696077810163478,0.4100595927595495
2622,0.2623,19,66,19,591968,84476,67511,58745,0.6690850335825624,0.4101702962554374
2623,0.2624,21,54,21,592022,84422,67532,58724,0.6686573311367381,0.4102384977575343
2624,0.2625,27,57,27,592079,84365,67559,58697,0.6682058674439234,0.4102906432176259
2625,0.2626,20,64,20,592143,84301,67579,58677,0.667698960841465,0.41039180852998364
2626,0.2627,22,61,22,592204,84240,67601,58655,0.6672158154859967,0.4104762238006928
2627,0.2628,23,80,23,592284,84160,67624,58632,0.6665821822329235,0.41061123872485855
2628,0.2629,20,61,20,592345,84099,67644,58612,0.6660990368774553,0.41070415034580376
2629,0.263,27,72,27,592417,84027,67671,58585,0.6655287669496895,0.41079993268448656
2630,0.2631,35,59,35,592476,83968,67706,58550,0.6650614624255481,0.4108252992604443
2631,0.2632,19,73,19,592549,83895,67725,58531,0.6644832720821189,0.41095726903795654
2632,0.2633,24,63,24,592612,83832,67749,58507,0.6639842858953238,0.4110398415051391
2633,0.2634,21,87,21,592699,83745,67770,58486,0.6632952097326068,0.41120430848408573
2634,0.2635,21,52,21,592751,83693,67791,58465,0.6628833481181092,0.4112677443408039
2635,0.2636,24,62,24,592813,83631,67815,58441,0.6623922823469776,0.4113477673292415
2636,0.2637,23,67,23,592880,83564,67838,58418,0.6618616144975288,0.41144652139003535
2637,0.2638,22,72,22,592952,83492,67860,58396,0.661291344569763,0.41156405051871897
2638,0.2639,31,50,31,593002,83442,67891,58365,0.6608953237865923,0.41158052846474436
2639,0.264,20,90,20,593092,83352,67911,58345,0.660182486376885,0.4117588939779953
2640,0.2641,24,66,24,593158,83286,67935,58321,0.6596597389430997,0.41185110905534333
2641,0.2642,24,78,24,593236,83208,67959,58297,0.6590419465213534,0.41197837532242676
2642,0.2643,24,52,24,593288,83156,67983,58273,0.6586300849068559,0.41203006455535995
2643,0.2644,14,55,14,593343,83101,67997,58259,0.6581944620453681,0.41213214487832484
2644,0.2645,32,72,32,593415,83029,68029,58227,0.6576241921176024,0.4122090389080818
2645,0.2646,23,62,23,593477,82967,68052,58204,0.6571331263464707,0.41229430973783565
2646,0.2647,20,53,20,593530,82914,68072,58184,0.6567133443163097,0.41236587336461183
2647,0.2648,20,59,20,593589,82855,68092,58164,0.6562460397921683,0.41245505924733544
2648,0.2649,26,55,26,593644,82800,68118,58138,0.6558104169306805,0.412507627467397
2649,0.265,21,74,21,593718,82726,68139,58117,0.6552243061715879,0.41263676576045666
2650,0.2651,32,66,32,593784,82660,68171,58085,0.6547015587378026,0.41269672102028493
2651,0.2652,31,66,31,593850,82594,68202,58054,0.6541788113040172,0.41276093510039247
2652,0.2653,13,72,13,593922,82522,68215,58041,0.6536085413762515,0.41291805098069906
2653,0.2654,20,45,20,593967,82477,68235,58021,0.6532521226713978,0.4129667326225284
2654,0.2655,20,50,20,594017,82427,68255,58001,0.6528561018882271,0.41303016492437405
2655,0.2656,35,81,35,594098,82346,68290,57966,0.6522145482194905,0.41312218484520213
2656,0.2657,19,77,19,594175,82269,68309,57947,0.6516046762134077,0.4132695270154619
2657,0.2658,26,64,26,594239,82205,68335,57921,0.6510977696109492,0.4133494140987397
2658,0.2659,18,59,18,594298,82146,68353,57903,0.6506304650868078,0.41344815029025556
2659,0.266,29,59,29,594357,82087,68382,57874,0.6501631605626663,0.41350090382320787
2660,0.2661,18,51,18,594408,82036,68400,57856,0.6497592193638322,0.4135761873445229
2661,0.2662,22,69,22,594477,81967,68422,57834,0.6492127106830566,0.41368802798263243
2662,0.2663,11,72,11,594549,81895,68433,57823,0.6486424407552909,0.41385505088821767
2663,0.2664,20,49,20,594598,81846,68453,57803,0.6482543403877835,0.41391631877063206
2664,0.2665,22,64,22,594662,81782,68475,57781,0.6477474337853251,0.41401374289747284
2665,0.2666,23,69,23,594731,81713,68498,57758,0.6472009251045495,0.41412193215793963
2666,0.2667,27,55,27,594786,81658,68525,57731,0.6467653022430617,0.41417185000251094
2667,0.2668,21,65,21,594851,81593,68546,57710,0.6462504752249398,0.41427679231603054
2668,0.2669,19,71,19,594922,81522,68565,57691,0.6456881257128374,0.41440813717109753
2669,0.267,28,69,28,594991,81453,68593,57663,0.6451416170320619,0.41449581644095573
2670,0.2671,23,58,23,595049,81395,68616,57640,0.6446822329235838,0.4145718703923473
2671,0.2672,16,55,16,595104,81340,68632,57624,0.644246610062096,0.4146685472496474
2672,0.2673,19,63,19,595167,81277,68651,57605,0.6437476238753009,0.41477657291801673
2673,0.2674,12,75,12,595242,81202,68663,57593,0.643153592700545,0.41495010627183976
2674,0.2675,27,75,27,595317,81127,68690,57566,0.6425595615257889,0.41506060147231655
2675,0.2676,26,67,26,595384,81060,68716,57540,0.6420288936763401,0.41515151515151516
2676,0.2677,17,63,17,595447,80997,68733,57523,0.6415299074895451,0.41526855327750506
2677,0.2678,16,57,16,595504,80940,68749,57507,0.6410784437967304,0.415371947387809
2678,0.2679,26,75,26,595579,80865,68775,57481,0.6404844126219744,0.41548725658855334
2679,0.268,21,65,21,595644,80800,68796,57460,0.6399695856038525,0.41559380876609286
2680,0.2681,22,67,22,595711,80733,68818,57438,0.6394389177544038,0.41570228195496883
2681,0.2682,24,61,24,595772,80672,68842,57414,0.6389557723989355,0.4157843662645018
2682,0.2683,21,62,21,595834,80610,68863,57393,0.6384647066278039,0.4158822634290559
2683,0.2684,24,61,24,595895,80549,68887,57369,0.6379815612723355,0.4159645586507925
2684,0.2685,13,51,13,595946,80498,68900,57356,0.6375776200735015,0.41606337139292293
2685,0.2686,30,54,30,596000,80444,68930,57326,0.6371499176276771,0.41609929592799594
2686,0.2687,26,60,26,596060,80384,68956,57300,0.6366746926878722,0.4161703611167601
2687,0.2688,20,67,20,596127,80317,68976,57280,0.6361440248384235,0.41628814581713264
2688,0.2689,17,73,17,596200,80244,68993,57263,0.6355658344949943,0.4164369813900383
2689,0.269,26,47,26,596247,80197,69019,57237,0.6351935749588138,0.41646899602718396
2690,0.2691,18,66,18,596313,80131,69037,57219,0.6346708275250285,0.41659264652348016
2691,0.2692,27,73,27,596386,80058,69064,57192,0.6340926371815993,0.41669945355191257
2692,0.2693,18,61,18,596447,79997,69082,57174,0.633609491826131,0.4168082174803712
2693,0.2694,19,66,19,596513,79931,69101,57155,0.6330867443923457,0.41692805975810804
2694,0.2695,22,69,22,596582,79862,69123,57133,0.6325402357115701,0.41704441767947736
2695,0.2696,30,68,30,596650,79794,69153,57103,0.632001647446458,0.4171238230202269
2696,0.2697,19,72,19,596722,79722,69172,57084,0.6314313775186922,0.41726240077189597
2697,0.2698,23,52,23,596774,79670,69195,57061,0.6310195159041947,0.4173230649962335
2698,0.2699,19,59,19,596833,79611,69214,57042,0.6305522113800532,0.4174222300278808
2699,0.27,33,65,33,596898,79546,69247,57009,0.6300373843619314,0.4174801362088536
2700,0.2701,22,70,22,596968,79476,69269,56987,0.6294829552654924,0.4176003751932758
2701,0.2702,22,55,22,597023,79421,69291,56965,0.6290473324040046,0.417674834660449
2702,0.2703,20,41,20,597064,79380,69311,56945,0.6287225953618046,0.41771501925545573
2703,0.2704,24,71,24,597135,79309,69335,56921,0.6281602458497022,0.41783014020406667
2704,0.2705,23,54,23,597189,79255,69358,56898,0.6277325434038779,0.41789751235742145
2705,0.2706,19,72,19,597261,79183,69377,56879,0.627162273476112,0.41803736531875174
2706,0.2707,33,66,33,597327,79117,69410,56846,0.6266395260423268,0.4180990416510374
2707,0.2708,20,65,20,597392,79052,69430,56826,0.6261246990242048,0.41821339731229484
2708,0.2709,22,60,22,597452,78992,69452,56804,0.6256494740844,0.4183039264779522
2709,0.271,19,55,19,597507,78937,69471,56785,0.6252138512229122,0.4183920071911702
2710,0.2711,24,68,24,597575,78869,69495,56761,0.6246752629578001,0.4184988571849886
2711,0.2712,25,57,25,597632,78812,69520,56736,0.6242237992649854,0.4185675922920294
2712,0.2713,14,70,14,597702,78742,69534,56722,0.6236693701685464,0.41872379377546803
2713,0.2714,28,66,28,597768,78676,69562,56694,0.6231466227347611,0.418807712196203
2714,0.2715,17,55,17,597823,78621,69579,56677,0.6227109998732734,0.4189049357714083
2715,0.2716,26,56,26,597879,78565,69605,56651,0.6222674565961221,0.41896669033250505
2716,0.2717,22,69,22,597948,78496,69627,56629,0.6217209479153466,0.41908603145235895
2717,0.2718,28,62,28,598010,78434,69655,56601,0.6212298821442149,0.41915799607509163
2718,0.2719,19,62,19,598072,78372,69674,56582,0.6207388163730833,0.41926878788327876
2719,0.272,14,69,14,598141,78303,69688,56568,0.6201923076923077,0.4194230042040172
2720,0.2721,21,68,21,598209,78235,69709,56547,0.6196537194271955,0.4195441527800448
2721,0.2722,32,54,32,598263,78181,69741,56515,0.6192260169813711,0.4195744491298925
2722,0.2723,32,64,32,598327,78117,69773,56483,0.6187191103789127,0.41963595839524515
2723,0.2724,21,64,21,598391,78053,69794,56462,0.6182122037764541,0.4197450098502026
2724,0.2725,22,49,22,598440,78004,69816,56440,0.6178241034089469,0.4198030406712088
2725,0.2726,21,67,21,598507,77937,69837,56419,0.6172934355594981,0.4199217005567299
2726,0.2727,22,66,22,598573,77871,69859,56397,0.6167706881257128,0.4200330681919743
2727,0.2728,18,57,18,598630,77814,69877,56379,0.6163192244328982,0.42013368804632134
2728,0.2729,14,66,14,598696,77748,69891,56365,0.6157964769991129,0.420279913207519
2729,0.273,22,51,22,598747,77697,69913,56343,0.6153925358002788,0.4203446732318711
2730,0.2731,21,67,21,598814,77630,69934,56322,0.6148618679508301,0.42046404682274247
2731,0.2732,22,77,22,598891,77553,69956,56300,0.6142519959447472,0.42061066991401014
2732,0.2733,14,46,14,598937,77507,69970,56286,0.6138876568242302,0.4206946551762798
2733,0.2734,27,64,27,599001,77443,69997,56259,0.6133807502217716,0.4207790459379815
2734,0.2735,16,71,16,599072,77372,70013,56243,0.6128184007096692,0.4209332784492759
2735,0.2736,22,70,22,599142,77302,70035,56221,0.6122639716132303,0.4210585442208458
2736,0.2737,22,61,22,599203,77241,70057,56199,0.611780826257762,0.42115557553956834
2737,0.2738,25,66,25,599269,77175,70082,56174,0.6112580788239766,0.4212555024784588
2738,0.2739,28,54,28,599323,77121,70110,56146,0.6108303763781523,0.4213045990380214
2739,0.274,24,60,24,599383,77061,70134,56122,0.6103551514383475,0.4213901173573204
2740,0.2741,17,75,17,599458,76986,70151,56105,0.6097611202635914,0.4215536738021354
2741,0.2742,23,77,23,599535,76909,70174,56082,0.6091512482575085,0.42169770886751734
2742,0.2743,18,60,18,599595,76849,70192,56064,0.6086760233177038,0.42180975525343645
2743,0.2744,17,48,17,599643,76801,70209,56047,0.6082958433658598,0.4218881729495363
2744,0.2745,23,47,23,599690,76754,70232,56024,0.6079235838296794,0.4219373691424784
2745,0.2746,19,58,19,599748,76696,70251,56005,0.6074641997212014,0.42203902005259947
2746,0.2747,25,70,25,599818,76626,70276,55980,0.6069097706247624,0.42215284376272566
2747,0.2748,17,50,17,599868,76576,70293,55963,0.6065137498415917,0.4222379827824263
2748,0.2749,23,63,23,599931,76513,70316,55940,0.6060147636547966,0.4223384898794289
2749,0.275,20,68,20,599999,76445,70336,55920,0.6054761753896845,0.4224681751218222
2750,0.2751,23,39,23,600038,76406,70359,55897,0.6051672791788113,0.42249230932027243
2751,0.2752,22,58,22,600096,76348,70381,55875,0.6047078950703333,0.42258154783963453
2752,0.2753,27,68,27,600164,76280,70408,55848,0.6041693068052212,0.4226810365705982
2753,0.2754,13,64,13,600228,76216,70421,55835,0.6036624002027626,0.42282905846983365
2754,0.2755,23,56,23,600284,76160,70444,55812,0.6032188569256115,0.4229078895523293
2755,0.2756,18,66,18,600350,76094,70462,55794,0.6026961094918262,0.42304076185854667
2756,0.2757,22,37,22,600387,76057,70484,55772,0.6024030541122798,0.4230632106744343
2757,0.2758,22,42,22,600429,76015,70506,55750,0.6020703966544164,0.42310173414791485
2758,0.2759,28,61,28,600490,75954,70534,55722,0.6015872512989482,0.4231750660712658
2759,0.276,19,64,19,600554,75890,70553,55703,0.6010803446964896,0.4232975918171939
2760,0.2761,21,41,21,600595,75849,70574,55682,0.6007556076542897,0.42333746417194423
2761,0.2762,27,78,27,600673,75771,70601,55655,0.6001378152325434,0.4234702418090789
2762,0.2763,25,61,25,600734,75710,70626,55630,0.5996546698770752,0.4235571798385869
2763,0.2764,24,66,24,600800,75644,70650,55606,0.5991319224432898,0.4236647619047619
2764,0.2765,20,55,20,600855,75589,70670,55586,0.598696299581802,0.42375452639603584
2765,0.2766,27,67,27,600922,75522,70697,55559,0.5981656317323533,0.42385242712521265
2766,0.2767,24,47,24,600969,75475,70721,55535,0.5977933721961729,0.42389893901228914
2767,0.2768,19,58,19,601027,75417,70740,55516,0.5973339880876949,0.4240031160975461
2768,0.2769,29,62,29,601089,75355,70769,55487,0.5968429223165632,0.4240763669158221
2769,0.277,13,71,13,601160,75284,70782,55474,0.5962805728044608,0.42424937671117635
2770,0.2771,23,62,23,601222,75222,70805,55451,0.5957895070333291,0.42434933000696395
2771,0.2772,17,67,17,601289,75155,70822,55434,0.5952588391838803,0.42449210882999333
2772,0.2773,21,63,21,601352,75092,70843,55413,0.5947598529970853,0.42460442128654075
2773,0.2774,20,58,20,601410,75034,70863,55393,0.5943004688886073,0.4247050073987748
2774,0.2775,23,55,23,601465,74979,70886,55370,0.5938648460271195,0.4247826987548811
2775,0.2776,12,50,12,601515,74929,70898,55358,0.5934688252439488,0.4248927368041324
2776,0.2777,26,64,26,601579,74865,70924,55332,0.5929619186414903,0.4249867508467937
2777,0.2778,21,47,21,601626,74818,70945,55311,0.5925896591053098,0.42504745291211027
2778,0.2779,24,59,24,601685,74759,70969,55287,0.5921223545811685,0.42513418328899005
2779,0.278,28,57,28,601742,74702,70997,55259,0.5916708908883538,0.42519678980617265
2780,0.2781,20,54,20,601796,74648,71017,55239,0.5912431884425294,0.4252850554712943
2781,0.2782,18,57,18,601853,74591,71035,55221,0.5907917247497149,0.4253921055064247
2782,0.2783,14,54,14,601907,74537,71049,55207,0.5903640223038905,0.4255071525465532
2783,0.2784,27,56,27,601963,74481,71076,55180,0.5899204790267393,0.4255712974603003
2784,0.2785,21,62,21,602025,74419,71097,55159,0.5894294132556076,0.42568182870549015
2785,0.2786,17,65,17,602090,74354,71114,55142,0.5889145862374857,0.42582010255143016
2786,0.2787,13,62,13,602152,74292,71127,55129,0.588423520466354,0.4259664196691418
2787,0.2788,25,45,25,602197,74247,71152,55104,0.5880671017615005,0.42600366444789756
2788,0.2789,22,62,22,602259,74185,71174,55082,0.5875760359903688,0.42611029883883744
2789,0.279,21,63,21,602322,74122,71195,55061,0.5870770498035737,0.4262248128623735
2790,0.2791,21,56,21,602378,74066,71216,55040,0.5866335065264225,0.4263163602001456
2791,0.2792,25,50,25,602428,74016,71241,55015,0.5862374857432519,0.42637040711146934
2792,0.2793,25,60,25,602488,73956,71266,54990,0.585762260803447,0.42645758689684055
2793,0.2794,28,70,28,602558,73886,71294,54962,0.585207831707008,0.42656463429777725
2794,0.2795,20,73,20,602631,73813,71314,54942,0.5846296413635788,0.4267174090326589
2795,0.2796,18,58,18,602689,73755,71332,54924,0.5841702572551007,0.4268295526076516
2796,0.2797,27,60,27,602749,73695,71359,54897,0.583695032315296,0.42690836132885407
2797,0.2798,12,45,12,602794,73650,71371,54885,0.5833386136104423,0.4270043178900689
2798,0.2799,24,70,24,602864,73580,71395,54861,0.5827841845140033,0.4271299662880233
2799,0.28,14,57,14,602921,73523,71409,54847,0.5823327208211887,0.4272571473085612
2800,0.2801,27,59,27,602980,73464,71436,54820,0.5818654162970472,0.42733310467400454
2801,0.2802,27,50,27,603030,73414,71463,54793,0.5814693955138766,0.42737916026426015
2802,0.2803,17,62,17,603092,73352,71480,54776,0.5809783297427449,0.42750999000999
2803,0.2804,30,56,30,603148,73296,71510,54746,0.5805347864655938,0.4275628309460958
2804,0.2805,20,62,20,603210,73234,71530,54726,0.5800437206944621,0.4276805251641138
2805,0.2806,29,57,29,603267,73177,71559,54697,0.5795922570016474,0.42774137041149884
2806,0.2807,18,60,18,603327,73117,71577,54679,0.5791170320618426,0.42786159191210993
2807,0.2808,22,68,22,603395,73049,71599,54657,0.5785784437967304,0.42799085399276465
2808,0.2809,21,65,21,603460,72984,71620,54636,0.5780636167786085,0.4281147155618242
2809,0.281,17,49,17,603509,72935,71637,54619,0.5776755164111013,0.4282029571789203
2810,0.2811,22,59,22,603568,72876,71659,54597,0.5772082118869598,0.42830246405121086
2811,0.2812,22,54,22,603622,72822,71681,54575,0.5767805094411355,0.42838528379789165
2812,0.2813,17,53,17,603675,72769,71698,54558,0.5763607274109745,0.42848728078098125
2813,0.2814,16,56,16,603731,72713,71714,54542,0.5759171841338233,0.42860398412636047
2814,0.2815,25,61,25,603792,72652,71739,54517,0.5754340387783551,0.4286972453978564
2815,0.2816,20,59,20,603851,72593,71759,54497,0.5749667342542136,0.4288063576992682
2816,0.2817,20,61,20,603912,72532,71779,54477,0.5744835888987454,0.4289223598327678
2817,0.2818,16,60,16,603972,72472,71795,54461,0.5740083639589406,0.42905312251345196
2818,0.2819,19,54,19,604026,72418,71814,54442,0.5735806615131163,0.4291502443638657
2819,0.282,25,48,25,604074,72370,71839,54417,0.5732004815612723,0.4292001545899816
2820,0.2821,24,68,24,604142,72302,71863,54393,0.5726618932961601,0.4293223884131181
2821,0.2822,26,50,26,604192,72252,71889,54367,0.5722658725129894,0.4293747383883935
2822,0.2823,22,55,22,604247,72197,71911,54345,0.5718302496515018,0.4294621548576757
2823,0.2824,25,55,25,604302,72142,71936,54320,0.571394626790014,0.429536145245212
2824,0.2825,21,60,21,604362,72082,71957,54299,0.5709194018502091,0.42964527895807125
2825,0.2826,21,74,21,604436,72008,71978,54278,0.5703332910911164,0.4298021950176583
2826,0.2827,13,65,13,604501,71943,71991,54265,0.5698184640729945,0.42996481997971603
2827,0.2828,24,54,24,604555,71889,72015,54241,0.5693907616271702,0.4300404344723698
2828,0.2829,21,48,21,604603,71841,72036,54220,0.5690105816753264,0.4301092328317243
2829,0.283,20,72,20,604675,71769,72056,54200,0.5684403117475605,0.43026458890679453
2830,0.2831,23,54,23,604729,71715,72079,54177,0.5680126093017361,0.43034505766847775
2831,0.2832,22,54,22,604783,71661,72101,54155,0.5675849068559118,0.4304301519679532
2832,0.2833,29,62,29,604845,71599,72130,54126,0.5670938410847801,0.43051103599125073
2833,0.2834,26,61,26,604906,71538,72156,54100,0.5666106957293119,0.43060220633884655
2834,0.2835,21,60,21,604966,71478,72177,54079,0.566135470789507,0.4307127440126795
2835,0.2836,19,47,19,605013,71431,72196,54060,0.5657632112533266,0.43078786526523816
2836,0.2837,17,59,17,605072,71372,72213,54043,0.5652959067291852,0.4309133676195033
2837,0.2838,17,61,17,605133,71311,72230,54026,0.5648127613737169,0.4310459002529181
2838,0.2839,26,54,26,605187,71257,72256,54000,0.5643850589278926,0.4311136303759471
2839,0.284,23,54,23,605241,71203,72279,53977,0.5639573564820681,0.431195079086116
2840,0.2841,20,57,20,605298,71146,72299,53957,0.5635058927892536,0.4313006082987618
2841,0.2842,20,62,20,605360,71084,72319,53937,0.5630148270181219,0.43142352084849744
2842,0.2843,25,56,25,605416,71028,72344,53912,0.5625712837409708,0.4315031214983192
2843,0.2844,22,63,22,605479,70965,72366,53890,0.5620722975541756,0.431620679988787
2844,0.2845,15,56,15,605535,70909,72381,53875,0.5616287542770244,0.4317460571868188
2845,0.2846,21,70,21,605605,70839,72402,53854,0.5610743251805855,0.4318927285412974
2846,0.2847,18,60,18,605665,70779,72420,53836,0.5605991002407806,0.43201861734141156
2847,0.2848,19,57,19,605722,70722,72439,53817,0.5601476365479661,0.43212969431262493
2848,0.2849,17,55,17,605777,70667,72456,53800,0.5597120136864783,0.4322430845123607
2849,0.285,27,55,27,605832,70612,72483,53773,0.5592763908249905,0.43231096997226354
2850,0.2851,24,53,24,605885,70559,72507,53749,0.5588566087948296,0.43238568716414066
2851,0.2852,24,58,24,605943,70501,72531,53725,0.5583972246863516,0.43247790317646867
2852,0.2853,22,59,22,606002,70442,72553,53703,0.5579299201622101,0.4325828668089734
2853,0.2854,27,52,27,606054,70390,72580,53676,0.5575180585477126,0.4326406912449825
2854,0.2855,23,59,23,606113,70331,72603,53653,0.5570507540235712,0.43274132146083366
2855,0.2856,23,49,23,606162,70282,72626,53630,0.5566626536560638,0.4328071534637485
2856,0.2857,16,55,16,606217,70227,72642,53614,0.5562270307945761,0.4329260907130918
2857,0.2858,24,59,24,606276,70168,72666,53590,0.5557597262704347,0.43302251167601286
2858,0.2859,26,49,26,606325,70119,72692,53564,0.5553716259029274,0.4330748769030505
2859,0.286,15,66,15,606391,70053,72707,53549,0.5548488784691421,0.4332373262568567
2860,0.2861,20,67,20,606458,69986,72727,53529,0.5543182106196933,0.43338056106545764
2861,0.2862,25,53,25,606511,69933,72752,53504,0.5538984285895324,0.4334518823367386
2862,0.2863,18,55,18,606566,69878,72770,53486,0.5534628057280446,0.4335624655491067
2863,0.2864,20,56,20,606622,69822,72790,53466,0.5530192624508934,0.43366751021997274
2864,0.2865,18,55,18,606677,69767,72808,53448,0.5525836395894057,0.43377835490808747
2865,0.2866,16,66,16,606743,69701,72824,53432,0.5520608921556204,0.43393728732346326
2866,0.2867,18,63,18,606806,69638,72842,53414,0.5515619059688253,0.43407665052173067
2867,0.2868,26,48,26,606854,69590,72868,53388,0.5511817260169813,0.4341264291174031
2868,0.2869,18,45,18,606899,69545,72886,53370,0.5508253073121278,0.43420249766098523
2869,0.287,25,52,25,606951,69493,72911,53345,0.5504134456976302,0.4342711538774646
2870,0.2871,22,55,22,607006,69438,72933,53323,0.5499778228361425,0.43436433394970714
2871,0.2872,17,62,17,607068,69376,72950,53306,0.5494867570650108,0.4345054694250175
2872,0.2873,21,44,21,607112,69332,72971,53285,0.5491382587758206,0.4345645383592813
2873,0.2874,24,41,24,607153,69291,72995,53261,0.5488135217336206,0.43459919054768587
2874,0.2875,14,59,14,607212,69232,73009,53247,0.5483462172094792,0.43474391528343637
2875,0.2876,17,46,17,607258,69186,73026,53230,0.5479818780889621,0.4348287805515619
2876,0.2877,16,59,16,607317,69127,73042,53214,0.5475145735648207,0.43496456625334107
2877,0.2878,32,55,32,607372,69072,73074,53182,0.5470789507033329,0.43501235133410765
2878,0.2879,26,61,26,607433,69011,73100,53156,0.5465958053478647,0.4351093175734855
2879,0.288,27,46,27,607479,68965,73127,53129,0.5462314662273476,0.4351483283371828
2880,0.2881,25,66,25,607545,68899,73152,53104,0.5457087187935623,0.43526798521347837
2881,0.2882,17,48,17,607593,68851,73169,53087,0.5453285388417184,0.4353605930882908
2882,0.2883,16,46,16,607639,68805,73185,53071,0.5449641997212014,0.43545078604483245
2883,0.2884,23,51,23,607690,68754,73208,53048,0.5445602585223672,0.4355265102379271
2884,0.2885,31,42,31,607732,68712,73239,53017,0.5442276010645039,0.43553302828413937
2885,0.2886,18,51,18,607783,68661,73257,52999,0.5438236598656697,0.4356320894295578
2886,0.2887,28,50,28,607833,68611,73285,52971,0.543427639082499,0.4356812686088401
2887,0.2888,29,40,29,607873,68571,73314,52942,0.5431108224559625,0.43569000847645933
2888,0.2889,20,53,20,607926,68518,73334,52922,0.5426910404258015,0.43578722002635045
2889,0.289,18,47,18,607973,68471,73352,52904,0.542318780889621,0.43587229660144183
2890,0.2891,22,39,22,608012,68432,73374,52882,0.5420098846787479,0.4359101175462024
2891,0.2892,18,46,18,608058,68386,73392,52864,0.5416455455582309,0.4359917525773196
2892,0.2893,17,58,17,608116,68328,73409,52847,0.5411861614497528,0.4361213121518465
2893,0.2894,22,55,22,608171,68273,73431,52825,0.5407505385882652,0.43621694825678375
2894,0.2895,21,53,21,608224,68220,73452,52804,0.5403307565581041,0.43631015335801165
2895,0.2896,23,41,23,608265,68179,73475,52781,0.5400060195159042,0.4363508597883598
2896,0.2897,9,62,9,608327,68117,73484,52772,0.5395149537447725,0.436532687010398
2897,0.2898,21,65,21,608392,68052,73505,52751,0.5390001267266507,0.4366696191319752
2898,0.2899,17,40,17,608432,68012,73522,52734,0.538683310100114,0.4367349643052358
2899,0.29,18,48,18,608480,67964,73540,52716,0.5383031301482701,0.43682466025853495
2900,0.2901,14,59,14,608539,67905,73554,52702,0.5378358256241288,0.43697297835117366
2901,0.2902,14,54,14,608593,67851,73568,52688,0.5374081231783044,0.4371033441458781
2902,0.2903,18,56,18,608649,67795,73586,52670,0.5369645799011532,0.4372224297513801
2903,0.2904,19,41,19,608690,67754,73605,52651,0.5366398428589533,0.4372825048793655
2904,0.2905,16,51,16,608741,67703,73621,52635,0.5362359016601191,0.43739300968937495
2905,0.2906,16,50,16,608791,67653,73637,52619,0.5358398808769484,0.4375
2906,0.2907,22,57,22,608848,67596,73659,52597,0.5353884171841338,0.4376045193979683
2907,0.2908,18,61,18,608909,67535,73677,52579,0.5349052718286655,0.43774247797925303
2908,0.2909,23,59,23,608968,67476,73700,52556,0.5344379673045241,0.43784990669154894
2909,0.291,20,51,20,609019,67425,73720,52536,0.5340340261056901,0.43794233125765875
2910,0.2911,21,60,21,609079,67365,73741,52515,0.5335588011658852,0.4380630630630631
2911,0.2912,27,54,27,609133,67311,73768,52488,0.5331310987200608,0.4381338742393509
2912,0.2913,19,68,19,609201,67243,73787,52469,0.5325925104549487,0.438293571237637
2913,0.2914,17,56,17,609257,67187,73804,52452,0.5321489671777975,0.43841891022158325
2914,0.2915,14,44,14,609301,67143,73818,52438,0.5318004688886073,0.43851447972503993
2915,0.2916,30,46,30,609347,67097,73848,52408,0.5314361297680902,0.43854232040500396
2916,0.2917,22,54,22,609401,67043,73870,52386,0.5310084273222658,0.4386371819239883
2917,0.2918,21,54,21,609455,66989,73891,52365,0.5305807248764415,0.43873686679960455
2918,0.2919,22,51,22,609506,66938,73913,52343,0.5301767836776075,0.438820935438167
2919,0.292,27,66,27,609572,66872,73940,52316,0.5296540362438221,0.43893680571869653
2920,0.2921,16,63,16,609635,66809,73956,52300,0.529155050057027,0.43909360333811887
2921,0.2922,23,63,23,609698,66746,73979,52277,0.5286560638702319,0.4392176302059266
2922,0.2923,23,57,23,609755,66689,74002,52254,0.5282046001774173,0.43931967412962514
2923,0.2924,24,47,24,609802,66642,74026,52230,0.5278323406412369,0.43938017363214216
2924,0.2925,23,51,23,609853,66591,74049,52207,0.5274283994424027,0.43946026027374196
2925,0.2926,14,46,14,609899,66545,74063,52193,0.5270640603218857,0.4395644191413027
2926,0.2927,15,51,15,609950,66494,74078,52178,0.5266601191230516,0.4396824861803964
2927,0.2928,18,49,18,609999,66445,74096,52160,0.5262720187555443,0.43977909868892545
2928,0.2929,17,49,17,610048,66396,74113,52143,0.525883918388037,0.43988054564320606
2929,0.293,21,56,21,610104,66340,74134,52122,0.5254403751108858,0.4399891948472928
2930,0.2931,11,60,11,610164,66280,74145,52111,0.524965150171081,0.44016014730849473
2931,0.2932,20,46,20,610210,66234,74165,52091,0.5246008110505639,0.4402366363828439
2932,0.2933,15,44,15,610254,66190,74180,52076,0.5242523127613737,0.4403294268851572
2933,0.2934,23,39,23,610293,66151,74203,52053,0.5239434165505006,0.4403658082636797
2934,0.2935,14,48,14,610341,66103,74217,52039,0.5235632365986567,0.4404784073403193
2935,0.2936,20,54,20,610395,66049,74237,52019,0.5231355341528323,0.4405850865602873
2936,0.2937,22,51,22,610446,65998,74259,51997,0.5227315929539982,0.4406712148819865
2937,0.2938,13,38,13,610484,65960,74272,51984,0.5224306171587885,0.4407515431052025
2938,0.2939,30,44,30,610528,65916,74302,51954,0.5220821188695983,0.4407737337744973
2939,0.294,18,47,18,610575,65869,74320,51936,0.5217098593334178,0.44086413989219475
2940,0.2941,19,47,19,610622,65822,74339,51917,0.5213375997972374,0.44094989765498266
2941,0.2942,28,64,28,610686,65758,74367,51889,0.5208306931947788,0.44105672052836026
2942,0.2943,17,57,17,610743,65701,74384,51872,0.5203792295019642,0.4411897289343642
2943,0.2944,15,40,15,610783,65661,74399,51857,0.5200624128754276,0.4412685716230705
2944,0.2945,21,58,21,610841,65603,74420,51836,0.5196030287669496,0.44138659218828497
2945,0.2946,15,59,15,610900,65544,74435,51821,0.5191357242428083,0.4415370851616751
2946,0.2947,18,49,18,610949,65495,74453,51803,0.5187476238753009,0.441635833518048
2947,0.2948,24,64,24,611013,65431,74477,51779,0.5182407172728425,0.44176264823820494
2948,0.2949,22,57,22,611070,65374,74499,51757,0.5177892535800279,0.44187277492721827
2949,0.295,11,46,11,611116,65328,74510,51746,0.5174249144595109,0.44199395254283613
2950,0.2951,16,49,16,611165,65279,74526,51730,0.5170368140920035,0.44210274423334955
2951,0.2952,18,52,18,611217,65227,74544,51712,0.5166249524775061,0.44221346171935794
2952,0.2953,29,45,29,611262,65182,74573,51683,0.5162685337726524,0.4422453258032773
2953,0.2954,25,49,25,611311,65133,74598,51658,0.5158804334051451,0.4423114794804394
2954,0.2955,26,44,26,611355,65089,74624,51632,0.5155319351159549,0.44235398942778076
2955,0.2956,15,40,15,611395,65049,74639,51617,0.5152151184894184,0.4424339567654672
2956,0.2957,26,47,26,611442,65002,74665,51591,0.5148428589532379,0.4424879709759591
2957,0.2958,13,43,13,611485,64959,74678,51578,0.5145022810797111,0.44258904897157125
2958,0.2959,18,41,18,611526,64918,74696,51560,0.514177544037511,0.4426586994969007
2959,0.296,24,52,24,611578,64866,74720,51536,0.5137656824230136,0.4427415336506246
2960,0.2961,14,43,14,611621,64823,74734,51522,0.5134251045494868,0.4428381107911814
2961,0.2962,13,57,13,611678,64766,74747,51509,0.5129736408566722,0.4429929047516663
2962,0.2963,22,59,22,611737,64707,74769,51487,0.5125063363325307,0.44311238101795275
2963,0.2964,22,34,22,611771,64673,74791,51465,0.5122370421999747,0.44313661333930326
2964,0.2965,14,62,14,611833,64611,74805,51451,0.511745976428843,0.443306163946856
2965,0.2966,27,46,27,611879,64565,74832,51424,0.511381637308326,0.4433523868642716
2966,0.2967,16,34,16,611913,64531,74848,51408,0.5111123431757698,0.44340558397088126
2967,0.2968,14,45,14,611958,64486,74862,51394,0.5107559244709162,0.44351052813255093
2968,0.2969,16,50,16,612008,64436,74878,51378,0.5103599036877455,0.44362512304211926
2969,0.297,16,58,16,612066,64378,74894,51362,0.5099005195792675,0.44377052013132884
2970,0.2971,13,45,13,612111,64333,74907,51349,0.5095441008744139,0.4438806383015508
2971,0.2972,21,42,21,612153,64291,74928,51328,0.5092114434165504,0.4439408747697178
2972,0.2973,15,49,15,612202,64242,74943,51313,0.5088233430490432,0.4440569425814547
2973,0.2974,15,53,15,612255,64189,74958,51298,0.5084035610188823,0.4441885233835843
2974,0.2975,24,47,24,612302,64142,74982,51274,0.5080313014827018,0.44425382962500864
2975,0.2976,19,38,19,612340,64104,75001,51255,0.5077303256874921,0.44430863651730684
2976,0.2977,29,37,29,612377,64067,75030,51226,0.5074372703079457,0.44431144995793326
2977,0.2978,29,50,29,612427,64017,75059,51197,0.507041249524775,0.4443644001597028
2978,0.2979,18,46,18,612473,63971,75077,51179,0.506676910404258,0.4444550586191924
2979,0.298,19,56,19,612529,63915,75096,51160,0.5062333671271069,0.44457962198566153
2980,0.2981,15,52,15,612581,63863,75111,51145,0.5058215055126093,0.4447081942125765
2981,0.2982,16,66,16,612647,63797,75127,51129,0.505298758078824,0.44488627464629416
2982,0.2983,22,59,22,612706,63738,75149,51107,0.5048314535546825,0.4450084897035134
2983,0.2984,27,54,27,612760,63684,75176,51080,0.5044037511088582,0.44508730960928516
2984,0.2985,22,61,22,612821,63623,75198,51058,0.5039206057533899,0.4452176036135018
2985,0.2986,20,46,20,612867,63577,75218,51038,0.5035562666328729,0.44529948087074117
2986,0.2987,21,36,21,612903,63541,75239,51017,0.50327113166899,0.44533773285148137
2987,0.2988,29,45,29,612948,63496,75268,50988,0.5029147129641364,0.4453722790957688
2988,0.2989,14,42,14,612990,63454,75282,50974,0.502582055506273,0.44546789247387003
2989,0.299,18,61,18,613051,63393,75300,50956,0.5020989101508048,0.445618238900209
2990,0.2991,29,54,29,613105,63339,75329,50927,0.5016712077049803,0.44568813120263245
2991,0.2992,13,37,13,613142,63302,75342,50914,0.501378152325434,0.44576941934580094
2992,0.2993,23,52,23,613194,63250,75365,50891,0.5009662907109365,0.4458608212649267
2993,0.2994,18,51,18,613245,63199,75383,50873,0.5005623495121024,0.445972718984501
2994,0.2995,19,48,19,613293,63151,75402,50854,0.5001821695602585,0.4460681549054866
2995,0.2996,25,53,25,613346,63098,75427,50829,0.4997623875300976,0.4461541162323242
2996,0.2997,19,49,19,613395,63049,75446,50810,0.4993742871625903,0.44625369975144696
2997,0.2998,26,66,26,613461,62983,75472,50784,0.49885153972880497,0.4463860346146071
2998,0.2999,19,57,19,613518,62926,75491,50765,0.49840007603599035,0.4465173144752003
2999,0.3,19,47,19,613565,62879,75510,50746,0.4980278164998099,0.4466094609460946
3000,0.3001,25,53,25,613618,62826,75535,50721,0.49760803446964896,0.4466960817987265
3001,0.3002,12,37,12,613655,62789,75547,50709,0.49731497909010264,0.4467832032282507
3002,0.3003,18,45,18,613700,62744,75565,50691,0.496958560385249,0.44687265835059725
3003,0.3004,15,42,15,613742,62702,75580,50676,0.4966259029273856,0.4469650196687188
3004,0.3005,23,35,23,613777,62667,75603,50653,0.4963486883791661,0.44699082244969995
3005,0.3006,18,61,18,613838,62606,75621,50635,0.4958655430236979,0.4471437023692832
3006,0.3007,18,50,18,613888,62556,75639,50617,0.4954695222405272,0.4472533201381955
3007,0.3008,28,58,28,613946,62498,75667,50589,0.4950101381320492,0.44734584877129996
3008,0.3009,20,51,20,613997,62447,75687,50569,0.49460619693321506,0.4474499185955971
3009,0.301,12,48,12,614045,62399,75699,50557,0.4942260169813712,0.44758135911328306
3010,0.3011,20,54,20,614099,62345,75719,50537,0.49379831453554685,0.4476975957194238
3011,0.3012,18,39,18,614138,62306,75737,50519,0.4934894183246737,0.4477642366496787
3012,0.3013,22,39,22,614177,62267,75759,50497,0.49318052211380053,0.44781135823489765
3013,0.3014,20,58,20,614235,62209,75779,50477,0.4927211380053225,0.4479438439557709
3014,0.3015,23,44,23,614279,62165,75802,50454,0.4923726397161323,0.4480061090934922
3015,0.3016,15,37,15,614316,62128,75817,50439,0.492079584336586,0.4480798102463422
3016,0.3017,23,57,23,614373,62071,75840,50416,0.49162812064377137,0.4481940135304524
3017,0.3018,22,45,22,614418,62026,75862,50394,0.4912717019389178,0.44826543319694007
3018,0.3019,23,65,23,614483,61961,75885,50371,0.49075687492079584,0.4484118505857636
3019,0.302,17,46,17,614529,61915,75902,50354,0.4903925358002788,0.44851205586582227
3020,0.3021,21,57,21,614586,61858,75923,50333,0.4899410721074642,0.4486366999135403
3021,0.3022,17,53,17,614639,61805,75940,50316,0.4895212900773033,0.44876517333951715
3022,0.3023,21,51,21,614690,61754,75961,50295,0.48911734887846914,0.448866121072031
3023,0.3024,24,51,24,614741,61703,75985,50271,0.488713407679635,0.4489524353867862
3024,0.3025,16,28,16,614769,61675,76001,50255,0.48849163604105944,0.44898597337621726
3025,0.3026,24,44,24,614813,61631,76025,50231,0.48814313775186924,0.44904435822710126
3026,0.3027,21,45,21,614858,61586,76046,50210,0.4877867190470156,0.4491216143690293
3027,0.3028,12,43,12,614901,61543,76058,50198,0.4874461411734888,0.44923528516838046
3028,0.3029,18,43,18,614944,61500,76076,50180,0.48710556329996196,0.4493194842406877
3029,0.303,16,39,16,614983,61461,76092,50164,0.4867966670890888,0.44939753639417696
3030,0.3031,22,53,22,615036,61408,76114,50142,0.4863768850589279,0.44950246526221427
3031,0.3032,16,46,16,615082,61362,76130,50126,0.48601254593841087,0.44960892652123996
3032,0.3033,24,49,24,615131,61313,76154,50102,0.48562444557090356,0.44968810303819057
3033,0.3034,20,47,20,615178,61266,76174,50082,0.4852521860347231,0.4497790710205841
3034,0.3035,20,58,20,615236,61208,76194,50062,0.4847928019262451,0.4499146220904107
3035,0.3036,16,31,16,615267,61177,76210,50046,0.48454726904067924,0.44996088938438994
3036,0.3037,15,40,15,615307,61137,76225,50031,0.4842304524141427,0.45004857512953367
3037,0.3038,25,49,25,615356,61088,76250,50006,0.4838423520466354,0.4501233189911246
3038,0.3039,14,58,14,615414,61030,76264,49992,0.4833829679381574,0.4502891318837708
3039,0.304,23,55,23,615469,60975,76287,49969,0.48294734507666964,0.45039839919238533
3040,0.3041,28,36,28,615505,60939,76315,49941,0.4826622101127867,0.45040584415584417
3041,0.3042,25,37,25,615542,60902,76340,49916,0.4823691547332404,0.4504322402497789
3042,0.3043,17,50,17,615592,60852,76357,49899,0.4819731339500697,0.4505512365576835
3043,0.3044,19,54,19,615646,60798,76376,49880,0.48154543150424534,0.4506767379244294
3044,0.3045,17,64,17,615710,60734,76393,49863,0.48103852490178683,0.4508530972811197
3045,0.3046,28,45,28,615755,60689,76421,49835,0.4806821061969332,0.4508975426151786
3046,0.3047,23,55,23,615810,60634,76444,49812,0.48024648333544545,0.45100773228546076
3047,0.3048,16,57,16,615867,60577,76460,49796,0.4797950196426308,0.45116106294111785
3048,0.3049,21,47,21,615914,60530,76481,49775,0.4794227601064504,0.45124881011740176
3049,0.305,18,35,18,615949,60495,76499,49757,0.4791455455582309,0.4513024707034793
3050,0.3051,17,44,17,615993,60451,76516,49740,0.47879704726904065,0.45139802706210125
3051,0.3052,20,53,20,616046,60398,76536,49720,0.47837726523887975,0.45151564685155926
3052,0.3053,21,43,21,616089,60355,76557,49699,0.47803668736535293,0.45158740254784013
3053,0.3054,18,51,18,616140,60304,76575,49681,0.4776327461665188,0.45170705096149477
3054,0.3055,17,37,17,616177,60267,76592,49664,0.4773396907869725,0.45177429478491055
3055,0.3056,27,36,27,616213,60231,76619,49637,0.4770545558230896,0.4517875996650526
3056,0.3057,29,53,29,616266,60178,76648,49608,0.4766347737929287,0.45186089301003773
3057,0.3058,23,45,23,616311,60133,76671,49585,0.47627835508807503,0.4519313148252794
3058,0.3059,21,31,21,616342,60102,76692,49564,0.4760328222025092,0.45195411522258494
3059,0.306,20,59,20,616401,60043,76712,49544,0.47556551767836774,0.4520974203144534
3060,0.3061,20,37,20,616438,60006,76732,49524,0.4752724622988214,0.4521500958641468
3061,0.3062,22,42,22,616480,59964,76754,49502,0.47493980484095805,0.45221347267644746
3062,0.3063,17,40,17,616520,59924,76771,49485,0.4746229882144215,0.45229368699101535
3063,0.3064,20,47,20,616567,59877,76791,49465,0.47425072867824103,0.4523879204697189
3064,0.3065,17,46,17,616613,59831,76808,49448,0.473886389557724,0.4524931597104659
3065,0.3066,15,39,15,616652,59792,76823,49433,0.47357749334685084,0.45257953765163655
3066,0.3067,18,47,18,616699,59745,76841,49415,0.47320523381067037,0.45268413338219127
3067,0.3068,20,41,20,616740,59704,76861,49395,0.4728804967684704,0.45275392075087767
3068,0.3069,19,53,19,616793,59651,76880,49376,0.4724607147383095,0.4528786447393765
3069,0.307,16,43,16,616836,59608,76896,49360,0.47212013686478266,0.4529770207767418
3070,0.3071,14,57,14,616893,59551,76910,49346,0.4716686731719681,0.45314379643149033
3071,0.3072,20,50,20,616943,59501,76930,49326,0.47127265238879734,0.4532514908983984
3072,0.3073,19,52,19,616995,59449,76949,49307,0.4708607907742998,0.4533726874839089
3073,0.3074,21,47,21,617042,59402,76970,49286,0.4704885312381194,0.4534631238039158
3074,0.3075,21,48,21,617090,59354,76991,49265,0.4701083512862755,0.45355784899511137
3075,0.3076,20,46,20,617136,59308,77011,49245,0.46974401216575845,0.45364936943244316
3076,0.3077,13,42,13,617178,59266,77024,49232,0.4694113547078951,0.453759516304448
3077,0.3078,20,39,20,617217,59227,77044,49212,0.4691024584970219,0.45382196442239414
3078,0.3079,15,47,15,617264,59180,77059,49197,0.46873019896084145,0.4539431798259778
3079,0.308,16,56,16,617320,59124,77075,49181,0.46828665568369027,0.4540972254281889
3080,0.3081,29,41,29,617361,59083,77104,49152,0.4679619186414903,0.45412297316025313
3081,0.3082,17,50,17,617411,59033,77121,49135,0.4675658978583196,0.45424709710820205
3082,0.3083,17,52,17,617463,58981,77138,49118,0.46715403624382207,0.4543797814965911
3083,0.3084,20,45,20,617508,58936,77158,49098,0.4667976175389684,0.4544680378399393
3084,0.3085,19,59,19,617567,58877,77177,49079,0.466330313014827,0.454620400904072
3085,0.3086,19,43,19,617610,58834,77196,49060,0.4659897351413002,0.45470554433054666
3086,0.3087,29,44,29,617654,58790,77225,49031,0.46564123685211,0.4547444375399968
3087,0.3088,13,45,13,617699,58745,77238,49018,0.46528481814725636,0.45486855414195965
3088,0.3089,14,50,14,617749,58695,77252,49004,0.46488879736408567,0.4550088673061031
3089,0.309,15,48,15,617797,58647,77267,48989,0.4645086174122418,0.4551358281615816
3090,0.3091,20,45,20,617842,58602,77287,48969,0.46415219870738816,0.45522492121482555
3091,0.3092,21,51,21,617893,58551,77308,48948,0.46374825750855403,0.4553344682276114
3092,0.3093,26,44,26,617937,58507,77334,48922,0.4633997592193638,0.4553891407348109
3093,0.3094,20,41,20,617978,58466,77354,48902,0.46307502217716384,0.45546159004545117
3094,0.3095,23,39,23,618017,58427,77377,48879,0.4627661259662907,0.4555104094831603
3095,0.3096,25,51,25,618068,58376,77402,48854,0.4623621847674566,0.4556001119089807
3096,0.3097,20,47,20,618115,58329,77422,48834,0.46198992523127613,0.45569832871420174
3097,0.3098,24,41,24,618156,58288,77446,48810,0.46166518818907615,0.45575080767147846
3098,0.3099,20,35,20,618191,58253,77466,48790,0.46138797364085665,0.45579813719720114
3099,0.31,22,35,22,618226,58218,77488,48768,0.46111075909263716,0.4558353429420672
3100,0.3101,27,46,27,618272,58172,77515,48741,0.4607464199721201,0.4558940446905428
3101,0.3102,24,42,24,618314,58130,77539,48717,0.46041376251425675,0.45595103278519755
3102,0.3103,20,34,20,618348,58096,77559,48697,0.46014446838170064,0.4559943067429513
3103,0.3104,19,49,19,618397,58047,77578,48678,0.4597563680141934,0.4561068165846803
3104,0.3105,20,48,20,618445,57999,77598,48658,0.45937618806234953,0.45621009403977236
3105,0.3106,16,43,16,618488,57956,77614,48642,0.4590356101888227,0.4563125011726299
3106,0.3107,15,42,15,618530,57914,77629,48627,0.45870295273095935,0.4564158399113956
3107,0.3108,18,40,18,618570,57874,77647,48609,0.45838613610442275,0.45649540302207864
3108,0.3109,21,31,21,618601,57843,77668,48588,0.4581406032188569,0.4565211263635595
3109,0.311,20,33,20,618634,57810,77688,48568,0.45787922950196425,0.45656056703453723
3110,0.3111,27,35,27,618669,57775,77715,48541,0.45760201495374475,0.4565728582715678
3111,0.3112,16,35,16,618704,57740,77731,48525,0.45732480040552526,0.4566414153296005
3112,0.3113,29,38,29,618742,57702,77760,48496,0.45702382461031554,0.4566564342078005
3113,0.3114,16,33,16,618775,57669,77776,48480,0.4567624508934229,0.45671650227510385
3114,0.3115,17,45,17,618820,57624,77793,48463,0.45640603218856923,0.4568231734331256
3115,0.3116,24,34,24,618854,57590,77817,48439,0.4561367380560132,0.45684671174867253
3116,0.3117,21,40,21,618894,57550,77838,48418,0.45581992142947664,0.4569115204590065
3117,0.3118,17,37,17,618931,57513,77855,48401,0.4555268660499303,0.45698396812508263
3118,0.3119,17,55,17,618986,57458,77872,48384,0.4550912431884425,0.45713421893010336
3119,0.312,15,44,15,619030,57414,77887,48369,0.4547427448992523,0.45724738379512775
3120,0.3121,21,47,21,619077,57367,77908,48348,0.45437048536307184,0.4573428557915149
3121,0.3122,17,58,17,619135,57309,77925,48331,0.45391110125459383,0.45750662627792504
3122,0.3123,26,48,26,619183,57261,77951,48305,0.45353092130274997,0.45758103934979066
3123,0.3124,23,44,23,619227,57217,77974,48282,0.45318242301355977,0.45765362704859763
3124,0.3125,21,43,21,619270,57174,77995,48261,0.45284184514003295,0.45773225209844925
3125,0.3126,19,39,19,619309,57135,78014,48242,0.4525329489291598,0.45780388509826625
3126,0.3127,16,40,16,619349,57095,78030,48226,0.45221613230262325,0.4578953864851264
3127,0.3128,22,42,22,619391,57053,78052,48204,0.4518834748447599,0.45796479094027
3128,0.3129,26,36,26,619427,57017,78078,48178,0.45159833988087694,0.45798754693664145
3129,0.313,17,40,17,619467,56977,78095,48161,0.4512815232543404,0.45807415016454567
3130,0.3131,13,38,13,619505,56939,78108,48148,0.45098054745913063,0.4581727521006404
3131,0.3132,14,50,14,619555,56889,78122,48134,0.45058452667595994,0.4583186540091218
3132,0.3133,20,47,20,619602,56842,78142,48114,0.4502122671397795,0.4584206715194939
3133,0.3134,28,52,28,619654,56790,78170,48086,0.44980040552528194,0.45850337541477554
3134,0.3135,18,47,18,619701,56743,78188,48068,0.4494281459891015,0.45861598496341033
3135,0.3136,21,46,21,619747,56697,78209,48047,0.44906380686858444,0.45870885205835177
3136,0.3137,19,38,19,619785,56659,78228,48028,0.4487628310733747,0.4587771165474223
3137,0.3138,14,46,14,619831,56613,78242,48014,0.4483984919528577,0.45890640083343687
3138,0.3139,17,39,17,619870,56574,78259,47997,0.44808959574198454,0.4589895860228935
3139,0.314,16,39,16,619909,56535,78275,47981,0.4477806995311114,0.45907803589880974
3140,0.3141,22,44,22,619953,56491,78297,47959,0.4474322012419212,0.459157491622786
3141,0.3142,21,41,21,619994,56450,78318,47938,0.4471074641997212,0.459229030156723
3142,0.3143,13,35,13,620029,56415,78331,47925,0.4468302496515017,0.4593156986774008
3143,0.3144,19,37,19,620066,56378,78350,47906,0.4465371942719554,0.45938015419431555
3144,0.3145,24,41,24,620107,56337,78374,47882,0.44621245722975544,0.4594363791631085
3145,0.3146,19,35,19,620142,56302,78393,47863,0.44593524268153595,0.45949215187443
3146,0.3147,17,46,17,620188,56256,78410,47846,0.44557090356101886,0.4596069239784058
3147,0.3148,23,38,23,620226,56218,78433,47823,0.44526992776580915,0.4596553281879259
3148,0.3149,18,44,18,620270,56174,78451,47805,0.44492142947661895,0.45975629694457537
3149,0.315,19,34,19,620304,56140,78470,47786,0.44465213534406284,0.4598079402651887
3150,0.3151,25,34,25,620338,56106,78495,47761,0.4443828412115068,0.45982843444019755
3151,0.3152,23,38,23,620376,56068,78518,47738,0.4440818654162971,0.45987707839623915
3152,0.3153,17,44,17,620420,56024,78535,47721,0.4437333671271068,0.45998361366812857
3153,0.3154,20,38,20,620458,55986,78555,47701,0.4434323913318971,0.4600480291646976
3154,0.3155,22,33,22,620491,55953,78577,47679,0.44317101761500444,0.46007989810097266
3155,0.3156,27,45,27,620536,55908,78604,47652,0.4428145989101508,0.4601390498261877
3156,0.3157,22,43,22,620579,55865,78626,47630,0.442474021036624,0.4602154693463452
3157,0.3158,21,49,21,620628,55816,78647,47609,0.4420859206691167,0.46032390621223107
3158,0.3159,12,40,12,620668,55776,78659,47597,0.44176910404258013,0.4604393797219777
3159,0.316,19,51,19,620719,55725,78678,47578,0.44136516284374605,0.460567456898638
3160,0.3161,16,37,16,620756,55688,78694,47562,0.4410721074641997,0.46064891041162226
3161,0.3162,13,50,13,620806,55638,78707,47549,0.44067608668102903,0.4608041710680609
3162,0.3163,16,47,16,620853,55591,78723,47533,0.44030382714484856,0.4609305302354447
3163,0.3164,20,38,20,620891,55553,78743,47513,0.44000285134963885,0.4609958667261755
3164,0.3165,25,50,25,620941,55503,78768,47488,0.43960683056646815,0.46108883300482567
3165,0.3166,20,34,20,620975,55469,78788,47468,0.43933753643391205,0.4611364232491718
3166,0.3167,28,37,28,621012,55432,78816,47440,0.4390444810543657,0.46115561085620965
3167,0.3168,16,51,16,621063,55381,78832,47424,0.43864053985553164,0.46130052040270414
3168,0.3169,14,45,14,621108,55336,78846,47410,0.438284121150678,0.4614291553929107
3169,0.317,19,40,19,621148,55296,78865,47391,0.43796730452414145,0.46150924654532705
3170,0.3171,15,40,15,621188,55256,78880,47376,0.43765048789760486,0.4616104139059942
3171,0.3172,18,51,18,621239,55205,78898,47358,0.4372465466987708,0.4617454637637355
3172,0.3173,15,49,15,621288,55156,78913,47343,0.4368584463312635,0.4618874330481273
3173,0.3174,18,37,18,621325,55119,78931,47325,0.43656539095171715,0.46195970481433757
3174,0.3175,19,37,19,621362,55082,78950,47306,0.4362723355721708,0.46202680001562685
3175,0.3176,21,40,21,621402,55042,78971,47285,0.4359555189456343,0.4620970027460983
3176,0.3177,12,32,12,621434,55010,78983,47273,0.435702065644405,0.4621784656296745
3177,0.3178,15,46,15,621480,54964,78998,47258,0.43533772652388797,0.46230752675549297
3178,0.3179,14,42,14,621522,54922,79012,47244,0.4350050690660246,0.4624238983614901
3179,0.318,24,43,24,621565,54879,79036,47220,0.4346644911924978,0.46249228689801075
3180,0.3181,12,41,12,621606,54838,79048,47208,0.4343397541502978,0.46261489916312254
3181,0.3182,14,41,14,621647,54797,79062,47194,0.4340150171080978,0.4627271033718661
3182,0.3183,19,35,19,621682,54762,79081,47175,0.4337378025598783,0.4627858383118985
3183,0.3184,21,35,21,621717,54727,79102,47154,0.4334605880116589,0.46283409075293724
3184,0.3185,24,37,24,621754,54690,79126,47130,0.43316753263211255,0.4628756629345904
3185,0.3186,23,44,23,621798,54646,79149,47107,0.4328190343429223,0.4629544092066082
3186,0.3187,20,39,20,621837,54607,79169,47087,0.4325101381320492,0.4630263339036718
3187,0.3188,20,39,20,621876,54568,79189,47067,0.43220124192117604,0.46309834210655776
3188,0.3189,16,55,16,621931,54513,79205,47051,0.43176561905968824,0.46326454255444843
3189,0.319,22,35,22,621966,54478,79227,47029,0.43148840451146875,0.4633079492054735
3190,0.3191,16,43,16,622009,54435,79243,47013,0.43114782663794193,0.46341968299030045
3191,0.3192,23,46,23,622055,54389,79266,46990,0.4307834875174249,0.46350822162380767
3192,0.3193,13,41,13,622096,54348,79279,46977,0.4304587504752249,0.46362694300518137
3193,0.3194,18,52,18,622148,54296,79297,46959,0.4300468888607274,0.46376969038565996
3194,0.3195,22,31,22,622179,54265,79319,46937,0.42980135597516156,0.4637951819134009
3195,0.3196,17,47,17,622226,54218,79336,46920,0.42942909643898114,0.4639205837568471
3196,0.3197,22,33,22,622259,54185,79358,46898,0.4291677227220885,0.46395536341422394
3197,0.3198,20,42,20,622301,54143,79378,46878,0.42883506526422505,0.46404212985418875
3198,0.3199,22,55,22,622356,54088,79400,46856,0.4283994424027373,0.46417815818671737
3199,0.32,23,38,23,622394,54050,79423,46833,0.42809846660752754,0.46423084166807094
3200,0.3201,14,43,14,622437,54007,79437,46819,0.4277578887340008,0.46435443238847124
3201,0.3202,15,41,15,622478,53966,79452,46804,0.4274331516918008,0.46446363004862556
3202,0.3203,25,51,25,622529,53915,79477,46779,0.42702921049296666,0.4645659125667865
3203,0.3204,16,42,16,622571,53873,79493,46763,0.4266965530351033,0.4646746691044954
3204,0.3205,18,42,18,622613,53831,79511,46745,0.4263638955772399,0.4647729080496341
3205,0.3206,16,41,16,622654,53790,79527,46729,0.42603915853503993,0.46487728688108715
3206,0.3207,17,37,17,622691,53753,79544,46712,0.4257461031554936,0.4649579455531777
3207,0.3208,19,44,19,622735,53709,79563,46693,0.4253976048663034,0.4650604569630087
3208,0.3209,18,35,18,622770,53674,79581,46675,0.4251203903180839,0.4651267077898136
3209,0.321,13,37,13,622807,53637,79594,46662,0.4248273349385376,0.4652289653934735
3210,0.3211,13,30,13,622837,53607,79607,46649,0.42458972246863513,0.46529883498244495
3211,0.3212,15,38,15,622875,53569,79622,46634,0.4242887466734254,0.465395247647276
3212,0.3213,20,48,20,622923,53521,79642,46614,0.42390856672158156,0.465511559394817
3213,0.3214,15,39,15,622962,53482,79657,46599,0.4235996705107084,0.4656128535885932
3214,0.3215,13,42,13,623004,53440,79670,46586,0.42326701305284503,0.46573890788395017
3215,0.3216,21,47,21,623051,53393,79691,46565,0.42289475351666456,0.46584565517517357
3216,0.3217,19,39,19,623090,53354,79710,46546,0.4225858573057914,0.4659259259259259
3217,0.3218,21,44,21,623134,53310,79731,46525,0.4222373590166012,0.4660189312365403
3218,0.3219,21,50,21,623184,53260,79752,46504,0.4218413382334305,0.4661400906138487
3219,0.322,23,37,23,623221,53223,79775,46481,0.4215482828538842,0.4661899221696221
3220,0.3221,15,40,15,623261,53183,79790,46466,0.4212314662273476,0.4662967014219912
3221,0.3222,14,38,14,623299,53145,79804,46452,0.42093049043213787,0.4663995903491069
3222,0.3223,19,33,19,623332,53112,79823,46433,0.4206691167152452,0.46645235822994624
3223,0.3224,23,47,23,623379,53065,79846,46410,0.42029685717906473,0.4665493842674039
3224,0.3225,23,40,23,623419,53025,79869,46387,0.4199800405525282,0.46661368848831125
3225,0.3226,20,32,20,623451,52993,79889,46367,0.41972658725129897,0.46665660225442834
3226,0.3227,21,34,21,623485,52959,79910,46346,0.41945729311874286,0.46670358995015354
3227,0.3228,13,43,13,623528,52916,79923,46333,0.41911671524521604,0.4668359378935808
3228,0.3229,17,30,17,623558,52886,79940,46316,0.41887910277531365,0.4668857482712042
3229,0.323,20,36,20,623594,52850,79960,46296,0.41859396781143077,0.46694773364533115
3230,0.3231,22,38,22,623632,52812,79982,46274,0.418292992016221,0.46700845729971946
3231,0.3232,15,35,15,623667,52777,79997,46259,0.4180157774680015,0.4670927743446827
3232,0.3233,14,40,14,623707,52737,80011,46245,0.41769896084146496,0.4672061586955204
3233,0.3234,16,55,16,623762,52682,80027,46229,0.41726333797997717,0.4673797656479057
3234,0.3235,18,43,18,623805,52639,80045,46211,0.4169227601064504,0.4674860900354072
3235,0.3236,23,44,23,623849,52595,80068,46188,0.41657426181726015,0.4675703309273863
3236,0.3237,14,38,14,623887,52557,80082,46174,0.41627328602205044,0.46767479312475313
3237,0.3238,13,46,13,623933,52511,80095,46161,0.4159089469015334,0.4678226852602562
3238,0.3239,23,27,23,623960,52484,80118,46138,0.41569509567862123,0.467826651254284
3239,0.324,13,44,13,624004,52440,80131,46125,0.41534659738943097,0.4679653020849186
3240,0.3241,18,41,18,624045,52399,80149,46107,0.41502186034723104,0.4680628591151808
3241,0.3242,20,33,20,624078,52366,80169,46087,0.4147604866303384,0.46811168781042733
3242,0.3243,27,43,27,624121,52323,80196,46060,0.41441990875681156,0.4681703139770082
3243,0.3244,15,37,15,624158,52286,80211,46045,0.41412685337726524,0.4682653486692905
3244,0.3245,21,56,21,624214,52230,80232,46024,0.41368331010011405,0.4684185885561911
3245,0.3246,26,29,26,624243,52201,80258,45998,0.41345361804587505,0.4684161753174676
3246,0.3247,24,45,24,624288,52156,80282,45974,0.4130971993410214,0.46850096810353614
3247,0.3248,23,42,23,624330,52114,80305,45951,0.41276454188315803,0.46857696425840006
3248,0.3249,27,37,27,624367,52077,80332,45924,0.4124714865036117,0.46860746318915114
3249,0.325,23,51,23,624418,52026,80355,45901,0.41206754530477757,0.4687267045860692
3250,0.3251,14,33,14,624451,51993,80369,45887,0.4118061715878849,0.4688087454025337
3251,0.3252,18,41,18,624492,51952,80387,45869,0.411481434545685,0.46890749430081474
3252,0.3253,20,34,20,624526,51918,80407,45849,0.41121214041312887,0.46896191966614503
3253,0.3254,18,32,18,624558,51886,80425,45831,0.41095868711189965,0.469017673485678
3254,0.3255,21,37,21,624595,51849,80446,45810,0.4106656317323533,0.46908119067367066
3255,0.3256,13,46,13,624641,51803,80459,45797,0.4103012926118363,0.4692315573770492
3256,0.3257,19,40,19,624681,51763,80478,45778,0.4099844759852997,0.4693205933914969
3257,0.3258,19,47,19,624728,51716,80497,45759,0.40961221644911927,0.46944344703770197
3258,0.3259,21,48,21,624776,51668,80518,45738,0.40923203649727535,0.46956039669014227
3259,0.326,19,35,19,624811,51633,80537,45719,0.4089548219490559,0.46962568822417616
3260,0.3261,26,38,26,624849,51595,80563,45693,0.40865384615384615,0.46966737932735797
3261,0.3262,30,46,30,624895,51549,80593,45663,0.4082895070333291,0.46972595975805453
3262,0.3263,14,45,14,624940,51504,80607,45649,0.40793308832847547,0.4698671168157442
3263,0.3264,24,35,24,624975,51469,80631,45625,0.407655873780256,0.469905452448143
3264,0.3265,21,53,21,625028,51416,80652,45604,0.40723609175009506,0.47004741290455576
3265,0.3266,21,42,21,625070,51374,80673,45583,0.40690343429223164,0.470136245964706
3266,0.3267,23,38,23,625108,51336,80696,45560,0.4066024584970219,0.47019484808454426
3267,0.3268,17,44,17,625152,51292,80713,45543,0.4062539602078317,0.4703154851035266
3268,0.3269,20,45,20,625197,51247,80733,45523,0.4058975415029781,0.4704247184044642
3269,0.327,10,35,10,625232,51212,80743,45513,0.4056203269547586,0.47054019126389246
3270,0.3271,25,33,25,625265,51179,80768,45488,0.4053589532378659,0.47056389460726
3271,0.3272,16,40,16,625305,51139,80784,45472,0.4050421366113294,0.4706710415998178
3272,0.3273,19,32,19,625337,51107,80803,45453,0.4047886833101001,0.4707228666114333
3273,0.3274,24,46,24,625383,51061,80827,45429,0.40442434418958306,0.47081562856254533
3274,0.3275,13,54,13,625437,51007,80840,45416,0.4039966417437587,0.47100795453366934
3275,0.3276,18,40,18,625477,50967,80858,45398,0.40367982511722217,0.471104654179422
3276,0.3277,22,39,22,625516,50928,80880,45376,0.403370928906349,0.47117461372320985
3277,0.3278,16,32,16,625548,50896,80896,45360,0.40311747560511973,0.4712433510638298
3278,0.3279,9,40,9,625588,50856,80905,45351,0.4028006589785832,0.4713898157098756
3279,0.328,14,27,14,625615,50829,80919,45337,0.402586807755671,0.47144520932554124
3280,0.3281,24,48,24,625663,50781,80943,45313,0.40220662780382715,0.4715486919058422
3281,0.3282,18,41,18,625704,50740,80961,45295,0.40188189076162717,0.4716509605872859
3282,0.3283,17,45,17,625749,50695,80978,45278,0.4015254720567735,0.4717785210423765
3283,0.3284,21,35,21,625784,50660,80999,45257,0.40124825750855403,0.47183502403119365
3284,0.3285,15,30,15,625814,50630,81014,45242,0.40101064503865164,0.4719000333778371
3285,0.3286,11,35,11,625849,50595,81025,45231,0.40073343049043214,0.47201177133554567
3286,0.3287,26,42,26,625891,50553,81051,45205,0.40040077303256877,0.4720754401721005
3287,0.3288,17,37,17,625928,50516,81068,45188,0.40010771765302244,0.4721641728663379
3288,0.3289,16,32,16,625960,50484,81084,45172,0.39985426435179316,0.47223383791921053
3289,0.329,21,38,21,625998,50446,81105,45151,0.39955328855658345,0.4723056162850299
3290,0.3291,18,31,18,626029,50415,81123,45133,0.3993077556710176,0.4723594423745133
3291,0.3292,12,27,12,626056,50388,81135,45121,0.39909390444810544,0.4724266823021914
3292,0.3293,22,29,22,626085,50359,81157,45099,0.39886421239386644,0.47244861614532047
3293,0.3294,15,38,15,626123,50321,81172,45084,0.3985632365986567,0.4725538493789634
3294,0.3295,19,48,19,626171,50273,81191,45065,0.3981830566468128,0.47268665170236424
3295,0.3296,16,54,16,626225,50219,81207,45049,0.39775535420098845,0.47286602006969813
3296,0.3297,15,31,15,626256,50188,81222,45034,0.3975098213154226,0.47293692634055157
3297,0.3298,15,54,15,626310,50134,81237,45019,0.39708211886959827,0.4731222347167194
3298,0.3299,25,41,25,626351,50093,81262,44994,0.3967573818273983,0.47318771230557277
3299,0.33,15,37,15,626388,50056,81277,44979,0.39646432644785196,0.47328878834113747
3300,0.3301,17,31,17,626419,50025,81294,44962,0.3962187935622862,0.4733489845978923
3301,0.3302,16,36,16,626455,49989,81310,44946,0.39593365859840324,0.47343972191499445
3302,0.3303,24,37,24,626492,49952,81334,44922,0.3956406032188569,0.4734911566920336
3303,0.3304,25,44,25,626536,49908,81359,44897,0.3952921049296667,0.4735720689837034
3304,0.3305,17,36,17,626572,49872,81376,44880,0.3950069699657838,0.4736575481256332
3305,0.3306,16,39,16,626611,49833,81392,44864,0.39469807375491067,0.4737636883956197
3306,0.3307,15,42,15,626653,49791,81407,44849,0.39436541629704724,0.4738905325443787
3307,0.3308,17,42,17,626695,49749,81424,44832,0.39403275883918387,0.4740064072065214
3308,0.3309,20,35,20,626730,49714,81444,44812,0.3937555442909644,0.47407062607113387
3309,0.331,21,30,21,626760,49684,81465,44791,0.393517931821062,0.4741042603863456
3310,0.3311,14,50,14,626810,49634,81479,44777,0.3931219110378913,0.47427736174810137
3311,0.3312,19,42,19,626852,49592,81498,44758,0.39278925358002786,0.4743826179120297
3312,0.3313,25,48,25,626900,49544,81523,44733,0.392409073628184,0.4744847629856699
3313,0.3314,11,37,11,626937,49507,81534,44722,0.3921160182486377,0.47460972736630974
3314,0.3315,20,41,20,626978,49466,81554,44702,0.3917912812064377,0.4747047829411265
3315,0.3316,12,40,12,627018,49426,81566,44690,0.39147446457990115,0.47483955969229463
3316,0.3317,16,38,16,627056,49388,81582,44674,0.39117348878469144,0.47494205949267504
3317,0.3318,11,32,11,627088,49356,81593,44663,0.39092003548346216,0.47504227868835025
3318,0.3319,14,32,14,627120,49324,81607,44649,0.39066658218223294,0.4751258340161536
3319,0.332,26,41,26,627161,49283,81633,44623,0.39034184514003295,0.47518795391135815
3320,0.3321,12,47,12,627208,49236,81645,44611,0.3899695856038525,0.4753588287318721
3321,0.3322,21,30,21,627238,49206,81666,44590,0.3897319731339501,0.4753934069683142
3322,0.3323,29,32,29,627270,49174,81695,44561,0.3894785198327208,0.4753933962767376
3323,0.3324,18,33,18,627303,49141,81713,44543,0.38921714611582814,0.47546005721361173
3324,0.3325,12,36,12,627339,49105,81725,44531,0.38893201115194526,0.4755756333034303
3325,0.3326,21,43,21,627382,49062,81746,44510,0.38859143327841844,0.47567648441841576
3326,0.3327,17,39,17,627421,49023,81763,44493,0.3882825370675453,0.4757795457461825
3327,0.3328,16,34,16,627455,48989,81779,44477,0.38801324293498923,0.47586288061969056
3328,0.3329,16,33,16,627488,48956,81795,44461,0.38775186921809657,0.47594120984403265
3329,0.333,21,38,21,627526,48918,81816,44440,0.38745089342288686,0.476017052636089
3330,0.3331,12,38,12,627564,48880,81828,44428,0.3871499176276771,0.47614352467098214
3331,0.3332,20,39,20,627603,48841,81848,44408,0.38684102141680393,0.47623030809981876
3332,0.3333,19,39,19,627642,48802,81867,44389,0.38653212520593083,0.4763228208732603
3333,0.3334,22,36,22,627678,48766,81889,44367,0.3862469902420479,0.4763832368762952
3334,0.3335,20,27,20,627705,48739,81909,44347,0.3860331390191357,0.4764089121887287
3335,0.3336,18,34,18,627739,48705,81927,44329,0.38576384488657967,0.47648171636176023
3336,0.3337,21,41,21,627780,48664,81948,44308,0.3854391078443797,0.4765735920492191
3337,0.3338,11,29,11,627809,48635,81959,44297,0.3852094157901407,0.47666035380708477
3338,0.3339,20,31,20,627840,48604,81979,44277,0.38496388290457484,0.4767067538032536
3339,0.334,18,36,18,627876,48568,81997,44259,0.3846787479406919,0.4767901580359163
3340,0.3341,17,32,17,627908,48536,82014,44242,0.3844252946394627,0.47685873806290285
3341,0.3342,14,42,14,627950,48494,82028,44228,0.3840926371815993,0.4769957507387675
3342,0.3343,19,51,19,628001,48443,82047,44209,0.38368869598276517,0.477151059879981
3343,0.3344,21,32,21,628033,48411,82068,44188,0.38343524268153595,0.47719737794144645
3344,0.3345,20,43,20,628076,48368,82088,44168,0.38309466480800913,0.47730612950635426
3345,0.3346,17,35,17,628111,48333,82105,44151,0.38281745025978964,0.47739068379395355
3346,0.3347,12,36,12,628147,48297,82117,44139,0.38253231529590676,0.47750876281968063
3347,0.3348,20,47,20,628194,48250,82137,44119,0.3821600557597263,0.477638601695374
3348,0.3349,13,47,13,628241,48203,82150,44106,0.3817877962235458,0.47780823105006015
3349,0.335,19,25,19,628266,48178,82169,44087,0.38158978583196046,0.47783016311710835
3350,0.3351,13,38,13,628304,48140,82182,44074,0.38128881003675075,0.477953456091266
3351,0.3352,15,37,15,628341,48103,82197,44059,0.3809957546572044,0.47806037195373363
3352,0.3353,15,39,15,628380,48064,82212,44044,0.38068685844633127,0.4781777912884874
3353,0.3354,23,36,23,628416,48028,82235,44021,0.3804017234824484,0.4782344186248628
3354,0.3355,9,23,9,628439,48005,82244,44012,0.3802195539221898,0.47830292228609933
3355,0.3356,17,35,17,628474,47970,82261,43995,0.3799423393739704,0.47838851737073884
3356,0.3357,18,38,18,628512,47932,82279,43977,0.3796413635787606,0.4784841528033163
3357,0.3358,21,40,21,628552,47892,82300,43956,0.37932454695222406,0.4785732950091455
3358,0.3359,16,30,16,628582,47862,82316,43940,0.3790869344823216,0.478638809611991
3359,0.336,21,25,21,628607,47837,82337,43919,0.37888892409073627,0.47864989755438336
3360,0.3361,13,32,13,628639,47805,82350,43906,0.37863547078950704,0.47874300792707525
3361,0.3362,16,45,16,628684,47760,82366,43890,0.3782790520846534,0.4788870703764321
3362,0.3363,18,29,18,628713,47731,82384,43872,0.3780493600304144,0.4789362793794963
3363,0.3364,25,43,25,628756,47688,82409,43847,0.3777087821568876,0.47901895449827936
3364,0.3365,18,42,18,628798,47646,82427,43829,0.3773761246990242,0.47913637605903253
3365,0.3366,24,39,24,628837,47607,82451,43805,0.37706722848815105,0.47920404323283594
3366,0.3367,16,28,16,628865,47579,82467,43789,0.3768454568495755,0.47925969704929516
3367,0.3368,23,31,23,628896,47548,82490,43766,0.37659992396400965,0.47929123683115404
3368,0.3369,15,35,15,628931,47513,82505,43751,0.37632270941579016,0.47938946353436185
3369,0.337,10,32,10,628963,47481,82515,43741,0.3760692561145609,0.4795005590756616
3370,0.3371,22,34,22,628997,47447,82537,43719,0.3757999619820048,0.479553781014852
3371,0.3372,19,33,19,629030,47414,82556,43700,0.37553858826511216,0.47961893891169305
3372,0.3373,16,38,16,629068,47376,82572,43684,0.3752376124699024,0.4797276520975181
3373,0.3374,14,37,14,629105,47339,82586,43670,0.3749445570903561,0.47984265292443606
3374,0.3375,14,37,14,629142,47302,82600,43656,0.3746515017108098,0.47995778271290046
3375,0.3376,21,22,21,629164,47280,82621,43635,0.37447725256621467,0.4799538030028048
3376,0.3377,23,34,23,629198,47246,82644,43612,0.3742079584336586,0.4800017609896762
3377,0.3378,19,44,19,629242,47202,82663,43593,0.37385946014446836,0.48012555757475633
3378,0.3379,16,44,16,629286,47158,82679,43577,0.37351096185527816,0.48026671075108834
3379,0.338,18,39,18,629325,47119,82697,43559,0.373202065644405,0.480370100796224
3380,0.3381,20,35,20,629360,47084,82717,43539,0.3729248510961855,0.4804409476622932
3381,0.3382,19,36,19,629396,47048,82736,43520,0.3726397161323026,0.4805229220033566
3382,0.3383,16,42,16,629438,47006,82752,43504,0.37230705867443925,0.48065407137332894
3383,0.3384,19,37,19,629475,46969,82771,43485,0.3720140032948929,0.4807415924116125
3384,0.3385,6,35,6,629510,46934,82777,43479,0.37173678874667343,0.48089323438001175
3385,0.3386,17,38,17,629548,46896,82794,43462,0.3714358129514637,0.48099780871643905
3386,0.3387,13,29,13,629577,46867,82807,43449,0.3712061208972247,0.48107754993578106
3387,0.3388,13,39,13,629616,46828,82820,43436,0.37089722468635156,0.4812106709208544
3388,0.3389,16,37,16,629653,46791,82836,43420,0.37060416930680523,0.48131602576182503
3389,0.339,16,37,16,629690,46754,82852,43404,0.3703111139272589,0.48142150446993054
3390,0.3391,16,24,16,629714,46730,82868,43388,0.37012102395133695,0.48145764442175815
3391,0.3392,12,35,12,629749,46695,82880,43376,0.36984380940311745,0.48157564587936186
3392,0.3393,16,36,16,629785,46659,82896,43360,0.36955867443923457,0.4816760906030949
3393,0.3394,21,34,21,629819,46625,82917,43339,0.3692893803066785,0.4817371393001645
3394,0.3395,23,41,23,629860,46584,82940,43316,0.36896464326447853,0.48182424916573974
3395,0.3396,18,35,18,629895,46549,82958,43298,0.36868742871625904,0.48190813271450356
3396,0.3397,14,45,14,629940,46504,82972,43284,0.3683310100114054,0.48206887334610415
3397,0.3398,22,32,22,629972,46472,82994,43262,0.36807755671017617,0.4821138030178082
3398,0.3399,22,38,22,630010,46434,83016,43240,0.3677765809149664,0.4821910475723175
3399,0.34,22,37,22,630047,46397,83038,43218,0.3674835255354201,0.48226301400435195
3400,0.3401,27,36,27,630083,46361,83065,43191,0.3671983905715372,0.4823007861354297
3401,0.3402,15,34,15,630117,46327,83080,43176,0.36692909643898114,0.4823972380814051
3402,0.3403,17,41,17,630158,46286,83097,43159,0.36660435939678115,0.4825199843479233
3403,0.3404,18,29,18,630187,46257,83115,43141,0.36637466734254215,0.4825723170540728
3404,0.3405,15,32,15,630219,46225,83130,43126,0.36612121404131287,0.48265828026546986
3405,0.3406,23,41,23,630260,46184,83153,43103,0.36579647699911294,0.48274664844826237
3406,0.3407,18,43,18,630303,46141,83171,43085,0.3654558991255861,0.482874946764396
3407,0.3408,9,38,9,630341,46103,83180,43076,0.36515492333037636,0.48302851568194305
3408,0.3409,14,35,14,630376,46068,83194,43062,0.36487770878215686,0.4831369909121508
3409,0.341,23,31,23,630407,46037,83217,43039,0.364632175896591,0.48317167362701513
3410,0.3411,24,27,24,630434,46010,83241,43015,0.36441832467367885,0.48317888233642237
3411,0.3412,12,35,12,630469,45975,83253,43003,0.3641411101254594,0.48329924250938433
3412,0.3413,10,46,10,630515,45929,83263,42993,0.3637767710049423,0.48349114954679384
3413,0.3414,22,42,22,630557,45887,83285,42971,0.36344411354707895,0.4835917981498571
3414,0.3415,21,29,21,630586,45858,83306,42950,0.36321442149283995,0.48362760111701647
3415,0.3416,18,29,18,630615,45829,83324,42932,0.36298472943860094,0.48368089588896024
3416,0.3417,17,32,17,630647,45797,83341,42915,0.3627312761373717,0.4837564252863198
3417,0.3418,19,34,19,630681,45763,83360,42896,0.3624619820048156,0.4838313087221827
3418,0.3419,13,27,13,630708,45736,83373,42883,0.36224813078190343,0.4839030004852233
3419,0.342,27,46,27,630754,45690,83400,42856,0.3618837916613864,0.48399701849885934
3420,0.3421,27,37,27,630791,45653,83427,42829,0.3615907362818401,0.48404195203544226
3421,0.3422,14,31,14,630822,45622,83441,42815,0.36134520339627424,0.4841299456109999
3422,0.3423,14,27,14,630849,45595,83455,42801,0.36113135217336206,0.4841961174713788
3423,0.3424,19,38,19,630887,45557,83474,42782,0.36083037637815235,0.48429346041952026
3424,0.3425,21,39,21,630926,45518,83495,42761,0.3605214801672792,0.48438473476138155
3425,0.3426,19,34,19,630960,45484,83514,42742,0.3602521860347231,0.4844603631582527
3426,0.3427,14,46,14,631006,45438,83528,42728,0.35988784691420606,0.48463126375246696
3427,0.3428,14,34,14,631040,45404,83542,42714,0.35961855278165,0.48473637622279214
3428,0.3429,28,36,28,631076,45368,83570,42686,0.35933341781776706,0.4847707088831853
3429,0.343,19,35,19,631111,45333,83589,42667,0.35905620326954757,0.4848522727272727
3430,0.3431,14,35,14,631146,45298,83603,42653,0.3587789887213281,0.48496321815556387
3431,0.3432,12,28,12,631174,45270,83615,42641,0.3585572170827525,0.48504737746129606
3432,0.3433,20,40,20,631214,45230,83635,42621,0.35824040045621597,0.48515099429716224
3433,0.3434,21,39,21,631253,45191,83656,42600,0.3579315042453428,0.48524336207583924
3434,0.3435,16,45,16,631298,45146,83672,42584,0.35757508554048917,0.4853983813974695
3435,0.3436,20,29,20,631327,45117,83692,42564,0.35734539348625016,0.48544154377801346
3436,0.3437,15,34,15,631361,45083,83707,42549,0.35707609935369405,0.4855418112105167
3437,0.3438,25,35,25,631396,45048,83732,42524,0.3567988848054746,0.48558900105056413
3438,0.3439,22,35,22,631431,45013,83754,42502,0.3565216702572551,0.4856538879049306
3439,0.344,19,30,19,631461,44983,83773,42483,0.35628405778735267,0.48570873253607116
3440,0.3441,14,33,14,631494,44950,83787,42469,0.35602268407046,0.48580972099886754
3441,0.3442,14,33,14,631527,44917,83801,42455,0.35576131035356734,0.48591081811106535
3442,0.3443,12,38,12,631565,44879,83813,42443,0.3554603345583576,0.4860516250200408
3443,0.3444,25,28,25,631593,44851,83838,42418,0.355238562919782,0.4860603421604464
3444,0.3445,24,38,24,631631,44813,83862,42394,0.3549375871245723,0.48613070051716034
3445,0.3446,11,31,11,631662,44782,83873,42383,0.35469205423900646,0.48623874261458155
3446,0.3447,20,42,20,631704,44740,83893,42363,0.3543593967811431,0.486355234607304
3447,0.3448,7,34,7,631738,44706,83900,42356,0.354090102648587,0.48650387080471386
3448,0.3449,25,39,25,631777,44667,83925,42331,0.3537812064377138,0.4865744040092876
3449,0.345,11,26,11,631803,44641,83936,42320,0.3535752756304651,0.48665493727073056
3450,0.3451,16,28,16,631831,44613,83952,42304,0.3533535039918895,0.48671721297329634
3451,0.3452,19,30,19,631861,44583,83971,42285,0.3531158915219871,0.4867730349495787
3452,0.3453,10,36,10,631897,44547,83981,42275,0.35283075655810414,0.4869157586786759
3453,0.3454,24,40,24,631937,44507,84005,42251,0.3525139399315676,0.4869983171580719
3454,0.3455,15,39,15,631976,44468,84020,42236,0.35220504372069444,0.487128621516885
3455,0.3456,16,50,16,632026,44418,84036,42220,0.35180902293752375,0.48731503497310646
3456,0.3457,16,40,16,632066,44378,84052,42204,0.3514922063109872,0.48744542745605324
3457,0.3458,26,40,26,632106,44338,84078,42178,0.35117538968445067,0.48751675990568216
3458,0.3459,21,37,21,632143,44301,84099,42157,0.35088233430490434,0.48760091605172456
3459,0.346,16,30,16,632173,44271,84115,42141,0.3506447218350019,0.48767532287182336
3460,0.3461,16,31,16,632204,44240,84131,42125,0.35039918894943606,0.4877554564927922
3461,0.3462,19,34,19,632238,44206,84150,42106,0.35012989481688,0.4878348317731022
3462,0.3463,22,30,22,632268,44176,84172,42084,0.34989228234697756,0.4878738696962671
3463,0.3464,19,39,19,632307,44137,84191,42065,0.3495833861361044,0.48798171736154616
3464,0.3465,15,38,15,632345,44099,84206,42050,0.3492824103408947,0.4881078132073501
3465,0.3466,20,34,20,632379,44065,84226,42030,0.34901311620833864,0.48818165979441314
3466,0.3467,10,19,10,632398,44046,84236,42020,0.3488626283107337,0.48822996305161154
3467,0.3468,14,28,14,632426,44018,84250,42006,0.34864085667215816,0.488305589137915
3468,0.3469,18,33,18,632459,43985,84268,41988,0.3483794829552655,0.48838588859293036
3469,0.347,18,32,18,632491,43953,84286,41970,0.3481260296540362,0.4884605984427918
3470,0.3471,17,46,17,632537,43907,84303,41953,0.3477616905335192,0.488621010948055
3471,0.3472,23,37,23,632574,43870,84326,41930,0.34746863515397286,0.4886946386946387
3472,0.3473,17,39,17,632613,43831,84343,41913,0.34715973894309976,0.48881554394476584
3473,0.3474,13,32,13,632645,43799,84356,41900,0.3469062856418705,0.48892052416014187
3474,0.3475,19,35,19,632680,43764,84375,41881,0.346629071093651,0.4890069472823866
3475,0.3476,25,33,25,632713,43731,84400,41856,0.3463676973767583,0.48904623365698063
3476,0.3477,15,28,15,632741,43703,84415,41841,0.34614592573818276,0.48911671186757694
3477,0.3478,16,37,16,632778,43666,84431,41825,0.34585287035863643,0.4892327847375747
3478,0.3479,17,30,17,632808,43636,84448,41808,0.345615257888734,0.48930293525584007
3479,0.348,13,28,13,632836,43608,84461,41795,0.3453934862501584,0.4893856187721743
3480,0.3481,18,21,18,632857,43587,84479,41777,0.34522715752122674,0.48939834122112363
3481,0.3482,22,39,22,632896,43548,84501,41755,0.3449182613103536,0.4894904047923285
3482,0.3483,16,38,16,632934,43510,84517,41739,0.3446172855151438,0.4896127813815998
3483,0.3484,15,38,15,632972,43472,84532,41724,0.3443163097199341,0.4897413024085638
3484,0.3485,16,34,16,633006,43438,84548,41708,0.34404701558737805,0.4898409790242642
3485,0.3486,16,38,16,633044,43400,84564,41692,0.3437460397921683,0.4899638038828562
3486,0.3487,15,39,15,633083,43361,84579,41677,0.3434371435812951,0.49009854418024884
3487,0.3488,18,20,18,633103,43341,84597,41659,0.3432787352680269,0.49010588235294117
3488,0.3489,9,31,9,633134,43310,84606,41650,0.34303320238246104,0.4902306967984934
3489,0.349,17,31,17,633165,43279,84623,41633,0.3427876694968952,0.49030761258714906
3490,0.3491,16,28,16,633193,43251,84639,41617,0.3425658978583196,0.49037328557288967
3491,0.3492,20,33,20,633226,43218,84659,41597,0.3423045241414269,0.49044390732771326
3492,0.3493,15,31,15,633257,43187,84674,41582,0.3420589912558611,0.4905330958251248
3493,0.3494,12,28,12,633285,43159,84686,41570,0.3418372196172855,0.49062304523834815
3494,0.3495,23,38,23,633323,43121,84709,41547,0.34153624382207576,0.49070487078943636
3495,0.3496,17,37,17,633360,43084,84726,41530,0.3412431884425295,0.49081712246200393
3496,0.3497,16,38,16,633398,43046,84742,41514,0.3409422126473197,0.4909413434247871
3497,0.3498,15,41,15,633439,43005,84757,41499,0.34061747560511973,0.4910891792104516
3498,0.3499,18,27,18,633466,42978,84775,41481,0.34040362438220756,0.4911377117891521
3499,0.35,8,33,8,633499,42945,84783,41473,0.3401422506653149,0.4912814802530266
3500,0.3501,19,43,19,633542,42902,84802,41454,0.33980167279178813,0.4914173265683532
3501,0.3502,22,28,22,633570,42874,84824,41432,0.3395799011532125,0.49144782103290396
3502,0.3503,16,31,16,633601,42843,84840,41416,0.3393343682676467,0.49153206185689363
3503,0.3504,16,36,16,633637,42807,84856,41400,0.3390492333037638,0.4916455876589832
3504,0.3505,22,36,22,633673,42771,84878,41378,0.33876409833988086,0.4917230151279278
3505,0.3506,11,39,11,633712,42732,84889,41367,0.3384552021290077,0.49188456462026897
3506,0.3507,19,38,19,633750,42694,84908,41348,0.338154226333798,0.491992099188501
3507,0.3508,15,35,15,633785,42659,84923,41333,0.3378770117855785,0.4921063910848652
3508,0.3509,18,28,18,633813,42631,84941,41315,0.33765524014700293,0.4921616277130536
3509,0.351,12,26,12,633839,42605,84953,41303,0.33744930933975414,0.49224150259808364
3510,0.3511,20,27,20,633866,42578,84973,41283,0.33723545811684197,0.49227889006808884
3511,0.3512,13,23,13,633889,42555,84986,41270,0.33705328855658345,0.4923352221890844
3512,0.3513,16,26,16,633915,42529,85002,41254,0.33684735774933466,0.4923910578518315
3513,0.3514,20,33,20,633948,42496,85022,41234,0.336585984032442,0.49246387196942554
3514,0.3515,18,25,18,633973,42471,85040,41216,0.33638797364085665,0.4925018222663018
3515,0.3516,22,30,22,634003,42441,85062,41194,0.33615036117095426,0.49254498714652956
3516,0.3517,18,39,18,634042,42402,85080,41176,0.3358414649600811,0.4926655339921989
3517,0.3518,16,23,16,634065,42379,85096,41160,0.3356592953998226,0.4927040065119286
3518,0.3519,18,32,18,634097,42347,85114,41142,0.3354058420985933,0.4927834804585035
3519,0.352,13,28,13,634125,42319,85127,41129,0.33518407046001775,0.49286981113987155
3520,0.3521,16,32,16,634157,42287,85143,41113,0.33493061715878847,0.49296163069544363
3521,0.3522,20,39,20,634196,42248,85163,41093,0.33462172094791537,0.4930706375013499
3522,0.3523,20,32,20,634228,42216,85183,41073,0.3343682676466861,0.49313834960198827
3523,0.3524,19,37,19,634265,42179,85202,41054,0.33407521226713977,0.49324186320329677
3524,0.3525,17,30,17,634295,42149,85219,41037,0.33383759979723737,0.49331618301156444
3525,0.3526,13,34,13,634329,42115,85232,41024,0.33356830566468126,0.49343869904617566
3526,0.3527,12,40,12,634369,42075,85244,41012,0.3332514890381447,0.4936030907362163
3527,0.3528,11,32,11,634401,42043,85255,41001,0.3329980357369155,0.4937262174269062
3528,0.3529,20,30,20,634431,42013,85275,40981,0.33276042326701305,0.49378268308552425
3529,0.353,18,31,18,634462,41982,85293,40963,0.3325148903814472,0.4938573753692206
3530,0.3531,19,35,19,634497,41947,85312,40944,0.3322376758332277,0.4939498859948607
3531,0.3532,14,28,14,634525,41919,85326,40930,0.33201590419465216,0.49403130997356637
3532,0.3533,18,27,18,634552,41892,85344,40912,0.33180205297174,0.4940824114777064
3533,0.3534,20,29,20,634581,41863,85364,40892,0.331572360917501,0.49413328499788534
3534,0.3535,18,40,18,634621,41823,85382,40874,0.3312555442909644,0.4942621860526984
3535,0.3536,13,29,13,634650,41794,85395,40861,0.33102585223672537,0.4943560583146815
3536,0.3537,20,37,20,634687,41757,85415,40841,0.33073279685717905,0.4944550715513693
3537,0.3538,19,21,19,634708,41736,85434,40822,0.33056646812824736,0.494464497686475
3538,0.3539,15,29,15,634737,41707,85449,40807,0.33033677607400835,0.494546380008241
3539,0.354,21,36,21,634773,41671,85470,40786,0.33005164111012547,0.4946335665862207
3540,0.3541,19,38,19,634811,41633,85489,40767,0.3297506653149157,0.494745145631068
3541,0.3542,15,34,15,634845,41599,85504,40752,0.32948137118235965,0.4948573787810713
3542,0.3543,16,41,16,634886,41558,85520,40736,0.32915663414015967,0.4950057112304664
3543,0.3544,20,22,20,634908,41536,85540,40716,0.3289823849955646,0.4950153187764431
3544,0.3545,26,33,26,634941,41503,85566,40690,0.3287210112786719,0.49505432336087013
3545,0.3546,16,37,16,634978,41466,85582,40674,0.3284279558991256,0.49517896274653034
3546,0.3547,19,28,19,635006,41438,85601,40655,0.32820618426055,0.49523101847904205
3547,0.3548,15,35,15,635041,41403,85616,40640,0.3279289697123305,0.4953499993905635
3548,0.3549,12,38,12,635079,41365,85628,40628,0.3276279939171208,0.49550571390240633
3549,0.355,15,40,15,635119,41325,85643,40613,0.32731117729058423,0.49565525153164586
3550,0.3551,15,38,15,635157,41287,85658,40598,0.32701020149537446,0.49579288025889967
3551,0.3552,14,26,14,635183,41261,85672,40584,0.32680427068812573,0.4958641334229336
3552,0.3553,15,31,15,635214,41230,85687,40569,0.3265587378025599,0.49595960830817004
3553,0.3554,8,29,8,635243,41201,85695,40561,0.3263290457483209,0.49608620141385973
3554,0.3555,21,33,21,635276,41168,85716,40540,0.3260676720314282,0.49615704704557695
3555,0.3556,18,31,18,635307,41137,85734,40522,0.3258221391458624,0.49623434036664665
3556,0.3557,20,43,20,635350,41094,85754,40502,0.3254815612723356,0.49637237119466643
3557,0.3558,21,34,21,635384,41060,85775,40481,0.3252122671397795,0.4964496388319986
3558,0.3559,17,24,17,635408,41036,85792,40464,0.32502217716385756,0.4964907975460123
3559,0.356,11,34,11,635442,41002,85803,40453,0.3247528830313015,0.49663004112700265
3560,0.3561,16,24,16,635466,40978,85819,40437,0.32456279305537955,0.49667751642817665
3561,0.3562,17,35,17,635501,40943,85836,40420,0.32428557850716005,0.49678600838218845
3562,0.3563,5,38,5,635539,40905,85841,40415,0.32398460271195034,0.4969872110181997
3563,0.3564,19,23,19,635562,40882,85860,40396,0.3238024331516918,0.49701026107925883
3564,0.3565,19,36,19,635598,40846,85879,40377,0.3235172981878089,0.4971128867439026
3565,0.3566,18,29,18,635627,40817,85897,40359,0.3232876061335699,0.4971789691534444
3566,0.3567,17,20,17,635647,40797,85914,40342,0.3231291978203016,0.49719616953622797
3567,0.3568,9,36,9,635683,40761,85923,40333,0.3228440628564187,0.49736108713345006
3568,0.3569,19,26,19,635709,40735,85942,40314,0.32263813204916997,0.49740280571012596
3569,0.357,16,31,16,635740,40704,85958,40298,0.32239259916360413,0.4974938890397768
3570,0.3571,20,30,20,635770,40674,85978,40278,0.3221549866937017,0.49755410613697004
3571,0.3572,13,36,13,635806,40638,85991,40265,0.3218698517298188,0.49769477028045933
3572,0.3573,19,26,19,635832,40612,86010,40246,0.32166392092257,0.4977367731084123
3573,0.3574,13,37,13,635869,40575,86023,40233,0.3213708655430237,0.49788387288387287
3574,0.3575,14,32,14,635901,40543,86037,40219,0.32111741224179446,0.4979941061390258
3575,0.3576,19,26,19,635927,40517,86056,40200,0.3209114814345457,0.49803634922011475
3576,0.3577,15,29,15,635956,40488,86071,40185,0.32068178938030667,0.4981220482689376
3577,0.3578,12,21,12,635977,40467,86083,40173,0.320515460651375,0.4981770833333333
3578,0.3579,11,35,11,636012,40432,86094,40162,0.3202382461031555,0.49832493734024863
3579,0.358,23,42,23,636054,40390,86117,40139,0.3199055886452921,0.4984415552161333
3580,0.3581,15,29,15,636083,40361,86132,40124,0.3196758965910531,0.49852767596446546
3581,0.3582,22,26,22,636109,40335,86154,40102,0.3194699657838043,0.4985516615487897
3582,0.3583,11,30,11,636139,40305,86165,40091,0.31923235331390193,0.4986690880143291
3583,0.3584,17,27,17,636166,40278,86182,40074,0.31901850209098975,0.4987305854241338
3584,0.3585,16,27,16,636193,40251,86198,40058,0.3188046508680776,0.49879839121393615
3585,0.3586,13,37,13,636230,40214,86211,40045,0.31851159548853125,0.4989471585741163
3586,0.3587,13,30,13,636260,40184,86224,40032,0.3182739830186288,0.4990525580931485
3587,0.3588,14,37,14,636297,40147,86238,40018,0.3179809276390825,0.4991954094679723
3588,0.3589,20,40,20,636337,40107,86258,39998,0.31766411101254594,0.4993196429686037
3589,0.359,19,26,19,636363,40081,86277,39979,0.31745818020529715,0.499362977766675
3590,0.3591,10,21,10,636384,40060,86287,39969,0.31729185147636546,0.49943145609716477
3591,0.3592,10,34,10,636418,40026,86297,39959,0.3170225573438094,0.4995811714696506
3592,0.3593,16,33,16,636451,39993,86313,39943,0.31676118362691674,0.49968724979983986
3593,0.3594,18,28,18,636479,39965,86331,39925,0.3165394119883411,0.49974965577669295
3594,0.3595,12,24,12,636503,39941,86343,39913,0.3163493220124192,0.49982468004107494
3595,0.3596,18,36,18,636539,39905,86361,39895,0.3160641870485363,0.499937343358396
3596,0.3597,13,22,13,636561,39883,86374,39882,0.3158899379039412,0.49999373158653543
3597,0.3598,27,26,27,636587,39857,86401,39855,0.3156840070966924,0.4999874548374147
3598,0.3599,12,39,12,636626,39818,86413,39843,0.31537511088581927,0.5001569149270032
3599,0.36,13,40,13,636666,39778,86426,39830,0.3150582942592827,0.5003266003416742
3600,0.3601,10,33,10,636699,39745,86436,39820,0.31479692054239006,0.5004713127631496
3601,0.3602,16,32,16,636731,39713,86452,39804,0.31454346724116083,0.5005722046857904
3602,0.3603,15,26,15,636757,39687,86467,39789,0.31433753643391205,0.5006417031556696
3603,0.3604,12,30,12,636787,39657,86479,39777,0.31409992396400965,0.500755344059219
3604,0.3605,16,26,16,636813,39631,86495,39761,0.31389399315676086,0.5008187222893994
3605,0.3606,16,30,16,636843,39601,86511,39745,0.31365638068685847,0.5009074181433216
3606,0.3607,18,40,18,636883,39561,86529,39727,0.3133395640603219,0.5010468166683483
3607,0.3608,13,29,13,636912,39532,86542,39714,0.31310987200608287,0.5011483229437448
3608,0.3609,21,35,21,636947,39497,86563,39693,0.3128326574578634,0.5012375299911604
3609,0.361,13,18,13,636965,39479,86576,39680,0.31269008997592196,0.5012695966346215
3610,0.3611,13,24,13,636989,39455,86589,39667,0.3125,0.501339703243093
3611,0.3612,17,38,17,637027,39417,86606,39650,0.3121990242047903,0.5014734339231285
3612,0.3613,11,30,11,637057,39387,86617,39639,0.31196141173488784,0.5015944119656822
3613,0.3614,17,43,17,637100,39344,86634,39622,0.311620833861361,0.5017602512473723
3614,0.3615,22,37,22,637137,39307,86656,39600,0.3113277784818147,0.501856616016323
3615,0.3616,16,26,16,637163,39281,86672,39584,0.31112184767456597,0.5019210042477652
3616,0.3617,12,26,12,637189,39255,86684,39572,0.3109159168673172,0.5020107323632765
3617,0.3618,13,39,13,637228,39216,86697,39559,0.3106070206564441,0.5021770866391622
3618,0.3619,16,24,16,637252,39192,86713,39543,0.3104169306805221,0.502228995999238
3619,0.362,19,34,19,637286,39158,86732,39524,0.310147636547966,0.5023258178490633
3620,0.3621,13,28,13,637314,39130,86745,39511,0.30992586490939045,0.5024224005289861
3621,0.3622,20,30,20,637344,39100,86765,39491,0.309688252439488,0.5024875621890548
3622,0.3623,19,21,19,637365,39079,86784,39472,0.3095219237105563,0.5025015594963782
3623,0.3624,19,31,19,637396,39048,86803,39453,0.3092763908249905,0.5025795849734398
3624,0.3625,13,38,13,637434,39010,86816,39440,0.30897541502978076,0.502740599107712
3625,0.3626,22,41,22,637475,38969,86838,39418,0.3086506779875808,0.502863995305344
3626,0.3627,19,30,19,637505,38939,86857,39399,0.3084130655176784,0.5029359953024075
3627,0.3628,16,36,16,637541,38903,86873,39383,0.30812793055379545,0.5030656822420356
3628,0.3629,20,23,20,637564,38880,86893,39363,0.30794576099353693,0.5030865380928645
3629,0.363,19,33,19,637597,38847,86912,39344,0.30768438727664427,0.5031781151283395
3630,0.3631,19,32,19,637629,38815,86931,39325,0.30743093397541504,0.503263373432301
3631,0.3632,17,26,17,637655,38789,86948,39308,0.30722500316816626,0.5033227908882544
3632,0.3633,18,36,18,637691,38753,86966,39290,0.3069398682042834,0.5034404110554438
3633,0.3634,15,35,15,637726,38718,86981,39275,0.3066626536560639,0.5035708332799097
3634,0.3635,12,45,12,637771,38673,86993,39263,0.30630623495121023,0.50378515705194
3635,0.3636,25,39,25,637810,38634,87018,39238,0.3059973387403371,0.5038781590302034
3636,0.3637,15,23,15,637833,38611,87033,39223,0.30581516918007856,0.5039314438420228
3637,0.3638,15,25,15,637858,38586,87048,39208,0.3056171587884932,0.5039977376147261
3638,0.3639,17,33,17,637891,38553,87065,39191,0.30535578507160055,0.5041032105371476
3639,0.364,20,22,20,637913,38531,87085,39171,0.3051815359270055,0.5041182981133047
3640,0.3641,14,30,14,637943,38501,87099,39157,0.304943923457103,0.5042236472739448
3641,0.3642,18,32,18,637975,38469,87117,39139,0.3046904701558738,0.5043165653025461
3642,0.3643,13,28,13,638003,38441,87130,39126,0.3044686985172982,0.5044155375352921
3643,0.3644,18,26,18,638029,38415,87148,39108,0.3042627677100494,0.5044696412677528
3644,0.3645,12,30,12,638059,38385,87160,39096,0.304025155240147,0.5045882216285282
3645,0.3646,15,31,15,638090,38354,87175,39081,0.30377962235458117,0.5046942597016852
3646,0.3647,17,29,17,638119,38325,87192,39064,0.30354993030034216,0.5047745803667187
3647,0.3648,21,39,21,638158,38286,87213,39043,0.303241034089469,0.504894670822072
3648,0.3649,22,34,22,638192,38252,87235,39021,0.30297173995691296,0.5049758647910655
3649,0.365,14,28,14,638220,38224,87249,39007,0.30274996831833734,0.505069207960534
3650,0.3651,13,25,13,638245,38199,87262,38994,0.302551957926752,0.5051494306478567
3651,0.3652,12,27,12,638272,38172,87274,38982,0.3023381067038398,0.5052492417761879
3652,0.3653,18,26,18,638298,38146,87292,38964,0.302132175896591,0.5053041110102451
3653,0.3654,14,26,14,638324,38120,87306,38950,0.3019262450893423,0.5053847151939795
3654,0.3655,15,32,15,638356,38088,87321,38935,0.301672791788113,0.5054983576334342
3655,0.3656,18,25,18,638381,38063,87339,38917,0.30147478139652767,0.5055468952974799
3656,0.3657,7,38,7,638419,38025,87346,38910,0.30117380560131796,0.5057516085006823
3657,0.3658,15,25,15,638444,38000,87361,38895,0.3009757952097326,0.5058196241628194
3658,0.3659,16,28,16,638472,37972,87377,38879,0.300754023571157,0.5059010292644207
3659,0.366,22,37,22,638509,37935,87399,38857,0.3004609681916107,0.5060032295030732
3660,0.3661,14,25,14,638534,37910,87413,38843,0.3002629578000253,0.5060779383216292
3661,0.3662,17,33,17,638567,37877,87430,38826,0.30000158408313266,0.5061861987145222
3662,0.3663,24,30,24,638597,37847,87454,38802,0.29976397161323026,0.5062296964083027
3663,0.3664,24,23,24,638620,37824,87478,38778,0.29958180205297175,0.5062269914623639
3664,0.3665,12,27,12,638647,37797,87490,38766,0.29936795083005957,0.5063281219387955
3665,0.3666,22,28,22,638675,37769,87512,38744,0.29914617919148395,0.5063714662867748
3666,0.3667,11,26,11,638701,37743,87523,38733,0.2989402483842352,0.5064726188608191
3667,0.3668,19,35,19,638736,37708,87542,38714,0.2986630338360157,0.5065818743293816
3668,0.3669,18,18,18,638754,37690,87560,38696,0.29852046635407425,0.5065849763045585
3669,0.367,20,28,20,638782,37662,87580,38676,0.2982986947154987,0.5066415153658729
3670,0.3671,13,38,13,638820,37624,87593,38663,0.2979977189202889,0.5068098103215489
3671,0.3672,13,27,13,638847,37597,87606,38650,0.29778386769737675,0.5069051897123821
3672,0.3673,18,31,18,638878,37566,87624,38632,0.2975383348118109,0.5069949342502428
3673,0.3674,21,32,21,638910,37534,87645,38611,0.2972848815105817,0.507072033620067
3674,0.3675,13,27,13,638937,37507,87658,38598,0.2970710302876695,0.5071677287957427
3675,0.3676,10,25,10,638962,37482,87668,38588,0.29687301989608417,0.5072696200867622
3676,0.3677,19,18,19,638980,37464,87687,38569,0.2967304524141427,0.5072665816158773
3677,0.3678,27,28,27,639008,37436,87714,38542,0.2965086807755671,0.5072784227013083
3678,0.3679,21,24,21,639032,37412,87735,38521,0.2963185907996452,0.5073024903533379
3679,0.368,18,46,18,639078,37366,87753,38503,0.29595425167912814,0.5074931790322793
3680,0.3681,18,24,18,639102,37342,87771,38485,0.2957641617032062,0.5075368931910796
3681,0.3682,20,20,20,639122,37322,87791,38465,0.2956057533899379,0.5075408711256548
3682,0.3683,11,23,11,639145,37299,87802,38454,0.29542358382967937,0.5076234604570116
3683,0.3684,26,23,26,639168,37276,87828,38428,0.29524141426942085,0.5076085807883335
3684,0.3685,15,25,15,639193,37251,87843,38413,0.2950434038778355,0.5076786847113555
3685,0.3686,21,36,21,639229,37215,87864,38392,0.2947582689139526,0.50778367082413
3686,0.3687,15,18,15,639247,37197,87879,38377,0.29461570143201116,0.5078069177230264
3687,0.3688,17,18,17,639265,37179,87896,38360,0.2944731339500697,0.5078171540528733
3688,0.3689,17,31,17,639296,37148,87913,38343,0.29422760106450385,0.5079148507769138
3689,0.369,16,35,16,639331,37113,87929,38327,0.29395038651628436,0.5080461293743372
3690,0.3691,19,25,19,639356,37088,87948,38308,0.293752376124699,0.5080906148867314
3691,0.3692,19,33,19,639389,37055,87967,38289,0.29349100240780635,0.5081891059672967
3692,0.3693,13,38,13,639427,37017,87980,38276,0.29319002661259663,0.5083606709787098
3693,0.3694,18,22,18,639449,36995,87998,38258,0.2930157774680015,0.5083916920255671
3694,0.3695,20,28,20,639477,36967,88018,38238,0.29279400582942594,0.5084502360215412
3695,0.3696,15,26,15,639503,36941,88033,38223,0.29258807502217715,0.5085280187323719
3696,0.3697,16,29,16,639532,36912,88049,38207,0.29235838296793815,0.5086196568111929
3697,0.3698,14,36,14,639568,36876,88063,38193,0.29207324800405526,0.5087719298245614
3698,0.3699,17,15,17,639583,36861,88080,38176,0.29195444176910407,0.5087623439103376
3699,0.37,18,26,18,639609,36835,88098,38158,0.2917485109618553,0.5088208232768392
3700,0.3701,20,28,20,639637,36807,88118,38138,0.29152673932327966,0.5088798452198279
3701,0.3702,14,21,14,639658,36786,88132,38124,0.291360410594348,0.5089307168602323
3702,0.3703,16,29,16,639687,36757,88148,38108,0.29113071854010897,0.5090229079008882
3703,0.3704,13,22,13,639709,36735,88161,38095,0.2909564693955139,0.5090872644661232
3704,0.3705,19,21,19,639730,36714,88180,38076,0.2907901406665822,0.5091054953870838
3705,0.3706,15,29,15,639759,36685,88195,38061,0.2905604486123432,0.5092045059267386
3706,0.3707,20,31,20,639790,36654,88215,38041,0.29031491572677737,0.5092844233215075
3707,0.3708,14,21,14,639811,36633,88229,38027,0.2901485869978456,0.5093356549691936
3708,0.3709,19,39,19,639850,36594,88248,38008,0.2898396907869725,0.509476957722313
3709,0.371,11,26,11,639876,36568,88259,37997,0.28963375997972374,0.5095822436800107
3710,0.3711,9,29,9,639905,36539,88268,37988,0.28940406792548473,0.5097213090557784
3711,0.3712,20,30,20,639935,36509,88288,37968,0.2891664554555823,0.5097949702592747
3712,0.3713,20,32,20,639967,36477,88308,37948,0.28891300215435306,0.5098824319785018
3713,0.3714,18,28,18,639995,36449,88326,37930,0.28869123051577744,0.5099557670847954
3714,0.3715,12,26,12,640021,36423,88338,37918,0.2884852997085287,0.5100550167471516
3715,0.3716,17,24,17,640045,36399,88355,37901,0.28829520973260675,0.5101076716016151
3716,0.3717,9,30,9,640075,36369,88364,37892,0.28805759726270436,0.5102543730895086
3717,0.3718,21,32,21,640107,36337,88385,37871,0.2878041439614751,0.5103358128503666
3718,0.3719,17,32,17,640139,36305,88402,37854,0.28755069066024586,0.5104437762105746
3719,0.372,21,24,21,640163,36281,88423,37833,0.2873606006843239,0.5104703564778584
3720,0.3721,14,26,14,640189,36255,88437,37819,0.28715466987707516,0.5105570105570105
3721,0.3722,16,18,16,640207,36237,88453,37803,0.2870121023951337,0.5105753646677471
3722,0.3723,24,35,24,640242,36202,88477,37779,0.2867348878469142,0.510658141955367
3723,0.3724,14,31,14,640273,36171,88491,37765,0.28648935496134836,0.5107795931616533
3724,0.3725,18,21,18,640294,36150,88509,37747,0.2863230262324167,0.5108055807407608
3725,0.3726,16,19,16,640313,36131,88525,37731,0.2861725383348118,0.5108310091792803
3726,0.3727,18,28,18,640341,36103,88543,37713,0.2859507666962362,0.510905494743687
3727,0.3728,26,31,26,640372,36072,88569,37687,0.28570523381067037,0.5109478165376429
3728,0.3729,19,29,19,640401,36043,88588,37668,0.28547554175643136,0.511022778147088
3729,0.373,13,36,13,640437,36007,88601,37655,0.2851904067925485,0.5111862289918818
3730,0.3731,15,29,15,640466,35978,88616,37640,0.2849607147383095,0.5112880002173381
3731,0.3732,24,28,24,640494,35950,88640,37616,0.28473894309973385,0.511323165592801
3732,0.3733,13,27,13,640521,35923,88653,37603,0.2845250918768217,0.5114245300981966
3733,0.3734,14,32,14,640553,35891,88667,37589,0.28427163857559246,0.5115541643984758
3734,0.3735,12,24,12,640577,35867,88679,37577,0.2840815485996705,0.5116415227928762
3735,0.3736,15,20,15,640597,35847,88694,37562,0.28392314028640225,0.511681129016878
3736,0.3737,17,25,17,640622,35822,88711,37545,0.2837251298948169,0.5117423364728011
3737,0.3738,13,24,13,640646,35798,88724,37532,0.28353503991889495,0.5118232646938498
3738,0.3739,9,31,9,640677,35767,88733,37523,0.2832895070333291,0.5119798062491472
3739,0.374,15,26,15,640703,35741,88748,37508,0.2830835762260803,0.5120615981105544
3740,0.3741,7,35,7,640738,35706,88755,37501,0.28280636167786083,0.5122597565806548
3741,0.3742,18,17,18,640755,35689,88773,37483,0.2826717146115828,0.5122587875143497
3742,0.3743,20,28,20,640783,35661,88793,37463,0.28244994297300724,0.5123215360210054
3743,0.3744,18,21,18,640804,35640,88811,37445,0.28228361424407555,0.5123486351508517
3744,0.3745,14,24,14,640828,35616,88825,37431,0.2820935242681536,0.5124235081522855
3745,0.3746,18,30,18,640858,35586,88843,37413,0.28185591179825115,0.5125138700530144
3746,0.3747,12,26,12,640884,35560,88855,37401,0.2816499809910024,0.5126163292718028
3747,0.3748,9,37,9,640921,35523,88864,37392,0.2813569256114561,0.5128162929438387
3748,0.3749,24,29,24,640950,35494,88888,37368,0.2811272335572171,0.5128599269852598
3749,0.375,10,25,10,640975,35469,88898,37358,0.28092922316563174,0.5129690911337828
3750,0.3751,14,25,14,641000,35444,88912,37344,0.2807312127740464,0.5130516019124032
3751,0.3752,20,33,20,641033,35411,88932,37324,0.2804698390571537,0.5131504777617378
3752,0.3753,15,25,15,641058,35386,88947,37309,0.2802718286655684,0.5132264942568264
3753,0.3754,18,22,18,641080,35364,88965,37291,0.28009757952097325,0.5132613034202739
3754,0.3755,15,23,15,641103,35341,88980,37276,0.27991540996071473,0.5133233264937962
3755,0.3756,11,38,11,641141,35303,88991,37265,0.279614434165505,0.5135183551978834
3756,0.3757,15,28,15,641169,35275,89006,37250,0.2793926625269294,0.5136159944846604
3757,0.3758,12,30,12,641199,35245,89018,37238,0.279155050057027,0.5137480512671937
3758,0.3759,24,16,24,641215,35229,89042,37214,0.27902832340641237,0.513700426542247
3759,0.376,15,28,15,641243,35201,89057,37199,0.27880655176783675,0.5137983425414364
3760,0.3761,17,28,17,641271,35173,89074,37182,0.2785847801292612,0.5138829382903739
3761,0.3762,14,34,14,641305,35139,89088,37168,0.2783154859967051,0.5140304534830653
3762,0.3763,19,25,19,641330,35114,89107,37149,0.27811747560511973,0.5140805114650651
3763,0.3764,13,25,13,641355,35089,89120,37136,0.2779194652135344,0.5141709934233298
3764,0.3765,14,26,14,641381,35063,89134,37122,0.27771353440628566,0.5142619657823647
3765,0.3766,19,33,19,641414,35030,89153,37103,0.277452160689393,0.5143692900614143
3766,0.3767,12,21,12,641435,35009,89165,37091,0.2772858319604613,0.5144382801664356
3767,0.3768,13,28,13,641463,34981,89178,37078,0.2770640603218857,0.5145505766108328
3768,0.3769,12,22,12,641485,34959,89190,37066,0.27688981117729056,0.5146268656716418
3769,0.377,21,28,21,641513,34931,89211,37045,0.276668039538715,0.5146854507057909
3770,0.3771,17,28,17,641541,34903,89228,37028,0.2764462679001394,0.5147711000820231
3771,0.3772,11,30,11,641571,34873,89239,37017,0.276208655430237,0.5149116706078731
3772,0.3773,20,32,20,641603,34841,89259,36997,0.2759552021290077,0.5150059856900248
3773,0.3774,17,27,17,641630,34814,89276,36980,0.27574135090609553,0.5150848260300304
3774,0.3775,18,22,18,641652,34792,89294,36962,0.27556710176150045,0.5151211082309001
3775,0.3776,14,36,14,641688,34756,89308,36948,0.2752819667976175,0.5152850608055338
3776,0.3777,13,26,13,641714,34730,89321,36935,0.2750760359903688,0.5153840786995046
3777,0.3778,21,33,21,641747,34697,89342,36914,0.2748146622734761,0.5154794654452528
3778,0.3779,17,22,17,641769,34675,89359,36897,0.274640413128881,0.5155228301570447
3779,0.378,17,17,17,641786,34658,89376,36880,0.27450576606260296,0.5155302077217703
3780,0.3781,16,26,16,641812,34632,89392,36864,0.2742998352553542,0.5156092648539778
3781,0.3782,13,33,13,641845,34599,89405,36851,0.27403846153846156,0.5157592722183345
3782,0.3783,16,29,16,641874,34570,89421,36835,0.27380876948422256,0.5158602338771795
3783,0.3784,12,31,12,641905,34539,89433,36823,0.2735632365986567,0.5160029147165158
3784,0.3785,10,29,10,641934,34510,89443,36813,0.2733335445444177,0.5161448621061929
3785,0.3786,14,33,14,641967,34477,89457,36799,0.27307217082752505,0.5162887928615523
3786,0.3787,20,13,20,641980,34464,89477,36779,0.27296920542390063,0.5162472102522353
3787,0.3788,15,31,15,642011,34433,89492,36764,0.2727236725383348,0.516370071772687
3788,0.3789,22,22,22,642033,34411,89514,36742,0.2725494233937397,0.5163801947915057
3789,0.379,15,28,15,642061,34383,89529,36727,0.2723276517551641,0.516481507523555
3790,0.3791,9,27,9,642088,34356,89538,36718,0.2721138005322519,0.5166164842277063
3791,0.3792,12,32,12,642120,34324,89550,36706,0.2718603472310227,0.5167675630015487
3792,0.3793,14,26,14,642146,34298,89564,36692,0.2716544164237739,0.5168615297929285
3793,0.3794,11,21,11,642167,34277,89575,36681,0.27148808769484223,0.516939598072099
3794,0.3795,14,26,14,642193,34251,89589,36667,0.27128215688759344,0.5170337572971601
3795,0.3796,17,29,17,642222,34222,89606,36650,0.27105246483335443,0.5171294728524665
3796,0.3797,23,16,23,642238,34206,89629,36627,0.27092573818273985,0.5170894921858455
3797,0.3798,23,30,23,642268,34176,89652,36604,0.2706881257128374,0.5171517377790337
3798,0.3799,9,22,9,642290,34154,89661,36595,0.27051387656824233,0.517251127224413
3799,0.38,6,22,6,642312,34132,89667,36589,0.2703396274236472,0.5173710778976541
3800,0.3801,21,19,21,642331,34113,89688,36568,0.27018913952604234,0.5173667605155559
3801,0.3802,25,25,25,642356,34088,89713,36543,0.269991129134457,0.5173790545228016
3802,0.3803,13,25,13,642381,34063,89726,36530,0.26979311874287165,0.5174734038785715
3803,0.3804,18,22,18,642403,34041,89744,36512,0.2696188695982765,0.5175116579025697
3804,0.3805,12,31,12,642434,34010,89756,36500,0.2693733367127107,0.5176570699191604
3805,0.3806,16,27,16,642461,33983,89772,36484,0.2691594854897985,0.5177458952417444
3806,0.3807,11,29,11,642490,33954,89783,36473,0.2689297934355595,0.5178837661692248
3807,0.3808,18,26,18,642516,33928,89801,36455,0.2687238626283107,0.5179517781282412
3808,0.3809,17,23,17,642539,33905,89818,36438,0.2685416930680522,0.5180046344341299
3809,0.381,10,26,10,642565,33879,89828,36428,0.26833576226080347,0.5181276402065228
3810,0.3811,15,25,15,642590,33854,89843,36413,0.2681377518692181,0.5182091166550443
3811,0.3812,13,17,13,642607,33837,89856,36400,0.26800310480294004,0.5182453692498256
3812,0.3813,20,25,20,642632,33812,89876,36380,0.2678050944113547,0.5182926829268293
3813,0.3814,10,37,10,642669,33775,89886,36370,0.26751203903180837,0.5184973982464894
3814,0.3815,17,23,17,642692,33752,89903,36353,0.26732986947154985,0.5185507453106055
3815,0.3816,13,26,13,642718,33726,89916,36340,0.2671239386643011,0.5186538406645164
3816,0.3817,17,18,17,642736,33708,89933,36323,0.26698137118235965,0.5186703031514615
3817,0.3818,17,29,17,642765,33679,89950,36306,0.26675167912812064,0.5187683074944631
3818,0.3819,23,21,23,642786,33658,89973,36283,0.26658535039918896,0.5187658169028181
3819,0.382,13,20,13,642806,33638,89986,36270,0.26642694208592066,0.5188247410882875
3820,0.3821,15,23,15,642829,33615,90001,36255,0.26624477252566214,0.5188922284242165
3821,0.3822,19,33,19,642862,33582,90020,36236,0.2659833988087695,0.5190065599129164
3822,0.3823,10,31,10,642893,33551,90030,36226,0.26573786592320364,0.5191682072889348
3823,0.3824,17,27,17,642920,33524,90047,36209,0.26552401470029147,0.5192520040726772
3824,0.3825,17,40,17,642960,33484,90064,36192,0.2652071980737549,0.5194328032608072
3825,0.3826,15,22,15,642982,33462,90079,36177,0.2650329489291598,0.5194933873260673
3826,0.3827,17,22,17,643004,33440,90096,36160,0.26485869978456467,0.5195402298850574
3827,0.3828,10,31,10,643035,33409,90106,36150,0.2646131668989989,0.5197026984286721
3828,0.3829,12,19,12,643054,33390,90118,36138,0.264462679001394,0.5197618225750776
3829,0.383,15,26,15,643080,33364,90133,36123,0.26425674819414524,0.5198526343056975
3830,0.3831,20,19,20,643099,33345,90153,36103,0.2641062602965404,0.5198565833429328
3831,0.3832,17,22,17,643121,33323,90170,36086,0.26393201115194526,0.5199037588785316
3832,0.3833,18,32,18,643153,33291,90188,36068,0.26367855785071603,0.5200190314162546
3833,0.3834,30,25,30,643178,33266,90218,36038,0.26348054745913063,0.5199988456654738
3834,0.3835,16,19,16,643197,33247,90234,36022,0.2633300595615258,0.5200306053212836
3835,0.3836,16,28,16,643225,33219,90250,36006,0.2631082879229502,0.5201300108342362
3836,0.3837,14,24,14,643249,33195,90264,35992,0.26291819794702825,0.5202133348750487
3837,0.3838,14,22,14,643271,33173,90278,35978,0.2627439488024331,0.5202817023614987
3838,0.3839,16,19,16,643290,33154,90294,35962,0.26259346090482827,0.5203136755599282
3839,0.384,22,28,22,643318,33126,90316,35940,0.2623716892662527,0.520371818260794
3840,0.3841,15,33,15,643351,33093,90331,35925,0.26211031554936004,0.5205163870294706
3841,0.3842,12,24,12,643375,33069,90343,35913,0.2619202255734381,0.5206140732364964
3842,0.3843,13,32,13,643407,33037,90356,35900,0.26166677227220886,0.5207653364666289
3843,0.3844,15,25,15,643432,33012,90371,35885,0.2614687618806235,0.5208499644396708
3844,0.3845,13,26,13,643458,32986,90384,35872,0.2612628310733747,0.5209561706700746
3845,0.3846,13,20,13,643478,32966,90397,35859,0.2611044227601064,0.5210170722847802
3846,0.3847,18,17,18,643495,32949,90415,35841,0.2609697756938284,0.5210204971652856
3847,0.3848,21,29,21,643524,32920,90436,35820,0.2607400836395894,0.5210939773057899
3848,0.3849,16,17,16,643541,32903,90452,35804,0.26060543657331137,0.5211113860305354
3849,0.385,18,19,18,643560,32884,90470,35786,0.2604549486757065,0.5211300422309597
3850,0.3851,11,20,11,643580,32864,90481,35775,0.2602965403624382,0.5212051457626131
3851,0.3852,19,30,19,643610,32834,90500,35756,0.2600589278925358,0.5213004811196967
3852,0.3853,12,22,12,643632,32812,90512,35744,0.2598846787479407,0.5213839780617305
3853,0.3854,25,17,25,643649,32795,90537,35719,0.25975003168166266,0.5213387044983507
3854,0.3855,12,25,12,643674,32770,90549,35707,0.2595520212900773,0.5214451567679659
3855,0.3856,18,26,18,643700,32744,90567,35689,0.25934609048282853,0.5215173965776745
3856,0.3857,11,17,11,643717,32727,90578,35678,0.2592114434165505,0.5215700606680799
3857,0.3858,16,24,16,643741,32703,90594,35662,0.25902135344062854,0.5216411906677393
3858,0.3859,13,20,13,643761,32683,90607,35649,0.2588629451273603,0.521702862494878
3859,0.386,13,27,13,643788,32656,90620,35636,0.2586490939044481,0.5218180753236104
3860,0.3861,14,16,14,643804,32640,90634,35622,0.2585223672538335,0.5218423134393952
3861,0.3862,13,24,13,643828,32616,90647,35609,0.2583322772779115,0.5219347746427263
3862,0.3863,12,27,12,643855,32589,90659,35597,0.25811842605499935,0.5220573138180858
3863,0.3864,14,22,14,643877,32567,90673,35583,0.2579441769104043,0.522127659574468
3864,0.3865,21,26,21,643903,32541,90694,35562,0.2577382461031555,0.5221796396634509
3865,0.3866,11,26,11,643929,32515,90705,35551,0.25753231529590676,0.5223018834660477
3866,0.3867,13,21,13,643950,32494,90718,35538,0.257365986566975,0.5223718250235183
3867,0.3868,12,27,12,643977,32467,90730,35526,0.25715213534406284,0.5224949627167502
3868,0.3869,10,19,10,643996,32448,90740,35516,0.257001647446458,0.5225707727620506
3869,0.387,14,27,14,644023,32421,90754,35502,0.2567877962235458,0.5226800936354401
3870,0.3871,17,19,17,644042,32402,90771,35485,0.25663730832594095,0.5227068510907832
3871,0.3872,5,19,5,644061,32383,90776,35480,0.2564868204283361,0.522818030443688
3872,0.3873,15,26,15,644087,32357,90791,35465,0.2562808896210873,0.5229129191117926
3873,0.3874,10,31,10,644118,32326,90801,35455,0.25603535673552147,0.523081689559021
3874,0.3875,14,24,14,644142,32302,90815,35441,0.25584526675959957,0.5231684454482382
3875,0.3876,17,25,17,644167,32277,90832,35424,0.2556472563680142,0.5232419018921434
3876,0.3877,15,21,15,644188,32256,90847,35409,0.2554809276390825,0.5232986034138772
3877,0.3878,10,28,10,644216,32228,90857,35399,0.2552591560005069,0.5234447779732947
3878,0.3879,10,32,10,644248,32196,90867,35389,0.25500570269927764,0.5236221054967818
3879,0.388,6,36,6,644284,32160,90873,35383,0.25472056773539475,0.5238588750869816
3880,0.3881,11,31,11,644315,32129,90884,35372,0.2544750348498289,0.5240218663427209
3881,0.3882,17,31,17,644346,32098,90901,35355,0.2542295019642631,0.5241427364238803
3882,0.3883,14,18,14,644364,32080,90915,35341,0.2540869344823216,0.5241838596283057
3883,0.3884,19,14,19,644378,32066,90934,35322,0.25397604866303386,0.5241586039057399
3884,0.3885,20,21,20,644399,32045,90954,35302,0.2538097199341021,0.5241807355932707
3885,0.3886,18,14,18,644413,32031,90972,35284,0.25369883411481436,0.5241625194978831
3886,0.3887,15,25,15,644438,32006,90987,35269,0.253500823723229,0.5242512077294686
3887,0.3888,14,29,14,644467,31977,91001,35255,0.25327113166899,0.524378272251309
3888,0.3889,18,24,18,644491,31953,91019,35237,0.25308104169306805,0.5244381604405417
3889,0.389,12,26,12,644517,31927,91031,35225,0.25287511088581927,0.524556230640934
3890,0.3891,17,27,17,644544,31900,91048,35208,0.2526612596629071,0.5246468379328844
3891,0.3892,15,22,15,644566,31878,91063,35193,0.252487010518312,0.5247126179719999
3892,0.3893,19,16,19,644582,31862,91082,35174,0.2523602838676974,0.5247031445790321
3893,0.3894,14,19,14,644601,31843,91096,35160,0.2522097959700925,0.5247526230168799
3894,0.3895,13,25,13,644626,31818,91109,35147,0.2520117855785072,0.5248562681998059
3895,0.3896,16,30,16,644656,31788,91125,35131,0.2517741731086047,0.5249779584273525
3896,0.3897,13,26,13,644682,31762,91138,35118,0.251568242301356,0.5250897129186602
3897,0.3898,18,25,18,644707,31737,91156,35100,0.25137023190977065,0.5251582207459939
3898,0.3899,21,33,21,644740,31704,91177,35079,0.251108858192878,0.52526840663043
3899,0.39,11,28,11,644768,31676,91188,35068,0.25088708655430236,0.5254105237924008
3900,0.3901,16,16,16,644784,31660,91204,35052,0.2507603599036877,0.5254227125554622
3901,0.3902,18,24,18,644808,31636,91222,35034,0.2505702699277658,0.5254837258137093
3902,0.3903,13,27,13,644835,31609,91235,35021,0.25035641870485364,0.5256040822452349
3903,0.3904,8,20,8,644855,31589,91243,35013,0.25019801039158535,0.5257049337857722
3904,0.3905,8,28,8,644883,31561,91251,35005,0.24997623875300976,0.525869062284049
3905,0.3906,15,24,15,644907,31537,91266,34990,0.24978614877708782,0.5259518691659025
3906,0.3907,10,25,10,644932,31512,91276,34980,0.24958813838550248,0.5260783252120556
3907,0.3908,15,22,15,644954,31490,91291,34965,0.24941388924090735,0.5261455120006019
3908,0.3909,11,16,11,644970,31474,91302,34954,0.24928716259029274,0.5261937737098814
3909,0.391,16,36,16,645006,31438,91318,34938,0.24900202762640983,0.5263649511871761
3910,0.3911,15,29,15,645035,31409,91333,34923,0.24877233557217082,0.5264879696074293
3911,0.3912,14,22,14,645057,31387,91347,34909,0.24859808642757572,0.5265626885483287
3912,0.3913,20,22,20,645079,31365,91367,34889,0.24842383728298062,0.5265946207021462
3913,0.3914,9,18,9,645097,31347,91376,34880,0.24828126980103915,0.5266734111465112
3914,0.3915,18,19,18,645116,31328,91394,34862,0.2481307819034343,0.5266958755098957
3915,0.3916,18,18,18,645134,31310,91412,34844,0.24798821442149285,0.5267104029990628
3916,0.3917,14,17,14,645151,31293,91426,34830,0.2478535673552148,0.5267456104532462
3917,0.3918,16,27,16,645178,31266,91442,34814,0.24763971613230262,0.5268462469733656
3918,0.3919,16,18,16,645196,31248,91458,34798,0.24749714865036118,0.5268752081882324
3919,0.392,14,28,14,645224,31220,91472,34784,0.2472753770117856,0.5269983637355312
3920,0.3921,12,26,12,645250,31194,91484,34772,0.2470694462045368,0.527120031531395
3921,0.3922,19,26,19,645276,31168,91503,34753,0.24686351539728804,0.5271916384763581
3922,0.3923,17,26,17,645302,31142,91520,34736,0.24665758459003928,0.5272776951334285
3923,0.3924,8,13,8,645315,31129,91528,34728,0.24655461918641491,0.5273243542827641
3924,0.3925,15,17,15,645332,31112,91543,34713,0.24641997212013686,0.5273528294720851
3925,0.3926,9,24,9,645356,31088,91552,34704,0.24622988214421493,0.5274805447470817
3926,0.3927,14,25,14,645381,31063,91566,34690,0.24603187175262958,0.5275804906240019
3927,0.3928,17,30,17,645411,31033,91583,34673,0.24579425928272716,0.5276991446747633
3928,0.3929,18,25,18,645436,31008,91601,34655,0.24559624889114182,0.5277705861748626
3929,0.393,10,23,10,645459,30985,91611,34645,0.24541407933088327,0.5278835898217279
3930,0.3931,19,21,19,645480,30964,91630,34626,0.2452477506019516,0.5279158408293947
3931,0.3932,16,19,16,645499,30945,91646,34610,0.24509726270434673,0.5279536267256503
3932,0.3933,24,29,24,645528,30916,91670,34586,0.24486757065010772,0.5280144117736864
3933,0.3934,21,21,21,645549,30895,91691,34565,0.244701241921176,0.5280323861900397
3934,0.3935,15,24,15,645573,30871,91706,34550,0.24451115194525408,0.5281178826370737
3935,0.3936,17,18,17,645591,30853,91723,34533,0.24436858446331264,0.5281405805524119
3936,0.3937,12,19,12,645610,30834,91735,34521,0.24421809656570778,0.5282074822125316
3937,0.3938,11,23,11,645633,30811,91746,34510,0.24403592700544924,0.528314018462669
3938,0.3939,17,19,17,645652,30792,91763,34493,0.24388543910784438,0.5283449490694646
3939,0.394,9,23,9,645675,30769,91772,34484,0.24370326954758587,0.5284661241628738
3940,0.3941,16,22,16,645697,30747,91788,34468,0.24352902040299074,0.5285287127194663
3941,0.3942,10,31,10,645728,30716,91798,34458,0.2432834875174249,0.5287077669009114
3942,0.3943,18,25,18,645753,30691,91816,34440,0.24308547712583956,0.528780457846494
3943,0.3944,23,16,23,645769,30675,91839,34417,0.24295875047522494,0.5287439316659497
3944,0.3945,19,20,19,645789,30655,91858,34398,0.24280034216195667,0.5287688500146035
3945,0.3946,14,19,14,645808,30636,91872,34384,0.2426498542643518,0.5288219009535527
3946,0.3947,13,36,13,645844,30600,91885,34371,0.24236471930046888,0.5290206399778362
3947,0.3948,16,21,16,645865,30579,91901,34355,0.2421983905715372,0.5290756768411002
3948,0.3949,19,21,19,645886,30558,91920,34336,0.2420320618426055,0.5291090085369988
3949,0.395,9,29,9,645915,30529,91929,34327,0.2418023697883665,0.5292802516343901
3950,0.3951,12,27,12,645942,30502,91941,34315,0.24158851856545432,0.5294135797707391
3951,0.3952,13,30,13,645972,30472,91954,34302,0.2413509060955519,0.529564331367524
3952,0.3953,21,19,21,645991,30453,91975,34281,0.24120041819794702,0.5295671517286125
3953,0.3954,12,23,12,646014,30430,91987,34269,0.2410182486376885,0.5296681556129151
3954,0.3955,15,24,15,646038,30406,92002,34254,0.24082815866176657,0.5297556449118466
3955,0.3956,14,27,14,646065,30379,92016,34240,0.2406143074388544,0.5298751141305189
3956,0.3957,12,26,12,646091,30353,92028,34228,0.24040837663160564,0.5300010839101283
3957,0.3958,13,26,13,646117,30327,92041,34215,0.24020244582435687,0.5301199219113135
3958,0.3959,12,26,12,646143,30301,92053,34203,0.2399965150171081,0.5302461862830212
3959,0.396,15,25,15,646168,30276,92068,34188,0.23979850462552274,0.5303425167535368
3960,0.3961,15,18,15,646186,30258,92083,34173,0.2396559371435813,0.5303813381757229
3961,0.3962,15,21,15,646207,30237,92098,34158,0.2394896084146496,0.5304449103191241
3962,0.3963,16,20,16,646227,30217,92114,34142,0.23933120010138131,0.5304930157398343
3963,0.3964,15,20,15,646247,30197,92129,34127,0.23917279178811304,0.5305484733536472
3964,0.3965,10,26,10,646273,30171,92139,34117,0.23896686098086428,0.5306900199104032
3965,0.3966,12,21,12,646294,30150,92151,34105,0.23880053225193257,0.5307758151116645
3966,0.3967,11,21,11,646315,30129,92162,34094,0.23863420352300088,0.5308690033165688
3967,0.3968,13,21,13,646336,30108,92175,34081,0.2384678747940692,0.5309476701615542
3968,0.3969,23,25,23,646361,30083,92198,34058,0.23826986440248385,0.5309864205422429
3969,0.397,14,29,14,646390,30054,92212,34044,0.23804017234824484,0.5311242160441824
3970,0.3971,16,20,16,646410,30034,92228,34028,0.23788176403497654,0.531172926227717
3971,0.3972,11,12,11,646422,30022,92239,34017,0.2377867190470156,0.5311919299177064
3972,0.3973,22,17,22,646439,30005,92261,33995,0.23765207198073754,0.531171875
3973,0.3974,20,18,20,646457,29987,92281,33975,0.2375095044987961,0.5311747600137582
3974,0.3975,6,14,6,646471,29973,92287,33969,0.2373986186795083,0.5312470676550624
3975,0.3976,16,22,16,646493,29951,92303,33953,0.2372243695349132,0.5313125938908363
3976,0.3977,14,19,14,646512,29932,92317,33939,0.23707388163730833,0.5313679134505488
3977,0.3978,15,19,15,646531,29913,92332,33924,0.23692339373970345,0.5314159499976503
3978,0.3979,15,19,15,646550,29894,92347,33909,0.2367729058420986,0.531464037741172
3979,0.398,15,21,15,646571,29873,92362,33894,0.2366065771131669,0.5315288472093717
3980,0.3981,6,32,6,646603,29841,92368,33888,0.23635312381193765,0.5317516358329802
3981,0.3982,13,19,13,646622,29822,92381,33875,0.2362026359143328,0.5318146851500071
3982,0.3983,13,21,13,646643,29801,92394,33862,0.23603630718540108,0.531894507013493
3983,0.3984,11,27,11,646670,29774,92405,33851,0.2358224559624889,0.5320392927308448
3984,0.3985,10,28,10,646698,29746,92415,33841,0.23560068432391332,0.5321999779829211
3985,0.3986,10,15,10,646713,29731,92425,33831,0.23548187808896212,0.5322519744501432
3986,0.3987,20,15,20,646728,29716,92445,33811,0.2353630718540109,0.5322303902277772
3987,0.3988,12,17,12,646745,29699,92457,33799,0.23522842478773287,0.532284481400989
3988,0.3989,11,25,11,646770,29674,92468,33788,0.2350304143961475,0.5324130976017144
3989,0.399,13,22,13,646792,29652,92481,33775,0.2348561652515524,0.5325019313541551
3990,0.3991,17,19,17,646811,29633,92498,33758,0.23470567735394754,0.5325361644397469
3991,0.3992,17,16,17,646827,29617,92515,33741,0.2345789507033329,0.532545219230405
3992,0.3993,8,23,8,646850,29594,92523,33733,0.23439678114307438,0.5326795837478485
3993,0.3994,15,21,15,646871,29573,92538,33718,0.2342304524141427,0.5327455720402585
3994,0.3995,19,18,19,646889,29555,92557,33699,0.23408788493220123,0.5327568217029753
3995,0.3996,12,28,12,646917,29527,92569,33687,0.23386611329362564,0.5329041035213719
3996,0.3997,13,15,13,646932,29512,92582,33674,0.23374730705867444,0.5329345108093565
3997,0.3998,12,32,12,646964,29480,92594,33662,0.2334938537574452,0.5331158341515948
3998,0.3999,11,20,11,646984,29460,92605,33651,0.23333544544417692,0.5332034035271189
3999,0.4,8,16,8,647000,29444,92613,33643,0.23320871879356228,0.5332794395041768
4000,0.4001,12,22,12,647022,29422,92625,33631,0.23303446964896718,0.5333766831078617
4001,0.4002,18,19,18,647041,29403,92643,33613,0.23288398175136232,0.5334042148025898
4002,0.4003,8,28,8,647069,29375,92651,33605,0.23266221011278673,0.5335820895522388
4003,0.4004,12,26,12,647095,29349,92663,33593,0.23245627930553794,0.5337135775793588
4004,0.4005,17,18,17,647113,29331,92680,33576,0.2323137118235965,0.5337402832753112
4005,0.4006,17,15,17,647128,29316,92697,33559,0.23219490558864528,0.5337415506958251
4006,0.4007,15,19,15,647147,29297,92712,33544,0.23204441769104042,0.533791632851164
4007,0.4008,3,23,3,647170,29274,92715,33541,0.2318622481307819,0.5339648173207037
4008,0.4009,17,17,17,647187,29257,92732,33524,0.23172760106450385,0.5339832114811807
4009,0.401,13,26,13,647213,29231,92745,33511,0.2315216702572551,0.5341079340792452
4010,0.4011,16,23,16,647236,29208,92761,33495,0.23133950069699658,0.5341849672264485
4011,0.4012,11,20,11,647256,29188,92772,33484,0.2311810923837283,0.5342736788358438
4012,0.4013,12,18,12,647274,29170,92784,33472,0.23103852490178683,0.5343379841001246
4013,0.4014,9,30,9,647304,29140,92793,33463,0.23080091243188441,0.5345270993402872
4014,0.4015,14,23,14,647327,29117,92807,33449,0.2306187428716259,0.5346194418693859
4015,0.4016,17,18,17,647345,29099,92824,33432,0.23047617538968446,0.5346468151796708
4016,0.4017,11,25,11,647370,29074,92835,33421,0.2302781649980991,0.5347787823025842
4017,0.4018,13,14,13,647384,29060,92848,33408,0.2301672791788113,0.5348018185310879
4018,0.4019,10,19,10,647403,29041,92858,33398,0.23001679128120645,0.5348900526914269
4019,0.402,17,21,17,647424,29020,92875,33381,0.22985046255227473,0.5349433502668226
4020,0.4021,10,22,10,647446,28998,92885,33371,0.22967621340767963,0.5350574804790842
4021,0.4022,17,21,17,647467,28977,92902,33354,0.22950988467874794,0.5351109399817106
4022,0.4023,11,16,11,647483,28961,92913,33343,0.2293831580281333,0.5351662814586543
4023,0.4024,19,21,19,647504,28940,92932,33324,0.22921682929920162,0.5352049338301427
4024,0.4025,10,26,10,647530,28914,92942,33314,0.22901089849195286,0.5353538599987144
4025,0.4026,22,21,22,647551,28893,92964,33292,0.22884456976302117,0.5353702661413524
4026,0.4027,16,18,16,647569,28875,92980,33276,0.2287020022810797,0.5354057054592847
4027,0.4028,20,24,20,647593,28851,93000,33256,0.22851191230515777,0.5354629912892267
4028,0.4029,17,17,17,647610,28834,93017,33239,0.22837726523887975,0.535482415865191
4029,0.403,16,33,16,647643,28801,93033,33223,0.22811589152198708,0.5356474912936927
4030,0.4031,19,19,19,647662,28782,93052,33204,0.2279654036243822,0.5356693446907366
4031,0.4032,14,20,14,647682,28762,93066,33190,0.22780699531111392,0.5357373450413223
4032,0.4033,15,21,15,647703,28741,93081,33175,0.22764066658218224,0.5358065766522385
4033,0.4034,7,15,7,647718,28726,93088,33168,0.22752186034723101,0.5358839305910105
4034,0.4035,20,21,20,647739,28705,93108,33148,0.22735553161829933,0.5359158003653824
4035,0.4036,19,14,19,647753,28691,93127,33129,0.22724464579901152,0.5358945325137496
4036,0.4037,14,23,14,647776,28668,93141,33115,0.227062476238753,0.5359888642506838
4037,0.4038,16,23,16,647799,28645,93157,33099,0.2268803066784945,0.536068281938326
4038,0.4039,15,31,15,647830,28614,93172,33084,0.22663477379292865,0.5362248371097929
4039,0.404,14,12,14,647842,28602,93186,33070,0.22653972880496767,0.5362238941496952
4040,0.4041,9,18,9,647860,28584,93195,33061,0.22639716132302623,0.5363127585367832
4041,0.4042,13,23,13,647883,28561,93208,33048,0.22621499176276771,0.5364151341524778
4042,0.4043,10,25,10,647908,28536,93218,33038,0.22601698137118237,0.5365576379640757
4043,0.4044,18,19,18,647927,28517,93236,33020,0.22586649347357748,0.5365877439589191
4044,0.4045,8,20,8,647947,28497,93244,33012,0.2257080851603092,0.5367019460566747
4045,0.4046,12,22,12,647969,28475,93256,33000,0.2255338360157141,0.5368035786905246
4046,0.4047,10,27,10,647996,28448,93266,32990,0.22531998479280194,0.5369640938832644
4047,0.4048,16,23,16,648019,28425,93282,32974,0.2251378152325434,0.5370445772732455
4048,0.4049,16,23,16,648042,28402,93298,32958,0.22495564567228488,0.5371251629726206
4049,0.405,15,23,15,648065,28379,93313,32943,0.22477347611202636,0.5372133981279149
4050,0.4051,11,28,11,648093,28351,93324,32932,0.22455170447345077,0.5373757812117553
4051,0.4052,10,26,10,648119,28325,93334,32922,0.224345773666202,0.537528368736428
4052,0.4053,13,14,13,648133,28311,93347,32909,0.2242348878469142,0.5375530872263966
4053,0.4054,7,11,7,648144,28300,93354,32902,0.22414776327461666,0.5375968105617464
4054,0.4055,7,25,7,648169,28275,93361,32895,0.2239497528830313,0.5377636096125552
4055,0.4056,18,20,18,648189,28255,93379,32877,0.22379134456976302,0.5378034417326442
4056,0.4057,11,25,11,648214,28230,93390,32866,0.22359333417817767,0.5379402906900616
4057,0.4058,17,21,17,648235,28209,93407,32849,0.22342700544924599,0.5379966589144748
4058,0.4059,11,24,11,648259,28185,93418,32838,0.22323691547332403,0.5381249692738803
4059,0.406,16,15,16,648274,28170,93434,32822,0.22311810923837283,0.538136149003148
4060,0.4061,13,10,13,648284,28160,93447,32809,0.22303890508173868,0.5381259328511211
4061,0.4062,11,17,11,648301,28143,93458,32798,0.22290425801546065,0.538192678164126
4062,0.4063,12,22,12,648323,28121,93470,32786,0.22273000887086555,0.5382960907613247
4063,0.4064,12,26,12,648349,28095,93482,32774,0.22252407806361676,0.5384349997535691
4064,0.4065,22,17,22,648366,28078,93504,32752,0.22238943099733874,0.5384185434818346
4065,0.4066,19,20,19,648386,28058,93523,32733,0.22223102268407047,0.5384514155055847
4066,0.4067,9,25,9,648411,28033,93532,32724,0.22203301229248512,0.538604605230673
4067,0.4068,14,18,14,648429,28015,93546,32710,0.22189044481054365,0.5386578839028406
4068,0.4069,12,22,12,648451,27993,93558,32698,0.22171619566594855,0.5387619251618856
4069,0.407,14,22,14,648473,27971,93572,32684,0.22154194652135345,0.5388508779160828
4070,0.4071,19,17,19,648490,27954,93591,32665,0.2214072994550754,0.5388574539335852
4071,0.4072,14,20,14,648510,27934,93605,32651,0.22124889114180712,0.5389287777502683
4072,0.4073,9,21,9,648531,27913,93614,32642,0.22108256241287544,0.5390471472215341
4073,0.4074,15,15,15,648546,27898,93629,32627,0.22096375617792421,0.5390665014456836
4074,0.4075,7,26,7,648572,27872,93636,32620,0.22075782537067545,0.5392448588243074
4075,0.4076,8,17,8,648589,27855,93644,32612,0.22062317830439743,0.5393355053169497
4076,0.4077,17,26,17,648615,27829,93661,32595,0.22041724749714864,0.5394379716668873
4077,0.4078,15,24,15,648639,27805,93676,32580,0.2202271575212267,0.5395379647263393
4078,0.4079,15,10,15,648649,27795,93691,32565,0.22014795336459259,0.5395129224652088
4079,0.408,11,27,11,648676,27768,93702,32554,0.21993410214168038,0.5396704353303936
4080,0.4081,15,22,15,648698,27746,93717,32539,0.21975985299708528,0.5397528406734677
4081,0.4082,12,26,12,648724,27720,93729,32527,0.21955392218983652,0.5398941026109184
4082,0.4083,16,21,16,648745,27699,93745,32511,0.21938759346090483,0.5399601395117091
4083,0.4084,13,19,13,648764,27680,93758,32498,0.21923710556329995,0.5400312406527302
4084,0.4085,23,22,23,648786,27658,93781,32475,0.21906285641870485,0.5400528827765121
4085,0.4086,11,15,11,648801,27643,93792,32464,0.21894405018375365,0.5401034821235463
4086,0.4087,12,23,12,648824,27620,93804,32452,0.2187618806234951,0.5402184045811692
4087,0.4088,15,17,15,648841,27603,93819,32437,0.21862723355721708,0.5402564956695536
4088,0.4089,12,17,12,648858,27586,93831,32425,0.21849258649093906,0.540317608438453
4089,0.409,7,17,7,648875,27569,93838,32418,0.218357939424661,0.5404170903695801
4090,0.4091,10,22,10,648897,27547,93848,32408,0.2181836902800659,0.5405387373863731
4091,0.4092,9,23,9,648920,27524,93857,32399,0.21800152071980738,0.5406772024097591
4092,0.4093,11,19,11,648939,27505,93868,32388,0.2178510328222025,0.5407643631142204
4093,0.4094,15,17,15,648956,27488,93883,32373,0.21771638575592447,0.5408028599589048
4094,0.4095,9,19,9,648975,27469,93892,32364,0.21756589785831962,0.5409055203650159
4095,0.4096,16,23,16,648998,27446,93908,32348,0.21738372829806107,0.5409907348563401
4096,0.4097,11,28,11,649026,27418,93919,32337,0.21716195665948548,0.5411597355869802
4097,0.4098,16,18,16,649044,27400,93935,32321,0.21701938917754404,0.5411999129284506
4098,0.4099,9,20,9,649064,27380,93944,32312,0.21686098086427577,0.5413120686189105
4099,0.41,8,15,8,649079,27365,93952,32304,0.21674217462932455,0.5413866496840906
4100,0.4101,11,23,11,649102,27342,93963,32293,0.21656000506906603,0.5415108577177832
4101,0.4102,12,17,12,649119,27325,93975,32281,0.21642535800278798,0.5415729960071134
4102,0.4103,14,23,14,649142,27302,93989,32267,0.21624318844252946,0.5416743608252614
4103,0.4104,8,14,8,649156,27288,93997,32259,0.21613230262324168,0.5417401380422188
4104,0.4105,9,24,9,649180,27264,94006,32250,0.21594221264731972,0.5418893033571933
4105,0.4106,11,25,11,649205,27239,94017,32239,0.21574420225573437,0.5420323480950939
4106,0.4107,17,18,17,649223,27221,94034,32222,0.21560163477379293,0.5420655081338425
4107,0.4108,20,16,20,649239,27205,94054,32202,0.2154749081231783,0.5420573333108893
4108,0.4109,15,25,15,649264,27180,94069,32187,0.21527689773159295,0.5421698923644449
4109,0.411,15,12,15,649276,27168,94084,32172,0.215181852743632,0.5421638018200202
4110,0.4111,16,16,16,649292,27152,94100,32156,0.21505512609301736,0.5421865515613408
4111,0.4112,10,26,10,649318,27126,94110,32146,0.2148491952857686,0.5423471453637468
4112,0.4113,4,26,4,649344,27100,94114,32142,0.21464326447851984,0.5425542689308261
4113,0.4114,10,15,10,649359,27085,94124,32132,0.2145244582435686,0.5426144519310333
4114,0.4115,10,15,10,649374,27070,94134,32122,0.21440565200861741,0.5426746857683471
4115,0.4116,8,21,8,649395,27049,94142,32114,0.21423932327968573,0.542805469634738
4116,0.4117,18,28,18,649423,27021,94160,32096,0.21401755164111014,0.5429233553800091
4117,0.4118,22,26,22,649449,26995,94182,32074,0.21381162083386135,0.5429920939917723
4118,0.4119,11,20,11,649469,26975,94193,32063,0.21365321252059308,0.5430908906128257
4119,0.412,10,14,10,649483,26961,94203,32053,0.2135423267013053,0.5431423052157115
4120,0.4121,14,24,14,649507,26937,94217,32039,0.21335223672538334,0.5432548833423766
4121,0.4122,14,10,14,649517,26927,94231,32025,0.21327303256874922,0.543238566969738
4122,0.4123,10,19,10,649536,26908,94241,32015,0.21312254467114433,0.5433362184545932
4123,0.4124,13,18,13,649554,26890,94254,32002,0.2129799771892029,0.5434014806764925
4124,0.4125,14,16,14,649570,26874,94268,31988,0.21285325053858828,0.5434405898542354
4125,0.4126,19,18,19,649588,26856,94287,31969,0.2127106830566468,0.5434594135146621
4126,0.4127,11,21,11,649609,26835,94298,31958,0.21254435432771512,0.5435681118500502
4127,0.4128,9,19,9,649628,26816,94307,31949,0.21239386643011024,0.5436739555858079
4128,0.4129,11,14,11,649642,26802,94318,31938,0.21228298061082246,0.5437180796731359
4129,0.413,15,17,15,649659,26785,94333,31923,0.2121483335445444,0.5437589425631941
4130,0.4131,18,22,18,649681,26763,94351,31905,0.2119740843999493,0.5438228676620986
4131,0.4132,16,13,16,649694,26750,94367,31889,0.21187111899632494,0.543818960077764
4132,0.4133,10,20,10,649714,26730,94377,31879,0.21171271068305664,0.5439267006773704
4133,0.4134,12,17,12,649731,26713,94389,31867,0.2115780636167786,0.5439911232502561
4134,0.4135,7,18,7,649749,26695,94396,31860,0.21143549613483717,0.5441038340022202
4135,0.4136,8,20,8,649769,26675,94404,31852,0.21127708782156887,0.5442274505783655
4136,0.4137,14,21,14,649790,26654,94418,31838,0.21111075909263718,0.5443137523080079
4137,0.4138,9,16,9,649806,26638,94427,31829,0.21098403244202255,0.5443925633263208
4138,0.4139,10,14,10,649820,26624,94437,31819,0.21087314662273476,0.544445014800746
4139,0.414,15,18,15,649838,26606,94452,31804,0.21073057914079332,0.5444958055127547
4140,0.4141,10,19,10,649857,26587,94462,31794,0.21058009124318844,0.544594988095442
4141,0.4142,15,18,15,649875,26569,94477,31779,0.210437523761247,0.5446459175978611
4142,0.4143,9,17,9,649892,26552,94486,31770,0.21030287669496894,0.5447344055416481
4143,0.4144,12,27,12,649919,26525,94498,31758,0.21008902547205677,0.5448930219789647
4144,0.4145,11,25,11,649944,26500,94509,31747,0.20989101508047142,0.5450409463148317
4145,0.4146,11,18,11,649962,26482,94520,31736,0.20974844759852998,0.545123501322615
4146,0.4147,9,18,9,649980,26464,94529,31727,0.2096058801165885,0.5452217696894709
4147,0.4148,16,27,16,650007,26437,94545,31711,0.20939202889367634,0.5453497970695467
4148,0.4149,11,20,11,650027,26417,94556,31700,0.20923362058040806,0.5454514169692173
4149,0.415,13,25,13,650052,26392,94569,31687,0.20903561018882272,0.5455844625423991
4150,0.4151,12,24,12,650076,26368,94581,31675,0.20884552021290076,0.5457161070241028
4151,0.4152,10,16,10,650092,26352,94591,31665,0.20871879356228615,0.5457883034283055
4152,0.4153,15,15,15,650107,26337,94606,31650,0.20859998732733495,0.5458119923431114
4153,0.4154,15,20,15,650127,26317,94621,31635,0.20844157901406665,0.5458827995582551
4154,0.4155,15,19,15,650146,26298,94636,31620,0.2082910911164618,0.5459442660312857
4155,0.4156,10,18,10,650164,26280,94646,31610,0.20814852363452033,0.5460355847296597
4156,0.4157,14,16,14,650180,26264,94660,31596,0.20802179698390572,0.5460767369512617
4157,0.4158,17,20,17,650200,26244,94677,31579,0.20786338867063744,0.5461321619424796
4158,0.4159,15,18,15,650218,26226,94692,31564,0.20772082118869598,0.5461844609794082
4159,0.416,10,7,10,650225,26219,94702,31554,0.20766537827905207,0.5461720873072197
4160,0.4161,17,19,17,650244,26200,94719,31537,0.20751489038144721,0.5462181963039299
4161,0.4162,14,22,14,650266,26178,94733,31523,0.2073406412368521,0.546316355002513
4162,0.4163,10,24,10,650290,26154,94743,31513,0.20715055126093018,0.546465049334975
4163,0.4164,13,16,13,650306,26138,94756,31500,0.20702382461031554,0.5465144522710712
4164,0.4165,12,16,12,650322,26122,94768,31488,0.20689709795970093,0.5465717757333797
4165,0.4166,13,20,13,650342,26102,94781,31475,0.20673868964643263,0.5466592563002588
4166,0.4167,12,10,12,650352,26092,94793,31463,0.2066594854897985,0.5466597167926331
4167,0.4168,14,24,14,650376,26068,94807,31449,0.20646939551387658,0.5467774744858042
4168,0.4169,7,16,7,650392,26052,94814,31442,0.20634266886326194,0.5468744564650224
4169,0.417,15,28,15,650420,26024,94829,31427,0.20612089722468635,0.5470226801970375
4170,0.4171,14,14,14,650434,26010,94843,31413,0.20601001140539857,0.5470456089023562
4171,0.4172,16,18,16,650452,25992,94859,31397,0.2058674439234571,0.5470909059227378
4172,0.4173,16,19,16,650471,25973,94875,31381,0.20571695602585224,0.5471457962827353
4173,0.4174,9,30,9,650501,25943,94884,31372,0.20547934355594982,0.5473610747622787
4174,0.4175,15,23,15,650524,25920,94899,31357,0.2052971739956913,0.5474623321752187
4175,0.4176,14,17,14,650541,25903,94913,31343,0.20516252692941325,0.5475142368025714
4176,0.4177,14,27,14,650568,25876,94927,31329,0.20494867570650108,0.5476619176645399
4177,0.4178,17,19,17,650587,25857,94944,31312,0.20479818780889622,0.5477094229390054
4178,0.4179,14,18,14,650605,25839,94958,31298,0.20465562032695475,0.5477711465425206
4179,0.418,13,15,13,650620,25824,94971,31285,0.20453681409200355,0.5478120786566041
4180,0.4181,6,17,6,650637,25807,94977,31279,0.2044021670257255,0.5479276880496093
4181,0.4182,15,24,15,650661,25783,94992,31264,0.20421207704980357,0.5480393359861168
4182,0.4183,14,16,14,650677,25767,95006,31250,0.20408535039918896,0.5480821509374397
4183,0.4184,23,24,23,650701,25743,95029,31227,0.203895260423267,0.5481305950500264
4184,0.4185,11,14,11,650715,25729,95040,31216,0.20378437460397922,0.5481780665554482
4185,0.4186,9,18,9,650733,25711,95049,31207,0.20364180712203778,0.5482799817281001
4186,0.4187,13,17,13,650750,25694,95062,31194,0.20350716005575972,0.5483405990718605
4187,0.4188,12,21,12,650771,25673,95074,31182,0.20334083132682804,0.5484478058218275
4188,0.4189,8,19,8,650790,25654,95082,31174,0.20319034342922315,0.548567607517421
4189,0.419,7,20,7,650810,25634,95089,31167,0.20303193511595488,0.5487051284308375
4190,0.4191,12,28,12,650838,25606,95101,31155,0.2028101634773793,0.5488803932277444
4191,0.4192,14,26,14,650864,25580,95115,31141,0.20260423267013053,0.5490206449110558
4192,0.4193,13,20,13,650884,25560,95128,31128,0.20244582435686226,0.5491109229466554
4193,0.4194,17,21,17,650905,25539,95145,31111,0.20227949562793054,0.5491791703442189
4194,0.4195,15,15,15,650920,25524,95160,31096,0.20216068939297935,0.5492052278346874
4195,0.4196,16,12,16,650932,25512,95176,31080,0.20206564440501837,0.5491942324003393
4196,0.4197,7,24,7,650956,25488,95183,31073,0.20187555442909644,0.5493714750446421
4197,0.4198,17,15,17,650971,25473,95200,31056,0.20175674819414524,0.5493817332696492
4198,0.4199,6,21,6,650992,25452,95206,31050,0.20159041946521353,0.5495380694488691
4199,0.42,10,11,10,651003,25441,95216,31040,0.201503294892916,0.5495653405570015
4200,0.4201,14,13,14,651016,25428,95230,31026,0.2014003294892916,0.5495801891805718
4201,0.4202,10,19,10,651035,25409,95240,31016,0.20124984159168674,0.549685423128046
4202,0.4203,9,12,9,651047,25397,95249,31007,0.20115479660372576,0.549730515566272
4203,0.4204,10,19,10,651066,25378,95259,30997,0.2010043087061209,0.5498359201773836
4204,0.4205,8,28,8,651094,25350,95267,30989,0.2007825370675453,0.5500452617192353
4205,0.4206,10,24,10,651118,25326,95277,30979,0.20059244709162335,0.5501998046354676
4206,0.4207,14,21,14,651139,25305,95291,30965,0.20042611836269167,0.5502932290741069
4207,0.4208,15,14,15,651153,25291,95306,30950,0.2003152325434039,0.5503102718657208
4208,0.4209,14,22,14,651175,25269,95320,30936,0.20014098339880876,0.5504136642647451
4209,0.421,9,20,9,651195,25249,95329,30927,0.1999825750855405,0.5505375961264597
4210,0.4211,15,18,15,651213,25231,95344,30912,0.19984000760359905,0.5505940188447358
4211,0.4212,9,27,9,651240,25204,95353,30903,0.19962615638068687,0.5507868893364465
4212,0.4213,11,20,11,651260,25184,95364,30892,0.19946774806741857,0.5508952136386333
4213,0.4214,16,19,16,651279,25165,95380,30876,0.19931726016981371,0.5509537659927553
4214,0.4215,10,18,10,651297,25147,95390,30866,0.19917469268787225,0.5510506489564923
4215,0.4216,13,31,13,651328,25116,95403,30853,0.19892915980230644,0.5512515856992264
4216,0.4217,11,20,11,651348,25096,95414,30842,0.19877075148903814,0.5513604347670635
4217,0.4218,13,21,13,651369,25075,95427,30829,0.19860442276010645,0.5514632226674299
4218,0.4219,16,16,16,651385,25059,95443,30813,0.1984776961094918,0.5514926975945017
4219,0.422,9,18,9,651403,25041,95452,30804,0.19833512862755037,0.5515981735159817
4220,0.4221,13,19,13,651422,25022,95465,30791,0.19818464072994552,0.5516815078924265
4221,0.4222,8,14,8,651436,25008,95473,30783,0.1980737549106577,0.5517556595149755
4222,0.4223,15,13,15,651449,24995,95488,30768,0.19797078950703334,0.551763714290838
4223,0.4224,9,19,9,651468,24976,95497,30759,0.19782030160942846,0.5518794294428995
4224,0.4225,8,16,8,651484,24960,95505,30751,0.19769357495881384,0.5519735779289547
4225,0.4226,14,10,14,651494,24950,95519,30737,0.1976143708021797,0.5519600624921436
4226,0.4227,16,9,16,651503,24941,95535,30721,0.19754308706120896,0.5519205202831375
4227,0.4228,18,17,18,651520,24924,95553,30703,0.19740843999493093,0.5519441997591098
4228,0.4229,13,21,13,651541,24903,95566,30690,0.19724211126599925,0.5520479197021207
4229,0.423,9,17,9,651558,24886,95575,30681,0.1971074641997212,0.5521442582827938
4230,0.4231,9,21,9,651579,24865,95584,30672,0.1969411354707895,0.5522804616741992
4231,0.4232,14,24,14,651603,24841,95598,30658,0.19675104549486758,0.552406349663958
4232,0.4233,10,18,10,651621,24823,95608,30648,0.1966084780129261,0.5525049124767897
4233,0.4234,11,16,11,651637,24807,95619,30637,0.1964817513623115,0.5525755717480701
4234,0.4235,20,15,20,651652,24792,95639,30617,0.19636294512736027,0.5525636629428432
4235,0.4236,11,10,11,651662,24782,95650,30606,0.19628374097072615,0.5525745648877013
4236,0.4237,13,21,13,651683,24761,95663,30593,0.19611741224179444,0.5526791198468042
4237,0.4238,11,20,11,651703,24741,95674,30582,0.19595900392852617,0.5527899788514723
4238,0.4239,9,14,9,651717,24727,95683,30573,0.19584811810923838,0.5528571428571428
4239,0.424,12,16,12,651733,24711,95695,30561,0.19572139145862374,0.5529201042118975
4240,0.4241,6,13,6,651746,24698,95701,30555,0.19561842605499938,0.5530016469693954
4241,0.4242,16,16,16,651762,24682,95717,30539,0.19549169940438474,0.5530323608772025
4242,0.4243,14,22,14,651784,24660,95731,30525,0.19531745025978964,0.5531394400652351
4243,0.4244,21,15,21,651799,24645,95752,30504,0.1951986440248384,0.5531197301854974
4244,0.4245,12,22,12,651821,24623,95764,30492,0.1950243948802433,0.5532432187244851
4245,0.4246,9,14,9,651835,24609,95773,30483,0.19491350906095553,0.5533108255282073
4246,0.4247,15,16,15,651851,24593,95788,30468,0.1947867824103409,0.5533499209967128
4247,0.4248,8,15,8,651866,24578,95796,30460,0.1946679761753897,0.5534358079872088
4248,0.4249,7,13,7,651879,24565,95803,30453,0.1945650107717653,0.5535097604420371
4249,0.425,13,13,13,651892,24552,95816,30440,0.1944620453681409,0.5535350596450392
4250,0.4251,14,23,14,651915,24529,95830,30426,0.1942798758078824,0.5536529888090256
4251,0.4252,9,21,9,651936,24508,95839,30417,0.1941135470789507,0.5537915339098771
4252,0.4253,13,16,13,651952,24492,95852,30404,0.19398682042833607,0.5538472748469834
4253,0.4254,12,21,12,651973,24471,95864,30392,0.19382049169940438,0.5539616863824436
4254,0.4255,14,12,14,651985,24459,95878,30378,0.19372544671144343,0.5539690355052246
4255,0.4256,10,16,10,652001,24443,95888,30368,0.1935987200608288,0.5540493696520772
4256,0.4257,19,20,19,652021,24423,95907,30349,0.19344031174756052,0.5540969838603667
4257,0.4258,11,17,11,652038,24406,95918,30338,0.19330566468128246,0.5541794534560865
4258,0.4259,12,19,12,652057,24387,95930,30326,0.1931551767836776,0.5542741213239998
4259,0.426,7,25,7,652082,24362,95937,30319,0.19295716639209226,0.5544704742049341
4260,0.4261,16,23,16,652105,24339,95953,30303,0.19277499683183374,0.5545734050730208
4261,0.4262,12,21,12,652126,24318,95965,30291,0.19260866810290203,0.5546887875624897
4262,0.4263,12,24,12,652150,24294,95977,30279,0.1924185781269801,0.554834808421747
4263,0.4264,14,11,14,652161,24283,95991,30265,0.19233145355468256,0.5548324411527462
4264,0.4265,8,12,8,652173,24271,95999,30257,0.19223640856672158,0.5548892312206573
4265,0.4266,11,19,11,652192,24252,96010,30246,0.19208592066911673,0.5549928437740834
4266,0.4267,12,14,12,652206,24238,96022,30234,0.19197503484982892,0.5550374504332501
4267,0.4268,15,23,15,652229,24215,96037,30219,0.1917928652895704,0.5551493551824227
4268,0.4269,7,12,7,652241,24203,96044,30212,0.19169782030160942,0.5552145548102545
4269,0.427,14,15,14,652256,24188,96058,30198,0.19157901406665823,0.5552531901592321
4270,0.4271,18,17,18,652273,24171,96076,30180,0.19144436700038017,0.5552795716730143
4271,0.4272,10,12,10,652285,24159,96086,30170,0.19134932201241922,0.5553203629737341
4272,0.4273,15,12,15,652297,24147,96101,30155,0.19125427702445824,0.5553202460314537
4273,0.4274,8,11,8,652308,24136,96109,30147,0.19116715245216068,0.5553672420463128
4274,0.4275,10,22,10,652330,24114,96119,30137,0.19099290330756558,0.5555104975023502
4275,0.4276,8,23,8,652353,24091,96127,30129,0.19081073374730706,0.5556805606787163
4276,0.4277,10,9,10,652362,24082,96137,30119,0.19073945000633633,0.5556908544122802
4277,0.4278,10,20,10,652382,24062,96147,30109,0.19058104169306805,0.5558139964187481
4278,0.4279,11,21,11,652403,24041,96158,30098,0.19041471296413637,0.5559393413251076
4279,0.428,9,27,9,652430,24014,96167,30089,0.1902008617412242,0.5561429125926474
4280,0.4281,10,17,10,652447,23997,96177,30079,0.19006621467494614,0.5562356683186627
4281,0.4282,8,13,8,652460,23984,96185,30071,0.18996324927132177,0.556303764684118
4282,0.4283,10,17,10,652477,23967,96195,30061,0.18982860220504372,0.556396683201303
4283,0.4284,15,23,15,652500,23944,96210,30046,0.1896464326447852,0.5565104649009076
4284,0.4285,16,16,16,652516,23928,96226,30030,0.18951970599417056,0.5565439786500611
4285,0.4286,16,20,16,652536,23908,96242,30014,0.1893612976809023,0.5566188197767146
4286,0.4287,12,31,12,652567,23877,96254,30002,0.18911576479533646,0.5568403274002858
4287,0.4288,6,18,6,652585,23859,96260,29996,0.188973197313395,0.5569770680531055
4288,0.4289,10,24,10,652609,23835,96270,29986,0.18878310733747308,0.5571431225729734
4289,0.429,6,18,6,652627,23817,96276,29980,0.1886405398555316,0.5572801457330334
4290,0.4291,9,20,9,652647,23797,96285,29971,0.18848213154226334,0.5574133313495016
4291,0.4292,10,14,10,652661,23783,96295,29961,0.18837124572297553,0.557476183387913
4292,0.4293,12,19,12,652680,23764,96307,29949,0.18822075782537068,0.5575745164112971
4293,0.4294,26,18,26,652698,23746,96333,29923,0.18807819034342924,0.5575471873893681
4294,0.4295,13,14,13,652712,23732,96346,29910,0.18796730452414143,0.5575854740688266
4295,0.4296,14,20,14,652732,23712,96360,29896,0.18780889621087316,0.5576779585136546
4296,0.4297,11,23,11,652755,23689,96371,29885,0.1876267266506146,0.5578265576585657
4297,0.4298,7,10,7,652765,23679,96378,29878,0.1875475224939805,0.5578729204399051
4298,0.4299,10,12,10,652777,23667,96388,29868,0.1874524775060195,0.5579153824600729
4299,0.43,12,17,12,652794,23650,96400,29856,0.18731783043974148,0.557993496056517
4300,0.4301,9,16,9,652810,23634,96409,29847,0.18719110378912684,0.5580860492511359
4301,0.4302,8,13,8,652823,23621,96417,29839,0.18708813838550248,0.5581556303778527
4302,0.4303,7,25,7,652848,23596,96424,29832,0.18689012799391713,0.5583589129295501
4303,0.4304,10,15,10,652863,23581,96434,29822,0.1867713217589659,0.558433046832575
4304,0.4305,11,20,11,652883,23561,96445,29811,0.18661291344569764,0.5585513003072772
4305,0.4306,13,22,13,652905,23539,96458,29798,0.18643866430110254,0.558674091156233
4306,0.4307,13,12,13,652917,23527,96471,29785,0.18634361931314156,0.5586922268907563
4307,0.4308,9,17,9,652934,23510,96480,29776,0.1862089722468635,0.5587959313891079
4308,0.4309,13,22,13,652956,23488,96493,29763,0.1860347231022684,0.558919081331806
4309,0.431,14,23,14,652979,23465,96507,29749,0.18585255354200989,0.5590446123200662
4310,0.4311,6,8,6,652987,23457,96513,29743,0.18578919021670257,0.559078947368421
4311,0.4312,18,23,18,653010,23434,96531,29725,0.18560702065644405,0.55917154197784
4312,0.4313,10,11,10,653021,23423,96541,29715,0.18551989608414649,0.559204335880161
4313,0.4314,13,23,13,653044,23400,96554,29702,0.18533772652388797,0.5593386313133215
4314,0.4315,11,20,11,653064,23380,96565,29691,0.1851793182106197,0.5594580844529027
4315,0.4316,15,12,15,653076,23368,96580,29676,0.18508427322265872,0.5594600708845486
4316,0.4317,10,22,10,653098,23346,96590,29666,0.18491002407806362,0.5596091450992228
4317,0.4318,14,19,14,653117,23327,96604,29652,0.18475953618045876,0.5596934634477811
4318,0.4319,11,17,11,653134,23310,96615,29641,0.1846248891141807,0.559781684954014
4319,0.432,17,16,17,653150,23294,96632,29624,0.1844981624635661,0.5598095166106051
4320,0.4321,13,12,13,653162,23282,96645,29611,0.18440311747560512,0.55982833267162
4321,0.4322,7,12,7,653174,23270,96652,29604,0.18430807248764416,0.559897113893407
4322,0.4323,14,19,14,653193,23251,96666,29590,0.18415758459003928,0.5599818322893207
4323,0.4324,13,24,13,653217,23227,96679,29577,0.18396749461411735,0.5601280206044996
4324,0.4325,14,17,14,653234,23210,96693,29563,0.18383284754783932,0.5601917647281754
4325,0.4326,9,18,9,653252,23192,96702,29554,0.18369028006589785,0.5603078906457362
4326,0.4327,11,18,11,653270,23174,96713,29543,0.1835477125839564,0.5604074586945388
4327,0.4328,14,18,14,653288,23156,96727,29529,0.18340514510201494,0.5604821106576825
4328,0.4329,10,16,10,653304,23140,96737,29519,0.18327841845140033,0.5605689435803947
4329,0.433,15,16,15,653320,23124,96752,29504,0.1831516918007857,0.5606141217602797
4330,0.4331,16,28,16,653348,23096,96768,29488,0.1829299201622101,0.5607789441655257
4331,0.4332,11,14,11,653362,23082,96779,29477,0.18281903434292232,0.56083639338648
4332,0.4333,20,12,20,653374,23070,96799,29457,0.18272398935496134,0.5607973042435319
4333,0.4334,14,24,14,653398,23046,96813,29443,0.1825338993790394,0.5609365771876013
4334,0.4335,9,11,9,653409,23035,96822,29434,0.18244677480674185,0.5609788637100002
4335,0.4336,9,24,9,653433,23011,96831,29425,0.18225668483081991,0.5611602715691509
4336,0.4337,11,22,11,653455,22989,96842,29414,0.18208243568622481,0.5613037421521668
4337,0.4338,17,20,17,653475,22969,96859,29397,0.18192402737295654,0.5613757017912386
4338,0.4339,13,15,13,653490,22954,96872,29384,0.18180522113800532,0.5614276433948565
4339,0.434,14,17,14,653507,22937,96886,29370,0.1816705740717273,0.5614927256390158
4340,0.4341,10,17,10,653524,22920,96896,29360,0.18153592700544924,0.5615914307574599
4341,0.4342,7,20,7,653544,22900,96903,29353,0.18137751869218097,0.5617476508525826
4342,0.4343,14,20,14,653564,22880,96917,29339,0.1812191103789127,0.5618453053486279
4343,0.4344,8,14,8,653578,22866,96925,29331,0.1811082245596249,0.5619288464854302
4344,0.4345,8,20,8,653598,22846,96933,29323,0.18094981624635662,0.5620770955931683
4345,0.4346,15,10,15,653608,22836,96948,29308,0.18087061208972247,0.5620589137772323
4346,0.4347,14,16,14,653624,22820,96962,29294,0.18074388543910785,0.5621138273784396
4347,0.4348,11,21,11,653645,22799,96973,29283,0.18057755671017614,0.5622479935486349
4348,0.4349,14,13,14,653658,22786,96987,29269,0.18047459130655177,0.5622706752473345
4349,0.435,13,16,13,653674,22770,97000,29256,0.18034786465593713,0.5623342175066313
4350,0.4351,11,8,11,653682,22762,97011,29245,0.18028450133062984,0.5623281481339051
4351,0.4352,7,17,7,653699,22745,97018,29238,0.1801498542643518,0.5624531096704692
4352,0.4353,11,12,11,653711,22733,97029,29227,0.18005480927639084,0.5624903772132409
4353,0.4354,16,12,16,653723,22721,97045,29211,0.17995976428842986,0.5624855580374336
4354,0.4355,11,14,11,653737,22707,97056,29200,0.17984887846914205,0.5625445508312944
4355,0.4356,11,20,11,653757,22687,97067,29189,0.17969047015587378,0.5626686714472974
4356,0.4357,9,18,9,653775,22669,97076,29180,0.17954790267393234,0.562788096202434
4357,0.4358,18,19,18,653794,22650,97094,29162,0.17939741477632745,0.5628425847294063
4358,0.4359,8,20,8,653814,22630,97102,29154,0.17923900646305918,0.5629924300942376
4359,0.436,12,20,12,653834,22610,97114,29142,0.1790805981497909,0.5631086721286134
4360,0.4361,7,12,7,653846,22598,97121,29135,0.17898555316182993,0.5631801751299944
4361,0.4362,15,26,15,653872,22572,97136,29120,0.17877962235458117,0.563336686527896
4362,0.4363,13,14,13,653886,22558,97149,29107,0.17866873653529336,0.5633794638536727
4363,0.4364,15,17,15,653903,22541,97164,29092,0.17853408946901533,0.5634381112854182
4364,0.4365,12,20,12,653923,22521,97176,29080,0.17837568115574706,0.5635549698649251
4365,0.4366,13,21,13,653944,22500,97189,29067,0.17820935242681535,0.5636744429577055
4366,0.4367,15,17,15,653961,22483,97204,29052,0.17807470536053732,0.5637333850781022
4367,0.4368,10,19,10,653980,22464,97214,29042,0.17792421746293247,0.563856638061585
4368,0.4369,15,14,15,653994,22450,97229,29027,0.17781333164364466,0.5638828991588476
4369,0.437,12,15,12,654009,22435,97241,29015,0.17769452540869346,0.5639455782312925
4370,0.4371,13,15,13,654024,22420,97254,29002,0.17757571917374224,0.5639998444245654
4371,0.4372,7,21,7,654045,22399,97261,28995,0.17740939044481055,0.564170914892789
4372,0.4373,11,17,11,654062,22382,97272,28984,0.1772747433785325,0.5642642993419772
4373,0.4374,11,16,11,654078,22366,97283,28973,0.17714801672791788,0.5643467928864996
4374,0.4375,10,18,10,654096,22348,97293,28963,0.17700544924597642,0.5644598624076709
4375,0.4376,16,21,16,654117,22327,97309,28947,0.17683912051704473,0.5645551351562196
4376,0.4377,12,11,12,654128,22316,97321,28935,0.1767519959447472,0.564574349768785
4377,0.4378,14,23,14,654151,22293,97335,28921,0.17656982638448865,0.5647088686687234
4378,0.4379,15,9,15,654160,22284,97350,28906,0.17649854264351794,0.5646806016800157
4379,0.438,24,21,24,654181,22263,97374,28882,0.17633221391458623,0.5647081826180468
4380,0.4381,9,18,9,654199,22245,97383,28873,0.1761896464326448,0.5648303924253687
4381,0.4382,15,14,15,654213,22231,97398,28858,0.17607876061335698,0.5648574057037719
4382,0.4383,11,17,11,654230,22214,97409,28847,0.17594411354707895,0.564951724408061
4383,0.4384,8,16,8,654246,22198,97417,28839,0.17581738689646434,0.5650606422791308
4384,0.4385,8,11,8,654257,22187,97425,28831,0.17573026232416677,0.5651142733937042
4385,0.4386,6,13,6,654270,22174,97431,28825,0.17562729692054238,0.565207160924724
4386,0.4387,10,14,10,654284,22160,97441,28815,0.1755164111012546,0.5652770966159882
4387,0.4388,9,11,9,654295,22149,97450,28806,0.17542928652895703,0.5653223432440388
4388,0.4389,16,17,16,654312,22132,97466,28790,0.175294639462679,0.5653744943246534
4389,0.439,9,16,9,654328,22116,97475,28781,0.17516791281206437,0.5654753718293809
4390,0.4391,23,18,23,654346,22098,97498,28758,0.17502534533012293,0.5654789995280792
4391,0.4392,17,19,17,654365,22079,97515,28741,0.17487485743251807,0.5655450609996064
4392,0.4393,9,15,9,654380,22064,97524,28732,0.17475605119756685,0.5656350893771163
4393,0.4394,12,16,12,654396,22048,97536,28720,0.17462932454695224,0.5657106838953672
4394,0.4395,13,14,13,654410,22034,97549,28707,0.17451843872766443,0.5657555034390335
4395,0.4396,7,20,7,654430,22014,97556,28700,0.17436003041439616,0.565918681232007
4396,0.4397,16,18,16,654448,21996,97572,28684,0.1742174629324547,0.565982636148382
4397,0.4398,8,17,8,654465,21979,97580,28676,0.17408281586617666,0.5661040371138091
4398,0.4399,15,16,15,654481,21963,97595,28661,0.17395608921556202,0.5661543931731985
4399,0.44,7,22,7,654503,21941,97602,28654,0.17378184007096692,0.5663405474849293
4400,0.4401,8,13,8,654516,21928,97610,28646,0.17367887466734255,0.566417526792423
4401,0.4402,5,18,5,654534,21910,97615,28641,0.17353630718540108,0.5665763288560068
4402,0.4403,13,15,13,654549,21895,97628,28628,0.1734175009504499,0.5666330186251806
4403,0.4404,12,11,12,654560,21884,97640,28616,0.17333037637815232,0.5666534653465346
4404,0.4405,12,16,12,654576,21868,97652,28604,0.1732036497275377,0.5667300681566017
4405,0.4406,8,14,8,654590,21854,97660,28596,0.1730927639082499,0.566818632309217
4406,0.4407,8,15,8,654605,21839,97668,28588,0.1729739576732987,0.5669185158744323
4407,0.4408,15,13,15,654618,21826,97683,28573,0.1728709922696743,0.5669358519018235
4408,0.4409,9,19,9,654637,21807,97692,28564,0.17272050437206946,0.5670723233606638
4409,0.441,8,23,8,654660,21784,97700,28556,0.1725383348118109,0.5672626142232817
4410,0.4411,14,13,14,654673,21771,97714,28542,0.17243536940818655,0.5672887722854928
4411,0.4412,14,8,14,654681,21763,97728,28528,0.17237200608287923,0.5672585552086854
4412,0.4413,9,14,9,654695,21749,97737,28519,0.17226112026359144,0.5673390626243335
4413,0.4414,10,19,10,654714,21730,97747,28509,0.17211063236598656,0.5674675053245487
4414,0.4415,7,14,7,654728,21716,97754,28502,0.17199974654669878,0.567565414791509
4415,0.4416,11,15,11,654743,21701,97765,28491,0.17188094031174755,0.5676402613962385
4416,0.4417,15,17,15,654760,21684,97780,28476,0.17174629324546953,0.5677033492822966
4417,0.4418,14,13,14,654773,21671,97794,28462,0.17164332784184513,0.5677298386292462
4418,0.4419,8,14,8,654787,21657,97802,28454,0.17153244202255735,0.5678194408413323
4419,0.442,14,17,14,654804,21640,97816,28440,0.1713977949562793,0.5678913738019169
4420,0.4421,10,25,10,654829,21615,97826,28430,0.17119978456469395,0.5680887201518633
4421,0.4422,16,13,16,654842,21602,97842,28414,0.17109681916106959,0.5680982085732565
4422,0.4423,17,15,17,654857,21587,97859,28397,0.17097801292611836,0.5681217989756722
4423,0.4424,9,16,9,654873,21571,97868,28388,0.17085128627550375,0.5682259452751256
4424,0.4425,14,20,14,654893,21551,97882,28374,0.17069287796223545,0.5683324987481222
4425,0.4426,16,23,16,654916,21528,97898,28358,0.17051070840197693,0.5684560798620856
4426,0.4427,14,20,14,654936,21508,97912,28344,0.17035230008870866,0.5685629463211105
4427,0.4428,13,19,13,654955,21489,97925,28331,0.17020181219110378,0.568667201926937
4428,0.4429,16,19,16,654974,21470,97941,28315,0.17005132429349892,0.5687456061062569
4429,0.443,15,15,15,654989,21455,97956,28300,0.1699325180585477,0.5687870565772284
4430,0.4431,13,15,13,655004,21440,97969,28287,0.1698137118235965,0.5688458986063909
4431,0.4432,9,16,9,655020,21424,97978,28278,0.1696869851729819,0.5689509476479819
4432,0.4433,14,20,14,655040,21404,97992,28264,0.1695285768597136,0.5690585487637916
4433,0.4434,18,15,18,655055,21389,98010,28246,0.1694097706247624,0.5690742419663544
4434,0.4435,16,13,16,655068,21376,98026,28230,0.169306805221138,0.569084384953433
4435,0.4436,13,13,13,655081,21363,98039,28217,0.16920383981751363,0.5691206131504639
4436,0.4437,9,13,9,655094,21350,98048,28208,0.16910087441388924,0.5691916542233343
4437,0.4438,11,11,11,655105,21339,98059,28197,0.16901374984159168,0.5692223837209303
4438,0.4439,6,13,6,655118,21326,98065,28191,0.1689107844379673,0.5693196276026415
4439,0.444,12,12,12,655130,21314,98077,28179,0.16881573945000633,0.5693532418725881
4440,0.4441,6,23,6,655153,21291,98083,28173,0.16863356988974781,0.5695657447840854
4441,0.4442,3,12,3,655165,21279,98086,28170,0.16853852490178683,0.5696778499059637
4442,0.4443,9,15,9,655180,21264,98095,28161,0.16841971866683564,0.5697723823975721
4443,0.4444,9,23,9,655203,21241,98104,28152,0.16823754910657712,0.5699593059745308
4444,0.4445,15,15,15,655218,21226,98119,28137,0.1681187428716259,0.5700018232279237
4445,0.4446,7,17,7,655235,21209,98126,28130,0.16798409580534787,0.5701372139686658
4446,0.4447,20,16,20,655251,21193,98146,28110,0.16785736915473323,0.5701478611849178
4447,0.4448,15,19,15,655270,21174,98161,28095,0.16770688125712838,0.5702368629361262
4448,0.4449,18,11,18,655281,21163,98179,28077,0.1676197566848308,0.5702071486596263
4449,0.445,9,11,9,655292,21152,98188,28068,0.16753263211253328,0.5702559934985778
4450,0.4451,8,14,8,655306,21138,98196,28060,0.16742174629324547,0.5703483881458596
4451,0.4452,14,20,14,655326,21118,98210,28046,0.1672633379799772,0.570458058742169
4452,0.4453,12,12,12,655338,21106,98222,28034,0.16716829299201622,0.5704924704924705
4453,0.4454,16,16,16,655354,21090,98238,28018,0.1670415663414016,0.5705384051478374
4454,0.4455,13,17,13,655371,21073,98251,28005,0.16690691927512355,0.5706222747463222
4455,0.4456,11,6,11,655377,21067,98262,27994,0.1668593967811431,0.5705957889158395
4456,0.4457,8,23,8,655400,21044,98270,27986,0.16667722722088454,0.5707933918009382
4457,0.4458,13,15,13,655415,21029,98283,27973,0.16655842098593335,0.5708542508469042
4458,0.4459,16,22,16,655437,21007,98299,27957,0.16638417184133825,0.5709705089453476
4459,0.446,12,19,12,655456,20988,98311,27945,0.16623368394373336,0.5710869965054258
4460,0.4461,10,17,10,655473,20971,98321,27935,0.16609903687745534,0.5711978080399133
4461,0.4462,8,19,8,655492,20952,98329,27927,0.16594854897985045,0.5713496593629166
4462,0.4463,18,14,18,655506,20938,98347,27909,0.16583766316056267,0.571355456834606
4463,0.4464,5,12,5,655518,20926,98352,27904,0.1657426181726017,0.5714519762441123
4464,0.4465,16,8,16,655526,20918,98368,27888,0.1656792548472944,0.5714051551038807
4465,0.4466,18,12,18,655538,20906,98386,27870,0.16558420985933342,0.5713875676562243
4466,0.4467,6,8,6,655546,20898,98392,27864,0.1655208465340261,0.5714285714285714
4467,0.4468,9,14,9,655560,20884,98401,27855,0.16540996071473832,0.5715135722932354
4468,0.4469,8,16,8,655576,20868,98409,27847,0.16528323406412368,0.5716309145027199
4469,0.447,11,12,11,655588,20856,98420,27836,0.16518818907616273,0.5716750184835291
4470,0.4471,7,13,7,655601,20843,98427,27829,0.16508522367253833,0.5717661078238001
4471,0.4472,12,13,12,655614,20830,98439,27817,0.16498225826891394,0.5718132670051597
4472,0.4473,17,10,17,655624,20820,98456,27800,0.16490305411227982,0.5717811600164542
4473,0.4474,13,21,13,655645,20799,98469,27787,0.16473672538334813,0.5719137200016465
4474,0.4475,10,13,10,655658,20786,98479,27777,0.16463375997972374,0.5719786668863126
4475,0.4476,8,13,8,655671,20773,98487,27769,0.16453079457609934,0.5720613077335092
4476,0.4477,12,15,12,655686,20758,98499,27757,0.16441198834114815,0.5721323302071524
4477,0.4478,10,16,10,655702,20742,98509,27747,0.1642852616905335,0.572232877559859
4478,0.4479,10,15,10,655717,20727,98519,27737,0.1641664554555823,0.5723217233410366
4479,0.448,15,16,15,655733,20711,98534,27722,0.16403972880496767,0.5723783370842195
4480,0.4481,8,12,8,655745,20699,98542,27714,0.16394468381700672,0.5724495486749427
4481,0.4482,20,13,20,655758,20686,98562,27694,0.16384171841338233,0.5724266225713105
4482,0.4483,16,15,16,655773,20671,98578,27678,0.16372291217843113,0.5724627189807442
4483,0.4484,14,16,14,655789,20655,98592,27664,0.1635961855278165,0.5725284049752686
4484,0.4485,9,13,9,655802,20642,98601,27655,0.16349322012419212,0.5726028531792865
4485,0.4486,13,11,13,655813,20631,98614,27642,0.16340609555189456,0.5726182337952893
4486,0.4487,6,20,6,655833,20611,98620,27636,0.1632476872386263,0.5728024540385931
4487,0.4488,11,18,11,655851,20593,98631,27625,0.16310511975668482,0.5729188269940686
4488,0.4489,12,9,12,655860,20584,98643,27613,0.1630338360157141,0.5729194763159533
4489,0.449,7,10,7,655870,20574,98650,27606,0.16295463185907996,0.5729763387297634
4490,0.4491,10,13,10,655883,20561,98660,27596,0.1628516664554556,0.5730423406773678
4491,0.4492,22,7,22,655890,20554,98682,27574,0.1627962235458117,0.5729305186170213
4492,0.4493,14,16,14,655906,20538,98696,27560,0.16266949689519705,0.5729967982036676
4493,0.4494,6,17,6,655923,20521,98702,27554,0.16253484982891903,0.5731461258450338
4494,0.4495,11,12,11,655935,20509,98713,27543,0.16243980484095805,0.5731915424956298
4495,0.4496,17,16,17,655951,20493,98730,27526,0.16231307819034343,0.5732314292259314
4496,0.4497,12,14,12,655965,20479,98742,27514,0.16220219237105563,0.5732919384076844
4497,0.4498,7,16,7,655981,20463,98749,27507,0.16207546572044101,0.5734208880550344
4498,0.4499,11,17,11,655998,20446,98760,27496,0.16194081865416296,0.5735263443327354
4499,0.45,10,18,10,656016,20428,98770,27486,0.16179825117222152,0.5736527945903076
4500,0.4501,13,14,13,656030,20414,98783,27473,0.1616873653529337,0.5737047632969282
4501,0.4502,12,13,12,656043,20401,98795,27461,0.16158439994930934,0.5737537085788308
4502,0.4503,10,13,10,656056,20388,98805,27451,0.16148143454568495,0.5738205230042434
4503,0.4504,13,15,13,656071,20373,98818,27438,0.16136262831073375,0.5738846708916359
4504,0.4505,9,11,9,656082,20362,98827,27429,0.1612755037384362,0.5739365152434559
4505,0.4506,12,13,12,656095,20349,98839,27417,0.16117253833481182,0.5739856801909308
4506,0.4507,10,18,10,656113,20331,98849,27407,0.16102997085287035,0.5741128660605807
4507,0.4508,10,17,10,656130,20314,98859,27397,0.16089532378659233,0.5742281654125883
4508,0.4509,9,9,9,656139,20305,98868,27388,0.1608240400456216,0.5742561801522236
4509,0.451,7,11,7,656150,20294,98875,27381,0.16073691547332403,0.574326166754064
4510,0.4511,8,11,8,656161,20283,98883,27373,0.1606497909010265,0.574387275474232
4511,0.4512,12,20,12,656181,20263,98895,27361,0.16049138258775822,0.5745212497900218
4512,0.4513,16,13,16,656194,20250,98911,27345,0.16038841718413382,0.5745351402458242
4513,0.4514,7,19,7,656213,20231,98918,27338,0.16023792928652897,0.5747020118144169
4514,0.4515,9,15,9,656228,20216,98927,27329,0.16011912305157774,0.574802818382585
4515,0.4516,16,18,16,656246,20198,98943,27313,0.1599765555696363,0.5748773968133696
4516,0.4517,13,14,13,656260,20184,98956,27300,0.1598656697503485,0.5749305029062421
4517,0.4518,8,15,8,656275,20169,98964,27292,0.1597468635153973,0.5750405596173701
4518,0.4519,11,18,11,656293,20151,98975,27281,0.15960429603345583,0.5751602293810086
4519,0.452,15,9,15,656302,20142,98990,27266,0.15953301229248512,0.5751349983125211
4520,0.4521,14,15,14,656317,20127,99004,27252,0.1594142060575339,0.5751915405559425
4521,0.4522,15,11,15,656328,20116,99019,27237,0.15932708148523633,0.5751905898253542
4522,0.4523,14,12,14,656340,20104,99033,27223,0.15923203649727538,0.5752107676379233
4523,0.4524,6,13,6,656353,20091,99039,27217,0.159129071093651,0.5753149573010907
4524,0.4525,8,24,8,656377,20067,99047,27209,0.15893898111772906,0.5755351552584821
4525,0.4526,11,9,11,656386,20058,99058,27198,0.15886769737675832,0.5755459624174708
4526,0.4527,13,16,13,656402,20042,99071,27185,0.1587409707261437,0.5756241133250047
4527,0.4528,13,16,13,656418,20026,99084,27172,0.15861424407552907,0.5757023602695029
4528,0.4529,11,15,11,656433,20011,99095,27161,0.15849543784057787,0.5757864835071652
4529,0.453,13,21,13,656454,19990,99108,27148,0.1583291091116462,0.575926004497433
4530,0.4531,14,5,14,656459,19985,99122,27134,0.1582895070333291,0.5758611175958743
4531,0.4532,7,17,7,656476,19968,99129,27127,0.15815485996705106,0.5760059454294512
4532,0.4533,5,9,5,656485,19959,99134,27122,0.15808357622608035,0.5760710265287483
4533,0.4534,13,10,13,656495,19949,99147,27109,0.1580043720694462,0.5760763313357984
4534,0.4535,16,19,16,656514,19930,99163,27093,0.15785388417184135,0.5761648554962465
4535,0.4536,8,13,8,656527,19917,99171,27085,0.15775091876821695,0.5762520743798136
4536,0.4537,10,14,10,656541,19903,99181,27075,0.15764003294892917,0.5763336029630891
4537,0.4538,14,13,14,656554,19890,99195,27061,0.15753706754530478,0.5763668505463142
4538,0.4539,7,17,7,656571,19873,99202,27054,0.15740242047902675,0.5765124555160143
4539,0.454,13,25,13,656596,19848,99215,27041,0.15720441008744138,0.5767024248757704
4540,0.4541,13,24,13,656620,19824,99228,27028,0.15701432011151945,0.5768803893110219
4541,0.4542,10,18,10,656638,19806,99238,27018,0.156871752629578,0.5770117888262429
4542,0.4543,14,18,14,656656,19788,99252,27004,0.15672918514763653,0.5771071978115917
4543,0.4544,10,17,10,656673,19771,99262,26994,0.1565945380813585,0.5772265583235325
4544,0.4545,4,18,4,656691,19753,99266,26990,0.15645197059941707,0.5774126607192521
4545,0.4546,11,13,11,656704,19740,99277,26979,0.15634900519579267,0.5774738329159442
4546,0.4547,8,16,8,656720,19724,99285,26971,0.15622227854517806,0.5775993147017882
4547,0.4548,11,13,11,656733,19711,99296,26960,0.15611931314155367,0.577660645797176
4548,0.4549,19,20,19,656753,19691,99315,26941,0.1559609048282854,0.5777363184079602
4549,0.455,4,11,4,656764,19680,99319,26937,0.15587378025598783,0.5778364116094987
4550,0.4551,9,10,9,656774,19670,99328,26928,0.15579457609935368,0.5778788789218421
4551,0.4552,13,15,13,656789,19655,99341,26915,0.15567576986440249,0.5779471762937514
4552,0.4553,14,15,14,656804,19640,99355,26901,0.15555696362945126,0.5780064889022583
4553,0.4554,14,20,14,656824,19620,99369,26887,0.155398555316183,0.5781280237383619
4554,0.4555,14,14,14,656838,19606,99383,26873,0.1552876694968952,0.5781750898255126
4555,0.4556,8,11,8,656849,19595,99391,26865,0.15520054492459764,0.5782393456736978
4556,0.4557,12,5,12,656854,19590,99403,26853,0.15516094284628057,0.5781926232155545
4557,0.4558,8,13,8,656867,19577,99411,26845,0.1550579774426562,0.5782818491232605
4558,0.4559,11,20,11,656887,19557,99422,26834,0.1548995691293879,0.5784311612166153
4559,0.456,11,18,11,656905,19539,99433,26823,0.15475700164744646,0.5785557137310728
4560,0.4561,12,13,12,656918,19526,99445,26811,0.15465403624382207,0.5786088870664912
4561,0.4562,10,7,10,656925,19519,99455,26801,0.1545985933341782,0.5786053540587219
4562,0.4563,3,12,3,656937,19507,99458,26798,0.1545035483462172,0.5787279991361624
4563,0.4564,12,15,12,656952,19492,99470,26786,0.154384742111266,0.5788063442672544
4564,0.4565,8,12,8,656964,19480,99478,26778,0.15428969712330504,0.5788836525573955
4565,0.4566,15,15,15,656979,19465,99493,26763,0.1541708908883538,0.5789348446828761
4566,0.4567,6,19,6,656998,19446,99499,26757,0.15402040299074896,0.5791182390753847
4567,0.4568,14,10,14,657008,19436,99513,26743,0.1539411988341148,0.5791160484202776
4568,0.4569,13,14,13,657022,19422,99526,26730,0.15383031301482702,0.5791731669266771
4569,0.457,12,15,12,657037,19407,99538,26718,0.1537115067798758,0.5792520325203252
4570,0.4571,7,16,7,657053,19391,99545,26711,0.1535847801292612,0.579389180512776
4571,0.4572,7,13,7,657066,19378,99552,26704,0.1534818147256368,0.5794887374679918
4572,0.4573,13,11,13,657077,19367,99565,26691,0.15339469015333926,0.5795084458725954
4573,0.4574,9,18,9,657095,19349,99574,26682,0.1532521226713978,0.5796528426495188
4574,0.4575,9,11,9,657106,19338,99583,26673,0.15316499809910025,0.5797091999739192
4575,0.4576,11,19,11,657125,19319,99594,26662,0.15301451020149537,0.5798481981688088
4576,0.4577,11,9,11,657134,19310,99605,26651,0.15294322646052466,0.5798611866582537
4577,0.4578,8,11,8,657145,19299,99613,26643,0.1528561018882271,0.5799268643071699
4578,0.4579,15,9,15,657154,19290,99628,26628,0.15278481814725636,0.5799033058931138
4579,0.458,9,18,9,657172,19272,99637,26619,0.15264225066531492,0.5800483754984638
4580,0.4581,10,15,10,657187,19257,99647,26609,0.1525234444303637,0.5801465137574674
4581,0.4582,11,19,11,657206,19238,99658,26598,0.15237295653275884,0.5802862378916136
4582,0.4583,6,21,6,657227,19217,99664,26592,0.15220662780382715,0.5804972821934554
4583,0.4584,17,12,17,657239,19205,99681,26575,0.15211158281586618,0.5804936653560506
4584,0.4585,4,16,4,657255,19189,99685,26571,0.15198485616525156,0.5806599650349651
4585,0.4586,15,11,15,657266,19178,99700,26556,0.151897731592954,0.5806620894739144
4586,0.4587,9,6,9,657272,19172,99709,26547,0.1518502090989735,0.5806557448763097
4587,0.4588,11,16,11,657288,19156,99720,26536,0.1517234824483589,0.5807581195832968
4588,0.4589,16,9,16,657297,19147,99736,26520,0.15165219870738816,0.5807256881336632
4589,0.459,11,21,11,657318,19126,99747,26509,0.15148586997845648,0.5808918593185055
4590,0.4591,11,19,11,657337,19107,99758,26498,0.1513353820808516,0.5810327814932573
4591,0.4592,5,16,5,657353,19091,99763,26493,0.15120865543023698,0.5811907686907687
4592,0.4593,10,11,10,657364,19080,99773,26483,0.15112153085793942,0.581239163356232
4593,0.4594,8,14,8,657378,19066,99781,26475,0.15101064503865164,0.5813442831734041
4594,0.4595,9,13,9,657391,19053,99790,26466,0.15090767963502724,0.5814275357543004
4595,0.4596,11,11,11,657402,19042,99801,26455,0.1508205550627297,0.5814669099061477
4596,0.4597,8,13,8,657415,19029,99809,26447,0.1507175896591053,0.5815595039141526
4597,0.4598,10,20,10,657435,19009,99819,26437,0.15055918134583704,0.5817233639924306
4598,0.4599,12,15,12,657450,18994,99831,26425,0.15044037511088582,0.5818049714877034
4599,0.46,11,9,11,657459,18985,99842,26414,0.15036909136991508,0.5818189827969779
4600,0.4601,7,9,7,657468,18976,99849,26407,0.15029780762894437,0.5818698631646211
4601,0.4602,13,14,13,657482,18962,99862,26394,0.15018692180965657,0.5819296234235823
4602,0.4603,9,15,9,657497,18947,99871,26385,0.15006811557470537,0.5820391776228713
4603,0.4604,12,20,12,657517,18927,99883,26373,0.14990970726143707,0.5821854304635762
4604,0.4605,15,11,15,657528,18916,99898,26358,0.14982258268913953,0.582188452533463
4605,0.4606,16,10,16,657538,18906,99914,26342,0.14974337853250538,0.5821693776520509
4606,0.4607,13,15,13,657553,18891,99927,26329,0.1496245722975542,0.5822423706324635
4607,0.4608,10,15,10,657568,18876,99937,26319,0.14950576606260296,0.5823431795552605
4608,0.4609,9,17,9,657585,18859,99946,26310,0.14937111899632494,0.582479133919281
4609,0.461,12,11,12,657596,18848,99958,26298,0.14928399442402737,0.5825100784122624
4610,0.4611,11,9,11,657605,18839,99969,26287,0.14921271068305664,0.582524486991978
4611,0.4612,13,25,13,657630,18814,99982,26274,0.1490147002914713,0.5827271114265437
4612,0.4613,10,19,10,657649,18795,99992,26264,0.14886421239386644,0.5828802237066957
4613,0.4614,5,10,5,657659,18785,99997,26259,0.14878500823723229,0.5829633247491341
4614,0.4615,6,9,6,657668,18776,100003,26253,0.14871372449626155,0.5830242732461303
4615,0.4616,10,13,10,657681,18763,100013,26243,0.14861075909263718,0.5831000311069635
4616,0.4617,10,18,10,657699,18745,100023,26233,0.14846819161069572,0.5832406954511095
4617,0.4618,7,19,7,657718,18726,100030,26226,0.14831770371309086,0.5834223171382809
4618,0.4619,10,17,10,657735,18709,100040,26216,0.14818305664681283,0.5835503617139677
4619,0.462,11,15,11,657750,18694,100051,26205,0.1480642504118616,0.5836432882692265
4620,0.4621,14,12,14,657762,18682,100065,26191,0.14796920542390066,0.5836694671628819
4621,0.4622,11,16,11,657778,18666,100076,26180,0.14784247877328602,0.5837755875663382
4622,0.4623,12,9,12,657787,18657,100088,26168,0.14777119503231528,0.5837813720022309
4623,0.4624,8,8,8,657795,18649,100096,26160,0.147707831707008,0.5838112879109107
4624,0.4625,10,14,10,657809,18635,100106,26150,0.14759694588772018,0.5839008596628336
4625,0.4626,9,20,9,657829,18615,100115,26141,0.1474385375744519,0.5840781124318527
4626,0.4627,7,12,7,657841,18603,100122,26134,0.14734349258649093,0.5841697029304602
4627,0.4628,12,16,12,657857,18587,100134,26122,0.14721676593587632,0.5842671497908698
4628,0.4629,11,16,11,657873,18571,100145,26111,0.14709003928526168,0.5843740208585113
4629,0.463,10,13,10,657886,18558,100155,26101,0.14698707388163731,0.5844510624958015
4630,0.4631,13,13,13,657899,18545,100168,26088,0.14688410847801292,0.5845002576568906
4631,0.4632,16,11,16,657910,18534,100184,26072,0.14679698390571538,0.5844953593686948
4632,0.4633,12,14,12,657924,18520,100196,26060,0.14668609808642757,0.5845670704351728
4633,0.4634,16,16,16,657940,18504,100212,26044,0.14655937143581296,0.5846278171859567
4634,0.4635,4,13,4,657953,18491,100216,26040,0.14645640603218857,0.5847611776066112
4635,0.4636,11,10,11,657963,18481,100227,26029,0.14637720187555442,0.584789934846102
4636,0.4637,9,8,9,657971,18473,100236,26020,0.14631383855024713,0.5848110938799361
4637,0.4638,12,13,12,657984,18460,100248,26008,0.14621087314662273,0.5848700188899884
4638,0.4639,16,20,16,658004,18440,100264,25992,0.14605246483335446,0.5849837954627296
4639,0.464,11,12,11,658016,18428,100275,25981,0.14595741984539348,0.5850390686572542
4640,0.4641,4,8,4,658024,18420,100279,25977,0.14589405652008616,0.5851071018312048
4641,0.4642,16,8,16,658032,18412,100295,25961,0.14583069319477887,0.5850629887544228
4642,0.4643,12,13,12,658045,18399,100307,25949,0.14572772779115448,0.5851222152069991
4643,0.4644,12,14,12,658059,18385,100319,25937,0.1456168419718667,0.5851947114299896
4644,0.4645,9,12,9,658071,18373,100328,25928,0.14552179698390572,0.5852689555540507
4645,0.4646,12,11,12,658082,18362,100340,25916,0.14543467241160815,0.585301955824563
4646,0.4647,10,12,10,658094,18350,100350,25906,0.1453396274236472,0.5853669558929863
4647,0.4648,17,14,17,658108,18336,100367,25889,0.1452287416043594,0.5853928773318259
4648,0.4649,14,15,14,658123,18321,100381,25875,0.1451099353694082,0.5854602226445832
4649,0.465,16,16,16,658139,18305,100397,25859,0.14498320871879355,0.5855221447332669
4650,0.4651,12,17,12,658156,18288,100409,25847,0.14484856165251553,0.5856349835731279
4651,0.4652,11,14,11,658170,18274,100420,25836,0.14473767583322772,0.585717524370891
4652,0.4653,9,16,9,658186,18258,100429,25827,0.1446109491826131,0.5858455256890098
4653,0.4654,8,16,8,658202,18242,100437,25819,0.14448422253199847,0.5859830689271691
4654,0.4655,6,14,6,658216,18228,100443,25813,0.1443733367127107,0.5861129402147999
4655,0.4656,12,11,12,658227,18217,100455,25801,0.14428621214041312,0.5861465764005634
4656,0.4657,6,14,6,658241,18203,100461,25795,0.14417532632112534,0.5862766489385881
4657,0.4658,12,12,12,658253,18191,100473,25783,0.14408028133316436,0.5863237367535362
4658,0.4659,9,13,9,658266,18178,100482,25774,0.14397731592954,0.586412449945395
4659,0.466,11,11,11,658277,18167,100493,25763,0.14389019135724243,0.5864557250170727
4660,0.4661,7,14,7,658291,18153,100500,25756,0.14377930553795462,0.586576783802865
4661,0.4662,6,14,6,658305,18139,100506,25750,0.14366841971866684,0.586707375424366
4662,0.4663,12,15,12,658320,18124,100518,25738,0.14354961348371562,0.5867949477907984
4663,0.4664,8,12,8,658332,18112,100526,25730,0.14345456849575466,0.5868801605766161
4664,0.4665,9,18,9,658350,18094,100535,25721,0.1433120010138132,0.5870364030583134
4665,0.4666,17,15,17,658365,18079,100552,25704,0.143193194778862,0.587077176072905
4666,0.4667,15,12,15,658377,18067,100567,25689,0.14309814979090102,0.5870966267483316
4667,0.4668,12,17,12,658394,18050,100579,25677,0.142963502724623,0.5872115626500789
4668,0.4669,14,18,14,658412,18032,100593,25663,0.14282093524268152,0.5873212037990617
4669,0.467,11,10,11,658422,18022,100604,25652,0.1427417310860474,0.5873517424554655
4670,0.4671,8,14,8,658436,18008,100612,25644,0.1426308452667596,0.587464491890406
4671,0.4672,6,16,6,658452,17992,100618,25638,0.14250411861614498,0.5876231950492781
4672,0.4673,14,18,14,658470,17974,100632,25624,0.1423615511342035,0.5877333822652415
4673,0.4674,15,20,15,658490,17954,100647,25609,0.14220314282093524,0.587861258407364
4674,0.4675,8,10,8,658500,17944,100655,25601,0.1421239386643011,0.587920541968079
4675,0.4676,15,17,15,658517,17927,100670,25586,0.14198929159802307,0.588008181463011
4676,0.4677,18,14,18,658531,17913,100688,25568,0.14187840577873526,0.588026954301879
4677,0.4678,11,12,11,658543,17901,100699,25557,0.1417833607907743,0.5880850476321966
4678,0.4679,11,17,11,658560,17884,100710,25546,0.14164871372449625,0.5882109141146673
4679,0.468,11,17,11,658577,17867,100721,25535,0.14151406665821822,0.5883369429980185
4680,0.4681,4,13,4,658590,17854,100725,25531,0.14141110125459383,0.5884752794744728
4681,0.4682,8,18,8,658608,17836,100733,25523,0.1412685337726524,0.5886436495306626
4682,0.4683,10,11,10,658619,17825,100743,25513,0.14118140920035482,0.5886981402002861
4683,0.4684,15,14,15,658633,17811,100758,25498,0.14107052338106704,0.5887459881317971
4684,0.4685,11,14,11,658647,17797,100769,25487,0.14095963756177923,0.5888319009333703
4685,0.4686,11,9,11,658656,17788,100780,25476,0.14088835382080853,0.5888498520710059
4686,0.4687,11,12,11,658668,17776,100791,25465,0.14079330883284755,0.5889086746374969
4687,0.4688,7,12,7,658680,17764,100798,25458,0.14069826384488657,0.589005599000509
4688,0.4689,15,12,15,658692,17752,100813,25443,0.14060321885692562,0.5890265076976502
4689,0.469,11,15,11,658707,17737,100824,25432,0.1404844126219744,0.5891264564849776
4690,0.4691,15,13,15,658720,17724,100839,25417,0.14038144721835003,0.5891611228297907
4691,0.4692,12,9,12,658729,17715,100851,25405,0.1403101634773793,0.5891697588126159
4692,0.4693,10,14,10,658743,17701,100861,25395,0.1401992776580915,0.5892658251345833
4693,0.4694,16,8,16,658751,17693,100877,25379,0.1401359143327842,0.5892226968796433
4694,0.4695,4,16,4,658767,17677,100881,25375,0.14000918768216955,0.5894035120319614
4695,0.4696,16,12,16,658779,17665,100897,25359,0.1399141426942086,0.5894152101152845
4696,0.4697,11,15,11,658794,17650,100908,25348,0.13979533645925737,0.5895157914321596
4697,0.4698,8,10,8,658804,17640,100916,25340,0.13971613230262325,0.5895765472312704
4698,0.4699,19,21,19,658825,17619,100935,25321,0.13954980357369154,0.589683278993945
4699,0.47,10,15,10,658840,17604,100945,25311,0.13943099733874034,0.5897937783991611
4700,0.4701,9,11,9,658851,17593,100954,25302,0.13934387276644278,0.5898589579205036
4701,0.4702,8,13,8,658864,17580,100962,25294,0.1392409073628184,0.5899612818957877
4702,0.4703,11,11,11,658875,17569,100973,25283,0.13915378279052085,0.5900074675627742
4703,0.4704,6,17,6,658892,17552,100979,25277,0.13901913572424282,0.5901842209717715
4704,0.4705,11,20,11,658912,17532,100990,25266,0.13886072741097452,0.5903546894714706
4705,0.4706,5,15,5,658927,17517,100995,25261,0.13874192117602333,0.5905138155126467
4706,0.4707,12,9,12,658936,17508,101007,25249,0.1386706374350526,0.5905231891853966
4707,0.4708,12,18,12,658954,17490,101019,25237,0.13852806995311115,0.5906569616401807
4708,0.4709,8,14,8,658968,17476,101027,25229,0.13841718413382334,0.5907739140615853
4709,0.471,8,11,8,658979,17465,101035,25221,0.13833005956152578,0.5908494588389636
4710,0.4711,11,10,11,658989,17455,101046,25210,0.13825085540489165,0.590882456345951
4711,0.4712,12,16,12,659005,17439,101058,25198,0.13812412875427701,0.5909890470717921
4712,0.4713,13,9,13,659014,17430,101071,25185,0.1380528450133063,0.5909890883491729
4713,0.4714,13,14,13,659028,17416,101084,25172,0.1379419591940185,0.5910585141354372
4714,0.4715,13,16,13,659044,17400,101097,25159,0.1378152325434039,0.5911558072323128
4715,0.4716,7,8,7,659052,17392,101104,25152,0.13775186921809657,0.5911996991350131
4716,0.4717,16,13,16,659065,17379,101120,25136,0.13764890381447217,0.5912266258967424
4717,0.4718,18,14,18,659079,17365,101138,25118,0.1375380179951844,0.591248264011487
4718,0.4719,17,9,17,659088,17356,101155,25101,0.13746673425421366,0.591209930046871
4719,0.472,8,15,8,659103,17341,101163,25093,0.13734792801926246,0.5913418485176981
4720,0.4721,10,7,10,659110,17334,101173,25083,0.13729248510961856,0.5913430935709739
4721,0.4722,11,8,11,659118,17326,101184,25072,0.13722912178431124,0.5913486485211567
4722,0.4723,5,9,5,659127,17317,101189,25067,0.1371578380433405,0.5914260098150246
4723,0.4724,7,16,7,659143,17301,101196,25060,0.1370311113927259,0.5915818795590283
4724,0.4725,13,7,13,659150,17294,101209,25047,0.13697566848308199,0.5915542854443684
4725,0.4726,11,9,11,659159,17285,101220,25036,0.13690438474211128,0.5915739231114576
4726,0.4727,12,14,12,659173,17271,101232,25024,0.13679349892282347,0.591653859794302
4727,0.4728,7,19,7,659192,17252,101239,25017,0.1366430110252186,0.5918521848162956
4728,0.4729,10,8,10,659200,17244,101249,25007,0.1365796476999113,0.5918676481030035
4729,0.473,8,13,8,659213,17231,101257,24999,0.1364766822962869,0.5919725313757992
4730,0.4731,17,18,17,659231,17213,101274,24982,0.13633411481434546,0.59206067069558
4731,0.4732,10,13,10,659244,17200,101284,24972,0.13623114941072106,0.5921464478801101
4732,0.4733,15,9,15,659253,17191,101299,24957,0.13615986566975036,0.5921277403435513
4733,0.4734,15,10,15,659263,17181,101314,24942,0.1360806615131162,0.5921230681575387
4734,0.4735,11,10,11,659273,17171,101325,24931,0.13600145735648206,0.5921571421785188
4735,0.4736,16,15,16,659288,17156,101341,24915,0.13588265112153086,0.592213163461767
4736,0.4737,10,14,10,659302,17142,101351,24905,0.13577176530224305,0.5923133636169049
4737,0.4738,11,13,11,659315,17129,101362,24894,0.13566879989861869,0.5923898817314328
4738,0.4739,12,11,12,659326,17118,101374,24882,0.13558167532632112,0.5924285714285714
4739,0.474,10,14,10,659340,17104,101384,24872,0.13547078950703334,0.5925290642271774
4740,0.4741,14,14,14,659354,17090,101398,24858,0.13535990368774553,0.5925908267378659
4741,0.4742,9,10,9,659364,17080,101407,24849,0.13528069953111138,0.5926447089126857
4742,0.4743,10,10,10,659374,17070,101417,24839,0.13520149537447726,0.5926889212341024
4743,0.4744,7,15,7,659389,17055,101424,24832,0.13508268913952604,0.5928330985747368
4744,0.4745,6,11,6,659400,17044,101430,24826,0.1349955645672285,0.5929304991640792
4745,0.4746,9,16,9,659416,17028,101439,24817,0.13486883791661386,0.5930696618472936
4746,0.4747,9,12,9,659428,17016,101448,24808,0.1347737929286529,0.5931522570772763
4747,0.4748,6,10,6,659438,17006,101454,24802,0.13469458877201876,0.5932357443551474
4748,0.4749,12,15,12,659453,16991,101466,24790,0.13457578253706753,0.5933318972738805
4749,0.475,7,12,7,659465,16979,101473,24783,0.13448073754910658,0.5934342224989224
4750,0.4751,11,14,11,659479,16965,101484,24772,0.13436985172981877,0.5935261278961114
4751,0.4752,12,16,12,659495,16949,101496,24760,0.13424312507920416,0.5936368649452156
4752,0.4753,7,13,7,659508,16936,101503,24753,0.13414015967557977,0.5937537479910768
4753,0.4754,7,7,7,659515,16929,101510,24746,0.13408471676593586,0.5937852429514097
4754,0.4755,7,6,7,659521,16923,101517,24739,0.1340371942719554,0.5938025058806586
4755,0.4756,5,16,5,659537,16907,101522,24734,0.13391046762134076,0.5939818928459931
4756,0.4757,14,8,14,659545,16899,101536,24720,0.13384710429603344,0.5939594896561666
4757,0.4758,9,15,9,659560,16884,101545,24711,0.13372829806108225,0.5940858276235125
4758,0.4759,21,8,21,659568,16876,101566,24690,0.13366493473577493,0.5939950921426166
4759,0.476,10,12,10,659580,16864,101576,24680,0.13356988974781397,0.5940689389562873
4760,0.4761,15,13,15,659593,16851,101591,24665,0.13346692434418958,0.5941082955968783
4761,0.4762,11,19,11,659612,16832,101602,24654,0.13331643644658472,0.5942727667164827
4762,0.4763,9,11,9,659623,16821,101611,24645,0.13322931187428716,0.5943423527709448
4763,0.4764,7,17,7,659640,16804,101618,24638,0.13309466480800913,0.5945176391100816
4764,0.4765,4,14,4,659654,16790,101622,24634,0.13298377898872132,0.5946794129007339
4765,0.4766,8,7,8,659661,16783,101630,24626,0.13292833607907742,0.5947016349102852
4766,0.4767,10,16,10,659677,16767,101640,24616,0.1328016094284628,0.594833627334896
4767,0.4768,14,15,14,659692,16752,101654,24602,0.13268280319351158,0.5949122213087005
4768,0.4769,11,11,11,659703,16741,101665,24591,0.13259567862121405,0.594962740733572
4769,0.477,9,11,9,659714,16730,101674,24582,0.13250855404891648,0.5950329202168861
4770,0.4771,19,12,19,659726,16718,101693,24563,0.13241350906095553,0.5950195004965965
4771,0.4772,10,8,10,659734,16710,101703,24553,0.1323501457356482,0.5950367157017182
4772,0.4773,11,13,11,659747,16697,101714,24542,0.13224718033202382,0.5951162734304906
4773,0.4774,12,15,12,659762,16682,101726,24530,0.13212837409707262,0.5952149859264292
4774,0.4775,8,10,8,659772,16672,101734,24522,0.13204916994043847,0.5952808661455552
4775,0.4776,6,13,6,659785,16659,101740,24516,0.1319462045368141,0.5954098360655737
4776,0.4777,10,15,10,659800,16644,101750,24506,0.13182739830186288,0.5955285540704739
4777,0.4778,11,9,11,659809,16635,101761,24495,0.13175611456089215,0.5955506929248724
4778,0.4779,6,11,6,659820,16624,101767,24489,0.1316689899885946,0.5956510106292413
4779,0.478,13,10,13,659830,16614,101780,24476,0.13158978583196046,0.5956680457532246
4780,0.4781,7,11,7,659841,16603,101787,24469,0.1315026612596629,0.5957586677054928
4781,0.4782,9,11,9,659852,16592,101796,24460,0.13141553668736536,0.5958296794309657
4782,0.4783,10,8,10,659860,16584,101806,24450,0.13135217336205804,0.5958473461032314
4783,0.4784,13,14,13,659874,16570,101819,24437,0.13124128754277026,0.595922647352891
4784,0.4785,6,14,6,659888,16556,101825,24431,0.13113040172348245,0.5960670456486203
4785,0.4786,14,10,14,659898,16546,101839,24417,0.1310511975668483,0.5960745062617484
4786,0.4787,13,14,13,659912,16532,101852,24404,0.13094031174756052,0.5961500879421536
4787,0.4788,11,15,11,659927,16517,101863,24393,0.1308215055126093,0.5962600831092643
4788,0.4789,10,14,10,659941,16503,101873,24383,0.1307106196933215,0.5963655040845277
4789,0.479,9,13,9,659954,16490,101882,24374,0.13060765428969712,0.596466327329679
4790,0.4791,9,6,9,659960,16484,101891,24365,0.13056013179571663,0.5964650297436902
4791,0.4792,9,8,9,659968,16476,101900,24356,0.13049676847040934,0.596492946708464
4792,0.4793,9,14,9,659982,16462,101909,24347,0.13038588265112153,0.596608591242128
4793,0.4794,14,13,14,659995,16449,101923,24333,0.13028291724749716,0.5966602913049875
4794,0.4795,14,19,14,660014,16430,101937,24319,0.13013242934989228,0.5967999214704656
4795,0.4796,10,14,10,660028,16416,101947,24309,0.1300215435306045,0.5969060773480663
4796,0.4797,13,9,13,660037,16407,101960,24296,0.12995025978963376,0.5969093187234357
4797,0.4798,7,14,7,660051,16393,101967,24289,0.12983937397034595,0.5970453763335136
4798,0.4799,9,13,9,660064,16380,101976,24280,0.12973640856672158,0.5971470732907034
4799,0.48,8,10,8,660074,16370,101984,24272,0.12965720441008743,0.5972147040007874
4800,0.4801,9,10,9,660084,16360,101993,24263,0.1295780002534533,0.5972724811067622
4801,0.4802,11,12,11,660096,16348,102004,24252,0.12948295526549233,0.5973399014778326
4802,0.4803,12,14,12,660110,16334,102016,24240,0.12937206944620452,0.5974269236456844
4803,0.4804,6,13,6,660123,16321,102022,24234,0.12926910404258016,0.5975588706694612
4804,0.4805,7,14,7,660137,16307,102029,24227,0.12915821822329235,0.5976957615828687
4805,0.4806,14,14,14,660151,16293,102043,24213,0.12904733240400457,0.5977632943267664
4806,0.4807,12,21,12,660172,16272,102055,24201,0.12888100367507288,0.5979541916833444
4807,0.4808,8,9,8,660181,16263,102063,24193,0.12880971993410215,0.5980077120822622
4808,0.4809,8,12,8,660193,16251,102071,24185,0.12871467494614117,0.5981056484320902
4809,0.481,12,12,12,660205,16239,102083,24173,0.12861962995818021,0.5981639117093932
4810,0.4811,6,16,6,660221,16223,102089,24167,0.12849290330756558,0.5983411735578114
4811,0.4812,6,16,6,660237,16207,102095,24161,0.12836617665695096,0.5985186286167261
4812,0.4813,8,9,8,660246,16198,102103,24153,0.12829489291598023,0.5985725260836162
4813,0.4814,10,9,10,660255,16189,102113,24143,0.1282236091750095,0.5986065655062978
4814,0.4815,12,11,12,660266,16178,102125,24131,0.12813648460271196,0.598650425463296
4815,0.4816,5,7,5,660273,16171,102130,24126,0.12808104169306805,0.5987046182097923
4816,0.4817,8,16,8,660289,16155,102138,24118,0.12795431504245341,0.5988627616517269
4817,0.4818,8,16,8,660305,16139,102146,24110,0.1278275883918388,0.5990210936917687
4818,0.4819,19,13,19,660318,16126,102165,24091,0.1277246229882144,0.5990252878136112
4819,0.482,8,7,8,660325,16119,102173,24083,0.12766918007857053,0.5990497985174867
4820,0.4821,9,16,9,660341,16103,102182,24074,0.1275424534279559,0.5991985464320382
4821,0.4822,3,13,3,660354,16090,102185,24071,0.12743948802433153,0.5993625656731655
4822,0.4823,11,13,11,660367,16077,102196,24060,0.12733652262070713,0.5994468943867255
4823,0.4824,8,14,8,660381,16063,102204,24052,0.12722563680141935,0.59957621837218
4824,0.4825,6,16,6,660397,16047,102210,24046,0.1270989101508047,0.5997555683036939
4825,0.4826,5,13,5,660410,16034,102215,24041,0.12699594474718034,0.5999001871490954
4826,0.4827,8,11,8,660421,16023,102223,24033,0.12690882017488278,0.5999850209706411
4827,0.4828,6,10,6,660431,16013,102229,24027,0.12682961601824863,0.6000749250749251
4828,0.4829,11,5,11,660436,16008,102240,24016,0.12679001393993156,0.6000399760143914
4829,0.483,10,8,10,660444,16000,102250,24006,0.12672665061462426,0.6000599910013498
4830,0.4831,10,13,10,660457,15987,102260,23996,0.12662368521099987,0.6001550659030088
4831,0.4832,9,13,9,660470,15974,102269,23987,0.1265207198073755,0.6002602537474038
4832,0.4833,9,8,9,660478,15966,102278,23978,0.12645735648206818,0.6002904065691969
4833,0.4834,17,7,17,660485,15959,102295,23961,0.12640191357242428,0.6002254509018036
4834,0.4835,8,14,8,660499,15945,102303,23953,0.1262910277531365,0.6003559075642889
4835,0.4836,10,15,10,660514,15930,102313,23943,0.12617222151818527,0.6004815288541118
4836,0.4837,15,14,15,660528,15916,102328,23928,0.12606133569889746,0.6005421142455577
4837,0.4838,8,15,8,660543,15901,102336,23920,0.12594252946394627,0.6006880791542151
4838,0.4839,13,11,13,660554,15890,102349,23907,0.1258554048916487,0.6007236726386411
4839,0.484,11,8,11,660562,15882,102360,23896,0.1257920415663414,0.6007340741113179
4840,0.4841,11,12,11,660574,15870,102371,23885,0.12569699657838043,0.6008049301974594
4841,0.4842,13,19,13,660593,15851,102384,23872,0.12554650868077558,0.600961659491982
4842,0.4843,13,16,13,660609,15835,102397,23859,0.12541978203016094,0.6010732100569356
4843,0.4844,13,15,13,660624,15820,102410,23846,0.12530097579520974,0.6011697675591187
4844,0.4845,15,17,15,660641,15803,102425,23831,0.1251663287289317,0.6012766816369783
4845,0.4846,5,6,5,660647,15797,102430,23826,0.1251188062349512,0.6013174166519446
4846,0.4847,11,11,11,660658,15786,102441,23815,0.12503168166265366,0.6013737026842757
4847,0.4848,6,14,6,660672,15772,102447,23809,0.12492079584336586,0.6015259846896238
4848,0.4849,5,18,5,660690,15754,102452,23804,0.12477822836142441,0.6017493300975782
4849,0.485,6,17,6,660707,15737,102458,23798,0.12464358129514637,0.6019476413304666
4850,0.4851,10,16,10,660723,15721,102468,23788,0.12451685464453174,0.6020906628869371
4851,0.4852,6,9,6,660732,15712,102474,23782,0.12444557090356102,0.6021674178356206
4852,0.4853,11,11,11,660743,15701,102485,23771,0.12435844633126346,0.6022243615727605
4853,0.4854,14,13,14,660756,15688,102499,23757,0.12425548092763908,0.6022816580048168
4854,0.4855,7,7,7,660763,15681,102506,23750,0.12420003801799519,0.6023179731683194
4855,0.4856,5,16,5,660779,15665,102511,23745,0.12407331136738056,0.6025120527784826
4856,0.4857,8,12,8,660791,15653,102519,23737,0.1239782663794196,0.6026148768723026
4857,0.4858,6,14,6,660805,15639,102525,23731,0.1238673805601318,0.6027686055372111
4858,0.4859,8,12,8,660817,15627,102533,23723,0.12377233557217082,0.6028716645489199
4859,0.486,13,15,13,660832,15612,102546,23710,0.12365352933721961,0.6029703473882305
4860,0.4861,12,18,12,660850,15594,102558,23698,0.12351096185527817,0.6031253181309172
4861,0.4862,10,11,10,660861,15583,102568,23688,0.1234238372829806,0.6031931959970461
4862,0.4863,3,13,3,660874,15570,102571,23685,0.12332087187935623,0.6033626289644631
4863,0.4864,7,8,7,660882,15562,102578,23678,0.12325750855404892,0.603414882772681
4864,0.4865,10,17,10,660899,15545,102588,23668,0.12312286148777088,0.6035753449111264
4865,0.4866,8,20,8,660919,15525,102596,23660,0.1229644531745026,0.6038024754370295
4866,0.4867,13,8,13,660927,15517,102609,23647,0.12290108984919529,0.6037943008885711
4867,0.4868,9,9,9,660936,15508,102618,23638,0.12282980610822455,0.6038420272824809
4868,0.4869,10,7,10,660943,15501,102628,23628,0.12277436319858066,0.6038488077896189
4869,0.487,12,23,12,660966,15478,102640,23616,0.12259219363832213,0.6040824678978871
4870,0.4871,6,9,6,660975,15469,102646,23610,0.12252090989735141,0.6041608024770337
4871,0.4872,8,8,8,660983,15461,102654,23602,0.12245754657204411,0.6042034661956327
4872,0.4873,15,12,15,660995,15449,102669,23587,0.12236250158408313,0.6042371144584486
4873,0.4874,11,12,11,661007,15437,102680,23576,0.12226745659612216,0.6043113833850255
4874,0.4875,7,9,7,661016,15428,102687,23569,0.12219617285515144,0.6043798240890325
4875,0.4876,7,12,7,661028,15416,102694,23562,0.12210112786719048,0.6044948432449074
4876,0.4877,15,11,15,661039,15405,102709,23547,0.12201400329489291,0.604513247073321
4877,0.4878,10,13,10,661052,15392,102719,23537,0.12191103789126853,0.6046135271905263
4878,0.4879,9,13,9,661065,15379,102728,23528,0.12180807248764415,0.6047240856401161
4879,0.488,12,12,12,661077,15367,102740,23516,0.12171302749968319,0.6047887251498084
4880,0.4881,13,13,13,661090,15354,102753,23503,0.1216100620960588,0.6048588413927992
4881,0.4882,3,10,3,661100,15344,102756,23500,0.12153085793942466,0.6049840387189784
4882,0.4883,8,18,8,661118,15326,102764,23492,0.12138829045748321,0.6051831624504096
4883,0.4884,9,10,9,661128,15316,102773,23483,0.12130908630084906,0.6052475579267507
4884,0.4885,10,10,10,661138,15306,102783,23473,0.12122988214421493,0.6053018386239976
4885,0.4886,12,10,12,661148,15296,102795,23461,0.1211506779875808,0.6053358103052352
4886,0.4887,11,14,11,661162,15282,102806,23450,0.121039792168293,0.6054425281421048
4887,0.4888,7,12,7,661174,15270,102813,23443,0.12094474718033202,0.6055588561981763
4888,0.4889,7,12,7,661186,15258,102820,23436,0.12084970219237105,0.6056752984958909
4889,0.489,10,14,10,661200,15244,102830,23426,0.12073881637308326,0.6057926040858547
4890,0.4891,10,11,10,661211,15233,102840,23416,0.12065169180078571,0.6058630236228622
4891,0.4892,11,10,11,661221,15223,102851,23405,0.12057248764415157,0.6059076317697007
4892,0.4893,10,13,10,661234,15210,102861,23395,0.12046952224052718,0.6060095842507447
4893,0.4894,14,15,14,661249,15195,102875,23381,0.12035071600557597,0.60610223973455
4894,0.4895,9,8,9,661257,15187,102884,23372,0.12028735268026866,0.6061360512461422
4895,0.4896,8,12,8,661269,15175,102892,23364,0.1201923076923077,0.6062430265445393
4896,0.4897,20,15,20,661284,15160,102912,23344,0.12007350145735649,0.6062746727612716
4897,0.4898,11,7,11,661291,15153,102923,23333,0.12001805854771258,0.6062724107467651
4898,0.4899,15,7,15,661298,15146,102938,23318,0.11996261563806869,0.6062292013311148
4899,0.49,3,16,3,661314,15130,102941,23315,0.11983588898745406,0.606450773832748
4900,0.4901,7,12,7,661326,15118,102948,23308,0.1197408439994931,0.6065684692656014
4901,0.4902,13,7,13,661333,15111,102961,23295,0.1196854010898492,0.6065458522105921
4902,0.4903,11,11,11,661344,15100,102972,23284,0.11959827651755164,0.6066069195498124
4903,0.4904,14,9,14,661353,15091,102986,23270,0.11952699277658091,0.6066056672140977
4904,0.4905,5,10,5,661363,15081,102991,23265,0.11944778861994677,0.6067125645438899
4905,0.4906,9,8,9,661371,15073,103000,23256,0.11938442529463947,0.6067468496438728
4906,0.4907,9,11,9,661382,15062,103009,23247,0.1192973007223419,0.6068286825550132
4907,0.4908,6,12,6,661394,15050,103015,23241,0.11920225573438094,0.6069572484395811
4908,0.4909,7,7,7,661401,15043,103022,23234,0.11914681282473705,0.6069963685764297
4909,0.491,12,11,12,661412,15032,103034,23222,0.11905968825243948,0.607047629006117
4910,0.4911,6,10,6,661422,15022,103040,23216,0.11898048409580535,0.6071447251425284
4911,0.4912,11,15,11,661437,15007,103051,23205,0.11886167786085414,0.6072699675494609
4912,0.4913,10,8,10,661445,14999,103061,23195,0.11879831453554683,0.6072943394250406
4913,0.4914,12,10,12,661455,14989,103073,23183,0.11871911037891268,0.6073299800901184
4914,0.4915,9,10,9,661465,14979,103082,23174,0.11863990622227855,0.6073965350038005
4915,0.4916,10,17,10,661482,14962,103092,23164,0.1185052591560005,0.607564391753659
4916,0.4917,14,11,14,661493,14951,103106,23150,0.11841813458370296,0.6075956011653237
4917,0.4918,10,10,10,661503,14941,103116,23140,0.1183389304270688,0.6076521099761035
4918,0.4919,15,14,15,661517,14927,103131,23125,0.11822804460778101,0.6077210133501524
4919,0.492,11,7,11,661524,14920,103142,23114,0.11817260169813712,0.607719408949887
4920,0.4921,8,16,8,661540,14904,103150,23106,0.1180458750475225,0.6078926598263615
4921,0.4922,6,15,6,661555,14889,103156,23100,0.11792706881257128,0.6080707573244887
4922,0.4923,11,13,11,661568,14876,103167,23089,0.1178241034089469,0.6081654155142895
4923,0.4924,13,4,13,661572,14872,103180,23076,0.11779242174629324,0.6080952882892379
4924,0.4925,11,13,11,661585,14859,103191,23065,0.11768945634266886,0.6081900643392048
4925,0.4926,13,16,13,661601,14843,103204,23052,0.11756272969205424,0.6083124422747064
4926,0.4927,7,12,7,661613,14831,103211,23045,0.11746768470409327,0.608432780652656
4927,0.4928,11,17,11,661630,14814,103222,23034,0.11733303763781523,0.6085922637920101
4928,0.4929,6,11,6,661641,14803,103228,23028,0.11724591306551768,0.6087071449340488
4929,0.493,7,13,7,661654,14790,103235,23021,0.1171429476618933,0.6088439871994922
4930,0.4931,11,8,11,661662,14782,103246,23010,0.11707958433658598,0.6088590177815411
4931,0.4932,18,10,18,661672,14772,103264,22992,0.11700038017995185,0.6088338099777566
4932,0.4933,11,7,11,661679,14765,103275,22981,0.11694493727030794,0.6088327239972448
4933,0.4934,10,10,10,661689,14755,103285,22971,0.1168657331136738,0.6088904203997243
4934,0.4935,9,14,9,661703,14741,103294,22962,0.11675484729438601,0.6090231546561281
4935,0.4936,10,12,10,661715,14729,103304,22952,0.11665980230642505,0.6091133462487726
4936,0.4937,10,12,10,661727,14717,103314,22942,0.11656475731846408,0.6092036432194163
4937,0.4938,5,12,5,661739,14705,103319,22937,0.1164697123305031,0.6093459433611391
4938,0.4939,10,16,10,661755,14689,103329,22927,0.11634298567988847,0.6095012760527435
4939,0.494,5,11,5,661766,14678,103334,22922,0.11625586110759092,0.6096276595744681
4940,0.4941,14,10,14,661776,14668,103348,22908,0.11617665695095679,0.609644453906749
4941,0.4942,9,6,9,661782,14662,103357,22899,0.1161291344569763,0.6096483054231783
4942,0.4943,5,14,5,661796,14648,103362,22894,0.1160182486376885,0.6098236641628043
4943,0.4944,6,11,6,661807,14637,103368,22888,0.11593112406539095,0.6099400399733511
4944,0.4945,12,8,12,661815,14629,103380,22876,0.11586776074008363,0.6099453406212505
4945,0.4946,11,7,11,661822,14622,103391,22865,0.11581231783043974,0.6099447808573639
4946,0.4947,10,11,10,661833,14611,103401,22855,0.11572519325814219,0.6100197512411253
4947,0.4948,11,9,11,661842,14602,103412,22844,0.11565390951717146,0.6100518079367623
4948,0.4949,8,7,8,661849,14595,103420,22836,0.11559846660752757,0.6100825518954877
4949,0.495,9,16,9,661865,14579,103429,22827,0.11547173995691294,0.6102496925626905
4950,0.4951,7,8,7,661873,14571,103436,22820,0.11540837663160562,0.6103072931988981
4951,0.4952,12,10,12,661883,14561,103448,22808,0.11532917247497149,0.6103454735208328
4952,0.4953,7,13,7,661896,14548,103455,22801,0.1152262070713471,0.6104848858068489
4953,0.4954,10,9,10,661905,14539,103465,22791,0.11515492333037637,0.6105277256897937
4954,0.4955,5,8,5,661913,14531,103470,22786,0.11509156000506907,0.6106064260256719
4955,0.4956,7,9,7,661922,14522,103477,22779,0.11502027626409835,0.6106806788021769
4956,0.4957,15,12,15,661934,14510,103492,22764,0.11492523127613737,0.610720609540162
4957,0.4958,6,11,6,661945,14499,103498,22758,0.11483810670383982,0.6108382317416862
4958,0.4959,13,5,13,661950,14494,103511,22745,0.11479850462552275,0.610784392706571
4959,0.496,14,14,14,661964,14480,103525,22731,0.11468761880623494,0.6108677541587165
4960,0.4961,11,16,11,661980,14464,103536,22720,0.11456089215562033,0.6110154905335629
4961,0.4962,14,12,14,661992,14452,103550,22706,0.11446584716765935,0.6110662576026696
4962,0.4963,5,12,5,662004,14440,103555,22701,0.11437080217969839,0.6112113297972591
4963,0.4964,10,9,10,662013,14431,103565,22691,0.11429951843872767,0.6112547815311675
4964,0.4965,9,14,9,662027,14417,103574,22682,0.11418863261943987,0.6113911426183994
4965,0.4966,12,11,12,662038,14406,103586,22670,0.11410150804714231,0.6114467580105729
4966,0.4967,5,10,5,662048,14396,103591,22665,0.11402230389050817,0.6115593211192358
4967,0.4968,5,10,5,662058,14386,103596,22660,0.11394309973387404,0.6116719753819576
4968,0.4969,9,6,9,662064,14380,103605,22651,0.11389557723989355,0.6116767033026383
4969,0.497,10,16,10,662080,14364,103615,22641,0.11376885058927892,0.6118362383461694
4970,0.4971,12,14,12,662094,14350,103627,22629,0.11365796476999113,0.611941912977636
4971,0.4972,11,8,11,662102,14342,103638,22618,0.11359460144468382,0.6119588744588744
4972,0.4973,11,15,11,662117,14327,103649,22607,0.11347579520973261,0.612091839497482
4973,0.4974,8,21,8,662138,14306,103657,22599,0.11330946648080091,0.6123560493158109
4974,0.4975,9,10,9,662148,14296,103666,22590,0.11323026232416677,0.612427479260424
4975,0.4976,14,10,14,662158,14286,103680,22576,0.11315105816753263,0.6124464217893766
4976,0.4977,7,7,7,662165,14279,103687,22569,0.11309561525788873,0.6124891445940078
4977,0.4978,14,10,14,662175,14269,103701,22555,0.1130164111012546,0.612508146860743
4978,0.4979,11,15,11,662190,14254,103712,22544,0.11289760486630339,0.6126419914125768
4979,0.498,10,10,10,662200,14244,103722,22534,0.11281840070966924,0.6127032465060634
4980,0.4981,10,10,10,662210,14234,103732,22524,0.1127391965530351,0.6127645682572501
4981,0.4982,6,10,6,662220,14224,103738,22518,0.11265999239640097,0.612868107343095
4982,0.4983,10,13,10,662233,14211,103748,22508,0.11255702699277659,0.612979656308723
4983,0.4984,7,14,7,662247,14197,103755,22501,0.11244614117348878,0.613139680636547
4984,0.4985,14,6,14,662253,14191,103769,22487,0.1123986186795083,0.6130923169202247
4985,0.4986,6,11,6,662264,14180,103775,22481,0.11231149410721075,0.6132129510924416
4986,0.4987,13,5,13,662269,14175,103788,22468,0.11227189202889368,0.6131594028873182
4987,0.4988,6,13,6,662282,14162,103794,22462,0.1121689266252693,0.6133136740934906
4988,0.4989,13,20,13,662302,14142,103807,22449,0.11201051831200101,0.6135115192260392
4989,0.499,11,8,11,662310,14134,103818,22438,0.1119471549866937,0.6135294761019359
4990,0.4991,9,8,9,662318,14126,103827,22429,0.11188379166138639,0.6135685952674053
4991,0.4992,16,12,16,662330,14114,103843,22413,0.11178874667342542,0.6136008979658882
4992,0.4993,11,9,11,662339,14105,103854,22402,0.1117174629324547,0.6136357410907497
4993,0.4994,5,3,5,662342,14102,103859,22397,0.11169370168546446,0.6136332502260335
4994,0.4995,6,16,6,662358,14086,103865,22391,0.11156697503484983,0.6138388573621735
4995,0.4996,8,13,8,662371,14073,103873,22383,0.11146400963122545,0.613973008558262
4996,0.4997,10,16,10,662387,14057,103883,22373,0.11133728298061082,0.6141367005215482
4997,0.4998,10,9,10,662396,14048,103893,22363,0.11126599923964009,0.6141825272582462
4998,0.4999,9,15,9,662411,14033,103902,22354,0.11114719300468888,0.6143402863660098
4999,0.5,5,16,5,662427,14017,103907,22349,0.11102046635407427,0.6145575537590057
5000,0.5001,14,11,14,662438,14006,103921,22335,0.1109333417817767,0.6145950854406869
5001,0.5002,10,11,10,662449,13995,103931,22325,0.11084621720947915,0.6146751101321586
5002,0.5003,9,13,9,662462,13982,103940,22316,0.11074325180585477,0.6147997134828366
5003,0.5004,3,12,3,662474,13970,103943,22313,0.11064820681789381,0.6149711986329686
5004,0.5005,10,8,10,662482,13962,103953,22303,0.11058484349258649,0.6150006893699159
5005,0.5006,9,3,9,662485,13959,103962,22294,0.11056108224559624,0.6149560036410779
5006,0.5007,10,12,10,662497,13947,103972,22284,0.11046603725763528,0.6150534073031382
5007,0.5008,19,11,19,662508,13936,103991,22265,0.11037891268533773,0.6150382586116405
5008,0.5009,13,10,13,662518,13926,104004,22252,0.11029970852870359,0.6150699320028746
5009,0.501,6,9,6,662527,13917,104010,22246,0.11022842478773286,0.6151591405580289
5010,0.5011,9,3,9,662530,13914,104019,22237,0.11020466354074261,0.6151143813449144
5011,0.5012,9,8,9,662538,13906,104028,22228,0.1101413002154353,0.6151547019427686
5012,0.5013,6,8,6,662546,13898,104034,22222,0.110077936890128,0.6152270210409745
5013,0.5014,4,11,4,662557,13887,104038,22218,0.10999081231783044,0.615371832156211
5014,0.5015,5,11,5,662568,13876,104043,22213,0.10990368774553289,0.6155061098949819
5015,0.5016,13,9,13,662577,13867,104056,22200,0.10983240400456216,0.6155211134832396
5016,0.5017,5,9,5,662586,13858,104061,22195,0.10976112026359143,0.6156214462041993
5017,0.5018,7,13,7,662599,13845,104068,22188,0.10965815485996705,0.615768878528016
5018,0.5019,8,6,8,662605,13839,104076,22180,0.10961063236598657,0.6157861128848663
5019,0.502,7,8,7,662613,13831,104083,22173,0.10954726904067925,0.6158482390845461
5020,0.5021,7,12,7,662625,13819,104090,22166,0.10945222405271829,0.615978880088926
5021,0.5022,6,10,6,662635,13809,104096,22160,0.10937301989608415,0.6160860741193805
5022,0.5023,8,13,8,662648,13796,104104,22152,0.10927005449245976,0.6162234338488929
5023,0.5024,7,12,7,662660,13784,104111,22145,0.1091750095044988,0.6163544768849676
5024,0.5025,3,12,3,662672,13772,104114,22142,0.10907996451653783,0.6165283733363034
5025,0.5026,10,9,10,662681,13763,104124,22132,0.10900868077556711,0.6165761248084691
5026,0.5027,7,12,7,662693,13751,104131,22125,0.10891363578760613,0.6167075482216524
5027,0.5028,10,13,10,662706,13738,104141,22115,0.10881067038398175,0.6168242545951524
5028,0.5029,14,11,14,662717,13727,104155,22101,0.1087235458116842,0.6168639053254438
5029,0.503,10,18,10,662735,13709,104165,22091,0.10858097832974274,0.6170670391061452
5030,0.5031,9,11,9,662746,13698,104174,22082,0.10849385375744519,0.6171604248183342
5031,0.5032,8,6,8,662752,13692,104182,22074,0.1084463312634647,0.6171783257842643
5032,0.5033,7,6,7,662758,13686,104189,22067,0.10839880876948423,0.6172069476687271
5033,0.5034,7,10,7,662768,13676,104196,22060,0.10831960461285008,0.6173046787553168
5034,0.5035,6,13,6,662781,13663,104202,22054,0.1082166392092257,0.6174650726544783
5035,0.5036,9,5,9,662786,13658,104211,22045,0.10817703713090863,0.6174551158165981
5036,0.5037,10,10,10,662796,13648,104221,22035,0.10809783297427449,0.6175209483507552
5037,0.5038,10,8,10,662804,13640,104231,22025,0.10803446964896718,0.6175522220664517
5038,0.5039,8,6,8,662810,13634,104239,22017,0.10798694715498669,0.6175703346329696
5039,0.504,11,6,11,662816,13628,104250,22006,0.10793942466100621,0.617556266487063
5040,0.5041,10,10,10,662826,13618,104260,21996,0.10786022050437206,0.6176222833717078
5041,0.5042,5,9,5,662835,13609,104265,21991,0.10778893676340134,0.6177247191011236
5042,0.5043,6,6,6,662841,13603,104271,21985,0.10774141426942085,0.6177644149713386
5043,0.5044,11,7,11,662848,13596,104282,21974,0.10768597135977696,0.617767781838628
5044,0.5045,9,13,9,662861,13583,104291,21965,0.10758300595615258,0.6178969280972206
5045,0.5046,6,14,6,662875,13569,104297,21959,0.10747212013686479,0.6180758838099527
5046,0.5047,14,5,14,662880,13564,104311,21945,0.10743251805854771,0.618012334901011
5047,0.5048,10,6,10,662886,13558,104321,21935,0.10738499556456722,0.6180091849097005
5048,0.5049,12,7,12,662893,13551,104333,21923,0.10732955265492333,0.6180019168968822
5049,0.505,9,16,9,662909,13535,104342,21914,0.10720282600430871,0.6181838697847613
5050,0.5051,7,12,7,662921,13523,104349,21907,0.10710778101634774,0.6183178097657352
5051,0.5052,8,9,8,662930,13514,104357,21899,0.10703649727537701,0.6183887273035326
5052,0.5053,10,16,10,662946,13498,104367,21889,0.10690977062476238,0.6185604883149179
5053,0.5054,10,16,10,662962,13482,104377,21879,0.10678304397414776,0.6187325019088826
5054,0.5055,6,13,6,662975,13469,104383,21873,0.10668007857052338,0.6188953652877596
5055,0.5056,10,11,10,662986,13458,104393,21863,0.10659295399822583,0.6189802100733275
5056,0.5057,10,9,10,662995,13449,104403,21853,0.1065216702572551,0.6190300832814005
5057,0.5058,7,9,7,663004,13440,104410,21846,0.10645038651628437,0.6191123958510457
5058,0.5059,16,12,16,663016,13428,104426,21830,0.1063553415283234,0.6191502637699245
5059,0.506,11,3,11,663019,13425,104437,21819,0.10633158028133316,0.619084099421178
5060,0.5061,9,7,9,663026,13418,104446,21810,0.10627613737168927,0.619109799023504
5061,0.5062,10,8,10,663034,13410,104456,21800,0.10621277404638195,0.6191422891224084
5062,0.5063,4,19,4,663053,13391,104460,21796,0.1060622861487771,0.6194333134396226
5063,0.5064,11,6,11,663059,13385,104471,21785,0.1060147636547966,0.6194199601933466
5064,0.5065,13,9,13,663068,13376,104484,21772,0.10594347991382588,0.6194378058495504
5065,0.5066,7,5,7,663073,13371,104491,21765,0.10590387783550881,0.6194501366120219
5066,0.5067,5,9,5,663082,13362,104496,21760,0.10583259409453809,0.6195546950629235
5067,0.5068,8,8,8,663090,13354,104504,21752,0.10576923076923077,0.6196091836153365
5068,0.5069,10,7,10,663097,13347,104514,21742,0.10571378785958688,0.6196243837099946
5069,0.507,11,6,11,663103,13341,104525,21731,0.10566626536560639,0.6196110857664233
5070,0.5071,6,9,6,663112,13332,104531,21725,0.10559498162463567,0.6197050517728271
5071,0.5072,7,7,7,663119,13325,104538,21718,0.10553953871499176,0.6197528750392375
5072,0.5073,11,8,11,663127,13317,104549,21707,0.10547617538968446,0.6197750114207401
5073,0.5074,7,8,7,663135,13309,104556,21700,0.10541281206437714,0.6198406124139507
5074,0.5075,11,8,11,663143,13301,104567,21689,0.10534944873906983,0.6198628179479851
5075,0.5076,5,7,5,663150,13294,104572,21684,0.10529400582942593,0.61993252901824
5076,0.5077,10,10,10,663160,13284,104582,21674,0.10521480167279179,0.6200011442302191
5077,0.5078,9,6,9,663166,13278,104591,21665,0.1051672791788113,0.6200097301319292
5078,0.5079,11,10,11,663176,13268,104602,21654,0.10508807502217717,0.6200675791764504
5079,0.508,12,11,12,663187,13257,104614,21642,0.10500095044987962,0.6201323820166766
5080,0.5081,13,7,13,663194,13250,104627,21629,0.10494550754023571,0.6201152555979242
5081,0.5082,10,8,10,663202,13242,104637,21619,0.1048821442149284,0.6201485901150282
5082,0.5083,12,11,12,663213,13231,104649,21607,0.10479501964263084,0.6202135599058499
5083,0.5084,9,9,9,663222,13222,104658,21598,0.10472373590166012,0.62027570361861
5084,0.5085,5,6,5,663228,13216,104663,21593,0.10467621340767963,0.6203280760722801
5085,0.5086,7,11,7,663239,13205,104670,21586,0.10458908883538208,0.6204478169641574
5086,0.5087,10,16,10,663255,13189,104680,21576,0.10446236218476745,0.6206241909966921
5087,0.5088,14,11,14,663266,13178,104694,21562,0.1043752376124699,0.6206678180771446
5088,0.5089,6,13,6,663279,13165,104700,21556,0.10427227220884552,0.6208346533797989
5089,0.509,9,9,9,663288,13156,104709,21547,0.10420098846787479,0.6208973287612022
5090,0.5091,11,9,11,663297,13147,104720,21536,0.10412970472690407,0.6209382118040538
5091,0.5092,13,10,13,663307,13137,104733,21523,0.10405050057026993,0.6209751875360646
5092,0.5093,10,6,10,663313,13131,104743,21513,0.10400297807628944,0.6209733287149289
5093,0.5094,6,8,6,663321,13123,104749,21507,0.10393961475098214,0.6210511117528155
5094,0.5095,9,8,9,663329,13115,104758,21498,0.10387625142567482,0.6210961199549302
5095,0.5096,8,6,8,663335,13109,104766,21490,0.10382872893169434,0.621116217231712
5096,0.5097,9,8,9,663343,13101,104775,21481,0.10376536560638702,0.6211612977849749
5097,0.5098,7,5,7,663348,13096,104782,21474,0.10372576352806995,0.6211744286954006
5098,0.5099,5,13,5,663361,13083,104787,21469,0.10362279812444557,0.6213533225283631
5099,0.51,12,10,12,663371,13073,104799,21457,0.10354359396781143,0.6214016796988127
5100,0.5101,14,11,14,663382,13062,104813,21443,0.10345646939551388,0.6214461672221417
5101,0.5102,8,8,8,663390,13054,104821,21435,0.10339310607020656,0.6215025080460437
5102,0.5103,8,7,8,663397,13047,104829,21427,0.10333766316056267,0.6215408713813309
5103,0.5104,7,9,7,663406,13038,104836,21420,0.10326637941959194,0.621626327703291
5104,0.5105,9,11,9,663417,13027,104845,21411,0.10317925484729439,0.6217260003484523
5105,0.5106,7,9,7,663426,13018,104852,21404,0.10310797110632366,0.6218116320957527
5106,0.5107,18,11,18,663437,13007,104870,21386,0.1030208465340261,0.6218125781409007
5107,0.5108,8,13,8,663450,12994,104878,21378,0.10291788113040172,0.6219597346677528
5108,0.5109,6,15,6,663465,12979,104884,21372,0.10279907489545051,0.6221652935867952
5109,0.511,6,22,6,663487,12957,104890,21366,0.10262482575085541,0.6224980333886898
5110,0.5111,2,9,2,663496,12948,104892,21364,0.10255354200988467,0.6226393098624388
5111,0.5112,13,12,13,663508,12936,104905,21351,0.10245849702192371,0.6227141482194418
5112,0.5113,8,11,8,663519,12925,104913,21343,0.10237137244962616,0.6228259600793743
5113,0.5114,8,12,8,663531,12913,104921,21335,0.10227632746166519,0.6229560850268628
5114,0.5115,8,6,8,663537,12907,104929,21327,0.1022288049676847,0.6229771572121283
5115,0.5116,14,12,14,663549,12895,104943,21313,0.10213375997972374,0.6230413938260057
5116,0.5117,7,10,7,663559,12885,104950,21306,0.1020545558230896,0.6231464420461525
5117,0.5118,11,15,11,663574,12870,104961,21295,0.10193574958813839,0.6232986974974389
5118,0.5119,7,8,7,663582,12862,104968,21288,0.10187238626283107,0.6233674963396779
5119,0.512,6,9,6,663591,12853,104974,21282,0.10180110252186035,0.6234656510912553
5120,0.5121,9,16,9,663607,12837,104983,21273,0.10167437587124573,0.6236587510993843
5121,0.5122,7,11,7,663618,12826,104990,21266,0.10158725129894818,0.6237827056200869
5122,0.5123,14,10,14,663628,12816,105004,21252,0.10150804714231403,0.6238112011271575
5123,0.5124,9,12,9,663640,12804,105013,21243,0.10141300215435306,0.6239316239316239
5124,0.5125,10,14,10,663654,12790,105023,21233,0.10130211633506526,0.624077829703436
5125,0.5126,12,8,12,663662,12782,105035,21221,0.10123875300975795,0.6240919918830692
5126,0.5127,11,12,11,663674,12770,105046,21210,0.10114370802179698,0.6241907004120071
5127,0.5128,12,11,12,663685,12759,105058,21198,0.10105658344949943,0.6242600936478487
5128,0.5129,4,6,4,663691,12753,105062,21194,0.10100906095551894,0.6243261554776564
5129,0.513,7,14,7,663705,12739,105069,21187,0.10089817513623114,0.6245062783705713
5130,0.5131,8,11,8,663716,12728,105077,21179,0.1008110505639336,0.6246202848969239
5131,0.5132,9,10,9,663726,12718,105086,21170,0.10073184640729946,0.624704910292729
5132,0.5133,11,13,11,663739,12705,105097,21159,0.10062888100367508,0.6248228206945429
5133,0.5134,7,10,7,663749,12695,105104,21152,0.10054967684704093,0.6249298312996721
5134,0.5135,8,5,8,663754,12690,105112,21144,0.10051007476872387,0.6249334988473133
5135,0.5136,6,7,6,663761,12683,105118,21138,0.10045463185907996,0.6249963040714349
5136,0.5137,5,10,5,663771,12673,105123,21133,0.10037542770244583,0.6251257173282849
5137,0.5138,13,15,13,663786,12658,105136,21120,0.10025662146749462,0.6252590443483924
5138,0.5139,8,9,8,663795,12649,105144,21112,0.10018533772652388,0.6253369272237197
5139,0.514,0,9,0,663804,12640,105144,21112,0.10011405398555316,0.6255036738563641
5140,0.5141,8,5,8,663809,12635,105152,21104,0.10007445190723609,0.6255075728385547
5141,0.5142,7,8,7,663817,12627,105159,21097,0.10001108858192878,0.6255782232238168
5142,0.5143,3,10,3,663827,12617,105162,21094,0.09993188442529465,0.6257304737326095
5143,0.5144,4,10,4,663837,12607,105166,21090,0.0998526802686605,0.6258717393239754
5144,0.5145,8,6,8,663843,12601,105174,21082,0.09980515777468002,0.6258943680788528
5145,0.5146,9,10,9,663853,12591,105183,21073,0.09972595361804587,0.6259802756653993
5146,0.5147,7,9,7,663862,12582,105190,21066,0.09965466987707515,0.6260699001426534
5147,0.5148,5,11,5,663873,12571,105195,21061,0.0995675453047776,0.6262190770694577
5148,0.5149,12,7,12,663880,12564,105207,21049,0.0995121023951337,0.6262160473626276
5149,0.515,7,10,7,663890,12554,105214,21042,0.09943289823849956,0.6263245624479105
5150,0.5151,11,7,11,663897,12547,105225,21031,0.09937745532885565,0.6263327178509739
5151,0.5152,9,10,9,663907,12537,105234,21022,0.09929825117222152,0.626419142405912
5152,0.5153,8,6,8,663913,12531,105242,21014,0.09925072867824103,0.6264420927112834
5153,0.5154,9,8,9,663921,12523,105251,21005,0.09918736535293372,0.6264912908613696
5154,0.5155,8,6,8,663927,12517,105259,20997,0.09913984285895323,0.6265142925344632
5155,0.5156,7,8,7,663935,12509,105266,20990,0.09907647953364593,0.6265858682348727
5156,0.5157,8,6,8,663941,12503,105274,20982,0.09902895703966544,0.6266089293713603
5157,0.5158,6,9,6,663950,12494,105280,20976,0.09895767329869472,0.6267104870032866
5158,0.5159,8,7,8,663957,12487,105288,20968,0.09890223038905081,0.6267523539082349
5159,0.516,7,7,7,663964,12480,105295,20961,0.09884678747940692,0.6268054184982507
5160,0.5161,12,5,12,663969,12475,105307,20949,0.09880718540108985,0.6267651986596458
5161,0.5162,7,10,7,663979,12465,105314,20942,0.09872798124445571,0.6268746071182686
5162,0.5163,3,10,3,663989,12455,105317,20939,0.09864877708782156,0.6270288075702222
5163,0.5164,14,10,14,663999,12445,105331,20925,0.09856957293118743,0.6270602337428828
5164,0.5165,6,8,6,664007,12437,105337,20919,0.09850620960588012,0.627143542391174
5165,0.5166,7,5,7,664012,12432,105344,20912,0.09846660752756305,0.6271593090211133
5166,0.5167,9,10,9,664022,12422,105353,20903,0.09838740337092891,0.6272468117029257
5167,0.5168,8,10,8,664032,12412,105361,20895,0.09830819921429476,0.6273456030263909
5168,0.5169,9,4,9,664036,12408,105370,20886,0.09827651755164112,0.6273202378806992
5169,0.517,9,9,9,664045,12399,105379,20877,0.09820523381067038,0.6273891092679409
5170,0.5171,12,7,12,664052,12392,105391,20865,0.09814979090102649,0.6273867155786752
5171,0.5172,7,5,7,664057,12387,105398,20858,0.09811018882270942,0.6274026169348774
5172,0.5173,9,11,9,664068,12376,105407,20849,0.09802306425041186,0.6275094055680963
5173,0.5174,6,9,6,664077,12367,105413,20843,0.09795178050944113,0.627612165010539
5174,0.5175,6,4,6,664081,12363,105419,20837,0.09792009884678748,0.6276204819277108
5175,0.5176,6,7,6,664088,12356,105425,20831,0.09786465593714358,0.6276855395184862
5176,0.5177,11,10,11,664098,12346,105436,20820,0.09778545178050944,0.6277513115841524
5177,0.5178,6,11,6,664109,12335,105442,20814,0.0976983272082119,0.6278922441099279
5178,0.5179,6,10,6,664119,12325,105448,20808,0.09761912305157774,0.6280143663417137
5179,0.518,5,12,5,664131,12313,105453,20803,0.09752407806361678,0.6281857712284092
5180,0.5181,7,13,7,664144,12300,105460,20796,0.0974211126599924,0.6283538796229151
5181,0.5182,10,10,10,664154,12290,105470,20786,0.09734190850335826,0.6284314911113799
5182,0.5183,11,6,11,664160,12284,105481,20775,0.09729438600937777,0.6284219123385463
5183,0.5184,6,10,6,664170,12274,105487,20769,0.09721518185274364,0.6285446236721848
5184,0.5185,4,12,4,664182,12262,105491,20765,0.09712013686478266,0.6287280104157205
5185,0.5186,10,12,10,664194,12250,105501,20755,0.09702509187682169,0.6288441145281018
5186,0.5187,6,9,6,664203,12241,105507,20749,0.09695380813585097,0.6289481661109427
5187,0.5188,7,6,7,664209,12235,105514,20742,0.09690628564187048,0.6289838372198805
5188,0.5189,13,10,13,664219,12225,105527,20729,0.09682708148523635,0.6290283425380834
5189,0.519,7,8,7,664227,12217,105534,20722,0.09676371815992903,0.6291022799720696
5190,0.5191,11,8,11,664235,12209,105545,20711,0.09670035483462172,0.6291312272174969
5191,0.5192,9,9,9,664244,12200,105554,20702,0.096629071093651,0.6292018722266124
5192,0.5193,7,11,7,664255,12189,105561,20695,0.09654194652135344,0.6293334144264688
5193,0.5194,9,5,9,664260,12184,105570,20686,0.09650234444303638,0.6293276543961058
5194,0.5195,12,17,12,664277,12167,105582,20674,0.09636769737675834,0.6295179805730642
5195,0.5196,10,16,10,664293,12151,105592,20664,0.09624097072614371,0.6297120219411855
5196,0.5197,8,11,8,664304,12140,105600,20656,0.09615384615384616,0.6298329064520063
5197,0.5198,8,8,8,664312,12132,105608,20648,0.09609048282853884,0.6298962782184259
5198,0.5199,13,8,13,664320,12124,105621,20635,0.09602711950323153,0.6299032326994108
5199,0.52,10,5,10,664325,12119,105631,20625,0.09598751742491446,0.6298863913999512
5200,0.5201,10,13,10,664338,12106,105641,20615,0.09588455202129008,0.630023532288133
5201,0.5202,7,14,7,664352,12092,105648,20608,0.09577366620200228,0.6302140672782874
5202,0.5203,8,4,8,664356,12088,105656,20600,0.09574198453934862,0.6302006852667645
5203,0.5204,11,9,11,664365,12079,105667,20589,0.0956707007983779,0.6302497857230317
5204,0.5205,10,7,10,664372,12072,105677,20579,0.095615257888734,0.6302716608985942
5205,0.5206,5,13,5,664385,12059,105682,20574,0.09551229248510962,0.6304660926056446
5206,0.5207,7,11,7,664396,12048,105689,20567,0.09542516791281207,0.6305994174459605
5207,0.5208,7,14,7,664410,12034,105696,20560,0.09531428209352427,0.6307909431183654
5208,0.5209,12,9,12,664419,12025,105708,20548,0.09524299835255354,0.6308292143800079
5209,0.521,7,11,7,664430,12014,105715,20541,0.09515587378025599,0.6309629857164798
5210,0.5211,9,7,9,664437,12007,105724,20532,0.0951004308706121,0.6309966501736378
5211,0.5212,8,8,8,664445,11999,105732,20524,0.09503706754530478,0.6310610952249177
5212,0.5213,8,8,8,664453,11991,105740,20516,0.09497370421999747,0.6311256037161227
5213,0.5214,9,13,9,664466,11978,105749,20507,0.09487073881637308,0.6312759735262429
5214,0.5215,7,10,7,664476,11968,105756,20500,0.09479153465973894,0.6313909079709252
5215,0.5216,5,10,5,664486,11958,105761,20495,0.0947123305031048,0.6315286722336918
5216,0.5217,7,4,7,664490,11954,105768,20488,0.09468064884045115,0.63152703285864
5217,0.5218,13,10,13,664500,11944,105781,20475,0.09460144468381701,0.6315740769301953
5218,0.5219,8,8,8,664508,11936,105789,20467,0.09453808135850969,0.6316390457673672
5219,0.522,11,12,11,664520,11924,105800,20456,0.09444303637054872,0.6317479925880173
5220,0.5221,9,6,9,664526,11918,105809,20447,0.09439551387656825,0.6317627066275298
5221,0.5222,11,9,11,664535,11909,105820,20436,0.09432423013559751,0.6318132632555263
5222,0.5223,8,11,8,664546,11898,105828,20428,0.09423710556329996,0.6319371403823547
5223,0.5224,6,9,6,664555,11889,105834,20422,0.09416582182232923,0.632044814459472
5224,0.5225,6,8,6,664563,11881,105840,20416,0.09410245849702192,0.6321330154503514
5225,0.5226,10,4,10,664567,11877,105850,20406,0.09407077683436826,0.6320973887185206
5226,0.5227,11,7,11,664574,11870,105861,20395,0.09401533392472437,0.632109096544243
5227,0.5228,6,8,6,664582,11862,105867,20389,0.09395197059941705,0.6321974512418219
5228,0.5229,10,4,10,664586,11858,105877,20379,0.09392028893676341,0.6321618016564817
5229,0.523,6,8,6,664594,11850,105883,20373,0.09385692561145609,0.6322502560283028
5230,0.5231,7,13,7,664607,11837,105890,20366,0.09375396020783171,0.6324255504145576
5231,0.5232,9,14,9,664621,11823,105899,20357,0.09364307438854391,0.6325978868862647
5232,0.5233,10,8,10,664629,11815,105909,20347,0.09357971106323659,0.6326410049126298
5233,0.5234,9,3,9,664632,11812,105918,20338,0.09355594981624636,0.632597200622084
5234,0.5235,5,8,5,664640,11804,105923,20333,0.09349258649093904,0.6326975137691757
5235,0.5236,14,9,14,664649,11795,105937,20319,0.09342130274996832,0.6327147038674721
5236,0.5237,6,6,6,664655,11789,105943,20313,0.09337378025598783,0.6327643137499221
5237,0.5238,8,13,8,664668,11776,105951,20305,0.09327081485236345,0.6329291480938873
5238,0.5239,5,7,5,664675,11769,105956,20300,0.09321537194271956,0.6330100720321806
5239,0.524,7,10,7,664685,11759,105963,20293,0.09313616778608541,0.633127417945838
5240,0.5241,11,10,11,664695,11749,105974,20282,0.09305696362945128,0.6331990883831289
5241,0.5242,12,6,12,664701,11743,105986,20270,0.09300944113547079,0.6331802705151033
5242,0.5243,9,10,9,664711,11733,105995,20261,0.09293023697883665,0.6332749890604489
5243,0.5244,11,8,11,664719,11725,106006,20250,0.09286687365352933,0.6333072713057076
5244,0.5245,7,10,7,664729,11715,106013,20243,0.0927876694968952,0.6334251204706177
5245,0.5246,10,8,10,664737,11707,106023,20233,0.09272430617158789,0.6334690043832185
5246,0.5247,9,9,9,664746,11698,106032,20224,0.09265302243061715,0.6335442641438507
5247,0.5248,8,6,8,664752,11692,106040,20216,0.09260549993663668,0.6335715181145795
5248,0.5249,8,8,8,664760,11684,106048,20208,0.09254213661132936,0.6336385300388813
5249,0.525,8,4,8,664764,11680,106056,20200,0.09251045494867571,0.6336260978670013
5250,0.5251,3,6,3,664770,11674,106059,20197,0.09246293245469522,0.633710897053748
5251,0.5252,7,9,7,664779,11665,106066,20190,0.0923916487137245,0.6338094490660807
5252,0.5253,8,9,8,664788,11656,106074,20182,0.09232036497275377,0.6338966015453232
5253,0.5254,11,7,11,664795,11649,106085,20171,0.09226492206310988,0.633909490886235
5254,0.5255,6,10,6,664805,11639,106091,20165,0.09218571790647573,0.6340397434284996
5255,0.5256,8,6,8,664811,11633,106099,20157,0.09213819541249525,0.6340673167662787
5256,0.5257,5,5,5,664816,11628,106104,20152,0.09209859333417818,0.6341095028319698
5257,0.5258,7,8,7,664824,11620,106111,20145,0.09203523000887087,0.634188572328034
5258,0.5259,5,8,5,664832,11612,106116,20140,0.09197186668356355,0.6342907533383724
5259,0.526,11,5,11,664837,11607,106127,20129,0.09193226460524648,0.6342639274010587
5260,0.5261,3,7,3,664844,11600,106130,20126,0.09187682169560259,0.6343692870201096
5261,0.5262,3,10,3,664854,11590,106133,20123,0.09179761753896845,0.6345347333900924
5262,0.5263,8,5,8,664859,11585,106141,20115,0.09175801546065138,0.6345425867507887
5263,0.5264,6,7,6,664866,11578,106147,20109,0.09170257255100747,0.6346135639221132
5264,0.5265,8,6,8,664872,11572,106155,20101,0.091655050057027,0.6346414927540808
5265,0.5266,8,11,8,664883,11561,106163,20093,0.09156792548472945,0.6347696973526252
5266,0.5267,8,10,8,664893,11551,106171,20085,0.0914887213280953,0.6348779871033
5267,0.5268,5,8,5,664901,11543,106176,20080,0.09142535800278799,0.634980868355311
5268,0.5269,4,7,4,664908,11536,106180,20076,0.09136991509314409,0.6350752878653676
5269,0.527,10,3,10,664911,11533,106190,20066,0.09134615384615384,0.6350200955726447
5270,0.5271,8,5,8,664916,11528,106198,20058,0.09130655176783678,0.635028177040461
5271,0.5272,8,8,8,664924,11520,106206,20050,0.09124318844252946,0.6350966107063668
5272,0.5273,10,9,10,664933,11511,106216,20040,0.09117190470155874,0.6351621184748503
5273,0.5274,6,6,6,664939,11505,106222,20034,0.09112438220757825,0.6352135451345953
5274,0.5275,4,9,4,664948,11496,106226,20030,0.09105309846660753,0.6353486011546026
5275,0.5276,9,10,9,664958,11486,106235,20021,0.0909738943099734,0.6354460913447805
5276,0.5277,6,10,6,664968,11476,106241,20015,0.09089469015333924,0.6355784192308913
5277,0.5278,11,7,11,664975,11469,106252,20004,0.09083924724369535,0.6355924125440854
5278,0.5279,5,9,5,664984,11460,106257,19999,0.09076796350272462,0.6357163291903748
5279,0.528,10,6,10,664990,11454,106267,19989,0.09072044100874414,0.6357217822726839
5280,0.5281,8,10,8,665000,11444,106275,19981,0.09064123685211,0.6358313444709626
5281,0.5282,9,7,9,665007,11437,106284,19972,0.0905857939424661,0.6358687000541247
5282,0.5283,6,6,6,665013,11431,106290,19966,0.09053827144848561,0.6359206293594929
5283,0.5284,7,7,7,665020,11424,106297,19959,0.09048282853884172,0.6359812637415161
5284,0.5285,8,6,8,665026,11418,106305,19951,0.09043530604486123,0.6360100736395805
5285,0.5286,7,9,7,665035,11409,106312,19944,0.09036402230389051,0.6361113769017319
5286,0.5287,6,7,6,665042,11402,106318,19938,0.09030857939424661,0.6361837906828335
5287,0.5288,5,9,5,665051,11393,106323,19933,0.09023729565327589,0.6363084977335121
5288,0.5289,4,8,4,665059,11385,106327,19929,0.09017393232796857,0.6364246024142556
5289,0.529,11,8,11,665067,11377,106338,19918,0.09011056900266126,0.6364594983224158
5290,0.5291,4,4,4,665071,11373,106342,19914,0.0900788873400076,0.6364943906414805
5291,0.5292,9,6,9,665077,11367,106351,19905,0.09003136484602713,0.6365118956254797
5292,0.5293,9,6,9,665083,11361,106360,19896,0.08998384235204664,0.6365294174105001
5293,0.5294,5,10,5,665093,11351,106365,19891,0.0899046381954125,0.636674988797132
5294,0.5295,6,7,6,665100,11344,106371,19885,0.0898491952857686,0.6367478945851612
5295,0.5296,18,4,18,665104,11340,106389,19867,0.08981751362311494,0.6366199891050085
5296,0.5297,8,6,8,665110,11334,106397,19859,0.08976999112913446,0.6366492482287692
5297,0.5298,13,10,13,665120,11324,106410,19846,0.08969078697250031,0.6367019570099455
5298,0.5299,13,7,13,665127,11317,106423,19833,0.08963534406285642,0.6366934189406099
5299,0.53,6,10,6,665137,11307,106429,19827,0.08955613990622228,0.6368279051840432
5300,0.5301,9,9,9,665146,11298,106438,19818,0.08948485616525155,0.6369070574623987
5301,0.5302,2,9,2,665155,11289,106440,19816,0.08941357242428083,0.6370679954991159
5302,0.5303,13,10,13,665165,11279,106453,19803,0.08933436826764668,0.6371211633743002
5303,0.5304,16,6,16,665171,11273,106469,19787,0.0892868457736662,0.6370573084352865
5304,0.5305,4,8,4,665179,11265,106473,19783,0.08922348244835888,0.6371746972429786
5305,0.5306,11,7,11,665186,11258,106484,19772,0.089168039538715,0.6371898163067998
5306,0.5307,7,7,7,665193,11251,106491,19765,0.08911259662907109,0.6372517410368842
5307,0.5308,13,3,13,665196,11248,106504,19752,0.08908883538208086,0.6371612903225806
5308,0.5309,14,8,14,665204,11240,106518,19738,0.08902547205677354,0.6371618568016011
5309,0.531,6,9,6,665213,11231,106524,19732,0.08895418831580282,0.6372767496689598
5310,0.5311,10,10,10,665223,11221,106534,19722,0.08887498415916867,0.6373654784603949
5311,0.5312,6,10,6,665233,11211,106540,19716,0.08879578000253453,0.6375012125327384
5312,0.5313,7,3,7,665236,11208,106547,19709,0.08877201875554429,0.6374809975094609
5313,0.5314,8,3,8,665239,11205,106555,19701,0.08874825750855404,0.6374490390215493
5314,0.5315,11,10,11,665249,11195,106566,19690,0.08866905335191991,0.6375263072689008
5315,0.5316,9,12,9,665261,11183,106575,19681,0.08857400836395894,0.6376684810782789
5316,0.5317,13,9,13,665270,11174,106588,19668,0.08850272462298821,0.6377018351598469
5317,0.5318,7,9,7,665279,11165,106595,19661,0.08843144088201749,0.6378057483942127
5318,0.5319,9,10,9,665289,11155,106604,19652,0.08835223672538335,0.6379069691953128
5319,0.532,9,12,9,665301,11143,106613,19643,0.08825719173742239,0.6380497628792308
5320,0.5321,5,8,5,665309,11135,106618,19638,0.08819382841211507,0.6381568257888409
5321,0.5322,6,4,6,665313,11131,106624,19632,0.0881621467494614,0.6381692292689269
5322,0.5323,6,4,6,665317,11127,106630,19626,0.08813046508680776,0.6381816408155302
5323,0.5324,4,9,4,665326,11118,106634,19622,0.08805918134583703,0.6383214053350683
5324,0.5325,10,7,10,665333,11111,106644,19612,0.08800373843619314,0.638349119552127
5325,0.5326,7,5,7,665338,11106,106651,19605,0.08796413635787606,0.6383706163915209
5326,0.5327,15,9,15,665347,11097,106666,19590,0.08789285261690534,0.6383810734187115
5327,0.5328,10,7,10,665354,11090,106676,19580,0.08783740970726144,0.638408868601239
5328,0.5329,11,14,11,665368,11076,106687,19569,0.08772652388797364,0.638570729319628
5329,0.533,4,11,4,665379,11065,106691,19565,0.08763939931567609,0.638752856676461
5330,0.5331,8,4,8,665383,11061,106699,19557,0.08760771765302243,0.6387419165196943
5331,0.5332,10,6,10,665389,11055,106709,19547,0.08756019515904194,0.6387491013659238
5332,0.5333,4,6,4,665395,11049,106713,19543,0.08751267266506146,0.6388271443514645
5333,0.5334,15,5,15,665400,11044,106728,19528,0.08747307058674439,0.638754415805312
5334,0.5335,11,5,11,665405,11039,106739,19517,0.08743346850842733,0.6387288912161277
5335,0.5336,5,7,5,665412,11032,106744,19512,0.08737802559878342,0.6388161341016239
5336,0.5337,10,7,10,665419,11025,106754,19502,0.08732258268913953,0.6388443017656501
5337,0.5338,7,10,7,665429,11015,106761,19495,0.08724337853250538,0.638970829236316
5338,0.5339,6,8,6,665437,11007,106767,19489,0.08718001520719808,0.6390674186778594
5339,0.534,5,10,5,665447,10997,106772,19484,0.08710081105056393,0.6392178734293494
5340,0.5341,12,7,12,665454,10990,106784,19472,0.08704536814092004,0.6392226380408378
5341,0.5342,7,8,7,665462,10982,106791,19465,0.08698200481561272,0.6393076493579006
5342,0.5343,8,17,8,665479,10965,106799,19457,0.08684735774933469,0.639570047991585
5343,0.5344,14,10,14,665489,10955,106813,19443,0.08676815359270054,0.6396144483189683
5344,0.5345,7,8,7,665497,10947,106820,19436,0.08670479026739324,0.6396998321429747
5345,0.5346,7,7,7,665504,10940,106827,19429,0.08664934735774933,0.6397642332641839
5346,0.5347,7,7,7,665511,10933,106834,19422,0.08659390444810544,0.6398286937901498
5347,0.5348,8,2,8,665513,10931,106842,19414,0.08657806361677861,0.6397759103641456
5348,0.5349,9,8,9,665521,10923,106851,19405,0.08651470029147129,0.6398377736744922
5349,0.535,10,9,10,665530,10914,106861,19395,0.08644341655050057,0.639908937939226
5350,0.5351,11,8,11,665538,10906,106872,19384,0.08638005322519325,0.6399471772862331
5351,0.5352,7,5,7,665543,10901,106879,19377,0.08634045114687619,0.639969614901909
5352,0.5353,9,9,9,665552,10892,106888,19368,0.08626916740590546,0.6400528750826173
5353,0.5354,10,8,10,665560,10884,106898,19358,0.08620580408059815,0.6401031677799087
5354,0.5355,8,11,8,665571,10873,106906,19350,0.0861186795083006,0.6402408761539226
5355,0.5356,12,2,12,665573,10871,106918,19338,0.08610283867697377,0.6401403555231885
5356,0.5357,12,7,12,665580,10864,106930,19326,0.08604739576732987,0.6401457436237165
5357,0.5358,10,11,10,665591,10853,106940,19316,0.08596027119503231,0.6402598694023667
5358,0.5359,8,4,8,665595,10849,106948,19308,0.08592858953237865,0.6402493616739066
5359,0.536,9,3,9,665598,10846,106957,19299,0.08590482828538842,0.6402056725825178
5360,0.5361,9,9,9,665607,10837,106966,19290,0.08583354454441769,0.6402894413648886
5361,0.5362,7,10,7,665617,10827,106973,19283,0.08575434038778355,0.6404184656260379
5362,0.5363,4,10,4,665627,10817,106977,19279,0.0856751362311494,0.640583466241361
5363,0.5364,7,12,7,665639,10805,106984,19272,0.08558009124318844,0.6407553944874821
5364,0.5365,6,8,6,665647,10797,106990,19266,0.08551672791788113,0.6408542061670492
5365,0.5366,5,7,5,665654,10790,106995,19261,0.08546128500823723,0.6409437289940435
5366,0.5367,5,6,5,665660,10784,107000,19256,0.08541376251425675,0.6410119840213049
5367,0.5368,13,10,13,665670,10774,107013,19243,0.0853345583576226,0.6410700602991638
5368,0.5369,9,8,9,665678,10766,107022,19234,0.0852711950323153,0.6411333333333333
5369,0.537,13,11,13,665689,10755,107035,19221,0.08518407046001775,0.6412129703763011
5370,0.5371,16,5,16,665694,10750,107051,19205,0.08514446838170067,0.6411283592054748
5371,0.5372,5,8,5,665702,10742,107056,19200,0.08508110505639337,0.641239730144947
5372,0.5373,7,9,7,665711,10733,107063,19193,0.08500982131542263,0.6413486600280692
5373,0.5374,10,5,10,665716,10728,107073,19183,0.08497021923710556,0.641335963357962
5374,0.5375,10,6,10,665722,10722,107083,19173,0.08492269674312508,0.6413447064726543
5375,0.5376,4,11,4,665733,10711,107087,19169,0.08483557217082753,0.641532797858099
5376,0.5377,9,8,9,665741,10703,107096,19160,0.08477220884552021,0.6415966245856076
5377,0.5378,9,8,9,665749,10695,107105,19151,0.0847088455202129,0.6416605240233197
5378,0.5379,7,4,7,665753,10691,107112,19144,0.08467716385755925,0.6416624769565946
5379,0.538,14,9,14,665762,10682,107126,19130,0.08460588011658852,0.6416879109083591
5380,0.5381,15,5,15,665767,10677,107141,19115,0.08456627803827145,0.6416151987110634
5381,0.5382,8,6,8,665773,10671,107149,19107,0.08451875554429096,0.6416481966552489
5382,0.5383,9,8,9,665781,10663,107158,19098,0.08445539221898365,0.6417123080541648
5383,0.5384,7,11,7,665792,10652,107165,19091,0.0843682676466861,0.6418653128467202
5384,0.5385,9,7,9,665799,10645,107174,19082,0.0843128247370422,0.6419080297372759
5385,0.5386,7,12,7,665811,10633,107181,19075,0.08421777974908123,0.6420829406220546
5386,0.5387,9,6,9,665817,10627,107190,19066,0.08417025725510074,0.6421041996430135
5387,0.5388,13,12,13,665829,10615,107203,19053,0.08407521226713978,0.6422070918160981
5388,0.5389,12,13,12,665842,10602,107215,19041,0.0839722468635154,0.6423438923185912
5389,0.539,10,11,10,665853,10591,107225,19031,0.08388512229121785,0.6424616838836
5390,0.5391,9,9,9,665862,10582,107234,19022,0.08381383855024711,0.642548304283205
5391,0.5392,11,6,11,665868,10576,107245,19011,0.08376631605626664,0.6425457126440667
5392,0.5393,9,10,9,665878,10566,107254,19002,0.08368711189963249,0.6426542207792207
5393,0.5394,10,6,10,665884,10560,107264,18992,0.08363958940565201,0.6426637791012453
5394,0.5395,17,6,17,665890,10554,107281,18975,0.08359206691167152,0.6425886416742863
5395,0.5396,10,10,10,665900,10544,107291,18965,0.08351286275503739,0.6426852824561998
5396,0.5397,11,10,11,665910,10534,107302,18954,0.08343365859840324,0.6427699403147042
5397,0.5398,12,7,12,665917,10527,107314,18942,0.08337821568875935,0.6427771556550952
5398,0.5399,6,3,6,665920,10524,107320,18936,0.0833544544417691,0.6427698574338085
5399,0.54,4,4,4,665924,10520,107324,18932,0.08332277277911544,0.6428086377835122
5400,0.5401,11,8,11,665932,10512,107335,18921,0.08325940945380814,0.6428498623993477
5401,0.5402,5,9,5,665941,10503,107340,18916,0.08318812571283742,0.6429858254869302
5402,0.5403,6,6,6,665947,10497,107346,18910,0.08314060321885693,0.6430441731560513
5403,0.5404,7,9,7,665956,10488,107353,18903,0.0830693194778862,0.643156068184138
5404,0.5405,6,6,6,665962,10482,107359,18897,0.08302179698390572,0.6432145409986725
5405,0.5406,6,4,6,665966,10478,107365,18891,0.08299011532125206,0.6432292553372604
5406,0.5407,11,5,11,665971,10473,107376,18880,0.082950513242935,0.6432051238374272
5407,0.5408,10,9,10,665980,10464,107386,18870,0.08287922950196426,0.643280834526488
5408,0.5409,12,12,12,665992,10452,107398,18858,0.0827841845140033,0.6433981576253839
5409,0.541,7,9,7,666001,10443,107405,18851,0.08271290077303257,0.6435106165085
5410,0.5411,8,11,8,666012,10432,107413,18843,0.08262577620073501,0.6436549957301452
5411,0.5412,7,13,7,666025,10419,107420,18836,0.08252281079711063,0.6438557511536489
5412,0.5413,8,12,8,666037,10407,107428,18828,0.08242776580914966,0.6440225756798358
5413,0.5414,8,11,8,666048,10396,107436,18820,0.08234064123685211,0.6441675794085433
5414,0.5415,10,10,10,666058,10386,107446,18810,0.08226143708021796,0.6442663378545006
5415,0.5416,8,4,8,666062,10382,107454,18802,0.08222975541756432,0.6442571271929824
5416,0.5417,10,12,10,666074,10370,107464,18792,0.08213471042960334,0.6444002468966463
5417,0.5418,8,10,8,666084,10360,107472,18784,0.0820555062729692,0.6445237441668954
5418,0.5419,4,7,4,666091,10353,107476,18780,0.08200006336332531,0.6446298012563073
5419,0.542,6,6,6,666097,10347,107482,18774,0.08195254086934482,0.644689399402493
5420,0.5421,11,8,11,666105,10339,107493,18763,0.08188917754403752,0.6447323208026939
5421,0.5422,10,10,10,666115,10329,107503,18753,0.08180997338740337,0.6448318547555189
5422,0.5423,17,6,17,666121,10323,107520,18736,0.08176245089342289,0.6447572180735744
5423,0.5424,4,6,4,666127,10317,107524,18732,0.0817149283994424,0.6448414747495611
5424,0.5425,9,8,9,666135,10309,107533,18723,0.0816515650741351,0.6449090658583632
5425,0.5426,6,8,6,666143,10301,107539,18717,0.08158820174882778,0.6450134399338342
5426,0.5427,8,5,8,666148,10296,107547,18709,0.0815485996705107,0.6450267195311153
5427,0.5428,5,3,5,666151,10293,107552,18704,0.08152483842352047,0.6450322447149706
5428,0.5429,9,5,9,666156,10288,107561,18695,0.0814852363452034,0.6450332953800504
5429,0.543,7,14,7,666170,10274,107568,18688,0.0813743505259156,0.6452593052965956
5430,0.5431,12,10,12,666180,10264,107580,18676,0.08129514636928147,0.6453351762266759
5431,0.5432,7,3,7,666183,10261,107587,18669,0.08127138512229122,0.6453162806774974
5432,0.5433,8,9,8,666192,10252,107595,18661,0.08120010138132049,0.6454190156676928
5433,0.5434,7,4,7,666196,10248,107602,18654,0.08116841971866684,0.6454224621133485
5434,0.5435,12,4,12,666200,10244,107614,18642,0.08113673805601318,0.6453645364536453
5435,0.5436,12,6,12,666206,10238,107626,18630,0.08108921556203269,0.6453512539836497
5436,0.5437,7,12,7,666218,10226,107633,18623,0.08099417057407172,0.6455336406807861
5437,0.5438,8,7,8,666225,10219,107641,18615,0.08093872766442783,0.6455920094333079
5438,0.5439,6,9,6,666234,10210,107647,18609,0.0808674439234571,0.6457198376071341
5439,0.544,8,9,8,666243,10201,107655,18601,0.08079616018248638,0.6458232067217554
5440,0.5441,6,7,6,666250,10194,107661,18595,0.08074071727284247,0.6459064225919622
5441,0.5442,7,10,7,666260,10184,107668,18588,0.08066151311620834,0.6460447657444738
5442,0.5443,2,9,2,666269,10175,107670,18586,0.08059022937523762,0.6462223149403706
5443,0.5444,8,10,8,666279,10165,107678,18578,0.08051102521860347,0.6463486761994225
5444,0.5445,10,8,10,666287,10157,107688,18568,0.08044766189329616,0.6464055700609226
5445,0.5446,12,9,12,666296,10148,107700,18556,0.08037637815232543,0.6464604236343366
5446,0.5447,9,5,9,666301,10143,107709,18547,0.08033677607400837,0.6464621819449285
5447,0.5448,8,3,8,666304,10140,107717,18539,0.08031301482701812,0.6464311865825169
5448,0.5449,10,6,10,666310,10134,107727,18529,0.08026549233303763,0.6464431497051949
5449,0.545,4,10,4,666320,10124,107731,18525,0.0801862881764035,0.646619428252295
5450,0.5451,8,4,8,666324,10120,107739,18517,0.08015460651374984,0.6466110276914482
5451,0.5452,4,3,4,666327,10117,107743,18513,0.08013084526675959,0.6466294097100943
5452,0.5453,1,14,1,666341,10103,107744,18512,0.0800199594474718,0.6469334265245501
5453,0.5454,4,5,4,666346,10098,107748,18508,0.07998035736915474,0.6469971334685031
5454,0.5455,12,8,12,666354,10090,107760,18496,0.07991699404384742,0.6470300146925069
5455,0.5456,7,7,7,666361,10083,107767,18489,0.07986155113420353,0.6471020579588408
5456,0.5457,9,7,9,666368,10076,107776,18480,0.07980610822455962,0.6471494607087828
5457,0.5458,14,4,14,666372,10072,107790,18466,0.07977442656190598,0.64706706847011
5458,0.5459,10,8,10,666380,10064,107800,18456,0.07971106323659866,0.647124824684432
5459,0.546,8,10,8,666390,10054,107808,18448,0.07963185907996452,0.6472528243632025
5460,0.5461,5,5,5,666395,10049,107813,18443,0.07959225700164745,0.6473045065281483
5461,0.5462,8,6,8,666401,10043,107821,18435,0.07954473450766696,0.6473418077112156
5462,0.5463,9,8,9,666409,10035,107830,18426,0.07948137118235965,0.6474122483398335
5463,0.5464,14,5,14,666414,10030,107844,18412,0.07944176910404258,0.6473525068560579
5464,0.5465,4,3,4,666417,10027,107848,18408,0.07941800785705234,0.6473711974679093
5465,0.5466,6,6,6,666423,10021,107854,18402,0.07937048536307185,0.647433416599233
5466,0.5467,14,10,14,666433,10011,107868,18388,0.07929128120643772,0.6474875875911124
5467,0.5468,12,6,12,666439,10005,107880,18376,0.07924375871245723,0.6474754236989535
5468,0.5469,11,9,11,666448,9996,107891,18365,0.07917247497148651,0.647544162758718
5469,0.547,9,6,9,666454,9990,107900,18356,0.07912495247750602,0.647569321950187
5470,0.5471,9,7,9,666461,9983,107909,18347,0.07906950956786211,0.6476173667490293
5471,0.5472,7,5,7,666466,9978,107916,18340,0.07902990748954505,0.6476446076700332
5472,0.5473,5,3,5,666469,9975,107921,18335,0.07900614624255481,0.6476510067114094
5473,0.5474,5,4,5,666473,9971,107926,18330,0.07897446457990115,0.6476802939825448
5474,0.5475,8,7,8,666480,9964,107934,18322,0.07891902167025726,0.6477409319097787
5475,0.5476,7,9,7,666489,9955,107941,18315,0.07884773792928652,0.6478599221789884
5476,0.5477,8,7,8,666496,9948,107949,18307,0.07879229501964263,0.6479207219961068
5477,0.5478,5,10,5,666506,9938,107954,18302,0.0787130908630085,0.6480878186968838
5478,0.5479,12,6,12,666512,9932,107966,18290,0.07866556836902801,0.648075969102119
5479,0.548,9,7,9,666519,9925,107975,18281,0.0786101254593841,0.6481245125150678
5480,0.5481,13,8,13,666527,9917,107988,18268,0.0785467621340768,0.6481461770445273
5481,0.5482,2,7,2,666534,9910,107990,18266,0.07849131922443289,0.64828222600795
5482,0.5483,10,7,10,666541,9903,108000,18256,0.078435876314789,0.6483184772186512
5483,0.5484,12,9,12,666550,9894,108012,18244,0.07836459257381827,0.6483758618238681
5484,0.5485,3,7,3,666557,9887,108015,18241,0.07830914966417438,0.648499715585893
5485,0.5486,6,7,6,666564,9880,108021,18235,0.07825370675453047,0.6485861639694114
5486,0.5487,4,7,4,666571,9873,108025,18231,0.07819826384488658,0.6486976942783945
5487,0.5488,8,6,8,666577,9867,108033,18223,0.07815074135090609,0.6487362050551798
5488,0.5489,15,7,15,666584,9860,108048,18208,0.0780952984412622,0.6487102750463161
5489,0.549,5,5,5,666589,9855,108053,18203,0.07805569636294513,0.6487632760709958
5490,0.5491,7,8,7,666597,9847,108060,18196,0.07799233303763782,0.6488606782441251
5491,0.5492,10,4,10,666601,9843,108070,18186,0.07796065137498416,0.648827999571872
5492,0.5493,5,3,5,666604,9840,108075,18181,0.07793689012799392,0.6488348024695764
5493,0.5494,7,3,7,666607,9837,108082,18174,0.07791312888100367,0.6488165363607155
5494,0.5495,8,7,8,666614,9830,108090,18166,0.07785768597135978,0.6488784112016003
5495,0.5496,14,9,14,666623,9821,108104,18152,0.07778640223038905,0.6489114503271012
5496,0.5497,7,7,7,666630,9814,108111,18145,0.07773095932074515,0.6489860152365965
5497,0.5498,8,8,8,666638,9806,108119,18137,0.07766759599543784,0.6490713237662384
5498,0.5499,11,2,11,666640,9804,108130,18126,0.07765175516411102,0.6489795918367347
5499,0.55,10,8,10,666648,9796,108140,18116,0.0775883918388037,0.6490398394955574
5500,0.5501,7,11,7,666659,9785,108147,18109,0.07750126726650615,0.6492077149207715
5501,0.5502,7,4,7,666663,9781,108154,18102,0.07746958560385249,0.6492127819818527
5502,0.5503,11,2,11,666665,9779,108165,18091,0.07745374477252566,0.6491209185504127
5503,0.5504,8,9,8,666674,9770,108173,18083,0.07738246103155494,0.6492298854701468
5504,0.5505,6,9,6,666683,9761,108179,18077,0.0773111772905842,0.6493641784610964
5505,0.5506,6,8,6,666691,9753,108185,18071,0.0772478139652769,0.6494752731454859
5506,0.5507,7,8,7,666699,9745,108192,18064,0.07718445063996958,0.6495738789600489
5507,0.5508,5,9,5,666708,9736,108197,18059,0.07711316689899886,0.6497211728728188
5508,0.5509,5,3,5,666711,9733,108202,18054,0.07708940565200861,0.6497282902076511
5509,0.551,7,9,7,666720,9724,108209,18047,0.07701812191103789,0.6498505635375031
5510,0.5511,4,6,4,666726,9718,108213,18043,0.0769705994170574,0.6499405641007169
5511,0.5512,10,7,10,666733,9711,108223,18033,0.07691515650741351,0.6499783737024222
5512,0.5513,13,8,13,666741,9703,108236,18020,0.07685179318210619,0.6500018035566136
5513,0.5514,9,5,9,666746,9698,108245,18011,0.07681219110378913,0.6500054134035873
5514,0.5515,5,7,5,666753,9691,108250,18006,0.07675674819414523,0.6501065097302957
5515,0.5516,3,4,3,666757,9687,108253,18003,0.07672506653149157,0.6501625135427952
5516,0.5517,8,3,8,666760,9684,108261,17995,0.07670130528450134,0.6501318689259005
5517,0.5518,10,5,10,666765,9679,108271,17985,0.07666170320618426,0.6501229034123771
5518,0.5519,9,6,9,666771,9673,108280,17976,0.07661418071220377,0.6501500958443344
5519,0.552,8,6,8,666777,9667,108288,17968,0.0765666582182233,0.6501899764791026
5520,0.5521,8,10,8,666787,9657,108296,17960,0.07648745406158915,0.6503240757504436
5521,0.5522,7,9,7,666796,9648,108303,17953,0.07641617032061843,0.650447447556248
5522,0.5523,7,10,7,666806,9638,108310,17946,0.07633696616398429,0.6505945475638051
5523,0.5524,8,13,8,666819,9625,108318,17938,0.07623400076035991,0.6507999854877916
5524,0.5525,4,5,4,666824,9620,108322,17934,0.07619439868204284,0.6508673876751107
5525,0.5526,7,7,7,666831,9613,108329,17927,0.07613895577239893,0.6509440813362382
5526,0.5527,11,15,11,666846,9598,108340,17916,0.07602014953744772,0.6511594097550338
5527,0.5528,10,6,10,666852,9592,108350,17906,0.07597262704346724,0.651174630882246
5528,0.5529,7,10,7,666862,9582,108357,17899,0.0758934228868331,0.6513227320694298
5529,0.553,8,6,8,666868,9576,108365,17891,0.07584590039285262,0.6513634543270106
5530,0.5531,5,6,5,666874,9570,108370,17886,0.07579837789887213,0.6514423076923077
5531,0.5532,6,8,6,666882,9562,108376,17880,0.07573501457356482,0.6515560090372422
5532,0.5533,7,9,7,666891,9553,108383,17873,0.07566373083259409,0.6516808867497995
5533,0.5534,10,7,10,666898,9546,108393,17863,0.0756082879229502,0.6517202378780692
5534,0.5535,12,5,12,666903,9541,108405,17851,0.07556868584463312,0.6516866238317757
5535,0.5536,6,12,6,666915,9529,108411,17845,0.07547364085667216,0.6518959596697597
5536,0.5537,6,5,6,666920,9524,108417,17839,0.07543403877835508,0.6519387494061324
5537,0.5538,6,8,6,666928,9516,108423,17833,0.07537067545304778,0.6520530915207138
5538,0.5539,9,10,9,666938,9506,108432,17824,0.07529147129641364,0.6521770947676546
5539,0.554,11,6,11,666944,9500,108443,17813,0.07524394880243315,0.6521802804525317
5540,0.5541,6,5,6,666949,9495,108449,17807,0.07520434672411608,0.6522232803457623
5541,0.5542,4,5,4,666954,9490,108453,17803,0.07516474464579902,0.6522917964313194
5542,0.5543,2,9,2,666963,9481,108455,17801,0.07509346090482828,0.6524814896268603
5543,0.5544,7,2,7,666965,9479,108462,17794,0.07507762007350145,0.652440142265244
5544,0.5545,5,6,5,666971,9473,108467,17789,0.07503009757952098,0.6525199911965373
5545,0.5546,6,5,6,666976,9468,108473,17783,0.0749904955012039,0.6525632086895894
5546,0.5547,3,3,3,666979,9465,108476,17780,0.07496673425421366,0.6525968067535327
5547,0.5548,7,3,7,666982,9462,108483,17773,0.07494297300722341,0.6525794015054158
5548,0.5549,5,6,5,666988,9456,108488,17768,0.07489545051324294,0.6526594181604467
5549,0.555,9,11,9,666999,9445,108497,17759,0.07480832594094539,0.6528084105278635
5550,0.5551,5,7,5,667006,9438,108502,17754,0.07475288303130148,0.6529126213592233
5551,0.5552,5,7,5,667013,9431,108507,17749,0.07469744012165759,0.6530169242089772
5552,0.5553,8,2,8,667015,9429,108515,17741,0.07468159929033076,0.6529628266470372
5553,0.5554,6,12,6,667027,9417,108521,17735,0.0745865543023698,0.653174720094284
5554,0.5555,10,9,10,667036,9408,108531,17725,0.07451527056139906,0.6532635536063096
5555,0.5556,11,6,11,667042,9402,108542,17714,0.07446774806741858,0.6532674435757486
5556,0.5557,10,8,10,667050,9394,108552,17704,0.07440438474211127,0.6533323492508673
5557,0.5558,4,7,4,667057,9387,108556,17700,0.07434894183246737,0.6534499944622881
5558,0.5559,8,7,8,667064,9380,108564,17692,0.07429349892282347,0.6535165484633569
5559,0.556,12,5,12,667069,9375,108576,17680,0.0742538968445064,0.653483644428017
5560,0.5561,6,6,6,667075,9369,108582,17674,0.07420637435052592,0.6535517509152091
5561,0.5562,4,11,4,667086,9358,108586,17670,0.07411924977822835,0.6537664644072814
5562,0.5563,7,4,7,667090,9354,108593,17663,0.07408756811557471,0.6537735499870452
5563,0.5564,8,8,8,667098,9346,108601,17655,0.07402420479026739,0.6538646716788267
5564,0.5565,7,8,7,667106,9338,108608,17648,0.07396084146496008,0.6539687245238271
5565,0.5566,13,8,13,667114,9330,108621,17635,0.07389747813965276,0.6539959206378639
5566,0.5567,10,9,10,667123,9321,108631,17625,0.07382619439868204,0.6540859496771321
5567,0.5568,9,5,9,667128,9316,108640,17616,0.07378659232036497,0.654091786722115
5568,0.5569,7,8,7,667136,9308,108647,17609,0.07372322899505766,0.6541962328639893
5569,0.557,9,9,9,667145,9299,108656,17600,0.07365194525408693,0.6542994163351797
5570,0.5571,7,9,7,667154,9290,108663,17593,0.07358066151311621,0.6544284492058178
5571,0.5572,11,5,11,667159,9285,108674,17582,0.07354105943479913,0.6544087542338184
5572,0.5573,8,6,8,667165,9279,108682,17574,0.07349353694081866,0.6544520165344654
5573,0.5574,5,3,5,667168,9276,108687,17569,0.07346977569382841,0.6544607934438443
5574,0.5575,5,10,5,667178,9266,108692,17564,0.07339057153719428,0.6546403279910548
5575,0.5576,6,8,6,667186,9258,108698,17558,0.07332720821188696,0.6547583532219571
5576,0.5577,9,5,9,667191,9253,108707,17549,0.0732876061335699,0.6547645698082233
5577,0.5578,11,10,11,667201,9243,108718,17538,0.07320840197693575,0.6548672566371682
5578,0.5579,3,4,3,667205,9239,108721,17535,0.07317672031428209,0.6549264211548517
5579,0.558,2,4,2,667209,9235,108723,17533,0.07314503865162844,0.654998505678422
5580,0.5581,7,6,7,667215,9229,108730,17526,0.07309751615764795,0.655055129882265
5581,0.5582,5,8,5,667223,9221,108735,17521,0.07303415283234065,0.6551865978610426
5582,0.5583,7,13,7,667236,9208,108742,17514,0.07293118742871627,0.655415013846269
5583,0.5584,9,8,9,667244,9200,108751,17505,0.07286782410340895,0.6554952256131811
5584,0.5585,5,6,5,667250,9194,108756,17500,0.07282030160942846,0.6555780325166705
5585,0.5586,12,4,12,667254,9190,108768,17488,0.07278861994677481,0.6555214034035535
5586,0.5587,5,5,5,667259,9185,108773,17483,0.07274901786845774,0.6555797210139493
5587,0.5588,5,5,5,667264,9180,108778,17478,0.07270941579014066,0.6556380823767725
5588,0.5589,7,4,7,667268,9176,108785,17471,0.07267773412748701,0.6556460389537284
5589,0.559,7,4,7,667272,9172,108792,17464,0.07264605246483335,0.6556540021024178
5590,0.5591,13,9,13,667281,9163,108805,17451,0.07257476872386263,0.6557075223566544
5591,0.5592,6,6,6,667287,9157,108811,17445,0.07252724622988214,0.6557777610705962
5592,0.5593,8,7,8,667294,9150,108819,17437,0.07247180332023824,0.6558468424417948
5593,0.5594,9,8,9,667302,9142,108828,17428,0.07240843999493093,0.6559277380504328
5594,0.5595,3,10,3,667312,9132,108831,17425,0.0723292358382968,0.6561358587189818
5595,0.5596,8,8,8,667320,9124,108839,17417,0.07226587251298948,0.6562299837986512
5596,0.5597,9,11,9,667331,9113,108848,17408,0.07217874794069193,0.6563855058255722
5597,0.5598,8,9,8,667340,9104,108856,17400,0.07210746419972121,0.6565046785390884
5598,0.5599,11,5,11,667345,9099,108867,17389,0.07206786212140413,0.6564859559045606
5599,0.56,6,6,6,667351,9093,108873,17383,0.07202033962742364,0.6565568817041849
5600,0.5601,7,11,7,667362,9082,108880,17376,0.07193321505512609,0.6567389825383627
5601,0.5602,12,4,12,667366,9078,108892,17364,0.07190153339247243,0.6566825504878602
5602,0.5603,5,6,5,667372,9072,108897,17359,0.07185401089849196,0.6567666754946843
5603,0.5604,12,7,12,667379,9065,108909,17347,0.07179856798884805,0.6567847947902469
5604,0.5605,14,9,14,667388,9056,108923,17333,0.07172728424787733,0.6568267080980712
5605,0.5606,4,2,4,667390,9054,108927,17329,0.0717114434165505,0.6568244703028465
5606,0.5607,10,8,10,667398,9046,108937,17319,0.07164808009124318,0.6568936089512611
5607,0.5608,8,7,8,667405,9039,108945,17311,0.07159263718159929,0.6569639468690702
5608,0.5609,4,5,4,667410,9034,108949,17307,0.07155303510328222,0.6570365589765005
5609,0.561,8,7,8,667417,9027,108957,17299,0.07149759219363833,0.6571070424675226
5610,0.5611,8,7,8,667424,9020,108965,17291,0.07144214928399442,0.6571776063243511
5611,0.5612,12,7,12,667431,9013,108977,17279,0.07138670637435053,0.6571961052791724
5612,0.5613,9,3,9,667434,9010,108986,17270,0.07136294512736029,0.6571537290715372
5613,0.5614,11,6,11,667440,9004,108997,17259,0.0713154226333798,0.657160263488558
5614,0.5615,9,4,9,667444,9000,109006,17250,0.07128374097072615,0.6571428571428571
5615,0.5616,8,9,8,667453,8991,109014,17242,0.07121245722975542,0.6572637517630465
5616,0.5617,12,7,12,667460,8984,109026,17230,0.07115701432011153,0.6572823682001984
5617,0.5618,5,6,5,667466,8978,109031,17225,0.07110949182613104,0.6573674770064496
5618,0.5619,7,8,7,667474,8970,109038,17218,0.07104612850082373,0.6574767068886513
5619,0.562,10,4,10,667478,8966,109048,17208,0.07101444683817007,0.6574463207763429
5620,0.5621,6,3,6,667481,8963,109054,17202,0.07099068559117983,0.6574431492451749
5621,0.5622,6,7,6,667488,8956,109060,17196,0.07093524268153592,0.6575405322728664
5622,0.5623,6,9,6,667497,8947,109066,17190,0.0708639589405652,0.6576883345448981
5623,0.5624,12,5,12,667502,8942,109078,17178,0.07082435686224813,0.657656967840735
5624,0.5625,5,5,5,667507,8937,109083,17173,0.07078475478393106,0.6577173496744543
5625,0.5626,9,6,9,667513,8931,109092,17164,0.07073723228995057,0.6577505269208661
5626,0.5627,5,4,5,667517,8927,109097,17159,0.07070555062729691,0.6577857854788008
5627,0.5628,11,4,11,667521,8923,109108,17148,0.07067386896464327,0.65774231905182
5628,0.5629,6,10,6,667531,8913,109114,17142,0.07059466480800912,0.657915947035118
5629,0.563,6,10,6,667541,8903,109120,17136,0.07051546065137498,0.6580897883943316
5630,0.5631,3,8,3,667549,8895,109123,17133,0.07045209732606768,0.6582526509912402
5631,0.5632,3,4,3,667553,8891,109126,17130,0.07042041566341402,0.6583144383382652
5632,0.5633,7,8,7,667561,8883,109133,17123,0.0703570523381067,0.6584249788510343
5633,0.5634,6,8,6,667569,8875,109139,17117,0.07029368901279939,0.658548784241305
5634,0.5635,8,6,8,667575,8869,109147,17109,0.0702461665188189,0.6585957348525675
5635,0.5636,8,4,8,667579,8865,109155,17101,0.07021448485616526,0.6585920049295232
5636,0.5637,6,6,6,667585,8859,109161,17095,0.07016696236218477,0.658665330970178
5637,0.5638,7,6,7,667591,8853,109168,17088,0.07011943986820428,0.6587255695616977
5638,0.5639,4,8,4,667599,8845,109172,17084,0.07005607654289697,0.6588761618265263
5639,0.564,5,7,5,667606,8838,109177,17079,0.07000063363325307,0.6589883088320407
5640,0.5641,7,9,7,667615,8829,109184,17072,0.06992934989228235,0.6591251303038492
5641,0.5642,6,5,6,667620,8824,109190,17066,0.06988974781396527,0.6591734260332175
5642,0.5643,6,8,6,667628,8816,109196,17060,0.06982638448865797,0.6592981913742464
5643,0.5644,8,4,8,667632,8812,109204,17052,0.0697947028260043,0.6592947726569749
5644,0.5645,7,5,7,667637,8807,109211,17045,0.06975510074768723,0.6593300324926504
5645,0.5646,10,6,10,667643,8801,109221,17035,0.06970757825370676,0.6593512927697786
5646,0.5647,6,7,6,667650,8794,109227,17029,0.06965213534406285,0.6594508771250436
5647,0.5648,6,4,6,667654,8790,109233,17023,0.0696204536814092,0.6594739084957192
5648,0.5649,6,2,6,667656,8788,109239,17017,0.06960461285008238,0.6594458438287154
5649,0.565,5,7,5,667663,8781,109244,17012,0.06954916994043847,0.6595587950219052
5650,0.5651,6,4,6,667667,8777,109250,17006,0.06951748827778481,0.6595818950471241
5651,0.5652,8,7,8,667674,8770,109258,16998,0.06946204536814092,0.6596553865259236
5652,0.5653,4,12,4,667686,8758,109262,16994,0.06936700038017996,0.6599099099099099
5653,0.5654,5,5,5,667691,8753,109267,16989,0.06932739830186288,0.6599720301452878
5654,0.5655,5,6,5,667697,8747,109272,16984,0.0692798758078824,0.6600598499863978
5655,0.5656,9,6,9,667703,8741,109281,16975,0.06923235331390191,0.6600948825633847
5656,0.5657,5,9,5,667712,8732,109286,16970,0.0691610695729312,0.6602599019531554
5657,0.5658,10,10,10,667722,8722,109296,16960,0.06908186541629704,0.6603847052410249
5658,0.5659,12,3,12,667725,8719,109308,16948,0.0690581041693068,0.6603031129465851
5659,0.566,6,4,6,667729,8715,109314,16942,0.06902642250665315,0.6603266165179094
5660,0.5661,13,7,13,667736,8708,109327,16929,0.06897097959700925,0.6603346725435894
5661,0.5662,11,6,11,667742,8702,109338,16918,0.06892345710302877,0.660343481654957
5662,0.5663,5,5,5,667747,8697,109343,16913,0.0688838550247117,0.6604060913705584
5663,0.5664,7,10,7,667757,8687,109350,16906,0.06880465086807756,0.6605712499511586
5664,0.5665,9,6,9,667763,8681,109359,16897,0.06875712837409707,0.6606067714442099
5665,0.5666,9,5,9,667768,8676,109368,16888,0.06871752629578,0.6606164919417932
5666,0.5667,8,7,8,667775,8669,109376,16880,0.06866208338613611,0.6606912207914204
5667,0.5668,12,6,12,667781,8663,109388,16868,0.06861456089215562,0.6606870079511182
5668,0.5669,5,4,5,667785,8659,109393,16863,0.06858287922950196,0.6607240811848601
5669,0.567,8,5,8,667790,8654,109401,16855,0.0685432771511849,0.660747187267239
5670,0.5671,6,3,6,667793,8651,109407,16849,0.06851951590419465,0.6607450980392157
5671,0.5672,10,2,10,667795,8649,109417,16839,0.06850367507286782,0.6606638418079096
5672,0.5673,5,6,5,667801,8643,109422,16834,0.06845615257888733,0.6607528358911959
5673,0.5674,3,3,3,667804,8640,109425,16831,0.0684323913318971,0.6607907031526049
5674,0.5675,7,8,7,667812,8632,109432,16824,0.06836902800658978,0.6609050911376493
5675,0.5676,4,3,4,667815,8629,109436,16820,0.06834526675959954,0.6609297025423396
5676,0.5677,4,13,4,667828,8616,109440,16816,0.06824230135597516,0.6612142183076439
5677,0.5678,10,7,10,667835,8609,109450,16806,0.06818685844633127,0.6612630336415503
5678,0.5679,8,11,8,667846,8598,109458,16798,0.06809973387403372,0.6614427468892738
5679,0.568,7,8,7,667854,8590,109465,16791,0.0680363705487264,0.661557858240416
5680,0.5681,9,7,9,667861,8583,109474,16782,0.0679809276390825,0.6616203429923122
5681,0.5682,7,3,7,667864,8580,109481,16775,0.06795716639209226,0.6616052060737527
5682,0.5683,10,10,10,667874,8570,109491,16765,0.06787796223545811,0.6617327807381094
5683,0.5684,7,5,7,667879,8565,109498,16758,0.06783836015714105,0.6617699324724559
5684,0.5685,7,3,7,667882,8562,109505,16751,0.0678145989101508,0.6617548295342314
5685,0.5686,2,7,2,667889,8555,109507,16749,0.0677591560005069,0.661911160290863
5686,0.5687,3,2,3,667891,8553,109510,16746,0.06774331516918009,0.6619233961816673
5687,0.5688,16,5,16,667896,8548,109526,16730,0.06770371309086301,0.6618403354695783
5688,0.5689,5,7,5,667903,8541,109531,16725,0.0676482701812191,0.6619567798622655
5689,0.569,4,3,4,667906,8538,109535,16721,0.06762450893422887,0.6619818678490835
5690,0.5691,6,6,6,667912,8532,109541,16715,0.06757698644024838,0.6620588584782351
5691,0.5692,11,5,11,667917,8527,109552,16704,0.06753738436193131,0.6620427252189767
5692,0.5693,5,5,5,667922,8522,109557,16699,0.06749778228361425,0.6621069743467746
5693,0.5694,9,7,9,667929,8515,109566,16690,0.06744233937397034,0.6621702043245388
5694,0.5695,8,3,8,667932,8512,109574,16682,0.0674185781269801,0.6621417797888386
5695,0.5696,4,6,4,667938,8506,109578,16678,0.06737105563299962,0.6622458703939009
5696,0.5697,7,12,7,667950,8494,109585,16671,0.06727601064503864,0.6624677130935823
5697,0.5698,6,6,6,667956,8488,109591,16665,0.06722848815105817,0.662545223233809
5698,0.5699,12,9,12,667965,8479,109603,16653,0.06715720441008745,0.662621359223301
5699,0.57,6,9,6,667974,8470,109609,16647,0.06708592066911671,0.6627781980332046
5700,0.5701,9,6,9,667980,8464,109618,16638,0.06703839817513624,0.6628157118954665
5701,0.5702,7,8,7,667988,8456,109625,16631,0.06697503484982892,0.6629329931837207
5702,0.5703,7,14,7,668002,8442,109632,16624,0.06686414903054112,0.6632091279023379
5703,0.5704,13,5,13,668007,8437,109645,16611,0.06682454695222405,0.6631667198977962
5704,0.5705,9,9,9,668016,8428,109654,16602,0.06675326321125333,0.6632840591290452
5705,0.5706,6,5,6,668021,8423,109660,16596,0.06671366113293625,0.6633358647427955
5706,0.5707,8,4,8,668025,8419,109668,16588,0.0666819794702826,0.6633342664054065
5707,0.5708,7,3,7,668028,8416,109675,16581,0.06665821822329236,0.6633195983518022
5708,0.5709,8,10,8,668038,8406,109683,16573,0.06657901406665821,0.6634773209495977
5709,0.571,14,7,14,668045,8399,109697,16559,0.06652357115701432,0.6634746373908166
5710,0.5711,4,4,4,668049,8395,109701,16555,0.06649188949436066,0.6635270541082164
5711,0.5712,9,6,9,668055,8389,109710,16546,0.06644436700038019,0.6635652697012232
5712,0.5713,12,6,12,668061,8383,109722,16534,0.0663968445063997,0.6635630292571337
5713,0.5714,9,5,9,668066,8378,109731,16525,0.06635724242808262,0.6635746697185078
5714,0.5715,9,6,9,668072,8372,109740,16516,0.06630971993410215,0.6636129861780777
5715,0.5716,7,8,7,668080,8364,109747,16509,0.06624635660879483,0.6637317573272223
5716,0.5717,4,6,4,668086,8358,109751,16505,0.06619883411481435,0.6638378313156096
5717,0.5718,6,9,6,668095,8349,109757,16499,0.06612755037384362,0.6639971023824855
5718,0.5719,5,6,5,668101,8343,109762,16494,0.06608002787986314,0.6640898659258364
5719,0.572,5,4,5,668105,8339,109767,16489,0.06604834621720948,0.6641292089576285
5720,0.5721,3,2,3,668107,8337,109770,16486,0.06603250538588265,0.6641421262538775
5721,0.5722,4,4,4,668111,8333,109774,16482,0.06600082372322899,0.6641950433205722
5722,0.5723,10,3,10,668114,8330,109784,16472,0.06597706247623876,0.6641399887105879
5723,0.5724,12,4,12,668118,8326,109796,16460,0.0659453808135851,0.6640845638666989
5724,0.5725,7,3,7,668121,8323,109803,16453,0.06592161956659486,0.6640700678075557
5725,0.5726,4,5,4,668126,8318,109807,16449,0.06588201748827778,0.6641498768522631
5726,0.5727,12,8,12,668134,8310,109819,16437,0.06581865416297047,0.6642017214207783
5727,0.5728,11,4,11,668138,8306,109830,16426,0.06578697250031681,0.6641597929807537
5728,0.5729,5,1,5,668139,8305,109835,16421,0.0657790520846534,0.6641187414058076
5729,0.573,9,8,9,668147,8297,109844,16412,0.0657156887593461,0.6642114209397385
5730,0.5731,9,7,9,668154,8290,109853,16403,0.06566024584970219,0.6642773255578504
5731,0.5732,5,4,5,668158,8286,109858,16398,0.06562856418704853,0.6643169664560039
5732,0.5733,8,8,8,668166,8278,109866,16390,0.06556520086174122,0.6644235446732609
5733,0.5734,9,8,9,668174,8270,109875,16381,0.06550183753643392,0.6645166524684597
5734,0.5735,4,1,4,668175,8269,109879,16377,0.0654939171207705,0.6644891665990424
5735,0.5736,8,5,8,668180,8264,109887,16369,0.06545431504245343,0.6645150813948768
5736,0.5737,5,3,5,668183,8261,109892,16364,0.06543055379546318,0.6645279187817259
5737,0.5738,7,4,7,668187,8257,109899,16357,0.06539887213280952,0.6645405054034289
5738,0.5739,7,6,7,668193,8251,109906,16350,0.06535134963882905,0.6646071297914719
5739,0.574,5,4,5,668197,8247,109911,16345,0.06531966797617539,0.6646470396877033
5740,0.5741,9,5,9,668202,8242,109920,16336,0.06528006589785831,0.6646594515420294
5741,0.5742,2,7,2,668209,8235,109922,16334,0.06522462298821442,0.6648215230575115
5742,0.5743,6,5,6,668214,8230,109928,16328,0.06518502090989735,0.6648749898200179
5743,0.5744,9,6,9,668220,8224,109937,16319,0.06513749841591687,0.6649146396121094
5744,0.5745,7,4,7,668224,8220,109944,16312,0.06510581675326321,0.6649274417087885
5745,0.5746,8,3,8,668227,8217,109952,16304,0.06508205550627297,0.6648994739203132
5746,0.5747,3,12,3,668239,8205,109955,16301,0.064987010518312,0.6651840365624745
5747,0.5748,15,4,15,668243,8201,109970,16286,0.06495532885565834,0.6650875975007147
5748,0.5749,13,3,13,668246,8198,109983,16273,0.0649315676086681,0.6649912140901475
5749,0.575,3,10,3,668256,8188,109986,16270,0.06485236345203396,0.6652220132471993
5750,0.5751,2,8,2,668264,8180,109988,16268,0.06478900012672666,0.6654123036649214
5751,0.5752,6,6,6,668270,8174,109994,16262,0.06474147763274617,0.6654935341299721
5752,0.5753,9,6,9,668276,8168,110003,16253,0.06469395513876568,0.665533761926211
5753,0.5754,11,8,11,668284,8160,110014,16242,0.06463059181345837,0.6656011802311286
5754,0.5755,10,4,10,668288,8156,110024,16232,0.06459891015080471,0.6655732327374119
5755,0.5756,9,9,9,668297,8147,110033,16223,0.06452762640983399,0.6656955272876488
5756,0.5757,9,5,9,668302,8142,110042,16214,0.06448802433151692,0.665708654951552
5757,0.5758,9,7,9,668309,8135,110051,16205,0.06443258142187303,0.6657764995891536
5758,0.5759,7,7,7,668316,8128,110058,16198,0.06437713851222912,0.6658719066019897
5759,0.576,9,7,9,668323,8121,110067,16189,0.06432169560258523,0.6659399424105307
5760,0.5761,9,5,9,668328,8116,110076,16180,0.06428209352426816,0.6659532433322357
5761,0.5762,6,7,6,668335,8109,110082,16174,0.06422665061462425,0.6660626775933781
5762,0.5763,6,8,6,668343,8101,110088,16168,0.06416328728931694,0.6661996786023322
5763,0.5764,11,9,11,668352,8092,110099,16157,0.06409200354834621,0.6662955173409213
5764,0.5765,4,7,4,668359,8085,110103,16153,0.06403656063870232,0.6664328739995049
5765,0.5766,11,10,11,668369,8075,110114,16142,0.06395735648206818,0.6665565511830532
5766,0.5767,5,4,5,668373,8071,110119,16137,0.06392567481941452,0.6665978189028421
5767,0.5768,8,3,8,668376,8068,110127,16129,0.06390191357242428,0.6665702359796669
5768,0.5769,6,7,6,668383,8061,110133,16123,0.06384647066278039,0.6666804498842209
5769,0.577,7,5,7,668388,8056,110140,16116,0.06380686858446331,0.6667218269071653
5770,0.5771,9,10,9,668398,8046,110149,16107,0.06372766442782918,0.666873680288163
5771,0.5772,4,6,4,668404,8040,110153,16103,0.06368014193384869,0.6669842190282897
5772,0.5773,7,9,7,668413,8031,110160,16096,0.06360885819287797,0.6671364031997348
5773,0.5774,5,5,5,668418,8026,110165,16091,0.0635692561145609,0.6672057055189285
5774,0.5775,9,1,9,668419,8025,110174,16082,0.06356133569889748,0.667109138424524
5775,0.5776,13,7,13,668426,8018,110187,16069,0.06350589278925357,0.6671233445426994
5776,0.5777,5,8,5,668434,8010,110192,16064,0.06344252946394627,0.6672758993104594
5777,0.5778,7,8,7,668442,8002,110199,16057,0.06337916613863896,0.6674009726090029
5778,0.5779,8,12,8,668454,7990,110207,16049,0.06328412115067798,0.6676234452348268
5779,0.578,8,4,8,668458,7986,110215,16041,0.06325243948802434,0.6676239230865276
5780,0.5781,7,7,7,668465,7979,110222,16034,0.06319699657838043,0.6677216507724982
5781,0.5782,12,6,12,668471,7973,110234,16022,0.06314947408439994,0.6677224421754532
5782,0.5783,5,9,5,668480,7964,110239,16017,0.06307819034342922,0.66790375714107
5783,0.5784,7,12,7,668492,7952,110246,16010,0.06298314535546826,0.6681412236040397
5784,0.5785,4,8,4,668500,7944,110250,16006,0.06291978203016094,0.6683089770354906
5785,0.5786,9,3,9,668503,7941,110259,15997,0.0628960207831707,0.6682680257331439
5786,0.5787,5,6,5,668509,7935,110264,15992,0.06284849828919022,0.6683662807706775
5787,0.5788,11,4,11,668513,7931,110275,15981,0.06281681662653656,0.6683255269320844
5788,0.5789,6,6,6,668519,7925,110281,15975,0.06276929413255608,0.6684100418410042
5789,0.579,6,4,6,668523,7921,110287,15969,0.06273761246990242,0.6684386772708246
5790,0.5791,11,8,11,668531,7913,110298,15958,0.06267424914459511,0.668509907419044
5791,0.5792,5,7,5,668538,7906,110303,15953,0.06261880623495121,0.6686365732008885
5792,0.5793,9,3,9,668541,7903,110312,15944,0.06259504498796097,0.6685956304776283
5793,0.5794,3,6,3,668547,7897,110315,15941,0.06254752249398049,0.6687222082389462
5794,0.5795,9,6,9,668553,7891,110324,15932,0.0625,0.6687654787390337
5795,0.5796,2,4,2,668557,7887,110326,15930,0.06246831833734635,0.6688499811059327
5796,0.5797,5,7,5,668564,7880,110331,15925,0.06241287542770244,0.6689771056500735
5797,0.5798,12,3,12,668567,7877,110343,15913,0.062389114180712205,0.6688944934846575
5798,0.5799,7,3,7,668570,7874,110350,15906,0.06236535293372196,0.6688814129520606
5799,0.58,4,4,4,668574,7870,110354,15902,0.06233367127106831,0.6689382466767626
5800,0.5801,12,5,12,668579,7865,110366,15890,0.06229406919275123,0.6689118080404125
5801,0.5802,7,8,7,668587,7857,110373,15883,0.062230705867443926,0.6690395956192081
5802,0.5803,2,12,2,668599,7845,110375,15881,0.062135660879482954,0.6693500800809239
5803,0.5804,4,4,4,668603,7841,110379,15877,0.0621039792168293,0.6694072012817269
5804,0.5805,5,1,5,668604,7840,110384,15872,0.062096058801165886,0.6693657219973009
5805,0.5806,5,5,5,668609,7835,110389,15867,0.06205645672284882,0.6694371782971901
5806,0.5807,11,7,11,668616,7828,110400,15856,0.062001013813204914,0.66948150650228
5807,0.5808,5,2,5,668618,7826,110405,15851,0.06198517298187809,0.669468260337036
5808,0.5809,4,10,4,668628,7816,110409,15847,0.06190596882524395,0.669695304906394
5809,0.581,11,7,11,668635,7809,110420,15836,0.06185052591560005,0.6697399027278494
5810,0.5811,5,11,5,668646,7798,110425,15831,0.06176340134330249,0.6699818020229379
5811,0.5812,4,4,4,668650,7794,110429,15827,0.06173171968064884,0.6700393717454807
5812,0.5813,13,7,13,668657,7787,110442,15814,0.06167627677100494,0.6700563535443413
5813,0.5814,9,6,9,668663,7781,110451,15805,0.06162875427702446,0.6701009073179004
5814,0.5815,7,3,7,668666,7778,110458,15798,0.061604993030034215,0.6700882253138786
5815,0.5816,9,6,9,668672,7772,110467,15789,0.06155747053605373,0.6701328466533678
5816,0.5817,11,4,11,668676,7768,110478,15778,0.06152578887340008,0.6700925847277669
5817,0.5818,6,5,6,668681,7763,110484,15772,0.061486186795083005,0.6701508391756957
5818,0.5819,8,5,8,668686,7758,110492,15764,0.06144658471676594,0.6701811070487204
5819,0.582,9,7,9,668693,7751,110501,15755,0.06139114180712204,0.6702544031311155
5820,0.5821,4,2,4,668695,7749,110505,15751,0.06137530097579521,0.6702553191489362
5821,0.5822,7,4,7,668699,7745,110512,15744,0.061343619313141556,0.6702711907701477
5822,0.5823,10,4,10,668703,7741,110522,15734,0.0613119376504879,0.67024494142705
5823,0.5824,7,2,7,668705,7739,110529,15727,0.06129609681916107,0.6702036989687207
5824,0.5825,8,2,8,668707,7737,110537,15719,0.061280255987834244,0.6701483628922238
5825,0.5826,5,3,5,668710,7734,110542,15714,0.061256494740844,0.6701637666325486
5826,0.5827,7,8,7,668718,7726,110549,15707,0.061193131415536686,0.6702940297870524
5827,0.5828,9,2,9,668720,7724,110558,15698,0.061177290584209856,0.6702245751857229
5828,0.5829,8,9,8,668729,7715,110566,15690,0.061106006843239136,0.6703695791497544
5829,0.583,11,5,11,668734,7710,110577,15679,0.06106640476492206,0.670357860532729
5830,0.5831,9,5,9,668739,7705,110586,15670,0.06102680268660499,0.6703743315508022
5831,0.5832,9,9,9,668748,7696,110595,15661,0.060955518945634266,0.6705056300038532
5832,0.5833,9,5,9,668753,7691,110604,15652,0.0609159168673172,0.6705222122263633
5833,0.5834,6,7,6,668760,7684,110610,15646,0.0608604739576733,0.6706386626660952
5834,0.5835,5,3,5,668763,7681,110615,15641,0.060836712710683055,0.6706543178115084
5835,0.5836,9,7,9,668770,7674,110624,15632,0.06078126980103916,0.6707285677507938
5836,0.5837,6,10,6,668780,7664,110630,15626,0.060702065644405015,0.6709317303563761
5837,0.5838,7,1,7,668781,7663,110637,15619,0.06069414522874161,0.6708616098273344
5838,0.5839,6,5,6,668786,7658,110643,15613,0.06065454315042453,0.6709208886597052
5839,0.584,5,3,5,668789,7655,110648,15608,0.060630781903434294,0.6709366805657052
5840,0.5841,10,5,10,668794,7650,110658,15598,0.06059117982511722,0.6709394356503785
5841,0.5842,7,7,7,668801,7643,110665,15591,0.06053573691547332,0.6710424378066626
5842,0.5843,7,6,7,668807,7637,110672,15584,0.06048821442149284,0.6711166616424787
5843,0.5844,5,5,5,668812,7632,110677,15579,0.06044861234317577,0.671190383869717
5844,0.5845,8,7,8,668819,7625,110685,15571,0.060393169433531874,0.6712795309536127
5845,0.5846,6,3,6,668822,7622,110691,15565,0.06036940818654163,0.6712813214301117
5846,0.5847,6,8,6,668830,7614,110697,15559,0.060306044861234316,0.6714279549475682
5847,0.5848,10,6,10,668836,7608,110707,15549,0.06025852236725383,0.6714600336831196
5848,0.5849,4,7,4,668843,7601,110711,15545,0.060203079457609936,0.6716063250669663
5849,0.585,11,5,11,668848,7596,110722,15534,0.06016347737929287,0.6715953307392996
5850,0.5851,8,6,8,668854,7590,110730,15526,0.06011595488531238,0.6716559958470324
5851,0.5852,11,4,11,668858,7586,110741,15515,0.060084273222658725,0.671615947361586
5852,0.5853,7,3,7,668861,7583,110748,15508,0.06006051197566848,0.6716036551037201
5853,0.5854,7,4,7,668865,7579,110755,15501,0.06002883031301483,0.6716204506065858
5854,0.5855,8,11,8,668876,7568,110763,15493,0.05994170574071727,0.6718268938901175
5855,0.5856,5,7,5,668883,7561,110768,15488,0.05988626283107337,0.6719597379495856
5856,0.5857,6,5,6,668888,7556,110774,15482,0.059846660752756305,0.672020140637208
5857,0.5858,6,11,6,668899,7545,110780,15476,0.05975953618045875,0.6722557664740889
5858,0.5859,11,4,11,668903,7541,110791,15465,0.059727854517805094,0.6722159436668695
5859,0.586,10,10,10,668913,7531,110801,15455,0.05964865036117095,0.672365787870878
5860,0.5861,8,3,8,668916,7528,110809,15447,0.059624889114180714,0.6723394994559304
5861,0.5862,3,7,3,668923,7521,110812,15444,0.059569446204536816,0.6725016329196604
5862,0.5863,6,14,6,668937,7507,110818,15438,0.05945856038524902,0.6728263238178253
5863,0.5864,7,5,7,668942,7502,110825,15431,0.059418958306931946,0.6728731522260498
5864,0.5865,5,6,5,668948,7496,110830,15426,0.05937143581295146,0.6729779251374226
5865,0.5866,11,6,11,668954,7490,110841,15415,0.05932391331897098,0.6729971621916612
5866,0.5867,11,7,11,668961,7483,110852,15404,0.05926847040932708,0.6730458338794949
5867,0.5868,9,4,9,668965,7479,110861,15395,0.05923678874667342,0.6730348867710064
5868,0.5869,5,4,5,668969,7475,110866,15390,0.05920510708401977,0.6730811283621255
5869,0.587,11,7,11,668976,7468,110877,15379,0.05914966417437587,0.6731299514159408
5870,0.5871,6,4,6,668980,7464,110883,15373,0.05911798251172221,0.6731619739895783
5871,0.5872,5,7,5,668987,7457,110888,15368,0.059062539602078315,0.6732968236582695
5872,0.5873,3,6,3,668993,7451,110891,15365,0.05901501710809783,0.6734309256661991
5873,0.5874,7,3,7,668996,7448,110898,15358,0.058991255861107594,0.6734192756292203
5874,0.5875,4,7,4,669003,7441,110902,15354,0.05893581295146369,0.6735687650800615
5875,0.5876,5,7,5,669010,7434,110907,15349,0.05888037004181979,0.6737040776017206
5876,0.5877,10,9,10,669019,7425,110917,15339,0.05880908630084907,0.6738270954138113
5877,0.5878,9,4,9,669023,7421,110926,15330,0.05877740463819541,0.6738165355368995
5878,0.5879,9,9,9,669032,7412,110935,15321,0.058706120897224684,0.6739541635507852
5879,0.588,5,4,5,669036,7408,110940,15316,0.05867443923457103,0.6740010561520859
5880,0.5881,6,4,6,669040,7404,110946,15310,0.05864275757191737,0.6740336356432156
5881,0.5882,5,9,5,669049,7395,110951,15305,0.05857147383094665,0.6742290748898678
5882,0.5883,6,4,6,669053,7391,110957,15299,0.05853979216829299,0.6742617893345086
5883,0.5884,9,6,9,669059,7385,110966,15290,0.05849226967431251,0.674310915104741
5884,0.5885,3,6,3,669065,7379,110969,15287,0.058444747180332025,0.6744463072443307
5885,0.5886,7,4,7,669069,7375,110976,15280,0.058413065517678366,0.6744647980578239
5886,0.5887,9,4,9,669073,7371,110985,15271,0.05838138385502471,0.6744545534846745
5887,0.5888,5,6,5,669079,7365,110990,15266,0.05833386136104423,0.6745614422694534
5888,0.5889,6,3,6,669082,7362,110996,15260,0.058310100114053985,0.6745645831491468
5889,0.589,4,5,4,669087,7357,111000,15256,0.05827049803573692,0.6746561712289391
5890,0.5891,6,7,6,669094,7350,111006,15250,0.05821505512609302,0.6747787610619469
5891,0.5892,2,4,2,669098,7346,111008,15248,0.05818337346343936,0.6748694343631052
5892,0.5893,6,3,6,669101,7343,111014,15242,0.05815961221644912,0.6748727031215408
5893,0.5894,11,5,11,669106,7338,111025,15231,0.05812001013813205,0.6748637511630998
5894,0.5895,2,7,2,669113,7331,111027,15229,0.05806456722848815,0.6750443262411348
5895,0.5896,4,5,4,669118,7326,111031,15225,0.05802496515017108,0.6751363575894639
5896,0.5897,8,1,8,669119,7325,111039,15217,0.05801704473450767,0.6750510158814657
5897,0.5898,5,8,5,669127,7317,111044,15212,0.057953681409200354,0.6752186071285898
5898,0.5899,10,5,10,669132,7312,111054,15202,0.057914079330883286,0.6752243048769655
5899,0.59,13,5,13,669137,7307,111067,15189,0.05787447725256621,0.6751866998577525
5900,0.5901,11,4,11,669141,7303,111078,15178,0.05784279558991256,0.6751479026733687
5901,0.5902,3,3,3,669144,7300,111081,15175,0.057819034342922314,0.675194660734149
5902,0.5903,5,6,5,669150,7294,111086,15170,0.05777151184894183,0.6753027065527065
5903,0.5904,6,5,6,669155,7289,111092,15164,0.05773190977062476,0.6753663207589187
5904,0.5905,6,10,6,669165,7279,111098,15158,0.05765270561399062,0.6755805143290101
5905,0.5906,9,0,9,669165,7279,111107,15149,0.05765270561399062,0.675450329944712
5906,0.5907,4,4,4,669169,7275,111111,15145,0.05762102395133697,0.6755129348795718
5907,0.5908,4,5,4,669174,7270,111115,15141,0.05758142187301989,0.6756057293293471
5908,0.5909,4,8,4,669182,7262,111119,15137,0.05751805854771258,0.6757890977275771
5909,0.591,6,6,6,669188,7256,111125,15131,0.0574705360537321,0.6758833251440568
5910,0.5911,4,6,4,669194,7250,111129,15127,0.057423013559751615,0.67600661393395
5911,0.5912,9,3,9,669197,7247,111138,15118,0.05739925231276138,0.6759669125866309
5912,0.5913,6,6,6,669203,7241,111144,15112,0.05735172981878089,0.6760613787858453
5913,0.5914,14,3,14,669206,7238,111158,15098,0.05732796857179065,0.6759491404011462
5914,0.5915,6,5,6,669211,7233,111164,15092,0.057288366493473575,0.676013437849944
5915,0.5916,11,6,11,669217,7227,111175,15081,0.05724084399949309,0.6760355029585798
5916,0.5917,4,2,4,669219,7225,111179,15077,0.05722500316816626,0.6760380234956506
5917,0.5918,12,5,12,669224,7220,111191,15065,0.057185401089849194,0.6760152568992596
5918,0.5919,9,2,9,669226,7218,111200,15056,0.057169560258522364,0.6759450480380713
5919,0.592,8,5,8,669231,7213,111208,15048,0.0571299581802053,0.6759804141772607
5920,0.5921,3,4,3,669235,7209,111211,15045,0.057098276517551644,0.6760582367214882
5921,0.5922,9,7,9,669242,7202,111220,15036,0.057042833607907746,0.6761399406421441
5922,0.5923,9,5,9,669247,7197,111229,15027,0.05700323152959067,0.6761609071274298
5923,0.5924,1,3,1,669250,7194,111230,15026,0.05697947028260043,0.6762376237623763
5924,0.5925,6,6,6,669256,7188,111236,15020,0.056931947788619944,0.6763328530259366
5925,0.5926,9,4,9,669260,7184,111245,15011,0.05690026612596629,0.6763234962829466
5926,0.5927,4,4,4,669264,7180,111249,15007,0.05686858446331264,0.6763870735115157
5927,0.5928,4,2,4,669266,7178,111253,15003,0.05685274363198581,0.6763897028988775
5928,0.5929,9,3,9,669269,7175,111262,14994,0.05682898238499556,0.6763498579096937
5929,0.593,4,4,4,669273,7171,111266,14990,0.05679730072234191,0.6764135192455214
5930,0.5931,7,6,7,669279,7165,111273,14983,0.05674977822836143,0.6764944916019505
5931,0.5932,4,5,4,669284,7160,111277,14979,0.05671017615004435,0.6765888251501875
5932,0.5933,3,3,3,669287,7157,111280,14976,0.056686414903054115,0.6766366963357882
5933,0.5934,8,7,8,669294,7150,111288,14968,0.05663097199341022,0.6767338819061398
5934,0.5935,8,8,8,669302,7142,111296,14960,0.056567608668102905,0.6768618224595059
5935,0.5936,6,11,6,669313,7131,111302,14954,0.05648048409580535,0.6771111614217795
5936,0.5937,12,7,12,669320,7124,111314,14942,0.05642504118616145,0.6771503670805764
5937,0.5938,7,3,7,669323,7121,111321,14935,0.056401279939171205,0.6771400072542619
5938,0.5939,6,6,6,669329,7115,111327,14929,0.05635375744519072,0.6772364362184722
5939,0.594,8,6,8,669335,7109,111335,14921,0.05630623495121024,0.6773036768043577
5940,0.5941,5,11,5,669346,7098,111340,14916,0.05621911037891269,0.6775688198419187
5941,0.5942,5,10,5,669356,7088,111345,14911,0.056139906222278546,0.6778035365243875
5942,0.5943,10,5,10,669361,7083,111355,14901,0.05610030414396148,0.677811135371179
5943,0.5944,7,3,7,669364,7080,111362,14894,0.05607654289697123,0.677801037589879
5944,0.5945,3,5,3,669369,7075,111365,14891,0.056036940818654166,0.6779113174906674
5945,0.5946,12,1,12,669370,7074,111377,14879,0.05602902040299075,0.6777661367466861
5946,0.5947,8,6,8,669376,7068,111385,14871,0.05598149790901027,0.6778339942568029
5947,0.5948,3,5,3,669381,7063,111388,14868,0.05594189583069319,0.6779444621768274
5948,0.5949,4,8,4,669389,7055,111392,14864,0.05587853250538588,0.6781331265112459
5949,0.595,7,6,7,669395,7049,111399,14857,0.0558310100114054,0.6782160138774765
5950,0.5951,11,5,11,669400,7044,111410,14846,0.05579140793308833,0.6782092279579717
5951,0.5952,6,5,6,669405,7039,111416,14840,0.055751805854771255,0.6782759723936195
5952,0.5953,7,2,7,669407,7037,111423,14833,0.05573596502344443,0.6782350251486053
5953,0.5954,5,6,5,669413,7031,111428,14828,0.05568844252946395,0.6783475913811244
5954,0.5955,10,9,10,669422,7022,111438,14818,0.05561715878849322,0.6784798534798535
5955,0.5956,6,3,6,669425,7019,111444,14812,0.05559339754150298,0.6784847235582429
5956,0.5957,8,1,8,669426,7018,111452,14804,0.05558547712583956,0.6783979470259371
5957,0.5958,8,5,8,669431,7013,111460,14796,0.055545875047522494,0.6784355082763996
5958,0.5959,8,1,8,669432,7012,111468,14788,0.05553795463185908,0.678348623853211
5959,0.596,7,2,7,669434,7010,111475,14781,0.05552211380053225,0.6783075581662155
5960,0.5961,9,1,9,669435,7009,111484,14772,0.055514193384868835,0.6782057756760479
5961,0.5962,7,6,7,669441,7003,111491,14765,0.05546667089088835,0.6782892319000368
5962,0.5963,8,6,8,669447,6997,111499,14757,0.05541914839690787,0.6783580031258619
5963,0.5964,3,4,3,669451,6993,111502,14754,0.055387466734254216,0.6784384052972824
5964,0.5965,8,2,8,669453,6991,111510,14746,0.055371625902927386,0.6783824814831854
5965,0.5966,1,8,1,669461,6983,111511,14745,0.055308262577620074,0.6786174521354934
5966,0.5967,5,3,5,669464,6980,111516,14740,0.05528450133062983,0.6786372007366482
5967,0.5968,7,2,7,669466,6978,111523,14733,0.055268660499303006,0.6785961033577449
5968,0.5969,7,8,7,669474,6970,111530,14726,0.05520529717399569,0.6787426253687315
5969,0.597,6,3,6,669477,6967,111536,14720,0.05518153592700545,0.6787476368331259
5970,0.5971,5,3,5,669480,6964,111541,14715,0.05515777468001521,0.6787674708243
5971,0.5972,7,7,7,669487,6957,111548,14708,0.055102331770371306,0.6788829909993076
5972,0.5973,9,7,9,669494,6950,111557,14699,0.05504688886072741,0.6789690054967897
5973,0.5974,5,7,5,669501,6943,111562,14694,0.05499144595108351,0.6791144798262236
5974,0.5975,8,2,8,669503,6941,111570,14686,0.05497560511975669,0.6790585841771859
5975,0.5976,9,5,9,669508,6936,111579,14677,0.05493600304143961,0.6790820339610419
5976,0.5977,4,6,4,669514,6930,111583,14673,0.05488848054745913,0.6792112206637967
5977,0.5978,3,4,3,669518,6926,111586,14670,0.05485679888480548,0.6792924615669569
5978,0.5979,6,7,6,669525,6919,111592,14664,0.05480135597516158,0.6794236204420145
5979,0.598,4,8,4,669533,6911,111596,14660,0.05473799264985427,0.6796161513142646
5980,0.5981,5,5,5,669538,6906,111601,14655,0.05469839057153719,0.6796994573535551
5981,0.5982,7,3,7,669541,6903,111608,14648,0.054674629324546954,0.6796900375852629
5982,0.5983,9,7,9,669548,6896,111617,14639,0.054619186414903056,0.6797771070350592
5983,0.5984,5,2,5,669550,6894,111622,14634,0.05460334558357623,0.6797658862876255
5984,0.5985,5,5,5,669555,6889,111627,14629,0.05456374350525916,0.6798494283855376
5985,0.5986,5,5,5,669560,6884,111632,14624,0.054524141426942084,0.6799330481681235
5986,0.5987,8,7,8,669567,6877,111640,14616,0.054468698517298186,0.6800353603498813
5987,0.5988,2,5,2,669572,6872,111642,14614,0.05442909643898112,0.6801638276086754
5988,0.5989,5,6,5,669578,6866,111647,14609,0.054381573945000636,0.6802793946449359
5989,0.599,7,3,7,669581,6863,111654,14602,0.05435781269801039,0.6802702073142325
5990,0.5991,8,7,8,669588,6856,111662,14594,0.05430236978836649,0.6803729603729604
5991,0.5992,6,1,6,669589,6855,111668,14588,0.05429444937270308,0.6803152543953738
5992,0.5993,8,4,8,669593,6851,111676,14580,0.054262767710049425,0.6803228967383697
5993,0.5994,5,3,5,669596,6848,111681,14575,0.05423900646305918,0.6803435559912244
5994,0.5995,4,3,4,669599,6845,111685,14571,0.05421524521606894,0.6803791557713859
5995,0.5996,5,6,5,669605,6839,111690,14566,0.05416772272208845,0.6804952113992058
5996,0.5997,7,4,7,669609,6835,111697,14559,0.0541360410594348,0.6805179022155745
5997,0.5998,8,5,8,669614,6830,111705,14551,0.05409643898111773,0.6805575043262709
5998,0.5999,10,4,10,669618,6826,111715,14541,0.05406475731846407,0.6805354050638835
5999,0.6,5,4,5,669622,6822,111720,14536,0.05403307565581042,0.6805880700440116
6000,0.6001,5,3,5,669625,6819,111725,14531,0.054009314408820175,0.6806088992974239
6001,0.6002,7,9,7,669634,6810,111732,14524,0.05393803066784945,0.6807912252742102
6002,0.6003,7,7,7,669641,6803,111739,14517,0.05388258775820555,0.6809099437148217
6003,0.6004,10,6,10,669647,6797,111749,14507,0.05383506526422507,0.680951933909125
6004,0.6005,11,3,11,669650,6794,111760,14496,0.05381130401723482,0.68088304368248
6005,0.6006,6,5,6,669655,6789,111766,14490,0.053771701938917754,0.6809530523050895
6006,0.6007,5,7,5,669662,6782,111771,14485,0.053716259029273856,0.6811021770818639
6007,0.6008,5,2,5,669664,6780,111776,14480,0.05370041819794703,0.6810912511759172
6008,0.6009,7,8,7,669672,6772,111783,14473,0.053637054872639714,0.6812426453283126
6009,0.601,4,8,4,669680,6764,111787,14469,0.0535736915473324,0.6814392690623087
6010,0.6011,9,6,9,669686,6758,111796,14460,0.05352616905335192,0.6814968423037044
6011,0.6012,6,6,6,669692,6752,111802,14454,0.053478646559371436,0.6815995472979346
6012,0.6013,10,7,10,669699,6745,111812,14444,0.05342320364972754,0.6816744537259899
6013,0.6014,3,3,3,669702,6742,111815,14441,0.05339944240273729,0.6817259122881556
6014,0.6015,5,4,5,669706,6738,111820,14436,0.05336776074008364,0.6817795409464438
6015,0.6016,11,1,11,669707,6737,111831,14425,0.053359840324420225,0.6816463472261601
6016,0.6017,11,5,11,669712,6732,111842,14414,0.05332023824610316,0.6816419180932564
6017,0.6018,8,5,8,669717,6727,111850,14406,0.05328063616778608,0.6816826763829082
6018,0.6019,10,2,10,669719,6725,111860,14396,0.05326479533645926,0.6815965153165097
6019,0.602,8,8,8,669727,6717,111868,14388,0.05320143201115195,0.6817341862117982
6020,0.6021,8,7,8,669734,6710,111876,14380,0.05314598910150805,0.6818397344713134
6021,0.6022,10,2,10,669736,6708,111886,14370,0.05313014827018122,0.681753487048107
6022,0.6023,8,6,8,669742,6702,111894,14362,0.05308262577620074,0.6818268135206988
6023,0.6024,6,1,6,669743,6701,111900,14356,0.05307470536053732,0.6817685330293964
6024,0.6025,6,7,6,669750,6694,111906,14350,0.053019262450893424,0.6819045808781601
6025,0.6026,9,4,9,669754,6690,111915,14341,0.052987580788239765,0.6818981503494841
6026,0.6027,12,2,12,669756,6688,111927,14329,0.05297173995691294,0.6817814150449636
6027,0.6028,11,6,11,669762,6682,111938,14318,0.05292421746293245,0.6818095238095238
6028,0.6029,6,2,6,669764,6680,111944,14312,0.05290837663160563,0.6817835365853658
6029,0.603,5,4,5,669768,6676,111949,14307,0.05287669496895197,0.6818376781203832
6030,0.6031,4,2,4,669770,6674,111953,14303,0.05286085413762514,0.6818420174476808
6031,0.6032,4,4,4,669774,6670,111957,14299,0.052829172474971486,0.6819113930087272
6032,0.6033,6,2,6,669776,6668,111963,14293,0.052813331643644656,0.6818854062306188
6033,0.6034,4,6,4,669782,6662,111967,14289,0.052765809149664174,0.6820199513149731
6034,0.6035,7,6,7,669788,6656,111974,14282,0.05271828665568369,0.6821090839621741
6035,0.6036,8,5,8,669793,6651,111982,14274,0.05267868457736662,0.6821505376344086
6036,0.6037,7,5,7,669798,6646,111989,14267,0.05263908249904955,0.6822072395160905
6037,0.6038,4,3,4,669801,6643,111993,14263,0.05261532125205931,0.6822443317707835
6038,0.6039,7,3,7,669804,6640,112000,14256,0.052591560005069066,0.6822358346094947
6039,0.604,8,8,8,669812,6632,112008,14248,0.05252819667976175,0.6823754789272031
6040,0.6041,6,9,6,669821,6623,112014,14242,0.052456912938791025,0.6825784807093218
6041,0.6042,3,6,3,669827,6617,112017,14239,0.05240939044481054,0.682729190640583
6042,0.6043,12,8,12,669835,6609,112029,14227,0.05234602711950323,0.6828086004991362
6043,0.6044,6,6,6,669841,6603,112035,14221,0.05229850462552275,0.6829139454475605
6044,0.6045,6,3,6,669844,6600,112041,14215,0.0522747433785325,0.6829209704539995
6045,0.6046,5,5,5,669849,6595,112046,14210,0.052235141300215435,0.6830088920932468
6046,0.6047,16,3,16,669852,6592,112062,14194,0.05221138005322519,0.6828634657942846
6047,0.6048,1,7,1,669859,6585,112063,14193,0.05215593714358129,0.683078255847531
6048,0.6049,4,4,4,669863,6581,112067,14189,0.05212425548092764,0.6831487722676938
6049,0.605,4,7,4,669870,6574,112071,14185,0.05206881257128374,0.683318078905535
6050,0.6051,11,3,11,669873,6571,112082,14174,0.0520450513242935,0.6832489756567848
6051,0.6052,7,4,7,669877,6567,112089,14167,0.052013369661639844,0.6832738497154432
6052,0.6053,5,5,5,669882,6562,112094,14162,0.051973767583322776,0.6833622852731133
6053,0.6054,7,4,7,669886,6558,112101,14155,0.051942085920669116,0.6833872447255347
6054,0.6055,5,6,5,669892,6552,112106,14150,0.051894563426688634,0.6835088397256304
6055,0.6056,11,6,11,669898,6546,112117,14139,0.05184704093270815,0.6835387962291516
6056,0.6057,7,2,7,669900,6544,112124,14132,0.05183120010138132,0.6834977751982976
6057,0.6058,8,5,8,669905,6539,112132,14124,0.05179159802306425,0.6835406281759667
6058,0.6059,13,7,13,669912,6532,112145,14111,0.051736155113420355,0.6835731240614252
6059,0.606,9,2,9,669914,6530,112154,14102,0.051720314282093525,0.6835013571151609
6060,0.6061,8,2,8,669916,6528,112162,14094,0.051704473450766696,0.6834448647075938
6061,0.6062,3,5,3,669921,6523,112165,14091,0.05166487137244963,0.683564567769477
6062,0.6063,11,3,11,669924,6520,112176,14080,0.05164111012545938,0.683495145631068
6063,0.6064,11,8,11,669932,6512,112187,14069,0.05157774680015207,0.6835916622127205
6064,0.6065,8,6,8,669938,6506,112195,14061,0.05153022430617159,0.6836680118636651
6065,0.6066,4,2,4,669940,6504,112199,14057,0.05151438347484476,0.683672973104421
6066,0.6067,6,6,6,669946,6498,112205,14051,0.051466860980864275,0.6837802326147258
6067,0.6068,5,6,5,669952,6492,112210,14046,0.05141933848688379,0.6839030090563832
6068,0.6069,6,5,6,669957,6487,112216,14040,0.051379736408566724,0.6839772007599747
6069,0.607,5,4,5,669961,6483,112221,14035,0.051348054745913065,0.6840335315332878
6070,0.6071,3,4,3,669965,6479,112224,14032,0.05131637308325941,0.6841207157135196
6071,0.6072,7,8,7,669973,6471,112231,14025,0.0512530097579521,0.6842798594847775
6072,0.6073,5,5,5,669978,6466,112236,14020,0.051213407679635024,0.6843698135311921
6073,0.6074,7,1,7,669979,6465,112243,14013,0.051205487263971616,0.6842953413419279
6074,0.6075,10,5,10,669984,6460,112253,14003,0.05116588518565454,0.6843082636954503
6075,0.6076,7,6,7,669990,6454,112260,13996,0.05111836269167406,0.68440097799511
6076,0.6077,4,3,4,669993,6451,112264,13992,0.051094601444683814,0.6844396614978232
6077,0.6078,5,5,5,669998,6446,112269,13987,0.051054999366366746,0.6845299270787452
6078,0.6079,7,5,7,670003,6441,112276,13980,0.05101539728804968,0.6845893932716322
6079,0.608,8,4,8,670007,6437,112284,13972,0.05098371562539602,0.6845999314028125
6080,0.6081,7,3,7,670010,6434,112291,13965,0.05095995437840578,0.6845923819795088
6081,0.6082,3,7,3,670017,6427,112294,13962,0.05090451146876188,0.6847810093677964
6082,0.6083,5,1,5,670018,6426,112299,13957,0.05089659105309847,0.6847372810675563
6083,0.6084,6,4,6,670022,6422,112305,13951,0.05086490939044481,0.6847788739999018
6084,0.6085,5,9,5,670031,6413,112310,13946,0.05079362564947409,0.685004175057714
6085,0.6086,11,5,11,670036,6408,112321,13935,0.05075402357115701,0.6850022120631175
6086,0.6087,5,6,5,670042,6402,112326,13930,0.05070650107717653,0.6851268935667912
6087,0.6088,11,2,11,670044,6400,112337,13919,0.0506906602458497,0.6850238692849058
6088,0.6089,4,3,4,670047,6397,112341,13915,0.05066689899885946,0.6850630169358015
6089,0.609,4,4,4,670051,6393,112345,13911,0.0506352173362058,0.6851359338061466
6090,0.6091,4,9,4,670060,6384,112349,13907,0.050563933595235075,0.6853777536838993
6091,0.6092,2,5,2,670065,6379,112351,13905,0.05052433151691801,0.6855156773811871
6092,0.6093,6,6,6,670071,6373,112357,13899,0.050476809022937524,0.6856254932912391
6093,0.6094,9,1,9,670072,6372,112366,13890,0.05046888860727411,0.68551969203435
6094,0.6095,6,6,6,670078,6366,112372,13884,0.05042136611329363,0.6856296296296296
6095,0.6096,4,5,4,670083,6361,112376,13880,0.05038176403497656,0.685736870707969
6096,0.6097,5,6,5,670089,6355,112381,13875,0.05033424154099607,0.6858625803262481
6097,0.6098,7,7,7,670096,6348,112388,13868,0.05027879863135217,0.6859912940245351
6098,0.6099,9,2,9,670098,6346,112397,13859,0.05026295780002535,0.6859193268992824
6099,0.61,7,3,7,670101,6343,112404,13852,0.050239196553035104,0.6859123545432038
6100,0.6101,12,6,12,670107,6337,112416,13840,0.05019167405905462,0.6859295237151212
6101,0.6102,4,3,4,670110,6334,112420,13836,0.050167912812064376,0.6859692612791274
6102,0.6103,5,7,5,670117,6327,112425,13831,0.05011246990242048,0.6861295763468598
6103,0.6104,9,8,9,670125,6319,112434,13822,0.050049106577113166,0.686261853929795
6104,0.6105,6,4,6,670129,6315,112440,13816,0.05001742491445951,0.6863047041875714
6105,0.6106,7,1,7,670130,6314,112447,13809,0.0500095044987961,0.6862296874223526
6106,0.6107,7,5,7,670135,6309,112454,13802,0.04996990242047903,0.6862910844811297
6107,0.6108,9,7,9,670142,6302,112463,13793,0.049914459510835125,0.6863896491664593
6108,0.6109,7,6,7,670148,6296,112470,13786,0.04986693701685464,0.686485409819739
6109,0.611,2,8,2,670156,6288,112472,13784,0.04980357369154733,0.6867277799920287
6110,0.6111,5,4,5,670160,6284,112477,13779,0.04977189202889368,0.6867866221402582
6111,0.6112,12,2,12,670162,6282,112489,13767,0.04975605119756685,0.6866676642226545
6112,0.6113,9,9,9,670171,6273,112498,13758,0.04968476745659612,0.6868354051220608
6113,0.6114,5,2,5,670173,6271,112503,13753,0.0496689266252693,0.686825809029165
6114,0.6115,5,4,5,670177,6267,112508,13748,0.04963724496261564,0.6868848363727205
6115,0.6116,7,4,7,670181,6263,112515,13741,0.049605563299961984,0.6869126174765047
6116,0.6117,9,3,9,670184,6260,112524,13732,0.04958180205297174,0.68687474989996
6117,0.6118,11,5,11,670189,6255,112535,13721,0.04954219997465467,0.6868742490989187
6118,0.6119,5,3,5,670192,6252,112540,13716,0.04951843872766443,0.6868990384615384
6119,0.612,7,6,7,670198,6246,112547,13709,0.049470916233683944,0.6869957404159358
6120,0.6121,3,2,3,670200,6244,112550,13706,0.049455075402357114,0.6870175438596491
6121,0.6122,8,12,8,670212,6232,112558,13698,0.04936003041439615,0.6873055694932263
6122,0.6123,6,7,6,670219,6225,112564,13692,0.04930458750475225,0.687452929658081
6123,0.6124,5,7,5,670226,6218,112569,13687,0.04924914459510835,0.68761617683999
6124,0.6125,8,1,8,670227,6217,112577,13679,0.04924122417944494,0.6875251306795336
6125,0.6126,6,7,6,670234,6210,112583,13673,0.04918578126980104,0.6876728863853543
6126,0.6127,9,5,9,670239,6205,112592,13664,0.049146179191483966,0.6877044642407771
6127,0.6128,4,5,4,670244,6200,112596,13660,0.0491065771131669,0.6878147029204431
6128,0.6129,1,2,1,670246,6198,112597,13659,0.04909073628184007,0.6878682580450219
6129,0.613,7,6,7,670252,6192,112604,13652,0.049043213787859585,0.6879661358597057
6130,0.6131,13,10,13,670262,6182,112617,13639,0.04896400963122545,0.6881085717168659
6131,0.6132,7,4,7,670266,6178,112624,13632,0.04893232796857179,0.6881373043917214
6132,0.6133,6,5,6,670271,6173,112630,13626,0.04889272589025472,0.6882165765947775
6133,0.6134,4,2,4,670273,6171,112634,13622,0.04887688505892789,0.6882231091800132
6134,0.6135,7,3,7,670276,6168,112641,13615,0.04885312381193765,0.6882171561441642
6135,0.6136,6,2,6,670278,6166,112647,13609,0.048837282980610824,0.6881921618204804
6136,0.6137,7,3,7,670281,6163,112654,13602,0.04881352173362058,0.6881861877055401
6137,0.6138,6,7,6,670288,6156,112660,13596,0.04875807882397668,0.6883353584447145
6138,0.6139,9,3,9,670291,6153,112669,13587,0.04873431757698644,0.6882978723404255
6139,0.614,10,2,10,670293,6151,112679,13577,0.048718476745659614,0.6882096512570965
6140,0.6141,9,10,9,670303,6141,112688,13568,0.04863927258902547,0.6884164594855142
6141,0.6142,10,6,10,670309,6135,112698,13558,0.04859175009504499,0.6884679835474534
6142,0.6143,12,3,12,670312,6132,112710,13546,0.048567988848054744,0.6883829657485517
6143,0.6144,5,2,5,670314,6130,112715,13541,0.04855214801672792,0.6883737481571857
6144,0.6145,8,6,8,670320,6124,112723,13533,0.04850462552274743,0.6884570382052195
6145,0.6146,5,3,5,670323,6121,112728,13528,0.04848086427575719,0.6884828744465368
6146,0.6147,5,6,5,670329,6115,112733,13523,0.04843334178177671,0.688613911803646
6147,0.6148,5,1,5,670330,6114,112738,13518,0.048425421366113296,0.6885696821515892
6148,0.6149,12,6,12,670336,6108,112750,13506,0.04837789887213281,0.6885897828081983
6149,0.615,9,1,9,670337,6107,112759,13497,0.0483699784564694,0.6884819424607223
6150,0.6151,2,9,2,670346,6098,112761,13495,0.04829869471549867,0.6887663961618945
6151,0.6152,7,4,7,670350,6094,112768,13488,0.04826701305284501,0.6887958329077725
6152,0.6153,8,4,8,670354,6090,112776,13480,0.04823533139019136,0.6888094021461421
6153,0.6154,4,5,4,670359,6085,112780,13476,0.04819572931187429,0.688921834262052
6154,0.6155,10,7,10,670366,6078,112790,13466,0.04814028640223039,0.6890094146541138
6155,0.6156,9,1,9,670367,6077,112799,13457,0.04813236598656698,0.6889014026825023
6156,0.6157,4,3,4,670370,6074,112803,13453,0.04810860473957673,0.68894351410867
6157,0.6158,7,7,7,670377,6067,112810,13446,0.048053161829932835,0.6890790754881361
6158,0.6159,5,3,5,670380,6064,112815,13441,0.04802940058294259,0.6891053576006152
6159,0.616,7,6,7,670386,6058,112822,13434,0.04798187808896211,0.6892058280320131
6160,0.6161,5,3,5,670389,6055,112827,13429,0.04795811684197187,0.6892321905152946
6161,0.6162,8,3,8,670392,6052,112835,13421,0.047934355594981624,0.6892107019976378
6162,0.6163,7,11,7,670403,6041,112842,13414,0.047847231022684074,0.6894885633513236
6163,0.6164,1,4,1,670407,6037,112843,13413,0.047815549360030414,0.6896143958868894
6164,0.6165,7,5,7,670412,6032,112850,13406,0.047775947281713346,0.6896800082312995
6165,0.6166,5,8,5,670420,6024,112855,13401,0.047712583956406034,0.6898841698841699
6166,0.6167,4,4,4,670424,6020,112859,13397,0.047680902293752374,0.6899624040789
6167,0.6168,9,3,9,670427,6017,112868,13388,0.047657141046762136,0.6899252769904664
6168,0.6169,9,3,9,670430,6014,112877,13379,0.04763337979977189,0.6898881039550353
6169,0.617,4,3,4,670433,6011,112881,13375,0.04760961855278165,0.6899308779531621
6170,0.6171,12,2,12,670435,6009,112893,13363,0.04759377772145482,0.6898100351022094
6171,0.6172,12,5,12,670440,6004,112905,13351,0.04755417564313775,0.689795918367347
6172,0.6173,4,5,4,670445,5999,112909,13347,0.04751457356482068,0.6899100589269099
6173,0.6174,4,3,4,670448,5996,112913,13343,0.04749081231783044,0.6899529448265164
6174,0.6175,7,6,7,670454,5990,112920,13336,0.04744328982384995,0.6900548483907689
6175,0.6176,1,7,1,670461,5983,112921,13335,0.047387846914206055,0.6902888497774097
6176,0.6177,7,5,7,670466,5978,112928,13328,0.04734824483588899,0.6903553299492385
6177,0.6178,4,3,4,670469,5975,112932,13324,0.04732448358889874,0.6903984662417741
6178,0.6179,8,6,8,670475,5969,112940,13316,0.04727696109491826,0.6904848327715841
6179,0.618,10,4,10,670479,5965,112950,13306,0.04724527943226461,0.6904675419023403
6180,0.6181,5,3,5,670482,5962,112955,13301,0.04722151818527436,0.690494730831127
6181,0.6182,4,2,4,670484,5960,112959,13297,0.04720567735394753,0.6905021550604975
6182,0.6183,11,1,11,670485,5959,112970,13286,0.047197756938284124,0.6903611327617563
6183,0.6184,4,5,4,670490,5954,112974,13282,0.04715815485996705,0.6904761904761905
6184,0.6185,7,3,7,670493,5951,112981,13275,0.04713439361297681,0.6904712368667429
6185,0.6186,6,3,6,670496,5948,112987,13269,0.04711063236598657,0.6904823853879377
6186,0.6187,3,3,3,670499,5945,112990,13266,0.04708687111899632,0.690541877049607
6187,0.6188,7,5,7,670504,5940,112997,13259,0.047047269040679254,0.6906088858794729
6188,0.6189,4,5,4,670509,5935,113001,13255,0.047007666962362187,0.6907243355914539
6189,0.619,8,5,8,670514,5930,113009,13247,0.04696806488404511,0.6907754080408823
6190,0.6191,3,6,3,670520,5924,113012,13244,0.04692054239006463,0.6909432387312187
6191,0.6192,3,3,3,670523,5921,113015,13241,0.04689678114307439,0.6910030268239223
6192,0.6193,6,7,6,670530,5914,113021,13235,0.04684133823343049,0.6911588072484203
6193,0.6194,1,3,1,670533,5911,113022,13234,0.04681757698644025,0.6912509793679812
6194,0.6195,8,5,8,670538,5906,113030,13226,0.04677797490812318,0.691302529793017
6195,0.6196,7,6,7,670544,5900,113037,13219,0.04673045241414269,0.6914064543124641
6196,0.6197,2,2,2,670546,5898,113039,13217,0.04671461158281587,0.6914465079780278
6197,0.6198,5,6,5,670552,5892,113044,13212,0.046667089088835385,0.6915829145728644
6198,0.6199,8,4,8,670556,5888,113052,13204,0.046635407426181726,0.6915985753195055
6199,0.62,10,7,10,670563,5881,113062,13194,0.04657996451653783,0.6916906946264745
6200,0.6201,1,4,1,670567,5877,113063,13193,0.046548282853884175,0.6918196119559518
6201,0.6202,6,4,6,670571,5873,113069,13187,0.046516601191230515,0.6918677859391396
6202,0.6203,3,3,3,670574,5870,113072,13184,0.04649283994424027,0.6919282040516427
6203,0.6204,1,3,1,670577,5867,113073,13183,0.04646907869725003,0.6920209973753281
6204,0.6205,7,5,7,670582,5862,113080,13176,0.046429476618932965,0.692089505200126
6205,0.6206,5,3,5,670585,5859,113085,13171,0.04640571537194272,0.6921177088807147
6206,0.6207,2,2,2,670587,5857,113087,13169,0.04638987454061589,0.6921580994428677
6207,0.6208,7,5,7,670592,5852,113094,13162,0.04635027246229882,0.6922267802671715
6208,0.6209,7,2,7,670594,5850,113101,13155,0.04633443163097199,0.6921862667719021
6209,0.621,4,4,4,670598,5846,113105,13151,0.04630274996831834,0.6922672000842238
6210,0.6211,9,3,9,670601,5843,113114,13142,0.046278988721328095,0.6922307084540427
6211,0.6212,9,3,9,670604,5840,113123,13133,0.04625522747433786,0.6921941706635746
6212,0.6213,8,7,8,670611,5833,113131,13125,0.04619978456469395,0.6923198649646587
6213,0.6214,8,5,8,670616,5828,113139,13117,0.046160182486376884,0.6923726576933228
6214,0.6215,5,3,5,670619,5825,113144,13112,0.046136421239386646,0.692401119501505
6215,0.6216,7,2,7,670621,5823,113151,13105,0.046120580408059816,0.6923605240912933
6216,0.6217,4,5,4,670626,5818,113155,13101,0.04608097832974274,0.6924784608065966
6217,0.6218,4,1,4,670627,5817,113159,13097,0.046073057914079334,0.6924500370096225
6218,0.6219,7,5,7,670632,5812,113166,13090,0.04603345583576226,0.6925193101259126
6219,0.622,9,4,9,670636,5808,113175,13081,0.046001774173108606,0.6925194557679073
6220,0.6221,8,7,8,670643,5801,113183,13073,0.04594633126346471,0.6926459679983046
6221,0.6222,5,1,5,670644,5800,113188,13068,0.04593841084780129,0.6926012295950816
6222,0.6223,6,4,6,670648,5796,113194,13062,0.045906729185147634,0.6926503340757239
6223,0.6224,8,6,8,670654,5790,113202,13054,0.04585920669116715,0.6927403948206325
6224,0.6225,5,6,5,670660,5784,113207,13049,0.04581168419718667,0.6928795199915043
6225,0.6226,5,3,5,670663,5781,113212,13044,0.04578792295019642,0.6929083665338646
6226,0.6227,3,3,3,670666,5778,113215,13041,0.045764161703206185,0.6929698708751794
6227,0.6228,6,1,6,670667,5777,113221,13035,0.04575624128754277,0.6929087816287476
6228,0.6229,3,4,3,670671,5773,113224,13032,0.04572455962488912,0.6930071789417708
6229,0.623,10,3,10,670674,5770,113234,13022,0.04570079837789887,0.6929544487015752
6230,0.6231,7,1,7,670675,5769,113241,13015,0.04569287796223546,0.6928769165247018
6231,0.6232,3,4,3,670679,5765,113244,13012,0.045661196299581805,0.6929754486872237
6232,0.6233,3,1,3,670680,5764,113247,13009,0.04565327588391839,0.692963298354019
6233,0.6234,4,2,4,670682,5762,113251,13005,0.04563743505259156,0.6929717056535408
6234,0.6235,12,3,12,670685,5759,113263,12993,0.045613673805601315,0.6928860921501706
6235,0.6236,9,2,9,670687,5757,113272,12984,0.04559783297427449,0.6928125500240115
6236,0.6237,6,3,6,670690,5754,113278,12978,0.04557407172728425,0.6928251121076233
6237,0.6238,6,2,6,670692,5752,113284,12972,0.04555823089595742,0.6928006836146122
6238,0.6239,7,2,7,670694,5750,113291,12965,0.045542390064630595,0.6927598183275447
6239,0.624,4,0,4,670694,5750,113295,12961,0.045542390064630595,0.6926941371385816
6240,0.6241,7,5,7,670699,5745,113302,12954,0.04550278798631352,0.6927643189475373
6241,0.6242,7,6,7,670705,5739,113309,12947,0.04545526549233304,0.69287166862892
6242,0.6243,4,3,4,670708,5736,113313,12943,0.04543150424534279,0.6929171797205418
6243,0.6244,5,3,5,670711,5733,113318,12938,0.045407742998352554,0.692946280327781
6244,0.6245,6,8,6,670719,5725,113324,12932,0.04534437967304524,0.6931446642011041
6245,0.6246,5,2,5,670721,5723,113329,12927,0.04532853884171841,0.6931367292225201
6246,0.6247,8,5,8,670726,5718,113337,12919,0.045288936763401344,0.6931909642109781
6247,0.6248,5,4,5,670730,5714,113342,12914,0.045257255100747684,0.6932574618853339
6248,0.6249,10,1,10,670731,5713,113352,12904,0.045249334685084276,0.69312993500564
6249,0.625,5,4,5,670735,5709,113357,12899,0.045217653022430616,0.6931964746345658
6250,0.6251,8,6,8,670741,5703,113365,12891,0.045170130528450134,0.6932881574701517
6251,0.6252,7,3,7,670744,5700,113372,12884,0.04514636928145989,0.6932845458458889
6252,0.6253,4,4,4,670748,5696,113376,12880,0.045114687618806236,0.6933677863910422
6253,0.6254,10,9,10,670757,5687,113386,12870,0.04504340387783551,0.6935388263189093
6254,0.6255,10,5,10,670762,5682,113396,12860,0.04500380179951844,0.6935605652033222
6255,0.6256,6,7,6,670769,5675,113402,12854,0.04494835888987454,0.6937233525824383
6256,0.6257,6,4,6,670773,5671,113408,12848,0.04491667722722088,0.6937739618769913
6257,0.6258,10,7,10,670780,5664,113418,12838,0.044861234317576985,0.693870932872122
6258,0.6259,4,2,4,670782,5662,113422,12834,0.044845393486250155,0.6938797577854672
6259,0.626,5,3,5,670785,5659,113427,12829,0.04482163223925992,0.6939095629597577
6260,0.6261,8,6,8,670791,5653,113435,12821,0.044774109745279435,0.6940023817256685
6261,0.6262,3,6,3,670797,5647,113438,12818,0.044726587251298945,0.6941781749255348
6262,0.6263,9,5,9,670802,5642,113447,12809,0.04468698517298188,0.6942171156034903
6263,0.6264,14,7,14,670809,5635,113461,12795,0.04463154226333798,0.6942485078676072
6264,0.6265,4,5,4,670814,5630,113465,12791,0.04459194018502091,0.6943705553444438
6265,0.6266,9,5,9,670819,5625,113474,12782,0.04455233810670384,0.6944097354267398
6266,0.6267,8,3,8,670822,5622,113482,12774,0.0445285768597136,0.6943900848010437
6267,0.6268,11,5,11,670827,5617,113493,12763,0.044488974781396524,0.6943960826985854
6268,0.6269,5,3,5,670830,5614,113498,12758,0.04446521353440629,0.6944263008926628
6269,0.627,3,6,3,670836,5608,113501,12755,0.044417691040425804,0.6946032783314273
6270,0.6271,6,4,6,670840,5604,113507,12749,0.044386009377772144,0.6946548248242794
6271,0.6272,4,2,4,670842,5602,113511,12745,0.044370168546445314,0.6946639777620319
6272,0.6273,8,4,8,670846,5598,113519,12737,0.04433848688379166,0.6946823016089446
6273,0.6274,5,4,5,670850,5594,113524,12732,0.04430680522113801,0.6947506275237367
6274,0.6275,7,5,7,670855,5589,113531,12725,0.044267203142820934,0.6948236321939499
6275,0.6276,3,4,3,670859,5585,113534,12722,0.04423552148016728,0.6949254383569127
6276,0.6277,6,5,6,670864,5580,113540,12716,0.044195919401850206,0.695015303891561
6277,0.6278,10,3,10,670867,5577,113550,12706,0.04417215815485997,0.6949625335010665
6278,0.6279,6,0,6,670867,5577,113556,12700,0.04417215815485997,0.6948623953602889
6279,0.628,4,4,4,670871,5573,113560,12696,0.04414047649220631,0.694947725655482
6280,0.6281,5,4,5,670875,5569,113565,12691,0.044108794829552656,0.6950164293537787
6281,0.6282,9,3,9,670878,5566,113574,12682,0.04408503358256241,0.6949802718106094
6282,0.6283,4,4,4,670882,5562,113578,12678,0.04405335191990876,0.6950657894736842
6283,0.6284,7,5,7,670887,5557,113585,12671,0.04401374984159169,0.695139346061005
6284,0.6285,4,5,4,670892,5552,113589,12667,0.043974147763274615,0.6952631867830287
6285,0.6286,6,5,6,670897,5547,113595,12661,0.04393454568495755,0.695353690685413
6286,0.6287,5,3,5,670900,5544,113600,12656,0.0439107844379673,0.6953846153846154
6287,0.6288,9,2,9,670902,5542,113609,12647,0.04389494360664048,0.6953103524107977
6288,0.6289,6,6,6,670908,5536,113615,12641,0.04384742111265999,0.6954392914122243
6289,0.629,6,5,6,670913,5531,113621,12635,0.04380781903434292,0.6955301111967411
6290,0.6291,1,4,1,670917,5527,113622,12634,0.04377613737168927,0.6956665381862233
6291,0.6292,7,4,7,670921,5523,113629,12627,0.04374445570903561,0.695702479338843
6292,0.6293,8,5,8,670926,5518,113637,12619,0.04370485363071854,0.6957600485196008
6293,0.6294,5,1,5,670927,5517,113642,12614,0.04369693321505513,0.6957145220892395
6294,0.6295,8,5,8,670932,5512,113650,12606,0.04365733113673806,0.6957721602825919
6295,0.6296,8,7,8,670939,5505,113658,12598,0.04360188822709416,0.6959067557863338
6296,0.6297,6,4,6,670943,5501,113664,12592,0.0435702065644405,0.695959763444426
6297,0.6298,9,6,9,670949,5495,113673,12583,0.04352268407046002,0.6960393848877088
6298,0.6299,8,5,8,670954,5490,113681,12575,0.04348308199214295,0.6960974259618046
6299,0.63,6,2,6,670956,5488,113687,12569,0.04346724116081612,0.6960735448856399
6300,0.6301,7,4,7,670960,5484,113694,12562,0.04343555949816246,0.6961099412612213
6301,0.6302,6,8,6,670968,5476,113700,12556,0.04337219617285515,0.6963176574977817
6302,0.6303,6,1,6,670969,5475,113706,12550,0.04336427575719174,0.6962552011095701
6303,0.6304,5,2,5,670971,5473,113711,12545,0.04334843492586491,0.6962481962481962
6304,0.6305,8,6,8,670977,5467,113719,12537,0.04330091243188443,0.6963452566096423
6305,0.6306,5,2,5,670979,5465,113724,12532,0.0432850716005576,0.6963382786019893
6306,0.6307,6,9,6,670988,5456,113730,12526,0.04321378785958687,0.6965854743632521
6307,0.6308,10,2,10,670990,5454,113740,12516,0.04319794702826004,0.6964941569282137
6308,0.6309,6,2,6,670992,5452,113746,12510,0.04318210619693322,0.6964703262442935
6309,0.631,5,4,5,670996,5448,113751,12505,0.04315042453427956,0.6965409680833287
6310,0.6311,5,5,5,671001,5443,113756,12500,0.04311082245596249,0.6966505043749651
6311,0.6312,7,5,7,671006,5438,113763,12493,0.04307122037764542,0.6967263398583459
6312,0.6313,8,3,8,671009,5435,113771,12485,0.04304745913065518,0.6967075892857143
6313,0.6314,5,6,5,671015,5429,113776,12480,0.042999936636674695,0.6968563292199452
6314,0.6315,8,6,8,671021,5423,113784,12472,0.04295241414269421,0.6969544565521095
6315,0.6316,6,3,6,671024,5420,113790,12466,0.04292865289570397,0.696969696969697
6316,0.6317,2,1,2,671025,5419,113792,12464,0.04292073248004055,0.6969747805178103
6317,0.6318,7,3,7,671028,5416,113799,12457,0.04289697123305031,0.6969730878979467
6318,0.6319,6,3,6,671031,5413,113805,12451,0.04287320998606007,0.6969883564711151
6319,0.632,8,2,8,671033,5411,113813,12443,0.04285736915473324,0.6969306597961241
6320,0.6321,4,5,4,671038,5406,113817,12439,0.04281776707641617,0.697057999439619
6321,0.6322,5,3,5,671041,5403,113822,12434,0.04279400582942593,0.697090317878567
6322,0.6323,7,5,7,671046,5398,113829,12427,0.04275440375110886,0.6971669004207574
6323,0.6324,9,5,9,671051,5393,113838,12418,0.04271480167279179,0.6972095895794733
6324,0.6325,5,2,5,671053,5391,113843,12413,0.04269896084146496,0.6972028757582566
6325,0.6326,6,4,6,671057,5387,113849,12407,0.0426672791788113,0.6972575025289424
6326,0.6327,4,7,4,671064,5380,113853,12403,0.042611836269167404,0.697463869988191
6327,0.6328,7,2,7,671066,5378,113860,12396,0.04259599543784058,0.6974232024305165
6328,0.6329,3,2,3,671068,5376,113863,12393,0.04258015460651375,0.6974506162417694
6329,0.633,8,5,8,671073,5371,113871,12385,0.04254055252819668,0.697510700608245
6330,0.6331,7,2,7,671075,5369,113878,12378,0.04252471169686985,0.6974699949287203
6331,0.6332,2,7,2,671082,5362,113880,12376,0.042469268787225956,0.6977111286503551
6332,0.6333,6,5,6,671087,5357,113886,12370,0.04242966670890888,0.6978056072657528
6333,0.6334,8,2,8,671089,5355,113894,12362,0.04241382587758206,0.6977479257210588
6334,0.6335,3,6,3,671095,5349,113897,12359,0.04236630338360157,0.6979331375649424
6335,0.6336,7,3,7,671098,5346,113904,12352,0.04234254213661133,0.697931969714092
6336,0.6337,5,6,5,671104,5340,113909,12347,0.04229501964263085,0.6980833380448918
6337,0.6338,3,5,3,671109,5335,113912,12344,0.04225541756431377,0.698229537869789
6338,0.6339,2,6,2,671115,5329,113914,12342,0.04220789507033329,0.6984324599626507
6339,0.634,9,6,9,671121,5323,113923,12333,0.04216037257635281,0.698516085183507
6340,0.6341,6,8,6,671129,5315,113929,12327,0.042097009251045495,0.6987303026867702
6341,0.6342,3,2,3,671131,5313,113932,12324,0.042081168419718665,0.6987582922265692
6342,0.6343,4,4,4,671135,5309,113936,12320,0.04204948675706501,0.6988484882863464
6343,0.6344,5,0,5,671135,5309,113941,12315,0.04204948675706501,0.6987630503858375
6344,0.6345,7,1,7,671136,5308,113948,12308,0.0420415663414016,0.6986830154405086
6345,0.6346,8,2,8,671138,5306,113956,12300,0.04202572551007477,0.6986254685902533
6346,0.6347,8,5,8,671143,5301,113964,12292,0.0419861234317577,0.6986869777752516
6347,0.6348,10,4,10,671147,5297,113974,12282,0.04195444176910404,0.6986745548666022
6348,0.6349,9,4,9,671151,5293,113983,12273,0.04192276010645039,0.6986792667653421
6349,0.635,8,8,8,671159,5285,113991,12265,0.041859396781143074,0.6988603988603989
6350,0.6351,3,5,3,671164,5280,113994,12262,0.041819794702826006,0.6990080948580549
6351,0.6352,8,4,8,671168,5276,114002,12254,0.041788113040172346,0.6990302338847689
6352,0.6353,9,4,9,671172,5272,114011,12245,0.041756431377518693,0.6990352229263002
6353,0.6354,9,2,9,671174,5270,114020,12236,0.041740590546191864,0.6989603564492174
6354,0.6355,5,4,5,671178,5266,114025,12231,0.04170890888353821,0.6990341201348803
6355,0.6356,10,6,10,671184,5260,114035,12221,0.04166138638955772,0.6991018820433613
6356,0.6357,12,7,12,671191,5253,114047,12209,0.04160594347991382,0.699175352193334
6357,0.6358,6,5,6,671196,5248,114053,12203,0.041566341401596756,0.6992722480087101
6358,0.6359,6,3,6,671199,5245,114059,12197,0.04154258015460651,0.6992890723540879
6359,0.636,2,4,2,671203,5241,114061,12195,0.04151089849195286,0.6994150034411563
6360,0.6361,4,2,4,671205,5239,114065,12191,0.04149505766062603,0.6994262765347102
6361,0.6362,9,5,9,671210,5234,114074,12182,0.04145545558230896,0.699471750114837
6362,0.6363,5,3,5,671213,5231,114079,12177,0.041431694335318715,0.6995059742647058
6363,0.6364,8,6,8,671219,5225,114087,12169,0.04138417184133823,0.6996090605956077
6364,0.6365,4,2,4,671221,5223,114091,12165,0.0413683310100114,0.6996204278812974
6365,0.6366,11,3,11,671224,5220,114102,12154,0.041344569763021165,0.6995510532980316
6366,0.6367,8,0,8,671224,5220,114110,12146,0.041344569763021165,0.6994126453990557
6367,0.6368,4,2,4,671226,5218,114114,12142,0.041328728931694335,0.6994239631336405
6368,0.6369,7,5,7,671231,5213,114121,12135,0.04128912685337727,0.6995042656213972
6369,0.637,4,3,4,671234,5210,114125,12131,0.04126536560638702,0.6995559656305864
6370,0.6371,6,9,6,671243,5201,114131,12125,0.041194081865416295,0.6998153064758167
6371,0.6372,9,3,9,671246,5198,114140,12116,0.04117032061842606,0.6997805244310962
6372,0.6373,4,4,4,671250,5194,114144,12112,0.0411386389557724,0.6998728764590315
6373,0.6374,7,4,7,671254,5190,114151,12105,0.041106957293118744,0.6999132697311362
6374,0.6375,4,4,4,671258,5186,114155,12101,0.041075275630465084,0.7000057846937005
6375,0.6376,9,5,9,671263,5181,114164,12092,0.041035673552148016,0.7000521044404562
6376,0.6377,9,2,9,671265,5179,114173,12083,0.04101983272082119,0.699976827714054
6377,0.6378,4,6,4,671271,5173,114177,12079,0.040972310226840704,0.7001507071643868
6378,0.6379,9,2,9,671273,5171,114186,12070,0.040956469395513874,0.7000754016588365
6379,0.638,1,3,1,671276,5168,114187,12069,0.040932708148523636,0.7001798456808029
6380,0.6381,5,4,5,671280,5164,114192,12064,0.040901026485869976,0.7002553981889946
6381,0.6382,3,5,3,671285,5159,114195,12061,0.04086142440755291,0.7004065040650407
6382,0.6383,9,3,9,671288,5156,114204,12052,0.040837663160562664,0.700371920037192
6383,0.6384,3,2,3,671290,5154,114207,12049,0.04082182232923584,0.7004010928326455
6384,0.6385,8,3,8,671293,5151,114215,12041,0.040798061082245596,0.7003838994881341
6385,0.6386,5,3,5,671296,5148,114220,12036,0.04077429983525535,0.7004189944134078
6386,0.6387,3,4,3,671300,5144,114223,12033,0.0407426181726017,0.7005297781917681
6387,0.6388,7,3,7,671303,5141,114230,12026,0.04071885692561145,0.7005300867944312
6388,0.6389,4,4,4,671307,5137,114234,12022,0.0406871752629578,0.7006235794626726
6389,0.639,7,2,7,671309,5135,114241,12015,0.04067133443163097,0.7005830903790088
6390,0.6391,6,3,6,671312,5132,114247,12009,0.04064757318464073,0.7006008984306633
6391,0.6392,5,3,5,671315,5129,114252,12004,0.04062381193765049,0.7006361991478434
6392,0.6393,4,5,4,671320,5124,114256,12000,0.04058420985933342,0.700770847932726
6393,0.6394,14,4,14,671324,5120,114270,11986,0.04055252819667976,0.7006898164386764
6394,0.6395,5,5,5,671329,5115,114275,11981,0.04051292611836269,0.7008072063640618
6395,0.6396,3,3,3,671332,5112,114278,11978,0.04048916487137245,0.7008777062609713
6396,0.6397,7,6,7,671338,5106,114285,11971,0.040441642377391965,0.70100134684078
6397,0.6398,0,3,0,671341,5103,114285,11971,0.04041788113040173,0.7011245168091835
6398,0.6399,9,4,9,671345,5099,114294,11962,0.04038619946774807,0.7011312349803646
6399,0.64,3,3,3,671348,5096,114297,11959,0.04036243822075782,0.7012019935502785
6400,0.6401,3,1,3,671349,5095,114300,11956,0.040354517805094414,0.7011905460090317
6401,0.6402,7,7,7,671356,5088,114307,11949,0.040299074895450517,0.7013558725127663
6402,0.6403,3,2,3,671358,5086,114310,11946,0.04028323406412369,0.7013856270549553
6403,0.6404,10,3,10,671361,5083,114320,11936,0.04025947281713344,0.7013338033962042
6404,0.6405,4,3,4,671364,5080,114324,11932,0.040235711570143204,0.7013872560545498
6405,0.6406,3,3,3,671367,5077,114327,11929,0.04021195032315296,0.7014583088321769
6406,0.6407,5,4,5,671371,5073,114332,11924,0.040180268660499306,0.7015355650997235
6407,0.6408,9,5,9,671376,5068,114341,11915,0.04014066658218223,0.7015839368780545
6408,0.6409,7,1,7,671377,5067,114348,11908,0.040132746166518816,0.7015022091310751
6409,0.641,10,4,10,671381,5063,114358,11898,0.040101064503865164,0.7014916573315253
6410,0.6411,2,3,2,671384,5060,114360,11896,0.04007730325687492,0.7015805614531729
6411,0.6412,11,3,11,671387,5057,114371,11885,0.04005354200988468,0.7015110376578916
6412,0.6413,8,5,8,671392,5052,114379,11877,0.040013939931567606,0.7015771752613857
6413,0.6414,9,2,9,671394,5050,114388,11868,0.03999809910024078,0.7015013594987587
6414,0.6415,5,1,5,671395,5049,114393,11863,0.03999017868457737,0.7014545884578998
6415,0.6416,7,3,7,671398,5046,114400,11856,0.03996641743758712,0.7014554490592829
6416,0.6417,5,2,5,671400,5044,114405,11851,0.039950576606260293,0.7014501331754958
6417,0.6418,10,3,10,671403,5041,114415,11841,0.039926815359270056,0.7013979386328634
6418,0.6419,6,5,6,671408,5036,114421,11835,0.03988721328095299,0.70149961472349
6419,0.642,6,7,6,671415,5029,114427,11829,0.03983177037130908,0.7016846601020287
6420,0.6421,6,7,6,671422,5022,114433,11823,0.039776327461665185,0.7018699910952805
6421,0.6422,6,4,6,671426,5018,114439,11817,0.03974464579901153,0.7019305019305019
6422,0.6423,4,4,4,671430,5014,114443,11813,0.03971296413635787,0.7020265050216913
6423,0.6424,8,2,8,671432,5012,114451,11805,0.03969712330503105,0.7019682464173158
6424,0.6425,7,4,7,671436,5008,114458,11798,0.03966544164237739,0.7020111864810187
6425,0.6426,4,4,4,671440,5004,114462,11794,0.03963375997972374,0.7021073937373496
6426,0.6427,7,2,7,671442,5002,114469,11787,0.03961791914839691,0.7020668294716779
6427,0.6428,7,3,7,671445,4999,114476,11780,0.03959415790140666,0.70206806126706
6428,0.6429,2,3,2,671448,4996,114478,11778,0.039570396654416425,0.7021581018242519
6429,0.643,11,3,11,671451,4993,114489,11767,0.03954663540742618,0.7020883054892602
6430,0.6431,6,3,6,671454,4990,114495,11761,0.03952287416043594,0.7021073368754104
6431,0.6432,5,4,5,671458,4986,114500,11756,0.03949119249778228,0.7021861187432804
6432,0.6433,3,2,3,671460,4984,114503,11753,0.03947535166645545,0.7022166457549143
6433,0.6434,8,0,8,671460,4984,114511,11745,0.03947535166645545,0.7020742423336721
6434,0.6435,6,3,6,671463,4981,114517,11739,0.039451590419465214,0.7020933014354067
6435,0.6436,2,2,2,671465,4979,114519,11737,0.039435749588138384,0.7021416606843742
6436,0.6437,7,6,7,671471,4973,114526,11730,0.0393882270941579,0.7022690534634497
6437,0.6438,6,4,6,671475,4969,114532,11724,0.03935654543150425,0.7023303180974061
6438,0.6439,7,4,7,671479,4965,114539,11717,0.03932486376885059,0.7023738160891979
6439,0.644,5,4,5,671483,4961,114544,11712,0.039293182106196936,0.702453067834223
6440,0.6441,1,5,1,671488,4956,114545,11711,0.03925358002787986,0.7026459470810584
6441,0.6442,8,4,8,671492,4952,114553,11703,0.03922189836522621,0.7026718703092164
6442,0.6443,6,5,6,671497,4947,114559,11697,0.039182296286909134,0.7027757750540735
6443,0.6444,10,5,10,671502,4942,114569,11687,0.039142694208592066,0.7028083468639125
6444,0.6445,4,3,4,671505,4939,114573,11683,0.03911893296160183,0.7028636746480568
6445,0.6446,8,4,8,671509,4935,114581,11675,0.03908725129894817,0.7028898254063817
6446,0.6447,8,2,8,671511,4933,114589,11667,0.03907141046762134,0.7028313253012048
6447,0.6448,8,7,8,671518,4926,114597,11659,0.03901596755797744,0.7029846246608381
6448,0.6449,4,2,4,671520,4924,114601,11655,0.03900012672665062,0.7029977682610531
6449,0.645,8,1,8,671521,4923,114609,11647,0.0389922063109872,0.7028968014484007
6450,0.6451,4,7,4,671528,4916,114613,11643,0.038936763401343305,0.7031221692131168
6451,0.6452,3,2,3,671530,4914,114616,11640,0.038920922570016475,0.7031533164189924
6452,0.6453,6,6,6,671536,4908,114622,11634,0.03887340007603599,0.7033006891548785
6453,0.6454,4,4,4,671540,4904,114626,11630,0.03884171841338233,0.7033990564896577
6454,0.6455,6,4,6,671544,4900,114632,11624,0.03881003675072868,0.7034616315662068
6455,0.6456,8,3,8,671547,4897,114640,11616,0.038786275503738435,0.7034457699993945
6456,0.6457,7,5,7,671552,4892,114647,11609,0.03874667342542137,0.7035331192048967
6457,0.6458,4,3,4,671555,4889,114651,11605,0.03872291217843112,0.7035891839456773
6458,0.6459,4,5,4,671560,4884,114655,11601,0.038683310100114054,0.7037306642402184
6459,0.646,10,7,10,671567,4877,114665,11591,0.03862786719047016,0.7038498906971096
6460,0.6461,4,4,4,671571,4873,114669,11587,0.0385961855278165,0.7039489671931957
6461,0.6462,4,6,4,671577,4867,114673,11583,0.038548663033836014,0.7041337386018237
6462,0.6463,5,9,5,671586,4858,114678,11578,0.03847737929286529,0.7044293015332198
6463,0.6464,4,4,4,671590,4854,114682,11574,0.038445697630211634,0.7045288531775018
6464,0.6465,5,1,5,671591,4853,114687,11569,0.03843777721454822,0.7044817927170869
6465,0.6466,9,3,9,671594,4850,114696,11560,0.038414015967557974,0.704448507007922
6466,0.6467,6,1,6,671595,4849,114702,11554,0.038406095551894566,0.7043833445101506
6467,0.6468,4,7,4,671602,4842,114706,11550,0.03835065264225067,0.7046120058565154
6468,0.6469,11,2,11,671604,4840,114717,11539,0.03833481181092384,0.7044996642041639
6469,0.647,7,5,7,671609,4835,114724,11532,0.03829520973260677,0.7045885012525203
6470,0.6471,5,2,5,671611,4833,114729,11527,0.03827936890127994,0.7045843520782397
6471,0.6472,14,6,14,671617,4827,114743,11513,0.03823184640729946,0.7045899632802938
6472,0.6473,8,4,8,671621,4823,114751,11505,0.0382001647446458,0.7046178343949044
6473,0.6474,7,0,7,671621,4823,114758,11498,0.0382001647446458,0.7044911463758348
6474,0.6475,7,3,7,671624,4820,114765,11491,0.03817640349765556,0.7044938998222059
6475,0.6476,5,2,5,671626,4818,114770,11486,0.03816056266632873,0.7044896957801766
6476,0.6477,6,4,6,671630,4814,114776,11480,0.03812888100367507,0.7045538234933104
6477,0.6478,7,2,7,671632,4812,114783,11473,0.03811304017234825,0.7045133558489407
6478,0.6479,5,4,5,671636,4808,114788,11468,0.03808135850969459,0.7045957237650529
6479,0.648,9,3,9,671639,4805,114797,11459,0.03805759726270435,0.7045622233152976
6480,0.6481,5,2,5,671641,4803,114802,11454,0.03804175643137752,0.7045580365381067
6481,0.6482,4,4,4,671645,4799,114806,11450,0.03801007476872386,0.7046587482306603
6482,0.6483,6,4,6,671649,4795,114812,11444,0.03797839310607021,0.7047231972412095
6483,0.6484,4,2,4,671651,4793,114816,11440,0.03796255227474338,0.7047372635988418
6484,0.6485,6,3,6,671654,4790,114822,11434,0.03793879102775314,0.7047583826429981
6485,0.6486,4,1,4,671655,4789,114826,11430,0.037930870612089725,0.7047290215179728
6486,0.6487,3,3,3,671658,4786,114829,11427,0.03790710936509948,0.7048047862826127
6487,0.6488,6,3,6,671661,4783,114835,11421,0.037883348118109235,0.7048259688965688
6488,0.6489,7,2,7,671663,4781,114842,11414,0.03786750728678241,0.7047854276011114
6489,0.649,6,2,6,671665,4779,114848,11408,0.03785166645545558,0.7047630814851424
6490,0.6491,5,6,5,671671,4773,114853,11403,0.0378041439614751,0.704933234421365
6491,0.6492,9,1,9,671672,4772,114862,11394,0.037796223545811684,0.7048125695904985
6492,0.6493,7,5,7,671677,4767,114869,11387,0.03775662146749462,0.7049028104494243
6493,0.6494,4,4,4,671681,4763,114873,11383,0.03772493980484096,0.705004335439118
6494,0.6495,5,3,5,671684,4760,114878,11378,0.03770117855785072,0.7050439955384806
6495,0.6496,3,10,3,671694,4750,114881,11375,0.037621974401216576,0.7054263565891473
6496,0.6497,7,7,7,671701,4743,114888,11368,0.03756653149157268,0.7056048662404568
6497,0.6498,5,2,5,671703,4741,114893,11363,0.03755069066024585,0.7056010928961749
6498,0.6499,8,5,8,671708,4736,114901,11355,0.03751108858192878,0.7056739792430551
6499,0.65,11,3,11,671711,4733,114912,11344,0.037487327334938536,0.7056042794053617
6500,0.6501,9,2,9,671713,4731,114921,11335,0.037471486503611706,0.7055272002987676
6501,0.6502,10,2,10,671715,4729,114931,11325,0.03745564567228488,0.7054316681200947
6502,0.6503,4,1,4,671716,4728,114935,11321,0.03744772525662147,0.7054022057449062
6503,0.6504,10,3,10,671719,4725,114945,11311,0.03742396400963122,0.7053504614617111
6504,0.6505,1,3,1,671722,4722,114946,11310,0.037400202762640986,0.7054640718562875
6505,0.6506,10,4,10,671726,4718,114956,11300,0.037368521099987326,0.7054563615932077
6506,0.6507,4,5,4,671731,4713,114960,11296,0.03732891902167026,0.7056030982572303
6507,0.6508,6,6,6,671737,4707,114966,11290,0.037281396527689775,0.7057573294992812
6508,0.6509,6,0,6,671737,4707,114972,11284,0.037281396527689775,0.7056469263960978
6509,0.651,5,3,5,671740,4704,114977,11279,0.03725763528069953,0.7056872927485454
6510,0.6511,8,8,8,671748,4696,114985,11271,0.03719427195539222,0.705893405148118
6511,0.6512,10,3,10,671751,4693,114995,11261,0.03717051070840198,0.7058417951610881
6512,0.6513,6,4,6,671755,4689,115001,11255,0.03713882904574832,0.7059081786251882
6513,0.6514,1,4,1,671759,4685,115002,11254,0.03710714738309467,0.7060668799799235
6514,0.6515,5,4,5,671763,4681,115007,11249,0.03707546572044101,0.7061519146264909
6515,0.6516,3,3,3,671766,4678,115010,11246,0.03705170447345077,0.7062295905551369
6516,0.6517,4,4,4,671770,4674,115014,11242,0.03702002281079711,0.7063332495601911
6517,0.6518,13,3,13,671773,4671,115027,11229,0.03699626156380687,0.7062264150943396
6518,0.6519,3,2,3,671775,4669,115030,11226,0.03698042073248004,0.7062598301352626
6519,0.652,9,5,9,671780,4664,115039,11217,0.03694081865416297,0.7063157231912348
6520,0.6521,5,6,5,671786,4658,115044,11212,0.036893296160182484,0.7064902331442974
6521,0.6522,8,2,8,671788,4656,115052,11204,0.03687745532885566,0.7064312736443884
6522,0.6523,5,1,5,671789,4655,115057,11199,0.036869534913192246,0.7063832471300618
6523,0.6524,6,6,6,671795,4649,115063,11193,0.03682201241921176,0.7065395783360687
6524,0.6525,5,3,5,671798,4646,115068,11188,0.03679825117222152,0.7065807755462928
6525,0.6526,7,2,7,671800,4644,115075,11181,0.03678241034089469,0.7065402843601896
6526,0.6527,5,3,5,671803,4641,115080,11176,0.03675864909390445,0.7065815262059809
6527,0.6528,3,5,3,671808,4636,115083,11173,0.036719047015587376,0.7067493200075906
6528,0.6529,4,4,4,671812,4632,115087,11169,0.036687365352933723,0.7068539965824948
6529,0.653,8,1,8,671813,4631,115095,11161,0.03667944493727031,0.7067502532928065
6530,0.6531,3,0,3,671813,4631,115098,11158,0.03667944493727031,0.7066945341693585
6531,0.6532,6,2,6,671815,4629,115104,11152,0.03666360410594348,0.7066725809517774
6532,0.6533,5,5,5,671820,4624,115109,11147,0.03662400202762641,0.7068036269101515
6533,0.6534,4,6,4,671826,4618,115113,11143,0.03657647953364593,0.706998286910729
6534,0.6535,2,2,2,671828,4616,115115,11141,0.0365606387023191,0.707050834549724
6535,0.6536,9,2,9,671830,4614,115124,11132,0.03654479787099227,0.706973199542741
6536,0.6537,4,2,4,671832,4612,115128,11128,0.03652895703966544,0.7069885641677255
6537,0.6538,6,4,6,671836,4608,115134,11122,0.036497275377011786,0.7070565797838525
6538,0.6539,4,0,4,671836,4608,115138,11118,0.036497275377011786,0.7069820679130103
6539,0.654,2,2,2,671838,4606,115140,11116,0.036481434545684956,0.7070347284060552
6540,0.6541,1,3,1,671841,4603,115141,11115,0.03645767329869472,0.7071510370276116
6541,0.6542,3,5,3,671846,4598,115144,11112,0.03641807122037764,0.7073201782304265
6542,0.6543,5,2,5,671848,4596,115149,11107,0.03640223038905082,0.7073170731707317
6543,0.6544,2,7,2,671855,4589,115151,11105,0.03634678747940692,0.7075952593347776
6544,0.6545,8,3,8,671858,4586,115159,11097,0.03632302623241668,0.7075814576292802
6545,0.6546,8,2,8,671860,4584,115167,11089,0.03630718540108985,0.7075224909079308
6546,0.6547,3,5,3,671865,4579,115170,11086,0.03626758332277278,0.7076923076923077
6547,0.6548,6,3,6,671868,4576,115176,11080,0.036243822075782535,0.7077158916709249
6548,0.6549,2,5,2,671873,4571,115178,11078,0.03620421999746547,0.707904658444629
6549,0.655,7,3,7,671876,4568,115185,11071,0.03618045875047522,0.707909712897244
6550,0.6551,8,7,8,671883,4561,115193,11063,0.036125015840831325,0.7080773169482847
6551,0.6552,5,7,5,671890,4554,115198,11058,0.03606957293118743,0.7083013066871637
6552,0.6553,6,3,6,671893,4551,115204,11052,0.03604581168419719,0.7083253220534512
6553,0.6554,2,2,2,671895,4549,115206,11050,0.03602997085287036,0.7083787422270659
6554,0.6555,6,1,6,671896,4548,115212,11044,0.036022050437206944,0.7083119548486403
6555,0.6556,11,10,11,671906,4538,115223,11033,0.0359428462805728,0.708560786076681
6556,0.6557,8,2,8,671908,4536,115231,11025,0.03592700544924598,0.708502024291498
6557,0.6558,5,3,5,671911,4533,115236,11020,0.035903244202255734,0.7085449752459333
6558,0.6559,6,3,6,671914,4530,115242,11014,0.03587948295526549,0.7085692228512609
6559,0.656,5,5,5,671919,4525,115247,11009,0.03583988087694842,0.7087034891206386
6560,0.6561,5,2,5,671921,4523,115252,11004,0.03582404004562159,0.708700972499517
6561,0.6562,3,6,3,671927,4517,115255,11001,0.03577651755164111,0.7089186750869958
6562,0.6563,5,3,5,671930,4514,115260,10996,0.03575275630465087,0.7089619600257898
6563,0.6564,7,1,7,671931,4513,115267,10989,0.035744835888987456,0.7088762740291575
6564,0.6565,5,2,5,671933,4511,115272,10984,0.035728995057660626,0.7088738302678284
6565,0.6566,10,3,10,671936,4508,115282,10974,0.03570523381067038,0.7088231494638936
6566,0.6567,7,0,7,671936,4508,115289,10967,0.03570523381067038,0.7086914378029079
6567,0.6568,7,1,7,671937,4507,115296,10960,0.03569731339500697,0.7086054179866813
6568,0.6569,7,3,7,671940,4504,115303,10953,0.03567355214801673,0.7086109853140972
6569,0.657,7,4,7,671944,4500,115310,10946,0.035641870485363075,0.7086624368768614
6570,0.6571,6,1,6,671945,4499,115316,10940,0.03563395006969966,0.7085951162640067
6571,0.6572,7,4,7,671949,4495,115323,10933,0.035602268407046,0.7086466165413534
6572,0.6573,7,2,7,671951,4493,115330,10926,0.03558642757571917,0.70860626499773
6573,0.6574,8,2,8,671953,4491,115338,10918,0.03557058674439235,0.7085469530793692
6574,0.6575,3,4,3,671957,4487,115341,10915,0.03553890508173869,0.7086741981560837
6575,0.6576,9,5,9,671962,4482,115350,10906,0.03549930300342162,0.7087340785027294
6576,0.6577,7,4,7,671966,4478,115357,10899,0.03546762134076796,0.7087858489952527
6577,0.6578,10,2,10,671968,4476,115367,10889,0.03545178050944114,0.7086885779368695
6578,0.6579,5,2,5,671970,4474,115372,10884,0.03543593967811431,0.7086860268264097
6579,0.658,3,4,3,671974,4470,115375,10881,0.035404258015460655,0.708813758061364
6580,0.6581,6,0,6,671974,4470,115381,10875,0.035404258015460655,0.7086999022482894
6581,0.6582,6,4,6,671978,4466,115387,10869,0.035372576352806995,0.7087707857841539
6582,0.6583,12,2,12,671980,4464,115399,10857,0.035356735521480165,0.708635206579205
6583,0.6584,6,6,6,671986,4458,115405,10851,0.03530921302749968,0.7087987458357828
6584,0.6585,2,3,2,671989,4455,115407,10849,0.035285451780509444,0.7088996340825928
6585,0.6586,4,0,4,671989,4455,115411,10845,0.035285451780509444,0.7088235294117647
6586,0.6587,7,3,7,671992,4452,115418,10838,0.0352616905335192,0.7088293001962067
6587,0.6588,5,5,5,671997,4447,115423,10833,0.03522208845520213,0.7089659685863874
6588,0.6589,4,3,4,672000,4444,115427,10829,0.03519832720821189,0.7090290054344268
6589,0.659,4,5,4,672005,4439,115431,10825,0.03515872512989482,0.7091850104821803
6590,0.6591,5,4,5,672009,4435,115436,10820,0.03512704346724116,0.7092756473287447
6591,0.6592,4,3,4,672012,4432,115440,10816,0.03510328222025092,0.7093389296956978
6592,0.6593,2,3,2,672015,4429,115442,10814,0.035079520973260676,0.7094403988716133
6593,0.6594,3,5,3,672020,4424,115445,10811,0.03503991889494361,0.7096160157531999
6594,0.6595,7,2,7,672022,4422,115452,10804,0.03502407806361678,0.7095757257323
6595,0.6596,6,4,6,672026,4418,115458,10798,0.034992396400963126,0.7096477392218717
6596,0.6597,8,2,8,672028,4416,115466,10790,0.034976555569636296,0.7095883203998422
6597,0.6598,4,2,4,672030,4414,115470,10786,0.034960714738309466,0.7096052631578947
6598,0.6599,9,0,9,672030,4414,115479,10777,0.034960714738309466,0.7094332170364032
6599,0.66,5,5,5,672035,4409,115484,10772,0.0349211126599924,0.7095711744944339
6600,0.6601,3,6,3,672041,4403,115487,10769,0.034873590166011915,0.7097943580279462
6601,0.6602,7,6,7,672047,4397,115494,10762,0.034826067672031426,0.7099412890032324
6602,0.6603,5,0,5,672047,4397,115499,10757,0.034826067672031426,0.7098455853240069
6603,0.6604,7,2,7,672049,4395,115506,10750,0.0348102268407046,0.7098052162429845
6604,0.6605,11,2,11,672051,4393,115517,10739,0.03479438600937777,0.7096880782447793
6605,0.6606,7,1,7,672052,4392,115524,10732,0.03478646559371436,0.709600634752711
6606,0.6607,5,7,5,672059,4385,115529,10727,0.03473102268407046,0.7098332451032292
6607,0.6608,6,3,6,672062,4382,115535,10721,0.034707261437080215,0.7098589684168708
6608,0.6609,7,4,7,672066,4378,115542,10714,0.03467557977442656,0.7099125364431487
6609,0.661,4,2,4,672068,4376,115546,10710,0.03465973894309973,0.709929736179239
6610,0.6611,3,4,3,672072,4372,115549,10707,0.03462805728044608,0.710060348829498
6611,0.6612,7,3,7,672075,4369,115556,10700,0.034604296033455835,0.7100670250182494
6612,0.6613,7,2,7,672077,4367,115563,10693,0.034588455202129005,0.7100265604249668
6613,0.6614,7,2,7,672079,4365,115570,10686,0.03457261437080218,0.7099860474387084
6614,0.6615,6,3,6,672082,4362,115576,10680,0.03454885312381194,0.7100119664938173
6615,0.6616,2,4,2,672086,4358,115578,10678,0.034517171461158284,0.7101622772013834
6616,0.6617,2,1,2,672087,4357,115580,10676,0.03450925104549487,0.710170957227433
6617,0.6618,2,0,2,672087,4357,115582,10674,0.03450925104549487,0.7101323930543544
6618,0.6619,5,4,5,672091,4353,115587,10669,0.03447756938284121,0.7102250033284516
6619,0.662,9,3,9,672094,4350,115596,10660,0.03445380813585097,0.7101932045303131
6620,0.6621,4,4,4,672098,4346,115600,10656,0.03442212647319731,0.7103052926276496
6621,0.6622,5,3,5,672101,4343,115605,10651,0.034398365226207074,0.7103508069894624
6622,0.6623,2,2,2,672103,4341,115607,10649,0.034382524394880244,0.7104069379586391
6623,0.6624,6,2,6,672105,4339,115613,10643,0.034366683563553414,0.71038579628888
6624,0.6625,7,1,7,672106,4338,115620,10636,0.03435876314789,0.7102978496059837
6625,0.6626,4,0,4,672106,4338,115624,10632,0.03435876314789,0.7102204408817635
6626,0.6627,5,4,5,672110,4334,115629,10627,0.034327081485236347,0.7103134817191364
6627,0.6628,3,3,3,672113,4331,115632,10624,0.0343033202382461,0.7103978602474089
6628,0.6629,2,2,2,672115,4329,115634,10622,0.03428747940691927,0.7104541502240653
6629,0.663,3,4,3,672119,4325,115637,10619,0.03425579774426562,0.7105861884368309
6630,0.6631,7,3,7,672122,4322,115644,10612,0.034232036497275374,0.7105932770858444
6631,0.6632,5,4,5,672126,4318,115649,10607,0.03420035483462172,0.7106867671691792
6632,0.6633,10,6,10,672132,4312,115659,10597,0.03415283234064124,0.7107787242605138
6633,0.6634,3,4,3,672136,4308,115662,10594,0.03412115067798758,0.7109112870755603
6634,0.6635,5,3,5,672139,4305,115667,10589,0.03409738943099734,0.7109574325231637
6635,0.6636,4,1,4,672140,4304,115671,10585,0.034089469015333926,0.7109275303915642
6636,0.6637,9,3,9,672143,4301,115680,10576,0.03406570776834368,0.7108960139813134
6637,0.6638,3,2,3,672145,4299,115683,10573,0.03404986693701686,0.710933297471759
6638,0.6639,1,6,1,672151,4293,115684,10572,0.03400234444303637,0.7112008072653885
6639,0.664,2,3,2,672154,4290,115686,10570,0.03397858319604613,0.7113055181695828
6640,0.6641,6,3,6,672157,4287,115692,10564,0.033954821949055886,0.7113325701972931
6641,0.6642,11,5,11,672162,4282,115703,10553,0.03391521987073882,0.7113582743511965
6642,0.6643,7,3,7,672165,4279,115710,10546,0.03389145862374857,0.7113659359190556
6643,0.6644,7,6,7,672171,4273,115717,10539,0.03384393612976809,0.7115176883607885
6644,0.6645,3,4,3,672175,4269,115720,10536,0.03381225446711444,0.7116514690982776
6645,0.6646,8,5,8,672180,4264,115728,10528,0.03377265238879736,0.7117360735532721
6646,0.6647,2,4,2,672184,4260,115730,10526,0.03374097072614371,0.7118896253212499
6647,0.6648,6,3,6,672187,4257,115736,10520,0.033717209479153465,0.711917168572782
6648,0.6649,2,3,2,672190,4254,115738,10518,0.03369344823216323,0.7120227457351747
6649,0.665,1,1,1,672191,4253,115739,10517,0.03368552781649981,0.7120514556533514
6650,0.6651,7,4,7,672195,4249,115746,10510,0.03365384615384615,0.7121078663866116
6651,0.6652,10,6,10,672201,4243,115756,10500,0.03360632365986567,0.7122024011395238
6652,0.6653,7,1,7,672202,4242,115763,10493,0.033598403244202255,0.7121140142517814
6653,0.6654,7,2,7,672204,4240,115770,10486,0.033582562412875425,0.7120738829281543
6654,0.6655,7,2,7,672206,4238,115777,10479,0.0335667215815486,0.7120337025208942
6655,0.6656,3,4,3,672210,4234,115780,10476,0.03353503991889494,0.7121685927940177
6656,0.6657,3,4,3,672214,4230,115783,10473,0.03350335825624129,0.7123036115078556
6657,0.6658,4,4,4,672218,4226,115787,10469,0.03347167659358763,0.7124191902007485
6658,0.6659,2,7,2,672225,4219,115789,10467,0.03341623368394373,0.7127195968950021
6659,0.666,6,6,6,672231,4213,115795,10461,0.03336871118996325,0.7128935532233883
6660,0.6661,3,2,3,672233,4211,115798,10458,0.03335287035863642,0.7129320335401186
6661,0.6662,1,1,1,672234,4210,115799,10457,0.033344949942973004,0.7129610690666122
6662,0.6663,2,2,2,672236,4208,115801,10455,0.03332910911164618,0.7130191638818796
6663,0.6664,7,3,7,672239,4205,115808,10448,0.033305347864655936,0.713028048863714
6664,0.6665,6,2,6,672241,4203,115814,10442,0.033289507033329106,0.7130078525093889
6665,0.6666,6,6,6,672247,4197,115820,10436,0.033241984539348624,0.7131825326317228
6666,0.6667,3,4,3,672251,4193,115823,10433,0.03321030287669497,0.7133187474360727
6667,0.6668,8,2,8,672253,4191,115831,10425,0.03319446204536814,0.7132594417077176
6668,0.6669,7,4,7,672257,4187,115838,10418,0.03316278038271449,0.7133173570694967
6669,0.667,7,4,7,672261,4183,115845,10411,0.03313109872006083,0.7133753597368782
6670,0.6671,6,4,6,672265,4179,115851,10405,0.033099417057407175,0.7134530992868897
6671,0.6672,5,5,5,672270,4174,115856,10400,0.0330598149790901,0.7135995608618086
6672,0.6673,12,2,12,672272,4172,115868,10388,0.03304397414776328,0.7134615384615385
6673,0.6674,4,3,4,672275,4169,115872,10384,0.03302021290077303,0.7135298563869993
6674,0.6675,8,1,8,672276,4168,115880,10376,0.03301229248510962,0.7134213421342134
6675,0.6676,7,1,7,672277,4167,115887,10369,0.0330043720694462,0.7133324160704458
6676,0.6677,9,1,9,672278,4166,115896,10360,0.03299645165378279,0.7132039102299326
6677,0.6678,5,5,5,672283,4161,115901,10355,0.03295684957546572,0.7133507853403142
6678,0.6679,4,5,4,672288,4156,115905,10351,0.03291724749714865,0.71351761218722
6679,0.668,8,2,8,672290,4154,115913,10343,0.03290140666582182,0.7134579568186521
6680,0.6681,6,3,6,672293,4151,115919,10337,0.03287764541883158,0.7134870237437879
6681,0.6682,6,3,6,672296,4148,115925,10331,0.03285388417184134,0.7135161268043373
6682,0.6683,8,4,8,672300,4144,115933,10323,0.03282220250918768,0.7135549872122762
6683,0.6684,14,4,14,672304,4140,115947,10309,0.03279052084653403,0.713474980967541
6684,0.6685,6,0,6,672304,4140,115953,10303,0.03279052084653403,0.7133559509797134
6685,0.6686,2,2,2,672306,4138,115955,10301,0.0327746800152072,0.7134150564443521
6686,0.6687,7,3,7,672309,4135,115962,10294,0.03275091876821696,0.7134243537320674
6687,0.6688,9,1,9,672310,4134,115971,10285,0.032742998352553544,0.713294958041473
6688,0.6689,5,7,5,672317,4127,115976,10280,0.03268755544290965,0.7135420281807455
6689,0.669,4,7,4,672324,4120,115980,10276,0.03263211253326575,0.7138093914976382
6690,0.6691,6,1,6,672325,4119,115986,10270,0.032624192117602334,0.7137396622419904
6691,0.6692,8,4,8,672329,4115,115994,10262,0.032592510454948674,0.7137789524935662
6692,0.6693,6,3,6,672332,4112,116000,10256,0.032568749207958436,0.7138084632516704
6693,0.6694,4,1,4,672333,4111,116004,10252,0.03256082879229502,0.7137784585393023
6694,0.6695,6,4,6,672337,4107,116010,10246,0.03252914712964136,0.7138577300912701
6695,0.6696,6,2,6,672339,4105,116016,10240,0.03251330629831454,0.7138375740676194
6696,0.6697,1,3,1,672342,4102,116017,10239,0.032489545051324294,0.7139669479115822
6697,0.6698,7,4,7,672346,4098,116024,10232,0.03245786338867064,0.7140265177948361
6698,0.6699,2,1,2,672347,4097,116026,10230,0.032449942973007226,0.7140364347037063
6699,0.67,2,7,2,672354,4090,116028,10228,0.03239450006336333,0.7143455789914792
6700,0.6701,5,3,5,672357,4087,116033,10223,0.03237073881637308,0.7143955276030748
6701,0.6702,2,1,2,672358,4086,116035,10221,0.03236281840070967,0.7144055357517299
6702,0.6703,8,2,8,672360,4084,116043,10213,0.03234697756938284,0.7143456669231307
6703,0.6704,5,1,5,672361,4083,116048,10208,0.03233905715371943,0.7142957105870827
6704,0.6705,6,4,6,672365,4079,116054,10202,0.03230737549106577,0.7143757439955185
6705,0.6706,2,6,2,672371,4073,116056,10200,0.03225985299708529,0.7146360260631962
6706,0.6707,4,0,4,672371,4073,116060,10196,0.03225985299708529,0.7145560305557502
6707,0.6708,4,5,4,672376,4068,116064,10192,0.03222025091876822,0.714726507713885
6708,0.6709,10,4,10,672380,4064,116074,10182,0.03218856925611456,0.71472694089569
6709,0.671,10,1,10,672381,4063,116084,10172,0.032180648840451145,0.7145767474534598
6710,0.6711,9,2,9,672383,4061,116093,10163,0.032164808009124315,0.7144966254218222
6711,0.6712,4,3,4,672386,4058,116097,10159,0.03214104676213408,0.7145670675951326
6712,0.6713,6,6,6,672392,4052,116103,10153,0.032093524268153595,0.7147483280535023
6713,0.6714,7,2,7,672394,4050,116110,10146,0.032077683436826765,0.7147083685545224
6714,0.6715,4,1,4,672395,4049,116114,10142,0.03206976302116335,0.7146783172433232
6715,0.6716,2,3,2,672398,4046,116116,10140,0.032046001774173105,0.7147892288171437
6716,0.6717,4,2,4,672400,4044,116120,10136,0.03203016094284628,0.7148095909732017
6717,0.6718,8,5,8,672405,4039,116128,10128,0.03199055886452921,0.7149008258629209
6718,0.6719,7,4,7,672409,4035,116135,10121,0.031958877201875555,0.7149618536309692
6719,0.672,5,4,5,672413,4031,116140,10116,0.0319271955392219,0.7150632642963173
6720,0.6721,4,3,4,672416,4028,116144,10112,0.03190343429223166,0.7151343705799151
6721,0.6722,1,2,1,672418,4026,116145,10111,0.03188759346090483,0.715215392233147
6722,0.6723,9,8,9,672426,4018,116154,10102,0.031824230135597514,0.7154390934844193
6723,0.6724,10,7,10,672433,4011,116164,10092,0.03176878722595362,0.7155924271431611
6724,0.6725,4,3,4,672436,4008,116168,10088,0.03174502597896338,0.7156640181611805
6725,0.6726,6,3,6,672439,4005,116174,10082,0.031721264731973134,0.7156953219280188
6726,0.6727,9,5,9,672444,4000,116183,10073,0.031681662653656066,0.7157677822781212
6727,0.6728,8,1,8,672445,3999,116191,10065,0.03167374223799265,0.7156569965870307
6728,0.6729,2,1,2,672446,3998,116193,10063,0.031665821822329236,0.7156674489723348
6729,0.673,7,4,7,672450,3994,116200,10056,0.031634140159675576,0.7157295373665481
6730,0.6731,6,3,6,672453,3991,116206,10050,0.03161037891268534,0.7157609856847803
6731,0.6732,6,3,6,672456,3988,116212,10044,0.031586617665695094,0.7157924743443558
6732,0.6733,3,0,3,672456,3988,116215,10041,0.031586617665695094,0.7157316986242783
6733,0.6734,8,2,8,672458,3986,116223,10033,0.03157077683436827,0.7156715885583851
6734,0.6735,2,1,2,672459,3985,116225,10031,0.031562856418704856,0.7156820776255708
6735,0.6736,5,5,5,672464,3980,116230,10026,0.03152325434038778,0.7158360702556047
6736,0.6737,4,6,4,672470,3974,116234,10022,0.0314757318464073,0.7160617319234067
6737,0.6738,8,3,8,672473,3971,116242,10014,0.03145197059941706,0.7160529138362531
6738,0.6739,6,1,6,672474,3970,116248,10008,0.031444050183753645,0.7159822578337387
6739,0.674,7,3,7,672477,3967,116255,10001,0.0314202889367634,0.7159936998854525
6740,0.6741,2,5,2,672482,3962,116257,9999,0.03138068685844633,0.7162094405844853
6741,0.6742,6,5,6,672487,3957,116263,9993,0.03134108478012926,0.7163440860215053
6742,0.6743,5,7,5,672494,3950,116268,9988,0.03128564187048536,0.7166020949921079
6743,0.6744,3,3,3,672497,3947,116271,9985,0.03126188062349512,0.7166953775480908
6744,0.6745,5,3,5,672500,3944,116276,9980,0.031238119376504878,0.7167480609020397
6745,0.6746,5,2,5,672502,3942,116281,9975,0.03122227854517805,0.716749299417978
6746,0.6747,8,7,8,672509,3935,116289,9967,0.031166835635534153,0.7169472018414617
6747,0.6748,9,8,9,672517,3927,116298,9958,0.03110347231022684,0.7171768095066618
6748,0.6749,2,1,2,672518,3926,116300,9956,0.031095551894563426,0.7171877251116554
6749,0.675,6,1,6,672519,3925,116306,9950,0.031087631478900014,0.7171171171171171
6750,0.6751,9,5,9,672524,3920,116315,9941,0.031048029400582943,0.7171921217805353
6751,0.6752,5,2,5,672526,3918,116320,9936,0.031032188569256113,0.7171935902988307
6752,0.6753,9,2,9,672528,3916,116329,9927,0.031016347737929287,0.7171133424835657
6753,0.6754,6,1,6,672529,3915,116335,9921,0.031008427322265872,0.7170424978317432
6754,0.6755,8,3,8,672532,3912,116343,9913,0.03098466607527563,0.7170343580470163
6755,0.6756,4,3,4,672535,3909,116347,9909,0.03096090482828539,0.7171081198436822
6756,0.6757,6,4,6,672539,3905,116353,9903,0.030929223165631733,0.7171929316338355
6757,0.6758,5,1,5,672540,3904,116358,9898,0.030921302749968318,0.7171424431241848
6758,0.6759,3,4,3,672544,3900,116361,9895,0.03088962108731466,0.7172888727799928
6759,0.676,3,3,3,672547,3897,116364,9892,0.03086585984032442,0.7173834215679165
6760,0.6761,6,1,6,672548,3896,116370,9886,0.030857939424661005,0.7173124365113916
6761,0.6762,8,2,8,672550,3894,116378,9878,0.03084209859333418,0.7172523961661342
6762,0.6763,7,5,7,672555,3889,116385,9871,0.030802496515017107,0.7173691860465117
6763,0.6764,6,3,6,672558,3886,116391,9865,0.030778735268026866,0.7174023707366737
6764,0.6765,6,2,6,672560,3884,116397,9859,0.03076289443670004,0.7173833951830022
6765,0.6766,5,5,5,672565,3879,116402,9854,0.03072329235838297,0.7175416879050462
6766,0.6767,5,2,5,672567,3877,116407,9849,0.03070745152705614,0.717543348389917
6767,0.6768,7,2,7,672569,3875,116414,9842,0.030691610695729312,0.7175038273675002
6768,0.6769,5,3,5,672572,3872,116419,9837,0.03066784944873907,0.7175578087387847
6769,0.677,4,1,4,672573,3871,116423,9833,0.030659929033075656,0.7175277291301809
6770,0.6771,5,3,5,672576,3868,116428,9828,0.030636167786085414,0.7175817757009346
6771,0.6772,4,2,4,672578,3866,116432,9824,0.030620326954758584,0.7176040905770635
6772,0.6773,5,6,5,672584,3860,116437,9819,0.030572804460778102,0.7178156297974998
6773,0.6774,2,1,2,672585,3859,116439,9817,0.030564884045114687,0.7178268499561276
6774,0.6775,5,5,5,672590,3854,116444,9812,0.03052528196679762,0.7179862432313772
6775,0.6776,6,5,6,672595,3849,116450,9806,0.030485679888480548,0.7181252288538996
6776,0.6777,9,4,9,672599,3845,116459,9797,0.03045399822582689,0.7181498314030201
6777,0.6778,5,3,5,672602,3842,116464,9792,0.03043023697883665,0.7182044887780549
6778,0.6779,2,7,2,672609,3835,116466,9790,0.030374794069192752,0.7185321100917431
6779,0.678,8,3,8,672612,3832,116474,9782,0.030351032822202507,0.7185250477449684
6780,0.6781,1,2,1,672614,3830,116475,9781,0.03033519199087568,0.7186099478363088
6781,0.6782,5,3,5,672617,3827,116480,9776,0.03031143074388544,0.718665000367566
6782,0.6783,4,3,4,672620,3824,116484,9772,0.0302876694968952,0.7187408061194469
6783,0.6784,4,4,4,672624,3820,116488,9768,0.030255987834241542,0.7188695908154253
6784,0.6785,8,6,8,672630,3814,116496,9760,0.030208465340261056,0.719021659054074
6785,0.6786,6,1,6,672631,3813,116502,9754,0.030200544924597644,0.7189503943392054
6786,0.6787,12,5,12,672636,3808,116514,9742,0.030160942846280573,0.7189667896678967
6787,0.6788,5,6,5,672642,3802,116519,9737,0.03011342035230009,0.719181623458158
6788,0.6789,3,4,3,672646,3798,116522,9734,0.030081738689646434,0.7193319538870825
6789,0.679,5,2,5,672648,3796,116527,9729,0.030065897858319604,0.7193345656192237
6790,0.6791,7,5,7,672653,3791,116534,9722,0.030026295780002536,0.7194553393028935
6791,0.6792,8,2,8,672655,3789,116542,9714,0.030010454948675706,0.7193956898467008
6792,0.6793,6,4,6,672659,3785,116548,9708,0.02997877328602205,0.7194841769806566
6793,0.6794,6,4,6,672663,3781,116554,9702,0.029947091623368394,0.7195727953719498
6794,0.6795,6,1,6,672664,3780,116560,9696,0.02993917120770498,0.7195013357079252
6795,0.6796,7,2,7,672666,3778,116567,9689,0.029923330376378152,0.7194623895448132
6796,0.6797,2,2,2,672668,3776,116569,9687,0.029907489545051326,0.7195275941469212
6797,0.6798,5,4,5,672672,3772,116574,9682,0.02987580788239767,0.7196372825925376
6798,0.6799,5,4,5,672676,3768,116579,9677,0.029844126219744013,0.7197471178876906
6799,0.68,3,4,3,672680,3764,116582,9674,0.029812444557090357,0.7198987944634618
6800,0.6801,6,3,6,672683,3761,116588,9668,0.029788683310100116,0.7199344701764837
6801,0.6802,8,8,8,672691,3753,116596,9660,0.029725319984792803,0.720196823976739
6802,0.6803,5,1,5,672692,3752,116601,9655,0.029717399569129388,0.7201461922876109
6803,0.6804,8,3,8,672695,3749,116609,9647,0.029693638322139147,0.7201403404001194
6804,0.6805,7,0,7,672695,3749,116616,9640,0.029693638322139147,0.7199940249458511
6805,0.6806,7,3,7,672698,3746,116623,9633,0.029669877075148905,0.7200089692802153
6806,0.6807,9,8,9,672706,3738,116632,9624,0.029606513749841593,0.7202514593623709
6807,0.6808,1,1,1,672707,3737,116633,9623,0.029598593334178178,0.7202844311377246
6808,0.6809,5,1,5,672708,3736,116638,9618,0.029590672918514763,0.720233637861315
6809,0.681,5,1,5,672709,3735,116643,9613,0.02958275250285135,0.7201827989211866
6810,0.6811,8,4,8,672713,3731,116651,9605,0.029551070840197695,0.7202309538092382
6811,0.6812,4,1,4,672714,3730,116655,9601,0.02954315042453428,0.7202010351811567
6812,0.6813,8,2,8,672716,3728,116663,9593,0.02952730959320745,0.7201411305457548
6813,0.6814,5,4,5,672720,3724,116668,9588,0.029495627930553797,0.7202524038461539
6814,0.6815,9,4,9,672724,3720,116677,9579,0.02946394626790014,0.7202797202797203
6815,0.6816,6,3,6,672727,3717,116683,9573,0.029440185020909896,0.7203160270880361
6816,0.6817,3,6,3,672733,3711,116686,9570,0.029392662526929413,0.7205782697086063
6817,0.6818,5,4,5,672737,3707,116691,9565,0.029360980864275757,0.7206901748040988
6818,0.6819,12,2,12,672739,3705,116703,9553,0.02934514003294893,0.7205460853824106
6819,0.682,0,2,0,672741,3703,116703,9553,0.0293292992016221,0.7206547978273989
6820,0.6821,10,3,10,672744,3700,116713,9543,0.02930553795463186,0.720607113191875
6821,0.6822,10,2,10,672746,3698,116723,9533,0.02928969712330503,0.7205048749149724
6822,0.6823,8,1,8,672747,3697,116731,9525,0.029281776707641618,0.7203902586598094
6823,0.6824,5,5,5,672752,3692,116736,9520,0.029242174629324547,0.7205570693309112
6824,0.6825,3,2,3,672754,3690,116739,9517,0.02922633379799772,0.7206027106837283
6825,0.6826,10,4,10,672758,3686,116749,9507,0.029194652135344064,0.720609414083226
6826,0.6827,7,2,7,672760,3684,116756,9500,0.029178811304017234,0.7205703883495146
6827,0.6828,7,3,7,672763,3681,116763,9493,0.029155050057026993,0.7205860027326553
6828,0.6829,6,0,6,672763,3681,116769,9487,0.029155050057026993,0.7204586877278251
6829,0.683,3,1,3,672764,3680,116772,9484,0.029147129641363578,0.7204497113339411
6830,0.6831,7,5,7,672769,3675,116779,9477,0.02910752756304651,0.7205748175182481
6831,0.6832,7,3,7,672772,3672,116786,9470,0.029083766316056265,0.7205904732917364
6832,0.6833,2,3,2,672775,3669,116788,9468,0.029060005069066024,0.720712491436401
6833,0.6834,8,1,8,672776,3668,116796,9460,0.029052084653402612,0.7205971968312005
6834,0.6835,1,6,1,672782,3662,116797,9459,0.029004562159422126,0.7209054187942993
6835,0.6836,5,1,5,672783,3661,116802,9454,0.02899664174375871,0.7208539839878002
6836,0.6837,2,0,2,672783,3661,116804,9452,0.02899664174375871,0.7208114085258903
6837,0.6838,8,2,8,672785,3659,116812,9444,0.028980800912431885,0.7207509730596047
6838,0.6839,4,2,4,672787,3657,116816,9440,0.028964960081105058,0.7207757501717951
6839,0.684,6,5,6,672792,3652,116822,9434,0.028925358002787987,0.7209231239492587
6840,0.6841,8,1,8,672793,3651,116830,9426,0.028917437587124572,0.7208075246616197
6841,0.6842,8,2,8,672795,3649,116838,9418,0.028901596755797745,0.7207469197214357
6842,0.6843,5,3,5,672798,3646,116843,9413,0.0288778355088075,0.720805574699441
6843,0.6844,5,3,5,672801,3643,116848,9408,0.02885407426181726,0.7208643015860854
6844,0.6845,3,1,3,672802,3642,116851,9405,0.028846153846153848,0.7208553690503564
6845,0.6846,3,2,3,672804,3640,116854,9402,0.028830313014827018,0.7209017021929152
6846,0.6847,6,2,6,672806,3638,116860,9396,0.02881447218350019,0.7208838422587079
6847,0.6848,5,3,5,672809,3635,116865,9391,0.028790710936509947,0.7209427299247658
6848,0.6849,9,1,9,672810,3634,116874,9382,0.028782790520846535,0.7208051628764598
6849,0.685,1,2,1,672812,3632,116875,9381,0.028766949689519705,0.7208944901252593
6850,0.6851,9,2,9,672814,3630,116884,9372,0.02875110885819288,0.7208121827411168
6851,0.6852,6,3,6,672817,3627,116890,9366,0.028727347611202637,0.7208496882936966
6852,0.6853,8,5,8,672822,3622,116898,9358,0.028687745532885566,0.7209553158705702
6853,0.6854,9,2,9,672824,3620,116907,9349,0.028671904701558736,0.720872850643843
6854,0.6855,4,2,4,672826,3618,116911,9345,0.02865606387023191,0.7208979402915991
6855,0.6856,7,1,7,672827,3617,116918,9338,0.028648143454568495,0.7208027788498649
6856,0.6857,5,3,5,672830,3614,116923,9333,0.028624382207578253,0.7208619757472774
6857,0.6858,4,3,4,672833,3611,116927,9329,0.028600620960588012,0.7209428129829984
6858,0.6859,9,0,9,672833,3611,116936,9320,0.028600620960588012,0.7207485886629031
6859,0.686,4,6,4,672839,3605,116940,9316,0.028553098466607526,0.7209968268709852
6860,0.6861,7,2,7,672841,3603,116947,9309,0.0285372576352807,0.720957249070632
6861,0.6862,7,2,7,672843,3601,116954,9302,0.028521416803953873,0.720917616058281
6862,0.6863,4,6,4,672849,3595,116958,9298,0.028473894309973387,0.721166524470643
6863,0.6864,8,2,8,672851,3593,116966,9290,0.02845805347864656,0.7211053326088644
6864,0.6865,4,3,4,672854,3590,116970,9286,0.02843429223165632,0.7211867039453246
6865,0.6866,11,3,11,672857,3587,116981,9275,0.028410530984666074,0.7211164671124242
6866,0.6867,11,1,11,672858,3586,116992,9264,0.028402610569002663,0.7209338521400778
6867,0.6868,4,6,4,672864,3580,116996,9260,0.028355088075022176,0.721183800623053
6868,0.6869,3,6,3,672870,3574,116999,9257,0.028307565581041694,0.7214558491154236
6869,0.687,3,4,3,672874,3570,117002,9254,0.028275883918388037,0.7216157205240175
6870,0.6871,4,4,4,672878,3566,117006,9250,0.02824420225573438,0.7217540574282147
6871,0.6872,6,8,6,672886,3558,117012,9244,0.02818083893042707,0.7220746758319012
6872,0.6873,6,6,6,672892,3552,117018,9238,0.028133316436446586,0.7222830336200157
6873,0.6874,6,3,6,672895,3549,117024,9232,0.028109555189456344,0.7223221970111885
6874,0.6875,6,4,6,672899,3545,117030,9226,0.028077873526802688,0.7224179782319318
6875,0.6876,5,6,5,672905,3539,117035,9221,0.028030351032822202,0.7226489028213167
6876,0.6877,8,3,8,672908,3536,117043,9213,0.02800658978583196,0.7226449133265355
6877,0.6878,5,3,5,672911,3533,117048,9208,0.02798282853884172,0.7227062240012558
6878,0.6879,5,7,5,672918,3526,117053,9203,0.02792738562919782,0.7229947364286275
6879,0.688,1,5,1,672923,3521,117054,9202,0.02788778355088075,0.723257093452802
6880,0.6881,9,4,9,672927,3517,117063,9193,0.027856101888227094,0.7232887490165224
6881,0.6882,11,1,11,672928,3516,117074,9182,0.02784818147256368,0.7231060009450307
6882,0.6883,10,5,10,672933,3511,117084,9172,0.02780857939424661,0.723172750926437
6883,0.6884,10,1,10,672934,3510,117094,9162,0.027800658978583196,0.7230113636363636
6884,0.6885,6,4,6,672938,3506,117100,9156,0.02776897731592954,0.7231085136629285
6885,0.6886,8,3,8,672941,3503,117108,9148,0.0277452160689393,0.7231048928938424
6886,0.6887,3,2,3,672943,3501,117111,9145,0.02772937523761247,0.7231535663450893
6887,0.6888,3,1,3,672944,3500,117114,9142,0.027721454821949057,0.7231450719822813
6888,0.6889,13,3,13,672947,3497,117127,9129,0.027697693574958812,0.7230318390622525
6889,0.689,5,1,5,672948,3496,117132,9124,0.0276897731592954,0.7229793977812995
6890,0.6891,0,3,0,672951,3493,117132,9124,0.02766601191230516,0.7231513037964651
6891,0.6892,4,1,4,672952,3492,117136,9120,0.027658091496641744,0.7231208372978116
6892,0.6893,8,4,8,672956,3488,117144,9112,0.027626409833988088,0.7231746031746031
6893,0.6894,3,2,3,672958,3486,117147,9109,0.027610569002661258,0.7232235013894402
6894,0.6895,3,3,3,672961,3483,117150,9106,0.027586807755671017,0.7233298911748351
6895,0.6896,6,1,6,672962,3482,117156,9100,0.027578887340007605,0.7232554442854872
6896,0.6897,7,3,7,672965,3479,117163,9093,0.02755512609301736,0.7232739420935412
6897,0.6898,4,1,4,672966,3478,117167,9089,0.02754720567735395,0.723243415294024
6898,0.6899,6,3,6,672969,3475,117173,9083,0.027523444430363704,0.7232839624143972
6899,0.69,5,3,5,672972,3472,117178,9078,0.027499683183373463,0.7233466135458168
6900,0.6901,9,3,9,672975,3469,117187,9069,0.02747592193638322,0.7233211038443133
6901,0.6902,4,2,4,672977,3467,117191,9065,0.027460081105056395,0.7233482285349505
6902,0.6903,5,2,5,672979,3465,117196,9060,0.027444240273729565,0.7233532934131737
6903,0.6904,4,1,4,672980,3464,117200,9056,0.02743631985806615,0.7233226837060703
6904,0.6905,2,4,2,672984,3460,117202,9054,0.027404638195412494,0.7235096691705291
6905,0.6906,12,5,12,672989,3455,117214,9042,0.027365036117095426,0.7235336480755381
6906,0.6907,4,4,4,672993,3451,117218,9038,0.02733335445444177,0.7236768356153415
6907,0.6908,3,2,3,672995,3449,117221,9035,0.02731751362311494,0.7237263697532842
6908,0.6909,10,3,10,672998,3446,117231,9025,0.0272937523761247,0.7236789351295004
6909,0.691,4,4,4,673002,3442,117235,9021,0.027262070713471042,0.7238225146433444
6910,0.6911,5,2,5,673004,3440,117240,9016,0.027246229882144216,0.7238278741168914
6911,0.6912,6,3,6,673007,3437,117246,9010,0.027222468635153974,0.7238692054310275
6912,0.6913,5,2,5,673009,3435,117251,9005,0.027206627803827144,0.7238745980707395
6913,0.6914,5,1,5,673010,3434,117256,9000,0.02719870738816373,0.7238217789930835
6914,0.6915,4,3,4,673013,3431,117260,8996,0.027174946141173488,0.7239076205037418
6915,0.6916,5,3,5,673016,3428,117265,8991,0.027151184894183247,0.7239713342459135
6916,0.6917,6,2,6,673018,3426,117271,8985,0.02713534406285642,0.7239545564418661
6917,0.6918,2,1,2,673019,3425,117273,8983,0.027127423647193005,0.7239684074790458
6918,0.6919,8,2,8,673021,3423,117281,8975,0.027111582815866175,0.723907081787385
6919,0.692,1,3,1,673024,3420,117282,8974,0.027087821568875934,0.7240600290463127
6920,0.6921,9,4,9,673028,3416,117291,8965,0.027056139906222278,0.7240933688716582
6921,0.6922,7,3,7,673031,3413,117298,8958,0.027032378659232036,0.724112844555816
6922,0.6923,3,3,3,673034,3410,117301,8955,0.027008617412241795,0.7242215932066316
6923,0.6924,2,2,2,673036,3408,117303,8953,0.026992776580914965,0.7242941509586603
6924,0.6925,5,4,5,673040,3404,117308,8948,0.02696109491826131,0.7244170984455959
6925,0.6926,5,2,5,673042,3402,117313,8943,0.026945254086934482,0.7244228432563791
6926,0.6927,2,2,2,673044,3400,117315,8941,0.026929413255607656,0.7244955838262701
6927,0.6928,4,2,4,673046,3398,117319,8937,0.026913572424280826,0.7245237130117552
6928,0.6929,8,6,8,673052,3392,117327,8929,0.026866049930300343,0.7246976706436166
6929,0.693,1,7,1,673059,3385,117328,8928,0.026810607020656445,0.7250873060992447
6930,0.6931,14,6,14,673065,3379,117342,8914,0.02676308452667596,0.7251281216952737
6931,0.6932,8,2,8,673067,3377,117350,8906,0.026747243695349133,0.7250671660017911
6932,0.6933,3,4,3,673071,3373,117353,8903,0.026715562032695477,0.7252362333007494
6933,0.6934,9,3,9,673074,3370,117362,8894,0.026691800785705235,0.7252120026092629
6934,0.6935,9,4,9,673078,3366,117371,8885,0.02666011912305158,0.7252469186188882
6935,0.6936,5,3,5,673081,3363,117376,8880,0.026636357876061334,0.725312423425631
6936,0.6937,4,3,4,673084,3360,117380,8876,0.026612596629071093,0.7254004576659039
6937,0.6938,9,2,9,673086,3358,117389,8867,0.026596755797744266,0.7253169734151329
6938,0.6939,8,3,8,673089,3355,117397,8859,0.026572994550754025,0.7253152120517439
6939,0.694,6,4,6,673093,3351,117403,8853,0.02654131288810037,0.7254178957718781
6940,0.6941,7,3,7,673096,3348,117410,8846,0.026517551641110127,0.7254387403641135
6941,0.6942,10,0,10,673096,3348,117420,8836,0.026517551641110127,0.7252133946158897
6942,0.6943,3,4,3,673100,3344,117423,8833,0.02648586997845647,0.7253839205058717
6943,0.6944,5,2,5,673102,3342,117428,8828,0.02647002914712964,0.7253903040262941
6944,0.6945,5,1,5,673103,3341,117433,8823,0.026462108731466226,0.7253370601775732
6945,0.6946,6,2,6,673105,3339,117439,8817,0.0264462679001394,0.7253208292201382
6946,0.6947,4,2,4,673107,3337,117443,8813,0.02643042706881257,0.7253497942386832
6947,0.6948,10,2,10,673109,3335,117453,8803,0.026414586237485743,0.7252430383918274
6948,0.6949,5,4,5,673113,3331,117458,8798,0.026382904574832087,0.7253689504493362
6949,0.695,5,5,5,673118,3326,117463,8793,0.026343302496515016,0.7255549137717634
6950,0.6951,4,2,4,673120,3324,117467,8789,0.02632746166518819,0.7255840832163791
6951,0.6952,4,4,4,673124,3320,117471,8785,0.026295780002534533,0.7257331681123502
6952,0.6953,2,5,2,673129,3315,117473,8783,0.02625617792421746,0.7259877665729872
6953,0.6954,5,1,5,673130,3314,117478,8778,0.02624825750855405,0.725934502150182
6954,0.6955,12,9,12,673139,3305,117490,8766,0.026176973767583323,0.726203297158479
6955,0.6956,7,2,7,673141,3303,117497,8759,0.026161132936256496,0.7261648151218704
6956,0.6957,8,3,8,673144,3300,117505,8751,0.02613737168926625,0.7261638038337067
6957,0.6958,8,6,8,673150,3294,117513,8743,0.02608984919528577,0.7263437733654565
6958,0.6959,5,3,5,673153,3291,117518,8738,0.026066087948295527,0.7264111729985867
6959,0.696,3,0,3,673153,3291,117521,8735,0.026066087948295527,0.7263429236653917
6960,0.6961,3,3,3,673156,3288,117524,8732,0.026042326701305286,0.7264559068219634
6961,0.6962,0,3,0,673159,3285,117524,8732,0.02601856545431504,0.7266372638761754
6962,0.6963,3,3,3,673162,3282,117527,8729,0.0259948042073248,0.7267504787278328
6963,0.6964,5,5,5,673167,3277,117532,8724,0.02595520212900773,0.7269394217148571
6964,0.6965,6,3,6,673170,3274,117538,8718,0.025931440882017487,0.7269846564376251
6965,0.6966,6,3,6,673173,3271,117544,8712,0.025907679635027245,0.7270299591087374
6966,0.6967,4,2,4,673175,3269,117548,8708,0.02589183880370042,0.7270601987142022
6967,0.6968,7,2,7,673177,3267,117555,8701,0.02587599797237359,0.7270220588235294
6968,0.6969,5,6,5,673183,3261,117560,8696,0.025828475478393106,0.7272727272727273
6969,0.697,6,2,6,673185,3259,117566,8690,0.025812634647066277,0.727257511088794
6970,0.6971,3,2,3,673187,3257,117569,8687,0.02579679381573945,0.7273107836570664
6971,0.6972,6,1,6,673188,3256,117575,8681,0.025788873400076035,0.727234648571668
6972,0.6973,5,1,5,673189,3255,117580,8676,0.025780952984412624,0.727181292431481
6973,0.6974,9,1,9,673190,3254,117589,8667,0.02577303256874921,0.7270363224561698
6974,0.6975,5,6,5,673196,3248,117594,8662,0.025725510074768723,0.7272879932829555
6975,0.6976,6,4,6,673200,3244,117600,8656,0.025693828412115066,0.7273949579831933
6976,0.6977,5,3,5,673203,3241,117605,8651,0.025670067165124825,0.7274638412378069
6977,0.6978,6,4,6,673207,3237,117611,8645,0.02563838550247117,0.7275711159737418
6978,0.6979,4,3,4,673210,3234,117615,8641,0.025614624255480927,0.7276631578947368
6979,0.698,8,3,8,673213,3231,117623,8633,0.025590863008490686,0.7276635198921105
6980,0.6981,3,3,3,673216,3228,117626,8630,0.025567101761500444,0.7277787147917018
6981,0.6982,5,5,5,673221,3223,117631,8625,0.025527499683183373,0.7279709655638082
6982,0.6983,6,5,6,673226,3218,117637,8619,0.025487897604866302,0.7281405761594999
6983,0.6984,5,5,5,673231,3213,117642,8614,0.025448295526549234,0.728333474253826
6984,0.6985,4,7,4,673238,3206,117646,8610,0.025392852616905336,0.7286729857819905
6985,0.6986,4,1,4,673239,3205,117650,8606,0.02538493220124192,0.7286427906189146
6986,0.6987,7,2,7,673241,3203,117657,8599,0.02536909136991509,0.7286053211320115
6987,0.6988,7,4,7,673245,3199,117664,8592,0.02533740970726144,0.7286913747773726
6988,0.6989,7,1,7,673246,3198,117671,8585,0.025329489291598024,0.728592039378766
6989,0.699,4,1,4,673247,3197,117675,8581,0.02532156887593461,0.7285617252504669
6990,0.6991,4,6,4,673253,3191,117679,8577,0.025274046381954126,0.7288409245411285
6991,0.6992,4,4,4,673257,3187,117683,8573,0.02524236471930047,0.7289965986394558
6992,0.6993,5,2,5,673259,3185,117688,8568,0.02522652388797364,0.7290053603335319
6993,0.6994,4,2,4,673261,3183,117692,8564,0.025210683056646813,0.7290372009874861
6994,0.6995,2,3,2,673264,3180,117694,8562,0.025186921809656572,0.7291773122125702
6995,0.6996,10,3,10,673267,3177,117704,8552,0.025163160562666327,0.7291329184073664
6996,0.6997,5,1,5,673268,3176,117709,8547,0.025155240147002916,0.7290795871363985
6997,0.6998,4,1,4,673269,3175,117713,8543,0.0251473197313395,0.7290493258235193
6998,0.6999,7,5,7,673274,3170,117720,8536,0.02510771765302243,0.7291987015205877
6999,0.7,5,1,5,673275,3169,117725,8531,0.025099797237359018,0.7291452991452991
7000,0.7001,5,2,5,673277,3167,117730,8526,0.025083956406032188,0.7291541948174122
7001,0.7002,6,5,6,673282,3162,117736,8520,0.025044354327715117,0.7293271700051361
7002,0.7003,7,0,7,673282,3162,117743,8513,0.025044354327715117,0.7291648822269807
7003,0.7004,4,2,4,673284,3160,117747,8509,0.02502851349638829,0.7291970177393092
7004,0.7005,5,3,5,673287,3157,117752,8504,0.02500475224939805,0.7292685018437527
7005,0.7006,8,2,8,673289,3155,117760,8496,0.02498891141807122,0.7292077933224616
7006,0.7007,5,4,5,673293,3151,117765,8491,0.024957229755417563,0.7293420374506099
7007,0.7008,5,1,5,673294,3150,117770,8486,0.02494930933975415,0.7292884152629769
7008,0.7009,9,1,9,673295,3149,117779,8477,0.024941388924090736,0.7291415792189919
7009,0.701,6,4,6,673299,3145,117785,8471,0.02490970726143708,0.7292527548209367
7010,0.7011,4,3,4,673302,3142,117789,8467,0.02488594601444684,0.7293479197174606
7011,0.7012,4,3,4,673305,3139,117793,8463,0.024862184767456597,0.729443199448371
7012,0.7013,7,1,7,673306,3138,117800,8456,0.024854264351793182,0.7293427634983612
7013,0.7014,6,2,6,673308,3136,117806,8450,0.024838423520466352,0.729328499913689
7014,0.7015,6,3,6,673311,3133,117812,8444,0.02481466227347611,0.7293772134404423
7015,0.7016,5,3,5,673314,3130,117817,8439,0.02479090102648587,0.7294493906128446
7016,0.7017,10,2,10,673316,3128,117827,8429,0.024775060195159043,0.7293415246171152
7017,0.7018,4,3,4,673319,3125,117831,8425,0.0247512989481688,0.7294372294372294
7018,0.7019,8,2,8,673321,3123,117839,8417,0.024735458116841972,0.7293760831889081
7019,0.702,3,1,3,673322,3122,117842,8414,0.024727537701178557,0.7293689320388349
7020,0.7021,2,1,2,673323,3121,117844,8412,0.024719617285515146,0.7293852423480447
7021,0.7022,6,3,6,673326,3118,117850,8406,0.0246958560385249,0.7294342242276988
7022,0.7023,4,3,4,673329,3115,117854,8402,0.02467209479153466,0.7295302596162195
7023,0.7024,4,5,4,673334,3110,117858,8398,0.024632492713217588,0.7297532151546751
7024,0.7025,4,4,4,673338,3106,117862,8394,0.024600811050563935,0.7299130434782609
7025,0.7026,8,4,8,673342,3102,117870,8386,0.02456912938791028,0.7299791086350975
7026,0.7027,5,3,5,673345,3099,117875,8381,0.024545368140920034,0.7300522648083624
7027,0.7028,5,3,5,673348,3096,117880,8376,0.024521606893929793,0.7301255230125523
7028,0.7029,2,2,2,673350,3094,117882,8374,0.024505766062602966,0.7302057900244158
7029,0.703,7,2,7,673352,3092,117889,8367,0.024489925231276136,0.7301684265642726
7030,0.7031,7,3,7,673355,3089,117896,8360,0.024466163984285895,0.7301947768364049
7031,0.7032,4,4,4,673359,3085,117900,8356,0.02443448232163224,0.7303557381347784
7032,0.7033,8,6,8,673365,3079,117908,8348,0.024386959827651756,0.7305504506869694
7033,0.7034,8,5,8,673370,3074,117916,8340,0.024347357749334685,0.730681619064307
7034,0.7035,4,4,4,673374,3070,117920,8336,0.02431567608668103,0.7308434157460986
7035,0.7036,4,6,4,673380,3064,117924,8332,0.024268153592700546,0.7311337311337311
7036,0.7037,2,3,2,673383,3061,117926,8330,0.024244392345710304,0.7312790799754192
7037,0.7038,6,4,6,673387,3057,117932,8324,0.024212710683056648,0.7313944293120113
7038,0.7039,9,6,9,673393,3051,117941,8315,0.02416518818907616,0.7315678338905508
7039,0.704,7,3,7,673396,3048,117948,8308,0.02414142694208592,0.731595632264882
7040,0.7041,5,3,5,673399,3045,117953,8303,0.02411766569509568,0.7316707789918928
7041,0.7042,4,1,4,673400,3044,117957,8299,0.024109745279432264,0.7316406594375385
7042,0.7043,4,1,4,673401,3043,117961,8295,0.02410182486376885,0.7316105133180455
7043,0.7044,2,2,2,673403,3041,117963,8293,0.024085984032442023,0.7316922533968591
7044,0.7045,11,2,11,673405,3039,117974,8282,0.024070143201115196,0.731560816182316
7045,0.7046,6,5,6,673410,3034,117980,8276,0.024030541122798125,0.7317418213969938
7046,0.7047,5,2,5,673412,3032,117985,8271,0.024014700291471295,0.73175263204459
7047,0.7048,5,1,5,673413,3031,117990,8266,0.024006779875807883,0.7316986810657696
7048,0.7049,4,4,4,673417,3027,117994,8262,0.023975098213154227,0.7318628753654
7049,0.705,4,3,4,673420,3024,117998,8258,0.023951336966163986,0.7319624180109909
7050,0.7051,10,3,10,673423,3021,118008,8248,0.02392757571917374,0.7319194249711598
7051,0.7052,8,2,8,673425,3019,118016,8240,0.023911734887846915,0.7318589572786216
7052,0.7053,8,1,8,673426,3018,118024,8232,0.0239038144721835,0.7317333333333333
7053,0.7054,11,3,11,673429,3015,118035,8221,0.023880053225193258,0.7316660733357067
7054,0.7055,5,0,5,673429,3015,118040,8216,0.023880053225193258,0.7315466120559166
7055,0.7056,4,5,4,673434,3010,118044,8212,0.023840451146876187,0.7317768668686508
7056,0.7057,2,1,2,673435,3009,118046,8210,0.023832530731212775,0.7317942775648454
7057,0.7058,4,2,4,673437,3007,118050,8206,0.023816689899885946,0.7318291269062696
7058,0.7059,5,3,5,673440,3004,118055,8201,0.023792928652895704,0.7319053993752789
7059,0.706,7,0,7,673440,3004,118062,8194,0.023792928652895704,0.731737810323272
7060,0.7061,7,2,7,673442,3002,118069,8187,0.023777087821568874,0.7317007775493789
7061,0.7062,6,5,6,673447,2997,118075,8181,0.023737485743251806,0.7318840579710145
7062,0.7063,6,2,6,673449,2995,118081,8175,0.023721644911924977,0.7318710832587287
7063,0.7064,8,3,8,673452,2992,118089,8167,0.023697883664934735,0.7318756160946321
7064,0.7065,10,4,10,673456,2988,118099,8157,0.02366620200228108,0.7318977119784656
7065,0.7066,5,3,5,673459,2985,118104,8152,0.023642440755290837,0.7319744994163598
7066,0.7067,8,0,8,673459,2985,118112,8144,0.023642440755290837,0.7317818312516848
7067,0.7068,3,2,3,673461,2983,118115,8141,0.02362659992396401,0.7318410643653362
7068,0.7069,5,1,5,673462,2982,118120,8136,0.023618679508300596,0.7317862924986508
7069,0.707,3,1,3,673463,2981,118123,8133,0.02361075909263718,0.7317797372683102
7070,0.7071,5,2,5,673465,2979,118128,8128,0.023594918261310355,0.7317907625821554
7071,0.7072,4,4,4,673469,2975,118132,8124,0.0235632365986567,0.7319578340391026
7072,0.7073,7,1,7,673470,2974,118139,8117,0.023555316182993283,0.7318546569290416
7073,0.7074,6,1,6,673471,2973,118145,8111,0.02354739576732987,0.7317755322988091
7074,0.7075,4,0,4,673471,2973,118149,8107,0.02354739576732987,0.7316787003610108
7075,0.7076,5,3,5,673474,2970,118154,8102,0.023523634520339627,0.7317557803468208
7076,0.7077,5,1,5,673475,2969,118159,8097,0.023515714104676212,0.7317007048617387
7077,0.7078,11,2,11,673477,2967,118170,8086,0.023499873273349386,0.731566090654121
7078,0.7079,8,4,8,673481,2963,118178,8078,0.02346819161069573,0.731636627117109
7079,0.708,1,5,1,673486,2958,118179,8077,0.023428589532378658,0.7319438151336656
7080,0.7081,9,3,9,673489,2955,118188,8068,0.023404828285388417,0.7319241585775197
7081,0.7082,4,5,4,673494,2950,118192,8064,0.023365226207071346,0.7321590702741965
7082,0.7083,4,4,4,673498,2946,118196,8060,0.023333544544417693,0.7323278211884426
7083,0.7084,4,6,4,673504,2940,118200,8056,0.023286022050437206,0.7326300472899236
7084,0.7085,4,2,4,673506,2938,118204,8052,0.02327018121911038,0.7326660600545951
7085,0.7086,4,2,4,673508,2936,118208,8048,0.02325434038778355,0.7327021121631464
7086,0.7087,8,0,8,673508,2936,118216,8040,0.02325434038778355,0.7325072886297376
7087,0.7088,8,3,8,673511,2933,118224,8032,0.02323057914079331,0.7325125398996808
7088,0.7089,6,2,6,673513,2931,118230,8026,0.023214738309466482,0.7324997718353564
7089,0.709,4,5,4,673518,2926,118234,8022,0.02317513623114941,0.7327365728900256
7090,0.7091,3,4,3,673522,2922,118237,8019,0.023143454568495755,0.7329311763092953
7091,0.7092,3,2,3,673524,2920,118240,8016,0.02312761373716893,0.7329919531821507
7092,0.7093,4,5,4,673529,2915,118244,8012,0.023088011658851857,0.7332296147158415
7093,0.7094,3,5,3,673534,2910,118247,8009,0.023048409580534786,0.7334920780291235
7094,0.7095,8,1,8,673535,2909,118255,8001,0.02304048916487137,0.7333638863428048
7095,0.7096,5,3,5,673538,2906,118260,7996,0.02301672791788113,0.7334434048798386
7096,0.7097,3,3,3,673541,2903,118263,7993,0.022992966670890888,0.733571953010279
7097,0.7098,7,3,7,673544,2900,118270,7986,0.022969205423900647,0.7336027925776226
7098,0.7099,3,4,3,673548,2896,118273,7983,0.02293752376124699,0.7337990624138248
7099,0.71,7,1,7,673549,2895,118280,7976,0.022929603345583575,0.7336951522399043
7100,0.7101,6,1,6,673550,2894,118286,7970,0.02292168292992016,0.7336156111929307
7101,0.7102,8,7,8,673557,2887,118294,7962,0.022866240020276263,0.7338925246566503
7102,0.7103,8,3,8,673560,2884,118302,7954,0.02284247877328602,0.7338992434028418
7103,0.7104,9,2,9,673562,2882,118311,7945,0.022826637941959195,0.7338136141128659
7104,0.7105,1,4,1,673566,2878,118312,7944,0.02279495627930554,0.7340602476436888
7105,0.7106,5,4,5,673570,2874,118317,7939,0.022763274616651882,0.7342088227134005
7106,0.7107,4,6,4,673576,2868,118321,7935,0.022715752122671396,0.7345181893918356
7107,0.7108,5,3,5,673579,2865,118326,7930,0.022691990875681155,0.7345993515516442
7108,0.7109,4,3,4,673582,2862,118330,7926,0.022668229628690913,0.7347052280311457
7109,0.711,5,2,5,673584,2860,118335,7921,0.022652388797364087,0.7347184862257675
7110,0.7111,9,1,9,673585,2859,118344,7912,0.022644468381700672,0.7345650357441278
7111,0.7112,8,3,8,673588,2856,118352,7904,0.02262070713471043,0.7345724907063197
7112,0.7113,13,1,13,673589,2855,118365,7891,0.022612786719047016,0.734319746882561
7113,0.7114,9,3,9,673592,2852,118374,7882,0.022589025472056774,0.7343022172535867
7114,0.7115,7,3,7,673595,2849,118381,7875,0.022565264225066533,0.7343342036553525
7115,0.7116,6,0,6,673595,2849,118387,7869,0.022565264225066533,0.734185482366113
7116,0.7117,5,3,5,673598,2846,118392,7864,0.022541502978076288,0.734267040149393
7117,0.7118,9,1,9,673599,2845,118401,7855,0.022533582562412877,0.7341121495327103
7118,0.7119,5,2,5,673601,2843,118406,7850,0.022517741731086047,0.7341251285887964
7119,0.712,8,1,8,673602,2842,118414,7842,0.022509821315422632,0.7339947585174093
7120,0.7121,6,3,6,673605,2839,118420,7836,0.02248606006843239,0.7340515222482435
7121,0.7122,8,3,8,673608,2836,118428,7828,0.02246229882144215,0.7340585146286571
7122,0.7123,5,3,5,673611,2833,118433,7823,0.022438537574451908,0.7341403903903904
7123,0.7124,5,2,5,673613,2831,118438,7818,0.022422696743125078,0.7341534416377125
7124,0.7125,9,3,9,673616,2828,118447,7809,0.022398935496134836,0.7341355645388737
7125,0.7126,3,3,3,673619,2825,118450,7806,0.022375174249144595,0.7342677076474462
7126,0.7127,8,2,8,673621,2823,118458,7798,0.02235933341781777,0.734205818661143
7127,0.7128,9,2,9,673623,2821,118467,7789,0.02234349258649094,0.7341187558906692
7128,0.7129,5,3,5,673626,2818,118472,7784,0.022319731339500697,0.7342010941331825
7129,0.713,6,2,6,673628,2816,118478,7778,0.022303890508173867,0.7341891636775534
7130,0.7131,4,4,4,673632,2812,118482,7774,0.022272208845520215,0.7343661439637257
7131,0.7132,3,6,3,673638,2806,118485,7771,0.02222468635153973,0.7347073839462985
7132,0.7133,10,3,10,673641,2803,118495,7761,0.022200925104549487,0.73466489965922
7133,0.7134,8,2,8,673643,2801,118503,7753,0.022185084273222657,0.73460299412545
7134,0.7135,1,3,1,673646,2798,118504,7752,0.022161323026232416,0.7347867298578199
7135,0.7136,8,3,8,673649,2795,118512,7744,0.022137561779242174,0.7347945725400892
7136,0.7137,3,2,3,673651,2793,118515,7741,0.022121720947915348,0.734858553256123
7137,0.7138,9,5,9,673656,2788,118524,7732,0.022082118869598277,0.7349809885931559
7138,0.7139,9,2,9,673658,2786,118533,7723,0.02206627803827145,0.734893900466267
7139,0.714,6,2,6,673660,2784,118539,7717,0.02205043720694462,0.7348823921531282
7140,0.7141,4,2,4,673662,2782,118543,7713,0.022034596375617794,0.7349213911386374
7141,0.7142,3,2,3,673664,2780,118546,7710,0.022018755544290964,0.7349857006673022
7142,0.7143,4,4,4,673668,2776,118550,7706,0.021987073881637308,0.7351650448387712
7143,0.7144,12,4,12,673672,2772,118562,7694,0.02195539221898365,0.7351423657557806
7144,0.7145,6,2,6,673674,2770,118568,7688,0.021939551387656825,0.7351310001912411
7145,0.7146,7,1,7,673675,2769,118575,7681,0.02193163097199341,0.735023923444976
7146,0.7147,7,1,7,673676,2768,118582,7674,0.021923710556329995,0.734916682627849
7147,0.7148,4,4,4,673680,2764,118586,7670,0.02189202889367634,0.7350967989265862
7148,0.7149,5,4,5,673684,2760,118591,7665,0.021860347231022682,0.7352517985611511
7149,0.715,5,3,5,673687,2757,118596,7660,0.02183658598403244,0.7353364692329846
7150,0.7151,9,3,9,673690,2754,118605,7651,0.0218128247370422,0.7353195579048535
7151,0.7152,7,4,7,673694,2750,118612,7644,0.021781143074388543,0.7354242832403309
7152,0.7153,4,1,4,673695,2749,118616,7640,0.02177322265872513,0.7353932043507556
7153,0.7154,3,3,3,673698,2746,118619,7637,0.021749461411734887,0.7355292304728884
7154,0.7155,8,2,8,673700,2744,118627,7629,0.02173362058040806,0.735467077990938
7155,0.7156,8,4,8,673704,2740,118635,7621,0.021701938917754404,0.7355467618955699
7156,0.7157,6,4,6,673708,2736,118641,7615,0.021670257255100748,0.7356777122983287
7157,0.7158,7,1,7,673709,2735,118648,7608,0.021662336839437333,0.7355699506912888
7158,0.7159,1,2,1,673711,2733,118649,7607,0.021646496008110507,0.7356866537717601
7159,0.716,5,1,5,673712,2732,118654,7602,0.02163857559244709,0.7356299593574608
7160,0.7161,4,3,4,673715,2729,118658,7598,0.02161481434545685,0.7357412607727317
7161,0.7162,11,3,11,673718,2726,118669,7587,0.02159105309846661,0.735673421894696
7162,0.7163,3,3,3,673721,2723,118672,7584,0.021567291851476364,0.7358106141457262
7163,0.7164,3,2,3,673723,2721,118675,7581,0.021551451020149538,0.7358765288293535
7164,0.7165,4,4,4,673727,2717,118679,7577,0.02151976935749588,0.7360598406838935
7165,0.7166,7,1,7,673728,2716,118686,7570,0.021511848941832466,0.7359517791172467
7166,0.7167,7,4,7,673732,2712,118693,7563,0.02148016727917881,0.7360583941605839
7167,0.7168,5,2,5,673734,2710,118698,7558,0.021464326447851984,0.7360732372419166
7168,0.7169,4,0,4,673734,2710,118702,7554,0.021464326447851984,0.7359703819173812
7169,0.717,7,6,7,673740,2704,118709,7547,0.0214168039538715,0.7362208565018047
7170,0.7171,3,4,3,673744,2700,118712,7544,0.021385122291217844,0.7364310816087466
7171,0.7172,5,0,5,673744,2700,118717,7539,0.021385122291217844,0.7363023732786405
7172,0.7173,9,5,9,673749,2695,118726,7530,0.021345520212900773,0.7364303178484107
7173,0.7174,4,3,4,673752,2692,118730,7526,0.021321758965910532,0.7365433548639656
7174,0.7175,7,2,7,673754,2690,118737,7519,0.021305918134583702,0.7365070036242531
7175,0.7176,5,1,5,673755,2689,118742,7514,0.02129799771892029,0.7364500637067529
7176,0.7177,4,0,4,673755,2689,118746,7510,0.02129799771892029,0.7363467006569272
7177,0.7178,2,4,2,673759,2685,118748,7508,0.021266316056266634,0.7365839301481408
7178,0.7179,10,3,10,673762,2682,118758,7498,0.02124255480927639,0.7365422396856581
7179,0.718,8,3,8,673765,2679,118766,7490,0.021218793562286148,0.7365522666928902
7180,0.7181,5,2,5,673767,2677,118771,7485,0.02120295273095932,0.7365676048022043
7181,0.7182,6,5,6,673772,2672,118777,7479,0.02116335065264225,0.736774701999803
7182,0.7183,4,4,4,673776,2668,118781,7475,0.021131668989988594,0.7369614512471655
7183,0.7184,1,2,1,673778,2666,118782,7474,0.021115828158661767,0.7370808678500986
7184,0.7185,7,4,7,673782,2662,118789,7467,0.02108414649600811,0.7371902458288083
7185,0.7186,6,2,6,673784,2660,118795,7461,0.02106830566468128,0.7371801205414484
7186,0.7187,6,1,6,673785,2659,118801,7455,0.02106038524901787,0.7370970931382242
7187,0.7188,9,1,9,673786,2658,118810,7446,0.021052464833354455,0.7369358669833729
7188,0.7189,4,2,4,673788,2656,118814,7442,0.021036624002027625,0.7369776193305605
7189,0.719,6,3,6,673791,2653,118820,7436,0.021012862755037384,0.7370403409654078
7190,0.7191,7,3,7,673794,2650,118827,7429,0.020989101508047142,0.7370770909812482
7191,0.7192,4,3,4,673797,2647,118831,7425,0.0209653402610569,0.7371922160444797
7192,0.7193,6,2,6,673799,2645,118837,7419,0.02094949942973007,0.7371820349761526
7193,0.7194,3,2,3,673801,2643,118840,7416,0.020933658598403244,0.7372502236802864
7194,0.7195,2,5,2,673806,2638,118842,7414,0.020894056520086173,0.7375646637485077
7195,0.7196,7,2,7,673808,2636,118849,7407,0.020878215688759347,0.7375286269043114
7196,0.7197,4,4,4,673812,2632,118853,7403,0.02084653402610569,0.7377179870453413
7197,0.7198,4,4,4,673816,2628,118857,7399,0.020814852363452034,0.7379076493467638
7198,0.7199,1,3,1,673819,2625,118858,7398,0.020791091116461793,0.7381023645615086
7199,0.72,3,1,3,673820,2624,118861,7395,0.020783170700798378,0.7380976145323884
7200,0.7201,6,3,6,673823,2621,118867,7389,0.020759409453808136,0.7381618381618381
7201,0.7202,7,3,7,673826,2618,118874,7382,0.020735648206817895,0.7382
7202,0.7203,2,1,2,673827,2617,118876,7380,0.02072772779115448,0.738221466439932
7203,0.7204,2,0,2,673827,2617,118878,7378,0.02072772779115448,0.7381690845422711
7204,0.7205,14,3,14,673830,2614,118892,7364,0.02070396654416424,0.7380236520344758
7205,0.7206,7,1,7,673831,2613,118899,7357,0.020696046128500824,0.737913741223671
7206,0.7207,4,6,4,673837,2607,118903,7353,0.02064852363452034,0.7382530120481928
7207,0.7208,3,1,3,673838,2606,118906,7350,0.020640603218856926,0.7382482924869426
7208,0.7209,5,0,5,673838,2606,118911,7345,0.020640603218856926,0.7381167721837001
7209,0.721,5,2,5,673840,2604,118916,7340,0.020624762387530096,0.7381335478680612
7210,0.7211,6,3,6,673843,2601,118922,7334,0.020601001140539855,0.7381982888777051
7211,0.7212,7,2,7,673845,2599,118929,7327,0.02058516030921303,0.7381624017731211
7212,0.7213,6,2,6,673847,2597,118935,7321,0.0205693194778862,0.7381528533978625
7213,0.7214,2,1,2,673848,2596,118937,7319,0.020561399062222787,0.7381744831064044
7214,0.7215,3,4,3,673852,2592,118940,7316,0.02052971739956913,0.7383932176019379
7215,0.7216,12,5,12,673857,2587,118952,7304,0.02049011532125206,0.7384490951369932
7216,0.7217,7,0,7,673857,2587,118959,7297,0.02049011532125206,0.7382638607851072
7217,0.7218,4,0,4,673857,2587,118963,7293,0.02049011532125206,0.7381578947368421
7218,0.7219,7,4,7,673861,2583,118970,7286,0.020458433658598403,0.7382713547471882
7219,0.722,3,3,3,673864,2580,118973,7283,0.02043467241160816,0.7384163033559769
7220,0.7221,3,4,3,673868,2576,118976,7280,0.020402990748954505,0.7386363636363636
7221,0.7222,6,2,6,673870,2574,118982,7274,0.020387149917627675,0.7386271324126726
7222,0.7223,3,4,3,673874,2570,118985,7271,0.020355468254974023,0.7388476780814958
7223,0.7224,6,2,6,673876,2568,118991,7265,0.020339627423647193,0.7388386046984644
7224,0.7225,6,4,6,673880,2564,118997,7259,0.020307945760993536,0.7389799450269775
7225,0.7226,5,1,5,673881,2563,119002,7254,0.02030002534533012,0.7389222776815728
7226,0.7227,6,4,6,673885,2559,119008,7248,0.020268343682676465,0.7390639339247477
7227,0.7228,6,1,6,673886,2558,119014,7242,0.020260423267013054,0.7389795918367347
7228,0.7229,6,5,6,673891,2553,119020,7236,0.020220821188695982,0.7391970579221575
7229,0.723,9,5,9,673896,2548,119029,7227,0.02018121911037891,0.7393350383631714
7230,0.7231,6,2,6,673898,2546,119035,7221,0.020165378279052085,0.7393263028565578
7231,0.7232,7,2,7,673900,2544,119042,7214,0.020149537447725258,0.7392908382865341
7232,0.7233,8,4,8,673904,2540,119050,7206,0.020117855785071602,0.7393802585676175
7233,0.7234,3,0,3,673904,2540,119053,7203,0.020117855785071602,0.7393000102637791
7234,0.7235,6,3,6,673907,2537,119059,7197,0.020094094538081357,0.7393671666324224
7235,0.7236,6,4,6,673911,2533,119065,7191,0.0200624128754277,0.7395104895104895
7236,0.7237,9,6,9,673917,2527,119074,7182,0.020014890381447218,0.7397260273972602
7237,0.7238,9,0,9,673917,2527,119083,7173,0.020014890381447218,0.7394845360824742
7238,0.7239,8,1,8,673918,2526,119091,7165,0.020006969965783803,0.7393457847487359
7239,0.724,6,0,6,673918,2526,119097,7159,0.020006969965783803,0.7391843056272587
7240,0.7241,4,3,4,673921,2523,119101,7155,0.01998320871879356,0.7393056416615003
7241,0.7242,6,0,6,673921,2523,119107,7149,0.01998320871879356,0.7391439205955335
7242,0.7243,3,3,3,673924,2520,119110,7146,0.01995944747180332,0.7392923649906891
7243,0.7244,8,1,8,673925,2519,119118,7138,0.019951527056139905,0.7391529460494978
7244,0.7245,2,2,2,673927,2517,119120,7136,0.01993568622481308,0.7392520459960634
7245,0.7246,4,3,4,673930,2514,119124,7132,0.019911924977822838,0.7393738337134563
7246,0.7247,8,2,8,673932,2512,119132,7124,0.019896084146496008,0.7393109173931092
7247,0.7248,6,3,6,673935,2509,119138,7118,0.019872322899505766,0.7393788303729095
7248,0.7249,7,0,7,673935,2509,119145,7111,0.019872322899505766,0.7391891891891892
7249,0.725,5,1,5,673936,2508,119150,7106,0.01986440248384235,0.7391304347826086
7250,0.7251,1,3,1,673939,2505,119151,7105,0.01984064123685211,0.7393340270551508
7251,0.7252,6,2,6,673941,2503,119157,7099,0.019824800405525284,0.7393251405957092
7252,0.7253,5,2,5,673943,2501,119162,7094,0.019808959574198454,0.7393434080250131
7253,0.7254,7,2,7,673945,2499,119169,7087,0.019793118742871627,0.739307323179637
7254,0.7255,5,3,5,673948,2496,119174,7082,0.019769357495881382,0.7394027980789308
7255,0.7256,4,2,4,673950,2494,119178,7078,0.019753516664554556,0.7394483911408274
7256,0.7257,6,3,6,673953,2491,119184,7072,0.019729755417564315,0.7395168880058559
7257,0.7258,3,4,3,673957,2487,119187,7069,0.019698073754910658,0.7397446630389284
7258,0.7259,4,3,4,673960,2484,119191,7065,0.019674312507920417,0.7398680490103676
7259,0.726,11,6,11,673966,2478,119202,7054,0.01962679001393993,0.7400335711288292
7260,0.7261,7,4,7,673970,2474,119209,7047,0.019595108351286274,0.7401533452368448
7261,0.7262,7,7,7,673977,2467,119216,7040,0.019539665441642377,0.740506994845903
7262,0.7263,6,4,6,673981,2463,119222,7034,0.01950798377898872,0.7406549436664209
7263,0.7264,2,2,2,673983,2461,119224,7032,0.019492142947661894,0.7407563467818392
7264,0.7265,5,3,5,673986,2458,119229,7027,0.019468381700671653,0.7408539799683711
7265,0.7266,6,2,6,673988,2456,119235,7021,0.019452540869344823,0.7408462593647779
7266,0.7267,6,2,6,673990,2454,119241,7015,0.019436700038017996,0.7408385257154927
7267,0.7268,2,2,2,673992,2452,119243,7013,0.019420859206691166,0.7409403063919704
7268,0.7269,3,3,3,673995,2449,119246,7010,0.019397097959700925,0.7410931388095994
7269,0.727,3,2,3,673997,2447,119249,7007,0.0193812571283741,0.741167759678443
7270,0.7271,7,4,7,674001,2443,119256,7000,0.019349575465720442,0.7412898443291327
7271,0.7272,5,2,5,674003,2441,119261,6995,0.019333734634393612,0.7413098770665536
7272,0.7273,4,1,4,674004,2440,119265,6991,0.019325814218730197,0.7412787615311208
7273,0.7274,2,5,2,674009,2435,119267,6989,0.01928621214041313,0.7416171477079796
7274,0.7275,5,0,5,674009,2435,119272,6984,0.01928621214041313,0.741479987259794
7275,0.7276,5,3,5,674012,2432,119277,6979,0.019262450893422888,0.7415790032940176
7276,0.7277,6,5,6,674017,2427,119283,6973,0.019222848815105817,0.7418085106382979
7277,0.7278,4,2,4,674019,2425,119287,6969,0.019207007983778987,0.7418565041515861
7278,0.7279,2,2,2,674021,2423,119289,6967,0.01919116715245216,0.7419595314164005
7279,0.728,5,2,5,674023,2421,119294,6962,0.019175326321125334,0.7419801769156986
7280,0.7281,4,2,4,674025,2419,119298,6958,0.019159485489798504,0.7420283672816466
7281,0.7282,1,4,1,674029,2415,119299,6957,0.019127803827144848,0.7423175416133163
7282,0.7283,8,5,8,674034,2410,119307,6949,0.01908820174882778,0.742493856181216
7283,0.7284,4,4,4,674038,2406,119311,6945,0.019056520086174124,0.7427013153673404
7284,0.7285,5,1,5,674039,2405,119316,6940,0.01904859967051071,0.7426431246655966
7285,0.7286,9,3,9,674042,2402,119325,6931,0.019024838423520467,0.7426336654880531
7286,0.7287,10,1,10,674043,2401,119335,6921,0.019016918007857053,0.7424372452263462
7287,0.7288,8,5,8,674048,2396,119343,6913,0.01897731592953998,0.7426146739714256
7288,0.7289,5,1,5,674049,2395,119348,6908,0.01896939551387657,0.7425561646780608
7289,0.729,5,0,5,674049,2395,119353,6903,0.01896939551387657,0.7424177242417724
7290,0.7291,2,2,2,674051,2393,119355,6901,0.01895355468254974,0.7425220572412309
7291,0.7292,9,2,9,674053,2391,119364,6892,0.018937713851222913,0.742432403317893
7292,0.7293,3,4,3,674057,2387,119367,6889,0.018906032188569257,0.7426692539887882
7293,0.7294,6,4,6,674061,2383,119373,6883,0.0188743505259156,0.7428232246924239
7294,0.7295,3,4,3,674065,2379,119376,6880,0.018842668863261944,0.7430608057025597
7295,0.7296,17,2,17,674067,2377,119393,6863,0.018826828031935115,0.7427489177489177
7296,0.7297,7,4,7,674071,2373,119400,6856,0.018795146369281458,0.7428757178459204
7297,0.7298,7,0,7,674071,2373,119407,6849,0.018795146369281458,0.7426805465191932
7298,0.7299,7,4,7,674075,2369,119414,6842,0.018763464706627805,0.7428075127564868
7299,0.73,3,1,3,674076,2368,119417,6839,0.01875554429096439,0.7428043879656783
7300,0.7301,4,2,4,674078,2366,119421,6835,0.01873970345963756,0.7428540376046082
7301,0.7302,7,1,7,674079,2365,119428,6828,0.01873178304397415,0.74273904057435
7302,0.7303,5,3,5,674082,2362,119433,6823,0.018708021796983904,0.7428415895481764
7303,0.7304,6,1,6,674083,2361,119439,6817,0.018700101381320493,0.7427544127260841
7304,0.7305,3,2,3,674085,2359,119442,6814,0.018684260549993663,0.7428322250081761
7305,0.7306,4,3,4,674088,2356,119446,6810,0.01866049930300342,0.7429631245908793
7306,0.7307,2,1,2,674089,2355,119448,6808,0.018652578887340007,0.7429881043326422
7307,0.7308,3,2,3,674091,2353,119451,6805,0.01863673805601318,0.7430661716531994
7308,0.7309,3,5,3,674096,2348,119454,6802,0.01859713597769611,0.7433879781420765
7309,0.731,7,2,7,674098,2346,119461,6795,0.018581295146369282,0.7433541188053824
7310,0.7311,8,2,8,674100,2344,119469,6787,0.018565454315042453,0.7432920819187384
7311,0.7312,6,1,6,674101,2343,119475,6781,0.01855753389937904,0.7432047347654538
7312,0.7313,7,5,7,674106,2338,119482,6774,0.01851793182106197,0.7434152765583846
7313,0.7314,6,2,6,674108,2336,119488,6768,0.01850209098973514,0.7434094903339191
7314,0.7315,5,5,5,674113,2331,119493,6763,0.018462488911418072,0.7436771497690785
7315,0.7316,6,1,6,674114,2330,119499,6757,0.018454568495754657,0.7435897435897436
7316,0.7317,6,4,6,674118,2326,119505,6751,0.018422886833101,0.7437479343395395
7317,0.7318,7,3,7,674121,2323,119512,6744,0.01839912558611076,0.7437961839638249
7318,0.7319,8,4,8,674125,2319,119520,6736,0.018367443923457103,0.7438983986747654
7319,0.732,6,4,6,674129,2315,119526,6730,0.018335762260803447,0.7440574903261471
7320,0.7321,5,1,5,674130,2314,119531,6725,0.018327841845140032,0.7439982298926873
7321,0.7322,3,0,3,674130,2314,119534,6722,0.018327841845140032,0.7439132359451085
7322,0.7323,5,2,5,674132,2312,119539,6717,0.018312001013813205,0.7439362055598626
7323,0.7324,6,0,6,674132,2312,119545,6711,0.018312001013813205,0.7437659315083675
7324,0.7325,2,3,2,674135,2309,119547,6709,0.018288239766822964,0.743956531381681
7325,0.7326,1,0,1,674135,2309,119548,6708,0.018288239766822964,0.7439281357435954
7326,0.7327,11,1,11,674136,2308,119559,6697,0.01828031935115955,0.7436979455857857
7327,0.7328,5,5,5,674141,2303,119564,6692,0.018240717272842478,0.7439688715953308
7328,0.7329,7,1,7,674142,2302,119571,6685,0.018232796857179066,0.7438522310003338
7329,0.733,2,3,2,674145,2299,119573,6683,0.01820903561018882,0.744043642841238
7330,0.7331,6,0,6,674145,2299,119579,6677,0.01820903561018882,0.7438725490196079
7331,0.7332,2,1,2,674146,2298,119581,6675,0.01820111519452541,0.7438983617519225
7332,0.7333,5,1,5,674147,2297,119586,6670,0.018193194778861995,0.7438385190141631
7333,0.7334,3,3,3,674150,2294,119589,6667,0.018169433531871754,0.7440017855150095
7334,0.7335,5,4,5,674154,2290,119594,6662,0.018137751869218097,0.7441912421805184
7335,0.7336,6,4,6,674158,2286,119600,6656,0.01810607020656444,0.7443524938492507
7336,0.7337,4,1,4,674159,2285,119604,6652,0.018098149790901026,0.74432136063556
7337,0.7338,9,3,9,674162,2282,119613,6643,0.018074388543910785,0.744313725490196
7338,0.7339,2,1,2,674163,2281,119615,6641,0.01806646812824737,0.7443398341179108
7339,0.734,5,2,5,674165,2279,119620,6636,0.018050627296920543,0.7443634324172742
7340,0.7341,7,3,7,674168,2276,119627,6629,0.018026866049930302,0.744413250982594
7341,0.7342,4,0,4,674168,2276,119631,6625,0.018026866049930302,0.7442983934389394
7342,0.7343,5,2,5,674170,2274,119636,6620,0.018011025218603472,0.7443220148414662
7343,0.7344,3,3,3,674173,2271,119639,6617,0.01798726397161323,0.7444869486948695
7344,0.7345,4,3,4,674176,2268,119643,6613,0.01796350272462299,0.744623353225988
7345,0.7346,4,3,4,674179,2265,119647,6609,0.017939741477632744,0.7447599729546991
7346,0.7347,7,2,7,674181,2263,119654,6602,0.017923900646305918,0.7447264523406656
7347,0.7348,5,1,5,674182,2262,119659,6597,0.017915980230642503,0.7446664409075516
7348,0.7349,6,4,6,674186,2258,119665,6591,0.017884298567988847,0.74482992428523
7349,0.735,6,2,6,674188,2256,119671,6585,0.01786845773666202,0.7448252460128945
7350,0.7351,4,3,4,674191,2253,119675,6581,0.01784469648967178,0.7449626443287299
7351,0.7352,9,3,9,674194,2250,119684,6572,0.017820935242681538,0.7449557923373384
7352,0.7353,7,2,7,674196,2248,119691,6565,0.017805094411354708,0.7449222739135368
7353,0.7354,8,4,8,674200,2244,119699,6557,0.01777341274870105,0.7450289739802295
7354,0.7355,1,4,1,674204,2240,119700,6556,0.017741731086047395,0.7453387903592542
7355,0.7356,9,3,9,674207,2237,119709,6547,0.017717969839057154,0.745332422586521
7356,0.7357,7,2,7,674209,2235,119716,6540,0.017702129007730327,0.7452991452991453
7357,0.7358,7,1,7,674210,2234,119723,6533,0.017694208592066912,0.7451807916048819
7358,0.7359,3,2,3,674212,2232,119726,6530,0.017678367760740082,0.7452636384387126
7359,0.736,4,2,4,674214,2230,119730,6526,0.017662526929413256,0.745317496573778
7360,0.7361,5,4,5,674218,2226,119735,6521,0.0176308452667596,0.745512747227621
7361,0.7362,1,2,1,674220,2224,119736,6520,0.01761500443543277,0.7456541628545288
7362,0.7363,8,7,8,674227,2217,119744,6512,0.017559561525788872,0.7460190170695383
7363,0.7364,2,2,2,674229,2215,119746,6510,0.017543720694462046,0.7461318051575931
7364,0.7365,3,1,3,674230,2214,119749,6507,0.01753580027879863,0.7461300309597523
7365,0.7366,5,3,5,674233,2211,119754,6502,0.01751203903180839,0.7462412487088259
7366,0.7367,6,3,6,674236,2208,119760,6496,0.017488277784818148,0.7463235294117647
7367,0.7368,6,7,6,674243,2201,119766,6490,0.01743283487517425,0.7467495109883788
7368,0.7369,9,3,9,674246,2198,119775,6481,0.017409073628184005,0.7467450167069939
7369,0.737,7,2,7,674248,2196,119782,6474,0.01739323279685718,0.7467128027681661
7370,0.7371,5,0,5,674248,2196,119787,6469,0.01739323279685718,0.7465666474321985
7371,0.7372,5,2,5,674250,2194,119792,6464,0.017377391965530353,0.7465927465927465
7372,0.7373,4,3,4,674253,2191,119796,6460,0.017353630718540108,0.7467344815628251
7373,0.7374,0,1,0,674254,2190,119796,6460,0.017345710302876696,0.7468208092485549
7374,0.7375,4,2,4,674256,2188,119800,6456,0.017329869471549866,0.7468764460897732
7375,0.7376,3,6,3,674262,2182,119803,6453,0.017282346977569384,0.7473074696004632
7376,0.7377,7,6,7,674268,2176,119810,6446,0.017234824483588897,0.7476223614010671
7377,0.7378,7,2,7,674270,2174,119817,6439,0.01721898365226207,0.7475908510391269
7378,0.7379,4,2,4,674272,2172,119821,6435,0.01720314282093524,0.7476472638550018
7379,0.738,5,5,5,674277,2167,119826,6430,0.017163540742618173,0.7479353262766081
7380,0.7381,5,2,5,674279,2165,119831,6425,0.017147699911291343,0.7479627473806753
7381,0.7382,5,3,5,674282,2162,119836,6420,0.017123938664301102,0.7480773712421347
7382,0.7383,9,0,9,674282,2162,119845,6411,0.017123938664301102,0.7478129009681559
7383,0.7384,6,2,6,674284,2160,119851,6405,0.017108097832974276,0.7478108581436077
7384,0.7385,5,5,5,674289,2155,119856,6400,0.017068495754657204,0.7481005260081823
7385,0.7386,7,3,7,674292,2152,119863,6393,0.017044734507666963,0.7481568168519602
7386,0.7387,5,4,5,674296,2148,119868,6388,0.017013052845013307,0.7483598875351453
7387,0.7388,3,4,3,674300,2144,119871,6385,0.01698137118235965,0.7486223472857311
7388,0.7389,6,2,6,674302,2142,119877,6379,0.016965530351032824,0.748621053866917
7389,0.739,5,5,5,674307,2137,119882,6374,0.016925928272715753,0.7489131711902244
7390,0.7391,5,0,5,674307,2137,119887,6369,0.016925928272715753,0.7487655772395956
7391,0.7392,7,0,7,674307,2137,119894,6362,0.016925928272715753,0.7485586539592893
7392,0.7393,5,3,5,674310,2134,119899,6357,0.01690216702572551,0.748675067718761
7393,0.7394,4,2,4,674312,2132,119903,6353,0.01688632619439868,0.748733058338244
7394,0.7395,9,1,9,674313,2131,119912,6344,0.016878405778735266,0.7485545722713864
7395,0.7396,6,1,6,674314,2130,119918,6338,0.016870485363071855,0.7484648086915446
7396,0.7397,7,3,7,674317,2127,119925,6331,0.016846724116081613,0.7485221092456845
7397,0.7398,4,2,4,674319,2125,119929,6327,0.016830883284754784,0.7485802176999526
7398,0.7399,6,1,6,674320,2124,119935,6321,0.01682296286909137,0.7484902309058614
7399,0.74,8,3,8,674323,2121,119943,6313,0.016799201622101127,0.7485179037230258
7400,0.7401,6,1,6,674324,2120,119949,6307,0.016791281206437712,0.7484276729559748
7401,0.7402,2,2,2,674326,2118,119951,6305,0.016775440375110886,0.7485456488187107
7402,0.7403,5,1,5,674327,2117,119956,6300,0.01676751995944747,0.7484852085065938
7403,0.7404,6,3,6,674330,2114,119962,6294,0.01674375871245723,0.7485727878211227
7404,0.7405,5,2,5,674332,2112,119967,6289,0.016727917881130403,0.7486013569813117
7405,0.7406,7,3,7,674335,2109,119974,6282,0.01670415663414016,0.7486592777976403
7406,0.7407,6,1,6,674336,2108,119980,6276,0.016696236218476747,0.7485687022900763
7407,0.7408,4,7,4,674343,2101,119984,6272,0.01664079330883285,0.7490744058282575
7408,0.7409,6,2,6,674345,2099,119990,6266,0.01662495247750602,0.7490735206216378
7409,0.741,7,0,7,674345,2099,119997,6259,0.01662495247750602,0.7488633644412539
7410,0.7411,3,4,3,674349,2095,120000,6256,0.016593270814852363,0.749131840498144
7411,0.7412,9,2,9,674351,2093,120009,6247,0.016577429983525536,0.7490407673860912
7412,0.7413,2,2,2,674353,2091,120011,6245,0.016561589152198707,0.7491602687140115
7413,0.7414,3,2,3,674355,2089,120014,6242,0.01654574832087188,0.7492497899411835
7414,0.7415,5,3,5,674358,2086,120019,6237,0.01652198707388164,0.7493692178301093
7415,0.7416,7,5,7,674363,2081,120026,6230,0.016482384995564568,0.7496089519913368
7416,0.7417,3,2,3,674365,2079,120029,6227,0.016466544164237738,0.7496990127618589
7417,0.7418,4,3,4,674368,2076,120033,6223,0.016442782917247496,0.7498493794433064
7418,0.7419,9,2,9,674370,2074,120042,6214,0.01642694208592067,0.7497586872586872
7419,0.742,4,3,4,674373,2071,120046,6210,0.01640318083893043,0.7499094312281126
7420,0.7421,3,0,3,674373,2071,120049,6207,0.01640318083893043,0.7498187968108239
7421,0.7422,3,3,3,674376,2068,120052,6204,0.016379419591940184,0.75
7422,0.7423,5,2,5,674378,2066,120057,6199,0.016363578760613357,0.7500302480338777
7423,0.7424,2,0,2,674378,2066,120059,6197,0.016363578760613357,0.7499697446448021
7424,0.7425,4,0,4,674378,2066,120063,6193,0.016363578760613357,0.749848649957622
7425,0.7426,4,2,4,674380,2064,120067,6189,0.016347737929286527,0.7499091239549255
7426,0.7427,6,1,6,674381,2063,120073,6183,0.016339817513623116,0.7498180936211496
7427,0.7428,4,1,4,674382,2062,120077,6179,0.0163318970979597,0.7497876471302026
7428,0.7429,4,1,4,674383,2061,120081,6175,0.016323976682296286,0.7497571636716853
7429,0.743,5,3,5,674386,2058,120086,6170,0.016300215435306045,0.7498784637822071
7430,0.7431,5,1,5,674387,2057,120091,6165,0.01629229501964263,0.749817562636828
7431,0.7432,7,1,7,674388,2056,120098,6158,0.016284374603979218,0.7496956415875334
7432,0.7433,4,0,4,674388,2056,120102,6154,0.016284374603979218,0.7495736906211936
7433,0.7434,5,0,5,674388,2056,120107,6149,0.016284374603979218,0.7494210847044485
7434,0.7435,6,1,6,674389,2055,120113,6143,0.016276454188315803,0.7493291046596731
7435,0.7436,3,1,3,674390,2054,120116,6140,0.016268533772652388,0.7493287771540151
7436,0.7437,7,3,7,674393,2051,120123,6133,0.016244772525662147,0.7493890518084066
7437,0.7438,6,3,6,674396,2048,120129,6127,0.016221011278671905,0.7494801223241591
7438,0.7439,7,3,7,674399,2045,120136,6120,0.016197250031681664,0.7495407225964482
7439,0.744,6,2,6,674401,2043,120142,6114,0.016181409200354834,0.749540272158882
7440,0.7441,7,1,7,674402,2042,120149,6107,0.01617348878469142,0.7494171063934225
7441,0.7442,4,3,4,674405,2039,120153,6103,0.016149727537701178,0.7495701301891428
7442,0.7443,9,1,9,674406,2038,120162,6094,0.016141807122037763,0.749385145105755
7443,0.7444,6,1,6,674407,2037,120168,6088,0.01613388670637435,0.7492923076923077
7444,0.7445,7,0,7,674407,2037,120175,6081,0.01613388670637435,0.7490761271249076
7445,0.7446,4,1,4,674408,2036,120179,6077,0.016125966290710936,0.7490447430050536
7446,0.7447,4,2,4,674410,2034,120183,6073,0.01611012545938411,0.7491057111138523
7447,0.7448,5,0,5,674410,2034,120188,6068,0.01611012545938411,0.7489508763268329
7448,0.7449,9,2,9,674412,2032,120197,6059,0.01609428462805728,0.7488567544184896
7449,0.745,6,2,6,674414,2030,120203,6053,0.016078443796730454,0.748855622912285
7450,0.7451,5,3,5,674417,2027,120208,6048,0.01605468254974021,0.7489783281733746
7451,0.7452,6,0,6,674417,2027,120214,6042,0.01605468254974021,0.7487916718304622
7452,0.7453,6,1,6,674418,2026,120220,6036,0.016046762134076797,0.7486975936492185
7453,0.7454,8,2,8,674420,2024,120228,6028,0.016030921302749968,0.7486338797814208
7454,0.7455,6,2,6,674422,2022,120234,6022,0.01601508047142314,0.7486325211337643
7455,0.7456,4,2,4,674424,2020,120238,6018,0.01599923964009631,0.7486937049017168
7456,0.7457,9,2,9,674426,2018,120247,6009,0.015983398808769485,0.7485984801295628
7457,0.7458,8,3,8,674429,2015,120255,6001,0.015959637561779243,0.748627744510978
7458,0.7459,5,2,5,674431,2013,120260,5996,0.015943796730452413,0.7486577600199775
7459,0.746,5,1,5,674432,2012,120265,5991,0.015935876314789,0.7485942771460702
7460,0.7461,4,0,4,674432,2012,120269,5987,0.015935876314789,0.7484685585698212
7461,0.7462,4,6,4,674438,2006,120273,5983,0.015888353820808516,0.7489047440230316
7462,0.7463,1,0,1,674438,2006,120274,5982,0.015888353820808516,0.7488733099649474
7463,0.7464,4,0,4,674438,2006,120278,5978,0.015888353820808516,0.74874749498998
7464,0.7465,6,4,6,674442,2002,120284,5972,0.01585667215815486,0.7489340356157512
7465,0.7466,4,3,4,674445,1999,120288,5968,0.015832910911164618,0.7490899962344671
7466,0.7467,10,2,10,674447,1997,120298,5958,0.015817070079837788,0.7489629164047769
7467,0.7468,2,1,2,674448,1996,120300,5956,0.015809149664174377,0.7489939637826962
7468,0.7469,6,1,6,674449,1995,120306,5950,0.015801229248510962,0.748898678414097
7469,0.747,3,3,3,674452,1992,120309,5947,0.01577746800152072,0.7490867867489608
7470,0.7471,8,3,8,674455,1989,120317,5939,0.01575370675453048,0.749117053481332
7471,0.7472,5,4,5,674459,1985,120322,5934,0.015722025091876823,0.7493370375047355
7472,0.7473,6,2,6,674461,1983,120328,5928,0.015706184260549993,0.7493363670838074
7473,0.7474,5,2,5,674463,1981,120333,5923,0.015690343429223166,0.7493674089068826
7474,0.7475,5,2,5,674465,1979,120338,5918,0.015674502597896336,0.7493985057616817
7475,0.7476,7,6,7,674471,1973,120345,5911,0.015626980103915854,0.7497463216641299
7476,0.7477,5,3,5,674474,1970,120350,5906,0.01560321885692561,0.749873031995937
7477,0.7478,9,5,9,674479,1965,120359,5897,0.015563616778608541,0.750063597049097
7478,0.7479,7,2,7,674481,1963,120366,5890,0.015547775947281713,0.7500318349675283
7479,0.748,3,1,3,674482,1962,120369,5887,0.0155398555316183,0.7500318511912345
7480,0.7481,4,1,4,674483,1961,120373,5883,0.015531935115954885,0.75
7481,0.7482,4,0,4,674483,1961,120377,5879,0.015531935115954885,0.7498724489795918
7482,0.7483,6,2,6,674485,1959,120383,5873,0.015516094284628057,0.7498723186925434
7483,0.7484,2,1,2,674486,1958,120385,5871,0.015508173868964643,0.7499042023246902
7484,0.7485,10,1,10,674487,1957,120395,5861,0.015500253453301228,0.7496802251215144
7485,0.7486,6,2,6,674489,1955,120401,5855,0.015484412621974402,0.7496798975672215
7486,0.7487,5,1,5,674490,1954,120406,5850,0.015476492206310987,0.7496155817529472
7487,0.7488,5,1,5,674491,1953,120411,5845,0.015468571790647574,0.7495511669658886
7488,0.7489,4,5,4,674496,1948,120415,5841,0.015428969712330503,0.7499037103607652
7489,0.749,7,2,7,674498,1946,120422,5834,0.015413128881003674,0.7498714652956299
7490,0.7491,8,2,8,674500,1944,120430,5826,0.015397288049676846,0.7498069498069498
7491,0.7492,5,2,5,674502,1942,120435,5821,0.01538144721835002,0.7498389797758599
7492,0.7493,7,4,7,674506,1938,120442,5814,0.015349765555696364,0.75
7493,0.7494,6,1,6,674507,1937,120448,5808,0.015341845140032949,0.7499031633311815
7494,0.7495,6,3,6,674510,1934,120454,5802,0.015318083893042707,0.75
7495,0.7496,3,4,3,674514,1930,120457,5799,0.015286402230389051,0.7502911113986286
7496,0.7497,6,2,6,674516,1928,120463,5793,0.015270561399062223,0.7502914130294004
7497,0.7498,5,1,5,674517,1927,120468,5788,0.01526264098339881,0.7502268308489954
7498,0.7499,7,4,7,674521,1923,120475,5781,0.015230959320745153,0.7503894080996885
7499,0.75,4,3,4,674524,1920,120479,5777,0.01520719807375491,0.7505521631804599
7500,0.7501,6,3,6,674527,1917,120485,5771,0.015183436826764669,0.7506503642039543
7501,0.7502,6,3,6,674530,1914,120491,5765,0.015159675579774427,0.7507487954160698
7502,0.7503,1,4,1,674534,1910,120492,5764,0.015127993917120771,0.7511076361740944
7503,0.7504,4,2,4,674536,1908,120496,5760,0.015112153085793943,0.7511737089201878
7504,0.7505,6,2,6,674538,1906,120502,5754,0.015096312254467115,0.7511749347258485
7505,0.7506,9,2,9,674540,1904,120511,5745,0.015080471423140287,0.7510785723624003
7506,0.7507,7,1,7,674541,1903,120518,5738,0.015072551007476872,0.7509488286873446
7507,0.7508,4,2,4,674543,1901,120522,5734,0.015056710176150045,0.7510150622134905
7508,0.7509,4,3,4,674546,1898,120526,5730,0.015032948929159802,0.7511798636601993
7509,0.751,8,2,8,674548,1896,120534,5722,0.015017108097832974,0.7511157784195327
7510,0.7511,6,3,6,674551,1893,120540,5716,0.014993346850842732,0.7512156656590879
7511,0.7512,4,1,4,674552,1892,120544,5712,0.014985426435179318,0.7511835875854813
7512,0.7513,5,2,5,674554,1890,120549,5707,0.01496958560385249,0.7512175858891668
7513,0.7514,4,0,4,674554,1890,120553,5703,0.01496958560385249,0.7510865270644014
7514,0.7515,3,1,3,674555,1889,120556,5700,0.014961665188189076,0.7510870997496376
7515,0.7516,5,1,5,674556,1888,120561,5695,0.014953744772525663,0.7510220229460636
7516,0.7517,6,2,6,674558,1886,120567,5689,0.014937903941198835,0.7510231023102311
7517,0.7518,5,2,5,674560,1884,120572,5684,0.014922063109872007,0.7510570824524313
7518,0.7519,6,2,6,674562,1882,120578,5678,0.014906222278545178,0.7510582010582011
7519,0.752,6,0,6,674562,1882,120584,5672,0.014906222278545178,0.7508604712734975
7520,0.7521,1,1,1,674563,1881,120585,5671,0.014898301862881764,0.750926906779661
7521,0.7522,5,2,5,674565,1879,120590,5666,0.014882461031554935,0.750960901259112
7522,0.7523,8,3,8,674568,1876,120598,5658,0.014858699784564694,0.7509954871250332
7523,0.7524,4,1,4,674569,1875,120602,5654,0.01485077936890128,0.7509629432859609
7524,0.7525,6,2,6,674571,1873,120608,5648,0.014834938537574453,0.7509639675575056
7525,0.7526,4,1,4,674572,1872,120612,5644,0.014827018121911038,0.7509313464608834
7526,0.7527,4,3,4,674575,1869,120616,5640,0.014803256874920796,0.7510986815821015
7527,0.7528,4,1,4,674576,1868,120620,5636,0.014795336459257381,0.7510660980810234
7528,0.7529,3,1,3,674577,1867,120623,5633,0.014787416043593968,0.7510666666666667
7529,0.753,5,3,5,674580,1864,120628,5628,0.014763654796603725,0.7512012813667912
7530,0.7531,3,0,3,674580,1864,120631,5625,0.014763654796603725,0.7511016157030311
7531,0.7532,8,2,8,674582,1862,120639,5617,0.014747813965276899,0.7510362347907474
7532,0.7533,6,1,6,674583,1861,120645,5611,0.014739893549613484,0.7509368308351178
7533,0.7534,3,4,3,674587,1857,120648,5608,0.014708211886959827,0.751239115874079
7534,0.7535,5,3,5,674590,1854,120653,5603,0.014684450639969586,0.7513745474051227
7535,0.7536,3,2,3,674592,1852,120656,5600,0.014668609808642758,0.7514761137949544
7536,0.7537,6,0,6,674592,1852,120662,5594,0.014668609808642758,0.7512758528068761
7537,0.7538,8,3,8,674595,1849,120670,5586,0.014644848561652515,0.7513113651647613
7538,0.7539,4,2,4,674597,1847,120674,5582,0.014629007730325688,0.75137972809261
7539,0.754,4,1,4,674598,1846,120678,5578,0.014621087314662273,0.7513469827586207
7540,0.7541,2,1,2,674599,1845,120680,5576,0.01461316689899886,0.7513812154696132
7541,0.7542,6,0,6,674599,1845,120686,5570,0.01461316689899886,0.75118004045853
7542,0.7543,6,4,6,674603,1841,120692,5564,0.014581485236345204,0.7513841998649561
7543,0.7544,7,1,7,674604,1840,120699,5557,0.014573564820681789,0.751250506962282
7544,0.7545,2,0,2,674604,1840,120701,5555,0.014573564820681789,0.751183231913455
7545,0.7546,5,0,5,674604,1840,120706,5550,0.014573564820681789,0.7510148849797023
7546,0.7547,4,0,4,674604,1840,120710,5546,0.014573564820681789,0.7508800433252099
7547,0.7548,3,5,3,674609,1835,120713,5543,0.01453396274236472,0.7512876118189211
7548,0.7549,7,0,7,674609,1835,120720,5536,0.01453396274236472,0.7510514177180844
7549,0.755,2,2,2,674611,1833,120722,5534,0.014518121911037891,0.7511877290620333
7550,0.7551,7,4,7,674615,1829,120729,5527,0.014486440248384235,0.7513594344752583
7551,0.7552,6,0,6,674615,1829,120735,5521,0.014486440248384235,0.751156462585034
7552,0.7553,4,3,4,674618,1826,120739,5517,0.014462679001393993,0.7513277951790821
7553,0.7554,6,0,6,674618,1826,120745,5511,0.014462679001393993,0.7511244377811095
7554,0.7555,8,2,8,674620,1824,120753,5503,0.014446838170067165,0.7510577316773577
7555,0.7556,8,5,8,674625,1819,120761,5495,0.014407236091750096,0.7512988788624556
7556,0.7557,0,2,0,674627,1817,120761,5495,0.014391395260423268,0.7515043763676149
7557,0.7558,8,1,8,674628,1816,120769,5487,0.014383474844759853,0.7513350677803642
7558,0.7559,7,4,7,674632,1812,120776,5480,0.014351793182106196,0.7515085024684586
7559,0.756,7,2,7,674634,1810,120783,5473,0.014335952350779368,0.7514760400933681
7560,0.7561,2,1,2,674635,1809,120785,5471,0.014328031935115955,0.751510989010989
7561,0.7562,3,4,3,674639,1805,120788,5468,0.014296350272462299,0.7518218066822494
7562,0.7563,2,2,2,674641,1803,120790,5466,0.01428050944113547,0.7519603796945935
7563,0.7564,6,0,6,674641,1803,120796,5460,0.01428050944113547,0.7517554729450641
7564,0.7565,9,3,9,674644,1800,120805,5451,0.014256748194145229,0.7517583781547372
7565,0.7566,7,0,7,674644,1800,120812,5444,0.014256748194145229,0.7515184980673661
7566,0.7567,11,1,11,674645,1799,120823,5433,0.014248827778481814,0.7512444690265486
7567,0.7568,6,3,6,674648,1796,120829,5427,0.014225066531491573,0.7513498546310398
7568,0.7569,2,2,2,674650,1794,120831,5425,0.014209225700164745,0.7514891259177171
7569,0.757,7,1,7,674651,1793,120838,5418,0.014201305284501331,0.7513521009568714
7570,0.7571,4,4,4,674655,1789,120842,5414,0.014169623621847675,0.7516312647507983
7571,0.7572,5,2,5,674657,1787,120847,5409,0.014153782790520847,0.7516675931072818
7572,0.7573,3,0,3,674657,1787,120850,5406,0.014153782790520847,0.7515640205755596
7573,0.7574,5,0,5,674657,1787,120855,5401,0.014153782790520847,0.7513912075681691
7574,0.7575,11,2,11,674659,1785,120866,5390,0.014137941959194019,0.751219512195122
7575,0.7576,5,4,5,674663,1781,120871,5385,0.014106260296540362,0.7514652525816355
7576,0.7577,4,1,4,674664,1780,120875,5381,0.01409833988087695,0.7514313643345901
7577,0.7578,6,2,6,674666,1778,120881,5375,0.014082499049550121,0.751432965189431
7578,0.7579,4,2,4,674668,1776,120885,5371,0.014066658218223293,0.7515041276059885
7579,0.758,6,2,6,674670,1774,120891,5365,0.014050817386896465,0.7515058131390951
7580,0.7581,5,5,5,674675,1769,120896,5360,0.014011215308579393,0.7518586056950484
7581,0.7582,4,2,4,674677,1767,120900,5356,0.013995374477252567,0.7519303664186439
7582,0.7583,5,5,5,674682,1762,120905,5351,0.013955772398935496,0.7522845494165612
7583,0.7584,7,0,7,674682,1762,120912,5344,0.013955772398935496,0.7520405291303124
7584,0.7585,7,2,7,674684,1760,120919,5337,0.013939931567608668,0.7520078906580245
7585,0.7586,5,3,5,674687,1757,120924,5332,0.013916170320618426,0.7521512202003103
7586,0.7587,6,2,6,674689,1755,120930,5326,0.013900329489291598,0.75215365061432
7587,0.7588,3,3,3,674692,1752,120933,5323,0.013876568242301357,0.7523674911660777
7588,0.7589,7,1,7,674693,1751,120940,5316,0.013868647826637942,0.7522286684590349
7589,0.759,5,0,5,674693,1751,120945,5311,0.013868647826637942,0.7520532427074483
7590,0.7591,3,4,3,674697,1747,120948,5308,0.013836966163984285,0.7523742026931255
7591,0.7592,2,1,2,674698,1746,120950,5306,0.013829045748320872,0.7524106636415201
7592,0.7593,5,2,5,674700,1744,120955,5301,0.013813204916994044,0.7524485450674238
7593,0.7594,7,2,7,674702,1742,120962,5294,0.013797364085667216,0.752416145537237
7594,0.7595,4,3,4,674705,1739,120966,5290,0.013773602838676974,0.7525963863992033
7595,0.7596,4,0,4,674705,1739,120970,5286,0.013773602838676974,0.7524555160142349
7596,0.7597,6,6,6,674711,1733,120976,5280,0.01372608034469649,0.7528874946527877
7597,0.7598,6,3,6,674714,1730,120982,5274,0.013702319097706247,0.7529982866933181
7598,0.7599,9,0,9,674714,1730,120991,5265,0.013702319097706247,0.7526804860614725
7599,0.76,5,1,5,674715,1729,120996,5260,0.013694398682042834,0.7526112462440979
7600,0.7601,5,3,5,674718,1726,121001,5255,0.013670637435052592,0.7527574846010601
7601,0.7602,4,2,4,674720,1724,121005,5251,0.013654796603725764,0.752831541218638
7602,0.7603,7,5,7,674725,1719,121012,5244,0.013615194525408693,0.7531236535975873
7603,0.7604,4,3,4,674728,1716,121016,5240,0.013591433278418451,0.753306497987349
7604,0.7605,8,1,8,674729,1715,121024,5232,0.013583512862755037,0.7531308478479919
7605,0.7606,6,1,6,674730,1714,121030,5226,0.013575592447091623,0.7530259365994236
7606,0.7607,5,0,5,674730,1714,121035,5221,0.013575592447091623,0.7528478731074261
7607,0.7608,6,2,6,674732,1712,121041,5215,0.013559751615764795,0.7528511621192435
7608,0.7609,2,1,2,674733,1711,121043,5213,0.013551831200101382,0.7528885037550549
7609,0.761,7,2,7,674735,1709,121050,5206,0.013535990368774554,0.7528561099060015
7610,0.7611,6,2,6,674737,1707,121056,5200,0.013520149537447726,0.7528594179817576
7611,0.7612,5,2,5,674739,1705,121061,5195,0.013504308706120897,0.7528985507246376
7612,0.7614,6,3,6,674742,1702,121067,5189,0.013480547459130654,0.753011173995066
7613,0.7615,6,2,6,674744,1700,121073,5183,0.013464706627803828,0.7530146738340839
7614,0.7616,7,3,7,674747,1697,121080,5176,0.013440945380813585,0.7530918085261167
7615,0.7617,8,3,8,674750,1694,121088,5168,0.013417184133823343,0.753133197318566
7616,0.7618,2,3,2,674753,1691,121090,5166,0.0133934228868331,0.7533906956394925
7617,0.7619,5,4,5,674757,1687,121095,5161,0.013361741224179446,0.7536507009345794
7618,0.762,3,0,3,674757,1687,121098,5158,0.013361741224179446,0.7535427319211103
7619,0.7621,6,2,6,674759,1685,121104,5152,0.013345900392852618,0.7535468772853591
7620,0.7622,3,1,3,674760,1684,121107,5149,0.013337979977189203,0.7535489536074931
7621,0.7623,8,2,8,674762,1682,121115,5141,0.013322139145862374,0.7534808735160486
7622,0.7624,5,3,5,674765,1679,121120,5136,0.013298377898872133,0.7536316947909024
7623,0.7625,7,6,7,674771,1673,121127,5129,0.013250855404891649,0.7540429285504263
7624,0.7626,9,3,9,674774,1670,121136,5120,0.013227094157901407,0.7540500736377025
7625,0.7627,4,3,4,674777,1667,121140,5116,0.013203332910911164,0.7542385375202713
7626,0.7628,6,0,6,674777,1667,121146,5110,0.013203332910911164,0.7540209532241404
7627,0.7629,4,3,4,674780,1664,121150,5106,0.013179571663920923,0.7542097488921713
7628,0.763,9,4,9,674784,1660,121159,5097,0.013147890001267266,0.7543288441616102
7629,0.7631,2,2,2,674786,1658,121161,5095,0.013132049169940438,0.7544794905967718
7630,0.7632,4,1,4,674787,1657,121165,5091,0.013124128754277025,0.7544457617071725
7631,0.7633,3,1,3,674788,1656,121168,5088,0.01311620833861361,0.7544483985765125
7632,0.7634,6,3,6,674791,1653,121174,5082,0.013092447091623369,0.75456570155902
7633,0.7635,2,4,2,674795,1649,121176,5080,0.013060765428969712,0.7549412988556992
7634,0.7636,9,1,9,674796,1648,121185,5071,0.013052845013306297,0.7547254055663045
7635,0.7637,0,4,0,674800,1644,121185,5071,0.013021163350652643,0.7551749813849591
7636,0.7638,5,2,5,674802,1642,121190,5066,0.013005322519325815,0.7552176505664878
7637,0.7639,3,3,3,674805,1639,121193,5063,0.012981561272335572,0.7554461354819457
7638,0.764,4,2,4,674807,1637,121197,5059,0.012965720441008743,0.7555256869772998
7639,0.7641,6,3,6,674810,1634,121203,5053,0.012941959194018502,0.7556452818902348
7640,0.7642,4,4,4,674814,1630,121207,5049,0.012910277531364846,0.7559514897439736
7641,0.7643,2,6,2,674820,1624,121209,5047,0.012862755037384361,0.7565582371458552
7642,0.7644,6,2,6,674822,1622,121215,5041,0.012846914206057533,0.7565661113612487
7643,0.7645,3,4,3,674826,1618,121218,5038,0.012815232543403879,0.7569110576923077
7644,0.7646,3,2,3,674828,1616,121221,5035,0.01279939171207705,0.7570290181927529
7645,0.7647,4,3,4,674831,1613,121225,5031,0.012775630465086807,0.7572245635159542
7646,0.7648,10,3,10,674834,1610,121235,5021,0.012751869218096566,0.7572010254863519
7647,0.7649,4,2,4,674836,1608,121239,5017,0.012736028386769738,0.7572830188679245
7648,0.765,4,2,4,674838,1606,121243,5013,0.01272018755544291,0.7573651609004382
7649,0.7651,5,1,5,674839,1605,121248,5008,0.012712267139779496,0.7572962346892484
7650,0.7652,2,0,2,674839,1605,121250,5006,0.012712267139779496,0.7572228104674028
7651,0.7653,5,2,5,674841,1603,121255,5001,0.012696426308452668,0.7572683222289521
7652,0.7654,5,1,5,674842,1602,121260,4996,0.012688505892789253,0.757199151257957
7653,0.7655,10,3,10,674845,1599,121270,4986,0.012664744645799012,0.7571753986332574
7654,0.7656,7,0,7,674845,1599,121277,4979,0.012664744645799012,0.7569169960474308
7655,0.7657,10,1,10,674846,1598,121287,4969,0.012656824230135597,0.7566620983706411
7656,0.7658,4,1,4,674847,1597,121291,4965,0.012648903814472184,0.7566290765010667
7657,0.7659,3,1,3,674848,1596,121294,4962,0.012640983398808769,0.7566331198536139
7658,0.766,4,5,4,674853,1591,121298,4958,0.0126013813204917,0.7570621468926554
7659,0.7661,7,4,7,674857,1587,121305,4951,0.012569699657838043,0.7572652187213215
7660,0.7662,5,2,5,674859,1585,121310,4946,0.012553858826511215,0.7573112846424743
7661,0.7663,2,2,2,674861,1583,121312,4944,0.012538017995184387,0.7574689750268117
7662,0.7664,6,1,6,674862,1582,121318,4938,0.012530097579520973,0.757361963190184
7663,0.7665,7,1,7,674863,1581,121325,4931,0.012522177163857558,0.7572174447174447
7664,0.7666,4,2,4,674865,1579,121329,4927,0.012506336332530732,0.7573009529664925
7665,0.7667,8,3,8,674868,1576,121337,4919,0.012482575085540489,0.7573518090839108
7666,0.7668,1,3,1,674871,1573,121338,4918,0.012458813838550247,0.7576644584809736
7667,0.7669,5,0,5,674871,1573,121343,4913,0.012458813838550247,0.7574776441566451
7668,0.767,1,2,1,674873,1571,121344,4912,0.01244297300722342,0.7576739163967299
7669,0.7671,4,0,4,674873,1571,121348,4908,0.01244297300722342,0.7575243093069918
7670,0.7672,5,1,5,674874,1570,121353,4903,0.012435052591560004,0.7574540398578712
7671,0.7673,11,2,11,674876,1568,121364,4892,0.012419211760233176,0.7572755417956656
7672,0.7674,3,1,3,674877,1567,121367,4889,0.012411291344569763,0.7572800495662949
7673,0.7675,5,2,5,674879,1565,121372,4884,0.012395450513242935,0.7573267173205148
7674,0.7676,7,0,7,674879,1565,121379,4877,0.012395450513242935,0.7570630239056194
7675,0.7677,5,1,5,674880,1564,121384,4872,0.012387530097579522,0.7569919204474829
7676,0.7678,2,1,2,674881,1563,121386,4870,0.012379609681916107,0.7570340432146744
7677,0.7679,1,2,1,674883,1561,121387,4869,0.012363768850589279,0.7572317262830482
7678,0.768,4,1,4,674884,1560,121391,4865,0.012355848434925865,0.7571984435797665
7679,0.7681,3,2,3,674886,1558,121394,4862,0.012340007603599037,0.7573208722741434
7680,0.7682,7,5,7,674891,1553,121401,4855,0.012300405525281968,0.7576466916354557
7681,0.7683,6,7,6,674898,1546,121407,4849,0.012244962615638068,0.7582486317435496
7682,0.7684,2,2,2,674900,1544,121409,4847,0.01222912178431124,0.7584102644343608
7683,0.7685,6,3,6,674903,1541,121415,4841,0.012205360537320999,0.7585396427452209
7684,0.7686,9,2,9,674905,1539,121424,4832,0.01218951970599417,0.7584366661434626
7685,0.7687,7,0,7,674905,1539,121431,4825,0.01218951970599417,0.7581709616593337
7686,0.7688,4,1,4,674906,1538,121435,4821,0.012181599290330757,0.7581380720239032
7687,0.7689,5,3,5,674909,1535,121440,4816,0.012157838043340514,0.7583057786175406
7688,0.769,7,1,7,674910,1534,121447,4809,0.012149917627677101,0.7581586000315308
7689,0.7691,10,2,10,674912,1532,121457,4799,0.012134076796350273,0.7580161111988627
7690,0.7692,8,3,8,674915,1529,121465,4791,0.01211031554936003,0.7580696202531646
7691,0.7693,8,2,8,674917,1527,121473,4783,0.012094474718033203,0.7580031695721078
7692,0.7694,6,4,6,674921,1523,121479,4777,0.012062793055379547,0.7582539682539683
7693,0.7695,3,1,3,674922,1522,121482,4774,0.012054872639716132,0.7582592121982211
7694,0.7696,8,3,8,674925,1519,121490,4766,0.01203111139272589,0.7583134447096261
7695,0.7697,4,1,4,674926,1518,121494,4762,0.012023190977062476,0.7582802547770701
7696,0.7698,8,1,8,674927,1517,121502,4754,0.012015270561399062,0.758092808164567
7697,0.7699,7,3,7,674930,1514,121509,4747,0.01199150931440882,0.758185593355694
7698,0.77,1,0,1,674930,1514,121510,4746,0.01199150931440882,0.75814696485623
7699,0.7701,3,2,3,674932,1512,121513,4743,0.011975668483081993,0.758273381294964
7700,0.7702,5,0,5,674932,1512,121518,4738,0.011975668483081993,0.75808
7701,0.7703,8,2,8,674934,1510,121526,4730,0.011959827651755165,0.7580128205128205
7702,0.7704,7,7,7,674941,1503,121533,4723,0.011904384742111265,0.7585929971088982
7703,0.7705,6,3,6,674944,1500,121539,4717,0.011880623495121024,0.7587260736689722
7704,0.7706,3,1,3,674945,1499,121542,4714,0.01187270307945761,0.7587316916143569
7705,0.7707,3,2,3,674947,1497,121545,4711,0.011856862248130783,0.7588595360824743
7706,0.7708,6,2,6,674949,1495,121551,4705,0.011841021416803954,0.7588709677419355
7707,0.7709,4,1,4,674950,1494,121555,4701,0.01183310100114054,0.7588377723970944
7708,0.771,7,3,7,674953,1491,121562,4694,0.011809339754150298,0.7589329021827
7709,0.7711,6,2,6,674955,1489,121568,4688,0.01179349892282347,0.7589444714262586
7710,0.7712,5,2,5,674957,1487,121573,4683,0.011777658091496642,0.7589951377633711
7711,0.7713,4,3,4,674960,1484,121577,4679,0.0117538968445064,0.7592081778354698
7712,0.7714,5,3,5,674963,1481,121582,4674,0.011730135597516157,0.7593826157595451
7713,0.7715,8,2,8,674965,1479,121590,4666,0.011714294766189329,0.7593165174938975
7714,0.7716,1,1,1,674966,1478,121591,4665,0.011706374350525916,0.7594009441640892
7715,0.7717,6,0,6,674966,1478,121597,4659,0.011706374350525916,0.759165716147955
7716,0.7718,4,2,4,674968,1476,121601,4655,0.011690533519199088,0.7592562387864948
7717,0.7719,7,6,7,674974,1470,121608,4648,0.011643011025218603,0.7597254004576659
7718,0.772,1,0,1,674974,1470,121609,4647,0.011643011025218603,0.7596861206473762
7719,0.7721,9,5,9,674979,1465,121618,4638,0.011603408946901534,0.7599541209241357
7720,0.7722,8,1,8,674980,1464,121626,4630,0.011595488531238119,0.7597637020019692
7721,0.7723,9,0,9,674980,1464,121635,4621,0.011595488531238119,0.7594083812654068
7722,0.7724,7,2,7,674982,1462,121642,4614,0.01157964769991129,0.7593811718235681
7723,0.7725,5,2,5,674984,1460,121647,4609,0.011563806868584464,0.7594331850387214
7724,0.7726,8,1,8,674985,1459,121655,4601,0.01155588645292105,0.7592409240924093
7725,0.7727,4,1,4,674986,1458,121659,4597,0.011547966037257636,0.7592072667217176
7726,0.7728,14,1,14,674987,1457,121673,4583,0.011540045621594221,0.758774834437086
7727,0.7729,6,1,6,674988,1456,121679,4577,0.011532125205930808,0.7586606994861594
7728,0.773,8,2,8,674990,1454,121687,4569,0.01151628437460398,0.7585920637556035
7729,0.7731,4,3,4,674993,1451,121691,4565,0.011492523127613737,0.7588098404255319
7730,0.7732,5,2,5,674995,1449,121696,4560,0.011476682296286908,0.7588617074388417
7731,0.7733,7,1,7,674996,1448,121703,4553,0.011468761880623495,0.7587068821863023
7732,0.7734,8,1,8,674997,1447,121711,4545,0.01146084146496008,0.7585113484646195
7733,0.7735,6,0,6,674997,1447,121717,4539,0.01146084146496008,0.7582692950217174
7734,0.7736,6,4,6,675001,1443,121723,4533,0.011429159802306426,0.7585341365461847
7735,0.7737,3,2,3,675003,1441,121726,4530,0.011413318970979597,0.7586668899681795
7736,0.7738,3,3,3,675006,1438,121729,4527,0.011389557723989354,0.758927074601844
7737,0.7739,1,1,1,675007,1437,121730,4526,0.011381637308325941,0.7590139191682039
7738,0.774,4,1,4,675008,1436,121734,4522,0.011373716892662526,0.7589795233299765
7739,0.7741,2,1,2,675009,1435,121736,4520,0.011365796476999113,0.7590260285474392
7740,0.7742,7,2,7,675011,1433,121743,4513,0.011349955645672285,0.7589976454759502
7741,0.7743,5,2,5,675013,1431,121748,4508,0.011334114814345457,0.7590503451759556
7742,0.7744,8,0,8,675013,1431,121756,4500,0.011334114814345457,0.7587253414264037
7743,0.7745,3,2,3,675015,1429,121759,4497,0.011318273983018629,0.7588592642591968
7744,0.7746,3,0,3,675015,1429,121762,4494,0.011318273983018629,0.7587371264561877
7745,0.7747,4,1,4,675016,1428,121766,4490,0.011310353567355215,0.7587022642784724
7746,0.7748,6,1,6,675017,1427,121772,4484,0.0113024331516918,0.7585856877008966
7747,0.7749,5,3,5,675020,1424,121777,4479,0.011278671904701559,0.7587667287819753
7748,0.775,6,2,6,675022,1422,121783,4473,0.01126283107337473,0.7587786259541984
7749,0.7751,6,3,6,675025,1419,121789,4467,0.01123906982638449,0.7589194699286442
7750,0.7752,5,1,5,675026,1418,121794,4462,0.011231149410721075,0.758843537414966
7751,0.7753,6,5,6,675031,1413,121800,4456,0.011191547332404005,0.759243482705742
7752,0.7754,6,1,6,675032,1412,121806,4450,0.01118362691674059,0.7591265779597407
7753,0.7755,3,2,3,675034,1410,121809,4447,0.011167786085413762,0.7592624210346594
7754,0.7756,5,1,5,675035,1409,121814,4442,0.011159865669750349,0.7591864638523329
7755,0.7757,8,0,8,675035,1409,121822,4434,0.011159865669750349,0.7588567516686634
7756,0.7758,5,2,5,675037,1407,121827,4429,0.01114402483842352,0.7589102124742975
7757,0.7759,7,2,7,675039,1405,121834,4422,0.011128184007096692,0.7588810708769521
7758,0.776,8,2,8,675041,1403,121842,4414,0.011112343175769864,0.7588103833591198
7759,0.7761,5,1,5,675042,1402,121847,4409,0.011104422760106451,0.7587334365857856
7760,0.7762,1,3,1,675045,1399,121848,4408,0.011080661513116208,0.7590838643017048
7761,0.7763,3,0,3,675045,1399,121851,4405,0.011080661513116208,0.7589593383873191
7762,0.7764,8,1,8,675046,1398,121859,4397,0.011072741097452795,0.7587575496117342
7763,0.7765,10,3,10,675049,1395,121869,4387,0.011048979850462552,0.7587340020754064
7764,0.7766,1,1,1,675050,1394,121870,4386,0.011041059434799138,0.7588235294117647
7765,0.7767,3,2,3,675052,1392,121873,4383,0.01102521860347231,0.758961038961039
7766,0.7768,3,3,3,675055,1389,121876,4380,0.011001457356482069,0.7592303692147686
7767,0.7769,3,3,3,675058,1386,121879,4377,0.010977696109491826,0.7595002602811036
7768,0.777,7,2,7,675060,1384,121886,4370,0.010961855278164997,0.759471671880431
7769,0.7771,3,2,3,675062,1382,121889,4367,0.01094601444683817,0.7596103670203513
7770,0.7772,4,1,4,675063,1381,121893,4363,0.010938094031174756,0.759575208913649
7771,0.7773,5,1,5,675064,1380,121898,4358,0.010930173615511341,0.7594980829557337
7772,0.7774,6,2,6,675066,1378,121904,4352,0.010914332784184515,0.7595113438045376
7773,0.7775,4,3,4,675069,1375,121908,4348,0.010890571537194272,0.7597413943735802
7774,0.7776,2,2,2,675071,1373,121910,4346,0.010874730705867443,0.759923063472635
7775,0.7777,6,1,6,675072,1372,121916,4340,0.01086681029020403,0.7598039215686274
7776,0.7778,3,1,3,675073,1371,121919,4337,0.010858889874540615,0.7598107918710582
7777,0.7779,4,1,4,675074,1370,121923,4333,0.010850969458877202,0.7597755567245309
7778,0.778,10,1,10,675075,1369,121933,4323,0.010843049043213787,0.7594869992972593
7779,0.7781,4,1,4,675076,1368,121937,4319,0.010835128627550374,0.7594513803411289
7780,0.7782,6,1,6,675077,1367,121943,4313,0.010827208211886959,0.759330985915493
7781,0.7783,4,3,4,675080,1364,121947,4309,0.010803446964896718,0.7595628415300546
7782,0.7784,2,2,2,675082,1362,121949,4307,0.01078760613356989,0.7597459869465514
7783,0.7785,4,5,4,675087,1357,121953,4303,0.01074800405525282,0.7602473498233215
7784,0.7786,6,2,6,675089,1355,121959,4297,0.010732163223925992,0.7602618542108988
7785,0.7787,8,0,8,675089,1355,121967,4289,0.010732163223925992,0.7599220411055989
7786,0.7788,6,1,6,675090,1354,121973,4283,0.010724242808262577,0.7598013127550115
7787,0.7789,9,2,9,675092,1352,121982,4274,0.01070840197693575,0.7596871667259154
7788,0.779,7,0,7,675092,1352,121989,4267,0.01070840197693575,0.7593877914219612
7789,0.7791,4,4,4,675096,1348,121993,4263,0.010676720314282094,0.7597576189627517
7790,0.7792,8,1,8,675097,1347,122001,4255,0.010668799898618679,0.7595501606569083
7791,0.7793,6,1,6,675098,1346,122007,4249,0.010660879482955266,0.7594280607685433
7792,0.7794,3,1,3,675099,1345,122010,4246,0.010652959067291851,0.7594348059381149
7793,0.7795,4,2,4,675101,1343,122014,4242,0.010637118235965023,0.7595344673231871
7794,0.7796,2,1,2,675102,1342,122016,4240,0.01062919782030161,0.7595843783590112
7795,0.7797,8,2,8,675104,1340,122024,4232,0.010613356988974781,0.7595118449389806
7796,0.7798,3,3,3,675107,1337,122027,4229,0.01058959574198454,0.7597915918074021
7797,0.7799,9,4,9,675111,1333,122036,4220,0.010557914079330884,0.7599495768053305
7798,0.78,6,2,6,675113,1331,122042,4214,0.010542073248004056,0.7599639314697926
7799,0.7801,7,3,7,675116,1328,122049,4207,0.010518312001013812,0.7600722673893405
7800,0.7802,3,2,3,675118,1326,122052,4204,0.010502471169686986,0.7602169981916818
7801,0.7803,5,1,5,675119,1325,122057,4199,0.010494550754023571,0.7601375814627082
7802,0.7804,2,0,2,675119,1325,122059,4197,0.010494550754023571,0.7600507062658457
7803,0.7805,3,2,3,675121,1323,122062,4194,0.010478709922696743,0.7601957585644372
7804,0.7806,2,2,2,675123,1321,122064,4192,0.010462869091369915,0.7603845456194449
7805,0.7807,2,0,2,675123,1321,122066,4190,0.010462869091369915,0.760297586644892
7806,0.7808,4,3,4,675126,1318,122070,4186,0.010439107844379673,0.7605377906976745
7807,0.7809,9,3,9,675129,1315,122079,4177,0.01041534659738943,0.7605608157319738
7808,0.781,6,3,6,675132,1312,122085,4171,0.010391585350399189,0.7607149370782419
7809,0.7811,6,2,6,675134,1310,122091,4165,0.01037574451907236,0.7607305936073059
7810,0.7812,5,2,5,675136,1308,122096,4160,0.010359903687745533,0.7607900512070227
7811,0.7813,5,2,5,675138,1306,122101,4155,0.010344062856418704,0.7608496612342062
7812,0.7814,7,2,7,675140,1304,122108,4148,0.010328222025091876,0.7608217168011738
7813,0.7815,6,1,6,675141,1303,122114,4142,0.010320301609428463,0.7606978879706152
7814,0.7816,3,5,3,675146,1298,122117,4139,0.010280699531111393,0.7612654037152842
7815,0.7817,9,1,9,675147,1297,122126,4130,0.010272779115447979,0.7610097659848903
7816,0.7818,3,2,3,675149,1295,122129,4127,0.01025693828412115,0.7611582441903356
7817,0.7819,8,1,8,675150,1294,122137,4119,0.010249017868457737,0.7609458710511731
7818,0.782,4,3,4,675153,1291,122141,4115,0.010225256621467494,0.7611912689604143
7819,0.7821,9,2,9,675155,1289,122150,4106,0.010209415790140666,0.7610750695088044
7820,0.7822,3,2,3,675157,1287,122153,4103,0.010193574958813838,0.7612244897959184
7821,0.7823,3,1,3,675158,1286,122156,4100,0.010185654543150425,0.7612328258447828
7822,0.7824,8,3,8,675161,1283,122164,4092,0.010161893296160183,0.7613023255813953
7823,0.7825,5,2,5,675163,1281,122169,4087,0.010146052464833355,0.7613636363636364
7824,0.7826,7,3,7,675166,1278,122176,4080,0.010122291217843112,0.761478163493841
7825,0.7827,3,1,3,675167,1277,122179,4077,0.010114370802179699,0.7614867388868136
7826,0.7828,4,1,4,675168,1276,122183,4073,0.010106450386516284,0.7614507384557861
7827,0.7829,7,1,7,675169,1275,122190,4066,0.01009852997085287,0.7612806590526119
7828,0.783,4,2,4,675171,1273,122194,4062,0.010082689139526042,0.7613870665417057
7829,0.7831,1,2,1,675173,1271,122195,4061,0.010066848308199214,0.7616279069767442
7830,0.7832,5,3,5,675176,1268,122200,4056,0.010043087061208973,0.7618332081141999
7831,0.7833,6,3,6,675179,1265,122206,4050,0.01001932581421873,0.761994355597366
7832,0.7834,2,4,2,675183,1261,122208,4048,0.009987644151565073,0.762478809568657
7833,0.7835,6,1,6,675184,1260,122214,4042,0.00997972373590166,0.7623538287438703
7834,0.7836,5,2,5,675186,1258,122219,4037,0.009963882904574832,0.7624173748819641
7835,0.7837,6,0,6,675186,1258,122225,4031,0.009963882904574832,0.76214785403668
7836,0.7838,4,0,4,675186,1258,122229,4027,0.009963882904574832,0.7619678334910123
7837,0.7839,4,3,4,675189,1255,122233,4023,0.00994012165758459,0.762220538082607
7838,0.784,7,2,7,675191,1253,122240,4016,0.009924280826257762,0.7621939646991839
7839,0.7841,3,2,3,675193,1251,122243,4013,0.009908439994930934,0.7623480243161094
7840,0.7842,3,2,3,675195,1249,122246,4010,0.009892599163604106,0.7625023768777334
7841,0.7843,4,0,4,675195,1249,122250,4006,0.009892599163604106,0.7623215984776404
7842,0.7844,1,1,1,675196,1248,122251,4005,0.009884678747940691,0.7624214734437464
7843,0.7845,3,3,3,675199,1245,122254,4002,0.00986091750095045,0.7627215551743853
7844,0.7846,5,0,5,675199,1245,122259,3997,0.00986091750095045,0.7624952308279282
7845,0.7847,5,0,5,675199,1245,122264,3992,0.00986091750095045,0.7622684743173572
7846,0.7848,4,0,4,675199,1245,122268,3988,0.00986091750095045,0.7620867571182878
7847,0.7849,5,1,5,675200,1244,122273,3983,0.009852997085287037,0.7620049741725655
7848,0.785,5,4,5,675204,1240,122278,3978,0.00982131542263338,0.762361057876581
7849,0.7851,8,3,8,675207,1237,122286,3970,0.009797554175643137,0.7624351834069522
7850,0.7852,6,1,6,675208,1236,122292,3964,0.009789633759979724,0.7623076923076924
7851,0.7853,2,2,2,675210,1234,122294,3962,0.009773792928652896,0.762509622786759
7852,0.7854,4,0,4,675210,1234,122298,3958,0.009773792928652896,0.762326656394453
7853,0.7855,6,1,6,675211,1233,122304,3952,0.00976587251298948,0.762198649951784
7854,0.7856,4,1,4,675212,1232,122308,3948,0.009757952097326068,0.7621621621621621
7855,0.7857,7,0,7,675212,1232,122315,3941,0.009757952097326068,0.7618403247631935
7856,0.7858,4,2,4,675214,1230,122319,3937,0.00974211126599924,0.7619508418811689
7857,0.7859,2,1,2,675215,1229,122321,3935,0.009734190850335826,0.762006196746708
7858,0.786,6,3,6,675218,1226,122327,3929,0.009710429603345583,0.762172647914646
7859,0.7861,2,4,2,675222,1222,122329,3927,0.009678747940691927,0.762672363565741
7860,0.7862,5,1,5,675223,1221,122334,3922,0.009670827525028514,0.762589928057554
7861,0.7863,4,3,4,675226,1218,122338,3918,0.009647066278038272,0.7628504672897196
7862,0.7864,4,1,4,675227,1217,122342,3914,0.009639145862374857,0.7628142662249074
7863,0.7865,7,1,7,675228,1216,122349,3907,0.009631225446711444,0.7626390786648448
7864,0.7866,3,0,3,675228,1216,122352,3904,0.009631225446711444,0.7625
7865,0.7867,2,3,2,675231,1213,122354,3902,0.009607464199721201,0.7628543499511241
7866,0.7868,4,1,4,675232,1212,122358,3898,0.009599543784057788,0.7628180039138943
7867,0.7869,3,1,3,675233,1211,122361,3895,0.009591623368394373,0.7628280454367411
7868,0.787,8,3,8,675236,1208,122369,3887,0.009567862121404131,0.7629048086359176
7869,0.7871,5,4,5,675240,1204,122374,3882,0.009536180458750475,0.7632717263075108
7870,0.7872,3,2,3,675242,1202,122377,3879,0.009520339627423647,0.7634323951977957
7871,0.7873,8,4,8,675246,1198,122385,3871,0.00948865796476999,0.7636614716906688
7872,0.7874,5,3,5,675249,1195,122390,3866,0.00946489671777975,0.7638806559968385
7873,0.7875,4,3,4,675252,1192,122394,3862,0.009441135470789508,0.7641472101305896
7874,0.7876,6,1,6,675253,1191,122400,3856,0.009433215055126093,0.7640182286506836
7875,0.7877,4,2,4,675255,1189,122404,3852,0.009417374223799265,0.7641341003769093
7876,0.7878,3,3,3,675258,1186,122407,3849,0.009393612976809023,0.7644488579940417
7877,0.7879,3,2,3,675260,1184,122410,3846,0.009377772145482195,0.7646123260437375
7878,0.788,3,4,3,675264,1180,122413,3843,0.009346090482828539,0.7650806291061119
7879,0.7881,4,0,4,675264,1180,122417,3839,0.009346090482828539,0.7648934050607691
7880,0.7882,4,5,4,675269,1175,122421,3835,0.00930648840451147,0.7654690618762475
7881,0.7883,5,1,5,675270,1174,122426,3830,0.009298567988848054,0.7653876898481216
7882,0.7884,3,3,3,675273,1171,122429,3827,0.009274806741857813,0.7657062825130052
7883,0.7885,4,2,4,675275,1169,122433,3823,0.009258965910530985,0.7658253205128205
7884,0.7886,3,1,3,675276,1168,122436,3820,0.00925104549486757,0.7658380112269446
7885,0.7887,4,2,4,675278,1166,122440,3816,0.009235204663540742,0.7659574468085106
7886,0.7888,6,1,6,675279,1165,122446,3810,0.009227284247877329,0.7658291457286432
7887,0.7889,5,0,5,675279,1165,122451,3805,0.009227284247877329,0.7655935613682092
7888,0.789,3,3,3,675282,1162,122454,3802,0.009203523000887087,0.765914585012087
7889,0.7891,4,3,4,675285,1159,122458,3798,0.009179761753896844,0.7661892273552552
7890,0.7892,5,0,5,675285,1159,122463,3793,0.009179761753896844,0.7659531502423264
7891,0.7893,5,2,5,675287,1157,122468,3788,0.009163920922570016,0.7660262891809909
7892,0.7894,6,5,6,675292,1152,122474,3782,0.009124318844252946,0.766518038102959
7893,0.7895,3,0,3,675292,1152,122477,3779,0.009124318844252946,0.7663759886432773
7894,0.7896,5,4,5,675296,1148,122482,3774,0.00909263718159929,0.7667614790735473
7895,0.7897,2,1,2,675297,1147,122484,3772,0.009084716765935877,0.7668225249034356
7896,0.7898,4,2,4,675299,1145,122488,3768,0.009068875934609049,0.766944840219825
7897,0.7899,6,2,6,675301,1143,122494,3762,0.00905303510328222,0.7669724770642202
7898,0.79,5,0,5,675301,1143,122499,3757,0.00905303510328222,0.766734693877551
7899,0.7901,5,0,5,675301,1143,122504,3752,0.00905303510328222,0.7664964249233912
7900,0.7902,6,2,6,675303,1141,122510,3746,0.009037194271955392,0.7665234295068549
7901,0.7903,11,2,11,675305,1139,122521,3735,0.009021353440628564,0.7663110381616742
7902,0.7904,2,6,2,675311,1133,122523,3733,0.00897383094664808,0.7671598849157418
7903,0.7905,10,2,10,675313,1131,122533,3723,0.008957990115321252,0.7669962917181706
7904,0.7906,3,1,3,675314,1130,122536,3720,0.008950069699657838,0.7670103092783506
7905,0.7907,5,2,5,675316,1128,122541,3715,0.00893422886833101,0.7670865166219285
7906,0.7908,5,3,5,675319,1125,122546,3710,0.008910467621340769,0.7673216132368149
7907,0.7909,4,1,4,675320,1124,122550,3706,0.008902547205677354,0.767287784679089
7908,0.791,8,2,8,675322,1122,122558,3698,0.008886706374350526,0.7672199170124482
7909,0.7911,7,5,7,675327,1117,122565,3691,0.008847104296033456,0.7676788685524126
7910,0.7912,2,0,2,675327,1117,122567,3689,0.008847104296033456,0.7675821889305036
7911,0.7913,5,2,5,675329,1115,122572,3684,0.008831263464706628,0.7676599291519066
7912,0.7914,8,4,8,675333,1111,122580,3676,0.008799581802052972,0.7679130979736787
7913,0.7915,4,1,4,675334,1110,122584,3672,0.008791661386389558,0.767879548306148
7914,0.7916,5,2,5,675336,1108,122589,3667,0.00877582055506273,0.7679581151832461
7915,0.7917,6,2,6,675338,1106,122595,3661,0.008759979723735902,0.7679882525697503
7916,0.7918,7,1,7,675339,1105,122602,3654,0.008752059308072487,0.7678083631014919
7917,0.7919,9,4,9,675343,1101,122611,3645,0.008720377645418831,0.7680151706700379
7918,0.792,3,5,3,675348,1096,122614,3642,0.008680775567101761,0.7686787674124103
7919,0.7921,4,0,4,675348,1096,122618,3638,0.008680775567101761,0.7684833122095479
7920,0.7922,3,0,3,675348,1096,122621,3635,0.008680775567101761,0.7683365039103783
7921,0.7923,1,1,1,675349,1095,122622,3634,0.008672855151438348,0.7684499894269402
7922,0.7924,5,2,5,675351,1093,122627,3629,0.00865701432011152,0.7685302837780601
7923,0.7925,4,1,4,675352,1092,122631,3625,0.008649093904448105,0.7684969260122959
7924,0.7926,7,3,7,675355,1089,122638,3618,0.008625332657457864,0.768642447418738
7925,0.7927,1,0,1,675355,1089,122639,3617,0.008625332657457864,0.7685932851678708
7926,0.7928,5,1,5,675356,1088,122644,3612,0.008617412241794449,0.7685106382978724
7927,0.7929,7,1,7,675357,1087,122651,3605,0.008609491826131035,0.7683290707587382
7928,0.793,3,2,3,675359,1085,122654,3602,0.008593650994804207,0.7685086409216983
7929,0.7931,2,4,2,675363,1081,122656,3600,0.008561969332150551,0.7690664387951293
7930,0.7932,8,4,8,675367,1077,122664,3592,0.008530287669496895,0.7693296209038338
7931,0.7933,1,1,1,675368,1076,122665,3591,0.008522367253833481,0.7694450396400258
7932,0.7934,4,0,4,675368,1076,122669,3587,0.008522367253833481,0.7692472657087712
7933,0.7935,4,2,4,675370,1074,122673,3583,0.008506526422506653,0.7693794288168349
7934,0.7936,3,3,3,675373,1071,122676,3580,0.008482765175516412,0.7697269404429155
7935,0.7937,1,0,1,675373,1071,122677,3579,0.008482765175516412,0.7696774193548387
7936,0.7938,2,2,2,675375,1069,122679,3577,0.008466924344189584,0.7699095996556178
7937,0.7939,2,0,2,675375,1069,122681,3575,0.008466924344189584,0.7698105081826012
7938,0.794,8,1,8,675376,1068,122689,3567,0.008459003928526169,0.7695792880258899
7939,0.7941,3,2,3,675378,1066,122692,3564,0.00844316309719934,0.7697624190064795
7940,0.7942,2,4,2,675382,1062,122694,3562,0.008411481434545684,0.7703287197231834
7941,0.7943,6,4,6,675386,1058,122700,3556,0.00837979977189203,0.7706978760294755
7942,0.7944,4,2,4,675388,1056,122704,3552,0.008363958940565202,0.7708333333333334
7943,0.7945,4,2,4,675390,1054,122708,3548,0.008348118109238373,0.7709691438504997
7944,0.7946,10,0,10,675390,1054,122718,3538,0.008348118109238373,0.7704703832752613
7945,0.7947,1,1,1,675391,1053,122719,3537,0.008340197693574958,0.7705882352941177
7946,0.7948,0,2,0,675393,1051,122719,3537,0.00832435686224813,0.770924149956408
7947,0.7949,6,4,6,675397,1047,122725,3531,0.008292675199594474,0.77129750982962
7948,0.795,6,2,6,675399,1045,122731,3525,0.008276834368267646,0.7713347921225383
7949,0.7951,5,2,5,675401,1043,122736,3520,0.00826099353694082,0.7714223098838483
7950,0.7952,1,4,1,675405,1039,122737,3519,0.008229311874287163,0.7720491443615621
7951,0.7953,5,4,5,675409,1035,122742,3514,0.008197630211633507,0.7724774675752912
7952,0.7954,3,2,3,675411,1033,122745,3511,0.008181789380306679,0.7726672535211268
7953,0.7955,7,3,7,675414,1030,122752,3504,0.008158028133316437,0.7728275253639171
7954,0.7956,5,1,5,675415,1029,122757,3499,0.008150107717653022,0.7727473498233216
7955,0.7957,3,2,3,675417,1027,122760,3496,0.008134266886326194,0.7729383152774707
7956,0.7958,2,1,2,675418,1026,122762,3494,0.008126346470662781,0.7730088495575221
7957,0.7959,8,2,8,675420,1024,122770,3486,0.008110505639335953,0.7729490022172949
7958,0.796,8,2,8,675422,1022,122778,3478,0.008094664808009125,0.7728888888888888
7959,0.7961,3,0,3,675422,1022,122781,3475,0.008094664808009125,0.7727373804758728
7960,0.7962,4,0,4,675422,1022,122785,3471,0.008094664808009125,0.7725350545292677
7961,0.7963,6,0,6,675422,1022,122791,3465,0.008094664808009125,0.7722308892355694
7962,0.7964,3,1,3,675423,1021,122794,3462,0.00808674439234571,0.7722507249609636
7963,0.7965,1,3,1,675426,1018,122795,3461,0.008062983145355468,0.7727171243581157
7964,0.7966,5,0,5,675426,1018,122800,3456,0.008062983145355468,0.7724631202503353
7965,0.7967,5,2,5,675428,1016,122805,3451,0.00804714231402864,0.7725542869935079
7966,0.7968,7,1,7,675429,1015,122812,3444,0.008039221898365227,0.7723704866562009
7967,0.7969,8,5,8,675434,1010,122820,3436,0.007999619820048156,0.7728295096716149
7968,0.797,6,1,6,675435,1009,122826,3430,0.007991699404384742,0.7726965532777652
7969,0.7971,6,1,6,675436,1008,122832,3424,0.007983778988721327,0.7725631768953068
7970,0.7972,6,0,6,675436,1008,122838,3418,0.007983778988721327,0.772254857659286
7971,0.7973,6,2,6,675438,1006,122844,3412,0.0079679381573945,0.7722951561792666
7972,0.7974,6,2,6,675440,1004,122850,3406,0.007952097326067673,0.7723356009070295
7973,0.7975,2,4,2,675444,1000,122852,3404,0.007920415663414017,0.7729336966394187
7974,0.7976,2,0,2,675444,1000,122854,3402,0.007920415663414017,0.7728305315765561
7975,0.7977,4,1,4,675445,999,122858,3398,0.007912495247750602,0.7727996361155334
7976,0.7978,6,0,6,675445,999,122864,3392,0.007912495247750602,0.7724891824185834
7977,0.7979,4,2,4,675447,997,122868,3388,0.007896654416423773,0.7726339794754846
7978,0.798,7,1,7,675448,996,122875,3381,0.00788873400076036,0.772446881425634
7979,0.7981,5,1,5,675449,995,122880,3376,0.007880813585096945,0.7723633035918555
7980,0.7982,4,3,4,675452,992,122884,3372,0.007857052338106704,0.772685609532539
7981,0.7983,5,3,5,675455,989,122889,3367,0.007833291091116463,0.7729568411386594
7982,0.7984,5,3,5,675458,986,122894,3362,0.007809529844126219,0.7732290708371665
7983,0.7985,6,3,6,675461,983,122900,3356,0.007785768597135978,0.7734501037105324
7984,0.7986,5,1,5,675462,982,122905,3351,0.007777848181472564,0.77336718209093
7985,0.7987,2,1,2,675463,981,122907,3349,0.00776992776580915,0.7734411085450347
7986,0.7988,6,2,6,675465,979,122913,3343,0.007754086934482322,0.7734844979176307
7987,0.7989,2,1,2,675466,978,122915,3341,0.007746166518818908,0.7735586941421625
7988,0.799,6,1,6,675467,977,122921,3335,0.0077382461031554935,0.7734230055658627
7989,0.7991,6,1,6,675468,976,122927,3329,0.0077303256874920795,0.7732868757259002
7990,0.7992,4,3,4,675471,973,122931,3325,0.007706564440501837,0.7736156351791531
7991,0.7993,4,1,4,675472,972,122935,3321,0.007698644024838423,0.7735849056603774
7992,0.7994,8,0,8,675472,972,122943,3313,0.007698644024838423,0.7731621936989498
7993,0.7995,1,1,1,675473,971,122944,3312,0.00769072360917501,0.7732897501751109
7994,0.7996,5,3,5,675476,968,122949,3307,0.007666962362184768,0.7735672514619883
7995,0.7997,1,1,1,675477,967,122950,3306,0.007659041946521354,0.7736952960449333
7996,0.7998,3,2,3,675479,965,122953,3303,0.0076432011151945254,0.7738987816307404
7997,0.7999,9,1,9,675480,964,122962,3294,0.007635280699531111,0.773602630342884
7998,0.8,5,5,5,675485,959,122967,3289,0.007595678621214041,0.77424670433145
7999,0.8001,2,0,2,675485,959,122969,3287,0.007595678621214041,0.7741403674046161
8000,0.8002,5,1,5,675486,958,122974,3282,0.007587758205550627,0.7740566037735849
8001,0.8003,1,0,1,675486,958,122975,3281,0.007587758205550627,0.774003302665723
8002,0.8004,2,4,2,675490,954,122977,3279,0.007556076542896971,0.77462792345854
8003,0.8005,6,0,6,675490,954,122983,3273,0.007556076542896971,0.7743080198722498
8004,0.8006,2,2,2,675492,952,122985,3271,0.007540235711570143,0.7745678427658063
8005,0.8007,3,2,3,675494,950,122988,3268,0.007524394880243315,0.7747747747747747
8006,0.8008,5,0,5,675494,950,122993,3263,0.007524394880243315,0.7745074768573463
8007,0.8009,4,0,4,675494,950,122997,3259,0.007524394880243315,0.7742931812782133
8008,0.801,8,1,8,675495,949,123005,3251,0.007516474464579901,0.7740476190476191
8009,0.8011,0,2,0,675497,947,123005,3251,0.007500633633253073,0.7744163887565507
8010,0.8012,9,4,9,675501,943,123014,3242,0.007468951970599417,0.7746714456391876
8011,0.8013,7,2,7,675503,941,123021,3235,0.007453111139272589,0.7746647509578544
8012,0.8014,6,1,6,675504,940,123027,3229,0.007445190723609175,0.7745262652914368
8013,0.8015,7,0,7,675504,940,123034,3222,0.007445190723609175,0.7741470446900529
8014,0.8016,5,1,5,675505,939,123039,3217,0.007437270307945761,0.7740615976900866
8015,0.8017,4,1,4,675506,938,123043,3213,0.007429349892282347,0.7740303541315345
8016,0.8018,6,0,6,675506,938,123049,3207,0.007429349892282347,0.7737032569360676
8017,0.8019,3,2,3,675508,936,123052,3204,0.007413509060955519,0.7739130434782608
8018,0.802,3,0,3,675508,936,123055,3201,0.007413509060955519,0.7737490935460478
8019,0.8021,4,1,4,675509,935,123059,3197,0.007405588645292105,0.7737173281703775
8020,0.8022,4,4,4,675513,931,123063,3193,0.007373906982638449,0.7742483026188167
8021,0.8023,4,0,4,675513,931,123067,3189,0.007373906982638449,0.7740291262135922
8022,0.8024,4,1,4,675514,930,123071,3185,0.007365986566975035,0.7739975698663426
8023,0.8025,3,0,3,675514,930,123074,3182,0.007365986566975035,0.7738326848249028
8024,0.8026,4,3,4,675517,927,123078,3178,0.007342225319984793,0.774177831912302
8025,0.8027,4,2,4,675519,925,123082,3174,0.007326384488657965,0.7743352037082215
8026,0.8028,8,4,8,675523,921,123090,3166,0.0072947028260043085,0.7746513334964522
8027,0.8029,4,2,4,675525,919,123094,3162,0.00727886199467748,0.7748100955648125
8028,0.803,1,1,1,675526,918,123095,3161,0.007270941579014066,0.7749448394214268
8029,0.8031,5,0,5,675526,918,123100,3156,0.007270941579014066,0.7746686303387335
8030,0.8032,7,2,7,675528,916,123107,3149,0.007255100747687239,0.7746617466174662
8031,0.8033,3,1,3,675529,915,123110,3146,0.007247180332023825,0.7746860379216942
8032,0.8034,4,1,4,675530,914,123114,3142,0.007239259916360411,0.77465483234714
8033,0.8035,2,1,2,675531,913,123116,3140,0.007231339500696997,0.7747347643720701
8034,0.8036,2,1,2,675532,912,123118,3138,0.007223419085033583,0.7748148148148148
8035,0.8037,1,3,1,675535,909,123119,3137,0.00719965783804334,0.7753336628769155
8036,0.8038,5,1,5,675536,908,123124,3132,0.007191737422379926,0.7752475247524753
8037,0.8039,9,3,9,675539,905,123133,3123,0.007167976175389684,0.7753227408142999
8038,0.804,5,2,5,675541,903,123138,3118,0.007152135344062857,0.7754289977617508
8039,0.8041,2,0,2,675541,903,123140,3116,0.007152135344062857,0.7753172430952974
8040,0.8042,4,0,4,675541,903,123144,3112,0.007152135344062857,0.7750933997509339
8041,0.8043,4,1,4,675542,902,123148,3108,0.007144214928399443,0.7750623441396509
8042,0.8044,2,3,2,675545,899,123150,3106,0.0071204536814092004,0.7755305867665419
8043,0.8045,4,2,4,675547,897,123154,3102,0.007104612850082372,0.7756939234808702
8044,0.8046,5,1,5,675548,896,123159,3097,0.007096692434418958,0.7756073127973955
8045,0.8047,4,1,4,675549,895,123163,3093,0.007088772018755544,0.7755767301905717
8046,0.8048,6,1,6,675550,894,123169,3087,0.00708085160309213,0.7754333082140166
8047,0.8049,5,2,5,675552,892,123174,3082,0.007065010771765302,0.7755410166079517
8048,0.805,4,0,4,675552,892,123178,3078,0.007065010771765302,0.7753148614609572
8049,0.8051,1,3,1,675555,889,123179,3077,0.0070412495247750605,0.775844679778114
8050,0.8052,2,1,2,675556,888,123181,3075,0.007033329109111646,0.7759273277819834
8051,0.8053,2,0,2,675556,888,123183,3073,0.007033329109111646,0.7758141883362787
8052,0.8054,7,2,7,675558,886,123190,3066,0.007017488277784818,0.7758097165991903
8053,0.8055,3,0,3,675558,886,123193,3063,0.007017488277784818,0.7756394023803495
8054,0.8056,4,0,4,675558,886,123197,3059,0.007017488277784818,0.7754119138149557
8055,0.8057,3,2,3,675560,884,123200,3056,0.00700164744645799,0.7756345177664975
8056,0.8058,2,1,2,675561,883,123202,3054,0.006993727030794576,0.7757175514351029
8057,0.8059,5,1,5,675562,882,123207,3049,0.006985806615131162,0.7756296107860595
8058,0.806,5,2,5,675564,880,123212,3044,0.006969965783804334,0.7757390417940877
8059,0.8061,11,3,11,675567,877,123223,3033,0.006946204536814092,0.7757033248081842
8060,0.8062,3,1,3,675568,876,123226,3030,0.006938284121150678,0.7757296466973886
8061,0.8063,4,0,4,675568,876,123230,3026,0.006938284121150678,0.7754997437211686
8062,0.8064,9,1,9,675569,875,123239,3017,0.006930363705487264,0.7751798561151079
8063,0.8065,8,1,8,675570,874,123247,3009,0.00692244328982385,0.7749163018284831
8064,0.8066,3,0,3,675570,874,123250,3006,0.00692244328982385,0.7747422680412371
8065,0.8067,5,1,5,675571,873,123255,3001,0.006914522874160436,0.7746515229736706
8066,0.8068,2,3,2,675574,870,123257,2999,0.006890761627170194,0.775135693977772
8067,0.8069,4,0,4,675574,870,123261,2995,0.006890761627170194,0.7749029754204398
8068,0.807,4,1,4,675575,869,123265,2991,0.00688284121150678,0.7748704663212436
8069,0.8071,2,3,2,675578,866,123267,2989,0.0068590799645165375,0.7753566796368353
8070,0.8072,4,1,4,675579,865,123271,2985,0.0068511595488531234,0.7753246753246753
8071,0.8073,6,1,6,675580,864,123277,2979,0.00684323913318971,0.775175644028103
8072,0.8074,0,2,0,675582,862,123277,2979,0.006827398301862882,0.7755792762301484
8073,0.8075,6,4,6,675586,858,123283,2973,0.006795716639209226,0.7760375880971025
8074,0.8076,2,0,2,675586,858,123285,2971,0.006795716639209226,0.7759206059023244
8075,0.8077,2,2,2,675588,856,123287,2969,0.006779875807882398,0.7762091503267974
8076,0.8078,4,3,4,675591,853,123291,2965,0.006756114560892155,0.7765845992666317
8077,0.8079,3,1,3,675592,852,123294,2962,0.006748194145228741,0.7766124803356057
8078,0.808,5,1,5,675593,851,123299,2957,0.006740273729565327,0.7765231092436975
8079,0.8081,3,3,3,675596,848,123302,2954,0.006716512482575086,0.7769594950026302
8080,0.8082,4,0,4,675596,848,123306,2950,0.006716512482575086,0.7767245918904687
8081,0.8083,4,0,4,675596,848,123310,2946,0.006716512482575086,0.7764891934633632
8082,0.8084,3,1,3,675597,847,123313,2943,0.006708592066911672,0.7765171503957784
8083,0.8085,5,1,5,675598,846,123318,2938,0.006700671651248258,0.7764270613107822
8084,0.8086,2,0,2,675598,846,123320,2936,0.006700671651248258,0.7763088313061872
8085,0.8087,7,4,7,675602,842,123327,2929,0.006668989988594601,0.7767170511800583
8086,0.8088,9,1,9,675603,841,123336,2920,0.006661069572931187,0.776389258176017
8087,0.8089,7,0,7,675603,841,123343,2913,0.006661069572931187,0.7759722962173682
8088,0.809,2,2,2,675605,839,123345,2911,0.006645228741604359,0.7762666666666667
8089,0.8091,6,0,6,675605,839,123351,2905,0.006645228741604359,0.7759081196581197
8090,0.8092,2,2,2,675607,837,123353,2903,0.006629387910277532,0.7762032085561498
8091,0.8093,3,2,3,675609,835,123356,2900,0.006613547078950704,0.7764390896921017
8092,0.8094,5,0,5,675609,835,123361,2895,0.006613547078950704,0.7761394101876675
8093,0.8095,2,2,2,675611,833,123363,2893,0.0065977062476238755,0.7764358561460011
8094,0.8096,4,5,4,675616,828,123367,2889,0.006558104169306805,0.7772397094430993
8095,0.8097,4,2,4,675618,826,123371,2885,0.006542263337979977,0.7774184855834007
8096,0.8098,5,2,5,675620,824,123376,2880,0.006526422506653149,0.7775377969762419
8097,0.8099,1,1,1,675621,823,123377,2879,0.0065185020909897355,0.777687736358725
8098,0.81,7,1,7,675622,822,123384,2872,0.0065105816753263214,0.7774769897130482
8099,0.8101,2,1,2,675623,821,123386,2870,0.006502661259662907,0.7775670549986453
8100,0.8102,6,0,6,675623,821,123392,2864,0.006502661259662907,0.7772048846675712
8101,0.8103,2,0,2,675623,821,123394,2862,0.006502661259662907,0.7770838989953842
8102,0.8104,6,1,6,675624,820,123400,2856,0.006494740843999493,0.7769314472252449
8103,0.8105,4,2,4,675626,818,123404,2852,0.006478900012672665,0.7771117166212534
8104,0.8106,4,1,4,675627,817,123408,2848,0.006470979597009251,0.7770804911323329
8105,0.8107,6,0,6,675627,817,123414,2842,0.006470979597009251,0.7767149494397376
8106,0.8108,6,1,6,675628,816,123420,2836,0.006463059181345837,0.7765607886089814
8107,0.8109,5,0,5,675628,816,123425,2831,0.006463059181345837,0.7762544557170277
8108,0.811,4,2,4,675630,814,123429,2827,0.006447218350019009,0.7764350453172205
8109,0.8111,2,1,2,675631,813,123431,2825,0.006439297934355595,0.7765255634964267
8110,0.8112,2,1,2,675632,812,123433,2823,0.006431377518692181,0.7766162310866574
8111,0.8113,0,2,0,675634,810,123433,2823,0.006415536687365353,0.7770437654830719
8112,0.8114,3,3,3,675637,807,123436,2820,0.006391775440375111,0.7775020678246485
8113,0.8115,3,1,3,675638,806,123439,2817,0.006383855024711697,0.7775324316864477
8114,0.8116,3,1,3,675639,805,123442,2814,0.006375934609048283,0.7775628626692457
8115,0.8117,7,1,7,675640,804,123449,2807,0.006368014193384869,0.7773469952921629
8116,0.8118,6,2,6,675642,802,123455,2801,0.006352173362058041,0.7774077157923952
8117,0.8119,5,2,5,675644,800,123460,2796,0.0063363325307312125,0.7775305895439377
8118,0.812,4,1,4,675645,799,123464,2792,0.0063284121150677984,0.7774993038150932
8119,0.8121,5,0,5,675645,799,123469,2787,0.0063284121150677984,0.7771890686001115
8120,0.8122,1,1,1,675646,798,123470,2786,0.006320491699404384,0.77734375
8121,0.8123,5,3,5,675649,795,123475,2781,0.006296730452414143,0.7776845637583892
8122,0.8124,2,1,2,675650,794,123477,2779,0.006288810036750729,0.7777777777777778
8123,0.8125,3,4,3,675654,790,123480,2776,0.006257128374097073,0.7784632641615256
8124,0.8126,6,3,6,675657,787,123486,2770,0.00623336712710683,0.778746134382907
8125,0.8127,3,1,3,675658,786,123489,2767,0.006225446711443416,0.7787784970447509
8126,0.8128,4,3,4,675661,783,123493,2763,0.006201685464453175,0.7791878172588832
8127,0.8129,3,1,3,675662,782,123496,2760,0.006193765048789761,0.7792207792207793
8128,0.813,8,0,8,675662,782,123504,2752,0.006193765048789761,0.7787209960384833
8129,0.8131,3,0,3,675662,782,123507,2749,0.006193765048789761,0.7785329934862645
8130,0.8132,3,1,3,675663,781,123510,2746,0.006185844633126347,0.7785653529912107
8131,0.8133,1,1,1,675664,780,123511,2745,0.006177924217462933,0.7787234042553192
8132,0.8134,2,4,2,675668,776,123513,2743,0.006146242554809276,0.7794828076157999
8133,0.8135,3,1,3,675669,775,123516,2740,0.006138322139145862,0.7795163584637269
8134,0.8136,6,1,6,675670,774,123522,2734,0.006130401723482448,0.7793614595210946
8135,0.8137,7,2,7,675672,772,123529,2727,0.00611456089215562,0.7793655330094312
8136,0.8138,6,1,6,675673,771,123535,2721,0.006106640476492206,0.7792096219931272
8137,0.8139,3,1,3,675674,770,123538,2718,0.006098720060828793,0.779243119266055
8138,0.814,6,2,6,675676,768,123544,2712,0.0060828792295019645,0.7793103448275862
8139,0.8141,4,2,4,675678,766,123548,2708,0.006067038398175136,0.7795048934945308
8140,0.8142,3,1,3,675679,765,123551,2705,0.006059117982511722,0.7795389048991355
8141,0.8143,4,2,4,675681,763,123555,2701,0.006043277151184894,0.7797344110854504
8142,0.8144,7,1,7,675682,762,123562,2694,0.00603535673552148,0.7795138888888888
8143,0.8145,4,4,4,675686,758,123566,2690,0.006003675072867824,0.7801624129930395
8144,0.8146,5,1,5,675687,757,123571,2685,0.00599575465720441,0.7800697269029634
8145,0.8147,5,0,5,675687,757,123576,2680,0.00599575465720441,0.7797497817864416
8146,0.8148,3,5,3,675692,752,123579,2677,0.00595615257888734,0.7806940799066784
8147,0.8149,2,2,2,675694,750,123581,2675,0.005940311747560512,0.781021897810219
8148,0.815,11,1,11,675695,749,123592,2664,0.005932391331897098,0.7805449750952241
8149,0.8151,2,1,2,675696,748,123594,2662,0.005924470916233684,0.7806451612903226
8150,0.8152,4,2,4,675698,746,123598,2658,0.005908630084906856,0.7808460634547592
8151,0.8153,8,4,8,675702,742,123606,2650,0.0058769484222532,0.78125
8152,0.8154,1,1,1,675703,741,123607,2649,0.005869028006589786,0.7814159292035399
8153,0.8155,4,1,4,675704,740,123611,2645,0.005861107590926372,0.7813884785819794
8154,0.8156,5,2,5,675706,738,123616,2640,0.005845266759599544,0.7815275310834814
8155,0.8157,4,1,4,675707,737,123620,2636,0.00583734634393613,0.7815001482359917
8156,0.8158,1,1,1,675708,736,123621,2635,0.005829425928272716,0.7816671610797983
8157,0.8159,5,4,5,675712,732,123626,2630,0.005797744265619059,0.7822724568709102
8158,0.816,6,2,6,675714,730,123632,2624,0.005781903434292232,0.7823494335122242
8159,0.8161,7,0,7,675714,730,123639,2617,0.005781903434292232,0.7818942336420676
8160,0.8162,3,3,3,675717,727,123642,2614,0.00575814218730199,0.7824004788985334
8161,0.8163,3,0,3,675717,727,123645,2611,0.00575814218730199,0.7822049131216298
8162,0.8164,1,2,1,675719,725,123646,2610,0.005742301355975162,0.782608695652174
8163,0.8165,1,1,1,675720,724,123647,2609,0.005734380940311748,0.7827782778277828
8164,0.8166,4,1,4,675721,723,123651,2605,0.0057264605246483335,0.7827524038461539
8165,0.8167,4,0,4,675721,723,123655,2601,0.0057264605246483335,0.7824909747292419
8166,0.8168,6,1,6,675722,722,123661,2595,0.0057185401089849194,0.7823334338257462
8167,0.8169,0,3,0,675725,719,123661,2595,0.005694778861994677,0.7830416415208208
8168,0.817,4,3,4,675728,716,123665,2591,0.005671017615004436,0.7834895675839129
8169,0.8171,3,0,3,675728,716,123668,2588,0.005671017615004436,0.7832929782082324
8170,0.8172,4,1,4,675729,715,123672,2584,0.005663097199341022,0.7832676568657169
8171,0.8173,3,2,3,675731,713,123675,2581,0.005647256368014194,0.7835458409228901
8172,0.8174,2,1,2,675732,712,123677,2579,0.0056393359523507795,0.7836523852932239
8173,0.8175,7,4,7,675736,708,123684,2572,0.005607654289697123,0.7841463414634147
8174,0.8176,3,1,3,675737,707,123687,2569,0.005599733874033709,0.7841880341880342
8175,0.8177,4,3,4,675740,704,123691,2565,0.005575972627043467,0.7846436219027225
8176,0.8178,4,0,4,675740,704,123695,2561,0.005575972627043467,0.7843797856049005
8177,0.8179,1,0,1,675740,704,123696,2560,0.005575972627043467,0.7843137254901961
8178,0.818,2,0,2,675740,704,123698,2558,0.005575972627043467,0.7841814837522992
8179,0.8181,2,1,2,675741,703,123700,2556,0.005568052211380054,0.7842896594047254
8180,0.8182,3,1,3,675742,702,123703,2553,0.0055601317957166396,0.784331797235023
8181,0.8183,1,1,1,675743,701,123704,2552,0.0055522113800532255,0.784506609283738
8182,0.8184,5,0,5,675743,701,123709,2547,0.0055522113800532255,0.7841748768472906
8183,0.8185,4,2,4,675745,699,123713,2543,0.005536370548726397,0.7843923504009871
8184,0.8186,6,3,6,675748,696,123719,2537,0.005512609301736155,0.7847200742344571
8185,0.8187,6,0,6,675748,696,123725,2531,0.005512609301736155,0.7843198016733809
8186,0.8188,3,2,3,675750,694,123728,2528,0.005496768470409327,0.7846058348851644
8187,0.8189,3,2,3,675752,692,123731,2525,0.005480927639082499,0.7848927572272303
8188,0.819,3,1,3,675753,691,123734,2522,0.005473007223419085,0.7849361967009025
8189,0.8191,3,2,3,675755,689,123737,2519,0.005457166392092257,0.7852244389027432
8190,0.8192,3,1,3,675756,688,123740,2516,0.005449245976428843,0.7852684144818977
8191,0.8193,3,1,3,675757,687,123743,2513,0.005441325560765429,0.7853125
8192,0.8194,6,1,6,675758,686,123749,2507,0.005433405145102015,0.7851550266207329
8193,0.8195,3,1,3,675759,685,123752,2504,0.005425484729438601,0.7851991219818125
8194,0.8196,3,1,3,675760,684,123755,2501,0.005417564313775187,0.7852433281004709
8195,0.8197,2,4,2,675764,680,123757,2499,0.005385882651121531,0.786096256684492
8196,0.8198,7,2,7,675766,678,123764,2492,0.0053700418197947025,0.7861198738170347
8197,0.8199,7,3,7,675769,675,123771,2485,0.005346280572804461,0.7863924050632911
8198,0.82,5,1,5,675770,674,123776,2480,0.005338360157141047,0.7863031071655041
8199,0.8201,3,2,3,675772,672,123779,2477,0.005322519325814219,0.7865989202921563
8200,0.8202,3,4,3,675776,668,123782,2474,0.0052908376631605625,0.7873965626989179
8201,0.8203,3,0,3,675776,668,123785,2471,0.0052908376631605625,0.7871933736858873
8202,0.8204,3,1,3,675777,667,123788,2468,0.0052829172474971485,0.7872408293460925
8203,0.8206,7,1,7,675778,666,123795,2461,0.005274996831833734,0.7870163095618804
8204,0.8207,3,3,3,675781,663,123798,2458,0.005251235584843493,0.787568087151554
8205,0.8208,3,1,3,675782,662,123801,2455,0.005243315169180079,0.7876162977221688
8206,0.8209,6,0,6,675782,662,123807,2449,0.005243315169180079,0.7872066859530698
8207,0.821,9,0,9,675782,662,123816,2440,0.005243315169180079,0.7865892972275951
8208,0.8211,5,3,5,675785,659,123821,2435,0.005219553922189837,0.7870071105365223
8209,0.8212,3,0,3,675785,659,123824,2432,0.005219553922189837,0.7868003882238758
8210,0.8213,7,0,7,675785,659,123831,2425,0.005219553922189837,0.7863164721141375
8211,0.8214,2,0,2,675785,659,123833,2423,0.005219553922189837,0.7861778066190785
8212,0.8215,3,0,3,675785,659,123836,2420,0.005219553922189837,0.78596947060734
8213,0.8216,5,0,5,675785,659,123841,2415,0.005219553922189837,0.7856213402732596
8214,0.8217,6,2,6,675787,657,123847,2409,0.0052037130908630085,0.7857142857142857
8215,0.8218,3,4,3,675791,653,123850,2406,0.005172031428209352,0.7865315462569468
8216,0.8219,3,0,3,675791,653,123853,2403,0.005172031428209352,0.7863219895287958
8217,0.822,5,0,5,675791,653,123858,2398,0.005172031428209352,0.7859718125204851
8218,0.8221,3,1,3,675792,652,123861,2395,0.005164111012545938,0.7860190351165081
8219,0.8222,4,1,4,675793,651,123865,2391,0.005156190596882524,0.7859960552268245
8220,0.8223,4,0,4,675793,651,123869,2387,0.005156190596882524,0.7857142857142857
8221,0.8224,6,1,6,675794,650,123875,2381,0.00514827018121911,0.7855493236555592
8222,0.8225,2,0,2,675794,650,123877,2379,0.00514827018121911,0.7854077253218884
8223,0.8226,3,0,3,675794,650,123880,2376,0.00514827018121911,0.7851949768671513
8224,0.8227,4,0,4,675794,650,123884,2372,0.00514827018121911,0.784910655195235
8225,0.8228,5,1,5,675795,649,123889,2367,0.005140349765555697,0.7848143236074271
8226,0.8229,3,2,3,675797,647,123892,2364,0.005124508934228869,0.7851212221853205
8227,0.823,6,2,6,675799,645,123898,2358,0.00510866810290204,0.7852147852147852
8228,0.8231,3,2,3,675801,643,123901,2355,0.005092827271575212,0.78552368245497
8229,0.8232,5,2,5,675803,641,123906,2350,0.005076986440248384,0.7856904045469743
8230,0.8233,1,1,1,675804,640,123907,2349,0.00506906602458497,0.7858815657410505
8231,0.8234,6,0,6,675804,640,123913,2343,0.00506906602458497,0.7854508883674154
8232,0.8235,3,3,3,675807,637,123916,2340,0.005045304777594728,0.7860262008733624
8233,0.8236,2,3,2,675810,634,123918,2338,0.005021543530604486,0.7866756393001346
8234,0.8237,2,2,2,675812,632,123920,2336,0.005005702699277658,0.7870619946091644
8235,0.8238,2,2,2,675814,630,123922,2334,0.00498986186795083,0.7874493927125507
8236,0.8239,5,1,5,675815,629,123927,2329,0.004981941452287416,0.7873563218390804
8237,0.824,3,1,3,675816,628,123930,2326,0.004974021036624002,0.7874069058903183
8238,0.8241,5,1,5,675817,627,123935,2321,0.004966100620960588,0.7873134328358209
8239,0.8242,4,0,4,675817,627,123939,2317,0.004966100620960588,0.7870244565217391
8240,0.8243,2,2,2,675819,625,123941,2315,0.00495025978963376,0.7874149659863946
8241,0.8244,5,3,5,675822,622,123946,2310,0.004926498542643518,0.7878581173260573
8242,0.8245,2,0,2,675822,622,123948,2308,0.004926498542643518,0.7877133105802048
8243,0.8246,3,1,3,675823,621,123951,2305,0.004918578126980104,0.7877648667122351
8244,0.8247,4,1,4,675824,620,123955,2301,0.00491065771131669,0.7877439233139336
8245,0.8248,3,2,3,675826,618,123958,2298,0.004894816879989862,0.7880658436213992
8246,0.8249,5,1,5,675827,617,123963,2293,0.004886896464326448,0.7879725085910653
8247,0.825,5,1,5,675828,616,123968,2288,0.004878976048663034,0.7878787878787878
8248,0.8251,2,1,2,675829,615,123970,2286,0.00487105563299962,0.7880041365046536
8249,0.8252,2,1,2,675830,614,123972,2284,0.004863135217336206,0.7881297446514838
8250,0.8253,3,0,3,675830,614,123975,2281,0.004863135217336206,0.7879101899827289
8251,0.8254,3,1,3,675831,613,123978,2278,0.004855214801672792,0.7879626426841924
8252,0.8255,2,0,2,675831,613,123980,2276,0.004855214801672792,0.787815853236414
8253,0.8256,6,0,6,675831,613,123986,2270,0.004855214801672792,0.7873742629205689
8254,0.8257,3,3,3,675834,610,123989,2267,0.004831453554682549,0.7879735835940216
8255,0.8258,3,2,3,675836,608,123992,2264,0.004815612723355722,0.7883008356545961
8256,0.8259,5,0,5,675836,608,123997,2259,0.004815612723355722,0.7879316358562958
8257,0.826,3,1,3,675837,607,124000,2256,0.004807692307692308,0.7879846315054139
8258,0.8261,3,0,3,675837,607,124003,2253,0.004807692307692308,0.7877622377622377
8259,0.8262,3,3,3,675840,604,124006,2250,0.004783931060702066,0.7883672039243167
8260,0.8263,3,2,3,675842,602,124009,2247,0.0047680902293752376,0.7886977886977887
8261,0.8264,3,3,3,675845,599,124012,2244,0.004744328982384995,0.7893070699964826
8262,0.8265,6,1,6,675846,598,124018,2238,0.004736408566721581,0.7891396332863188
8263,0.8266,6,0,6,675846,598,124024,2232,0.004736408566721581,0.7886925795053004
8264,0.8267,4,1,4,675847,597,124028,2228,0.004728488151058167,0.7886725663716814
8265,0.8268,4,2,4,675849,595,124032,2224,0.00471264731973134,0.7889322454771196
8266,0.8269,2,1,2,675850,594,124034,2222,0.004704726904067926,0.7890625
8267,0.827,6,2,6,675852,592,124040,2216,0.004688886072741098,0.7891737891737892
8268,0.8271,4,1,4,675853,591,124044,2212,0.0046809656570776835,0.789154477345701
8269,0.8272,5,0,5,675853,591,124049,2207,0.0046809656570776835,0.7887776983559686
8270,0.8273,5,0,5,675853,591,124054,2202,0.0046809656570776835,0.7883995703544576
8271,0.8274,5,1,5,675854,590,124059,2197,0.0046730452414142695,0.788302834589164
8272,0.8275,4,1,4,675855,589,124063,2193,0.004665124825750855,0.7882818116462976
8273,0.8276,4,3,4,675858,586,124067,2189,0.004641363578760613,0.7888288288288289
8274,0.8277,2,1,2,675859,585,124069,2187,0.004633443163097199,0.788961038961039
8275,0.8278,2,2,2,675861,583,124071,2185,0.004617602331770371,0.789378612716763
8276,0.8279,5,2,5,675863,581,124076,2180,0.004601761500443544,0.7895689967403114
8277,0.828,3,2,3,675865,579,124079,2177,0.0045859206691167154,0.7899129172714079
8278,0.8281,0,2,0,675867,577,124079,2177,0.004570079837789887,0.7904865649963689
8279,0.8282,3,4,3,675871,573,124082,2174,0.004538398175136231,0.7914088096104842
8280,0.8283,5,0,5,675871,573,124087,2169,0.004538398175136231,0.7910284463894968
8281,0.8284,9,0,9,675871,573,124096,2160,0.004538398175136231,0.7903402854006586
8282,0.8285,4,3,4,675874,570,124100,2156,0.004514636928145989,0.7909024211298606
8283,0.8286,5,3,5,675877,567,124105,2151,0.004490875681155747,0.7913907284768212
8284,0.8287,5,1,5,675878,566,124110,2146,0.004482955265492333,0.7912979351032449
8285,0.8288,2,0,2,675878,566,124112,2144,0.004482955265492333,0.7911439114391144
8286,0.8289,5,0,5,675878,566,124117,2139,0.004482955265492333,0.7907578558225509
8287,0.829,5,0,5,675878,566,124122,2134,0.004482955265492333,0.7903703703703704
8288,0.8291,3,2,3,675880,564,124125,2131,0.004467114434165505,0.7907235621521336
8289,0.8292,3,1,3,675881,563,124128,2128,0.004459194018502091,0.7907840951319213
8290,0.8293,3,0,3,675881,563,124131,2125,0.004459194018502091,0.7905505952380952
8291,0.8294,5,2,5,675883,561,124136,2120,0.004443353187175263,0.7907497202536367
8292,0.8295,4,1,4,675884,560,124140,2116,0.004435432771511849,0.7907324364723468
8293,0.8296,8,2,8,675886,558,124148,2108,0.004419591940185021,0.7906976744186046
8294,0.8297,4,2,4,675888,556,124152,2104,0.0044037511088581924,0.7909774436090226
8295,0.8298,5,1,5,675889,555,124157,2099,0.004395830693194779,0.7908816880180859
8296,0.8299,6,0,6,675889,555,124163,2093,0.004395830693194779,0.7904078549848943
8297,0.83,3,2,3,675891,553,124166,2090,0.004379989861867951,0.7907680665909951
8298,0.8301,1,3,1,675894,550,124167,2089,0.004356228614877709,0.7915877226222053
8299,0.8302,5,1,5,675895,549,124172,2084,0.004348308199214295,0.7914925939992404
8300,0.8303,5,0,5,675895,549,124177,2079,0.004348308199214295,0.791095890410959
8301,0.8304,5,1,5,675896,548,124182,2074,0.004340387783550881,0.7909992372234935
8302,0.8305,6,2,6,675898,546,124188,2068,0.0043245469522240525,0.791124713083397
8303,0.8306,3,0,3,675898,546,124191,2065,0.0043245469522240525,0.7908847184986595
8304,0.8307,4,3,4,675901,543,124195,2061,0.00430078570523381,0.7914746543778802
8305,0.8308,5,1,5,675902,542,124200,2056,0.004292865289570397,0.7913779830638953
8306,0.8309,4,1,4,675903,541,124204,2052,0.004284944873906983,0.7913613575009641
8307,0.831,3,0,3,675903,541,124207,2049,0.004284944873906983,0.7911196911196912
8308,0.8311,4,0,4,675903,541,124211,2045,0.004284944873906983,0.7907965970610982
8309,0.8312,4,0,4,675903,541,124215,2041,0.004284944873906983,0.7904725019364833
8310,0.8313,3,2,3,675905,539,124218,2038,0.004269104042580155,0.7908420644159876
8311,0.8314,3,0,3,675905,539,124221,2035,0.004269104042580155,0.7905982905982906
8312,0.8315,3,1,3,675906,538,124224,2032,0.004261183626916741,0.7906614785992218
8313,0.8316,5,1,5,675907,537,124229,2027,0.004253263211253327,0.7905616224648986
8314,0.8317,1,0,1,675907,537,124230,2026,0.004253263211253327,0.7904799063597346
8315,0.8318,3,0,3,675907,537,124233,2023,0.004253263211253327,0.790234375
8316,0.8319,2,2,2,675909,535,124235,2021,0.0042374223799264985,0.7906885758998435
8317,0.832,2,0,2,675909,535,124237,2019,0.0042374223799264985,0.7905246671887236
8318,0.8321,1,2,1,675911,533,124238,2018,0.00422158154859967,0.791062328498628
8319,0.8322,3,0,3,675911,533,124241,2015,0.00422158154859967,0.7908163265306123
8320,0.8323,5,0,5,675911,533,124246,2010,0.00422158154859967,0.7904050334250885
8321,0.8324,1,1,1,675912,532,124247,2009,0.004213661132936256,0.790633608815427
8322,0.8325,5,2,5,675914,530,124252,2004,0.004197820301609428,0.7908445146014207
8323,0.8326,2,1,2,675915,529,124254,2002,0.004189899885946015,0.7909917028842355
8324,0.8327,7,2,7,675917,527,124261,1995,0.004174059054619187,0.7910388580491673
8325,0.8328,2,0,2,675917,527,124263,1993,0.004174059054619187,0.7908730158730158
8326,0.8329,9,2,9,675919,525,124272,1984,0.0041582182232923585,0.7907532881626146
8327,0.833,1,2,1,675921,523,124273,1983,0.00414237739196553,0.7913008778930567
8328,0.8331,3,1,3,675922,522,124276,1980,0.004134456976302116,0.7913669064748201
8329,0.8332,5,2,5,675924,520,124281,1975,0.004118616144975288,0.7915831663326653
8330,0.8333,5,1,5,675925,519,124286,1970,0.004110695729311874,0.7914825231016472
8331,0.8334,5,1,5,675926,518,124291,1965,0.00410277531364846,0.7913813934756343
8332,0.8335,3,0,3,675926,518,124294,1962,0.00410277531364846,0.7911290322580645
8333,0.8336,3,2,3,675928,516,124297,1959,0.004086934482321632,0.7915151515151515
8334,0.8337,2,0,2,675928,516,124299,1957,0.004086934482321632,0.7913465426607359
8335,0.8338,5,1,5,675929,515,124304,1952,0.004079014066658219,0.791244426428861
8336,0.8339,2,2,2,675931,513,124306,1950,0.0040631732353313904,0.7917174177831913
8337,0.834,5,2,5,675933,511,124311,1945,0.004047332404004562,0.7919381107491856
8338,0.8341,3,0,3,675933,511,124314,1942,0.004047332404004562,0.7916836526701998
8339,0.8342,3,0,3,675933,511,124317,1939,0.004047332404004562,0.7914285714285715
8340,0.8343,5,4,5,675937,507,124322,1934,0.004015650741350906,0.7922982384268742
8341,0.8344,5,0,5,675937,507,124327,1929,0.004015650741350906,0.791871921182266
8342,0.8345,5,2,5,675939,505,124332,1924,0.003999809910024078,0.7920955125566077
8343,0.8346,4,2,4,675941,503,124336,1920,0.00398396907869725,0.7924061081304168
8344,0.8347,2,1,2,675942,502,124338,1918,0.003976048663033836,0.7925619834710744
8345,0.8348,4,0,4,675942,502,124342,1914,0.003976048663033836,0.7922185430463576
8346,0.8349,2,0,2,675942,502,124344,1912,0.003976048663033836,0.792046396023198
8347,0.835,5,1,5,675943,501,124349,1907,0.003968128247370422,0.7919435215946844
8348,0.8351,4,0,4,675943,501,124353,1903,0.003968128247370422,0.7915973377703827
8349,0.8352,3,0,3,675943,501,124356,1900,0.003968128247370422,0.7913369429404414
8350,0.8354,1,1,1,675944,500,124357,1899,0.003960207831707008,0.7915798249270529
8351,0.8355,2,1,2,675945,499,124359,1897,0.003952287416043594,0.7917362270450752
8352,0.8356,3,0,3,675945,499,124362,1894,0.003952287416043594,0.7914751358127873
8353,0.8357,7,0,7,675945,499,124369,1887,0.003952287416043594,0.7908633696563285
8354,0.8358,5,3,5,675948,496,124374,1882,0.003928526169053352,0.7914213624894869
8355,0.8359,7,3,7,675951,493,124381,1875,0.0039047649220631097,0.7918074324324325
8356,0.836,2,2,2,675953,491,124383,1873,0.003888924090736282,0.7923011844331641
8357,0.8361,2,3,2,675956,488,124385,1871,0.0038651628437460397,0.7931326833403984
8358,0.8362,5,0,5,675956,488,124390,1866,0.0038651628437460397,0.7926932880203909
8359,0.8363,6,1,6,675957,487,124396,1860,0.0038572424280826256,0.7925010651896037
8360,0.8364,5,0,5,675957,487,124401,1855,0.0038572424280826256,0.7920580700256191
8361,0.8365,2,0,2,675957,487,124403,1853,0.0038572424280826256,0.7918803418803418
8362,0.8366,1,1,1,675958,486,124404,1852,0.0038493220124192116,0.7921300256629598
8363,0.8367,5,1,5,675959,485,124409,1847,0.003841401596755798,0.7920240137221269
8364,0.8368,3,0,3,675959,485,124412,1844,0.003841401596755798,0.7917561185057965
8365,0.8369,3,0,3,675959,485,124415,1841,0.003841401596755798,0.791487532244196
8366,0.837,2,0,2,675959,485,124417,1839,0.003841401596755798,0.7913080895008606
8367,0.8371,7,0,7,675959,485,124424,1832,0.003841401596755798,0.790677600345274
8368,0.8372,4,1,4,675960,484,124428,1828,0.003833481181092384,0.7906574394463668
8369,0.8373,3,0,3,675960,484,124431,1825,0.003833481181092384,0.7903854482459939
8370,0.8374,6,2,6,675962,482,124437,1819,0.0038176403497655557,0.7905258583224685
8371,0.8375,3,0,3,675962,482,124440,1816,0.0038176403497655557,0.7902523933855526
8372,0.8376,7,0,7,675962,482,124447,1809,0.0038176403497655557,0.7896115233522479
8373,0.8377,3,0,3,675962,482,124450,1806,0.0038176403497655557,0.7893356643356644
8374,0.8378,2,3,2,675965,479,124452,1804,0.0037938791027753134,0.7901883486640385
8375,0.8379,2,0,2,675965,479,124454,1802,0.0037938791027753134,0.7900043840420868
8376,0.838,0,2,0,675967,477,124454,1802,0.0037780382714484857,0.7906976744186046
8377,0.8382,4,0,4,675967,477,124458,1798,0.0037780382714484857,0.7903296703296703
8378,0.8383,3,2,3,675969,475,124461,1795,0.0037621974401216575,0.7907488986784141
8379,0.8384,1,0,1,675969,475,124462,1794,0.0037621974401216575,0.7906566769501984
8380,0.8385,0,1,0,675970,474,124462,1794,0.0037542770244582435,0.791005291005291
8381,0.8386,1,0,1,675970,474,124463,1793,0.0037542770244582435,0.7909131010145567
8382,0.8387,4,1,4,675971,473,124467,1789,0.0037463566087948294,0.7908930150309461
8383,0.8388,1,0,1,675971,473,124468,1788,0.0037463566087948294,0.7908005307386112
8384,0.8389,3,1,3,675972,472,124471,1785,0.0037384361931314157,0.7908728400531679
8385,0.839,2,0,2,675972,472,124473,1783,0.0037384361931314157,0.7906873614190687
8386,0.8391,1,0,1,675972,472,124474,1782,0.0037384361931314157,0.7905944986690329
8387,0.8392,3,1,3,675973,471,124477,1779,0.0037305157774680017,0.7906666666666666
8388,0.8393,3,2,3,675975,469,124480,1776,0.0037146749461411735,0.7910913140311804
8389,0.8394,4,4,4,675979,465,124484,1772,0.0036829932834875176,0.7921323200715243
8390,0.8395,8,0,8,675979,465,124492,1764,0.0036829932834875176,0.7913862718707941
8391,0.8396,4,2,4,675981,463,124496,1760,0.0036671524521606894,0.7917228969860549
8392,0.8397,2,0,2,675981,463,124498,1758,0.0036671524521606894,0.7915353444394417
8393,0.8398,4,2,4,675983,461,124502,1754,0.0036513116208338613,0.7918735891647856
8394,0.8399,3,0,3,675983,461,124505,1751,0.0036513116208338613,0.7915913200723327
8395,0.84,3,3,3,675986,458,124508,1748,0.0036275503738436195,0.7923844061650045
8396,0.8401,2,1,2,675987,457,124510,1746,0.0036196299581802054,0.7925556059918293
8397,0.8402,1,0,1,675987,457,124511,1745,0.0036196299581802054,0.7924613987284287
8398,0.8403,4,0,4,675987,457,124515,1741,0.0036196299581802054,0.792083712465878
8399,0.8404,1,0,1,675987,457,124516,1740,0.0036196299581802054,0.7919890760127446
8400,0.8405,5,1,5,675988,456,124521,1735,0.0036117095425167913,0.7918758557736193
8401,0.8406,1,0,1,675988,456,124522,1734,0.0036117095425167913,0.7917808219178082
8402,0.8407,2,0,2,675988,456,124524,1732,0.0036117095425167913,0.7915904936014625
8403,0.8408,3,3,3,675991,453,124527,1729,0.003587948295526549,0.7923923006416131
8404,0.8409,7,0,7,675991,453,124534,1722,0.003587948295526549,0.7917241379310345
8405,0.841,9,0,9,675991,453,124543,1713,0.003587948295526549,0.7908587257617729
8406,0.8411,4,0,4,675991,453,124547,1709,0.003587948295526549,0.7904717853839038
8407,0.8412,1,0,1,675991,453,124548,1708,0.003587948295526549,0.7903748264692272
8408,0.8413,4,1,4,675992,452,124552,1704,0.0035800278798631354,0.7903525046382189
8409,0.8414,5,0,5,675992,452,124557,1699,0.0035800278798631354,0.7898651789865179
8410,0.8415,1,1,1,675993,451,124558,1698,0.0035721074641997213,0.790134946486738
8411,0.8416,2,0,2,675993,451,124560,1696,0.0035721074641997213,0.7899394503959013
8412,0.8417,2,0,2,675993,451,124562,1694,0.0035721074641997213,0.7897435897435897
8413,0.8418,3,2,3,675995,449,124565,1691,0.003556266632872893,0.7901869158878505
8414,0.8419,6,1,6,675996,448,124571,1685,0.003548346217209479,0.7899671823722456
8415,0.842,2,0,2,675996,448,124573,1683,0.003548346217209479,0.7897700610042234
8416,0.8421,2,1,2,675997,447,124575,1681,0.003540425801546065,0.7899436090225563
8417,0.8422,1,1,1,675998,446,124576,1680,0.003532505385882651,0.7902163687676388
8418,0.8423,1,1,1,675999,445,124577,1679,0.0035245849702192373,0.7904896421845574
8419,0.8424,2,2,2,676001,443,124579,1677,0.003508744138892409,0.7910377358490566
8420,0.8425,4,3,4,676004,440,124583,1673,0.003484982891902167,0.7917652626597255
8421,0.8426,5,0,5,676004,440,124588,1668,0.003484982891902167,0.7912713472485768
8422,0.8427,5,1,5,676005,439,124593,1663,0.003477062476238753,0.791151284490961
8423,0.8428,5,3,5,676008,436,124598,1658,0.003453301229248511,0.7917860553963706
8424,0.8429,5,0,5,676008,436,124603,1653,0.003453301229248511,0.791287697462901
8425,0.843,4,0,4,676008,436,124607,1649,0.003453301229248511,0.7908872901678657
8426,0.8431,2,0,2,676008,436,124609,1647,0.003453301229248511,0.7906865098415746
8427,0.8432,6,0,6,676008,436,124615,1641,0.003453301229248511,0.7900818488204141
8428,0.8433,5,1,5,676009,435,124620,1636,0.003445380813585097,0.7899565427329792
8429,0.8434,5,1,5,676010,434,124625,1631,0.003437460397921683,0.7898305084745763
8430,0.8435,2,0,2,676010,434,124627,1629,0.003437460397921683,0.7896267571497819
8431,0.8436,3,0,3,676010,434,124630,1626,0.003437460397921683,0.7893203883495146
8432,0.8437,6,2,6,676012,432,124636,1620,0.003421619566594855,0.7894736842105263
8433,0.8438,4,0,4,676012,432,124640,1616,0.003421619566594855,0.7890625
8434,0.8439,3,1,3,676013,431,124643,1613,0.003413699150931441,0.7891389432485323
8435,0.844,5,4,5,676017,427,124648,1608,0.0033820174882777847,0.7901719901719901
8436,0.8441,5,0,5,676017,427,124653,1603,0.0033820174882777847,0.7896551724137931
8437,0.8442,8,2,8,676019,425,124661,1595,0.003366176656950957,0.7896039603960396
8438,0.8443,2,2,2,676021,423,124663,1593,0.003350335825624129,0.7901785714285714
8439,0.8444,3,2,3,676023,421,124666,1590,0.0033344949942973007,0.7906514172053705
8440,0.8445,3,2,3,676025,419,124669,1587,0.0033186541629704725,0.7911266201395812
8441,0.8446,5,0,5,676025,419,124674,1582,0.0033186541629704725,0.7906046976511744
8442,0.8447,2,0,2,676025,419,124676,1580,0.0033186541629704725,0.7903951975987994
8443,0.8448,4,0,4,676025,419,124680,1576,0.0033186541629704725,0.7899749373433584
8444,0.8449,3,0,3,676025,419,124683,1573,0.0033186541629704725,0.7896586345381527
8445,0.845,3,0,3,676025,419,124686,1570,0.0033186541629704725,0.7893413775766717
8446,0.8451,1,1,1,676026,418,124687,1569,0.003310733747307059,0.7896326119778561
8447,0.8452,5,2,5,676028,416,124692,1564,0.0032948929159802307,0.7898989898989899
8448,0.8453,7,0,7,676028,416,124699,1557,0.0032948929159802307,0.7891535732387227
8449,0.8454,0,2,0,676030,414,124699,1557,0.0032790520846534025,0.7899543378995434
8450,0.8455,0,1,0,676031,413,124699,1557,0.0032711316689899884,0.7903553299492386
8451,0.8456,2,0,2,676031,413,124701,1555,0.0032711316689899884,0.7901422764227642
8452,0.8457,3,1,3,676032,412,124704,1552,0.0032632112533265744,0.790224032586558
8453,0.8458,2,1,2,676033,411,124706,1550,0.0032552908376631607,0.7904130545639979
8454,0.8459,5,2,5,676035,409,124711,1545,0.0032394500063363326,0.7906857727737974
8455,0.846,4,2,4,676037,407,124715,1541,0.0032236091750095044,0.7910677618069816
8456,0.8461,2,0,2,676037,407,124717,1539,0.0032236091750095044,0.7908530318602262
8457,0.8462,1,0,1,676037,407,124718,1538,0.0032236091750095044,0.790745501285347
8458,0.8463,1,0,1,676037,407,124719,1537,0.0032236091750095044,0.7906378600823045
8459,0.8464,1,0,1,676037,407,124720,1536,0.0032236091750095044,0.7905301080802882
8460,0.8465,1,1,1,676038,406,124721,1535,0.0032156887593460903,0.7908294693456981
8461,0.8466,5,0,5,676038,406,124726,1530,0.0032156887593460903,0.7902892561983471
8462,0.8467,4,1,4,676039,405,124730,1526,0.0032077683436826767,0.7902641118591404
8463,0.8468,3,0,3,676039,405,124733,1523,0.0032077683436826767,0.7899377593360996
8464,0.8469,3,2,3,676041,403,124736,1520,0.0031919275123558485,0.7904316172646906
8465,0.847,1,1,1,676042,402,124737,1519,0.0031840070966924344,0.7907339927121291
8466,0.8471,1,1,1,676043,401,124738,1518,0.0031760866810290203,0.7910369984366857
8467,0.8472,4,0,4,676043,401,124742,1514,0.0031760866810290203,0.7906005221932115
8468,0.8473,4,0,4,676043,401,124746,1510,0.0031760866810290203,0.7901622187336473
8469,0.8474,2,2,2,676045,399,124748,1508,0.003160245849702192,0.7907708442579968
8470,0.8475,0,1,0,676046,398,124748,1508,0.0031523254340387785,0.7911857292759706
8471,0.8476,5,2,5,676048,396,124753,1503,0.0031364846027119504,0.7914691943127962
8472,0.8477,4,2,4,676050,394,124757,1499,0.003120643771385122,0.791864764923402
8473,0.8478,4,0,4,676050,394,124761,1495,0.003120643771385122,0.79142403388036
8474,0.8479,3,2,3,676052,392,124764,1492,0.003104802940058294,0.7919320594479831
8475,0.848,3,0,3,676052,392,124767,1489,0.003104802940058294,0.7916002126528442
8476,0.8481,2,2,2,676054,390,124769,1487,0.0030889621087314663,0.7922216302610549
8477,0.8482,3,2,3,676056,388,124772,1484,0.003073121277404638,0.7927350427350427
8478,0.8483,6,0,6,676056,388,124778,1478,0.003073121277404638,0.7920685959271169
8479,0.8484,4,1,4,676057,387,124782,1474,0.003065200861741224,0.7920472864051585
8480,0.8485,2,2,2,676059,385,124784,1472,0.0030493600304143964,0.7926763597199784
8481,0.8486,4,0,4,676059,385,124788,1468,0.0030493600304143964,0.7922288181327577
8482,0.8487,1,1,1,676060,384,124789,1467,0.0030414396147509823,0.7925445705024311
8483,0.8488,2,0,2,676060,384,124791,1465,0.0030414396147509823,0.7923201730665225
8484,0.8489,3,1,3,676061,383,124794,1462,0.003033519199087568,0.7924119241192412
8485,0.849,3,3,3,676064,380,124797,1459,0.003009757952097326,0.7933659597607395
8486,0.8491,2,1,2,676065,379,124799,1457,0.003001837536433912,0.7935729847494554
8487,0.8492,5,1,5,676066,378,124804,1452,0.0029939171207704982,0.7934426229508197
8488,0.8493,5,0,5,676066,378,124809,1447,0.0029939171207704982,0.7928767123287671
8489,0.8494,2,1,2,676067,377,124811,1445,0.002985996705107084,0.7930845225027442
8490,0.8495,4,2,4,676069,375,124815,1441,0.002970155873780256,0.7935022026431718
8491,0.8496,3,1,3,676070,374,124818,1438,0.002962235458116842,0.7935982339955849
8492,0.8497,2,1,2,676071,373,124820,1436,0.002954315042453428,0.7938087341072416
8493,0.8499,5,0,5,676071,373,124825,1431,0.002954315042453428,0.7932372505543237
8494,0.85,3,1,3,676072,372,124828,1428,0.0029463946267900137,0.7933333333333333
8495,0.8501,3,2,3,676074,370,124831,1425,0.002930553795463186,0.7938718662952646
8496,0.8502,2,3,2,676077,367,124833,1423,0.0029067925484729438,0.7949720670391062
8497,0.8503,2,1,2,676078,366,124835,1421,0.0028988721328095297,0.7951874650251819
8498,0.8504,5,0,5,676078,366,124840,1416,0.0028988721328095297,0.7946127946127947
8499,0.8505,1,0,1,676078,366,124841,1415,0.0028988721328095297,0.7944974733295901
8500,0.8507,4,1,4,676079,365,124845,1411,0.002890951717146116,0.7944819819819819
8501,0.8508,3,2,3,676081,363,124848,1408,0.002875110885819288,0.7950310559006211
8502,0.8509,5,0,5,676081,363,124853,1403,0.002875110885819288,0.7944507361268404
8503,0.851,2,1,2,676082,362,124855,1401,0.002867190470155874,0.7946681792399319
8504,0.8511,1,1,1,676083,361,124856,1400,0.0028592700544924597,0.7950028392958546
8505,0.8512,3,0,3,676083,361,124859,1397,0.0028592700544924597,0.7946530147895335
8506,0.8513,5,2,5,676085,359,124864,1392,0.0028434292231656316,0.7949743003997716
8507,0.8514,3,0,3,676085,359,124867,1389,0.0028434292231656316,0.7946224256292906
8508,0.8515,2,1,2,676086,358,124869,1387,0.002835508807502218,0.7948424068767909
8509,0.8516,2,0,2,676086,358,124871,1385,0.002835508807502218,0.7946069994262766
8510,0.8517,2,1,2,676087,357,124873,1383,0.002827588391838804,0.7948275862068965
8511,0.8518,5,0,5,676087,357,124878,1378,0.002827588391838804,0.7942363112391931
8512,0.8519,1,0,1,676087,357,124879,1377,0.002827588391838804,0.7941176470588235
8513,0.852,2,2,2,676089,355,124881,1375,0.0028117475605119757,0.7947976878612717
8514,0.8521,3,0,3,676089,355,124884,1372,0.0028117475605119757,0.7944412275622467
8515,0.8522,5,1,5,676090,354,124889,1367,0.0028038271448485616,0.7943056362579896
8516,0.8523,2,0,2,676090,354,124891,1365,0.0028038271448485616,0.794066317626527
8517,0.8524,4,1,4,676091,353,124895,1361,0.0027959067291851475,0.794049008168028
8518,0.8525,5,1,5,676092,352,124900,1356,0.0027879863135217334,0.7939110070257611
8519,0.8526,6,0,6,676092,352,124906,1350,0.0027879863135217334,0.7931844888366627
8520,0.8527,2,0,2,676092,352,124908,1348,0.0027879863135217334,0.7929411764705883
8521,0.8528,3,2,3,676094,350,124911,1345,0.0027721454821949057,0.7935103244837758
8522,0.8529,3,0,3,676094,350,124914,1342,0.0027721454821949057,0.793144208037825
8523,0.853,1,0,1,676094,350,124915,1341,0.0027721454821949057,0.7930218805440568
8524,0.8531,6,0,6,676094,350,124921,1335,0.0027721454821949057,0.7922848664688428
8525,0.8532,5,0,5,676094,350,124926,1330,0.0027721454821949057,0.7916666666666666
8526,0.8533,5,2,5,676096,348,124931,1325,0.0027563046508680775,0.7919904363419008
8527,0.8534,6,1,6,676097,347,124937,1319,0.0027483842352046635,0.7917166866746699
8528,0.8535,5,0,5,676097,347,124942,1314,0.0027483842352046635,0.7910897049969897
8529,0.8536,4,1,4,676098,346,124946,1310,0.0027404638195412494,0.7910628019323671
8530,0.8537,1,1,1,676099,345,124947,1309,0.0027325434038778353,0.7914147521160823
8531,0.8538,3,1,3,676100,344,124950,1306,0.0027246229882144216,0.7915151515151515
8532,0.8539,3,1,3,676101,343,124953,1303,0.0027167025725510076,0.7916160388821385
8533,0.8541,1,2,1,676103,341,124954,1302,0.0027008617412241794,0.7924528301886793
8534,0.8542,4,2,4,676105,339,124958,1298,0.0026850209098973512,0.7929138668295663
8535,0.8543,3,2,3,676107,337,124961,1295,0.0026691800785705235,0.7935049019607843
8536,0.8544,4,1,4,676108,336,124965,1291,0.0026612596629071094,0.7934849416103258
8537,0.8545,1,1,1,676109,335,124966,1290,0.0026533392472436954,0.7938461538461539
8538,0.8546,1,1,1,676110,334,124967,1289,0.0026454188315802813,0.7942082563154652
8539,0.8547,3,1,3,676111,333,124970,1286,0.002637498415916867,0.7943174799258802
8540,0.8548,3,3,3,676114,330,124973,1283,0.0026137371689266254,0.7954122752634842
8541,0.8549,1,1,1,676115,329,124974,1282,0.0026058167532632113,0.7957790192427064
8542,0.855,3,0,3,676115,329,124977,1279,0.0026058167532632113,0.7953980099502488
8543,0.8551,3,2,3,676117,327,124980,1276,0.002589975921936383,0.7960074859638179
8544,0.8552,4,0,4,676117,327,124984,1272,0.002589975921936383,0.7954971857410882
8545,0.8553,0,2,0,676119,325,124984,1272,0.002574135090609555,0.7964934251721979
8546,0.8554,3,2,3,676121,323,124987,1269,0.0025582942592827273,0.7971105527638191
8547,0.8555,0,1,0,676122,322,124987,1269,0.002550373843619313,0.7976115650534256
8548,0.8556,2,0,2,676122,322,124989,1267,0.002550373843619313,0.7973568281938326
8549,0.8557,0,1,0,676123,321,124989,1267,0.002542453427955899,0.7978589420654912
8550,0.8558,2,1,2,676124,320,124991,1265,0.002534533012292485,0.7981072555205048
8551,0.8559,3,2,3,676126,318,124994,1262,0.0025186921809656573,0.7987341772151899
8552,0.856,4,0,4,676126,318,124998,1258,0.0025186921809656573,0.7982233502538071
8553,0.8561,2,2,2,676128,316,125000,1256,0.002502851349638829,0.7989821882951654
8554,0.8562,4,0,4,676128,316,125004,1252,0.002502851349638829,0.798469387755102
8555,0.8563,2,1,2,676129,315,125006,1250,0.002494930933975415,0.7987220447284346
8556,0.8564,5,0,5,676129,315,125011,1245,0.002494930933975415,0.7980769230769231
8557,0.8565,4,0,4,676129,315,125015,1241,0.002494930933975415,0.7975578406169666
8558,0.8566,3,1,3,676130,314,125018,1238,0.002487010518312001,0.7976804123711341
8559,0.8567,1,1,1,676131,313,125019,1237,0.002479090102648587,0.7980645161290323
8560,0.8568,2,1,2,676132,312,125021,1235,0.002471169686985173,0.7983193277310925
8561,0.8569,3,0,3,676132,312,125024,1232,0.002471169686985173,0.7979274611398963
8562,0.857,1,0,1,676132,312,125025,1231,0.002471169686985173,0.797796500324044
8563,0.8571,3,2,3,676134,310,125028,1228,0.002455328855658345,0.7984395318595578
8564,0.8572,3,0,3,676134,310,125031,1225,0.002455328855658345,0.7980456026058632
8565,0.8573,4,1,4,676135,309,125035,1221,0.002447408439994931,0.7980392156862746
8566,0.8574,3,2,3,676137,307,125038,1218,0.002431567608668103,0.7986885245901639
8567,0.8575,2,2,2,676139,305,125040,1216,0.0024157267773412747,0.799474030243261
8568,0.8576,1,0,1,676139,305,125041,1215,0.0024157267773412747,0.7993421052631579
8569,0.8577,2,1,2,676140,304,125043,1213,0.002407806361677861,0.7996044825313118
8570,0.8578,3,0,3,676140,304,125046,1210,0.002407806361677861,0.7992073976221928
8571,0.8579,2,1,2,676141,303,125048,1208,0.002399885946014447,0.799470549305096
8572,0.858,6,0,6,676141,303,125054,1202,0.002399885946014447,0.7986710963455149
8573,0.8581,2,0,2,676141,303,125056,1200,0.002399885946014447,0.7984031936127745
8574,0.8582,1,0,1,676141,303,125057,1199,0.002399885946014447,0.7982689747003995
8575,0.8583,3,0,3,676141,303,125060,1196,0.002399885946014447,0.7978652434956638
8576,0.8584,1,1,1,676142,302,125061,1195,0.002391965530351033,0.7982631930527722
8577,0.8585,2,0,2,676142,302,125063,1193,0.002391965530351033,0.7979933110367893
8578,0.8586,2,0,2,676142,302,125065,1191,0.002391965530351033,0.797722705961152
8579,0.8587,3,0,3,676142,302,125068,1188,0.002391965530351033,0.7973154362416107
8580,0.8588,2,0,2,676142,302,125070,1186,0.002391965530351033,0.7970430107526881
8581,0.859,2,1,2,676143,301,125072,1184,0.0023840451146876188,0.7973063973063973
8582,0.8591,4,2,4,676145,299,125076,1180,0.0023682042833607906,0.7978363759296823
8583,0.8592,1,0,1,676145,299,125077,1179,0.0023682042833607906,0.7976995940460081
8584,0.8593,2,0,2,676145,299,125079,1177,0.0023682042833607906,0.7974254742547425
8585,0.8594,4,2,4,676147,297,125083,1173,0.002352363452033963,0.7979591836734694
8586,0.8595,2,3,2,676150,294,125085,1171,0.0023286022050437206,0.7993174061433447
8587,0.8596,3,0,3,676150,294,125088,1168,0.0023286022050437206,0.79890560875513
8588,0.8597,2,3,2,676153,291,125090,1166,0.002304840958053479,0.8002745367192862
8589,0.8598,1,2,1,676155,289,125091,1165,0.0022890001267266507,0.8012379642365888
8590,0.8599,2,1,2,676156,288,125093,1163,0.0022810797110632366,0.8015161957270848
8591,0.86,4,1,4,676157,287,125097,1159,0.0022731592953998225,0.8015214384508991
8592,0.8601,3,0,3,676157,287,125100,1156,0.0022731592953998225,0.8011088011088011
8593,0.8602,6,1,6,676158,286,125106,1150,0.0022652388797364084,0.8008356545961003
8594,0.8603,2,1,2,676159,285,125108,1148,0.0022573184640729944,0.8011165387299372
8595,0.8604,2,1,2,676160,284,125110,1146,0.0022493980484095807,0.8013986013986014
8596,0.8605,1,0,1,676160,284,125111,1145,0.0022493980484095807,0.801259622113366
8597,0.8606,3,1,3,676161,283,125114,1142,0.0022414776327461666,0.8014035087719298
8598,0.8607,1,0,1,676161,283,125115,1141,0.0022414776327461666,0.8012640449438202
8599,0.8608,3,0,3,676161,283,125118,1138,0.0022414776327461666,0.800844475721323
8600,0.8609,3,1,3,676162,282,125121,1135,0.0022335572170827525,0.8009880028228652
8601,0.861,1,0,1,676162,282,125122,1134,0.0022335572170827525,0.8008474576271186
8602,0.8611,3,1,3,676163,281,125125,1131,0.0022256368014193385,0.8009915014164306
8603,0.8612,4,1,4,676164,280,125129,1127,0.0022177163857559244,0.8009950248756219
8604,0.8613,0,1,0,676165,279,125129,1127,0.0022097959700925103,0.8015647226173542
8605,0.8614,2,1,2,676166,278,125131,1125,0.0022018755544290962,0.8018531717747683
8606,0.8615,2,0,2,676166,278,125133,1123,0.0022018755544290962,0.801570306923626
8607,0.8616,2,1,2,676167,277,125135,1121,0.0021939551387656826,0.801859799713877
8608,0.8617,2,0,2,676167,277,125137,1119,0.0021939551387656826,0.8015759312320917
8609,0.8618,3,1,3,676168,276,125140,1116,0.0021860347231022685,0.8017241379310345
8610,0.8619,4,1,4,676169,275,125144,1112,0.0021781143074388544,0.8017303532804614
8611,0.862,2,0,2,676169,275,125146,1110,0.0021781143074388544,0.8014440433212996
8612,0.8621,1,0,1,676169,275,125147,1109,0.0021781143074388544,0.8013005780346821
8613,0.8622,3,2,3,676171,273,125150,1106,0.0021622734761120263,0.8020304568527918
8614,0.8623,4,1,4,676172,272,125154,1102,0.002154353060448612,0.8020378457059679
8615,0.8624,3,1,3,676173,271,125157,1099,0.0021464326447851985,0.8021897810218979
8616,0.8625,4,1,4,676174,270,125161,1095,0.0021385122291217844,0.8021978021978022
8617,0.8626,5,0,5,676174,270,125166,1090,0.0021385122291217844,0.8014705882352942
8618,0.8629,1,2,1,676176,268,125167,1089,0.0021226713977949563,0.8025055268975682
8619,0.863,1,2,1,676178,266,125168,1088,0.002106830566468128,0.8035450516986706
8620,0.8631,0,1,0,676179,265,125168,1088,0.002098910150804714,0.804138950480414
8621,0.8633,0,3,0,676182,262,125168,1088,0.0020751489038144722,0.8059259259259259
8622,0.8634,2,4,2,676186,258,125170,1086,0.002043467241160816,0.8080357142857143
8623,0.8635,5,0,5,676186,258,125175,1081,0.002043467241160816,0.8073188946975355
8624,0.8636,4,0,4,676186,258,125179,1077,0.002043467241160816,0.8067415730337079
8625,0.8637,4,2,4,676188,256,125183,1073,0.002027626409833988,0.8073739653875094
8626,0.8638,0,2,0,676190,254,125183,1073,0.00201178557850716,0.8085908063300679
8627,0.8639,1,1,1,676191,253,125184,1072,0.002003865162843746,0.8090566037735849
8628,0.864,3,0,3,676191,253,125187,1069,0.002003865162843746,0.8086232980332829
8629,0.8641,2,0,2,676191,253,125189,1067,0.002003865162843746,0.8083333333333333
8630,0.8642,2,1,2,676192,252,125191,1065,0.001995944747180332,0.8086560364464692
8631,0.8643,5,0,5,676192,252,125196,1060,0.001995944747180332,0.8079268292682927
8632,0.8644,3,1,3,676193,251,125199,1057,0.001988024331516918,0.8081039755351682
8633,0.8645,4,1,4,676194,250,125203,1053,0.001980103915853504,0.8081350729086723
8634,0.8646,1,1,1,676195,249,125204,1052,0.00197218350019009,0.808608762490392
8635,0.8647,1,0,1,676195,249,125205,1051,0.00197218350019009,0.8084615384615385
8636,0.8648,3,2,3,676197,247,125208,1048,0.001956342668863262,0.8092664092664092
8637,0.8649,3,2,3,676199,245,125211,1045,0.001940501837536434,0.810077519379845
8638,0.865,4,0,4,676199,245,125215,1041,0.001940501837536434,0.8094867807153966
8639,0.8652,5,2,5,676201,243,125220,1036,0.0019246610062096058,0.8100078186082877
8640,0.8653,3,0,3,676201,243,125223,1033,0.0019246610062096058,0.8095611285266457
8641,0.8654,4,2,4,676203,241,125227,1029,0.0019088201748827778,0.8102362204724409
8642,0.8655,2,0,2,676203,241,125229,1027,0.0019088201748827778,0.8099369085173501
8643,0.8656,0,2,0,676205,239,125229,1027,0.00189297934355595,0.811216429699842
8644,0.8657,3,1,3,676206,238,125232,1024,0.0018850589278925358,0.8114104595879557
8645,0.8658,2,2,2,676208,236,125234,1022,0.0018692180965657079,0.8124006359300477
8646,0.8659,4,1,4,676209,235,125238,1018,0.0018612976809022938,0.8124501197126895
8647,0.866,3,1,3,676210,234,125241,1015,0.0018533772652388797,0.8126501200960768
8648,0.8661,2,1,2,676211,233,125243,1013,0.0018454568495754656,0.8130016051364366
8649,0.8662,1,1,1,676212,232,125244,1012,0.0018375364339120518,0.8135048231511254
8650,0.8663,2,1,2,676213,231,125246,1010,0.0018296160182486377,0.8138597904915391
8651,0.8664,4,1,4,676214,230,125250,1006,0.0018216956025852236,0.813915857605178
8652,0.8665,2,0,2,676214,230,125252,1004,0.0018216956025852236,0.813614262560778
8653,0.8666,1,1,1,676215,229,125253,1003,0.0018137751869218097,0.8141233766233766
8654,0.8668,1,0,1,676215,229,125254,1002,0.0018137751869218097,0.8139723801787165
8655,0.8669,2,0,2,676215,229,125256,1000,0.0018137751869218097,0.8136696501220505
8656,0.867,1,2,1,676217,227,125257,999,0.0017979343555949816,0.8148450244698205
8657,0.8671,5,0,5,676217,227,125262,994,0.0017979343555949816,0.814086814086814
8658,0.8672,1,2,1,676219,225,125263,993,0.0017820935242681536,0.8152709359605911
8659,0.8673,3,1,3,676220,224,125266,990,0.0017741731086047396,0.8154859967051071
8660,0.8674,3,0,3,676220,224,125269,987,0.0017741731086047396,0.815028901734104
8661,0.8675,1,1,1,676221,223,125270,986,0.0017662526929413255,0.815550041356493
8662,0.8676,3,1,3,676222,222,125273,983,0.0017583322772779116,0.8157676348547718
8663,0.8677,1,0,1,676222,222,125274,982,0.0017583322772779116,0.8156146179401993
8664,0.8678,4,1,4,676223,221,125278,978,0.0017504118616144975,0.8156797331109258
8665,0.8679,5,1,5,676224,220,125283,973,0.0017424914459510834,0.815590947191953
8666,0.868,3,0,3,676224,220,125286,970,0.0017424914459510834,0.8151260504201681
8667,0.8681,4,2,4,676226,218,125290,966,0.0017266506146242555,0.8158783783783784
8668,0.8682,4,0,4,676226,218,125294,962,0.0017266506146242555,0.8152542372881356
8669,0.8683,1,0,1,676226,218,125295,961,0.0017266506146242555,0.81509754028838
8670,0.8684,5,0,5,676226,218,125300,956,0.0017266506146242555,0.8143100511073254
8671,0.8685,4,1,4,676227,217,125304,952,0.0017187301989608414,0.8143712574850299
8672,0.8686,0,1,0,676228,216,125304,952,0.0017108097832974276,0.815068493150685
8673,0.8687,4,1,4,676229,215,125308,948,0.0017028893676340135,0.8151332760103182
8674,0.8688,4,1,4,676230,214,125312,944,0.0016949689519705994,0.8151986183074266
8675,0.8689,6,1,6,676231,213,125318,938,0.0016870485363071853,0.8149435273675065
8676,0.869,4,3,4,676234,210,125322,934,0.0016632872893169433,0.8164335664335665
8677,0.8691,1,1,1,676235,209,125323,933,0.0016553668736535294,0.8169877408056042
8678,0.8692,8,0,8,676235,209,125331,925,0.0016553668736535294,0.8156966490299824
8679,0.8693,2,1,2,676236,208,125333,923,0.0016474464579901153,0.8160919540229885
8680,0.8694,3,0,3,676236,208,125336,920,0.0016474464579901153,0.8156028368794326
8681,0.8695,1,0,1,676236,208,125337,919,0.0016474464579901153,0.8154392191659272
8682,0.8696,2,1,2,676237,207,125339,917,0.0016395260423267013,0.8158362989323843
8683,0.8697,3,1,3,676238,206,125342,914,0.0016316056266632872,0.8160714285714286
8684,0.8698,4,1,4,676239,205,125346,910,0.0016236852109998733,0.8161434977578476
8685,0.8699,2,0,2,676239,205,125348,908,0.0016236852109998733,0.8158131176999102
8686,0.87,1,3,1,676242,202,125349,907,0.0015999239640096313,0.8178539224526601
8687,0.8701,3,0,3,676242,202,125352,904,0.0015999239640096313,0.8173598553345389
8688,0.8702,1,0,1,676242,202,125353,903,0.0015999239640096313,0.8171945701357466
8689,0.8703,3,1,3,676243,201,125356,900,0.0015920035483462172,0.8174386920980926
8690,0.8704,2,2,2,676245,199,125358,898,0.0015761627170193893,0.8185961713764813
8691,0.8705,3,0,3,676245,199,125361,895,0.0015761627170193893,0.8180987202925045
8692,0.8706,1,0,1,676245,199,125362,894,0.0015761627170193893,0.817932296431839
8693,0.8707,1,1,1,676246,198,125363,893,0.0015682423013559752,0.8185151237396884
8694,0.8708,1,0,1,676246,198,125364,892,0.0015682423013559752,0.818348623853211
8695,0.8709,1,1,1,676247,197,125365,891,0.001560321885692561,0.8189338235294118
8696,0.871,3,0,3,676247,197,125368,888,0.001560321885692561,0.8184331797235023
8697,0.8711,3,2,3,676249,195,125371,885,0.0015444810543657332,0.8194444444444444
8698,0.8712,1,0,1,676249,195,125372,884,0.0015444810543657332,0.8192771084337349
8699,0.8713,4,0,4,676249,195,125376,880,0.0015444810543657332,0.8186046511627907
8700,0.8714,1,0,1,676249,195,125377,879,0.0015444810543657332,0.8184357541899442
8701,0.8715,1,0,1,676249,195,125378,878,0.0015444810543657332,0.8182665424044734
8702,0.8716,3,2,3,676251,193,125381,875,0.001528640223038905,0.8192883895131086
8703,0.8717,0,1,0,676252,192,125381,875,0.0015207198073754911,0.8200562324273665
8704,0.8718,2,0,2,676252,192,125383,873,0.0015207198073754911,0.819718309859155
8705,0.8719,3,0,3,676252,192,125386,870,0.0015207198073754911,0.8192090395480226
8706,0.872,3,0,3,676252,192,125389,867,0.0015207198073754911,0.8186968838526912
8707,0.8721,2,0,2,676252,192,125391,865,0.0015207198073754911,0.8183538315988647
8708,0.8722,3,0,3,676252,192,125394,862,0.0015207198073754911,0.8178368121442126
8709,0.8723,3,0,3,676252,192,125397,859,0.0015207198073754911,0.8173168411037107
8710,0.8724,2,0,2,676252,192,125399,857,0.0015207198073754911,0.8169685414680649
8711,0.8725,2,1,2,676253,191,125401,855,0.001512799391712077,0.8173996175908221
8712,0.8726,2,0,2,676253,191,125403,853,0.001512799391712077,0.8170498084291188
8713,0.8727,2,1,2,676254,190,125405,851,0.001504878976048663,0.8174831892411143
8714,0.8728,2,3,2,676257,187,125407,849,0.001481117729058421,0.8194980694980695
8715,0.8729,0,1,0,676258,186,125407,849,0.0014731973133950069,0.8202898550724638
8716,0.873,1,0,1,676258,186,125408,848,0.0014731973133950069,0.8201160541586073
8717,0.8731,3,0,3,676258,186,125411,845,0.0014731973133950069,0.8195926285160039
8718,0.8732,3,0,3,676258,186,125414,842,0.0014731973133950069,0.8190661478599222
8719,0.8733,4,0,4,676258,186,125418,838,0.0014731973133950069,0.818359375
8720,0.8734,1,0,1,676258,186,125419,837,0.0014731973133950069,0.8181818181818182
8721,0.8736,6,0,6,676258,186,125425,831,0.0014731973133950069,0.8171091445427728
8722,0.8737,2,1,2,676259,185,125427,829,0.001465276897731593,0.8175542406311637
8723,0.8738,3,0,3,676259,185,125430,826,0.001465276897731593,0.8170128585558852
8724,0.8739,4,0,4,676259,185,125434,822,0.001465276897731593,0.8162859980139027
8725,0.874,4,0,4,676259,185,125438,818,0.001465276897731593,0.8155533399800599
8726,0.8741,1,0,1,676259,185,125439,817,0.001465276897731593,0.8153692614770459
8727,0.8743,4,0,4,676259,185,125443,813,0.001465276897731593,0.814629258517034
8728,0.8744,1,0,1,676259,185,125444,812,0.001465276897731593,0.8144433299899699
8729,0.8745,1,0,1,676259,185,125445,811,0.001465276897731593,0.8142570281124498
8730,0.8746,1,0,1,676259,185,125446,810,0.001465276897731593,0.8140703517587939
8731,0.8747,1,0,1,676259,185,125447,809,0.001465276897731593,0.8138832997987927
8732,0.8748,1,1,1,676260,184,125448,808,0.001457356482068179,0.8145161290322581
8733,0.8749,3,1,3,676261,183,125451,805,0.0014494360664047648,0.8147773279352226
8734,0.875,4,0,4,676261,183,125455,801,0.0014494360664047648,0.8140243902439024
8735,0.8751,4,0,4,676261,183,125459,797,0.0014494360664047648,0.813265306122449
8736,0.8752,3,2,3,676263,181,125462,794,0.001433595235077937,0.8143589743589743
8737,0.8753,1,1,1,676264,180,125463,793,0.0014256748194145228,0.8150051387461459
8738,0.8754,1,2,1,676266,178,125464,792,0.0014098339880876949,0.8164948453608247
8739,0.8755,2,0,2,676266,178,125466,790,0.0014098339880876949,0.8161157024793388
8740,0.8756,1,0,1,676266,178,125467,789,0.0014098339880876949,0.8159255429162358
8741,0.8757,2,0,2,676266,178,125469,787,0.0014098339880876949,0.8155440414507772
8742,0.8758,4,0,4,676266,178,125473,783,0.0014098339880876949,0.8147762747138397
8743,0.8759,3,0,3,676266,178,125476,780,0.0014098339880876949,0.81419624217119
8744,0.8761,2,0,2,676266,178,125478,778,0.0014098339880876949,0.8138075313807531
8745,0.8763,3,1,3,676267,177,125481,775,0.0014019135724242808,0.8140756302521008
8746,0.8764,0,1,0,676268,176,125481,775,0.0013939931567608667,0.814931650893796
8747,0.8765,3,1,3,676269,175,125484,772,0.0013860727410974528,0.8152059134107709
8748,0.8766,0,2,0,676271,173,125484,772,0.0013702319097706247,0.816931216931217
8749,0.8767,5,2,5,676273,171,125489,767,0.0013543910784437967,0.8176972281449894
8750,0.8768,4,1,4,676274,170,125493,763,0.0013464706627803827,0.8177920685959271
8751,0.8769,3,0,3,676274,170,125496,760,0.0013464706627803827,0.8172043010752689
8752,0.877,2,2,2,676276,168,125498,758,0.0013306298314535547,0.8185745140388769
8753,0.8771,3,0,3,676276,168,125501,755,0.0013306298314535547,0.8179848320693391
8754,0.8772,3,1,3,676277,167,125504,752,0.0013227094157901406,0.8182807399347116
8755,0.8773,2,1,2,676278,166,125506,750,0.0013147890001267266,0.8187772925764192
8756,0.8774,1,0,1,676278,166,125507,749,0.0013147890001267266,0.8185792349726776
8757,0.8775,1,0,1,676278,166,125508,748,0.0013147890001267266,0.8183807439824945
8758,0.8776,3,2,3,676280,164,125511,745,0.0012989481687998986,0.8195819581958196
8759,0.8777,6,1,6,676281,163,125517,739,0.0012910277531364845,0.8192904656319291
8760,0.8778,3,0,3,676281,163,125520,736,0.0012910277531364845,0.8186874304783093
8761,0.8779,3,0,3,676281,163,125523,733,0.0012910277531364845,0.8180803571428571
8762,0.878,4,0,4,676281,163,125527,729,0.0012910277531364845,0.8172645739910314
8763,0.8781,1,1,1,676282,162,125528,728,0.0012831073374730707,0.8179775280898877
8764,0.8782,1,0,1,676282,162,125529,727,0.0012831073374730707,0.8177727784026997
8765,0.8783,1,0,1,676282,162,125530,726,0.0012831073374730707,0.8175675675675675
8766,0.8784,1,0,1,676282,162,125531,725,0.0012831073374730707,0.8173618940248027
8767,0.8785,2,0,2,676282,162,125533,723,0.0012831073374730707,0.8169491525423729
8768,0.8787,2,0,2,676282,162,125535,721,0.0012831073374730707,0.8165345413363534
8769,0.8788,1,0,1,676282,162,125536,720,0.0012831073374730707,0.8163265306122449
8770,0.8789,2,0,2,676282,162,125538,718,0.0012831073374730707,0.8159090909090909
8771,0.879,0,1,0,676283,161,125538,718,0.0012751869218096566,0.8168373151308305
8772,0.8791,2,1,2,676284,160,125540,716,0.0012672665061462425,0.817351598173516
8773,0.8793,2,0,2,676284,160,125542,714,0.0012672665061462425,0.816933638443936
8774,0.8794,1,1,1,676285,159,125543,713,0.0012593460904828286,0.8176605504587156
8775,0.8795,3,2,3,676287,157,125546,710,0.0012435052591560005,0.8189158016147635
8776,0.8796,2,1,2,676288,156,125548,708,0.0012355848434925864,0.8194444444444444
8777,0.8797,5,0,5,676288,156,125553,703,0.0012355848434925864,0.8183934807916181
8778,0.8798,3,2,3,676290,154,125556,700,0.0012197440121657585,0.819672131147541
8779,0.8799,2,0,2,676290,154,125558,698,0.0012197440121657585,0.8192488262910798
8780,0.88,1,0,1,676290,154,125559,697,0.0012197440121657585,0.8190364277320799
8781,0.8801,2,0,2,676290,154,125561,695,0.0012197440121657585,0.8186101295641932
8782,0.8802,4,0,4,676290,154,125565,691,0.0012197440121657585,0.8177514792899409
8783,0.8803,0,1,0,676291,153,125565,691,0.0012118235965023444,0.8187203791469194
8784,0.8804,2,0,2,676291,153,125567,689,0.0012118235965023444,0.8182897862232779
8785,0.8805,4,0,4,676291,153,125571,685,0.0012118235965023444,0.8174224343675418
8786,0.8806,1,0,1,676291,153,125572,684,0.0012118235965023444,0.8172043010752689
8787,0.8807,4,0,4,676291,153,125576,680,0.0012118235965023444,0.8163265306122449
8788,0.8808,3,0,3,676291,153,125579,677,0.0012118235965023444,0.8156626506024096
8789,0.8809,5,2,5,676293,151,125584,672,0.0011959827651755164,0.8165249088699879
8790,0.881,1,0,1,676293,151,125585,671,0.0011959827651755164,0.816301703163017
8791,0.8811,4,1,4,676294,150,125589,667,0.0011880623495121023,0.8164014687882497
8792,0.8812,2,1,2,676295,149,125591,665,0.0011801419338486885,0.816953316953317
8793,0.8813,1,0,1,676295,149,125592,664,0.0011801419338486885,0.8167281672816729
8794,0.8814,2,1,2,676296,148,125594,662,0.0011722215181852744,0.817283950617284
8795,0.8815,2,1,2,676297,147,125596,660,0.0011643011025218603,0.8178438661710037
8796,0.8816,2,0,2,676297,147,125598,658,0.0011643011025218603,0.8173913043478261
8797,0.8817,3,1,3,676298,146,125601,655,0.0011563806868584462,0.8177278401997503
8798,0.8818,3,0,3,676298,146,125604,652,0.0011563806868584462,0.8170426065162907
8799,0.8819,4,0,4,676298,146,125608,648,0.0011563806868584462,0.8161209068010076
8800,0.882,1,0,1,676298,146,125609,647,0.0011563806868584462,0.8158890290037831
8801,0.8821,2,1,2,676299,145,125611,645,0.0011484602711950324,0.8164556962025317
8802,0.8822,1,0,1,676299,145,125612,644,0.0011484602711950324,0.8162230671736375
8803,0.8823,2,1,2,676300,144,125614,642,0.0011405398555316183,0.816793893129771
8804,0.8824,2,0,2,676300,144,125616,640,0.0011405398555316183,0.8163265306122449
8805,0.8825,2,1,2,676301,143,125618,638,0.0011326194398682042,0.8169014084507042
8806,0.8827,5,0,5,676301,143,125623,633,0.0011326194398682042,0.8157216494845361
8807,0.8828,5,0,5,676301,143,125628,628,0.0011326194398682042,0.814526588845655
8808,0.8829,2,1,2,676302,142,125630,626,0.0011246990242047904,0.8151041666666666
8809,0.883,2,0,2,676302,142,125632,624,0.0011246990242047904,0.814621409921671
8810,0.8832,1,3,1,676305,139,125633,623,0.0011009377772145481,0.8175853018372703
8811,0.8833,3,0,3,676305,139,125636,620,0.0011009377772145481,0.8168642951251647
8812,0.8834,1,0,1,676305,139,125637,619,0.0011009377772145481,0.816622691292876
8813,0.8835,4,0,4,676305,139,125641,615,0.0011009377772145481,0.8156498673740054
8814,0.8836,1,0,1,676305,139,125642,614,0.0011009377772145481,0.8154050464807437
8815,0.8838,3,0,3,676305,139,125645,611,0.0011009377772145481,0.8146666666666667
8816,0.8839,2,0,2,676305,139,125647,609,0.0011009377772145481,0.8141711229946524
8817,0.8841,2,1,2,676306,138,125649,607,0.0010930173615511342,0.8147651006711409
8818,0.8842,1,2,1,676308,136,125650,606,0.001077176530224306,0.816711590296496
8819,0.8843,2,1,2,676309,135,125652,604,0.0010692561145608922,0.8173207036535859
8820,0.8844,3,0,3,676309,135,125655,601,0.0010692561145608922,0.8165760869565217
8821,0.8846,2,0,2,676309,135,125657,599,0.0010692561145608922,0.8160762942779292
8822,0.8847,3,0,3,676309,135,125660,596,0.0010692561145608922,0.8153214774281806
8823,0.8848,2,0,2,676309,135,125662,594,0.0010692561145608922,0.8148148148148148
8824,0.8849,3,0,3,676309,135,125665,591,0.0010692561145608922,0.8140495867768595
8825,0.885,2,0,2,676309,135,125667,589,0.0010692561145608922,0.81353591160221
8826,0.8852,2,1,2,676310,134,125669,587,0.0010613356988974781,0.8141470180305131
8827,0.8853,1,1,1,676311,133,125670,586,0.001053415283234064,0.8150208623087621
8828,0.8854,1,0,1,676311,133,125671,585,0.001053415283234064,0.8147632311977716
8829,0.8856,2,0,2,676311,133,125673,583,0.001053415283234064,0.8142458100558659
8830,0.886,7,0,7,676311,133,125680,576,0.001053415283234064,0.8124118476727785
8831,0.8861,1,0,1,676311,133,125681,575,0.001053415283234064,0.8121468926553672
8832,0.8862,1,1,1,676312,132,125682,574,0.0010454948675706502,0.8130311614730878
8833,0.8863,2,0,2,676312,132,125684,572,0.0010454948675706502,0.8125
8834,0.8864,1,0,1,676312,132,125685,571,0.0010454948675706502,0.8122332859174964
8835,0.8865,4,0,4,676312,132,125689,567,0.0010454948675706502,0.8111587982832618
8836,0.8866,5,0,5,676312,132,125694,562,0.0010454948675706502,0.8097982708933718
8837,0.8867,6,0,6,676312,132,125700,556,0.0010454948675706502,0.8081395348837209
8838,0.8869,2,1,2,676313,131,125702,554,0.0010375744519072361,0.8087591240875912
8839,0.887,4,1,4,676314,130,125706,550,0.001029654036243822,0.8088235294117647
8840,0.8871,1,0,1,676314,130,125707,549,0.001029654036243822,0.8085419734904271
8841,0.8872,2,1,2,676315,129,125709,547,0.001021733620580408,0.8091715976331361
8842,0.8873,1,0,1,676315,129,125710,546,0.001021733620580408,0.8088888888888889
8843,0.8874,2,0,2,676315,129,125712,544,0.001021733620580408,0.8083209509658247
8844,0.8875,1,0,1,676315,129,125713,543,0.001021733620580408,0.8080357142857143
8845,0.8876,1,0,1,676315,129,125714,542,0.001021733620580408,0.8077496274217586
8846,0.8877,1,2,1,676317,127,125715,541,0.00100589278925358,0.8098802395209581
8847,0.8878,2,0,2,676317,127,125717,539,0.00100589278925358,0.8093093093093093
8848,0.8879,2,0,2,676317,127,125719,537,0.00100589278925358,0.8087349397590361
8849,0.888,5,0,5,676317,127,125724,532,0.00100589278925358,0.8072837632776935
8850,0.8881,1,2,1,676319,125,125725,531,0.000990051957926752,0.8094512195121951
8851,0.8882,2,0,2,676319,125,125727,529,0.000990051957926752,0.808868501529052
8852,0.8883,3,0,3,676319,125,125730,526,0.000990051957926752,0.8079877112135176
8853,0.8885,4,1,4,676320,124,125734,522,0.000982131542263338,0.8080495356037152
8854,0.8886,0,2,0,676322,122,125734,522,0.0009662907109365099,0.8105590062111802
8855,0.8888,0,2,0,676324,120,125734,522,0.0009504498796096819,0.8130841121495327
8856,0.8889,3,0,3,676324,120,125737,519,0.0009504498796096819,0.812206572769953
8857,0.889,0,2,0,676326,118,125737,519,0.0009346090482828539,0.814756671899529
8858,0.8891,1,1,1,676327,117,125738,518,0.0009266886326194399,0.815748031496063
8859,0.8892,4,1,4,676328,116,125742,514,0.0009187682169560259,0.8158730158730159
8860,0.8893,3,1,3,676329,115,125745,511,0.0009108478012926118,0.8162939297124601
8861,0.8894,6,0,6,676329,115,125751,505,0.0009108478012926118,0.8145161290322581
8862,0.8895,2,1,2,676330,114,125753,503,0.0009029273856291978,0.8152350081037277
8863,0.8896,1,0,1,676330,114,125754,502,0.0009029273856291978,0.814935064935065
8864,0.8897,2,0,2,676330,114,125756,500,0.0009029273856291978,0.8143322475570033
8865,0.8898,4,0,4,676330,114,125760,496,0.0009029273856291978,0.8131147540983606
8866,0.8899,1,0,1,676330,114,125761,495,0.0009029273856291978,0.812807881773399
8867,0.89,3,0,3,676330,114,125764,492,0.0009029273856291978,0.8118811881188119
8868,0.8901,4,0,4,676330,114,125768,488,0.0009029273856291978,0.8106312292358804
8869,0.8902,4,2,4,676332,112,125772,484,0.0008870865543023698,0.8120805369127517
8870,0.8903,2,0,2,676332,112,125774,482,0.0008870865543023698,0.8114478114478114
8871,0.8904,1,0,1,676332,112,125775,481,0.0008870865543023698,0.8111298482293423
8872,0.8905,4,1,4,676333,111,125779,477,0.0008791661386389558,0.8112244897959183
8873,0.8906,1,0,1,676333,111,125780,476,0.0008791661386389558,0.8109028960817717
8874,0.8907,1,0,1,676333,111,125781,475,0.0008791661386389558,0.810580204778157
8875,0.8908,1,1,1,676334,110,125782,474,0.0008712457229755417,0.8116438356164384
8876,0.891,2,0,2,676334,110,125784,472,0.0008712457229755417,0.8109965635738832
8877,0.8911,1,0,1,676334,110,125785,471,0.0008712457229755417,0.810671256454389
8878,0.8912,3,0,3,676334,110,125788,468,0.0008712457229755417,0.8096885813148789
8879,0.8913,2,0,2,676334,110,125790,466,0.0008712457229755417,0.8090277777777778
8880,0.8914,3,0,3,676334,110,125793,463,0.0008712457229755417,0.8080279232111692
8881,0.8915,4,0,4,676334,110,125797,459,0.0008712457229755417,0.8066783831282952
8882,0.8916,3,0,3,676334,110,125800,456,0.0008712457229755417,0.8056537102473498
8883,0.8917,2,0,2,676334,110,125802,454,0.0008712457229755417,0.8049645390070922
8884,0.8918,1,1,1,676335,109,125803,453,0.0008633253073121277,0.806049822064057
8885,0.8919,0,1,0,676336,108,125803,453,0.0008554048916487138,0.8074866310160428
8886,0.892,1,1,1,676337,107,125804,452,0.0008474844759852997,0.8085867620751341
8887,0.8921,0,3,0,676340,104,125804,452,0.0008237232289950577,0.8129496402877698
8888,0.8922,2,0,2,676340,104,125806,450,0.0008237232289950577,0.8122743682310469
8889,0.8923,6,1,6,676341,103,125812,444,0.0008158028133316436,0.8117001828153565
8890,0.8924,2,2,2,676343,101,125814,442,0.0007999619820048156,0.8139963167587477
8891,0.8925,3,1,3,676344,100,125817,439,0.0007920415663414016,0.8144712430426716
8892,0.8926,1,0,1,676344,100,125818,438,0.0007920415663414016,0.8141263940520446
8893,0.8927,5,0,5,676344,100,125823,433,0.0007920415663414016,0.8123827392120075
8894,0.8928,2,1,2,676345,99,125825,431,0.0007841211506779876,0.8132075471698114
8895,0.8929,1,1,1,676346,98,125826,430,0.0007762007350145735,0.8143939393939394
8896,0.8932,1,0,1,676346,98,125827,429,0.0007762007350145735,0.8140417457305503
8897,0.8933,0,1,0,676347,97,125827,429,0.0007682803193511595,0.8155893536121673
8898,0.8934,2,0,2,676347,97,125829,427,0.0007682803193511595,0.8148854961832062
8899,0.8936,1,1,1,676348,96,125830,426,0.0007603599036877456,0.8160919540229885
8900,0.8937,2,1,2,676349,95,125832,424,0.0007524394880243315,0.8169556840077071
8901,0.894,1,0,1,676349,95,125833,423,0.0007524394880243315,0.8166023166023166
8902,0.8941,1,0,1,676349,95,125834,422,0.0007524394880243315,0.816247582205029
8903,0.8944,2,1,2,676350,94,125836,420,0.0007445190723609175,0.8171206225680934
8904,0.8945,0,1,0,676351,93,125836,420,0.0007365986566975034,0.8187134502923976
8905,0.8946,3,0,3,676351,93,125839,417,0.0007365986566975034,0.8176470588235294
8906,0.8947,0,2,0,676353,91,125839,417,0.0007207578253706755,0.8208661417322834
8907,0.8948,3,3,3,676356,88,125842,414,0.0006969965783804334,0.8247011952191236
8908,0.8949,1,1,1,676357,87,125843,413,0.0006890761627170194,0.826
8909,0.895,0,2,0,676359,85,125843,413,0.0006732353313901913,0.8293172690763052
8910,0.8951,1,0,1,676359,85,125844,412,0.0006732353313901913,0.8289738430583501
8911,0.8952,1,1,1,676360,84,125845,411,0.0006653149157267774,0.8303030303030303
8912,0.8953,4,0,4,676360,84,125849,407,0.0006653149157267774,0.8289205702647657
8913,0.8955,4,1,4,676361,83,125853,403,0.0006573945000633633,0.8292181069958847
8914,0.8956,1,0,1,676361,83,125854,402,0.0006573945000633633,0.8288659793814434
8915,0.8957,1,0,1,676361,83,125855,401,0.0006573945000633633,0.8285123966942148
8916,0.8958,2,1,2,676362,82,125857,399,0.0006494740843999493,0.8295218295218295
8917,0.8959,3,1,3,676363,81,125860,396,0.0006415536687365353,0.8301886792452831
8918,0.8961,2,0,2,676363,81,125862,394,0.0006415536687365353,0.8294736842105264
8919,0.8962,1,0,1,676363,81,125863,393,0.0006415536687365353,0.8291139240506329
8920,0.8963,4,0,4,676363,81,125867,389,0.0006415536687365353,0.8276595744680851
8921,0.8964,1,0,1,676363,81,125868,388,0.0006415536687365353,0.8272921108742004
8922,0.8965,1,1,1,676364,80,125869,387,0.0006336332530731213,0.828693790149893
8923,0.8966,0,1,0,676365,79,125869,387,0.0006257128374097073,0.8304721030042919
8924,0.8967,1,1,1,676366,78,125870,386,0.0006177924217462932,0.8318965517241379
8925,0.8968,3,0,3,676366,78,125873,383,0.0006177924217462932,0.8308026030368764
8926,0.8969,3,0,3,676366,78,125876,380,0.0006177924217462932,0.8296943231441049
8927,0.897,2,0,2,676366,78,125878,378,0.0006177924217462932,0.8289473684210527
8928,0.8971,0,1,0,676367,77,125878,378,0.0006098720060828792,0.8307692307692308
8929,0.8972,1,0,1,676367,77,125879,377,0.0006098720060828792,0.8303964757709251
8930,0.8973,1,0,1,676367,77,125880,376,0.0006098720060828792,0.8300220750551877
8931,0.8974,1,0,1,676367,77,125881,375,0.0006098720060828792,0.8296460176991151
8932,0.8976,1,0,1,676367,77,125882,374,0.0006098720060828792,0.8292682926829268
8933,0.8977,2,2,2,676369,75,125884,372,0.0005940311747560512,0.8322147651006712
8934,0.8978,2,0,2,676369,75,125886,370,0.0005940311747560512,0.8314606741573034
8935,0.8979,3,0,3,676369,75,125889,367,0.0005940311747560512,0.830316742081448
8936,0.898,1,0,1,676369,75,125890,366,0.0005940311747560512,0.8299319727891157
8937,0.8981,1,0,1,676369,75,125891,365,0.0005940311747560512,0.8295454545454546
8938,0.8982,1,0,1,676369,75,125892,364,0.0005940311747560512,0.8291571753986332
8939,0.8983,3,1,3,676370,74,125895,361,0.0005861107590926372,0.8298850574712644
8940,0.8984,4,0,4,676370,74,125899,357,0.0005861107590926372,0.8283062645011601
8941,0.8985,1,0,1,676370,74,125900,356,0.0005861107590926372,0.827906976744186
8942,0.8986,1,0,1,676370,74,125901,355,0.0005861107590926372,0.8275058275058275
8943,0.8988,2,0,2,676370,74,125903,353,0.0005861107590926372,0.8266978922716628
8944,0.8989,0,1,0,676371,73,125903,353,0.0005781903434292231,0.8286384976525821
8945,0.899,1,1,1,676372,72,125904,352,0.0005702699277658091,0.8301886792452831
8946,0.8991,2,0,2,676372,72,125906,350,0.0005702699277658091,0.8293838862559242
8947,0.8992,1,0,1,676372,72,125907,349,0.0005702699277658091,0.828978622327791
8948,0.8993,1,0,1,676372,72,125908,348,0.0005702699277658091,0.8285714285714286
8949,0.8994,1,0,1,676372,72,125909,347,0.0005702699277658091,0.8281622911694511
8950,0.8995,1,0,1,676372,72,125910,346,0.0005702699277658091,0.8277511961722488
8951,0.8996,1,1,1,676373,71,125911,345,0.0005623495121023952,0.8293269230769231
8952,0.8997,1,0,1,676373,71,125912,344,0.0005623495121023952,0.8289156626506025
8953,0.8998,2,0,2,676373,71,125914,342,0.0005623495121023952,0.8280871670702179
8954,0.8999,2,0,2,676373,71,125916,340,0.0005623495121023952,0.8272506082725061
8955,0.9,1,0,1,676373,71,125917,339,0.0005623495121023952,0.8268292682926829
8956,0.9001,1,0,1,676373,71,125918,338,0.0005623495121023952,0.8264058679706602
8957,0.9003,2,0,2,676373,71,125920,336,0.0005623495121023952,0.8255528255528255
8958,0.9004,2,0,2,676373,71,125922,334,0.0005623495121023952,0.8246913580246914
8959,0.9006,1,0,1,676373,71,125923,333,0.0005623495121023952,0.8242574257425742
8960,0.9007,1,0,1,676373,71,125924,332,0.0005623495121023952,0.8238213399503722
8961,0.9008,1,0,1,676373,71,125925,331,0.0005623495121023952,0.8233830845771144
8962,0.901,1,0,1,676373,71,125926,330,0.0005623495121023952,0.8229426433915212
8963,0.9011,1,1,1,676374,70,125927,329,0.0005544290964389811,0.8245614035087719
8964,0.9013,0,1,0,676375,69,125927,329,0.0005465086807755671,0.8266331658291457
8965,0.9014,2,0,2,676375,69,125929,327,0.0005465086807755671,0.8257575757575758
8966,0.9015,4,0,4,676375,69,125933,323,0.0005465086807755671,0.8239795918367347
8967,0.9016,2,0,2,676375,69,125935,321,0.0005465086807755671,0.823076923076923
8968,0.9017,4,0,4,676375,69,125939,317,0.0005465086807755671,0.8212435233160622
8969,0.9018,1,0,1,676375,69,125940,316,0.0005465086807755671,0.8207792207792208
8970,0.9019,1,0,1,676375,69,125941,315,0.0005465086807755671,0.8203125
8971,0.902,1,0,1,676375,69,125942,314,0.0005465086807755671,0.8198433420365535
8972,0.9021,2,0,2,676375,69,125944,312,0.0005465086807755671,0.8188976377952756
8973,0.9022,1,0,1,676375,69,125945,311,0.0005465086807755671,0.8184210526315789
8974,0.9024,3,1,3,676376,68,125948,308,0.000538588265112153,0.8191489361702128
8975,0.9027,1,1,1,676377,67,125949,307,0.0005306678494487391,0.820855614973262
8976,0.9028,2,1,2,676378,66,125951,305,0.0005227474337853251,0.8221024258760108
8977,0.9031,2,0,2,676378,66,125953,303,0.0005227474337853251,0.8211382113821138
8978,0.9032,3,1,3,676379,65,125956,300,0.000514827018121911,0.821917808219178
8979,0.9035,2,0,2,676379,65,125958,298,0.000514827018121911,0.8209366391184573
8980,0.9037,1,0,1,676379,65,125959,297,0.000514827018121911,0.8204419889502762
8981,0.904,3,0,3,676379,65,125962,294,0.000514827018121911,0.8189415041782729
8982,0.9042,2,0,2,676379,65,125964,292,0.000514827018121911,0.8179271708683473
8983,0.9044,0,1,0,676380,64,125964,292,0.000506906602458497,0.8202247191011236
8984,0.9045,1,1,1,676381,63,125965,291,0.000498986186795083,0.8220338983050848
8985,0.9046,2,0,2,676381,63,125967,289,0.000498986186795083,0.8210227272727273
8986,0.9047,1,0,1,676381,63,125968,288,0.000498986186795083,0.8205128205128205
8987,0.9048,1,0,1,676381,63,125969,287,0.000498986186795083,0.82
8988,0.9049,1,0,1,676381,63,125970,286,0.000498986186795083,0.8194842406876791
8989,0.905,1,0,1,676381,63,125971,285,0.000498986186795083,0.8189655172413793
8990,0.9051,3,0,3,676381,63,125974,282,0.000498986186795083,0.8173913043478261
8991,0.9052,2,0,2,676381,63,125976,280,0.000498986186795083,0.8163265306122449
8992,0.9054,1,0,1,676381,63,125977,279,0.000498986186795083,0.8157894736842105
8993,0.9055,0,1,0,676382,62,125977,279,0.000491065771131669,0.8181818181818182
8994,0.9056,0,1,0,676383,61,125977,279,0.00048314535546825497,0.8205882352941176
8995,0.9057,1,0,1,676383,61,125978,278,0.00048314535546825497,0.8200589970501475
8996,0.9059,1,0,1,676383,61,125979,277,0.00048314535546825497,0.8195266272189349
8997,0.906,2,1,2,676384,60,125981,275,0.00047522493980484094,0.8208955223880597
8998,0.9061,1,0,1,676384,60,125982,274,0.00047522493980484094,0.8203592814371258
8999,0.9063,2,0,2,676384,60,125984,272,0.00047522493980484094,0.8192771084337349
9000,0.9064,1,0,1,676384,60,125985,271,0.00047522493980484094,0.8187311178247734
9001,0.9066,1,1,1,676385,59,125986,270,0.00046730452414142697,0.8206686930091185
9002,0.9069,1,0,1,676385,59,125987,269,0.00046730452414142697,0.8201219512195121
9003,0.907,1,0,1,676385,59,125988,268,0.00046730452414142697,0.8195718654434251
9004,0.9071,1,0,1,676385,59,125989,267,0.00046730452414142697,0.8190184049079755
9005,0.9072,1,0,1,676385,59,125990,266,0.00046730452414142697,0.8184615384615385
9006,0.9075,1,0,1,676385,59,125991,265,0.00046730452414142697,0.8179012345679012
9007,0.9076,1,0,1,676385,59,125992,264,0.00046730452414142697,0.8173374613003096
9008,0.9077,2,0,2,676385,59,125994,262,0.00046730452414142697,0.8161993769470405
9009,0.9079,1,0,1,676385,59,125995,261,0.00046730452414142697,0.815625
9010,0.908,1,0,1,676385,59,125996,260,0.00046730452414142697,0.8150470219435737
9011,0.9081,1,0,1,676385,59,125997,259,0.00046730452414142697,0.8144654088050315
9012,0.9082,1,0,1,676385,59,125998,258,0.00046730452414142697,0.8138801261829653
9013,0.9085,0,1,0,676386,58,125998,258,0.00045938410847801294,0.8164556962025317
9014,0.9086,1,0,1,676386,58,125999,257,0.00045938410847801294,0.8158730158730159
9015,0.9087,1,1,1,676387,57,126000,256,0.0004514636928145989,0.8178913738019169
9016,0.9089,3,0,3,676387,57,126003,253,0.0004514636928145989,0.8161290322580645
9017,0.9091,1,0,1,676387,57,126004,252,0.0004514636928145989,0.8155339805825242
9018,0.9092,3,0,3,676387,57,126007,249,0.0004514636928145989,0.8137254901960784
9019,0.9093,1,0,1,676387,57,126008,248,0.0004514636928145989,0.8131147540983606
9020,0.9094,1,0,1,676387,57,126009,247,0.0004514636928145989,0.8125
9021,0.9095,2,1,2,676388,56,126011,245,0.0004435432771511849,0.813953488372093
9022,0.9096,1,1,1,676389,55,126012,244,0.00043562286148777086,0.8160535117056856
9023,0.9097,3,0,3,676389,55,126015,241,0.00043562286148777086,0.8141891891891891
9024,0.9098,1,0,1,676389,55,126016,240,0.00043562286148777086,0.8135593220338984
9025,0.9099,1,0,1,676389,55,126017,239,0.00043562286148777086,0.8129251700680272
9026,0.9101,1,0,1,676389,55,126018,238,0.00043562286148777086,0.8122866894197952
9027,0.9104,2,1,2,676390,54,126020,236,0.0004277024458243569,0.8137931034482758
9028,0.9105,3,1,3,676391,53,126023,233,0.00041978203016094286,0.8146853146853147
9029,0.9106,1,0,1,676391,53,126024,232,0.00041978203016094286,0.8140350877192982
9030,0.9107,1,1,1,676392,52,126025,231,0.00041186161449752884,0.8162544169611308
9031,0.9108,1,1,1,676393,51,126026,230,0.0004039411988341148,0.8185053380782918
9032,0.911,2,0,2,676393,51,126028,228,0.0004039411988341148,0.8172043010752689
9033,0.9111,2,1,2,676394,50,126030,226,0.0003960207831707008,0.8188405797101449
9034,0.9112,0,1,0,676395,49,126030,226,0.00038810036750728676,0.8218181818181818
9035,0.9113,0,1,0,676396,48,126030,226,0.0003801799518438728,0.8248175182481752
9036,0.9115,2,0,2,676396,48,126032,224,0.0003801799518438728,0.8235294117647058
9037,0.9116,0,1,0,676397,47,126032,224,0.00037225953618045876,0.8265682656826568
9038,0.9117,1,0,1,676397,47,126033,223,0.00037225953618045876,0.825925925925926
9039,0.9119,1,0,1,676397,47,126034,222,0.00037225953618045876,0.8252788104089219
9040,0.912,2,0,2,676397,47,126036,220,0.00037225953618045876,0.8239700374531835
9041,0.9121,1,0,1,676397,47,126037,219,0.00037225953618045876,0.8233082706766918
9042,0.9122,1,1,1,676398,46,126038,218,0.00036433912051704473,0.8257575757575758
9043,0.9123,1,1,1,676399,45,126039,217,0.0003564187048536307,0.8282442748091603
9044,0.9126,1,0,1,676399,45,126040,216,0.0003564187048536307,0.8275862068965517
9045,0.9127,2,1,2,676400,44,126042,214,0.0003484982891902167,0.8294573643410853
9046,0.9128,1,0,1,676400,44,126043,213,0.0003484982891902167,0.8287937743190662
9047,0.9132,1,0,1,676400,44,126044,212,0.0003484982891902167,0.828125
9048,0.9133,2,0,2,676400,44,126046,210,0.0003484982891902167,0.8267716535433071
9049,0.9134,1,0,1,676400,44,126047,209,0.0003484982891902167,0.8260869565217391
9050,0.9135,1,0,1,676400,44,126048,208,0.0003484982891902167,0.8253968253968254
9051,0.9136,2,0,2,676400,44,126050,206,0.0003484982891902167,0.824
9052,0.9137,0,1,0,676401,43,126050,206,0.0003405778735268027,0.8273092369477911
9053,0.9139,1,0,1,676401,43,126051,205,0.0003405778735268027,0.8266129032258065
9054,0.9141,1,0,1,676401,43,126052,204,0.0003405778735268027,0.8259109311740891
9055,0.9142,1,1,1,676402,42,126053,203,0.0003326574578633887,0.8285714285714286
9056,0.9146,2,0,2,676402,42,126055,201,0.0003326574578633887,0.8271604938271605
9057,0.9147,2,0,2,676402,42,126057,199,0.0003326574578633887,0.8257261410788381
9058,0.9148,1,0,1,676402,42,126058,198,0.0003326574578633887,0.825
9059,0.915,1,0,1,676402,42,126059,197,0.0003326574578633887,0.8242677824267782
9060,0.9151,0,1,0,676403,41,126059,197,0.00032473704219997465,0.8277310924369747
9061,0.9154,2,0,2,676403,41,126061,195,0.00032473704219997465,0.826271186440678
9062,0.9155,1,0,1,676403,41,126062,194,0.00032473704219997465,0.825531914893617
9063,0.9157,1,0,1,676403,41,126063,193,0.00032473704219997465,0.8247863247863247
9064,0.9159,2,0,2,676403,41,126065,191,0.00032473704219997465,0.8232758620689655
9065,0.9161,0,1,0,676404,40,126065,191,0.0003168166265365606,0.8268398268398268
9066,0.9164,1,0,1,676404,40,126066,190,0.0003168166265365606,0.8260869565217391
9067,0.9165,1,0,1,676404,40,126067,189,0.0003168166265365606,0.8253275109170306
9068,0.9169,1,1,1,676405,39,126068,188,0.0003088962108731466,0.8281938325991189
9069,0.917,3,0,3,676405,39,126071,185,0.0003088962108731466,0.8258928571428571
9070,0.9172,1,0,1,676405,39,126072,184,0.0003088962108731466,0.8251121076233184
9071,0.9175,3,1,3,676406,38,126075,181,0.00030097579520973263,0.8264840182648402
9072,0.9177,1,1,1,676407,37,126076,180,0.0002930553795463186,0.8294930875576036
9073,0.9181,1,0,1,676407,37,126077,179,0.0002930553795463186,0.8287037037037037
9074,0.9182,1,0,1,676407,37,126078,178,0.0002930553795463186,0.827906976744186
9075,0.9183,2,0,2,676407,37,126080,176,0.0002930553795463186,0.8262910798122066
9076,0.9184,2,0,2,676407,37,126082,174,0.0002930553795463186,0.8246445497630331
9077,0.9186,1,0,1,676407,37,126083,173,0.0002930553795463186,0.8238095238095238
9078,0.9188,0,1,0,676408,36,126083,173,0.0002851349638829046,0.8277511961722488
9079,0.919,1,0,1,676408,36,126084,172,0.0002851349638829046,0.8269230769230769
9080,0.9191,1,1,1,676409,35,126085,171,0.00027721454821949055,0.8300970873786407
9081,0.9193,0,1,0,676410,34,126085,171,0.0002692941325560765,0.8341463414634146
9082,0.9194,2,0,2,676410,34,126087,169,0.0002692941325560765,0.8325123152709359
9083,0.9195,3,0,3,676410,34,126090,166,0.0002692941325560765,0.83
9084,0.9196,1,0,1,676410,34,126091,165,0.0002692941325560765,0.8291457286432161
9085,0.9198,1,0,1,676410,34,126092,164,0.0002692941325560765,0.8282828282828283
9086,0.9199,1,0,1,676410,34,126093,163,0.0002692941325560765,0.8274111675126904
9087,0.9203,1,0,1,676410,34,126094,162,0.0002692941325560765,0.826530612244898
9088,0.9205,1,0,1,676410,34,126095,161,0.0002692941325560765,0.8256410256410256
9089,0.9209,2,0,2,676410,34,126097,159,0.0002692941325560765,0.8238341968911918
9090,0.921,1,1,1,676411,33,126098,158,0.00026137371689266255,0.8272251308900523
9091,0.9211,1,0,1,676411,33,126099,157,0.00026137371689266255,0.8263157894736842
9092,0.9212,0,1,0,676412,32,126099,157,0.0002534533012292485,0.8306878306878307
9093,0.9213,0,1,0,676413,31,126099,157,0.0002455328855658345,0.8351063829787234
9094,0.9214,2,0,2,676413,31,126101,155,0.0002455328855658345,0.8333333333333334
9095,0.9215,2,0,2,676413,31,126103,153,0.0002455328855658345,0.8315217391304348
9096,0.922,3,0,3,676413,31,126106,150,0.0002455328855658345,0.8287292817679558
9097,0.9222,2,0,2,676413,31,126108,148,0.0002455328855658345,0.8268156424581006
9098,0.9223,1,0,1,676413,31,126109,147,0.0002455328855658345,0.8258426966292135
9099,0.9224,0,2,0,676415,29,126109,147,0.00022969205423900647,0.8352272727272727
9100,0.9225,2,0,2,676415,29,126111,145,0.00022969205423900647,0.8333333333333334
9101,0.9227,0,1,0,676416,28,126111,145,0.00022177163857559244,0.838150289017341
9102,0.923,2,0,2,676416,28,126113,143,0.00022177163857559244,0.8362573099415205
9103,0.9233,0,1,0,676417,27,126113,143,0.00021385122291217844,0.8411764705882353
9104,0.9234,2,0,2,676417,27,126115,141,0.00021385122291217844,0.8392857142857143
9105,0.9237,1,1,1,676418,26,126116,140,0.00020593080724876442,0.8433734939759037
9106,0.9238,1,0,1,676418,26,126117,139,0.00020593080724876442,0.8424242424242424
9107,0.924,1,0,1,676418,26,126118,138,0.00020593080724876442,0.8414634146341463
9108,0.9241,1,1,1,676419,25,126119,137,0.0001980103915853504,0.845679012345679
9109,0.9242,3,0,3,676419,25,126122,134,0.0001980103915853504,0.8427672955974843
9110,0.9243,2,0,2,676419,25,126124,132,0.0001980103915853504,0.8407643312101911
9111,0.9245,4,1,4,676420,24,126128,128,0.0001900899759219364,0.8421052631578947
9112,0.9247,3,1,3,676421,23,126131,125,0.00018216956025852237,0.8445945945945946
9113,0.9251,1,1,1,676422,22,126132,124,0.00017424914459510834,0.8493150684931506
9114,0.9252,1,0,1,676422,22,126133,123,0.00017424914459510834,0.8482758620689655
9115,0.9253,1,0,1,676422,22,126134,122,0.00017424914459510834,0.8472222222222222
9116,0.9254,1,0,1,676422,22,126135,121,0.00017424914459510834,0.8461538461538461
9117,0.9256,2,0,2,676422,22,126137,119,0.00017424914459510834,0.8439716312056738
9118,0.9259,0,1,0,676423,21,126137,119,0.00016632872893169434,0.85
9119,0.9262,1,0,1,676423,21,126138,118,0.00016632872893169434,0.8489208633093526
9120,0.9263,1,0,1,676423,21,126139,117,0.00016632872893169434,0.8478260869565217
9121,0.9265,1,0,1,676423,21,126140,116,0.00016632872893169434,0.8467153284671532
9122,0.9267,2,0,2,676423,21,126142,114,0.00016632872893169434,0.8444444444444444
9123,0.9269,1,1,1,676424,20,126143,113,0.0001584083132682803,0.849624060150376
9124,0.9271,1,0,1,676424,20,126144,112,0.0001584083132682803,0.8484848484848485
9125,0.9277,1,0,1,676424,20,126145,111,0.0001584083132682803,0.8473282442748091
9126,0.9279,1,0,1,676424,20,126146,110,0.0001584083132682803,0.8461538461538461
9127,0.928,1,0,1,676424,20,126147,109,0.0001584083132682803,0.8449612403100775
9128,0.9281,1,0,1,676424,20,126148,108,0.0001584083132682803,0.84375
9129,0.9282,2,0,2,676424,20,126150,106,0.0001584083132682803,0.8412698412698413
9130,0.9283,1,0,1,676424,20,126151,105,0.0001584083132682803,0.84
9131,0.9286,2,0,2,676424,20,126153,103,0.0001584083132682803,0.8373983739837398
9132,0.9294,1,0,1,676424,20,126154,102,0.0001584083132682803,0.8360655737704918
9133,0.9296,1,0,1,676424,20,126155,101,0.0001584083132682803,0.8347107438016529
9134,0.9297,3,0,3,676424,20,126158,98,0.0001584083132682803,0.8305084745762712
9135,0.9299,1,0,1,676424,20,126159,97,0.0001584083132682803,0.8290598290598291
9136,0.93,1,0,1,676424,20,126160,96,0.0001584083132682803,0.8275862068965517
9137,0.9301,2,0,2,676424,20,126162,94,0.0001584083132682803,0.8245614035087719
9138,0.9302,0,1,0,676425,19,126162,94,0.00015048789760486631,0.831858407079646
9139,0.9303,1,0,1,676425,19,126163,93,0.00015048789760486631,0.8303571428571429
9140,0.9305,2,0,2,676425,19,126165,91,0.00015048789760486631,0.8272727272727273
9141,0.9306,1,0,1,676425,19,126166,90,0.00015048789760486631,0.8256880733944955
9142,0.9308,1,0,1,676425,19,126167,89,0.00015048789760486631,0.8240740740740741
9143,0.9309,1,0,1,676425,19,126168,88,0.00015048789760486631,0.822429906542056
9144,0.931,1,0,1,676425,19,126169,87,0.00015048789760486631,0.8207547169811321
9145,0.9312,1,0,1,676425,19,126170,86,0.00015048789760486631,0.819047619047619
9146,0.9315,1,0,1,676425,19,126171,85,0.00015048789760486631,0.8173076923076923
9147,0.9323,1,0,1,676425,19,126172,84,0.00015048789760486631,0.8155339805825242
9148,0.9325,3,0,3,676425,19,126175,81,0.00015048789760486631,0.81
9149,0.933,2,1,2,676426,18,126177,79,0.0001425674819414523,0.8144329896907216
9150,0.9331,1,0,1,676426,18,126178,78,0.0001425674819414523,0.8125
9151,0.9332,1,0,1,676426,18,126179,77,0.0001425674819414523,0.8105263157894737
9152,0.9333,1,1,1,676427,17,126180,76,0.00013464706627803826,0.8172043010752689
9153,0.9335,1,0,1,676427,17,126181,75,0.00013464706627803826,0.8152173913043478
9154,0.9336,1,0,1,676427,17,126182,74,0.00013464706627803826,0.8131868131868132
9155,0.9338,0,1,0,676428,16,126182,74,0.00012672665061462426,0.8222222222222222
9156,0.9339,1,0,1,676428,16,126183,73,0.00012672665061462426,0.8202247191011236
9157,0.9344,1,0,1,676428,16,126184,72,0.00012672665061462426,0.8181818181818182
9158,0.9346,1,0,1,676428,16,126185,71,0.00012672665061462426,0.8160919540229885
9159,0.9352,1,0,1,676428,16,126186,70,0.00012672665061462426,0.813953488372093
9160,0.9353,1,1,1,676429,15,126187,69,0.00011880623495121023,0.8214285714285714
9161,0.9357,1,0,1,676429,15,126188,68,0.00011880623495121023,0.8192771084337349
9162,0.9361,1,0,1,676429,15,126189,67,0.00011880623495121023,0.8170731707317073
9163,0.9363,1,0,1,676429,15,126190,66,0.00011880623495121023,0.8148148148148148
9164,0.9364,1,0,1,676429,15,126191,65,0.00011880623495121023,0.8125
9165,0.9366,1,0,1,676429,15,126192,64,0.00011880623495121023,0.810126582278481
9166,0.937,1,0,1,676429,15,126193,63,0.00011880623495121023,0.8076923076923077
9167,0.9372,1,0,1,676429,15,126194,62,0.00011880623495121023,0.8051948051948052
9168,0.9379,0,1,0,676430,14,126194,62,0.00011088581928779622,0.8157894736842105
9169,0.9387,0,1,0,676431,13,126194,62,0.00010296540362438221,0.8266666666666667
9170,0.9388,1,0,1,676431,13,126195,61,0.00010296540362438221,0.8243243243243243
9171,0.9391,0,1,0,676432,12,126195,61,9.50449879609682e-05,0.8356164383561644
9172,0.9393,2,0,2,676432,12,126197,59,9.50449879609682e-05,0.8309859154929577
9173,0.9399,1,0,1,676432,12,126198,58,9.50449879609682e-05,0.8285714285714286
9174,0.9402,1,0,1,676432,12,126199,57,9.50449879609682e-05,0.8260869565217391
9175,0.9408,1,0,1,676432,12,126200,56,9.50449879609682e-05,0.8235294117647058
9176,0.9409,1,0,1,676432,12,126201,55,9.50449879609682e-05,0.8208955223880597
9177,0.941,1,0,1,676432,12,126202,54,9.50449879609682e-05,0.8181818181818182
9178,0.9411,2,0,2,676432,12,126204,52,9.50449879609682e-05,0.8125
9179,0.9414,1,1,1,676433,11,126205,51,8.712457229755417e-05,0.8225806451612904
9180,0.9417,0,1,0,676434,10,126205,51,7.920415663414016e-05,0.8360655737704918
9181,0.9418,1,0,1,676434,10,126206,50,7.920415663414016e-05,0.8333333333333334
9182,0.942,1,0,1,676434,10,126207,49,7.920415663414016e-05,0.8305084745762712
9183,0.9421,2,0,2,676434,10,126209,47,7.920415663414016e-05,0.8245614035087719
9184,0.943,0,1,0,676435,9,126209,47,7.128374097072614e-05,0.8392857142857143
9185,0.9437,0,1,0,676436,8,126209,47,6.336332530731213e-05,0.8545454545454545
9186,0.9438,1,1,1,676437,7,126210,46,5.544290964389811e-05,0.8679245283018868
9187,0.944,0,1,0,676438,6,126210,46,4.75224939804841e-05,0.8846153846153846
9188,0.9442,1,0,1,676438,6,126211,45,4.75224939804841e-05,0.8823529411764706
9189,0.9443,1,0,1,676438,6,126212,44,4.75224939804841e-05,0.88
9190,0.9444,1,0,1,676438,6,126213,43,4.75224939804841e-05,0.8775510204081632
9191,0.9448,1,0,1,676438,6,126214,42,4.75224939804841e-05,0.875
9192,0.9456,2,0,2,676438,6,126216,40,4.75224939804841e-05,0.8695652173913043
9193,0.9457,1,0,1,676438,6,126217,39,4.75224939804841e-05,0.8666666666666667
9194,0.9459,1,0,1,676438,6,126218,38,4.75224939804841e-05,0.8636363636363636
9195,0.9461,1,0,1,676438,6,126219,37,4.75224939804841e-05,0.8604651162790697
9196,0.9465,1,0,1,676438,6,126220,36,4.75224939804841e-05,0.8571428571428571
9197,0.9471,1,0,1,676438,6,126221,35,4.75224939804841e-05,0.8536585365853658
9198,0.9473,1,0,1,676438,6,126222,34,4.75224939804841e-05,0.85
9199,0.9475,1,0,1,676438,6,126223,33,4.75224939804841e-05,0.8461538461538461
9200,0.9476,1,0,1,676438,6,126224,32,4.75224939804841e-05,0.8421052631578947
9201,0.9492,1,0,1,676438,6,126225,31,4.75224939804841e-05,0.8378378378378378
9202,0.9496,1,0,1,676438,6,126226,30,4.75224939804841e-05,0.8333333333333334
9203,0.9501,2,0,2,676438,6,126228,28,4.75224939804841e-05,0.8235294117647058
9204,0.9508,1,0,1,676438,6,126229,27,4.75224939804841e-05,0.8181818181818182
9205,0.952,1,0,1,676438,6,126230,26,4.75224939804841e-05,0.8125
9206,0.9526,1,0,1,676438,6,126231,25,4.75224939804841e-05,0.8064516129032258
9207,0.9529,1,0,1,676438,6,126232,24,4.75224939804841e-05,0.8
9208,0.9531,2,0,2,676438,6,126234,22,4.75224939804841e-05,0.7857142857142857
9209,0.9542,1,0,1,676438,6,126235,21,4.75224939804841e-05,0.7777777777777778
9210,0.9552,1,0,1,676438,6,126236,20,4.75224939804841e-05,0.7692307692307693
9211,0.9553,1,0,1,676438,6,126237,19,4.75224939804841e-05,0.76
9212,0.9561,0,1,0,676439,5,126237,19,3.960207831707008e-05,0.7916666666666666
9213,0.9571,1,0,1,676439,5,126238,18,3.960207831707008e-05,0.782608695652174
9214,0.9573,0,1,0,676440,4,126238,18,3.1681662653656065e-05,0.8181818181818182
9215,0.9578,1,0,1,676440,4,126239,17,3.1681662653656065e-05,0.8095238095238095
9216,0.9593,1,0,1,676440,4,126240,16,3.1681662653656065e-05,0.8
9217,0.9597,0,1,0,676441,3,126240,16,2.376124699024205e-05,0.8421052631578947
9218,0.9604,1,0,1,676441,3,126241,15,2.376124699024205e-05,0.8333333333333334
9219,0.9606,1,0,1,676441,3,126242,14,2.376124699024205e-05,0.8235294117647058
9220,0.962,0,1,0,676442,2,126242,14,1.5840831326828033e-05,0.875
9221,0.9624,1,0,1,676442,2,126243,13,1.5840831326828033e-05,0.8666666666666667
9222,0.9627,0,1,0,676443,1,126243,13,7.920415663414016e-06,0.9285714285714286
9223,0.9642,1,0,1,676443,1,126244,12,7.920415663414016e-06,0.9230769230769231
9224,0.9646,1,0,1,676443,1,126245,11,7.920415663414016e-06,0.9166666666666666
9225,0.968,1,0,1,676443,1,126246,10,7.920415663414016e-06,0.9090909090909091
9226,0.9699,1,0,1,676443,1,126247,9,7.920415663414016e-06,0.9
9227,0.9714,0,1,0,676444,0,126247,9,0.0,1.0
9228,0.9771,1,0,1,676444,0,126248,8,0.0,1.0
9229,0.9775,1,0,1,676444,0,126249,7,0.0,1.0
9230,0.9776,1,0,1,676444,0,126250,6,0.0,1.0
9231,0.9793,1,0,1,676444,0,126251,5,0.0,1.0
9232,0.9806,1,0,1,676444,0,126252,4,0.0,1.0
9233,0.9824,2,0,2,676444,0,126254,2,0.0,1.0
9234,0.9891,1,0,1,676444,0,126255,1,0.0,1.0
9235,0.9949,1,0,1,676444,0,126256,0,0.0,
