,y_proba,y_test,Neg,Pos,TN,FP,FN,TP,FP/P,Prec
0,0.0,3,194,3,194,676250,3,126253,5.3561810923837285,0.15732402246471353
1,0.002,0,1,0,195,676249,3,126253,5.356173171968065,0.15732421850662054
2,0.0025,0,1,0,196,676248,3,126253,5.356165251552402,0.15732441454901613
3,0.0033,0,10,0,206,676238,3,126253,5.356086047395768,0.15732637499984423
4,0.005,0,13,0,219,676225,3,126253,5.355983081992143,0.15732892365896636
5,0.0057,0,3,0,222,676222,3,126253,5.355959320745153,0.15732951182279822
6,0.006,0,2,0,224,676220,3,126253,5.355943479913826,0.15732990393446258
7,0.0067,0,3,0,227,676217,3,126253,5.3559197186668355,0.1573304921056239
8,0.0075,0,5,0,232,676212,3,126253,5.355880116588518,0.15733147240066545
9,0.008,0,2,0,234,676210,3,126253,5.355864275757192,0.15733186452210257
10,0.0083,0,2,0,236,676208,3,126253,5.355848434925865,0.1573322566454943
11,0.0088,0,1,0,237,676207,3,126253,5.355840514510201,0.15733245270792315
12,0.01,6,246,6,483,675961,9,126247,5.353892092257001,0.15737439666520403
13,0.0111,1,3,1,486,675958,10,126246,5.353868331010012,0.15737393480959955
14,0.0115,0,4,0,490,675954,10,126246,5.3538366493473575,0.15737471952131638
15,0.012,0,4,0,494,675950,10,126246,5.353804967684704,0.15737550424085883
16,0.0125,0,4,0,498,675946,10,126246,5.353773286022051,0.15737628896822706
17,0.0127,0,1,0,499,675945,10,126246,5.353765365606387,0.1573764851512919
18,0.0129,0,2,0,501,675943,10,126246,5.35374952477506,0.15737687751888893
19,0.0133,1,26,1,527,675917,11,126245,5.353543593967811,0.15738092804196657
20,0.0138,0,1,0,528,675916,11,126245,5.353535673552148,0.1573811242381517
21,0.014,0,11,0,539,675905,11,126245,5.35344854897985,0.15738328242847346
22,0.015,0,35,0,574,675870,11,126245,5.353171334431631,0.15739014979148874
23,0.016,0,14,0,588,675856,11,126245,5.353060448612343,0.15739289690450453
24,0.0167,0,15,0,603,675841,11,126245,5.352941642377392,0.15739584034629703
25,0.0175,0,8,0,611,675833,11,126245,5.352878279052085,0.15739741022693554
26,0.0179,0,8,0,619,675825,11,126245,5.3528149157267775,0.15739898013889062
27,0.0183,0,2,0,621,675823,11,126245,5.352799074895451,0.15739937262177273
28,0.019,0,1,0,622,675822,11,126245,5.352791154479787,0.15739956886394776
29,0.0192,0,4,0,626,675818,11,126245,5.352759472817134,0.15740035383754145
30,0.02,8,424,8,1050,675394,19,126237,5.3494012165758456,0.1574751974412167
31,0.0207,0,1,0,1051,675393,19,126237,5.349393296160183,0.1574753938849594
32,0.0208,0,1,0,1052,675392,19,126237,5.349385375744519,0.15747559032919217
33,0.021,0,4,0,1056,675388,19,126237,5.349353694081866,0.15747637611102447
34,0.0214,0,1,0,1057,675387,19,126237,5.349345773666202,0.15747657255770786
35,0.0215,0,6,0,1063,675381,19,126237,5.349298251172222,0.1574777512481007
36,0.0217,0,10,0,1073,675371,19,126237,5.349219047015588,0.15747971577129968
37,0.022,0,1,0,1074,675370,19,126237,5.349211126599924,0.15747991222631538
38,0.0225,1,13,1,1087,675357,20,126236,5.349108161196299,0.15748141513211816
39,0.0229,0,1,0,1088,675356,20,126236,5.349100240780636,0.15748161159293006
40,0.023,0,1,0,1089,675355,20,126236,5.3490923203649725,0.15748180805423215
41,0.0233,2,47,2,1136,675308,22,126234,5.348720060828792,0.1574889400680189
42,0.0237,0,1,0,1137,675307,22,126234,5.348712140413129,0.15748913655071917
43,0.024,0,13,0,1150,675294,22,126234,5.348609175009504,0.15749169087043746
44,0.0242,0,1,0,1151,675293,22,126234,5.3486012545938415,0.1574918873600016
45,0.0248,0,4,0,1155,675289,22,126234,5.348569572931187,0.15749267332316103
46,0.025,1,62,1,1217,675227,23,126233,5.348078507160055,0.15750380555486237
47,0.0253,1,2,1,1219,675225,24,126232,5.348062666328729,0.15750314739281085
48,0.0255,0,2,0,1221,675223,24,126232,5.348046825497402,0.15750354043583234
49,0.0256,1,1,1,1222,675222,25,126231,5.348038905081738,0.15750268574701198
50,0.0257,0,2,0,1224,675220,25,126231,5.348023064250412,0.1575030787908431
51,0.0258,0,2,0,1226,675218,25,126231,5.348007223419085,0.1575034718366359
52,0.026,0,6,0,1232,675212,25,126231,5.347959700925105,0.1575046509857844
53,0.0267,0,24,0,1256,675188,25,126231,5.347769610949182,0.1575093677589376
54,0.027,0,2,0,1258,675186,25,126231,5.347753770117856,0.15750976083611903
55,0.0271,0,1,0,1259,675185,25,126231,5.347745849702193,0.15750995737544546
56,0.0272,0,3,0,1262,675182,25,126231,5.347722088455202,0.15751054699636766
57,0.0275,0,11,0,1273,675171,25,126231,5.347634963882904,0.1575127089775169
58,0.0277,0,1,0,1274,675170,25,126231,5.3476270434672415,0.15751290552420075
59,0.0278,0,2,0,1276,675168,25,126231,5.347611202635914,0.15751329861903995
60,0.028,0,3,0,1279,675165,25,126231,5.347587441388924,0.15751388826497761
61,0.0283,1,17,1,1296,675148,26,126230,5.347452794322646,0.15751617838273574
62,0.0289,0,3,0,1299,675145,26,126230,5.347429033075656,0.15751676805490564
63,0.029,0,1,0,1300,675144,26,126230,5.347421112659992,0.1575169646132767
64,0.0293,0,1,0,1301,675143,26,126230,5.347413192244329,0.15751716117213832
65,0.03,16,640,16,1941,674503,42,126214,5.342344126219744,0.15762622749360886
66,0.0305,0,2,0,1943,674501,42,126214,5.342328285388417,0.15762662120729598
67,0.0308,0,6,0,1949,674495,42,126214,5.342280762894437,0.1576278023601583
68,0.0309,0,2,0,1951,674493,42,126214,5.3422649220631095,0.15762819608171277
69,0.031,0,1,0,1952,674492,42,126214,5.342257001647447,0.1576283929432276
70,0.0312,1,7,1,1959,674485,43,126213,5.342201558737803,0.15762871894272248
71,0.0313,0,1,0,1960,674484,43,126213,5.342193638322139,0.15762891580710306
72,0.0315,0,2,0,1962,674482,43,126213,5.3421777974908125,0.15762930953733945
73,0.0317,1,11,1,1973,674471,44,126212,5.3420906729185145,0.15763042302634125
74,0.032,0,7,0,1980,674464,44,126212,5.342035230008871,0.1576318011280468
75,0.0323,0,1,0,1981,674463,44,126212,5.342027309593208,0.1576319980016861
76,0.0325,2,26,2,2007,674437,46,126210,5.3418213787859585,0.15763501268349223
77,0.0327,0,3,0,2010,674434,46,126210,5.341797617538968,0.15763560333931184
78,0.0328,0,2,0,2012,674432,46,126210,5.341781776707641,0.15763599711231738
79,0.0333,2,46,2,2058,674386,48,126208,5.341417437587125,0.15764295010954366
80,0.0338,0,4,0,2062,674382,48,126208,5.341385755924471,0.15764373774341423
81,0.034,1,11,1,2073,674371,49,126207,5.341298631352173,0.1576448515947228
82,0.0342,0,4,0,2077,674367,49,126207,5.34126694968952,0.15764563925383537
83,0.0343,0,1,0,2078,674366,49,126207,5.341259029273856,0.15764583616984335
84,0.035,3,95,3,2173,674271,52,126204,5.340506589785832,0.15766138855054812
85,0.0355,0,2,0,2175,674269,52,126204,5.3404907489545055,0.15766178247111395
86,0.0356,0,7,0,2182,674262,52,126204,5.340435306044861,0.157663161208596
87,0.0357,0,3,0,2185,674259,52,126204,5.340411544797871,0.1576637521034701
88,0.0358,0,2,0,2187,674257,52,126204,5.340395703966544,0.15766414603584683
89,0.036,0,22,0,2209,674235,52,126204,5.340221454821949,0.15766847942191722
90,0.0362,0,4,0,2213,674231,52,126204,5.340189773159295,0.1576692673358861
91,0.0367,0,47,0,2260,674184,52,126204,5.339817513623115,0.15767852591493126
92,0.037,0,4,0,2264,674180,52,126204,5.339785831960461,0.15767931392931392
93,0.0375,1,17,1,2281,674163,53,126203,5.3396511848941834,0.1576816106631216
94,0.0376,0,2,0,2283,674161,53,126203,5.339635344062857,0.15768200468786703
95,0.0377,0,1,0,2284,674160,53,126203,5.339627423647193,0.1576822017009782
96,0.038,0,4,0,2288,674156,53,126203,5.33959574198454,0.15768298975834594
97,0.0381,0,1,0,2289,674155,53,126203,5.339587821568876,0.15768318677391868
98,0.0382,0,6,0,2295,674149,53,126203,5.339540299074895,0.15768436887769383
99,0.0383,0,17,0,2312,674132,53,126203,5.339405652008617,0.15768771826797529
100,0.0385,1,1,1,2313,674131,54,126202,5.339397731592954,0.15768686284334146
101,0.0388,0,1,0,2314,674130,54,126202,5.33938981117729,0.15768705987015388
102,0.0389,0,1,0,2315,674129,54,126202,5.3393818907616275,0.1576872568974587
103,0.0392,1,6,1,2321,674123,55,126201,5.339334368267647,0.1576873866084236
104,0.0393,0,5,0,2326,674118,55,126201,5.3392947661893295,0.15768837176176
105,0.0394,0,3,0,2329,674115,55,126201,5.339271004942339,0.15768896285967043
106,0.0395,0,1,0,2330,674114,55,126201,5.339263084526676,0.15768915989329202
107,0.04,20,847,20,3177,673267,75,126181,5.3325544924597645,0.15783515625781788
108,0.0401,0,1,0,3178,673266,75,126181,5.332546572044101,0.157835353688237
109,0.0403,0,4,0,3182,673262,75,126181,5.332514890381447,0.15783614341485258
110,0.0405,0,1,0,3183,673261,75,126181,5.332506969965784,0.1578363408477413
111,0.0407,0,9,0,3192,673252,75,126181,5.332435686224813,0.15783811776596662
112,0.0408,0,13,0,3205,673239,75,126181,5.332332720821189,0.1578406844962598
113,0.041,0,5,0,3210,673234,75,126181,5.3322931187428715,0.15784167172244704
114,0.0413,0,1,0,3211,673233,75,126181,5.332285198327209,0.15784186916916643
115,0.0414,0,3,0,3214,673230,75,126181,5.332261437080218,0.15784246151228842
116,0.0415,0,3,0,3217,673227,75,126181,5.332237675833228,0.15784305385985628
117,0.0417,0,14,0,3231,673213,75,126181,5.33212679001394,0.15784581820729202
118,0.042,1,11,1,3242,673202,76,126180,5.332039665441642,0.15784693675864606
119,0.0423,0,6,0,3248,673196,76,126180,5.331992142947662,0.15784812153479713
120,0.0424,0,6,0,3254,673190,76,126180,5.331944620453681,0.15784930632873387
121,0.0425,1,46,1,3300,673144,77,126179,5.3315802813331645,0.15785733677124267
122,0.0427,0,5,0,3305,673139,77,126179,5.331540679254847,0.15785832422139875
123,0.0429,0,6,0,3311,673133,77,126179,5.3314931567608665,0.157859509177893
124,0.043,0,1,0,3312,673132,77,126179,5.331485236345204,0.1578597066723716
125,0.0432,0,1,0,3313,673131,77,126179,5.33147731592954,0.15785990416734433
126,0.0433,2,95,2,3408,673036,79,126177,5.330724876441516,0.1578765610669496
127,0.0438,0,1,0,3409,673035,79,126177,5.330716956025852,0.1578767586072281
128,0.044,1,12,1,3421,673023,80,126176,5.330621911037891,0.1578780754230173
129,0.0442,1,7,1,3428,673016,81,126175,5.330566468128247,0.15787840453658764
130,0.0443,0,2,0,3430,673014,81,126175,5.330550627296921,0.1578787996331281
131,0.0444,0,3,0,3433,673011,81,126175,5.33052686604993,0.15787939228164657
132,0.0447,0,1,0,3434,673010,81,126175,5.3305189456342665,0.15787958983214148
133,0.0448,0,1,0,3435,673009,81,126175,5.330511025218604,0.1578797873831308
134,0.045,5,136,5,3571,672873,86,126170,5.329433848688379,0.15790138953723393
135,0.0451,0,3,0,3574,672870,86,126170,5.3294100874413886,0.15790198237885464
136,0.0453,0,2,0,3576,672868,86,126170,5.329394246610062,0.1579023776090749
137,0.0454,0,1,0,3577,672867,86,126170,5.329386326194399,0.157902575224927
138,0.0457,0,4,0,3581,672863,86,126170,5.329354644531745,0.15790336569328176
139,0.0458,0,16,0,3597,672847,86,126170,5.329227917881131,0.15790652764584484
140,0.046,1,19,1,3616,672828,87,126169,5.329077429983526,0.15790922869547697
141,0.0462,0,8,0,3624,672820,87,126169,5.329014066658218,0.15791080978586688
142,0.0463,0,1,0,3625,672819,87,126169,5.329006146242555,0.15791100742439185
143,0.0465,0,4,0,3629,672815,87,126169,5.328974464579901,0.15791179798343896
144,0.0467,2,85,2,3714,672730,89,126167,5.328301229248511,0.1579264911496726
145,0.047,1,4,1,3718,672726,90,126166,5.328269547585857,0.15792622782553836
146,0.0471,0,3,0,3721,672723,90,126166,5.328245786338867,0.15792682087248666
147,0.0473,0,3,0,3724,672720,90,126166,5.328222025091877,0.157927413923889
148,0.0475,1,32,1,3756,672688,91,126165,5.327968571790648,0.15793268598853608
149,0.0476,0,2,0,3758,672686,91,126165,5.32795273095932,0.15793308138814371
150,0.0478,0,2,0,3760,672684,91,126165,5.327936890127994,0.15793347678973121
151,0.0479,1,0,1,3760,672684,92,126164,5.327936890127994,0.1579324226886717
152,0.048,1,8,1,3768,672676,93,126163,5.327873526802686,0.157932950193969
153,0.0481,0,1,0,3769,672675,93,126163,5.327865606387023,0.15793314789732085
154,0.0482,0,1,0,3770,672674,93,126163,5.32785768597136,0.1579333456011677
155,0.0483,1,28,1,3798,672646,94,126162,5.3276359143327845,0.15793782736277054
156,0.0487,0,2,0,3800,672644,94,126162,5.327620073501457,0.1579382227975253
157,0.0488,0,1,0,3801,672643,94,126162,5.327612153085794,0.15793842051564524
158,0.049,0,5,0,3806,672638,94,126162,5.327572551007477,0.1579394091136705
159,0.0492,0,2,0,3808,672636,94,126162,5.32755671017615,0.1579398045563459
160,0.0493,0,2,0,3810,672634,94,126162,5.327540869344824,0.1579402000010015
161,0.0495,0,3,0,3813,672631,94,126162,5.327517108097833,0.1579407931716978
162,0.0498,0,2,0,3815,672629,94,126162,5.3275012672665065,0.15794118862130394
163,0.05,22,1076,22,4891,671553,116,126140,5.318978900012673,0.1581310103009554
164,0.0503,1,4,1,4895,671549,117,126139,5.318947218350019,0.15813074786131923
165,0.0507,0,6,0,4901,671543,117,126139,5.318899695856039,0.15813193728829283
166,0.0508,0,4,0,4905,671539,117,126139,5.318868014193385,0.15813273024954932
167,0.051,0,2,0,4907,671537,117,126139,5.318852173362058,0.15813312673315982
168,0.0511,0,1,0,4908,671536,117,126139,5.318844252946395,0.15813332497571067
169,0.0513,0,2,0,4910,671534,117,126139,5.318828412115068,0.15813372146230348
170,0.0515,0,1,0,4911,671533,117,126139,5.318820491699404,0.15813391970634547
171,0.0517,0,33,0,4944,671500,117,126139,5.318559117982511,0.1581404620385914
172,0.0518,0,1,0,4945,671499,117,126139,5.3185511975668485,0.15814066029953439
173,0.052,1,17,1,4962,671482,118,126138,5.3184165505005705,0.1581429753516712
174,0.0521,0,1,0,4963,671481,118,126138,5.318408630084907,0.15814317362048796
175,0.0522,1,2,1,4965,671479,119,126137,5.31839278925358,0.15814251469378748
176,0.0523,0,1,0,4966,671478,119,126137,5.318384868837916,0.15814271296302101
177,0.0525,0,53,0,5019,671425,119,126137,5.317965086807756,0.15815322194387396
178,0.0527,0,1,0,5020,671424,119,126137,5.317957166392092,0.15815342023995657
179,0.0529,0,2,0,5022,671422,119,126137,5.317941325560765,0.15815381683361357
180,0.053,0,1,0,5023,671421,119,126137,5.317933405145102,0.15815401513118796
181,0.0533,3,83,3,5106,671338,122,126134,5.317276010645038,0.1581673086954777
182,0.0535,0,2,0,5108,671336,122,126134,5.317260169813712,0.15816770536822702
183,0.0537,0,2,0,5110,671334,122,126134,5.317244328982385,0.158168102042966
184,0.0538,0,1,0,5111,671333,122,126134,5.317236408566721,0.1581683003810816
185,0.0539,0,2,0,5113,671331,122,126134,5.3172205677353945,0.1581686970588051
186,0.054,1,25,1,5138,671306,123,126133,5.317022557343809,0.1581726000358648
187,0.0541,0,3,0,5141,671303,123,126133,5.3169987960968195,0.15817319509026428
188,0.0542,0,6,0,5147,671297,123,126133,5.316951273602839,0.15817438521249513
189,0.0543,1,5,1,5152,671292,124,126132,5.3169116715245215,0.15817432131463313
190,0.0545,0,7,0,5159,671285,124,126132,5.316856228614878,0.15817570982309131
191,0.0546,0,1,0,5160,671284,124,126132,5.316848308199214,0.1581759081834325
192,0.0547,1,0,1,5160,671284,125,126131,5.316848308199214,0.15817485249211516
193,0.0548,0,1,0,5161,671283,125,126131,5.316840387783551,0.1581750508518787
194,0.055,6,201,6,5362,671082,131,126125,5.315248384235205,0.15820859575994692
195,0.0553,0,5,0,5367,671077,131,126125,5.315208782156888,0.15820958803414945
196,0.0557,0,7,0,5374,671070,131,126125,5.315153339247244,0.15821097723894403
197,0.0558,2,11,2,5385,671059,133,126123,5.315066214674946,0.15821104841805259
198,0.056,2,16,2,5401,671043,135,126121,5.314939488024332,0.158212111936816
199,0.0561,0,1,0,5402,671042,135,126121,5.314931567608668,0.1582123104057765
200,0.0562,0,4,0,5406,671038,135,126121,5.314899885946015,0.15821310428659777
201,0.0563,0,1,0,5407,671037,135,126121,5.314891965530351,0.15821330275804796
202,0.0564,0,6,0,5413,671031,135,126121,5.31484444303637,0.15821449359720605
203,0.0565,0,3,0,5416,671028,135,126121,5.314820681789381,0.15821508902350753
204,0.0567,5,94,5,5510,670934,140,126116,5.314076162717019,0.15822846747380967
205,0.057,1,4,1,5514,670930,141,126115,5.314044481054366,0.15822820543382118
206,0.0571,0,4,0,5518,670926,141,126115,5.314012799391712,0.1582289995119448
207,0.0573,0,13,0,5531,670913,141,126115,5.313909833988088,0.1582315803208921
208,0.0575,1,53,1,5584,670860,142,126114,5.313490051957927,0.15824104675936732
209,0.0576,0,1,0,5585,670859,142,126114,5.313482131542263,0.15824124531194908
210,0.0577,0,2,0,5587,670857,142,126114,5.313466290710936,0.15824164241860744
211,0.0578,0,3,0,5590,670854,142,126114,5.313442529463947,0.15824223808233204
212,0.0579,0,1,0,5591,670853,142,126114,5.313434609048283,0.15824243663790344
213,0.058,0,7,0,5598,670846,142,126114,5.313379166138639,0.15824382654085525
214,0.0581,0,1,0,5599,670845,142,126114,5.313371245722975,0.15824402510041294
215,0.0582,0,3,0,5602,670842,142,126114,5.313347484475985,0.1582446207820758
216,0.0583,3,33,3,5635,670809,145,126111,5.313086110759093,0.15824800481855142
217,0.0585,0,2,0,5637,670807,145,126111,5.313070269927766,0.15824840196858397
218,0.0587,0,3,0,5640,670804,145,126111,5.313046508680776,0.1582489976973705
219,0.0588,0,1,0,5641,670803,145,126111,5.313038588265112,0.15824919627462938
220,0.059,0,11,0,5652,670792,145,126111,5.312951463692815,0.15825138065736985
221,0.0592,0,10,0,5662,670782,145,126111,5.312872259536181,0.1582533665121917
222,0.0593,0,3,0,5665,670779,145,126111,5.31284849828919,0.1582539622783571
223,0.0594,1,2,1,5667,670777,146,126110,5.3128326574578635,0.1582533031659445
224,0.0595,0,3,0,5670,670774,146,126110,5.312808896210873,0.1582538989363571
225,0.06,29,1322,29,6992,669452,175,126081,5.30233810670384,0.1584861973041973
226,0.0603,0,4,0,6996,669448,175,126081,5.302306425041186,0.1584869941887725
227,0.0606,0,5,0,7001,669443,175,126081,5.302266822962869,0.15848799030576072
228,0.0607,0,3,0,7004,669440,175,126081,5.3022430617158784,0.15848858798196402
229,0.0608,0,12,0,7016,669428,175,126081,5.302148016727918,0.15849097873185597
230,0.061,0,2,0,7018,669426,175,126081,5.302132175896591,0.15849137719718367
231,0.0612,0,2,0,7020,669424,175,126081,5.302116335065264,0.158491775664515
232,0.0613,0,1,0,7021,669423,175,126081,5.3021084146496005,0.158491974898932
233,0.0614,0,5,0,7026,669418,175,126081,5.302068812571283,0.15849297107853058
234,0.0617,0,58,0,7084,669360,175,126081,5.301609428462806,0.15850452767709988
235,0.0618,0,1,0,7085,669359,175,126081,5.301601508047142,0.1585047269435784
236,0.062,0,19,0,7104,669340,175,126081,5.301451020149537,0.1585085131018668
237,0.0622,0,1,0,7105,669339,175,126081,5.301443099733874,0.15850871237836614
238,0.0623,0,2,0,7107,669337,175,126081,5.301427258902547,0.158509110932868
239,0.0625,1,59,1,7166,669278,176,126080,5.300959954378405,0.1585198112045142
240,0.0626,0,1,0,7167,669277,176,126080,5.3009520339627425,0.15852001051100323
241,0.0627,0,11,0,7178,669266,176,126080,5.3008649093904445,0.15852220291546068
242,0.0628,0,6,0,7184,669260,176,126080,5.3008173868964645,0.15852339879799834
243,0.0629,0,1,0,7185,669259,176,126080,5.300809466480801,0.15852359811350883
244,0.063,0,2,0,7187,669257,176,126080,5.300793625649474,0.15852399674603343
245,0.0631,0,1,0,7188,669256,176,126080,5.30078570523381,0.15852419606304757
246,0.0632,0,1,0,7189,669255,176,126080,5.300777784818147,0.1585243953805629
247,0.0633,3,94,3,7283,669161,179,126077,5.300033265745786,0.15853995910658192
248,0.0634,0,1,0,7284,669160,179,126077,5.3000253453301225,0.1585401584684817
249,0.0635,0,1,0,7285,669159,179,126077,5.30001742491446,0.1585403578308829
250,0.0636,0,2,0,7287,669157,179,126077,5.300001584083133,0.15854075655718947
251,0.0638,0,2,0,7289,669155,179,126077,5.299985743251806,0.15854115528550158
252,0.0639,0,1,0,7290,669154,179,126077,5.2999778228361425,0.15854135465040975
253,0.064,0,17,0,7307,669137,179,126077,5.2998431757698645,0.1585447439305646
254,0.0642,1,9,1,7316,669128,180,126076,5.299771892028894,0.15854548015352035
255,0.0643,1,2,1,7318,669126,181,126075,5.2997560511975665,0.15854482074343468
256,0.0645,0,1,0,7319,669125,181,126075,5.299748130781904,0.15854502012072436
257,0.0647,0,4,0,7323,669121,181,126075,5.299716449119249,0.15854581763489756
258,0.0648,0,5,0,7328,669116,181,126075,5.299676847040932,0.15854681453889694
259,0.065,6,266,6,7594,668850,187,126069,5.297570016474465,0.15859351707532465
260,0.0652,1,3,1,7597,668847,188,126068,5.297546255227474,0.15859305711931465
261,0.0653,0,1,0,7598,668846,188,126068,5.297538334811811,0.158593256629019
262,0.0654,0,3,0,7601,668843,188,126068,5.297514573564821,0.15859385516114383
263,0.0656,0,2,0,7603,668841,188,126068,5.2974987327334935,0.15859425418507023
264,0.0657,0,9,0,7612,668832,188,126068,5.297427448992523,0.15859604981758713
265,0.0658,0,12,0,7624,668820,188,126068,5.297332404004562,0.1585984440575276
266,0.066,1,24,1,7648,668796,189,126067,5.29714231402864,0.15860217421115336
267,0.0662,0,3,0,7651,668793,189,126067,5.29711855278165,0.15860277281533855
268,0.0663,0,3,0,7654,668790,189,126067,5.29709479153466,0.15860337142404232
269,0.0665,1,5,1,7659,668785,190,126066,5.2970551894563425,0.1586033105575762
270,0.0666,0,1,0,7660,668784,190,126066,5.29704726904068,0.15860351009624457
271,0.0667,6,124,6,7784,668660,196,126060,5.296065137498416,0.15862190457016306
272,0.067,1,4,1,7788,668656,197,126059,5.2960334558357625,0.1586216442372423
273,0.0671,0,4,0,7792,668652,197,126059,5.296001774173108,0.15862244262379657
274,0.0673,0,12,0,7804,668640,197,126059,5.295906729185147,0.15862483783168219
275,0.0675,3,64,3,7868,668576,200,126056,5.295399822582689,0.1586344370727582
276,0.0676,0,2,0,7870,668574,200,126056,5.295383981751362,0.15863483633892503
277,0.0677,1,7,1,7877,668567,201,126055,5.295328538841718,0.15863517496369342
278,0.068,0,15,0,7892,668552,201,126055,5.295209732606767,0.15863816956055005
279,0.0681,1,2,1,7894,668550,202,126054,5.29519389177544,0.1586375100049836
280,0.0682,1,4,1,7898,668546,203,126053,5.295162210112787,0.15863724973225488
281,0.0683,0,69,0,7967,668477,203,126053,5.294615701432011,0.15865102639296189
282,0.0684,0,2,0,7969,668475,203,126053,5.294599860600684,0.15865142575214466
283,0.0685,0,3,0,7972,668472,203,126053,5.294576099353694,0.15865202479468865
284,0.0686,0,1,0,7973,668471,203,126053,5.294568178938031,0.15865222447654193
285,0.0687,0,1,0,7974,668470,203,126053,5.294560258522368,0.15865242415889785
286,0.0688,0,3,0,7977,668467,203,126053,5.294536497275377,0.15865302320898153
287,0.069,2,9,2,7986,668458,205,126051,5.294465213534406,0.15865270248669303
288,0.0691,0,2,0,7988,668456,205,126051,5.294449372703079,0.15865310186065068
289,0.0692,1,7,1,7995,668449,206,126050,5.2943939297934355,0.15865344072176302
290,0.0693,0,10,0,8005,668439,206,126050,5.294314725636801,0.15865543764608447
291,0.0694,0,1,0,8006,668438,206,126050,5.294306805221138,0.15865563734128144
292,0.0695,0,4,0,8010,668434,206,126050,5.294275123558484,0.15865643612709632
293,0.0697,0,6,0,8016,668428,206,126050,5.294227601064504,0.15865763432090002
294,0.07,36,1560,36,9576,666868,242,126014,5.281871752629578,0.15893159385633676
295,0.0702,0,2,0,9578,666866,242,126014,5.281855911798251,0.1589319947533044
296,0.0703,0,3,0,9581,666863,242,126014,5.281832150551261,0.15893259610254806
297,0.0704,0,2,0,9583,666861,242,126014,5.281816309719934,0.15893299700457197
298,0.0705,0,1,0,9584,666860,242,126014,5.28180838930427,0.15893319745634238
299,0.0707,0,9,0,9593,666851,242,126014,5.2817371055633,0.15893500154502974
300,0.0708,0,17,0,9610,666834,242,126014,5.281602458497022,0.1589384093798559
301,0.071,2,11,2,9621,666823,244,126012,5.281515333924724,0.1589384928768281
302,0.0711,0,2,0,9623,666821,244,126012,5.281499493093397,0.15893889381496482
303,0.0712,0,5,0,9628,666816,244,126012,5.28145989101508,0.1589398961691565
304,0.0713,0,3,0,9631,666813,244,126012,5.28143612976809,0.15894049758774004
305,0.0714,0,9,0,9640,666804,244,126012,5.281364846027119,0.15894230187079977
306,0.0715,0,3,0,9643,666801,244,126012,5.281341084780129,0.15894290330758956
307,0.0717,2,46,2,9689,666755,246,126010,5.280976745659612,0.15895000409957555
308,0.0719,0,1,0,9690,666754,246,126010,5.280968825243948,0.15895020460061254
309,0.072,2,26,2,9716,666728,248,126008,5.2807628944367,0.15895329592701732
310,0.0721,0,2,0,9718,666726,248,126008,5.280747053605373,0.15895369695257172
311,0.0722,0,7,0,9725,666719,248,126008,5.28069161069573,0.15895510055794743
312,0.0723,0,2,0,9727,666717,248,126008,5.280675769864403,0.15895550159260777
313,0.0724,0,1,0,9728,666716,248,126008,5.280667849448739,0.1589557021106968
314,0.0725,0,76,0,9804,666640,248,126008,5.28006589785832,0.15897094296585623
315,0.0726,0,3,0,9807,666637,248,126008,5.280042136611329,0.1589715446385204
316,0.0727,0,5,0,9812,666632,248,126008,5.280002534533012,0.158972547436415
317,0.0729,0,6,0,9818,666626,248,126008,5.279955012039032,0.15897375081058848
318,0.073,0,7,0,9825,666619,248,126008,5.2798995691293875,0.1589751547701504
319,0.0732,0,2,0,9827,666617,248,126008,5.279883728298061,0.1589755559060085
320,0.0733,8,160,8,9987,666457,256,126000,5.2786164617919145,0.15899916336154518
321,0.0735,0,4,0,9991,666453,256,126000,5.278584780129261,0.15899996592857873
322,0.0736,0,1,0,9992,666452,256,126000,5.278576859713597,0.15900016657160307
323,0.0737,0,6,0,9998,666446,256,126000,5.278529337219617,0.15900137044038332
324,0.0738,2,7,2,10005,666439,258,125998,5.278473894309974,0.15900065241779474
325,0.074,0,23,0,10028,666416,258,125998,5.278291724749715,0.15900526744858118
326,0.0742,0,12,0,10040,666404,258,125998,5.278196679761754,0.1590076753970838
327,0.0743,0,7,0,10047,666397,258,125998,5.27814123685211,0.15900908006739065
328,0.0744,0,2,0,10049,666395,258,125998,5.2781253960207835,0.15900948140632237
329,0.0745,0,2,0,10051,666393,258,125998,5.278109555189456,0.15900988274728006
330,0.0747,0,4,0,10055,666389,258,125998,5.278077873526803,0.1590106854352734
331,0.0748,0,3,0,10058,666386,258,125998,5.278054112279812,0.15901128745658671
332,0.075,13,265,13,10323,666121,271,125985,5.2759552021290075,0.1590506826106607
333,0.0753,0,4,0,10327,666117,271,125985,5.275923520466354,0.1590514857934963
334,0.0754,1,7,1,10334,666110,272,125984,5.27586807755671,0.15905182970708023
335,0.0755,0,3,0,10337,666107,272,125984,5.27584431630972,0.159052432106917
336,0.0756,0,2,0,10339,666105,272,125984,5.275828475478393,0.15905283370934326
337,0.0757,1,3,1,10342,666102,273,125983,5.275804714231403,0.15905237442951198
338,0.0758,1,18,1,10360,666084,274,125982,5.275662146749461,0.15905492724091175
339,0.076,1,32,1,10392,666052,275,125981,5.275408693448232,0.15906029167976588
340,0.0761,0,1,0,10393,666051,275,125981,5.275400773032569,0.1590604925053533
341,0.0762,0,5,0,10398,666046,275,125981,5.275361170954252,0.15906149664089733
342,0.0764,1,2,1,10400,666044,276,125980,5.275345330122925,0.15906083654030687
343,0.0765,0,2,0,10402,666042,276,125980,5.275329489291598,0.15906123819792883
344,0.0767,6,120,6,10522,665922,282,125974,5.274379039411988,0.15907896996575308
345,0.0768,0,5,0,10527,665917,282,125974,5.274339437333671,0.15907997439041485
346,0.077,0,8,0,10535,665909,282,125974,5.274276074008364,0.1590815814962564
347,0.0771,0,1,0,10536,665908,282,125974,5.2742681535927005,0.15908178238676973
348,0.0773,0,6,0,10542,665902,282,125974,5.27422063109872,0.15908298774050483
349,0.0775,0,51,0,10593,665851,282,125974,5.273816689899886,0.15909323398478198
350,0.0776,0,1,0,10594,665850,282,125974,5.273808769484223,0.1590934349047263
351,0.0777,0,7,0,10601,665843,282,125974,5.273753326574579,0.15909484135854624
352,0.0778,0,1,0,10602,665842,282,125974,5.273745406158915,0.1590950422825505
353,0.0779,0,3,0,10605,665839,282,125974,5.273721644911925,0.1590956450576083
354,0.078,1,14,1,10619,665825,283,125973,5.273610759092637,0.15909739605303372
355,0.0781,0,1,0,10620,665824,283,125973,5.2736028386769735,0.15909759698508583
356,0.0782,1,1,1,10621,665823,284,125972,5.273594918261311,0.15909673589754925
357,0.0783,3,58,3,10679,665765,287,125969,5.273135534152832,0.15910520452576243
358,0.0784,0,4,0,10683,665761,287,125969,5.273103852490179,0.15910600836143635
359,0.0785,0,4,0,10687,665757,287,125969,5.273072170827525,0.15910681220523262
360,0.0787,0,4,0,10691,665753,287,125969,5.273040489164871,0.15910761605715137
361,0.0788,0,9,0,10700,665744,287,125969,5.272969205423901,0.15910942475366704
362,0.079,1,8,1,10708,665736,288,125968,5.272905842098593,0.15910997039297514
363,0.0792,0,11,0,10719,665725,288,125968,5.272818717526296,0.15911218111060726
364,0.0793,0,5,0,10724,665720,288,125968,5.272779115447979,0.15911318600256666
365,0.0794,0,1,0,10725,665719,288,125968,5.272771195032315,0.1591133869824817
366,0.0795,1,6,1,10731,665713,289,125967,5.272723672538334,0.15911353071948262
367,0.0797,0,1,0,10732,665712,289,125967,5.2727157521226715,0.15911373170186402
368,0.0798,0,3,0,10735,665709,289,125967,5.272691990875681,0.15911433465205463
369,0.08,37,1781,37,12516,663928,326,125930,5.25858573057914,0.15943372099795153
370,0.0802,0,1,0,12517,663927,326,125930,5.2585778101634775,0.1594339228493259
371,0.0803,1,4,1,12521,663923,327,125929,5.258546128500824,0.15943366605389364
372,0.0804,0,3,0,12524,663920,327,125929,5.258522367253834,0.1594342716139414
373,0.0805,0,3,0,12527,663917,327,125929,5.258498606006843,0.15943487717858926
374,0.0806,0,1,0,12528,663916,327,125929,5.2584906855911795,0.1594350790344941
375,0.0807,0,5,0,12533,663911,327,125929,5.258451083512862,0.1594360883216854
376,0.0808,1,21,1,12554,663890,328,125928,5.258284754783931,0.1594392632226665
377,0.081,0,16,0,12570,663874,328,125928,5.258158028133316,0.15944249318183545
378,0.0811,0,1,0,12571,663873,328,125928,5.258150107717653,0.15944269505862868
379,0.0812,0,3,0,12574,663870,328,125928,5.258126346470663,0.15944330069207568
380,0.0813,0,2,0,12576,663868,328,125928,5.258110505639336,0.1594437044502631
381,0.0814,0,3,0,12579,663865,328,125928,5.258086744392346,0.15944431009137838
382,0.0815,0,4,0,12583,663861,328,125928,5.258055062729692,0.15944511762002256
383,0.0817,2,55,2,12638,663806,330,125926,5.257619439868204,0.15945409328734306
384,0.0818,0,4,0,12642,663802,330,125926,5.257587758205551,0.15945490092791442
385,0.082,1,22,1,12664,663780,331,125925,5.257413509060956,0.15945827872433377
386,0.0823,1,3,1,12667,663777,332,125924,5.257389747813965,0.1594578201116625
387,0.0825,3,71,3,12738,663706,335,125921,5.256827398301863,0.15946896446043513
388,0.0826,0,1,0,12739,663705,335,125921,5.256819477886199,0.1594691664154929
389,0.0827,0,6,0,12745,663699,335,125921,5.256771955392219,0.15947037815658166
390,0.0828,0,9,0,12754,663690,335,125921,5.256700671651248,0.15947219580274338
391,0.0829,0,1,0,12755,663689,335,125921,5.256692751235585,0.15947239776598574
392,0.083,0,8,0,12763,663681,335,125921,5.2566293879102775,0.1594740134903407
393,0.0831,0,3,0,12766,663678,335,125921,5.256605626663287,0.15947461939541463
394,0.0832,0,7,0,12773,663671,335,125921,5.256550183753643,0.15947603319182566
395,0.0833,6,172,6,12945,663499,341,125915,5.255187872259536,0.15950439186535836
396,0.0835,0,6,0,12951,663493,341,125915,5.255140349765556,0.15950560419960275
397,0.0836,0,1,0,12952,663492,341,125915,5.255132429349892,0.15950580625710184
398,0.0837,0,6,0,12958,663486,341,125915,5.255084906855912,0.15950701861284697
399,0.0838,0,4,0,12962,663482,341,125915,5.255053225193258,0.15950782686024903
400,0.084,0,27,0,12989,663455,341,125915,5.254839373970346,0.1595132827444671
401,0.0842,1,20,1,13009,663435,342,125914,5.254680965657077,0.15951625960126636
402,0.0843,0,4,0,13013,663431,342,125914,5.254649283994424,0.15951706794874232
403,0.0844,0,2,0,13015,663429,342,125914,5.254633443163097,0.1595174721255525
404,0.0845,0,3,0,13018,663426,342,125914,5.254609681916107,0.15951807839460816
405,0.0846,0,2,0,13020,663424,342,125914,5.25459384108478,0.15951848257653883
406,0.0847,0,6,0,13026,663418,342,125914,5.2545463185907995,0.15951969513462017
407,0.0848,0,4,0,13030,663414,342,125914,5.254514636928146,0.15952050351691566
408,0.0849,0,1,0,13031,663413,342,125914,5.254506716512482,0.15952070561376971
409,0.085,8,331,8,13362,663082,350,125906,5.2518850589278925,0.15957910639959036
410,0.0851,0,2,0,13364,663080,350,125906,5.251869218096566,0.15957951091654352
411,0.0853,0,8,0,13372,663072,350,125906,5.251805854771258,0.1595811290048645
412,0.0854,0,3,0,13375,663069,350,125906,5.251782093524268,0.15958173579644475
413,0.0855,0,2,0,13377,663067,350,125906,5.251766252692941,0.15958214032672854
414,0.0857,0,10,0,13387,663057,350,125906,5.251687048536307,0.1595841630089117
415,0.0858,0,20,0,13407,663037,350,125906,5.251528640223039,0.15958820852710526
416,0.086,2,30,2,13437,663007,352,125904,5.251291027753137,0.15959214664265045
417,0.0861,0,3,0,13440,663004,352,125904,5.251267266506146,0.15959275352766103
418,0.0862,0,3,0,13443,663001,352,125904,5.251243505259156,0.15959336041728725
419,0.0863,0,1,0,13444,663000,352,125904,5.251235584843492,0.15959356271485503
420,0.0864,0,3,0,13447,662997,352,125904,5.251211823596503,0.15959416961063555
421,0.0865,1,8,1,13455,662989,353,125903,5.251148460271195,0.15959472272503714
422,0.0867,4,176,4,13631,662813,357,125899,5.2497544671144345,0.15962607390276806
423,0.0868,0,2,0,13633,662811,357,125899,5.249738626283107,0.15962647868037683
424,0.0869,0,3,0,13636,662808,357,125899,5.249714865036117,0.1596270858506391
425,0.087,0,11,0,13647,662797,357,125899,5.249627740463819,0.15962931218111923
426,0.0871,0,2,0,13649,662795,357,125899,5.249611899632493,0.15962971697515133
427,0.0873,0,8,0,13657,662787,357,125899,5.249548536307185,0.15963133617180983
428,0.0874,0,1,0,13658,662786,357,125899,5.249540615891522,0.1596315385737018
429,0.0875,1,71,1,13729,662715,358,125898,5.24897826637942,0.15964484480981167
430,0.0876,0,2,0,13731,662713,358,125898,5.2489624255480924,0.15964524968584004
431,0.0877,0,4,0,13735,662709,358,125898,5.248930743885439,0.1596460594440577
432,0.0878,1,6,1,13741,662703,359,125897,5.248883221391458,0.1596462084707076
433,0.0879,0,7,0,13748,662696,359,125897,5.2488277784818145,0.15964762558125675
434,0.088,3,13,3,13761,662683,362,125894,5.248724813078191,0.15964706046460903
435,0.0882,0,3,0,13764,662680,362,125894,5.2487010518312,0.15964766781557596
436,0.0883,6,74,6,13838,662606,368,125888,5.2481149410721075,0.15965625610340725
437,0.0884,0,1,0,13839,662605,368,125888,5.248107020656444,0.1596564585861891
438,0.0885,0,4,0,13843,662601,368,125888,5.24807533899379,0.15965726852245243
439,0.0886,0,2,0,13845,662599,368,125888,5.248059498162464,0.15965767349366572
440,0.0887,0,13,0,13858,662586,368,125888,5.247956532758839,0.15966030585662938
441,0.0888,1,0,1,13858,662586,369,125887,5.247956532758839,0.15965924007543694
442,0.089,2,10,2,13868,662576,371,125885,5.247877328602205,0.15965913342574967
443,0.0892,1,16,1,13884,662560,372,125884,5.247750601951591,0.15966130758811026
444,0.0893,0,18,0,13902,662542,372,125884,5.247608034469649,0.15966495270323403
445,0.0895,0,6,0,13908,662536,372,125884,5.247560511975668,0.15966616777859516
446,0.0897,0,8,0,13916,662528,372,125884,5.247497148650361,0.15966778790784514
447,0.0898,0,6,0,13922,662522,372,125884,5.2474496261563806,0.1596690030263595
448,0.09,61,2045,61,15967,660477,433,125823,5.231252376124699,0.1600190766882869
449,0.0902,0,4,0,15971,660473,433,125823,5.231220694462046,0.1600198907281736
450,0.0903,0,6,0,15977,660467,433,125823,5.231173171968065,0.16002111180353304
451,0.0904,0,2,0,15979,660465,433,125823,5.231157331136738,0.16002151883279409
452,0.0905,0,2,0,15981,660463,433,125823,5.231141490305411,0.16002192586412578
453,0.0906,0,1,0,15982,660462,433,125823,5.231133569889748,0.16002212938056812
454,0.0907,0,12,0,15994,660450,433,125823,5.231038524901787,0.16002457161825473
455,0.0908,2,10,2,16004,660440,435,125821,5.230959320745153,0.16002447024588526
456,0.0909,0,4,0,16008,660436,435,125821,5.230927639082499,0.16002528435358923
457,0.091,1,9,1,16017,660427,436,125820,5.230856355341528,0.16002604779414104
458,0.0911,0,1,0,16018,660426,436,125820,5.230848434925865,0.16002625132592088
459,0.0912,0,8,0,16026,660418,436,125820,5.2307850716005575,0.16002787959879833
460,0.0913,0,5,0,16031,660413,436,125820,5.23074546952224,0.16002889728617345
461,0.0915,1,3,1,16034,660410,437,125819,5.23072170827525,0.16002843955132665
462,0.0916,0,1,0,16035,660409,437,125819,5.230713787859587,0.16002864309080828
463,0.0917,4,93,4,16128,660316,441,125815,5.22997718920289,0.16004330067126216
464,0.0918,0,2,0,16130,660314,441,125815,5.229961348371562,0.16004370783929864
465,0.0919,1,0,1,16130,660314,442,125814,5.229961348371562,0.16004263936661714
466,0.092,0,25,0,16155,660289,442,125814,5.2297633379799775,0.16004772911437815
467,0.0921,0,1,0,16156,660288,442,125814,5.229755417564314,0.16004793271102224
468,0.0922,0,3,0,16159,660285,442,125814,5.229731656317323,0.16004854350406247
469,0.0923,0,9,0,16168,660276,442,125814,5.229660372576353,0.1600503759111552
470,0.0925,8,91,8,16259,660185,450,125806,5.228939614750982,0.1600603569252065
471,0.0926,0,5,0,16264,660180,450,125806,5.228900012672665,0.16006137513899737
472,0.0927,1,7,1,16271,660173,451,125805,5.228844569763021,0.16006173200776613
473,0.0928,0,1,0,16272,660172,451,125805,5.2288366493473575,0.16006193565460566
474,0.0929,0,5,0,16277,660167,451,125805,5.22879704726904,0.16006295389657646
475,0.093,0,8,0,16285,660159,451,125805,5.228733683943734,0.1600645831106768
476,0.0931,0,4,0,16289,660155,451,125805,5.2287020022810795,0.16006539773016437
477,0.0932,3,3,3,16292,660152,454,125802,5.228678241034089,0.1600628026576619
478,0.0933,9,190,9,16482,659962,463,125793,5.227173362058041,0.1600918861477178
479,0.0935,0,3,0,16485,659959,463,125793,5.2271496008110505,0.16009249737830766
480,0.0936,0,5,0,16490,659954,463,125793,5.227109998732733,0.16009351610632938
481,0.0937,0,9,0,16499,659945,463,125793,5.227038714991763,0.1600953498494409
482,0.0938,1,2,1,16501,659943,464,125792,5.227022874160436,0.16009468841276003
483,0.094,2,44,2,16545,659899,466,125790,5.226674375871245,0.160101515994242
484,0.0942,0,20,0,16565,659879,466,125790,5.226515967557978,0.16010559154045786
485,0.0943,0,7,0,16572,659872,466,125790,5.226460524648333,0.1601070180306544
486,0.0945,0,4,0,16576,659868,466,125790,5.22642884298568,0.1601078331793223
487,0.0946,0,2,0,16578,659866,466,125790,5.226413002154353,0.16010824075676885
488,0.0947,0,9,0,16587,659857,466,125790,5.226341718413383,0.160110074880958
489,0.0948,0,6,0,16593,659851,466,125790,5.226294195919402,0.16011129765376297
490,0.0949,0,1,0,16594,659850,466,125790,5.226286275503738,0.16011150145104627
491,0.095,11,394,11,16988,659456,477,125779,5.223165631732353,0.16018007348118715
492,0.0952,0,3,0,16991,659453,477,125779,5.223141870485363,0.16018068545347108
493,0.0953,0,9,0,17000,659444,477,125779,5.2230705867443925,0.16018252139837982
494,0.0954,0,3,0,17003,659441,477,125779,5.223046825497402,0.1601831333893686
495,0.0956,0,2,0,17005,659439,477,125779,5.223030984666075,0.16018354138595906
496,0.0957,0,13,0,17018,659426,477,125779,5.222928019262451,0.16018619341445864
497,0.0958,1,17,1,17035,659409,478,125778,5.222793372196173,0.16018859201693356
498,0.0959,0,2,0,17037,659407,478,125778,5.222777531364846,0.16018900004457548
499,0.096,2,49,2,17086,659358,480,125776,5.222389430997339,0.16019685811593945
500,0.0962,0,13,0,17099,659345,480,125776,5.222286465593714,0.16019951064867707
501,0.0963,0,2,0,17101,659343,480,125776,5.222270624762388,0.16019991873843328
502,0.0965,1,4,1,17105,659339,481,125775,5.222238943099734,0.16019966527154017
503,0.0967,7,217,7,17322,659122,488,125768,5.220520212900773,0.1602364662564181
504,0.0968,0,8,0,17330,659114,488,125768,5.2204568495754655,0.16023809948501813
505,0.0969,0,1,0,17331,659113,488,125768,5.220448929159803,0.1602383036409341
506,0.097,0,22,0,17353,659091,488,125768,5.220274680015208,0.1602427952027052
507,0.0971,1,4,1,17357,659087,489,125767,5.220242998352553,0.16024254192499496
508,0.0972,0,4,0,17361,659083,489,125767,5.2202113166899,0.16024335860355482
509,0.0973,0,9,0,17370,659074,489,125767,5.22014003294893,0.16024519616075103
510,0.0975,2,114,2,17484,658960,491,125765,5.2192371055633,0.16026633534040588
511,0.0976,0,3,0,17487,658957,491,125765,5.21921334431631,0.16026694804019767
512,0.0977,0,18,0,17505,658939,491,125765,5.219070776834369,0.16027062433732975
513,0.0978,0,4,0,17509,658935,491,125765,5.2190390951717145,0.16027144131515228
514,0.0979,1,6,1,17515,658929,492,125764,5.2189915726777345,0.16027159666264387
515,0.098,1,18,1,17533,658911,493,125763,5.218849005195793,0.16027420304483136
516,0.0981,0,4,0,17537,658907,493,125763,5.218817323533139,0.16027502007213223
517,0.0982,0,4,0,17541,658903,493,125763,5.218785641870485,0.16027583710776305
518,0.0983,0,91,0,17632,658812,493,125763,5.2180648840451145,0.1602944269190326
519,0.0985,0,5,0,17637,658807,493,125763,5.218025281966797,0.16029544846221497
520,0.0986,0,1,0,17638,658806,493,125763,5.2180173615511345,0.1602956527724139
521,0.0987,1,5,1,17643,658801,494,125762,5.217977759472817,0.1602956040496429
522,0.0988,0,3,0,17646,658798,494,125762,5.217953998225827,0.1602962169878658
523,0.0989,0,2,0,17648,658796,494,125762,5.2179381573945,0.1602966256159519
524,0.099,1,7,1,17655,658789,495,125761,5.2178827144848565,0.16029698553310814
525,0.0992,0,35,0,17690,658754,495,125761,5.217605499936637,0.160304136950855
526,0.0993,1,6,1,17696,658748,496,125760,5.217557977442656,0.16030429262671636
527,0.0994,0,1,0,17697,658747,496,125760,5.217550057026993,0.16030449696433557
528,0.0995,1,7,1,17704,658740,497,125759,5.217494614117349,0.16030485698515867
529,0.0997,0,6,0,17710,658734,497,125759,5.217447091623368,0.1603060830370698
530,0.0998,0,1,0,17711,658733,497,125759,5.217439171207705,0.16030628738087832
531,0.1,63,2181,63,19892,656552,560,125696,5.200164744645799,0.16068561376954624
532,0.1001,0,1,0,19893,656551,560,125696,5.2001568242301355,0.1606858191849889
533,0.1002,0,4,0,19897,656547,560,125696,5.200125142567482,0.16068664085201145
534,0.1003,0,3,0,19900,656544,560,125696,5.200101381320492,0.160687257107793
535,0.1004,0,3,0,19903,656541,560,125696,5.200077620073501,0.16068787336830143
536,0.1005,0,8,0,19911,656533,560,125696,5.200014256748194,0.16068951675276677
537,0.1007,1,11,1,19922,656522,561,125695,5.199927132175897,0.16069070347486694
538,0.1008,2,24,2,19946,656498,563,125693,5.199737042199975,0.16069348790768495
539,0.1009,0,1,0,19947,656497,563,125693,5.199729121784311,0.1606936933481635
540,0.101,0,11,0,19958,656486,563,125693,5.199641997212014,0.1606959532280974
541,0.1011,0,3,0,19961,656483,563,125693,5.199618235965024,0.16069656957002004
542,0.1012,1,8,1,19969,656475,564,125692,5.199554872639716,0.1606971401248071
543,0.1013,0,6,0,19975,656469,564,125692,5.199507350145736,0.1606983728413971
544,0.1014,0,3,0,19978,656466,564,125692,5.199483588898746,0.1606989892067843
545,0.1015,0,6,0,19984,656460,564,125692,5.199436066404765,0.16070022195174338
546,0.1017,2,69,2,20053,656391,566,125690,5.198889557723989,0.16071225359010127
547,0.1018,0,3,0,20056,656388,566,125690,5.1988657964769995,0.16071287007178311
548,0.1019,0,1,0,20057,656387,566,125690,5.198857876061336,0.1607130755667281
549,0.102,0,33,0,20090,656354,566,125690,5.198596502344443,0.16071985719473583
550,0.1021,0,3,0,20093,656351,566,125690,5.198572741097453,0.16072047373475304
551,0.1022,1,4,1,20097,656347,567,125689,5.198541059434799,0.16072022259844815
552,0.1023,0,12,0,20109,656335,567,125689,5.198446014446838,0.1607226888177345
553,0.1024,0,1,0,20110,656334,567,125689,5.198438094031175,0.1607228943394248
554,0.1025,4,124,4,20234,656210,571,125685,5.197455962488911,0.16074408967956055
555,0.1026,1,2,1,20236,656208,572,125684,5.197440121657585,0.16074342748103318
556,0.1027,0,10,0,20246,656198,572,125684,5.1973609175009505,0.16074548333380229
557,0.1028,0,6,0,20252,656192,572,125684,5.19731339500697,0.16074671687070585
558,0.1029,0,12,0,20264,656180,572,125684,5.197218350019009,0.1607491840013097
559,0.103,1,15,1,20279,656165,573,125683,5.1970995437840575,0.16075119460560108
560,0.1031,0,4,0,20283,656161,573,125683,5.197067862121404,0.16075201702641448
561,0.1032,0,3,0,20286,656158,573,125683,5.197044100874414,0.160752633847547
562,0.1033,8,239,8,20525,655919,581,125675,5.195151121530858,0.16079319953837926
563,0.1034,0,5,0,20530,655914,581,125675,5.195111519452541,0.16079422816851313
564,0.1035,0,4,0,20534,655910,581,125675,5.195079837789887,0.160795051082096
565,0.1036,0,3,0,20537,655907,581,125675,5.195056076542897,0.16079566827281078
566,0.1037,0,6,0,20543,655901,581,125675,5.195008554048917,0.1607969026684545
567,0.1038,0,3,0,20546,655898,581,125675,5.194984792801926,0.16079751987338356
568,0.104,2,43,2,20589,655855,583,125673,5.1946442149284,0.16080421942655926
569,0.1042,0,30,0,20619,655825,583,125673,5.194406602458497,0.16081039234905273
570,0.1043,2,18,2,20637,655807,585,125671,5.194264034976555,0.16081194864090864
571,0.1044,0,1,0,20638,655806,585,125671,5.1942561145608925,0.1608121544204116
572,0.1045,0,5,0,20643,655801,585,125671,5.194216512482575,0.16081318332582614
573,0.1046,0,1,0,20644,655800,585,125671,5.194208592066912,0.160813389108489
574,0.1047,1,6,1,20650,655794,586,125670,5.194161069572931,0.16081354995239705
575,0.1048,0,6,0,20656,655788,586,125670,5.194113547078951,0.160814784671729
576,0.1049,0,3,0,20659,655785,586,125670,5.19408978583196,0.16081540203850508
577,0.105,16,482,16,21141,655303,602,125654,5.1902721454821945,0.1608974629845177
578,0.1051,0,1,0,21142,655302,602,125654,5.190264225066532,0.16089766901080216
579,0.1052,0,9,0,21151,655293,602,125654,5.190192941325561,0.16089952327110546
580,0.1053,1,13,1,21164,655280,603,125653,5.1900899759219365,0.16090112724138947
581,0.1054,0,5,0,21169,655275,603,125653,5.1900503738436194,0.16090215743320768
582,0.1055,0,3,0,21172,655272,603,125653,5.190026612596629,0.16090277555463073
583,0.1057,1,16,1,21188,655256,604,125652,5.189899885946015,0.1609049977718246
584,0.1058,2,29,2,21217,655227,606,125650,5.189670193891775,0.16090882430907813
585,0.106,2,45,2,21262,655182,608,125648,5.189313775186922,0.1609159484138673
586,0.1061,0,1,0,21263,655181,608,125648,5.189305854771258,0.1609161544973355
587,0.1062,0,5,0,21268,655176,608,125648,5.189266252692941,0.1609171849225946
588,0.1063,0,5,0,21273,655171,608,125648,5.189226650614624,0.1609182153610504
589,0.1064,0,1,0,21274,655170,608,125648,5.189218730198961,0.16091842145032517
590,0.1065,0,9,0,21283,655161,608,125648,5.18914744645799,0.16092027627755315
591,0.1066,0,2,0,21285,655159,608,125648,5.189131605626663,0.16092068846718843
592,0.1067,9,262,9,21547,654897,617,125639,5.187056456722849,0.1609650291594494
593,0.1068,0,10,0,21557,654887,617,125639,5.186977252566215,0.16096709142296348
594,0.1069,0,1,0,21558,654886,617,125639,5.186969332150551,0.16096729765222126
595,0.107,3,10,3,21568,654876,620,125636,5.186890127993917,0.16096613504981347
596,0.1071,1,4,1,21572,654872,621,125635,5.1868584463312635,0.1609658849952659
597,0.1072,0,3,0,21575,654869,621,125635,5.186834685084273,0.16096650369504834
598,0.1073,0,19,0,21594,654850,621,125635,5.186684197186668,0.16097042223745492
599,0.1074,0,4,0,21598,654846,621,125635,5.186652515524015,0.1609712472180617
600,0.1075,3,117,3,21715,654729,624,125632,5.185725826891395,0.1609921561943767
601,0.1076,0,1,0,21716,654728,624,125632,5.185717906475732,0.16099236249935928
602,0.1078,0,3,0,21719,654725,624,125632,5.185694145228742,0.16099298141747945
603,0.1079,3,2,3,21721,654723,627,125629,5.185678304397415,0.16099016853932585
604,0.108,0,24,0,21745,654699,627,125629,5.185488214421492,0.16099512000082017
605,0.1081,0,1,0,21746,654698,627,125629,5.1854802940058295,0.16099532631832553
606,0.1082,0,11,0,21757,654687,627,125629,5.185393169433532,0.16099759584578555
607,0.1083,6,101,6,21858,654586,633,125623,5.184593207451527,0.16101198525010607
608,0.1084,0,8,0,21866,654578,633,125623,5.18452984412622,0.16101363622963827
609,0.1085,0,13,0,21879,654565,633,125623,5.184426878722595,0.16101631914359102
610,0.1086,0,1,0,21880,654564,633,125623,5.184418958306932,0.16101652552529072
611,0.1087,1,7,1,21887,654557,634,125622,5.184363515397288,0.16101689484079937
612,0.1088,1,5,1,21892,654552,635,125621,5.184323913318971,0.1610168513906531
613,0.1089,0,1,0,21893,654551,635,125621,5.184315992903308,0.161017057777003
614,0.109,2,30,2,21923,654521,637,125619,5.184078380433405,0.16102109877714257
615,0.1091,0,2,0,21925,654519,637,125619,5.1840625396020785,0.1610215115787207
616,0.1092,0,21,0,21946,654498,637,125619,5.183896210873146,0.16102584612308155
617,0.1093,0,26,0,21972,654472,637,125619,5.183690280065898,0.16103121302514706
618,0.1094,0,3,0,21975,654469,637,125619,5.1836665188189075,0.1610318323060988
619,0.1095,0,4,0,21979,654465,637,125619,5.183634837156254,0.16103265802144384
620,0.1096,0,3,0,21982,654462,637,125619,5.183611075909264,0.16103327731350975
621,0.1097,0,5,0,21987,654457,637,125619,5.183571473830947,0.16103430947753808
622,0.1098,0,3,0,21990,654454,637,125619,5.183547712583956,0.16103492878230627
623,0.1099,0,1,0,21991,654453,637,125619,5.183539792168293,0.16103513521828755
624,0.11,83,2367,83,24358,652086,720,125536,5.164792168292992,0.1614357618483016
625,0.1101,1,2,1,24360,652084,721,125535,5.164776327461666,0.16143509867943043
626,0.1102,0,5,0,24365,652079,721,125535,5.1647367253833485,0.1614361366950698
627,0.1103,0,2,0,24367,652077,721,125535,5.164720884552021,0.1614365519050632
628,0.1104,0,4,0,24371,652073,721,125535,5.164689202889368,0.1614373823314575
629,0.1105,1,3,1,24374,652070,722,125534,5.164665441642377,0.16143692676478003
630,0.1106,0,4,0,24378,652066,722,125534,5.164633759979724,0.1614377572016461
631,0.1107,0,20,0,24398,652046,722,125534,5.164475351666455,0.1614419095141336
632,0.1108,2,24,2,24422,652022,724,125532,5.164285261690534,0.16144473567109166
633,0.1109,0,1,0,24423,652021,724,125532,5.16427734127487,0.16144494330290024
634,0.111,1,24,1,24447,651997,725,125531,5.164087251298948,0.16144884814437552
635,0.1111,1,2,1,24449,651995,726,125530,5.1640714104676215,0.16144818494582167
636,0.1112,0,6,0,24455,651989,726,125530,5.164023887973641,0.1614494308177678
637,0.1113,1,6,1,24461,651983,727,125529,5.163976365479661,0.16144959820555824
638,0.1114,1,1,1,24462,651982,728,125528,5.163968445063997,0.16144872734755822
639,0.1115,1,9,1,24471,651973,729,125527,5.1638971613230265,0.16144951768488747
640,0.1116,0,3,0,24474,651970,729,125527,5.163873400076036,0.1614501406436295
641,0.1117,3,96,3,24570,651874,732,125524,5.163113040172348,0.1614668419522561
642,0.1118,0,5,0,24575,651869,732,125524,5.163073438094031,0.1614678804671511
643,0.112,4,34,4,24609,651835,736,125520,5.162804143961475,0.1614706279627712
644,0.1121,0,3,0,24612,651832,736,125520,5.162780382714485,0.1614712511191841
645,0.1122,0,3,0,24615,651829,736,125520,5.162756621467494,0.16147187428040688
646,0.1123,0,12,0,24627,651817,736,125520,5.162661576479533,0.16147436697339765
647,0.1124,0,1,0,24628,651816,736,125520,5.1626536560638705,0.16147457470128748
648,0.1125,4,121,4,24749,651695,740,125516,5.161695285768597,0.16149539828952497
649,0.1126,0,1,0,24750,651694,740,125516,5.161687365352933,0.16149560607815133
650,0.1127,0,11,0,24761,651683,740,125516,5.161600240780636,0.1614978917883322
651,0.1128,0,2,0,24763,651681,740,125516,5.16158439994931,0.16149830737895282
652,0.1129,0,6,0,24769,651675,740,125516,5.161536877455329,0.1614995541636483
653,0.113,0,5,0,24774,651670,740,125516,5.161497275377012,0.1615005931656
654,0.1131,0,3,0,24777,651667,740,125516,5.161473514130021,0.16150121657318803
655,0.1132,1,9,1,24786,651658,741,125515,5.161402230389051,0.16150200791844288
656,0.1133,6,280,6,25066,651378,747,125509,5.159184514003295,0.16155373947562515
657,0.1135,1,7,1,25073,651371,748,125508,5.159129071093651,0.1615541158919214
658,0.1136,0,2,0,25075,651369,748,125508,5.159113230262324,0.16155453179847004
659,0.1137,0,12,0,25087,651357,748,125508,5.1590181852743635,0.16155702728273252
660,0.1138,0,8,0,25095,651349,748,125508,5.158954821949056,0.16155869098173795
661,0.1139,0,9,0,25104,651340,748,125508,5.1588835382080855,0.1615605626840772
662,0.114,0,57,0,25161,651283,748,125508,5.158432074515271,0.16157241780607653
663,0.1141,0,1,0,25162,651282,748,125508,5.158424154099607,0.16157262580620244
664,0.1142,1,25,1,25187,651257,749,125507,5.1582261437080215,0.16157674660514648
665,0.1143,2,14,2,25201,651243,751,125505,5.158115257888734,0.16157750003862256
666,0.1144,0,1,0,25202,651242,751,125505,5.15810733747307,0.16157770805680613
667,0.1145,0,6,0,25208,651236,751,125505,5.15805981497909,0.16157895617715556
668,0.1146,0,2,0,25210,651234,751,125505,5.1580439741477635,0.16157937222155705
669,0.1147,0,5,0,25215,651229,751,125505,5.158004372069446,0.1615804123419343
670,0.1148,0,1,0,25216,651228,751,125505,5.157996451653783,0.16158062036761667
671,0.115,17,548,17,25764,650680,768,125488,5.153656063870232,0.16167633811236742
672,0.1151,0,2,0,25766,650678,768,125488,5.153640223038905,0.16167675471484194
673,0.1152,1,1,1,25767,650677,769,125487,5.153632302623242,0.16167588293195767
674,0.1153,2,14,2,25781,650663,771,125485,5.153521416803954,0.16167663899153253
675,0.1154,0,6,0,25787,650657,771,125485,5.153473894309974,0.16167788883992879
676,0.1155,0,3,0,25790,650654,771,125485,5.153450133062983,0.16167851377137343
677,0.1156,1,3,1,25793,650651,772,125484,5.153426371815993,0.16167805858516882
678,0.1157,0,24,0,25817,650627,772,125484,5.153236281840071,0.1616830582223419
679,0.1158,6,40,6,25857,650587,778,125478,5.152919465213534,0.16168491041343186
680,0.1159,0,1,0,25858,650586,778,125478,5.152911544797871,0.16168511875309252
681,0.116,1,53,1,25911,650533,779,125477,5.15249176276771,0.161695081248953
682,0.1161,0,1,0,25912,650532,779,125477,5.152483842352047,0.1616952896164864
683,0.1162,0,4,0,25916,650528,779,125477,5.152452160689393,0.16169612309199038
684,0.1163,1,9,1,25925,650519,780,125476,5.152380876948422,0.1616969181502458
685,0.1165,1,8,1,25933,650511,781,125475,5.152317513623115,0.16169750485189166
686,0.1167,6,256,6,26189,650255,787,125469,5.1502898872132805,0.16174438331159022
687,0.1168,1,8,1,26197,650247,788,125468,5.150226523887974,0.16174497076890354
688,0.117,0,15,0,26212,650232,788,125468,5.1501077176530226,0.16174809849168492
689,0.1171,0,4,0,26216,650228,788,125468,5.150076035990368,0.16174893257152287
690,0.1172,1,3,1,26219,650225,789,125467,5.150052274743379,0.1617484774884877
691,0.1173,0,20,0,26239,650205,789,125467,5.14989386643011,0.16175264802648542
692,0.1175,7,118,7,26357,650087,796,125460,5.1489592573818275,0.16176969287483545
693,0.1177,0,7,0,26364,650080,796,125460,5.148903814472184,0.16177115300306882
694,0.1178,0,3,0,26367,650077,796,125460,5.148880053225193,0.16177177878038057
695,0.1179,1,4,1,26371,650073,797,125459,5.14884837156254,0.16177153231588123
696,0.118,0,27,0,26398,650046,797,125459,5.148634520339628,0.16177716455728847
697,0.1181,0,3,0,26401,650043,797,125459,5.148610759092637,0.1617777903860983
698,0.1182,1,3,1,26404,650040,798,125458,5.148586997845647,0.16177733533806662
699,0.1183,5,134,5,26538,649906,803,125453,5.14752566214675,0.16179988882569235
700,0.1184,1,1,1,26539,649905,804,125452,5.147517741731086,0.16179901645306613
701,0.1185,0,9,0,26548,649896,804,125452,5.147446457990116,0.16180089456605293
702,0.1186,0,1,0,26549,649895,804,125452,5.147438537574452,0.1618011032479651
703,0.1187,1,17,1,26566,649878,805,125451,5.147303890508174,0.16180356983938432
704,0.1188,1,7,1,26573,649871,806,125450,5.14724844759853,0.1618039495899118
705,0.1189,0,7,0,26580,649864,806,125450,5.147193004688886,0.16180541045305516
706,0.119,2,40,2,26620,649824,808,125448,5.1468761880623495,0.1618115964461505
707,0.1192,2,24,2,26644,649800,810,125446,5.146686098086428,0.1618144434153804
708,0.1193,1,19,1,26663,649781,811,125445,5.146535610188823,0.16181732810819038
709,0.1195,0,13,0,26676,649768,811,125445,5.1464326447851985,0.16182004171756664
710,0.1196,0,6,0,26682,649762,811,125445,5.146385122291218,0.16182129418336005
711,0.1197,1,3,1,26685,649759,812,125444,5.146361361044228,0.16182083918663887
712,0.1198,0,5,0,26690,649754,812,125444,5.146321758965911,0.16182188292539454
713,0.1199,0,1,0,26691,649753,812,125444,5.146313838550247,0.1618220916747614
714,0.12,87,2590,87,29281,647163,899,125357,5.125799961982005,0.16227023248589034
715,0.1201,0,1,0,29282,647162,899,125357,5.125792041566341,0.16227044253927736
716,0.1202,0,5,0,29287,647157,899,125357,5.125752439488024,0.1622714928143697
717,0.1203,0,10,0,29297,647147,899,125357,5.12567323533139,0.1622735934053416
718,0.1205,0,6,0,29303,647141,899,125357,5.12562571283741,0.1622748537860292
719,0.1206,0,4,0,29307,647137,899,125357,5.125594031174756,0.16227569405069814
720,0.1207,0,15,0,29322,647122,899,125357,5.125475224939805,0.16227884512070878
721,0.1208,1,31,1,29353,647091,900,125356,5.125229692054239,0.16228427322521805
722,0.121,0,21,0,29374,647070,900,125356,5.1250633633253075,0.16228868525917045
723,0.1211,1,2,1,29376,647068,901,125355,5.125047522493981,0.16228802094189324
724,0.1212,1,8,1,29384,647060,902,125354,5.124984159168673,0.1622886172441204
725,0.1213,3,15,3,29399,647045,905,125351,5.124865352933722,0.1622885152175827
726,0.1214,0,6,0,29405,647039,905,125351,5.124817830439741,0.16228977589041804
727,0.1215,0,15,0,29420,647024,905,125351,5.12469902420479,0.1622929276581971
728,0.1216,0,1,0,29421,647023,905,125351,5.124691103789127,0.16229313778040172
729,0.1217,8,124,8,29545,646899,913,125343,5.123708972246863,0.1623105192413777
730,0.1218,0,9,0,29554,646890,913,125343,5.123637688505893,0.16231241089153145
731,0.1219,0,2,0,29556,646888,913,125343,5.123621847674566,0.16231283126422016
732,0.122,3,65,3,29621,646823,916,125340,5.123107020656444,0.16232324004128662
733,0.1221,0,5,0,29626,646818,916,125340,5.123067418578127,0.1623242911424864
734,0.1222,0,5,0,29631,646813,916,125340,5.1230278164998095,0.16232534225729875
735,0.1223,1,18,1,29649,646795,917,125339,5.122885249017869,0.162328041505749
736,0.1224,0,1,0,29650,646794,917,125339,5.122877328602205,0.16232825173901388
737,0.1225,5,147,5,29797,646647,922,125334,5.121713027499683,0.1623537366852293
738,0.1226,0,1,0,29798,646646,922,125334,5.121705107084019,0.16235394699344544
739,0.1227,0,14,0,29812,646632,922,125334,5.121594221264732,0.1623568913656819
740,0.1228,1,3,1,29815,646629,923,125333,5.121570460017741,0.16235643723395712
741,0.1229,0,5,0,29820,646624,923,125333,5.121530857939424,0.16235748882385936
742,0.123,0,21,0,29841,646603,923,125333,5.121364529210493,0.16236190565020933
743,0.1231,0,2,0,29843,646601,923,125333,5.121348688379166,0.1623623263128713
744,0.1232,0,12,0,29855,646589,923,125333,5.1212536433912055,0.1623648503346193
745,0.1233,9,290,9,30145,646299,932,125324,5.118956722848815,0.16241610216388055
746,0.1235,0,3,0,30148,646296,932,125324,5.118932961601825,0.16241673362535963
747,0.1236,0,2,0,30150,646294,932,125324,5.118917120770498,0.16241715460240688
748,0.1237,1,7,1,30157,646287,933,125323,5.118861677860854,0.16241754254092095
749,0.1238,0,7,0,30164,646280,933,125323,5.118806234951211,0.1624190159965682
750,0.1239,0,5,0,30169,646275,933,125323,5.118766632872894,0.16242006848125579
751,0.124,1,63,1,30232,646212,934,125322,5.118267646686098,0.16243224537091042
752,0.1241,0,2,0,30234,646210,934,125322,5.118251805854771,0.16243266643509277
753,0.1242,3,40,3,30274,646170,937,125319,5.117934989228234,0.16243783125877362
754,0.1243,0,13,0,30287,646157,937,125319,5.117832023824611,0.1624405684687534
755,0.1244,0,1,0,30288,646156,937,125319,5.117824103408947,0.16244077902718818
756,0.1245,0,11,0,30299,646145,937,125319,5.117736978836649,0.16244309520599795
757,0.1246,0,3,0,30302,646142,937,125319,5.117713217589659,0.16244372690259132
758,0.1247,0,12,0,30314,646130,937,125319,5.1176181726016985,0.16244625373809546
759,0.1248,2,9,2,30323,646121,939,125317,5.117546888860727,0.1624459775121267
760,0.1249,0,1,0,30324,646120,939,125317,5.117538968445064,0.16244618808794498
761,0.125,21,592,21,30916,645528,960,125296,5.112850082372323,0.16254813031249676
762,0.1251,0,1,0,30917,645527,960,125296,5.112842161956659,0.16254834118857378
763,0.1252,0,4,0,30921,645523,960,125296,5.112810480294006,0.1625491846983533
764,0.1253,0,14,0,30935,645509,960,125296,5.1126995944747184,0.16255213705152405
765,0.1254,0,5,0,30940,645504,960,125296,5.112659992396401,0.1625531914893617
766,0.1255,0,7,0,30947,645497,960,125296,5.112604549486757,0.16255466772531665
767,0.1256,0,2,0,30949,645495,960,125296,5.11258870865543,0.16255508951194292
768,0.1257,0,12,0,30961,645483,960,125296,5.112493663667469,0.16255762027766715
769,0.1258,0,42,0,31003,645441,960,125296,5.112161006209606,0.16256647857829584
770,0.1259,0,1,0,31004,645440,960,125296,5.112153085793943,0.16256668950198253
771,0.126,2,58,2,31062,645382,962,125294,5.111693701685464,0.16257675080059583
772,0.1261,0,2,0,31064,645380,962,125294,5.111677860854138,0.1625771727085642
773,0.1262,2,14,2,31078,645366,964,125292,5.11156697503485,0.16257795286625196
774,0.1263,1,8,1,31086,645358,965,125291,5.1115036117095425,0.16257855392013745
775,0.1264,0,8,0,31094,645350,965,125291,5.111440248384235,0.1625802416429959
776,0.1265,1,5,1,31099,645345,966,125290,5.111400646305918,0.1625802098269609
777,0.1266,0,4,0,31103,645341,966,125290,5.1113689646432645,0.16258105370793544
778,0.1267,13,292,13,31395,645049,979,125277,5.109056203269548,0.16262854947126282
779,0.1268,2,7,2,31402,645042,981,125275,5.109000760359904,0.1626278532084843
780,0.127,0,22,0,31424,645020,981,125275,5.108826511215309,0.16263249793910126
781,0.1271,1,3,1,31427,645017,982,125274,5.108802749968318,0.16263204425340552
782,0.1272,0,6,0,31433,645011,982,125274,5.1087552274743375,0.1626333110472098
783,0.1273,1,19,1,31452,644992,983,125273,5.108604739576733,0.162636235581261
784,0.1274,0,4,0,31456,644988,983,125273,5.10857305791408,0.16263708015854367
785,0.1275,3,143,3,31599,644845,986,125270,5.107440438474211,0.16266401771164046
786,0.1277,0,10,0,31609,644835,986,125270,5.107361234317577,0.16266612994331942
787,0.1278,0,11,0,31620,644824,986,125270,5.10727410974528,0.16266845346152548
788,0.1279,0,2,0,31622,644822,986,125270,5.107258268913952,0.16266887592651266
789,0.128,3,32,3,31654,644790,989,125267,5.107004815612723,0.16267237360351247
790,0.1281,1,1,1,31655,644789,990,125266,5.10699689519706,0.162671497490439
791,0.1282,0,11,0,31666,644778,990,125266,5.106909770624762,0.1626738212361891
792,0.1283,5,135,5,31801,644643,995,125261,5.105840514510201,0.16269690766641035
793,0.1284,0,1,0,31802,644642,995,125261,5.105832594094538,0.16269711898771663
794,0.1285,0,5,0,31807,644637,995,125261,5.105792992016221,0.1626981756024824
795,0.1286,0,3,0,31810,644634,995,125261,5.105769230769231,0.16269880957792945
796,0.1287,0,9,0,31819,644625,995,125261,5.10569794702826,0.1627007115339154
797,0.1288,1,6,1,31825,644619,996,125260,5.1056504245342795,0.1627008919583467
798,0.1289,0,9,0,31834,644610,996,125260,5.105579140793309,0.1627027939782041
799,0.129,0,19,0,31853,644591,996,125260,5.105428652895704,0.16270680949950056
800,0.1292,6,39,6,31892,644552,1002,125254,5.1051197566848305,0.16270852656383555
801,0.1293,2,10,2,31902,644542,1004,125252,5.105040552528196,0.16270846486202803
802,0.1294,1,0,1,31902,644542,1005,125251,5.105040552528196,0.16270737717802058
803,0.1295,2,8,2,31910,644534,1007,125249,5.10497718920289,0.16270689272171507
804,0.1296,0,1,0,31911,644533,1007,125249,5.104969268787226,0.16270710408920966
805,0.1297,0,5,0,31916,644528,1007,125249,5.104929666708909,0.1627081609349201
806,0.1298,2,8,2,31924,644520,1009,125247,5.104866303383601,0.1627076764787267
807,0.1299,0,2,0,31926,644518,1009,125247,5.104850462552275,0.16270809922508817
808,0.13,99,2859,99,34785,641659,1108,125148,5.082205994170574,0.16320664782663696
809,0.1301,0,3,0,34788,641656,1108,125148,5.082182232923584,0.1632072863469674
810,0.1302,0,6,0,34794,641650,1108,125148,5.082134710429603,0.1632085634026171
811,0.1303,1,12,1,34806,641638,1109,125147,5.082039665441642,0.16321002627855266
812,0.1304,1,3,1,34809,641635,1110,125146,5.082015904194652,0.16320957352881724
813,0.1305,0,4,0,34813,641631,1110,125146,5.081984222531998,0.16321042493449855
814,0.1306,0,5,0,34818,641626,1110,125146,5.081944620453681,0.16321148920409195
815,0.1307,0,10,0,34828,641616,1110,125146,5.081865416297047,0.1632136177849189
816,0.1308,2,52,2,34880,641564,1112,125144,5.0814535546825494,0.16322250452584294
817,0.1309,0,4,0,34884,641560,1112,125144,5.081421873019896,0.16322335608005176
818,0.131,0,36,0,34920,641524,1112,125144,5.0811367380560135,0.16323102046779048
819,0.1311,0,3,0,34923,641521,1112,125144,5.081112976809023,0.16323165919925914
820,0.1312,3,18,3,34941,641503,1115,125141,5.080970409327081,0.16323221730033757
821,0.1313,0,3,0,34944,641500,1115,125141,5.080946648080091,0.16323285605648538
822,0.1314,0,3,0,34947,641497,1115,125141,5.080922886833101,0.1632334948176323
823,0.1315,0,6,0,34953,641491,1115,125141,5.0808753643391205,0.16323477235492387
824,0.1317,3,147,3,35100,641344,1118,125138,5.079711063236599,0.16326280330131693
825,0.1318,1,8,1,35108,641336,1119,125137,5.079647699911291,0.16326341567152397
826,0.1319,1,3,1,35111,641333,1120,125136,5.079623938664301,0.16326296301611676
827,0.132,2,57,2,35168,641276,1122,125134,5.079172474971487,0.1632729218042562
828,0.1321,0,4,0,35172,641272,1122,125134,5.079140793308833,0.16327377395270914
829,0.1322,0,7,0,35179,641265,1122,125134,5.079085350399189,0.16327526523390556
830,0.1323,1,11,1,35190,641254,1123,125133,5.078998225826892,0.1632765169555329
831,0.1324,0,3,0,35193,641251,1123,125133,5.078974464579901,0.16327715609929225
832,0.1325,6,143,6,35336,641108,1129,125127,5.077841845140033,0.1633010760406403
833,0.1326,0,2,0,35338,641106,1129,125127,5.077826004308706,0.16330150228455312
834,0.1327,2,18,2,35356,641088,1131,125125,5.0776834368267645,0.16330315460583414
835,0.1328,0,1,0,35357,641087,1131,125125,5.077675516411102,0.16330336773634452
836,0.1329,0,4,0,35361,641083,1131,125125,5.077643834748447,0.16330422026394922
837,0.133,1,22,1,35383,641061,1132,125124,5.077469585603852,0.16330781730260968
838,0.1332,0,6,0,35389,641055,1132,125124,5.077422063109872,0.16330909617726405
839,0.1333,18,312,18,35701,640743,1150,125106,5.074950893422887,0.16335596181492695
840,0.1334,0,1,0,35702,640742,1150,125106,5.074942973007223,0.16335617511568876
841,0.1335,1,18,1,35720,640724,1151,125105,5.0748004055252816,0.16335892216147468
842,0.1337,1,7,1,35727,640717,1152,125104,5.074744962615638,0.16335932287048802
843,0.1338,0,9,0,35736,640708,1152,125104,5.074673678874667,0.16336124270708738
844,0.1339,0,4,0,35740,640704,1152,125104,5.074641997212014,0.16336209598228277
845,0.134,3,67,3,35807,640637,1155,125101,5.074111329362565,0.16337311195212983
846,0.1341,0,6,0,35813,640631,1155,125101,5.074063806868584,0.16337439208495924
847,0.1342,3,27,3,35840,640604,1158,125098,5.073849955645672,0.163376875076727
848,0.1343,0,14,0,35854,640590,1158,125098,5.0737390698263845,0.16337986229378024
849,0.1344,0,2,0,35856,640588,1158,125098,5.073723228995058,0.16338028904799096
850,0.1345,1,14,1,35870,640574,1159,125097,5.07361234317577,0.16338218373165497
851,0.1346,0,2,0,35872,640572,1159,125097,5.073596502344443,0.16338261050140465
852,0.1347,0,18,0,35890,640554,1159,125097,5.073453934862502,0.16338645152948275
853,0.1348,0,3,0,35893,640551,1159,125097,5.073430173615511,0.16338709171838756
854,0.1349,1,2,1,35895,640549,1160,125096,5.073414332784185,0.16338642582397847
855,0.135,20,669,20,36564,639880,1180,125076,5.06811557470536,0.16350744356538155
856,0.1352,0,2,0,36566,639878,1180,125076,5.068099733874034,0.1635078710615279
857,0.1353,0,12,0,36578,639866,1180,125076,5.068004688886073,0.16351043608535026
858,0.1354,3,4,3,36582,639862,1183,125073,5.0679730072234195,0.16350801048455096
859,0.1355,1,5,1,36587,639857,1184,125072,5.067933405145102,0.16350798570847752
860,0.1356,0,1,0,36588,639856,1184,125072,5.067925484729439,0.16350819946452477
861,0.1357,3,25,3,36613,639831,1187,125069,5.067727474337853,0.1635102627794483
862,0.1358,1,46,1,36659,639785,1188,125068,5.067363135217336,0.1635190029979617
863,0.1359,1,2,1,36661,639783,1189,125067,5.06734729438601,0.16351833692880957
864,0.136,2,81,2,36742,639702,1191,125065,5.066705740717273,0.16353346836356694
865,0.1361,0,2,0,36744,639700,1191,125065,5.066689899885946,0.16353389603342203
866,0.1362,0,7,0,36751,639693,1191,125065,5.066634456976302,0.16353539289553035
867,0.1363,1,6,1,36757,639687,1192,125064,5.066586934482322,0.16353558216988276
868,0.1364,0,6,0,36763,639681,1192,125064,5.066539411988341,0.16353686522958633
869,0.1365,0,10,0,36773,639671,1192,125064,5.066460207831707,0.16353900370716654
870,0.1367,14,337,14,37110,639334,1206,125050,5.063791027753137,0.16359578431782978
871,0.1368,0,7,0,37117,639327,1206,125050,5.063735584843492,0.16359728249280134
872,0.1369,0,2,0,37119,639325,1206,125050,5.0637197440121655,0.1635977105478332
873,0.137,2,22,2,37141,639303,1208,125048,5.06354549486757,0.1636002307840246
874,0.1371,1,3,1,37144,639300,1209,125047,5.06352173362058,0.16359977863457303
875,0.1373,0,19,0,37163,639281,1209,125047,5.063371245722975,0.1636038454694843
876,0.1374,0,1,0,37164,639280,1209,125047,5.0633633253073125,0.16360405951902784
877,0.1375,10,154,10,37318,639126,1219,125037,5.062143581295146,0.16362608501065873
878,0.1376,0,3,0,37321,639123,1219,125037,5.0621198200481565,0.16362672738693468
879,0.1377,0,16,0,37337,639107,1219,125037,5.061993093397541,0.16363015347892543
880,0.1378,0,7,0,37344,639100,1219,125037,5.061937650487898,0.1636316524392877
881,0.1379,0,4,0,37348,639096,1219,125037,5.061905968825244,0.16363250900039653
882,0.138,4,48,4,37396,639048,1223,125033,5.0615257888734,0.1636384100638545
883,0.1382,0,6,0,37402,639042,1223,125033,5.06147826637942,0.1636396950561136
884,0.1383,9,169,9,37571,638873,1232,125024,5.060139716132302,0.16366604398236936
885,0.1384,0,1,0,37572,638872,1232,125024,5.060131795716639,0.16366625823410516
886,0.1385,1,11,1,37583,638861,1233,125023,5.060044671144341,0.163667520199402
887,0.1386,1,4,1,37587,638857,1234,125022,5.060012989481688,0.16366728238372832
888,0.1387,2,11,2,37598,638846,1236,125020,5.05992586490939,0.16366744952648762
889,0.1388,0,12,0,37610,638834,1236,125020,5.059830819921429,0.16367002071076409
890,0.1389,0,3,0,37613,638831,1236,125020,5.059807058674439,0.16367066351945603
891,0.139,2,23,2,37636,638808,1238,125018,5.059624889114181,0.16367340205753667
892,0.1392,6,35,6,37671,638773,1244,125012,5.059347674565961,0.16367433243648408
893,0.1393,2,16,2,37687,638757,1246,125010,5.059220947915347,0.16367557121478146
894,0.1394,0,7,0,37694,638750,1246,125010,5.059165505005702,0.16367707133130827
895,0.1395,0,9,0,37703,638741,1246,125010,5.059094221264732,0.16367900009296224
896,0.1396,0,5,0,37708,638736,1246,125010,5.059054619186415,0.1636800716468564
897,0.1397,1,8,1,37716,638728,1247,125009,5.058991255861107,0.16368069112796682
898,0.1398,0,4,0,37720,638724,1247,125009,5.058959574198454,0.16368154839453056
899,0.1399,0,2,0,37722,638722,1247,125009,5.058943733367127,0.16368197703117982
900,0.14,90,2976,90,40698,635746,1337,124919,5.035372576352807,0.16422340977960073
901,0.1402,1,7,1,40705,635739,1338,124918,5.035317133443163,0.16422382230098453
902,0.1403,2,9,2,40714,635730,1340,124916,5.035245849702193,0.1642235678620541
903,0.1404,1,4,1,40718,635726,1341,124915,5.035214168039539,0.16422333268913983
904,0.1405,0,10,0,40728,635716,1341,124915,5.035134963882904,0.16422549172989268
905,0.1406,0,1,0,40729,635715,1341,124915,5.0351270434672415,0.1642257076370903
906,0.1407,0,20,0,40749,635695,1341,124915,5.034968635153973,0.16423002590026425
907,0.1408,0,50,0,40799,635645,1341,124915,5.034572614370802,0.16424082255180394
908,0.1409,0,2,0,40801,635643,1341,124915,5.034556773539475,0.16424125444739257
909,0.141,1,31,1,40832,635612,1342,124914,5.03431124065391,0.16424685020630458
910,0.1411,0,4,0,40836,635608,1342,124914,5.034279558991256,0.16424771407007294
911,0.1412,0,18,0,40854,635590,1342,124914,5.034136991509315,0.1642516015694855
912,0.1413,1,8,1,40862,635582,1343,124913,5.034073628184007,0.16425223045516407
913,0.1414,0,4,0,40866,635578,1343,124913,5.034041946521353,0.16425309438244504
914,0.1415,0,12,0,40878,635566,1343,124913,5.033946901533392,0.16425568621881734
915,0.1416,0,1,0,40879,635565,1343,124913,5.033938981117729,0.1642559022088739
916,0.1417,8,158,8,41037,635407,1351,124905,5.03268755544291,0.1642812424373152
917,0.1418,1,5,1,41042,635402,1352,124904,5.0326479533645925,0.1642812236125981
918,0.1419,0,6,0,41048,635396,1352,124904,5.0326004308706125,0.1642825200578719
919,0.142,2,37,2,41085,635359,1354,124902,5.032307375491066,0.1642883167754232
920,0.1421,1,4,1,41089,635355,1355,124901,5.032275693828412,0.16428808190925162
921,0.1422,1,7,1,41096,635348,1356,124900,5.032220250918768,0.16428849533310183
922,0.1423,1,10,1,41106,635338,1357,124899,5.032141046762134,0.16428955707233403
923,0.1424,0,2,0,41108,635336,1357,124899,5.032125205930807,0.16428998927963065
924,0.1425,6,197,6,41305,635139,1363,124893,5.0305648840451145,0.16432597574838953
925,0.1426,0,1,0,41306,635138,1363,124893,5.030556963629452,0.1643261919579596
926,0.1427,1,11,1,41317,635127,1364,124892,5.030469839057154,0.1643274707605994
927,0.1428,0,12,0,41329,635115,1364,124892,5.030374794069193,0.16433006538097675
928,0.1429,0,16,0,41345,635099,1364,124892,5.0302480674185786,0.16433352500226978
929,0.143,1,15,1,41360,635084,1365,124891,5.030129261183627,0.16433566893647816
930,0.1431,0,1,0,41361,635083,1365,124891,5.0301213407679635,0.16433588517501915
931,0.1432,0,6,0,41367,635077,1365,124891,5.030073818273983,0.1643371826182155
932,0.1433,16,368,16,41735,634709,1381,124875,5.027159105309846,0.1643991974554493
933,0.1434,0,5,0,41740,634704,1381,124875,5.027119503231529,0.16440027962858372
934,0.1435,1,5,1,41745,634699,1382,124874,5.027079901153212,0.16440026172599606
935,0.1436,0,2,0,41747,634697,1382,124874,5.0270640603218855,0.1644006946026112
936,0.1437,0,4,0,41751,634693,1382,124874,5.027032378659232,0.1644015603626803
937,0.1438,0,9,0,41760,634684,1382,124874,5.026961094918262,0.16440350835617557
938,0.1439,0,4,0,41764,634680,1382,124874,5.0269294132556075,0.16440437414588036
939,0.144,6,93,6,41857,634587,1388,124868,5.02619281459891,0.16441790494499345
940,0.1441,0,1,0,41858,634586,1388,124868,5.026184894183246,0.16441812143987655
941,0.1442,5,54,5,41912,634532,1393,124863,5.025757191737422,0.16442431145846365
942,0.1443,5,24,5,41936,634508,1398,124858,5.0255671017615,0.16442400634213278
943,0.1444,1,6,1,41942,634502,1399,124857,5.02551957926752,0.16442420515197687
944,0.1445,0,16,0,41958,634486,1399,124857,5.025392852616905,0.16442766970920913
945,0.1446,0,4,0,41962,634482,1399,124857,5.025361170954252,0.1644285358713302
946,0.1447,0,11,0,41973,634471,1399,124857,5.025274046381954,0.1644309178642168
947,0.1448,2,9,2,41982,634462,1401,124855,5.025202762640983,0.16443066598008474
948,0.1449,0,3,0,41985,634459,1401,124855,5.025179001393993,0.16443131563490204
949,0.145,30,725,30,42710,633734,1431,124825,5.019436700038018,0.16455542680266136
950,0.1451,1,3,1,42713,633731,1432,124824,5.019412938791028,0.16455497623771512
951,0.1452,1,8,1,42721,633723,1433,124823,5.0193495754657205,0.16455561033872698
952,0.1453,1,9,1,42730,633714,1434,124822,5.01927829172475,0.1645564613940538
953,0.1454,0,8,0,42738,633706,1434,124822,5.0192149283994425,0.1645581969287884
954,0.1455,0,7,0,42745,633699,1434,124822,5.019159485489799,0.1645597155517118
955,0.1456,0,2,0,42747,633697,1434,124822,5.019143644658472,0.1645601494491239
956,0.1457,1,23,1,42770,633674,1435,124821,5.018961475098213,0.1645640379962953
957,0.1458,7,46,7,42816,633628,1442,124814,5.018597135977696,0.16456630830043695
958,0.146,3,65,3,42881,633563,1445,124811,5.018082308959574,0.16457710839242906
959,0.1461,0,1,0,42882,633562,1445,124811,5.018074388543911,0.16457732540583592
960,0.1462,0,14,0,42896,633548,1445,124811,5.017963502724623,0.1645803636536258
961,0.1463,0,10,0,42906,633538,1445,124811,5.017884298567989,0.16458253389929967
962,0.1464,0,3,0,42909,633535,1445,124811,5.017860537320999,0.1645831849841629
963,0.1465,2,15,2,42924,633520,1447,124809,5.017741731086048,0.16458423718465204
964,0.1467,15,346,15,43270,633174,1462,124794,5.0150012672665065,0.16464283452599582
965,0.1468,1,4,1,43274,633170,1463,124793,5.014969585603852,0.16464260128792566
966,0.1469,0,2,0,43276,633168,1463,124793,5.014953744772526,0.1646430357234739
967,0.147,0,27,0,43303,633141,1463,124793,5.0147398935496135,0.16464890082777656
968,0.1471,0,9,0,43312,633132,1463,124793,5.014668609808643,0.16465085595540455
969,0.1472,0,2,0,43314,633130,1463,124793,5.0146527689773155,0.16465129043451643
970,0.1473,0,22,0,43336,633108,1463,124793,5.01447851983272,0.16465606985608938
971,0.1474,1,3,1,43339,633105,1464,124792,5.014454758585731,0.1646556194311364
972,0.1475,12,182,12,43521,632923,1476,124780,5.013013242934989,0.164681940021354
973,0.1476,0,3,0,43524,632920,1476,124780,5.012989481687999,0.164682592054903
974,0.1477,0,14,0,43538,632906,1476,124780,5.012878595868711,0.1646856349464026
975,0.1478,1,6,1,43544,632900,1477,124779,5.0128310733747306,0.16468583661418623
976,0.1479,0,8,0,43552,632892,1477,124779,5.012767710049423,0.1646875754780109
977,0.148,3,34,3,43586,632858,1480,124776,5.012498415916867,0.1646916585052941
978,0.1481,0,2,0,43588,632856,1480,124776,5.01248257508554,0.16469209325899645
979,0.1482,0,7,0,43595,632849,1480,124776,5.012427132175897,0.1646936149150305
980,0.1483,12,130,12,43725,632719,1492,124764,5.011397478139653,0.1647086469267297
981,0.1484,0,2,0,43727,632717,1492,124764,5.011381637308326,0.16470908181195304
982,0.1485,0,16,0,43743,632701,1492,124764,5.011254910657711,0.16471256097641476
983,0.1486,0,7,0,43750,632694,1492,124764,5.011199467748067,0.16471408315708594
984,0.1487,2,13,2,43763,632681,1494,124762,5.011096502344443,0.16471470460483495
985,0.1488,0,6,0,43769,632675,1494,124762,5.011048979850463,0.16471600938427883
986,0.1489,0,4,0,43773,632671,1494,124762,5.0110172981878085,0.16471687924872563
987,0.149,3,36,3,43809,632635,1497,124759,5.010732163223926,0.164721399958278
988,0.1492,1,48,1,43857,632587,1498,124758,5.010351983272082,0.16473073698248486
989,0.1493,3,21,3,43878,632566,1501,124755,5.01018565454315,0.16473199607564032
990,0.1494,1,0,1,43878,632566,1502,124754,5.01018565454315,0.16473089314952727
991,0.1495,0,8,0,43886,632558,1502,124754,5.010122291217843,0.16473263331361446
992,0.1496,0,5,0,43891,632553,1502,124754,5.0100826891395265,0.16473372093483885
993,0.1497,1,6,1,43897,632547,1503,124753,5.010035166645546,0.16473392314802587
994,0.1498,0,8,0,43905,632539,1503,124753,5.009971803320238,0.1647356633900794
995,0.1499,0,1,0,43906,632538,1503,124753,5.009963882904575,0.1647358809229213
996,0.15,115,3119,115,47025,629419,1618,124638,4.9852601064503865,0.1652898918782002
997,0.1501,0,2,0,47027,629417,1618,124638,4.98524426561906,0.16529033028094767
998,0.1502,1,7,1,47034,629410,1619,124637,4.985188822709416,0.16529075773791288
999,0.1503,0,12,0,47046,629398,1619,124637,4.985093777721455,0.1652933882379465
1000,0.1505,1,6,1,47052,629392,1620,124636,4.985046255227474,0.165293596524267
1001,0.1506,1,1,1,47053,629391,1621,124635,4.985038334811811,0.16529270873948643
1002,0.1507,2,28,2,47081,629363,1623,124633,4.9848165631732355,0.16529663287338395
1003,0.1508,2,39,2,47120,629324,1625,124631,4.9845076669623625,0.16530296901008681
1004,0.151,6,41,6,47161,629283,1631,124625,4.984182929920162,0.1653053157679717
1005,0.1511,0,2,0,47163,629281,1631,124625,4.984167089088835,0.1653057542982812
1006,0.1512,1,8,1,47171,629273,1632,124624,4.984103725763528,0.16530640127232235
1007,0.1513,1,12,1,47183,629261,1633,124623,4.984008680775567,0.16530792535721675
1008,0.1514,0,6,0,47189,629255,1633,124623,4.983961158281587,0.16530924101777741
1009,0.1515,1,16,1,47205,629239,1634,124622,4.983834431630972,0.16531164233194184
1010,0.1516,0,4,0,47209,629235,1634,124622,4.983802749968318,0.16531251948313805
1011,0.1517,11,176,11,47385,629059,1645,124611,4.982408756811558,0.1653389414465217
1012,0.1518,0,14,0,47399,629045,1645,124611,4.982297870992269,0.1653420128015965
1013,0.152,2,59,2,47458,628986,1647,124609,4.981830566468128,0.16535274252085005
1014,0.1521,0,1,0,47459,628985,1647,124609,4.981822646052465,0.1653529619397182
1015,0.1522,0,6,0,47465,628979,1647,124609,4.981775123558484,0.16535427846515602
1016,0.1523,1,14,1,47479,628965,1648,124608,4.981664237739197,0.16535624285901962
1017,0.1524,0,2,0,47481,628963,1648,124608,4.98164839690787,0.16535668171943985
1018,0.1525,8,187,8,47668,628776,1656,124600,4.980167279178811,0.16538886293165697
1019,0.1526,0,4,0,47672,628772,1656,124600,4.980135597516158,0.16538974105753865
1020,0.1527,0,18,0,47690,628754,1656,124600,4.979993030034216,0.16539369273940271
1021,0.1528,0,9,0,47699,628745,1656,124600,4.979921746293246,0.1653956686511492
1022,0.1529,0,20,0,47719,628725,1656,124600,4.9797633379799775,0.16540005973517405
1023,0.153,0,27,0,47746,628698,1656,124600,4.979549486757065,0.16540598806846693
1024,0.1531,0,2,0,47748,628696,1656,124600,4.979533645925738,0.16540642722117202
1025,0.1532,0,8,0,47756,628688,1656,124600,4.979470282600431,0.16540818385531164
1026,0.1533,23,394,23,48150,628294,1679,124577,4.976349638829046,0.16546925037622648
1027,0.1534,0,6,0,48156,628288,1679,124577,4.976302116335066,0.16547056909273242
1028,0.1535,0,6,0,48162,628282,1679,124577,4.976254593841085,0.16547188783025774
1029,0.1536,0,7,0,48169,628275,1679,124577,4.976199150931441,0.16547342638393736
1030,0.1537,0,17,0,48186,628258,1679,124577,4.976064503865163,0.16547716299056234
1031,0.1538,0,11,0,48197,628247,1679,124577,4.975977379292865,0.16547958088477518
1032,0.1539,0,5,0,48202,628242,1679,124577,4.975937777214548,0.16548067995095767
1033,0.154,1,72,1,48274,628170,1680,124576,4.975367507286783,0.1654953995105919
1034,0.1541,0,1,0,48275,628169,1680,124576,4.975359586871119,0.16549561936645213
1035,0.1542,5,46,5,48321,628123,1685,124571,4.974995247750602,0.16550018998424326
1036,0.1543,2,25,2,48346,628098,1687,124569,4.974797237359017,0.16550346966188234
1037,0.1544,0,4,0,48350,628094,1687,124569,4.974765555696363,0.1655043492240219
1038,0.1545,1,14,1,48364,628080,1688,124568,4.974654669877075,0.16550631902296956
1039,0.1546,1,3,1,48367,628077,1689,124567,4.974630908630085,0.165505869973055
1040,0.1547,0,15,0,48382,628062,1689,124567,4.974512102395134,0.16550916852792014
1041,0.1548,0,10,0,48392,628052,1689,124567,4.9744328982385,0.16551136763754304
1042,0.1549,0,1,0,48393,628051,1689,124567,4.974424977822836,0.16551158755171946
1043,0.155,35,814,35,49207,627237,1724,124532,4.967977759472817,0.16565194893644192
1044,0.1551,1,0,1,49207,627237,1725,124531,4.967977759472817,0.16565083908865502
1045,0.1552,0,10,0,49217,627227,1725,124531,4.967898555316183,0.16565304260147548
1046,0.1553,2,18,2,49235,627209,1727,124529,4.967755987834241,0.16565478930159178
1047,0.1554,0,5,0,49240,627204,1727,124529,4.967716385755924,0.1656558911209166
1048,0.1555,1,5,1,49245,627199,1728,124528,4.967676783677607,0.1656558830532893
1049,0.1556,0,4,0,49249,627195,1728,124528,4.967645102014954,0.16565676452629494
1050,0.1557,1,22,1,49271,627173,1729,124527,4.967470852870359,0.16566050286018358
1051,0.1558,5,44,5,49315,627129,1734,124522,4.967122354581169,0.1656646502166564
1052,0.1559,0,2,0,49317,627127,1734,124522,4.967106513749842,0.16566509101987764
1053,0.156,4,70,4,49387,627057,1738,124518,4.966552084653403,0.1656760802315138
1054,0.1561,0,1,0,49388,627056,1738,124518,4.966544164237739,0.16567630067032654
1055,0.1562,1,11,1,49399,627045,1739,124517,4.966457039665442,0.1656776154196194
1056,0.1563,2,13,2,49412,627032,1741,124515,4.966354074261817,0.16567826097369825
1057,0.1564,0,1,0,49413,627031,1741,124515,4.966346153846154,0.16567848142362543
1058,0.1565,3,22,3,49435,627009,1744,124512,4.966171904701559,0.16568000095805707
1059,0.1566,1,3,1,49438,627006,1745,124511,4.966148143454569,0.16567955215916605
1060,0.1567,14,413,14,49851,626593,1759,124497,4.9628770117855785,0.16575510258424422
1061,0.1568,0,14,0,49865,626579,1759,124497,4.962766125966291,0.1657581922468565
1062,0.1569,0,6,0,49871,626573,1759,124497,4.96271860347231,0.1657595164232362
1063,0.157,2,21,2,49892,626552,1761,124495,4.962552274743379,0.16576192967950076
1064,0.1571,0,10,0,49902,626542,1761,124495,4.962473070586745,0.16576413678686935
1065,0.1572,0,9,0,49911,626533,1761,124495,4.962401786845773,0.16576612323375428
1066,0.1573,0,18,0,49929,626515,1761,124495,4.962259219363832,0.1657700962703559
1067,0.1574,0,2,0,49931,626513,1761,124495,4.962243378532506,0.16577053773062336
1068,0.1575,7,199,7,50130,626314,1768,124488,4.960667215815486,0.16580669737161063
1069,0.1576,0,6,0,50136,626308,1768,124488,4.960619693321505,0.16580802241887277
1070,0.1577,1,9,1,50145,626299,1769,124487,4.960548409580535,0.16580889894057693
1071,0.1578,0,10,0,50155,626289,1769,124487,4.960469205423901,0.16581110744083455
1072,0.1579,2,8,2,50163,626281,1771,124485,4.960405842098593,0.16581065205403547
1073,0.158,2,51,2,50214,626230,1773,124483,4.960001900899759,0.165819694077497
1074,0.1581,0,2,0,50216,626228,1773,124483,4.959986060068433,0.16582013584455269
1075,0.1582,1,10,1,50226,626218,1774,124482,4.9599068559117985,0.16582123351538564
1076,0.1583,8,181,8,50407,626037,1782,124474,4.95847326067672,0.16585233261071455
1077,0.1584,0,1,0,50408,626036,1782,124474,4.958465340261057,0.16585255359688744
1078,0.1585,1,16,1,50424,626020,1783,124473,4.958338613610442,0.16585497799446497
1079,0.1586,0,3,0,50427,626017,1783,124473,4.958314852363452,0.1658556409812256
1080,0.1587,1,18,1,50445,625999,1784,124472,4.958172284881511,0.16585850752394163
1081,0.1588,0,13,0,50458,625986,1784,124472,4.958069319477886,0.16586138065021627
1082,0.1589,1,2,1,50460,625984,1785,124471,4.958053478646559,0.16586071116855775
1083,0.159,0,45,0,50505,625939,1785,124471,4.957697059941705,0.1658706573739689
1084,0.1592,5,42,5,50547,625897,1790,124466,4.957364402483842,0.16587438346506958
1085,0.1593,0,24,0,50571,625873,1790,124466,4.95717431250792,0.16587968904721734
1086,0.1594,1,5,1,50576,625868,1791,124465,4.957134710429603,0.16587968275419046
1087,0.1595,0,12,0,50588,625856,1791,124465,4.957039665441642,0.16588233569365646
1088,0.1596,0,1,0,50589,625855,1791,124465,4.957031745025979,0.16588255677577568
1089,0.1597,0,9,0,50598,625846,1791,124465,4.956960461285008,0.1658845465413675
1090,0.1598,1,7,1,50605,625839,1792,124464,4.956905018375364,0.1658849824670833
1091,0.1599,0,1,0,50606,625838,1792,124464,4.956897097959701,0.16588520355803396
1092,0.16,140,3285,140,53891,622553,1932,124324,4.930878532505386,0.16645846638737033
1093,0.1601,0,2,0,53893,622551,1932,124324,4.930862691674059,0.16645891213389122
1094,0.1602,0,3,0,53896,622548,1932,124324,4.930838930427069,0.16645958075814865
1095,0.1603,1,10,1,53906,622538,1933,124323,4.930759726270435,0.16646069348914994
1096,0.1604,0,8,0,53914,622530,1933,124323,4.9306963629451275,0.16646247655161056
1097,0.1605,1,14,1,53928,622516,1934,124322,4.93058547712584,0.16646448091821786
1098,0.1606,0,4,0,53932,622512,1934,124322,4.930553795463186,0.16646537249241464
1099,0.1607,2,24,2,53956,622488,1936,124320,4.930363705487264,0.16646848989298454
1100,0.1608,6,67,6,54023,622421,1942,124314,4.929833037637815,0.16647672869224023
1101,0.1609,0,1,0,54024,622420,1942,124314,4.929825117222152,0.16647695163204032
1102,0.161,3,45,3,54069,622375,1945,124311,4.929468698517298,0.16648363569157584
1103,0.1611,0,4,0,54073,622371,1945,124311,4.929437016854645,0.16648452754988066
1104,0.1612,0,11,0,54084,622360,1945,124311,4.929349892282347,0.16648698020948985
1105,0.1613,0,17,0,54101,622343,1945,124311,4.929215245216069,0.1664907708255765
1106,0.1614,0,10,0,54111,622333,1945,124311,4.929136041059435,0.16649300068037778
1107,0.1615,2,24,2,54135,622309,1947,124309,4.928945951083513,0.16649611983638218
1108,0.1616,0,3,0,54138,622306,1947,124309,4.9289221898365225,0.16649678884029923
1109,0.1617,11,154,11,54292,622152,1958,124298,4.927702445824357,0.1665188559180119
1110,0.1618,0,19,0,54311,622133,1958,124298,4.927551957926752,0.1665230945660081
1111,0.1619,0,3,0,54314,622130,1958,124298,4.927528196679762,0.1665237638459436
1112,0.162,1,51,1,54365,622079,1959,124297,4.927124255480928,0.16653402574573672
1113,0.1621,0,4,0,54369,622075,1959,124297,4.927092573818274,0.1665349182445215
1114,0.1622,1,7,1,54376,622068,1960,124296,4.92703713090863,0.16653536344196665
1115,0.1623,0,9,0,54385,622059,1960,124296,4.92696584716766,0.16653737162610285
1116,0.1624,0,5,0,54390,622054,1960,124296,4.9269262450893425,0.16653848730488377
1117,0.1625,12,198,12,54588,621856,1972,124284,4.925358002787986,0.16656927654327605
1118,0.1626,1,4,1,54592,621852,1973,124283,4.925326321125333,0.16656905251730586
1119,0.1627,1,36,1,54628,621816,1974,124282,4.92504118616145,0.16657597259341267
1120,0.1628,0,11,0,54639,621805,1974,124282,4.924954061589152,0.1665784285210706
1121,0.1629,0,14,0,54653,621791,1974,124282,4.9248431757698645,0.16658155435191999
1122,0.163,0,28,0,54681,621763,1974,124282,4.924621404131289,0.16658780636556775
1123,0.1631,0,5,0,54686,621758,1974,124282,4.9245818020529715,0.16658892284596
1124,0.1632,2,11,2,54697,621747,1976,124280,4.924494677480674,0.16658914489690052
1125,0.1633,21,445,21,55142,621302,1997,124259,4.920970092510455,0.16666510184947977
1126,0.1634,0,3,0,55145,621299,1997,124259,4.9209463312634645,0.166665772481819
1127,0.1635,0,18,0,55163,621281,1997,124259,4.920803763781524,0.1666697963891944
1128,0.1636,0,2,0,55165,621279,1997,124259,4.920787922950196,0.16667024350200796
1129,0.1637,0,21,0,55186,621258,1997,124259,4.920621594221265,0.16667493833138614
1130,0.1638,1,8,1,55194,621250,1998,124258,4.920558230895957,0.1666756091148586
1131,0.164,2,78,2,55272,621172,2000,124256,4.919940438474211,0.16669081386800602
1132,0.1641,0,1,0,55273,621171,2000,124256,4.919932518058547,0.16669103748589734
1133,0.1642,2,49,2,55322,621122,2002,124254,4.91954441769104,0.1666997595844245
1134,0.1643,2,21,2,55343,621101,2004,124252,4.919378088962109,0.16670222029025172
1135,0.1644,0,9,0,55352,621092,2004,124252,4.919306805221138,0.1667042332131204
1136,0.1645,2,11,2,55363,621081,2006,124250,4.91921968064884,0.16670445748264864
1137,0.1646,0,5,0,55368,621076,2006,124250,4.919180078570523,0.16670557581514667
1138,0.1647,0,15,0,55383,621061,2006,124250,4.919061272335572,0.16670893090267017
1139,0.1648,0,15,0,55398,621046,2006,124250,4.918942466100621,0.1667122861252442
1140,0.1649,1,0,1,55398,621046,2007,124249,4.918942466100621,0.16671116806096914
1141,0.165,41,889,41,56287,620157,2048,124208,4.9119012165758456,0.16686437433248474
1142,0.1651,0,4,0,56291,620153,2048,124208,4.911869534913192,0.1668652710176917
1143,0.1652,0,5,0,56296,620148,2048,124208,4.911829932834875,0.16686639188775262
1144,0.1653,1,22,1,56318,620126,2049,124207,4.91165568369028,0.16687020459928553
1145,0.1654,0,2,0,56320,620124,2049,124207,4.911639842858953,0.1668706529756251
1146,0.1655,0,8,0,56328,620116,2049,124207,4.911576479533646,0.16687244650507913
1147,0.1656,1,4,1,56332,620112,2050,124206,4.9115447978709925,0.16687222396878754
1148,0.1657,1,30,1,56362,620082,2051,124205,4.91130718540109,0.16687783072927515
1149,0.1658,2,69,2,56431,620013,2053,124203,4.910760676720314,0.16689106388467864
1150,0.1659,0,1,0,56432,620012,2053,124203,4.9107527563046505,0.16689128813582096
1151,0.166,2,85,2,56517,619927,2055,124201,4.910079520973261,0.16690811258278146
1152,0.1661,0,5,0,56522,619922,2055,124201,4.9100399188949435,0.1669092340916757
1153,0.1662,2,19,2,56541,619903,2057,124199,4.909889430997339,0.16691125679006372
1154,0.1663,0,8,0,56549,619895,2057,124199,4.909826067672031,0.16691305130803366
1155,0.1664,0,1,0,56550,619894,2057,124199,4.9098181472563684,0.16691327562549305
1156,0.1665,2,26,2,56576,619868,2059,124197,4.909612216449119,0.16691686882194431
1157,0.1666,0,1,0,56577,619867,2059,124197,4.909604296033456,0.16691709315327713
1158,0.1667,28,440,28,57017,619427,2087,124169,4.906119313141554,0.1669844915787605
1159,0.1668,2,4,2,57021,619423,2089,124167,4.9060876314789,0.1669831493161554
1160,0.1669,0,1,0,57022,619422,2089,124167,4.906079711063237,0.1669833738799256
1161,0.167,2,36,2,57058,619386,2091,124165,4.905794576099353,0.16698921795545968
1162,0.1671,0,7,0,57065,619379,2091,124165,4.9057391331897096,0.16699079005411918
1163,0.1672,0,5,0,57070,619374,2091,124165,4.9056995311113925,0.1669919129998561
1164,0.1673,0,32,0,57102,619342,2091,124165,4.905446077810163,0.16699910021021994
1165,0.1674,0,3,0,57105,619339,2091,124165,4.905422316563174,0.16699977404291033
1166,0.1675,7,180,7,57285,619159,2098,124158,4.903996641743759,0.16703236976955996
1167,0.1676,0,5,0,57290,619154,2098,124158,4.903957039665442,0.1670334933379254
1168,0.1677,0,18,0,57308,619136,2098,124158,4.9038144721835,0.167037538309202
1169,0.1678,0,9,0,57317,619127,2098,124158,4.9037431884425295,0.16703956086830757
1170,0.1679,0,4,0,57321,619123,2098,124158,4.903711506779876,0.16704045979918766
1171,0.168,1,49,1,57370,619074,2099,124157,4.903323406412368,0.1670503517748856
1172,0.1681,1,7,1,57377,619067,2100,124156,4.903267963502724,0.16705080440190898
1173,0.1682,0,11,0,57388,619056,2100,124156,4.903180838930427,0.16705327685774718
1174,0.1683,11,216,11,57604,618840,2111,124145,4.90147002914713,0.16708951055539478
1175,0.1684,0,5,0,57609,618835,2111,124145,4.901430427068813,0.16709063501036367
1176,0.1685,1,8,1,57617,618827,2112,124144,4.901367063743505,0.16709131311989298
1177,0.1686,0,4,0,57621,618823,2112,124144,4.901335382080852,0.1670922127093128
1178,0.1687,3,24,3,57645,618799,2115,124141,4.90114529210493,0.16709424718012222
1179,0.1688,2,9,2,57654,618790,2117,124139,4.901074008363959,0.16709402917371646
1180,0.1689,0,8,0,57662,618782,2117,124139,4.901010645038651,0.16709582849320453
1181,0.169,4,46,4,57708,618736,2121,124135,4.900646305918134,0.16710169060307914
1182,0.1691,0,1,0,57709,618735,2121,124135,4.9006383855024716,0.16710191554376944
1183,0.1692,4,71,4,57780,618664,2125,124131,4.900076035990368,0.16711340275580747
1184,0.1693,1,40,1,57820,618624,2126,124130,4.899759219363832,0.16712128107017937
1185,0.1694,0,6,0,57826,618618,2126,124130,4.8997116968698515,0.16712263109426076
1186,0.1695,0,18,0,57844,618600,2126,124130,4.899569129387911,0.1671266812973759
1187,0.1696,0,6,0,57850,618594,2126,124130,4.89952160689393,0.16712803140870633
1188,0.1697,0,15,0,57865,618579,2126,124130,4.8994028006589785,0.16713140678246796
1189,0.1698,0,13,0,57878,618566,2126,124130,4.899299835255354,0.16713433221668084
1190,0.1699,1,3,1,57881,618563,2127,124129,4.899276074008364,0.16713388591771555
1191,0.17,141,3652,141,61533,614911,2268,123988,4.870350716005576,0.16780101204630132
1192,0.1701,0,3,0,61536,614908,2268,123988,4.8703269547585855,0.1678016933370867
1193,0.1702,1,8,1,61544,614900,2269,123987,4.870263591433279,0.16780238385571813
1194,0.1703,1,13,1,61557,614887,2270,123986,4.870160626029654,0.1678042099251157
1195,0.1704,0,4,0,61561,614883,2270,123986,4.870128944367,0.1678051183633364
1196,0.1705,1,13,1,61574,614870,2271,123985,4.870025978963376,0.1678069445290348
1197,0.1706,0,2,0,61576,614868,2271,123985,4.8700101381320495,0.16780739876538364
1198,0.1707,1,33,1,61609,614835,2272,123984,4.8697487644151565,0.16781376764809786
1199,0.1708,6,55,6,61664,614780,2278,123978,4.869313141553668,0.16781950246224067
1200,0.1709,0,1,0,61665,614779,2278,123978,4.8693052211380055,0.1678197296269274
1201,0.171,1,35,1,61700,614744,2279,123977,4.869028006589786,0.16782655427421178
1202,0.1711,0,5,0,61705,614739,2279,123977,4.868988404511469,0.16782769020841568
1203,0.1712,1,8,1,61713,614731,2280,123976,4.868925041186161,0.16782838121203672
1204,0.1713,1,28,1,61741,614703,2281,123975,4.868703269547586,0.1678336162712305
1205,0.1714,0,10,0,61751,614693,2281,123975,4.868624065390952,0.16783588838287294
1206,0.1715,1,12,1,61763,614681,2282,123974,4.868529020402991,0.1678374884079848
1207,0.1716,0,5,0,61768,614676,2282,123974,4.868489418324674,0.1678386245177012
1208,0.1717,8,194,8,61962,614482,2290,123966,4.8669528576859715,0.1678737026845492
1209,0.1718,2,25,2,61987,614457,2292,123964,4.866754847294386,0.16787713242174856
1210,0.172,5,51,5,62038,614406,2297,123959,4.866350906095552,0.1678830930501852
1211,0.1721,0,7,0,62045,614399,2297,123959,4.866295463185908,0.16788468466516243
1212,0.1722,1,5,1,62050,614394,2298,123958,4.866255861107591,0.16788469456302685
1213,0.1723,1,19,1,62069,614375,2299,123957,4.866105373209986,0.1678878878336575
1214,0.1724,0,5,0,62074,614370,2299,123957,4.866065771131669,0.16788902478170242
1215,0.1725,12,231,12,62305,614139,2311,123945,4.864236155113421,0.1679280407108134
1216,0.1726,1,5,1,62310,614134,2312,123944,4.864196553035104,0.16792805096480318
1217,0.1727,1,18,1,62328,614116,2313,123943,4.864053985553162,0.1679310190648715
1218,0.1728,0,4,0,62332,614112,2313,123943,4.864022303890509,0.16793192919226888
1219,0.1729,2,9,2,62341,614103,2315,123941,4.863951020149537,0.16793172222794306
1220,0.173,2,28,2,62369,614075,2317,123939,4.863729248510962,0.1679358386155276
1221,0.1731,0,8,0,62377,614067,2317,123939,4.863665885185655,0.16793765904342242
1222,0.1732,0,7,0,62384,614060,2317,123939,4.863610442276011,0.1679392519502059
1223,0.1733,21,447,21,62831,613613,2338,123918,4.860070016474465,0.16801734435569488
1224,0.1734,0,3,0,62834,613610,2338,123918,4.860046255227474,0.16801802779013136
1225,0.1735,0,14,0,62848,613596,2338,123918,4.859935369408187,0.16802121722435098
1226,0.1736,0,3,0,62851,613593,2338,123918,4.859911608161196,0.1680219006902948
1227,0.1737,0,17,0,62868,613576,2338,123918,4.859776961094918,0.16802577376900693
1228,0.1738,1,4,1,62872,613572,2339,123917,4.859745279432264,0.16802555699135852
1229,0.1739,0,2,0,62874,613570,2339,123917,4.8597294386009375,0.1680260126619181
1230,0.174,4,91,4,62965,613479,2343,123913,4.859008680775567,0.16804223533751383
1231,0.1741,1,4,1,62969,613475,2344,123912,4.8589769991129135,0.1680420186415003
1232,0.1742,2,76,2,63045,613399,2346,123910,4.858375047522494,0.16805708325817262
1233,0.1743,1,39,1,63084,613360,2347,123909,4.858066151311621,0.16806484471746405
1234,0.1745,3,17,3,63101,613343,2350,123906,4.857931504245343,0.1680653347783449
1235,0.1746,0,3,0,63104,613340,2350,123906,4.857907742998353,0.16806601866948073
1236,0.1747,1,19,1,63123,613321,2351,123905,4.857757255100748,0.16806922164980617
1237,0.1748,0,14,0,63137,613307,2351,123905,4.8576463692814595,0.1680724133627776
1238,0.1749,1,7,1,63144,613300,2352,123904,4.857590926371816,0.16807288077655574
1239,0.175,33,898,33,64042,612402,2385,123871,4.85047839310607,0.16824058467443462
1240,0.1751,1,5,1,64047,612397,2386,123870,4.850438791027753,0.16824059750063497
1241,0.1752,0,7,0,64054,612390,2386,123870,4.850383348118109,0.1682421970499552
1242,0.1753,0,9,0,64063,612381,2386,123870,4.850312064377139,0.16824425365805953
1243,0.1754,0,4,0,64067,612377,2386,123870,4.850280382714485,0.16824516772224538
1244,0.1755,2,11,2,64078,612366,2388,123868,4.850193258142188,0.16824542197181874
1245,0.1756,0,3,0,64081,612363,2388,123868,4.850169496895197,0.16824610753961733
1246,0.1757,1,24,1,64105,612339,2389,123867,4.849979406919275,0.16825046250641804
1247,0.1758,1,66,1,64171,612273,2390,123866,4.84945665948549,0.1682644174537689
1248,0.176,9,89,9,64260,612184,2399,123857,4.848751742491446,0.16827459339900902
1249,0.1761,1,4,1,64264,612180,2400,123856,4.848720060828792,0.16827437788369048
1250,0.1762,1,15,1,64279,612165,2401,123855,4.8486012545938415,0.16827667726420478
1251,0.1763,0,18,0,64297,612147,2401,123855,4.8484586871119,0.1682807927152372
1252,0.1764,0,7,0,64304,612140,2401,123855,4.848403244202256,0.16828239322278005
1253,0.1765,0,24,0,64328,612116,2401,123855,4.848213154226333,0.168287880908351
1254,0.1766,0,1,0,64329,612115,2401,123855,4.8482052338106705,0.16828810956968354
1255,0.1767,21,466,21,64795,611649,2422,123834,4.84451432011152,0.16837098886038154
1256,0.1768,0,11,0,64806,611638,2422,123834,4.844427195539222,0.1683735070811669
1257,0.1769,0,2,0,64808,611636,2422,123834,4.844411354707895,0.16837396494758453
1258,0.177,2,30,2,64838,611606,2424,123832,4.8441737422379925,0.16837857168109344
1259,0.1771,0,8,0,64846,611598,2424,123832,4.844110378912685,0.1683804033014699
1260,0.1772,0,8,0,64854,611590,2424,123832,4.844047015587378,0.16838223496169547
1261,0.1773,1,40,1,64894,611550,2425,123831,4.8437301989608414,0.16839026300652316
1262,0.1774,0,6,0,64900,611544,2425,123831,4.843682676466861,0.1683916369199388
1263,0.1775,9,190,9,65090,611354,2434,123822,4.8421777974908125,0.1684249757881106
1264,0.1776,0,5,0,65095,611349,2434,123822,4.842138195412495,0.1684261212697454
1265,0.1777,1,15,1,65110,611334,2435,123821,4.842019389177544,0.16842842665832375
1266,0.1778,0,13,0,65123,611321,2435,123821,4.841916423773919,0.16843140508908483
1267,0.1779,0,8,0,65131,611313,2435,123821,4.841853060448613,0.16843323802191165
1268,0.178,3,52,3,65183,611261,2438,123818,4.841441198834115,0.16844175932110697
1269,0.1781,0,2,0,65185,611259,2438,123818,4.841425358002788,0.16844221761801825
1270,0.1782,1,8,1,65193,611251,2439,123817,4.841361994677481,0.16844291956662513
1271,0.1783,11,224,11,65417,611027,2450,123806,4.839587821568876,0.16848181831790351
1272,0.1784,0,3,0,65420,611024,2450,123806,4.8395640603218855,0.16848250615788685
1273,0.1785,1,18,1,65438,611006,2451,123805,4.839421492839945,0.1684855017140462
1274,0.1786,0,10,0,65448,610996,2451,123805,4.83934228868331,0.16848779465460717
1275,0.1787,4,16,4,65464,610980,2455,123801,4.839215562032695,0.16848693692406308
1276,0.1788,0,2,0,65466,610978,2455,123801,4.839199721201369,0.16848739552981237
1277,0.1789,0,8,0,65474,610970,2455,123801,4.839136357876061,0.16848922997777538
1278,0.179,3,39,3,65513,610931,2458,123798,4.838827461665188,0.16849477834684626
1279,0.1791,0,1,0,65514,610930,2458,123798,4.838819541249525,0.16849500767631015
1280,0.1792,1,70,1,65584,610860,2459,123797,4.838265112153086,0.16850993048456628
1281,0.1793,4,24,4,65608,610836,2463,123793,4.838075022177164,0.16851090822714596
1282,0.1794,0,3,0,65611,610833,2463,123793,4.838051260930174,0.16851159637693194
1283,0.1795,1,27,1,65638,610806,2464,123792,4.837837409707261,0.16851665809054747
1284,0.1796,0,3,0,65641,610803,2464,123792,4.837813648460271,0.16851734629285525
1285,0.1797,1,22,1,65663,610781,2465,123791,4.837639399315676,0.16852126136035678
1286,0.1798,1,14,1,65677,610767,2466,123790,4.837528513496388,0.16852334127916554
1287,0.1799,0,4,0,65681,610763,2466,123790,4.837496831833735,0.16852425897110215
1288,0.18,155,3736,155,69417,607027,2621,123635,4.80790615891522,0.16920956611949164
1289,0.1801,1,1,1,69418,607026,2622,123634,4.807898238499557,0.16920866066296225
1290,0.1802,1,10,1,69428,607016,2623,123633,4.807819034342923,0.16920983947148358
1291,0.1803,1,14,1,69442,607002,2624,123632,4.807708148523634,0.1692119446946077
1292,0.1804,0,4,0,69446,606998,2624,123632,4.807676466860981,0.16921287108385913
1293,0.1805,2,20,2,69466,606978,2626,123630,4.807518058547712,0.1692152289599895
1294,0.1806,0,4,0,69470,606974,2626,123630,4.807486376885059,0.16921615540018944
1295,0.1807,2,29,2,69499,606945,2628,123628,4.80725668483082,0.16922059807849454
1296,0.1808,2,62,2,69561,606883,2630,123626,4.806765619059688,0.16923268570270866
1297,0.1809,0,2,0,69563,606881,2630,123626,4.806749778228362,0.16923314903211056
1298,0.181,4,36,4,69599,606845,2634,123622,4.806464643264478,0.16923694020400648
1299,0.1811,0,2,0,69601,606843,2634,123622,4.8064488024331515,0.16923740357169748
1300,0.1812,1,13,1,69614,606830,2635,123621,4.806345837029527,0.16923927819935902
1301,0.1813,0,23,0,69637,606807,2635,123621,4.806163667469269,0.16924460727135324
1302,0.1814,1,4,1,69641,606803,2636,123620,4.806131985806615,0.16924439673997121
1303,0.1815,1,12,1,69653,606791,2637,123619,4.806036940818654,0.1692460398954012
1304,0.1816,0,5,0,69658,606786,2637,123619,4.805997338740337,0.16924719847208056
1305,0.1817,4,233,4,69891,606553,2641,123615,4.804151881890761,0.1692966550163798
1306,0.1818,0,18,0,69909,606535,2641,123615,4.8040093144088205,0.16930082859686366
1307,0.1819,1,8,1,69917,606527,2642,123614,4.803945951083513,0.16930154586579851
1308,0.182,4,57,4,69974,606470,2646,123610,4.803494487390698,0.16931021257944334
1309,0.1821,1,9,1,69983,606461,2647,123609,4.803423203649728,0.16931116194337528
1310,0.1822,0,5,0,69988,606456,2647,123609,4.803383601571411,0.16931232150561937
1311,0.1823,1,24,1,70012,606432,2648,123608,4.803193511595489,0.16931674976713604
1312,0.1824,0,7,0,70019,606425,2648,123608,4.803138068685844,0.16931837327901617
1313,0.1825,8,240,8,70259,606185,2656,123600,4.801237168926625,0.16936494995101298
1314,0.1826,0,5,0,70264,606180,2656,123600,4.801197566848308,0.1693661103346214
1315,0.1827,4,25,4,70289,606155,2660,123596,4.8009995564567225,0.16936735955140864
1316,0.1828,0,10,0,70299,606145,2660,123596,4.800920352300088,0.1693696804756756
1317,0.1829,2,21,2,70320,606124,2662,123594,4.800754023571157,0.16937227805809915
1318,0.183,1,21,1,70341,606103,2663,123593,4.800587694842226,0.169376014120949
1319,0.1831,0,3,0,70344,606100,2663,123593,4.800563933595235,0.16937671047961267
1320,0.1832,0,15,0,70359,606085,2663,123593,4.800445127360284,0.1693801923588213
1321,0.1833,22,513,22,70872,605572,2685,123571,4.796381954124953,0.16947430065158686
1322,0.1834,0,2,0,70874,605570,2685,123571,4.796366113293626,0.169474765511746
1323,0.1835,0,11,0,70885,605559,2685,123571,4.796278988721328,0.1694773222882065
1324,0.1836,0,1,0,70886,605558,2685,123571,4.796271068305665,0.16947755472625559
1325,0.1837,1,13,1,70899,605545,2686,123570,4.79616810290204,0.16947943740013577
1326,0.1838,0,22,0,70921,605523,2686,123570,4.795993853757445,0.16948455135353102
1327,0.1839,1,7,1,70928,605516,2687,123569,4.795938410847802,0.16948503946727747
1328,0.184,6,103,6,71031,605413,2693,123563,4.79512260803447,0.16950215096244595
1329,0.1841,0,2,0,71033,605411,2693,123563,4.795106767203142,0.16950261600550912
1330,0.1842,8,77,8,71110,605334,2701,123555,4.79449689519706,0.16951140708667575
1331,0.1843,1,23,1,71133,605311,2702,123554,4.794314725636801,0.16951561674658544
1332,0.1844,0,2,0,71135,605309,2702,123554,4.794298884805475,0.16951608189742104
1333,0.1845,3,15,3,71150,605294,2705,123551,4.794180078570523,0.16951615226831493
1334,0.1846,2,6,2,71156,605288,2707,123549,4.794132556076543,0.1695152688461206
1335,0.1847,3,15,3,71171,605273,2710,123546,4.794013749841592,0.1695153391994446
1336,0.1848,1,8,1,71179,605265,2711,123545,4.7939503865162845,0.16951606042727185
1337,0.1849,0,3,0,71182,605262,2711,123545,4.793926625269294,0.16951675820896342
1338,0.185,40,1031,40,72213,604231,2751,123505,4.785760676720314,0.16971126892169688
1339,0.1852,0,4,0,72217,604227,2751,123505,4.785728995057661,0.16971220174459828
1340,0.1853,2,24,2,72241,604203,2753,123503,4.785538905081738,0.1697155169807587
1341,0.1854,0,4,0,72245,604199,2753,123503,4.785507223419085,0.1697164498654669
1342,0.1855,2,7,2,72252,604192,2755,123501,4.785451780509441,0.16971580048179657
1343,0.1856,1,7,1,72259,604185,2756,123500,4.785396337599797,0.1697162920769289
1344,0.1857,3,33,3,72292,604152,2759,123497,4.785134963882904,0.1697205658222577
1345,0.1858,2,84,2,72376,604068,2761,123495,4.784469648967177,0.16973787836929585
1346,0.1859,0,1,0,72377,604067,2761,123495,4.7844617285515145,0.16973811166608482
1347,0.186,5,73,5,72450,603994,2766,123490,4.7838835382080855,0.1697494377883225
1348,0.1861,2,3,2,72453,603991,2768,123488,4.783859776961095,0.16974785526455058
1349,0.1862,3,11,3,72464,603980,2771,123485,4.783772652388797,0.16974699813736743
1350,0.1863,2,11,2,72475,603969,2773,123483,4.7836855278165,0.16974728229491431
1351,0.1864,1,8,1,72483,603961,2774,123482,4.7836221644911925,0.16974800774768609
1352,0.1865,2,16,2,72499,603945,2776,123480,4.783495437840578,0.16974945870708322
1353,0.1867,18,508,18,73007,603437,2794,123462,4.779471866683563,0.16984753039968414
1354,0.1868,0,12,0,73019,603425,2794,123462,4.779376821695602,0.16985033437109207
1355,0.1869,0,2,0,73021,603423,2794,123462,4.779360980864276,0.16985080170866093
1356,0.187,6,46,6,73067,603377,2800,123456,4.778996641743759,0.1698546983970183
1357,0.1871,1,9,1,73076,603368,2801,123455,4.778925358002788,0.16985565949343925
1358,0.1872,1,3,1,73079,603365,2802,123454,4.778901596755798,0.16985521842439452
1359,0.1873,2,31,2,73110,603334,2804,123452,4.778656063870232,0.1698601789247454
1360,0.1874,0,5,0,73115,603329,2804,123452,4.7786164617919145,0.16986134750358087
1361,0.1875,11,248,11,73363,603081,2815,123441,4.776652198707388,0.16990676125430476
1362,0.1876,0,5,0,73368,603076,2815,123441,4.776612596629071,0.16990793057836223
1363,0.1877,0,16,0,73384,603060,2815,123441,4.7764858699784565,0.1699116725235065
1364,0.1878,0,2,0,73386,603058,2815,123441,4.77647002914713,0.1699121402782385
1365,0.1879,0,7,0,73393,603051,2815,123441,4.776414586237486,0.16991377744008193
1366,0.188,4,55,4,73448,602996,2819,123437,4.775978963375998,0.1699220712715419
1367,0.1881,1,2,1,73450,602994,2820,123436,4.775963122544671,0.16992139641809947
1368,0.1882,0,11,0,73461,602983,2820,123436,4.775875997972373,0.16992396949969646
1369,0.1883,12,254,12,73715,602729,2832,123424,4.773864212393867,0.16996968958332473
1370,0.1884,1,2,1,73717,602727,2833,123423,4.77384837156254,0.16996901466639125
1371,0.1885,0,13,0,73730,602714,2833,123423,4.773745406158915,0.1699720576144722
1372,0.1886,0,7,0,73737,602707,2833,123423,4.7736899632492715,0.16997369617010727
1373,0.1887,1,24,1,73761,602683,2834,123422,4.77349987327335,0.16997817120113481
1374,0.1888,1,18,1,73779,602665,2835,123421,4.773357305791408,0.16998124189145639
1375,0.1889,2,3,2,73782,602662,2837,123419,4.773333544544418,0.16997965791695416
1376,0.189,2,47,2,73829,602615,2839,123417,4.772961285008237,0.16998837516803667
1377,0.1891,0,2,0,73831,602613,2839,123417,4.77294544417691,0.16998884343622164
1378,0.1892,3,79,3,73910,602534,2842,123414,4.7723197313395005,0.1700039121259374
1379,0.1893,4,20,4,73930,602514,2846,123410,4.772161323026232,0.17000402245965143
1380,0.1894,0,4,0,73934,602510,2846,123410,4.772129641363579,0.17000495922415693
1381,0.1895,1,15,1,73949,602495,2847,123409,4.7720108351286274,0.17000732879278802
1382,0.1896,0,5,0,73954,602490,2847,123409,4.77197123305031,0.1700084998050693
1383,0.1897,3,19,3,73973,602471,2850,123406,4.771820745152706,0.1700095195191472
1384,0.1898,1,13,1,73986,602458,2851,123405,4.771717779749081,0.1700114208879637
1385,0.1899,0,7,0,73993,602451,2851,123405,4.771662336839437,0.1700130604417405
1386,0.19,156,3862,156,77855,598589,3007,123249,4.741073691547332,0.1707432969724509
1387,0.1901,0,2,0,77857,598587,3007,123249,4.741057850716006,0.17074377005303143
1388,0.1902,1,3,1,77860,598584,3008,123248,4.741034089469015,0.17074333085814983
1389,0.1903,0,19,0,77879,598565,3008,123248,4.740883601571411,0.17074782526776325
1390,0.1904,0,5,0,77884,598560,3008,123248,4.7408439994930935,0.17074900804646112
1391,0.1905,3,15,3,77899,598545,3011,123245,4.740725193258142,0.17074910985189598
1392,0.1906,0,3,0,77902,598542,3011,123245,4.740701432011152,0.17074981954510127
1393,0.1907,3,34,3,77936,598508,3014,123242,4.740432137878596,0.17075441634915137
1394,0.1908,3,78,3,78014,598430,3017,123239,4.73981434545685,0.1707694247639846
1395,0.191,2,42,2,78056,598388,3019,123237,4.739481687998986,0.1707770656504417
1396,0.1911,0,3,0,78059,598385,3019,123237,4.739457926751996,0.1707777756221401
1397,0.1912,0,14,0,78073,598371,3019,123237,4.739347040932708,0.1707810889014534
1398,0.1913,3,21,3,78094,598350,3022,123234,4.739180712203776,0.17078261158784008
1399,0.1914,0,5,0,78099,598345,3022,123234,4.739141110125459,0.17078379498294713
1400,0.1915,5,18,5,78117,598327,3027,123229,4.738998542643518,0.1707823093425874
1401,0.1916,0,5,0,78122,598322,3027,123229,4.738958940565201,0.17078349278152202
1402,0.1917,19,218,19,78340,598104,3046,123210,4.737232289950577,0.17081326578993336
1403,0.1918,0,5,0,78345,598099,3046,123210,4.73719268787226,0.17081444984049832
1404,0.1919,1,4,1,78349,598095,3047,123209,4.737161006209606,0.17081424752947438
1405,0.192,5,66,5,78415,598029,3052,123204,4.7366382587758205,0.1708241303434535
1406,0.1921,0,9,0,78424,598020,3052,123204,4.73656697503485,0.17082626202123058
1407,0.1922,0,5,0,78429,598015,3052,123204,4.736527372956533,0.17082744630965074
1408,0.1923,1,21,1,78450,597994,3053,123203,4.736361044227601,0.17083127079008925
1409,0.1924,1,8,1,78458,597986,3054,123202,4.736297680902294,0.17083201606238596
1410,0.1925,21,251,21,78709,597735,3075,123181,4.734309656570777,0.1708673409939577
1411,0.1926,0,2,0,78711,597733,3075,123181,4.73429381573945,0.17086781502370602
1412,0.1927,0,26,0,78737,597707,3075,123181,4.734087884932201,0.17087397764978748
1413,0.1928,0,13,0,78750,597694,3075,123181,4.733984919528577,0.17087705912953008
1414,0.1929,1,7,1,78757,597687,3076,123180,4.733929476618933,0.1708775682615517
1415,0.193,1,33,1,78790,597654,3077,123179,4.73366810290204,0.17088424087132525
1416,0.1931,0,2,0,78792,597652,3077,123179,4.733652262070714,0.17088471500254568
1417,0.1932,0,13,0,78805,597639,3077,123179,4.733549296667089,0.17088779691961078
1418,0.1933,34,538,34,79343,597101,3111,123145,4.729288113040172,0.17097630531790528
1419,0.1934,0,2,0,79345,597099,3111,123145,4.729272272208846,0.17097678009119133
1420,0.1935,3,15,3,79360,597084,3114,123142,4.729153465973894,0.17097688781021514
1421,0.1936,2,2,2,79362,597082,3116,123140,4.729137625142568,0.17097506046746697
1422,0.1937,0,14,0,79376,597068,3116,123140,4.72902673932328,0.17097838402239354
1423,0.1938,0,8,0,79384,597060,3116,123140,4.728963375997973,0.17098028325465148
1424,0.1939,1,3,1,79387,597057,3117,123139,4.728939614750982,0.17097984437569771
1425,0.194,8,110,8,79497,596947,3125,123131,4.728068369028007,0.1709967531295221
1426,0.1942,9,71,9,79568,596876,3134,123122,4.727506019515904,0.1710032527868133
1427,0.1943,3,38,3,79606,596838,3137,123119,4.727205043720694,0.17100882413810825
1428,0.1944,0,3,0,79609,596835,3137,123119,4.727181282473704,0.1710095367204016
1429,0.1945,3,22,3,79631,596813,3140,123116,4.727007033329109,0.17101130805954476
1430,0.1947,0,27,0,79658,596786,3140,123116,4.726793182106197,0.17101772185658604
1431,0.1948,0,8,0,79666,596778,3140,123116,4.72672981878089,0.17101962233328796
1432,0.1949,0,1,0,79667,596777,3140,123116,4.726721898365226,0.17101985989584564
1433,0.195,65,1031,65,80698,595746,3205,123051,4.718555949816246,0.17119019695407744
1434,0.1951,0,8,0,80706,595738,3205,123051,4.718492586490939,0.17119210227201584
1435,0.1952,3,16,3,80722,595722,3208,123048,4.718365859840325,0.1711924537751993
1436,0.1953,2,25,2,80747,595697,3210,123046,4.718167849448739,0.1711961020837768
1437,0.1954,0,12,0,80759,595685,3210,123046,4.718072804460778,0.17119896038990945
1438,0.1955,1,7,1,80766,595678,3211,123045,4.7180173615511345,0.17119947462374238
1439,0.1956,1,9,1,80775,595669,3212,123044,4.717946077810163,0.1712004652761255
1440,0.1957,0,32,0,80807,595637,3212,123044,4.717692624508934,0.17120808815037547
1441,0.1958,2,95,2,80902,595542,3214,123042,4.71694018502091,0.171228415884573
1442,0.1959,0,2,0,80904,595540,3214,123042,4.716924344189583,0.17122889245764575
1443,0.196,10,90,10,80994,595450,3224,123032,4.716211506779876,0.171238806260978
1444,0.1961,1,2,1,80996,595448,3225,123031,4.716195665948549,0.17123812943732525
1445,0.1962,0,16,0,81012,595432,3225,123031,4.7160689392979345,0.17124194286970937
1446,0.1963,1,11,1,81023,595421,3226,123030,4.7159818147256365,0.17124341117209108
1447,0.1965,2,22,2,81045,595399,3228,123028,4.715807565581041,0.1712463479240062
1448,0.1966,0,4,0,81049,595395,3228,123028,4.715775883918388,0.17124730138094132
1449,0.1967,39,509,39,81558,594886,3267,122989,4.71174439234571,0.1713236984154623
1450,0.1968,1,13,1,81571,594873,3268,122988,4.711641426942086,0.171325646608466
1451,0.1969,0,1,0,81572,594872,3268,122988,4.7116335065264225,0.1713258852701084
1452,0.197,6,46,6,81618,594826,3274,122982,4.711269167405906,0.17132993781066802
1453,0.1971,1,17,1,81635,594809,3275,122981,4.711134520339628,0.17133284108165342
1454,0.1972,1,12,1,81647,594797,3276,122980,4.711039475351667,0.1713345509817116
1455,0.1973,3,30,3,81677,594767,3279,122977,4.710801862881764,0.17133824873492498
1456,0.1974,1,4,1,81681,594763,3280,122976,4.71077018121911,0.17133804906797595
1457,0.1975,18,266,18,81947,594497,3298,122958,4.7086633506526425,0.17138078346377125
1458,0.1976,0,4,0,81951,594493,3298,122958,4.708631668989988,0.17138173896196396
1459,0.1977,0,21,0,81972,594472,3298,122958,4.708465340261057,0.17138675550227897
1460,0.1978,1,6,1,81978,594466,3299,122957,4.708417817767076,0.1713870338698369
1461,0.1979,0,8,0,81986,594458,3299,122957,4.7083544544417695,0.17138894503181562
1462,0.198,3,61,3,82047,594397,3302,122954,4.7078713090863005,0.17140005380908369
1463,0.1981,0,5,0,82052,594392,3302,122954,4.707831707007983,0.1714012484909653
1464,0.1982,1,15,1,82067,594377,3303,122953,4.707712900773033,0.17140367752638255
1465,0.1983,16,260,16,82327,594117,3319,122937,4.7056535927005445,0.17144733869415693
1466,0.1984,0,4,0,82331,594113,3319,122937,4.705621911037891,0.17144829509797085
1467,0.1985,1,16,1,82347,594097,3320,122936,4.705495184387277,0.17145096529727363
1468,0.1986,0,7,0,82354,594090,3320,122936,4.705439741477632,0.1714526390953745
1469,0.1987,0,19,0,82373,594071,3320,122936,4.705289253580028,0.17145718242639194
1470,0.1988,0,16,0,82389,594055,3320,122936,4.7051625269294135,0.17146100857611882
1471,0.1989,0,6,0,82395,594049,3320,122936,4.705115004435433,0.17146244342629205
1472,0.199,7,56,7,82451,593993,3327,122929,4.704671461158282,0.17146774683996308
1473,0.1991,0,2,0,82453,593991,3327,122929,4.704655620326955,0.17146822518551583
1474,0.1992,7,93,7,82546,593898,3334,122922,4.7039190216702575,0.17148238051393655
1475,0.1993,1,40,1,82586,593858,3335,122921,4.703602205043721,0.17149079423364802
1476,0.1994,0,4,0,82590,593854,3335,122921,4.703570523381067,0.17149175124690455
1477,0.1995,0,19,0,82609,593835,3335,122921,4.703420035483462,0.17149629720574366
1478,0.1996,0,6,0,82615,593829,3335,122921,4.703372512989482,0.17149773282176492
1479,0.1997,1,16,1,82631,593813,3336,122920,4.703245786338867,0.17150040531132235
1480,0.1998,0,8,0,82639,593805,3336,122920,4.70318242301356,0.17150231957863896
1481,0.1999,0,3,0,82642,593802,3336,122920,4.70315866176657,0.1715030374399
1482,0.2,196,4046,196,86688,589756,3532,122724,4.671112659992397,0.17224904558724455
1483,0.2001,0,2,0,86690,589754,3532,122724,4.67109681916107,0.1722495291082672
1484,0.2002,0,9,0,86699,589745,3532,122724,4.671025535420099,0.17225170498646256
1485,0.2003,3,27,3,86726,589718,3535,122721,4.6708116841971865,0.17225474742399
1486,0.2004,0,5,0,86731,589713,3535,122721,4.670772082118869,0.17225595634121899
1487,0.2005,1,9,1,86740,589704,3536,122720,4.670700798377899,0.17225697056808867
1488,0.2006,0,4,0,86744,589700,3536,122720,4.670669116715246,0.17225793773335954
1489,0.2007,2,43,2,86787,589657,3538,122718,4.670328538841718,0.17226601158097912
1490,0.2008,4,70,4,86857,589587,3542,122714,4.66977410974528,0.1722782924634389
1491,0.2009,0,2,0,86859,589585,3542,122714,4.669758268913952,0.17227877618808954
1492,0.201,2,61,2,86920,589524,3544,122712,4.669275123558484,0.17229120684716864
1493,0.2011,1,6,1,86926,589518,3545,122711,4.669227601064504,0.17229149613396816
1494,0.2012,1,15,1,86941,589503,3546,122710,4.669108794829553,0.17229396262073285
1495,0.2013,1,35,1,86976,589468,3547,122709,4.668831580281333,0.17230126780280744
1496,0.2014,0,5,0,86981,589463,3547,122709,4.668791978203016,0.17230247749139252
1497,0.2015,0,21,0,87002,589442,3547,122709,4.668625649474085,0.1723075583689414
1498,0.2016,0,2,0,87004,589440,3547,122709,4.668609808642757,0.1723080422776694
1499,0.2017,13,281,13,87285,589159,3560,122696,4.666384171841338,0.17236094429343055
1500,0.2018,2,11,2,87296,589148,3562,122694,4.66629704726904,0.1723612824194133
1501,0.2019,0,3,0,87299,589145,3562,122694,4.666273286022051,0.17236200882502925
1502,0.202,7,90,7,87389,589055,3569,122687,4.665560448612343,0.1723756642154039
1503,0.2021,0,11,0,87400,589044,3569,122687,4.665473324040046,0.17237832832910185
1504,0.2022,0,4,0,87404,589040,3569,122687,4.665441642377392,0.1723792971181366
1505,0.2023,0,24,0,87428,589016,3569,122687,4.66525155240147,0.172385110081031
1506,0.2024,0,4,0,87432,589012,3569,122687,4.665219870738817,0.17238607894629612
1507,0.2025,9,279,9,87711,588733,3578,122678,4.6630100747687235,0.17244321496293985
1508,0.2026,0,9,0,87720,588724,3578,122678,4.662938791027753,0.17244539655497174
1509,0.2027,2,37,2,87757,588687,3580,122676,4.662645735648207,0.17245203925422042
1510,0.2028,0,5,0,87762,588682,3580,122676,4.66260613356989,0.17245325138678416
1511,0.2029,0,26,0,87788,588656,3580,122676,4.662400202762641,0.17245955475080554
1512,0.203,3,38,3,87826,588618,3583,122673,4.662099226967431,0.1724652779242251
1513,0.2031,0,6,0,87832,588612,3583,122673,4.662051704473451,0.17246673274425864
1514,0.2032,0,7,0,87839,588605,3583,122673,4.661996261563807,0.17246843006531903
1515,0.2033,33,534,33,88373,588071,3616,122640,4.657766759599544,0.1725595917327859
1516,0.2034,1,8,1,88381,588063,3617,122639,4.657703396274236,0.17256036988780107
1517,0.2035,4,30,4,88411,588033,3621,122635,4.657465783804334,0.1725629970675477
1518,0.2036,0,4,0,88415,588029,3621,122635,4.65743410214168,0.172563968345097
1519,0.2037,1,28,1,88443,588001,3622,122634,4.657212330503105,0.17256960324217074
1520,0.2038,1,19,1,88462,587982,3623,122633,4.6570618426055,0.17257305291895048
1521,0.2039,0,4,0,88466,587978,3623,122633,4.657030160942846,0.1725740243255452
1522,0.204,9,113,9,88579,587865,3632,122624,4.656135153972881,0.1725909901490382
1523,0.2041,0,2,0,88581,587863,3632,122624,4.656119313141554,0.17259147598759725
1524,0.2042,5,82,5,88663,587781,3637,122619,4.655469839057154,0.17260557432432433
1525,0.2043,2,29,2,88692,587752,3639,122617,4.655240147002915,0.17261029127115626
1526,0.2044,0,7,0,88699,587745,3639,122617,4.655184704093271,0.17261199219552847
1527,0.2045,1,10,1,88709,587735,3640,122616,4.655105499936637,0.17261325738965666
1528,0.2046,2,7,2,88716,587728,3642,122614,4.655050057026993,0.17261262884638667
1529,0.2047,4,27,4,88743,587701,3646,122610,4.654836205804081,0.1726145308181909
1530,0.2048,1,27,1,88770,587674,3647,122609,4.654622354581169,0.17261992755000471
1531,0.2049,0,4,0,88774,587670,3647,122609,4.6545906729185145,0.1726208996746349
1532,0.205,45,1133,45,89907,586537,3692,122564,4.645616841971867,0.17284420696064454
1533,0.2051,1,2,1,89909,586535,3693,122563,4.64560100114054,0.17284352797497665
1534,0.2052,3,10,3,89919,586525,3696,122560,4.645521796983906,0.17284246599490893
1535,0.2053,0,18,0,89937,586507,3696,122560,4.645379229501964,0.17284685368237415
1536,0.2054,0,6,0,89943,586501,3696,122560,4.645331707007983,0.17284831629436678
1537,0.2055,1,18,1,89961,586483,3697,122559,4.6451891395260425,0.17285153770862657
1538,0.2057,3,37,3,89998,586446,3700,122556,4.644896084146496,0.17285705823114744
1539,0.2058,5,99,5,90097,586347,3705,122551,4.644111962995818,0.17287536429782563
1540,0.2059,1,7,1,90104,586340,3706,122550,4.644056520086174,0.17287590458322166
1541,0.206,7,123,7,90227,586217,3713,122543,4.643082308959574,0.17289773689260116
1542,0.2061,1,2,1,90229,586215,3714,122542,4.643066468128247,0.17289705780683648
1543,0.2062,3,23,3,90252,586192,3717,122539,4.642884298567989,0.1728991676672814
1544,0.2063,1,18,1,90270,586174,3718,122538,4.642741731086048,0.17290239194482385
1545,0.2064,0,6,0,90276,586168,3718,122538,4.642694208592067,0.1729038557596521
1546,0.2065,1,20,1,90296,586148,3719,122537,4.642535800278798,0.17290756824259015
1547,0.2066,1,1,1,90297,586147,3720,122536,4.6425278798631355,0.17290664514317403
1548,0.2067,34,550,34,90847,585597,3754,122502,4.638171651248258,0.17300123287845343
1549,0.2068,0,13,0,90860,585584,3754,122502,4.638068685844633,0.1730044090689549
1550,0.2069,0,7,0,90867,585577,3754,122502,4.638013242934989,0.1730061193736857
1551,0.207,1,37,1,90904,585540,3755,122501,4.637720187555443,0.17301399212757454
1552,0.2071,1,9,1,90913,585531,3756,122500,4.637648903814473,0.17301502335349722
1553,0.2072,2,12,2,90925,585519,3758,122498,4.637553858826511,0.17301561968144832
1554,0.2073,6,34,6,90959,585485,3764,122492,4.637284564693955,0.17301692004118777
1555,0.2074,0,4,0,90963,585481,3764,122492,4.637252883031302,0.17301789757519
1556,0.2075,12,260,12,91223,585221,3776,122480,4.635193574958814,0.173067439497754
1557,0.2076,0,2,0,91225,585219,3776,122480,4.635177734127487,0.17306792859676218
1558,0.2077,3,26,3,91251,585193,3779,122477,4.634971803320238,0.17307078157898456
1559,0.2078,1,7,1,91258,585186,3780,122476,4.634916360410594,0.17307132501109287
1560,0.2079,0,7,0,91265,585179,3780,122476,4.6348609175009505,0.17307303700249416
1561,0.208,9,60,9,91325,585119,3789,122467,4.634385692561145,0.17307719485687958
1562,0.2081,1,3,1,91328,585116,3790,122466,4.634361931314156,0.17307676000802732
1563,0.2082,2,5,2,91333,585111,3792,122464,4.634322329235839,0.1730756456912695
1564,0.2083,25,272,25,91605,584839,3817,122439,4.632167976175389,0.173112976792718
1565,0.2084,0,5,0,91610,584834,3817,122439,4.632128374097072,0.1731142005986373
1566,0.2085,2,12,2,91622,584822,3819,122437,4.632033329109111,0.17311479952888545
1567,0.2086,1,5,1,91627,584817,3820,122436,4.631993727030794,0.1731148542317954
1568,0.2087,2,24,2,91651,584793,3822,122434,4.6318036370548725,0.17311839055918396
1569,0.2088,2,8,2,91659,584785,3824,122432,4.631740273729565,0.17311801045506542
1570,0.2089,0,6,0,91665,584779,3824,122432,4.631692751235585,0.17311947919362114
1571,0.209,3,46,3,91711,584733,3827,122429,4.631328412115068,0.1731272325153218
1572,0.2091,0,2,0,91713,584731,3827,122429,4.631312571283741,0.17312772215623057
1573,0.2092,8,94,8,91807,584637,3835,122421,4.63056805221138,0.17314138302656926
1574,0.2093,3,44,3,91851,584593,3838,122418,4.63021955392219,0.17314864973812288
1575,0.2094,0,7,0,91858,584586,3838,122418,4.6301641110125455,0.1731503640714904
1576,0.2095,1,7,1,91865,584579,3839,122417,4.630108668102902,0.17315090891603346
1577,0.2096,0,4,0,91869,584575,3839,122417,4.6300769864402485,0.17315188856450991
1578,0.2097,1,16,1,91885,584559,3840,122416,4.629950259789633,0.17315463771703385
1579,0.2098,0,12,0,91897,584547,3840,122416,4.6298552148016725,0.17315757684631303
1580,0.2099,0,3,0,91900,584544,3840,122416,4.629831453554683,0.17315831164422316
1581,0.21,177,4182,177,96082,580362,4017,122239,4.596708275250285,0.17398068035769945
1582,0.2101,0,3,0,96085,580359,4017,122239,4.596684514003295,0.1739814232320616
1583,0.2102,2,14,2,96099,580345,4019,122237,4.596573628184007,0.1739825386929924
1584,0.2103,1,18,1,96117,580327,4020,122236,4.5964310607020655,0.17398582048869637
1585,0.2104,0,11,0,96128,580316,4020,122236,4.596343936129768,0.1739885446201847
1586,0.2105,1,13,1,96141,580303,4021,122235,4.596240970726144,0.17399058840945258
1587,0.2106,0,2,0,96143,580301,4021,122235,4.596225129894817,0.17399108373094047
1588,0.2107,2,41,2,96184,580260,4023,122233,4.5959003928526165,0.17399888682164805
1589,0.2108,7,90,7,96274,580170,4030,122226,4.59518755544291,0.1740129499598517
1590,0.2109,0,4,0,96278,580166,4030,122226,4.595155873780256,0.17401394093326802
1591,0.211,5,62,5,96340,580104,4035,122221,4.594664808009124,0.1740234222048197
1592,0.2111,1,6,1,96346,580098,4036,122220,4.5946172855151435,0.17402373283897038
1593,0.2112,0,9,0,96355,580089,4036,122220,4.594546001774173,0.17402596293084668
1594,0.2113,1,31,1,96386,580058,4037,122219,4.5943004688886075,0.1740324686697699
1595,0.2114,0,12,0,96398,580046,4037,122219,4.594205423900647,0.1740354424611792
1596,0.2115,3,27,3,96425,580019,4040,122216,4.5939915726777345,0.1740386053101882
1597,0.2116,0,5,0,96430,580014,4040,122216,4.593951970599417,0.17403984449539325
1598,0.2117,23,266,23,96696,579748,4063,122193,4.591845140032949,0.17407873311289696
1599,0.2118,1,15,1,96711,579733,4064,122192,4.591726333797998,0.17408127648965346
1600,0.2119,0,3,0,96714,579730,4064,122192,4.591702572551007,0.17408202050940133
1601,0.212,4,81,4,96795,579649,4068,122188,4.591061018882271,0.174097404383069
1602,0.2121,0,8,0,96803,579641,4068,122188,4.590997655556964,0.17409938888247706
1603,0.2122,1,13,1,96816,579628,4069,122187,4.590894690153339,0.17410143698838013
1604,0.2123,3,35,3,96851,579593,4072,122184,4.59061747560512,0.1741065894151561
1605,0.2124,0,3,0,96854,579590,4072,122184,4.590593714358129,0.1741073337000231
1606,0.2125,14,288,14,97142,579302,4086,122170,4.588312634647067,0.17416233292276811
1607,0.2126,0,1,0,97143,579301,4086,122170,4.588304714231403,0.17416258120435485
1608,0.2127,4,28,4,97171,579273,4090,122166,4.588082942592827,0.1741648240260379
1609,0.2128,1,12,1,97183,579261,4091,122165,4.587987897604866,0.17416662627276433
1610,0.2129,1,20,1,97203,579241,4092,122164,4.587829489291598,0.17417041509541564
1611,0.213,2,35,2,97238,579206,4094,122162,4.587552274743379,0.17417675171949676
1612,0.2131,0,4,0,97242,579202,4094,122162,4.587520593080725,0.17417774507958778
1613,0.2132,1,13,1,97255,579189,4095,122161,4.587417627677101,0.17417979610750695
1614,0.2133,36,641,36,97896,578548,4131,122125,4.582340641236852,0.1742967118755825
1615,0.2134,0,4,0,97900,578544,4131,122125,4.582308959574198,0.17429770690582858
1616,0.2135,4,23,4,97923,578521,4135,122121,4.58212679001394,0.17429871460746002
1617,0.2136,1,8,1,97931,578513,4136,122120,4.582063426688633,0.1742995262855161
1618,0.2137,2,22,2,97953,578491,4138,122118,4.581889177544038,0.17430264241538432
1619,0.2138,1,16,1,97969,578475,4139,122117,4.5817624508934225,0.1743054445383333
1620,0.2139,0,5,0,97974,578470,4139,122117,4.581722848815105,0.1743066885340436
1621,0.214,5,133,5,98107,578337,4144,122112,4.580669433531872,0.1743338915467079
1622,0.2141,0,2,0,98109,578335,4144,122112,4.5806535927005445,0.17433438932567347
1623,0.2142,14,101,14,98210,578234,4158,122098,4.5798536307185405,0.17434302587915446
1624,0.2143,3,44,3,98254,578190,4161,122095,4.57950513242935,0.17435044303390762
1625,0.2144,0,3,0,98257,578187,4161,122095,4.57948137118236,0.1743511899491919
1626,0.2145,2,21,2,98278,578166,4163,122093,4.579315042453428,0.17435406042621374
1627,0.2146,1,7,1,98285,578159,4164,122092,4.579259599543784,0.17435462427044018
1628,0.2147,1,27,1,98312,578132,4165,122091,4.579045748320872,0.17436016811787103
1629,0.2148,3,17,3,98329,578115,4168,122088,4.578911101254594,0.1743608639208915
1630,0.2149,0,3,0,98332,578112,4168,122088,4.578887340007603,0.17436161096829478
1631,0.215,54,1112,54,99444,577000,4222,122034,4.570079837789887,0.17457519948958133
1632,0.2151,0,5,0,99449,576995,4222,122034,4.57004023571157,0.17457644818741425
1633,0.2152,0,9,0,99458,576986,4222,122034,4.5699689519705995,0.17457869588852964
1634,0.2153,2,31,2,99489,576955,4224,122032,4.569723419085034,0.17458407667095382
1635,0.2154,0,4,0,99493,576951,4224,122032,4.56969173742238,0.17458507574576207
1636,0.2155,1,9,1,99502,576942,4225,122031,4.569620453681409,0.1745861428123833
1637,0.2156,0,7,0,99509,576935,4225,122031,4.569565010771766,0.1745878912565132
1638,0.2157,5,45,5,99554,576890,4230,122026,4.569208592066912,0.17459322722616166
1639,0.2158,4,81,4,99635,576809,4234,122022,4.568567038398175,0.17460873945202773
1640,0.2159,2,2,2,99637,576807,4236,122020,4.5685511975668485,0.17460687695237878
1641,0.216,18,106,18,99743,576701,4254,122002,4.567711633506526,0.17461210271030753
1642,0.2161,1,11,1,99754,576690,4255,122001,4.5676245089342284,0.17461367042082981
1643,0.2162,3,15,3,99769,576675,4258,121998,4.567505702699278,0.1746138751604828
1644,0.2163,3,22,3,99791,576653,4261,121995,4.567331453554683,0.1746158294305573
1645,0.2164,0,6,0,99797,576647,4261,121995,4.567283931060702,0.17461732904692245
1646,0.2165,3,19,3,99816,576628,4264,121992,4.567133443163097,0.17461853368068478
1647,0.2166,0,1,0,99817,576627,4264,121992,4.567125522747434,0.17461878362884492
1648,0.2167,32,576,32,100393,576051,4296,121960,4.5625633633253075,0.17472504014979706
1649,0.2168,1,11,1,100404,576040,4297,121959,4.56247623875301,0.17472661135617673
1650,0.2169,0,3,0,100407,576037,4297,121959,4.562452477506019,0.17472736233445463
1651,0.217,3,38,3,100445,575999,4300,121956,4.56215150171081,0.17473332807989053
1652,0.2171,0,16,0,100461,575983,4300,121956,4.562024775060195,0.1747373337784534
1653,0.2172,0,10,0,100471,575973,4300,121956,4.5619455709035615,0.17473983743332058
1654,0.2173,3,31,3,100502,575942,4303,121953,4.561700038017995,0.1747440517556366
1655,0.2174,0,8,0,100510,575934,4303,121953,4.5616366746926875,0.17474605487707895
1656,0.2175,23,303,23,100813,575631,4326,121930,4.559236788746674,0.17479474913305074
1657,0.2176,1,3,1,100816,575628,4327,121929,4.559213027499683,0.17479431788369984
1658,0.2177,2,30,2,100846,575598,4329,121927,4.5589754150297805,0.1747994695530626
1659,0.2178,1,8,1,100854,575590,4330,121926,4.558912051704474,0.17480029131948227
1660,0.2179,0,8,0,100862,575582,4330,121926,4.558848688379166,0.17480229617438078
1661,0.218,3,63,3,100925,575519,4333,121923,4.558349702192371,0.17481453654927578
1662,0.2181,0,8,0,100933,575511,4333,121923,4.558286338867064,0.17481654178029749
1663,0.2182,1,17,1,100950,575494,4334,121922,4.558151691800786,0.17481961985386055
1664,0.2183,18,329,18,101279,575165,4352,121904,4.555545875047523,0.17488082241499767
1665,0.2185,4,34,4,101313,575131,4356,121900,4.555276580914966,0.1748846177573164
1666,0.2186,2,7,2,101320,575124,4358,121898,4.555221138005322,0.17488400653064035
1667,0.2187,1,31,1,101351,575093,4359,121897,4.554975605119757,0.17489060101292703
1668,0.2188,1,15,1,101366,575078,4360,121896,4.554856798884805,0.17489318109427324
1669,0.2189,0,3,0,101369,575075,4360,121896,4.554833037637815,0.17489393389394967
1670,0.219,6,65,6,101434,575010,4366,121890,4.5543182106196936,0.17490314248816186
1671,0.2191,1,5,1,101439,575005,4367,121889,4.5542786085413764,0.17490321340117723
1672,0.2192,4,77,4,101516,574928,4371,121885,4.553668736535293,0.17491780434635978
1673,0.2193,1,54,1,101570,574874,4372,121884,4.553241034089469,0.17493017661799362
1674,0.2194,0,8,0,101578,574866,4372,121884,4.553177670764161,0.17493218514531755
1675,0.2195,2,21,2,101599,574845,4374,121882,4.55301134203523,0.17493508935350574
1676,0.2196,0,7,0,101606,574838,4374,121882,4.552955899125586,0.17493684693994718
1677,0.2197,3,19,3,101625,574819,4377,121879,4.552805411227982,0.17493806498655085
1678,0.2198,1,19,1,101644,574800,4378,121878,4.552654923330376,0.17494165166691067
1679,0.2199,1,6,1,101650,574794,4379,121877,4.552607400836396,0.1749419740451375
1680,0.22,216,4345,216,105995,570449,4595,121661,4.518193194778862,0.1757827512967592
1681,0.2201,0,1,0,105996,570448,4595,121661,4.518185274363199,0.17578300527807036
1682,0.2202,0,14,0,106010,570434,4595,121661,4.518074388543911,0.1757865610934915
1683,0.2203,1,13,1,106023,570421,4596,121660,4.5179714231402865,0.17578867213519805
1684,0.2204,0,6,0,106029,570415,4596,121660,4.517923900646306,0.17579019614926128
1685,0.2205,0,12,0,106041,570403,4596,121660,4.517828855658345,0.17579324425666448
1686,0.2206,0,5,0,106046,570398,4596,121660,4.517789253580028,0.17579451433261373
1687,0.2207,7,43,7,106089,570355,4603,121653,4.517448675706501,0.17579710061155362
1688,0.2208,5,86,5,106175,570269,4608,121648,4.516767519959448,0.17581299491123936
1689,0.2209,0,2,0,106177,570267,4608,121648,4.516751679128121,0.17581350310370494
1690,0.221,2,57,2,106234,570210,4610,121646,4.516300215435306,0.1758256053282764
1691,0.2211,0,1,0,106235,570209,4610,121646,4.5162922950196425,0.17582585946477225
1692,0.2212,1,12,1,106247,570197,4611,121645,4.516197250031682,0.17582771788934468
1693,0.2213,4,19,4,106266,570178,4615,121641,4.516046762134077,0.17582778154401657
1694,0.2214,1,3,1,106269,570175,4616,121640,4.5160230008870865,0.17582735268821867
1695,0.2215,1,15,1,106284,570160,4617,121639,4.515904194652135,0.1758299737351456
1696,0.2216,0,5,0,106289,570155,4617,121639,4.515864592573818,0.17583124456124222
1697,0.2217,25,294,25,106583,569861,4642,121614,4.513535990368775,0.17587620665967676
1698,0.2218,1,11,1,106594,569850,4643,121613,4.513448865796477,0.17587781269569014
1699,0.2219,0,9,0,106603,569841,4643,121613,4.513377582055506,0.17588010193013562
1700,0.222,4,88,4,106691,569753,4647,121609,4.512680585477126,0.17589772073096294
1701,0.2221,0,11,0,106702,569742,4647,121609,4.512593460904828,0.17590051941777765
1702,0.2222,1,8,1,106710,569734,4648,121608,4.512530097579521,0.17590136285658906
1703,0.2223,1,23,1,106733,569711,4649,121607,4.512347928019262,0.1759060229879737
1704,0.2224,0,2,0,106735,569709,4649,121607,4.512332087187936,0.17590653188990274
1705,0.2225,14,302,14,107037,569407,4663,121593,4.509940121657585,0.17596671490593344
1706,0.2226,0,2,0,107039,569405,4663,121593,4.509924280826258,0.17596722421772568
1707,0.2227,2,43,2,107082,569362,4665,121591,4.509583702952731,0.1759757899596644
1708,0.2228,0,12,0,107094,569350,4665,121591,4.50948865796477,0.1759788462401276
1709,0.2229,2,19,2,107113,569331,4667,121589,4.509338170067165,0.1759813002952585
1710,0.223,3,48,3,107161,569283,4670,121586,4.508957990115321,0.17598994889045536
1711,0.2231,0,3,0,107164,569280,4670,121586,4.508934228868331,0.17599071310500156
1712,0.2232,1,17,1,107181,569263,4671,121585,4.5087995818020525,0.17599385103524942
1713,0.2233,33,600,33,107781,568663,4704,121552,4.504047332404005,0.17610744478169846
1714,0.2234,0,2,0,107783,568661,4704,121552,4.504031491572678,0.17610795508053312
1715,0.2235,3,22,3,107805,568639,4707,121549,4.503857242428083,0.17610998742371645
1716,0.2236,1,2,1,107807,568637,4708,121548,4.503841401596755,0.1761093040271811
1717,0.2237,2,21,2,107828,568616,4710,121546,4.503675072867824,0.17611227508903707
1718,0.2238,0,10,0,107838,568606,4710,121546,4.50359586871119,0.17611482687871657
1719,0.2239,1,6,1,107844,568600,4711,121545,4.50354834621721,0.17611516420462367
1720,0.224,5,115,5,107959,568485,4716,121540,4.5026374984159165,0.17613854570486576
1721,0.2241,0,5,0,107964,568480,4716,121540,4.502597896337599,0.17613982203414394
1722,0.2242,6,99,6,108063,568381,4722,121534,4.501813775186922,0.17615793249893102
1723,0.2243,1,29,1,108092,568352,4723,121533,4.501584083132683,0.17616414329924554
1724,0.2244,1,4,1,108096,568348,4724,121532,4.501552401470029,0.17616397054560212
1725,0.2245,0,10,0,108106,568338,4724,121532,4.501473197313395,0.1761665241277342
1726,0.2246,0,8,0,108114,568330,4724,121532,4.501409833988088,0.1761685670467427
1727,0.2247,2,29,2,108143,568301,4726,121530,4.501180141933848,0.17617358454462034
1728,0.2248,0,17,0,108160,568284,4726,121530,4.50104549486757,0.17617792622359071
1729,0.2249,0,4,0,108164,568280,4726,121530,4.501013813204917,0.17617894782621302
1730,0.225,67,1211,67,109375,567069,4793,121463,4.4914221898365225,0.17640864912596654
1731,0.2251,0,3,0,109378,567066,4793,121463,4.491398428589532,0.17640941775872912
1732,0.2252,1,10,1,109388,567056,4794,121462,4.491319224432898,0.17641078374131106
1733,0.2253,0,24,0,109412,567032,4794,121462,4.491129134456976,0.1764169331904127
1734,0.2254,0,8,0,109420,567024,4794,121462,4.491065771131669,0.17641898310205292
1735,0.2255,4,21,4,109441,567003,4798,121458,4.490899442402737,0.17641957932257601
1736,0.2256,0,6,0,109447,566997,4798,121458,4.490851919908756,0.17642111684859577
1737,0.2257,2,36,2,109483,566961,4800,121456,4.490566784944874,0.17642794991988867
1738,0.2258,2,116,2,109599,566845,4802,121454,4.489648016727918,0.17645529050601555
1739,0.2259,1,3,1,109602,566842,4803,121453,4.489624255480928,0.17645486310375638
1740,0.226,12,125,12,109727,566717,4815,121441,4.4886342035230005,0.17647255426806052
1741,0.2261,0,3,0,109730,566714,4815,121441,4.488610442276011,0.1764733235971547
1742,0.2262,2,13,2,109743,566701,4817,121439,4.488507476872386,0.17647426395791554
1743,0.2263,3,18,3,109761,566683,4820,121436,4.4883649093904445,0.17647528988445313
1744,0.2264,0,4,0,109765,566679,4820,121436,4.488333227727791,0.17647631573210873
1745,0.2265,0,25,0,109790,566654,4820,121436,4.488135217336206,0.17648272755017513
1746,0.2266,0,2,0,109792,566652,4820,121436,4.488119376504879,0.17648324051574799
1747,0.2267,48,609,48,110401,566043,4868,121388,4.48329584336586,0.17658208605663694
1748,0.2268,0,17,0,110418,566026,4868,121388,4.483161196299582,0.17658645299630207
1749,0.2269,1,3,1,110421,566023,4869,121387,4.483137435052591,0.17658602580701474
1750,0.227,2,34,2,110455,565989,4871,121385,4.4828681409200355,0.17659236456426924
1751,0.2271,0,15,0,110470,565974,4871,121385,4.482749334685084,0.17659621827894884
1752,0.2272,1,23,1,110493,565951,4872,121384,4.482567165124825,0.1766009296776681
1753,0.2273,2,33,2,110526,565918,4874,121382,4.482305791407933,0.1766070129492216
1754,0.2274,0,8,0,110534,565910,4874,121382,4.482242428082626,0.17660906863458325
1755,0.2275,18,319,18,110853,565591,4892,121364,4.479715815485997,0.17666950528054967
1756,0.2276,0,8,0,110861,565583,4892,121364,4.479652452160689,0.17667156272609094
1757,0.2277,5,26,5,110887,565557,4897,121359,4.479446521353441,0.17667225686983562
1758,0.2278,1,11,1,110898,565546,4898,121358,4.479359396781143,0.1766738874719029
1759,0.2279,1,13,1,110911,565533,4899,121357,4.479256431377519,0.17667603255251932
1760,0.228,3,71,3,110982,565462,4902,121354,4.478694081865417,0.17669070027489167
1761,0.2281,1,2,1,110984,565460,4903,121353,4.478678241034089,0.17669001605968437
1762,0.2282,0,13,0,110997,565447,4903,121353,4.478575275630465,0.17669336051252185
1763,0.2283,24,314,24,111311,565133,4927,121329,4.476088265112153,0.17674539887131407
1764,0.2284,0,1,0,111312,565132,4927,121329,4.47608034469649,0.17674565634464304
1765,0.2285,4,26,4,111338,565106,4931,121325,4.475874413889241,0.17674755365069467
1766,0.2286,1,7,1,111345,565099,4932,121324,4.475818970979597,0.17674815674882688
1767,0.2287,3,23,3,111368,565076,4935,121321,4.475636801419339,0.17675048113555275
1768,0.2288,1,18,1,111386,565058,4936,121320,4.475494233937397,0.1767539169378972
1769,0.2289,3,6,3,111392,565052,4939,121317,4.475446711443417,0.17675186379338229
1770,0.229,10,71,10,111463,564981,4949,121307,4.474884361931315,0.176758154011144
1771,0.2291,0,6,0,111469,564975,4949,121307,4.474836839437334,0.17675969936556693
1772,0.2292,6,92,6,111561,564883,4955,121301,4.474108161196299,0.17677619996968744
1773,0.2293,1,39,1,111600,564844,4956,121300,4.473799264985426,0.17678504803656375
1774,0.2294,1,6,1,111606,564838,4957,121299,4.473751742491446,0.17678539417055195
1775,0.2295,0,21,0,111627,564817,4957,121299,4.473585413762514,0.1767908050533729
1776,0.2296,0,4,0,111631,564813,4957,121299,4.473553732099861,0.17679183573527354
1777,0.2297,3,17,3,111648,564796,4960,121296,4.473419085033583,0.1767926167336159
1778,0.2298,1,12,1,111660,564784,4961,121295,4.473324040045622,0.17679450908714595
1779,0.2299,0,4,0,111664,564780,4961,121295,4.473292358382968,0.17679553984622673
1780,0.23,239,4460,239,116124,560320,5200,121056,4.4379673045241415,0.17766402103977832
1781,0.2301,0,3,0,116127,560317,5200,121056,4.437943543277151,0.17766480327221654
1782,0.2302,1,10,1,116137,560307,5201,121055,4.437864339120517,0.1776662038681347
1783,0.2303,0,24,0,116161,560283,5201,121055,4.437674249144595,0.17767246212599327
1784,0.2304,0,5,0,116166,560278,5201,121055,4.437634647066278,0.1776737659852084
1785,0.2305,2,16,2,116182,560262,5203,121053,4.437507920415664,0.1776755245371084
1786,0.2306,0,5,0,116187,560257,5203,121053,4.437468318337347,0.1776768284628143
1787,0.2307,2,49,2,116236,560208,5205,121051,4.437080217969839,0.17768719385725545
1788,0.2308,12,116,12,116352,560092,5217,121039,4.436161449752883,0.17770296756424242
1789,0.2309,0,1,0,116353,560091,5217,121039,4.436153529337219,0.17770322845859088
1790,0.231,7,71,7,116424,560020,5224,121032,4.435591179825117,0.1777133023616405
1791,0.2311,1,4,1,116428,560016,5225,121031,4.435559498162464,0.17771313874079175
1792,0.2312,1,18,1,116446,559998,5226,121030,4.435416930680522,0.17771662839119684
1793,0.2313,1,32,1,116478,559966,5227,121029,4.435163477379293,0.17772377183386076
1794,0.2314,0,14,0,116492,559952,5227,121029,4.435052591560005,0.17772742558162416
1795,0.2315,1,34,1,116526,559918,5228,121028,4.434783297427449,0.17773509206310045
1796,0.2316,0,2,0,116528,559916,5228,121028,4.434767456596123,0.17773561408867689
1797,0.2317,22,314,22,116842,559602,5250,121006,4.43228044607781,0.17779103389910197
1798,0.2318,1,15,1,116857,559587,5251,121005,4.432161639842859,0.17779374426969463
1799,0.2319,0,3,0,116860,559584,5251,121005,4.432137878595869,0.1777945279750334
1800,0.232,5,95,5,116955,559489,5256,121000,4.431385439107844,0.17781330778307952
1801,0.2321,3,6,3,116961,559483,5259,120997,4.431337916613864,0.17781125088173055
1802,0.2322,1,11,1,116972,559472,5260,120996,4.431250792041566,0.17781291699242285
1803,0.2323,0,27,0,116999,559445,5260,120996,4.431036940818654,0.1778199726353938
1804,0.2324,0,7,0,117006,559438,5260,120996,4.43098149790901,0.17782180196756775
1805,0.2325,11,348,11,117354,559090,5271,120985,4.428225193258142,0.17789949637907584
1806,0.2326,0,7,0,117361,559083,5271,120985,4.4281697503484985,0.1779013275143074
1807,0.2327,1,27,1,117388,559056,5272,120984,4.427955899125586,0.17790718193047467
1808,0.2328,0,15,0,117403,559041,5272,120984,4.427837092890635,0.17791110620933054
1809,0.2329,0,22,0,117425,559019,5272,120984,4.42766284374604,0.1779168621314906
1810,0.233,6,41,6,117466,558978,5278,120978,4.42733810670384,0.1779203360217426
1811,0.2331,0,6,0,117472,558972,5278,120978,4.427290584209859,0.17792190602250166
1812,0.2332,3,17,3,117489,558955,5281,120975,4.427155937143581,0.17792272733957906
1813,0.2333,44,635,44,118124,558320,5325,120931,4.422126473197314,0.17803580708751257
1814,0.2334,1,4,1,118128,558316,5326,120930,4.42209479153466,0.17803564540681874
1815,0.2335,2,15,2,118143,558301,5328,120928,4.421975985299708,0.17803715683517635
1816,0.2336,2,9,2,118152,558292,5330,120926,4.421904701558738,0.17803709560111775
1817,0.2337,2,27,2,118179,558265,5332,120924,4.421690850335826,0.17804175273745598
1818,0.2338,2,23,2,118202,558242,5334,120922,4.421508680775567,0.17804536165049972
1819,0.2339,0,8,0,118210,558234,5334,120922,4.42144531745026,0.17804745890487605
1820,0.234,10,117,10,118327,558117,5344,120912,4.42051862881764,0.1780660325258568
1821,0.2342,3,75,3,118402,558042,5347,120909,4.4199245976428845,0.17808207072380774
1822,0.2343,2,38,2,118440,558004,5349,120907,4.419623621847674,0.17808961704847912
1823,0.2344,1,7,1,118447,557997,5350,120906,4.419568178938031,0.17809024264143772
1824,0.2345,4,14,4,118461,557983,5354,120902,4.419457293118743,0.1780890725233287
1825,0.2346,0,8,0,118469,557975,5354,120902,4.4193939297934355,0.17809117115471582
1826,0.2347,1,20,1,118489,557955,5355,120901,4.419235521480167,0.1780952072309886
1827,0.2348,0,14,0,118503,557941,5355,120901,4.4191246356608795,0.1780988801517879
1828,0.2349,0,6,0,118509,557935,5355,120901,4.419077113166899,0.17810045430707858
1829,0.235,87,1289,87,119798,556646,5442,120814,4.408867697376758,0.17833377616390636
1830,0.2351,0,4,0,119802,556642,5442,120814,4.408836015714105,0.17833482912543397
1831,0.2352,1,14,1,119816,556628,5443,120813,4.408725129894817,0.1783373016985981
1832,0.2353,3,43,3,119859,556585,5446,120810,4.40838455202129,0.17834498335535395
1833,0.2354,0,6,0,119865,556579,5446,120810,4.40833702952731,0.1783465630531349
1834,0.2355,0,15,0,119880,556564,5446,120810,4.408218223292359,0.17835051242002203
1835,0.2356,1,13,1,119893,556551,5447,120809,4.408115257888734,0.1783527223337664
1836,0.2357,3,47,3,119940,556504,5450,120806,4.407742998352553,0.17836145930223973
1837,0.2358,8,91,8,120031,556413,5458,120798,4.407022240527183,0.17837572041800856
1838,0.236,8,124,8,120155,556289,5466,120790,4.40604010898492,0.17839868021309183
1839,0.2361,0,8,0,120163,556281,5466,120790,4.405976745659612,0.1784007881005094
1840,0.2362,1,23,1,120186,556258,5467,120789,4.405794576099353,0.17840563505930904
1841,0.2363,2,16,2,120202,556242,5469,120787,4.405667849448739,0.1784074242019175
1842,0.2364,1,3,1,120205,556239,5470,120786,4.405644088201749,0.17840700121856654
1843,0.2365,1,26,1,120231,556213,5471,120785,4.4054381573945,0.17841263932832888
1844,0.2366,0,4,0,120235,556209,5471,120785,4.405406475731846,0.17841369347438826
1845,0.2367,48,615,48,120850,555594,5519,120737,4.400535420098847,0.1785176193313629
1846,0.2368,1,15,1,120865,555579,5520,120736,4.400416613863896,0.17852036403155336
1847,0.2369,0,5,0,120870,555574,5520,120736,4.4003770117855785,0.178521683843208
1848,0.237,2,40,2,120910,555534,5522,120734,4.400060195159042,0.1785298136241845
1849,0.2371,1,9,1,120919,555525,5523,120733,4.399988911418071,0.17853097486462266
1850,0.2372,1,7,1,120926,555518,5524,120732,4.3999334685084275,0.17853160813308688
1851,0.2373,4,55,4,120981,555463,5528,120728,4.399497845646939,0.1785412701440865
1852,0.2374,1,8,1,120989,555455,5529,120727,4.399434482321632,0.17854216764125636
1853,0.2375,16,318,16,121307,555137,5545,120711,4.396915790140667,0.17860672814005515
1854,0.2376,1,10,1,121317,555127,5546,120710,4.396836585984032,0.17860815551678882
1855,0.2377,2,24,2,121341,555103,5548,120708,4.396646496008111,0.17861206757510606
1856,0.2378,1,17,1,121358,555086,5549,120707,4.396511848941833,0.178615345231454
1857,0.2379,1,14,1,121372,555072,5550,120706,4.396400963122544,0.17861783011580726
1858,0.238,8,65,8,121437,555007,5558,120698,4.395886136104423,0.17862528766251545
1859,0.2381,0,11,0,121448,554996,5558,120698,4.395799011532125,0.17862819560333523
1860,0.2382,3,26,3,121474,554970,5561,120695,4.395593080724876,0.17863142237647356
1861,0.2383,30,347,30,121821,554623,5591,120665,4.3928446964896715,0.17868672329435736
1862,0.2385,1,31,1,121852,554592,5592,120664,4.392599163604106,0.1786937102373026
1863,0.2386,0,7,0,121859,554585,5592,120664,4.392543720694462,0.1786955626739173
1864,0.2387,3,26,3,121885,554559,5595,120661,4.392337789887213,0.17869879446698853
1865,0.2388,4,24,4,121909,554535,5599,120657,4.392147699911291,0.17870028080901432
1866,0.2389,0,3,0,121912,554532,5599,120657,4.392123938664301,0.17870107481016426
1867,0.239,6,64,6,121976,554468,5605,120651,4.391617032061842,0.17871071618485038
1868,0.2391,0,5,0,121981,554463,5605,120651,4.391577429983526,0.17871203974439873
1869,0.2392,4,102,4,122083,554361,5609,120647,4.390769547585857,0.1787341779652982
1870,0.2393,1,51,1,122134,554310,5610,120646,4.390365606387023,0.17874646643633066
1871,0.2394,0,3,0,122137,554307,5610,120646,4.390341845140033,0.17874726092039
1872,0.2395,1,13,1,122150,554294,5611,120645,4.390238879736408,0.1787494869906762
1873,0.2396,0,6,0,122156,554288,5611,120645,4.390191357242428,0.17875107603273213
1874,0.2397,0,24,0,122180,554264,5611,120645,4.3900012672665065,0.17875743248349038
1875,0.2398,1,24,1,122204,554240,5612,120644,4.389811177290584,0.1787625725309831
1876,0.2399,0,7,0,122211,554233,5612,120644,4.38975573438094,0.17876442670293993
1877,0.24,254,4612,254,126823,549621,5866,120390,4.353226777341275,0.17968361713464406
1878,0.2401,0,7,0,126830,549614,5866,120390,4.353171334431631,0.1796854944149587
1879,0.2402,0,11,0,126841,549603,5866,120390,4.353084209859333,0.17968844450613664
1880,0.2403,3,18,3,126859,549585,5869,120387,4.352941642377392,0.1796895989683151
1881,0.2404,0,10,0,126869,549575,5869,120387,4.3528624382207575,0.17969228105474638
1882,0.2405,0,8,0,126877,549567,5869,120387,4.352799074895451,0.1796944267815402
1883,0.2406,0,6,0,126883,549561,5869,120387,4.35275155240147,0.17969603611026527
1884,0.2407,5,55,5,126938,549506,5874,120382,4.352315929539983,0.1797046670488201
1885,0.2408,7,99,7,127037,549407,5881,120375,4.351531808389304,0.1797226560283794
1886,0.2409,0,3,0,127040,549404,5881,120375,4.351508047142314,0.17972346102221778
1887,0.241,4,65,4,127105,549339,5885,120371,4.3509932201241925,0.17973600513655164
1888,0.2411,1,7,1,127112,549332,5886,120370,4.350937777214548,0.1797366589916112
1889,0.2412,2,24,2,127136,549308,5888,120368,4.350747687238626,0.17974065070272788
1890,0.2413,1,31,1,127167,549277,5889,120367,4.350502154353061,0.17974774656384587
1891,0.2414,0,12,0,127179,549265,5889,120367,4.3504071093651,0.17975096769568957
1892,0.2415,2,39,2,127218,549226,5891,120365,4.350098213154227,0.17975898720263564
1893,0.2416,0,4,0,127222,549222,5891,120365,4.3500665314915725,0.17976006105255926
1894,0.2417,22,330,22,127552,548892,5913,120343,4.347452794322646,0.17982173675913543
1895,0.2418,2,11,2,127563,548881,5915,120341,4.347365669750348,0.17982224134890962
1896,0.2419,0,4,0,127567,548877,5915,120341,4.347333988087695,0.17982331616902117
1897,0.242,10,80,10,127647,548797,5925,120331,4.3467003548346215,0.17983255819514354
1898,0.2421,1,15,1,127662,548782,5926,120330,4.34658154859967,0.17983536388526883
1899,0.2422,2,10,2,127672,548772,5928,120328,4.346502344443036,0.1798356000597818
1900,0.2423,2,31,2,127703,548741,5930,120326,4.3462568115574705,0.1798414807485648
1901,0.2424,0,7,0,127710,548734,5930,120326,4.346201368647827,0.17984336232923803
1902,0.2425,28,384,28,128094,548350,5958,120298,4.343159929033075,0.17991230064249053
1903,0.2426,0,7,0,128101,548343,5958,120298,4.343104486123432,0.17991418414365856
1904,0.2427,3,39,3,128140,548304,5961,120295,4.3427955899125585,0.17992099898444358
1905,0.2428,3,12,3,128152,548292,5964,120292,4.342700544924598,0.1799205485025068
1906,0.2429,3,10,3,128162,548282,5967,120289,4.3426213407679635,0.17991955977749557
1907,0.243,4,36,4,128198,548246,5971,120285,4.342336205804081,0.17992434157877496
1908,0.2431,1,4,1,128202,548242,5972,120284,4.342304524141427,0.17992419143010144
1909,0.2432,0,13,0,128215,548229,5972,120284,4.342201558737803,0.1799276902618199
1910,0.2433,43,676,43,128891,547553,6015,120241,4.336847357749335,0.18005702357313783
1911,0.2434,0,2,0,128893,547551,6015,120241,4.336831516918008,0.1800575628339363
1912,0.2435,1,27,1,128920,547524,6016,120240,4.336617665695096,0.18006361528923392
1913,0.2436,0,3,0,128923,547521,6016,120240,4.336593904448105,0.18006442424759758
1914,0.2437,1,23,1,128946,547498,6017,120239,4.336411734887847,0.18006939858057888
1915,0.2438,0,26,0,128972,547472,6017,120239,4.336205804080598,0.18007641030325994
1916,0.2439,1,6,1,128978,547466,6018,120238,4.336158281586617,0.18007680049842445
1917,0.244,8,136,8,129114,547330,6026,120230,4.3350811050563935,0.18010366109413387
1918,0.2442,8,108,8,129222,547222,6034,120222,4.334225700164745,0.1801229766092736
1919,0.2443,5,51,5,129273,547171,6039,120217,4.333821758965911,0.180130598692215
1920,0.2444,0,8,0,129281,547163,6039,120217,4.333758395640603,0.18013275794899458
1921,0.2445,0,25,0,129306,547138,6039,120217,4.333560385249018,0.1801395059600962
1922,0.2446,0,7,0,129313,547131,6039,120217,4.333504942339374,0.18014139549380534
1923,0.2447,1,23,1,129336,547108,6040,120216,4.333322772779115,0.18014637567358585
1924,0.2448,2,9,2,129345,547099,6042,120214,4.333251489038145,0.180146348115502
1925,0.2449,0,2,0,129347,547097,6042,120214,4.333235648206818,0.1801468880327164
1926,0.245,71,1393,71,130740,545704,6113,120143,4.322202509187682,0.180436346488007
1927,0.2451,1,7,1,130747,545697,6114,120142,4.322147066278038,0.18043701255108216
1928,0.2452,2,19,2,130766,545678,6116,120140,4.321996578380434,0.18043969973776616
1929,0.2453,5,28,5,130794,545650,6121,120135,4.321774806741858,0.18044113339892007
1930,0.2454,2,3,2,130797,545647,6123,120133,4.321751045494867,0.18043948451440417
1931,0.2455,0,14,0,130811,545633,6123,120133,4.32164015967558,0.18044327886975303
1932,0.2456,1,3,1,130814,545630,6124,120132,4.321616398428589,0.18044286096232587
1933,0.2457,1,45,1,130859,545585,6125,120131,4.321259979723736,0.18045382715752664
1934,0.2458,15,116,15,130975,545469,6140,120116,4.32034121150678,0.18046680739499837
1935,0.2459,0,10,0,130985,545459,6140,120116,4.320262007350146,0.18046951883709575
1936,0.246,10,134,10,131119,545325,6150,120106,4.319200671651248,0.18049354478525947
1937,0.2461,0,3,0,131122,545322,6150,120106,4.319176910404258,0.18049435851812667
1938,0.2462,2,18,2,131140,545304,6152,120104,4.319034342922317,0.18049677791670674
1939,0.2463,3,19,3,131159,545285,6155,120101,4.318883855024712,0.18049823711349502
1940,0.2464,0,11,0,131170,545274,6155,120101,4.318796730452414,0.18050122111591207
1941,0.2465,4,26,4,131196,545248,6159,120097,4.318590799645166,0.18050334788718636
1942,0.2466,0,4,0,131200,545244,6159,120097,4.318559117982511,0.18050443306515004
1943,0.2467,47,675,47,131875,544569,6206,120050,4.313212837409707,0.1806298044443508
1944,0.2468,2,16,2,131891,544553,6208,120048,4.313086110759093,0.18063168728304652
1945,0.2469,1,3,1,131894,544550,6209,120047,4.313062349512102,0.18063126977702276
1946,0.247,5,49,5,131943,544501,6214,120042,4.312674249144595,0.18063842369869218
1947,0.2471,1,19,1,131962,544482,6215,120041,4.31252376124699,0.18064235549409124
1948,0.2472,0,10,0,131972,544472,6215,120041,4.312444557090356,0.18064507391127035
1949,0.2473,2,42,2,132014,544430,6217,120039,4.312111899632493,0.1806540259966981
1950,0.2474,1,5,1,132019,544425,6218,120038,4.312072297554176,0.18065415230042906
1951,0.2475,22,349,22,132368,544076,6240,120016,4.309308072487644,0.18072194816380863
1952,0.2476,2,8,2,132376,544068,6242,120014,4.3092447091623365,0.1807216578675525
1953,0.2477,5,27,5,132403,544041,6247,120009,4.309030857939424,0.18072283713575785
1954,0.2478,1,13,1,132416,544028,6248,120008,4.3089278925358006,0.18072514140799595
1955,0.2479,1,11,1,132427,544017,6249,120007,4.308840767963503,0.18072690143729744
1956,0.248,10,87,10,132514,543930,6259,119997,4.308151691800786,0.1807382438129493
1957,0.2481,0,6,0,132520,543924,6259,119997,4.308104169306805,0.18073987718418305
1958,0.2482,0,16,0,132536,543908,6259,119997,4.307977442656191,0.18074423298514095
1959,0.2483,27,362,27,132898,543546,6286,119970,4.305110252186035,0.18080950572405186
1960,0.2484,0,2,0,132900,543544,6286,119970,4.305094411354708,0.1808100507299017
1961,0.2485,1,34,1,132934,543510,6287,119969,4.304825117222152,0.18081808165744506
1962,0.2486,4,14,4,132948,543496,6291,119965,4.304714231402864,0.1808169583441981
1963,0.2487,0,25,0,132973,543471,6291,119965,4.304516221011279,0.18082377199910768
1964,0.2488,3,21,3,132994,543450,6294,119962,4.304349892282347,0.1808257915141722
1965,0.2489,1,7,1,133001,543443,6295,119961,4.304294449372703,0.18082646471833153
1966,0.249,3,78,3,133079,543365,6298,119958,4.303676656950957,0.18084402319835133
1967,0.2491,0,2,0,133081,543363,6298,119958,4.30366081611963,0.1808445684668509
1968,0.2492,9,112,9,133193,543251,6307,119949,4.302773729565327,0.18086399276236428
1969,0.2493,1,59,1,133252,543192,6308,119948,4.302306425041186,0.18087884911180144
1970,0.2494,0,5,0,133257,543187,6308,119948,4.302266822962869,0.180880212927986
1971,0.2495,2,33,2,133290,543154,6310,119946,4.302005449245977,0.18088674408083244
1972,0.2496,0,5,0,133295,543149,6310,119946,4.30196584716766,0.18088810803881797
1973,0.2497,3,18,3,133313,543131,6313,119943,4.301823279685718,0.18088931250508994
1974,0.2498,3,10,3,133323,543121,6316,119940,4.301744075529084,0.18088833455745398
1975,0.2499,1,1,1,133324,543120,6317,119939,4.301736155113421,0.18088737201365188
1976,0.25,289,4734,289,138058,538386,6606,119650,4.264240907362819,0.1818289576862056
1977,0.2501,0,1,0,138059,538385,6606,119650,4.264232986947155,0.18182923400730963
1978,0.2502,2,16,2,138075,538369,6608,119648,4.264106260296541,0.18183116849564676
1979,0.2503,0,23,0,138098,538346,6608,119648,4.263924090736282,0.18183752435432543
1980,0.2504,0,8,0,138106,538338,6608,119648,4.263860727410974,0.18183973519193417
1981,0.2505,1,19,1,138125,538319,6609,119647,4.26371023951337,0.1818437426857923
1982,0.2506,2,5,2,138130,538314,6611,119645,4.263670637435053,0.18184263761115815
1983,0.2507,4,61,4,138191,538253,6615,119641,4.2631874920795845,0.18185452367706653
1984,0.2508,6,98,6,138289,538155,6621,119635,4.26241129134457,0.18187415436537496
1985,0.2509,0,2,0,138291,538153,6621,119635,4.262395450513243,0.18187470735252087
1986,0.251,4,58,4,138349,538095,6625,119631,4.261936066404765,0.18188577006230558
1987,0.2511,1,2,1,138351,538093,6626,119630,4.261920225573438,0.18188507928109554
1988,0.2512,2,27,2,138378,538066,6628,119628,4.261706374350526,0.18189005829458685
1989,0.2513,2,17,2,138395,538049,6630,119626,4.261571727284248,0.1818922720188543
1990,0.2514,0,13,0,138408,538036,6630,119626,4.261468761880623,0.18189586748208045
1991,0.2515,3,18,3,138426,538018,6633,119623,4.261326194398682,0.18189711407895798
1992,0.2516,1,0,1,138426,538018,6634,119622,4.261326194398682,0.18189587008089533
1993,0.2517,23,322,23,138748,537696,6657,119599,4.258775820555063,0.18195635140994532
1994,0.2518,0,12,0,138760,537684,6657,119599,4.258680775567102,0.18195967338269817
1995,0.2519,0,4,0,138764,537680,6657,119599,4.258649093904448,0.18196078073390448
1996,0.252,6,94,6,138858,537586,6663,119593,4.257904574832088,0.18197933896244403
1997,0.2521,2,16,2,138874,537570,6665,119591,4.2577778481814725,0.18198128008204992
1998,0.2522,0,6,0,138880,537564,6665,119591,4.257730325687492,0.18198294161955703
1999,0.2523,2,45,2,138925,537519,6667,119589,4.257373906982639,0.18199291440676418
2000,0.2524,1,5,1,138930,537514,6668,119588,4.2573343049043215,0.1819930543507705
2001,0.2525,22,355,22,139285,537159,6690,119566,4.254522557343809,0.18206402984506453
2002,0.2526,1,5,1,139290,537154,6691,119565,4.254482955265492,0.18206417052042045
2003,0.2527,4,46,4,139336,537108,6695,119561,4.254118616144975,0.18207194187634868
2004,0.2528,1,14,1,139350,537094,6696,119560,4.254007730325688,0.1820745780883083
2005,0.2529,0,16,0,139366,537078,6696,119560,4.2538810036750725,0.18207901461688175
2006,0.253,1,30,1,139396,537048,6697,119559,4.253643391205171,0.1820860880252571
2007,0.2531,0,8,0,139404,537040,6697,119559,4.253580027879863,0.18208830656153907
2008,0.2532,0,12,0,139416,537028,6697,119559,4.253484982891902,0.1820916344673288
2009,0.2533,44,699,44,140115,536329,6741,119515,4.247948612343175,0.18223083538158463
2010,0.2534,0,2,0,140117,536327,6741,119515,4.247932771511849,0.18223139109724598
2011,0.2535,1,24,1,140141,536303,6742,119514,4.247742681535927,0.18223681301338635
2012,0.2536,1,16,1,140157,536287,6743,119513,4.247615954885313,0.18224001219884112
2013,0.2537,3,30,3,140187,536257,6746,119510,4.24737834241541,0.18224460822212768
2014,0.2538,2,18,2,140205,536239,6748,119508,4.247235774933468,0.18224711664712154
2015,0.2539,0,4,0,140209,536235,6748,119508,4.247204093270815,0.1822482283455561
2016,0.254,10,178,10,140387,536057,6758,119498,4.245794259282727,0.18228523922477902
2017,0.2541,0,3,0,140390,536054,6758,119498,4.2457704980357365,0.1822860734159914
2018,0.2542,5,113,5,140503,535941,6763,119493,4.2448754910657716,0.1823112624612089
2019,0.2543,0,31,0,140534,535910,6763,119493,4.244629958180205,0.18231988562762147
2020,0.2544,0,4,0,140538,535906,6763,119493,4.244598276517552,0.18232099835367463
2021,0.2545,2,19,2,140557,535887,6765,119491,4.244447788619947,0.18232378871429922
2022,0.2546,0,3,0,140560,535884,6765,119491,4.244424027372957,0.18232462330726684
2023,0.2547,2,28,2,140588,535856,6767,119489,4.244202255734381,0.18232991782954017
2024,0.2548,1,31,1,140619,535825,6768,119488,4.243956722848815,0.18233729530773843
2025,0.2549,1,6,1,140625,535819,6769,119487,4.243909200354834,0.18233771703601065
2026,0.255,93,1432,93,142057,534387,6862,119394,4.232567165124825,0.18262078585948505
2027,0.2551,0,1,0,142058,534386,6862,119394,4.2325592447091624,0.1826210651901251
2028,0.2552,1,12,1,142070,534374,6863,119393,4.232464199721202,0.18262316696927192
2029,0.2553,2,28,2,142098,534346,6865,119391,4.232242428082626,0.1826284882146796
2030,0.2554,4,13,4,142111,534333,6869,119387,4.232139462679001,0.1826271186440678
2031,0.2555,1,31,1,142142,534302,6870,119386,4.2318939297934355,0.1826345290107819
2032,0.2556,1,8,1,142150,534294,6871,119385,4.231830566468128,0.18263551376134157
2033,0.2557,2,47,2,142197,534247,6873,119383,4.231458306931947,0.1826461453727644
2034,0.2558,9,109,9,142306,534138,6882,119374,4.230594981624636,0.18266535274027101
2035,0.2559,0,2,0,142308,534136,6882,119374,4.230579140793309,0.1826659117687564
2036,0.256,6,143,6,142451,533993,6888,119368,4.229446521353441,0.18269838573162464
2037,0.2561,0,5,0,142456,533988,6888,119368,4.229406919275124,0.1826997838850489
2038,0.2562,1,24,1,142480,533964,6889,119367,4.229216829299202,0.18270524435546454
2039,0.2563,3,25,3,142505,533939,6892,119364,4.229018818907616,0.18270848289384864
2040,0.2564,0,11,0,142516,533928,6892,119364,4.228931694335318,0.1827115593027314
2041,0.2565,3,36,3,142552,533892,6895,119361,4.228646559371436,0.18271787500401834
2042,0.2566,0,1,0,142553,533891,6895,119361,4.228638638955772,0.1827181547090556
2043,0.2567,38,725,38,143278,533166,6933,119323,4.222896337599797,0.1828735810105611
2044,0.2568,2,24,2,143302,533142,6935,119321,4.222706247623876,0.1828778030325091
2045,0.2569,0,5,0,143307,533137,6935,119321,4.222666645545559,0.1828792044851929
2046,0.257,4,61,4,143368,533076,6939,119317,4.22218350019009,0.18289129405128504
2047,0.2571,0,10,0,143378,533066,6939,119317,4.222104296033456,0.18289409748567942
2048,0.2572,2,8,2,143386,533058,6941,119315,4.222040932708149,0.18289383527521832
2049,0.2573,0,33,0,143419,533025,6941,119315,4.221779558991256,0.18290308734708893
2050,0.2574,0,8,0,143427,533017,6941,119315,4.221716195665948,0.18290533041457419
2051,0.2575,25,403,25,143830,532614,6966,119290,4.218524268153593,0.18298706558020814
2052,0.2576,0,5,0,143835,532609,6966,119290,4.218484666075276,0.18298846907266308
2053,0.2577,1,20,1,143855,532589,6967,119289,4.2183262577620075,0.18299282994670782
2054,0.2578,0,14,0,143869,532575,6967,119289,4.218215371942719,0.18299676006038068
2055,0.2579,1,17,1,143886,532558,6968,119288,4.218080724876441,0.18300027920705197
2056,0.258,5,87,5,143973,532471,6973,119283,4.217391648713725,0.18301843947256174
2057,0.2581,0,3,0,143976,532468,6973,119283,4.217367887466734,0.1830192819036718
2058,0.2582,3,21,3,143997,532447,6976,119280,4.217201558737803,0.18302141847736858
2059,0.2583,26,348,26,144345,532099,7002,119254,4.214445254086934,0.18308659052771692
2060,0.2584,0,3,0,144348,532096,7002,119254,4.214421492839945,0.18308743379135642
2061,0.2585,2,20,2,144368,532076,7004,119252,4.214263084526676,0.18309054731256755
2062,0.2586,1,10,1,144378,532066,7005,119251,4.214183880370042,0.18309210415204885
2063,0.2587,3,32,3,144410,532034,7008,119248,4.213930427068813,0.18309733725175883
2064,0.2588,3,21,3,144431,532013,7011,119245,4.2137640983398805,0.1830994782405744
2065,0.2589,2,11,2,144442,532002,7013,119243,4.213676973767583,0.18310006218857727
2066,0.259,4,84,4,144526,531918,7017,119239,4.2130116588518565,0.1831186641624063
2067,0.2591,1,4,1,144530,531914,7018,119238,4.212979977189203,0.18311853453571517
2068,0.2592,8,112,8,144642,531802,7026,119230,4.2120928906349,0.18313999926270905
2069,0.2593,3,57,3,144699,531745,7029,119227,4.211641426942086,0.1831522707581893
2070,0.2594,0,6,0,144705,531739,7029,119227,4.211593904448105,0.18315395888571753
2071,0.2595,2,22,2,144727,531717,7031,119225,4.21141965530351,0.18315763923667547
2072,0.2596,0,6,0,144733,531711,7031,119225,4.2113721328095295,0.18315932749148917
2073,0.2597,1,21,1,144754,531690,7032,119224,4.211205804080598,0.18316398172416018
2074,0.2598,1,23,1,144777,531667,7033,119223,4.211023634520339,0.18316919909662155
2075,0.2599,0,2,0,144779,531665,7033,119223,4.211007793689013,0.18316976192524673
2076,0.26,283,4800,283,149579,526865,7316,118940,4.172989798504625,0.18417324114864395
2077,0.2601,1,4,1,149583,526861,7317,118939,4.172958116841972,0.18417311861257354
2078,0.2602,3,21,3,149604,526840,7320,118936,4.17279178811304,0.18417531775724091
2079,0.2603,1,21,1,149625,526819,7321,118935,4.172625459384109,0.18418004379376668
2080,0.2604,0,9,0,149634,526810,7321,118935,4.172554175643138,0.18418261078289416
2081,0.2605,3,19,3,149653,526791,7324,118932,4.172403687745533,0.18418423999145145
2082,0.2606,0,3,0,149656,526788,7324,118932,4.172379926498543,0.18418509570711764
2083,0.2607,6,49,6,149705,526739,7330,118926,4.171991826131035,0.18419149249223668
2084,0.2608,10,145,10,149850,526594,7340,118916,4.170843365859841,0.18422022896624374
2085,0.2609,0,2,0,149852,526592,7340,118916,4.170827525028513,0.18422079974221853
2086,0.261,5,78,5,149930,526514,7345,118911,4.170209732606767,0.18423674323120426
2087,0.2611,0,6,0,149936,526508,7345,118911,4.170162210112787,0.18423845594877125
2088,0.2612,1,23,1,149959,526485,7346,118910,4.169980040552528,0.18424375769877363
2089,0.2613,1,41,1,150000,526444,7347,118909,4.1696553035103285,0.18425419886480732
2090,0.2614,2,13,2,150013,526431,7349,118907,4.169552338106704,0.18425538245074674
2091,0.2615,4,31,4,150044,526400,7353,118903,4.169306805221138,0.18425917747166834
2092,0.2616,1,2,1,150046,526398,7354,118902,4.169290964389811,0.18425848442584844
2093,0.2617,33,363,33,150409,526035,7387,118869,4.166415853503992,0.1843204569982509
2094,0.2618,2,17,2,150426,526018,7389,118867,4.166281206437714,0.18432278623320436
2095,0.2619,0,5,0,150431,526013,7389,118867,4.166241604359397,0.18432421535789603
2096,0.262,10,99,10,150530,525914,7399,118857,4.165457483208719,0.18433986640218
2097,0.2621,2,8,2,150538,525906,7401,118855,4.165394119883412,0.18433962351941263
2098,0.2622,2,12,2,150550,525894,7403,118853,4.165299074895451,0.18434052426765848
2099,0.2623,6,41,6,150591,525853,7409,118847,4.16497433785325,0.18434465642934697
2100,0.2624,0,7,0,150598,525846,7409,118847,4.1649188949436065,0.18434665802172506
2101,0.2625,28,375,28,150973,525471,7437,118819,4.161948739069826,0.18441850719396546
2102,0.2626,1,1,1,150974,525470,7438,118818,4.161940818654163,0.1844175275653124
2103,0.2627,2,42,2,151016,525428,7440,118816,4.161608161196299,0.18442701833466824
2104,0.2628,1,14,1,151030,525414,7441,118815,4.161497275377012,0.18442976022501315
2105,0.2629,1,24,1,151054,525390,7442,118814,4.16130718540109,0.18443536519487616
2106,0.263,6,51,6,151105,525339,7448,118808,4.160903244202256,0.1844423710736835
2107,0.2631,0,5,0,151110,525334,7448,118808,4.160863642123939,0.18444380276398684
2108,0.2632,2,30,2,151140,525304,7450,118806,4.160626029654036,0.18444986104857866
2109,0.2633,34,727,34,151867,524577,7484,118772,4.154867887466734,0.18461519330876397
2110,0.2634,0,12,0,151879,524565,7484,118772,4.154772842478773,0.18461863688859803
2111,0.2635,4,44,4,151923,524521,7488,118768,4.154424344189583,0.18462619444759665
2112,0.2636,1,4,1,151927,524517,7489,118767,4.15439266252693,0.18462607495289796
2113,0.2637,2,33,2,151960,524484,7491,118765,4.154131288810037,0.1846330114776704
2114,0.2638,3,19,3,151979,524465,7494,118762,4.153980800912432,0.18463466241311388
2115,0.2639,1,7,1,151986,524458,7495,118761,4.153925358002788,0.18463540411586102
2116,0.264,14,134,14,152120,524324,7509,118747,4.15286402230389,0.18465612661743416
2117,0.2641,0,1,0,152121,524323,7509,118747,4.1528561018882275,0.18465641376521996
2118,0.2642,14,114,14,152235,524209,7523,118733,4.151953174502598,0.1846714011528256
2119,0.2643,7,37,7,152272,524172,7530,118726,4.1516601191230516,0.1846731518841247
2120,0.2644,0,4,0,152276,524168,7530,118726,4.151628437460398,0.18467430089563755
2121,0.2645,1,17,1,152293,524151,7531,118725,4.15149379039412,0.18467791611446063
2122,0.2646,2,5,2,152298,524146,7533,118723,4.151454188315803,0.18467681596095006
2123,0.2647,0,25,0,152323,524121,7533,118723,4.151256177924218,0.1846839979839588
2124,0.2648,2,20,2,152343,524101,7535,118721,4.151097769610949,0.18468720734511265
2125,0.2649,2,2,2,152345,524099,7537,118719,4.151081928779623,0.18468524527937924
2126,0.265,91,1408,91,153753,522691,7628,118628,4.139929983525535,0.1849750280281732
2127,0.2651,1,11,1,153764,522680,7629,118627,4.139842858953238,0.1849769299259169
2128,0.2652,0,17,0,153781,522663,7629,118627,4.13970821188696,0.18498183349186795
2129,0.2653,2,32,2,153813,522631,7631,118625,4.139454758585731,0.1849885225245456
2130,0.2654,0,6,0,153819,522625,7631,118625,4.13940723609175,0.18499025341130604
2131,0.2655,4,19,4,153838,522606,7635,118621,4.139256748194145,0.18499065073679055
2132,0.2656,2,9,2,153847,522597,7637,118619,4.139185464453175,0.18499070516019564
2133,0.2657,7,55,7,153902,522542,7644,118612,4.138749841591687,0.18499767606534467
2134,0.2658,16,126,16,154028,522416,7660,118596,4.137751869218096,0.1850136970914741
2135,0.2659,1,4,1,154032,522412,7661,118595,4.137720187555443,0.18501358019491207
2136,0.266,14,159,14,154191,522253,7675,118581,4.13646084146496,0.18504168006067093
2137,0.2661,0,3,0,154194,522250,7675,118581,4.13643708021797,0.18504254631876424
2138,0.2662,2,29,2,154223,522221,7677,118579,4.136207388163731,0.1850483770287141
2139,0.2663,3,26,3,154249,522195,7680,118576,4.136001457356482,0.18505207008432029
2140,0.2664,0,7,0,154256,522188,7680,118576,4.135946014446838,0.1850540916780593
2141,0.2665,1,27,1,154283,522161,7681,118575,4.135732163223926,0.18506061778954203
2142,0.2666,0,5,0,154288,522156,7681,118575,4.135692561145609,0.18506206192614374
2143,0.2667,52,754,52,155042,521402,7733,118523,4.1297205677353945,0.1852138922529984
2144,0.2668,0,12,0,155054,521390,7733,118523,4.129625522747434,0.1852173654856207
2145,0.2669,0,5,0,155059,521385,7733,118523,4.129585920669117,0.18521881270432625
2146,0.267,4,47,4,155106,521338,7737,118519,4.129213661132936,0.1852273242302577
2147,0.2671,1,23,1,155129,521315,7738,118518,4.129031491572678,0.18523270916004644
2148,0.2672,1,9,1,155138,521306,7739,118517,4.128960207831707,0.18523404128954413
2149,0.2673,7,48,7,155186,521258,7746,118510,4.128580027879863,0.185239024146253
2150,0.2674,0,9,0,155195,521249,7746,118510,4.128508744138893,0.1852416300513162
2151,0.2675,33,351,33,155546,520898,7779,118477,4.1257286782410345,0.1853012707722385
2152,0.2676,0,5,0,155551,520893,7779,118477,4.125689076162717,0.185302719864867
2153,0.2677,1,35,1,155586,520858,7780,118476,4.125411861614498,0.1853115898732118
2154,0.2678,1,10,1,155596,520848,7781,118475,4.1253326574578635,0.18531321413432647
2155,0.2679,1,11,1,155607,520837,7782,118474,4.1252455328855655,0.18531512831782967
2156,0.268,5,86,5,155693,520751,7787,118469,4.124564377138512,0.18533368793216734
2157,0.2681,0,7,0,155700,520744,7787,118469,4.124508934228868,0.1853357175151319
2158,0.2682,3,25,3,155725,520719,7790,118466,4.124310923837283,0.18533914281467806
2159,0.2683,21,376,21,156101,520343,7811,118445,4.12133284754784,0.18542145437923066
2160,0.2684,0,2,0,156103,520341,7811,118445,4.121317006716512,0.1854220349224936
2161,0.2685,2,24,2,156127,520317,7813,118443,4.12112691674059,0.18542645124929552
2162,0.2686,1,8,1,156135,520309,7814,118442,4.121063553415283,0.18542749835225306
2163,0.2687,4,32,4,156167,520277,7818,118438,4.120810100114054,0.18543168705917348
2164,0.2688,0,15,0,156182,520262,7818,118438,4.120691293879103,0.18543604196023172
2165,0.2689,1,5,1,156187,520257,7819,118437,4.120651691800786,0.1854362182829336
2166,0.269,4,74,4,156261,520183,7823,118433,4.120065581041693,0.18545260375562153
2167,0.2691,0,8,0,156269,520175,7823,118433,4.120002217716386,0.18545492696615137
2168,0.2692,6,124,6,156393,520051,7829,118427,4.119020086174123,0.18548328994890975
2169,0.2693,1,44,1,156437,520007,7830,118426,4.118671587884932,0.18549479741805328
2170,0.2694,0,4,0,156441,520003,7830,118426,4.1186399062222785,0.18549595961336343
2171,0.2695,4,17,4,156458,519986,7834,118422,4.1185052591560005,0.18549579579203268
2172,0.2696,2,7,2,156465,519979,7836,118420,4.118449816246357,0.18549527803145055
2173,0.2697,1,22,1,156487,519957,7837,118419,4.118275567101762,0.1855003947516824
2174,0.2698,0,15,0,156502,519942,7837,118419,4.11815676086681,0.18550475357987095
2175,0.2699,0,7,0,156509,519935,7837,118419,4.118101317957167,0.18550678776979546
2176,0.27,303,4861,303,161370,515074,8140,118116,4.079600177417311,0.18654116457935216
2177,0.2701,0,5,0,161375,515069,8140,118116,4.079560575338994,0.18654263761775786
2178,0.2702,1,16,1,161391,515053,8141,118115,4.079433848688379,0.18654606676269173
2179,0.2703,2,25,2,161416,515028,8143,118113,4.0792358382967935,0.1865508630778926
2180,0.2704,0,9,0,161425,515019,8143,118113,4.079164554555823,0.18655351490684408
2181,0.2705,2,23,2,161448,514996,8145,118111,4.078982384995564,0.18655772247029334
2182,0.2706,0,6,0,161454,514990,8145,118111,4.078934862501584,0.18655949050783366
2183,0.2707,4,59,4,161513,514931,8149,118107,4.078467557977443,0.18657173818949258
2184,0.2708,9,121,9,161634,514810,8158,118098,4.077509187682169,0.18659584015370323
2185,0.2709,0,4,0,161638,514806,8158,118098,4.077477506019516,0.1865970194531872
2186,0.271,5,83,5,161721,514723,8163,118093,4.076820111519453,0.18661506662284139
2187,0.2711,0,3,0,161724,514720,8163,118093,4.0767963502724625,0.18661595131579156
2188,0.2712,3,27,3,161751,514693,8166,118090,4.07658249904955,0.18662005774491414
2189,0.2713,4,28,4,161779,514665,8170,118086,4.076360727410974,0.18662317404476642
2190,0.2714,0,13,0,161792,514652,8170,118086,4.076257762007351,0.18662700833520351
2191,0.2715,1,37,1,161829,514615,8171,118085,4.075964706627804,0.18663663663663663
2192,0.2716,1,4,1,161833,514611,8172,118084,4.07593302496515,0.18663653102995914
2193,0.2717,40,374,40,162207,514237,8212,118044,4.072970789507034,0.1866954724244442
2194,0.2718,1,15,1,162222,514222,8213,118043,4.072851983272082,0.1866986152958016
2195,0.2719,0,6,0,162228,514216,8213,118043,4.0728044607781015,0.18670038702493758
2196,0.272,9,91,9,162319,514125,8222,118034,4.072083702952731,0.18671568387067178
2197,0.2721,2,9,2,162328,514116,8224,118032,4.07201241921176,0.18671576909204807
2198,0.2722,1,21,1,162349,514095,8225,118031,4.071846090482828,0.18672068543296746
2199,0.2723,5,33,5,162382,514062,8230,118026,4.071584716765936,0.18672400045563275
2200,0.2724,1,13,1,162395,514049,8231,118025,4.071481751362311,0.1867265541692903
2201,0.2725,21,410,21,162805,513639,8252,118004,4.068234380940312,0.1868207199319869
2202,0.2726,0,7,0,162812,513632,8252,118004,4.068178938030668,0.1868227903412725
2203,0.2727,10,42,10,162854,513590,8262,117994,4.067846280572804,0.18682233875462328
2204,0.2728,1,15,1,162869,513575,8263,117993,4.067727474337853,0.18682548830846402
2205,0.2729,3,24,3,162893,513551,8266,117990,4.067537384361931,0.186828725292578
2206,0.273,5,48,5,162941,513503,8271,117985,4.067157204410088,0.18683648778757475
2207,0.2731,0,9,0,162950,513494,8271,117985,4.067085920669117,0.18683915062892037
2208,0.2732,2,23,2,162973,513471,8273,117983,4.066903751108859,0.1868433805154453
2209,0.2733,51,764,51,163737,512707,8324,117932,4.06085255354201,0.18700397533295593
2210,0.2734,0,2,0,163739,512705,8324,117932,4.0608367127106835,0.18700456839671634
2211,0.2735,4,23,4,163762,512682,8328,117928,4.060654543150425,0.1870062320610203
2212,0.2736,0,6,0,163768,512676,8328,117928,4.060607020656444,0.18700801136688
2213,0.2737,0,24,0,163792,512652,8328,117928,4.060416930680522,0.18701512892892258
2214,0.2738,0,20,0,163812,512632,8328,117928,4.060258522367254,0.18702106064450646
2215,0.2739,0,9,0,163821,512623,8328,117928,4.060187238626283,0.1870237300392831
2216,0.274,15,146,15,163967,512477,8343,117913,4.059030857939424,0.18704770062976886
2217,0.2741,0,9,0,163976,512468,8343,117913,4.058959574198454,0.18705037112476422
2218,0.2742,6,110,6,164086,512358,8349,117907,4.0580883284754785,0.18707527785931313
2219,0.2743,6,48,6,164134,512310,8355,117901,4.057708148523634,0.18708178689359595
2220,0.2744,0,2,0,164136,512308,8355,117901,4.0576923076923075,0.18708238060706844
2221,0.2745,3,24,3,164160,512284,8358,117898,4.057502217716386,0.18708563557829325
2222,0.2746,2,7,2,164167,512277,8360,117896,4.057446774806742,0.18708513376485505
2223,0.2747,4,27,4,164194,512250,8364,117892,4.05723292358383,0.18708798969121246
2224,0.2748,1,13,1,164207,512237,8365,117891,4.057129958180205,0.187090559378412
2225,0.2749,0,3,0,164210,512234,8365,117891,4.057106196933215,0.18709145010910533
2226,0.275,92,1472,92,165682,510762,8457,117799,4.04544734507667,0.18741060931238177
2227,0.2751,0,2,0,165684,510760,8457,117799,4.045431504245343,0.18741120563065677
2228,0.2752,1,19,1,165703,510741,8458,117798,4.0452810163477375,0.1874155780309575
2229,0.2753,2,32,2,165735,510709,8460,117796,4.045027563046509,0.18742253442693377
2230,0.2754,0,11,0,165746,510698,8460,117796,4.044940438474211,0.18742581472535935
2231,0.2755,1,23,1,165769,510675,8461,117795,4.044758268913952,0.1874313809728388
2232,0.2756,2,2,2,165771,510673,8463,117793,4.044742428082626,0.18742939156613087
2233,0.2757,2,56,2,165827,510617,8465,117791,4.044298884805475,0.18744350803936297
2234,0.2758,13,106,13,165933,510511,8478,117778,4.043459320745153,0.18745831934030358
2235,0.2759,0,4,0,165937,510507,8478,117778,4.043427639082499,0.18745951280071943
2236,0.276,12,154,12,166091,510353,8490,117766,4.042207895070334,0.18748995015275768
2237,0.2761,0,4,0,166095,510349,8490,117766,4.0421762134076795,0.1874911441376181
2238,0.2762,3,33,3,166128,510316,8493,117763,4.041914839690787,0.1874971142165237
2239,0.2763,1,21,1,166149,510295,8494,117762,4.041748510961855,0.18750208977847552
2240,0.2764,0,9,0,166158,510286,8494,117762,4.041677227220885,0.18750477670496524
2241,0.2765,2,24,2,166182,510262,8496,117760,4.041487137244963,0.1875093547678266
2242,0.2766,0,1,0,166183,510261,8496,117760,4.041479216829299,0.18750965333961764
2243,0.2767,60,795,60,166978,509466,8556,117700,4.035182486376885,0.18766961219198744
2244,0.2768,0,22,0,167000,509444,8556,117700,4.03500823723229,0.18767619557868687
2245,0.2769,2,5,2,167005,509439,8558,117698,4.034968635153973,0.18767510129365672
2246,0.277,6,56,6,167061,509383,8564,117692,4.034525091876822,0.18768408882510065
2247,0.2771,3,19,3,167080,509364,8567,117689,4.0343746039792165,0.18768588939053
2248,0.2772,1,16,1,167096,509348,8568,117688,4.034247877328602,0.1876893830657251
2249,0.2773,8,48,8,167144,509300,8576,117680,4.033867697376758,0.18769338734887875
2250,0.2774,1,6,1,167150,509294,8577,117679,4.033820174882778,0.18769388793456815
2251,0.2775,29,391,29,167541,508903,8606,117650,4.030723292358383,0.187773420604482
2252,0.2776,1,11,1,167552,508892,8607,117649,4.030636167786086,0.18777542092217428
2253,0.2777,3,38,3,167590,508854,8610,117646,4.030335191990876,0.1877829209896249
2254,0.2778,0,5,0,167595,508849,8610,117646,4.0302955899125585,0.18778441966815376
2255,0.2779,1,19,1,167614,508830,8611,117645,4.030145102014954,0.1877888183886029
2256,0.278,13,94,13,167708,508736,8624,117632,4.029400582942593,0.18780014304689896
2257,0.2781,0,6,0,167714,508730,8624,117632,4.029353060448613,0.18780194200797623
2258,0.2782,0,21,0,167735,508709,8624,117632,4.029186731719681,0.18780823864316723
2259,0.2783,33,358,33,168093,508351,8657,117599,4.0263512229121785,0.18787283329339405
2260,0.2785,5,33,5,168126,508318,8662,117594,4.0260898491952855,0.18787625097457789
2261,0.2786,0,5,0,168131,508313,8662,117594,4.026050247116968,0.18787775180657829
2262,0.2787,4,41,4,168172,508272,8666,117590,4.025725510074769,0.18788486918841535
2263,0.2788,3,14,3,168186,508258,8669,117587,4.025614624255481,0.18788517923767067
2264,0.2789,3,8,3,168194,508250,8672,117584,4.025551260930174,0.18788368800672384
2265,0.279,5,102,5,168296,508148,8677,117579,4.024743378532506,0.18790782561724204
2266,0.2791,1,7,1,168303,508141,8678,117578,4.024687935622861,0.18790862991214907
2267,0.2792,19,134,19,168437,508007,8697,117559,4.023626599923964,0.1879242158301442
2268,0.2793,4,54,4,168491,507953,8701,117555,4.02319889747814,0.18793524623186275
2269,0.2794,0,8,0,168499,507945,8701,117555,4.023135534152832,0.18793764988009592
2270,0.2795,3,18,3,168517,507927,8704,117552,4.022992966670891,0.18793916342515096
2271,0.2796,1,10,1,168527,507917,8705,117551,4.022913762514257,0.18794086987663638
2272,0.2797,3,34,3,168561,507883,8708,117548,4.022644468381701,0.18794719161666115
2273,0.2798,0,18,0,168579,507865,8708,117548,4.022501900899759,0.1879526009213112
2274,0.2799,0,4,0,168583,507861,8708,117548,4.022470219237105,0.18795380303129633
2275,0.28,314,5027,314,173610,502834,9022,117234,3.9826542896971233,0.18906636046369107
2276,0.2801,1,4,1,173614,502830,9023,117233,3.9826226080344695,0.18906627229813744
2277,0.2802,1,20,1,173634,502810,9024,117232,3.9824641997212016,0.1890710629279952
2278,0.2803,5,30,5,173664,502780,9029,117227,3.982226587251299,0.18907367174886736
2279,0.2804,1,9,1,173673,502771,9030,117226,3.982155303510328,0.189075108427944
2280,0.2805,2,26,2,173699,502745,9032,117224,3.9819493727030792,0.18908042176302364
2281,0.2806,0,14,0,173713,502731,9032,117224,3.9818384868837917,0.18908469163084418
2282,0.2807,2,57,2,173770,502674,9034,117222,3.981387023190977,0.18909946184521276
2283,0.2808,12,139,12,173909,502535,9046,117210,3.9802860854137627,0.1891261728614188
2284,0.2809,0,2,0,173911,502533,9046,117210,3.9802702445824356,0.1891267831988421
2285,0.281,10,70,10,173981,502463,9056,117200,3.9797158154859966,0.18913506212247624
2286,0.2811,0,9,0,173990,502454,9056,117200,3.979644531745026,0.1891378091644692
2287,0.2812,1,22,1,174012,502432,9057,117199,3.9794702826004307,0.18914321588171024
2288,0.2813,6,23,6,174035,502409,9063,117193,3.9792881130401723,0.18914238495033908
2289,0.2814,2,8,2,174043,502401,9065,117191,3.979224749714865,0.1891422097121977
2290,0.2815,5,25,5,174068,502376,9070,117186,3.9790267393232797,0.18914329800730192
2291,0.2816,0,4,0,174072,502372,9070,117186,3.978995057660626,0.18914451915720562
2292,0.2817,35,386,35,174458,501986,9105,117151,3.9759377772145483,0.1892166031104586
2293,0.2818,1,14,1,174472,501972,9106,117150,3.9758268913952604,0.1892195722329363
2294,0.2819,0,6,0,174478,501966,9106,117150,3.97577936890128,0.18922140600469056
2295,0.282,7,86,7,174564,501880,9113,117143,3.9750982131542263,0.18923852587060577
2296,0.2821,1,14,1,174578,501866,9114,117142,3.9749873273349388,0.18924149607113316
2297,0.2822,1,11,1,174589,501855,9115,117141,3.9749002027626408,0.1892435492313359
2298,0.2823,2,31,2,174620,501824,9117,117139,3.9746546698770753,0.18925040753647634
2299,0.2824,0,3,0,174623,501821,9117,117139,3.974630908630085,0.18925132480289517
2300,0.2825,21,359,21,174982,501462,9138,117118,3.9717874794069195,0.18933363509974457
2301,0.2826,0,9,0,174991,501453,9138,117118,3.9717161956659486,0.18933638984045487
2302,0.2827,2,44,2,175035,501409,9140,117116,3.9713676973767584,0.18934723737924902
2303,0.2828,2,12,2,175047,501397,9142,117114,3.9712726523887976,0.18934828968280273
2304,0.2829,1,23,1,175070,501374,9143,117113,3.9710904828285387,0.1893540203755293
2305,0.283,8,46,8,175116,501328,9151,117105,3.970726143708022,0.18935761836771323
2306,0.2831,0,5,0,175121,501323,9151,117105,3.970686541629705,0.18935914932700332
2307,0.2832,3,19,3,175140,501304,9154,117102,3.9705360537320997,0.18936103466007767
2308,0.2833,45,843,45,175983,500461,9199,117057,3.963859143327842,0.18956046625361528
2309,0.2834,0,3,0,175986,500458,9199,117057,3.9638353820808514,0.18956138717278123
2310,0.2835,3,20,3,176006,500438,9202,117054,3.9636769737675834,0.18956358948779903
2311,0.2836,0,9,0,176015,500429,9202,117054,3.9636056900266126,0.18956635243399414
2312,0.2837,6,43,6,176058,500386,9208,117048,3.9632651121530857,0.18957167891628904
2313,0.2838,1,27,1,176085,500359,9209,117047,3.9630512609301736,0.18957865650803524
2314,0.2839,0,6,0,176091,500353,9209,117047,3.963003738436193,0.18958049886621314
2315,0.284,7,168,7,176259,500185,9216,117040,3.9616731086047396,0.18962290898780834
2316,0.2841,0,1,0,176260,500184,9216,117040,3.9616651881890763,0.189623216206758
2317,0.2842,11,133,11,176393,500051,9227,117029,3.960611772905842,0.18964964024113568
2318,0.2843,4,48,4,176441,500003,9231,117025,3.960231592953998,0.18965914026591987
2319,0.2844,0,4,0,176445,499999,9231,117025,3.9601999112913444,0.18966036977491962
2320,0.2845,1,29,1,176474,499970,9232,117024,3.9599702192371056,0.18966797083926262
2321,0.2846,0,8,0,176482,499962,9232,117024,3.959906855911798,0.18967043012321186
2322,0.2847,4,40,4,176522,499922,9236,117020,3.9595900392852617,0.18967747373334934
2323,0.2848,3,12,3,176534,499910,9239,117017,3.959494994297301,0.1896772227508279
2324,0.2849,0,5,0,176539,499905,9239,117017,3.9594553922189837,0.18967876003773573
2325,0.285,102,1538,102,178077,498367,9341,116915,3.947273792928653,0.1900185605949792
2326,0.2851,1,7,1,178084,498360,9342,116914,3.947218350019009,0.1900194059882264
2327,0.2852,4,22,4,178106,498338,9346,116910,3.9470441008744137,0.19002093464749173
2328,0.2853,2,26,2,178132,498312,9348,116908,3.9468381700671653,0.19002633204382172
2329,0.2854,1,17,1,178149,498295,9349,116907,3.946703523000887,0.19003026648157842
2330,0.2855,2,18,2,178167,498277,9351,116905,3.9465609555189456,0.1900331934289365
2331,0.2856,1,12,1,178179,498265,9352,116904,3.9464659105309847,0.19003558371764506
2332,0.2857,6,61,6,178240,498204,9358,116898,3.9459827651755166,0.1900465288683828
2333,0.2858,19,108,19,178348,498096,9377,116879,3.945127360283868,0.19005488027968617
2334,0.286,15,149,15,178497,497947,9392,116864,3.943947218350019,0.19008117941936628
2335,0.2861,0,5,0,178502,497942,9392,116864,3.943907616271702,0.19008272528244682
2336,0.2862,4,25,4,178527,497917,9396,116860,3.9437096058801164,0.19008518535989471
2337,0.2863,3,22,3,178549,497895,9399,116857,3.9435353567355214,0.1900880355004945
2338,0.2864,2,11,2,178560,497884,9401,116855,3.943448232163224,0.19008880191430835
2339,0.2865,1,30,1,178590,497854,9402,116854,3.9432106196933217,0.19009676138914736
2340,0.2866,1,6,1,178596,497848,9403,116853,3.943163097199341,0.19009729933740144
2341,0.2867,35,727,35,179323,497121,9438,116818,3.937404955012039,0.19027623265503577
2342,0.2868,7,21,7,179344,497100,9445,116811,3.9372386262831074,0.1902735087007726
2343,0.2869,0,8,0,179352,497092,9445,116811,3.9371752629578,0.190275988226153
2344,0.287,5,55,5,179407,497037,9450,116806,3.936739640096312,0.19028644132131506
2345,0.2871,0,24,0,179431,497013,9450,116806,3.9365495501203904,0.19029388142107037
2346,0.2872,1,16,1,179447,496997,9451,116805,3.936422823469776,0.19029752265388514
2347,0.2873,4,34,4,179481,496963,9455,116801,3.9361535293372194,0.19030278739059311
2348,0.2874,0,7,0,179488,496956,9455,116801,3.9360980864275756,0.19030495782532827
2349,0.2875,37,388,37,179876,496568,9492,116764,3.933024965150171,0.19037650081848004
2350,0.2876,2,11,2,179887,496557,9494,116762,3.9329378405778734,0.19037727512110336
2351,0.2877,1,38,1,179925,496519,9495,116761,3.9326368647826637,0.19038775110879208
2352,0.2878,0,29,0,179954,496490,9495,116761,3.932407172728425,0.19039675434691505
2353,0.2879,3,10,3,179964,496480,9498,116758,3.9323279685717907,0.1903958984929179
2354,0.288,5,85,5,180049,496395,9503,116753,3.9316547332404004,0.19041569082831553
2355,0.2881,1,7,1,180056,496388,9504,116752,3.9315992903307566,0.1904165443455002
2356,0.2882,2,15,2,180071,496373,9506,116750,3.9314804840958053,0.19041856201773544
2357,0.2883,28,412,28,180483,495961,9534,116722,3.928217272842479,0.1905096110060178
2358,0.2884,0,3,0,180486,495958,9534,116722,3.9281935115954885,0.19051054384017757
2359,0.2885,6,40,6,180526,495918,9540,116716,3.927876694968952,0.19051505466559152
2360,0.2886,1,10,1,180536,495908,9541,116715,3.927797490812318,0.19051684314823308
2361,0.2887,5,37,5,180573,495871,9546,116710,3.9275044354327715,0.19052174324701548
2362,0.2888,0,23,0,180596,495848,9546,116710,3.927322265872513,0.19052889685548144
2363,0.2889,1,5,1,180601,495843,9547,116709,3.927282663794196,0.190529130588097
2364,0.289,6,89,6,180690,495754,9553,116703,3.926577746800152,0.19054888751373567
2365,0.2891,0,1,0,180691,495753,9553,116703,3.9265698263844886,0.1905491986363102
2366,0.2892,8,136,8,180827,495617,9561,116695,3.9254926498542644,0.19058094566168882
2367,0.2893,5,53,5,180880,495564,9566,116690,3.9250728678241034,0.1905908332162795
2368,0.2894,0,7,0,180887,495557,9566,116690,3.9250174249144596,0.19059301229732445
2369,0.2895,5,21,5,180908,495536,9571,116685,3.924851096185528,0.19059293947773762
2370,0.2896,0,6,0,180914,495530,9571,116685,3.9248035736915474,0.19059480737976037
2371,0.2897,1,20,1,180934,495510,9572,116684,3.924645165378279,0.19059971185604563
2372,0.2898,1,26,1,180960,495484,9573,116683,3.92443923457103,0.19060648483175344
2373,0.2899,0,1,0,180961,495483,9573,116683,3.924431314155367,0.1906067961958031
2374,0.29,312,5090,312,186051,490393,9885,116371,3.8841163984285894,0.19178955903778075
2375,0.2901,1,11,1,186062,490382,9886,116370,3.884029273856292,0.19179170402404935
2376,0.2902,1,19,1,186081,490363,9887,116369,3.883878785958687,0.19179637797248208
2377,0.2903,3,21,3,186102,490342,9890,116366,3.8837124572297554,0.19179902028652993
2378,0.2904,0,4,0,186106,490338,9890,116366,3.8836807755671017,0.19180028481763758
2379,0.2905,2,17,2,186123,490321,9892,116364,3.8835461285008237,0.1918029949644379
2380,0.2906,0,4,0,186127,490317,9892,116364,3.88351444683817,0.1918042595696915
2381,0.2907,2,59,2,186186,490258,9894,116362,3.8830471423140285,0.1918202499093337
2382,0.2908,22,136,22,186322,490122,9916,116340,3.8819699657838043,0.19183394837599058
2383,0.2909,0,2,0,186324,490120,9916,116340,3.8819541249524776,0.19183458101111367
2384,0.291,7,79,7,186403,490041,9923,116333,3.8813284121150677,0.19185024423870417
2385,0.2911,0,11,0,186414,490030,9923,116333,3.88124128754277,0.19185372458411876
2386,0.2912,2,24,2,186438,490006,9925,116331,3.8810511975668485,0.19185865286136258
2387,0.2913,2,33,2,186471,489973,9927,116329,3.880789823849956,0.19186642960108988
2388,0.2914,1,9,1,186480,489964,9928,116328,3.880718540108985,0.19186794481866823
2389,0.2915,2,26,2,186506,489938,9930,116326,3.880512609301736,0.19187350725096658
2390,0.2916,2,4,2,186510,489934,9932,116324,3.8804809276390824,0.19187210725466716
2391,0.2917,34,414,34,186924,489520,9966,116290,3.8772018755544293,0.1919578745811393
2392,0.2918,0,15,0,186939,489505,9966,116290,3.877083069319478,0.19196262762155514
2393,0.2919,0,4,0,186943,489501,9966,116290,3.877051387656824,0.19196389513875248
2394,0.292,8,109,8,187052,489392,9974,116282,3.876188062349512,0.19198776899784373
2395,0.2921,0,11,0,187063,489381,9974,116282,3.8761009377772147,0.19199125586340918
2396,0.2922,2,18,2,187081,489363,9976,116280,3.875958370295273,0.19199429366805196
2397,0.2923,2,47,2,187128,489316,9978,116278,3.8755861107590928,0.19200652582423208
2398,0.2924,1,12,1,187140,489304,9979,116277,3.8754910657711314,0.19200899631923724
2399,0.2925,27,369,27,187509,488935,10006,116250,3.872568432391332,0.19209002205937029
2400,0.2926,1,7,1,187516,488928,10007,116249,3.872512989481688,0.19209090894069009
2401,0.2927,5,54,5,187570,488874,10012,116244,3.8720852870358637,0.19210137526895582
2402,0.2928,1,16,1,187586,488858,10013,116243,3.871958560385249,0.19210511964118387
2403,0.2929,4,14,4,187600,488844,10017,116239,3.871847674565961,0.19210422371806843
2404,0.293,4,57,4,187657,488787,10021,116235,3.871396210873147,0.1921169808701171
2405,0.2931,0,4,0,187661,488783,10021,116235,3.871364529210493,0.19211825102724217
2406,0.2932,1,27,1,187688,488756,10022,116234,3.871150677987581,0.19212548967751533
2407,0.2933,64,790,64,188478,487966,10086,116170,3.8648935496134835,0.19229113974336903
2408,0.2934,0,2,0,188480,487964,10086,116170,3.864877708782157,0.19229177632776834
2409,0.2935,4,37,4,188517,487927,10090,116166,3.8645846534026105,0.19229820573984469
2410,0.2936,1,4,1,188521,487923,10091,116165,3.8645529717399567,0.19229814199255738
2411,0.2937,2,35,2,188556,487888,10093,116163,3.8642757571917374,0.1923066098723452
2412,0.2938,2,27,2,188583,487861,10095,116161,3.8640619059688253,0.192312531662754
2413,0.2939,0,3,0,188586,487858,10095,116161,3.864038144721835,0.19231348682740113
2414,0.294,12,173,12,188759,487685,10107,116149,3.8626679128120642,0.19235253397456917
2415,0.2941,0,4,0,188763,487681,10107,116149,3.862636231149411,0.19235380819104714
2416,0.2942,6,139,6,188902,487542,10113,116143,3.8615352933721963,0.1923900709807267
2417,0.2943,7,47,7,188949,487495,10120,116136,3.8611630338360157,0.19239568544359054
2418,0.2944,0,3,0,188952,487492,10120,116136,3.8611392725890257,0.1923966416402155
2419,0.2945,1,31,1,188983,487461,10121,116135,3.8608937397034597,0.19240518492501607
2420,0.2946,1,9,1,188992,487452,10122,116134,3.860822455962489,0.19240671586153424
2421,0.2947,2,31,2,189023,487421,10124,116132,3.860576923076923,0.1924139222238975
2422,0.2948,1,21,1,189044,487400,10125,116131,3.860410594347991,0.1924192792085245
2423,0.2949,0,6,0,189050,487394,10125,116131,3.8603630718540107,0.19242119216271075
2424,0.295,112,1533,112,190583,485861,10237,116019,3.848221074641997,0.19276101548481425
2425,0.2951,0,7,0,190590,485854,10237,116019,3.8481656317323534,0.19276325736492583
2426,0.2952,0,24,0,190614,485830,10237,116019,3.847975541756431,0.19277094420693563
2427,0.2953,5,34,5,190648,485796,10242,116014,3.8477062476238753,0.1927751283627723
2428,0.2954,2,11,2,190659,485785,10244,116012,3.8476191230515777,0.19277596930526406
2429,0.2955,0,19,0,190678,485766,10244,116012,3.847468635153973,0.1927820558411906
2430,0.2956,1,7,1,190685,485759,10245,116011,3.847413192244329,0.1927829569436828
2431,0.2957,7,54,7,190739,485705,10252,116004,3.8469854897985045,0.19279086734617565
2432,0.2958,10,119,10,190858,485586,10262,115994,3.8460429603345583,0.19281558562452208
2433,0.2959,1,0,1,190858,485586,10263,115993,3.8460429603345583,0.19281424384827264
2434,0.296,15,163,15,191021,485423,10278,115978,3.844751932581422,0.1928463703918018
2435,0.2961,1,5,1,191026,485418,10279,115977,3.844712330503105,0.19284663158157284
2436,0.2962,1,21,1,191047,485397,10280,115976,3.844546001774173,0.19285202361928452
2437,0.2963,0,21,0,191068,485376,10280,115976,3.8443796730452413,0.1928587582647102
2438,0.2964,2,9,2,191077,485367,10282,115974,3.844308389304271,0.1928589602238996
2439,0.2965,2,23,2,191100,485344,10284,115972,3.844126219744012,0.19286365238909325
2440,0.2966,0,3,0,191103,485341,10284,115972,3.844102458497022,0.19286461460171325
2441,0.2967,63,796,63,191899,484545,10347,115909,3.8377978076289443,0.193035603060351
2442,0.2968,2,15,2,191914,484530,10349,115907,3.837679001393993,0.19303773751451025
2443,0.2969,0,7,0,191921,484523,10349,115907,3.837623558484349,0.19303998800859384
2444,0.297,5,75,5,191996,484448,10354,115902,3.837029527309593,0.19305738319313734
2445,0.2971,2,18,2,192014,484430,10356,115900,3.836886959827652,0.19306048340079623
2446,0.2972,2,15,2,192029,484415,10358,115898,3.8367681535927005,0.19306261900042146
2447,0.2973,3,55,3,192084,484360,10361,115895,3.836332530731213,0.19307627591606902
2448,0.2974,1,9,1,192093,484351,10362,115894,3.836261246990242,0.19307782655415706
2449,0.2975,27,372,27,192465,483979,10389,115867,3.833314852363452,0.193161244719478
2450,0.2976,3,8,3,192473,483971,10392,115864,3.833251489038145,0.1931597856077088
2451,0.2977,6,43,6,192516,483928,10398,115858,3.832910911164618,0.19316556238391694
2452,0.2978,3,10,3,192526,483918,10401,115855,3.832831707007984,0.1931647473294063
2453,0.2979,0,8,0,192534,483910,10401,115855,3.8327683436826763,0.19316732386851518
2454,0.298,8,86,8,192620,483824,10409,115847,3.8320871879356226,0.1931842627040494
2455,0.2981,0,7,0,192627,483817,10409,115847,3.832031745025979,0.193186517783292
2456,0.2982,2,24,2,192651,483793,10411,115845,3.831841655050057,0.19319155890720735
2457,0.2983,29,402,29,193053,483391,10440,115816,3.8286576479533645,0.193282121203524
2458,0.2984,1,3,1,193056,483388,10441,115815,3.8286338867063745,0.19328174258139563
2459,0.2985,3,37,3,193093,483351,10444,115812,3.828340831326828,0.1932896390464698
2460,0.2986,0,11,0,193104,483340,10444,115812,3.8282537067545306,0.19329318770529014
2461,0.2987,6,38,6,193142,483302,10450,115806,3.827952730959321,0.19329736875488226
2462,0.2988,4,25,4,193167,483277,10454,115802,3.8277547205677354,0.19330004890840774
2463,0.2989,0,11,0,193178,483266,10454,115802,3.827667595995438,0.19330359825595758
2464,0.299,10,83,10,193261,483183,10464,115792,3.8270102014953746,0.19331691639884804
2465,0.2991,0,5,0,193266,483178,10464,115792,3.8269705994170575,0.19331853014341285
2466,0.2992,11,137,11,193403,483041,10475,115781,3.8258855024711695,0.19334793978845133
2467,0.2993,5,56,5,193459,482985,10480,115776,3.8254419591940185,0.1933592869275053
2468,0.2994,0,6,0,193465,482979,10480,115776,3.825394436700038,0.19336122454092242
2469,0.2995,1,23,1,193488,482956,10481,115775,3.8252122671397797,0.19336730518379708
2470,0.2996,2,5,2,193493,482951,10483,115773,3.8251726650614626,0.19336622550624327
2471,0.2997,1,28,1,193521,482923,10484,115772,3.8249508934228866,0.19337392161284125
2472,0.2998,4,29,4,193550,482894,10488,115768,3.824721201368648,0.19337789938228916
2473,0.2999,0,4,0,193554,482890,10488,115768,3.824689519705994,0.19337919145822824
2474,0.3,335,5152,335,198706,477738,10823,115433,3.783883538208085,0.19460324257254655
2475,0.3001,0,8,0,198714,477730,10823,115433,3.783820174882778,0.19460586718996295
2476,0.3002,1,18,1,198732,477712,10824,115432,3.7836776074008363,0.19461041500883428
2477,0.3003,3,41,3,198773,477671,10827,115429,3.7833528703586365,0.19461979430112966
2478,0.3004,2,10,2,198783,477661,10829,115427,3.7832736662020023,0.19462035987914103
2479,0.3005,4,26,4,198809,477635,10833,115423,3.7830677353947535,0.19462346010002393
2480,0.3006,1,8,1,198817,477627,10834,115422,3.7830043720694464,0.19462472746771345
2481,0.3007,9,68,9,198885,477559,10843,115413,3.782465783804334,0.19463482255485925
2482,0.3008,11,159,11,199044,477400,10854,115402,3.781206437713851,0.19467208275275724
2483,0.3009,1,1,1,199045,477399,10855,115401,3.7811985172981877,0.19467105263157894
2484,0.301,6,79,6,199124,477320,10861,115395,3.7805728044607783,0.19468884708502399
2485,0.3011,0,6,0,199130,477314,10861,115395,3.780525281966798,0.19469081792245435
2486,0.3012,0,20,0,199150,477294,10861,115395,3.7803668736535294,0.19469738766874364
2487,0.3013,3,35,3,199185,477259,10864,115392,3.7800896591053097,0.1947048094072228
2488,0.3014,1,13,1,199198,477246,10865,115391,3.7799866937016855,0.19470772159011335
2489,0.3015,2,32,2,199230,477214,10867,115389,3.779733240400456,0.19471551780871849
2490,0.3016,0,1,0,199231,477213,10867,115389,3.779725319984793,0.1947158463859386
2491,0.3017,40,432,40,199663,476781,10907,115349,3.776303700418198,0.194803505986861
2492,0.3018,2,18,2,199681,476763,10909,115347,3.7761611329362563,0.19480670821300097
2493,0.3019,0,5,0,199686,476758,10909,115347,3.7761215308579392,0.194808353248157
2494,0.302,11,103,11,199789,476655,10920,115336,3.7753057280446076,0.1948272862256352
2495,0.3021,0,13,0,199802,476642,10920,115336,3.7752027626409834,0.19483156468652552
2496,0.3022,0,21,0,199823,476621,10920,115336,3.7750364339120517,0.1948384764433903
2497,0.3023,4,56,4,199879,476565,10924,115332,3.7745928906349007,0.1948514690900613
2498,0.3024,1,5,1,199884,476560,10925,115331,3.7745532885565836,0.19485175479944788
2499,0.3025,58,386,58,200270,476174,10983,115273,3.7714960081105056,0.19489996567739798
2500,0.3026,1,3,1,200273,476171,10984,115272,3.7714722468635156,0.1948995930292522
2501,0.3027,1,31,1,200304,476140,10985,115271,3.7712267139779496,0.19490844776306157
2502,0.3028,2,10,2,200314,476130,10987,115269,3.7711475098213154,0.1949090208133595
2503,0.3029,1,15,1,200329,476115,10988,115268,3.771028703586364,0.19491260316918138
2504,0.303,6,58,6,200387,476057,10994,115262,3.770569319477886,0.19492355226197705
2505,0.3031,0,7,0,200394,476050,10994,115262,3.770513876568242,0.19492585978299104
2506,0.3032,2,24,2,200418,476026,10996,115260,3.7703237865923205,0.1949310485957726
2507,0.3033,69,797,69,201215,475229,11065,115191,3.7640112153085794,0.19510009823515465
2508,0.3034,0,4,0,201219,475225,11065,115191,3.7639795336459256,0.19510142001571773
2509,0.3035,1,48,1,201267,475177,11066,115190,3.7635993536940817,0.19511591941961526
2510,0.3036,1,8,1,201275,475169,11067,115189,3.7635359903687746,0.19511720007182082
2511,0.3037,5,30,5,201305,475139,11072,115184,3.763298377898872,0.1951202985484218
2512,0.3038,1,34,1,201339,475105,11073,115183,3.763029083766316,0.19513017374569702
2513,0.3039,1,3,1,201342,475102,11074,115182,3.7630053225193256,0.19512980192585264
2514,0.304,7,163,7,201505,474939,11081,115175,3.7617142947661892,0.19517415279081668
2515,0.3041,0,2,0,201507,474937,11081,115175,3.7616984539348626,0.19517481427254488
2516,0.3042,15,162,15,201669,474775,11096,115160,3.7604153465973895,0.19520794663818894
2517,0.3043,8,45,8,201714,474730,11104,115152,3.7600589278925356,0.19521192374068033
2518,0.3044,0,7,0,201721,474723,11104,115152,3.760003484982892,0.1952142403051494
2519,0.3045,5,32,5,201753,474691,11109,115147,3.7597500316816626,0.19521800901264416
2520,0.3046,1,8,1,201761,474683,11110,115146,3.7596866683563555,0.19521929237117877
2521,0.3047,0,39,0,201800,474644,11110,115146,3.7593777721454824,0.1952322012919853
2522,0.3048,1,19,1,201819,474625,11111,115145,3.7592272842478773,0.19523712633738577
2523,0.3049,0,6,0,201825,474619,11111,115145,3.759179761753897,0.19523911259419022
2524,0.305,154,1602,154,203427,473017,11265,114991,3.7464912558611076,0.19556026448619745
2525,0.3051,1,7,1,203434,473010,11266,114990,3.746435812951464,0.19556122448979593
2526,0.3052,0,15,0,203449,472995,11266,114990,3.7463170067165126,0.19556621342381184
2527,0.3053,3,57,3,203506,472938,11269,114987,3.745865543023698,0.19558106901390485
2528,0.3054,1,3,1,203509,472935,11270,114986,3.745841781776708,0.1955806987673514
2529,0.3055,5,23,5,203532,472912,11275,114981,3.745659612216449,0.19558150888001727
2530,0.3056,1,8,1,203540,472904,11276,114980,3.745596248891142,0.19558280204938389
2531,0.3057,2,58,2,203598,472846,11278,114978,3.7451368647826637,0.1955993630746618
2532,0.3058,13,122,13,203720,472724,11291,114965,3.7441705740717275,0.19562217431328474
2533,0.3059,0,7,0,203727,472717,11291,114965,3.7441151311620833,0.19562450440884696
2534,0.306,11,146,11,203873,472571,11302,114954,3.742958750475225,0.19565805710395304
2535,0.3061,1,11,1,203884,472560,11303,114953,3.7428716259029273,0.19566035134541704
2536,0.3062,3,33,3,203917,472527,11306,114950,3.7426102521860347,0.19566723463216432
2537,0.3063,4,18,4,203935,472509,11310,114946,3.7424676847040934,0.19566775327471891
2538,0.3064,0,16,0,203951,472493,11310,114946,3.7423409580534788,0.195673082651986
2539,0.3065,3,33,3,203984,472460,11313,114943,3.742079584336586,0.19567996758613762
2540,0.3066,2,2,2,203986,472458,11315,114941,3.742063743505259,0.1956778952636964
2541,0.3067,61,844,61,204830,471614,11376,114880,3.735378912685338,0.1958758316368113
2542,0.3068,1,16,1,204846,471598,11377,114879,3.735252186034723,0.19587980432310217
2543,0.3069,0,8,0,204854,471590,11377,114879,3.7351888227094157,0.1958824763116209
2544,0.307,7,54,7,204908,471536,11384,114872,3.7347611202635913,0.19589091554003357
2545,0.3071,3,18,3,204926,471518,11387,114869,3.73461855278165,0.19589281481342527
2546,0.3072,2,23,2,204949,471495,11389,114867,3.7344363832213916,0.19589775599373765
2547,0.3073,10,57,10,205006,471438,11399,114857,3.733984919528577,0.19590308633026035
2548,0.3074,0,9,0,205015,471429,11399,114857,3.733913635787606,0.1959060936130148
2549,0.3075,40,419,40,205434,471010,11439,114817,3.7305949816246358,0.1959913080141407
2550,0.3076,0,8,0,205442,471002,11439,114817,3.7305316182993282,0.19599398449008995
2551,0.3077,7,36,7,205478,470966,11446,114810,3.7302464833354456,0.19599642184043048
2552,0.3078,1,13,1,205491,470953,11447,114809,3.730143517931821,0.1959993990733438
2553,0.3079,2,21,2,205512,470932,11449,114807,3.7299771892028892,0.1960036808202971
2554,0.308,8,91,8,205603,470841,11457,114799,3.7292564313775185,0.1960231541561369
2555,0.3081,0,6,0,205609,470835,11457,114799,3.729208908883538,0.19602516247349028
2556,0.3082,1,31,1,205640,470804,11458,114798,3.7289633759979726,0.19603416654997763
2557,0.3083,37,417,37,206057,470387,11495,114761,3.7256605626663286,0.196123032121788
2558,0.3084,0,5,0,206062,470382,11495,114761,3.7256209605880115,0.19612470797736622
2559,0.3085,5,30,5,206092,470352,11500,114756,3.7253833481181093,0.19612789433745564
2560,0.3086,3,13,3,206105,470339,11503,114753,3.7252803827144847,0.1961281302769479
2561,0.3087,5,35,5,206140,470304,11508,114748,3.7250031681662654,0.19613299330657788
2562,0.3088,2,26,2,206166,470278,11510,114746,3.7247972373590166,0.19613896182036977
2563,0.3089,3,8,3,206174,470270,11513,114743,3.7247338740337095,0.19613752173028634
2564,0.309,11,85,11,206259,470185,11524,114732,3.724060638702319,0.1961509068808053
2565,0.3091,0,1,0,206260,470184,11524,114732,3.724052718286656,0.1961512422296535
2566,0.3092,16,128,16,206388,470056,11540,114716,3.7230389050817387,0.19617218334667186
2567,0.3093,4,72,4,206460,469984,11544,114712,3.722468635153973,0.19619084105244436
2568,0.3094,0,8,0,206468,469976,11544,114712,3.7224052718286655,0.19619352543578797
2569,0.3095,0,30,0,206498,469946,11544,114712,3.7221676593587634,0.19620359252759734
2570,0.3096,1,8,1,206506,469938,11545,114711,3.722104296033456,0.19620490242863667
2571,0.3097,4,22,4,206528,469916,11549,114707,3.7219300468888608,0.19620678625370538
2572,0.3098,3,30,3,206558,469886,11552,114704,3.721692434418958,0.19621273028960468
2573,0.3099,1,11,1,206569,469875,11553,114703,3.7216053098466606,0.19621504743592813
2574,0.31,409,5113,409,211682,464762,11962,114294,3.6811082245596247,0.19737987344920008
2575,0.3101,0,8,0,211690,464754,11962,114294,3.6810448612343176,0.19738260040618394
2576,0.3102,1,25,1,211715,464729,11963,114293,3.680846850842732,0.19738973648669653
2577,0.3103,3,33,3,211748,464696,11966,114290,3.6805854771258395,0.197396828248006
2578,0.3104,0,15,0,211763,464681,11966,114290,3.680466670890888,0.19740194241162337
2579,0.3105,5,23,5,211786,464658,11971,114285,3.68028450133063,0.1974028531306191
2580,0.3106,0,4,0,211790,464654,11971,114285,3.680252819667976,0.19740421702459154
2581,0.3107,8,76,8,211866,464578,11979,114277,3.6796508680775566,0.1974190427654594
2582,0.3108,13,134,13,212000,464444,11992,114264,3.678589532378659,0.19744672615550501
2583,0.3109,0,5,0,212005,464439,11992,114264,3.678549930300342,0.19744843209729343
2584,0.311,3,104,3,212109,464335,11995,114261,3.677726207071347,0.197479761353345
2585,0.3111,0,7,0,212116,464328,11995,114261,3.6776707641617032,0.19748215054209464
2586,0.3112,0,21,0,212137,464307,11995,114261,3.6775044354327715,0.19748931845522047
2587,0.3113,2,38,2,212175,464269,11997,114259,3.677203459637562,0.19749951601305382
2588,0.3114,0,13,0,212188,464256,11997,114259,3.6771004942339376,0.19750395408934945
2589,0.3115,4,28,4,212216,464228,12001,114255,3.6768787225953616,0.19750796479758265
2590,0.3116,2,8,2,212224,464220,12003,114253,3.6768153592700545,0.19750792171804044
2591,0.3117,57,468,57,212692,463752,12060,114196,3.6731086047395767,0.19758871040301204
2592,0.3118,2,13,2,212705,463739,12062,114194,3.6730056393359525,0.19759037812341568
2593,0.3119,1,5,1,212710,463734,12063,114193,3.6729660372576354,0.19759069917134864
2594,0.312,9,113,9,212823,463621,12072,114184,3.6720710302876696,0.19761684305258695
2595,0.3121,0,11,0,212834,463610,12072,114184,3.671983905715372,0.19762060526762132
2596,0.3122,2,17,2,212851,463593,12074,114182,3.671849258649094,0.1976236424213578
2597,0.3123,2,40,2,212891,463553,12076,114180,3.6715324420225572,0.1976345474466579
2598,0.3124,5,9,5,212900,463544,12081,114175,3.671461158281587,0.1976306820443849
2599,0.3125,40,404,40,213304,463140,12121,114135,3.6682613103535675,0.1977133948291542
2600,0.3126,0,6,0,213310,463134,12121,114135,3.668213787859587,0.19771544981629016
2601,0.3127,3,49,3,213359,463085,12124,114132,3.6678256874920794,0.197728064142255
2602,0.3128,3,22,3,213381,463063,12127,114129,3.6676514383474843,0.19773143078906152
2603,0.3129,3,21,3,213402,463042,12130,114126,3.6674851096185526,0.19773445513264767
2604,0.313,4,52,4,213454,462990,12134,114122,3.6670732480040553,0.19774671121030232
2605,0.3131,0,4,0,213458,462986,12134,114122,3.6670415663414015,0.19774808181484227
2606,0.3132,5,25,5,213483,462961,12139,114117,3.666843555949816,0.1977496976145339
2607,0.3133,70,810,70,214293,462151,12209,114047,3.6604280192624508,0.1979302253739166
2608,0.3134,0,1,0,214294,462150,12209,114047,3.6604200988467874,0.19793056888529445
2609,0.3135,5,33,5,214327,462117,12214,114042,3.660158725129895,0.1979349450412126
2610,0.3136,1,10,1,214337,462107,12215,114041,3.6600795209732606,0.19793698841269952
2611,0.3137,5,43,5,214380,462064,12220,114036,3.659738943099734,0.19794480124978303
2612,0.3138,0,14,0,214394,462050,12220,114036,3.6596280572804463,0.19794961168992128
2613,0.3139,0,4,0,214398,462046,12220,114036,3.6595963756177925,0.19795098614433362
2614,0.314,12,187,12,214585,461859,12232,114024,3.658115257888734,0.1979985517891655
2615,0.3141,0,4,0,214589,461855,12232,114024,3.65808357622608,0.19799992706801256
2616,0.3142,16,131,16,214720,461724,12248,114008,3.657046001774173,0.1980226911132263
2617,0.3143,4,59,4,214779,461665,12252,114004,3.6565786972500316,0.1980374138610903
2618,0.3144,0,2,0,214781,461663,12252,114004,3.656562856418705,0.19803810188876556
2619,0.3145,5,29,5,214810,461634,12257,113999,3.6563331643644656,0.19804111300081823
2620,0.3146,3,6,3,214816,461628,12260,113996,3.656285641870485,0.19803899767904048
2621,0.3147,4,39,4,214855,461589,12264,113992,3.655976745659612,0.19804684310288212
2622,0.3148,1,23,1,214878,461566,12265,113991,3.6557945760993538,0.1980533639587391
2623,0.3149,1,6,1,214884,461560,12266,113990,3.6557470536053733,0.19805403527061072
2624,0.315,148,1619,148,216503,459941,12414,113842,3.642923900646306,0.19840601760595905
2625,0.3151,1,5,1,216508,459936,12415,113841,3.642884298567989,0.19840634950512132
2626,0.3152,0,19,0,216527,459917,12415,113841,3.642733810670384,0.1984129197327096
2627,0.3153,2,53,2,216580,459864,12417,113839,3.642314028640223,0.19842845514142335
2628,0.3154,1,7,1,216587,459857,12418,113838,3.642258585730579,0.19842947907860448
2629,0.3155,2,14,2,216601,459843,12420,113836,3.642147699911291,0.1984315270386401
2630,0.3156,1,9,1,216610,459834,12421,113835,3.6420764161703207,0.19843324286304473
2631,0.3157,3,53,3,216663,459781,12424,113832,3.6416566341401597,0.19844738525800495
2632,0.3158,15,146,15,216809,459635,12439,113817,3.6405002534533013,0.19847694314432593
2633,0.3159,0,3,0,216812,459632,12439,113817,3.640476492206311,0.19847798147699272
2634,0.316,12,170,12,216982,459462,12451,113805,3.6391300215435307,0.19852006133267744
2635,0.3161,0,3,0,216985,459459,12451,113805,3.6391062602965403,0.19852110022607386
2636,0.3162,1,28,1,217013,459431,12452,113804,3.6388844886579648,0.1985293989376085
2637,0.3163,5,32,5,217045,459399,12457,113799,3.6386310353567355,0.19853349104497922
2638,0.3164,0,11,0,217056,459388,12457,113799,3.638543910784438,0.1985373010902201
2639,0.3165,2,35,2,217091,459353,12459,113797,3.6382666962362187,0.19854662828229958
2640,0.3166,2,3,2,217094,459350,12461,113795,3.6382429349892282,0.19854487084420172
2641,0.3167,85,831,85,217925,458519,12546,113710,3.631661069572931,0.19871415115277274
2642,0.3168,2,17,2,217942,458502,12548,113708,3.6315264225066533,0.19871725415494312
2643,0.3169,0,4,0,217946,458498,12548,113708,3.6314947408439995,0.19871864328580965
2644,0.317,10,76,10,218022,458422,12558,113698,3.63089278925358,0.198731035447109
2645,0.3171,2,18,2,218040,458404,12560,113696,3.6307502217716388,0.19873448697780108
2646,0.3172,3,10,3,218050,458394,12563,113693,3.6306710176150045,0.1987337590261621
2647,0.3173,5,63,5,218113,458331,12568,113688,3.6301720314282093,0.19874864296465677
2648,0.3174,2,8,2,218121,458323,12570,113686,3.6301086681029022,0.19874862108812974
2649,0.3175,47,417,47,218538,457906,12617,113639,3.6268058547712583,0.19882773884820967
2650,0.3176,0,8,0,218546,457898,12617,113639,3.626742491445951,0.19883052190846787
2651,0.3177,1,33,1,218579,457865,12618,113638,3.6264811177290586,0.19884060101171822
2652,0.3178,3,18,3,218597,457847,12621,113635,3.626338550247117,0.19884265821145722
2653,0.3179,3,14,3,218611,457833,12624,113632,3.6262276644278293,0.1988433237381117
2654,0.318,5,106,5,218717,457727,12629,113627,3.6253881003675072,0.19887320295298536
2655,0.3181,2,4,2,218721,457723,12631,113625,3.6253564187048535,0.19887179092252008
2656,0.3182,2,25,2,218746,457698,12633,113623,3.6251584083132684,0.19887768872490247
2657,0.3183,37,460,37,219206,457238,12670,113586,3.6215150171080976,0.19898602721679537
2658,0.3184,1,1,1,219207,457237,12671,113585,3.6215070966924343,0.1989849725483601
2659,0.3185,2,31,2,219238,457206,12673,113583,3.6212615638068684,0.19899297288490142
2660,0.3186,2,17,2,219255,457189,12675,113581,3.6211269167405904,0.19899609299717924
2661,0.3187,7,46,7,219301,457143,12682,113574,3.6207625776200736,0.19900230762356824
2662,0.3188,1,24,1,219325,457119,12683,113573,3.6205724876441514,0.1990092729528362
2663,0.3189,3,13,3,219338,457106,12686,113570,3.620469522240527,0.19900959563745452
2664,0.319,12,83,12,219421,457023,12698,113558,3.619812127740464,0.19902169893494526
2665,0.3191,0,1,0,219422,457022,12698,113558,3.6198042073248002,0.19902204774089524
2666,0.3192,12,135,12,219557,456887,12710,113546,3.6187349512102394,0.19905229886770226
2667,0.3193,9,64,9,219621,456823,12719,113537,3.618228044607781,0.19906199593239357
2668,0.3194,1,3,1,219624,456820,12720,113536,3.618204283360791,0.19906163869583207
2669,0.3195,3,29,3,219653,456791,12723,113533,3.617974591306552,0.19906754756945175
2670,0.3196,1,6,1,219659,456785,12724,113532,3.617927068812571,0.19906823748897542
2671,0.3197,1,20,1,219679,456765,12725,113531,3.617768660499303,0.19907381429994248
2672,0.3198,3,22,3,219701,456743,12728,113528,3.617594411354708,0.1990772808015838
2673,0.3199,0,4,0,219705,456739,12728,113528,3.6175627296920543,0.19907867718103975
2674,0.32,407,5152,407,224857,451587,13135,113121,3.5767567481941454,0.20031768630867633
2675,0.3201,1,0,1,224857,451587,13136,113120,3.5767567481941454,0.20031627020738188
2676,0.3202,1,21,1,224878,451566,13137,113119,3.5765904194652136,0.20032230358518466
2677,0.3203,2,27,2,224905,451539,13139,113117,3.5763765682423014,0.20032904989940778
2678,0.3204,1,7,1,224912,451532,13140,113116,3.5763211253326577,0.2003301171703433
2679,0.3205,2,28,2,224940,451504,13142,113114,3.5760993536940817,0.20033721914639632
2680,0.3206,0,4,0,224944,451500,13142,113114,3.5760676720314284,0.2003386384326283
2681,0.3207,12,68,12,225012,451432,13154,113102,3.575529083766316,0.20034577191099207
2682,0.3208,13,142,13,225154,451290,13167,113089,3.5744043847421114,0.20037776033481047
2683,0.321,9,73,9,225227,451217,13176,113080,3.573826194398682,0.20039092889028295
2684,0.3211,1,3,1,225230,451214,13177,113079,3.573802433151692,0.20039057723558507
2685,0.3212,2,21,2,225251,451193,13179,113077,3.5736361044227603,0.20039520087901183
2686,0.3213,5,41,5,225292,451152,13184,113072,3.57331136738056,0.2004026769509982
2687,0.3214,2,14,2,225306,451138,13186,113070,3.573200481561272,0.2004048152454414
2688,0.3215,2,33,2,225339,451105,13188,113068,3.5729391078443795,0.20041370288900745
2689,0.3216,0,4,0,225343,451101,13188,113068,3.572907426181726,0.2004151238370063
2690,0.3217,47,473,47,225816,450628,13235,113021,3.569161069572931,0.2005166335786988
2691,0.3218,1,22,1,225838,450606,13236,113020,3.568986820428336,0.2005230418752861
2692,0.3219,0,8,0,225846,450598,13236,113020,3.5689234571030286,0.20052588810151556
2693,0.322,15,96,15,225942,450502,13251,113005,3.568163097199341,0.20053876881742375
2694,0.3221,2,15,2,225957,450487,13253,113003,3.56804429096439,0.2005412695877478
2695,0.3222,2,20,2,225977,450467,13255,113001,3.5678858826511215,0.200545550057856
2696,0.3223,6,37,6,226014,450430,13261,112995,3.567592827271575,0.20055020632737278
2697,0.3224,1,11,1,226025,450419,13262,112994,3.5675057026992776,0.20055270290177898
2698,0.3225,38,376,38,226401,450043,13300,112956,3.564527626409834,0.20063268318416197
2699,0.3226,0,11,0,226412,450032,13300,112956,3.5644405018375362,0.2006366032668547
2700,0.3227,1,54,1,226466,449978,13301,112955,3.564012799391712,0.20065442956799476
2701,0.3228,0,15,0,226481,449963,13301,112955,3.563893993156761,0.20065977637950821
2702,0.3229,2,13,2,226494,449950,13303,112953,3.5637910277531364,0.2006615704659595
2703,0.323,4,52,4,226546,449898,13307,112949,3.563379166138639,0.20067442839705996
2704,0.3231,1,13,1,226559,449885,13308,112948,3.5632762007350145,0.2006776432796229
2705,0.3232,1,30,1,226589,449855,13309,112947,3.5630385882651123,0.20068692008912548
2706,0.3233,70,867,70,227456,448988,13379,112877,3.5561715878849323,0.20089701262758847
2707,0.3235,2,41,2,227497,448947,13381,112875,3.555846850842732,0.20090882877495006
2708,0.3236,3,16,3,227513,448931,13384,112872,3.5557201241921175,0.20091028349795212
2709,0.3237,1,33,1,227546,448898,13385,112871,3.555458750475225,0.20092066311953846
2710,0.3238,2,19,2,227565,448879,13387,112869,3.5553082625776202,0.20092461388380556
2711,0.3239,0,3,0,227568,448876,13387,112869,3.55528450133063,0.20092568692200197
2712,0.324,18,177,18,227745,448699,13405,112851,3.5538825877582054,0.20096340486154393
2713,0.3241,0,5,0,227750,448694,13405,112851,3.5538429856798883,0.200965194240889
2714,0.3242,12,143,12,227893,448551,13417,112839,3.5527103662400203,0.2009993052957837
2715,0.3243,3,52,3,227945,448499,13420,112836,3.5522985046255227,0.20101365494758033
2716,0.3244,0,9,0,227954,448490,13420,112836,3.5522272208845522,0.20101687789270406
2717,0.3245,2,23,2,227977,448467,13422,112834,3.5520450513242934,0.20102226790973116
2718,0.3246,3,16,3,227993,448451,13425,112831,3.5519183246736787,0.20102372782309072
2719,0.3247,3,36,3,228029,448415,13428,112828,3.551633189709796,0.2010323514057191
2720,0.3248,4,22,4,228051,448393,13432,112824,3.551458940565201,0.20103453744273606
2721,0.3249,1,6,1,228057,448387,13433,112823,3.55141141807122,0.20103526309224712
2722,0.325,134,1633,134,229690,446754,13567,112689,3.5384773792928654,0.20143070875853303
2723,0.3251,0,4,0,229694,446750,13567,112689,3.5384456976302117,0.2014321489921153
2724,0.3252,0,22,0,229716,446728,13567,112689,3.5382714484856166,0.20144007064497504
2725,0.3253,8,42,8,229758,446686,13575,112681,3.537938791027753,0.20144377483834405
2726,0.3254,1,10,1,229768,446676,13576,112680,3.537859586871119,0.2014459485551241
2727,0.3255,1,25,1,229793,446651,13577,112679,3.537661576479534,0.20145352475282927
2728,0.3256,0,8,0,229801,446643,13577,112679,3.5375982131542263,0.2014564061488731
2729,0.3257,7,68,7,229869,446575,13584,112672,3.537059624889114,0.20147090641523335
2730,0.3258,11,132,11,230001,446443,13595,112661,3.5360141300215435,0.2015027615613553
2731,0.3259,0,5,0,230006,446438,13595,112661,3.5359745279432264,0.20150456359249436
2732,0.326,16,154,16,230160,446284,13611,112645,3.534754783931061,0.20153722565835733
2733,0.3261,0,11,0,230171,446273,13611,112645,3.5346676593587634,0.20154119208900054
2734,0.3262,3,36,3,230207,446237,13614,112642,3.5343825243948803,0.20154988825846024
2735,0.3263,2,28,2,230235,446209,13616,112640,3.534160752756305,0.201557129027698
2736,0.3264,1,7,1,230242,446202,13617,112639,3.5341053098466606,0.20155822496917727
2737,0.3265,3,29,3,230271,446173,13620,112636,3.5338756177924218,0.20156439856909963
2738,0.3266,1,4,1,230275,446169,13621,112635,3.533843936129768,0.20156441256683919
2739,0.3267,62,880,62,231155,445289,13683,112573,3.5268739703459637,0.20179363355094987
2740,0.3268,2,35,2,231190,445254,13685,112571,3.5265967557977445,0.20180343297629186
2741,0.3269,1,9,1,231199,445245,13686,112570,3.5265254720567736,0.20180525801565036
2742,0.327,8,70,8,231269,445175,13694,112562,3.5259710429603346,0.2018191369767471
2743,0.3271,3,32,3,231301,445143,13697,112559,3.5257175896591053,0.20182642343043417
2744,0.3272,1,15,1,231316,445128,13698,112558,3.525598783424154,0.20183042070268933
2745,0.3273,9,55,9,231371,445073,13707,112549,3.5251631605626663,0.20183744543794901
2746,0.3274,1,5,1,231376,445068,13708,112548,3.525123558484349,0.2018378238787983
2747,0.3275,39,393,39,231769,444675,13747,112509,3.5220108351286274,0.2019243194348725
2748,0.3276,1,8,1,231777,444667,13748,112508,3.5219474718033204,0.20192578633283978
2749,0.3277,4,42,4,231819,444625,13752,112504,3.521614814345457,0.20193527890309065
2750,0.3278,6,16,6,231835,444609,13758,112498,3.5214880876948422,0.20193248334700514
2751,0.3279,0,16,0,231851,444593,13758,112498,3.5213613610442276,0.2019382829735178
2752,0.328,12,117,12,231968,444476,13770,112486,3.520434672411608,0.2019635091801595
2753,0.3281,0,12,0,231980,444464,13770,112486,3.520339627423647,0.201967860669719
2754,0.3282,2,26,2,232006,444438,13772,112484,3.5201336966163983,0.20197442370744917
2755,0.3283,43,421,43,232427,444017,13815,112441,3.516799201622101,0.20206556469670667
2756,0.3284,1,5,1,232432,444012,13816,112440,3.516759599543784,0.20206594638890685
2757,0.3285,4,28,4,232460,443984,13820,112436,3.5165378279052084,0.2020703784910679
2758,0.3286,1,12,1,232472,443972,13821,112435,3.5164427829172475,0.20207330245665492
2759,0.3287,6,42,6,232514,443930,13827,112429,3.516110125459384,0.202079951973456
2760,0.3288,1,33,1,232547,443897,13828,112428,3.5158487517424915,0.2020905046510583
2761,0.3289,0,9,0,232556,443888,13828,112428,3.5157774680015206,0.2020937740420912
2762,0.329,7,88,7,232644,443800,13835,112421,3.5150804714231403,0.20211570580758367
2763,0.3291,1,1,1,232645,443799,13836,112420,3.515072551007477,0.2021146347032374
2764,0.3292,13,146,13,232791,443653,13849,112407,3.5139161703206185,0.20214904866381325
2765,0.3293,7,62,7,232853,443591,13856,112400,3.5134251045494866,0.2021615457804173
2766,0.3294,2,5,2,232858,443586,13858,112398,3.5133855024711695,0.2021604938271605
2767,0.3295,4,38,4,232896,443548,13862,112394,3.51308452667596,0.20216857154163564
2768,0.3296,1,5,1,232901,443543,13863,112393,3.5130449245976427,0.20216895469982157
2769,0.3297,5,34,5,232935,443509,13868,112388,3.512775630465087,0.20217414377123819
2770,0.3298,3,27,3,232962,443482,13871,112385,3.5125617792421746,0.2021796580836783
2771,0.3299,0,6,0,232968,443476,13871,112385,3.512514256748194,0.2021818404241348
2772,0.33,440,5229,440,238197,438247,14311,111945,3.471098403244202,0.2034653357373426
2773,0.3301,1,6,1,238203,438241,14312,111944,3.4710508807502216,0.20346610685496697
2774,0.3302,1,15,1,238218,438226,14313,111943,3.4709320745152707,0.20347020642747957
2775,0.3303,2,25,2,238243,438201,14315,111941,3.4707340641236852,0.20347655696165717
2776,0.3304,0,8,0,238251,438193,14315,111941,3.4706707007983777,0.2034795158997626
2777,0.3305,1,35,1,238286,438158,14316,111940,3.4703934862501584,0.20349101432835603
2778,0.3306,0,3,0,238289,438155,14316,111940,3.470369725003168,0.2034921240876576
2779,0.3307,3,59,3,238348,438096,14319,111937,3.4699024204790265,0.20350960760536185
2780,0.3308,18,167,18,238515,437929,14337,111919,3.468579711063237,0.20354534344036898
2781,0.3309,0,1,0,238516,437928,14337,111919,3.468571790647573,0.20354571362579044
2782,0.331,6,98,6,238614,437830,14343,111913,3.4677955899125585,0.20357330607211005
2783,0.3311,1,5,1,238619,437825,14344,111912,3.4677559878342414,0.20357370888261114
2784,0.3312,4,24,4,238643,437801,14348,111908,3.4675658978583197,0.2035768015440897
2785,0.3313,3,41,3,238684,437760,14351,111905,3.4672411608161195,0.20358763974420785
2786,0.3314,2,15,2,238699,437745,14353,111903,3.4671223545811682,0.20359029779058596
2787,0.3315,3,32,3,238731,437713,14356,111900,3.466868901279939,0.20359780427318858
2788,0.3316,0,8,0,238739,437705,14356,111900,3.466805537954632,0.2036007678241646
2789,0.3317,60,457,60,239196,437248,14416,111840,3.4631859079964515,0.20368319832158052
2790,0.3318,3,17,3,239213,437231,14419,111837,3.4630512609301736,0.2036851537514479
2791,0.3319,0,5,0,239218,437226,14419,111837,3.4630116588518565,0.20368700859464214
2792,0.332,16,106,16,239324,437120,14435,111821,3.462172094791535,0.20370313020889314
2793,0.3321,4,19,4,239343,437101,14439,111817,3.46202160689393,0.20370437843175118
2794,0.3322,1,19,1,239362,437082,14440,111816,3.4618711189963247,0.2037099789031842
2795,0.3323,3,34,3,239396,437048,14443,111813,3.4616018248637688,0.2037182456031673
2796,0.3324,1,14,1,239410,437034,14444,111812,3.4614909390444812,0.2037219912325133
2797,0.3325,34,382,34,239792,436652,14478,111778,3.458465340261057,0.20381452509891873
2798,0.3326,0,9,0,239801,436643,14478,111778,3.458394056520086,0.20381786984816408
2799,0.3327,5,53,5,239854,436590,14483,111773,3.457974274489925,0.2038303094847756
2800,0.3328,1,23,1,239877,436567,14484,111772,3.4577921049296667,0.20383740715141546
2801,0.3329,0,15,0,239892,436552,14484,111772,3.4576732986947154,0.20384298334561318
2802,0.333,8,56,8,239948,436496,14492,111764,3.4572297554175644,0.20385218691861526
2803,0.3331,1,9,1,239957,436487,14493,111763,3.4571584716765935,0.20385408116735065
2804,0.3332,5,24,5,239981,436463,14498,111758,3.4569683817006718,0.20385574430749642
2805,0.3333,72,888,72,240869,435575,14570,111686,3.44993505259156,0.20408178181891273
2806,0.3334,0,1,0,240870,435574,14570,111686,3.4499271321758966,0.20408215473449548
2807,0.3335,2,30,2,240900,435544,14572,111684,3.449689519705994,0.20409043396902204
2808,0.3336,2,11,2,240911,435533,14574,111682,3.4496023951336965,0.20409162760523744
2809,0.3337,0,29,0,240940,435504,14574,111682,3.4493727030794576,0.20410244414148024
2810,0.3338,2,29,2,240969,435475,14576,111680,3.449143011025219,0.2041103526423043
2811,0.3339,0,8,0,240977,435467,14576,111680,3.4490796476999113,0.20411333700084255
2812,0.334,15,172,15,241149,435295,14591,111665,3.447717336205804,0.2041556969431037
2813,0.3341,0,3,0,241152,435292,14591,111665,3.447693574958814,0.20415681671502514
2814,0.3342,9,146,9,241298,435146,14600,111656,3.4465371942719556,0.20419822897502204
2815,0.3343,9,67,9,241365,435079,14609,111647,3.4460065264225066,0.20421015280048874
2816,0.3344,1,9,1,241374,435070,14610,111646,3.4459352426815357,0.20421205891175676
2817,0.3345,1,35,1,241409,435035,14611,111645,3.4456580281333165,0.2042236774712812
2818,0.3346,1,10,1,241419,435025,14612,111644,3.4455788239766822,0.20422595757213233
2819,0.3347,1,29,1,241448,434996,14613,111643,3.4453491319224434,0.20423533630055668
2820,0.3348,3,30,3,241478,434966,14616,111640,3.445111519452541,0.204242178095374
2821,0.3349,0,4,0,241482,434962,14616,111640,3.445079837789887,0.20424367272713967
2822,0.335,128,1703,128,243185,433259,14744,111512,3.4315913699150933,0.20469518384789204
2823,0.3351,0,6,0,243191,433253,14744,111512,3.431543847421113,0.20469743834497445
2824,0.3352,1,17,1,243208,433236,14745,111511,3.4314092003548344,0.20470236641964068
2825,0.3353,3,40,3,243248,433196,14748,111508,3.431092383728298,0.20471301844671602
2826,0.3354,0,15,0,243263,433181,14748,111508,3.4309735774933467,0.204718655966983
2827,0.3355,1,28,1,243291,433153,14749,111507,3.4307518058547712,0.204727720045533
2828,0.3356,0,13,0,243304,433140,14749,111507,3.430648840451147,0.204732606624107
2829,0.3357,1,64,1,243368,433076,14750,111506,3.4301419338486885,0.20475520674572426
2830,0.3358,16,134,16,243502,432942,14766,111490,3.429080598149791,0.20478223175713403
2831,0.3359,0,2,0,243504,432940,14766,111490,3.4290647573184643,0.20478298403835204
2832,0.336,19,166,19,243670,432774,14785,111471,3.4277499683183374,0.20481768321252378
2833,0.3361,0,5,0,243675,432769,14785,111471,3.4277103662400203,0.2048195648978392
2834,0.3362,2,28,2,243703,432741,14787,111469,3.427488594601445,0.20482718068392716
2835,0.3363,4,19,4,243722,432722,14791,111465,3.4273381067038398,0.20482848726632574
2836,0.3364,0,7,0,243729,432715,14791,111465,3.427282663794196,0.20483112205520232
2837,0.3365,3,48,3,243777,432667,14794,111462,3.426902483842352,0.2048448070218643
2838,0.3367,55,818,55,244595,431849,14849,111407,3.4204235838296793,0.20507274655042926
2839,0.3368,1,18,1,244613,431831,14850,111406,3.420281016347738,0.2050780782605014
2840,0.3369,0,5,0,244618,431826,14850,111406,3.420241414269421,0.20507996583411875
2841,0.337,5,49,5,244667,431777,14855,111401,3.4198533139019136,0.20509114875786574
2842,0.3371,4,18,4,244685,431759,14859,111397,3.4197107464199723,0.2050920914065204
2843,0.3372,3,22,3,244707,431737,14862,111394,3.4195364972753772,0.20509600814536455
2844,0.3373,6,70,6,244777,431667,14868,111388,3.4189820681789382,0.20511366252037086
2845,0.3374,1,5,1,244782,431662,14869,111387,3.418942466100621,0.2051140873107215
2846,0.3375,46,440,46,245222,431222,14915,111341,3.415457483208719,0.20521303516826617
2847,0.3376,0,7,0,245229,431215,14915,111341,3.415402040299075,0.20521568280509292
2848,0.3377,4,35,4,245264,431180,14919,111337,3.4151248257508553,0.20522306213445846
2849,0.3378,1,27,1,245291,431153,14920,111336,3.414910974527943,0.2052318111519312
2850,0.3379,0,16,0,245307,431137,14920,111336,3.4147842478773285,0.2052378643729734
2851,0.338,10,102,10,245409,431035,14930,111326,3.41397636547966,0.20526180901650376
2852,0.3381,0,8,0,245417,431027,14930,111326,3.413913002154353,0.20526483673917173
2853,0.3382,5,20,5,245437,431007,14935,111321,3.4137545938410847,0.20526507943532327
2854,0.3383,49,474,49,245911,430533,14984,111272,3.4100003168166264,0.20537278172036064
2855,0.3384,1,1,1,245912,430532,14985,111271,3.409992396400963,0.2053716941397519
2856,0.3385,5,41,5,245953,430491,14990,111266,3.4096676593587634,0.20537990279774881
2857,0.3386,0,8,0,245961,430483,14990,111266,3.409604296033456,0.20538293563993656
2858,0.3387,2,33,2,245994,430450,14992,111264,3.409342922316563,0.20539251339267584
2859,0.3388,2,12,2,246006,430438,14994,111262,3.4092478773286023,0.2053941295920251
2860,0.3389,0,5,0,246011,430433,14994,111262,3.4092082752502852,0.20539602543866936
2861,0.339,13,108,13,246119,430325,15007,111249,3.4083528703586365,0.20541791149501268
2862,0.3391,1,4,1,246123,430321,15008,111248,3.4083211886959828,0.2054179615155225
2863,0.3392,13,141,13,246264,430180,15021,111235,3.4072044100874415,0.2054523794132043
2864,0.3393,4,54,4,246318,430126,15025,111231,3.406776707641617,0.20546700236627585
2865,0.3394,1,7,1,246325,430119,15026,111230,3.4067212647319733,0.20546819149938395
2866,0.3395,4,32,4,246357,430087,15030,111226,3.406467811430744,0.2054744667133433
2867,0.3396,2,10,2,246367,430077,15032,111224,3.40638860727411,0.20547532703615917
2868,0.3397,4,27,4,246394,430050,15036,111220,3.4061747560511977,0.20547970513791639
2869,0.3398,2,27,2,246421,430023,15038,111218,3.4059609048282855,0.20548701964559227
2870,0.3399,2,6,2,246427,430017,15040,111216,3.405913382334305,0.2054863616963489
2871,0.34,435,5117,435,251544,424900,15475,110781,3.3653846153846154,0.2068040494249376
2872,0.3401,3,10,3,251554,424890,15478,110778,3.365305411227981,0.2068034678196196
2873,0.3402,2,28,2,251582,424862,15480,110776,3.3650836395894057,0.20681131659815025
2874,0.3403,1,40,1,251622,424822,15481,110775,3.364766822962869,0.2068252809481756
2875,0.3404,2,8,2,251630,424814,15483,110773,3.364703459637562,0.20682540838369864
2876,0.3405,0,35,0,251665,424779,15483,110773,3.364426245089342,0.20683892507170173
2877,0.3406,2,3,2,251668,424776,15485,110771,3.364402483842352,0.20683712167186075
2878,0.3407,8,51,8,251719,424725,15493,110763,3.3639985426435177,0.20684497131588384
2879,0.3408,13,144,13,251863,424581,15506,110750,3.3628580027879864,0.20688135004324426
2880,0.3409,1,3,1,251866,424578,15507,110749,3.362834241540996,0.2068810278577393
2881,0.341,10,76,10,251942,424502,15517,110739,3.3622322899505765,0.20689558535313998
2882,0.3411,1,3,1,251945,424499,15518,110738,3.3622085287035866,0.20689526321984467
2883,0.3412,4,31,4,251976,424468,15522,110734,3.3619629958180206,0.20690131950179558
2884,0.3413,5,39,5,252015,424429,15527,110729,3.3616540996071476,0.20690898762608426
2885,0.3414,3,12,3,252027,424417,15530,110726,3.3615590546191862,0.20690918128425487
2886,0.3415,3,40,3,252067,424377,15533,110723,3.36124223799265,0.20692020183143336
2887,0.3416,2,5,2,252072,424372,15535,110721,3.3612026359143328,0.20691917105998398
2888,0.3417,57,441,57,252513,423931,15592,110664,3.357709732606767,0.20700530307990161
2889,0.3418,4,33,4,252546,423898,15596,110660,3.3574483588898745,0.20701214835434134
2890,0.3419,1,6,1,252552,423892,15597,110659,3.357400836395894,0.20701298847069785
2891,0.342,6,109,6,252661,423783,15603,110653,3.356537511088582,0.2070463067607721
2892,0.3421,2,12,2,252673,423771,15605,110651,3.356442466100621,0.2070479882938951
2893,0.3422,2,16,2,252689,423755,15607,110649,3.3563157394500065,0.20705121967649942
2894,0.3423,2,49,2,252738,423706,15609,110647,3.3559276390824992,0.2070672383237298
2895,0.3424,0,6,0,252744,423700,15609,110647,3.3558801165885184,0.20706956341104188
2896,0.3425,39,422,39,253166,423278,15648,110608,3.3525377011785578,0.2071753145802662
2897,0.3426,2,7,2,253173,423271,15650,110606,3.352482258268914,0.20717506092227236
2898,0.3427,4,43,4,253216,423228,15654,110602,3.352141680395387,0.20718580821609875
2899,0.3428,1,19,1,253235,423209,15655,110601,3.351991192497782,0.2071916974204305
2900,0.3429,3,18,3,253253,423191,15658,110598,3.351848625015841,0.2071942284310842
2901,0.343,7,63,7,253316,423128,15665,110591,3.3513496388290456,0.20720828750709644
2902,0.3431,2,5,2,253321,423123,15667,110589,3.3513100367507285,0.20720725784692867
2903,0.3432,2,22,2,253343,423101,15669,110587,3.3511357876061334,0.20721282846906808
2904,0.3433,90,865,90,254208,422236,15759,110497,3.3442846280572804,0.20741534689985414
2905,0.3434,0,4,0,254212,422232,15759,110497,3.3442529463946267,0.2074169042796619
2906,0.3435,2,40,2,254252,422192,15761,110495,3.3439361297680903,0.20742950362971124
2907,0.3436,1,9,1,254261,422183,15762,110494,3.3438648460271194,0.20743152041481047
2908,0.3437,4,44,4,254305,422139,15766,110490,3.3435163477379293,0.20744270402099774
2909,0.3438,1,28,1,254333,422111,15767,110489,3.3432945760993538,0.20745212166729252
2910,0.3439,0,6,0,254339,422105,15767,110489,3.3432470536053733,0.20745445874343307
2911,0.344,14,172,14,254511,421933,15781,110475,3.341884742111266,0.20750063860798484
2912,0.3441,0,3,0,254514,421930,15781,110475,3.3418609808642756,0.2075018078342615
2913,0.3442,11,137,11,254651,421793,15792,110464,3.340775883918388,0.2075388393201029
2914,0.3443,4,62,4,254713,421731,15796,110460,3.340284818147256,0.20755706128063045
2915,0.3444,2,6,2,254719,421725,15798,110458,3.3402372956532758,0.20755642326041981
2916,0.3445,4,23,4,254742,421702,15802,110454,3.3400551260930174,0.20755943745818894
2917,0.3446,0,12,0,254754,421690,15802,110454,3.3399600811050565,0.20756411798310231
2918,0.3447,3,27,3,254781,421663,15805,110451,3.3397462298821443,0.20757018232935048
2919,0.3448,3,27,3,254808,421636,15808,110448,3.339532378659232,0.2075762473594395
2920,0.3449,0,3,0,254811,421633,15808,110448,3.3395086174122417,0.20757741772399316
2921,0.345,167,1609,167,256420,420024,15975,110281,3.3267646686098087,0.20795768472859957
2922,0.3451,0,5,0,256425,420019,15975,110281,3.3267250665314916,0.20795964548368848
2923,0.3452,7,38,7,256463,419981,15982,110274,3.326424090736282,0.20796409274782887
2924,0.3453,3,37,3,256500,419944,15985,110271,3.3261310353567355,0.20797412370453494
2925,0.3454,0,11,0,256511,419933,15985,110271,3.326043910784438,0.20797843848782732
2926,0.3455,3,29,3,256540,419904,15988,110268,3.325814218730199,0.20798533306172337
2927,0.3456,1,10,1,256550,419894,15989,110267,3.325735014573565,0.20798776220808396
2928,0.3457,5,65,5,256615,419829,15994,110262,3.325220187555443,0.2080057952313848
2929,0.3458,9,147,9,256762,419682,16003,110253,3.3240558864529213,0.20805004387330522
2930,0.3459,0,3,0,256765,419679,16003,110253,3.324032125205931,0.20805122166617604
2931,0.346,12,157,12,256922,419522,16015,110241,3.322788619946775,0.20809494056776331
2932,0.3461,1,3,1,256925,419519,16016,110240,3.3227648586997844,0.20809462415928753
2933,0.3462,4,25,4,256950,419494,16020,110236,3.3225668483081994,0.20809846525588507
2934,0.3463,1,30,1,256980,419464,16021,110235,3.3223292358382968,0.20810875610488222
2935,0.3464,1,10,1,256990,419454,16022,110234,3.3222500316816626,0.20811118998353748
2936,0.3465,7,45,7,257035,419409,16029,110227,3.321893612976809,0.20811840584854505
2937,0.3466,0,2,0,257037,419407,16029,110227,3.3218777721454824,0.20811919174373247
2938,0.3467,88,844,88,257881,418563,16117,110139,3.3151929413255607,0.20831962050455644
2939,0.3468,3,23,3,257904,418540,16120,110136,3.3150107717653023,0.20832419099788907
2940,0.3469,3,8,3,257912,418532,16123,110133,3.314947408439995,0.2083228509547634
2941,0.347,3,55,3,257967,418477,16126,110130,3.314511785578507,0.20834003333289192
2942,0.3471,3,15,3,257982,418462,16129,110127,3.314392979343556,0.2083414524327975
2943,0.3472,2,25,2,258007,418437,16131,110125,3.3141949689519707,0.20834831107798138
2944,0.3473,7,57,7,258064,418380,16138,110118,3.313743505259156,0.2083602965384921
2945,0.3474,0,8,0,258072,418372,16138,110118,3.313680141933849,0.20836345058563077
2946,0.3475,38,411,38,258483,417961,16176,110080,3.3104248510961853,0.20846866057749303
2947,0.3476,0,12,0,258495,417949,16176,110080,3.3103298061082245,0.20847339824138447
2948,0.3477,5,48,5,258543,417901,16181,110075,3.3099496261563806,0.2084848553722139
2949,0.3478,3,35,3,258578,417866,16184,110072,3.3096724116081613,0.20849417924074418
2950,0.3479,1,14,1,258592,417852,16185,110071,3.3095615257888733,0.2084982090191183
2951,0.348,13,102,13,258694,417750,16198,110058,3.308753643391205,0.20851900691160422
2952,0.3481,0,11,0,258705,417739,16198,110058,3.3086665188189075,0.2085233527284164
2953,0.3482,2,26,2,258731,417713,16200,110056,3.3084605880116587,0.20853062608830758
2954,0.3483,50,459,50,259190,417254,16250,110006,3.3048251172221517,0.20863710503356978
2955,0.3484,0,2,0,259192,417252,16250,110006,3.304809276390825,0.20863789643779707
2956,0.3485,3,39,3,259231,417213,16253,110003,3.304500380179952,0.20864882704622015
2957,0.3486,3,15,3,259246,417198,16256,110000,3.3043815739450006,0.20865026043346144
2958,0.3487,5,46,5,259292,417152,16261,109995,3.3040172348244834,0.2086609617431191
2959,0.3488,3,31,3,259323,417121,16264,109992,3.303771701938918,0.20866872947546353
2960,0.3489,3,7,3,259330,417114,16267,109989,3.3037162590292737,0.20866699677292674
2961,0.349,8,98,8,259428,417016,16275,109981,3.302940058294259,0.20869378763066962
2962,0.3491,1,8,1,259436,417008,16276,109980,3.302876694968952,0.20869545416593926
2963,0.3492,20,163,20,259599,416845,16296,109960,3.3015856672158157,0.20872998547849775
2964,0.3493,5,69,5,259668,416776,16301,109955,3.30103915853504,0.20874981726915637
2965,0.3494,0,7,0,259675,416769,16301,109955,3.300983715625396,0.20875259149004033
2966,0.3495,5,31,5,259706,416738,16306,109950,3.3007381827398303,0.20875736679020596
2967,0.3496,1,13,1,259719,416725,16307,109949,3.3006352173362057,0.20876101725165852
2968,0.3497,4,26,4,259745,416699,16311,109945,3.300429286528957,0.20876531395022063
2969,0.3498,1,23,1,259768,416676,16312,109944,3.3002471169686984,0.2087729292468953
2970,0.3499,1,9,1,259777,416667,16313,109943,3.300175833227728,0.20877499477791914
2971,0.35,473,5212,473,264989,411455,16786,109470,3.258894626790014,0.21014541440706436
2972,0.3501,3,4,3,264993,411451,16789,109467,3.25886294512736,0.210142479238575
2973,0.3502,1,27,1,265020,411424,16790,109466,3.258649093904448,0.21015185547812398
2974,0.3503,4,43,4,265063,411381,16794,109462,3.258308516030921,0.21016313937213324
2975,0.3504,0,7,0,265070,411374,16794,109462,3.2582530731212773,0.21016596395026457
2976,0.3505,1,34,1,265104,411340,16795,109461,3.2579837789887214,0.2101781678606608
2977,0.3506,1,5,1,265109,411335,16796,109460,3.2579441769104043,0.21017866915004946
2978,0.3507,12,62,12,265171,411273,16808,109448,3.2574531111392724,0.21018549280708862
2979,0.3508,19,170,19,265341,411103,16827,109429,3.2561066404764922,0.21022530795416997
2980,0.3509,0,6,0,265347,411097,16827,109429,3.256059117982512,0.21022773117961446
2981,0.351,11,81,11,265428,411016,16838,109418,3.2554175643137753,0.21024375809420598
2982,0.3511,0,7,0,265435,411009,16838,109418,3.2553621214041315,0.21024658597651544
2983,0.3512,5,25,5,265460,410984,16843,109413,3.255164111012546,0.21024909828457888
2984,0.3513,3,49,3,265509,410935,16846,109410,3.2547760106450387,0.21026434384879264
2985,0.3514,0,7,0,265516,410928,16846,109410,3.2547205677353945,0.21026717249172652
2986,0.3515,0,36,0,265552,410892,16846,109410,3.254435432771512,0.21028172100049586
2987,0.3516,1,3,1,265555,410889,16847,109409,3.2544116715245215,0.21028141565026195
2988,0.3517,44,443,44,265998,410446,16891,109365,3.250902927385629,0.21039377773844725
2989,0.3518,3,31,3,266029,410415,16894,109362,3.250657394500063,0.21040176845070097
2990,0.3519,2,10,2,266039,410405,16896,109360,3.2505781903434294,0.21040277817859995
2991,0.352,7,100,7,266139,410305,16903,109353,3.249786148777088,0.21043263069172416
2992,0.3521,0,12,0,266151,410293,16903,109353,3.249691103789127,0.2104374901375167
2993,0.3522,3,20,3,266171,410273,16906,109350,3.2495326954758585,0.210441031286144
2994,0.3523,5,48,5,266219,410225,16911,109345,3.2491525155240146,0.21045287449236869
2995,0.3524,1,1,1,266220,410224,16912,109344,3.2491445951083513,0.21045175992362886
2996,0.3525,46,407,46,266627,409817,16958,109298,3.245920985933342,0.210546795989328
2997,0.3526,3,8,3,266635,409809,16961,109295,3.2458576226080345,0.2105454783627173
2998,0.3527,7,63,7,266698,409746,16968,109288,3.2453586364212392,0.21056038718080125
2999,0.3528,0,12,0,266710,409734,16968,109288,3.2452635914332784,0.21056525542269885
3000,0.3529,3,24,3,266734,409710,16971,109285,3.2450735014573566,0.21057042938756634
3001,0.353,2,62,2,266796,409648,16973,109283,3.2445824356862247,0.210592545058977
3002,0.3531,0,10,0,266806,409638,16973,109283,3.2445032315295905,0.2105966033365387
3003,0.3532,4,21,4,266827,409617,16977,109279,3.244336902800659,0.21059904104097932
3004,0.3533,98,930,98,267757,408687,17075,109181,3.236970916233684,0.21082785574702434
3005,0.3534,1,8,1,267765,408679,17076,109180,3.236907552908377,0.21082958874906105
3006,0.3535,6,36,6,267801,408643,17082,109174,3.236622417944494,0.21083510197618077
3007,0.3536,0,12,0,267813,408631,17082,109174,3.236527372956533,0.2108399880263806
3008,0.3537,1,32,1,267845,408599,17083,109173,3.2362739196553036,0.2108514944801959
3009,0.3538,1,24,1,267869,408575,17084,109172,3.2360838296793815,0.21085974423801587
3010,0.3539,0,6,0,267875,408569,17084,109172,3.236036307185401,0.2108621878506821
3011,0.354,14,164,14,268039,408405,17098,109158,3.2347373590166013,0.2109076576184928
3012,0.3541,1,6,1,268045,408399,17099,109157,3.234689836522621,0.21090857800894974
3013,0.3542,13,160,13,268205,408239,17112,109144,3.2334225700164745,0.2109539741352151
3014,0.3543,8,45,8,268250,408194,17120,109136,3.233066151311621,0.2109601221657356
3015,0.3544,0,4,0,268254,408190,17120,109136,3.2330344696489672,0.2109617533238229
3016,0.3545,4,25,4,268279,408165,17124,109132,3.2328364592573817,0.2109658474725351
3017,0.3546,0,7,0,268286,408158,17124,109132,3.232781016347738,0.21096870227531944
3018,0.3547,7,38,7,268324,408120,17131,109125,3.2324800405525282,0.2109735231853377
3019,0.3548,1,18,1,268342,408102,17132,109124,3.232337473070587,0.21097933978570296
3020,0.3549,0,2,0,268344,408100,17132,109124,3.23232163223926,0.21098015559989483
3021,0.355,158,1702,158,270046,406398,17290,108966,3.2188410847801294,0.21143502456516172
3022,0.3551,0,8,0,270054,406390,17290,108966,3.218777721454822,0.2114383067238957
3023,0.3552,2,15,2,270069,406375,17292,108964,3.2186589152198706,0.21144140070904782
3024,0.3553,2,27,2,270096,406348,17294,108962,3.2184450639969584,0.21144941879645263
3025,0.3554,3,15,3,270111,406333,17297,108959,3.2183262577620075,0.21145098313189414
3026,0.3555,2,26,2,270137,406307,17299,108957,3.2181203269547587,0.2114585921003602
3027,0.3556,1,10,1,270147,406297,17300,108956,3.2180411227981245,0.21146116567977286
3028,0.3557,10,53,10,270200,406244,17310,108946,3.2176213407679635,0.21146761389002117
3029,0.3558,19,165,19,270365,406079,17329,108927,3.2163144721835,0.21150627371331596
3030,0.3559,0,4,0,270369,406075,17329,108927,3.2162827905208466,0.21150791647411077
3031,0.356,16,150,16,270519,405925,17345,108911,3.2150947281713345,0.21154503570068914
3032,0.3561,1,8,1,270527,405917,17346,108910,3.215031364846027,0.21154679144644706
3033,0.3562,4,30,4,270557,405887,17350,108906,3.2147937523761247,0.21155299314481743
3034,0.3563,3,31,3,270588,405856,17353,108903,3.214548219490559,0.2115611383190969
3035,0.3564,3,13,3,270601,405843,17356,108900,3.2144452540869346,0.21156188622283353
3036,0.3565,4,41,4,270642,405802,17360,108896,3.2141205170447344,0.21157261151199344
3037,0.3566,0,5,0,270647,405797,17360,108896,3.2140809149664173,0.2115746668402329
3038,0.3567,96,851,96,271498,404946,17456,108800,3.207340641236852,0.2117778045960455
3039,0.3568,2,15,2,271513,404931,17458,108798,3.207221835001901,0.21178091951203845
3040,0.3569,1,12,1,271525,404919,17459,108797,3.2071267900139397,0.2117843321991139
3041,0.357,2,55,2,271580,404864,17461,108795,3.206691167152452,0.2118039399679554
3042,0.3571,1,16,1,271596,404848,17462,108794,3.2065644405018374,0.21180900315784146
3043,0.3572,4,8,4,271604,404840,17466,108790,3.2065010771765303,0.21180616397017307
3044,0.3573,7,59,7,271663,404781,17473,108783,3.206033772652389,0.21181975372105522
3045,0.3574,0,9,0,271672,404772,17473,108783,3.205962488911418,0.21182346584104916
3046,0.3575,43,431,43,272103,404341,17516,108740,3.2025487897604865,0.2119353474402677
3047,0.3576,2,12,2,272115,404329,17518,108738,3.2024537447725256,0.2119372323692617
3048,0.3577,3,33,3,272148,404296,17521,108735,3.202192371055633,0.21194625665895434
3049,0.3578,1,22,1,272170,404274,17522,108734,3.202018121911038,0.21195380968717836
3050,0.3579,1,11,1,272181,404263,17523,108733,3.2019309973387404,0.21195681837675148
3051,0.358,11,115,11,272296,404148,17534,108722,3.2010201495374475,0.21198744321173008
3052,0.3581,0,13,0,272309,404135,17534,108722,3.2009171841338233,0.211992816711091
3053,0.3582,4,16,4,272325,404119,17538,108718,3.2007904574832087,0.21199328441590604
3054,0.3583,46,471,46,272796,403648,17584,108672,3.197059941705741,0.21211742660836977
3055,0.3584,2,6,2,272802,403642,17586,108670,3.1970124192117604,0.21211683505363918
3056,0.3585,6,37,6,272839,403605,17592,108664,3.196719363832214,0.2121229276024901
3057,0.3586,0,13,0,272852,403592,17592,108664,3.1966163984285894,0.2121283108445777
3058,0.3587,3,34,3,272886,403558,17595,108661,3.1963471042960334,0.21213777700553865
3059,0.3588,6,41,6,272927,403517,17601,108655,3.1960223672538333,0.2121455292362722
3060,0.3589,2,8,2,272935,403509,17603,108653,3.195959003928526,0.21214576637860677
3061,0.359,11,96,11,273031,403413,17614,108642,3.1951986440248383,0.2121686146995928
3062,0.3591,2,8,2,273039,403405,17616,108640,3.1951352806995312,0.2121688523469617
3063,0.3592,17,164,17,273203,403241,17633,108623,3.193836332530731,0.21221066533297908
3064,0.3593,9,69,9,273272,403172,17642,108614,3.193289823849956,0.21222542234449554
3065,0.3594,1,9,1,273281,403163,17643,108613,3.193218540108985,0.2122276152066529
3066,0.3595,10,32,10,273313,403131,17653,108603,3.1929650868077557,0.21222549215021866
3067,0.3596,1,13,1,273326,403118,17654,108602,3.1928621214041315,0.2122293441725944
3068,0.3597,4,40,4,273366,403078,17658,108598,3.1925453047775947,0.2122397767337143
3069,0.3598,6,18,6,273384,403060,17664,108592,3.1924027372956534,0.21223800551937644
3070,0.3599,3,12,3,273396,403048,17667,108589,3.1923076923076925,0.2122383643090707
3071,0.36,525,4952,525,278348,398096,18192,108064,3.153085793942466,0.21349770823455033
3072,0.3601,0,12,0,278360,398084,18192,108064,3.152990748954505,0.21350276994080783
3073,0.3602,1,16,1,278376,398068,18193,108063,3.1528640223038904,0.21350796532913416
3074,0.3603,6,42,6,278418,398026,18199,108057,3.152531364846027,0.21351635996466983
3075,0.3604,3,13,3,278431,398013,18202,108054,3.1524283994424027,0.21351718250745455
3076,0.3605,2,22,2,278453,397991,18204,108052,3.1522541502978076,0.21352335671079334
3077,0.3606,2,10,2,278463,397981,18206,108050,3.1521749461411734,0.21352446786856932
3078,0.3607,6,70,6,278533,397911,18212,108044,3.1516205170447344,0.21354468282752417
3079,0.3608,22,154,22,278687,397757,18234,108022,3.150400773032569,0.21357549443531662
3080,0.3609,1,7,1,278694,397750,18235,108021,3.1503453301229247,0.2135768954724569
3081,0.361,13,96,13,278790,397654,18248,108008,3.149584970219237,0.21359722502383013
3082,0.3611,1,12,1,278802,397642,18249,108007,3.149489925231276,0.21360073885244507
3083,0.3612,6,27,6,278829,397615,18255,108001,3.149276074008364,0.21360281320211386
3084,0.3613,2,40,2,278869,397575,18257,107999,3.1489592573818275,0.213616602119571
3085,0.3614,2,13,2,278882,397562,18259,107997,3.148856291978203,0.2136189841343938
3086,0.3615,6,37,6,278919,397525,18265,107991,3.148563236598657,0.21362528584654095
3087,0.3616,0,4,0,278923,397521,18265,107991,3.148531554936003,0.2136269762142145
3088,0.3617,46,450,46,279373,397071,18311,107945,3.1449673678874666,0.21374570310643623
3089,0.3618,3,25,3,279398,397046,18314,107942,3.1447693574958815,0.21375161389973624
3090,0.3619,2,6,2,279404,397040,18316,107940,3.144721835001901,0.21375103964513445
3091,0.362,15,116,15,279520,396924,18331,107925,3.143803066784945,0.21377679266473737
3092,0.3621,2,13,2,279533,396911,18333,107923,3.1437001013813206,0.21377918286010847
3093,0.3622,3,25,3,279558,396886,18336,107920,3.143502090989735,0.2137850976414702
3094,0.3623,6,44,6,279602,396842,18342,107914,3.143153592700545,0.21379438778340426
3095,0.3624,1,6,1,279608,396836,18343,107913,3.1431060702065645,0.21379537156091444
3096,0.3625,52,439,52,280047,396397,18395,107861,3.1396290077303255,0.21390042398930706
3097,0.3626,1,15,1,280062,396382,18396,107860,3.1395102014953746,0.213905228045264
3098,0.3627,6,54,6,280116,396328,18402,107854,3.1390824990495503,0.213918783296508
3099,0.3628,2,15,2,280131,396313,18404,107852,3.138963692814599,0.21392202949431238
3100,0.3629,2,24,2,280155,396289,18406,107850,3.138773602838677,0.21392909495198745
3101,0.363,11,67,11,280222,396222,18417,107839,3.1382429349892282,0.21394037626398393
3102,0.3631,3,6,3,280228,396216,18420,107836,3.138195412495248,0.21393824446684073
3103,0.3632,2,19,2,280247,396197,18422,107834,3.1380449245976427,0.21394319000220224
3104,0.3633,83,907,83,281154,395290,18505,107751,3.1308611075909263,0.21419924022097603
3105,0.3634,1,3,1,281157,395287,18506,107750,3.1308373463439363,0.2141989555440256
3106,0.3635,0,41,0,281198,395246,18506,107750,3.130512609301736,0.21421641523988263
3107,0.3636,1,6,1,281204,395240,18507,107749,3.1304650868077557,0.21421740833298542
3108,0.3637,5,32,5,281236,395208,18512,107744,3.1302116335065264,0.21422322607326344
3109,0.3638,1,25,1,281261,395183,18513,107743,3.130013623114941,0.2142323125072078
3110,0.3639,0,8,0,281269,395175,18513,107743,3.129950259789634,0.2142357203361184
3111,0.364,16,176,16,281445,394999,18529,107727,3.128556266632873,0.21428571428571427
3112,0.3641,0,3,0,281448,394996,18529,107727,3.128532505385883,0.21428699303592635
3113,0.3642,23,154,23,281602,394842,18552,107704,3.127312761373717,0.21431669936682413
3114,0.3643,10,69,10,281671,394773,18562,107694,3.126766252692941,0.21433049334583168
3115,0.3644,0,8,0,281679,394765,18562,107694,3.126702889367634,0.21433390585102466
3116,0.3645,4,20,4,281699,394745,18566,107690,3.1265444810543657,0.21433618278981362
3117,0.3646,1,10,1,281709,394735,18567,107689,3.1264652768977315,0.2143388850851074
3118,0.3647,3,34,3,281743,394701,18570,107686,3.1261959827651755,0.21434869930949646
3119,0.3648,3,15,3,281758,394686,18573,107683,3.126077176530224,0.21435040776799524
3120,0.3649,0,7,0,281765,394679,18573,107683,3.1260217336205804,0.21435339456407929
3121,0.365,144,1684,144,283449,392995,18717,107539,3.1126837536433913,0.2148485417574031
3122,0.3651,0,14,0,283463,392981,18717,107539,3.1125728678241034,0.21485455126668265
3123,0.3652,6,27,6,283490,392954,18723,107533,3.112359016601191,0.21485672954542276
3124,0.3653,8,46,8,283536,392908,18731,107525,3.1119946774806744,0.21486392783849187
3125,0.3654,0,7,0,283543,392901,18731,107525,3.11193923457103,0.2148669333727664
3126,0.3655,2,26,2,283569,392875,18733,107523,3.1117333037637813,0.21487495953221236
3127,0.3656,1,4,1,283573,392871,18734,107522,3.111701622101128,0.21487510816498231
3128,0.3657,7,62,7,283635,392809,18741,107515,3.111210556329996,0.21489075079348582
3129,0.3658,8,158,8,283793,392651,18749,107507,3.109959130655177,0.21494607703965546
3130,0.3659,1,4,1,283797,392647,18750,107506,3.109927448992523,0.21494622645470485
3131,0.366,17,186,17,283983,392461,18767,107489,3.1084542516791283,0.214999499949995
3132,0.3661,3,9,3,283992,392452,18770,107486,3.1083829679381574,0.21499865983381938
3133,0.3662,1,32,1,284024,392420,18771,107485,3.108129514636928,0.21501085206189177
3134,0.3663,7,38,7,284062,392382,18778,107478,3.1078285388417184,0.21501620453727044
3135,0.3664,0,14,0,284076,392368,18778,107478,3.1077176530224304,0.21502222684586852
3136,0.3665,3,43,3,284119,392325,18781,107475,3.1073770751489036,0.2150360144057623
3137,0.3666,2,8,2,284127,392317,18783,107473,3.1073137118235965,0.21503631525240602
3138,0.3667,84,898,84,285025,391419,18867,107389,3.100201178557851,0.21529125435037128
3139,0.3668,5,16,5,285041,391403,18872,107384,3.1000744519072363,0.21529029425385987
3140,0.3669,0,7,0,285048,391396,18872,107384,3.100019008997592,0.2152933156902843
3141,0.367,7,68,7,285116,391328,18879,107377,3.09948042073248,0.2153116571921276
3142,0.3671,2,26,2,285142,391302,18881,107375,3.0992744899252314,0.21531973602151291
3143,0.3672,0,16,0,285158,391286,18881,107375,3.0991477632746167,0.21532664475465296
3144,0.3673,2,47,2,285205,391239,18883,107373,3.098775503738436,0.21534379437317994
3145,0.3674,2,12,2,285217,391227,18885,107371,3.0986804587504753,0.21534582970649702
3146,0.3675,38,458,38,285675,390769,18923,107333,3.0950529083766316,0.21548397717736528
3147,0.3676,2,5,2,285680,390764,18925,107331,3.0950133062983145,0.21548299019263392
3148,0.3677,5,50,5,285730,390714,18930,107326,3.094617285515144,0.21549674724921694
3149,0.3678,1,15,1,285745,390699,18931,107325,3.0944984792801926,0.21550166257047854
3150,0.3679,5,15,5,285760,390684,18936,107320,3.0943796730452413,0.21550027710620798
3151,0.368,11,126,11,285886,390558,18947,107309,3.0933817006716513,0.21553748290206018
3152,0.3681,2,8,2,285894,390550,18949,107307,3.0933183373463438,0.21553779498932424
3153,0.3682,1,19,1,285913,390531,18950,107306,3.093167849448739,0.21554444527023905
3154,0.3683,49,472,49,286385,390059,18999,107257,3.0894294132556075,0.21567172582422445
3155,0.3684,1,3,1,286388,390056,19000,107256,3.0894056520086175,0.21567144971366065
3156,0.3685,6,32,6,286420,390024,19006,107250,3.089152198707388,0.21567586481497122
3157,0.3686,1,23,1,286443,390001,19007,107249,3.08897002914713,0.21568426344896932
3158,0.3687,8,25,8,286468,389976,19015,107241,3.0887720187555443,0.2156824887322839
3159,0.3688,4,24,4,286492,389952,19019,107237,3.0885819287796226,0.21568659000903076
3160,0.3689,2,13,2,286505,389939,19021,107235,3.088478963375998,0.21568907464992135
3161,0.369,9,109,9,286614,389830,19030,107226,3.087615638068686,0.21572217214961695
3162,0.3691,0,4,0,286618,389826,19030,107226,3.087583956406032,0.21572390816252626
3163,0.3692,19,193,19,286811,389633,19049,107207,3.086055316182993,0.21577771515981
3164,0.3693,5,60,5,286871,389573,19054,107202,3.0855800912431883,0.21579588344824116
3165,0.3694,2,10,2,286881,389563,19056,107200,3.085500887086554,0.2157970702326864
3166,0.3695,4,31,4,286912,389532,19060,107196,3.0852553542009886,0.21580422283422718
3167,0.3696,2,9,2,286921,389523,19062,107194,3.0851840704600177,0.215804975468929
3168,0.3697,7,30,7,286951,389493,19069,107187,3.084946457990115,0.21580695820246437
3169,0.3698,3,24,3,286975,389469,19072,107184,3.0847563680141934,0.21581264987828525
3170,0.3699,0,1,0,286976,389468,19072,107184,3.08474844759853,0.215813084413231
3171,0.37,518,5033,518,292009,384435,19590,106666,3.0448849955645674,0.21719768438671475
3172,0.3701,1,6,1,292015,384429,19591,106665,3.044837473070587,0.2171987440286381
3173,0.3702,1,25,1,292040,384404,19592,106664,3.0446394626790014,0.2172082074173027
3174,0.3703,4,40,4,292080,384364,19596,106660,3.044322646052465,0.21721952491120597
3175,0.3704,4,6,4,292086,384358,19600,106656,3.044275123558484,0.2172158024007462
3176,0.3705,5,34,5,292120,384324,19605,106651,3.0440058294259282,0.21722287285503336
3177,0.3706,1,10,1,292130,384314,19606,106650,3.043926625269294,0.2172257029028605
3178,0.3707,7,67,7,292197,384247,19613,106643,3.0433959574198455,0.21724418912587343
3179,0.3708,19,161,19,292358,384086,19632,106624,3.0421207704980358,0.21728515824010108
3180,0.3709,1,3,1,292361,384083,19633,106623,3.0420970092510453,0.21728489156439906
3181,0.371,9,92,9,292453,383991,19642,106614,3.0413683310100113,0.21731127893111565
3182,0.3711,0,5,0,292458,383986,19642,106614,3.041328728931694,0.2173134936812067
3183,0.3712,2,28,2,292486,383958,19644,106612,3.0411069572931186,0.21732270623968036
3184,0.3713,8,58,8,292544,383900,19652,106604,3.0406475731846405,0.21733563844535417
3185,0.3714,4,10,4,292554,383890,19656,106600,3.0405683690280068,0.21733368672144182
3186,0.3715,12,32,12,292586,383858,19668,106588,3.0403149157267775,0.21732871712686005
3187,0.3716,1,1,1,292587,383857,19669,106587,3.040306995311114,0.2173275644110235
3188,0.3717,49,465,49,293052,383392,19718,106538,3.0366240020276263,0.21745555487518625
3189,0.3718,7,28,7,293080,383364,19725,106531,3.0364022303890508,0.2174568019677686
3190,0.3719,5,9,5,293089,383355,19730,106526,3.03633094664808,0.21745280996813512
3191,0.372,15,111,15,293200,383244,19745,106511,3.035451780509441,0.2174781268185113
3192,0.3721,1,11,1,293211,383233,19746,106510,3.0353646559371437,0.2174814137210741
3193,0.3722,0,24,0,293235,383209,19746,106510,3.0351745659612215,0.21749207198413784
3194,0.3723,5,57,5,293292,383152,19751,106505,3.034723102268407,0.21750939943674857
3195,0.3724,2,7,2,293299,383145,19753,106503,3.0346676593587634,0.21750931281246935
3196,0.3725,44,436,44,293735,382709,19797,106459,3.031214358129515,0.21763279691230825
3197,0.3726,1,9,1,293744,382700,19798,106458,3.031143074388544,0.21763520171396564
3198,0.3727,11,71,11,293815,382629,19809,106447,3.0305807248764416,0.21764919971538166
3199,0.3728,1,17,1,293832,382612,19810,106446,3.0304460778101636,0.2176551656449746
3200,0.3729,2,8,2,293840,382604,19812,106444,3.030382714484856,0.21765552665587018
3201,0.373,8,70,8,293910,382534,19820,106436,3.029828285388417,0.21767388592347178
3202,0.3731,2,8,2,293918,382526,19822,106434,3.02976492206311,0.21767424738219895
3203,0.3732,5,33,5,293951,382493,19827,106429,3.0295035483462174,0.21768093888186663
3204,0.3733,86,874,86,294825,381619,19913,106343,3.0225811050563935,0.21793295379558245
3205,0.3734,1,4,1,294829,381615,19914,106342,3.0225494233937398,0.2179331375510547
3206,0.3735,7,35,7,294864,381580,19921,106335,3.02227220884552,0.2179375505979525
3207,0.3736,2,4,2,294868,381576,19923,106333,3.0222405271828667,0.21793613153272434
3208,0.3737,6,32,6,294900,381544,19929,106327,3.0219870738816375,0.21794080812345887
3209,0.3738,6,32,6,294932,381512,19935,106321,3.021733620580408,0.21794548544276424
3210,0.3739,0,7,0,294939,381505,19935,106321,3.021678177670764,0.21794861282506467
3211,0.374,21,203,21,295142,381302,19956,106300,3.020070333291091,0.21800566855755307
3212,0.3741,0,7,0,295149,381295,19956,106300,3.0200148903814474,0.21800879828546232
3213,0.3742,18,136,18,295285,381159,19974,106282,3.018937713851223,0.21804074749559435
3214,0.3743,4,75,4,295360,381084,19978,106278,3.0183436826764667,0.21806788383173084
3215,0.3744,0,5,0,295365,381079,19978,106278,3.0183040805981496,0.21807012108167115
3216,0.3745,3,34,3,295399,381045,19981,106275,3.0180347864655936,0.21808052203890668
3217,0.3746,0,8,0,295407,381037,19981,106275,3.0179714231402865,0.2180841021768395
3218,0.3747,4,40,4,295447,380997,19985,106271,3.0176546065137497,0.21809558600195375
3219,0.3748,3,20,3,295467,380977,19988,106268,3.0174961982004818,0.21809972395817298
3220,0.3749,0,3,0,295470,380974,19988,106268,3.0174724369534913,0.21810106682100475
3221,0.375,163,1724,163,297194,379250,20151,106105,3.0038176403497654,0.21861318004347333
3222,0.3751,3,13,3,297207,379237,20154,106102,3.003714674946141,0.21861420574072968
3223,0.3752,6,26,6,297233,379211,20160,106096,3.0035087441388924,0.21861625733813853
3224,0.3753,2,32,2,297265,379179,20162,106094,3.003255290837663,0.2186274530006821
3225,0.3754,3,11,3,297276,379168,20165,106091,3.0031681662653655,0.21862757826233
3226,0.3755,0,25,0,297301,379143,20165,106091,3.0029701558737805,0.21863884229052374
3227,0.3756,0,10,0,297311,379133,20165,106091,3.0028909517171463,0.21864334822679835
3228,0.3757,3,74,3,297385,379059,20168,106088,3.0023048409580535,0.2186718664652157
3229,0.3758,16,152,16,297537,378907,20184,106072,3.0011009377772147,0.21871462475694825
3230,0.3759,0,5,0,297542,378902,20184,106072,3.0010613356988975,0.218716879667776
3231,0.376,20,174,20,297716,378728,20204,106052,2.9996831833734636,0.21876315029497917
3232,0.3761,2,8,2,297724,378720,20206,106050,2.999619820048156,0.21876353734760814
3233,0.3762,2,32,2,297756,378688,20208,106048,2.999366366746927,0.21877475574333247
3234,0.3763,2,40,2,297796,378648,20210,106046,2.9990495501203904,0.21878958683210437
3235,0.3764,0,13,0,297809,378635,20210,106046,2.998946584716766,0.21879545515504012
3236,0.3765,8,39,8,297848,378596,20218,106038,2.9986376885058927,0.2188001667237544
3237,0.3766,0,5,0,297853,378591,20218,106038,2.9985980864275756,0.2188024241223699
3238,0.3767,103,870,103,298723,377721,20321,105935,2.9917073248004056,0.21902964090179797
3239,0.3768,7,27,7,298750,377694,20328,105928,2.9914934735774934,0.21903056519347755
3240,0.3769,3,11,3,298761,377683,20331,105925,2.991406349005196,0.21903070255248053
3241,0.377,6,54,6,298815,377629,20337,105919,2.9909786465593715,0.21904547221785634
3242,0.3771,1,28,1,298843,377601,20338,105918,2.990756874920796,0.21905654172845326
3243,0.3772,1,34,1,298877,377567,20339,105917,2.9904875807882396,0.21907033117952196
3244,0.3773,9,53,9,298930,377514,20348,105908,2.990067798758079,0.2190798101865451
3245,0.3774,1,10,1,298940,377504,20349,105907,2.989988594601445,0.21908272670667403
3246,0.3775,51,436,51,299376,377068,20400,105856,2.9865352933721963,0.21919805186737457
3247,0.3776,3,9,3,299385,377059,20403,105853,2.9864640096312254,0.21919728646212974
3248,0.3777,4,41,4,299426,377018,20407,105849,2.9861392725890257,0.2192094303400315
3249,0.3778,3,18,3,299444,377000,20410,105846,2.985996705107084,0.2192127510634861
3250,0.3779,2,18,2,299462,376982,20412,105844,2.9858541376251426,0.21921768918823759
3251,0.378,11,119,11,299581,376863,20423,105833,2.9849116081611964,0.2192539403682649
3252,0.3781,1,8,1,299589,376855,20424,105832,2.984848244835889,0.2192559567587277
3253,0.3782,1,29,1,299618,376826,20425,105831,2.98461855278165,0.21926751295433403
3254,0.3783,47,464,47,300082,376362,20472,105784,2.980943479913826,0.21940242167310317
3255,0.3784,0,6,0,300088,376356,20472,105784,2.9808959574198455,0.21940515203053054
3256,0.3785,5,24,5,300112,376332,20477,105779,2.9807058674439233,0.21940797866051595
3257,0.3786,0,12,0,300124,376320,20477,105779,2.9806108224559624,0.2194134399780958
3258,0.3787,5,50,5,300174,376270,20482,105774,2.980214801672792,0.21942810199898766
3259,0.3788,2,10,2,300184,376260,20484,105772,2.9801355975161576,0.21942941547449132
3260,0.3789,3,6,3,300190,376254,20487,105769,2.980088075022177,0.219427288739334
3261,0.379,14,112,14,300302,376142,20501,105755,2.9792009884678747,0.21945560980873507
3262,0.3791,0,5,0,300307,376137,20501,105755,2.9791613863895576,0.21945788682941406
3263,0.3792,15,156,15,300463,375981,20516,105740,2.977925801546065,0.2195046510324441
3264,0.3793,6,69,6,300532,375912,20522,105734,2.9773792928652894,0.2195263741420047
3265,0.3794,1,3,1,300535,375909,20523,105733,2.9773555316182994,0.21952612106087094
3266,0.3795,2,34,2,300569,375875,20525,105731,2.9770862374857434,0.21953837784412986
3267,0.3796,2,6,2,300575,375869,20527,105729,2.977038714991763,0.2195378718350159
3268,0.3797,2,37,2,300612,375832,20529,105727,2.9767456596122166,0.2195514983626098
3269,0.3798,1,30,1,300642,375802,20530,105726,2.976508047142314,0.21956355601335747
3270,0.3799,1,3,1,300645,375799,20531,105725,2.976484285895324,0.2195633031790731
3271,0.38,530,5007,530,305652,370792,21061,105195,2.9368267646686097,0.22100393498141757
3272,0.3801,0,6,0,305658,370786,21061,105195,2.9367792421746293,0.22100672085650477
3273,0.3802,3,25,3,305683,370761,21064,105192,2.9365812317830438,0.22101341939225091
3274,0.3803,5,32,5,305715,370729,21069,105187,2.936327778481815,0.22102009598332478
3275,0.3804,4,13,4,305728,370716,21073,105183,2.9362248130781903,0.22101958608864486
3276,0.3805,3,33,3,305761,370683,21076,105180,2.9359634393612977,0.22103000233260414
3277,0.3806,1,10,1,305771,370673,21077,105179,2.9358842352046635,0.22103301026369543
3278,0.3807,15,57,15,305828,370616,21092,105164,2.935432771511849,0.2210349321114801
3279,0.3808,16,155,16,305983,370461,21108,105148,2.93420510708402,0.221080761718134
3280,0.3809,0,3,0,305986,370458,21108,105148,2.9341813458370294,0.22108215623856722
3281,0.381,13,109,13,306095,370349,21121,105135,2.9333180205297174,0.22111154108234976
3282,0.3811,0,6,0,306101,370343,21121,105135,2.933270498035737,0.22111433126243485
3283,0.3812,4,28,4,306129,370315,21125,105131,2.9330487263971614,0.22112080025912512
3284,0.3813,5,35,5,306164,370280,21130,105126,2.9327715118489417,0.2211288877296458
3285,0.3814,1,10,1,306174,370270,21131,105125,2.9326923076923075,0.2211319008403538
3286,0.3815,7,29,7,306203,370241,21138,105118,2.9324626156380686,0.22113392194110135
3287,0.3816,0,5,0,306208,370236,21138,105118,2.9324230135597515,0.2211362479331193
3288,0.3817,53,442,53,306650,369794,21191,105065,2.9289221898365225,0.22125515152919076
3289,0.3818,7,22,7,306672,369772,21198,105058,2.9287479406919275,0.2212539224564581
3290,0.3819,0,9,0,306681,369763,21198,105058,2.9286766569509566,0.22125811621642683
3291,0.382,16,106,16,306787,369657,21214,105042,2.927837092890635,0.22128127508168335
3292,0.3821,2,15,2,306802,369642,21216,105040,2.9277182866556837,0.22128498658048967
3293,0.3822,2,28,2,306830,369614,21218,105038,2.927496515017108,0.22129475910772523
3294,0.3823,6,50,6,306880,369564,21224,105032,2.9271004942339376,0.22130822847221637
3295,0.3824,1,9,1,306889,369555,21225,105031,2.9270292104929667,0.221310784557488
3296,0.3825,47,438,47,307327,369117,21272,104984,2.9235600684323915,0.2214380480108669
3297,0.3826,0,10,0,307337,369107,21272,104984,2.9234808642757573,0.22144271880293023
3298,0.3827,7,57,7,307394,369050,21279,104977,2.9230294005829425,0.22145784944739436
3299,0.3828,7,18,7,307412,369032,21286,104970,2.922886833101001,0.22145476179425402
3300,0.3829,1,29,1,307441,369003,21287,104969,2.9226571410467623,0.22146666891715122
3301,0.383,10,82,10,307523,368921,21297,104959,2.922007666962362,0.2214885625052756
3302,0.3831,2,9,2,307532,368912,21299,104957,2.9219363832213916,0.22148948338042793
3303,0.3832,3,27,3,307559,368885,21302,104954,2.9217225319984794,0.22149717520085938
3304,0.3833,83,848,83,308407,368037,21385,104871,2.915006019515904,0.22175772031769392
3305,0.3834,1,2,1,308409,368035,21386,104870,2.9149901786845773,0.22175701250779756
3306,0.3835,6,37,6,308446,367998,21392,104864,2.914697123305031,0.22176448942820526
3307,0.3836,0,10,0,308456,367988,21392,104864,2.9146179191483967,0.22176917936267584
3308,0.3837,4,39,4,308495,367949,21396,104860,2.9143090229375237,0.2217808882656633
3309,0.3838,2,28,2,308523,367921,21398,104858,2.914087251298948,0.2217907309757836
3310,0.3839,0,6,0,308529,367915,21398,104858,2.9140397288049678,0.2217935457397102
3311,0.384,20,164,20,308693,367751,21418,104838,2.9127407806361676,0.22183757979978375
3312,0.3841,1,7,1,308700,367744,21419,104837,2.912685337726524,0.22183921909683207
3313,0.3842,23,140,23,308840,367604,21442,104814,2.911576479533646,0.22186707534429256
3314,0.3843,7,68,7,308908,367536,21449,104807,2.911037891268534,0.2218874843069549
3315,0.3844,0,14,0,308922,367522,21449,104807,2.910927005449246,0.22189406113111834
3316,0.3845,5,18,5,308940,367504,21454,104802,2.9107844379673047,0.2218942804029591
3317,0.3846,0,5,0,308945,367499,21454,104802,2.9107448358889876,0.2218966294799291
3318,0.3847,4,39,4,308984,367460,21458,104798,2.910435939678114,0.22190836364868355
3319,0.3848,3,38,3,309022,367422,21461,104795,2.9101349638829044,0.22192127771765946
3320,0.3849,0,3,0,309025,367419,21461,104795,2.9101112026359144,0.22192268759503106
3321,0.385,203,1706,203,310731,365713,21664,104592,2.89659897351413,0.22239185209598028
3322,0.3851,0,12,0,310743,365701,21664,104592,2.896503928526169,0.22239752664828097
3323,0.3852,0,13,0,310756,365688,21664,104592,2.8964009631225447,0.22240367440673642
3324,0.3853,1,45,1,310801,365643,21665,104591,2.896044544417691,0.22242330414219302
3325,0.3854,1,11,1,310812,365632,21666,104590,2.8959574198453937,0.22242685369889117
3326,0.3855,3,30,3,310842,365602,21669,104587,2.895719807375491,0.22243608421294417
3327,0.3856,0,11,0,310853,365591,21669,104587,2.8956326828031935,0.22244128819298223
3328,0.3857,9,80,9,310933,365511,21678,104578,2.8949990495501203,0.22246425676839918
3329,0.3858,11,158,11,311091,365353,21689,104567,2.893747623875301,0.22252085461355126
3330,0.3859,0,7,0,311098,365346,21689,104567,2.8936921809656573,0.22252416936752123
3331,0.386,15,161,15,311259,365185,21704,104552,2.8924169940438476,0.22257561145917823
3332,0.3861,1,4,1,311263,365181,21705,104551,2.892385312381194,0.22257585176228148
3333,0.3862,7,25,7,311288,365156,21712,104544,2.8921873019896083,0.22257611241217798
3334,0.3863,5,29,5,311317,365127,21717,104539,2.8919576099353694,0.22258157924993505
3335,0.3864,1,11,1,311328,365116,21718,104538,2.891870485363072,0.22258513714351416
3336,0.3865,4,49,4,311377,365067,21722,104534,2.8914823849955646,0.22260174062661706
3337,0.3866,3,5,3,311382,365062,21725,104531,2.8914427829172475,0.22259914436543987
3338,0.3867,94,928,94,312310,364134,21819,104437,2.8840926371815994,0.22288404532077316
3339,0.3868,1,27,1,312337,364107,21820,104436,2.883878785958687,0.22289523053380372
3340,0.3869,0,10,0,312347,364097,21820,104436,2.883799581802053,0.22289998783436812
3341,0.387,8,60,8,312407,364037,21828,104428,2.883324356862248,0.22291526581494883
3342,0.3871,2,26,2,312433,364011,21830,104426,2.8831184260549994,0.2229243206663863
3343,0.3872,2,19,2,312452,363992,21832,104424,2.8829679381573947,0.2229300450881268
3344,0.3873,12,57,12,312509,363935,21844,104412,2.88251647446458,0.22293726659933766
3345,0.3874,2,7,2,312516,363928,21846,104410,2.882461031554936,0.22293728034026708
3346,0.3875,59,480,59,312996,363448,21905,104351,2.8786592320364974,0.2230680270800066
3347,0.3876,0,5,0,313001,363443,21905,104351,2.8786196299581803,0.22307041133490382
3348,0.3877,10,47,10,313048,363396,21915,104341,2.8782473704219997,0.2230762159076575
3349,0.3878,3,26,3,313074,363370,21918,104338,2.878041439614751,0.2230836333780906
3350,0.3879,1,15,1,313089,363355,21919,104337,2.8779226333797996,0.22308912703232042
3351,0.388,14,107,14,313196,363248,21933,104323,2.8770751489038147,0.22311691700297923
3352,0.3881,1,2,1,313198,363246,21934,104322,2.8770593080724876,0.22311620983471922
3353,0.3882,2,21,2,313219,363225,21936,104320,2.876892979343556,0.22312290795538398
3354,0.3883,56,449,56,313668,362776,21992,104264,2.873336712710683,0.22324426173347037
3355,0.3884,1,5,1,313673,362771,21993,104263,2.873297110632366,0.22324498858755465
3356,0.3885,2,27,2,313700,362744,21995,104261,2.8730832594094537,0.22325456900889712
3357,0.3886,1,12,1,313712,362732,21996,104260,2.872988214421493,0.22325864254633912
3358,0.3887,5,30,5,313742,362702,22001,104255,2.8727506019515903,0.22326466890955698
3359,0.3888,1,14,1,313756,362688,22002,104254,2.8726397161323027,0.2232696994487538
3360,0.3889,1,10,1,313766,362678,22003,104253,2.8725605119756685,0.22327281761116738
3361,0.389,12,113,12,313879,362565,22015,104241,2.8716655050057027,0.22330689836891557
3362,0.3891,0,8,0,313887,362557,22015,104241,2.871602141680395,0.22331072541013458
3363,0.3892,21,149,21,314036,362408,22036,104220,2.8704219997465468,0.22334707732926443
3364,0.3893,4,66,4,314102,362342,22040,104216,2.8698992523127616,0.2233720137689205
3365,0.3894,1,12,1,314114,362330,22041,104215,2.8698042073248002,0.22337609448177562
3366,0.3895,2,33,2,314147,362297,22043,104213,2.8695428336079076,0.22338856616149708
3367,0.3896,3,6,3,314153,362291,22046,104210,2.869495311113927,0.22338644504513389
3368,0.3897,6,29,6,314182,362262,22052,104204,2.8692656190596884,0.22339034356201737
3369,0.3898,5,31,5,314213,362231,22057,104199,2.8690200861741224,0.22339686555324487
3370,0.3899,0,4,0,314217,362227,22057,104199,2.8689884045114686,0.2233987813715359
3371,0.39,481,5069,481,319286,357158,22538,103718,2.828839817513623,0.2250453484234371
3372,0.3901,1,12,1,319298,357146,22539,103717,2.828744772525662,0.22504952664891736
3373,0.3902,2,23,2,319321,357123,22541,103715,2.8285626029654036,0.22505739544048017
3374,0.3903,3,24,3,319345,357099,22544,103712,2.828372512989482,0.2250640718212022
3375,0.3904,2,11,2,319356,357088,22546,103710,2.8282853884171844,0.22506608101597664
3376,0.3905,5,17,5,319373,357071,22551,103705,2.828150741350906,0.22506597565845443
3377,0.3906,1,4,1,319377,357067,22552,103704,2.8281190596882526,0.22506624765881533
3378,0.3907,12,66,12,319443,357001,22564,103692,2.827596312254467,0.2250783059434374
3379,0.3908,18,152,18,319595,356849,22582,103674,2.826392409073628,0.22512230659489318
3380,0.3909,2,5,2,319600,356844,22584,103672,2.826352806995311,0.22512138557617975
3381,0.391,10,79,10,319679,356765,22594,103662,2.8257270941579016,0.22514318230685865
3382,0.3911,0,12,0,319691,356753,22594,103662,2.8256320491699403,0.2251490503133043
3383,0.3912,4,20,4,319711,356733,22598,103658,2.8254736408566723,0.22515209897673932
3384,0.3913,7,33,7,319744,356700,22605,103651,2.8252122671397797,0.22515645670368914
3385,0.3914,4,18,4,319762,356682,22609,103647,2.825069699657838,0.2251585279224207
3386,0.3915,6,38,6,319800,356644,22615,103641,2.8247687238626282,0.2251670160878586
3387,0.3916,0,3,0,319803,356641,22615,103641,2.8247449626156382,0.22516848366870745
3388,0.3917,39,497,39,320300,356144,22654,103602,2.820808516030921,0.22534616940658536
3389,0.3918,7,23,7,320323,356121,22661,103595,2.8206263464706627,0.22534564818279113
3390,0.3919,0,9,0,320332,356112,22661,103595,2.8205550627296923,0.22535005992947682
3391,0.392,14,120,14,320452,355992,22675,103581,2.8196046128500822,0.22538530331416337
3392,0.3921,4,12,4,320464,355980,22679,103577,2.8195095678621214,0.22538444632548302
3393,0.3922,2,18,2,320482,355962,22681,103575,2.81936700038018,0.22538990331572867
3394,0.3923,5,52,5,320534,355910,22686,103570,2.8189551387656824,0.2254069818055193
3395,0.3924,1,9,1,320543,355901,22687,103569,2.8188838550247115,0.2254097111889786
3396,0.3925,61,455,61,320998,355446,22748,103508,2.8152800658978583,0.2255302274302
3397,0.3926,1,2,1,321000,355444,22749,103507,2.8152642250665316,0.22552952275951027
3398,0.3927,7,59,7,321059,355385,22756,103500,2.81479692054239,0.22554670560162132
3399,0.3928,5,22,5,321081,355363,22761,103495,2.814622671397795,0.2255490805434361
3400,0.3929,1,28,1,321109,355335,22762,103494,2.814400899759219,0.2255611567708231
3401,0.393,7,65,7,321174,355270,22769,103487,2.8138860727410973,0.22558129903194937
3402,0.3931,1,11,1,321185,355259,22770,103486,2.8137989481687997,0.225585020000218
3403,0.3932,6,28,6,321213,355231,22776,103480,2.813577176530224,0.2255886603983772
3404,0.3933,94,871,94,322084,354360,22870,103386,2.806678494487391,0.2258588824369847
3405,0.3934,2,6,2,322090,354354,22872,103384,2.8066309719934104,0.2258584605167148
3406,0.3935,7,38,7,322128,354316,22879,103377,2.8063299961982007,0.22586537264061282
3407,0.3936,0,15,0,322143,354301,22879,103377,2.8062111899632494,0.22587277518255192
3408,0.3937,5,36,5,322179,354265,22884,103372,2.8059260549993663,0.225882085583115
3409,0.3938,2,32,2,322211,354233,22886,103370,2.805672601698137,0.22589449806928713
3410,0.3939,0,6,0,322217,354227,22886,103370,2.8056250792041566,0.2258974599920891
3411,0.394,25,189,25,322406,354038,22911,103345,2.8041281206437714,0.22594849393178146
3412,0.3941,0,6,0,322412,354032,22911,103345,2.804080598149791,0.22595145798761196
3413,0.3942,20,137,20,322549,353895,22931,103325,2.8029955012039034,0.22598530248020646
3414,0.3943,12,59,12,322608,353836,22943,103313,2.802528196679762,0.22599415070359993
3415,0.3944,0,7,0,322615,353829,22943,103313,2.8024727537701177,0.2259976112455211
3416,0.3945,3,29,3,322644,353800,22946,103310,2.802243061715879,0.2260068692437269
3417,0.3946,0,13,0,322657,353787,22946,103310,2.8021400963122542,0.2260132969588512
3418,0.3947,2,40,2,322697,353747,22948,103308,2.801823279685718,0.22602969008106247
3419,0.3948,2,30,2,322727,353717,22950,103306,2.8015856672158157,0.2260411401614361
3420,0.3949,1,3,1,322730,353714,22951,103305,2.8015619059688253,0.22604093046459775
3421,0.395,180,1711,180,324441,352003,23131,103125,2.788010074768724,0.22658460916489429
3422,0.3951,1,5,1,324446,351998,23132,103124,2.787970472690407,0.22658539907980718
3423,0.3952,3,20,3,324466,351978,23135,103121,2.7878120643771385,0.22659025838334076
3424,0.3953,4,34,4,324500,351944,23139,103117,2.7875427702445825,0.22660038983784592
3425,0.3954,2,12,2,324512,351932,23141,103115,2.7874477252566217,0.2266029662869989
3426,0.3955,4,33,4,324545,351899,23145,103111,2.7871863515397286,0.2266126019208369
3427,0.3956,1,7,1,324552,351892,23146,103110,2.787130908630085,0.22661438850818238
3428,0.3957,11,58,11,324610,351834,23157,103099,2.7866715245216067,0.2266245798831916
3429,0.3958,29,145,29,324755,351689,23186,103070,2.785523064250412,0.22664752099463673
3430,0.3959,0,4,0,324759,351685,23186,103070,2.7854913825877583,0.2266495145737815
3431,0.396,22,179,22,324938,351506,23208,103048,2.7840736281840073,0.22670133801484532
3432,0.3961,0,7,0,324945,351499,23208,103048,2.784018185274363,0.2267048292035807
3433,0.3962,7,38,7,324983,351461,23215,103041,2.7837172094791534,0.22671187365512144
3434,0.3963,1,30,1,325013,351431,23216,103040,2.783479597009251,0.2267251375775352
3435,0.3964,1,6,1,325019,351425,23217,103039,2.7834320745152707,0.2267264293761442
3436,0.3965,2,40,2,325059,351385,23219,103037,2.783115257888734,0.2267429833942899
3437,0.3966,1,4,1,325063,351381,23220,103036,2.78308357622608,0.22674327765026397
3438,0.3967,115,927,115,325990,350454,23335,102921,2.7757413509060958,0.22701075268817203
3439,0.3968,2,30,2,326020,350424,23337,102919,2.775503738436193,0.2270223649642765
3440,0.3969,0,4,0,326024,350420,23337,102919,2.7754720567735394,0.22702436807775198
3441,0.397,9,62,9,326086,350358,23346,102910,2.774980991002408,0.22704007342234617
3442,0.3971,2,28,2,326114,350330,23348,102908,2.7747592193638324,0.22705068860069103
3443,0.3972,2,9,2,326123,350321,23350,102906,2.7746879356228615,0.22705178641166568
3444,0.3973,6,71,6,326194,350250,23356,102900,2.774125586110759,0.22707712677921219
3445,0.3974,0,4,0,326198,350246,23356,102900,2.7740939044481054,0.22707913122922854
3446,0.3975,68,415,68,326613,349831,23424,102832,2.7708069319477886,0.22717120683599057
3447,0.3976,2,14,2,326627,349817,23426,102830,2.7706960461285006,0.22717481834630518
3448,0.3977,3,33,3,326660,349784,23429,102827,2.770434672411608,0.22718625928225342
3449,0.3978,1,21,1,326681,349763,23430,102826,2.7702683436826763,0.22719509311980626
3450,0.3979,1,13,1,326694,349750,23431,102825,2.770165378279052,0.2271999116168591
3451,0.398,15,101,15,326795,349649,23446,102810,2.769365416297047,0.22722500823279015
3452,0.3981,2,6,2,326801,349643,23448,102808,2.7693178938030667,0.2272246055373952
3453,0.3982,6,24,6,326825,349619,23454,102802,2.769127803827145,0.22722641079879138
3454,0.3983,49,465,49,327290,349154,23503,102753,2.7654448105436575,0.22737642922105655
3455,0.3984,0,4,0,327294,349150,23503,102753,2.7654131288810038,0.22737844183375636
3456,0.3985,5,31,5,327325,349119,23508,102748,2.765167595995438,0.22738549174867825
3457,0.3986,1,10,1,327335,349109,23509,102747,2.7650883918388036,0.2273888141354768
3458,0.3987,7,46,7,327381,349063,23516,102740,2.764724052718287,0.2273999951306211
3459,0.3988,1,27,1,327408,349036,23517,102739,2.7645102014953746,0.2274118753804438
3460,0.3989,0,7,0,327415,349029,23517,102739,2.7644547585857304,0.2274153990543819
3461,0.399,8,73,8,327488,348956,23525,102731,2.7638765682423014,0.22743846955967295
3462,0.3991,0,2,0,327490,348954,23525,102731,2.7638607274109743,0.22743947662641
3463,0.3992,20,157,20,327647,348797,23545,102711,2.7626172221518184,0.22748434136272225
3464,0.3993,8,79,8,327726,348718,23553,102703,2.761991509314409,0.22751046140963757
3465,0.3994,1,4,1,327730,348714,23554,102702,2.761959827651755,0.22751076612260088
3466,0.3995,3,27,3,327757,348687,23557,102699,2.761745976428843,0.22751924073852534
3467,0.3996,2,13,2,327770,348674,23559,102697,2.761643011025219,0.2275223707327232
3468,0.3997,7,32,7,327802,348642,23566,102690,2.7613895577239895,0.22752652149637073
3469,0.3998,3,26,3,327828,348616,23569,102687,2.7611836269167407,0.2275344945635194
3470,0.3999,1,8,1,327836,348608,23570,102686,2.761120263591433,0.2275368163547488
3471,0.4,575,4865,575,332701,343743,24145,102111,2.722587441388924,0.22902340227967002
3472,0.4001,0,2,0,332703,343741,24145,102111,2.7225716005575973,0.2290244296313575
3473,0.4002,4,27,4,332730,343714,24149,102107,2.722357749334685,0.2290313825503958
3474,0.4003,2,25,2,332755,343689,24151,102105,2.7221597389430996,0.22904076770885207
3475,0.4004,2,10,2,332765,343679,24153,102103,2.7220805347864654,0.22904244675648636
3476,0.4005,7,31,7,332796,343648,24160,102096,2.7218350019009,0.2290462687102911
3477,0.4006,2,4,2,332800,343644,24162,102094,2.721803320238246,0.22904486492064846
3478,0.4007,8,70,8,332870,343574,24170,102086,2.721248891141807,0.22906700175021316
3479,0.4008,19,146,19,333016,343428,24189,102067,2.7200925104549487,0.2291091931447042
3480,0.4009,1,2,1,333018,343426,24190,102066,2.720076669623622,0.2291084912860388
3481,0.401,17,88,17,333106,343338,24207,102049,2.7193796730452413,0.22912433456746606
3482,0.4011,1,12,1,333118,343326,24208,102048,2.7192846280572804,0.2291287771625645
3483,0.4012,3,45,3,333163,343281,24211,102045,2.718928209352427,0.2291467374462753
3484,0.4013,10,32,10,333195,343249,24221,102035,2.7186747560511977,0.2291458934073535
3485,0.4014,3,11,3,333206,343238,24224,102032,2.7185876314789,0.22914636063512026
3486,0.4015,10,36,10,333242,343202,24234,102022,2.718302496515017,0.22914757515318132
3487,0.4016,2,5,2,333247,343197,24236,102020,2.7182628944367,0.2291466857734543
3488,0.4017,58,473,58,333720,342724,24294,101962,2.714516537827905,0.22928988094970384
3489,0.4018,4,24,4,333744,342700,24298,101958,2.7143264478519833,0.22929532359701163
3490,0.4019,1,4,1,333748,342696,24299,101957,2.7142947661893295,0.2292956530148228
3491,0.402,9,125,9,333873,342571,24308,101948,2.713304714231403,0.22934452745551934
3492,0.4021,1,15,1,333888,342556,24309,101947,2.7131859079964515,0.22935053306726838
3493,0.4022,1,16,1,333904,342540,24310,101946,2.713059181345837,0.2293570551153467
3494,0.4023,8,44,8,333948,342496,24318,101938,2.7127106830566468,0.22936589009841732
3495,0.4024,1,18,1,333966,342478,24319,101937,2.7125681155747055,0.2293734459907969
3496,0.4025,56,408,56,334374,342070,24375,101881,2.7093365859840324,0.22948703798392164
3497,0.4026,1,10,1,334384,342060,24376,101880,2.709257381827398,0.22949047168536288
3498,0.4027,4,55,4,334439,342005,24380,101876,2.7088217589659105,0.22951196379209743
3499,0.4028,3,19,3,334458,341986,24383,101873,2.708671271068306,0.22951658071594808
3500,0.4029,2,23,2,334481,341963,24385,101871,2.708489101508047,0.22952500259105882
3501,0.403,9,67,9,334548,341896,24394,101862,2.7079584336585985,0.22954403075550187
3502,0.4031,1,4,1,334552,341892,24395,101861,2.7079267519959447,0.22954436364373876
3503,0.4032,4,28,4,334580,341864,24399,101857,2.707704980357369,0.22955190311028778
3504,0.4033,107,849,107,335429,341015,24506,101750,2.700980547459131,0.22980587896513952
3505,0.4034,0,8,0,335437,341007,24506,101750,2.7009171841338233,0.22981003123609564
3506,0.4035,5,36,5,335473,340971,24511,101745,2.7006320491699403,0.2298200200580056
3507,0.4036,0,10,0,335483,340961,24511,101745,2.7005528450133065,0.22982521131405492
3508,0.4037,4,32,4,335515,340929,24515,101741,2.7002993917120772,0.22983486570131248
3509,0.4038,2,25,2,335540,340904,24517,101739,2.7001013813204917,0.22984436667924263
3510,0.4039,1,8,1,335548,340896,24518,101738,2.700038017995184,0.2298467808618407
3511,0.404,20,150,20,335698,340746,24538,101718,2.6988499556456724,0.22988988934692992
3512,0.4041,0,2,0,335700,340744,24538,101718,2.6988341148143453,0.2298909284865141
3513,0.4042,14,169,14,335869,340575,24552,101704,2.6974955645672285,0.22995439530251266
3514,0.4043,7,65,7,335934,340510,24559,101697,2.6969807375491066,0.22997600671178883
3515,0.4044,1,16,1,335950,340494,24560,101696,2.696854010898492,0.22998258667088808
3516,0.4045,2,29,2,335979,340465,24562,101694,2.696624318844253,0.2299941876112439
3517,0.4046,0,8,0,335987,340457,24562,101694,2.6965609555189456,0.22999834898032573
3518,0.4047,3,32,3,336019,340425,24565,101691,2.6963075022177163,0.23000977119127106
3519,0.4048,3,26,3,336045,340399,24568,101688,2.6961015714104675,0.23001807336564975
3520,0.4049,0,6,0,336051,340393,24568,101688,2.696054048916487,0.2300211952108324
3521,0.405,191,1704,191,337755,338689,24759,101497,2.6825576606260295,0.23057752859018688
3522,0.4051,1,4,1,337759,338685,24760,101496,2.682525978963376,0.23057787591922413
3523,0.4052,1,24,1,337783,338661,24761,101495,2.682335888987454,0.23058870036986887
3524,0.4053,5,21,5,337804,338640,24766,101490,2.6821695602585223,0.23059096176129779
3525,0.4054,4,8,4,337812,338632,24770,101486,2.682106196933215,0.2305881604478799
3526,0.4055,6,26,6,337838,338606,24776,101480,2.6819002661259663,0.23059129351990293
3527,0.4056,1,5,1,337843,338601,24777,101479,2.6818606640476492,0.23059216506089802
3528,0.4057,9,62,9,337905,338539,24786,101470,2.6813695982765173,0.23060891936301303
3529,0.4058,18,160,18,338065,338379,24804,101452,2.6801023317703714,0.2306613221896592
3530,0.4059,0,3,0,338068,338376,24804,101452,2.680078570523381,0.2306628954955119
3531,0.406,20,176,20,338244,338200,24824,101432,2.6786845773666204,0.23072023874513228
3532,0.4061,1,9,1,338253,338191,24825,101431,2.6786132936256495,0.23072321221412942
3533,0.4062,6,38,6,338291,338153,24831,101425,2.6783123178304398,0.23073265723034364
3534,0.4063,1,35,1,338326,338118,24832,101424,2.67803510328222,0.23074927993229316
3535,0.4064,0,11,0,338337,338107,24832,101424,2.6779479787099225,0.23075505481979655
3536,0.4065,6,43,6,338380,338064,24838,101418,2.6776074008363957,0.23076713039441887
3537,0.4066,2,4,2,338384,338060,24840,101416,2.6775757191737424,0.23076573009675158
3538,0.4067,115,875,115,339259,337185,24955,101301,2.6706453554682548,0.23102447968692272
3539,0.4068,6,21,6,339280,337164,24961,101295,2.6704790267393235,0.23102502172380998
3540,0.4069,1,7,1,339287,337157,24962,101294,2.6704235838296793,0.2310269562619312
3541,0.407,4,65,4,339352,337092,24966,101290,2.6699087568115574,0.2310541947433973
3542,0.4071,1,21,1,339373,337071,24967,101289,2.6697424280826256,0.23106350944429235
3543,0.4072,2,20,2,339393,337051,24969,101287,2.6695840197693577,0.23107054373565605
3544,0.4073,12,62,12,339455,336989,24981,101275,2.6690929539982258,0.2310821787780881
3545,0.4074,2,8,2,339463,336981,24983,101273,2.6690295906729187,0.2310828880055858
3546,0.4075,58,458,58,339921,336523,25041,101215,2.665402040299075,0.23122278623286074
3547,0.4076,2,17,2,339938,336506,25043,101213,2.665267393232797,0.23122825374269795
3548,0.4077,2,51,2,339989,336455,25045,101211,2.6648634520339627,0.23125168507492014
3549,0.4078,3,18,3,340007,336437,25048,101208,2.6647208845520214,0.2312559266071816
3550,0.4079,1,21,1,340028,336416,25049,101207,2.6645545558230896,0.23126526713632511
3551,0.408,12,115,12,340143,336301,25061,101195,2.663643708021797,0.23130497193117194
3552,0.4081,0,15,0,340158,336286,25061,101195,2.663524901786846,0.2313129027317758
3553,0.4082,4,25,4,340183,336261,25065,101191,2.6633268913952604,0.2313190932948072
3554,0.4083,61,447,61,340630,335814,25126,101130,2.6597864655937142,0.2314484235966165
3555,0.4084,0,8,0,340638,335806,25126,101130,2.659723102268407,0.23145266125931488
3556,0.4085,4,35,4,340673,335771,25130,101126,2.6594458877201874,0.23146416661135233
3557,0.4086,1,17,1,340690,335754,25131,101125,2.6593112406539094,0.23147141428175766
3558,0.4087,5,32,5,340722,335722,25136,101120,2.65905778735268,0.23147957385049972
3559,0.4088,3,31,3,340753,335691,25139,101117,2.6588122544671142,0.23149072361312065
3560,0.4089,2,9,2,340762,335682,25141,101115,2.658740970726144,0.23149197453279213
3561,0.409,16,106,16,340868,335576,25157,101099,2.6579014066658218,0.23152000916013052
3562,0.4091,0,2,0,340870,335574,25157,101099,2.657885565834495,0.23152106954173948
3563,0.4092,21,148,21,341018,335426,25178,101078,2.6567133443163096,0.23156259736451443
3564,0.4093,4,54,4,341072,335372,25182,101074,2.656285641870485,0.231584205147945
3565,0.4094,1,6,1,341078,335366,25183,101073,2.656238119376505,0.23158562823212409
3566,0.4095,2,33,2,341111,335333,25185,101071,2.655976745659612,0.23159961870193674
3567,0.4096,1,13,1,341124,335320,25186,101070,2.655873780255988,0.23160475721258508
3568,0.4097,1,32,1,341156,335288,25187,101069,2.6556203269547587,0.23161998088720934
3569,0.4098,5,26,5,341182,335262,25192,101064,2.65541439614751,0.2316249776543227
3570,0.4099,0,7,0,341189,335255,25192,101064,2.655358953237866,0.23162869368512487
3571,0.41,552,4913,552,346102,330342,25744,100512,2.616445951083513,0.23328552131348437
3572,0.4101,3,8,3,346110,330334,25747,100509,2.6163825877582054,0.23328451431263825
3573,0.4102,4,17,4,346127,330317,25751,100505,2.6162479406919275,0.23328660096281062
3574,0.4103,8,21,8,346148,330296,25759,100497,2.6160816119629957,0.23328373487962897
3575,0.4104,2,10,2,346158,330286,25761,100495,2.6160024078063615,0.23328559059011422
3576,0.4105,6,31,6,346189,330255,25767,100489,2.615756874920796,0.2332916999424252
3577,0.4106,0,2,0,346191,330253,25767,100489,2.615741034089469,0.2332927831509349
3578,0.4107,8,56,8,346247,330197,25775,100481,2.615297490812318,0.233308875772619
3579,0.4108,16,144,16,346391,330053,25791,100465,2.614156950956786,0.2333584193924528
3580,0.4109,0,7,0,346398,330046,25791,100465,2.6141015080471424,0.23336221374134458
3581,0.411,13,81,13,346479,329965,25804,100452,2.613459954378406,0.2333829751148305
3582,0.4111,0,12,0,346491,329953,25804,100452,2.613364909390445,0.2333894819995121
3583,0.4112,3,37,3,346528,329916,25807,100449,2.6130718540108986,0.23340420340873444
3584,0.4113,6,41,6,346569,329875,25813,100443,2.6127471169686984,0.23341575300126882
3585,0.4114,4,18,4,346587,329857,25817,100439,2.612604549486757,0.23341839106103707
3586,0.4115,8,45,8,346632,329812,25825,100431,2.6122481307819037,0.2334285508421985
3587,0.4116,1,9,1,346641,329803,25826,100430,2.612176847040933,0.23343165215127618
3588,0.4117,71,484,71,347125,329319,25897,100359,2.6083433658598403,0.23356792761090864
3589,0.4118,6,21,6,347146,329298,25903,100353,2.6081770371309085,0.23356864059434285
3590,0.4119,0,9,0,347155,329289,25903,100353,2.608105753389938,0.23357353331378217
3591,0.412,12,106,12,347261,329183,25915,100341,2.607266189329616,0.2336097633659586
3592,0.4121,1,19,1,347280,329164,25916,100340,2.607115701432011,0.23361831321710624
3593,0.4122,4,20,4,347300,329144,25920,100336,2.606957293118743,0.23362205457762877
3594,0.4123,9,37,9,347337,329107,25929,100327,2.6066642377391966,0.2336261218254726
3595,0.4124,0,18,0,347355,329089,25929,100327,2.606521670257255,0.2336359148238538
3596,0.4125,55,411,55,347766,328678,25984,100272,2.603266379419592,0.23376151066557874
3597,0.4126,3,9,3,347775,328669,25987,100269,2.6031950956786214,0.233761056376446
3598,0.4127,5,59,5,347834,328610,25992,100264,2.60272779115448,0.2337842816305022
3599,0.4128,2,16,2,347850,328594,25994,100262,2.6026010645038653,0.23378943048482476
3600,0.4129,4,21,4,347871,328573,25998,100258,2.6024347357749336,0.23379373226282615
3601,0.413,9,57,9,347928,328516,26007,100249,2.6019832720821188,0.23380872972374145
3602,0.4131,2,8,2,347936,328508,26009,100247,2.6019199087568117,0.23380951825634685
3603,0.4132,3,25,3,347961,328483,26012,100244,2.601721898365226,0.23381779080860315
3604,0.4133,97,865,97,348826,327618,26109,100147,2.594870738816373,0.23411686323097963
3605,0.4134,0,7,0,348833,327611,26109,100147,2.594815295906729,0.23412069441132602
3606,0.4135,3,32,3,348865,327579,26112,100144,2.5945618426055,0.23413283830890552
3607,0.4136,0,12,0,348877,327567,26112,100144,2.594466797617539,0.2341394072165551
3608,0.4137,2,23,2,348900,327544,26114,100142,2.5942846280572804,0.23414841729680186
3609,0.4138,6,41,6,348941,327503,26120,100136,2.5939598910150803,0.23416012103666878
3610,0.4139,1,6,1,348947,327497,26121,100135,2.5939123685211,0.23416161559471696
3611,0.414,26,182,26,349129,327315,26147,100109,2.592470852870359,0.23421473759077638
3612,0.4141,0,4,0,349133,327311,26147,100109,2.592439171207705,0.23421692948388004
3613,0.4142,14,154,14,349287,327157,26161,100095,2.591219427195539,0.23427625850785952
3614,0.4143,8,57,8,349344,327100,26169,100087,2.5907679635027248,0.2342931783972827
3615,0.4144,2,3,2,349347,327097,26171,100085,2.5907442022557343,0.23429123886306072
3616,0.4145,4,44,4,349391,327053,26175,100081,2.590395703966544,0.2343082030463508
3617,0.4146,3,13,3,349404,327040,26178,100078,2.59029273856292,0.23430995649914074
3618,0.4147,5,35,5,349439,327005,26183,100073,2.5900155240147003,0.23432019443755006
3619,0.4148,4,23,4,349462,326982,26187,100069,2.589833354454442,0.23432564260474745
3620,0.4149,0,5,0,349467,326977,26187,100069,2.5897937523761247,0.23432838616917148
3621,0.415,187,1602,187,351069,325375,26374,99882,2.5771052464833355,0.23487444063237053
3622,0.4151,1,8,1,351077,325367,26375,99881,2.577041883158028,0.23487705997441494
3623,0.4152,3,27,3,351104,325340,26378,99878,2.576828031935116,0.23488657582698758
3624,0.4153,4,40,4,351144,325300,26382,99874,2.5765112153085794,0.23490147563115335
3625,0.4154,1,8,1,351152,325292,26383,99873,2.576447851983272,0.234904096056825
3626,0.4155,1,32,1,351184,325260,26384,99872,2.576194398682043,0.23491997779513185
3627,0.4156,3,5,3,351189,325255,26387,99869,2.576154796603726,0.2349173417638148
3628,0.4157,6,57,6,351246,325198,26393,99863,2.575703332910911,0.2349380441865991
3629,0.4158,22,164,22,351410,325034,26415,99841,2.5744043847421114,0.2349891144454251
3630,0.4159,1,3,1,351413,325031,26416,99840,2.574380623495121,0.23498897312360692
3631,0.416,18,158,18,351571,324873,26434,99822,2.5731291978203017,0.23504397273337335
3632,0.4161,1,6,1,351577,324867,26435,99821,2.5730816753263213,0.23504549222017104
3633,0.4162,5,38,5,351615,324829,26440,99816,2.5727806995311115,0.23505751863321128
3634,0.4163,7,36,7,351651,324793,26447,99809,2.5724955645672285,0.2350648371887085
3635,0.4164,1,8,1,351659,324785,26448,99808,2.572432201241921,0.23506746460728273
3636,0.4165,8,39,8,351698,324746,26456,99800,2.572123305031048,0.23507464444371162
3637,0.4166,0,8,0,351706,324738,26456,99800,2.572059941705741,0.23507907419359397
3638,0.4167,99,829,99,352535,323909,26555,99701,2.5654939171207705,0.2353603550435542
3639,0.4168,2,14,2,352549,323895,26557,99699,2.5653830313014825,0.2353645235768212
3640,0.4169,1,5,1,352554,323890,26558,99698,2.565343429223166,0.23536549666185066
3641,0.417,17,72,17,352626,323818,26575,99681,2.5647731592953997,0.23537481788622877
3642,0.4171,0,28,0,352654,323790,26575,99681,2.564551387656824,0.235390380923369
3643,0.4172,3,17,3,352671,323773,26578,99678,2.5644167405905463,0.23539441399359076
3644,0.4173,8,62,8,352733,323711,26586,99670,2.5639256748194144,0.23541443758694888
3645,0.4174,2,12,2,352745,323699,26588,99668,2.5638306298314535,0.2354174982934428
3646,0.4175,43,450,43,353195,323249,26631,99625,2.5602664427829174,0.23559027038786967
3647,0.4176,2,7,2,353202,323242,26633,99623,2.560210999873273,0.2355905549052298
3648,0.4177,4,40,4,353242,323202,26637,99619,2.559894183246737,0.2356056108849844
3649,0.4178,2,31,2,353273,323171,26639,99617,2.559648650361171,0.23561927017796153
3650,0.4179,1,19,1,353292,323152,26640,99616,2.559498162463566,0.2356280513189267
3651,0.418,10,100,10,353392,323052,26650,99606,2.5587061208972246,0.23566571554306318
3652,0.4181,0,16,0,353408,323036,26650,99606,2.55857939424661,0.2356746371633676
3653,0.4182,4,27,4,353435,323009,26654,99602,2.558365543023698,0.23568245975613508
3654,0.4183,75,498,75,353933,322511,26729,99527,2.5544211760233178,0.23582473616119876
3655,0.4184,2,2,2,353935,322509,26731,99525,2.554405335191991,0.2358222323319922
3656,0.4185,6,42,6,353977,322467,26737,99519,2.5540726777341276,0.23583483812259173
3657,0.4186,5,19,5,353996,322448,26742,99514,2.5539221898365225,0.23583640233006764
3658,0.4187,3,35,3,354031,322413,26745,99511,2.5536449752883033,0.23585053232335682
3659,0.4188,7,30,7,354061,322383,26752,99504,2.5534073628184006,0.23585462457956752
3660,0.4189,0,15,0,354076,322368,26752,99504,2.5532885565834493,0.23586301058140857
3661,0.419,16,96,16,354172,322272,26768,99488,2.552528196679762,0.2358877086494689
3662,0.4191,0,5,0,354177,322267,26768,99488,2.552488594601445,0.23589050515109483
3663,0.4192,15,161,15,354338,322106,26783,99473,2.551213407679635,0.2359534037511356
3664,0.4193,8,71,8,354409,322035,26791,99465,2.550651058167533,0.23597864768683274
3665,0.4194,1,5,1,354414,322030,26792,99464,2.5506114560892157,0.2359796343482944
3666,0.4195,2,32,2,354446,321998,26794,99462,2.5503580027879864,0.23599392587671428
3667,0.4196,3,17,3,354463,321981,26797,99459,2.5502233557217084,0.235998006833713
3668,0.4197,6,29,6,354492,321952,26803,99453,2.549993663667469,0.23600336967999905
3669,0.4198,4,24,4,354516,321928,26807,99449,2.5498035736915474,0.2360095591358807
3670,0.4199,2,8,2,354524,321920,26809,99447,2.54974021036624,0.23601041372485268
3671,0.42,604,4854,604,359378,317066,27413,98843,2.511294512736028,0.23765535249297323
3672,0.4201,0,6,0,359384,317060,27413,98843,2.511246990242048,0.23765878101384216
3673,0.4202,3,21,3,359405,317039,27416,98840,2.511080661513116,0.23766528244994337
3674,0.4203,2,28,2,359433,317011,27418,98838,2.5108588898745405,0.23767761855865951
3675,0.4204,2,12,2,359445,316999,27420,98836,2.5107638448865797,0.2376808108985535
3676,0.4205,3,30,3,359475,316969,27423,98833,2.510526232416677,0.23769245939172973
3677,0.4206,2,15,2,359490,316954,27425,98831,2.510407426181726,0.23769736762990487
3678,0.4207,12,66,12,359556,316888,27437,98819,2.5098846787479405,0.23771310081379432
3679,0.4208,26,154,26,359710,316734,27463,98793,2.508664934735775,0.2377535033824517
3680,0.4209,0,4,0,359714,316730,27463,98793,2.5086332530731212,0.237755792098151
3681,0.421,10,97,10,359811,316633,27473,98783,2.50786497275377,0.23779295934677527
3682,0.4211,1,12,1,359823,316621,27474,98782,2.507769927765809,0.23779799375546157
3683,0.4212,0,28,0,359851,316593,27474,98782,2.5075481561272337,0.23781402347276556
3684,0.4213,5,32,5,359883,316561,27479,98777,2.5072947028260044,0.23782317052617385
3685,0.4214,2,14,2,359897,316547,27481,98775,2.5071838170067164,0.23782751696274215
3686,0.4215,4,33,4,359930,316514,27485,98771,2.506922443289824,0.23783907437061294
3687,0.4216,0,2,0,359932,316512,27485,98771,2.506906602458497,0.23784021980191822
3688,0.4217,68,447,68,360379,316065,27553,98703,2.503366176656951,0.2379715889364657
3689,0.4218,7,26,7,360405,316039,27560,98696,2.503160245849702,0.23797364582203093
3690,0.4219,1,10,1,360415,316029,27561,98695,2.503081041693068,0.23797754651286157
3691,0.422,7,109,7,360524,315920,27568,98688,2.502217716385756,0.23802724501215605
3692,0.4221,1,18,1,360542,315902,27569,98687,2.5020751489038147,0.2380357414210218
3693,0.4222,4,13,4,360555,315889,27573,98683,2.50197218350019,0.2380358538444468
3694,0.4223,5,46,5,360601,315843,27578,98678,2.501607844379673,0.23805307813114415
3695,0.4224,1,8,1,360609,315835,27579,98677,2.5015444810543657,0.23805583433048982
3696,0.4225,54,396,54,361005,315439,27633,98623,2.498407996451654,0.2381841366751839
3697,0.4226,0,4,0,361009,315435,27633,98623,2.498376314789,0.2381864376488318
3698,0.4227,6,64,6,361073,315371,27639,98617,2.4978694081865416,0.2382122187116535
3699,0.4228,2,20,2,361093,315351,27641,98615,2.497710999873273,0.23822004705700467
3700,0.4229,1,14,1,361107,315337,27642,98614,2.4976001140539856,0.2382262634949547
3701,0.423,3,59,3,361166,315278,27645,98611,2.497132809529844,0.23825470113967753
3702,0.4231,0,2,0,361168,315276,27645,98611,2.4971169686985175,0.23825585244281652
3703,0.4232,4,19,4,361187,315257,27649,98607,2.4969664808009124,0.23825942821796534
3704,0.4233,89,856,89,362043,314401,27738,98518,2.49018660499303,0.23858916639825245
3705,0.4234,0,6,0,362049,314395,27738,98518,2.4901390824990495,0.23859263331500824
3706,0.4235,7,57,7,362106,314338,27745,98511,2.489687618806235,0.23861266467885353
3707,0.4236,1,20,1,362126,314318,27746,98510,2.4895292104929667,0.2386223802649045
3708,0.4237,12,39,12,362165,314279,27758,98498,2.4892203142820937,0.2386227914830526
3709,0.4238,4,28,4,362193,314251,27762,98494,2.4889985426435177,0.2386316006250833
3710,0.4239,1,9,1,362202,314242,27763,98493,2.4889272589025473,0.23863495947763091
3711,0.424,22,156,22,362358,314086,27785,98471,2.4876916740590547,0.23868459388642055
3712,0.4241,0,3,0,362361,314083,27785,98471,2.4876679128120642,0.23868632954716232
3713,0.4242,29,156,29,362517,313927,27814,98442,2.4864323279685716,0.2387230853919669
3714,0.4243,3,49,3,362566,313878,27817,98439,2.4860442276010644,0.2387459163701715
3715,0.4244,2,3,2,362569,313875,27819,98437,2.4860204663540744,0.23874396088399077
3716,0.4245,4,19,4,362588,313856,27823,98433,2.4858699784564693,0.23874757754875828
3717,0.4246,1,12,1,362600,313844,27824,98432,2.4857749334685084,0.23875268024333213
3718,0.4247,4,44,4,362644,313800,27828,98428,2.4854264351793183,0.2387707773368136
3719,0.4248,3,20,3,362664,313780,27831,98425,2.48526802686605,0.23877682221224875
3720,0.4249,0,9,0,362673,313771,27831,98425,2.485196743125079,0.23878203573057477
3721,0.425,240,1594,240,364267,312177,28071,98185,2.4725716005575973,0.2392643568361593
3722,0.4251,0,8,0,364275,312169,28071,98185,2.4725082372322897,0.23926902138153885
3723,0.4252,4,17,4,364292,312152,28075,98181,2.4723735901660118,0.23927151849839035
3724,0.4253,4,51,4,364343,312101,28079,98177,2.471969648967178,0.2392938446614247
3725,0.4254,2,20,2,364363,312081,28081,98175,2.4718112406539094,0.2393018018018018
3726,0.4255,5,21,5,364384,312060,28086,98170,2.4716449119249777,0.23930478024522828
3727,0.4256,1,4,1,364388,312056,28087,98169,2.4716132302623244,0.23930525930891583
3728,0.4257,3,46,3,364434,312010,28090,98166,2.471248891141807,0.23932653300046808
3729,0.4258,15,153,15,364587,311857,28105,98151,2.470037067545305,0.2393880119412304
3730,0.4259,1,8,1,364595,311849,28106,98150,2.4699737042199974,0.23939082778250678
3731,0.426,18,145,18,364740,311704,28124,98132,2.4688252439488023,0.23944211831073892
3732,0.4261,0,12,0,364752,311692,28124,98132,2.4687301989608414,0.239449129382369
3733,0.4262,7,47,7,364799,311645,28131,98125,2.468357939424661,0.23946360153256704
3734,0.4263,7,29,7,364828,311616,28138,98118,2.468128247370422,0.23946755700039538
3735,0.4264,3,9,3,364837,311607,28141,98115,2.468056963629451,0.23946724852460938
3736,0.4265,7,38,7,364875,311569,28148,98108,2.4677559878342414,0.23947646560583094
3737,0.4266,0,3,0,364878,311566,28148,98108,2.4677322265872514,0.23947821926702695
3738,0.4267,112,828,112,365706,310738,28260,97996,2.4611741224179444,0.2397549506525026
3739,0.4268,5,20,5,365726,310718,28265,97991,2.461015714104676,0.23975738239187294
3740,0.4269,0,8,0,365734,310710,28265,97991,2.460952350779369,0.23976207545369352
3741,0.427,16,75,16,365809,310635,28281,97975,2.460358319604613,0.23977631482342576
3742,0.4271,4,24,4,365833,310611,28285,97971,2.460168229628691,0.23978295666475763
3743,0.4272,2,20,2,365853,310591,28287,97969,2.4600098213154227,0.2397909731740748
3744,0.4273,11,58,11,365911,310533,28298,97958,2.4595504372069446,0.2398045489374307
3745,0.4274,1,6,1,365917,310527,28299,97957,2.459502914712964,0.23980621027996202
3746,0.4275,71,409,71,366326,310118,28370,97886,2.4562634647066277,0.23991431456554346
3747,0.4276,2,13,2,366339,310105,28372,97884,2.4561604993030035,0.2399182330896176
3748,0.4277,8,42,8,366381,310063,28380,97876,2.45582784184514,0.23992802845523473
3749,0.4278,5,20,5,366401,310043,28385,97871,2.4556694335318716,0.23993047554141314
3750,0.4279,4,6,4,366407,310037,28389,97867,2.455621911037891,0.2399265513454146
3751,0.428,16,100,16,366507,309937,28405,97851,2.45482986947155,0.23995556514659577
3752,0.4281,1,5,1,366512,309932,28406,97850,2.454790267393233,0.239956643500694
3753,0.4282,4,27,4,366539,309905,28410,97846,2.4545764161703207,0.23996507672574685
3754,0.4283,63,472,63,367011,309433,28473,97783,2.450837979977189,0.24012563357039016
3755,0.4284,0,3,0,367014,309430,28473,97783,2.450814218730199,0.24012740261239204
3756,0.4285,10,37,10,367051,309393,28483,97773,2.4505211633506527,0.24013056099969055
3757,0.4286,2,10,2,367061,309383,28485,97771,2.4504419591940185,0.24013272619205508
3758,0.4287,5,36,5,367097,309347,28490,97766,2.4501568242301355,0.240144628149924
3759,0.4288,1,21,1,367118,309326,28491,97765,2.4499904955012037,0.24015514958571915
3760,0.4289,1,13,1,367131,309313,28492,97764,2.4498875300975795,0.2401609523505381
3761,0.429,16,97,16,367228,309216,28508,97748,2.4491192497782284,0.24018832132571924
3762,0.4291,0,5,0,367233,309211,28508,97748,2.4490796476999113,0.240191272339474
3763,0.4292,31,141,31,367374,309070,28539,97717,2.44796286909137,0.24021662442506767
3764,0.4293,9,75,9,367449,308995,28548,97708,2.447368837916614,0.2402441093377723
3765,0.4294,1,4,1,367453,308991,28549,97707,2.44733715625396,0.24024460410427392
3766,0.4295,7,42,7,367495,308949,28556,97700,2.4470044987960966,0.24025633900489118
3767,0.4296,2,6,2,367501,308943,28558,97698,2.446956976302116,0.24025614731421574
3768,0.4297,3,30,3,367531,308913,28561,97695,2.446719363832214,0.2402682682091843
3769,0.4298,6,22,6,367553,308891,28567,97689,2.446545114687619,0.24027005755324907
3770,0.4299,1,4,1,367557,308887,28568,97688,2.446513433024965,0.2402705527885384
3771,0.43,606,4751,606,372308,304136,29174,97082,2.408883538208085,0.24196820681026274
3772,0.4301,1,8,1,372316,304128,29175,97081,2.408820174882778,0.2419711422226321
3773,0.4302,4,25,4,372341,304103,29179,97077,2.4086221644911925,0.24197866294431428
3774,0.4303,7,39,7,372380,304064,29186,97070,2.4083132682803194,0.24198896129472944
3775,0.4304,1,4,1,372384,304060,29187,97069,2.4082815866176657,0.24198948467949213
3776,0.4305,4,21,4,372405,304039,29191,97065,2.408115257888734,0.24199459491802625
3777,0.4306,0,5,0,372410,304034,29191,97065,2.408075655810417,0.24199761156223276
3778,0.4307,10,68,10,372478,303966,29201,97055,2.407537067545305,0.24201974460190365
3779,0.4308,25,132,25,372610,303834,29226,97030,2.406491572677734,0.24205216731859183
3780,0.4309,1,8,1,372618,303826,29227,97029,2.406428209352427,0.24205510720834217
3781,0.431,18,84,18,372702,303742,29245,97011,2.4057628944367,0.2420717998368072
3782,0.4311,0,11,0,372713,303731,29245,97011,2.4056757698644025,0.24207844448547944
3783,0.4312,3,35,3,372748,303696,29248,97008,2.405398555316183,0.24209391471011021
3784,0.4313,5,36,5,372784,303660,29253,97003,2.4051134203523,0.24210620895865104
3785,0.4314,2,21,2,372805,303639,29255,97001,2.4049470916233684,0.2421151158146965
3786,0.4315,2,47,2,372852,303592,29257,96999,2.404574832087188,0.2421397385363126
3787,0.4316,2,3,2,372855,303589,29259,96997,2.404551070840198,0.24213776816963148
3788,0.4317,59,423,59,373278,303166,29318,96938,2.4012007350145734,0.24228200667826366
3789,0.4318,6,22,6,373300,303144,29324,96932,2.4010264858699784,0.24228396604645117
3790,0.4319,2,10,2,373310,303134,29326,96930,2.400947281713344,0.2422862342025276
3791,0.432,13,114,13,373424,303020,29339,96917,2.400044354327715,0.24233066708006512
3792,0.4321,4,14,4,373438,303006,29343,96913,2.3999334685084275,0.24233157214335904
3793,0.4322,2,21,2,373459,302985,29345,96911,2.3997671397794957,0.2423405085322184
3794,0.4323,10,40,10,373499,302945,29355,96901,2.399450323152959,0.24234580313420667
3795,0.4324,3,10,3,373509,302935,29358,96898,2.3993711189963247,0.24234617952995374
3796,0.4325,52,416,52,373925,302519,29410,96846,2.3960762260803445,0.24249996870031174
3797,0.4326,1,11,1,373936,302508,29411,96845,2.395989101508047,0.24250475143544684
3798,0.4327,6,56,6,373992,302452,29417,96839,2.395545558230896,0.24252737978066122
3799,0.4328,2,9,2,374001,302443,29419,96837,2.395474274489925,0.24252905229412944
3800,0.4329,0,20,0,374021,302423,29419,96837,2.395315866176657,0.2425412012222612
3801,0.433,8,70,8,374091,302353,29427,96829,2.394761437080218,0.24256855269025157
3802,0.4331,0,6,0,374097,302347,29427,96829,2.3947139145862373,0.24257219872938252
3803,0.4332,3,24,3,374121,302323,29430,96826,2.3945238246103155,0.2425810912716805
3804,0.4333,125,826,125,374947,301497,29555,96701,2.3879815612723356,0.2428465235887674
3805,0.4334,0,5,0,374952,301492,29555,96701,2.3879419591940185,0.24284957294578258
3806,0.4335,6,42,6,374994,301450,29561,96695,2.387609301736155,0.24286378078338294
3807,0.4336,2,14,2,375008,301436,29563,96693,2.3874984159168675,0.2428685174905621
3808,0.4337,4,37,4,375045,301399,29567,96689,2.387205360537321,0.24288348304897409
3809,0.4338,9,20,9,375065,301379,29576,96680,2.3870469522240527,0.242878568252445
3810,0.4339,0,7,0,375072,301372,29576,96680,2.386991509314409,0.24288283942801442
3811,0.434,22,177,22,375249,301195,29598,96658,2.3855895957419846,0.24294902891268885
3812,0.4341,1,7,1,375256,301188,29599,96657,2.385534152832341,0.24295140067111565
3813,0.4342,35,174,35,375430,301014,29634,96622,2.3841560005069065,0.24299107726664587
3814,0.4343,8,54,8,375484,300960,29642,96614,2.383728298061082,0.24300884866716638
3815,0.4344,3,7,3,375491,300953,29645,96611,2.3836728551514383,0.24300741515831414
3816,0.4345,4,27,4,375518,300926,29649,96607,2.383459003928526,0.24301630304905505
3817,0.4346,1,7,1,375525,300919,29650,96606,2.3834035610188824,0.2430186780705616
3818,0.4347,6,43,6,375568,300876,29656,96600,2.3830629831453556,0.2430335416477976
3819,0.4348,6,22,6,375590,300854,29662,96594,2.3828887340007605,0.24303556691693
3820,0.4349,0,6,0,375596,300848,29662,96594,2.38284121150678,0.2430392359136679
3821,0.435,188,1494,188,377090,299354,29850,96406,2.3710081105056395,0.24359712957347887
3822,0.4351,2,7,2,377097,299347,29852,96404,2.3709526675959953,0.24359761567248092
3823,0.4352,4,30,4,377127,299317,29856,96400,2.370715055126093,0.24360843734284854
3824,0.4353,4,43,4,377170,299274,29860,96396,2.3703744772525663,0.24362726514519675
3825,0.4354,0,12,0,377182,299262,29860,96396,2.3702794322646055,0.2436346541710265
3826,0.4355,3,30,3,377212,299232,29863,96393,2.370041819794703,0.2436473933649289
3827,0.4356,3,7,3,377219,299225,29866,96390,2.369986376885059,0.24364596893444385
3828,0.4357,14,56,14,377275,299169,29880,96376,2.3695428336079076,0.24365369300585268
3829,0.4358,25,153,25,377428,299016,29905,96351,2.3683310100114054,0.24370015706925463
3830,0.4359,0,3,0,377431,299013,29905,96351,2.368307248764415,0.24370200625246607
3831,0.436,22,159,22,377590,298854,29927,96329,2.3670479026739324,0.24375795517519733
3832,0.4361,1,3,1,377593,298851,29928,96328,2.367024141426942,0.24375789199324863
3833,0.4362,2,44,2,377637,298807,29930,96326,2.366675643137752,0.24378120784647195
3834,0.4363,3,38,3,377675,298769,29933,96323,2.366374667342542,0.24379891265831755
3835,0.4364,0,5,0,377680,298764,29933,96323,2.366335065264225,0.24380199804093783
3836,0.4365,4,37,4,377717,298727,29937,96319,2.3660420098846786,0.2438171757213084
3837,0.4366,2,5,2,377722,298722,29939,96317,2.3660024078063615,0.2438164333141791
3838,0.4367,109,840,109,378562,297882,30048,96208,2.359349258649094,0.24412697607145575
3839,0.4368,2,20,2,378582,297862,30050,96206,2.3591908503358257,0.2441355299085437
3840,0.4369,1,8,1,378590,297854,30051,96205,2.359127487010518,0.2441385680824445
3841,0.437,14,67,14,378657,297787,30065,96191,2.3585968191610696,0.24415322682992452
3842,0.4371,5,15,5,378672,297772,30070,96186,2.3584780129261183,0.24415293000776733
3843,0.4372,1,10,1,378682,297762,30071,96185,2.358398808769484,0.24415720896465767
3844,0.4373,12,42,12,378724,297720,30083,96173,2.358066151311621,0.244160216099296
3845,0.4374,4,15,4,378739,297705,30087,96169,2.3579473450766697,0.24416183855750823
3846,0.4375,51,420,51,379159,297285,30138,96118,2.3546207704980358,0.24432452218208808
3847,0.4376,3,6,3,379165,297279,30141,96115,2.3545732480040553,0.24432248585387678
3848,0.4377,3,40,3,379205,297239,30144,96112,2.3542564313775185,0.24434156770924695
3849,0.4378,5,31,5,379236,297208,30149,96107,2.354010898491953,0.24435121976024307
3850,0.4379,3,13,3,379249,297195,30152,96104,2.3539079330883284,0.24435353255411277
3851,0.438,18,103,18,379352,297092,30170,96086,2.3530921302749968,0.24438295123328366
3852,0.4381,0,6,0,379358,297086,30170,96086,2.3530446077810163,0.2443866806384992
3853,0.4382,5,27,5,379385,297059,30175,96081,2.352830756558104,0.2443938546065015
3854,0.4383,71,445,71,379830,296614,30246,96010,2.349306171587885,0.2445342108480378
3855,0.4384,0,6,0,379836,296608,30246,96010,2.3492586490939042,0.24453794782715005
3856,0.4385,7,46,7,379882,296562,30253,96003,2.3488943099733874,0.2445531313285698
3857,0.4386,5,12,5,379894,296550,30258,95998,2.3487992649854266,0.2445509848477129
3858,0.4387,8,48,8,379942,296502,30266,95990,2.3484190850335827,0.24456549432854682
3859,0.4388,4,34,4,379976,296468,30270,95986,2.3481497909010263,0.244578982504956
3860,0.4389,0,7,0,379983,296461,30270,95986,2.3480943479913825,0.24458334501219273
3861,0.439,14,86,14,380069,296375,30284,95972,2.347413192244329,0.2446100008410922
3862,0.4391,0,7,0,380076,296368,30284,95972,2.347357749334685,0.24461436509150228
3863,0.4392,20,142,20,380218,296226,30304,95952,2.3462330503104805,0.2446644125881615
3864,0.4393,9,63,9,380281,296163,30313,95943,2.3457340641236852,0.2446863858242414
3865,0.4394,1,3,1,380284,296160,30314,95942,2.345710302876695,0.24468633161779332
3866,0.4395,5,28,5,380312,296132,30319,95937,2.3454885312381193,0.24469417372962413
3867,0.4396,0,6,0,380318,296126,30319,95937,2.345441008744139,0.24469791844678024
3868,0.4397,6,29,6,380347,296097,30325,95931,2.3452113166899,0.2447044598855184
3869,0.4398,3,21,3,380368,296076,30328,95928,2.3450449879609683,0.2447117886552178
3870,0.4399,0,9,0,380377,296067,30328,95928,2.3449737042199974,0.24471740710978457
3871,0.44,646,4723,646,385100,291344,30974,95282,2.307565581041693,0.24644488472063442
3872,0.4401,0,9,0,385109,291335,30974,95282,2.3074942973007224,0.24645062167468063
3873,0.4402,2,19,2,385128,291316,30976,95280,2.3073438094031173,0.24645883558029572
3874,0.4403,4,31,4,385159,291285,30980,95276,2.307098276517552,0.24647080279697123
3875,0.4404,0,17,0,385176,291268,30980,95276,2.3069636294512734,0.24648164245208826
3876,0.4405,4,26,4,385202,291242,30984,95272,2.306757698644025,0.24649042466767052
3877,0.4406,0,18,0,385220,291224,30984,95272,2.3066151311620833,0.24650190428878954
3878,0.4407,11,59,11,385279,291165,30995,95261,2.306147826637942,0.2465180914327711
3879,0.4408,23,151,23,385430,291014,31018,95238,2.3049518438727663,0.24656959705063017
3880,0.4409,1,3,1,385433,291011,31019,95237,2.3049280826257763,0.24656956152523768
3881,0.441,12,82,12,385515,290929,31031,95225,2.3042786085413764,0.24659850733127198
3882,0.4411,1,2,1,385517,290927,31032,95224,2.3042627677100493,0.2465978334900078
3883,0.4412,9,31,9,385548,290896,31041,95215,2.3040172348244834,0.2466000709640492
3884,0.4413,7,28,7,385576,290868,31048,95208,2.303795463185908,0.2466042955273055
3885,0.4414,4,11,4,385587,290857,31052,95204,2.3037083386136104,0.24660351602466968
3886,0.4415,5,34,5,385621,290823,31057,95199,2.3034390444810544,0.24661547787431803
3887,0.4416,4,9,4,385630,290814,31061,95195,2.3033677607400835,0.24661342093060007
3888,0.4417,62,447,62,386077,290367,31123,95133,2.2998273349385374,0.2467782101167315
3889,0.4418,5,24,5,386101,290343,31128,95128,2.2996372449626157,0.2467838047479577
3890,0.4419,0,6,0,386107,290337,31128,95128,2.2995897224686352,0.24678764608978765
3891,0.442,12,88,12,386195,290249,31140,95116,2.2988927258902545,0.24682054675437573
3892,0.4421,2,15,2,386210,290234,31142,95114,2.2987739196553036,0.24682624536782338
3893,0.4422,3,16,3,386226,290218,31145,95111,2.298647193004689,0.24683063044826628
3894,0.4423,6,42,6,386268,290176,31151,95105,2.2983145355468255,0.24684580864356145
3895,0.4424,2,13,2,386281,290163,31153,95103,2.2982115701432013,0.2468502281540546
3896,0.4425,61,396,61,386677,289767,31214,95042,2.295075085540489,0.24698486781754064
3897,0.4426,0,7,0,386684,289760,31214,95042,2.2950196426308453,0.2469893607621582
3898,0.4427,8,54,8,386738,289706,31222,95034,2.294591940185021,0.24700836928835057
3899,0.4428,1,15,1,386753,289691,31223,95033,2.2944731339500697,0.24701604266955013
3900,0.4429,5,23,5,386776,289668,31228,95028,2.2942909643898113,0.24702102439328716
3901,0.443,10,61,10,386837,289607,31238,95018,2.2938078190343427,0.24704062398440038
3902,0.4431,2,11,2,386848,289596,31240,95016,2.293720694462045,0.24704377398521107
3903,0.4432,4,21,4,386869,289575,31244,95012,2.293554365733114,0.24704943224809991
3904,0.4433,131,804,131,387673,288771,31375,94881,2.2871863515397286,0.24731006224390853
3905,0.4434,1,5,1,387678,288766,31376,94880,2.287146749461412,0.2473113234596477
3906,0.4435,1,42,1,387720,288724,31377,94879,2.2868140920035485,0.24733643897466911
3907,0.4436,2,12,2,387732,288712,31379,94877,2.2867190470155876,0.24734025219701294
3908,0.4437,3,29,3,387761,288683,31382,94874,2.2864893549613483,0.24735306616747968
3909,0.4438,4,32,4,387793,288651,31386,94870,2.286235901660119,0.24736585480325718
3910,0.4439,2,11,2,387804,288640,31388,94868,2.2861487770878215,0.24736902489648194
3911,0.444,17,186,17,387990,288454,31405,94851,2.2846755797744267,0.24745568150689398
3912,0.4441,0,5,0,387995,288449,31405,94851,2.2846359776961096,0.24745890947038873
3913,0.4442,21,139,21,388134,288310,31426,94830,2.283535039918895,0.24750743853421725
3914,0.4443,6,54,6,388188,288256,31432,94824,2.2831073374730706,0.24753054192335805
3915,0.4444,1,9,1,388197,288247,31433,94823,2.2830360537320997,0.24753439319184484
3916,0.4445,7,30,7,388227,288217,31440,94816,2.2827984412621976,0.24754002918808563
3917,0.4446,4,9,4,388236,288208,31444,94812,2.2827271575212267,0.24753798757245052
3918,0.4447,4,28,4,388264,288180,31448,94808,2.282505385882651,0.24754822605408003
3919,0.4448,2,30,2,388294,288150,31450,94806,2.2822677734127486,0.24756368877886756
3920,0.4449,0,8,0,388302,288142,31450,94806,2.2822044100874415,0.24756886052414426
3921,0.445,217,1586,217,389888,286556,31667,94589,2.269642630845267,0.24817064371826994
3922,0.4451,1,10,1,389898,286546,31668,94588,2.2695634266886326,0.24817518248175183
3923,0.4452,2,23,2,389921,286523,31670,94586,2.2693812571283742,0.2481862144425873
3924,0.4453,7,43,7,389964,286480,31677,94579,2.2690406792548474,0.24820040991027637
3925,0.4454,1,14,1,389978,286466,31678,94578,2.2689297934355594,0.2482075560827621
3926,0.4455,5,29,5,390007,286437,31683,94573,2.2687001013813206,0.2482165822419359
3927,0.4456,2,4,2,390011,286433,31685,94571,2.268668419718667,0.2482152418347314
3928,0.4457,9,52,9,390063,286381,31694,94562,2.268256558104169,0.24823136269730642
3929,0.4458,10,156,10,390219,286225,31704,94552,2.2670209732606765,0.24831331724342595
3930,0.4459,0,5,0,390224,286220,31704,94552,2.2669813711823594,0.2483165778996355
3931,0.446,20,156,20,390380,286064,31724,94532,2.2657457863388673,0.24837885842205384
3932,0.4461,0,7,0,390387,286057,31724,94532,2.265690343429223,0.24838342674118274
3933,0.4462,3,21,3,390408,286036,31727,94529,2.2655240147002913,0.24839120780944124
3934,0.4463,4,32,4,390440,286004,31731,94525,2.265270561399062,0.24840419521245424
3935,0.4464,2,6,2,390446,285998,31733,94523,2.2652230389050816,0.24840416166256266
3936,0.4465,6,47,6,390493,285951,31739,94517,2.2648507793689014,0.24842299483793642
3937,0.4466,1,5,1,390498,285946,31740,94516,2.2648111772905843,0.24842428415978468
3938,0.4467,130,799,130,391297,285147,31870,94386,2.2584827651755166,0.248689837247354
3939,0.4468,2,27,2,391324,285120,31872,94384,2.2582689139526044,0.248703570976854
3940,0.4469,0,3,0,391327,285117,31872,94384,2.258245152705614,0.24870553700780762
3941,0.447,9,61,9,391388,285056,31881,94375,2.257762007350146,0.2487277001615577
3942,0.4471,6,22,6,391410,285034,31887,94369,2.257587758205551,0.248730241985435
3943,0.4472,3,22,3,391432,285012,31890,94366,2.2574135090609557,0.2487387249656016
3944,0.4473,5,47,5,391479,284965,31895,94361,2.257041249524775,0.24875964210204415
3945,0.4474,0,9,0,391488,284956,31895,94361,2.2569699657838043,0.2487655443863576
3946,0.4475,61,428,61,391916,284528,31956,94300,2.2535800278798632,0.24892563379686825
3947,0.4476,4,9,4,391925,284519,31960,94296,2.2535087441388924,0.24892361706901786
3948,0.4477,4,38,4,391963,284481,31964,94292,2.2532077683436826,0.24894065838906151
3949,0.4478,4,18,4,391981,284463,31968,94288,2.2530652008617413,0.24894455724209308
3950,0.4479,1,14,1,391995,284449,31969,94287,2.2529543150424534,0.2489517764353006
3951,0.448,20,87,20,392082,284362,31989,94267,2.2522652388797364,0.24896930768641598
3952,0.4481,1,5,1,392087,284357,31990,94266,2.2522256368014193,0.24897061192796
3953,0.4482,5,28,5,392115,284329,31995,94261,2.252003865162844,0.2489791066853324
3954,0.4483,61,427,61,392542,283902,32056,94200,2.248621847674566,0.24913912118952028
3955,0.4484,0,6,0,392548,283896,32056,94200,2.2485743251805856,0.2491430747746604
3956,0.4485,6,39,6,392587,283857,32062,94194,2.248265428969712,0.24915685978875865
3957,0.4486,0,16,0,392603,283841,32062,94194,2.2481387023190975,0.2491674051344452
3958,0.4487,8,52,8,392655,283789,32070,94186,2.2477268407046003,0.24918579271115815
3959,0.4488,8,23,8,392678,283766,32078,94178,2.247544671144342,0.2491850644539932
3960,0.4489,1,8,1,392686,283758,32079,94177,2.2474813078190343,0.24918835249447657
3961,0.449,15,106,15,392792,283652,32094,94162,2.2466417437587123,0.2492284563303636
3962,0.4491,1,2,1,392794,283650,32095,94161,2.2466259029273856,0.2492277884974233
3963,0.4492,28,150,28,392944,283500,32123,94133,2.2454378405778734,0.24927111772541066
3964,0.4493,15,58,15,393002,283442,32138,94118,2.2449784564693953,0.24927958470176925
3965,0.4494,1,8,1,393010,283434,32139,94117,2.244915093144088,0.24928287833961504
3966,0.4495,3,29,3,393039,283405,32142,94114,2.2446854010898494,0.2492960619200623
3967,0.4496,1,8,1,393047,283397,32143,94113,2.244622037764542,0.24929935630844216
3968,0.4497,3,36,3,393083,283361,32146,94110,2.244336902800659,0.2493171660869312
3969,0.4498,4,31,4,393114,283330,32150,94106,2.2440913699150933,0.24932968768215008
3970,0.4499,0,4,0,393118,283326,32150,94106,2.2440596882524395,0.2493323300621039
3971,0.45,689,4562,689,397680,278764,32839,93417,2.2079267519959447,0.2509988419613038
3972,0.4501,2,6,2,397686,278758,32841,93415,2.2078792295019642,0.2509988634317911
3973,0.4502,3,29,3,397715,278729,32844,93412,2.2076495374477254,0.25101238509059737
3974,0.4503,2,27,2,397742,278702,32846,93410,2.2074356862248132,0.2510265726447951
3975,0.4504,0,9,0,397751,278693,32846,93410,2.2073644024838424,0.2510326441872277
3976,0.4505,3,33,3,397784,278660,32849,93407,2.2071030287669497,0.2510488702303617
3977,0.4506,0,4,0,397788,278656,32849,93407,2.207071347104296,0.2510515692234917
3978,0.4507,7,53,7,397841,278603,32856,93400,2.206651565074135,0.2510732440329782
3979,0.4508,28,159,28,398000,278444,32884,93372,2.2053922189836523,0.25112421197581597
3980,0.4509,1,8,1,398008,278436,32885,93371,2.205328855658345,0.2511276011479074
3981,0.451,11,87,11,398095,278349,32896,93360,2.204639779495628,0.2511642171698829
3982,0.4511,0,9,0,398104,278340,32896,93360,2.2045684957546574,0.2511702986279257
3983,0.4512,4,22,4,398126,278318,32900,93356,2.204394246610062,0.251177106819417
3984,0.4513,9,54,9,398180,278264,32909,93347,2.2039665441642375,0.25119547053235775
3985,0.4514,1,11,1,398191,278253,32910,93346,2.20387941959194,0.2512008912833458
3986,0.4515,3,35,3,398226,278218,32913,93343,2.2036022050437207,0.25121850786277355
3987,0.4516,2,4,2,398230,278214,32915,93341,2.203570523381067,0.2512171818438724
3988,0.4517,68,437,68,398667,277777,32983,93273,2.200109301736155,0.25137582536046355
3989,0.4518,5,24,5,398691,277753,32988,93268,2.1999192117602333,0.2513819972454389
3990,0.4519,0,11,0,398702,277742,32988,93268,2.1998320871879358,0.2513894504191262
3991,0.452,12,99,12,398801,277643,33000,93256,2.1990479660372575,0.2514323306344854
3992,0.4521,2,20,2,398821,277623,33002,93254,2.1988895577239895,0.25144185268970576
3993,0.4522,2,26,2,398847,277597,33004,93252,2.1986836269167407,0.2514554441295514
3994,0.4523,13,46,13,398893,277551,33017,93239,2.1983192877962234,0.25146039537204345
3995,0.4524,0,7,0,398900,277544,33017,93239,2.1982638448865797,0.2514651426845352
3996,0.4525,58,411,58,399311,277133,33075,93181,2.1950085540489166,0.2516269976290391
3997,0.4526,1,9,1,399320,277124,33076,93180,2.1949372703079457,0.2516310922917387
3998,0.4527,9,46,9,399366,277078,33085,93171,2.194572931187429,0.2516441637924748
3999,0.4528,1,20,1,399386,277058,33086,93170,2.1944145228741605,0.2516557364650972
4000,0.4529,3,15,3,399401,277043,33089,93167,2.194295716639209,0.25165986872315715
4001,0.453,7,54,7,399455,276989,33096,93160,2.193868014193385,0.2516824305887629
4002,0.4531,0,7,0,399462,276982,33096,93160,2.193812571283741,0.2516871903215523
4003,0.4532,4,28,4,399490,276954,33100,93156,2.1935907996451656,0.2516981437950879
4004,0.4533,132,799,132,400289,276155,33232,93024,2.1872623875300974,0.25197532904092595
4005,0.4534,0,4,0,400293,276151,33232,93024,2.187230705867444,0.2519780591860229
4006,0.4535,9,40,9,400333,276111,33241,93015,2.1869138892409072,0.25198712634710096
4007,0.4536,0,8,0,400341,276103,33241,93015,2.1868505259156,0.2519925877361711
4008,0.4537,7,32,7,400373,276071,33248,93008,2.186597072614371,0.2520002492691267
4009,0.4538,2,33,2,400406,276038,33250,93006,2.1863356988974783,0.2520187294739923
4010,0.4539,0,7,0,400413,276031,33250,93006,2.186280255987834,0.25202350983776695
4011,0.454,24,143,24,400556,275888,33274,92982,2.185147636547966,0.2520725458833735
4012,0.4541,1,4,1,400560,275884,33275,92981,2.1851159548853123,0.25207325173166334
4013,0.4542,25,142,25,400702,275742,33300,92956,2.1839912558611076,0.25211962093637613
4014,0.4543,7,54,7,400756,275688,33307,92949,2.1835635534152833,0.2521423514188755
4015,0.4544,0,9,0,400765,275679,33307,92949,2.1834922696743124,0.2521485074383932
4016,0.4545,3,34,3,400799,275645,33310,92946,2.1832229755417565,0.2521656795743792
4017,0.4546,2,9,2,400808,275636,33312,92944,2.1831516918007856,0.2521677790438982
4018,0.4547,7,44,7,400852,275592,33319,92937,2.1828031935115955,0.25218368160985977
4019,0.4548,8,29,8,400881,275563,33327,92929,2.1825735014573566,0.25218729307556204
4020,0.4549,1,1,1,400882,275562,33328,92928,2.182565581041693,0.252185948058292
4021,0.455,228,1505,228,402387,274057,33556,92700,2.1706453554682548,0.2527559119526008
4022,0.4551,1,5,1,402392,274052,33557,92699,2.170605753389938,0.25275732036177134
4023,0.4552,5,23,5,402415,274029,33562,92694,2.1704235838296793,0.252762984596003
4024,0.4553,3,27,3,402442,274002,33565,92691,2.170209732606767,0.25277548248807585
4025,0.4554,3,7,3,402449,273995,33568,92688,2.1701542896971233,0.25277419460405853
4026,0.4555,3,26,3,402475,273969,33571,92685,2.1699483588898745,0.2527860053347297
4027,0.4556,4,6,4,402481,273963,33575,92681,2.169900836395894,0.2527819901593917
4028,0.4557,5,57,5,402538,273906,33580,92676,2.1694493727030792,0.25281110365484394
4029,0.4558,17,154,17,402692,273752,33597,92659,2.1682296286909137,0.2528826918405834
4030,0.4559,2,7,2,402699,273745,33599,92657,2.16817418578127,0.2528834449593616
4031,0.456,21,150,21,402849,273595,33620,92636,2.166986123431758,0.2529441800393741
4032,0.4561,1,9,1,402858,273586,33621,92635,2.166914839690787,0.25294835632036394
4033,0.4562,5,28,5,402886,273558,33626,92630,2.1666930680522114,0.2529574972418539
4034,0.4563,4,39,4,402925,273519,33630,92626,2.1663841718413384,0.252976279889115
4035,0.4564,0,10,0,402935,273509,33630,92626,2.166304967684704,0.2529831892607918
4036,0.4565,3,43,3,402978,273466,33633,92623,2.1659643898111773,0.2530067825037081
4037,0.4566,1,9,1,402987,273457,33634,92622,2.1658931060702065,0.2530109621147348
4038,0.4567,116,826,116,403813,272631,33750,92506,2.1593508427322265,0.2533460043764395
4039,0.4568,6,32,6,403845,272599,33756,92500,2.1590973894309973,0.25335593907405934
4040,0.4569,1,6,1,403851,272593,33757,92499,2.159049866937017,0.2533580576950467
4041,0.457,9,61,9,403912,272532,33766,92490,2.1585667215815487,0.2533819879349738
4042,0.4571,2,21,2,403933,272511,33768,92488,2.158400392852617,0.2533924750478768
4043,0.4572,2,15,2,403948,272496,33770,92486,2.1582815866176657,0.2533987977489301
4044,0.4573,6,62,6,404010,272434,33776,92480,2.157790520846534,0.25342957518757847
4045,0.4574,3,10,3,404020,272424,33779,92477,2.1577113166899,0.25343038248730476
4046,0.4575,49,396,49,404416,272028,33828,92428,2.154574832087188,0.2536053734881577
4047,0.4576,0,10,0,404426,272018,33828,92428,2.1544956279305536,0.25361233214248474
4048,0.4577,8,44,8,404470,271974,33836,92420,2.1541471296413635,0.2536265690433981
4049,0.4578,2,16,2,404486,271958,33838,92418,2.154020402990749,0.2536336092388083
4050,0.4579,1,14,1,404500,271944,33839,92417,2.1539095171714613,0.2536413062868968
4051,0.458,22,90,22,404590,271854,33861,92395,2.153196679761754,0.2536588981713059
4052,0.4581,1,7,1,404597,271847,33862,92394,2.15314123685211,0.2536617239684714
4053,0.4582,5,31,5,404628,271816,33867,92389,2.152895703966544,0.2536730687387598
4054,0.4583,68,431,68,405059,271385,33935,92321,2.1494820048156127,0.2538341407620441
4055,0.4584,3,2,3,405061,271383,33938,92318,2.149466163984286,0.2538293818273802
4056,0.4585,7,30,7,405091,271353,33945,92311,2.1492285515143834,0.2538359584671565
4057,0.4586,3,25,3,405116,271328,33948,92308,2.1490305411227983,0.2538472538472539
4058,0.4587,10,35,10,405151,271293,33958,92298,2.1487533265745786,0.2538511679331997
4059,0.4588,1,36,1,405187,271257,33959,92297,2.1484681916106956,0.2538742525181954
4060,0.4589,0,10,0,405197,271247,33959,92297,2.1483889874540614,0.2538812358339018
4061,0.459,12,81,12,405278,271166,33971,92285,2.147747433785325,0.2539131822446492
4062,0.4591,0,4,0,405282,271162,33971,92285,2.1477157521226715,0.2539159767448899
4063,0.4592,23,143,23,405425,271019,33994,92262,2.146583132682803,0.25396869090318513
4064,0.4593,9,66,9,405491,270953,34003,92253,2.146060385249018,0.2539963546857706
4065,0.4594,0,12,0,405503,270941,34003,92253,2.145965340261057,0.2540047467744511
4066,0.4595,8,41,8,405544,270900,34011,92245,2.145640603218857,0.25401699045835685
4067,0.4596,3,7,3,405551,270893,34014,92242,2.145585160309213,0.2540157241797128
4068,0.4597,1,25,1,405576,270868,34015,92241,2.1453871499176276,0.2540311586878871
4069,0.4598,5,20,5,405596,270848,34020,92236,2.1452287416043596,0.2540348789811724
4070,0.4599,0,6,0,405602,270842,34020,92236,2.1451812191103787,0.2540390770027377
4071,0.46,649,4349,649,409951,266493,34669,91587,2.1107353313901913,0.2557724530831099
4072,0.4601,0,8,0,409959,266485,34669,91587,2.110671968064884,0.2557781675193816
4073,0.4602,6,32,6,409991,266453,34675,91581,2.110418514763655,0.2557885563940855
4074,0.4603,10,31,10,410022,266422,34685,91571,2.110172981878089,0.2557899176799546
4075,0.4604,1,12,1,410034,266410,34686,91570,2.110077936890128,0.25579641320744173
4076,0.4605,4,28,4,410062,266382,34690,91566,2.1098561652515526,0.2558081062053706
4077,0.4606,2,9,2,410071,266373,34692,91564,2.1097848815105817,0.2558103800389454
4078,0.4607,13,49,13,410120,266324,34705,91551,2.1093967811430745,0.25581837233670973
4079,0.4608,16,146,16,410266,266178,34721,91535,2.108240400456216,0.2558894980053842
4080,0.4609,3,5,3,410271,266173,34724,91532,2.108200798377899,0.25588683412309027
4081,0.461,26,87,26,410358,266086,34750,91506,2.107511722215182,0.25589498646502157
4082,0.4611,2,5,2,410363,266081,34752,91504,2.107472120136865,0.255894402729421
4083,0.4612,1,29,1,410392,266052,34753,91503,2.1072424280826256,0.2559130763099383
4084,0.4613,5,48,5,410440,266004,34758,91498,2.1068622481307817,0.25593702972291066
4085,0.4614,4,14,4,410454,265990,34762,91494,2.106751362311494,0.2559387273276566
4086,0.4615,9,28,9,410482,265962,34771,91485,2.1065295906729187,0.25594004146069205
4087,0.4616,1,1,1,410483,265961,34772,91484,2.106521670257255,0.25593867588020536
4088,0.4617,71,454,71,410937,265507,34843,91413,2.102925801546065,0.25611621651910793
4089,0.4618,2,39,2,410976,265468,34845,91411,2.102616905335192,0.256140036258788
4090,0.4619,2,8,2,410984,265460,34847,91409,2.102553542009885,0.2561416093860772
4091,0.462,13,100,13,411084,265360,34860,91396,2.1017615004435433,0.25618630100124457
4092,0.4621,0,24,0,411108,265336,34860,91396,2.1015714104676215,0.25620353654844535
4093,0.4622,4,21,4,411129,265315,34864,91392,2.10140508173869,0.25621027902452154
4094,0.4623,9,56,9,411185,265259,34873,91383,2.1009615384615383,0.2562317393913224
4095,0.4624,2,7,2,411192,265252,34875,91381,2.1009060955518946,0.2562325976564143
4096,0.4625,59,424,59,411616,264828,34934,91322,2.097547839310607,0.2564144321212972
4097,0.4626,0,6,0,411622,264822,34934,91322,2.0975003168166264,0.2564187519654971
4098,0.4627,6,56,6,411678,264766,34940,91316,2.0970567735394754,0.2564465488286406
4099,0.4628,1,27,1,411705,264739,34941,91315,2.096842922316563,0.2564639071601499
4100,0.4629,0,18,0,411723,264721,34941,91315,2.096700354834622,0.2564768731251896
4101,0.463,12,85,12,411808,264636,34953,91303,2.0960271195032316,0.2565130542031078
4102,0.4631,1,8,1,411816,264628,34954,91302,2.095963756177924,0.2565167308178574
4103,0.4632,2,22,2,411838,264606,34956,91300,2.095789507033329,0.25652840918669534
4104,0.4633,110,801,110,412639,263805,35066,91190,2.0894452540869346,0.25687685742052707
4105,0.4634,0,3,0,412642,263802,35066,91190,2.089421492839944,0.25687902825979175
4106,0.4635,10,34,10,412676,263768,35076,91180,2.089152198707388,0.25688269831073846
4107,0.4636,0,18,0,412694,263750,35076,91180,2.089009631225447,0.2568957259177866
4108,0.4637,5,39,5,412733,263711,35081,91175,2.0887007350145734,0.2569134877115468
4109,0.4638,3,27,3,412760,263684,35084,91172,2.0884868837916613,0.2569267533872895
4110,0.4639,2,5,2,412765,263679,35086,91170,2.088447281713344,0.2569261855042567
4111,0.464,24,159,24,412924,263520,35110,91146,2.0871879356228615,0.2569910845697078
4112,0.4641,0,10,0,412934,263510,35110,91146,2.0871087314662273,0.25699833077686546
4113,0.4642,23,150,23,413084,263360,35133,91123,2.085920669116715,0.2570588716525193
4114,0.4643,5,38,5,413122,263322,35138,91118,2.0856196933215054,0.2570759507956213
4115,0.4644,3,14,3,413136,263308,35141,91115,2.085508807502218,0.25707981705476224
4116,0.4645,6,20,6,413156,263288,35147,91109,2.0853503991889495,0.2570817473059874
4117,0.4646,1,17,1,413173,263271,35148,91108,2.0852157521226715,0.25709198344145673
4118,0.4647,6,38,6,413211,263233,35154,91102,2.084914776327462,0.25710697503774677
4119,0.4648,4,27,4,413238,263206,35158,91098,2.0847009251045496,0.2571181809971098
4120,0.4649,1,8,1,413246,263198,35159,91097,2.084637561779242,0.25712188995046503
4121,0.465,209,1476,209,414722,261722,35368,90888,2.0729470282600433,0.2577578627945889
4122,0.4651,0,12,0,414734,261710,35368,90888,2.072851983272082,0.25776663509152065
4123,0.4652,3,18,3,414752,261692,35371,90885,2.0727094157901407,0.2577734792683584
4124,0.4653,5,39,5,414791,261653,35376,90880,2.0724005195792676,0.25779146916742546
4125,0.4654,3,19,3,414810,261634,35379,90877,2.0722500316816626,0.2577990474056129
4126,0.4655,7,26,7,414836,261608,35386,90870,2.0720441008744137,0.25780332389539207
4127,0.4656,0,8,0,414844,261600,35386,90870,2.0719807375491066,0.25780917524895736
4128,0.4657,7,48,7,414892,261552,35393,90863,2.0716005575972627,0.25782954755047316
4129,0.4658,28,138,28,415030,261414,35421,90835,2.0705075402357114,0.25787156244588344
4130,0.4659,0,6,0,415036,261408,35421,90835,2.070460017741731,0.25787595495155335
4131,0.466,25,148,25,415184,261260,35446,90810,2.069287796223546,0.2579316613173517
4132,0.4661,3,12,3,415196,261248,35449,90807,2.069192751235585,0.25793412961043016
4133,0.4662,3,32,3,415228,261216,35452,90804,2.0689392979343557,0.25795125276972897
4134,0.4663,7,42,7,415270,261174,35459,90797,2.0686066404764922,0.2579672757130559
4135,0.4664,1,11,1,415281,261163,35460,90796,2.0685195159041947,0.2579732298364298
4136,0.4665,4,33,4,415314,261130,35464,90792,2.068258142187302,0.25798898619580474
4137,0.4666,1,9,1,415323,261121,35465,90791,2.068186858446331,0.25799347564163766
4138,0.4667,128,743,128,416066,260378,35593,90663,2.0623019896084145,0.25826897712802777
4139,0.4668,3,15,3,416081,260363,35596,90660,2.0621831833734636,0.2582736743746136
4140,0.4669,1,8,1,416089,260355,35597,90659,2.062119820048156,0.25827744762317173
4141,0.467,8,50,8,416139,260305,35605,90651,2.0617237992649855,0.2582973364182405
4142,0.4671,5,34,5,416173,260271,35610,90646,2.0614545051324296,0.25831179452691094
4143,0.4672,3,26,3,416199,260245,35613,90643,2.0612485743251807,0.258324593602517
4144,0.4673,10,39,10,416238,260206,35623,90633,2.0609396781143072,0.25833216945664533
4145,0.4674,1,6,1,416244,260200,35624,90632,2.060892155620327,0.25833447348018423
4146,0.4675,58,409,58,416653,259791,35682,90574,2.057652705613991,0.2585132647382016
4147,0.4676,1,16,1,416669,259775,35683,90573,2.057525978963376,0.25852295431970496
4148,0.4677,8,45,8,416714,259730,35691,90565,2.0571695602585223,0.2585392312194008
4149,0.4678,1,22,1,416736,259708,35692,90564,2.056995311113927,0.258553352822949
4150,0.4679,0,12,0,416748,259696,35692,90564,2.0569002661259663,0.25856221092902415
4151,0.468,13,89,13,416837,259607,35705,90551,2.0561953491319223,0.25860040324653444
4152,0.4681,2,6,2,416843,259601,35707,90549,2.056147826637942,0.2586005997429673
4153,0.4682,3,34,3,416877,259567,35710,90546,2.055878532505386,0.25861936003518865
4154,0.4683,69,459,69,417336,259108,35779,90477,2.052243061715879,0.2588125920734585
4155,0.4684,1,3,1,417339,259105,35780,90476,2.0522193004688885,0.2588126929095117
4156,0.4685,6,34,6,417373,259071,35786,90470,2.0519500063363325,0.25882514497583975
4157,0.4686,0,16,0,417389,259055,35786,90470,2.051823279685718,0.25883699306201274
4158,0.4687,8,59,8,417448,258996,35794,90462,2.0513559751615764,0.2588637261130093
4159,0.4688,3,37,3,417485,258959,35797,90459,2.05106291978203,0.25888477411009164
4160,0.4689,2,9,2,417494,258950,35799,90457,2.0509916360410596,0.2588872003136743
4161,0.469,9,73,9,417567,258877,35808,90448,2.05041344569763,0.2589222071137193
4162,0.4691,1,3,1,417570,258874,35809,90447,2.05038968445064,0.2589223092800032
4163,0.4692,19,155,19,417725,258719,35828,90428,2.049162020022811,0.2589969267958768
4164,0.4693,3,52,3,417777,258667,35831,90425,2.048750158408313,0.259029138450609
4165,0.4694,2,4,2,417781,258663,35833,90423,2.0487184767456594,0.25902786132929995
4166,0.4695,7,33,7,417814,258630,35840,90416,2.048457103028767,0.2590374907605301
4167,0.4696,6,15,6,417829,258615,35846,90410,2.048338296793816,0.25903588568154146
4168,0.4697,4,21,4,417850,258594,35850,90406,2.048171968064884,0.25904297994269343
4169,0.4698,5,24,5,417874,258570,35855,90401,2.047981878088962,0.25905017895469823
4170,0.4699,1,11,1,417885,258559,35856,90400,2.0478947535166645,0.25905622150453206
4171,0.47,726,4369,726,422254,254190,36582,89674,2.0132904574832087,0.26078333294558315
4172,0.4701,0,5,0,422259,254185,36582,89674,2.0132508554048916,0.2607871249552869
4173,0.4702,3,12,3,422271,254173,36585,89671,2.0131558104169307,0.26078977675922804
4174,0.4703,3,36,3,422307,254137,36588,89668,2.0128706754530477,0.26081063393493403
4175,0.4704,2,5,2,422312,254132,36590,89666,2.0128310733747306,0.26081012687682886
4176,0.4705,5,25,5,422337,254107,36595,89661,2.0126330629831455,0.26081834260315095
4177,0.4706,0,3,0,422340,254104,36595,89661,2.012609301736155,0.2608206187366369
4178,0.4707,9,51,9,422391,254053,36604,89652,2.012205360537321,0.26083996450444424
4179,0.4708,23,157,23,422548,253896,36627,89629,2.010961855278165,0.26090968634014994
4180,0.4709,3,6,3,422554,253890,36630,89626,2.0109143327841843,0.2609077888657297
4181,0.471,19,95,19,422649,253795,36649,89607,2.0101618932961602,0.2609390743210581
4182,0.4711,2,8,2,422657,253787,36651,89605,2.0100985299708527,0.26094084894231667
4183,0.4712,2,28,2,422685,253759,36653,89603,2.009876758332277,0.26095782293905556
4184,0.4713,9,43,9,422728,253716,36662,89594,2.0095361804587504,0.26097113396056043
4185,0.4714,2,19,2,422747,253697,36664,89592,2.0093856925611457,0.2609812723390496
4186,0.4715,6,41,6,422788,253656,36670,89586,2.0090609555189456,0.26099952802978654
4187,0.4716,2,6,2,422794,253650,36672,89584,2.009013433024965,0.260999784403643
4188,0.4717,72,397,72,423191,253253,36744,89512,2.0058690280065896,0.2611468498825726
4189,0.4718,1,34,1,423225,253219,36745,89511,2.0055997338740337,0.26117060076445014
4190,0.4719,0,4,0,423229,253215,36745,89511,2.00556805221138,0.26117364892071215
4191,0.472,14,92,14,423321,253123,36759,89497,2.004839373970346,0.26121358939933453
4192,0.4721,2,21,2,423342,253102,36761,89495,2.004673045241414,0.26122528802061895
4193,0.4722,0,14,0,423356,253088,36761,89495,2.0045621594221266,0.2612359632556198
4194,0.4723,5,44,5,423400,253044,36766,89490,2.0042136611329364,0.26125873635901836
4195,0.4724,1,14,1,423414,253030,36767,89489,2.0041027753136484,0.26126725816670027
4196,0.4725,65,375,65,423789,252655,36832,89424,2.0011326194398684,0.26141329926712836
4197,0.4726,1,5,1,423794,252650,36833,89423,2.0010930173615513,0.26141496113402696
4198,0.4727,13,50,13,423844,252600,36846,89410,2.0006969965783803,0.26142510452910733
4199,0.4728,6,24,6,423868,252576,36852,89404,2.0005069066024586,0.26143049301128723
4200,0.4729,2,10,2,423878,252566,36854,89402,2.0004277024458244,0.26143381836897017
4201,0.473,14,66,14,423944,252500,36868,89388,1.9999049550120391,0.2614540434294272
4202,0.4731,3,9,3,423953,252491,36871,89385,1.9998336712710683,0.26145444547145746
4203,0.4732,4,19,4,423972,252472,36875,89381,1.9996831833734634,0.2614603352903148
4204,0.4733,119,777,119,424749,251695,36994,89262,1.9935290204029907,0.2617984085969785
4205,0.4734,0,3,0,424752,251692,36994,89262,1.9935052591560005,0.26180071211952344
4206,0.4735,6,32,6,424784,251660,37000,89256,1.9932518058547712,0.26181229393750954
4207,0.4736,2,16,2,424800,251644,37002,89254,1.9931250792041566,0.2618202512188397
4208,0.4737,8,37,8,424837,251607,37010,89246,1.9928320238246102,0.2618313466509023
4209,0.4738,6,31,6,424868,251576,37016,89240,1.9925864909390445,0.26184216703441154
4210,0.4739,1,4,1,424872,251572,37017,89239,1.9925548092763907,0.2618430743139159
4211,0.474,19,145,19,425017,251427,37036,89220,1.9914063490051959,0.2619133589903918
4212,0.4741,1,3,1,425020,251424,37037,89219,1.9913825877582056,0.2619134988829948
4213,0.4742,24,137,24,425157,251287,37061,89195,1.9902974908123179,0.2619668587473053
4214,0.4743,16,54,16,425211,251233,37077,89179,1.9898697883664935,0.26197372595560675
4215,0.4744,1,3,1,425214,251230,37078,89178,1.9898460271195033,0.2619738666541327
4216,0.4745,10,29,10,425243,251201,37088,89168,1.9896163350652643,0.2619745041410939
4217,0.4746,3,10,3,425253,251191,37091,89165,1.98953713090863,0.26197569603591536
4218,0.4747,10,45,10,425298,251146,37101,89155,1.9891807122037763,0.2619886512234757
4219,0.4748,4,30,4,425328,251116,37105,89151,1.988943099733874,0.2620030740565497
4220,0.4749,0,8,0,425336,251108,37105,89151,1.9888797364085666,0.26200923414222693
4221,0.475,243,1419,243,426755,249689,37348,88908,1.9776406665821822,0.26257763654137517
4222,0.4751,0,10,0,426765,249679,37348,88908,1.9775614624255482,0.2625853916423253
4223,0.4752,4,35,4,426800,249644,37352,88904,1.9772842478773287,0.2626038257499675
4224,0.4753,9,33,9,426833,249611,37361,88895,1.9770228741604359,0.26260982080081297
4225,0.4754,3,14,3,426847,249597,37364,88892,1.9769119883411481,0.2626141469885284
4226,0.4755,4,16,4,426863,249581,37368,88888,1.9767852616905335,0.26261784683383116
4227,0.4756,0,10,0,426873,249571,37368,88888,1.9767060575338993,0.2626256060556818
4228,0.4757,8,57,8,426930,249514,37376,88880,1.9762545938410847,0.26265241109475934
4229,0.4758,21,139,21,427069,249375,37397,88859,1.9751536560638703,0.26271457038618234
4230,0.4759,0,7,0,427076,249368,37397,88859,1.9750982131542263,0.26272000756888125
4231,0.476,26,138,26,427214,249230,37423,88833,1.9740051957926752,0.2627705486847126
4232,0.4761,4,4,4,427218,249226,37427,88829,1.9739735141300216,0.26276493469997486
4233,0.4762,7,29,7,427247,249197,37434,88822,1.9737438220757826,0.2627722110295575
4234,0.4763,4,35,4,427282,249162,37438,88818,1.973466607527563,0.2627906976744186
4235,0.4764,4,14,4,427296,249148,37442,88814,1.9733557217082753,0.2627928583686923
4236,0.4765,6,47,6,427343,249101,37448,88808,1.9729834621720947,0.2628163203702772
4237,0.4766,2,8,2,427351,249093,37450,88806,1.9729200988467874,0.262818179396802
4238,0.4767,134,716,134,428067,248377,37584,88672,1.967249081231783,0.26308340923723256
4239,0.4768,4,16,4,428083,248361,37588,88668,1.9671223545811685,0.26308715273759825
4240,0.4769,2,10,2,428093,248351,37590,88666,1.9670431504245343,0.26309058593483414
4241,0.477,6,46,6,428139,248305,37596,88660,1.9666788113040172,0.2631133797278649
4242,0.4771,1,26,1,428165,248279,37597,88659,1.9664728804967684,0.26313149600223185
4243,0.4772,4,9,4,428174,248270,37601,88655,1.9664015967557977,0.2631297766565259
4244,0.4773,6,64,6,428238,248206,37607,88649,1.9658946901533392,0.26316664440189397
4245,0.4774,0,11,0,428249,248195,37607,88649,1.9658075655810416,0.2631752383892841
4246,0.4775,82,412,82,428661,247783,37689,88567,1.962544354327715,0.2633179723502304
4247,0.4776,0,12,0,428673,247771,37689,88567,1.9624493093397541,0.2633273671128448
4248,0.4777,6,38,6,428711,247733,37695,88561,1.9621483335445444,0.26334397878047183
4249,0.4778,2,20,2,428731,247713,37697,88559,1.9619899252312762,0.2633552600275967
4250,0.4779,2,10,2,428741,247703,37699,88557,1.961910721074642,0.2633587105216202
4251,0.478,15,109,15,428850,247594,37714,88542,1.9610473957673298,0.26341123830830376
4252,0.4781,0,10,0,428860,247584,37714,88542,1.9609681916106958,0.263419074989736
4253,0.4782,4,28,4,428888,247556,37718,88538,1.96074641997212,0.26343225407177756
4254,0.4783,58,420,58,429308,247136,37776,88480,1.9574198453934863,0.2636346300533944
4255,0.4784,1,4,1,429312,247132,37777,88479,1.9573881637308326,0.2636355780948777
4256,0.4785,6,30,6,429342,247102,37783,88473,1.9571505512609302,0.2636459807792595
4257,0.4786,4,10,4,429352,247092,37787,88469,1.957071347104296,0.263645060063595
4258,0.4787,11,42,11,429394,247050,37798,88458,1.9567386896464327,0.2636539218140849
4259,0.4788,5,32,5,429426,247018,37803,88453,1.9564852363452034,0.26366809649716366
4260,0.4789,0,9,0,429435,247009,37803,88453,1.9564139526042326,0.26367517036206783
4261,0.479,17,100,17,429535,246909,37820,88436,1.9556219110378912,0.26371647109693
4262,0.4791,1,9,1,429544,246900,37821,88435,1.9555506272969205,0.2637213532735921
4263,0.4792,24,154,24,429698,246746,37845,88411,1.9543308832847548,0.26378980597152973
4264,0.4793,7,79,7,429777,246667,37852,88404,1.9537051704473452,0.2638366197014961
4265,0.4794,0,1,0,429778,246666,37852,88404,1.9536972500316816,0.2638374071089623
4266,0.4795,4,35,4,429813,246631,37856,88400,1.953420035483462,0.26385618047285175
4267,0.4796,1,9,1,429822,246622,37857,88399,1.9533487517424915,0.26386107139552445
4268,0.4797,2,37,2,429859,246585,37859,88397,1.953055696362945,0.26388582073066613
4269,0.4798,4,29,4,429888,246556,37863,88393,1.9528260043087062,0.26389987729475234
4270,0.4799,1,9,1,429897,246547,37864,88392,1.9527547205677354,0.26390477071944446
4271,0.48,725,4333,725,434230,242214,38589,87667,1.9184355594981624,0.26575340804714426
4272,0.4801,2,5,2,434235,242209,38591,87665,1.9183959574198455,0.26575298447285933
4273,0.4802,3,27,3,434262,242182,38594,87662,1.9181821061969333,0.26576806005263093
4274,0.4803,7,38,7,434300,242144,38601,87655,1.9178811304017236,0.26578309819010976
4275,0.4804,0,5,0,434305,242139,38601,87655,1.9178415283234065,0.26578712772215385
4276,0.4805,3,30,3,434335,242109,38604,87652,1.917603915853504,0.26580462820042394
4277,0.4806,0,6,0,434341,242103,38604,87652,1.9175563933595234,0.2658094646025079
4278,0.4807,11,64,11,434405,242039,38615,87641,1.917049486757065,0.26583656879398204
4279,0.4808,24,153,24,434558,241886,38639,87617,1.9158376631605627,0.26590653195873787
4280,0.4809,0,6,0,434564,241880,38639,87617,1.9157901406665823,0.2659113740034052
4281,0.481,19,76,19,434640,241804,38658,87598,1.9151881890761626,0.26593038293635135
4282,0.4811,1,10,1,434650,241794,38659,87597,1.9151089849195286,0.26593622776578596
4283,0.4812,3,20,3,434670,241774,38662,87594,1.9149505766062602,0.26594568992737605
4284,0.4813,6,37,6,434707,241737,38668,87588,1.914657521226714,0.2659621953996812
4285,0.4814,2,12,2,434719,241725,38670,87586,1.914562476238753,0.26596742896532455
4286,0.4815,4,43,4,434762,241682,38674,87582,1.9142218983652262,0.2659932455415715
4287,0.4816,0,5,0,434767,241677,38674,87582,1.914182296286909,0.26599728481226026
4288,0.4817,66,409,66,435176,241268,38740,87516,1.9109428462805729,0.2661808360504161
4289,0.4818,4,25,4,435201,241243,38744,87512,1.9107448358889874,0.26619214916883394
4290,0.4819,1,11,1,435212,241232,38745,87511,1.9106577113166898,0.2661988240053781
4291,0.482,16,96,16,435308,241136,38761,87495,1.9098973514130022,0.2662408598093302
4292,0.4821,2,15,2,435323,241121,38763,87493,1.909778545178051,0.2662485469273981
4293,0.4822,9,20,9,435343,241101,38772,87484,1.9096201368647827,0.26624465511207146
4294,0.4823,10,45,10,435388,241056,38782,87474,1.909263718159929,0.26625878915167567
4295,0.4824,2,11,2,435399,241045,38784,87472,1.9091765935876315,0.26626323751891073
4296,0.4825,64,368,64,435767,240677,38848,87408,1.9062618806234952,0.26641876343020865
4297,0.4826,2,4,2,435771,240673,38850,87406,1.9062301989608414,0.2664175396779434
4298,0.4827,11,49,11,435820,240624,38861,87395,1.9058420985933342,0.2664327371280322
4299,0.4828,5,26,5,435846,240598,38866,87390,1.9056361677860854,0.2664426747320024
4300,0.4829,2,13,2,435859,240585,38868,87388,1.905533202382461,0.2664487625505758
4301,0.483,14,62,14,435921,240523,38882,87374,1.9050421366113293,0.26646782373733213
4302,0.4831,0,9,0,435930,240514,38882,87374,1.9049708528703586,0.26647513785194943
4303,0.4832,8,22,8,435952,240492,38890,87366,1.9047966037257635,0.2664751203264828
4304,0.4833,132,769,132,436721,239723,39022,87234,1.8987058040805982,0.26680572674694225
4305,0.4834,1,2,1,436723,239721,39023,87233,1.8986899632492713,0.2668051163160567
4306,0.4835,8,29,8,436752,239692,39031,87225,1.8984602711950322,0.26681084189564935
4307,0.4836,3,10,3,436762,239682,39034,87222,1.8983810670383983,0.2668122751633507
4308,0.4837,9,20,9,436782,239662,39043,87213,1.8982226587251299,0.26680841300191205
4309,0.4838,0,28,0,436810,239634,39043,87213,1.8980008870865543,0.2668312696766377
4310,0.4839,4,11,4,436821,239623,39047,87209,1.8979137625142568,0.26683127723111566
4311,0.484,29,148,29,436969,239475,39076,87180,1.8967415409960715,0.26688708270193323
4312,0.4841,1,3,1,436972,239472,39077,87179,1.8967177797490813,0.26688728949245527
4313,0.4842,23,120,23,437092,239352,39100,87156,1.8957673298694715,0.2669337351611599
4314,0.4843,10,43,10,437135,239309,39110,87146,1.8954267519959447,0.2669464397849627
4315,0.4844,2,8,2,437143,239301,39112,87144,1.8953633886706374,0.266948490557368
4316,0.4845,3,29,3,437172,239272,39115,87141,1.8951336966163985,0.2669654701252707
4317,0.4846,5,16,5,437188,239256,39120,87136,1.8950069699657839,0.2669673276305792
4318,0.4847,15,33,15,437221,239223,39135,87121,1.894745596248891,0.2669606305003309
4319,0.4848,4,30,4,437251,239193,39139,87117,1.8945079837789887,0.26697618828721154
4320,0.4849,1,3,1,437254,239190,39140,87116,1.8944842225319984,0.2669763963886658
4321,0.485,257,1390,257,438644,237800,39397,86859,1.883474844759853,0.2675391718695616
4322,0.4851,0,10,0,438654,237790,39397,86859,1.8833956406032188,0.2675474127442253
4323,0.4852,2,26,2,438680,237764,39399,86857,1.88318970979597,0.26756432886350545
4324,0.4853,4,27,4,438707,237737,39403,86853,1.8829758585730578,0.26757755938260575
4325,0.4854,2,9,2,438716,237728,39405,86851,1.8829045748320872,0.26758046577258543
4326,0.4855,2,20,2,438736,237708,39407,86849,1.882746166518819,0.2675924413893399
4327,0.4856,2,6,2,438742,237702,39409,86847,1.8826986440248383,0.2675928750358189
4328,0.4857,13,69,13,438811,237633,39422,86834,1.882152135344063,0.26762043597654
4329,0.4858,21,126,21,438937,237507,39443,86813,1.8811541629704727,0.2676769856931426
4330,0.4859,0,5,0,438942,237502,39443,86813,1.8811145608921556,0.267681112498651
4331,0.486,35,168,35,439110,237334,39478,86778,1.879783931060702,0.26774078096460485
4332,0.4861,4,11,4,439121,237323,39482,86774,1.8796968064884045,0.26774083067723553
4333,0.4862,5,47,5,439168,237276,39487,86769,1.879324546952224,0.267768365504791
4334,0.4863,1,15,1,439183,237261,39488,86768,1.8792057407172729,0.2677785013069818
4335,0.4864,3,10,3,439193,237251,39491,86765,1.8791265365606387,0.2677799861735223
4336,0.4865,8,37,8,439230,237214,39499,86757,1.8788334811810923,0.2677924875991987
4337,0.4866,0,6,0,439236,237208,39499,86757,1.8787859586871118,0.26779744725510474
4338,0.4867,127,739,127,439975,236469,39626,86630,1.872932771511849,0.268122154509918
4339,0.4868,3,21,3,439996,236448,39629,86627,1.8727664427829172,0.2681327865046816
4340,0.4869,3,8,3,440004,236440,39632,86624,1.8727030794576098,0.26813263006710747
4341,0.487,9,56,9,440060,236384,39641,86615,1.8722595361804588,0.26815872494961285
4342,0.4871,2,26,2,440086,236358,39643,86613,1.87205360537321,0.2681757804880314
4343,0.4872,6,16,6,440102,236342,39649,86607,1.8719268787225953,0.26817547043031564
4344,0.4873,6,54,6,440156,236288,39655,86601,1.871499176276771,0.2682067211952095
4345,0.4874,1,8,1,440164,236280,39656,86600,1.8714358129514637,0.26821110009910804
4346,0.4875,60,391,60,440555,235889,39716,86540,1.8683389304270688,0.26840017492223095
4347,0.4876,4,13,4,440568,235876,39720,86536,1.8682359650234444,0.26840192052405
4348,0.4877,8,46,8,440614,235830,39728,86528,1.8678716259029273,0.26842206490920034
4349,0.4878,3,13,3,440627,235817,39731,86525,1.867768660499303,0.2684260816151789
4350,0.4879,2,17,2,440644,235800,39733,86523,1.867634013433025,0.26843569959326513
4351,0.488,13,93,13,440737,235707,39746,86510,1.8668974147763275,0.26848366163175746
4352,0.4881,1,6,1,440743,235701,39747,86509,1.8668498922823469,0.2684863908631017
4353,0.4882,2,25,2,440768,235676,39749,86507,1.8666518818907616,0.2685026832576517
4354,0.4883,65,356,65,441124,235320,39814,86442,1.8638322139145862,0.26865198500755216
4355,0.4884,1,4,1,441128,235316,39815,86441,1.8638005322519327,0.2686530518372561
4356,0.4885,8,31,8,441159,235285,39823,86433,1.8635549993663667,0.2686607525845616
4357,0.4886,0,7,0,441166,235278,39823,86433,1.863499556456723,0.26866659828230927
4358,0.4887,10,39,10,441205,235239,39833,86423,1.8631906602458497,0.2686764367565954
4359,0.4888,3,22,3,441227,235217,39836,86420,1.8630164111012546,0.2686879929858816
4360,0.4889,0,12,0,441239,235205,39836,86420,1.8629213661132937,0.2686980178779635
4361,0.489,13,85,13,441324,235120,39849,86407,1.8622481307819034,0.2687394837758571
4362,0.4891,2,7,2,441331,235113,39851,86405,1.8621926878722594,0.2687407858969016
4363,0.4892,22,129,22,441460,234984,39873,86383,1.8611709542516792,0.2687986009764537
4364,0.4893,10,72,10,441532,234912,39883,86373,1.8606006843239133,0.268836080115785
4365,0.4894,0,4,0,441536,234908,39883,86373,1.8605690026612596,0.26883942716811765
4366,0.4895,5,17,5,441553,234891,39888,86368,1.8604343555949816,0.26884227367949226
4367,0.4896,2,8,2,441561,234883,39890,86366,1.8603709922696743,0.26884441663631636
4368,0.4897,5,26,5,441587,234857,39895,86361,1.8601650614624254,0.2688547964310842
4369,0.4898,8,32,8,441619,234825,39903,86353,1.8599116081611964,0.26886337171288194
4370,0.4899,1,11,1,441630,234814,39904,86352,1.8598244835888988,0.26887030383041793
4371,0.49,727,4189,727,445819,230625,40631,85625,1.8266458623748574,0.2707509881422925
4372,0.4901,0,6,0,445825,230619,40631,85625,1.826598339880877,0.27075612501739166
4373,0.4902,3,23,3,445848,230596,40634,85622,1.8264161703206183,0.27076889993612
4374,0.4903,4,25,4,445873,230571,40638,85618,1.826218159929033,0.27078108346590174
4375,0.4904,3,12,3,445885,230559,40641,85615,1.8261231149410722,0.27078444147842645
4376,0.4905,4,29,4,445914,230530,40645,85611,1.825893422886833,0.2708000544061036
4377,0.4906,4,9,4,445923,230521,40649,85607,1.8258221391458624,0.2707985373013463
4378,0.4907,5,63,5,445986,230458,40654,85602,1.8253231529590672,0.27084097956084285
4379,0.4908,15,115,15,446101,230343,40669,85587,1.8244123051577747,0.2709049472984522
4380,0.4909,2,3,2,446104,230340,40671,85585,1.8243885439107845,0.27090290417029356
4381,0.491,12,74,12,446178,230266,40683,85573,1.8238024331516918,0.27093867445122355
4382,0.4911,3,8,3,446186,230258,40686,85570,1.8237390698263845,0.27093861215598364
4383,0.4912,8,35,8,446221,230223,40694,85562,1.823461855278165,0.2709501717941004
4384,0.4913,6,41,6,446262,230182,40700,85556,1.823137118235965,0.2709715016881085
4385,0.4914,0,16,0,446278,230166,40700,85556,1.8230103915853504,0.27098523384496487
4386,0.4915,3,30,3,446308,230136,40703,85553,1.822772779115448,0.27100405779105385
4387,0.4916,1,3,1,446311,230133,40704,85552,1.8227490178684578,0.27100432393050033
4388,0.4917,73,415,73,446726,229718,40777,85479,1.819462045368141,0.2711923019571887
4389,0.4918,3,28,3,446754,229690,40780,85476,1.8192402737295654,0.27120945787299394
4390,0.4919,2,7,2,446761,229683,40782,85474,1.8191848308199214,0.2712108568110497
4391,0.492,11,95,11,446856,229588,40793,85463,1.8184323913318972,0.27126719166103264
4392,0.4921,1,14,1,446870,229574,40794,85462,1.8183215055126094,0.2712769334298302
4393,0.4922,2,16,2,446886,229558,40796,85460,1.8181947788619948,0.2712860852395736
4394,0.4923,3,40,3,446926,229518,40799,85457,1.8178779622354582,0.271313596317168
4395,0.4924,0,6,0,446932,229512,40799,85457,1.8178304397414777,0.271318764703828
4396,0.4925,59,385,59,447317,229127,40858,85398,1.8147810797110633,0.27151418806136235
4397,0.4926,0,8,0,447325,229119,40858,85398,1.814717716385756,0.27152109424927745
4398,0.4927,6,38,6,447363,229081,40864,85392,1.8144167405905463,0.2715400050242787
4399,0.4928,4,15,4,447378,229066,40868,85388,1.814297934355595,0.2715436916051314
4400,0.4929,5,14,5,447392,229052,40873,85383,1.8141870485363072,0.2715441983239779
4401,0.493,7,50,7,447442,229002,40880,85376,1.8137910277531364,0.2715711659212795
4402,0.4931,0,6,0,447448,228996,40880,85376,1.813743505259156,0.27157634903871847
4403,0.4932,2,32,2,447480,228964,40882,85374,1.8134900519579267,0.27159936119718264
4404,0.4933,127,709,127,448189,228255,41009,85247,1.8078744772525661,0.27191852045600984
4405,0.4934,1,5,1,448194,228250,41010,85246,1.8078348751742492,0.27192053487125833
4406,0.4935,9,27,9,448221,228223,41019,85237,1.807621023951337,0.2719230523830792
4407,0.4936,2,13,2,448234,228210,41021,85235,1.8075180585477126,0.2719296846336678
4408,0.4937,8,31,8,448265,228179,41029,85227,1.8072725256621467,0.2719379973580595
4409,0.4938,5,25,5,448290,228154,41034,85222,1.8070745152705614,0.2719480751557235
4410,0.4939,0,5,0,448295,228149,41034,85222,1.8070349131922443,0.2719524142310552
4411,0.494,26,139,26,448434,228010,41060,85196,1.8059339754150299,0.27201266897824433
4412,0.4941,1,3,1,448437,228007,41061,85195,1.8059102141680394,0.27201295010887544
4413,0.4942,23,129,23,448566,227878,41084,85172,1.8048884805474592,0.27207155406484584
4414,0.4943,14,60,14,448626,227818,41098,85158,1.8044132556076542,0.2720911507591636
4415,0.4944,0,3,0,448629,227815,41098,85158,1.804389494360664,0.2720937588865493
4416,0.4945,1,25,1,448654,227790,41099,85157,1.8041914839690787,0.27211316932260093
4417,0.4946,0,10,0,448664,227780,41099,85157,1.8041122798124445,0.2721218647842856
4418,0.4947,7,25,7,448689,227755,41106,85150,1.8039142694208592,0.27212732298940573
4419,0.4948,3,25,3,448714,227730,41109,85147,1.803716259029274,0.2721420877852958
4420,0.4949,0,6,0,448720,227724,41109,85147,1.8036687365352935,0.272147306717465
4421,0.495,243,1414,243,450134,226310,41352,84904,1.792469268787226,0.27281549030570607
4422,0.4951,0,4,0,450138,226306,41352,84904,1.7924375871245724,0.2728189968188683
4423,0.4952,3,28,3,450166,226278,41355,84901,1.7922158154859966,0.27283653459905716
4424,0.4953,9,32,9,450198,226246,41364,84892,1.7919623621847676,0.2728435613779095
4425,0.4954,3,11,3,450209,226235,41367,84889,1.7918752376124698,0.2728461963718646
4426,0.4955,2,17,2,450226,226218,41369,84887,1.7917405905461918,0.2728564311084682
4427,0.4956,4,11,4,450237,226207,41373,84883,1.7916534659738943,0.2728567295637918
4428,0.4957,9,62,9,450299,226145,41382,84874,1.7911624002027626,0.27289008067031273
4429,0.4958,21,141,21,450440,226004,41403,84853,1.7900456215942213,0.2729647394139427
4430,0.4959,0,7,0,450447,225997,41403,84853,1.7899901786845773,0.27297088627955607
4431,0.496,26,135,26,450582,225862,41429,84827,1.7889209225700164,0.2730286556653116
4432,0.4961,2,4,2,450586,225858,41431,84825,1.788889240907363,0.2730274910439258
4433,0.4962,4,31,4,450617,225827,41435,84821,1.788643708021797,0.2730453761170199
4434,0.4963,4,22,4,450639,225805,41439,84817,1.7884694588772019,0.2730553534521058
4435,0.4964,1,12,1,450651,225793,41440,84816,1.788374413889241,0.2730635622277526
4436,0.4965,8,33,8,450684,225760,41448,84808,1.7881130401723482,0.27307385178125243
4437,0.4966,0,3,0,450687,225757,41448,84808,1.788089278925358,0.27307648962375025
4438,0.4967,144,745,144,451432,225012,41592,84664,1.7821885692561146,0.2733954197290071
4439,0.4968,5,23,5,451455,224989,41597,84659,1.782006399695856,0.27340399421278355
4440,0.4969,1,6,1,451461,224983,41598,84658,1.7819588772018755,0.27340694546264865
4441,0.497,8,55,8,451516,224928,41606,84650,1.7815232543403878,0.2734367429210086
4442,0.4971,7,13,7,451529,224915,41613,84643,1.7814202889367634,0.27343179630311604
4443,0.4972,6,24,6,451553,224891,41619,84637,1.7812301989608414,0.2734389134424026
4444,0.4973,13,59,13,451612,224832,41632,84624,1.7807628944367,0.2734605242748565
4445,0.4974,3,5,3,451617,224827,41635,84621,1.780723292358383,0.2734578992270107
4446,0.4975,60,339,60,451956,224488,41695,84561,1.7780382714484857,0.27361680510210357
4447,0.4976,2,15,2,451971,224473,41697,84559,1.7779194652135344,0.27362538507339046
4448,0.4977,11,40,11,452011,224433,41708,84548,1.7776026485869978,0.27363494842724956
4449,0.4978,5,16,5,452027,224417,41713,84543,1.7774759219363832,0.2736373640600725
4450,0.4979,2,14,2,452041,224403,41715,84541,1.7773650361170954,0.27364506188823867
4451,0.498,15,103,15,452144,224300,41730,84526,1.7765492333037638,0.2737010484868502
4452,0.4981,3,9,3,452153,224291,41733,84523,1.7764779495627931,0.273701969470296
4453,0.4982,2,34,2,452187,224257,41735,84521,1.776208655430237,0.273727402859012
4454,0.4983,67,420,67,452607,223837,41802,84454,1.772882080851603,0.27394247642649316
4455,0.4984,0,5,0,452612,223832,41802,84454,1.772842478773286,0.2739469194189811
4456,0.4985,1,34,1,452646,223798,41803,84453,1.77257318464073,0.2739747802926836
4457,0.4986,5,11,5,452657,223787,41808,84448,1.7724860600684325,0.27397278050837837
4458,0.4987,8,28,8,452685,223759,41816,84440,1.7722642884298567,0.27397882536932305
4459,0.4988,7,22,7,452707,223737,41823,84433,1.7720900392852617,0.2739818931109453
4460,0.4989,0,5,0,452712,223732,41823,84433,1.7720504372069446,0.2739863384874986
4461,0.499,17,95,17,452807,223637,41840,84416,1.7712979977189203,0.2740307674328768
4462,0.4991,2,4,2,452811,223633,41842,84414,1.7712663160562667,0.274029612364347
4463,0.4992,26,127,26,452938,223506,41868,84388,1.7702604232670132,0.27408133968183856
4464,0.4993,7,73,7,453011,223433,41875,84381,1.7696822329235837,0.2741298316515818
4465,0.4994,1,5,1,453016,223428,41876,84380,1.7696426308452669,0.27413192639567524
4466,0.4995,3,28,3,453044,223400,41879,84377,1.7694208592066911,0.2741497902702281
4467,0.4996,4,8,4,453052,223392,41883,84373,1.7693574958813838,0.2741474826572222
4468,0.4997,6,25,6,453077,223367,41889,84367,1.7691594854897985,0.2741556019159404
4469,0.4998,4,27,4,453104,223340,41893,84363,1.7689456342668863,0.2741702225847652
4470,0.4999,2,5,2,453109,223335,41895,84361,1.7689060321885692,0.2741699599604805
4471,0.5,651,4185,651,457294,219150,42546,83710,1.7357590926371815,0.276398335864756
4472,0.5001,0,5,0,457299,219145,42546,83710,1.7357194905588644,0.2764028990771161
4473,0.5002,2,18,2,457317,219127,42548,83708,1.7355769230769231,0.2764145491769445
4474,0.5003,6,41,6,457358,219086,42554,83702,1.7352521860347232,0.27643763953657347
4475,0.5004,2,11,2,457369,219075,42556,83700,1.7351650614624254,0.2764429031459004
4476,0.5005,5,26,5,457395,219049,42561,83695,1.7349591306551768,0.27645469439526466
4477,0.5006,0,2,0,457397,219047,42561,83695,1.73494328982385,0.27645652073382615
4478,0.5007,14,41,14,457438,219006,42575,83681,1.73461855278165,0.2764605021028323
4479,0.5008,22,120,22,457558,218886,42597,83659,1.7336681029020402,0.27651754284486607
4480,0.5009,1,7,1,457565,218879,42598,83658,1.7336126599923964,0.2765215494303176
4481,0.501,12,84,12,457649,218795,42610,83646,1.7329473450766697,0.27656964498860936
4482,0.5011,2,9,2,457658,218786,42612,83644,1.7328760613356988,0.2765730912938531
4483,0.5012,1,16,1,457674,218770,42613,83643,1.7327493346850842,0.27658533197977603
4484,0.5013,13,42,13,457716,218728,42626,83630,1.732416677227221,0.2765926484498508
4485,0.5014,5,11,5,457727,218717,42631,83625,1.7323295526549234,0.27659074822551943
4486,0.5015,1,48,1,457775,218669,42632,83624,1.7319493727030795,0.27663227398583495
4487,0.5016,2,7,2,457782,218662,42634,83622,1.7318939297934355,0.27663389395403
4488,0.5017,65,400,65,458182,218262,42699,83557,1.72872576352807,0.2768447314450051
4489,0.5018,6,31,6,458213,218231,42705,83551,1.7284802306425042,0.27685879210821057
4490,0.5019,2,11,2,458224,218220,42707,83549,1.7283931060702065,0.2768640914076661
4491,0.502,16,83,16,458307,218137,42723,83533,1.7277357115701433,0.2769019126860477
4492,0.5021,2,13,2,458320,218124,42725,83531,1.7276327461665189,0.27690905173128244
4493,0.5022,1,23,1,458343,218101,42726,83530,1.7274505766062602,0.27692776936057634
4494,0.5023,3,38,3,458381,218063,42729,83527,1.7271496008110505,0.27695546934580056
4495,0.5024,0,11,0,458392,218052,42729,83527,1.727062476238753,0.276965571210197
4496,0.5025,67,381,67,458773,217671,42796,83460,1.7240447978709923,0.27715512517807867
4497,0.5026,1,3,1,458776,217668,42797,83459,1.724021036624002,0.2771554858913349
4498,0.5027,9,33,9,458809,217635,42806,83450,1.7237596629071095,0.27716425594101335
4499,0.5028,4,24,4,458833,217611,42810,83446,1.7235695729311875,0.2771767472604856
4500,0.5029,2,19,2,458852,217592,42812,83444,1.7234190850335827,0.2771894391368474
4501,0.503,6,70,6,458922,217522,42818,83438,1.7228646559371437,0.27723950026581606
4502,0.5031,3,9,3,458931,217513,42821,83435,1.7227933721961728,0.27724058641359967
4503,0.5032,4,19,4,458950,217494,42825,83431,1.722642884298568,0.27724848384148876
4504,0.5033,121,712,121,459662,216782,42946,83310,1.7170035483462172,0.2776148647748024
4505,0.5034,2,3,2,459665,216779,42948,83308,1.716979787099227,0.2776128256139053
4506,0.5035,4,47,4,459712,216732,42952,83304,1.7166075275630466,0.27764668239811224
4507,0.5036,2,16,2,459728,216716,42954,83302,1.716480800912432,0.27765667393289734
4508,0.5037,5,33,5,459761,216683,42959,83297,1.7162194271955393,0.27767517834522304
4509,0.5038,6,25,6,459786,216658,42965,83291,1.7160214168039538,0.2776838729250639
4510,0.5039,2,7,2,459793,216651,42967,83289,1.71596597389431,0.2776855371074215
4511,0.504,29,132,29,459925,216519,42996,83260,1.7149204790267394,0.2777379336110935
4512,0.5041,0,1,0,459926,216518,42996,83260,1.7149125586110758,0.2777388600897998
4513,0.5042,18,148,18,460074,216370,43014,83242,1.7137403370928905,0.27783266357822783
4514,0.5043,12,50,12,460124,216320,43026,83230,1.71334431630972,0.27785010849607744
4515,0.5044,1,8,1,460132,216312,43027,83229,1.7132809529844126,0.2778551183310465
4516,0.5045,3,27,3,460159,216285,43030,83226,1.7130671017615005,0.2778729328805954
4517,0.5046,1,20,1,460179,216265,43031,83225,1.7129086934482323,0.2778890780994357
4518,0.5047,8,42,8,460221,216223,43039,83217,1.7125760359903688,0.27790876302431206
4519,0.5048,2,17,2,460238,216206,43041,83215,1.7124413889240908,0.2779197183898257
4520,0.5049,0,1,0,460239,216205,43041,83215,1.7124334685084273,0.27792064658339455
4521,0.505,230,1288,230,461527,214917,43271,82985,1.7022319731339501,0.27856476290860754
4522,0.5051,0,10,0,461537,214907,43271,82985,1.702152768977316,0.27857411410846883
4523,0.5052,5,20,5,461557,214887,43276,82980,1.7019943606640477,0.27858070883985137
4524,0.5053,5,40,5,461597,214847,43281,82975,1.7016775440375111,0.2786060129876235
4525,0.5054,4,9,4,461606,214838,43285,82971,1.7016062602965403,0.2786047433086307
4526,0.5055,2,30,2,461636,214808,43287,82969,1.7013686478266379,0.2786279665655843
4527,0.5056,2,11,2,461647,214797,43289,82967,1.7012815232543403,0.27863341438185946
4528,0.5057,8,42,8,461689,214755,43297,82959,1.700948865796477,0.27865333843890444
4529,0.5058,16,104,16,461793,214651,43313,82943,1.700125142567482,0.27871193639656716
4530,0.5059,3,1,3,461794,214650,43316,82940,1.7001172221518186,0.27870560166672265
4531,0.506,24,154,24,461948,214496,43340,82916,1.6988974781396529,0.2787917098166853
4532,0.5061,1,7,1,461955,214489,43341,82915,1.6988420352300089,0.2787958467270111
4533,0.5062,2,26,2,461981,214463,43343,82913,1.69863610442276,0.2788153717852147
4534,0.5063,2,26,2,462007,214437,43345,82911,1.6984301736155114,0.2788349005206021
4535,0.5064,0,8,0,462015,214429,43345,82911,1.698366810290204,0.27884240263671217
4536,0.5065,8,33,8,462048,214396,43353,82903,1.6981054365733115,0.278853948381932
4537,0.5066,1,11,1,462059,214385,43354,82902,1.6980183120010137,0.2788618405782964
4538,0.5067,115,717,115,462776,213668,43469,82787,1.692339373970346,0.2792565482113643
4539,0.5068,4,25,4,462801,213643,43473,82783,1.6921413635787605,0.2792703743936092
4540,0.5069,3,8,3,462809,213635,43476,82780,1.6920780002534532,0.27927061720898066
4541,0.507,7,52,7,462861,213583,43483,82773,1.6916661386389558,0.2793025955270013
4542,0.5071,6,27,6,462888,213556,43489,82767,1.6914522874160436,0.2793134518751498
4543,0.5072,4,19,4,462907,213537,43493,82763,1.6913017995184387,0.2793216334795815
4544,0.5073,7,55,7,462962,213482,43500,82756,1.690866176656951,0.27935646338417086
4545,0.5074,2,9,2,462971,213473,43502,82754,1.6907948929159802,0.2793600853399589
4546,0.5075,77,370,77,463341,213103,43579,82677,1.687864339120517,0.27952194198390695
4547,0.5076,4,14,4,463355,213089,43583,82673,1.6877534533012293,0.27952542923025947
4548,0.5077,6,46,6,463401,213043,43589,82667,1.6873891141807122,0.2795542930573873
4549,0.5078,0,17,0,463418,213026,43589,82667,1.6872544671144343,0.27957036520986295
4550,0.5079,3,18,3,463436,213008,43592,82664,1.6871118996324928,0.2795800752184853
4551,0.508,12,83,12,463519,212925,43604,82652,1.6864545051324293,0.2796293351647794
4552,0.5081,3,7,3,463526,212918,43607,82649,1.6863990622227853,0.27962864595844594
4553,0.5082,3,24,3,463550,212894,43610,82646,1.6862089722468636,0.2796440414157136
4554,0.5083,61,374,61,463924,212520,43671,82585,1.6832467367887467,0.2798495450771759
4555,0.5084,0,4,0,463928,212516,43671,82585,1.683215055126093,0.2798533383485654
4556,0.5085,5,38,5,463966,212478,43676,82580,1.6829140793308832,0.27987717669068457
4557,0.5086,4,12,4,463978,212466,43680,82576,1.6828190343429223,0.2798787969170491
4558,0.5087,5,39,5,464017,212427,43685,82571,1.682510138132049,0.27990359256672925
4559,0.5088,10,25,10,464042,212402,43695,82561,1.6823121277404638,0.27990290307597904
4560,0.5089,2,7,2,464049,212395,43697,82559,1.68225668483082,0.27990466310000883
4561,0.509,12,80,12,464129,212315,43709,82547,1.6816230515777468,0.2799512992518534
4562,0.5091,1,10,1,464139,212305,43710,82546,1.6815438474211126,0.27995835184550844
4563,0.5092,19,131,19,464270,212174,43729,82527,1.6805062729692055,0.28003637585213487
4564,0.5093,12,43,12,464313,212131,43741,82515,1.6801656950956787,0.28004792191307537
4565,0.5094,1,11,1,464324,212120,43742,82514,1.6800785705233812,0.2800559338026161
4566,0.5095,7,22,7,464346,212098,43749,82507,1.6799043213787859,0.2800597410091478
4567,0.5096,1,5,1,464351,212093,43750,82506,1.679864719300469,0.2800620504482364
4568,0.5097,4,30,4,464381,212063,43754,82502,1.6796271068305664,0.28008079710759937
4569,0.5098,5,21,5,464402,212042,43759,82497,1.6794607781016349,0.2800885451502178
4570,0.5099,0,3,0,464405,212039,43759,82497,1.6794370168546446,0.2800913979954912
4571,0.51,743,3989,743,468394,208050,44502,81754,1.647842478773286,0.28210100619729195
4572,0.5101,1,7,1,468401,208043,44503,81753,1.6477870358636422,0.28210534306891744
4573,0.5102,9,32,9,468433,208011,44512,81744,1.647533582562413,0.28211419992752496
4574,0.5103,6,24,6,468457,207987,44518,81738,1.647343492586491,0.28212270256277505
4575,0.5104,1,6,1,468463,207981,44519,81737,1.6472959700925105,0.28212606741728163
4576,0.5105,2,31,2,468494,207950,44521,81735,1.6470504372069446,0.2821513022766108
4577,0.5106,0,6,0,468500,207944,44521,81735,1.6470029147129641,0.2821571463585555
4578,0.5107,10,44,10,468544,207900,44531,81725,1.646654416423774,0.2821752265861027
4579,0.5108,20,125,20,468669,207775,44551,81705,1.645664364465847,0.2822474782368385
4580,0.5109,2,8,2,468677,207767,44553,81703,1.6456010011405398,0.28225031954952157
4581,0.511,12,72,12,468749,207695,44565,81691,1.645030731212774,0.2822907811711693
4582,0.5111,2,7,2,468756,207688,44567,81689,1.6449752883031301,0.282292649381257
4583,0.5112,7,25,7,468781,207663,44574,81682,1.6447772779115448,0.28229967685634794
4584,0.5113,4,35,4,468816,207628,44578,81678,1.6445000633633253,0.2823239061754682
4585,0.5114,0,8,0,468824,207620,44578,81678,1.644436700038018,0.28233171331982937
4586,0.5115,6,41,6,468865,207579,44584,81672,1.644111962995818,0.2823568457844571
4587,0.5116,2,8,2,468873,207571,44586,81670,1.6440485996705108,0.28235969312787607
4588,0.5117,62,364,62,469237,207207,44648,81608,1.641165568369028,0.2825615013070651
4589,0.5118,2,16,2,469253,207191,44650,81606,1.6410388417184134,0.28257218738421797
4590,0.5119,1,12,1,469265,207179,44651,81605,1.6409437967304523,0.28258144495539916
4591,0.512,13,85,13,469350,207094,44664,81592,1.6402705613990622,0.2826323410210402
4592,0.5121,8,12,8,469362,207082,44672,81584,1.6401755164111012,0.2826242092937859
4593,0.5122,3,22,3,469384,207060,44675,81581,1.640001267266506,0.28263829462896817
4594,0.5123,4,37,4,469421,207023,44679,81577,1.63970821188696,0.2826645876645877
4595,0.5124,2,14,2,469435,207009,44681,81575,1.639597326067672,0.28267332908269344
4596,0.5125,67,328,67,469763,206681,44748,81508,1.6369994297300723,0.2828282828282828
4597,0.5126,1,7,1,469770,206674,44749,81507,1.6369439868204283,0.28283266419368386
4598,0.5127,17,60,17,469830,206614,44766,81490,1.6364687618806235,0.282849248882348
4599,0.5128,1,15,1,469845,206599,44767,81489,1.6363499556456722,0.28286148676793205
4600,0.5129,1,18,1,469863,206581,44768,81488,1.636207388163731,0.2828766719084664
4601,0.513,7,53,7,469916,206528,44775,81481,1.6357876061335699,0.2829112979108292
4602,0.5131,1,7,1,469923,206521,44776,81480,1.635732163223926,0.28291568432054054
4603,0.5132,2,25,2,469948,206496,44778,81478,1.6355341528323406,0.2829352649892004
4604,0.5133,128,639,128,470587,205857,44906,81350,1.630473007223419,0.2832451855282079
4605,0.5134,0,3,0,470590,205854,44906,81350,1.6304492459764288,0.283248144176265
4606,0.5135,2,31,2,470621,205823,44908,81348,1.630203713090863,0.2832737288932378
4607,0.5136,1,14,1,470635,205809,44909,81347,1.6300928272715751,0.28328504366964297
4608,0.5137,4,28,4,470663,205781,44913,81343,1.6298710556329996,0.28330268455440855
4609,0.5138,2,25,2,470688,205756,44915,81341,1.6296730452414143,0.2833223614318506
4610,0.5139,1,12,1,470700,205744,44916,81340,1.6295780002534532,0.2833317077928411
4611,0.514,26,137,26,470837,205607,44942,81314,1.6284929033075657,0.2834020514357611
4612,0.5141,1,7,1,470844,205600,44943,81313,1.6284374603979217,0.2834064681628229
4613,0.5142,15,137,15,470981,205463,44958,81298,1.627352363452034,0.28350438169765063
4614,0.5143,14,56,14,471037,205407,44972,81284,1.6269088201748827,0.2835247705718003
4615,0.5144,1,6,1,471043,205401,44973,81283,1.6268612976809023,0.2835282052713092
4616,0.5145,6,29,6,471072,205372,44979,81277,1.6266316056266632,0.28354189269803837
4617,0.5146,3,9,3,471081,205363,44982,81274,1.6265603218856926,0.2835432969225885
4618,0.5147,5,29,5,471110,205334,44987,81269,1.6263306298314535,0.28355948821191684
4619,0.5148,3,22,3,471132,205312,44990,81266,1.6261563806868584,0.28357375653399775
4620,0.5149,0,6,0,471138,205306,44990,81266,1.626108858192878,0.28357969375933445
4621,0.515,249,1279,249,472417,204027,45239,81017,1.6159786465593715,0.2842262948878068
4622,0.5151,0,13,0,472430,204014,45239,81017,1.615875681155747,0.2842392581859517
4623,0.5152,3,26,3,472456,203988,45242,81014,1.6156697503484982,0.2842576543322503
4624,0.5153,2,33,2,472489,203955,45244,81012,1.6154083766316056,0.2842855488530251
4625,0.5154,0,9,0,472498,203946,45244,81012,1.615337092890635,0.28429452761459584
4626,0.5155,4,27,4,472525,203919,45248,81008,1.6151232416677228,0.28431142011813554
4627,0.5156,0,8,0,472533,203911,45248,81008,1.6150598783424155,0.2843194030584131
4628,0.5157,8,51,8,472584,203860,45256,81000,1.6146559371435814,0.28435020711928666
4629,0.5158,25,126,25,472710,203734,45281,80975,1.6136579647699911,0.2844132078718973
4630,0.5159,1,2,1,472712,203732,45282,80974,1.6136421239386642,0.28441269239144945
4631,0.516,32,143,32,472855,203589,45314,80942,1.612509504498796,0.2844751538496684
4632,0.5161,0,6,0,472861,203583,45314,80942,1.6124619820048156,0.2844811527985239
4633,0.5162,5,27,5,472888,203556,45319,80937,1.6122481307819034,0.2844955763410699
4634,0.5163,4,29,4,472917,203527,45323,80933,1.6120184387276644,0.2845145187372566
4635,0.5164,2,9,2,472926,203518,45325,80931,1.6119471549866937,0.28451849013355646
4636,0.5165,7,30,7,472956,203488,45332,80924,1.6117095425167913,0.2845308918048465
4637,0.5166,0,6,0,472962,203482,45332,80924,1.611662020022811,0.2845368944396391
4638,0.5167,123,689,123,473651,202793,45455,80801,1.6062048536307185,0.2849178755544899
4639,0.5168,7,31,7,473682,202762,45462,80794,1.6059593207451528,0.2849313715809223
4640,0.5169,0,2,0,473684,202760,45462,80794,1.605943479913826,0.2849333812959789
4641,0.517,10,54,10,473738,202706,45472,80784,1.6055157774680016,0.2849624325373029
4642,0.5171,5,17,5,473755,202689,45477,80779,1.6053811304017236,0.284966909845203
4643,0.5172,2,13,2,473768,202676,45479,80777,1.6052781649980992,0.28497493411606156
4644,0.5173,10,47,10,473815,202629,45489,80767,1.6049059054619186,0.28499696537706953
4645,0.5174,1,8,1,473823,202621,45490,80766,1.6048425421366113,0.2850024877640823
4646,0.5175,62,349,62,474172,202272,45552,80704,1.6020783170700799,0.28519733122243585
4647,0.5176,0,14,0,474186,202258,45552,80704,1.601967431250792,0.28521144181904284
4648,0.5177,8,40,8,474226,202218,45560,80696,1.6016506146242555,0.28523155446531456
4649,0.5178,1,11,1,474237,202207,45561,80695,1.601563490051958,0.28524011848626024
4650,0.5179,0,7,0,474244,202200,45561,80695,1.601508047142314,0.2852471765142544
4651,0.518,18,106,18,474350,202094,45579,80677,1.6006684830819922,0.28530860661100327
4652,0.5181,2,9,2,474359,202085,45581,80675,1.6005971993410215,0.2853126326213043
4653,0.5182,3,31,3,474390,202054,45584,80672,1.6003516664554556,0.28533633270374853
4654,0.5183,79,364,79,474754,201690,45663,80593,1.5974686351539729,0.2855042634519259
4655,0.5184,0,1,0,474755,201689,45663,80593,1.5974607147383095,0.285505274866977
4656,0.5185,5,36,5,474791,201653,45668,80588,1.5971755797744265,0.2855290336981516
4657,0.5186,2,18,2,474809,201635,45670,80586,1.5970330122924852,0.2855421814818883
4658,0.5187,6,37,6,474846,201598,45676,80580,1.5967399569129388,0.2855644309620169
4659,0.5188,10,23,10,474869,201575,45686,80570,1.5965577873526802,0.285562388133761
4660,0.5189,0,6,0,474875,201569,45686,80570,1.5965102648586997,0.28556846093592164
4661,0.519,14,65,14,474940,201504,45700,80556,1.5959954378405778,0.28559880876409277
4662,0.5191,1,7,1,474947,201497,45701,80555,1.595939994930934,0.28560336391871005
4663,0.5192,24,137,24,475084,201360,45725,80531,1.5948548979850463,0.2856813449170069
4664,0.5193,6,54,6,475138,201306,45731,80525,1.594427195539222,0.28572087527631806
4665,0.5194,0,4,0,475142,201302,45731,80525,1.5943955138765682,0.2857249305424959
4666,0.5195,2,25,2,475167,201277,45733,80523,1.594197503484983,0.28574520936834635
4667,0.5196,0,3,0,475170,201274,45733,80523,1.5941737422379927,0.2857482514008311
4668,0.5197,10,20,10,475190,201254,45743,80513,1.5940153339247243,0.28574318497198037
4669,0.5198,2,20,2,475210,201234,45745,80511,1.593856925611456,0.285758398551882
4670,0.5199,2,6,2,475216,201228,45747,80509,1.5938094031174757,0.2857594139214942
4671,0.52,730,3942,730,479158,197286,46477,79779,1.5625871245722975,0.28794326241134754
4672,0.5201,1,5,1,479163,197281,46478,79778,1.5625475224939804,0.2879458887818118
4673,0.5202,8,28,8,479191,197253,46486,79770,1.562325750855405,0.28795442977658897
4674,0.5203,4,18,4,479209,197235,46490,79766,1.5621831833734634,0.287962859339858
4675,0.5204,3,9,3,479218,197226,46493,79763,1.5621118996324928,0.2879645040055742
4676,0.5205,4,25,4,479243,197201,46497,79759,1.5619138892409075,0.28798021374927785
4677,0.5206,1,7,1,479250,197194,46498,79758,1.5618584463312635,0.2879849215748577
4678,0.5207,6,60,6,479310,197134,46504,79752,1.5613832213914587,0.2880318976040681
4679,0.5208,26,122,26,479432,197012,46530,79726,1.560416930680522,0.2880919859217021
4680,0.5209,4,9,4,479441,197003,46534,79722,1.5603456469395514,0.2880910651368687
4681,0.521,19,69,19,479510,196934,46553,79703,1.559799138258776,0.2881140266847891
4682,0.5211,0,12,0,479522,196922,46553,79703,1.5597040932708148,0.28812652507907816
4683,0.5212,3,21,3,479543,196901,46556,79700,1.559537764541883,0.28814067917324954
4684,0.5213,7,37,7,479580,196864,46563,79693,1.559244709162337,0.2881612108896177
4685,0.5214,1,7,1,479587,196857,46564,79692,1.559189266252693,0.2881659308115379
4686,0.5215,6,35,6,479622,196822,46570,79686,1.5589120517044734,0.2881869602326153
4687,0.5216,1,3,1,479625,196819,46571,79685,1.5588882904574832,0.2881875126580447
4688,0.5217,72,366,72,479991,196453,46643,79613,1.5559894183246736,0.28838393717444377
4689,0.5218,3,17,3,480008,196436,46646,79610,1.5558547712583957,0.2883939633249531
4690,0.5219,3,8,3,480016,196428,46649,79607,1.5557914079330883,0.28839458764287135
4691,0.522,13,96,13,480112,196332,46662,79594,1.5550310480294005,0.28846139907076535
4692,0.5221,6,11,6,480123,196321,46668,79588,1.554943923457103,0.28845742618037107
4693,0.5222,7,15,7,480138,196306,46675,79581,1.5548251172221519,0.28845505587432535
4694,0.5223,11,28,11,480166,196278,46686,79570,1.5546033455835762,0.28845596125402395
4695,0.5224,1,4,1,480170,196274,46687,79569,1.5545716639209226,0.288457564629155
4696,0.5225,59,330,59,480500,195944,46746,79510,1.5519579267519958,0.2886507366021187
4697,0.5226,1,13,1,480513,195931,46747,79509,1.5518549613483716,0.288661777519605
4698,0.5227,14,40,14,480553,195891,46761,79495,1.551538144721835,0.2886675430123536
4699,0.5228,0,12,0,480565,195879,46761,79495,1.551443099733874,0.28868012230639056
4700,0.5229,1,21,1,480586,195858,46762,79494,1.5512767710049424,0.28869955547807896
4701,0.523,9,44,9,480630,195814,46771,79485,1.550928272715752,0.28872244359768834
4702,0.5231,2,9,2,480639,195805,46773,79483,1.5508569889747814,0.2887267152945279
4703,0.5232,7,21,7,480660,195784,46780,79476,1.5506906602458497,0.2887306546537819
4704,0.5233,130,643,130,481303,195141,46910,79346,1.5455978329742746,0.2890701563279864
4705,0.5234,0,5,0,481308,195136,46910,79346,1.5455582308959575,0.28907542206774944
4706,0.5235,6,35,6,481343,195101,46916,79340,1.545281016347738,0.28909674574863087
4707,0.5236,4,4,4,481347,195097,46920,79336,1.5452493346850842,0.2890905977050865
4708,0.5237,5,25,5,481372,195072,46925,79331,1.545051324293499,0.2891039820993211
4709,0.5238,7,26,7,481398,195046,46932,79324,1.54484539348625,0.2891132412435762
4710,0.5239,2,8,2,481406,195038,46934,79322,1.544782030160943,0.28911648928415223
4711,0.524,21,109,21,481515,194929,46955,79301,1.5439187048536307,0.2891769682383401
4712,0.5241,0,1,0,481516,194928,46955,79301,1.5439107844379674,0.28917802274741183
4713,0.5242,33,114,33,481630,194814,46988,79268,1.543007857052338,0.28921271736195736
4714,0.5243,8,53,8,481683,194761,46996,79260,1.5425880750221772,0.2892479043576952
4715,0.5244,2,11,2,481694,194750,46998,79258,1.5425009504498797,0.28925432834077835
4716,0.5245,6,24,6,481718,194726,47004,79252,1.5423108604739577,0.2892641014972005
4717,0.5246,1,9,1,481727,194717,47005,79251,1.5422395767329868,0.2892710097529638
4718,0.5247,4,31,4,481758,194686,47009,79247,1.5419940438474211,0.28929336735625133
4719,0.5248,5,15,5,481773,194671,47014,79242,1.5418752376124698,0.289296236396228
4720,0.5249,0,10,0,481783,194661,47014,79242,1.5417960334558358,0.2893067983921315
4721,0.525,216,1259,216,483042,193402,47230,79026,1.5318242301355975,0.2900803147987725
4722,0.5251,2,7,2,483049,193395,47232,79024,1.5317687872259536,0.29008255664986654
4723,0.5252,5,16,5,483065,193379,47237,79019,1.531642060575339,0.2900865645122211
4724,0.5253,9,31,9,483096,193348,47246,79010,1.5313965276897732,0.2900961234845314
4725,0.5254,3,14,3,483110,193334,47249,79007,1.5312856418704854,0.29010321618852836
4726,0.5255,4,40,4,483150,193294,47253,79003,1.5309688252439488,0.29013540362178064
4727,0.5256,2,8,2,483158,193286,47255,79001,1.5309054619186415,0.2901387139305218
4728,0.5257,9,45,9,483203,193241,47264,78992,1.5305490432137878,0.29016320578328125
4729,0.5258,28,97,28,483300,193144,47292,78964,1.5297807628944367,0.2901935996001588
4730,0.5259,1,2,1,483302,193142,47293,78963,1.5297649220631098,0.29019312397787617
4731,0.526,27,131,27,483433,193011,47320,78936,1.5287273476112027,0.29026244084325253
4732,0.5261,1,9,1,483442,193002,47321,78935,1.528656063870232,0.2902694374064581
4733,0.5262,6,32,6,483474,192970,47327,78929,1.5284026105690027,0.29028793780043327
4734,0.5263,6,30,6,483504,192940,47333,78923,1.5281649980991003,0.29030430768438514
4735,0.5264,2,11,2,483515,192929,47335,78921,1.5280778735268026,0.2903108331800625
4736,0.5265,6,29,6,483544,192900,47341,78915,1.5278481814725637,0.29032614094144915
4737,0.5266,1,5,1,483549,192895,47342,78914,1.5278085793942466,0.29032887064078083
4738,0.5267,146,653,146,484202,192242,47488,78768,1.5226365479660373,0.2906461016198664
4739,0.5268,2,20,2,484222,192222,47490,78766,1.522478139652769,0.29066231715057494
4740,0.5269,3,6,3,484228,192216,47493,78763,1.5224306171587885,0.2906608999221342
4741,0.527,9,52,9,484280,192164,47502,78754,1.522018755544291,0.2906931248569678
4742,0.5271,2,34,2,484314,192130,47504,78752,1.5217494614117348,0.2907243744508679
4743,0.5272,2,21,2,484335,192109,47506,78750,1.521583132682803,0.2907416774041106
4744,0.5273,13,42,13,484377,192067,47519,78737,1.5212504752249398,0.2907527215255314
4745,0.5274,3,7,3,484384,192060,47522,78734,1.5211950323152958,0.29075238003796244
4746,0.5275,56,361,56,484745,191699,47578,78678,1.5183357622608034,0.2909936865931644
4747,0.5276,3,9,3,484754,191690,47581,78675,1.5182644785198327,0.29099550607512065
4748,0.5277,5,49,5,484803,191641,47586,78670,1.5178763781523255,0.29103514100425065
4749,0.5278,6,12,6,484815,191629,47592,78664,1.5177813331643644,0.29103232418153635
4750,0.5279,1,15,1,484830,191614,47593,78663,1.5176625269294133,0.29104585295826135
4751,0.528,16,80,16,484910,191534,47609,78647,1.51702889367634,0.29109004704253816
4752,0.5281,0,3,0,484913,191531,47609,78647,1.5170051324293499,0.2910932792455344
4753,0.5282,11,20,11,484933,191511,47620,78636,1.5168467241160817,0.291085964308321
4754,0.5283,83,362,83,485295,191149,47703,78553,1.5139795336459256,0.29125850012235727
4755,0.5284,1,5,1,485300,191144,47704,78552,1.5139399315676088,0.2912612719506407
4756,0.5285,5,28,5,485328,191116,47709,78547,1.513718159929033,0.2912783733771411
4757,0.5286,1,14,1,485342,191102,47710,78546,1.5136072741097453,0.2912908680947012
4758,0.5287,12,44,12,485386,191058,47722,78534,1.5132587758205551,0.29130686370515446
4759,0.5288,3,30,3,485416,191028,47725,78531,1.5130211633506527,0.29133139683705606
4760,0.5289,0,6,0,485422,191022,47725,78531,1.512973640856672,0.2913378816039888
4761,0.529,18,79,18,485501,190943,47743,78513,1.5123479280192624,0.29137595748470996
4762,0.5291,0,3,0,485504,190940,47743,78513,1.5123241667722722,0.2913792015676203
4763,0.5292,27,127,27,485631,190813,47770,78486,1.5113182739830187,0.291445567937497
4764,0.5293,11,67,11,485698,190746,47781,78475,1.5107876061335699,0.29148914832052475
4765,0.5294,2,6,2,485704,190740,47783,78473,1.5107400836395894,0.29149038122230353
4766,0.5295,4,20,4,485724,190720,47787,78469,1.510581675326321,0.2915015100914228
4767,0.5296,2,11,2,485735,190709,47789,78467,1.5104945507540235,0.29150815823104587
4768,0.5297,2,25,2,485760,190684,47791,78465,1.5102965403624382,0.2915299703881493
4769,0.5298,5,22,5,485782,190662,47796,78460,1.5101222912178431,0.2915406395612399
4770,0.5299,1,2,1,485784,190660,47797,78459,1.5101064503865163,0.2915401736778154
4771,0.53,764,3641,764,489425,187019,48561,77695,1.4812682169560258,0.29350544361084036
4772,0.5301,1,2,1,489427,187017,48562,77694,1.481252376124699,0.29350499223681675
4773,0.5302,4,31,4,489458,186986,48566,77690,1.4810068432391332,0.2935286916834167
4774,0.5303,9,24,9,489482,186962,48575,77681,1.4808167532632113,0.2935312855431657
4775,0.5304,3,11,3,489493,186951,48578,77678,1.4807296286909137,0.29353547797104623
4776,0.5305,3,27,3,489520,186924,48581,77675,1.4805157774680016,0.29355742085193065
4777,0.5306,0,7,0,489527,186917,48581,77675,1.4804603345583576,0.29356518715607427
4778,0.5307,14,56,14,489583,186861,48595,77661,1.4800167912812063,0.2935899471499535
4779,0.5308,29,109,29,489692,186752,48624,77632,1.4791534659738943,0.2936335027838296
4780,0.5309,3,5,3,489697,186747,48627,77629,1.4791138638955772,0.2936310406390898
4781,0.531,16,81,16,489778,186666,48643,77613,1.4784723102268407,0.2936782718263653
4782,0.5311,0,7,0,489785,186659,48643,77613,1.478416867317197,0.2936860507356057
4783,0.5312,3,27,3,489812,186632,48646,77610,1.4782030160942847,0.29370804035694553
4784,0.5313,3,40,3,489852,186592,48649,77607,1.4778861994677481,0.29374448805635145
4785,0.5314,2,6,2,489858,186586,48651,77605,1.4778386769737675,0.2937458126885473
4786,0.5315,11,29,11,489887,186557,48662,77594,1.4776089849195286,0.29374865133957473
4787,0.5316,2,1,2,489888,186556,48664,77592,1.477601064503865,0.293744416009207
4788,0.5317,56,329,56,490217,186227,48720,77536,1.4749952477506019,0.293960866383837
4789,0.5318,3,25,3,490242,186202,48723,77533,1.4747972373590166,0.29398070032418905
4790,0.5319,3,5,3,490247,186197,48726,77530,1.4747576352806995,0.2939782426524398
4791,0.532,22,67,22,490314,186130,48748,77508,1.4742269674312507,0.2939940372783893
4792,0.5321,6,8,6,490322,186122,48754,77502,1.4741636041059434,0.2939868904196887
4793,0.5322,5,12,5,490334,186110,48759,77497,1.4740685591179825,0.29398688198720063
4794,0.5323,7,27,7,490361,186083,48766,77490,1.4738547078950703,0.29399824716492207
4795,0.5324,3,17,3,490378,186066,48769,77487,1.4737200608287924,0.2940091746252177
4796,0.5325,72,329,72,490707,185737,48841,77415,1.4711142440755292,0.29418358971240954
4797,0.5326,4,11,4,490718,185726,48845,77411,1.4710271195032316,0.29418515830156916
4798,0.5327,9,47,9,490765,185679,48854,77402,1.470654859967051,0.2942135692049217
4799,0.5328,3,17,3,490782,185662,48857,77399,1.470520212900773,0.29422453347322486
4800,0.5329,3,17,3,490799,185645,48860,77396,1.470385565834495,0.2942354994088374
4801,0.533,7,57,7,490856,185588,48867,77389,1.4699341021416803,0.29428048840773147
4802,0.5331,1,11,1,490867,185577,48868,77388,1.4698469775693828,0.2942901146540414
4803,0.5332,2,21,2,490888,185556,48870,77386,1.4696806488404512,0.2943082504887009
4804,0.5333,137,635,137,491523,184921,49007,77249,1.4646511848941832,0.29465232482740206
4805,0.5334,2,13,2,491536,184908,49009,77247,1.4645482194905588,0.29466155518681697
4806,0.5335,4,35,4,491571,184873,49013,77243,1.4642710049423393,0.29469013719116727
4807,0.5336,3,8,3,491579,184865,49016,77240,1.464207641617032,0.294691058926766
4808,0.5337,8,32,8,491611,184833,49024,77232,1.4639541883158027,0.29470551199129985
4809,0.5338,2,18,2,491629,184815,49026,77230,1.4638116208338614,0.2947203724551127
4810,0.5339,0,8,0,491637,184807,49026,77230,1.463748257508554,0.29472937027976964
4811,0.534,23,122,23,491759,184685,49049,77207,1.4627819667976176,0.29480472866677865
4812,0.5341,3,13,3,491772,184672,49052,77204,1.4626790013939932,0.29481128473017765
4813,0.5342,22,105,22,491877,184567,49074,77182,1.4618473577493347,0.2948702764862521
4814,0.5343,11,39,11,491916,184528,49085,77171,1.4615384615384615,0.2948845811409291
4815,0.5344,2,3,2,491919,184525,49087,77169,1.4615147002914712,0.2948825727758374
4816,0.5345,2,36,2,491955,184489,49089,77167,1.4612295653275884,0.2949177546091051
4817,0.5346,3,9,3,491964,184480,49092,77164,1.4611582815866178,0.29491981471006407
4818,0.5347,6,36,6,492000,184444,49098,77158,1.4608731466227347,0.29494422825513567
4819,0.5348,6,33,6,492033,184411,49104,77152,1.460611772905842,0.29496526649411425
4820,0.5349,1,4,1,492037,184407,49105,77151,1.4605800912431885,0.29496708187094256
4821,0.535,267,1208,267,493245,183199,49372,76884,1.4510122291217844,0.295613323439056
4822,0.5351,1,5,1,493250,183194,49373,76883,1.4509726270434673,0.29561629825013364
4823,0.5352,2,20,2,493270,183174,49375,76881,1.450814218730199,0.29563361596585336
4824,0.5353,3,32,3,493302,183142,49378,76878,1.4505607654289696,0.29566187216367973
4825,0.5354,0,8,0,493310,183134,49378,76878,1.4504974021036623,0.2956709690321985
4826,0.5355,4,26,4,493336,183108,49382,76874,1.4502914712964137,0.2956897015947258
4827,0.5356,0,7,0,493343,183101,49382,76874,1.4502360283867697,0.2956976632368497
4828,0.5357,9,53,9,493396,183048,49391,76865,1.4498162463566089,0.29573357238768355
4829,0.5358,23,130,23,493526,182918,49414,76842,1.4487865923203649,0.2958192177394518
4830,0.5359,1,11,1,493537,182907,49415,76841,1.4486994677480673,0.295829034294778
4831,0.536,27,124,27,493661,182783,49442,76814,1.447717336205804,0.29589710204663383
4832,0.5361,4,9,4,493670,182774,49446,76810,1.4476460524648334,0.29589651134122286
4833,0.5362,6,33,6,493703,182741,49452,76804,1.4473846787479407,0.29591785624843475
4834,0.5363,5,23,5,493726,182718,49457,76799,1.4472025091876821,0.29593051707595264
4835,0.5364,3,14,3,493740,182704,49460,76796,1.4470916233683944,0.2959383429672447
4836,0.5365,8,24,8,493764,182680,49468,76788,1.4469015333924724,0.2959440085097199
4837,0.5366,2,6,2,493770,182674,49470,76786,1.446854010898492,0.2959454251136977
4838,0.5367,127,609,127,494379,182065,49597,76659,1.4420304777594728,0.2962964394489881
4839,0.5368,1,23,1,494402,182042,49598,76658,1.4418483081992144,0.29632006184770004
4840,0.5369,3,8,3,494410,182034,49601,76655,1.441784944873907,0.29632106506268147
4841,0.537,14,67,14,494477,181967,49615,76641,1.4412542770244583,0.29635974138464394
4842,0.5371,8,19,8,494496,181948,49623,76633,1.4411037891268534,0.29635974800932785
4843,0.5372,4,19,4,494515,181929,49627,76629,1.4409533012292486,0.2963706402431949
4844,0.5373,8,37,8,494552,181892,49635,76621,1.4406602458497022,0.2963912839973232
4845,0.5374,6,10,6,494562,181882,49641,76615,1.440581041693068,0.2963864184110454
4846,0.5375,58,344,58,494906,181538,49699,76557,1.4378564187048537,0.2966233363683915
4847,0.5376,2,8,2,494914,181530,49701,76555,1.4377930553795464,0.2966270802255071
4848,0.5377,3,43,3,494957,181487,49704,76552,1.4374524775060196,0.2966683330814334
4849,0.5378,2,21,2,494978,181466,49706,76550,1.4372861487770878,0.2966870271611063
4850,0.5379,5,15,5,494993,181451,49711,76545,1.4371673425421365,0.29669064636661036
4851,0.538,18,92,18,495085,181359,49729,76527,1.4364386643011025,0.29674740001395966
4852,0.5381,2,6,2,495091,181353,49731,76525,1.436391141807122,0.2967488502315048
4853,0.5382,2,34,2,495125,181319,49733,76523,1.4361218476745659,0.2967825257328131
4854,0.5383,75,325,75,495450,180994,49808,76448,1.4335477125839564,0.29695232324173987
4855,0.5384,1,5,1,495455,180989,49809,76447,1.4335081105056393,0.2969553597787411
4856,0.5385,2,37,2,495492,180952,49811,76445,1.433215055126093,0.29699258344114343
4857,0.5386,4,19,4,495511,180933,49815,76441,1.433064567228488,0.29700358233543406
4858,0.5387,10,32,10,495543,180901,49825,76431,1.4328111139272588,0.29701319695956974
4859,0.5388,4,20,4,495563,180881,49829,76427,1.4326527056139906,0.29702535482767733
4860,0.5389,2,2,2,495565,180879,49831,76425,1.4326368647826637,0.2970221994216957
4861,0.539,7,67,7,495632,180812,49838,76418,1.432106196933215,0.29708043385297206
4862,0.5391,1,5,1,495637,180807,49839,76417,1.432066594854898,0.29708347588094425
4863,0.5392,24,118,24,495755,180689,49863,76393,1.4311319858066152,0.29715421538653036
4864,0.5393,9,56,9,495811,180633,49872,76384,1.430688442529464,0.2971943490119331
4865,0.5394,1,5,1,495816,180628,49873,76383,1.4306488404511468,0.29719739622039526
4866,0.5395,5,25,5,495841,180603,49878,76378,1.4304508300595615,0.2972126343970955
4867,0.5396,1,7,1,495848,180596,49879,76377,1.4303953871499175,0.2972179956649142
4868,0.5397,1,19,1,495867,180577,49880,76376,1.4302448992523127,0.2972372379384557
4869,0.5398,4,18,4,495885,180559,49884,76372,1.4301023317703714,0.29724712082232196
4870,0.5399,0,7,0,495892,180552,49884,76372,1.4300468888607274,0.29725521944232536
4871,0.54,752,3674,752,499566,176878,50636,75620,1.4009472817133444,0.2994875206932332
4872,0.5401,4,2,4,499568,176876,50640,75616,1.4009314408820175,0.29947879536777405
4873,0.5402,4,19,4,499587,176857,50644,75612,1.4007809529844126,0.29949023444462486
4874,0.5403,7,26,7,499613,176831,50651,75605,1.4005750221771638,0.299501655865249
4875,0.5404,2,8,2,499621,176823,50653,75603,1.4005116588518565,0.2995055976801122
4876,0.5405,3,28,3,499649,176795,50656,75600,1.400289887213281,0.2995304978307811
4877,0.5406,3,4,3,499653,176791,50659,75597,1.4002582055506272,0.29952691887094474
4878,0.5407,6,63,6,499716,176728,50665,75591,1.3997592193638322,0.2995850490846904
4879,0.5408,26,113,26,499829,176615,50691,75565,1.3988642123938664,0.2996470774843366
4880,0.5409,1,11,1,499840,176604,50692,75564,1.3987770878215688,0.299657371276292
4881,0.541,16,95,16,499935,176509,50708,75548,1.3980246483335446,0.29972585565963256
4882,0.5411,3,8,3,499943,176501,50711,75545,1.3979612850082372,0.2997270339541195
4883,0.5412,4,18,4,499961,176483,50715,75541,1.3978187175262957,0.2997373266038155
4884,0.5413,7,40,7,500001,176443,50722,75534,1.3975019008997591,0.2997654547835715
4885,0.5414,2,17,2,500018,176426,50724,75532,1.3973672538334811,0.29978012208383936
4886,0.5415,10,28,10,500046,176398,50734,75522,1.3971454821949056,0.2997856462369006
4887,0.5416,2,9,2,500055,176389,50736,75520,1.3970741984539348,0.2997907974705151
4888,0.5417,71,320,71,500375,176069,50807,75449,1.3945396654416424,0.29997455450504534
4889,0.5418,3,44,3,500419,176025,50810,75446,1.394191167152452,0.30001869002787596
4890,0.5419,2,5,2,500424,176020,50812,75444,1.3941515650741352,0.3000190882193873
4891,0.542,17,58,17,500482,175962,50829,75427,1.393692180965657,0.30004097235758126
4892,0.5421,3,7,3,500489,175955,50832,75424,1.393636738056013,0.300040973987485
4893,0.5422,2,11,2,500500,175944,50834,75422,1.3935496134837155,0.300048534805821
4894,0.5423,3,32,3,500532,175912,50837,75419,1.3932961601824865,0.3000783826905555
4895,0.5424,2,12,2,500544,175900,50839,75417,1.3932011151945254,0.30008714094152006
4896,0.5425,61,311,61,500855,175589,50900,75356,1.3907378659232037,0.30028890792803203
4897,0.5426,1,6,1,500861,175583,50901,75355,1.3906903434292233,0.30029329954012546
4898,0.5427,15,47,15,500908,175536,50916,75340,1.3903180838930427,0.30030772174301246
4899,0.5428,4,13,4,500921,175523,50920,75336,1.3902151184894183,0.30031212752980757
4900,0.5429,6,13,6,500934,175510,50926,75330,1.3901121530857938,0.3003109551905597
4901,0.543,5,33,5,500967,175477,50931,75325,1.3898507793689012,0.3003365204424207
4902,0.5431,4,11,4,500978,175466,50935,75321,1.3897636547966037,0.30033853429404234
4903,0.5432,4,25,4,501003,175441,50939,75317,1.3895656444050184,0.3003573166160202
4904,0.5433,127,640,127,501643,174801,51066,75190,1.3844965783804335,0.300770827749799
4905,0.5434,0,5,0,501648,174796,51066,75190,1.3844569763021164,0.3007768435032362
4906,0.5435,14,33,14,501681,174763,51080,75176,1.3841956025852238,0.30077738968308265
4907,0.5436,2,8,2,501689,174755,51082,75174,1.3841322392599165,0.30078142192382634
4908,0.5437,9,42,9,501731,174713,51091,75165,1.383799581802053,0.3008067937153331
4909,0.5438,9,26,9,501757,174687,51100,75156,1.3835936509948041,0.3008129105077989
4910,0.5439,0,3,0,501760,174684,51100,75156,1.383569889747814,0.30081652257444763
4911,0.544,26,121,26,501881,174563,51126,75130,1.3826115194525408,0.30088949229654016
4912,0.5441,0,3,0,501884,174560,51126,75130,1.3825877582055506,0.300893107453242
4913,0.5442,29,127,29,502011,174433,51155,75101,1.381581865416297,0.30096499875768434
4914,0.5443,10,48,10,502059,174385,51165,75091,1.381201685464453,0.30099488527954593
4915,0.5444,0,9,0,502068,174376,51165,75091,1.3811304017234824,0.30100574424673404
4916,0.5445,5,26,5,502094,174350,51170,75086,1.3809244709162336,0.30102310813194566
4917,0.5446,1,10,1,502104,174340,51171,75085,1.3808452667595996,0.3010323744612609
4918,0.5447,8,31,8,502135,174309,51179,75077,1.3805997338740337,0.301047372346483
4919,0.5448,5,26,5,502161,174283,51184,75072,1.380393803066785,0.30106474704738223
4920,0.5449,1,10,1,502171,174273,51185,75071,1.3803145989101508,0.3010740182238193
4921,0.545,255,1158,255,503329,173115,51440,74816,1.3711427575719173,0.30176137715735424
4922,0.5451,3,9,3,503338,173106,51443,74813,1.3710714738309466,0.30176388255841624
4923,0.5452,7,23,7,503361,173083,51450,74806,1.3708893042706882,0.30177216415411734
4924,0.5453,3,34,3,503395,173049,51453,74803,1.370620010138132,0.3018051095008311
4925,0.5454,1,5,1,503400,173044,51454,74802,1.370580408059815,0.30180838101078894
4926,0.5455,6,19,6,503419,173025,51460,74796,1.37042992016221,0.30181461619475347
4927,0.5456,2,5,2,503424,173020,51462,74794,1.370390318083893,0.30181507098065485
4928,0.5457,8,44,8,503468,172976,51470,74786,1.3700418197947029,0.30184612652464865
4929,0.5458,29,99,29,503567,172877,51499,74757,1.3692576986440248,0.30188504001873734
4930,0.5459,0,3,0,503570,172874,51499,74757,1.3692339373970346,0.3018886972955728
4931,0.546,26,106,26,503676,172768,51525,74731,1.3683943733367128,0.30194465432183565
4932,0.5461,2,7,2,503683,172761,51527,74729,1.3683389304270688,0.3019475534365025
4933,0.5462,7,22,7,503705,172739,51534,74722,1.3681646812824737,0.30195465144002487
4934,0.5463,6,29,6,503734,172710,51540,74716,1.3679349892282346,0.3019731151940378
4935,0.5464,1,13,1,503747,172697,51541,74715,1.3678320238246102,0.3019861607359384
4936,0.5465,7,29,7,503776,172668,51548,74708,1.3676023317703714,0.30200181100834356
4937,0.5466,2,5,2,503781,172663,51550,74706,1.3675627296920543,0.3020022719095764
4938,0.5467,152,637,152,504418,172026,51702,74554,1.3625174249144596,0.30235217779219725
4939,0.5468,3,28,3,504446,171998,51705,74551,1.3622956532758839,0.3023780262746959
4940,0.5469,1,5,1,504451,171993,51706,74550,1.3622560511975668,0.30238132901765613
4941,0.547,7,50,7,504501,171943,51713,74543,1.3618600304143962,0.30242285565914495
4942,0.5471,5,15,5,504516,171928,51718,74538,1.3617412241794449,0.30242710962161107
4943,0.5472,5,9,5,504525,171919,51723,74533,1.3616699404384742,0.30242400142827003
4944,0.5473,9,28,9,504553,171891,51732,74524,1.3614481687998987,0.30243288760830306
4945,0.5474,1,7,1,504560,171884,51733,74523,1.3613927258902547,0.3024386482526876
4946,0.5475,62,324,62,504884,171560,51795,74461,1.3588265112153086,0.3026611549420578
4947,0.5476,4,10,4,504894,171550,51799,74457,1.3587473070586744,0.302662119370587
4948,0.5477,7,41,7,504935,171509,51806,74450,1.3584225700164745,0.3026927252102993
4949,0.5478,4,16,4,504951,171493,51810,74446,1.3582958433658598,0.30270107628314336
4950,0.5479,3,14,3,504965,171479,51813,74443,1.358184957546572,0.30270980229503663
4951,0.548,19,94,19,505059,171385,51832,74424,1.3574404384742111,0.30277166417828477
4952,0.5481,0,8,0,505067,171377,51832,74424,1.3573770751489038,0.3027815183827568
4953,0.5482,7,29,7,505096,171348,51839,74417,1.3571473830946648,0.3027973877484589
4954,0.5483,65,329,65,505425,171019,51904,74352,1.3545415663414015,0.30301869414070937
4955,0.5484,2,7,2,505432,171012,51906,74350,1.3544861234317578,0.3030216577954206
4956,0.5485,9,35,9,505467,170977,51915,74341,1.3542089088835383,0.30303932039230713
4957,0.5486,4,10,4,505477,170967,51919,74337,1.354129704726904,0.30304030916740043
4958,0.5487,5,32,5,505509,170935,51924,74332,1.3538762514256748,0.3030656386713255
4959,0.5488,3,27,3,505536,170908,51927,74329,1.3536624002027626,0.30309047982156034
4960,0.5489,1,5,1,505541,170903,51928,74328,1.3536227981244455,0.3030938176657927
4961,0.549,14,69,14,505610,170834,51942,74314,1.35307628944367,0.3031393280793643
4962,0.5491,1,3,1,505613,170831,51943,74313,1.3530525281966799,0.30314019515060536
4963,0.5492,14,108,14,505721,170723,51957,74299,1.352197123305031,0.30323399531470646
4964,0.5493,11,48,11,505769,170675,51968,74288,1.3518169433531873,0.3032621253005556
4965,0.5494,1,7,1,505776,170668,51969,74287,1.3517615004435433,0.3032679471739707
4966,0.5495,6,34,6,505810,170634,51975,74281,1.351492206310987,0.3032929791968642
4967,0.5496,5,5,5,505815,170629,51980,74276,1.3514526042326702,0.30328494722443394
4968,0.5497,6,21,6,505836,170608,51986,74270,1.3512862755037385,0.3032938851183038
4969,0.5498,4,31,4,505867,170577,51990,74266,1.3510407426181725,0.30332090359944947
4970,0.5499,0,5,0,505872,170572,51990,74266,1.3510011405398554,0.3033270979178069
4971,0.55,778,3530,778,509402,167042,52768,73488,1.3230420732480042,0.3055252982995884
4972,0.5501,0,8,0,509410,167034,52768,73488,1.3229787099226968,0.30553546037368723
4973,0.5502,9,18,9,509428,167016,52777,73479,1.3228361424407553,0.3055323395496788
4974,0.5503,5,20,5,509448,166996,52782,73474,1.322677734127487,0.30554331101592713
4975,0.5504,2,9,2,509457,166987,52784,73472,1.3226064503865163,0.3055489709264365
4976,0.5505,4,15,4,509472,166972,52788,73468,1.3224876441515652,0.3055564797870571
4977,0.5506,3,8,3,509480,166964,52791,73465,1.3224242808262578,0.3055579817742452
4978,0.5507,13,41,13,509521,166923,52804,73452,1.3220995437840577,0.3055725429017161
4979,0.5508,26,117,26,509638,166806,52830,73426,1.3211728551514383,0.30564620866495723
4980,0.5509,2,8,2,509646,166798,52832,73424,1.321109491826131,0.3056506065223002
4981,0.551,12,55,12,509701,166743,52844,73412,1.3206738689646433,0.3056859111823614
4982,0.5511,1,7,1,509708,166736,52845,73411,1.3206184260549994,0.3056919303593216
4983,0.5512,3,33,3,509741,166703,52848,73408,1.3203570523381067,0.3057252687298791
4984,0.5513,0,35,0,509776,166668,52848,73408,1.3200798377898872,0.3057698395508089
4985,0.5514,2,12,2,509788,166656,52850,73406,1.3199847928019262,0.3057793403370796
4986,0.5515,6,24,6,509812,166632,52856,73400,1.3197947028260044,0.30579256099186775
4987,0.5516,2,8,2,509820,166624,52858,73398,1.319731339500697,0.30579696861121064
4988,0.5517,85,334,85,510154,166290,52943,73313,1.3170859206691168,0.30597697023826914
4989,0.5518,7,19,7,510173,166271,52950,73306,1.316935432771512,0.3059809581053273
4990,0.5519,5,12,5,510185,166259,52955,73301,1.3168403877835508,0.30598179996660546
4991,0.552,13,75,13,510260,166184,52968,73288,1.3162463566087947,0.30603995456671346
4992,0.5521,2,9,2,510269,166175,52970,73286,1.316175072867824,0.3060456608800598
4993,0.5522,2,13,2,510282,166162,52972,73284,1.3160721074641997,0.3060564803755335
4994,0.5523,12,43,12,510325,166119,52984,73272,1.3157315295906729,0.30607666954898055
4995,0.5524,0,15,0,510340,166104,52984,73272,1.3156127233557218,0.30609584920794064
4996,0.5525,70,304,70,510644,165800,53054,73202,1.3132049169940438,0.30628195579953305
4997,0.5526,1,3,1,510647,165797,53055,73201,1.3131811557470536,0.30628289776483486
4998,0.5527,15,49,15,510696,165748,53070,73186,1.3127930553795464,0.3063021587551374
4999,0.5528,3,19,3,510715,165729,53073,73183,1.3126425674819415,0.30631780739351727
5000,0.5529,2,13,2,510728,165716,53075,73181,1.312539602078317,0.3063286688405463
5001,0.553,13,51,13,510779,165665,53088,73168,1.312135660879483,0.30635632429354404
5002,0.5531,2,3,2,510782,165662,53090,73166,1.3121118996324928,0.3063543638099385
5003,0.5532,9,26,9,510808,165636,53099,73157,1.311905968825244,0.30636157676313797
5004,0.5533,138,580,138,511388,165056,53237,73019,1.3073121277404638,0.3067058699989499
5005,0.5534,0,8,0,511396,165048,53237,73019,1.3072487644151565,0.30671617653853744
5006,0.5535,4,22,4,511418,165026,53241,73015,1.3070745152705614,0.30673287374863994
5007,0.5536,2,9,2,511427,165017,53243,73013,1.3070032315295907,0.30673864638911064
5008,0.5537,6,21,6,511448,164996,53249,73007,1.306836902800659,0.30674823426595466
5009,0.5538,1,35,1,511483,164961,53250,73006,1.3065596882524395,0.3067904373295457
5010,0.5539,2,5,2,511488,164956,53252,73004,1.3065200861741224,0.30679105732055806
5011,0.554,27,129,27,511617,164827,53279,72977,1.305498352553542,0.3068787741164993
5012,0.5541,2,4,2,511621,164823,53281,72975,1.3054666708908884,0.3068781066283148
5013,0.5542,22,107,22,511728,164716,53303,72953,1.304619186414903,0.3069521056595517
5014,0.5543,10,51,10,511779,164665,53313,72943,1.304215245216069,0.3069888219251877
5015,0.5544,1,10,1,511789,164655,53314,72942,1.3041360410594347,0.3069988257427493
5016,0.5545,3,26,3,511815,164629,53317,72939,1.303930110252186,0.30702367322198276
5017,0.5546,3,16,3,511831,164613,53320,72936,1.3038033836015714,0.30703560107598854
5018,0.5547,6,48,6,511879,164565,53326,72930,1.3034232036497275,0.3070801490557696
5019,0.5548,5,22,5,511901,164543,53331,72925,1.3032489545051325,0.30709400845587614
5020,0.5549,3,10,3,511911,164533,53334,72922,1.3031697503484982,0.30709818702491
5021,0.555,255,1086,255,512997,163447,53589,72667,1.2945681789380308,0.30776235208416275
5022,0.5551,2,2,2,512999,163445,53591,72665,1.294552338106704,0.30775909533691925
5023,0.5552,8,19,8,513018,163426,53599,72657,1.294401850209099,0.3077604062977851
5024,0.5553,2,27,2,513045,163399,53601,72655,1.2941879989861869,0.3077897430249011
5025,0.5554,2,9,2,513054,163390,53603,72653,1.294116715245216,0.3077956135110976
5026,0.5555,7,29,7,513083,163361,53610,72646,1.2938870231909771,0.3078129038545467
5027,0.5556,1,9,1,513092,163352,53611,72645,1.2938157394500063,0.30782170959800337
5028,0.5557,9,45,9,513137,163307,53620,72636,1.2934593207451528,0.3078540155885108
5029,0.5558,23,99,23,513236,163208,53643,72613,1.2926751995944747,0.3079157496575793
5030,0.5559,0,7,0,513243,163201,53643,72613,1.2926197566848308,0.307924889955643
5031,0.556,29,132,29,513375,163069,53672,72584,1.29157426181726,0.3080122043852614
5032,0.5561,0,6,0,513381,163063,53672,72584,1.2915267393232797,0.3080200469346098
5033,0.5562,5,30,5,513411,163033,53677,72579,1.2912891268533773,0.3080445817700287
5034,0.5563,3,25,3,513436,163008,53680,72576,1.291091116461792,0.3080684596577017
5035,0.5564,0,3,0,513439,163005,53680,72576,1.2910673552148018,0.30807238274733534
5036,0.5565,6,39,6,513478,162966,53686,72570,1.2907584590039285,0.30810576727124517
5037,0.5566,1,6,1,513484,162960,53687,72569,1.290710936509948,0.3081106785151722
5038,0.5567,125,575,125,514059,162385,53812,72444,1.286156697503485,0.30849682109109183
5039,0.5568,2,17,2,514076,162368,53814,72442,1.2860220504372069,0.3085132660448874
5040,0.5569,1,6,1,514082,162362,53815,72441,1.2859745279432264,0.30851820462259855
5041,0.557,6,34,6,514116,162328,53821,72435,1.2857052338106705,0.3085452136835873
5042,0.5571,5,22,5,514138,162306,53826,72430,1.2855309846660752,0.30855940290368755
5043,0.5572,6,15,6,514153,162291,53832,72424,1.285412178431124,0.30856144686108683
5044,0.5573,11,36,11,514189,162255,53843,72413,1.2851270434672413,0.30857637172516067
5045,0.5574,1,7,1,514196,162248,53844,72412,1.2850716005575973,0.30858263018835763
5046,0.5575,65,293,65,514489,161955,53909,72347,1.282750918768217,0.30877670698500226
5047,0.5576,0,4,0,514493,161951,53909,72347,1.2827192371055633,0.3087819785060052
5048,0.5577,1,28,1,514521,161923,53910,72346,1.2824974654669876,0.3088159338196688
5049,0.5578,2,17,2,514538,161906,53912,72344,1.2823628184007096,0.3088324439701174
5050,0.5579,1,15,1,514553,161891,53913,72343,1.2822440121657586,0.3088492703877319
5051,0.558,20,90,20,514643,161801,53933,72323,1.2815311747560512,0.3089089542293827
5052,0.5581,3,14,3,514657,161787,53936,72320,1.2814202889367634,0.3089185714224692
5053,0.5582,2,28,2,514685,161759,53938,72318,1.281198517298188,0.308949619142419
5054,0.5583,81,328,81,515013,161431,54019,72237,1.278600620960588,0.3091437424037523
5055,0.5584,2,2,2,515015,161429,54021,72235,1.2785847801292611,0.3091404752122706
5056,0.5585,8,29,8,515044,161400,54029,72227,1.278355088075022,0.30915519182286294
5057,0.5586,1,15,1,515059,161385,54030,72226,1.278236281840071,0.30917208521858985
5058,0.5587,3,30,3,515089,161355,54033,72223,1.2779986693701686,0.30920292150801876
5059,0.5588,2,21,2,515110,161334,54035,72221,1.2778323406412369,0.3092248078611034
5060,0.5589,2,19,2,515129,161315,54037,72219,1.277681852743632,0.3092440501168995
5061,0.559,20,72,20,515201,161243,54057,72199,1.2771115828158661,0.30928024948381183
5062,0.5591,2,6,2,515207,161237,54059,72197,1.2770640603218857,0.3092822810730228
5063,0.5592,24,108,24,515315,161129,54083,72173,1.276208655430237,0.3093543990192969
5064,0.5593,9,34,9,515349,161095,54092,72164,1.2759393612976808,0.30937284306286145
5065,0.5594,1,3,1,515352,161092,54093,72163,1.2759156000506906,0.3093738612248398
5066,0.5595,5,25,5,515377,161067,54098,72158,1.2757175896591053,0.3093922178154143
5067,0.5596,1,8,1,515385,161059,54099,72157,1.275654226333798,0.30939986964873767
5068,0.5597,3,22,3,515407,161037,54102,72154,1.275479977189203,0.3094201748781042
5069,0.5598,7,13,7,515420,161024,54109,72147,1.2753770117855785,0.30941669418581214
5070,0.5599,2,6,2,515426,161018,54111,72145,1.275329489291598,0.3094187328178141
5071,0.56,828,3377,828,518803,157641,54939,71317,1.248582245596249,0.31148507586544255
5072,0.5601,4,10,4,518813,157631,54943,71313,1.2485030414396148,0.31148665175763507
5073,0.5602,6,16,6,518829,157615,54949,71307,1.2483763147890001,0.3114903766348363
5074,0.5603,4,24,4,518853,157591,54953,71303,1.2481862248130782,0.311511005094061
5075,0.5604,1,1,1,518854,157590,54954,71302,1.2481783043974148,0.31150935812522934
5076,0.5605,2,23,2,518877,157567,54956,71300,1.2479961348371562,0.3115346467599086
5077,0.5606,1,6,1,518883,157561,54957,71299,1.2479486123431758,0.3115398059949314
5078,0.5607,7,52,7,518935,157509,54964,71292,1.2475367507286783,0.3115895472484823
5079,0.5608,20,99,20,519034,157410,54984,71272,1.2467526295780003,0.3116642324275632
5080,0.5609,1,1,1,519035,157409,54985,71271,1.246744709162337,0.3116625852719958
5081,0.561,10,63,10,519098,157346,54995,71261,1.2462457229755417,0.31171836382962903
5082,0.5611,4,14,4,519112,157332,54999,71257,1.246134837156254,0.31172541110902097
5083,0.5612,6,22,6,519134,157310,55005,71251,1.2459605880116589,0.31173734801650327
5084,0.5613,10,38,10,519172,157272,55015,71241,1.2456596122164492,0.3117590684118628
5085,0.5614,2,15,2,519187,157257,55017,71239,1.2455408059814979,0.3117735102583853
5086,0.5615,10,34,10,519221,157223,55027,71229,1.245271511848942,0.3117897851627475
5087,0.5616,0,3,0,519224,157220,55027,71229,1.2452477506019517,0.311793879596759
5088,0.5617,81,328,81,519552,156892,55108,71148,1.2426498542643518,0.31199789510612175
5089,0.5618,5,23,5,519575,156869,55113,71143,1.2424676847040932,0.31201427995017805
5090,0.5619,2,9,2,519584,156860,55115,71141,1.2423964009631225,0.31202056131332756
5091,0.562,19,54,19,519638,156806,55134,71122,1.2419686985172982,0.3120371345337124
5092,0.5621,2,9,2,519647,156797,55136,71120,1.2418974147763275,0.3120434193149261
5093,0.5622,5,19,5,519666,156778,55141,71115,1.2417469268787227,0.3120543412917466
5094,0.5623,10,39,10,519705,156739,55151,71105,1.2414380306678494,0.31207756184055757
5095,0.5624,3,2,3,519707,156737,55154,71102,1.2414221898365225,0.31207124329021807
5096,0.5625,71,281,71,519988,156456,55225,71031,1.2391965530351032,0.31224201822521724
5097,0.5626,0,9,0,519997,156447,55225,71031,1.2391252692941326,0.31225437185134386
5098,0.5627,8,48,8,520045,156399,55233,71023,1.2387450893422887,0.3122960839320734
5099,0.5628,4,23,4,520068,156376,55237,71019,1.2385629197820303,0.3123155742210691
5100,0.5629,1,12,1,520080,156364,55238,71018,1.2384678747940692,0.3123290322013176
5101,0.563,11,37,11,520117,156327,55249,71007,1.2381748194145228,0.31234659135896964
5102,0.5631,1,5,1,520122,156322,55250,71006,1.238135217336206,0.3123504363738739
5103,0.5632,1,17,1,520139,156305,55251,71005,1.2380005702699277,0.31237077119352424
5104,0.5633,132,540,132,520679,155765,55383,70873,1.2337235458116842,0.3127145491929862
5105,0.5634,1,15,1,520694,155750,55384,70872,1.233604739576733,0.31273221487763764
5106,0.5635,8,33,8,520727,155717,55392,70864,1.2333433658598403,0.31275349654207546
5107,0.5636,2,12,2,520739,155705,55394,70862,1.2332483208718794,0.31276399475651795
5108,0.5637,6,24,6,520763,155681,55400,70856,1.2330582308959575,0.3127789279455453
5109,0.5638,6,28,6,520791,155653,55406,70850,1.2328364592573817,0.31279938897056553
5110,0.5639,1,16,1,520807,155637,55407,70849,1.2327097326067673,0.31281845235467093
5111,0.564,27,105,27,520912,155532,55434,70822,1.2318780889621088,0.312881592549723
5112,0.5641,1,1,1,520913,155531,55435,70821,1.2318701685464453,0.31287993920972645
5113,0.5642,21,109,21,521022,155422,55456,70800,1.2310068432391332,0.3129669086118945
5114,0.5643,7,53,7,521075,155369,55463,70793,1.2305870612089722,0.31301898639028664
5115,0.5644,0,7,0,521082,155362,55463,70793,1.2305316182993284,0.3130286750237669
5116,0.5645,7,28,7,521110,155334,55470,70786,1.2303098466607527,0.31304617017512826
5117,0.5646,2,10,2,521120,155324,55472,70784,1.2302306425041185,0.31305393882569393
5118,0.5647,9,27,9,521147,155297,55481,70775,1.2300167912812063,0.31306397961711313
5119,0.5648,0,16,0,521163,155281,55481,70775,1.229890064630592,0.31308613794811907
5120,0.5649,0,10,0,521173,155271,55481,70775,1.2298108604739577,0.31309998849791637
5121,0.565,257,1041,257,522214,154230,55738,70518,1.2215657077683437,0.3137647498531689
5122,0.5651,1,7,1,522221,154223,55739,70517,1.2215102648586997,0.3137714692533594
5123,0.5652,2,25,2,522246,154198,55741,70515,1.2213122544671144,0.3138002696773217
5124,0.5653,8,28,8,522274,154170,55749,70507,1.221090482828539,0.31381494322961406
5125,0.5654,3,4,3,522278,154166,55752,70504,1.2210588011658852,0.31381136778386076
5126,0.5655,3,27,3,522305,154139,55755,70501,1.220844949942973,0.31383992165242164
5127,0.5656,1,8,1,522313,154131,55756,70500,1.2207815866176657,0.3138480441256995
5128,0.5657,6,44,6,522357,154087,55762,70494,1.2204330883284755,0.3138912018380896
5129,0.5658,28,88,28,522445,153999,55790,70466,1.219736091750095,0.3139286748490856
5130,0.5659,1,4,1,522449,153995,55791,70465,1.2197044100874415,0.31393121268822954
5131,0.566,18,124,18,522573,153871,55809,70447,1.2187222785451781,0.3140496973047192
5132,0.5661,2,3,2,522576,153868,55811,70445,1.218698517298188,0.3140477814482442
5133,0.5662,3,21,3,522597,153847,55814,70442,1.2185321885692562,0.31406801046863647
5134,0.5663,7,18,7,522615,153829,55821,70435,1.2183896210873146,0.3140718082260193
5135,0.5664,1,11,1,522626,153818,55822,70434,1.218302496515017,0.3140841553252591
5136,0.5665,3,36,3,522662,153782,55825,70431,1.2180173615511343,0.3141254075365835
5137,0.5666,1,7,1,522669,153775,55826,70430,1.2179619186414903,0.31413215583952186
5138,0.5667,125,514,125,523183,153261,55951,70305,1.2138908249904956,0.3144708945009527
5139,0.5668,15,24,15,523207,153237,55966,70290,1.2137007350145737,0.3144586560012884
5140,0.5669,0,7,0,523214,153230,55966,70290,1.2136452921049297,0.31446850393700787
5141,0.567,9,36,9,523250,153194,55975,70281,1.2133601571410468,0.3144915538650856
5142,0.5671,3,10,3,523260,153184,55978,70278,1.2132809529844126,0.3144964244480046
5143,0.5672,1,19,1,523279,153165,55979,70277,1.2131304650868078,0.314520099175625
5144,0.5673,6,46,6,523325,153119,55985,70271,1.2127661259662907,0.3145664532879717
5145,0.5674,2,10,2,523335,153109,55987,70269,1.2126869218096565,0.3145743985531252
5146,0.5675,63,284,63,523619,152825,56050,70206,1.210437523761247,0.3147813532647928
5147,0.5676,3,8,3,523627,152817,56053,70203,1.2103741604359397,0.3147834274952919
5148,0.5677,5,39,5,523666,152778,56058,70198,1.2100652642250664,0.3148231199770379
5149,0.5678,3,23,3,523689,152755,56061,70195,1.209883094664808,0.31484637811168426
5150,0.5679,6,8,6,523697,152747,56067,70189,1.2098197313395007,0.31483923637277067
5151,0.568,13,85,13,523782,152662,56080,70176,1.2091464960081104,0.3149193584577137
5152,0.5681,0,6,0,523788,152656,56080,70176,1.20909897351413,0.31492783801249374
5153,0.5682,4,20,4,523808,152636,56084,70172,1.2089405652008618,0.31494380812179096
5154,0.5683,84,298,84,524106,152338,56168,70088,1.2065802813331643,0.3151070468380495
5155,0.5684,0,4,0,524110,152334,56168,70088,1.2065485996705108,0.3151127136704103
5156,0.5685,6,27,6,524137,152307,56174,70082,1.2063347484475986,0.3151324930639555
5157,0.5686,1,6,1,524143,152301,56175,70081,1.2062872259536181,0.3151379158385121
5158,0.5687,11,31,11,524174,152270,56186,70070,1.2060416930680522,0.3151479715750652
5159,0.5688,2,27,2,524201,152243,56188,70068,1.20582784184514,0.31518008555582044
5160,0.5689,2,4,2,524205,152239,56190,70066,1.2057961601824865,0.31517959560063874
5161,0.569,12,70,12,524275,152169,56202,70054,1.2052417310860475,0.3152418966533617
5162,0.5691,1,4,1,524279,152165,56203,70053,1.2052100494233937,0.31524448964530327
5163,0.5692,28,112,28,524391,152053,56231,70025,1.2043229628690915,0.31531714082439505
5164,0.5693,8,43,8,524434,152010,56239,70017,1.2039823849955646,0.3153535380832061
5165,0.5694,0,12,0,524446,151998,56239,70017,1.2038873400076036,0.3153705830687116
5166,0.5695,4,20,4,524466,151978,56243,70013,1.2037289316943354,0.3153866598195422
5167,0.5696,2,7,2,524473,151971,56245,70011,1.2036734887846914,0.3153904370624645
5168,0.5697,9,23,9,524496,151948,56254,70002,1.203491319224433,0.31539535931516105
5169,0.5698,4,16,4,524512,151932,56258,69998,1.2033645925738183,0.31540575857252284
5170,0.5699,0,3,0,524515,151929,56258,69998,1.2033408313268281,0.315410022214512
5171,0.57,780,3179,780,527694,148750,57038,69218,1.178161829932835,0.317560375834985
5172,0.5701,2,7,2,527701,148743,57040,69216,1.178106387023191,0.317564312554196
5173,0.5702,4,18,4,527719,148725,57044,69212,1.1779638195412496,0.31757801566507754
5174,0.5703,3,22,3,527741,148703,57047,69209,1.1777895703966543,0.317600682844451
5175,0.5704,2,6,2,527747,148697,57049,69207,1.177742047902674,0.31760316469638006
5176,0.5705,6,25,6,527772,148672,57055,69201,1.1775440375110886,0.3176208157963584
5177,0.5706,1,13,1,527785,148659,57056,69200,1.1774410721074642,0.3176366365401475
5178,0.5707,9,48,9,527833,148611,57065,69191,1.1770608921556203,0.317678441887586
5179,0.5708,19,89,19,527922,148522,57084,69172,1.1763559751615764,0.317748766617362
5180,0.5709,2,1,2,527923,148521,57086,69170,1.176348054745913,0.3177439581792541
5181,0.571,20,66,20,527989,148455,57106,69150,1.1758253073121276,0.31777762459502307
5182,0.5711,1,7,1,527996,148448,57107,69149,1.1757698644024839,0.3177847121054059
5183,0.5712,0,18,0,528014,148430,57107,69149,1.1756272969205424,0.3178110019808897
5184,0.5713,8,33,8,528047,148397,57115,69141,1.1753659232036497,0.31783412553209095
5185,0.5714,3,11,3,528058,148386,57118,69138,1.1752787986313522,0.3178407899817951
5186,0.5715,7,28,7,528086,148358,57125,69131,1.1750570269927765,0.3178597538266303
5187,0.5716,1,4,1,528090,148354,57126,69130,1.175025345330123,0.31786246344558683
5188,0.5717,60,267,60,528357,148087,57186,69070,1.1729105943479914,0.3180648102524901
5189,0.5718,5,22,5,528379,148065,57191,69065,1.1727363452033963,0.31808133376318337
5190,0.5719,3,8,3,528387,148057,57194,69062,1.172672981878089,0.3180836315568882
5191,0.572,13,70,13,528457,147987,57207,69049,1.17211855278165,0.3181453768038482
5192,0.5721,1,14,1,528471,147973,57208,69048,1.1720076669623622,0.31816275844273134
5193,0.5722,3,12,3,528483,147961,57211,69045,1.1719126219744012,0.31817092614950737
5194,0.5723,4,36,4,528519,147925,57215,69041,1.1716274870105183,0.31821114829051556
5195,0.5724,1,9,1,528528,147916,57216,69040,1.1715562032695477,0.3182212061431811
5196,0.5725,62,272,62,528800,147644,57278,68978,1.169401850209099,0.31842564467136303
5197,0.5726,1,3,1,528803,147641,57279,68977,1.1693780889621088,0.31842690819784136
5198,0.5727,8,31,8,528834,147610,57287,68969,1.1691325560765429,0.3184473102193657
5199,0.5728,4,7,4,528841,147603,57291,68965,1.169077113166899,0.318445014960659
5200,0.5729,2,26,2,528867,147577,57293,68963,1.1688711823596503,0.3184769557587513
5201,0.573,9,47,9,528914,147530,57302,68954,1.1684989228234697,0.3185177657471222
5202,0.5731,3,5,3,528919,147525,57305,68951,1.1684593207451528,0.31851567841238754
5203,0.5732,2,14,2,528933,147511,57307,68949,1.1683484349258648,0.31852998244479347
5204,0.5733,133,522,133,529455,146989,57440,68816,1.1642139779495628,0.318880470795394
5205,0.5734,0,5,0,529460,146984,57440,68816,1.1641743758712457,0.318887859128823
5206,0.5735,9,25,9,529485,146959,57449,68807,1.1639763654796604,0.3188963970227005
5207,0.5736,2,5,2,529490,146954,57451,68805,1.1639367634013433,0.31889747357004805
5208,0.5737,6,30,6,529520,146924,57457,68799,1.163699150931441,0.3189228779499636
5209,0.5738,6,17,6,529537,146907,57463,68793,1.1635645038651627,0.3189290681502086
5210,0.5739,0,9,0,529546,146898,57463,68793,1.163493220124192,0.3189423758988553
5211,0.574,18,95,18,529641,146803,57481,68775,1.1627407806361678,0.319026060173116
5212,0.5741,0,7,0,529648,146796,57481,68775,1.1626853377265238,0.3190364195555061
5213,0.5742,28,82,28,529730,146714,57509,68747,1.162035863642124,0.31906934433609796
5214,0.5743,5,38,5,529768,146676,57514,68742,1.1617348878469143,0.3191098236916135
5215,0.5744,1,3,1,529771,146673,57515,68741,1.161711126599924,0.3191111069846899
5216,0.5745,7,28,7,529799,146645,57522,68734,1.1614893549613483,0.3191304630442151
5217,0.5746,1,6,1,529805,146639,57523,68733,1.1614418324673679,0.3191361922626897
5218,0.5747,3,21,3,529826,146618,57526,68730,1.1612755037384361,0.3191578282593755
5219,0.5748,4,27,4,529853,146591,57530,68726,1.161061652515524,0.3191852013542823
5220,0.5749,3,4,3,529857,146587,57533,68723,1.1610299708528704,0.3191816450698992
5221,0.575,272,1054,272,530911,145533,57805,68451,1.152681852743632,0.3198884028712427
5222,0.5751,6,6,6,530917,145527,57811,68445,1.1526343302496516,0.3198783018338848
5223,0.5752,4,23,4,530940,145504,57815,68441,1.152452160689393,0.31989997429245837
5224,0.5753,4,26,4,530966,145478,57819,68437,1.1522462298821443,0.31992613888694105
5225,0.5754,3,7,3,530973,145471,57822,68434,1.1521907869725003,0.31992707042846125
5226,0.5755,2,27,2,531000,145444,57824,68432,1.1519769357495881,0.3199610989545344
5227,0.5756,2,3,2,531003,145441,57826,68430,1.151953174502598,0.31995922775878916
5228,0.5757,8,45,8,531048,145396,57834,68422,1.1515967557977442,0.32000112244993406
5229,0.5758,25,97,25,531145,145299,57859,68397,1.150828475478393,0.3200668238993711
5230,0.5759,2,9,2,531154,145290,57861,68395,1.1507571917374224,0.3200739406135199
5231,0.576,32,97,32,531251,145193,57893,68363,1.1499889114180712,0.3201174399220813
5232,0.5761,1,3,1,531254,145190,57894,68362,1.149965150171081,0.3201187532778902
5233,0.5762,4,17,4,531271,145173,57898,68358,1.1498305031048028,0.32013150315410877
5234,0.5763,3,14,3,531285,145159,57901,68355,1.149719617285515,0.32014294144646255
5235,0.5764,1,9,1,531294,145150,57902,68354,1.1496483335445444,0.3201532523980815
5236,0.5765,2,26,2,531320,145124,57904,68352,1.1494424027372956,0.32018587569562856
5237,0.5766,1,5,1,531325,145119,57905,68351,1.1494028006589785,0.32019019065910903
5238,0.5767,126,467,126,531792,144652,58031,68225,1.1457039665441642,0.3204902361457555
5239,0.5768,4,22,4,531814,144630,58035,68221,1.145529717399569,0.320510591916411
5240,0.5769,1,7,1,531821,144623,58036,68220,1.1454742744899253,0.3205179404537617
5241,0.577,13,43,13,531864,144580,58049,68207,1.1451336966163985,0.3205411984754708
5242,0.5771,7,22,7,531886,144558,58056,68200,1.1449594474718032,0.3205519886443753
5243,0.5772,4,18,4,531904,144540,58060,68196,1.144816879989862,0.3205663357400722
5244,0.5773,4,41,4,531945,144499,58064,68192,1.144492142947662,0.3206153527887875
5245,0.5774,2,5,2,531950,144494,58066,68190,1.144452540869345,0.3206165014763687
5246,0.5775,71,286,71,532236,144208,58137,68119,1.1421873019896085,0.320821186189227
5247,0.5776,4,5,4,532241,144203,58141,68115,1.1421476999112914,0.320815945892482
5248,0.5777,7,35,7,532276,144168,58148,68108,1.141870485363072,0.32084644519399275
5249,0.5778,4,15,4,532291,144153,58152,68104,1.1417516791281206,0.3208563204040385
5250,0.5779,3,15,3,532306,144138,58155,68101,1.1416328728931695,0.3208693972361347
5251,0.578,18,72,18,532378,144066,58173,68083,1.1410626029654036,0.3209206736774625
5252,0.5781,2,6,2,532384,144060,58175,68081,1.1410150804714232,0.32092334815052254
5253,0.5782,4,19,4,532403,144041,58179,68077,1.1408645925738183,0.320939288509226
5254,0.5783,72,307,72,532710,143734,58251,68005,1.1384330249651502,0.3211737091419153
5255,0.5784,0,5,0,532715,143729,58251,68005,1.138393422886833,0.32118129350978114
5256,0.5785,3,25,3,532740,143704,58254,68002,1.1381954124952478,0.3212096019952198
5257,0.5786,1,11,1,532751,143693,58255,68001,1.1381082879229503,0.3212230861526543
5258,0.5787,9,21,9,532772,143672,58264,67992,1.1379419591940185,0.32122609418701337
5259,0.5788,2,23,2,532795,143649,58266,67990,1.13775978963376,0.3212545891825231
5260,0.5789,3,6,3,532801,143643,58269,67987,1.1377122671397795,0.3212540755091433
5261,0.579,9,53,9,532854,143590,58278,67978,1.1372924851096184,0.32130567949784467
5262,0.5791,2,3,2,532857,143587,58280,67976,1.1372687238626282,0.3213038196660096
5263,0.5792,18,79,18,532936,143508,58298,67958,1.1366430110252186,0.3213660824908023
5264,0.5793,10,48,10,532984,143460,58308,67948,1.1362628310733747,0.32140694770301975
5265,0.5794,2,4,2,532988,143456,58310,67946,1.1362311494107211,0.32140660920899516
5266,0.5795,3,35,3,533023,143421,58313,67943,1.1359539348625016,0.3214501996555705
5267,0.5796,2,10,2,533033,143411,58315,67941,1.1358747307058674,0.32145898784965365
5268,0.5797,5,29,5,533062,143382,58320,67936,1.1356450386516284,0.32148704795616084
5269,0.5798,7,16,7,533078,143366,58327,67929,1.1355183120010137,0.3214889136042027
5270,0.5799,1,3,1,533081,143363,58328,67928,1.1354945507540235,0.32149026697777
5271,0.58,798,3175,798,536256,140188,59126,67130,1.110347231022684,0.32380208182598713
5272,0.5801,2,6,2,536262,140182,59128,67128,1.1102997085287036,0.3238049298152525
5273,0.5802,4,17,4,536279,140165,59132,67124,1.1101650614624254,0.32381843706130087
5274,0.5803,4,21,4,536300,140144,59136,67120,1.109998732733494,0.3238381966960012
5275,0.5804,0,3,0,536303,140141,59136,67120,1.1099749714865037,0.3238428840930035
5276,0.5805,0,19,0,536322,140122,59136,67120,1.1098244835888988,0.32387257409212417
5277,0.5806,1,10,1,536332,140112,59137,67119,1.1097452794322646,0.3238849399944989
5278,0.5807,8,47,8,536379,140065,59145,67111,1.109373019896084,0.32393230876163265
5279,0.5808,18,87,18,536466,139978,59163,67093,1.108683943733367,0.3240096392058762
5280,0.5809,1,2,1,536468,139976,59164,67092,1.1086681029020402,0.32400950412424906
5281,0.581,9,62,9,536530,139914,59173,67083,1.1081770371309085,0.3240771605385585
5282,0.5811,3,4,3,536534,139910,59176,67080,1.108145355468255,0.3240736267452534
5283,0.5812,6,20,6,536554,139890,59182,67074,1.1079869471549868,0.3240853481764945
5284,0.5813,8,34,8,536588,139856,59190,67066,1.1077176530224306,0.32411246749983086
5285,0.5814,2,11,2,536599,139845,59192,67064,1.107630528450133,0.32412316525622376
5286,0.5815,5,25,5,536624,139820,59197,67059,1.1074325180585478,0.3241459983855297
5287,0.5816,1,1,1,536625,139819,59198,67058,1.1074245976428843,0.3241442983028563
5288,0.5817,75,271,75,536896,139548,59273,66983,1.1052781649980992,0.32432419346248265
5289,0.5818,6,17,6,536913,139531,59279,66977,1.105143517931821,0.324331260774401
5290,0.5819,1,5,1,536918,139526,59280,66976,1.105103915853504,0.3243358417836147
5291,0.582,16,66,16,536984,139460,59296,66960,1.1045811684197187,0.32438717178567966
5292,0.5821,2,15,2,536999,139445,59298,66958,1.1044623621847676,0.3244041995513631
5293,0.5822,8,14,8,537013,139431,59306,66950,1.1043514763654796,0.3244000174434662
5294,0.5823,9,28,9,537041,139403,59315,66941,1.104129704726904,0.3244145698445315
5295,0.5824,1,4,1,537045,139399,59316,66940,1.1040980230642503,0.3244175846543794
5296,0.5825,77,250,77,537295,139149,59393,66863,1.102117919148397,0.32455876356717084
5297,0.5826,2,5,2,537300,139144,59395,66861,1.1020783170700799,0.3245600834931191
5298,0.5827,11,37,11,537337,139107,59406,66850,1.1017852616905335,0.3245823157260982
5299,0.5828,2,15,2,537352,139092,59408,66848,1.1016664554555824,0.3245993978828785
5300,0.5829,2,12,2,537364,139080,59410,66846,1.1015714104676213,0.32461175373677925
5301,0.583,9,48,9,537412,139032,59419,66837,1.1011912305157774,0.3246579135275345
5302,0.5831,0,2,0,537414,139030,59419,66837,1.1011753896844507,0.32466106758246827
5303,0.5832,4,25,4,537439,139005,59423,66833,1.1009773792928652,0.32468737550889537
5304,0.5833,108,502,108,537941,138503,59531,66725,1.0970013306298314,0.3251262011031633
5305,0.5834,0,6,0,537947,138497,59531,66725,1.096953808135851,0.3251357066981123
5306,0.5835,9,23,9,537970,138474,59540,66716,1.0967716385755923,0.3251425508065695
5307,0.5836,1,14,1,537984,138460,59541,66715,1.0966607527563046,0.3251614475447788
5308,0.5837,3,22,3,538006,138438,59544,66712,1.0964865036117095,0.32518644893980014
5309,0.5838,6,24,6,538030,138414,59550,66706,1.0962964136357876,0.3252047581903276
5310,0.5839,1,7,1,538037,138407,59551,66705,1.0962409707261438,0.3252125667927766
5311,0.584,30,90,30,538127,138317,59581,66675,1.0955281333164364,0.3252565953793319
5312,0.5841,0,4,0,538131,138313,59581,66675,1.0954964516537828,0.32526294222100804
5313,0.5842,20,109,20,538240,138204,59601,66655,1.0946331263464706,0.3253701326278074
5314,0.5843,4,37,4,538277,138167,59605,66651,1.0943400709669244,0.32541573494517084
5315,0.5844,0,2,0,538279,138165,59605,66651,1.0943242301355975,0.3254189125849543
5316,0.5845,7,20,7,538299,138145,59612,66644,1.0941658218223291,0.3254276352733789
5317,0.5846,2,10,2,538309,138135,59614,66642,1.0940866176656951,0.32543693871870377
5318,0.5847,4,30,4,538339,138105,59618,66638,1.0938490051957928,0.3254714446891957
5319,0.5848,4,25,4,538364,138080,59622,66634,1.0936509948042072,0.3254980118604492
5320,0.5849,0,8,0,538372,138072,59622,66634,1.0935876314789,0.32551073246509626
5321,0.585,277,930,277,539302,137142,59899,66357,1.086221644911925,0.32608022643845913
5322,0.5851,1,3,1,539305,137139,59900,66356,1.0861978836649346,0.32608172190962925
5323,0.5852,7,29,7,539334,137110,59907,66349,1.0859681916106958,0.3261050137865614
5324,0.5853,6,27,6,539361,137083,59913,66343,1.0857543403877836,0.3261284201626144
5325,0.5854,1,11,1,539372,137072,59914,66342,1.085667215815486,0.3261427433706628
5326,0.5855,9,28,9,539400,137044,59923,66333,1.0854454441769104,0.3261578251228015
5327,0.5856,2,5,2,539405,137039,59925,66331,1.0854058420985933,0.32615921719034274
5328,0.5857,7,42,7,539447,136997,59932,66324,1.08507318464073,0.326203392664801
5329,0.5858,29,85,29,539532,136912,59961,66295,1.0843999493093397,0.32624368255030584
5330,0.5859,0,3,0,539535,136909,59961,66295,1.0843761880623495,0.3262484990452944
5331,0.586,26,84,26,539619,136825,59987,66269,1.0837108731466227,0.3262971825854038
5332,0.5861,3,3,3,539622,136822,59990,66266,1.0836871118996325,0.3262920507366265
5333,0.5862,4,17,4,539639,136805,59994,66262,1.0835524648333545,0.32630609601757055
5334,0.5863,6,28,6,539667,136777,60000,66256,1.0833306931947788,0.32633118754094165
5335,0.5864,3,5,3,539672,136772,60003,66253,1.0832910911164617,0.3263292697943603
5336,0.5865,4,24,4,539696,136748,60007,66249,1.0831010011405398,0.3263545766686207
5337,0.5866,5,8,5,539704,136740,60012,66244,1.0830376378152324,0.3263508453868285
5338,0.5867,142,476,142,540180,136264,60154,66102,1.0792675199594475,0.32664578041765907
5339,0.5868,8,28,8,540208,136236,60162,66094,1.079045748320872,0.3266643602036277
5340,0.5869,0,10,0,540218,136226,60162,66094,1.0789665441642378,0.3266805061289047
5341,0.587,7,34,7,540252,136192,60169,66087,1.0786972500316816,0.3267121154445098
5342,0.5871,3,11,3,540263,136181,60172,66084,1.078610125459384,0.3267198971646108
5343,0.5872,2,13,2,540276,136168,60174,66082,1.0785071600557596,0.326734239802225
5344,0.5873,15,36,15,540312,136132,60189,66067,1.0782220250918768,0.32674246657995343
5345,0.5874,0,5,0,540317,136127,60189,66067,1.0781824230135597,0.32675054650484187
5346,0.5875,67,232,67,540549,135895,60256,66000,1.0763448865796477,0.3269025978850392
5347,0.5876,2,10,2,540559,135885,60258,65998,1.0762656824230135,0.3269121223679062
5348,0.5877,9,40,9,540599,135845,60267,65989,1.075948865796477,0.32694689695492335
5349,0.5878,2,17,2,540616,135828,60269,65987,1.075814218730199,0.32696776750984813
5350,0.5879,1,4,1,540620,135824,60270,65986,1.0757825370675453,0.32697091323522126
5351,0.588,20,71,20,540691,135753,60290,65966,1.075220187555443,0.3270192693796816
5352,0.5881,0,9,0,540700,135744,60290,65966,1.0751489038144721,0.32703386049278665
5353,0.5882,4,18,4,540718,135726,60294,65962,1.0750063363325306,0.3270497005275475
5354,0.5883,71,282,71,541000,135444,60365,65891,1.072772779115448,0.32727046961531775
5355,0.5884,1,6,1,541006,135438,60366,65890,1.0727252566214676,0.3272768815067949
5356,0.5885,7,27,7,541033,135411,60373,65883,1.0725114053985554,0.32729738591314195
5357,0.5886,2,12,2,541045,135399,60375,65881,1.0724163604105943,0.3273102146263911
5358,0.5887,5,22,5,541067,135377,60380,65876,1.0722421112659992,0.32732928204796946
5359,0.5888,6,21,6,541088,135356,60386,65870,1.0720757825370675,0.32734338504964566
5360,0.5889,0,3,0,541091,135353,60386,65870,1.0720520212900773,0.32734826535733985
5361,0.589,11,54,11,541145,135299,60397,65859,1.071624318844253,0.3273993577188081
5362,0.5891,0,5,0,541150,135294,60397,65859,1.0715847167659358,0.3274074957867892
5363,0.5892,29,84,29,541234,135210,60426,65830,1.070919401850209,0.32744727417429365
5364,0.5893,14,45,14,541279,135165,60440,65816,1.0705629831453554,0.32747374129892876
5365,0.5894,2,8,2,541287,135157,60442,65814,1.0704996198200483,0.32748008419125146
5366,0.5895,6,28,6,541315,135129,60448,65808,1.0702778481814725,0.3275056360948954
5367,0.5896,0,7,0,541322,135122,60448,65808,1.0702224052718288,0.32751704573732143
5368,0.5897,1,22,1,541344,135100,60449,65807,1.0700481561272335,0.32754956273300584
5369,0.5898,4,16,4,541360,135084,60453,65803,1.0699214294766188,0.3275622613708204
5370,0.5899,0,6,0,541366,135078,60453,65803,1.0698739069826384,0.32757204514115323
5371,0.59,822,3085,822,544451,131993,61275,64981,1.0454394246610061,0.32989633149552733
5372,0.5901,0,6,0,544457,131987,61275,64981,1.0453919021670257,0.32990638073189554
5373,0.5902,5,22,5,544479,131965,61280,64976,1.0452176530224306,0.32992622155874096
5374,0.5903,5,12,5,544491,131953,61285,64971,1.0451226080344695,0.3299293128313461
5375,0.5904,2,13,2,544504,131940,61287,64969,1.0450196426308453,0.32994428898628303
5376,0.5905,6,16,6,544520,131924,61293,64963,1.0448929159802307,0.32995068237110625
5377,0.5906,1,4,1,544524,131920,61294,64962,1.044861234317577,0.32995398258855557
5378,0.5907,5,43,5,544567,131877,61299,64957,1.0445206564440501,0.3300090431531138
5379,0.5908,16,85,16,544652,131792,61315,64941,1.04384742111266,0.33009713672845936
5380,0.5909,1,4,1,544656,131788,61316,64940,1.0438157394500063,0.3301004432515961
5381,0.591,16,50,16,544706,131738,61332,64924,1.0434197186668357,0.3301298674883811
5382,0.5911,0,5,0,544711,131733,61332,64924,1.0433801165885186,0.3301382610331694
5383,0.5912,1,12,1,544723,131721,61333,64923,1.0432850716005575,0.3301550009153597
5384,0.5913,8,30,8,544753,131691,61341,64915,1.043047459130655,0.33017812274294783
5385,0.5914,2,10,2,544763,131681,61343,64913,1.0429682549740211,0.33018810340091764
5386,0.5915,7,20,7,544783,131661,61350,64906,1.0428098466607527,0.3301978460270544
5387,0.5916,0,3,0,544786,131658,61350,64906,1.0427860854137625,0.33020288557416416
5388,0.5917,63,279,63,545065,131379,61413,64843,1.04057628944367,0.3304573391362844
5389,0.5918,4,15,4,545080,131364,61417,64839,1.0404574832087188,0.330468953074112
5390,0.5919,0,8,0,545088,131356,61417,64839,1.0403941198834115,0.3304824281964372
5391,0.592,20,60,20,545148,131296,61437,64819,1.0399188949436067,0.33051525890421435
5392,0.5921,1,10,1,545158,131286,61438,64818,1.0398396907869725,0.33052869905764287
5393,0.5922,5,16,5,545174,131270,61443,64813,1.0397129641363578,0.3305385984506561
5394,0.5923,7,28,7,545202,131242,61450,64806,1.0394911924977823,0.33056190320737777
5395,0.5924,2,9,2,545211,131233,61452,64804,1.0394199087568115,0.33057024949371805
5396,0.5925,71,267,71,545478,130966,61523,64733,1.03730515777468,0.33077838926105907
5397,0.5926,1,6,1,545484,130960,61524,64732,1.0372576352806995,0.3307851112973448
5398,0.5927,11,45,11,545529,130915,61535,64721,1.036901216575846,0.33082357030403403
5399,0.5928,1,14,1,545543,130901,61536,64720,1.036790330756558,0.33084382556065045
5400,0.5929,2,14,2,545557,130887,61538,64718,1.0366794449372703,0.3308606630709849
5401,0.593,10,59,10,545616,130828,61548,64708,1.0362121404131288,0.3309262744456264
5402,0.5931,1,9,1,545625,130819,61549,64707,1.0361408566721582,0.3309380849605679
5403,0.5932,3,11,3,545636,130808,61552,64704,1.0360537320998606,0.3309464380702975
5404,0.5933,120,489,120,546125,130319,61672,64584,1.0321806488404512,0.33136483276296413
5405,0.5934,0,11,0,546136,130308,61672,64584,1.0320935242681535,0.3313835354965827
5406,0.5935,6,25,6,546161,130283,61678,64578,1.0318955138765682,0.33140546338158994
5407,0.5936,0,9,0,546170,130274,61678,64578,1.0318242301355975,0.33142077063617514
5408,0.5937,3,15,3,546185,130259,61681,64575,1.0317054239006462,0.33143599166469917
5409,0.5938,6,28,6,546213,130231,61687,64569,1.0314836522620707,0.33146303901437374
5410,0.5939,0,6,0,546219,130225,61687,64569,1.0314361297680903,0.3314732486626898
5411,0.594,27,92,27,546311,130133,61714,64542,1.0307074515270562,0.33153717734686017
5412,0.5941,0,3,0,546314,130130,61714,64542,1.0306836902800658,0.3315422865126983
5413,0.5942,32,116,32,546430,130014,61746,64510,1.0297649220631098,0.3316300302276326
5414,0.5943,8,36,8,546466,129978,61754,64502,1.029479787099227,0.3316639243109831
5415,0.5944,1,9,1,546475,129969,61755,64501,1.0294085033582563,0.33167583689000874
5416,0.5945,3,27,3,546502,129942,61758,64498,1.0291946521353441,0.3317115819790167
5417,0.5946,4,10,4,546512,129932,61762,64494,1.02911544797871,0.3317148940985259
5418,0.5947,9,34,9,546546,129898,61771,64485,1.0288461538461537,0.3317419733207122
5419,0.5948,4,12,4,546558,129886,61775,64481,1.0287511088581929,0.3317487021973895
5420,0.5949,1,1,1,546559,129885,61776,64480,1.0287431884425295,0.33174697090525557
5421,0.595,227,931,227,547490,128954,62003,64253,1.021369281459891,0.3325604144777363
5422,0.5951,1,8,1,547498,128946,62004,64252,1.0213059181345836,0.3325707305458649
5423,0.5952,6,25,6,547523,128921,62010,64246,1.0211079077429983,0.3325930412544586
5424,0.5953,9,35,9,547558,128886,62019,64237,1.0208306931947788,0.3326222148578885
5425,0.5954,1,20,1,547578,128866,62020,64236,1.0206722848815106,0.3326532091847832
5426,0.5955,7,24,7,547602,128842,62027,64229,1.0204821949055887,0.33267036478808315
5427,0.5956,4,7,4,547609,128835,62031,64225,1.0204267519959447,0.3326686004350979
5428,0.5957,10,39,10,547648,128796,62041,64215,1.0201178557850716,0.3327012450067613
5429,0.5958,22,74,22,547722,128722,62063,64193,1.0195317450259789,0.3327527667625638
5430,0.5959,3,4,3,547726,128718,62066,64190,1.0195000633633253,0.33274928981690755
5431,0.596,21,90,21,547816,128628,62087,64169,1.0187872259536181,0.3328319424057428
5432,0.5961,2,6,2,547822,128622,62089,64167,1.0187397034596375,0.33283537961190734
5433,0.5962,5,25,5,547847,128597,62094,64162,1.0185416930680522,0.3328612412390602
5434,0.5963,9,21,9,547868,128576,62103,64153,1.0183753643391205,0.3328663563864286
5435,0.5964,2,12,2,547880,128564,62105,64151,1.0182803193511596,0.33288015982149805
5436,0.5965,9,37,9,547917,128527,62114,64142,1.0179872639716132,0.332912923199892
5437,0.5966,0,8,0,547925,128519,62114,64142,1.017923900646306,0.3329267469804475
5438,0.5967,139,504,139,548429,128015,62253,64003,1.0139320111519452,0.33331770979803976
5439,0.5968,6,22,6,548451,127993,62259,63997,1.0137577620073501,0.33333506953487163
5440,0.5969,1,2,1,548453,127991,62260,63996,1.0137419211760232,0.3333350695620016
5441,0.597,10,41,10,548494,127950,62270,63986,1.0134171841338233,0.3333715405135045
5442,0.5971,3,15,3,548509,127935,62273,63983,1.0132983778988722,0.3333871757729864
5443,0.5972,7,13,7,548522,127922,62280,63976,1.0131954124952478,0.3333854443506446
5444,0.5973,13,47,13,548569,127875,62293,63963,1.0128231529590672,0.3334219497701185
5445,0.5974,3,3,3,548572,127872,62296,63960,1.012799391712077,0.3334167396471913
5446,0.5975,69,277,69,548849,127595,62365,63891,1.0106054365733115,0.3336588575666106
5447,0.5976,2,4,2,548853,127591,62367,63889,1.0105737549106577,0.3336588677668686
5448,0.5977,4,39,4,548892,127552,62371,63885,1.0102648586997847,0.3337129186103
5449,0.5978,4,13,4,548905,127539,62375,63881,1.0101618932961602,0.3337216591787692
5450,0.5979,5,8,5,548913,127531,62380,63876,1.010098529970853,0.3337182025735736
5451,0.598,17,73,17,548986,127458,62397,63859,1.0095203396274237,0.33378633367656824
5452,0.5981,0,5,0,548991,127453,62397,63859,1.0094807375491066,0.3337950572886175
5453,0.5982,3,17,3,549008,127436,62400,63856,1.0093460904828286,0.3338142734667419
5454,0.5983,76,202,76,549210,127234,62476,63780,1.007746166518819,0.33390222706189077
5455,0.5984,1,4,1,549214,127230,62477,63779,1.0077144848561652,0.33390573219062974
5456,0.5985,7,32,7,549246,127198,62484,63772,1.007461031554936,0.3339372676336597
5457,0.5986,1,14,1,549260,127184,62485,63771,1.0073501457356482,0.33395826241784715
5458,0.5987,7,17,7,549277,127167,62492,63764,1.0072154986693702,0.33396357846551894
5459,0.5988,5,20,5,549297,127147,62497,63759,1.0070570903561018,0.3339811215991116
5460,0.5989,0,7,0,549304,127140,62497,63759,1.007001647446458,0.33399336822089165
5461,0.599,12,52,12,549356,127088,62509,63747,1.0065897858319606,0.3340424974454372
5462,0.5991,1,3,1,549359,127085,62510,63746,1.0065660245849701,0.33404425905644264
5463,0.5992,23,83,23,549442,127002,62533,63723,1.005908630084907,0.3341093197011404
5464,0.5993,6,45,6,549487,126957,62539,63717,1.0055522113800532,0.33416721734478744
5465,0.5994,2,7,2,549494,126950,62541,63715,1.0054967684704093,0.3341725015078803
5466,0.5995,1,16,1,549510,126934,62542,63714,1.0053700418197946,0.33419705425706014
5467,0.5996,1,11,1,549521,126923,62543,63713,1.005282917247497,0.33421284542269036
5468,0.5997,4,16,4,549537,126907,62547,63709,1.0051561905968824,0.3342269274352625
5469,0.5998,5,14,5,549551,126893,62552,63704,1.0050453047775947,0.33423401207783965
5470,0.5999,3,2,3,549553,126891,62555,63701,1.0050294639462678,0.3342270399597045
5471,0.6,853,3001,853,552554,123890,63408,62848,0.9812602965403624,0.3365571013933961
5472,0.6001,1,6,1,552560,123884,63409,62847,0.981212774046382,0.33656436263930467
5473,0.6002,7,13,7,552573,123871,63416,62840,0.9811098086427575,0.3365629234485381
5474,0.6003,6,18,6,552591,123853,63422,62834,0.9809672411608161,0.33657405175507665
5475,0.6004,4,4,4,552595,123849,63426,62830,0.9809355594981625,0.33656704824859784
5476,0.6005,9,17,9,552612,123832,63435,62821,0.9808009124318844,0.33656571284683345
5477,0.6006,2,2,2,552614,123830,63437,62819,0.9807850716005576,0.3365622103520512
5478,0.6007,11,37,11,552651,123793,63448,62808,0.9804920162210112,0.33658983606733084
5479,0.6008,22,73,22,552724,123720,63470,62786,0.979913825877582,0.33664332514771644
5480,0.6009,0,1,0,552725,123719,63470,62786,0.9799059054619187,0.3366451301573684
5481,0.601,17,56,17,552781,123663,63487,62769,0.9794623621847675,0.3366857621009269
5482,0.6011,1,6,1,552787,123657,63488,62768,0.979414839690787,0.3366930400965536
5483,0.6012,6,16,6,552803,123641,63494,62762,0.9792881130401724,0.3367005895827857
5484,0.6013,4,25,4,552828,123616,63498,62758,0.979090102648587,0.3367315183448335
5485,0.6014,1,5,1,552833,123611,63499,62757,0.9790505005702699,0.33673699347527475
5486,0.6015,6,29,6,552862,123582,63505,62751,0.9788208085160309,0.3367680443077716
5487,0.6016,1,5,1,552867,123577,63506,62750,0.9787812064377138,0.33677352181916737
5488,0.6017,69,247,69,553114,123330,63575,62681,0.9768248637688506,0.3369746950449167
5489,0.6018,1,22,1,553136,123308,63576,62680,0.9766506146242555,0.33701098995634127
5490,0.6019,4,8,4,553144,123300,63580,62676,0.9765872512989482,0.3370112272551297
5491,0.602,13,49,13,553193,123251,63593,62663,0.9761991509314408,0.337053691491765
5492,0.6021,1,10,1,553203,123241,63594,62662,0.9761199467748067,0.33706825602599205
5493,0.6022,5,20,5,553223,123221,63599,62657,0.9759615384615384,0.33708669127061835
5494,0.6023,10,26,10,553249,123195,63609,62647,0.9757556076542897,0.3370981801745569
5495,0.6024,3,7,3,553256,123188,63612,62644,0.9757001647446458,0.33710017650350854
5496,0.6025,67,249,67,553505,122939,63679,62577,0.9737279812444557,0.3373132236572587
5497,0.6026,1,10,1,553515,122929,63680,62576,0.9736487770878216,0.3373278348292499
5498,0.6027,12,41,12,553556,122888,63692,62564,0.9733240400456216,0.3373595323857386
5499,0.6028,5,13,5,553569,122875,63697,62559,0.9732210746419973,0.3373653159614742
5500,0.6029,6,7,6,553576,122868,63703,62553,0.9731656317323533,0.33735661009270795
5501,0.603,8,35,8,553611,122833,63711,62545,0.9728884171841338,0.33739170775388666
5502,0.6031,0,7,0,553618,122826,63711,62545,0.9728329742744899,0.337404448376499
5503,0.6032,7,18,7,553636,122808,63718,62538,0.9726904067925485,0.3374121912531158
5504,0.6033,106,410,106,554046,122398,63824,62432,0.9694430363705487,0.3377806633122329
5505,0.6034,1,8,1,554054,122390,63825,62431,0.9693796730452414,0.33779170115950025
5506,0.6035,4,30,4,554084,122360,63829,62427,0.969142060575339,0.3378322068110852
5507,0.6036,2,4,2,554088,122356,63831,62425,0.9691103789126854,0.33783235289342517
5508,0.6037,3,21,3,554109,122335,63834,62422,0.9689440501837536,0.3378599998917497
5509,0.6038,10,14,10,554123,122321,63844,62412,0.9688331643644659,0.33784976154774726
5510,0.6039,2,3,2,554126,122318,63846,62410,0.9688094031174757,0.3378480793382703
5511,0.604,27,87,27,554213,122231,63873,62383,0.9681203269547586,0.3379104509950491
5512,0.6041,0,5,0,554218,122226,63873,62383,0.9680807248764415,0.3379196030529389
5513,0.6042,18,80,18,554298,122146,63891,62365,0.9674470916233684,0.3380015283641626
5514,0.6043,6,31,6,554329,122115,63897,62359,0.9672015587378026,0.3380367965133298
5515,0.6044,0,5,0,554334,122110,63897,62359,0.9671619566594855,0.33804595894161077
5516,0.6045,7,19,7,554353,122091,63904,62352,0.9670114687618806,0.33805565947203203
5517,0.6046,0,8,0,554361,122083,63904,62352,0.9669481054365733,0.33807032287797867
5518,0.6047,5,32,5,554393,122051,63909,62347,0.9666946521353441,0.33811104241911516
5519,0.6048,7,21,7,554414,122030,63916,62340,0.9665283234064124,0.33812442371318546
5520,0.6049,1,11,1,554425,122019,63917,62339,0.9664411988341148,0.33814100825567645
5521,0.605,249,869,249,555294,121150,64166,62090,0.959558357622608,0.33884523029906133
5522,0.6051,1,5,1,555299,121145,64167,62089,0.959518755544291,0.33885086828863636
5523,0.6052,8,13,8,555312,121132,64175,62081,0.9594157901406666,0.33884604258431444
5524,0.6053,8,26,8,555338,121106,64183,62073,0.9592098593334178,0.3388652629395291
5525,0.6054,2,10,2,555348,121096,64185,62071,0.9591306551767836,0.33887654435569725
5526,0.6055,2,18,2,555366,121078,64187,62069,0.9589880876948422,0.3389026301277116
5527,0.6056,0,5,0,555371,121073,64187,62069,0.9589484856165251,0.3389118825829138
5528,0.6057,14,43,14,555414,121030,64201,62055,0.9586079077429983,0.3389409290766584
5529,0.6058,18,74,18,555488,120956,64219,62037,0.9580217969839057,0.33901296770914735
5530,0.6059,0,3,0,555491,120953,64219,62037,0.9579980357369154,0.33901852560249196
5531,0.606,28,89,28,555580,120864,64247,62009,0.9572931187428716,0.3390823139555867
5532,0.6061,1,4,1,555584,120860,64248,62008,0.9572614370802179,0.33908611676181727
5533,0.6062,6,18,6,555602,120842,64254,62002,0.9571188695982765,0.3390978101551049
5534,0.6063,5,25,5,555627,120817,64259,61997,0.9569208592066911,0.3391261063157089
5535,0.6064,2,7,2,555634,120810,64261,61995,0.9568654162970472,0.3391318618199721
5536,0.6065,5,32,5,555666,120778,64266,61990,0.956611962995818,0.3391731594152149
5537,0.6066,2,4,2,555670,120774,64268,61988,0.9565802813331644,0.33917335113426206
5538,0.6067,131,457,131,556127,120317,64399,61857,0.9529606513749842,0.33954900260190807
5539,0.6068,2,16,2,556143,120301,64401,61855,0.9528339247243696,0.3395715760117701
5540,0.6069,0,6,0,556149,120295,64401,61855,0.952786402230389,0.3395827614603349
5541,0.607,7,27,7,556176,120268,64408,61848,0.9525725510074768,0.33960772255046234
5542,0.6071,9,14,9,556190,120254,64417,61839,0.9524616651881891,0.3396011927970872
5543,0.6072,6,22,6,556212,120232,64423,61833,0.952287416043594,0.33962046521846595
5544,0.6073,13,34,13,556246,120198,64436,61820,0.9520181219110379,0.3396367392235933
5545,0.6074,2,5,2,556251,120193,64438,61818,0.9519785198327209,0.33963881303877236
5546,0.6075,70,236,70,556487,119957,64508,61748,0.9501093017361552,0.3398255413995212
5547,0.6076,0,7,0,556494,119950,64508,61748,0.9500538588265112,0.3398386333366355
5548,0.6077,6,27,6,556521,119923,64514,61742,0.949840007603599,0.33986733823246085
5549,0.6078,1,25,1,556546,119898,64515,61741,0.9496419972120137,0.339910481779794
5550,0.6079,4,11,4,556557,119887,64519,61737,0.9495548726397162,0.3399165308549531
5551,0.608,14,66,14,556623,119821,64533,61723,0.9490321252059308,0.33998920371920854
5552,0.6081,1,3,1,556626,119818,64534,61722,0.9490083639589406,0.3399911865153685
5553,0.6082,3,21,3,556647,119797,64537,61719,0.9488420352300089,0.3400196125961348
5554,0.6083,53,228,53,556875,119569,64590,61666,0.9470361804587505,0.34025436587855545
5555,0.6084,0,10,0,556885,119559,64590,61666,0.9469569763021163,0.3402731411229135
5556,0.6085,3,22,3,556907,119537,64593,61663,0.9467827271575212,0.34030353200883
5557,0.6086,1,11,1,556918,119526,64594,61662,0.9466956025852237,0.3403205510298695
5558,0.6087,7,26,7,556944,119500,64601,61655,0.9464896717779749,0.34034390439126716
5559,0.6088,2,9,2,556953,119491,64603,61653,0.9464183880370042,0.34035353089254955
5560,0.6089,1,10,1,556963,119481,64604,61652,0.9463391838803701,0.34036867936819903
5561,0.609,17,59,17,557022,119422,64621,61635,0.9458718793562286,0.34041765852742506
5562,0.6091,1,3,1,557025,119419,64622,61634,0.9458481181092384,0.3404196561227928
5563,0.6092,20,66,20,557091,119353,64642,61614,0.9453253706754531,0.34047091458663736
5564,0.6093,12,27,12,557118,119326,64654,61602,0.9451115194525409,0.3404779801910152
5565,0.6094,1,4,1,557122,119322,64655,61601,0.9450798377898872,0.34048186244977147
5566,0.6095,7,27,7,557149,119295,64662,61594,0.9448659865669751,0.3405071618506377
5567,0.6096,0,4,0,557153,119291,64662,61594,0.9448343049043214,0.3405146916549189
5568,0.6097,3,23,3,557176,119268,64665,61591,0.9446521353440629,0.3405470559938958
5569,0.6098,4,19,4,557195,119249,64669,61587,0.944501647446458,0.34056824968479726
5570,0.6099,0,3,0,557198,119246,64669,61587,0.9444778861994677,0.3405738996753911
5571,0.61,881,2852,881,560050,116394,65550,60706,0.9218888607274109,0.34277809147374366
5572,0.6101,0,3,0,560053,116391,65550,60706,0.9218650994804207,0.3427838980897474
5573,0.6102,3,23,3,560076,116368,65553,60703,0.9216829299201622,0.3428172879805276
5574,0.6103,3,15,3,560091,116353,65556,60700,0.921564123685211,0.3428351962406737
5575,0.6104,2,7,2,560098,116346,65558,60698,0.9215086807755671,0.34284132757958474
5576,0.6105,2,20,2,560118,116326,65560,60696,0.9213502724622988,0.3428726372993187
5577,0.6106,0,12,0,560130,116314,65560,60696,0.9212552274743379,0.34289588158861084
5578,0.6107,6,36,6,560166,116278,65566,60690,0.9209700925104549,0.34294335699109446
5579,0.6108,26,74,26,560240,116204,65592,60664,0.9203839817513623,0.34299025261777144
5580,0.6109,0,3,0,560243,116201,65592,60664,0.920360220504372,0.34299607044921265
5581,0.611,15,54,15,560297,116147,65607,60649,0.9199325180585477,0.34304509151790763
5582,0.6111,1,9,1,560306,116138,65608,60648,0.9198612343175769,0.34305883950086546
5583,0.6112,4,22,4,560328,116116,65612,60644,0.9196869851729819,0.3430866711925775
5584,0.6113,6,30,6,560358,116086,65618,60638,0.9194493727030795,0.34312260926642674
5585,0.6114,1,11,1,560369,116075,65619,60637,0.9193622481307819,0.34314025080356736
5586,0.6115,7,23,7,560392,116052,65626,60630,0.9191800785705234,0.34315889564301966
5587,0.6116,0,1,0,560393,116051,65626,60630,0.91917215815486,0.34316083789428403
5588,0.6117,97,229,97,560622,115822,65723,60533,0.9173583829679381,0.34324515891242097
5589,0.6118,3,18,3,560640,115804,65726,60530,0.9172158154859967,0.3432690235575669
5590,0.6119,3,2,3,560642,115802,65729,60527,0.9171999746546698,0.34326174367233975
5591,0.612,15,69,15,560711,115733,65744,60512,0.9166534659738943,0.3433402366024568
5592,0.6121,1,6,1,560717,115727,65745,60511,0.9166059434799139,0.3433481995937312
5593,0.6122,6,13,6,560730,115714,65751,60505,0.9165029780762894,0.3433511709861025
5594,0.6123,7,20,7,560750,115694,65758,60498,0.9163445697630211,0.3433640573919361
5595,0.6124,0,9,0,560759,115685,65758,60498,0.9162732860220505,0.3433815975434633
5596,0.6125,77,214,77,560973,115471,65835,60421,0.9145783170700799,0.34351192777386125
5597,0.6126,1,6,1,560979,115465,65836,60420,0.9145307945760993,0.343519913579896
5598,0.6127,9,36,9,561015,115429,65845,60411,0.9142456596122165,0.3435566424021838
5599,0.6128,5,16,5,561031,115413,65850,60406,0.9141189329616018,0.34356923881946777
5600,0.6129,6,12,6,561043,115401,65856,60400,0.9140238879736409,0.34357028685843655
5601,0.613,8,34,8,561077,115367,65864,60392,0.9137545938410848,0.34360687077190927
5602,0.6131,1,11,1,561088,115356,65865,60391,0.9136674692687873,0.3436246422414038
5603,0.6132,7,10,7,561098,115346,65872,60384,0.9135882651121531,0.34361805041825527
5604,0.6133,133,473,133,561571,114873,66005,60251,0.9098419085033582,0.34404764623923617
5605,0.6134,0,5,0,561576,114868,66005,60251,0.9098023064250412,0.3440574694921739
5606,0.6135,6,26,6,561602,114842,66011,60245,0.9095963756177924,0.3440860829187775
5607,0.6136,1,8,1,561610,114834,66012,60244,0.9095330122924851,0.3440980591507785
5608,0.6137,6,19,6,561629,114815,66018,60238,0.9093825243948802,0.344112925799615
5609,0.6138,6,29,6,561658,114786,66024,60232,0.9091528323406413,0.34414745911849065
5610,0.6139,0,1,0,561659,114785,66024,60232,0.9091449119249778,0.34414942548438154
5611,0.614,30,90,30,561749,114695,66054,60202,0.9084320745152705,0.34421402311074517
5612,0.6141,0,5,0,561754,114690,66054,60202,0.9083924724369535,0.3442238638702742
5613,0.6142,21,83,21,561837,114607,66075,60181,0.9077350779368901,0.34430853376662013
5614,0.6143,9,37,9,561874,114570,66084,60172,0.9074420225573439,0.3443476668459786
5615,0.6144,2,7,2,561881,114563,66086,60170,0.9073865796476999,0.3443539571803838
5616,0.6145,3,27,3,561908,114536,66089,60167,0.9071727284247877,0.3443959176430857
5617,0.6146,1,2,1,561910,114534,66090,60166,0.9071568875934609,0.34439610761305095
5618,0.6147,7,34,7,561944,114500,66097,60159,0.9068875934609049,0.34443687413760526
5619,0.6148,4,24,4,561968,114476,66101,60155,0.9066975034849829,0.3444691950455532
5620,0.6149,1,4,1,561972,114472,66102,60154,0.9066658218223292,0.3444733315771993
5621,0.615,258,796,258,562768,113676,66360,59896,0.9003611709542517,0.3450786993293849
5622,0.6151,1,7,1,562775,113669,66361,59895,0.9003057280446077,0.3450888433085202
5623,0.6152,3,23,3,562798,113646,66364,59892,0.9001235584843492,0.34512325830653806
5624,0.6153,7,24,7,562822,113622,66371,59885,0.8999334685084274,0.3451445762995153
5625,0.6154,2,13,2,562835,113609,66373,59883,0.899830503104803,0.3451628893551288
5626,0.6155,6,17,6,562852,113592,66379,59877,0.8996958560385249,0.34517406568320563
5627,0.6156,1,3,1,562855,113589,66380,59876,0.8996720947915346,0.34517626034070276
5628,0.6157,4,32,4,562887,113557,66384,59872,0.8994186414903054,0.3452248470555674
5629,0.6158,21,109,21,562996,113448,66405,59851,0.8985553161829933,0.345362639138137
5630,0.6159,0,5,0,563001,113443,66405,59851,0.8985157141046762,0.3453726037831662
5631,0.616,25,93,25,563094,113350,66430,59826,0.8977791154479787,0.3454635746292789
5632,0.6161,1,3,1,563097,113347,66431,59825,0.8977553542009885,0.34546577968724734
5633,0.6162,4,18,4,563115,113329,66435,59821,0.897612786719047,0.34548657233612473
5634,0.6163,6,24,6,563139,113305,66441,59815,0.897422696743125,0.34551178373382624
5635,0.6164,1,4,1,563143,113301,66442,59814,0.8973910150804715,0.34551598648297377
5636,0.6165,5,20,5,563163,113281,66447,59809,0.8972326067672032,0.34553700387081865
5637,0.6166,1,4,1,563167,113277,66448,59808,0.8972009251045495,0.34554120807695643
5638,0.6167,135,414,135,563581,112863,66583,59673,0.8939218730198961,0.34585825566838224
5639,0.6168,2,20,2,563601,112843,66585,59671,0.8937634647066278,0.3458907682854725
5640,0.6169,2,6,2,563607,112837,66587,59669,0.8937159422126473,0.3458952152388902
5641,0.617,13,37,13,563644,112800,66600,59656,0.893422886833101,0.3459201187549288
5642,0.6171,2,16,2,563660,112784,66602,59654,0.8932961601824864,0.34594462937403586
5643,0.6172,1,19,1,563679,112765,66603,59653,0.8931456722848815,0.34597895811342205
5644,0.6173,13,37,13,563716,112728,66616,59640,0.8928526169053352,0.3460038986354776
5645,0.6174,3,9,3,563725,112719,66619,59637,0.8927813331643645,0.3460105827473369
5646,0.6175,66,223,66,563948,112496,66685,59571,0.8910150804714232,0.34620816309925784
5647,0.6176,1,6,1,563954,112490,66686,59570,0.8909675579774426,0.3462164361269325
5648,0.6177,3,37,3,563991,112453,66689,59567,0.8906745025978964,0.3462795023834438
5649,0.6178,3,9,3,564000,112444,66692,59564,0.8906032188569256,0.3462862192456165
5650,0.6179,6,16,6,564016,112428,66698,59558,0.890476492206311,0.3462956287139651
5651,0.618,19,58,19,564074,112370,66717,59539,0.890017108097833,0.346340214881129
5652,0.6181,1,1,1,564075,112369,66718,59538,0.8900091876821695,0.3463384271728318
5653,0.6182,5,19,5,564094,112350,66723,59533,0.8898586997845647,0.3463576968053851
5654,0.6183,60,218,60,564312,112132,66783,59473,0.8881320491699405,0.34656915591037557
5655,0.6184,0,3,0,564315,112129,66783,59473,0.8881082879229502,0.34657521474108693
5656,0.6185,7,17,7,564332,112112,66790,59466,0.8879736408566722,0.34658289524297986
5657,0.6186,4,13,4,564345,112099,66794,59462,0.8878706754530478,0.34659392286125634
5658,0.6187,4,27,4,564372,112072,66798,59458,0.8876568242301356,0.3466332419984842
5659,0.6188,6,21,6,564393,112051,66804,59452,0.887490495501204,0.34665282823040994
5660,0.6189,3,4,3,564397,112047,66807,59449,0.8874588138385503,0.34664948453608246
5661,0.619,18,70,18,564467,111977,66825,59431,0.8869043847421113,0.34672244002613645
5662,0.6191,2,4,2,564471,111973,66827,59429,0.8868727030794576,0.3467229087175179
5663,0.6192,21,67,21,564538,111906,66848,59408,0.8863420352300089,0.34677843025088434
5664,0.6193,11,36,11,564574,111870,66859,59397,0.8860569002661259,0.346809367829179
5665,0.6194,0,6,0,564580,111864,66859,59397,0.8860093777721455,0.3468215180338781
5666,0.6195,6,17,6,564597,111847,66865,59391,0.8858747307058674,0.3468330627547624
5667,0.6196,2,3,2,564600,111844,66867,59389,0.8858509694588772,0.3468315102813126
5668,0.6197,3,18,3,564618,111826,66870,59386,0.8857084019769358,0.34685652874798495
5669,0.6198,1,16,1,564634,111810,66871,59385,0.8855816753263211,0.3468851309909752
5670,0.6199,2,7,2,564641,111803,66873,59383,0.8855262324166773,0.3468916850677041
5671,0.62,855,2680,855,567321,109123,67728,58528,0.8642995184387277,0.34910617890737305
5672,0.6201,0,3,0,567324,109120,67728,58528,0.8642757571917374,0.34911242603550297
5673,0.6202,3,20,3,567344,109100,67731,58525,0.8641173488784691,0.3491424310216257
5674,0.6203,6,27,6,567371,109073,67737,58519,0.863903497655557,0.34917537829968015
5675,0.6204,2,12,2,567383,109061,67739,58517,0.863808452667596,0.34919261478237
5676,0.6205,3,17,3,567400,109044,67742,58514,0.863673805601318,0.34921639074231015
5677,0.6206,0,6,0,567406,109038,67742,58514,0.8636262831073375,0.3492288961038961
5678,0.6207,8,27,8,567433,109011,67750,58506,0.8634124318844253,0.3492541055534662
5679,0.6208,25,68,25,567501,108943,67775,58481,0.8628738436193132,0.34929878631498473
5680,0.6209,3,3,3,567504,108940,67778,58478,0.8628500823723229,0.3492933854185333
5681,0.621,11,44,11,567548,108896,67789,58467,0.8625015840831327,0.34934244725536706
5682,0.6211,0,5,0,567553,108891,67789,58467,0.8624619820048156,0.34935288423618827
5683,0.6212,4,20,4,567573,108871,67793,58463,0.8623035736915473,0.34937908613909907
5684,0.6213,2,27,2,567600,108844,67795,58461,0.8620897224686351,0.3494276919398703
5685,0.6214,1,4,1,567604,108840,67796,58460,0.8620580408059815,0.34943215780035863
5686,0.6215,7,28,7,567632,108812,67803,58453,0.8618362691674059,0.3494634262995845
5687,0.6217,60,234,60,567866,108578,67863,58393,0.859982891902167,0.3497194123530433
5688,0.6218,1,22,1,567888,108556,67864,58392,0.859808642757572,0.3497616024151233
5689,0.6219,1,3,1,567891,108553,67865,58391,0.8597848815105816,0.34976399271612035
5690,0.622,21,52,21,567943,108501,67886,58370,0.8593730198960842,0.3497911560426917
5691,0.6221,1,17,1,567960,108484,67887,58369,0.8592383728298061,0.34982289800003596
5692,0.6222,7,17,7,567977,108467,67894,58362,0.8591037257635281,0.3498312643485245
5693,0.6223,1,26,1,568003,108441,67895,58361,0.8588977949562793,0.34988189590052876
5694,0.6224,2,13,2,568016,108428,67897,58359,0.858794829552655,0.3499013712099864
5695,0.6225,56,215,56,568231,108213,67953,58303,0.8570919401850209,0.3501345216075332
5696,0.6226,0,3,0,568234,108210,67953,58303,0.8570681789380307,0.3501408298451172
5697,0.6227,8,33,8,568267,108177,67961,58295,0.8568068052211381,0.35017900908260846
5698,0.6228,3,13,3,568280,108164,67964,58292,0.8567038398175136,0.3501946460325852
5699,0.6229,4,17,4,568297,108147,67968,58288,0.8565691927512356,0.3502147985700123
5700,0.623,8,36,8,568333,108111,67976,58280,0.8562840577873527,0.3502593289300503
5701,0.6231,2,2,2,568335,108109,67978,58278,0.8562682169560258,0.3502557291134524
5702,0.6232,10,31,10,568366,108078,67988,58268,0.85602268407046,0.35028194245728783
5703,0.6233,105,428,105,568794,107650,68093,58163,0.8526327461665189,0.35077466784872113
5704,0.6234,0,3,0,568797,107647,68093,58163,0.8526089849195285,0.35078101441408843
5705,0.6235,0,22,0,568819,107625,68093,58163,0.8524347357749334,0.35082756291167033
5706,0.6236,2,4,2,568823,107621,68095,58161,0.8524030541122798,0.3508281960647115
5707,0.6237,4,19,4,568842,107602,68099,58157,0.8522525662146749,0.35085274404406397
5708,0.6238,5,18,5,568860,107584,68104,58152,0.8521099987327335,0.3508712651445673
5709,0.6239,2,2,2,568862,107582,68106,58150,0.8520941579014066,0.3508676658702001
5710,0.624,22,90,22,568952,107492,68128,58128,0.8513813204916995,0.3509721048182587
5711,0.6241,2,3,2,568955,107489,68130,58126,0.8513575592447091,0.35097062464148776
5712,0.6242,19,83,19,569038,107406,68149,58107,0.8507001647446458,0.3510721212231063
5713,0.6243,4,38,4,569076,107368,68153,58103,0.8503991889494361,0.3511370572487022
5714,0.6244,2,4,2,569080,107364,68155,58101,0.8503675072867825,0.3511377028374581
5715,0.6245,4,18,4,569098,107346,68159,58097,0.8502249398048409,0.35116021832292693
5716,0.6246,0,2,0,569100,107344,68159,58097,0.8502090989735142,0.35116446346431657
5717,0.6247,5,21,5,569121,107323,68164,58092,0.8500427702445824,0.3511894326391198
5718,0.6248,3,14,3,569135,107309,68167,58089,0.8499318844252947,0.3512073906576863
5719,0.6249,0,5,0,569140,107304,68167,58089,0.8498922823469776,0.35121800801726794
5720,0.625,262,839,262,569979,106465,68429,57827,0.8432470536053732,0.3519769678377523
5721,0.6251,3,2,3,569981,106463,68432,57824,0.8432312127740463,0.35196941936976145
5722,0.6252,8,27,8,570008,106436,68440,57816,0.8430173615511342,0.35199571390302703
5723,0.6253,9,28,9,570036,106408,68449,57807,0.8427955899125587,0.35202021739792344
5724,0.6254,1,9,1,570045,106399,68450,57806,0.8427243061715879,0.3520355652994732
5725,0.6255,5,24,5,570069,106375,68455,57801,0.8425342161956659,0.35206729363609784
5726,0.6256,2,3,2,570072,106372,68457,57799,0.8425104549486757,0.3520658337952501
5727,0.6257,8,29,8,570101,106343,68465,57791,0.8422807628944367,0.35209645777230797
5728,0.6258,12,67,12,570168,106276,68477,57779,0.841750095044988,0.35219286214988876
5729,0.6259,0,2,0,570170,106274,68477,57779,0.8417342542136611,0.3521971557972119
5730,0.626,25,88,25,570258,106186,68502,57754,0.8410372576352807,0.35228742222764425
5731,0.6261,0,4,0,570262,106182,68502,57754,0.841005575972627,0.3522960179582276
5732,0.6262,3,22,3,570284,106160,68505,57751,0.840831326828032,0.35233144816394263
5733,0.6263,3,17,3,570301,106143,68508,57748,0.8406966797617539,0.3523561391412585
5734,0.6264,1,2,1,570303,106141,68509,57747,0.8406808389304271,0.3523564873572196
5735,0.6265,10,14,10,570317,106127,68519,57737,0.8405699531111392,0.3523470683005419
5736,0.6266,0,2,0,570319,106125,68519,57737,0.8405541122798125,0.3523513688347512
5737,0.6267,140,406,140,570725,105719,68659,57597,0.8373384235204664,0.3526721203066448
5738,0.6268,5,19,5,570744,105700,68664,57592,0.8371879356228615,0.3526933346397864
5739,0.6269,1,2,1,570746,105698,68665,57591,0.8371720947915346,0.35269369032819115
5740,0.627,5,23,5,570769,105675,68670,57586,0.8369899252312761,0.35272355308371256
5741,0.6271,1,6,1,570775,105669,68671,57585,0.8369424027372957,0.35273255172920726
5742,0.6272,3,12,3,570787,105657,68674,57582,0.8368473577493347,0.3527465862937166
5743,0.6273,9,48,9,570835,105609,68683,57573,0.8364671777974908,0.35281464867448614
5744,0.6274,1,4,1,570839,105605,68684,57572,0.8364354961348371,0.3528193311557389
5745,0.6275,60,194,60,571033,105411,68744,57512,0.8348989354961348,0.35300111095425446
5746,0.6276,0,11,0,571044,105400,68744,57512,0.8348118109238373,0.35302494598310746
5747,0.6277,8,32,8,571076,105368,68752,57504,0.834558357622608,0.3530625276290584
5748,0.6278,2,21,2,571097,105347,68754,57502,0.8343920288936764,0.35310011114590817
5749,0.6279,3,8,3,571105,105339,68757,57499,0.834328665568369,0.35310554047581033
5750,0.628,13,66,13,571171,105273,68770,57486,0.8338059181345837,0.3531970582271948
5751,0.6281,7,15,7,571186,105258,68777,57479,0.8336871118996325,0.3532017918481968
5752,0.6282,4,20,4,571206,105238,68781,57475,0.8335287035863642,0.3532293055871381
5753,0.6283,77,252,77,571458,104986,68858,57398,0.8315327588391839,0.35347078529904424
5754,0.6284,0,8,0,571466,104978,68858,57398,0.8314693955138766,0.35348820022663446
5755,0.6285,2,36,2,571502,104942,68860,57396,0.8311842605499936,0.3535586245980608
5756,0.6286,2,15,2,571517,104927,68862,57394,0.8310654543150424,0.35358333179317525
5757,0.6287,2,22,2,571539,104905,68864,57392,0.8308912051704473,0.35362329556307265
5758,0.6288,5,13,5,571552,104892,68869,57387,0.8307882397668229,0.3536317083541308
5759,0.6289,0,4,0,571556,104888,68869,57387,0.8307565581041693,0.3536404252041288
5760,0.629,11,50,11,571606,104838,68880,57376,0.8303605373209986,0.3537055987769243
5761,0.6291,2,6,2,571612,104832,68882,57374,0.8303130148270181,0.35371071353710715
5762,0.6292,20,87,20,571699,104745,68902,57354,0.8296239386643011,0.353820813206744
5763,0.6293,8,40,8,571739,104705,68910,57346,0.8293071220377646,0.3538762488352432
5764,0.6294,2,2,2,571741,104703,68912,57344,0.8292912812064377,0.35387264188784734
5765,0.6295,7,17,7,571758,104686,68919,57337,0.8291566341401597,0.353881856279664
5766,0.6296,0,9,0,571767,104677,68919,57337,0.829085350399189,0.35390151468391623
5767,0.6297,3,24,3,571791,104653,68922,57334,0.828895260423267,0.3539419829986357
5768,0.6298,4,18,4,571809,104635,68926,57330,0.8287526929413256,0.3539653628870435
5769,0.6299,4,5,4,571814,104630,68930,57326,0.8287130908630085,0.3539603349057769
5770,0.63,881,2633,881,574447,101997,69811,56445,0.8078586364212393,0.35625023667966826
5771,0.6301,1,3,1,574450,101994,69812,56444,0.8078348751742491,0.35625291912293766
5772,0.6302,3,21,3,574471,101973,69815,56441,0.8076685464453175,0.3562879543474693
5773,0.6303,5,17,5,574488,101956,69820,56436,0.8075338993790394,0.3563058740340421
5774,0.6304,1,9,1,574497,101947,69821,56435,0.8074626156380686,0.3563220567993838
5775,0.6305,9,19,9,574516,101928,69830,56426,0.8073121277404638,0.35632822663147123
5776,0.6306,0,5,0,574521,101923,69830,56426,0.8072725256621468,0.35633947798849375
5777,0.6307,6,41,6,574562,101882,69836,56420,0.8069477886199468,0.3564073732486008
5778,0.6308,22,77,22,574639,101805,69858,56398,0.8063379166138639,0.35649134340056765
5779,0.6309,0,9,0,574648,101796,69858,56398,0.8062666328728931,0.3565116249668129
5780,0.631,11,56,11,574704,101740,69869,56387,0.805823089595742,0.35659311818980943
5781,0.6311,1,16,1,574720,101724,69870,56386,0.8056963629451274,0.3566251344001012
5782,0.6312,1,25,1,574745,101699,69871,56385,0.805498352553542,0.35667746261481237
5783,0.6313,13,29,13,574774,101670,69884,56372,0.805268660499303,0.3566899937991167
5784,0.6314,0,10,0,574784,101660,69884,56372,0.8051894563426688,0.35671256454388983
5785,0.6315,8,19,8,574803,101641,69892,56364,0.805038968445064,0.3567228885161862
5786,0.6316,0,7,0,574810,101634,69892,56364,0.8049835255354201,0.3567386928948468
5787,0.6317,46,207,46,575017,101427,69938,56318,0.8033439994930934,0.35701923991251705
5788,0.6318,4,25,4,575042,101402,69942,56314,0.803145989101508,0.35705952471531105
5789,0.6319,2,12,2,575054,101390,69944,56312,0.803050944113547,0.357078540538484
5790,0.632,16,50,16,575104,101340,69960,56296,0.8026549233303764,0.35712654469791166
5791,0.6321,0,9,0,575113,101331,69960,56296,0.8025836395894057,0.3571469354869407
5792,0.6322,2,28,2,575141,101303,69962,56294,0.8023618679508301,0.35720223100693543
5793,0.6323,7,27,7,575168,101276,69969,56287,0.8021480167279179,0.35723488382424806
5794,0.6324,1,6,1,575174,101270,69970,56286,0.8021004942339374,0.35724440833735305
5795,0.6325,69,187,69,575361,101083,70039,56217,0.800619376504879,0.35738715829624923
5796,0.6326,0,3,0,575364,101080,70039,56217,0.8005956152578887,0.3573939744559655
5797,0.6327,13,44,13,575408,101036,70052,56204,0.8002471169686985,0.35744085474433984
5798,0.6328,6,11,6,575419,101025,70058,56198,0.800159992396401,0.35744134127958377
5799,0.6329,3,4,3,575423,101021,70061,56195,0.8001283107337473,0.3574381742316304
5800,0.633,10,34,10,575457,100987,70071,56185,0.7998590166011912,0.3574746137988955
5801,0.6331,0,3,0,575460,100984,70071,56185,0.799835255354201,0.3574814371790875
5802,0.6332,7,17,7,575477,100967,70078,56178,0.799700608287923,0.3574914887524261
5803,0.6333,137,394,137,575871,100573,70215,56041,0.7965799645165378,0.35782880202280765
5804,0.6334,1,5,1,575876,100568,70216,56040,0.7965403624382208,0.3578361258684103
5805,0.6335,6,24,6,575900,100544,70222,56034,0.7963502724622988,0.3578663669225562
5806,0.6336,3,6,3,575906,100538,70225,56031,0.7963027499683183,0.35786777714617835
5807,0.6337,5,21,5,575927,100517,70230,56026,0.7961364212393867,0.3578952747807312
5808,0.6338,4,21,4,575948,100496,70234,56022,0.7959700925104549,0.357926883808891
5809,0.6339,1,7,1,575955,100489,70235,56021,0.795914649600811,0.3579387898536835
5810,0.634,19,94,19,576049,100395,70254,56002,0.7951701305284501,0.3580759221724202
5811,0.6341,1,2,1,576051,100393,70255,56001,0.7951542896971233,0.35807639679271586
5812,0.6342,17,68,17,576119,100325,70272,55984,0.7946157014320111,0.35816235789365936
5813,0.6343,11,34,11,576153,100291,70283,55973,0.794346407299455,0.35819510571852764
5814,0.6344,1,5,1,576158,100286,70284,55972,0.7943068052211381,0.35820246003404627
5815,0.6345,6,17,6,576175,100269,70290,55966,0.79417215815486,0.3582167888117259
5816,0.6346,3,12,3,576187,100257,70293,55963,0.794077113166899,0.35823198054026373
5817,0.6347,10,17,10,576204,100240,70303,55953,0.7939424661006209,0.35822988226104885
5818,0.6348,3,14,3,576218,100226,70306,55950,0.7938315802813332,0.35824966704231126
5819,0.6349,4,12,4,576230,100214,70310,55946,0.7937365352933722,0.3582607581967213
5820,0.635,227,777,227,577007,99437,70537,55719,0.7875823723228995,0.3591159864910155
5821,0.6351,2,10,2,577017,99427,70539,55717,0.7875031681662653,0.35913087196411075
5822,0.6352,2,14,2,577031,99413,70541,55715,0.7873922823469776,0.35915502037027486
5823,0.6353,10,24,10,577055,99389,70551,55705,0.7872021923710556,0.3591692779862535
5824,0.6354,0,6,0,577061,99383,70551,55705,0.7871546698770752,0.3591831734241205
5825,0.6355,2,13,2,577074,99370,70553,55703,0.7870517044734507,0.35920501957142764
5826,0.6356,1,3,1,577077,99367,70554,55702,0.7870279432264605,0.3592078365114884
5827,0.6357,8,27,8,577104,99340,70562,55694,0.7868140920035483,0.3592373285859876
5828,0.6358,20,71,20,577175,99269,70582,55674,0.7862517424914459,0.35931923352458645
5829,0.6359,0,4,0,577179,99265,70582,55674,0.7862200608287923,0.35932850992971427
5830,0.636,24,84,24,577263,99181,70606,55650,0.7855547459130655,0.35942414632728586
5831,0.6361,1,9,1,577272,99172,70607,55649,0.7854834621720947,0.35944090271991525
5832,0.6362,6,9,6,577281,99163,70613,55643,0.7854121784311241,0.3594369727271553
5833,0.6363,4,24,4,577305,99139,70617,55639,0.7852220884552021,0.35947615294163254
5834,0.6364,1,8,1,577313,99131,70618,55638,0.7851587251298948,0.359490595661922
5835,0.6365,9,22,9,577335,99109,70627,55629,0.7849844759852997,0.359504452687769
5836,0.6366,1,0,1,577335,99109,70628,55628,0.7849844759852997,0.35950031343505434
5837,0.6367,138,368,138,577703,98741,70766,55490,0.7820697630211634,0.35978499782793344
5838,0.6368,5,17,5,577720,98724,70771,55485,0.7819351159548853,0.3598039024959633
5839,0.6369,2,7,2,577727,98717,70773,55483,0.7818796730452414,0.3598119325551232
5840,0.637,7,17,7,577744,98700,70780,55476,0.7817450259789633,0.3598225404732254
5841,0.6371,4,16,4,577760,98684,70784,55472,0.7816182993283487,0.3598432756428553
5842,0.6372,1,13,1,577773,98671,70785,55471,0.7815153339247244,0.35986947100725303
5843,0.6373,9,31,9,577804,98640,70794,55462,0.7812698010391586,0.35990447885166965
5844,0.6374,2,8,2,577812,98632,70796,55460,0.7812064377138512,0.3599148560600161
5845,0.6375,60,213,60,578025,98419,70856,55400,0.779519389177544,0.3601635688699055
5846,0.6376,1,4,1,578029,98415,70857,55399,0.7794877075148904,0.3601687752740323
5847,0.6377,7,22,7,578051,98393,70864,55392,0.7793134583702953,0.360191175992457
5848,0.6378,1,12,1,578063,98381,70865,55391,0.7792184133823343,0.3602151236896184
5849,0.6379,1,13,1,578076,98368,70866,55390,0.7791154479787099,0.3602414183327046
5850,0.638,12,52,12,578128,98316,70878,55378,0.7787035863642124,0.36031334990305414
5851,0.6381,0,9,0,578137,98307,70878,55378,0.7786323026232417,0.36033445033672773
5852,0.6382,4,13,4,578150,98294,70882,55374,0.7785293372196173,0.36034828331207536
5853,0.6383,69,209,69,578359,98085,70951,55305,0.7768739703459637,0.36055153530217093
5854,0.6384,2,5,2,578364,98080,70953,55303,0.7768343682676467,0.3605549506790192
5855,0.6385,7,22,7,578386,98058,70960,55296,0.7766601191230516,0.36057748738213546
5856,0.6386,1,13,1,578399,98045,70961,55295,0.7765571537194272,0.36060388678753097
5857,0.6387,3,27,3,578426,98018,70964,55292,0.7763433024965151,0.36065488226469244
5858,0.6388,4,17,4,578443,98001,70968,55288,0.776208655430237,0.36067819608712953
5859,0.6389,0,6,0,578449,97995,70968,55288,0.7761611329362565,0.36069231421618836
5860,0.639,17,44,17,578493,97951,70985,55271,0.7758126346470663,0.3607249611674564
5861,0.6391,1,6,1,578499,97945,70986,55270,0.7757651121530857,0.36073491498874133
5862,0.6392,16,67,16,578566,97878,71002,55254,0.7752344443036371,0.36082595407883394
5863,0.6393,7,28,7,578594,97850,71009,55247,0.7750126726650615,0.36086272102000694
5864,0.6394,2,8,2,578602,97842,71011,55245,0.7749493093397541,0.36087322894824514
5865,0.6395,3,20,3,578622,97822,71014,55242,0.7747909010264858,0.36090785553755295
5866,0.6396,2,9,2,578631,97813,71016,55240,0.7747196172855152,0.3609207268070538
5867,0.6397,3,14,3,578645,97799,71019,55237,0.7746087314662273,0.3609412164458036
5868,0.6398,6,18,6,578663,97781,71025,55231,0.7744661639842859,0.36095861762476145
5869,0.6399,0,3,0,578666,97778,71025,55231,0.7744424027372957,0.3609656948284088
5870,0.64,935,2551,935,581217,95227,71960,54296,0.7542374223799265,0.3631280806297359
5871,0.6401,0,4,0,581221,95223,71960,54296,0.7542057407172729,0.3631377951965971
5872,0.6402,3,14,3,581235,95209,71963,54293,0.754094854897985,0.3631590212839962
5873,0.6403,6,29,6,581264,95180,71969,54287,0.753865162843746,0.3632039179216817
5874,0.6404,1,6,1,581270,95174,71970,54286,0.7538176403497655,0.36321423792319013
5875,0.6405,5,17,5,581287,95157,71975,54281,0.7536829932834875,0.36323425099372314
5876,0.6406,1,6,1,581293,95151,71976,54280,0.753635470789507,0.3632445744189626
5877,0.6407,15,37,15,581330,95114,71991,54265,0.7533424154099607,0.36327060697956204
5878,0.6408,22,72,22,581402,95042,72013,54243,0.752772145482195,0.36335197776065914
5879,0.6409,1,2,1,581404,95040,72014,54242,0.7527563046508681,0.3633525810211546
5880,0.641,12,48,12,581452,94992,72026,54230,0.7523761246990242,0.3634182627226548
5881,0.6411,2,5,2,581457,94987,72028,54228,0.7523365226207072,0.36342190798512214
5882,0.6412,6,17,6,581474,94970,72034,54222,0.7522018755544291,0.36343771784009865
5883,0.6413,7,18,7,581492,94952,72041,54215,0.7520593080724877,0.3634517017839066
5884,0.6414,1,14,1,581506,94938,72042,54214,0.7519484222531998,0.36348154902381463
5885,0.6415,9,28,9,581534,94910,72051,54205,0.7517266506146243,0.3635113838312712
5886,0.6416,1,7,1,581541,94903,72052,54204,0.7516712077049803,0.36352418062196945
5887,0.6417,54,172,54,581713,94731,72106,54150,0.7503088962108732,0.36371330122715456
5888,0.6418,4,22,4,581735,94709,72110,54146,0.7501346470662781,0.3637499580128313
5889,0.6419,1,3,1,581738,94706,72111,54145,0.7501108858192878,0.36375301475972616
5890,0.642,14,36,14,581774,94670,72125,54131,0.7498257508554049,0.363781157384695
5891,0.6421,3,3,3,581777,94667,72128,54128,0.7498019896084146,0.36377566450485566
5892,0.6422,7,16,7,581793,94651,72135,54121,0.7496752629578001,0.36378485198827737
5893,0.6423,8,27,8,581820,94624,72143,54113,0.7494614117348879,0.36381666969214116
5894,0.6424,4,6,4,581826,94618,72147,54109,0.7494138892409073,0.36381423682317265
5895,0.6425,67,195,67,582021,94423,72214,54042,0.7478694081865417,0.3640049843397434
5896,0.6426,1,9,1,582030,94414,72215,54041,0.7477981244455709,0.364022767842107
5897,0.6427,7,28,7,582058,94386,72222,54034,0.7475763528069953,0.3640614472443067
5898,0.6428,1,15,1,582073,94371,72223,54033,0.7474575465720441,0.3640939597315436
5899,0.6429,1,11,1,582084,94360,72224,54032,0.7473704219997466,0.36411666397110354
5900,0.643,11,35,11,582119,94325,72235,54021,0.7470932074515271,0.36415542043600774
5901,0.6431,0,7,0,582126,94318,72235,54021,0.7470377645418832,0.36417260464206985
5902,0.6432,7,14,7,582140,94304,72242,54014,0.7469268787225953,0.3641769711026308
5903,0.6433,132,357,132,582497,93947,72374,53882,0.7440992903307566,0.36448869978150433
5904,0.6434,0,5,0,582502,93942,72374,53882,0.7440596882524395,0.36450102824981057
5905,0.6435,1,20,1,582522,93922,72375,53881,0.7439012799391712,0.3645460511626963
5906,0.6436,4,12,4,582534,93910,72379,53877,0.7438062349512102,0.36455845236725826
5907,0.6437,3,13,3,582547,93897,72382,53874,0.7437032695475858,0.3645776234849869
5908,0.6438,3,22,3,582569,93875,72385,53871,0.7435290204029907,0.364619008298025
5909,0.6439,1,4,1,582573,93871,72386,53870,0.7434973387403371,0.36462457950061256
5910,0.644,19,57,19,582630,93814,72405,53851,0.7430458750475225,0.3646835743067077
5911,0.6441,1,8,1,582638,93806,72406,53850,0.7429825117222152,0.36469903017825217
5912,0.6442,22,65,22,582703,93741,72428,53828,0.7424676847040933,0.36476495740975406
5913,0.6443,10,25,10,582728,93716,72438,53818,0.7422696743125079,0.36478371087342576
5914,0.6444,2,7,2,582735,93709,72440,53816,0.742214231402864,0.36479240806642943
5915,0.6445,5,15,5,582750,93694,72445,53811,0.7420954251679128,0.36480797261109793
5916,0.6446,3,11,3,582761,93683,72448,53808,0.7420083005956153,0.36482226034130893
5917,0.6447,14,25,14,582786,93658,72462,53794,0.7418102902040299,0.3648238070694192
5918,0.6448,6,16,6,582802,93642,72468,53788,0.7416835635534152,0.3648375500237401
5919,0.6449,0,7,0,582809,93635,72468,53788,0.7416281206437714,0.3648548733915332
5920,0.645,247,704,247,583513,92931,72715,53541,0.7360521480167279,0.36553744060298216
5921,0.6451,1,2,1,583515,92929,72716,53540,0.7360363071854011,0.36553810021233163
5922,0.6452,1,15,1,583530,92914,72717,53539,0.7359175009504498,0.36557120714495434
5923,0.6453,2,23,2,583553,92891,72719,53537,0.7357353313901913,0.3656199633949791
5924,0.6454,3,7,3,583560,92884,72722,53534,0.7356798884805474,0.36562444508188885
5925,0.6455,3,26,3,583586,92858,72725,53531,0.7354739576732987,0.36567638278832426
5926,0.6456,0,1,0,583587,92857,72725,53531,0.7354660372576353,0.3656788807825778
5927,0.6457,15,40,15,583627,92817,72740,53516,0.7351492206310987,0.3657138171157565
5928,0.6458,19,65,19,583692,92752,72759,53497,0.7346343936129768,0.365793954146695
5929,0.646,19,73,19,583765,92679,72778,53478,0.7340562032695476,0.3658942096512654
5930,0.6461,0,6,0,583771,92673,72778,53478,0.7340086807755671,0.3659092308639695
5931,0.6462,2,22,2,583793,92651,72780,53476,0.733834431630972,0.36595564132569613
5932,0.6463,2,25,2,583818,92626,72782,53474,0.7336364212393867,0.36600958247775495
5933,0.6464,3,11,3,583829,92615,72785,53471,0.7335492966670891,0.36602412277699437
5934,0.6465,5,11,5,583840,92604,72790,53466,0.7334621720947916,0.3660299856233313
5935,0.6466,0,1,0,583841,92603,72790,53466,0.7334542516791281,0.3660324914937461
5936,0.6467,122,401,122,584242,92202,72912,53344,0.730278164998099,0.36650955711596334
5937,0.6468,1,13,1,584255,92189,72913,53343,0.7301751995944747,0.36653794354506225
5938,0.6469,0,1,0,584256,92188,72913,53343,0.7301672791788113,0.36654046216957215
5939,0.647,8,37,8,584293,92151,72921,53335,0.729874223799265,0.3665988479991202
5940,0.6471,4,11,4,584304,92140,72925,53331,0.7297870992269674,0.3666091523396416
5941,0.6472,3,12,3,584316,92128,72928,53328,0.7296920542390065,0.36662633373666265
5942,0.6473,1,23,1,584339,92105,72929,53327,0.7295098846787479,0.366679960393861
5943,0.6474,3,3,3,584342,92102,72932,53324,0.7294861234317577,0.36667445986274805
5944,0.6475,56,214,56,584556,91888,72988,53268,0.7277911544797872,0.3669707073768911
5945,0.6476,2,7,2,584563,91881,72990,53266,0.7277357115701432,0.3669796826665381
5946,0.6477,7,24,7,584587,91857,72997,53259,0.7275456215942213,0.36700984040353923
5947,0.6478,1,13,1,584600,91844,72998,53258,0.7274426561905969,0.36703835922316713
5948,0.6479,0,12,0,584612,91832,72998,53258,0.7273476112026359,0.36706871596939833
5949,0.648,30,56,30,584668,91776,73028,53228,0.7269040679254847,0.3670795288405837
5950,0.6481,0,4,0,584672,91772,73028,53228,0.7268723862628311,0.3670896551724138
5951,0.6482,7,18,7,584690,91754,73035,53221,0.7267298187808896,0.3671046732195206
5952,0.6483,60,171,60,584861,91583,73095,53161,0.7253754277024458,0.36727601834963797
5953,0.6484,0,4,0,584865,91579,73095,53161,0.7253437460397921,0.3672861683017825
5954,0.6485,2,19,2,584884,91560,73097,53159,0.7251932581421873,0.36732564487040403
5955,0.6486,2,8,2,584892,91552,73099,53157,0.72512989481688,0.36733720777560486
5956,0.6487,13,23,13,584915,91529,73112,53144,0.7249477252566214,0.36733875705902275
5957,0.6488,3,14,3,584929,91515,73115,53141,0.7248368394373337,0.3673611879216901
5958,0.6489,2,6,2,584935,91509,73117,53139,0.7247893169433531,0.3673676787788286
5959,0.649,17,46,17,584981,91463,73134,53122,0.7244249778228361,0.36741017394612163
5960,0.6491,1,3,1,584984,91460,73135,53121,0.7244012165758459,0.3674134222339035
5961,0.6492,21,80,21,585064,91380,73156,53100,0.7237675833227728,0.3675249169435216
5962,0.6493,6,22,6,585086,91358,73162,53094,0.7235933341781776,0.3675546202198654
5963,0.6494,3,4,3,585090,91354,73165,53091,0.7235616525155241,0.3675516632628336
5964,0.6495,3,19,3,585109,91335,73168,53088,0.7234111646179191,0.36758688020606134
5965,0.6496,3,6,3,585115,91329,73171,53085,0.7233636421239387,0.36758901491545143
5966,0.6497,3,20,3,585135,91309,73174,53082,0.7232052338106704,0.36762679114349234
5967,0.6498,6,16,6,585151,91293,73180,53076,0.7230785071600557,0.3676412526234856
5968,0.6499,1,4,1,585155,91289,73181,53075,0.7230468254974021,0.36764705882352944
5969,0.65,859,2423,859,587578,88866,74040,52216,0.7038556583449499,0.3701109992770162
5970,0.6501,0,3,0,587581,88863,74040,52216,0.7038318970979597,0.37011886956953194
5971,0.6502,5,18,5,587599,88845,74045,52211,0.7036893296160183,0.3701437726860254
5972,0.6503,6,20,6,587619,88825,74051,52205,0.70353092130275,0.3701694674891867
5973,0.6504,4,9,4,587628,88816,74055,52201,0.7034596375617792,0.37017522710027867
5974,0.6505,4,17,4,587645,88799,74059,52197,0.7033249904955012,0.3702019915458595
5975,0.6506,2,10,2,587655,88789,74061,52195,0.703245786338867,0.37021931566702604
5976,0.6507,14,32,14,587687,88757,74075,52181,0.7029923330376379,0.3702408151101903
5977,0.6508,16,79,16,587766,88678,74091,52165,0.7023666202002281,0.3703769445410848
5978,0.651,19,51,19,587817,88627,74110,52146,0.701962679001394,0.3704261470594503
5979,0.6511,1,4,1,587821,88623,74111,52145,0.7019309973387403,0.37043220050011366
5980,0.6512,3,18,3,587839,88605,74114,52142,0.7017884298567989,0.3704661555841332
5981,0.6513,5,26,5,587865,88579,74119,52137,0.7015824990495502,0.3705122374143665
5982,0.6514,1,6,1,587871,88573,74120,52136,0.7015349765555696,0.37052356281403465
5983,0.6515,3,21,3,587892,88552,74123,52133,0.701368647826638,0.3705654476312329
5984,0.6516,2,4,2,587896,88548,74125,52131,0.7013369661639843,0.37056703559166615
5985,0.6517,53,222,53,588118,88326,74178,52078,0.6995786338867064,0.3709153585367938
5986,0.6518,1,19,1,588137,88307,74179,52077,0.6994281459891015,0.3709610781855482
5987,0.6519,1,6,1,588143,88301,74180,52076,0.699380623495121,0.3709724527522315
5988,0.652,11,41,11,588184,88260,74191,52065,0.699055886452921,0.37103153393907
5989,0.6521,3,11,3,588195,88249,74194,52062,0.6989687618806235,0.37104717377824975
5990,0.6522,6,12,6,588207,88237,74200,52056,0.6988737168926625,0.3710520125736851
5991,0.6523,4,21,4,588228,88216,74204,52052,0.6987073881637308,0.3710896284255853
5992,0.6524,4,6,4,588234,88210,74208,52048,0.6986598656697504,0.371087567197593
5993,0.6525,53,163,53,588397,88047,74261,51995,0.6973688379166139,0.37128147270104683
5994,0.6526,2,5,2,588402,88042,74263,51993,0.6973292358382968,0.37128574999107367
5995,0.6527,8,34,8,588436,88008,74271,51985,0.6970599417057407,0.3713399955712071
5996,0.6528,2,9,2,588445,87999,74273,51983,0.6969886579647699,0.37135488848566245
5997,0.6529,0,16,0,588461,87983,74273,51983,0.6968619313141554,0.37139733935384306
5998,0.653,6,28,6,588489,87955,74279,51977,0.6966401596755798,0.37144470171226024
5999,0.6531,1,6,1,588495,87949,74280,51976,0.6965926371815993,0.3714561372163659
6000,0.6532,5,19,5,588514,87930,74285,51971,0.6964421492839944,0.37148412091407496
6001,0.6533,130,361,130,588875,87569,74415,51841,0.693582879229502,0.3718599813499749
6002,0.6534,2,3,2,588878,87566,74417,51839,0.6935591179825117,0.3718589720598257
6003,0.6535,6,21,6,588899,87545,74423,51833,0.69339278925358,0.3718879593623097
6004,0.6536,4,8,4,588907,87537,74427,51829,0.6933294259282727,0.37189127907811087
6005,0.6537,8,22,8,588929,87515,74435,51821,0.6931551767836777,0.3719139346615376
6006,0.6538,7,20,7,588949,87495,74442,51814,0.6929967684704094,0.37193576868687594
6007,0.6539,1,2,1,588951,87493,74443,51813,0.6929809276390825,0.3719366000028714
6008,0.654,20,72,20,589023,87421,74463,51793,0.6924106577113167,0.3720387317367506
6009,0.6541,2,5,2,589028,87416,74465,51791,0.6923710556329996,0.37204307254663915
6010,0.6542,26,72,26,589100,87344,74491,51765,0.6918007857052338,0.37211826697050515
6011,0.6543,12,38,12,589138,87306,74503,51753,0.6914998099100241,0.3721657713632343
6012,0.6544,1,4,1,589142,87302,74504,51752,0.6914681282473705,0.3721719619716082
6013,0.6545,1,17,1,589159,87285,74505,51751,0.6913334811810924,0.372212952041198
6014,0.6546,2,4,2,589163,87281,74507,51749,0.6913017995184387,0.37221462993598503
6015,0.6547,13,25,13,589188,87256,74520,51736,0.6911037891268533,0.3722228617474387
6016,0.6548,9,17,9,589205,87239,74529,51727,0.6909691420605754,0.3722277391592188
6017,0.6549,2,7,2,589212,87232,74531,51725,0.6909136991509315,0.3722374547521895
6018,0.655,257,665,257,589877,86567,74788,51468,0.6856466227347611,0.3728619553011917
6019,0.6551,1,4,1,589881,86563,74789,51467,0.6856149410721074,0.37286821705426354
6020,0.6552,3,13,3,589894,86550,74792,51464,0.6855119756684831,0.37288970684133493
6021,0.6553,5,29,5,589923,86521,74797,51459,0.685282283614244,0.3729453543991883
6022,0.6554,0,4,0,589927,86517,74797,51459,0.6852506019515904,0.3729561662897895
6023,0.6555,10,19,10,589946,86498,74807,51449,0.6851001140539855,0.37296207963928174
6024,0.6556,4,3,4,589949,86495,74811,51445,0.6850763528069953,0.3729520081194722
6025,0.6557,6,35,6,589984,86460,74817,51439,0.6847991382587758,0.3730193837518764
6026,0.6558,20,54,20,590038,86406,74837,51419,0.6843714358129515,0.37307455106112825
6027,0.6559,3,5,3,590043,86401,74840,51416,0.6843318337346344,0.37307443929268524
6028,0.656,15,87,15,590130,86314,74855,51401,0.6836427575719174,0.37324184003195005
6029,0.6561,0,7,0,590137,86307,74855,51401,0.6835873146622735,0.3732608127341912
6030,0.6562,1,24,1,590161,86283,74856,51400,0.6833972246863516,0.3733213250728122
6031,0.6563,3,15,3,590176,86268,74859,51397,0.6832784184514004,0.37334834562161767
6032,0.6564,1,7,1,590183,86261,74860,51396,0.6832229755417565,0.37336277850018523
6033,0.6565,2,22,2,590205,86239,74862,51394,0.6830487263971613,0.3734133529022836
6034,0.6566,2,4,2,590209,86235,74864,51392,0.6830170447345076,0.3734151002346923
6035,0.6567,154,364,154,590573,85871,75018,51238,0.6801340134330249,0.3737026745144374
6036,0.6568,4,20,4,590593,85851,75022,51234,0.6799756051197566,0.37373892110734214
6037,0.6569,3,3,3,590596,85848,75025,51231,0.6799518438727664,0.37373339461186617
6038,0.657,7,30,7,590626,85818,75032,51224,0.679714231402864,0.37378321974285256
6039,0.6571,3,19,3,590645,85799,75035,51221,0.6795637435052592,0.3738213399503722
6040,0.6572,3,18,3,590663,85781,75038,51218,0.6794211760233178,0.3738567434798794
6041,0.6573,15,27,15,590690,85754,75053,51203,0.6792073248004056,0.3738618690537906
6042,0.6574,0,4,0,590694,85750,75053,51203,0.6791756431377519,0.37387278847487826
6043,0.6575,68,188,68,590882,85562,75121,51135,0.67768660499303,0.37407551006971623
6044,0.6576,1,5,1,590887,85557,75122,51134,0.6776470029147129,0.37408461420283706
6045,0.6577,4,27,4,590914,85530,75126,51130,0.6774331516918007,0.3741402019610713
6046,0.6578,4,11,4,590925,85519,75130,51126,0.6773460271195032,0.37415199970727064
6047,0.6579,2,6,2,590931,85513,75132,51124,0.6772985046255228,0.3741592687193074
6048,0.658,15,47,15,590978,85466,75147,51109,0.6769262450893423,0.3742192934285191
6049,0.6581,0,6,0,590984,85460,75147,51109,0.6768787225953619,0.3742357343174513
6050,0.6582,2,25,2,591009,85435,75149,51107,0.6766807122037765,0.3742950886906593
6051,0.6583,58,177,58,591186,85258,75207,51049,0.6752787986313522,0.374514881847594
6052,0.6584,1,3,1,591189,85255,75208,51048,0.6752550373843619,0.3745185359089675
6053,0.6585,7,18,7,591207,85237,75215,51041,0.6751124699024205,0.37453587519628995
6054,0.6586,1,9,1,591216,85228,75216,51040,0.6750411861614497,0.3745560219567323
6055,0.6587,6,13,6,591229,85215,75222,51034,0.6749382207578254,0.3745642169850788
6056,0.6588,2,12,2,591241,85203,75224,51032,0.6748431757698644,0.3745880280397842
6057,0.6589,2,4,2,591245,85199,75226,51030,0.6748114941072108,0.3745898450403365
6058,0.659,6,40,6,591285,85159,75232,51024,0.6744946774806742,0.3746723159278324
6059,0.6591,0,4,0,591289,85155,75232,51024,0.6744629958180205,0.3746833212169277
6060,0.6592,19,43,19,591332,85112,75251,51005,0.6741224179444937,0.3747144001116686
6061,0.6593,13,25,13,591357,85087,75264,50992,0.6739244075529084,0.3747235061986052
6062,0.6594,0,5,0,591362,85082,75264,50992,0.6738848054745913,0.3747372753060835
6063,0.6595,5,21,5,591383,85061,75269,50987,0.6737184767456597,0.3747721392449724
6064,0.6596,0,5,0,591388,85056,75269,50987,0.6736788746673426,0.3747859132774196
6065,0.6597,5,13,5,591401,85043,75274,50982,0.6735759092637181,0.3747987502297372
6066,0.6598,3,12,3,591413,85031,75277,50979,0.6734808642757572,0.37481802808617015
6067,0.6599,0,6,0,591419,85025,75277,50979,0.6734333417817767,0.37483456368930324
6068,0.66,1009,2373,1009,593792,82652,76286,49970,0.6546381954124952,0.3767851487686809
6069,0.6601,3,3,3,593795,82649,76289,49967,0.654614434165505,0.37677957410870483
6070,0.6602,3,13,3,593808,82636,76292,49964,0.6545114687618806,0.3768024132730015
6071,0.6603,6,19,6,593827,82617,76298,49958,0.6543609808642757,0.37682821044691683
6072,0.6604,1,5,1,593832,82612,76299,49957,0.6543213787859586,0.3768377222427566
6073,0.6605,4,19,4,593851,82593,76303,49953,0.6541708908883538,0.3768729346792812
6074,0.6606,1,7,1,593858,82586,76304,49952,0.6541154479787099,0.3768881377416288
6075,0.6607,9,32,9,593890,82554,76313,49943,0.6538619946774806,0.37693683630572766
6076,0.6608,23,85,23,593975,82469,76336,49920,0.6531887593460904,0.3770706025425073
6077,0.6609,1,5,1,593980,82464,76337,49919,0.6531491572677735,0.3770801386885023
6078,0.661,13,37,13,594017,82427,76350,49906,0.6528561018882271,0.3771243756281502
6079,0.6612,0,17,0,594034,82410,76350,49906,0.6527214548219491,0.3771728286828501
6080,0.6613,2,25,2,594059,82385,76352,49904,0.6525234444303637,0.3772346907150254
6081,0.6614,5,11,5,594070,82374,76357,49899,0.6524363198580662,0.3772425211494409
6082,0.6615,4,19,4,594089,82355,76361,49895,0.6522858319604613,0.37727788279773156
6083,0.6616,0,5,0,594094,82350,76361,49895,0.6522462298821442,0.377292147151121
6084,0.6617,64,192,64,594286,82158,76425,49831,0.6507255100747688,0.3775390373440211
6085,0.6618,3,18,3,594304,82140,76428,49828,0.6505829425928272,0.3775763821532493
6086,0.6619,1,7,1,594311,82133,76429,49827,0.6505274996831834,0.3775916944528645
6087,0.662,14,48,14,594359,82085,76443,49813,0.6501473197313395,0.37766304265417217
6088,0.6621,2,11,2,594370,82074,76445,49811,0.6500601951590419,0.37768510444705616
6089,0.6622,2,9,2,594379,82065,76447,49809,0.6499889114180712,0.37770144228581826
6090,0.6623,5,23,5,594402,82042,76452,49804,0.6498067418578127,0.377743731322907
6091,0.6624,5,6,5,594408,82036,76457,49799,0.6497592193638322,0.3777373231691129
6092,0.6625,59,153,59,594561,81883,76516,49740,0.6485473957673299,0.3778974799237215
6093,0.6626,4,6,4,594567,81877,76520,49736,0.6484998732733493,0.3778958005668133
6094,0.6627,8,30,8,594597,81847,76528,49728,0.648262260803447,0.37794413832414975
6095,0.6628,5,14,5,594611,81833,76533,49723,0.6481513749841592,0.37796071634893125
6096,0.6629,7,12,7,594623,81821,76540,49716,0.6480563299961982,0.37796209431566785
6097,0.663,6,31,6,594654,81790,76546,49710,0.6478107971106324,0.37802281368821294
6098,0.6631,0,7,0,594661,81783,76546,49710,0.6477553542009885,0.3780429376468709
6099,0.6632,1,10,1,594671,81773,76547,49709,0.6476761500443543,0.37806695973593346
6100,0.6633,108,283,108,594954,81490,76655,49601,0.6454346724116081,0.3783707500896324
6101,0.6634,2,9,2,594963,81481,76657,49599,0.6453633886706375,0.3783872444308819
6102,0.6635,9,20,9,594983,81461,76666,49590,0.6452049803573692,0.37840230139411374
6103,0.6636,0,3,0,594986,81458,76666,49590,0.645181219110379,0.3784109639216165
6104,0.6637,3,28,3,595014,81430,76669,49587,0.6449594474718033,0.37847760214323334
6105,0.6638,4,16,4,595030,81414,76673,49583,0.6448327208211887,0.37850485125613564
6106,0.6639,2,2,2,595032,81412,76675,49581,0.6448168799898618,0.3785011412823586
6107,0.664,25,75,25,595107,81337,76700,49556,0.6442228488151058,0.37859931394345
6108,0.6641,0,3,0,595110,81334,76700,49556,0.6441990875681156,0.37860799144319657
6109,0.6642,33,72,33,595182,81262,76733,49523,0.6436288176403497,0.37865963222082044
6110,0.6643,6,33,6,595215,81229,76739,49517,0.6433674439234571,0.3787266914475395
6111,0.6644,3,3,3,595218,81226,76742,49514,0.6433436826764669,0.3787211258987303
6112,0.6645,4,20,4,595238,81206,76746,49510,0.6431852743631986,0.3787600599773555
6113,0.6646,1,3,1,595241,81203,76747,49509,0.6431615131162083,0.37876400024481305
6114,0.6647,7,27,7,595268,81176,76754,49502,0.6429476618932961,0.37880898085370146
6115,0.6648,4,15,4,595283,81161,76758,49498,0.6428288556583449,0.3788334519627427
6116,0.6649,1,5,1,595288,81156,76759,49497,0.6427892535800279,0.37884319533420585
6117,0.665,248,615,248,595903,80541,77007,49249,0.6379181979470283,0.3794514215270822
6118,0.6651,0,5,0,595908,80536,77007,49249,0.6378785958687112,0.3794660399892129
6119,0.6652,4,22,4,595930,80514,77011,49245,0.6377043467241161,0.37951124777472084
6120,0.6653,5,15,5,595945,80499,77016,49240,0.6375855404891648,0.3795312126654283
6121,0.6654,1,4,1,595949,80495,77017,49239,0.6375538588265112,0.37953813186982593
6122,0.6655,6,12,6,595961,80483,77023,49233,0.6374588138385503,0.3795445434641833
6123,0.6656,0,6,0,595967,80477,77023,49233,0.6374112913445698,0.37956210006938557
6124,0.6657,9,20,9,595987,80457,77032,49224,0.6372528830313015,0.37957757882804727
6125,0.6658,15,61,15,596048,80396,77047,49209,0.6367697376758332,0.3796844257551792
6126,0.6659,2,3,2,596051,80393,77049,49207,0.636745976428843,0.37968364197530863
6127,0.666,39,61,39,596112,80332,77088,49168,0.6362628310733748,0.3796756756756757
6128,0.6661,1,3,1,596115,80329,77089,49167,0.6362390698263845,0.3796796812256749
6129,0.6662,3,17,3,596132,80312,77092,49164,0.6361044227601065,0.3797151595662517
6130,0.6663,9,25,9,596157,80287,77101,49155,0.6359064123685211,0.37974536858206764
6131,0.6664,3,7,3,596164,80280,77104,49152,0.6358509694588772,0.37975152976080107
6132,0.6665,6,15,6,596179,80265,77110,49146,0.635732163223926,0.37976678953102905
6133,0.6666,0,2,0,596181,80263,77110,49146,0.6357163223925991,0.3797726587795285
6134,0.6667,120,340,120,596521,79923,77230,49026,0.6330233810670384,0.3801968219993951
6135,0.6668,2,14,2,596535,79909,77232,49024,0.6329124952477506,0.38022849076652215
6136,0.6669,1,4,1,596539,79905,77233,49023,0.632880813585097,0.3802354802680566
6137,0.667,8,27,8,596566,79878,77241,49015,0.6326669623621848,0.3802766635891786
6138,0.6671,2,5,2,596571,79873,77243,49013,0.6326273602838677,0.3802817994196422
6139,0.6672,2,21,2,596592,79852,77245,49011,0.632461031554936,0.38033415332562487
6140,0.6673,5,26,5,596618,79826,77250,49006,0.6322551007476872,0.3803868604073522
6141,0.6674,0,6,0,596624,79820,77250,49006,0.6322075782537068,0.38040457671588035
6142,0.6675,54,173,54,596797,79647,77304,48952,0.6308373463439362,0.38065614818155663
6143,0.6676,1,3,1,596800,79644,77305,48951,0.6308135850969459,0.3806602122944127
6144,0.6677,8,22,8,596822,79622,77313,48943,0.6306393359523508,0.3806868121183837
6145,0.6678,2,14,2,596836,79608,77315,48941,0.630528450133063,0.38071863647325144
6146,0.6679,2,3,2,596839,79605,77317,48939,0.6305046888860727,0.3807178864824496
6147,0.668,17,37,17,596876,79568,77334,48922,0.6302116335065264,0.3807455833138766
6148,0.6682,7,14,7,596890,79554,77341,48915,0.6301007476872387,0.3807533334890129
6149,0.6683,47,162,47,597052,79392,77388,48868,0.6288176403497655,0.3810073288632465
6150,0.6685,7,25,7,597077,79367,77395,48861,0.6286196299581802,0.3810478210687213
6151,0.6686,3,5,3,597082,79362,77398,48858,0.6285800278798631,0.3810481984089846
6152,0.6687,5,14,5,597096,79348,77403,48853,0.6284691420605754,0.3810656703145841
6153,0.6688,5,10,5,597106,79338,77408,48848,0.6283899379039412,0.38107125583137
6154,0.6689,1,4,1,597110,79334,77409,48847,0.6283582562412875,0.38107831893962446
6155,0.669,11,42,11,597152,79292,77420,48836,0.6280255987834241,0.3811500999000999
6156,0.6691,1,3,1,597155,79289,77421,48835,0.6280018375364339,0.3811541943742
6157,0.6692,22,57,22,597212,79232,77443,48813,0.6275503738436193,0.38121754070834474
6158,0.6693,10,19,10,597231,79213,77453,48803,0.6273998859460145,0.3812257842769654
6159,0.6694,2,7,2,597238,79206,77455,48801,0.6273444430363706,0.3812369636035529
6160,0.6695,3,19,3,597257,79187,77458,48798,0.6271939551387656,0.38127905613939134
6161,0.6696,2,4,2,597261,79183,77460,48796,0.627162273476112,0.38128130396393156
6162,0.6697,6,19,6,597280,79164,77466,48790,0.6270117855785071,0.38130890788877253
6163,0.6698,2,15,2,597295,79149,77468,48788,0.6268929793435559,0.3813439427218084
6164,0.6699,4,6,4,597301,79143,77472,48784,0.6268454568495755,0.3813424843856262
6165,0.67,941,2299,941,599600,76844,78413,47843,0.6086364212393867,0.3837047968112153
6166,0.6701,0,2,0,599602,76842,78413,47843,0.6086205804080598,0.38371095159802704
6167,0.6702,3,23,3,599625,76819,78416,47840,0.6084384108478013,0.38376691614724967
6168,0.6703,3,14,3,599639,76805,78419,47837,0.6083275250285135,0.38379518942250607
6169,0.6704,1,4,1,599643,76801,78420,47836,0.6082958433658598,0.3838025626419121
6170,0.6705,13,28,13,599671,76773,78433,47823,0.6080740717272842,0.3838245208513917
6171,0.6706,2,5,2,599676,76768,78435,47821,0.6080344696489671,0.3838300331489939
6172,0.6707,10,37,10,599713,76731,78445,47811,0.6077414142694209,0.38389458977694274
6173,0.6708,17,74,17,599787,76657,78462,47794,0.6071553035103282,0.3840386979614467
6174,0.6709,1,3,1,599790,76654,78463,47793,0.607131542263338,0.3840430062596929
6175,0.671,15,45,15,599835,76609,78478,47778,0.6067751235584844,0.3841076639841784
6176,0.6711,1,5,1,599840,76604,78479,47777,0.6067355214801673,0.3841181530941221
6177,0.6712,4,19,4,599859,76585,78483,47773,0.6065850335825624,0.38415703050869265
6178,0.6713,4,12,4,599871,76573,78487,47769,0.6064899885946015,0.3841742934808834
6179,0.6714,2,6,2,599877,76567,78489,47767,0.6064424661006209,0.38418292663310116
6180,0.6715,5,18,5,599895,76549,78494,47762,0.6062998986186795,0.3842137863905849
6181,0.6716,0,3,0,599898,76546,78494,47762,0.6062761373716893,0.3842230588538147
6182,0.6717,61,172,61,600070,76374,78555,47701,0.604913825877582,0.384452951843643
6183,0.6718,7,13,7,600083,76361,78562,47694,0.6048108604739577,0.38445850630768613
6184,0.6719,1,8,1,600091,76353,78563,47693,0.6047474971486504,0.38447833868081194
6185,0.672,13,46,13,600137,76307,78576,47680,0.6043831580281334,0.38455644543379547
6186,0.6721,0,5,0,600142,76302,78576,47680,0.6043435559498163,0.3845719539933216
6187,0.6722,3,14,3,600156,76288,78579,47677,0.6042326701305285,0.38460049207437585
6188,0.6723,9,23,9,600179,76265,78588,47668,0.6040505005702699,0.3846271775878902
6189,0.6724,2,5,2,600184,76260,78590,47666,0.6040108984919529,0.38463276471442637
6190,0.6725,61,143,61,600327,76117,78651,47605,0.6028782790520847,0.38477392864648163
6191,0.6726,2,6,2,600333,76111,78653,47603,0.6028307565581041,0.38478264383982413
6192,0.6727,8,26,8,600359,76085,78661,47595,0.6026248257508554,0.3848237386804657
6193,0.6728,3,21,3,600380,76064,78664,47592,0.6024584970219237,0.3848741670440577
6194,0.6729,4,9,4,600389,76055,78668,47588,0.602387213280953,0.384882282053978
6195,0.673,10,23,10,600412,76032,78678,47578,0.6022050437206945,0.38490413396974354
6196,0.6731,0,2,0,600414,76030,78678,47578,0.6021892028893676,0.384910361788881
6197,0.6732,2,7,2,600421,76023,78680,47576,0.6021337599797237,0.3849222081084798
6198,0.6733,118,310,118,600731,75713,78798,47458,0.5996784311240654,0.3853017349863198
6199,0.6734,1,7,1,600738,75706,78799,47457,0.5996229882144215,0.3853186427742098
6200,0.6735,7,15,7,600753,75691,78806,47450,0.5995041819794703,0.3853306372369885
6201,0.6736,2,8,2,600761,75683,78808,47448,0.599440818654163,0.3853456887380107
6202,0.6737,1,19,1,600780,75664,78809,47447,0.5992903307565581,0.3854001673286709
6203,0.6738,10,17,10,600797,75647,78819,47437,0.59915568369028,0.3854034643008027
6204,0.6739,0,11,0,600808,75636,78819,47437,0.5990685591179825,0.38543791083340784
6205,0.674,23,69,23,600877,75567,78842,47414,0.598522050437207,0.3855392296370984
6206,0.6741,1,8,1,600885,75559,78843,47413,0.5984586871118996,0.3855593143154539
6207,0.6742,16,60,16,600945,75499,78859,47397,0.5979834621720947,0.38566755630777244
6208,0.6743,5,32,5,600977,75467,78864,47392,0.5977300088708656,0.3857430062103712
6209,0.6744,2,3,2,600980,75464,78866,47390,0.5977062476238753,0.3857424259690364
6210,0.6745,2,19,2,600999,75445,78868,47388,0.5975557597262704,0.3857920917017414
6211,0.6746,1,6,1,601005,75439,78869,47387,0.59750823723229,0.3858059368537606
6212,0.6747,8,19,8,601024,75420,78877,47379,0.5973577493346851,0.385825617472455
6213,0.6748,6,14,6,601038,75406,78883,47373,0.5972468635153972,0.38583959797685274
6214,0.6749,1,4,1,601042,75402,78884,47372,0.5972151818527436,0.38584716633814975
6215,0.675,240,604,240,601646,74798,79124,47132,0.5924312507920416,0.3865496596407775
6216,0.6751,0,3,0,601649,74795,79124,47132,0.5924074895450513,0.38655917065129136
6217,0.6752,3,25,3,601674,74770,79127,47129,0.592209479153466,0.38662335211937754
6218,0.6753,3,19,3,601693,74751,79130,47126,0.5920589912558611,0.3866685264652067
6219,0.6754,1,2,1,601695,74749,79131,47125,0.5920431504245343,0.3866698393422715
6220,0.6755,2,11,2,601706,74738,79133,47123,0.5919560258522367,0.3866946767218388
6221,0.6756,2,4,2,601710,74734,79135,47121,0.5919243441895831,0.3866973041729925
6222,0.6757,14,31,14,601741,74703,79149,47107,0.5916788113040172,0.3867252278138084
6223,0.6758,21,56,21,601797,74647,79170,47086,0.5912352680268661,0.38679733515152015
6224,0.6759,0,1,0,601798,74646,79170,47086,0.5912273476112027,0.3868005126014524
6225,0.676,27,65,27,601863,74581,79197,47059,0.5907125205930808,0.3868710950345281
6226,0.6761,2,6,2,601869,74575,79199,47057,0.5906649980991002,0.38688009734280454
6227,0.6762,7,14,7,601883,74561,79206,47050,0.5905541122798125,0.38688934389158874
6228,0.6763,7,18,7,601901,74543,79213,47043,0.590411544797871,0.38691132202720707
6229,0.6764,0,1,0,601902,74542,79213,47043,0.5904036243822076,0.3869145042562816
6230,0.6765,4,21,4,601923,74521,79217,47039,0.5902372956532759,0.38696117143797304
6231,0.6766,0,1,0,601924,74520,79217,47039,0.5902293752376124,0.38696435475777197
6232,0.6767,133,305,133,602229,74215,79350,46906,0.5878136484602712,0.3872656269350484
6233,0.6768,2,18,2,602247,74197,79352,46904,0.5876710809783298,0.38731306925624065
6234,0.6769,1,4,1,602251,74193,79353,46903,0.5876393993156761,0.38732080332958974
6235,0.677,9,35,9,602286,74158,79362,46894,0.5873621847674566,0.38738723854211415
6236,0.6771,2,9,2,602295,74149,79364,46892,0.5872909010264858,0.3874059203079948
6237,0.6772,6,22,6,602317,74127,79370,46886,0.5871166518818908,0.3874459768785172
6238,0.6773,6,29,6,602346,74098,79376,46880,0.5868869598276517,0.3875084726148556
6239,0.6774,0,3,0,602349,74095,79376,46880,0.5868631985806615,0.38751808224839845
6240,0.6775,55,127,55,602476,73968,79431,46825,0.5858573057914079,0.38764663515269926
6241,0.6776,2,5,2,602481,73963,79433,46823,0.5858177037130908,0.3876525425132052
6242,0.6777,9,19,9,602500,73944,79442,46814,0.585667215815486,0.38766789777902916
6243,0.6778,1,20,1,602520,73924,79443,46813,0.5855088075022177,0.3877270430771015
6244,0.6779,2,7,2,602527,73917,79445,46811,0.5854533645925738,0.3877393810880657
6245,0.678,14,34,14,602561,73883,79459,46797,0.5851840704600177,0.3877775936360623
6246,0.6781,1,3,1,602564,73880,79460,46796,0.5851603092130275,0.3877821604958733
6247,0.6782,5,18,5,602582,73862,79465,46791,0.585017741731086,0.3878146419898386
6248,0.6783,50,159,50,602741,73703,79515,46741,0.5837583956406032,0.38807246521204875
6249,0.6784,0,1,0,602742,73702,79515,46741,0.5837504752249398,0.38807568725455194
6250,0.6785,6,28,6,602770,73674,79521,46735,0.5835287035863642,0.3881354383808519
6251,0.6786,2,10,2,602780,73664,79523,46733,0.5834494994297301,0.3881575122303712
6252,0.6787,8,10,8,602790,73654,79531,46725,0.5833702952730959,0.38814909577251844
6253,0.6788,4,11,4,602801,73643,79535,46721,0.5832831707007984,0.3881642351533681
6254,0.6789,2,9,2,602810,73634,79537,46719,0.5832118869598276,0.3881830947296702
6255,0.679,12,30,12,602840,73604,79549,46707,0.5829742744899252,0.3882188661053437
6256,0.6791,0,1,0,602841,73603,79549,46707,0.5829663540742618,0.38822209292660625
6257,0.6792,24,64,24,602905,73539,79573,46683,0.5824594474718033,0.38830663272945054
6258,0.6793,8,28,8,602933,73511,79581,46675,0.5822376758332277,0.3883563809428719
6259,0.6794,1,8,1,602941,73503,79582,46674,0.5821743125079204,0.3883771437130233
6260,0.6795,3,22,3,602963,73481,79585,46671,0.5820000633633253,0.3884329848858113
6261,0.6796,1,3,1,602966,73478,79586,46670,0.5819763021163351,0.3884375936345174
6262,0.6797,4,14,4,602980,73464,79590,46666,0.5818654162970472,0.3884624989594606
6263,0.6798,3,8,3,602988,73456,79593,46663,0.5818020529717399,0.3884730975116343
6264,0.6799,3,3,3,602991,73453,79596,46660,0.5817782917247497,0.3884675264126281
6265,0.68,949,2201,949,605192,71252,80545,45711,0.5643454568495755,0.39081589904499714
6266,0.6801,0,1,0,605193,71251,80545,45711,0.564337536433912,0.390819240437065
6267,0.6802,4,15,4,605208,71236,80549,45707,0.5642187301989608,0.39084853304601386
6268,0.6803,4,12,4,605220,71224,80553,45703,0.5641236852109999,0.39086780640912705
6269,0.6804,2,8,2,605228,71216,80555,45701,0.5640603218856926,0.39088413147788603
6270,0.6805,4,13,4,605241,71203,80559,45697,0.5639573564820681,0.39090675791274593
6271,0.6806,0,4,0,605245,71199,80559,45697,0.5639256748194145,0.3909201341363263
6272,0.6807,5,27,5,605272,71172,80564,45692,0.5637118235965023,0.3909843921139102
6273,0.6808,22,75,22,605347,71097,80586,45670,0.5631177924217463,0.39112077898721387
6274,0.6809,3,3,3,605350,71094,80589,45667,0.5630940311747561,0.39111518400835893
6275,0.681,25,35,25,605385,71059,80614,45642,0.5628168166265366,0.3911020471118499
6276,0.6811,0,2,0,605387,71057,80614,45642,0.5628009757952097,0.3911087498607529
6277,0.6812,4,17,4,605404,71040,80618,45638,0.5626663287289317,0.39114486021357925
6278,0.6813,6,15,6,605419,71025,80624,45632,0.5625475224939804,0.3911638392895411
6279,0.6814,0,5,0,605424,71020,80624,45632,0.5625079204156634,0.3911806055618421
6280,0.6815,4,18,4,605442,71002,80628,45628,0.5623653529337219,0.39122009774500555
6281,0.6816,0,4,0,605446,70998,80628,45628,0.5623336712710683,0.3912335156826094
6282,0.6817,61,137,61,605583,70861,80689,45567,0.5612485743251806,0.39137492699350673
6283,0.6818,5,24,5,605607,70837,80694,45562,0.5610584843492586,0.39142947963470476
6284,0.6819,1,9,1,605616,70828,80695,45561,0.5609872006082879,0.391454518897834
6285,0.682,13,45,13,605661,70783,80708,45548,0.5606307819034343,0.39153793915637275
6286,0.6821,3,1,3,605662,70782,80711,45545,0.5606228614877709,0.39152561314226275
6287,0.6822,2,5,2,605667,70777,80713,45543,0.5605832594094539,0.39153198074277856
6288,0.6823,6,26,6,605693,70751,80719,45537,0.560377328602205,0.3915881260319207
6289,0.6824,4,1,4,605694,70750,80723,45533,0.5603694081865417,0.3915705649149059
6290,0.6825,51,126,51,605820,70624,80774,45482,0.5593714358129515,0.3917282483248066
6291,0.6826,0,2,0,605822,70622,80774,45482,0.5593555949816247,0.39173499621029423
6292,0.6827,6,32,6,605854,70590,80780,45476,0.5591021416803954,0.39181155549428776
6293,0.6828,4,19,4,605873,70571,80784,45472,0.5589516537827905,0.39185474350025423
6294,0.6829,5,5,5,605878,70566,80789,45467,0.5589120517044734,0.3918454232847552
6295,0.683,9,31,9,605909,70535,80798,45458,0.5586665188189076,0.39190295966135885
6296,0.6831,0,2,0,605911,70533,80798,45458,0.5586506779875808,0.39190971713322587
6297,0.6832,5,5,5,605916,70528,80803,45453,0.5586110759092637,0.39190039747889743
6298,0.6833,140,332,140,606248,70196,80943,45313,0.5559814979090103,0.3922897782856747
6299,0.6834,1,8,1,606256,70188,80944,45312,0.555918134583703,0.39231168831168833
6300,0.6835,5,19,5,606275,70169,80949,45307,0.5557676466860981,0.39234992552565034
6301,0.6836,1,7,1,606282,70162,80950,45306,0.5557122037764541,0.39236844840128865
6302,0.6837,3,12,3,606294,70150,80953,45303,0.5556171587884933,0.39239344148701205
6303,0.6838,1,9,1,606303,70141,80954,45302,0.5555458750475225,0.39241876943599874
6304,0.6839,2,2,2,606305,70139,80956,45300,0.5555300342161956,0.39241504171034053
6305,0.684,25,57,25,606362,70082,80981,45275,0.555078570523381,0.3924772662257167
6306,0.6841,1,5,1,606367,70077,80982,45274,0.555038968445064,0.3924890117987707
6307,0.6842,17,64,17,606431,70013,80999,45257,0.5545320618426055,0.3926173332176629
6308,0.6843,10,28,10,606459,69985,81009,45247,0.5543102902040299,0.39266002499305747
6309,0.6844,2,2,2,606461,69983,81011,45245,0.5542944493727031,0.39265629881625996
6310,0.6845,2,9,2,606470,69974,81013,45243,0.5542231656317324,0.3926764279576799
6311,0.6846,2,5,2,606475,69969,81015,45241,0.5541835635534152,0.3926829268292683
6312,0.6847,3,17,3,606492,69952,81018,45238,0.5540489164871373,0.3927250629394913
6313,0.6848,4,15,4,606507,69937,81022,45234,0.5539301102521861,0.39275512064669055
6314,0.6849,1,4,1,606511,69933,81023,45233,0.5538984285895324,0.3927634892242502
6315,0.685,225,560,225,607071,69373,81248,45008,0.5494629958180205,0.3934919261066086
6316,0.6851,1,3,1,607074,69370,81249,45007,0.5494392345710303,0.3934969443157278
6317,0.6852,1,13,1,607087,69357,81250,45006,0.5493362691674059,0.39353637102909156
6318,0.6853,5,21,5,607108,69336,81255,45001,0.5491699404384742,0.39358213001915393
6319,0.6854,1,6,1,607114,69330,81256,45000,0.5491224179444937,0.39359748097612174
6320,0.6855,1,16,1,607130,69314,81257,44999,0.5489956912938792,0.3936472667150718
6321,0.6856,3,7,3,607137,69307,81260,44996,0.5489402483842352,0.3936554596117337
6322,0.6857,7,25,7,607162,69282,81267,44989,0.5487422379926499,0.39370443944657874
6323,0.6858,22,55,22,607217,69227,81289,44967,0.5483066151311621,0.39377725624813914
6324,0.6859,1,4,1,607221,69223,81290,44966,0.5482749334685084,0.39378574118347653
6325,0.686,27,68,27,607289,69155,81317,44939,0.5477363452033963,0.3938769786316546
6326,0.6861,0,8,0,607297,69147,81317,44939,0.547672981878089,0.3939045982855039
6327,0.6862,2,15,2,607312,69132,81319,44937,0.5475541756431378,0.39394576966572864
6328,0.6863,5,14,5,607326,69118,81324,44932,0.5474432898238499,0.39396755808855766
6329,0.6864,2,4,2,607330,69114,81326,44930,0.5474116081611963,0.3939707481322998
6330,0.6865,4,19,4,607349,69095,81330,44926,0.5472611202635914,0.3940151375623789
6331,0.6866,2,3,2,607352,69092,81332,44924,0.5472373590166012,0.3940148751052484
6332,0.6867,120,325,120,607677,68767,81452,44804,0.5446632239259916,0.3945021176180539
6333,0.6868,5,17,5,607694,68750,81457,44799,0.5445285768597136,0.39453451813754414
6334,0.6869,2,1,2,607695,68749,81459,44797,0.5445206564440502,0.39452732813133
6335,0.687,7,22,7,607717,68727,81466,44790,0.544346407299455,0.39456645260181294
6336,0.6871,4,15,4,607732,68712,81470,44786,0.5442276010645039,0.39459726162575554
6337,0.6872,3,12,3,607744,68700,81473,44783,0.5441325560765429,0.3946229831780972
6338,0.6873,5,16,5,607760,68684,81478,44778,0.5440058294259282,0.3946519539581534
6339,0.6874,2,4,2,607764,68680,81480,44776,0.5439741477632746,0.39465519672824706
6340,0.6875,55,142,55,607906,68538,81535,44721,0.5428494487390698,0.39485603793076046
6341,0.6876,3,4,3,607910,68534,81538,44718,0.5428177670764162,0.39485395401405715
6342,0.6877,10,19,10,607929,68515,81548,44708,0.5426672791788113,0.394866767352923
6343,0.6878,3,9,3,607938,68506,81551,44705,0.5425959954378405,0.3948821227619224
6344,0.6879,4,3,4,607941,68503,81555,44701,0.5425722341908503,0.3948712059644536
6345,0.688,21,39,21,607980,68464,81576,44680,0.5422633379799772,0.39489500106059533
6346,0.6881,1,3,1,607983,68461,81577,44679,0.542239576732987,0.3949001237404985
6347,0.6882,4,9,4,607992,68452,81581,44675,0.5421682929920162,0.3949101452350014
6348,0.6883,51,133,51,608125,68319,81632,44624,0.5411148777087822,0.39510195408303306
6349,0.6884,1,0,1,608125,68319,81633,44623,0.5411148777087822,0.3950965982539711
6350,0.6885,4,16,4,608141,68303,81637,44619,0.5409881510581676,0.395131152476931
6351,0.6886,2,6,2,608147,68297,81639,44617,0.540940628564187,0.39514143507448146
6352,0.6887,2,18,2,608165,68279,81641,44615,0.5407980610822456,0.3951937215441033
6353,0.6888,7,18,7,608183,68261,81648,44608,0.5406554936003042,0.39521923645996687
6354,0.6889,1,0,1,608183,68261,81649,44607,0.5406554936003042,0.3952138781585569
6355,0.689,11,28,11,608211,68233,81660,44596,0.5404337219617286,0.39525299346799136
6356,0.6891,1,3,1,608214,68230,81661,44595,0.5404099607147383,0.3952581431420341
6357,0.6892,22,71,22,608285,68159,81683,44573,0.5398476112026359,0.3953890643295604
6358,0.6893,10,43,10,608328,68116,81693,44563,0.5395070333291091,0.39548629292059745
6359,0.6894,2,5,2,608333,68111,81695,44561,0.539467431250792,0.39549311275205906
6360,0.6895,5,12,5,608345,68099,81700,44556,0.5393723862628311,0.39550841063423725
6361,0.6896,1,7,1,608352,68092,81701,44555,0.5393169433531871,0.39552762168544214
6362,0.6897,3,18,3,608370,68074,81704,44552,0.5391743758712457,0.3955747340756131
6363,0.6898,2,11,2,608381,68063,81706,44550,0.5390872512989482,0.3956026391269214
6364,0.6899,1,7,1,608388,68056,81707,44549,0.5390318083893043,0.395621864038009
6365,0.69,949,2122,949,610510,65934,82656,43600,0.5222246863515397,0.3980499205726076
6366,0.6901,1,8,1,610518,65926,82657,43599,0.5221613230262324,0.39807349920109564
6367,0.6902,8,14,8,610532,65912,82665,43591,0.5220504372069447,0.3980804178880944
6368,0.6903,4,8,4,610540,65904,82669,43587,0.5219870738816373,0.39808751404225007
6369,0.6904,3,4,3,610544,65900,82672,43584,0.5219553922189837,0.398085565014066
6370,0.6905,5,11,5,610555,65889,82677,43579,0.5218682676466861,0.39809807432308986
6371,0.6906,2,0,2,610555,65889,82679,43577,0.5218682676466861,0.3980870772660004
6372,0.6907,8,29,8,610584,65860,82687,43569,0.5216385755924471,0.39814857121969494
6373,0.6908,17,53,17,610637,65807,82704,43552,0.5212187935622862,0.39824797227480135
6374,0.6909,0,1,0,610638,65806,82704,43552,0.5212108731466227,0.398251613965142
6375,0.691,13,40,13,610678,65766,82717,43539,0.5208940565200861,0.3983257856456704
6376,0.6911,0,5,0,610683,65761,82717,43539,0.5208544544417691,0.3983440073193047
6377,0.6912,6,24,6,610707,65737,82723,43533,0.5206643644658472,0.39839846252402306
6378,0.6913,6,12,6,610719,65725,82729,43527,0.5205693194778862,0.39840918244059603
6379,0.6914,8,17,8,610736,65708,82737,43519,0.5204346724116081,0.3984271288234594
6380,0.6915,5,13,5,610749,65695,82742,43514,0.5203317070079838,0.3984470144402018
6381,0.6916,0,4,0,610753,65691,82742,43514,0.5203000253453302,0.3984616089006914
6382,0.6917,56,154,56,610907,65537,82798,43458,0.5190802813331644,0.39871553740997295
6383,0.6918,2,16,2,610923,65521,82800,43456,0.5189535546825498,0.39876304174275307
6384,0.6919,0,1,0,610924,65520,82800,43456,0.5189456342668863,0.3987667009249743
6385,0.692,16,45,16,610969,65475,82816,43440,0.5185892155620327,0.39884313455446907
6386,0.6921,4,5,4,610974,65470,82820,43436,0.5185496134837156,0.398839366058803
6387,0.6922,2,8,2,610982,65462,82822,43434,0.5184862501584083,0.39885762562444904
6388,0.6923,8,23,8,611005,65439,82830,43426,0.5183040805981498,0.3988977173563588
6389,0.6924,1,3,1,611008,65436,82831,43425,0.5182803193511596,0.3989031884696999
6390,0.6925,49,139,49,611147,65297,82880,43376,0.517179381573945,0.39914238127225715
6391,0.6926,1,7,1,611154,65290,82881,43375,0.5171239386643011,0.39916256384300375
6392,0.6927,10,25,10,611179,65265,82891,43365,0.5169259282727158,0.3991991162662248
6393,0.6928,3,14,3,611193,65251,82894,43362,0.5168150424534279,0.3992339775165035
6394,0.6929,6,7,6,611200,65244,82900,43356,0.516759599543784,0.3992265193370166
6395,0.693,12,33,12,611233,65211,82912,43344,0.5164982258268914,0.39928147022246785
6396,0.6931,1,4,1,611237,65207,82913,43343,0.5164665441642378,0.3992906494702902
6397,0.6932,6,19,6,611256,65188,82919,43337,0.5163160562666329,0.39932734392997005
6398,0.6933,115,310,115,611566,64878,83034,43222,0.5138607274109745,0.3998334875115634
6399,0.6934,2,4,2,611570,64874,83036,43220,0.5138290457483209,0.3998371787518271
6400,0.6935,5,19,5,611589,64855,83041,43215,0.513678557850716,0.3998797075969279
6401,0.6936,0,7,0,611596,64848,83041,43215,0.5136231149410722,0.3999056106160295
6402,0.6937,3,16,3,611612,64832,83044,43212,0.5134963882904575,0.39994816926437377
6403,0.6938,3,16,3,611628,64816,83047,43209,0.5133696616398429,0.39999074288359177
6404,0.6939,0,2,0,611630,64814,83047,43209,0.513353820808516,0.39999814854244004
6405,0.694,18,72,18,611702,64742,83065,43191,0.5127835508807502,0.4001649171245124
6406,0.6941,0,3,0,611705,64739,83065,43191,0.51275978963376,0.40017604002594276
6407,0.6942,22,70,22,611775,64669,83087,43169,0.512205360537321,0.4003134331126319
6408,0.6943,8,28,8,611803,64641,83095,43161,0.5119835888987454,0.4003729058830077
6409,0.6944,2,3,2,611806,64638,83097,43159,0.5119598276517552,0.4003729231796803
6410,0.6945,2,11,2,611817,64627,83099,43157,0.5118727030794576,0.40040265716618423
6411,0.6946,2,3,2,611820,64624,83101,43155,0.5118489418324673,0.400402675845944
6412,0.6947,2,16,2,611836,64608,83103,43153,0.5117222151818528,0.4004509980419632
6413,0.6948,6,17,6,611853,64591,83109,43147,0.5115875681155747,0.40048079600512354
6414,0.695,215,556,215,612409,64035,83324,42932,0.5071838170067166,0.40135742799181057
6415,0.6951,1,2,1,612411,64033,83325,42931,0.5071679761753897,0.40135933585131445
6416,0.6952,8,13,8,612424,64020,83333,42923,0.5070650107717654,0.40136334308930927
6417,0.6953,8,20,8,612444,64000,83341,42915,0.5069066024584971,0.40139363045409904
6418,0.6954,3,4,3,612448,63996,83344,42912,0.5068749207958434,0.40139185093725444
6419,0.6955,3,12,3,612460,63984,83347,42909,0.5067798758078824,0.4014201117004855
6420,0.6956,1,4,1,612464,63980,83348,42908,0.5067481941452288,0.4014295337175361
6421,0.6957,16,24,16,612488,63956,83364,42892,0.5065581041693068,0.40143006888289906
6422,0.6958,13,55,13,612543,63901,83377,42879,0.506122481307819,0.40156396328900545
6423,0.6959,0,4,0,612547,63897,83377,42879,0.5060907996451653,0.40157900651831874
6424,0.696,29,61,29,612608,63836,83406,42850,0.5056076542896971,0.4016459516712596
6425,0.6961,0,1,0,612609,63835,83406,42850,0.5055997338740337,0.4016497164549843
6426,0.6962,1,6,1,612615,63829,83407,42849,0.5055522113800532,0.4016666979133467
6427,0.6963,4,19,4,612634,63810,83411,42845,0.5054017234824484,0.40171581266701045
6428,0.6964,1,4,1,612638,63806,83412,42844,0.5053700418197947,0.40172526957337085
6429,0.6965,4,19,4,612657,63787,83416,42840,0.5052195539221899,0.4017744098586662
6430,0.6966,0,3,0,612660,63784,83416,42840,0.5051957926751995,0.4017857142857143
6431,0.6967,134,253,134,612913,63531,83550,42706,0.5031919275123559,0.40198800794450146
6432,0.6968,5,20,5,612933,63511,83555,42701,0.5030335191990876,0.40203555153843257
6433,0.6969,1,5,1,612938,63506,83556,42700,0.5029939171207705,0.4020488484643052
6434,0.697,5,16,5,612954,63490,83561,42695,0.5028671904701558,0.40208127324951737
6435,0.6971,2,12,2,612966,63478,83563,42693,0.502772145482195,0.4021154552561434
6436,0.6972,2,10,2,612976,63468,83565,42691,0.5026929413255607,0.4021420699139969
6437,0.6973,10,19,10,612995,63449,83575,42681,0.5025424534279559,0.40215773108451897
6438,0.6974,1,4,1,612999,63445,83576,42680,0.5025107717653022,0.4021672555948174
6439,0.6975,50,151,50,613150,63294,83626,42630,0.5013147890001267,0.40245836637589216
6440,0.6976,2,11,2,613161,63283,83628,42628,0.5012276644278292,0.40248888217465606
6441,0.6977,5,19,5,613180,63264,83633,42623,0.5010771765302243,0.40253288883432337
6442,0.6978,3,11,3,613191,63253,83636,42620,0.5009900519579268,0.40255778149292076
6443,0.6979,4,5,4,613196,63248,83640,42616,0.5009504498796097,0.4025542205093327
6444,0.698,10,52,10,613248,63196,83650,42606,0.5005385882651121,0.4026956012173683
6445,0.6981,2,4,2,613252,63192,83652,42604,0.5005069066024584,0.4026995349540625
6446,0.6982,7,23,7,613275,63169,83659,42597,0.5003247370421999,0.40274757483501317
6447,0.6983,45,136,45,613411,63033,83704,42552,0.49924756051197566,0.4030117914476488
6448,0.6984,1,1,1,613412,63032,83705,42551,0.4992396400963123,0.4030099542539992
6449,0.6985,5,10,5,613422,63022,83710,42546,0.4991604359396781,0.40301985450136407
6450,0.6986,4,13,4,613435,63009,83714,42542,0.4990574705360537,0.4030468683385283
6451,0.6987,3,14,3,613449,62995,83717,42539,0.49894658471676595,0.40308336649800064
6452,0.6988,1,8,1,613457,62987,83718,42538,0.49888322139145863,0.403108268182895
6453,0.6989,1,1,1,613458,62986,83719,42537,0.4988753009757952,0.40310643177316796
6454,0.699,7,22,7,613480,62964,83726,42530,0.4987010518312001,0.4031508900980151
6455,0.6991,1,0,1,613480,62964,83727,42529,0.4987010518312001,0.40314523238508715
6456,0.6992,17,53,17,613533,62911,83744,42512,0.49828126980103915,0.4032516623507204
6457,0.6993,8,37,8,613570,62874,83752,42504,0.4979882144214928,0.40334794738939816
6458,0.6994,3,3,3,613573,62871,83755,42501,0.4979644531745026,0.40334244391299395
6459,0.6995,2,16,2,613589,62855,83757,42499,0.49783772652388797,0.4033923723826338
6460,0.6996,3,2,3,613591,62853,83760,42496,0.49782188569256114,0.40338304112995854
6461,0.6997,3,23,3,613614,62830,83763,42493,0.4976397161323026,0.4034541363235001
6462,0.6998,4,17,4,613631,62813,83767,42489,0.4975050690660246,0.4034966097510019
6463,0.6999,2,4,2,613635,62809,83769,42487,0.49747338740337094,0.4035006078103632
6464,0.7,993,2037,993,615672,60772,84762,41494,0.4813395006969966,0.40574580016818884
6465,0.7001,3,0,3,615672,60772,84765,41491,0.4813395006969966,0.40572836705357757
6466,0.7002,4,22,4,615694,60750,84769,41487,0.4811652515524015,0.40579242348660466
6467,0.7003,2,14,2,615708,60736,84771,41485,0.48105436573311366,0.40583637413056023
6468,0.7004,0,11,0,615719,60725,84771,41485,0.48096724116081613,0.40588005087564816
6469,0.7005,5,12,5,615731,60713,84776,41480,0.48087219617285515,0.40589864276418147
6470,0.7006,2,0,2,615731,60713,84778,41478,0.48087219617285515,0.4058870154906009
6471,0.7007,9,21,9,615752,60692,84787,41469,0.48070586744392346,0.4059181096504537
6472,0.7008,12,46,12,615798,60646,84799,41457,0.48034152832340643,0.4060311646082877
6473,0.7009,0,4,0,615802,60642,84799,41457,0.48030984666075277,0.40604707195956863
6474,0.701,13,33,13,615835,60609,84812,41444,0.4800484729438601,0.40610271133626646
6475,0.7011,0,4,0,615839,60605,84812,41444,0.48001679128120645,0.4061186292859313
6476,0.7012,5,11,5,615850,60594,84817,41439,0.4799296667089089,0.40613330981153156
6477,0.7013,7,20,7,615870,60574,84824,41432,0.4797712583956406,0.4061721859498461
6478,0.7014,4,16,4,615886,60558,84828,41428,0.47964453174502597,0.406212617418077
6479,0.7015,5,23,5,615909,60535,84833,41423,0.47946236218476745,0.4062751328978599
6480,0.7016,1,0,1,615909,60535,84834,41422,0.47946236218476745,0.4062693096109144
6481,0.7017,61,140,61,616049,60395,84895,41361,0.4783535039918895,0.4064723456110696
6482,0.7018,5,12,5,616061,60383,84900,41356,0.47825845900392855,0.4064911194330591
6483,0.7019,1,3,1,616064,60380,84901,41355,0.4782346977569383,0.4064972723251585
6484,0.702,12,29,12,616093,60351,84913,41343,0.47800500570269927,0.40654315888843
6485,0.7021,0,9,0,616102,60342,84913,41343,0.47793372196172856,0.406579141466293
6486,0.7022,2,12,2,616114,60330,84915,41341,0.4778386769737676,0.4066154557346736
6487,0.7023,1,22,1,616136,60308,84916,41340,0.47766442782917246,0.40669762317015584
6488,0.7024,3,3,3,616139,60305,84919,41337,0.47764066658218224,0.4066921154640798
6489,0.7025,49,127,49,616266,60178,84968,41288,0.4766347737929287,0.40691463150217805
6490,0.7026,1,2,1,616268,60176,84969,41287,0.47661893296160185,0.40691680711195216
6491,0.7027,6,17,6,616285,60159,84975,41281,0.47648428589532377,0.4069499211356467
6492,0.7028,0,8,0,616293,60151,84975,41281,0.47642092257001645,0.40698201750926727
6493,0.7029,1,3,1,616296,60148,84976,41280,0.47639716132302623,0.4069882083842726
6494,0.703,9,28,9,616324,60120,84985,41271,0.47617538968445067,0.40704796283693817
6495,0.7031,1,7,1,616331,60113,84986,41270,0.47611994677480673,0.4070702188729866
6496,0.7032,2,14,2,616345,60099,84988,41268,0.4760090609555189,0.4071147414839149
6497,0.7033,119,266,119,616611,59833,85107,41149,0.4739022303890508,0.40748846329048743
6498,0.7034,0,2,0,616613,59831,85107,41149,0.473886389557724,0.4074965339671222
6499,0.7035,5,15,5,616628,59816,85112,41144,0.4737675833227728,0.4075277337559429
6500,0.7036,1,9,1,616637,59807,85113,41143,0.47369629958180204,0.40755819712729074
6501,0.7037,7,17,7,616654,59790,85120,41136,0.473561652515524,0.40758575590036267
6502,0.7038,5,16,5,616670,59774,85125,41131,0.4734349258649094,0.4076210296813835
6503,0.7039,1,1,1,616671,59773,85126,41130,0.473427005449246,0.4076191986363141
6504,0.704,20,60,20,616731,59713,85146,41110,0.47295178050944114,0.4077442647015066
6505,0.7041,1,5,1,616736,59708,85147,41109,0.47291217843112404,0.4077586121388258
6506,0.7042,28,59,28,616795,59649,85175,41081,0.47244487390698264,0.4078328204109997
6507,0.7043,6,24,6,616819,59625,85181,41075,0.4722547839310607,0.40789473684210525
6508,0.7044,1,1,1,616820,59624,85182,41074,0.4722468635153973,0.40789290750561086
6509,0.7045,0,9,0,616829,59615,85182,41074,0.47217557977442653,0.4079293666636872
6510,0.7046,6,4,6,616833,59611,85188,41068,0.47214389811177293,0.4079102891367614
6511,0.7047,9,21,9,616854,59590,85197,41059,0.4719775693828412,0.4079424534769347
6512,0.7048,1,18,1,616872,59572,85198,41058,0.4718350019008998,0.4080095398986386
6513,0.7049,1,7,1,616879,59565,85199,41057,0.47177955899125584,0.40803204070680366
6514,0.705,222,497,222,617376,59068,85421,40835,0.4678431124065391,0.4087464840895669
6515,0.7051,2,14,2,617390,59054,85423,40833,0.4677322265872513,0.4087919348864217
6516,0.7052,3,16,3,617406,59038,85426,40830,0.4676054999366367,0.4088396683622382
6517,0.7053,6,14,6,617420,59024,85432,40824,0.4674946141173489,0.40886146943353896
6518,0.7054,1,3,1,617423,59021,85433,40823,0.4674708528703586,0.40886783382076036
6519,0.7055,6,19,6,617442,59002,85439,40817,0.46732036497275375,0.40891012733046816
6520,0.7056,2,2,2,617444,59000,85441,40815,0.4673045241414269,0.4089064769824175
6521,0.7057,13,23,13,617467,58977,85454,40802,0.4671223545811684,0.4089237214243478
6522,0.7058,19,54,19,617521,58923,85473,40783,0.46669465213534406,0.40903255571379854
6523,0.7059,0,2,0,617523,58921,85473,40783,0.4666788113040172,0.4090407606515285
6524,0.706,20,52,20,617575,58869,85493,40763,0.4662669496895197,0.4091356190782078
6525,0.7061,1,8,1,617583,58861,85494,40762,0.4662035863642124,0.4091625427863044
6526,0.7062,1,7,1,617590,58854,85495,40761,0.4661481434545685,0.4091853636500527
6527,0.7063,1,19,1,617609,58835,85496,40760,0.46599765555696365,0.4092574928460264
6528,0.7064,0,5,0,617614,58830,85496,40760,0.46595805347864655,0.4092780399638518
6529,0.7065,4,10,4,617624,58820,85500,40756,0.4658788493220124,0.40929541254920865
6530,0.7066,0,7,0,617631,58813,85500,40756,0.4658234064123685,0.40932418724703473
6531,0.7067,128,244,128,617875,58569,85628,40628,0.4638908249904955,0.4095688377672712
6532,0.7068,0,16,0,617891,58553,85628,40628,0.46376409833988086,0.40963490991218077
6533,0.7069,1,4,1,617895,58549,85629,40627,0.4637324166772272,0.4096454787448576
6534,0.707,9,22,9,617917,58527,85638,40618,0.4635581675326321,0.40968278783599776
6535,0.7071,5,7,5,617924,58520,85643,40613,0.4635027246229882,0.4096819424409632
6536,0.7072,3,21,3,617945,58499,85646,40610,0.4633363958940565,0.4097508803438638
6537,0.7073,10,22,10,617967,58477,85656,40600,0.46316214674946143,0.4097822905416999
6538,0.7074,0,5,0,617972,58472,85656,40600,0.46312254467114433,0.4098029715762274
6539,0.7075,57,149,57,618121,58323,85713,40543,0.46194240273729564,0.4100803107236057
6540,0.7076,1,7,1,618128,58316,85714,40542,0.46188695982765177,0.4101033806065265
6541,0.7077,7,14,7,618142,58302,85721,40535,0.46177607400836396,0.41011969201817133
6542,0.7078,6,11,6,618153,58291,85727,40529,0.4616889494360664,0.41012952843553935
6543,0.7079,0,6,0,618159,58285,85727,40529,0.46164142694208593,0.41015443155828124
6544,0.708,19,40,19,618199,58245,85746,40510,0.46132461031554933,0.4102070781226267
6545,0.7081,3,3,3,618202,58242,85749,40507,0.4613008490685591,0.4102016222949093
6546,0.7082,3,17,3,618219,58225,85752,40504,0.4611662020022811,0.4102543325669256
6547,0.7083,55,140,55,618359,58085,85807,40449,0.4600573438094031,0.4105080479834372
6548,0.7084,1,2,1,618361,58083,85808,40448,0.4600415029780763,0.41051039774284237
6549,0.7085,11,16,11,618377,58067,85819,40437,0.45991477632746164,0.4105112482741818
6550,0.7086,4,9,4,618386,58058,85823,40433,0.45984349258649093,0.41052481952665726
6551,0.7087,5,15,5,618401,58043,85828,40428,0.45972468635153974,0.4105574229976338
6552,0.7088,4,8,4,618409,58035,85832,40424,0.4596613230262324,0.41056683492621293
6553,0.7089,1,0,1,618409,58035,85833,40423,0.4596613230262324,0.41056084828048506
6554,0.709,11,21,11,618430,58014,85844,40412,0.45949499429730073,0.4105825696462317
6555,0.7091,0,4,0,618434,58010,85844,40412,0.45946331263464707,0.41059925626384347
6556,0.7092,14,43,14,618477,57967,85858,40398,0.45912273476112025,0.4106948609769735
6557,0.7093,7,24,7,618501,57943,85865,40391,0.45893264478519835,0.41075314743628855
6558,0.7094,0,8,0,618509,57935,85865,40391,0.45886928145989103,0.41078656713382017
6559,0.7095,1,11,1,618520,57924,85866,40390,0.45878215688759344,0.4108265353866184
6560,0.7096,2,10,2,618530,57914,85868,40388,0.45870295273095935,0.4108563406644829
6561,0.7097,2,15,2,618545,57899,85870,40386,0.4585841464960081,0.4109070560105815
6562,0.7098,8,14,8,618559,57885,85878,40378,0.45847326067672034,0.410917639396314
6563,0.7099,1,3,1,618562,57882,85879,40377,0.45844949942973007,0.41092419015052056
6564,0.71,1025,1907,1025,620469,55975,86904,39352,0.44334526675959957,0.41281064126637784
6565,0.7101,0,8,0,620477,55967,86904,39352,0.44328190343429225,0.41284528792790526
6566,0.7102,4,11,4,620488,55956,86908,39348,0.44319477886199465,0.4128682951397633
6567,0.7103,10,10,10,620498,55946,86918,39338,0.44311557470536056,0.4128500062969649
6568,0.7104,1,3,1,620501,55943,86919,39337,0.4430918134583703,0.4128568429890848
6569,0.7105,6,19,6,620520,55924,86925,39331,0.44294132556076543,0.4129022098577502
6570,0.7106,1,5,1,620525,55919,86926,39330,0.4429017234824484,0.4129177209209545
6571,0.7107,4,28,4,620553,55891,86930,39326,0.44267995184387277,0.4130144827079198
6572,0.7108,26,38,26,620591,55853,86956,39300,0.44237897604866305,0.4130190325055437
6573,0.7109,1,3,1,620594,55850,86957,39299,0.4423552148016728,0.4130258857160874
6574,0.711,17,37,17,620631,55813,86974,39282,0.44206215942212645,0.41308165518691836
6575,0.7111,0,10,0,620641,55803,86974,39282,0.4419829552654923,0.41312509859599306
6576,0.7112,3,5,3,620646,55798,86977,39279,0.44194335318717526,0.4131283065304963
6577,0.7113,7,26,7,620672,55772,86984,39272,0.4417374223799265,0.4131980977231598
6578,0.7114,1,5,1,620677,55767,86985,39271,0.4416978203016094,0.4132136619036596
6579,0.7115,8,20,8,620697,55747,86993,39263,0.4415394119883411,0.41325123671192504
6580,0.7116,0,4,0,620701,55743,86993,39263,0.4415077303256875,0.4132686356651159
6581,0.7117,40,140,40,620841,55603,87033,39223,0.44039887213280954,0.41363128255963555
6582,0.7118,4,19,4,620860,55584,87037,39219,0.4402483842352047,0.41368944020758835
6583,0.7119,2,4,2,620864,55580,87039,39217,0.440216702572551,0.41369452619808644
6584,0.712,11,30,11,620894,55550,87050,39206,0.4399790901026486,0.41375744016210053
6585,0.7121,0,3,0,620897,55547,87050,39206,0.43995532885565836,0.4137705402467468
6586,0.7122,8,19,8,620916,55528,87058,39198,0.4398048409580535,0.4138040242383295
6587,0.7123,7,17,7,620933,55511,87065,39191,0.4396701938917754,0.4138349770860172
6588,0.7124,4,6,4,620939,55505,87069,39187,0.43962267139779493,0.4138364381362734
6589,0.7125,61,117,61,621056,55388,87130,39126,0.4386959827651755,0.41397041708106735
6590,0.7126,0,4,0,621060,55384,87130,39126,0.43866430110252186,0.41398793778436144
6591,0.7127,6,22,6,621082,55362,87136,39120,0.43849005195792673,0.4140471200863657
6592,0.7128,2,8,2,621090,55354,87138,39118,0.43842668863261947,0.41406977728850874
6593,0.7129,2,5,2,621095,55349,87140,39116,0.43838708655430236,0.4140792886254168
6594,0.713,6,25,6,621120,55324,87146,39110,0.438189076162717,0.4141516826566703
6595,0.7131,3,5,3,621125,55319,87149,39107,0.43814947408439997,0.4141549996822909
6596,0.7132,4,13,4,621138,55306,87153,39103,0.43804650868077555,0.4141872067281721
6597,0.7133,113,228,113,621366,55078,87266,38990,0.43624065390951716,0.4144873920993324
6598,0.7134,1,6,1,621372,55072,87267,38989,0.4361931314155367,0.41450760676582216
6599,0.7135,2,13,2,621385,55059,87269,38987,0.4360901660119123,0.414552453054888
6600,0.7136,2,6,2,621391,55053,87271,38985,0.4360426435179318,0.41456645185988644
6601,0.7137,5,16,5,621407,55037,87276,38980,0.4359159168673172,0.4146058691513237
6602,0.7138,7,19,7,621426,55018,87283,38973,0.4357654289697123,0.41464608313561935
6603,0.7139,0,2,0,621428,55016,87283,38973,0.4357495881383855,0.41465490642521996
6604,0.714,26,59,26,621487,54957,87309,38947,0.4352822836142441,0.41475336513886524
6605,0.7141,0,2,0,621489,54955,87309,38947,0.43526644278291726,0.4147621988882026
6606,0.7142,26,43,26,621532,54912,87335,38921,0.43492586490939045,0.41479010582630843
6607,0.7143,5,33,5,621565,54879,87340,38916,0.4346644911924978,0.41490484567407643
6608,0.7144,0,5,0,621570,54874,87340,38916,0.43462488911418073,0.4149269644951487
6609,0.7145,2,17,2,621587,54857,87342,38914,0.43449024204790265,0.414989708971857
6610,0.7146,1,5,1,621592,54852,87343,38913,0.4344506399695856,0.41500559910414336
6611,0.7147,4,28,4,621620,54824,87347,38909,0.43422886833101,0.41510460563515517
6612,0.7148,2,16,2,621636,54808,87349,38907,0.4341021416803954,0.41516299418449554
6613,0.7149,0,2,0,621638,54806,87349,38907,0.4340863008490686,0.41517185449190613
6614,0.715,237,485,237,622123,54321,87586,38670,0.43024489925231274,0.41584669484143627
6615,0.7151,0,1,0,622124,54320,87586,38670,0.43023697883664935,0.4158511667921282
6616,0.7152,4,18,4,622142,54302,87590,38666,0.4300944113547079,0.41590654848980296
6617,0.7153,3,13,3,622155,54289,87593,38663,0.4299914459510835,0.4159458645322317
6618,0.7154,0,2,0,622157,54287,87593,38663,0.4299756051197567,0.4159548144163529
6619,0.7155,7,13,7,622170,54274,87600,38656,0.4298726397161323,0.4159690089314538
6620,0.7156,3,5,3,622175,54269,87603,38653,0.4298330376378152,0.4159725361055509
6621,0.7157,8,25,8,622200,54244,87611,38645,0.4296350272462299,0.4160341913466611
6622,0.7158,18,56,18,622256,54188,87629,38627,0.4291914839690787,0.416171954964176
6623,0.7159,0,11,0,622267,54177,87629,38627,0.42910435939678115,0.4162212835653636
6624,0.716,17,61,17,622328,54116,87646,38610,0.42862121404131287,0.41638806807152257
6625,0.7161,0,3,0,622331,54113,87646,38610,0.42859745279432265,0.416401540070964
6626,0.7162,5,10,5,622341,54103,87651,38605,0.4285182486376885,0.41641498036846875
6627,0.7163,5,16,5,622357,54087,87656,38600,0.42839152198707386,0.41645538209241856
6628,0.7164,4,3,4,622360,54084,87660,38596,0.42836776074008365,0.4164436771687527
6629,0.7165,9,15,9,622375,54069,87669,38587,0.42824895450513245,0.41645441201864963
6630,0.7166,0,6,0,622381,54063,87669,38587,0.42820143201115196,0.41648138154344305
6631,0.7167,118,275,118,622656,53788,87787,38469,0.4260233177037131,0.4169764895888659
6632,0.7168,6,12,6,622668,53776,87793,38463,0.4259282727157521,0.4169928121510424
6633,0.7169,0,2,0,622670,53774,87793,38463,0.4259124318844253,0.41700185391979355
6634,0.717,9,19,9,622689,53755,87802,38454,0.42576194398682043,0.41703087551106727
6635,0.7171,1,10,1,622699,53745,87803,38453,0.4256827398301863,0.4170697845940259
6636,0.7172,4,17,4,622716,53728,87807,38449,0.42554809276390826,0.41712140772643935
6637,0.7173,11,24,11,622740,53704,87818,38438,0.4253580027879863,0.41716046970979576
6638,0.7174,5,5,5,622745,53699,87823,38433,0.42531840070966925,0.4171514783137238
6639,0.7175,55,147,55,622892,53552,87878,38378,0.4241540996071474,0.4174698139889046
6640,0.7176,0,7,0,622899,53545,87878,38378,0.42409865669750346,0.4175016046038532
6641,0.7177,1,14,1,622913,53531,87879,38377,0.4239877708782157,0.41755886321103713
6642,0.7178,1,9,1,622922,53522,87880,38376,0.42391648713724495,0.4175934187903981
6643,0.7179,5,2,5,622924,53520,87885,38371,0.4239006463059181,0.41757081759911197
6644,0.718,12,55,12,622979,53465,87897,38359,0.4234650234444304,0.4177448161700645
6645,0.7181,0,1,0,622980,53464,87897,38359,0.42345710302876693,0.41774936562734827
6646,0.7182,2,17,2,622997,53447,87899,38357,0.4233224559624889,0.4178140386039824
6647,0.7183,51,122,51,623119,53325,87950,38306,0.4223561652515524,0.4180462943763573
6648,0.7184,1,1,1,623120,53324,87951,38305,0.422348244835889,0.4180445055604667
6649,0.7185,6,21,6,623141,53303,87957,38299,0.42218191610695727,0.41810222484225235
6650,0.7186,2,7,2,623148,53296,87959,38297,0.4221264731973134,0.4181214721649034
6651,0.7187,4,18,4,623166,53278,87963,38293,0.4219839057153719,0.41817824420395106
6652,0.7188,5,13,5,623179,53265,87968,38288,0.42188094031174755,0.4182058479787664
6653,0.719,14,25,14,623204,53240,87982,38274,0.4216829299201622,0.4182310903249776
6654,0.7191,4,3,4,623207,53237,87986,38270,0.421659168673172,0.41821937119564623
6655,0.7192,19,57,19,623264,53180,88005,38251,0.42120770498035737,0.4183591998337544
6656,0.7193,10,32,10,623296,53148,88015,38241,0.42095425167912814,0.4184420444473624
6657,0.7194,0,2,0,623298,53146,88015,38241,0.4209384108478013,0.41845120203092345
6658,0.7195,4,10,4,623308,53136,88019,38237,0.42085920669116716,0.4184715397327438
6659,0.7196,2,5,2,623313,53131,88021,38235,0.42081960461285006,0.4184817109209115
6660,0.7197,5,10,5,623323,53121,88026,38230,0.42074040045621597,0.41849569243905377
6661,0.7198,4,10,4,623333,53111,88030,38226,0.4206611962995818,0.4185160449762966
6662,0.7199,2,9,2,623342,53102,88032,38224,0.42058991255861106,0.418544554672273
6663,0.72,991,1873,991,625215,51229,89023,37233,0.4057549740210366,0.420892586647374
6664,0.7202,6,19,6,625234,51210,89029,37227,0.40560448612343175,0.42094372265002206
6665,0.7203,5,15,5,625249,51195,89034,37222,0.40548567988848055,0.42098239026431566
6666,0.7204,0,3,0,625252,51192,89034,37222,0.4054619186414903,0.42099667473477054
6667,0.7205,4,20,4,625272,51172,89038,37218,0.40530351032822204,0.4210657314175812
6668,0.7206,1,7,1,625279,51165,89039,37217,0.4052480674185781,0.42109253015319864
6669,0.7207,4,27,4,625306,51138,89043,37213,0.40503421619566593,0.42119500628176254
6670,0.7208,9,57,9,625363,51081,89052,37204,0.40458275250285136,0.4214079401936909
6671,0.7209,0,2,0,625365,51079,89052,37204,0.40456691167152453,0.42141748694539155
6672,0.721,11,30,11,625395,51049,89063,37193,0.4043292992016221,0.42148863353051835
6673,0.7211,2,3,2,625398,51046,89065,37191,0.40430553795463187,0.4214898511962102
6674,0.7212,3,11,3,625409,51035,89068,37188,0.40421841338233433,0.42152273216734865
6675,0.7213,6,18,6,625427,51017,89074,37182,0.40407584590039286,0.4215694055488157
6676,0.7214,0,8,0,625435,51009,89074,37182,0.40401248257508554,0.4216076470388135
6677,0.7215,9,7,9,625442,51002,89083,37173,0.40395703966544166,0.42158208108874395
6678,0.7216,3,12,3,625454,50990,89086,37170,0.4038619946774807,0.4216197822141561
6679,0.7217,61,119,61,625573,50871,89147,37109,0.4029194652135344,0.4217890429643101
6680,0.7218,4,10,4,625583,50861,89151,37105,0.40284026105690024,0.4218106995884774
6681,0.7219,1,6,1,625589,50855,89152,37104,0.4027927385629198,0.4218328994190475
6682,0.722,17,21,17,625610,50834,89169,37087,0.40262640983398806,0.4218218628086578
6683,0.7221,1,1,1,625611,50833,89170,37086,0.4026184894183247,0.4218200843958644
6684,0.7222,3,15,3,625626,50818,89173,37083,0.4024996831833735,0.42187233364808135
6685,0.7223,8,17,8,625643,50801,89181,37075,0.4023650361170954,0.42190131549000864
6686,0.7224,1,2,1,625645,50799,89182,37074,0.4023491952857686,0.4219043392168243
6687,0.7225,56,143,56,625788,50656,89238,37018,0.40121657584590037,0.4222232360791113
6688,0.7226,0,2,0,625790,50654,89238,37018,0.40120073501457354,0.42223286796240533
6689,0.7227,9,24,9,625814,50630,89247,37009,0.40101064503865164,0.4222891635002681
6690,0.7228,5,7,5,625821,50623,89252,37004,0.4009552021290077,0.42228993346799504
6691,0.7229,3,11,3,625832,50612,89255,37001,0.40086807755671017,0.422323171218883
6692,0.723,6,29,6,625861,50583,89261,36995,0.40063838550247116,0.4224234396766311
6693,0.7231,1,0,1,625861,50583,89262,36994,0.40063838550247116,0.42241684460531875
6694,0.7232,5,7,5,625868,50576,89267,36989,0.4005829425928273,0.42241763261577114
6695,0.7233,110,215,110,626083,50361,89377,36879,0.39888005322519327,0.42273039889958736
6696,0.7234,0,4,0,626087,50357,89377,36879,0.3988483715625396,0.4227497822000092
6697,0.7235,8,19,8,626106,50338,89385,36871,0.39869788366493475,0.42278893233496545
6698,0.7236,0,10,0,626116,50328,89385,36871,0.3986186795083006,0.42283741786029655
6699,0.7237,4,12,4,626128,50316,89389,36867,0.3985236345203396,0.4228691373318193
6700,0.7238,7,10,7,626138,50306,89396,36860,0.39844443036370547,0.42287130303099835
6701,0.7239,1,1,1,626139,50305,89397,36859,0.3984365099480421,0.4228695332935616
6702,0.724,25,47,25,626186,50258,89422,36834,0.3980642504118616,0.4229320718320856
6703,0.7241,0,4,0,626190,50254,89422,36834,0.39803256874920795,0.42295149733602794
6704,0.7242,20,47,20,626237,50207,89442,36814,0.3976603092130275,0.4230473104193241
6705,0.7243,10,22,10,626259,50185,89452,36804,0.3974860600684324,0.4230879766407247
6706,0.7244,2,2,2,626261,50183,89454,36802,0.39747021923710557,0.42308443984595046
6707,0.7245,7,22,7,626283,50161,89461,36795,0.39729597009251044,0.42314503887023325
6708,0.7246,1,3,1,626286,50158,89462,36794,0.3972722088455202,0.4231530039562057
6709,0.7247,2,28,2,626314,50130,89464,36792,0.3970504372069446,0.42327604058811347
6710,0.7248,4,8,4,626322,50122,89468,36788,0.3969870738816373,0.4232884593257393
6711,0.7249,0,2,0,626324,50120,89468,36788,0.39697123305031046,0.4232982003958209
6712,0.725,228,432,228,626756,49688,89696,36560,0.39354961348371564,0.4238938873944903
6713,0.7251,0,1,0,626757,49687,89696,36560,0.3935416930680522,0.42389880227718063
6714,0.7252,0,5,0,626762,49682,89696,36560,0.39350209098973515,0.4239233784003154
6715,0.7253,4,18,4,626780,49664,89700,36556,0.3933595235077937,0.423985154256553
6716,0.7254,0,7,0,626787,49657,89700,36556,0.3933040805981498,0.4240195794137775
6717,0.7255,4,13,4,626800,49644,89704,36552,0.3932011151945254,0.42405680077961855
6718,0.7256,3,3,3,626803,49641,89707,36549,0.39317735394753517,0.42405151409676295
6719,0.7257,7,22,7,626825,49619,89714,36542,0.39300310480294004,0.42411299776000744
6720,0.7258,13,39,13,626864,49580,89727,36529,0.3926942085920669,0.42421814212219394
6721,0.7259,1,1,1,626865,49579,89728,36528,0.3926862881764035,0.424216381943396
6722,0.726,22,60,22,626925,49519,89750,36506,0.39221106323659866,0.4243650101714618
6723,0.7261,1,7,1,626932,49512,89751,36505,0.3921556203269548,0.4243928525756536
6724,0.7262,7,19,7,626951,49493,89758,36498,0.39200513242934987,0.42443976695235547
6725,0.7263,3,20,3,626971,49473,89761,36495,0.3918467241160816,0.4245184254606365
6726,0.7264,2,10,2,626981,49463,89763,36493,0.3917675199594475,0.42455442319326164
6727,0.7265,2,13,2,626994,49450,89765,36491,0.3916645545558231,0.42460525244062786
6728,0.7266,0,2,0,626996,49448,89765,36491,0.3916487137244963,0.4246151339903885
6729,0.7267,126,246,126,627242,49202,89891,36365,0.3897002914712964,0.4249886054203139
6730,0.7268,5,8,5,627250,49194,89896,36360,0.3896369281459891,0.4249947401641069
6731,0.7269,1,8,1,627258,49186,89897,36359,0.3895735648206818,0.4250277631655854
6732,0.727,9,13,9,627271,49173,89906,36350,0.3894705994170574,0.42503186277375676
6733,0.7271,2,4,2,627275,49169,89908,36348,0.38943891775440376,0.42503829647906266
6734,0.7272,2,17,2,627292,49152,89910,36346,0.38930427068812573,0.4251093592832581
6735,0.7273,6,28,6,627320,49124,89916,36340,0.3890824990495501,0.42520827482916784
6736,0.7274,0,2,0,627322,49122,89916,36340,0.3890666582182233,0.4252182256441459
6737,0.7275,55,124,55,627446,48998,89971,36285,0.38808452667595994,0.425465802094204
6738,0.7276,0,2,0,627448,48996,89971,36285,0.3880686858446331,0.425475780068245
6739,0.7277,7,20,7,627468,48976,89978,36278,0.38791027753136487,0.4255284209538555
6740,0.7278,2,12,2,627480,48964,89980,36276,0.3878152325434039,0.4255748474894416
6741,0.7279,1,5,1,627485,48959,89981,36275,0.3877756304650868,0.42559307318675643
6742,0.728,22,31,22,627516,48928,90003,36253,0.38753009757952095,0.4255996055458377
6743,0.7281,1,2,1,627518,48926,90004,36252,0.3875142567481941,0.4256028551973514
6744,0.7282,2,10,2,627528,48916,90006,36250,0.38743505259156,0.4256393396425804
6745,0.7283,66,114,66,627642,48802,90072,36184,0.38653212520593083,0.4257642435224625
6746,0.7284,0,3,0,627645,48799,90072,36184,0.38650836395894056,0.42577927350175915
6747,0.7285,3,12,3,627657,48787,90075,36181,0.3864133189709796,0.4258191319084832
6748,0.7286,2,5,2,627662,48782,90077,36179,0.38637371689266253,0.4258306752509975
6749,0.7287,8,8,8,627670,48774,90085,36171,0.3863103535673552,0.4258167049267173
6750,0.7288,4,10,4,627680,48764,90089,36167,0.38623114941072106,0.4258397993665446
6751,0.7289,5,7,5,627687,48757,90094,36162,0.3861757065010772,0.42584109563230843
6752,0.729,13,30,13,627717,48727,90107,36149,0.38593809403117474,0.4259036712380414
6753,0.7291,2,5,2,627722,48722,90109,36147,0.3858984919528577,0.4259152340666203
6754,0.7292,19,62,19,627784,48660,90128,36128,0.385407426181726,0.42609803274048214
6755,0.7293,8,21,8,627805,48639,90136,36120,0.38524109745279433,0.42614943545818146
6756,0.7294,4,2,4,627807,48637,90140,36116,0.3852252566214675,0.42613240829233184
6757,0.7295,4,13,4,627820,48624,90144,36112,0.38512229121784314,0.42617069486404835
6758,0.7296,0,7,0,627827,48617,90144,36112,0.3850668483081992,0.42620590352771776
6759,0.7297,4,6,4,627833,48611,90148,36108,0.3850193258142187,0.42620899680118984
6760,0.7298,4,18,4,627851,48593,90152,36104,0.3848767583322773,0.4262724771833713
6761,0.7299,0,1,0,627852,48592,90152,36104,0.38486883791661386,0.4262775101539624
6762,0.73,987,1829,987,629681,46763,91139,35117,0.3703823976682296,0.4288837322911578
6763,0.7301,2,5,2,629686,46758,91141,35115,0.37034279558991257,0.4288959730314023
6764,0.7302,3,7,3,629693,46751,91144,35112,0.37028735268026863,0.4289117183587213
6765,0.7303,4,17,4,629710,46734,91148,35108,0.3701527056139906,0.42897289900051316
6766,0.7304,0,6,0,629716,46728,91148,35108,0.3701051831200101,0.4290043501637421
6767,0.7305,10,11,10,629727,46717,91158,35098,0.3700180585477126,0.42899223858705615
6768,0.7306,1,1,1,629728,46716,91159,35097,0.3700101381320492,0.4289905027318397
6769,0.7307,7,29,7,629757,46687,91166,35090,0.3697804460778102,0.42909375496777824
6770,0.7308,11,41,11,629798,46646,91177,35079,0.3694557090356102,0.4292321810951361
6771,0.7309,1,0,1,629798,46646,91178,35078,0.3694557090356102,0.4292251970045519
6772,0.731,17,20,17,629818,46626,91195,35061,0.3692973007223419,0.4292115024422491
6773,0.7311,0,4,0,629822,46622,91195,35061,0.36926561905968824,0.42923252084277025
6774,0.7312,4,11,4,629833,46611,91199,35057,0.3691784944873907,0.4292623793897242
6775,0.7313,4,18,4,629851,46593,91203,35053,0.36903592700544924,0.4293290546995566
6776,0.7314,2,6,2,629857,46587,91205,35051,0.36898840451146875,0.42934662779587934
6777,0.7315,2,8,2,629865,46579,91207,35049,0.36892504118616143,0.4293747243592885
6778,0.7317,53,116,53,629981,46463,91260,34996,0.3680062729692054,0.42961489829239247
6779,0.7318,2,10,2,629991,46453,91262,34994,0.36792706881257126,0.4296536397902931
6780,0.7319,1,17,1,630008,46436,91263,34993,0.36779242174629323,0.42973633472104533
6781,0.732,13,34,13,630042,46402,91276,34980,0.3675231276137372,0.42982477697771004
6782,0.7321,4,2,4,630044,46400,91280,34976,0.36750728678241035,0.4298073141958317
6783,0.7322,4,7,4,630051,46393,91284,34972,0.36745184387276647,0.42981626006268053
6784,0.7323,5,12,5,630063,46381,91289,34967,0.3673567988848055,0.42984461818360625
6785,0.7324,1,3,1,630066,46378,91290,34966,0.3673330376378152,0.42985346184107004
6786,0.7325,61,113,61,630179,46265,91351,34905,0.36643803066784947,0.4300234076629297
6787,0.7326,1,1,1,630180,46264,91352,34904,0.366430110252186,0.4300216834220382
6788,0.7327,12,21,12,630201,46243,91364,34892,0.36626378152325434,0.43004868429161275
6789,0.7328,3,3,3,630204,46240,91367,34889,0.3662400202762641,0.43004351095169424
6790,0.7329,2,8,2,630212,46232,91369,34887,0.3661766569509568,0.4300718697222599
6791,0.733,8,12,8,630224,46220,91377,34879,0.3660816119629958,0.43007928581116905
6792,0.7331,1,5,1,630229,46215,91378,34878,0.3660420098846787,0.4300987754800044
6793,0.7332,3,13,3,630242,46202,91381,34875,0.36593904448105435,0.43014665071475267
6794,0.7333,112,214,112,630456,45988,91493,34763,0.3642440755290838,0.43049621676511746
6795,0.7334,2,6,2,630462,45982,91495,34761,0.3641965530351033,0.4305141002935239
6796,0.7335,5,11,5,630473,45971,91500,34756,0.36410942846280575,0.43053749055458523
6797,0.7336,3,5,3,630478,45966,91503,34753,0.36406982638448865,0.43054299483393005
6798,0.7337,4,21,4,630499,45945,91507,34749,0.36390349765555696,0.4306268124024091
6799,0.7338,4,17,4,630516,45928,91511,34745,0.36376885058927894,0.4306893260446494
6800,0.7339,1,3,1,630519,45925,91512,34744,0.36374508934228866,0.4306982855867805
6801,0.734,15,49,15,630568,45876,91527,34729,0.3633569889747814,0.43085416537435645
6802,0.7341,2,5,2,630573,45871,91529,34727,0.3633173868964643,0.4308667708876151
6803,0.7342,19,63,19,630636,45808,91548,34708,0.36281840070966925,0.4310696010730786
6804,0.7343,9,17,9,630653,45791,91557,34699,0.3626837536433912,0.43109703068704186
6805,0.7344,0,4,0,630657,45787,91557,34699,0.36265207198073757,0.431118455383545
6806,0.7345,4,16,4,630673,45771,91561,34695,0.36252534533012293,0.43117590038028486
6807,0.7346,5,3,5,630676,45768,91566,34690,0.36250158408313266,0.43115662830296553
6808,0.7347,1,17,1,630693,45751,91567,34689,0.36236693701685463,0.4312406762804575
6809,0.7348,2,13,2,630706,45738,91569,34687,0.36226397161323026,0.43129623873173767
6810,0.7349,0,1,0,630707,45737,91569,34687,0.3622560511975669,0.4313016015119865
6811,0.735,195,431,195,631138,45306,91764,34492,0.3588423520466354,0.4322414095591368
6812,0.7351,1,5,1,631143,45301,91765,34491,0.35880274996831835,0.432261379586926
6813,0.7352,1,16,1,631159,45285,91766,34490,0.3586760233177037,0.43234095894703856
6814,0.7353,9,10,9,631169,45275,91775,34481,0.35859681916106956,0.4323311098851497
6815,0.7354,1,2,1,631171,45273,91776,34480,0.35858097832974273,0.4323348337993555
6816,0.7355,1,11,1,631182,45262,91777,34479,0.3584938537574452,0.43238735405876527
6817,0.7356,0,2,0,631184,45260,91777,34479,0.35847801292611836,0.43239819912464417
6818,0.7357,6,22,6,631206,45238,91783,34473,0.35830376378152323,0.43247481527016346
6819,0.7358,15,44,15,631250,45194,91798,34458,0.35795526549233303,0.43260683975292524
6820,0.7359,1,3,1,631253,45191,91799,34457,0.3579315042453428,0.4326160104459622
6821,0.736,16,50,16,631303,45141,91815,34441,0.3575354834621721,0.4327737428061622
6822,0.7361,2,7,2,631310,45134,91817,34439,0.3574800405525282,0.4327975569602755
6823,0.7362,5,13,5,631323,45121,91822,34434,0.3573770751489038,0.4328326315127899
6824,0.7363,2,10,2,631333,45111,91824,34432,0.3572978709922697,0.4328727857888186
6825,0.7364,1,6,1,631339,45105,91825,34431,0.3572503484982892,0.4328983101991551
6826,0.7365,5,17,5,631356,45088,91830,34426,0.35711570143201116,0.43295520285735845
6827,0.7366,0,2,0,631358,45086,91830,34426,0.3570998606006843,0.4329660931683268
6828,0.7367,123,257,123,631615,44829,91953,34303,0.35506431377518693,0.43349087600465047
6829,0.7368,4,13,4,631628,44816,91957,34299,0.3549613483715625,0.43353346394489034
6830,0.7369,2,6,2,631634,44810,91959,34297,0.3549138258775821,0.4335520244731819
6831,0.737,4,11,4,631645,44799,91963,34293,0.3548267013052845,0.4335836747079351
6832,0.7371,1,4,1,631649,44795,91964,34292,0.3547950196426308,0.43359844222185695
6833,0.7372,1,7,1,631656,44788,91965,34291,0.35473957673298695,0.4336296614777627
6834,0.7373,5,24,5,631680,44764,91970,34286,0.354549486757065,0.4337254901960784
6835,0.7374,0,3,0,631683,44761,91970,34286,0.3545257255100748,0.43374195099118246
6836,0.7375,51,103,51,631786,44658,92021,34235,0.3537099226967431,0.4339421748444095
6837,0.7376,0,2,0,631788,44656,92021,34235,0.3536940818654163,0.4339531759009266
6838,0.7377,6,19,6,631807,44637,92027,34229,0.35354359396781143,0.43401465777394566
6839,0.7378,4,18,4,631825,44619,92031,34225,0.35340102648586996,0.4340850286641977
6840,0.7379,3,2,3,631827,44617,92034,34222,0.35338518565454313,0.4340745062722764
6841,0.738,10,36,10,631863,44581,92044,34212,0.35310005069066025,0.43420100770373005
6842,0.7381,1,0,1,631863,44581,92045,34211,0.35310005069066025,0.4341938267844451
6843,0.7382,6,13,6,631876,44568,92051,34205,0.3529970852870359,0.43422238584286493
6844,0.7383,45,97,45,631973,44471,92096,34160,0.3522288049676847,0.4344342562093831
6845,0.7384,1,1,1,631974,44470,92097,34159,0.3522208845520213,0.43443258848516453
6846,0.7385,3,15,3,631989,44455,92100,34156,0.3521020783170701,0.43449390034473545
6847,0.7386,1,7,1,631996,44448,92101,34155,0.3520466354074262,0.434525399793901
6848,0.7387,7,12,7,632008,44436,92108,34148,0.3519515904194652,0.4345413824697139
6849,0.7388,10,10,10,632018,44426,92118,34138,0.35187238626283107,0.43452471870067716
6850,0.7389,1,1,1,632019,44425,92119,34137,0.3518644658471677,0.43452305185713197
6851,0.739,14,30,14,632049,44395,92133,34123,0.35162685337726524,0.43458824728087825
6852,0.7391,2,0,2,632049,44395,92135,34121,0.35162685337726524,0.4345738448214377
6853,0.7392,17,36,17,632085,44359,92152,34104,0.35134171841338235,0.43465072709429925
6854,0.7393,9,15,9,632100,44344,92161,34095,0.3512229121784311,0.43466897844184654
6855,0.7394,0,2,0,632102,44342,92161,34095,0.35120707134710427,0.4346800617055726
6856,0.7395,2,14,2,632116,44328,92163,34093,0.3510961855278165,0.434743244794124
6857,0.7396,1,2,1,632118,44326,92164,34092,0.3510803446964897,0.4347471243847076
6858,0.7397,6,18,6,632136,44308,92170,34086,0.3509377772145482,0.43480368395540475
6859,0.7398,8,12,8,632148,44296,92178,34078,0.35084273222658724,0.4348125653915839
6860,0.7399,1,3,1,632151,44293,92179,34077,0.350818970979597,0.4348219982136021
6861,0.74,1037,1769,1037,633920,42524,93216,33040,0.3368077556710176,0.43724524906039913
6862,0.7401,0,2,0,633922,42522,93216,33040,0.3367919148396908,0.43725682221222306
6863,0.7402,2,6,2,633928,42516,93218,33038,0.3367443923457103,0.4372766498133785
6864,0.7403,1,11,1,633939,42505,93219,33037,0.33665726777341276,0.4373328744274708
6865,0.7404,2,6,2,633945,42499,93221,33035,0.33660974527943227,0.4373527153334922
6866,0.7405,2,13,2,633958,42486,93223,33033,0.3365067798758079,0.43741310133873595
6867,0.7406,1,8,1,633966,42478,93224,33032,0.3364434165505006,0.4374519931134949
6868,0.7407,7,22,7,633988,42456,93231,33025,0.33626916740590546,0.43752732475722367
6869,0.7408,12,51,12,634039,42405,93243,33013,0.3358652262070713,0.4377336975257896
6870,0.7409,1,1,1,634040,42404,93244,33012,0.33585730579140793,0.4377320462501326
6871,0.741,16,28,16,634068,42376,93260,32996,0.3356355341528323,0.43777530117284935
6872,0.7411,4,2,4,634070,42374,93264,32992,0.3356196933215055,0.4377570787888438
6873,0.7412,6,9,6,634079,42365,93270,32986,0.3355484095805348,0.4377645950285995
6874,0.7413,3,19,3,634098,42346,93273,32983,0.3353979216829299,0.4378526198409643
6875,0.7414,3,8,3,634106,42338,93276,32980,0.3353345583576226,0.43787673597280863
6876,0.7415,6,14,6,634120,42324,93282,32974,0.3352236725383348,0.43791335759249916
6877,0.7416,0,1,0,634121,42323,93282,32974,0.3352157521226714,0.43791917340664305
6878,0.7417,58,127,58,634248,42196,93340,32916,0.3342098593334178,0.43822558312919374
6879,0.7418,10,13,10,634261,42183,93350,32906,0.3341068939297934,0.4382266377232351
6880,0.7419,1,3,1,634264,42180,93351,32905,0.3340831326828032,0.43823666511287207
6881,0.742,11,24,11,634288,42156,93362,32894,0.33389304270688125,0.43829447035309793
6882,0.7421,1,5,1,634293,42151,93363,32893,0.3338534406285642,0.43831618783646925
6883,0.7422,2,6,2,634299,42145,93365,32891,0.3338059181345837,0.43833626525934216
6884,0.7423,5,14,5,634313,42131,93370,32886,0.3336950323152959,0.4383806337230228
6885,0.7424,1,2,1,634315,42129,93371,32885,0.3336791914839691,0.43838483483083157
6886,0.7425,28,125,28,634440,42004,93399,32857,0.33268913952604234,0.438906773887605
6887,0.7426,0,4,0,634444,42000,93399,32857,0.3326574578633887,0.43893022696608197
6888,0.7427,5,27,5,634471,41973,93404,32852,0.3324436066404765,0.4390511192783161
6889,0.7428,1,3,1,634474,41970,93405,32851,0.33241984539348624,0.4390612261263549
6890,0.7429,1,1,1,634475,41969,93406,32850,0.33241192497782285,0.4390595971611489
6891,0.743,7,19,7,634494,41950,93413,32843,0.332261437080218,0.43911863409677376
6892,0.7431,0,1,0,634495,41949,93413,32843,0.33225351666455455,0.43912450529468394
6893,0.7432,6,13,6,634508,41936,93419,32837,0.3321505512609302,0.43915584502427346
6894,0.7433,89,231,89,634739,41705,93508,32748,0.3303209352426815,0.43984795777201724
6895,0.7434,5,5,5,634744,41700,93513,32743,0.3302813331643645,0.43983987749016024
6896,0.7435,5,20,5,634764,41680,93518,32738,0.3301229248510962,0.439920449353651
6897,0.7436,3,2,3,634766,41678,93521,32735,0.33010708401976935,0.43990969319876905
6898,0.7437,6,16,6,634782,41662,93527,32729,0.3299803573691547,0.4399591348415803
6899,0.7438,4,19,4,634801,41643,93531,32725,0.32982986947154985,0.4400414156626506
6900,0.7439,5,5,5,634806,41638,93536,32720,0.3297902673932328,0.44003335216116624
6901,0.744,26,53,26,634859,41585,93562,32694,0.32937048536307184,0.44015132136943147
6902,0.7441,1,4,1,634863,41581,93563,32693,0.3293388037004182,0.44016748795002286
6903,0.7442,20,42,20,634905,41539,93583,32673,0.3290061462425548,0.440265725219641
6904,0.7443,5,21,5,634926,41518,93588,32668,0.3288398175136231,0.4403526271803305
6905,0.7444,2,3,2,634929,41515,93590,32666,0.32881605626663285,0.4403553470565239
6906,0.7445,1,10,1,634939,41505,93591,32665,0.32873685210999876,0.44040717271133883
6907,0.7446,1,5,1,634944,41500,93592,32664,0.32869725003168165,0.44042931880696834
6908,0.7447,1,13,1,634957,41487,93593,32663,0.3285942846280573,0.44049898853674985
6909,0.7448,4,11,4,634968,41476,93597,32659,0.32850716005575975,0.440534160652863
6910,0.7449,1,8,1,634976,41468,93598,32658,0.32844379673045243,0.4405741575155816
6911,0.745,227,410,227,635386,41058,93825,32431,0.3251964263084527,0.44130414075575936
6912,0.7452,5,10,5,635396,41048,93830,32426,0.32511722215181854,0.4413261834118192
6913,0.7453,3,9,3,635405,41039,93833,32423,0.3250459384108478,0.44135743649778114
6914,0.7454,1,1,1,635406,41038,93834,32422,0.3250380179951844,0.44135583991287775
6915,0.7455,7,11,7,635417,41027,93841,32415,0.32495089342288686,0.4413686991095014
6916,0.7456,1,3,1,635420,41024,93842,32414,0.3249271321758966,0.44137912252512324
6917,0.7457,5,16,5,635436,41008,93847,32409,0.32480040552528194,0.4414372692973017
6918,0.7458,14,44,14,635480,40964,93861,32395,0.32445190723609174,0.4415954415954416
6919,0.7459,2,7,2,635487,40957,93863,32393,0.32439646432644786,0.4416223585548739
6920,0.746,23,45,23,635532,40912,93886,32370,0.3240400456215942,0.4417182937146912
6921,0.7461,0,1,0,635533,40911,93886,32370,0.32403212520593083,0.4417243214475785
6922,0.7462,2,9,2,635542,40902,93888,32368,0.32396084146496007,0.4417633410672854
6923,0.7463,7,7,7,635549,40895,93895,32361,0.3239053985553162,0.4417522114229551
6924,0.7464,1,5,1,635554,40890,93896,32360,0.3238657964769991,0.44177474402730377
6925,0.7465,2,11,2,635565,40879,93898,32358,0.32377867190470155,0.44182585305241884
6926,0.7466,0,1,0,635566,40878,93898,32358,0.32377075148903817,0.4418318859577257
6927,0.7467,91,209,91,635775,40669,93989,32267,0.32211538461538464,0.44240155752988924
6928,0.7468,2,12,2,635787,40657,93991,32265,0.32202033962742366,0.44245906585118344
6929,0.7469,1,8,1,635795,40649,93992,32264,0.32195697630211634,0.44249996571256156
6930,0.747,5,23,5,635818,40626,93997,32259,0.3217748067418578,0.4426013583041778
6931,0.7471,2,11,2,635829,40615,93999,32257,0.3216876821695603,0.4426528707871336
6932,0.7472,4,6,4,635835,40609,94003,32253,0.3216401596755798,0.44265872471247014
6933,0.7473,3,12,3,635847,40597,94006,32250,0.3215451146876188,0.4427086908177413
6934,0.7474,0,3,0,635850,40594,94006,32250,0.32152135344062854,0.4427269232881226
6935,0.7475,58,91,58,635941,40503,94064,32192,0.32080059561525787,0.44283650870073593
6936,0.7476,1,2,1,635943,40501,94065,32191,0.32078475478393104,0.4428410278985308
6937,0.7477,6,12,6,635955,40489,94071,32185,0.3206897097959701,0.4428681509205493
6938,0.7478,4,13,4,635968,40476,94075,32181,0.3205867443923457,0.4429167182790371
6939,0.7479,0,3,0,635971,40473,94075,32181,0.3205629831453555,0.4429350070195722
6940,0.748,18,40,18,636011,40433,94093,32163,0.32024616651881893,0.4430409388947049
6941,0.7481,2,1,2,636012,40432,94095,32161,0.3202382461031555,0.44303169727108677
6942,0.7482,3,11,3,636023,40421,94098,32158,0.32015112153085795,0.4430758208297166
6943,0.7483,51,79,51,636102,40342,94149,32107,0.31952540869344825,0.44316691741776976
6944,0.7484,1,6,1,636108,40336,94150,32106,0.31947788619946776,0.44319593605919216
6945,0.7485,6,6,6,636114,40330,94156,32100,0.3194303637054873,0.443186524920613
6946,0.7486,4,1,4,636115,40329,94160,32096,0.31942244328982383,0.4431618916120124
6947,0.7487,8,20,8,636135,40309,94168,32088,0.3192640349765556,0.44322278547453625
6948,0.7488,5,8,5,636143,40301,94173,32083,0.31920067165124827,0.4432333112290009
6949,0.7489,0,2,0,636145,40299,94173,32083,0.31918483081992144,0.44324555828797213
6950,0.749,15,25,15,636170,40274,94188,32068,0.3189868204283361,0.44328329324597054
6951,0.7491,2,1,2,636171,40273,94190,32066,0.31897890001267265,0.44327402922351705
6952,0.7492,16,42,16,636213,40231,94206,32050,0.3186462425548093,0.44340836457713645
6953,0.7493,6,22,6,636235,40209,94212,32044,0.31847199341021415,0.4434971558274397
6954,0.7494,0,3,0,636238,40206,94212,32044,0.31844823216322393,0.44351557093425603
6955,0.7495,3,16,3,636254,40190,94215,32041,0.3183215055126093,0.44359070205313506
6956,0.7496,1,2,1,636256,40188,94216,32040,0.31830566468128246,0.4435952816082406
6957,0.7497,3,12,3,636268,40176,94219,32037,0.3182106196933215,0.4436458809355656
6958,0.7498,4,12,4,636280,40164,94223,32033,0.31811557470536056,0.44368879593334903
6959,0.7499,2,3,2,636283,40161,94225,32031,0.3180918134583703,0.44369182180851063
6960,0.75,1027,1624,1027,637907,38537,95252,31004,0.3052290584209859,0.445837707251837
6961,0.7501,1,3,1,637910,38534,95253,31003,0.3052052971739957,0.44584897248946603
6962,0.7502,2,9,2,637919,38525,95255,31001,0.305134013433025,0.44589074590800565
6963,0.7503,2,13,2,637932,38512,95257,30999,0.30503104802940056,0.44595819366718936
6964,0.7504,1,4,1,637936,38508,95258,30998,0.3049993663667469,0.44597588697378643
6965,0.7505,2,3,2,637939,38505,95260,30996,0.3049756051197567,0.4459791945439634
6966,0.7506,5,1,5,637940,38504,95265,30991,0.30496768470409324,0.44594575149291316
6967,0.7507,7,17,7,637957,38487,95272,30984,0.3048330376378152,0.44599904996329404
6968,0.7508,18,36,18,637993,38451,95290,30966,0.30454790267393234,0.4460866934612559
6969,0.7509,1,3,1,637996,38448,95291,30965,0.30452414142694206,0.446097993171308
6970,0.751,13,18,13,638014,38430,95304,30952,0.30438157394500065,0.4461099420599003
6971,0.7511,0,5,0,638019,38425,95304,30952,0.30434197186668355,0.44614209320091675
6972,0.7512,1,6,1,638025,38419,95305,30951,0.30429444937270306,0.4461726971313248
6973,0.7513,6,9,6,638034,38410,95311,30945,0.30422316563173235,0.44618268329608535
6974,0.7514,2,5,2,638039,38405,95313,30943,0.3041835635534153,0.4461988810059411
6975,0.7515,5,14,5,638053,38391,95318,30938,0.3040726777341275,0.44624904441142954
6976,0.7516,3,1,3,638054,38390,95321,30935,0.30406475731846405,0.44623151821132345
6977,0.7517,51,107,51,638161,38283,95372,30884,0.3032172728424788,0.4465135107782613
6978,0.7518,5,11,5,638172,38272,95377,30879,0.3031301482701812,0.4465445185174473
6979,0.7519,0,2,0,638174,38270,95377,30879,0.30311430743885437,0.44655743394698405
6980,0.752,8,29,8,638203,38241,95385,30871,0.30288461538461536,0.4466807500868156
6981,0.7521,1,6,1,638209,38235,95386,30870,0.3028370928906349,0.4467115259387888
6982,0.7522,1,5,1,638214,38230,95387,30869,0.3027974908123178,0.44673584277630646
6983,0.7523,10,20,10,638234,38210,95397,30859,0.3026390824990495,0.44678509895901203
6984,0.7524,1,4,1,638238,38206,95398,30858,0.30260740083639587,0.4468029653654581
6985,0.7525,55,104,55,638342,38102,95453,30803,0.3017836776074008,0.4470357738915899
6986,0.7526,0,3,0,638345,38099,95453,30803,0.3017599163604106,0.447055237874082
6987,0.7527,9,25,9,638370,38074,95462,30794,0.30156190596882526,0.4471452634024511
6988,0.7528,2,10,2,638380,38064,95464,30792,0.3014827018121911,0.44719414430115023
6989,0.7529,0,8,0,638388,38056,95464,30792,0.3014193384868838,0.4472461073669533
6990,0.753,10,21,10,638409,38035,95474,30782,0.3012530097579521,0.44730226542860047
6991,0.7531,0,3,0,638412,38032,95474,30782,0.30122924851096183,0.4473217659197256
6992,0.7532,5,16,5,638428,38016,95479,30777,0.30110252186034725,0.44738563516636864
6993,0.7533,130,217,130,638645,37799,95609,30647,0.2993837916613864,0.44775443415247057
6994,0.7535,7,14,7,638659,37785,95616,30640,0.2992729058420986,0.44778955060284986
6995,0.7536,3,5,3,638664,37780,95619,30637,0.29923330376378154,0.447798061885204
6996,0.7537,5,12,5,638676,37768,95624,30632,0.29913825877582056,0.44783625730994153
6997,0.7538,8,19,8,638695,37749,95632,30624,0.2989877708782157,0.4478960993374578
6998,0.7539,1,3,1,638698,37746,95633,30623,0.29896400963122544,0.447907677456157
6999,0.754,20,49,20,638747,37697,95653,30603,0.2985759092637182,0.44806734992679353
7000,0.7541,1,8,1,638755,37689,95654,30602,0.29851254593841087,0.44811175703972705
7001,0.7542,17,33,17,638788,37656,95671,30585,0.2982511722215182,0.44819097023783355
7002,0.7543,11,20,11,638808,37636,95682,30574,0.2980927639082499,0.44823339686263014
7003,0.7544,1,6,1,638814,37630,95683,30573,0.2980452414142694,0.4482647390877234
7004,0.7545,3,6,3,638820,37624,95686,30570,0.2979977189202889,0.4482799073232249
7005,0.7546,1,5,1,638825,37619,95687,30569,0.2979581168419719,0.4483046870417082
7006,0.7547,5,21,5,638846,37598,95692,30564,0.2977917881130402,0.44840233561221793
7007,0.7548,1,14,1,638860,37584,95693,30563,0.2976809022937524,0.4484863603680279
7008,0.7549,1,6,1,638866,37578,95694,30562,0.2976333797997719,0.4485177575579689
7009,0.755,228,367,228,639233,37211,95922,30334,0.29472658725129897,0.4490931971278407
7010,0.7551,0,2,0,639235,37209,95922,30334,0.29471074641997214,0.4491064951216262
7011,0.7552,4,5,4,639240,37204,95926,30330,0.29467114434165503,0.4491071164154352
7012,0.7553,2,10,2,639250,37194,95928,30328,0.2945919401850209,0.4491573116910044
7013,0.7554,2,2,2,639252,37192,95930,30326,0.29457609935369405,0.4491542995941823
7014,0.7555,3,9,3,639261,37183,95933,30323,0.29450481561272335,0.4491897016561491
7015,0.7556,2,4,2,639265,37179,95935,30321,0.2944731339500697,0.4492
7016,0.7557,7,21,7,639286,37158,95942,30314,0.294306805221138,0.4492826654019445
7017,0.7558,14,41,14,639327,37117,95956,30300,0.293982068178938,0.44944153551774774
7018,0.7559,0,3,0,639330,37114,95956,30300,0.2939583069319478,0.4494615361794286
7019,0.756,29,38,29,639368,37076,95985,30271,0.29365733113673803,0.44947807623205194
7020,0.7561,2,4,2,639372,37072,95987,30269,0.2936256494740844,0.4494884245853195
7021,0.7562,2,16,2,639388,37056,95989,30267,0.2934989228234698,0.4495788957711332
7022,0.7563,2,12,2,639400,37044,95991,30265,0.2934038778355088,0.44964269265625695
7023,0.7564,1,1,1,639401,37043,95992,30264,0.2933959574198454,0.44964119630944777
7024,0.7565,3,9,3,639410,37034,95995,30261,0.29332467367887466,0.4496767961958541
7025,0.7566,0,2,0,639412,37032,95995,30261,0.29330883284754783,0.4496901609379876
7026,0.7567,126,197,126,639609,36835,96121,30135,0.2917485109618553,0.4499776019113036
7027,0.7568,4,7,4,639616,36828,96125,30131,0.2916930680522114,0.4499917860183097
7028,0.7569,0,2,0,639618,36826,96125,30131,0.29167722722088457,0.4500052272353899
7029,0.757,7,18,7,639636,36808,96132,30124,0.2915346597389431,0.45006872646865476
7030,0.7571,2,3,2,639639,36805,96134,30122,0.29151089849195283,0.4500724670163013
7031,0.7572,2,12,2,639651,36793,96136,30120,0.2914158535039919,0.4501367447282292
7032,0.7573,4,18,4,639669,36775,96140,30116,0.29127328602205044,0.4502249928988952
7033,0.7574,0,4,0,639673,36771,96140,30116,0.2912416043593968,0.4502519174129502
7034,0.7575,41,82,41,639755,36689,96181,30075,0.2905921302749968,0.45046731771613446
7035,0.7576,0,10,0,639765,36679,96181,30075,0.2905129261183627,0.45053479941276925
7036,0.7577,6,19,6,639784,36660,96187,30069,0.2903624382207578,0.45061367621274107
7037,0.7578,3,4,3,639788,36656,96190,30066,0.29033075655810414,0.45061598872935466
7038,0.7579,2,3,2,639791,36653,96192,30064,0.2903069953111139,0.4506197820645413
7039,0.758,14,28,14,639819,36625,96206,30050,0.29008522367253836,0.4506936632920885
7040,0.7581,2,2,2,639821,36623,96208,30048,0.29006938284121153,0.45069070510416825
7041,0.7582,1,6,1,639827,36617,96209,30047,0.29002186034723104,0.45072302892115684
7042,0.7583,44,75,44,639902,36542,96253,30003,0.28942782917247495,0.45086783379667894
7043,0.7584,0,2,0,639904,36540,96253,30003,0.2894119883411481,0.4508813849691177
7044,0.7585,4,15,4,639919,36525,96257,29999,0.2892931821061969,0.45095003307077147
7045,0.7586,0,3,0,639922,36522,96257,29999,0.2892694208592067,0.45097037025901593
7046,0.7587,1,10,1,639932,36512,96258,29998,0.28919021670257256,0.4510299203127349
7047,0.7588,3,12,3,639944,36500,96261,29995,0.2890951717146116,0.4510865478607414
7048,0.7589,3,2,3,639946,36498,96264,29992,0.28907933088328475,0.4510753496766431
7049,0.759,17,25,17,639971,36473,96281,29975,0.2888813204916994,0.45110462316397787
7050,0.7591,1,2,1,639973,36471,96282,29974,0.28886547966037257,0.4511099405523365
7051,0.7592,22,41,22,640014,36430,96304,29952,0.2885407426181726,0.4512066524057726
7052,0.7593,9,19,9,640033,36411,96313,29943,0.28839025472056773,0.4512614160412334
7053,0.7594,1,2,1,640035,36409,96314,29942,0.2883744138892409,0.4512667480520263
7054,0.7595,2,7,2,640042,36402,96316,29940,0.288318970979597,0.45129782038527627
7055,0.7596,2,7,2,640049,36395,96318,29938,0.2882635280699531,0.45132890115025703
7056,0.7597,4,14,4,640063,36381,96322,29934,0.28815264225066534,0.45139108798914274
7057,0.7598,2,7,2,640070,36374,96324,29932,0.2880971993410214,0.45142219406991824
7058,0.7599,1,4,1,640074,36370,96325,29931,0.28806551767836774,0.45144115473371443
7059,0.76,961,1597,961,641671,34773,97286,28970,0.2754166138638956,0.45448127637544516
7060,0.7601,1,1,1,641672,34772,97287,28969,0.27540869344823216,0.454479848135423
7061,0.7602,4,18,4,641690,34754,97291,28965,0.2752661259662907,0.4545739889201023
7062,0.7603,5,7,5,641697,34747,97296,28960,0.2752106830566468,0.45458112923226646
7063,0.7604,2,3,2,641700,34744,97298,28958,0.2751869218096566,0.45458541333082164
7064,0.7605,3,17,3,641717,34727,97301,28955,0.2750522747433785,0.45468107157438525
7065,0.7606,0,1,0,641718,34726,97301,28955,0.2750443543277151,0.4546882115544668
7066,0.7607,3,20,3,641738,34706,97304,28952,0.2748859460144468,0.4548053661755003
7067,0.7608,12,42,12,641780,34664,97316,28940,0.27455328855658345,0.45500283001069114
7068,0.7609,1,2,1,641782,34662,97317,28939,0.2745374477252566,0.45500856904765646
7069,0.761,7,17,7,641799,34645,97324,28932,0.2744028006589786,0.45507022980008494
7070,0.7611,1,8,1,641807,34637,97325,28931,0.2743394373336713,0.45511892776239615
7071,0.7612,2,10,2,641817,34627,97327,28929,0.2742602331770371,0.45517339039587135
7072,0.7613,5,11,5,641828,34616,97332,28924,0.2741731086047396,0.4552093169656909
7073,0.7614,2,4,2,641832,34612,97334,28922,0.27414142694208593,0.45522082664400165
7074,0.7615,5,15,5,641847,34597,97339,28917,0.27402262070713473,0.45528544887741285
7075,0.7616,0,6,0,641853,34591,97339,28917,0.27397509821315424,0.4553284625558985
7076,0.7617,41,73,41,641926,34518,97380,28876,0.273396907869725,0.45550052055399565
7077,0.7618,3,3,3,641929,34515,97383,28873,0.27337314662273476,0.4554963084495488
7078,0.7619,2,2,2,641931,34513,97385,28871,0.27335730579140793,0.4554934999368926
7079,0.762,11,25,11,641956,34488,97396,28860,0.2731592953998226,0.45557870808865314
7080,0.7621,2,0,2,641956,34488,97398,28858,0.2731592953998226,0.45556151927509236
7081,0.7622,5,8,5,641964,34480,97403,28853,0.27309593207451527,0.4555760819793788
7082,0.7623,5,11,5,641975,34469,97408,28848,0.27300880750221773,0.45561223684002716
7083,0.7624,1,3,1,641978,34466,97409,28847,0.27298504625522746,0.4556252270465781
7084,0.7625,36,94,36,642072,34372,97445,28811,0.27224052718286657,0.4559929094851463
7085,0.7626,0,3,0,642075,34369,97445,28811,0.2722167659358763,0.4560145615701171
7086,0.7627,4,18,4,642093,34351,97449,28807,0.2720741984539349,0.45611007314987806
7087,0.7628,2,14,2,642107,34337,97451,28805,0.27196331263464707,0.4561939754838301
7088,0.7629,7,7,7,642114,34330,97458,28798,0.2719078697250032,0.45618426054999367
7089,0.763,6,32,6,642146,34298,97464,28792,0.2716544164237739,0.45636392455222696
7090,0.7631,0,1,0,642147,34297,97464,28792,0.2716464960081105,0.45637115820507534
7091,0.7632,7,8,7,642155,34289,97471,28785,0.2715831326828032,0.45636870976947713
7092,0.7633,106,162,106,642317,34127,97577,28679,0.2703000253453301,0.45662834761010096
7093,0.7634,2,7,2,642324,34120,97579,28677,0.2702445824356862,0.45666194244948005
7094,0.7635,6,16,6,642340,34104,97585,28671,0.2701178557850716,0.45672640382317803
7095,0.7636,1,4,1,642344,34100,97586,28670,0.2700861741224179,0.45674685359248046
7096,0.7637,3,20,3,642364,34080,97589,28667,0.2699277658091497,0.45686646373531803
7097,0.7638,7,10,7,642374,34070,97596,28660,0.26984856165251553,0.45687868643392315
7098,0.7639,1,6,1,642380,34064,97597,28659,0.26980103915853504,0.45691373180492006
7099,0.764,23,44,23,642424,34020,97620,28636,0.26945254086934484,0.457035240040858
7100,0.7641,2,0,2,642424,34020,97622,28634,0.26945254086934484,0.457017907874996
7101,0.7642,18,24,18,642448,33996,97640,28616,0.2692624508934229,0.45703698971443174
7102,0.7643,4,18,4,642466,33978,97644,28612,0.2691198834114814,0.4571337274324972
7103,0.7644,1,0,1,642466,33978,97645,28611,0.2691198834114814,0.45712505392321334
7104,0.7645,5,7,5,642473,33971,97650,28606,0.26906444050183753,0.4571328123751538
7105,0.7647,1,9,1,642482,33962,97651,28605,0.2689931567608668,0.45718989243530933
7106,0.7648,2,8,2,642490,33954,97653,28603,0.2689297934355595,0.4572310053231453
7107,0.7649,0,3,0,642493,33951,97653,28603,0.26890603218856923,0.45725293346548584
7108,0.765,195,349,195,642842,33602,97848,28408,0.2661418071220378,0.4581196581196581
7109,0.7651,1,4,1,642846,33598,97849,28407,0.2661101254593841,0.45814047254253687
7110,0.7652,3,11,3,642857,33587,97852,28404,0.2660230008870866,0.4581955445145263
7111,0.7653,5,10,5,642867,33577,97857,28399,0.26594379673045243,0.45822576481218535
7112,0.7654,1,1,1,642868,33576,97858,28398,0.265935876314789,0.4582244166908704
7113,0.7655,4,10,4,642878,33566,97862,28394,0.26585667215815484,0.45826339573918656
7114,0.7656,0,4,0,642882,33562,97862,28394,0.2658249904955012,0.4582929821163406
7115,0.7657,3,21,3,642903,33541,97865,28391,0.2656586617665695,0.45842214041206486
7116,0.7658,13,37,13,642940,33504,97878,28378,0.26536560638702317,0.45858246339808023
7117,0.7659,0,1,0,642941,33503,97878,28378,0.2653576859713598,0.4585898741132173
7118,0.766,19,42,19,642983,33461,97897,28359,0.2650250285134964,0.4587350372047881
7119,0.7661,0,1,0,642984,33460,97897,28359,0.26501710809783297,0.4587424578204112
7120,0.7662,3,9,3,642993,33451,97900,28356,0.26494582435686226,0.4587829857459511
7121,0.7663,2,11,2,643004,33440,97902,28354,0.26485869978456467,0.4588471372625174
7122,0.7664,0,5,0,643009,33435,97902,28354,0.2648190977062476,0.45888426742624094
7123,0.7665,8,6,8,643015,33429,97910,28346,0.26477157521226713,0.4588587616349656
7124,0.7666,0,6,0,643021,33423,97910,28346,0.26472405271828664,0.45890333338729783
7125,0.7667,104,168,104,643189,33255,98014,28242,0.2633934228868331,0.459241914239719
7126,0.7668,3,5,3,643194,33250,98017,28239,0.26335382080851605,0.45925287449787766
7127,0.7669,0,1,0,643195,33249,98017,28239,0.2633459003928526,0.45926034348165495
7128,0.767,10,13,10,643208,33236,98027,28229,0.26324293498922824,0.45926950296916946
7129,0.7671,3,4,3,643212,33232,98030,28226,0.2632112533265746,0.4592729994467767
7130,0.7672,5,6,5,643218,33226,98035,28221,0.2631637308325941,0.45927384575325075
7131,0.7673,7,13,7,643231,33213,98042,28214,0.2630607654289697,0.45930942419457244
7132,0.7674,0,2,0,643233,33211,98042,28214,0.2630449245976429,0.4593243793243793
7133,0.7675,63,85,63,643318,33126,98105,28151,0.2623716892662527,0.45940564975439396
7134,0.7676,1,3,1,643321,33123,98106,28150,0.26234792801926243,0.45941932009204706
7135,0.7677,4,15,4,643336,33108,98110,28146,0.26222912178431124,0.4594965226760701
7136,0.7678,3,10,3,643346,33098,98113,28143,0.2621499176276771,0.459545076011169
7137,0.7679,1,4,1,643350,33094,98114,28142,0.2621182359650234,0.45956626820824353
7138,0.768,19,23,19,643373,33071,98133,28123,0.2619360664047649,0.45957119979082917
7139,0.7681,1,5,1,643378,33066,98134,28122,0.26189646432644786,0.45959992155324575
7140,0.7682,2,9,2,643387,33057,98136,28120,0.2618251805854771,0.45964986841460026
7141,0.7683,44,81,44,643468,32976,98180,28076,0.2611836269167406,0.4598702745200812
7142,0.7684,0,1,0,643469,32975,98180,28076,0.2611757065010772,0.45987780707932713
7143,0.7685,2,14,2,643483,32961,98182,28074,0.2610648206817894,0.4599655935119194
7144,0.7686,4,4,4,643487,32957,98186,28070,0.2610331390191357,0.45996034542087927
7145,0.7687,3,2,3,643489,32955,98189,28067,0.2610172981878089,0.45994887089902003
7146,0.7688,3,14,3,643503,32941,98192,28064,0.2609064123685211,0.46002786656831407
7147,0.7689,1,1,1,643504,32940,98193,28063,0.2608984919528577,0.4600265560710129
7148,0.769,10,28,10,643532,32912,98203,28053,0.2606767203142821,0.4601492659722792
7149,0.7691,0,1,0,643533,32911,98203,28053,0.2606687998986187,0.46015681385735846
7150,0.7692,11,26,11,643559,32885,98214,28042,0.2604628690913699,0.46025571585668096
7151,0.7693,8,23,8,643582,32862,98222,28034,0.2602806995311114,0.4603586442459275
7152,0.7694,1,3,1,643585,32859,98223,28033,0.26025693828412116,0.4603724627208829
7153,0.7695,1,5,1,643590,32854,98224,28032,0.26021733620580406,0.4604014059061196
7154,0.7696,2,2,2,643592,32852,98226,28030,0.26020149537447723,0.4603988042442758
7155,0.7697,3,19,3,643611,32833,98229,28027,0.2600510074768724,0.46051593821886294
7156,0.7698,1,7,1,643618,32826,98230,28026,0.2599955645672285,0.4605600473279432
7157,0.7699,2,1,2,643619,32825,98232,28024,0.25998764415156506,0.4605498857828395
7158,0.77,1069,1457,1069,645076,31368,99301,26955,0.24844759852997086,0.4621675839720179
7159,0.7701,0,1,0,645077,31367,99301,26955,0.24843967811430745,0.4621755083844861
7160,0.7702,6,16,6,645093,31351,99307,26949,0.2483129514636928,0.46224699828473415
7161,0.7703,4,9,4,645102,31342,99311,26945,0.24824166772272208,0.46228146928131486
7162,0.7704,0,4,0,645106,31338,99311,26945,0.24820998606006844,0.4623131959576549
7163,0.7705,6,13,6,645119,31325,99317,26939,0.24810702065644405,0.462360977619113
7164,0.7706,0,2,0,645121,31323,99317,26939,0.24809117982511722,0.46237684940441454
7165,0.7707,4,15,4,645136,31308,99321,26935,0.24797237359016602,0.46245900794945316
7166,0.7708,12,29,12,645165,31279,99333,26923,0.24774268153592702,0.46257860554620117
7167,0.7709,1,2,1,645167,31277,99334,26922,0.2477268407046002,0.4625852677881063
7168,0.771,8,27,8,645194,31250,99342,26914,0.247512989481688,0.46272608486348943
7169,0.7711,0,3,0,645197,31247,99342,26914,0.24748922823469777,0.4627499527174567
7170,0.7712,1,9,1,645206,31238,99343,26913,0.24741794449372703,0.462812333407852
7171,0.7713,2,15,2,645221,31223,99345,26911,0.2472991382587758,0.46291326934324145
7172,0.7714,3,1,3,645222,31222,99348,26908,0.2472912178431124,0.46289351453638394
7173,0.7715,7,3,7,645225,31219,99355,26901,0.24726745659612218,0.4628527185134205
7174,0.7716,0,3,0,645228,31216,99355,26901,0.24724369534913193,0.4628766109744137
7175,0.7717,43,84,43,645312,31132,99398,26858,0.24657838043340516,0.4631488187618555
7176,0.7718,0,11,0,645323,31121,99398,26858,0.2464912558611076,0.46323668914607014
7177,0.7719,0,1,0,645324,31120,99398,26858,0.24648333544544418,0.46324467901617855
7178,0.772,11,14,11,645338,31106,99409,26847,0.24637244962615637,0.4632547064000138
7179,0.7721,1,6,1,645344,31100,99410,26846,0.2463249271321759,0.46329341110689265
7180,0.7722,2,7,2,645351,31093,99412,26844,0.246269484222532,0.46333085938174223
7181,0.7723,6,17,6,645368,31076,99418,26838,0.24613483715625395,0.46341126497910695
7182,0.7724,2,0,2,645368,31076,99420,26836,0.24613483715625395,0.4633927338030115
7183,0.7725,44,83,44,645451,30993,99464,26792,0.2454774426561906,0.463649736090681
7184,0.7726,1,2,1,645453,30991,99465,26791,0.24546160182486376,0.46365650202485204
7185,0.7727,8,16,8,645469,30975,99473,26783,0.24533487517424915,0.46371065480106655
7186,0.7728,2,2,2,645471,30973,99475,26781,0.24531903434292232,0.4637081414274336
7187,0.7729,2,5,2,645476,30968,99477,26779,0.24527943226460525,0.46372971756108544
7188,0.773,9,16,9,645492,30952,99486,26770,0.24515270561399063,0.46377464398323
7189,0.7731,2,3,2,645495,30949,99488,26768,0.2451289443670004,0.4637801687544398
7190,0.7732,3,9,3,645504,30940,99491,26765,0.24505766062602966,0.4638246252491119
7191,0.7733,113,157,113,645661,30783,99604,26652,0.24381415536687365,0.4640376077304779
7192,0.7734,0,1,0,645662,30782,99604,26652,0.24380623495121023,0.4640456872235958
7193,0.7735,5,12,5,645674,30770,99609,26647,0.24371118996324928,0.46409599944267377
7194,0.7736,1,6,1,645680,30764,99610,26646,0.2436636674692688,0.4641351680891831
7195,0.7737,6,13,6,645693,30751,99616,26640,0.2435607020656444,0.46418427976511994
7196,0.7738,4,13,4,645706,30738,99620,26636,0.24345773666202003,0.46425210025447067
7197,0.7739,0,5,0,645711,30733,99620,26636,0.24341813458370296,0.46429256218515225
7198,0.774,20,37,20,645748,30696,99640,26616,0.24312507920415663,0.46440536013400335
7199,0.7741,0,5,0,645753,30691,99640,26616,0.24308547712583956,0.4644458792119636
7200,0.7742,15,26,15,645779,30665,99655,26601,0.2428795463185908,0.46451646701358573
7201,0.7743,11,18,11,645797,30647,99666,26590,0.24273697883664935,0.46455963799640093
7202,0.7744,0,3,0,645800,30644,99666,26590,0.2427132175896591,0.4645839885382814
7203,0.7745,5,9,5,645809,30635,99671,26585,0.24264193384868837,0.4646102761272282
7204,0.7746,0,5,0,645814,30630,99671,26585,0.2426023317703713,0.46465087826618895
7205,0.7747,4,7,4,645821,30623,99675,26581,0.24254688886072742,0.46467030277602966
7206,0.7748,5,13,5,645834,30610,99680,26576,0.24244392345710303,0.46472912950722206
7207,0.7749,0,8,0,645842,30602,99680,26576,0.2423805601317957,0.464794151596768
7208,0.775,189,353,189,646195,30249,99869,26387,0.23958465340261056,0.46590507804223463
7209,0.7751,0,3,0,646198,30246,99869,26387,0.23956089215562032,0.46592975826814753
7210,0.7752,0,14,0,646212,30232,99869,26387,0.23945000633633254,0.46604496723714656
7211,0.7753,2,11,2,646223,30221,99871,26385,0.23936288176403497,0.46611666607780095
7212,0.7754,0,5,0,646228,30216,99871,26385,0.2393232796857179,0.46615784173424496
7213,0.7755,6,10,6,646238,30206,99877,26379,0.23924407552908378,0.4661836175664929
7214,0.7756,0,2,0,646240,30204,99877,26379,0.23922823469775695,0.46620009543502466
7215,0.7757,6,20,6,646260,30184,99883,26373,0.23906982638448865,0.46630832611347844
7216,0.7758,15,27,15,646287,30157,99898,26358,0.23885597516157647,0.4663894541272229
7217,0.7759,2,5,2,646292,30152,99900,26356,0.2388163730832594,0.4664118354923197
7218,0.776,18,44,18,646336,30108,99918,26338,0.2384678747940692,0.4666052510363888
7219,0.7761,1,4,1,646340,30104,99919,26337,0.23843619313141554,0.4666288690845308
7220,0.7762,7,5,7,646345,30099,99926,26330,0.23839659105309846,0.4666040511084726
7221,0.7763,2,10,2,646355,30089,99928,26328,0.23831738689646434,0.4666678483435844
7222,0.7764,1,6,1,646361,30083,99929,26327,0.23826986440248385,0.4667080304910477
7223,0.7765,2,10,2,646371,30073,99931,26325,0.2381906602458497,0.46677187134295545
7224,0.7766,1,5,1,646376,30068,99932,26324,0.23815105816753263,0.4668038019577245
7225,0.7767,98,173,98,646549,29895,100030,26226,0.236780826257762,0.4673117015021115
7226,0.7768,4,13,4,646562,29882,100034,26222,0.2366778608541376,0.4673820048481392
7227,0.7769,0,1,0,646563,29881,100034,26222,0.23666994043847422,0.4673903356326756
7228,0.777,5,16,5,646579,29865,100039,26217,0.23654321378785959,0.46747619557077136
7229,0.7771,3,7,3,646586,29858,100042,26214,0.23648777087821568,0.46750606363247255
7230,0.7772,3,8,3,646594,29850,100045,26211,0.2364244075529084,0.46754428212126076
7231,0.7773,8,23,8,646617,29827,100053,26203,0.23624223799264985,0.4676601820453329
7232,0.7774,0,6,0,646623,29821,100053,26203,0.23619471549866938,0.4677102670284164
7233,0.7775,59,76,59,646699,29745,100112,26144,0.2355927639082499,0.46778435828159387
7234,0.7776,2,3,2,646702,29742,100114,26142,0.23556900266125966,0.467790423019111
7235,0.7777,8,6,8,646708,29736,100122,26134,0.23552148016727917,0.4677644531949168
7236,0.7778,5,10,5,646718,29726,100127,26129,0.23544227601064505,0.46780055500850415
7237,0.7779,2,4,2,646722,29722,100129,26127,0.2354105943479914,0.46781500116385255
7238,0.778,15,31,15,646753,29691,100144,26112,0.23516506146242555,0.4679318316219558
7239,0.7781,1,3,1,646756,29688,100145,26111,0.2351413002154353,0.4679474542554526
7240,0.7782,4,9,4,646765,29679,100149,26107,0.23507001647446457,0.46798479905352597
7241,0.7783,41,75,41,646840,29604,100190,26066,0.23447598529970853,0.4682234596730735
7242,0.7784,1,0,1,646840,29604,100191,26065,0.23447598529970853,0.46821390720149453
7243,0.7785,2,8,2,646848,29596,100193,26063,0.23441262197440121,0.4682620959772903
7244,0.7786,1,9,1,646857,29587,100194,26062,0.23434133823343048,0.46832827184675374
7245,0.7787,3,14,3,646871,29573,100197,26059,0.2342304524141427,0.46841745757837217
7246,0.7788,1,5,1,646876,29568,100198,26058,0.23419085033582562,0.46845000539316145
7247,0.7789,0,2,0,646878,29566,100198,26058,0.2341750095044988,0.4684668488422264
7248,0.779,10,16,10,646894,29550,100208,26048,0.23404828285388418,0.468506061369114
7249,0.7791,1,1,1,646895,29549,100209,26047,0.23404036243822077,0.468504928412116
7250,0.7792,14,45,14,646940,29504,100223,26033,0.23368394373336712,0.46875056268793774
7251,0.7793,7,18,7,646958,29486,100230,26026,0.23354137625142568,0.46883556708459434
7252,0.7794,2,2,2,646960,29484,100232,26024,0.23352553542009885,0.46883332132305255
7253,0.7795,3,12,3,646972,29472,100235,26021,0.23343049043213787,0.4689059881426486
7254,0.7796,4,2,4,646974,29470,100239,26017,0.23341464960081104,0.46888460360084344
7255,0.7797,2,6,2,646980,29464,100241,26015,0.23336712710683058,0.46891616647740586
7256,0.7798,6,11,6,646991,29453,100247,26009,0.23328000253453302,0.4689517146875338
7257,0.7799,1,3,1,646994,29450,100248,26008,0.23325624128754277,0.46896750694219047
7258,0.78,1038,1489,1038,648483,27961,101286,24970,0.2214627423647193,0.4717462356653001
7259,0.7801,2,3,2,648486,27958,101288,24968,0.22143898111772906,0.47175301364168837
7260,0.7802,4,8,4,648494,27950,101292,24964,0.22137561779242174,0.4717844048833957
7261,0.7803,3,5,3,648499,27945,101295,24961,0.2213360157141047,0.47179903980644916
7262,0.7804,1,0,1,648499,27945,101296,24960,0.2213360157141047,0.47178905585483416
7263,0.7805,3,16,3,648515,27929,101299,24957,0.22120928906349005,0.4719018265703589
7264,0.7807,7,17,7,648532,27912,101306,24950,0.22107464199721202,0.47198365555597593
7265,0.7808,17,20,17,648552,27892,101323,24933,0.22091623368394372,0.4719924278277331
7266,0.7809,1,2,1,648554,27890,101324,24932,0.2209003928526169,0.472000302904093
7267,0.781,8,17,8,648571,27873,101332,24924,0.22076574578633887,0.472072276833911
7268,0.7811,1,5,1,648576,27868,101333,24923,0.2207261437080218,0.47210698793354927
7269,0.7812,0,6,0,648582,27862,101333,24923,0.2206786212140413,0.47216065170029364
7270,0.7813,3,8,3,648590,27854,101336,24920,0.220615257888734,0.4722022207905408
7271,0.7814,1,1,1,648591,27853,101337,24919,0.2206073374730706,0.4722011672856818
7272,0.7815,3,8,3,648599,27845,101340,24916,0.22054397414776328,0.47224275506529445
7273,0.7816,2,1,2,648600,27844,101342,24914,0.22053605373209986,0.4722316994579021
7274,0.7817,44,81,44,648681,27763,101386,24870,0.21989450006336334,0.47251724203446505
7275,0.7818,2,4,2,648685,27759,101388,24868,0.21986281840070968,0.47253311038060314
7276,0.7819,1,1,1,648686,27758,101389,24867,0.21985489798504626,0.47253206650831353
7277,0.782,10,22,10,648708,27736,101399,24857,0.21968064884045116,0.47262943737759777
7278,0.7821,2,6,2,648714,27730,101401,24855,0.21963312634647067,0.47266330702671866
7279,0.7822,5,9,5,648723,27721,101406,24850,0.21956184260549994,0.4726940708755778
7280,0.7823,7,18,7,648741,27703,101413,24843,0.2194192751235585,0.4727857496288966
7281,0.7824,3,3,3,648744,27700,101416,24840,0.21939551387656825,0.4727826417967263
7282,0.7825,31,91,31,648835,27609,101447,24809,0.21867475605119757,0.4732916173833416
7283,0.7826,0,1,0,648836,27608,101447,24809,0.21866683563553416,0.4733006467367457
7284,0.7827,3,9,3,648845,27599,101450,24806,0.21859555189456342,0.4733517794103616
7285,0.7828,4,9,4,648854,27590,101454,24802,0.2185242681535927,0.47339288440983357
7286,0.7829,2,4,2,648858,27586,101456,24800,0.21849258649093906,0.47340892604894436
7287,0.783,6,17,6,648875,27569,101462,24794,0.218357939424661,0.47350228214579
7288,0.7831,1,2,1,648877,27567,101463,24793,0.21834209859333417,0.4735103132161956
7289,0.7832,3,9,3,648886,27558,101466,24790,0.21827081485236347,0.4735615496294032
7290,0.7833,102,161,102,649047,27397,101568,24688,0.2169956279305538,0.4739944321781703
7291,0.7834,0,2,0,649049,27395,101568,24688,0.21697978709922697,0.47401263368085556
7292,0.7835,4,9,4,649058,27386,101572,24684,0.21690850335825623,0.4740541578644133
7293,0.7836,0,7,0,649065,27379,101572,24684,0.21685306044861236,0.47411789562645257
7294,0.7837,6,10,6,649075,27369,101578,24678,0.2167738562919782,0.4741483659000519
7295,0.7838,2,8,2,649083,27361,101580,24676,0.2167104929666709,0.47420104925341583
7296,0.7839,1,4,1,649087,27357,101581,24675,0.21667881130401723,0.47422739852398527
7297,0.784,23,28,23,649115,27329,101604,24652,0.21645703966544164,0.47425020680633306
7298,0.7841,1,2,1,649117,27327,101605,24651,0.2164411988341148,0.4742583400669514
7299,0.7842,10,25,10,649142,27302,101615,24641,0.21624318844252946,0.4743853839785919
7300,0.7843,5,11,5,649153,27291,101620,24636,0.2161560638702319,0.4744352648910971
7301,0.7844,1,3,1,649156,27288,101621,24635,0.21613230262324168,0.4744525547445255
7302,0.7845,4,11,4,649167,27277,101625,24631,0.21604517805094411,0.47451259921399397
7303,0.7846,0,2,0,649169,27275,101625,24631,0.21602933721961728,0.47453088274958577
7304,0.7847,1,13,1,649182,27262,101626,24630,0.2159263718159929,0.47463963616742466
7305,0.7848,2,8,2,649190,27254,101628,24628,0.2158630084906856,0.4746925716047955
7306,0.7849,1,1,1,649191,27253,101629,24627,0.21585508807502218,0.4746915959907479
7307,0.785,228,286,228,649477,26967,101857,24399,0.21358984919528576,0.4750029202196005
7308,0.7851,1,1,1,649478,26966,101858,24398,0.21358192877962234,0.4750019468888716
7309,0.7852,3,6,3,649484,26960,101861,24395,0.21353440628564188,0.47502677441339697
7310,0.7853,0,9,0,649493,26951,101861,24395,0.21346312254467115,0.47511003778288474
7311,0.7854,1,2,1,649495,26949,101862,24394,0.21344728171334432,0.4751183218744522
7312,0.7855,2,6,2,649501,26943,101864,24392,0.21339975921936383,0.47515340411025614
7313,0.7856,0,3,0,649504,26940,101864,24392,0.21337599797237358,0.475181173536975
7314,0.7857,5,16,5,649520,26924,101869,24387,0.21324927132175897,0.4752782054530218
7315,0.7858,11,26,11,649546,26898,101880,24376,0.2130433405145102,0.4754066388422982
7316,0.7859,0,2,0,649548,26896,101880,24376,0.21302749968318338,0.47542518333593387
7317,0.786,15,42,15,649590,26854,101895,24361,0.21269484222531998,0.47566142731621597
7318,0.7861,0,1,0,649591,26853,101895,24361,0.21268692180965657,0.47567071503885655
7319,0.7862,4,12,4,649603,26841,101899,24357,0.2125918768216956,0.4757412398921833
7320,0.7863,2,8,2,649611,26833,101901,24355,0.2125285134963883,0.475795108228491
7321,0.7864,2,2,2,649613,26831,101903,24353,0.21251267266506146,0.4757932166301969
7322,0.7865,5,5,5,649618,26826,101908,24348,0.2124730705867444,0.4757884863407199
7323,0.7866,0,1,0,649619,26825,101908,24348,0.21246515017108097,0.4757977839876497
7324,0.7867,97,169,97,649788,26656,102005,24251,0.21112659992396401,0.4763784941167227
7325,0.7868,2,13,2,649801,26643,102007,24249,0.21102363452033962,0.4764796038670125
7326,0.7869,1,0,1,649801,26643,102008,24248,0.21102363452033962,0.47646931677506826
7327,0.787,6,13,6,649814,26630,102014,24242,0.21092066911671525,0.4765293285107721
7328,0.7871,4,3,4,649817,26627,102018,24238,0.210896907869725,0.4765162685540155
7329,0.7872,1,1,1,649818,26626,102019,24237,0.2108889874540616,0.47651534514283467
7330,0.7873,7,15,7,649833,26611,102026,24230,0.21077018121911037,0.47658385948348775
7331,0.7874,0,1,0,649834,26610,102026,24230,0.21076226080344695,0.47659323367427225
7332,0.7875,58,76,58,649910,26534,102084,24172,0.2101603092130275,0.4767088707450795
7333,0.7876,1,4,1,649914,26530,102085,24171,0.21012862755037384,0.47673615905011735
7334,0.7877,2,12,2,649926,26518,102087,24169,0.21003358256241286,0.4768283780851106
7335,0.7878,4,2,4,649928,26516,102091,24165,0.21001774173108606,0.47680590359306246
7336,0.7879,1,2,1,649930,26514,102092,24164,0.21000190089975923,0.4768143967796677
7337,0.788,14,25,14,649955,26489,102106,24150,0.20980389050817386,0.4769051521554533
7338,0.7881,0,3,0,649958,26486,102106,24150,0.20978012926118364,0.4769334070621692
7339,0.7882,2,8,2,649966,26478,102108,24148,0.20971676593587632,0.4769881088768617
7340,0.7883,34,85,34,650051,26393,102142,24114,0.20904353060448613,0.47743877086344466
7341,0.7885,3,9,3,650060,26384,102145,24111,0.2089722468635154,0.4774928210713932
7342,0.7886,3,3,3,650063,26381,102148,24108,0.20894848561652515,0.4774901463685159
7343,0.7887,3,10,3,650073,26371,102151,24105,0.208869281459891,0.47755368888184485
7344,0.7888,1,3,1,650076,26368,102152,24104,0.20884552021290076,0.477571722935489
7345,0.7889,1,6,1,650082,26362,102153,24103,0.2087979977189203,0.4776181511938968
7346,0.789,6,20,6,650102,26342,102159,24097,0.208639589405652,0.47774539542814093
7347,0.7891,0,2,0,650104,26340,102159,24097,0.20862374857432517,0.4777643396712731
7348,0.7892,16,34,16,650138,26306,102175,24081,0.20835445444176912,0.47792089229364715
7349,0.7893,7,10,7,650148,26296,102182,24074,0.20827525028513497,0.47794322017073654
7350,0.7895,3,6,3,650154,26290,102185,24071,0.20822772779115448,0.4779690633625226
7351,0.7896,3,1,3,650155,26289,102188,24068,0.20821980737549106,0.4779474551700856
7352,0.7897,5,8,5,650163,26281,102193,24063,0.20815644405018374,0.477971555696806
7353,0.7898,2,10,2,650173,26271,102195,24061,0.20807723989354962,0.4780457760470476
7354,0.79,1113,1339,1113,651512,24932,103308,22948,0.19747180332023825,0.47928153717627403
7355,0.7901,1,4,1,651516,24928,103309,22947,0.1974401216575846,0.4793107049608355
7356,0.7902,4,10,4,651526,24918,103313,22943,0.19736091750095044,0.47936733457303443
7357,0.7903,4,11,4,651537,24907,103317,22939,0.1972737929286529,0.479434017472725
7358,0.7904,2,5,2,651542,24902,103319,22937,0.19723419085033583,0.4794623633437154
7359,0.7905,5,5,5,651547,24897,103324,22932,0.19719458877201876,0.47945806937213825
7360,0.7906,3,7,3,651554,24890,103327,22929,0.19713914586237485,0.47949559798406494
7361,0.7907,3,17,3,651571,24873,103330,22926,0.19700449879609683,0.4796334651352539
7362,0.7908,15,40,15,651611,24833,103345,22911,0.19668768216956026,0.4798718163538874
7363,0.7909,1,2,1,651613,24831,103346,22910,0.19667184133823343,0.47988102469575417
7364,0.791,6,10,6,651623,24821,103352,22904,0.19659263718159928,0.47991618648507073
7365,0.7911,0,3,0,651626,24818,103352,22904,0.19656887593460906,0.47994635597837476
7366,0.7912,1,12,1,651638,24806,103353,22903,0.19647383094664808,0.48005617388752647
7367,0.7913,4,11,4,651649,24795,103357,22899,0.19638670637435052,0.480123285947918
7368,0.7914,1,7,1,651656,24788,103358,22898,0.19633126346470664,0.48018286289476997
7369,0.7915,4,7,4,651663,24781,103362,22894,0.19627582055506274,0.480209753539591
7370,0.7916,0,2,0,651665,24779,103362,22894,0.1962599797237359,0.4802298995238395
7371,0.7917,44,83,44,651748,24696,103406,22850,0.19560258522367255,0.48058722079670213
7372,0.7918,5,8,5,651756,24688,103411,22845,0.19553922189836523,0.4806134685376475
7373,0.7919,1,0,1,651756,24688,103412,22844,0.19553922189836523,0.48060254144576287
7374,0.792,8,19,8,651775,24669,103420,22836,0.19538873400076037,0.48070729396905587
7375,0.7921,2,2,2,651777,24667,103422,22834,0.19537289316943354,0.4807056693543294
7376,0.7922,2,8,2,651785,24659,103424,22832,0.19530952984412622,0.4807647764839654
7377,0.7923,4,6,4,651791,24653,103428,22828,0.19526200735014573,0.48078178639877006
7378,0.7925,52,75,52,651866,24578,103480,22776,0.1946679761753897,0.48097309625374834
7379,0.7926,0,1,0,651867,24577,103480,22776,0.19466005575972628,0.48098325343695225
7380,0.7927,3,8,3,651875,24569,103483,22773,0.19459669243441896,0.48103164209370114
7381,0.7928,6,6,6,651881,24563,103489,22767,0.19454916994043847,0.48102683287555464
7382,0.7929,4,6,4,651887,24557,103493,22763,0.19450164744645798,0.48104395604395606
7383,0.793,7,15,7,651902,24542,103500,22756,0.19438284121150678,0.48111970907860796
7384,0.7931,1,9,1,651911,24533,103501,22755,0.19431155747053605,0.4812003045170022
7385,0.7932,4,10,4,651921,24523,103505,22751,0.1942323533139019,0.481258196894699
7386,0.7933,88,139,88,652060,24384,103593,22663,0.19313141553668736,0.48170977958212
7387,0.7934,2,5,2,652065,24379,103595,22661,0.1930918134583703,0.48173894557823127
7388,0.7935,3,15,3,652080,24364,103598,22658,0.1929730072234191,0.48185955510186723
7389,0.7936,0,4,0,652084,24360,103598,22658,0.19294132556076543,0.48190054872601984
7390,0.7937,4,6,4,652090,24354,103602,22654,0.19289380306678494,0.48191797140912185
7391,0.7938,2,9,2,652099,24345,103604,22652,0.1928225193258142,0.48198821201353276
7392,0.7939,0,1,0,652100,24344,103604,22652,0.1928145989101508,0.48199846795471957
7393,0.794,16,28,16,652128,24316,103620,22636,0.1925928272715752,0.48210938831146705
7394,0.7941,0,3,0,652131,24313,103620,22636,0.19256906602458498,0.4821401946793329
7395,0.7942,21,37,21,652168,24276,103641,22615,0.19227601064503866,0.4822887121195965
7396,0.7943,9,13,9,652181,24263,103650,22606,0.19217304524141426,0.4823230706863812
7397,0.7944,0,8,0,652189,24255,103650,22606,0.19210968191610694,0.4824054117496426
7398,0.7945,3,7,3,652196,24248,103653,22603,0.19205423900646307,0.48244434483789034
7399,0.7946,1,0,1,652196,24248,103654,22602,0.19205423900646307,0.48243329775880467
7400,0.7947,6,7,6,652203,24241,103660,22596,0.19199879609681916,0.4824390972948737
7401,0.7948,4,10,4,652213,24231,103664,22592,0.191919591940185,0.48249791769002415
7402,0.7949,1,1,1,652214,24230,103665,22591,0.1919116715245216,0.4824971700732577
7403,0.795,189,275,189,652489,23955,103854,22402,0.18973355721708277,0.48324956317276785
7404,0.7951,0,3,0,652492,23952,103854,22402,0.18970979597009252,0.48328083876256633
7405,0.7952,2,15,2,652507,23937,103856,22400,0.1895909897351413,0.4834149815482228
7406,0.7953,2,7,2,652514,23930,103858,22398,0.1895355468254974,0.48346572267311344
7407,0.7955,1,12,1,652526,23918,103859,22397,0.18944050183753644,0.4835798337471661
7408,0.7956,1,3,1,652529,23915,103860,22396,0.1894167405905462,0.48360000863725683
7409,0.7957,4,8,4,652537,23907,103864,22392,0.18935337726523888,0.4836389554849997
7410,0.7958,6,28,6,652565,23879,103870,22386,0.18913160562666329,0.48386469253215175
7411,0.7959,0,3,0,652568,23876,103870,22386,0.18910784437967304,0.4838960702088107
7412,0.796,15,28,15,652596,23848,103885,22371,0.18888607274109745,0.4840217226681668
7413,0.7961,0,3,0,652599,23845,103885,22371,0.1888623114941072,0.4840531417690843
7414,0.7962,2,10,2,652609,23835,103887,22369,0.18878310733747308,0.48413557267769025
7415,0.7963,1,11,1,652620,23824,103888,22368,0.18869598276517552,0.48423969518531346
7416,0.7964,0,1,0,652621,23823,103888,22368,0.1886880623495121,0.484250178606222
7417,0.7965,2,5,2,652626,23818,103890,22366,0.18864846027119503,0.484280270223454
7418,0.7966,0,1,0,652627,23817,103890,22366,0.1886405398555316,0.4842907563389126
7419,0.7967,105,137,105,652764,23680,103995,22261,0.1875554429096439,0.48455627870529594
7420,0.7968,4,7,4,652771,23673,103999,22257,0.1875,0.48458523840627044
7421,0.7969,2,2,2,652773,23671,104001,22255,0.18748415916867317,0.48458389583242606
7422,0.797,4,13,4,652786,23658,104005,22251,0.1873811937650488,0.48467620727961835
7423,0.7971,1,2,1,652788,23656,104006,22250,0.18736535293372197,0.48468609767786347
7424,0.7972,0,4,0,652792,23652,104006,22250,0.1873336712710683,0.48472833427737355
7425,0.7973,1,10,1,652802,23642,104007,22249,0.18725446711443416,0.4848227321261249
7426,0.7974,1,1,1,652803,23641,104008,22248,0.18724654669877075,0.48482207064873933
7427,0.7975,49,86,49,652889,23555,104057,22199,0.18656539095171715,0.48518162346461513
7428,0.7976,0,2,0,652891,23553,104057,22199,0.18654955012039032,0.485202832663053
7429,0.7977,4,16,4,652907,23537,104061,22195,0.1864228234697757,0.48532756057027904
7430,0.7978,1,9,1,652916,23528,104062,22194,0.18635153972880497,0.485411836752548
7431,0.7979,0,1,0,652917,23527,104062,22194,0.18634361931314156,0.4854224535771309
7432,0.798,14,31,14,652948,23496,104076,22180,0.18609808642757572,0.48559418513004643
7433,0.7981,0,7,0,652955,23489,104076,22180,0.18604264351793182,0.48566861547220214
7434,0.7982,2,16,2,652971,23473,104078,22178,0.1859159168673172,0.48581630194300235
7435,0.7983,35,71,35,653042,23402,104113,22143,0.1853535673552148,0.48617850477549673
7436,0.7984,0,2,0,653044,23400,104113,22143,0.18533772652388797,0.4861998550820104
7437,0.7985,4,10,4,653054,23390,104117,22139,0.18525852236725385,0.4862615036570098
7438,0.7986,1,2,1,653056,23388,104118,22138,0.18524268153592702,0.4862715810745508
7439,0.7987,8,6,8,653062,23382,104126,22130,0.18519515904194653,0.486245385832308
7440,0.7988,3,8,3,653070,23374,104129,22127,0.1851317957166392,0.4862970044614404
7441,0.7989,3,9,3,653079,23365,104132,22124,0.18506051197566847,0.4863593396205676
7442,0.799,11,21,11,653100,23344,104143,22113,0.1848941832467368,0.4864597311745166
7443,0.7991,1,0,1,653100,23344,104144,22112,0.1848941832467368,0.4864484336501232
7444,0.7992,7,21,7,653121,23323,104151,22105,0.1847278545178051,0.4865941709958616
7445,0.7993,9,13,9,653134,23310,104160,22096,0.1846248891141807,0.4866317226798221
7446,0.7995,2,3,2,653137,23307,104162,22094,0.18460112786719046,0.48664126340829494
7447,0.7996,0,2,0,653139,23305,104162,22094,0.18458528703586363,0.486662701821626
7448,0.7997,1,11,1,653150,23294,104163,22093,0.1844981624635661,0.48676933923810783
7449,0.7998,2,10,2,653160,23284,104165,22091,0.18441895830693195,0.4868539944903581
7450,0.7999,2,3,2,653163,23281,104167,22089,0.1843951970599417,0.48686356623319377
7451,0.8,1029,1254,1029,654417,22027,105196,21060,0.17446299581802052,0.48877851788242394
7452,0.8001,4,5,4,654422,22022,105200,21056,0.17442339373970345,0.48878778030549236
7453,0.8002,2,9,2,654431,22013,105202,21054,0.17435210999873274,0.4888661852462442
7454,0.8003,4,5,4,654436,22008,105206,21050,0.17431250792041567,0.48887547029587997
7455,0.8004,1,2,1,654438,22006,105207,21049,0.17429666708908884,0.4888863082104285
7456,0.8005,2,6,2,654444,22000,105209,21047,0.17424914459510835,0.48893070364949937
7457,0.8006,0,3,0,654447,21997,105209,21047,0.1742253833481181,0.48896478022488615
7458,0.8007,6,9,6,654456,21988,105215,21041,0.1741540996071474,0.48899579353459294
7459,0.8008,11,20,11,654476,21968,105226,21030,0.1739956912938791,0.4890925159309735
7460,0.8009,1,3,1,654479,21965,105227,21029,0.17397193004688885,0.48911476019909755
7461,0.801,9,18,9,654497,21947,105236,21020,0.1738293625649474,0.48921265156980936
7462,0.8011,1,2,1,654499,21945,105237,21019,0.17381352173362058,0.4892235359836142
7463,0.8012,1,10,1,654509,21935,105238,21018,0.17373431757698643,0.48932554187134775
7464,0.8013,4,13,4,654522,21922,105242,21014,0.17363135217336206,0.4894261226010807
7465,0.8014,1,4,1,654526,21918,105243,21013,0.1735996705107084,0.4894598308914304
7466,0.8015,4,13,4,654539,21905,105247,21009,0.173496705107084,0.4895605163816004
7467,0.8017,32,83,32,654622,21822,105279,20977,0.17283931060702065,0.49012827402509407
7468,0.8018,6,5,6,654627,21817,105285,20971,0.17279970852870358,0.4901140506684117
7469,0.8019,1,2,1,654629,21815,105286,20970,0.17278386769737675,0.49012504382377003
7470,0.802,10,20,10,654649,21795,105296,20960,0.17262545938410848,0.4902350602268741
7471,0.8021,0,3,0,654652,21792,105296,20960,0.17260169813711823,0.4902694610778443
7472,0.8022,1,7,1,654659,21785,105297,20959,0.17254625522747433,0.49033782519183977
7473,0.8023,5,11,5,654670,21774,105302,20954,0.1724591306551768,0.49040441864819323
7474,0.8024,0,1,0,654671,21773,105302,20954,0.17245121023951338,0.4904158962716783
7475,0.8025,42,66,42,654737,21707,105344,20912,0.17192846280572804,0.49067317393650717
7476,0.8026,0,9,0,654746,21698,105344,20912,0.1718571790647573,0.4907768129547055
7477,0.8027,2,18,2,654764,21680,105346,20910,0.17171461158281587,0.4909603193237849
7478,0.8028,2,3,2,654767,21677,105348,20908,0.17169085033582562,0.4909709991781144
7479,0.8029,1,3,1,654770,21674,105349,20907,0.17166708908883538,0.49099363565909676
7480,0.803,6,16,6,654786,21658,105355,20901,0.17154036243822077,0.49110646396766844
7481,0.8032,0,6,0,654792,21652,105355,20901,0.17149283994424028,0.4911757102906963
7482,0.8033,98,142,98,654934,21510,105453,20803,0.1703681409200355,0.49164559355280885
7483,0.8034,0,3,0,654937,21507,105453,20803,0.17034437967304525,0.49168045379342945
7484,0.8035,4,8,4,654945,21499,105457,20799,0.17028101634773793,0.4917253770863871
7485,0.8036,1,2,1,654947,21497,105458,20798,0.1702651755164111,0.4917366118926587
7486,0.8037,4,7,4,654954,21490,105462,20794,0.1702097326067672,0.4917699366190521
7487,0.8038,3,6,3,654960,21484,105465,20791,0.17016221011278673,0.49180366646954465
7488,0.8039,0,3,0,654963,21481,105465,20791,0.1701384488657965,0.4918385692657078
7489,0.804,19,25,19,654988,21456,105484,20772,0.16994043847421111,0.4919011082693947
7490,0.8042,15,28,15,655016,21428,105499,20757,0.16971866683563552,0.4920469361147327
7491,0.8043,7,13,7,655029,21415,105506,20750,0.16961570143201116,0.4921143128186885
7492,0.8044,0,3,0,655032,21412,105506,20750,0.1695919401850209,0.49214932877946965
7493,0.8045,2,6,2,655038,21406,105508,20748,0.16954441769104042,0.4921952839588177
7494,0.8046,1,1,1,655039,21405,105509,20747,0.169536497275377,0.4921949136458531
7495,0.8047,9,11,9,655050,21394,105518,20738,0.16944937270307947,0.4922149435108706
7496,0.8048,3,5,3,655055,21389,105521,20735,0.1694097706247624,0.4922372044440224
7497,0.8049,0,2,0,655057,21387,105521,20735,0.16939392979343557,0.49226057642087273
7498,0.805,186,276,186,655333,21111,105707,20549,0.1672078950703333,0.49325492078732597
7499,0.8051,0,1,0,655334,21110,105707,20549,0.16719997465466988,0.49326676108403944
7500,0.8052,1,3,1,655337,21107,105708,20548,0.16717621340767963,0.4932901212339455
7501,0.8053,7,11,7,655348,21096,105715,20541,0.1670890888353821,0.49333525470134737
7502,0.8054,1,3,1,655351,21093,105716,20540,0.16706532758839185,0.49335863377609107
7503,0.8055,3,7,3,655358,21086,105719,20537,0.16700988467874794,0.49340508853278237
7504,0.8056,3,4,3,655362,21082,105722,20534,0.16697820301609428,0.4934159938485198
7505,0.8057,5,13,5,655375,21069,105727,20529,0.1668752376124699,0.49350930333189097
7506,0.8058,13,34,13,655409,21035,105740,20516,0.16660594347991384,0.49375466294433346
7507,0.8059,1,2,1,655411,21033,105741,20515,0.166590102648587,0.49376624626937515
7508,0.806,24,43,24,655454,20990,105765,20491,0.1662495247750602,0.49398519804247726
7509,0.8061,1,5,1,655459,20985,105766,20490,0.16620992269674312,0.49403254972875227
7510,0.8062,2,8,2,655467,20977,105768,20488,0.16614655937143583,0.49410346075003014
7511,0.8063,3,9,3,655476,20968,105771,20485,0.1660752756304651,0.4941741249125516
7512,0.8064,0,1,0,655477,20967,105771,20485,0.16606735521480168,0.4941860465116279
7513,0.8065,6,11,6,655488,20956,105777,20479,0.1659802306425041,0.49424399662121393
7514,0.8067,100,122,100,655610,20834,105877,20379,0.1650139399315676,0.4944798971198408
7515,0.8068,2,7,2,655617,20827,105879,20377,0.16495849702192372,0.4945393651101835
7516,0.807,7,11,7,655628,20816,105886,20370,0.16487137244962616,0.494585538775312
7517,0.8071,4,5,4,655633,20811,105890,20366,0.16483177037130908,0.49459649804502515
7518,0.8072,0,12,0,655645,20799,105890,20366,0.16473672538334813,0.4947406777602332
7519,0.8073,6,8,6,655653,20791,105896,20360,0.1646733620580408,0.49476318922990936
7520,0.8074,0,1,0,655654,20790,105896,20360,0.1646654416423774,0.494775212636695
7521,0.8075,49,76,49,655730,20714,105945,20311,0.16406349005195792,0.4950883607556368
7522,0.8076,0,6,0,655736,20708,105945,20311,0.16401596755797745,0.4951607791511251
7523,0.8077,4,13,4,655749,20695,105949,20307,0.16391300215435306,0.4952685234866592
7524,0.8078,0,7,0,655756,20688,105949,20307,0.16385755924470916,0.49535309184046833
7525,0.8079,0,2,0,655758,20686,105949,20307,0.16384171841338233,0.49537725953211525
7526,0.808,9,18,9,655776,20668,105958,20298,0.16369915093144088,0.49548405995215544
7527,0.8081,2,4,2,655780,20664,105960,20296,0.16366746926878722,0.4955078125
7528,0.8082,0,4,0,655784,20660,105960,20296,0.16363578760613356,0.49555620666080674
7529,0.8083,35,53,35,655837,20607,105995,20261,0.16321600557597263,0.49576685915630814
7530,0.8084,0,1,0,655838,20606,105995,20261,0.1632080851603092,0.495778990383439
7531,0.8085,6,7,6,655845,20599,106001,20255,0.1631526422506653,0.4957898859352817
7532,0.8086,1,3,1,655848,20596,106002,20254,0.16312888100367506,0.4958139534883721
7533,0.8087,8,8,8,655856,20588,106010,20246,0.16306551767836777,0.4958123132683548
7534,0.8088,2,7,2,655863,20581,106012,20244,0.16301007476872387,0.49587262706674834
7535,0.8089,0,1,0,655864,20580,106012,20244,0.16300215435306045,0.49588477366255146
7536,0.809,8,17,8,655881,20563,106020,20236,0.1628675072867824,0.4959925488369813
7537,0.8091,0,1,0,655882,20562,106020,20236,0.16285958687111898,0.49600470611304476
7538,0.8092,7,20,7,655902,20542,106027,20229,0.1627011785578507,0.4961614873316818
7539,0.8093,5,8,5,655910,20534,106032,20224,0.1626378152325434,0.49619706560675203
7540,0.8094,3,7,3,655917,20527,106035,20221,0.16258237232289952,0.4962452144890547
7541,0.8095,2,6,2,655923,20521,106037,20219,0.16253484982891903,0.49629356897398136
7542,0.8096,2,1,2,655924,20520,106039,20217,0.1625269294132556,0.49628102216658077
7543,0.8097,4,8,4,655932,20512,106043,20213,0.1624635660879483,0.49632903621853897
7544,0.8098,3,8,3,655940,20504,106046,20210,0.16240020276264097,0.49638944834700593
7545,0.8099,0,5,0,655945,20499,106046,20210,0.16236060068432392,0.4964504163698445
7546,0.81,1041,1206,1041,657151,19293,107087,19169,0.1528085793942466,0.49838801934376786
7547,0.8101,2,2,2,657153,19291,107089,19167,0.15279273856291978,0.4983878516823548
7548,0.8102,3,2,3,657155,19289,107092,19164,0.15277689773159295,0.4983746391698957
7549,0.8103,3,7,3,657162,19282,107095,19161,0.15272145482194904,0.4984262414483781
7550,0.8104,0,1,0,657163,19281,107095,19161,0.15271353440628563,0.49843920711721557
7551,0.8105,3,9,3,657172,19272,107098,19158,0.15264225066531492,0.4985167837626854
7552,0.8106,2,2,2,657174,19270,107100,19156,0.1526264098339881,0.49851662936553376
7553,0.8107,9,11,9,657185,19259,107109,19147,0.15253928526169053,0.4985418944956517
7554,0.8108,10,25,10,657210,19234,107119,19137,0.15234127487010518,0.4987360246019129
7555,0.8109,1,0,1,657210,19234,107120,19136,0.15234127487010518,0.4987229606463383
7556,0.811,5,12,5,657222,19222,107125,19131,0.1522462298821442,0.4988136521263004
7557,0.8111,0,4,0,657226,19218,107125,19131,0.15221454821949057,0.49886568098255496
7558,0.8112,1,5,1,657231,19213,107126,19130,0.1521749461411735,0.4989176642411913
7559,0.8113,7,14,7,657245,19199,107133,19123,0.15206406032188569,0.49900840248421274
7560,0.8114,0,1,0,657246,19198,107133,19123,0.15205613990622227,0.49902142428433494
7561,0.8115,2,8,2,657254,19190,107135,19121,0.15199277658091498,0.4990994753465062
7562,0.8116,0,4,0,657258,19186,107135,19121,0.15196109491826132,0.4991515910930117
7563,0.8117,41,59,41,657317,19127,107176,19080,0.1514937903941199,0.49938492946318735
7564,0.8118,6,12,6,657329,19115,107182,19074,0.1513987454061589,0.49946319620833224
7565,0.8119,1,1,1,657330,19114,107183,19073,0.1513908249904955,0.49946316809385394
7566,0.812,13,23,13,657353,19091,107196,19060,0.15120865543023698,0.49959371969279964
7567,0.8121,4,3,4,657356,19088,107200,19056,0.15118489418324674,0.49958053691275167
7568,0.8122,2,4,2,657360,19084,107202,19054,0.15115321252059308,0.4996066914888038
7569,0.8123,2,2,2,657362,19082,107204,19052,0.15113737168926625,0.4996066502333875
7570,0.8124,1,10,1,657372,19072,107205,19051,0.15105816753263213,0.49972457571544737
7571,0.8125,35,62,35,657434,19010,107240,19016,0.15056710176150045,0.500078893388734
7572,0.8126,0,1,0,657435,19009,107240,19016,0.15055918134583704,0.5000920447074293
7573,0.8127,7,14,7,657449,18995,107247,19009,0.15044829552654923,0.500184191137775
7574,0.8128,2,5,2,657454,18990,107249,19007,0.15040869344823216,0.5002237018712004
7575,0.8129,7,1,7,657455,18989,107256,19000,0.15040077303256874,0.5001447787517439
7576,0.813,7,11,7,657466,18978,107263,18993,0.1503136484602712,0.5001975191593585
7577,0.8131,3,2,3,657468,18976,107266,18990,0.15029780762894437,0.500184375493863
7578,0.8132,5,4,5,657472,18972,107271,18985,0.15026612596629071,0.5001712464104118
7579,0.8133,89,147,89,657619,18825,107360,18896,0.14910182486376886,0.5009411203308501
7580,0.8134,1,3,1,657622,18822,107361,18895,0.1490780636167786,0.5009677333828247
7581,0.8135,1,6,1,657628,18816,107362,18894,0.14903054112279812,0.5010342084327765
7582,0.8136,0,4,0,657632,18812,107362,18894,0.14899885946014446,0.5010873601018405
7583,0.8137,1,6,1,657638,18806,107363,18893,0.14895133696616397,0.5011538767606568
7584,0.8138,4,12,4,657650,18794,107367,18889,0.14885629197820302,0.5012605153517501
7585,0.8139,3,4,3,657654,18790,107370,18886,0.14882461031554936,0.5012740205966663
7586,0.814,23,41,23,657695,18749,107393,18863,0.14849987327334938,0.5015154737849622
7587,0.8141,0,1,0,657696,18748,107393,18863,0.14849195285768596,0.5015288080614714
7588,0.8142,11,27,11,657723,18721,107404,18852,0.14827810163477378,0.5017432730950416
7589,0.8143,5,14,5,657737,18707,107409,18847,0.148167215815486,0.5018639825318209
7590,0.8144,1,5,1,657742,18702,107410,18846,0.14812761373716893,0.5019175455417066
7591,0.8145,1,5,1,657747,18697,107411,18845,0.14808801165885185,0.5019711256725801
7592,0.8146,1,1,1,657748,18696,107412,18844,0.14808009124318844,0.5019712306872669
7593,0.8147,5,15,5,657763,18681,107417,18839,0.14796128500823724,0.5021055437100214
7594,0.8148,2,5,2,657768,18676,107419,18837,0.14792168292992017,0.5021459227467812
7595,0.8149,1,0,1,657768,18676,107420,18836,0.14792168292992017,0.5021326508850501
7596,0.815,166,246,166,658014,18430,107586,18670,0.1459732606767203,0.5032345013477089
7597,0.8151,2,2,2,658016,18428,107588,18668,0.14595741984539348,0.5032348501186111
7598,0.8152,0,7,0,658023,18421,107588,18668,0.14590197693574958,0.503329828250964
7599,0.8153,3,7,3,658030,18414,107591,18665,0.1458465340261057,0.5033846651743574
7600,0.8154,1,4,1,658034,18410,107592,18664,0.14581485236345204,0.5034255812698927
7601,0.8155,1,2,1,658036,18408,107593,18663,0.1457990115321252,0.5034393461196083
7602,0.8156,0,2,0,658038,18406,107593,18663,0.14578317070079838,0.503466508403248
7603,0.8157,4,8,4,658046,18398,107597,18659,0.14571980737549106,0.5035216018565993
7604,0.8158,6,20,6,658066,18378,107603,18653,0.1455613990622228,0.5037131052361535
7605,0.816,18,31,18,658097,18347,107621,18635,0.14531586617665695,0.503893786166243
7606,0.8161,0,2,0,658099,18345,107621,18635,0.14530002534533012,0.5039210383991347
7607,0.8162,4,7,4,658106,18338,107625,18631,0.14524458243568622,0.5039627796261733
7608,0.8163,5,8,5,658114,18330,107630,18626,0.1451812191103789,0.5040047624201753
7609,0.8164,1,2,1,658116,18328,107631,18625,0.14516537827905207,0.5040186182447974
7610,0.8165,3,2,3,658118,18326,107634,18622,0.14514953744772527,0.5040056295333983
7611,0.8166,1,3,1,658121,18323,107635,18621,0.14512577620073502,0.5040331312256388
7612,0.8167,105,138,105,658259,18185,107740,18516,0.14403275883918387,0.5045094139124274
7613,0.8168,1,10,1,658269,18175,107741,18515,0.14395355468254975,0.5046334150994821
7614,0.8169,3,6,3,658275,18169,107744,18512,0.14390603218856926,0.5046754450532973
7615,0.817,3,15,3,658290,18154,107747,18509,0.14378722595361804,0.5048413932302321
7616,0.8171,2,3,2,658293,18151,107749,18507,0.1437634647066278,0.5048556931638387
7617,0.8172,2,5,2,658298,18146,107751,18505,0.14372386262831074,0.5048975471337753
7618,0.8173,3,7,3,658305,18139,107754,18502,0.14366841971866684,0.504953467427199
7619,0.8174,2,2,2,658307,18137,107756,18500,0.14365257888734,0.504954008243033
7620,0.8175,35,67,35,658374,18070,107791,18465,0.14312191103789126,0.5054057752839742
7621,0.8176,1,1,1,658375,18069,107792,18464,0.14311399062222785,0.5054060712232776
7622,0.8177,3,7,3,658382,18062,107795,18461,0.14305854771258394,0.5054623114202009
7623,0.8178,2,4,2,658386,18058,107797,18459,0.1430268660499303,0.5054905934222417
7624,0.8179,2,3,2,658389,18055,107799,18457,0.14300310480294007,0.5055050394390885
7625,0.818,12,16,12,658405,18039,107811,18445,0.14287637815232543,0.5055640828856485
7626,0.8181,0,1,0,658406,18038,107811,18445,0.142868457736662,0.5055779404106022
7627,0.8182,5,13,5,658419,18025,107816,18440,0.14276549233303765,0.5056903880433292
7628,0.8183,35,64,35,658483,17961,107851,18405,0.14225858573057915,0.506104603200792
7629,0.8184,3,2,3,658485,17959,107854,18402,0.14224274489925232,0.5060916916476444
7630,0.8185,1,7,1,658492,17952,107855,18401,0.1421873019896084,0.5061755563502325
7631,0.8186,1,4,1,658496,17948,107856,18400,0.14215562032695475,0.5062176735996479
7632,0.8187,7,9,7,658505,17939,107863,18393,0.14208433658598404,0.5062479357040626
7633,0.8188,4,6,4,658511,17933,107867,18389,0.14203681409200355,0.5062771873795496
7634,0.8189,0,4,0,658515,17929,107867,18389,0.1420051324293499,0.5063329478495512
7635,0.819,2,16,2,658531,17913,107869,18387,0.14187840577873526,0.5065289256198348
7636,0.8191,0,1,0,658532,17912,107869,18387,0.14187048536307184,0.5065428799691452
7637,0.8192,12,18,12,658550,17894,107881,18375,0.1417279178811304,0.5066310071962282
7638,0.8193,11,11,11,658561,17883,107892,18364,0.14164079330883284,0.506635031864706
7639,0.8194,2,1,2,658562,17882,107894,18362,0.14163287289316942,0.5066217856748704
7640,0.8195,3,5,3,658567,17877,107897,18359,0.14159327081485237,0.5066508444640688
7641,0.8196,2,2,2,658569,17875,107899,18357,0.14157742998352554,0.5066515787149481
7642,0.8197,1,11,1,658580,17864,107900,18356,0.14149030541122798,0.5067918277194919
7643,0.8198,3,11,3,658591,17853,107903,18353,0.14140318083893041,0.5069049328840524
7644,0.8199,1,3,1,658594,17850,107904,18352,0.1413794195919402,0.5069333186011823
7645,0.82,1052,1144,1052,659738,16706,108956,17300,0.13231846407299455,0.5087337528671411
7646,0.8201,2,0,2,659738,16706,108958,17298,0.13231846407299455,0.5087048582519703
7647,0.8202,5,6,5,659744,16700,108963,17293,0.13227094157901406,0.5087223840202395
7648,0.8203,1,2,1,659746,16698,108964,17292,0.13225510074768723,0.5087378640776699
7649,0.8204,0,2,0,659748,16696,108964,17292,0.1322392599163604,0.5087678004001412
7650,0.8205,3,2,3,659750,16694,108967,17289,0.13222341908503357,0.5087543771885943
7651,0.8206,1,4,1,659754,16690,108968,17288,0.13219173742237994,0.5087998116428277
7652,0.8207,7,8,7,659762,16682,108975,17281,0.13212837409707262,0.5088184200453435
7653,0.8208,10,20,10,659782,16662,108985,17271,0.13196996578380432,0.5089735655556538
7654,0.8209,3,1,3,659783,16661,108988,17268,0.1319620453681409,0.5089451501665242
7655,0.821,3,19,3,659802,16642,108991,17265,0.13181155747053605,0.5091868935618014
7656,0.8211,0,1,0,659803,16641,108991,17265,0.13180363705487264,0.5092019111661653
7657,0.8212,1,4,1,659807,16637,108992,17264,0.13177195539221898,0.5092475148225716
7658,0.8213,4,3,4,659810,16634,108996,17260,0.13174819414522873,0.509234672803446
7659,0.8214,1,2,1,659812,16632,108997,17259,0.1317323533139019,0.5092502434274586
7660,0.8215,2,3,2,659815,16629,108999,17257,0.13170859206691168,0.5092663636900194
7661,0.8216,1,0,1,659815,16629,109000,17256,0.13170859206691168,0.5092518813634351
7662,0.8217,32,56,32,659871,16573,109032,17224,0.13126504878976047,0.5096310323401485
7663,0.8218,0,9,0,659880,16564,109032,17224,0.13119376504878977,0.509766781105718
7664,0.8219,2,8,2,659888,16556,109034,17222,0.13113040172348245,0.5098584877731067
7665,0.822,11,21,11,659909,16535,109045,17211,0.13096407299455076,0.5100160018965211
7666,0.8221,0,1,0,659910,16534,109045,17211,0.13095615257888735,0.5100311157208476
7667,0.8222,0,2,0,659912,16532,109045,17211,0.13094031174756052,0.51006134605696
7668,0.8223,3,11,3,659923,16521,109048,17208,0.13085318717526295,0.5101841145601708
7669,0.8224,0,1,0,659924,16520,109048,17208,0.13084526675959954,0.5101992409867173
7670,0.8225,31,56,31,659980,16464,109079,17177,0.13040172348244836,0.5105971879551737
7671,0.8226,1,2,1,659982,16462,109080,17176,0.13038588265112153,0.5106129972055413
7672,0.8227,5,8,5,659990,16454,109085,17171,0.1303225193258142,0.5106617100371748
7673,0.8228,2,3,2,659993,16451,109087,17169,0.130298758078824,0.5106781677572874
7674,0.8229,1,4,1,659997,16447,109088,17168,0.13026707641617033,0.5107243789974714
7675,0.823,9,8,9,660005,16439,109097,17159,0.130203713090863,0.5107149235073516
7676,0.8232,4,3,4,660008,16436,109101,17155,0.13017995184387277,0.5107022714417553
7677,0.8233,82,131,82,660139,16305,109183,17073,0.12914237739196552,0.5115045838576308
7678,0.8234,0,5,0,660144,16300,109183,17073,0.12910277531364847,0.5115812183501633
7679,0.8235,2,5,2,660149,16295,109185,17071,0.1290631732353314,0.5116286039681113
7680,0.8236,3,2,3,660151,16293,109188,17068,0.12904733240400457,0.511615359251821
7681,0.8237,10,8,10,660159,16285,109198,17058,0.12898396907869725,0.5115916384248568
7682,0.8238,2,7,2,660166,16278,109200,17056,0.12892852616905334,0.5116697666046679
7683,0.8239,1,0,1,660166,16278,109201,17055,0.12892852616905334,0.5116551165511655
7684,0.824,16,29,16,660195,16249,109217,17039,0.12869883411481434,0.5118661379476087
7685,0.8241,1,2,1,660197,16247,109218,17038,0.1286829932834875,0.5118822292323869
7686,0.8242,16,22,16,660219,16225,109234,17022,0.1285087441388924,0.5119860438535808
7687,0.8243,5,13,5,660232,16212,109239,17017,0.12840577873526804,0.5121129134190014
7688,0.8244,0,1,0,660233,16211,109239,17017,0.12839785831960462,0.5121283255086072
7689,0.8245,4,3,4,660236,16208,109243,17013,0.12837409707261438,0.5121158303482737
7690,0.8246,2,6,2,660242,16202,109245,17011,0.1283265745786339,0.5121789660675037
7691,0.8247,1,9,1,660251,16193,109246,17010,0.12825529083766316,0.5123031051411017
7692,0.8248,4,8,4,660259,16185,109250,17006,0.12819192751235584,0.512367810551053
7693,0.8249,2,0,2,660259,16185,109252,17004,0.12819192751235584,0.5123384253819037
7694,0.825,177,214,177,660473,15971,109429,16827,0.12649695856038526,0.5130495761936703
7695,0.8251,0,1,0,660474,15970,109429,16827,0.12648903814472184,0.5130652193798213
7696,0.8252,3,9,3,660483,15961,109432,16824,0.1264177544037511,0.5131615067866402
7697,0.8253,1,1,1,660484,15960,109433,16823,0.1264098339880877,0.5131623097337035
7698,0.8254,3,3,3,660487,15957,109436,16820,0.12638607274109745,0.5131647191628276
7699,0.8255,1,9,1,660496,15948,109437,16819,0.12631478900012671,0.5132908108767967
7700,0.8256,2,5,2,660501,15943,109439,16817,0.12627518692180967,0.5133394383394383
7701,0.8257,2,9,2,660510,15934,109441,16815,0.12620390318083893,0.5134507923906073
7702,0.8258,5,19,5,660529,15915,109446,16810,0.12605341528323408,0.5136745607333842
7703,0.826,16,31,16,660560,15884,109462,16794,0.12580788239766824,0.5139237407430075
7704,0.8261,0,1,0,660561,15883,109462,16794,0.12579996198200483,0.5139394681274291
7705,0.8262,4,7,4,660568,15876,109466,16790,0.12574451907236092,0.5139900814302333
7706,0.8263,3,3,3,660571,15873,109469,16787,0.12572075782537068,0.5139926515615432
7707,0.8264,0,1,0,660572,15872,109469,16787,0.12571283740970726,0.5140083897241189
7708,0.8265,4,11,4,660583,15861,109473,16783,0.1256257128374097,0.5141220438671732
7709,0.8266,1,2,1,660585,15859,109474,16782,0.12560987200608287,0.5141386599675255
7710,0.8267,87,107,87,660692,15752,109561,16695,0.12476238753009758,0.5145313896508151
7711,0.8268,3,0,3,660692,15752,109564,16692,0.12476238753009758,0.514486499815066
7712,0.8269,0,2,0,660694,15750,109564,16692,0.12474654669877075,0.5145182171259478
7713,0.827,8,9,8,660703,15741,109572,16684,0.12467526295780003,0.5145412490362374
7714,0.8271,3,2,3,660705,15739,109575,16681,0.1246594221264732,0.5145280690931524
7715,0.8272,2,2,2,660707,15737,109577,16679,0.12464358129514637,0.5145298617966436
7716,0.8273,6,15,6,660722,15722,109583,16673,0.12452477506019516,0.5146781910788703
7717,0.8274,0,1,0,660723,15721,109583,16673,0.12451685464453174,0.51469407915046
7718,0.8275,32,70,32,660793,15651,109615,16641,0.12396242554809277,0.5153288740245262
7719,0.8276,2,1,2,660794,15650,109617,16639,0.12395450513242935,0.5153148130942427
7720,0.8277,0,12,0,660806,15638,109617,16639,0.12385946014446839,0.515506397744524
7721,0.8278,2,3,2,660809,15635,109619,16637,0.12383569889747814,0.5155242935052058
7722,0.8279,3,3,3,660812,15632,109622,16634,0.1238119376504879,0.5155271803136429
7723,0.828,10,23,10,660835,15609,109632,16624,0.12362976809022938,0.5157447336580523
7724,0.8282,4,9,4,660844,15600,109636,16620,0.12355848434925865,0.515828677839851
7725,0.8283,29,37,29,660881,15563,109665,16591,0.12326542896971233,0.5159855694470361
7726,0.8284,3,4,3,660885,15559,109668,16588,0.12323374730705867,0.5160046038510592
7727,0.8285,3,5,3,660890,15554,109671,16585,0.1231941452287416,0.5160397025420829
7728,0.8286,3,1,3,660891,15553,109674,16582,0.12318622481307819,0.516010580364089
7729,0.8287,4,2,4,660893,15551,109678,16578,0.12317038398175137,0.5159824457655078
7730,0.8288,3,5,3,660898,15546,109681,16575,0.1231307819034343,0.5160175586065191
7731,0.8289,0,4,0,660902,15542,109681,16575,0.12309910024078063,0.5160818258243298
7732,0.829,7,21,7,660923,15521,109688,16568,0.12293277151184895,0.5163140016828197
7733,0.8291,1,3,1,660926,15518,109689,16567,0.1229090102648587,0.5163472027427146
7734,0.8292,11,14,11,660940,15504,109700,16556,0.12279812444557091,0.516406737367436
7735,0.8293,8,12,8,660952,15492,109708,16548,0.12270307945760993,0.5164794007490636
7736,0.8294,0,1,0,660953,15491,109708,16548,0.12269515904194653,0.5164955210836792
7737,0.8295,3,4,3,660957,15487,109711,16545,0.12266347737929287,0.5165147352647352
7738,0.8296,1,8,1,660965,15479,109712,16544,0.12260011405398555,0.5166286731411798
7739,0.8297,3,12,3,660977,15467,109715,16541,0.12250506906602458,0.516777055736066
7740,0.8298,3,4,3,660981,15463,109718,16538,0.12247338740337092,0.5167963501140589
7741,0.83,983,998,983,661979,14465,110701,15555,0.11456881257128373,0.5181545636242505
7742,0.8301,0,1,0,661980,14464,110701,15555,0.11456089215562033,0.518171824511143
7743,0.8302,2,3,2,661983,14461,110703,15553,0.11453713090863009,0.5181915106283734
7744,0.8303,2,2,2,661985,14459,110705,15551,0.11452129007730326,0.5181939353548817
7745,0.8305,1,4,1,661989,14455,110706,15550,0.1144896084146496,0.5182469588401933
7746,0.8306,0,2,0,661991,14453,110706,15550,0.11447376758332277,0.518281505182815
7747,0.8307,1,7,1,661998,14446,110707,15549,0.11441832467367888,0.5183863977329555
7748,0.8308,15,25,15,662023,14421,110722,15534,0.11422031428209352,0.5185778668002003
7749,0.8309,2,3,2,662026,14418,110724,15532,0.11419655303510329,0.5185976627712855
7750,0.831,4,20,4,662046,14398,110728,15528,0.114038144721835,0.5188799037626145
7751,0.8311,0,2,0,662048,14396,110728,15528,0.11402230389050817,0.5189145836118166
7752,0.8312,3,5,3,662053,14391,110731,15525,0.1139827018121911,0.5189530685920578
7753,0.8313,1,9,1,662062,14382,110732,15524,0.11391141807122038,0.5190931585634989
7754,0.8314,1,1,1,662063,14381,110733,15523,0.11390349765555696,0.5190944355270198
7755,0.8315,3,6,3,662069,14375,110736,15520,0.11385597516157649,0.519150359591905
7756,0.8316,2,0,2,662069,14375,110738,15518,0.11385597516157649,0.5191181882045964
7757,0.8317,33,37,33,662106,14338,110771,15485,0.11356291978203016,0.5192301244006304
7758,0.8318,4,3,4,662109,14335,110775,15481,0.11353915853503992,0.5192178696002147
7759,0.8319,0,2,0,662111,14333,110775,15481,0.11352331770371309,0.5192527000737909
7760,0.832,10,15,10,662126,14318,110785,15471,0.11340451146876188,0.51935278122797
7761,0.8321,2,0,2,662126,14318,110787,15469,0.11340451146876188,0.519320508946856
7762,0.8322,1,4,1,662130,14314,110788,15468,0.11337282980610823,0.5193741185951246
7763,0.8323,9,10,9,662140,14304,110797,15459,0.11329362564947408,0.5194032859590767
7764,0.8324,1,2,1,662142,14302,110798,15458,0.11327778481814725,0.5194220430107527
7765,0.8325,23,57,23,662199,14245,110821,15435,0.11282632112533265,0.5200471698113207
7766,0.8326,0,1,0,662200,14244,110821,15435,0.11281840070966924,0.5200646922066108
7767,0.8327,1,5,1,662205,14239,110822,15434,0.11277879863135218,0.5201361507093991
7768,0.8328,1,4,1,662209,14235,110823,15433,0.11274711696869852,0.5201901038155589
7769,0.8329,0,4,0,662213,14231,110823,15433,0.11271543530604486,0.5202602481121898
7770,0.833,2,6,2,662219,14225,110825,15431,0.11266791281206438,0.5203331534933909
7771,0.8332,1,1,1,662220,14224,110826,15430,0.11265999239640097,0.5203345248533081
7772,0.8333,73,87,73,662307,14137,110899,15357,0.11197091623368394,0.5206821726452838
7773,0.8334,1,0,1,662307,14137,110900,15356,0.11197091623368394,0.5206659207269522
7774,0.8335,5,5,5,662312,14132,110905,15351,0.11193131415536688,0.5206729301631449
7775,0.8336,1,0,1,662312,14132,110906,15350,0.11193131415536688,0.5206566718675802
7776,0.8337,0,9,0,662321,14123,110906,15350,0.11186003041439614,0.5208156617921488
7777,0.8338,8,1,8,662322,14122,110914,15342,0.11185210999873273,0.5207032310616345
7778,0.8339,1,2,1,662324,14120,110915,15341,0.11183626916740591,0.5207223108516343
7779,0.834,17,25,17,662349,14095,110932,15324,0.11163825877582055,0.5208878615860498
7780,0.8342,14,27,14,662376,14068,110946,15310,0.11142440755290837,0.5211382667302062
7781,0.8343,6,6,6,662382,14062,110952,15304,0.1113768850589279,0.521146904583532
7782,0.8344,1,1,1,662383,14061,110953,15303,0.11136896464326448,0.5211483449121374
7783,0.8345,2,12,2,662395,14049,110955,15301,0.1112739196553035,0.5213287904599659
7784,0.8346,1,2,1,662397,14047,110956,15300,0.11125807882397669,0.521348008314308
7785,0.8347,4,7,4,662404,14040,110960,15296,0.11120263591433278,0.5214071448050177
7786,0.8348,0,2,0,662406,14038,110960,15296,0.11118679508300595,0.5214426944842163
7787,0.8349,1,3,1,662409,14035,110961,15295,0.11116303383601571,0.5214797136038186
7788,0.835,174,187,174,662596,13848,111135,15121,0.1096819161069573,0.5219717629189824
7789,0.8351,1,1,1,662597,13847,111136,15120,0.10967399569129388,0.5219732799392413
7790,0.8352,3,9,3,662606,13838,111139,15117,0.10960271195032316,0.5220859955102746
7791,0.8353,4,8,4,662614,13830,111143,15113,0.10953934862501584,0.5221642538783126
7792,0.8354,2,5,2,662619,13825,111145,15111,0.10949974654669876,0.5222214542438485
7793,0.8355,1,6,1,662625,13819,111146,15110,0.10945222405271829,0.5223132496802516
7794,0.8356,1,2,1,662627,13817,111147,15109,0.10943638322139146,0.5223328493396944
7795,0.8357,9,9,9,662636,13808,111156,15100,0.10936509948042074,0.5223467552234675
7796,0.8358,6,22,6,662658,13786,111162,15094,0.10919085033582562,0.5226454293628808
7797,0.8359,3,2,3,662660,13784,111165,15091,0.1091750095044988,0.5226320346320347
7798,0.836,19,17,19,662677,13767,111184,15072,0.10904036243822075,0.5226256111515656
7799,0.8361,1,4,1,662681,13763,111185,15071,0.10900868077556711,0.5226815564958036
7800,0.8362,3,8,3,662689,13755,111188,15068,0.10894531745025979,0.5227769489643688
7801,0.8363,4,5,4,662694,13750,111192,15064,0.10890571537194271,0.5228014159783438
7802,0.8364,2,1,2,662695,13749,111194,15062,0.10889779495627931,0.5227864357363508
7803,0.8365,3,3,3,662698,13746,111197,15059,0.10887403370928907,0.5227911820864434
7804,0.8367,84,98,84,662796,13648,111281,14975,0.10809783297427449,0.5231806589106662
7805,0.8368,1,8,1,662804,13640,111282,14974,0.10803446964896718,0.5233102677011253
7806,0.8369,2,2,2,662806,13638,111284,14972,0.10801862881764035,0.5233135267389025
7807,0.837,2,5,2,662811,13633,111286,14970,0.10797902673932327,0.5233716742998986
7808,0.8371,0,7,0,662818,13626,111286,14970,0.10792358382967938,0.5234997901804448
7809,0.8372,1,3,1,662821,13623,111287,14969,0.10789982258268914,0.5235380526021265
7810,0.8373,4,11,4,662832,13612,111291,14965,0.10781269801039159,0.5236728837876614
7811,0.8374,2,1,2,662833,13611,111293,14963,0.10780477759472817,0.5236578707916287
7812,0.8375,38,46,38,662879,13565,111331,14925,0.10744043847421113,0.5238680238680239
7813,0.8376,0,1,0,662880,13564,111331,14925,0.10743251805854771,0.523886412299484
7814,0.8377,5,7,5,662887,13557,111336,14920,0.10737707514890381,0.5239315939178987
7815,0.8378,1,7,1,662894,13550,111337,14919,0.10732163223925992,0.5240436966524992
7816,0.8379,0,3,0,662897,13547,111337,14919,0.10729787099226967,0.5240989250333732
7817,0.838,12,19,12,662916,13528,111349,14907,0.1071473830946648,0.5242482855635661
7818,0.8381,2,1,2,662917,13527,111351,14905,0.10713946267900139,0.5242332583005065
7819,0.8382,3,7,3,662924,13520,111354,14902,0.1070840197693575,0.5243121525578777
7820,0.8383,20,41,20,662965,13479,111374,14882,0.10675928272715753,0.5247346708508163
7821,0.8384,1,2,1,662967,13477,111375,14881,0.1067434418958307,0.5247549192467734
7822,0.8385,4,9,4,662976,13468,111379,14877,0.10667215815485996,0.5248544716881284
7823,0.8386,3,1,3,662977,13467,111382,14874,0.10666423773919655,0.524822695035461
7824,0.8387,4,7,4,662984,13460,111386,14870,0.10660879482955266,0.5248852806212495
7825,0.8388,1,5,1,662989,13455,111387,14869,0.10656919275123558,0.5249611636774467
7826,0.8389,1,4,1,662993,13451,111388,14868,0.10653751108858193,0.5250185387902115
7827,0.839,7,10,7,663003,13441,111395,14861,0.10645830693194779,0.5250865663204014
7828,0.8392,9,10,9,663013,13431,111404,14852,0.10637910277531365,0.525121097479051
7829,0.8393,5,5,5,663018,13426,111409,14847,0.10633950069699658,0.5251299826689775
7830,0.8395,3,9,3,663027,13417,111412,14844,0.10626821695602585,0.5252468065532006
7831,0.8396,0,2,0,663029,13415,111412,14844,0.10625237612469902,0.5252839803248522
7832,0.8397,3,4,3,663033,13411,111415,14841,0.10622069446204536,0.5253079428005097
7833,0.8398,4,3,4,663036,13408,111419,14837,0.10619693321505512,0.5252965126571074
7834,0.8399,1,0,1,663036,13408,111420,14836,0.10619693321505512,0.5252797054241609
7835,0.84,983,915,983,663951,12493,112403,13853,0.0989497528830313,0.5258103696955895
7836,0.8401,1,4,1,663955,12489,112404,13852,0.09891807122037764,0.525872214418587
7837,0.8402,3,8,3,663963,12481,112407,13849,0.09885470789507034,0.5259779718951766
7838,0.8403,0,3,0,663966,12478,112407,13849,0.09883094664808009,0.5260379078512554
7839,0.8404,0,6,0,663972,12472,112407,13849,0.0987834241540996,0.5261578207514912
7840,0.8405,1,8,1,663980,12464,112408,13848,0.0987200608287923,0.5262997871693524
7841,0.8406,0,2,0,663982,12462,112408,13848,0.09870421999746547,0.526339794754846
7842,0.8407,3,8,3,663990,12454,112411,13845,0.09864085667215816,0.5264458724666337
7843,0.8408,8,17,8,664007,12437,112419,13837,0.09850620960588012,0.5266423079850803
7844,0.8409,1,1,1,664008,12436,112420,13836,0.0984982891902167,0.5266443361753959
7845,0.841,10,12,10,664020,12424,112430,13826,0.09840324420225574,0.5267047619047619
7846,0.8411,3,3,3,664023,12421,112433,13823,0.0983794829552655,0.5267108672458467
7847,0.8412,1,5,1,664028,12416,112434,13822,0.09833988087694842,0.526793200701273
7848,0.8413,1,9,1,664037,12407,112435,13821,0.0982685971359777,0.5269559249656856
7849,0.8414,4,1,4,664038,12406,112439,13817,0.09826067672031429,0.5269038630210121
7850,0.8415,0,2,0,664040,12404,112439,13817,0.09824483588898746,0.5269440524770223
7851,0.8416,2,3,2,664043,12401,112441,13815,0.09822107464199721,0.5269682636557828
7852,0.8417,28,52,28,664095,12349,112469,13787,0.09780921302749969,0.5275099479644935
7853,0.8418,1,2,1,664097,12347,112470,13786,0.09779337219617286,0.527532238931619
7854,0.8419,0,1,0,664098,12346,112470,13786,0.09778545178050944,0.5275524261441911
7855,0.842,15,14,15,664112,12332,112485,13771,0.09767456596122165,0.5275638815461824
7856,0.8421,3,4,3,664116,12328,112488,13768,0.09764288429856799,0.5275904353157572
7857,0.8422,1,10,1,664126,12318,112489,13767,0.09756368014193385,0.527774583093732
7858,0.8423,1,8,1,664134,12310,112490,13766,0.09750031681662653,0.5279183923914711
7859,0.8424,2,4,2,664138,12306,112492,13764,0.09746863515397287,0.5279631760644419
7860,0.8425,21,33,21,664171,12273,112513,13743,0.09720726143708022,0.5282518450184502
7861,0.8426,1,3,1,664174,12270,112514,13742,0.09718350019008998,0.5282946332461941
7862,0.8427,6,6,6,664180,12264,112520,13736,0.09713597769610949,0.5283076923076923
7863,0.8428,1,3,1,664183,12261,112521,13735,0.09711221644911924,0.5283505154639175
7864,0.8429,1,1,1,664184,12260,112522,13734,0.09710429603345584,0.5283526967761791
7865,0.843,2,4,2,664188,12256,112524,13732,0.09707261437080218,0.5283977220255502
7866,0.8431,0,2,0,664190,12254,112524,13732,0.09705677353947535,0.5284383899022551
7867,0.8432,2,4,2,664194,12250,112526,13730,0.09702509187682169,0.5284834488067744
7868,0.8433,72,91,72,664285,12159,112598,13658,0.09630433405145102,0.5290312584730992
7869,0.8434,1,1,1,664286,12158,112599,13657,0.0962964136357876,0.5290335076505908
7870,0.8435,2,11,2,664297,12147,112601,13655,0.09620928906349005,0.5292225408883032
7871,0.8436,1,3,1,664300,12144,112602,13654,0.0961855278164998,0.5292658345608187
7872,0.8437,4,6,4,664306,12138,112606,13650,0.09613800532251933,0.5293159609120521
7873,0.8438,2,5,2,664311,12133,112608,13648,0.09609840324420225,0.5293821030991815
7874,0.8439,0,3,0,664314,12130,112608,13648,0.09607464199721201,0.5294437116921406
7875,0.844,10,17,10,664331,12113,112618,13638,0.09593999493093397,0.5296105005630849
7876,0.8441,0,1,0,664332,12112,112618,13638,0.09593207451527055,0.5296310679611651
7877,0.8442,13,20,13,664352,12092,112631,13625,0.09577366620200228,0.5298051872302368
7878,0.8443,6,7,6,664359,12085,112637,13619,0.09571822329235838,0.5298397136632431
7879,0.8444,0,3,0,664362,12082,112637,13619,0.09569446204536815,0.5299015602505739
7880,0.8445,0,1,0,664363,12081,112637,13619,0.09568654162970473,0.5299221789883268
7881,0.8446,1,1,1,664364,12080,112638,13618,0.09567862121404132,0.5299245077437933
7882,0.8447,4,14,4,664378,12066,112642,13614,0.09556773539475352,0.5301401869158878
7883,0.8448,2,8,2,664386,12058,112644,13612,0.0955043720694462,0.5302687962602259
7884,0.845,163,172,163,664558,11886,112807,13449,0.094142060575339,0.5308466548253404
7885,0.8451,4,5,4,664563,11881,112811,13445,0.09410245849702192,0.5308773592355682
7886,0.8452,1,4,1,664567,11877,112812,13444,0.09407077683436826,0.5309426957861064
7887,0.8453,2,7,2,664574,11870,112814,13442,0.09401533392472437,0.5310524652338812
7888,0.8454,0,3,0,664577,11867,112814,13442,0.09399157267773413,0.5311154134892726
7889,0.8455,7,4,7,664581,11863,112821,13435,0.09395989101508047,0.5310696497746857
7890,0.8456,1,5,1,664586,11858,112822,13434,0.09392028893676341,0.5311560967894987
7891,0.8457,8,9,8,664595,11849,112830,13426,0.09384900519579267,0.5311968348170129
7892,0.8458,9,14,9,664609,11835,112839,13417,0.09373811937650488,0.5313242515444321
7893,0.846,19,44,19,664653,11791,112858,13398,0.09338962108731466,0.5318988447338123
7894,0.8462,7,3,7,664656,11788,112865,13391,0.09336585984032442,0.5318320822907979
7895,0.8463,3,6,3,664662,11782,112868,13388,0.09331833734634394,0.5319030591974573
7896,0.8464,0,3,0,664665,11779,112868,13388,0.0932945760993537,0.5319664640203441
7897,0.8465,2,6,2,664671,11773,112870,13386,0.0932470536053732,0.5320561230573552
7898,0.8466,0,2,0,664673,11771,112870,13386,0.09323121277404638,0.5320984219104027
7899,0.8467,66,95,66,664768,11676,112936,13320,0.09247877328602205,0.5328852616418627
7900,0.8468,1,2,1,664770,11674,112937,13319,0.09246293245469522,0.5329092145800824
7901,0.8469,1,3,1,664773,11671,112938,13318,0.09243917120770498,0.5329544999799912
7902,0.847,2,5,2,664778,11666,112940,13316,0.0923995691293879,0.5330237771195261
7903,0.8471,3,3,3,664781,11663,112943,13313,0.09237580788239767,0.5330317104420244
7904,0.8472,0,5,0,664786,11658,112943,13313,0.0923362058040806,0.5331384405910856
7905,0.8473,3,3,3,664789,11655,112946,13310,0.09231244455709035,0.5331464049669538
7906,0.8474,1,1,1,664790,11654,112947,13309,0.09230452414142694,0.5331490606097024
7907,0.8475,33,42,33,664832,11612,112980,13276,0.09197186668356355,0.5334297653487624
7908,0.8476,2,1,2,664833,11611,112982,13274,0.09196394626790014,0.5334137030339562
7909,0.8477,6,5,6,664838,11606,112988,13268,0.09192434418958306,0.5334083782262603
7910,0.8478,0,2,0,664840,11604,112988,13268,0.09190850335825625,0.5334512705049855
7911,0.8479,0,3,0,664843,11601,112988,13268,0.091884742111266,0.5335156218585387
7912,0.848,12,13,12,664856,11588,113000,13256,0.09178177670764162,0.5335694735147319
7913,0.8481,0,1,0,664857,11587,113000,13256,0.0917738562919782,0.5335909511733687
7914,0.8482,1,7,1,664864,11580,113001,13255,0.0917184133823343,0.5337225689551037
7915,0.8483,34,30,34,664894,11550,113035,13221,0.09148080091243188,0.5337289572483953
7916,0.8485,3,2,3,664896,11548,113038,13218,0.09146496008110505,0.5337155778082856
7917,0.8486,1,3,1,664899,11545,113039,13217,0.09144119883411482,0.5337614086099669
7918,0.8487,2,8,2,664907,11537,113041,13215,0.0913778355088075,0.5338962508080155
7919,0.8488,1,2,1,664909,11535,113042,13214,0.09136199467748067,0.5339205624469675
7920,0.8489,0,4,0,664913,11531,113042,13214,0.09133031301482702,0.5340068700747626
7921,0.849,9,17,9,664930,11514,113051,13205,0.09119566594854898,0.5342044581091469
7922,0.8491,1,2,1,664932,11512,113052,13204,0.09117982511722215,0.5342288396180612
7923,0.8492,9,20,9,664952,11492,113061,13195,0.09102141680395387,0.5344918378093734
7924,0.8493,2,13,2,664965,11479,113063,13193,0.09091845140032949,0.5347357328145266
7925,0.8494,7,6,7,664971,11473,113070,13186,0.090870928906349,0.5347337686037552
7926,0.8495,3,5,3,664976,11468,113073,13183,0.09083132682803194,0.5347856070747637
7927,0.8496,0,6,0,664982,11462,113073,13183,0.09078380433405145,0.5349158044228038
7928,0.8497,4,5,4,664987,11457,113077,13179,0.09074420225573437,0.5349488553336581
7929,0.8498,2,7,2,664994,11450,113079,13177,0.09068875934609048,0.5350631420798311
7930,0.85,944,876,944,665870,10574,114023,12233,0.08375047522493981,0.5363704125926251
7931,0.8501,1,2,1,665872,10572,114024,12232,0.08373463439361298,0.5363971233116998
7932,0.8502,6,4,6,665876,10568,114030,12226,0.08370295273095932,0.5363692199701676
7933,0.8503,0,3,0,665879,10565,114030,12226,0.08367919148396907,0.5364398227370454
7934,0.8504,0,1,0,665880,10564,114030,12226,0.08367127106830566,0.5364633611232997
7935,0.8505,3,4,3,665884,10560,114033,12223,0.08363958940565201,0.5364965105561164
7936,0.8507,4,7,4,665891,10553,114037,12219,0.08358414649600811,0.5365800105392587
7937,0.8508,10,13,10,665904,10540,114047,12209,0.08348118109238373,0.5366829311178514
7938,0.8509,1,1,1,665905,10539,114048,12208,0.08347326067672031,0.5366861564162307
7939,0.851,4,5,4,665910,10534,114052,12204,0.08343365859840324,0.5367226669012226
7940,0.8511,1,4,1,665914,10530,114053,12203,0.08340197693574959,0.5367967272247394
7941,0.8512,2,1,2,665915,10529,114055,12201,0.08339405652008618,0.5367795864496261
7942,0.8513,7,2,7,665917,10527,114062,12194,0.08337821568875935,0.5366841248184498
7943,0.8514,2,1,2,665918,10526,114064,12192,0.08337029527309593,0.5366669601197288
7944,0.8515,0,8,0,665926,10518,114064,12192,0.08330693194778863,0.5368560105680317
7945,0.8516,0,4,0,665930,10514,114064,12192,0.08327525028513497,0.5369505857482604
7946,0.8517,18,36,18,665966,10478,114082,12174,0.08299011532125206,0.5374359879922302
7947,0.8518,0,5,0,665971,10473,114082,12174,0.082950513242935,0.5375546429990727
7948,0.8519,1,1,1,665972,10472,114083,12173,0.08294259282727158,0.5375579598145286
7949,0.852,4,8,4,665980,10464,114087,12169,0.08287922950196426,0.5376662395617019
7950,0.8521,2,0,2,665980,10464,114089,12167,0.08287922950196426,0.5376253811144006
7951,0.8522,1,6,1,665986,10458,114090,12166,0.08283170700798378,0.5377475247524752
7952,0.8523,3,7,3,665993,10451,114093,12163,0.08277626409833988,0.5378526576457062
7953,0.8524,1,2,1,665995,10449,114094,12162,0.08276042326701305,0.5378797930210959
7954,0.8525,30,41,30,666036,10408,114124,12132,0.08243568622481308,0.538243123336291
7955,0.8526,0,2,0,666038,10406,114124,12132,0.08241984539348625,0.5382908865027953
7956,0.8527,3,11,3,666049,10395,114127,12129,0.0823327208211887,0.5384922749067661
7957,0.8528,0,5,0,666054,10390,114127,12129,0.08229311874287162,0.5386118388916027
7958,0.8529,0,2,0,666056,10388,114127,12129,0.0822772779115448,0.5386596793533774
7959,0.853,4,7,4,666063,10381,114131,12125,0.0822218350019009,0.5387452234959567
7960,0.8531,1,4,1,666067,10377,114132,12124,0.08219015333924724,0.5388204968668059
7961,0.8532,2,4,2,666071,10373,114134,12122,0.08215847167659358,0.5388753056234719
7962,0.8533,71,93,71,666164,10280,114205,12051,0.08142187301989609,0.5396533966235278
7963,0.8535,3,6,3,666170,10274,114208,12048,0.0813743505259156,0.5397365827434818
7964,0.8536,1,1,1,666171,10273,114209,12047,0.08136643011025219,0.5397401433691756
7965,0.8537,0,6,0,666177,10267,114209,12047,0.0813189076162717,0.539885273819127
7966,0.8538,1,5,1,666182,10262,114210,12046,0.08127930553795464,0.5399856553702708
7967,0.8539,0,1,0,666183,10261,114210,12046,0.08127138512229122,0.5400098623750392
7968,0.854,25,20,25,666203,10241,114235,12021,0.08111297680902294,0.5399784385949151
7969,0.8541,0,7,0,666210,10234,114235,12021,0.08105753389937904,0.5401482812851045
7970,0.8542,9,13,9,666223,10221,114244,12012,0.08095456849575466,0.5402779651868843
7971,0.8543,3,8,3,666231,10213,114247,12009,0.08089120517044734,0.5404104041040411
7972,0.8545,0,5,0,666236,10208,114247,12009,0.08085160309213027,0.540532025025881
7973,0.8547,2,12,2,666248,10196,114249,12007,0.0807565581041693,0.5407827771021934
7974,0.8548,2,5,2,666253,10191,114251,12005,0.08071695602585224,0.5408632185979456
7975,0.8549,1,1,1,666254,10190,114252,12004,0.08070903561018883,0.5408669009642245
7976,0.855,134,155,134,666409,10035,114386,11870,0.07948137118235965,0.5418854142889751
7977,0.8551,3,3,3,666412,10032,114389,11867,0.0794576099353694,0.541896890268962
7978,0.8552,0,6,0,666418,10026,114389,11867,0.07941008744138893,0.5420454026401132
7979,0.8553,3,7,3,666425,10019,114392,11864,0.07935464453174502,0.5421560115157885
7980,0.8554,0,1,0,666426,10018,114392,11864,0.07934672411608161,0.5421807878621698
7981,0.8555,2,5,2,666431,10013,114394,11862,0.07930712203776454,0.5422628571428572
7982,0.8557,2,4,2,666435,10009,114396,11860,0.07927544037511089,0.5423201792491655
7983,0.8558,7,10,7,666445,9999,114403,11853,0.07919623621847674,0.5424217462932455
7984,0.8559,1,0,1,666445,9999,114404,11852,0.07919623621847674,0.5424008054551279
7985,0.856,14,15,14,666460,9984,114418,11838,0.07907742998352553,0.542480065988452
7986,0.8562,6,2,6,666462,9982,114424,11832,0.07906158915219871,0.5424039607591455
7987,0.8563,5,0,5,666462,9982,114429,11827,0.07906158915219871,0.5422990508505663
7988,0.8564,1,1,1,666463,9981,114430,11826,0.0790536687365353,0.542302930251754
7989,0.8565,4,6,4,666469,9975,114434,11822,0.07900614624255481,0.5423682158095151
7990,0.8567,74,98,74,666567,9877,114508,11748,0.07822994550754024,0.5432601156069364
7991,0.8568,1,6,1,666573,9871,114509,11747,0.07818242301355975,0.5433897677861041
7992,0.8569,0,2,0,666575,9869,114509,11747,0.07816658218223292,0.543440044411547
7993,0.857,3,5,3,666580,9864,114512,11744,0.07812698010391585,0.5435024065161052
7994,0.8571,1,3,1,666583,9861,114513,11743,0.07810321885692562,0.5435567487502314
7995,0.8572,5,5,5,666588,9856,114518,11738,0.07806361677860854,0.54357691951468
7996,0.8573,5,9,5,666597,9847,114523,11733,0.07799233303763782,0.5436978683966636
7997,0.8574,1,4,1,666601,9843,114524,11732,0.07796065137498416,0.5437775202780997
7998,0.8575,36,43,36,666644,9800,114560,11696,0.07762007350145736,0.544101228135467
7999,0.8576,1,2,1,666646,9798,114561,11695,0.07760423267013053,0.5441306471874564
8000,0.8577,6,8,6,666654,9790,114567,11689,0.07754086934482321,0.5442059686205131
8001,0.8578,1,2,1,666656,9788,114568,11688,0.0775250285134964,0.5442354255913578
8002,0.8579,0,3,0,666659,9785,114568,11688,0.07750126726650615,0.5443114609043915
8003,0.858,14,6,14,666665,9779,114582,11674,0.07745374477252566,0.5441663170652123
8004,0.8581,3,1,3,666666,9778,114585,11671,0.07744582435686224,0.5441279313720919
8005,0.8582,4,7,4,666673,9771,114589,11667,0.07739038144721835,0.5442205429610971
8006,0.8583,24,41,24,666714,9730,114613,11643,0.07706564440501837,0.5447527254012071
8007,0.8584,1,4,1,666718,9726,114614,11642,0.07703396274236472,0.5448333957319356
8008,0.8585,0,4,0,666722,9722,114614,11642,0.07700228107971106,0.5449354053548024
8009,0.8586,5,0,5,666722,9722,114619,11637,0.07700228107971106,0.5448288777564493
8010,0.8587,4,5,4,666727,9717,114623,11633,0.07696267900139399,0.5448711943793911
8011,0.8588,4,2,4,666729,9715,114627,11629,0.07694683817006716,0.5448369565217391
8012,0.859,2,7,2,666736,9708,114629,11627,0.07689139526042327,0.5449730489805484
8013,0.8591,1,1,1,666737,9707,114630,11626,0.07688347484475985,0.5449772652697699
8014,0.8592,5,19,5,666756,9688,114635,11621,0.07673298694715498,0.5453564221690366
8015,0.8593,3,9,3,666765,9679,114638,11618,0.07666170320618426,0.5455228435929943
8016,0.8595,2,5,2,666770,9674,114640,11616,0.07662210112786719,0.5456082667919211
8017,0.8596,1,0,1,666770,9674,114641,11615,0.07662210112786719,0.5455869228239936
8018,0.8597,3,3,3,666773,9671,114644,11612,0.07659833988087694,0.5455997744678852
8019,0.8598,1,1,1,666774,9670,114645,11611,0.07659041946521354,0.5456040599595884
8020,0.8599,1,2,1,666776,9668,114646,11610,0.07657457863388671,0.5456339881567817
8021,0.86,907,783,907,667559,8885,115553,10703,0.07037289316943353,0.5464059628343884
8022,0.8601,0,1,0,667560,8884,115553,10703,0.07036497275377011,0.5464338591923215
8023,0.8602,0,5,0,667565,8879,115553,10703,0.07032537067545305,0.5465733837197426
8024,0.8603,3,7,3,667572,8872,115556,10700,0.07026992776580915,0.5466993664418557
8025,0.8604,2,4,2,667576,8868,115558,10698,0.07023824610315549,0.5467647960748236
8026,0.8605,4,5,4,667581,8863,115562,10694,0.07019864402483843,0.5468118832131718
8027,0.8607,1,8,1,667589,8855,115563,10693,0.07013528069953111,0.547012482095355
8028,0.8608,5,11,5,667600,8844,115568,10688,0.07004815612723356,0.547204587343846
8029,0.8609,0,4,0,667604,8840,115568,10688,0.0700164744645799,0.5473166734944694
8030,0.861,5,7,5,667611,8833,115573,10683,0.069961031554936,0.5473970075835212
8031,0.8611,1,2,1,667613,8831,115574,10682,0.06994519072360918,0.5474299185158612
8032,0.8612,1,5,1,667618,8826,115575,10681,0.0699055886452921,0.5475470343979084
8033,0.8613,2,4,2,667622,8822,115577,10679,0.06987390698263844,0.5476129429260038
8034,0.8614,2,6,2,667628,8816,115579,10677,0.06982638448865797,0.547735084389268
8035,0.8615,3,2,3,667630,8814,115582,10674,0.06981054365733114,0.5477216748768473
8036,0.8616,0,1,0,667631,8813,115582,10674,0.06980262324166772,0.547749781905886
8037,0.8617,27,39,27,667670,8774,115609,10647,0.06949372703079458,0.5482209978888831
8038,0.8618,0,4,0,667674,8770,115609,10647,0.06946204536814092,0.5483339341813874
8039,0.8619,0,4,0,667678,8766,115609,10647,0.06943036370548726,0.5484469170143718
8040,0.862,8,4,8,667682,8762,115617,10639,0.0693986820428336,0.5483737951651977
8041,0.8621,0,1,0,667683,8761,115617,10639,0.0693907616271702,0.5484020618556701
8042,0.8622,1,5,1,667688,8756,115618,10638,0.06935115954885313,0.5485201608744973
8043,0.8623,6,9,6,667697,8747,115624,10632,0.0692798758078824,0.5486351204912534
8044,0.8624,1,2,1,667699,8745,115625,10631,0.06926403497655557,0.548668455821635
8045,0.8625,31,44,31,667743,8701,115656,10600,0.06891553668736536,0.549194342262059
8046,0.8626,1,1,1,667744,8700,115657,10599,0.06890761627170194,0.5491994403855122
8047,0.8627,5,4,5,667748,8696,115662,10594,0.06887593460904828,0.549196474857439
8048,0.8628,1,1,1,667749,8695,115663,10593,0.06886801419338487,0.5492015761094982
8049,0.8629,2,2,2,667751,8693,115665,10591,0.06885217336205804,0.5492117817880108
8050,0.863,5,10,5,667761,8683,115670,10586,0.0687729692054239,0.5493798328922103
8051,0.8631,0,1,0,667762,8682,115670,10586,0.06876504878976049,0.5494083454432219
8052,0.8632,1,2,1,667764,8680,115671,10585,0.06874920795843366,0.5494419932520114
8053,0.8633,65,81,65,667845,8599,115736,10520,0.06810765428969712,0.550237983158115
8054,0.8635,2,5,2,667850,8594,115738,10518,0.06806805221138006,0.5503348681456677
8055,0.8636,2,2,2,667852,8592,115740,10516,0.06805221138005323,0.550345405065941
8056,0.8637,2,7,2,667859,8585,115742,10514,0.06799676847040932,0.5505000261793811
8057,0.8638,4,4,4,667863,8581,115746,10510,0.06796508680775568,0.5505211879943429
8058,0.864,21,22,21,667885,8559,115767,10489,0.06779083766316056,0.5506614867702646
8059,0.8641,0,1,0,667886,8558,115767,10489,0.06778291724749715,0.5506903974379167
8060,0.8642,7,15,7,667901,8543,115774,10482,0.06766411101254594,0.5509592641261498
8061,0.8643,7,8,7,667909,8535,115781,10475,0.06760074768723863,0.5510257759074172
8062,0.8645,1,1,1,667910,8534,115782,10474,0.06759282727157521,0.5510311447811448
8063,0.8646,1,1,1,667911,8533,115783,10473,0.0675849068559118,0.5510365147848048
8064,0.8647,2,3,2,667914,8530,115785,10471,0.06756114560892156,0.5510762591442556
8065,0.8648,1,0,1,667914,8530,115786,10470,0.06756114560892156,0.5510526315789473
8066,0.8649,0,2,0,667916,8528,115786,10470,0.06754530477759473,0.5511106432256027
8067,0.865,151,141,151,668057,8387,115937,10319,0.06642852616905336,0.5516411846466375
8068,0.8651,3,0,3,668057,8387,115940,10316,0.06642852616905336,0.5515692669625194
8069,0.8652,3,5,3,668062,8382,115943,10313,0.06638892409073628,0.5516448248194704
8070,0.8653,0,6,0,668068,8376,115943,10313,0.06634140159675579,0.5518219273369361
8071,0.8654,1,2,1,668070,8374,115944,10312,0.06632556076542898,0.5518570052445682
8072,0.8655,0,5,0,668075,8369,115944,10312,0.0662859586871119,0.5520047106685938
8073,0.8657,3,4,3,668079,8365,115947,10309,0.06625427702445824,0.5520509799721538
8074,0.8658,6,10,6,668089,8355,115953,10303,0.0661750728678241,0.5522028084467788
8075,0.8659,2,1,2,668090,8354,115955,10301,0.06616715245216069,0.5521844009648887
8076,0.866,13,14,13,668104,8340,115968,10288,0.0660562666328729,0.5522868799656431
8077,0.8661,0,2,0,668106,8338,115968,10288,0.06604042580154607,0.5523461827552884
8078,0.8662,2,6,2,668112,8332,115970,10286,0.06599290330756558,0.5524760983993985
8079,0.8663,1,3,1,668115,8329,115971,10285,0.06596914206057534,0.5525410980982056
8080,0.8665,2,4,2,668119,8325,115973,10283,0.06593746039792169,0.5526117798796216
8081,0.8667,63,67,63,668186,8258,116036,10220,0.06540679254847294,0.553090161272865
8082,0.8668,3,5,3,668191,8253,116039,10217,0.06536719047015588,0.5531672983216026
8083,0.8669,1,3,1,668194,8250,116040,10216,0.06534342922316563,0.553232968699231
8084,0.867,5,8,5,668202,8242,116045,10211,0.06528006589785831,0.5533517585216496
8085,0.8671,5,4,5,668206,8238,116050,10206,0.06524838423520467,0.5533506831489915
8086,0.8672,1,3,1,668209,8235,116051,10205,0.06522462298821442,0.553416485900217
8087,0.8673,6,2,6,668211,8233,116057,10199,0.06520878215688759,0.5533311631944444
8088,0.8675,35,38,35,668249,8195,116092,10164,0.06490780636167787,0.5536249251048532
8089,0.8677,0,9,0,668258,8186,116092,10164,0.06483652262070713,0.5538964577656675
8090,0.8678,2,4,2,668262,8182,116094,10162,0.06480484095805347,0.5539686000872219
8091,0.8679,3,5,3,668267,8177,116097,10159,0.06476523887973641,0.5540466841186736
8092,0.868,9,15,9,668282,8162,116106,10150,0.0646464326447852,0.5542813455657493
8093,0.8681,0,1,0,668283,8161,116106,10150,0.06463851222912179,0.5543116159685435
8094,0.8682,0,3,0,668286,8158,116106,10150,0.06461475098213154,0.5544024470176971
8095,0.8683,16,25,16,668311,8133,116122,10134,0.0644167405905462,0.5547708983412711
8096,0.8684,2,0,2,668311,8133,116124,10132,0.0644167405905462,0.554722146181221
8097,0.8685,3,6,3,668317,8127,116127,10129,0.0643692180965657,0.5548312883435583
8098,0.8686,1,3,1,668320,8124,116128,10128,0.06434545684957546,0.5548980933596318
8099,0.8687,1,11,1,668331,8113,116129,10127,0.06425833227727791,0.5552083333333333
8100,0.8688,2,4,2,668335,8109,116131,10125,0.06422665061462425,0.5552813425468904
8101,0.8689,1,2,1,668337,8107,116132,10124,0.06421080978329742,0.5553178651747024
8102,0.869,2,7,2,668344,8100,116134,10122,0.06415536687365353,0.5554823839315114
8103,0.8691,1,1,1,668345,8099,116135,10121,0.06414744645799011,0.5554884742041712
8104,0.8692,3,7,3,668352,8092,116138,10118,0.06409200354834621,0.5556287753981329
8105,0.8693,3,8,3,668360,8084,116141,10115,0.0640286402230389,0.5557997692180889
8106,0.8694,1,1,1,668361,8083,116142,10114,0.06402071980737549,0.55580590207177
8107,0.8695,1,5,1,668366,8078,116143,10113,0.06398111772905841,0.555934253202133
8108,0.8696,1,0,1,668366,8078,116144,10112,0.06398111772905841,0.5559098405717428
8109,0.8697,3,6,3,668372,8072,116147,10109,0.06393359523507794,0.5560200209009405
8110,0.8698,0,1,0,668373,8071,116147,10109,0.06392567481941452,0.5560506050605061
8111,0.8699,0,4,0,668377,8067,116147,10109,0.06389399315676086,0.5561729753521126
8112,0.87,827,704,827,669081,7363,116974,9282,0.0583180205297174,0.5576449384199459
8113,0.8701,0,1,0,669082,7362,116974,9282,0.058310100114053985,0.5576784426820476
8114,0.8702,2,7,2,669089,7355,116976,9280,0.05825465720441009,0.5578599338743613
8115,0.8703,0,5,0,669094,7350,116976,9280,0.05821505512609302,0.5580276608538786
8116,0.8704,3,3,3,669097,7347,116979,9277,0.058191293879102775,0.558048604427334
8117,0.8705,3,4,3,669101,7343,116982,9274,0.05815961221644912,0.55810314737919
8118,0.8706,0,1,0,669102,7342,116982,9274,0.05815169180078571,0.5581367356764564
8119,0.8707,1,6,1,669108,7336,116983,9273,0.058104169306805224,0.5583117586850502
8120,0.8708,14,12,14,669120,7324,116997,9259,0.05800912431884425,0.558342881263945
8121,0.8709,0,3,0,669123,7321,116997,9259,0.057985363071854014,0.5584439083232811
8122,0.871,7,8,7,669131,7313,117004,9252,0.0579219997465467,0.5585270147902204
8123,0.8711,0,5,0,669136,7308,117004,9252,0.057882397668229627,0.558695652173913
8124,0.8712,1,1,1,669137,7307,117005,9251,0.05787447725256621,0.5587027418770383
8125,0.8713,2,5,2,669142,7302,117007,9249,0.057834875174249144,0.5588181982961754
8126,0.8714,1,3,1,669145,7299,117008,9248,0.057811113927258906,0.5588928506677948
8127,0.8715,2,1,2,669146,7298,117010,9246,0.05780319351159549,0.5588733075435203
8128,0.8716,4,0,4,669146,7298,117014,9242,0.05780319351159549,0.5587666263603386
8129,0.8717,22,30,22,669176,7268,117036,9220,0.05756558104169307,0.5591945657447841
8130,0.8718,4,0,4,669176,7268,117040,9216,0.05756558104169307,0.5590876000970638
8131,0.8719,0,3,0,669179,7265,117040,9216,0.057541819794702825,0.5591893695770888
8132,0.872,7,4,7,669183,7261,117047,9209,0.05751013813204917,0.5591378263509411
8133,0.8721,0,3,0,669186,7258,117047,9209,0.05748637688505893,0.5592396915042206
8134,0.8722,0,2,0,669188,7256,117047,9209,0.0574705360537321,0.5593076222289706
8135,0.8723,0,6,0,669194,7250,117047,9209,0.057423013559751615,0.5595115134576827
8136,0.8724,0,2,0,669196,7248,117047,9209,0.057407172728424785,0.5595795102388041
8137,0.8725,21,41,21,669237,7207,117068,9188,0.057082435686224814,0.5604147605977432
8138,0.8726,0,2,0,669239,7205,117068,9188,0.057066594854897984,0.5604831330445922
8139,0.8727,0,8,0,669247,7197,117068,9188,0.05700323152959067,0.5607567897467196
8140,0.8728,1,4,1,669251,7193,117069,9187,0.05697154986693702,0.5608669108669109
8141,0.873,2,8,2,669259,7185,117071,9185,0.056908186541629706,0.561087354917532
8142,0.8731,1,3,1,669262,7182,117072,9184,0.05688442529463946,0.561163387510693
8143,0.8732,2,3,2,669265,7179,117074,9182,0.05686066404764922,0.5612126398141923
8144,0.8733,45,53,45,669318,7126,117119,9137,0.05644088201748828,0.5618274611080366
8145,0.8735,1,3,1,669321,7123,117120,9136,0.056417120770498035,0.5619041761485947
8146,0.8736,0,1,0,669322,7122,117120,9136,0.05640920035483462,0.5619387378521343
8147,0.8737,1,3,1,669325,7119,117121,9135,0.05638543910784438,0.562015503875969
8148,0.8738,3,6,3,669331,7113,117124,9132,0.0563379166138639,0.5621421975992613
8149,0.8739,1,2,1,669333,7111,117125,9131,0.05632207578253707,0.5621844600418667
8150,0.874,11,10,11,669343,7101,117136,9120,0.05624287162590293,0.5622341409284262
8151,0.8741,1,0,1,669343,7101,117137,9119,0.05624287162590293,0.5622071516646115
8152,0.8742,6,13,6,669356,7088,117143,9113,0.056139906222278546,0.5624961422134436
8153,0.8743,2,9,2,669365,7079,117145,9111,0.05606862248130782,0.5627547869054972
8154,0.8745,1,1,1,669366,7078,117146,9110,0.056060702065644404,0.5627625401531999
8155,0.8746,1,2,1,669368,7076,117147,9109,0.056044861234317574,0.5628050664195242
8156,0.8747,2,3,2,669371,7073,117149,9107,0.056021099987327336,0.5628553770086526
8157,0.8748,0,2,0,669373,7071,117149,9107,0.056005259156000506,0.5629249598219804
8158,0.8749,1,3,1,669376,7068,117150,9106,0.05598149790901027,0.5630023494497342
8159,0.875,104,117,104,669493,6951,117254,9002,0.05505480927639082,0.564282580078982
8160,0.8751,0,1,0,669494,6950,117254,9002,0.05504688886072741,0.5643179538615848
8161,0.8752,1,3,1,669497,6947,117255,9001,0.05502312761373717,0.5643967895660897
8162,0.8753,1,5,1,669502,6942,117256,9000,0.054983525535420096,0.5645464809936018
8163,0.8754,0,3,0,669505,6939,117256,9000,0.05495976428842986,0.564652738565782
8164,0.8755,3,2,3,669507,6937,117259,8997,0.05494392345710303,0.5646416467930212
8165,0.8756,0,1,0,669508,6936,117259,8997,0.05493600304143961,0.5646770852946714
8166,0.8757,4,5,4,669513,6931,117263,8993,0.054896400963122545,0.564745038934941
8167,0.8758,1,5,1,669518,6926,117264,8992,0.05485679888480548,0.5648950873225279
8168,0.876,10,14,10,669532,6912,117274,8982,0.05474591306551768,0.565118912797282
8169,0.8761,1,8,1,669540,6904,117275,8981,0.05468254974021037,0.5653761410135347
8170,0.8762,1,1,1,669541,6903,117276,8980,0.054674629324546954,0.5653843732292388
8171,0.8763,3,5,3,669546,6898,117279,8977,0.05463502724622988,0.5654803149606299
8172,0.8764,2,4,2,669550,6894,117281,8975,0.05460334558357623,0.5655680887264478
8173,0.8765,1,3,1,669553,6891,117282,8974,0.05457958433658598,0.5656476520642925
8174,0.8767,52,70,52,669623,6821,117334,8922,0.054025155240147005,0.5667280696182431
8175,0.8768,1,4,1,669627,6817,117335,8921,0.053993473577493345,0.5668445799974584
8176,0.8769,1,1,1,669628,6816,117336,8920,0.05398555316182993,0.5668530757498729
8177,0.877,1,4,1,669632,6812,117337,8919,0.05395387149917628,0.5669696777064395
8178,0.8771,2,1,2,669633,6811,117339,8917,0.05394595108351286,0.5669506612410987
8179,0.8772,2,1,2,669634,6810,117341,8915,0.05393803066784945,0.5669316375198729
8180,0.8773,2,3,2,669637,6807,117343,8913,0.05391426942085921,0.5669847328244275
8181,0.8775,15,33,15,669670,6774,117358,8898,0.053652895703966544,0.5677641653905053
8182,0.8776,1,3,1,669673,6771,117359,8897,0.0536291344569763,0.5678452897625734
8183,0.8777,3,5,3,669678,6766,117362,8894,0.05358953237865923,0.5679438058748404
8184,0.8778,0,1,0,669679,6765,117362,8894,0.053581611962995816,0.5679800753560252
8185,0.8779,0,4,0,669683,6761,117362,8894,0.05354993030034216,0.5681251996167359
8186,0.878,14,13,14,669696,6748,117376,8880,0.05344696489671778,0.5682109035065267
8187,0.8781,1,2,1,669698,6746,117377,8879,0.05343112406539095,0.568256
8188,0.8782,2,7,2,669705,6739,117379,8877,0.053375681155747055,0.5684554303278688
8189,0.8783,26,29,26,669734,6710,117405,8851,0.05314598910150805,0.5687937793200951
8190,0.8785,4,2,4,669736,6708,117409,8847,0.05313014827018122,0.5687560270009643
8191,0.8786,1,4,1,669740,6704,117410,8846,0.05309846660752756,0.5688745980707396
8192,0.8787,2,3,2,669743,6701,117412,8844,0.05307470536053732,0.5689289160501769
8193,0.8788,2,9,2,669752,6692,117414,8842,0.053003421619566594,0.5692030384962019
8194,0.8789,1,1,1,669753,6691,117415,8841,0.05299550120390318,0.5692119495235642
8195,0.879,5,8,5,669761,6683,117420,8836,0.05293213787859587,0.5693665828983826
8196,0.8791,1,0,1,669761,6683,117421,8835,0.05293213787859587,0.569338832323753
8197,0.8792,5,4,5,669765,6679,117426,8830,0.052900456215942214,0.5693468308723967
8198,0.8793,4,5,4,669770,6674,117430,8826,0.05286085413762514,0.5694193548387096
8199,0.8794,2,0,2,669770,6674,117432,8824,0.05286085413762514,0.569363788875984
8200,0.8795,1,0,1,669770,6674,117433,8823,0.05286085413762514,0.5693360005162289
8201,0.8796,1,3,1,669773,6671,117434,8822,0.0528370928906349,0.569418447040599
8202,0.8797,2,3,2,669776,6668,117436,8820,0.052813331643644656,0.5694731404958677
8203,0.8798,1,2,1,669778,6666,117437,8819,0.052797490812317834,0.569518889247659
8204,0.8799,0,1,0,669779,6665,117437,8819,0.05278957039665442,0.5695556703694136
8205,0.88,845,636,845,670415,6029,118282,7974,0.0477521860347231,0.5694494036992073
8206,0.8802,1,3,1,670418,6026,118283,7973,0.047728424787732864,0.5695406814772483
8207,0.8803,3,0,3,670418,6026,118286,7970,0.047728424787732864,0.5694484138325235
8208,0.8804,1,0,1,670418,6026,118287,7969,0.047728424787732864,0.5694176491604145
8209,0.8805,2,8,2,670426,6018,118289,7967,0.04766506146242555,0.56968180193064
8210,0.8806,0,1,0,670427,6017,118289,7967,0.047657141046762136,0.5697225400457666
8211,0.8807,0,3,0,670430,6014,118289,7967,0.04763337979977189,0.5698447893569845
8212,0.8808,4,10,4,670440,6004,118293,7963,0.04755417564313775,0.5701295911792081
8213,0.881,6,8,6,670448,5996,118299,7957,0.04749081231783044,0.5702716261735827
8214,0.8811,0,2,0,670450,5994,118299,7957,0.04747497148650361,0.570353379686044
8215,0.8812,2,4,2,670454,5990,118301,7955,0.04744328982384995,0.5704553603442094
8216,0.8813,2,8,2,670462,5982,118303,7953,0.04737992649854264,0.5707212055974166
8217,0.8814,2,0,2,670462,5982,118305,7951,0.04737992649854264,0.5706595851575397
8218,0.8815,1,3,1,670465,5979,118306,7950,0.0473561652515524,0.5707516691794099
8219,0.8816,1,0,1,670465,5979,118307,7949,0.0473561652515524,0.5707208500861574
8220,0.8817,14,36,14,670501,5943,118321,7935,0.0470710302876695,0.5717682663207955
8221,0.8818,1,1,1,670502,5942,118322,7934,0.047063109872006084,0.571778610550591
8222,0.8819,0,1,0,670503,5941,118322,7934,0.04705518945634267,0.5718198198198198
8223,0.882,8,6,8,670509,5935,118330,7926,0.047007666962362187,0.5718202149917033
8224,0.8821,1,1,1,670510,5934,118331,7925,0.04699974654669877,0.5718305794068836
8225,0.8822,2,4,2,670514,5930,118333,7923,0.04696806488404511,0.571933877138526
8226,0.8823,2,8,2,670522,5922,118335,7921,0.0469047015587378,0.5722025572491511
8227,0.8824,0,2,0,670524,5920,118335,7921,0.046888860727410976,0.572285239505816
8228,0.8825,18,30,18,670554,5890,118353,7903,0.046651248257508555,0.5729717972884797
8229,0.8826,3,1,3,670555,5889,118356,7900,0.04664332784184514,0.57292044383204
8230,0.8827,5,4,5,670559,5885,118361,7895,0.04661164617919148,0.5729317851959361
8231,0.8828,3,2,3,670561,5883,118364,7892,0.04659580534786466,0.5729219600725953
8232,0.8829,0,6,0,670567,5877,118364,7892,0.046548282853884175,0.573171617401409
8233,0.883,1,3,1,670570,5874,118365,7891,0.04652452160689393,0.573265528514348
8234,0.8832,1,1,1,670571,5873,118366,7890,0.046516601191230515,0.5732761752524885
8235,0.8833,58,62,58,670633,5811,118424,7832,0.046025535420098844,0.5740672872535366
8236,0.8834,1,0,1,670633,5811,118425,7831,0.046025535420098844,0.5740360650930949
8237,0.8835,4,2,4,670635,5809,118429,7827,0.04600969458877202,0.5739953065415078
8238,0.8836,0,2,0,670637,5807,118429,7827,0.04599385375744519,0.5740795071145666
8239,0.8837,1,4,1,670641,5803,118430,7826,0.04596217209479153,0.5742167437082691
8240,0.8838,1,3,1,670644,5800,118431,7825,0.04593841084780129,0.5743119266055046
8241,0.8839,0,2,0,670646,5798,118431,7825,0.045922570016474464,0.5743962416501505
8242,0.884,7,17,7,670663,5781,118438,7818,0.04578792295019642,0.5748952128833003
8243,0.8841,1,2,1,670665,5779,118439,7817,0.0457720821188696,0.5749485142689026
8244,0.8842,9,7,9,670672,5772,118448,7808,0.0457166392092257,0.5749631811487481
8245,0.8843,5,4,5,670676,5768,118453,7803,0.04568495754657204,0.5749760518753224
8246,0.8844,2,2,2,670678,5766,118455,7801,0.04566911671524521,0.5749981572934326
8247,0.8845,1,1,1,670679,5765,118456,7800,0.045661196299581805,0.5750092148912643
8248,0.8846,0,1,0,670680,5764,118456,7800,0.04565327588391839,0.5750516071955175
8249,0.8847,1,5,1,670685,5759,118457,7799,0.045613673805601315,0.5752323351526774
8250,0.8848,3,1,3,670686,5758,118460,7796,0.04560575338993791,0.5751807584476907
8251,0.8849,0,1,0,670687,5757,118460,7796,0.04559783297427449,0.5752231978159817
8252,0.885,111,104,111,670791,5653,118571,7685,0.044774109745279435,0.576173339331234
8253,0.8851,0,2,0,670793,5651,118571,7685,0.044758268913952605,0.5762597480503899
8254,0.8852,3,4,3,670797,5647,118574,7682,0.044726587251298945,0.5763373096256283
8255,0.8853,0,3,0,670800,5644,118574,7682,0.04470282600430871,0.5764670568812847
8256,0.8854,1,1,1,670801,5643,118575,7681,0.04469490558864529,0.5764785349744821
8257,0.8855,4,5,4,670806,5638,118579,7677,0.044655303510328224,0.5765677806984604
8258,0.8856,0,1,0,670807,5637,118579,7677,0.04464738309466481,0.5766110860748085
8259,0.8857,1,4,1,670811,5633,118580,7676,0.04461570143201115,0.57675257344654
8260,0.8858,7,8,7,670819,5625,118587,7669,0.04455233810670384,0.5768767865202347
8261,0.886,11,7,11,670826,5618,118598,7658,0.04449689519705994,0.5768303705935522
8262,0.8861,0,1,0,670827,5617,118598,7658,0.044488974781396524,0.5768738229755179
8263,0.8862,2,2,2,670829,5615,118600,7656,0.0444731339500697,0.5768969934443523
8264,0.8863,2,4,2,670833,5611,118602,7654,0.04444145228741604,0.5770071617037317
8265,0.8864,0,2,0,670835,5609,118602,7654,0.04442561145608922,0.577094171756013
8266,0.8865,2,3,2,670838,5606,118604,7652,0.044401850209098974,0.5771609594207271
8267,0.8867,63,57,63,670895,5549,118667,7589,0.04395038651628438,0.5776373877302481
8268,0.8868,1,3,1,670898,5546,118668,7588,0.04392662526929413,0.5777371707019948
8269,0.8869,1,2,1,670900,5544,118669,7587,0.0439107844379673,0.5777930089102125
8270,0.887,4,1,4,670901,5543,118673,7583,0.04390286402230389,0.5777083650769466
8271,0.8871,1,3,1,670904,5540,118674,7582,0.04387910277531365,0.5778082609358329
8272,0.8872,2,0,2,670904,5540,118676,7580,0.04387910277531365,0.5777439024390244
8273,0.8873,4,2,4,670906,5538,118680,7576,0.04386326194398682,0.5777032179350312
8274,0.8874,0,3,0,670909,5535,118680,7576,0.043839500696996575,0.5778354053847914
8275,0.8875,21,35,21,670944,5500,118701,7555,0.04356228614877709,0.5787054768288012
8276,0.8876,2,1,2,670945,5499,118703,7553,0.04355436573311367,0.5786852589641435
8277,0.8877,0,4,0,670949,5495,118703,7553,0.04352268407046002,0.578862660944206
8278,0.8878,1,0,1,670949,5495,118704,7552,0.04352268407046002,0.5788303824634016
8279,0.8879,2,4,2,670953,5491,118706,7550,0.04349100240780636,0.578943332566521
8280,0.888,9,10,9,670963,5481,118715,7541,0.04341179825117222,0.5790969129166027
8281,0.8881,2,1,2,670964,5480,118717,7539,0.04340387783550881,0.5790767340041478
8282,0.8882,2,4,2,670968,5476,118719,7537,0.04337219617285515,0.5791900407285022
8283,0.8883,19,31,19,670999,5445,118738,7518,0.04312666328728932,0.5799583429761629
8284,0.8884,2,2,2,671001,5443,118740,7516,0.04311082245596249,0.5799830233814337
8285,0.8885,2,4,2,671005,5439,118742,7514,0.04307914079330883,0.5800972747626033
8286,0.8886,1,3,1,671008,5436,118743,7513,0.04305537954631859,0.5801992431848019
8287,0.8887,2,2,2,671010,5434,118745,7511,0.04303953871499176,0.5802240247199691
8288,0.8888,3,2,3,671012,5432,118748,7508,0.04302369788366493,0.5802163833075734
8289,0.889,7,5,7,671017,5427,118755,7501,0.042984095805347865,0.5802134900990099
8290,0.8891,2,3,2,671020,5424,118757,7499,0.04296033455835762,0.5802832159715237
8291,0.8892,7,12,7,671032,5412,118764,7492,0.042865289570396654,0.5805951642901426
8292,0.8893,5,3,5,671035,5409,118769,7487,0.04284152832340641,0.580567617866005
8293,0.8895,3,2,3,671037,5407,118772,7484,0.04282568749207959,0.5805600806764409
8294,0.8896,1,3,1,671040,5404,118773,7483,0.04280192624508934,0.5806626833242803
8295,0.8897,2,2,2,671042,5402,118775,7481,0.04278608541376251,0.5806877280136614
8296,0.8898,4,1,4,671043,5401,118779,7477,0.0427781649980991,0.5806025780400683
8297,0.89,745,551,745,671594,4850,119524,6732,0.038414015967557974,0.5812467622172336
8298,0.8901,2,1,2,671595,4849,119526,6730,0.038406095551894566,0.5812246307971327
8299,0.8902,2,1,2,671596,4848,119528,6728,0.03839817513623115,0.5812024879060125
8300,0.8903,2,3,2,671599,4845,119530,6726,0.038374413889240906,0.5812807881773399
8301,0.8904,0,1,0,671600,4844,119530,6726,0.03836649347357749,0.5813310285220398
8302,0.8905,1,2,1,671602,4842,119531,6725,0.03835065264225067,0.5813953488372093
8303,0.8907,5,10,5,671612,4832,119536,6720,0.038271448485616526,0.5817174515235457
8304,0.8908,6,8,6,671620,4824,119542,6714,0.03820808516030921,0.5819032761310452
8305,0.8909,0,1,0,671621,4823,119542,6714,0.0382001647446458,0.581953714137124
8306,0.891,3,5,3,671626,4818,119545,6711,0.03816056266632873,0.5820973198022379
8307,0.8912,0,4,0,671630,4814,119545,6711,0.03812888100367507,0.5822993492407809
8308,0.8913,0,4,0,671634,4810,119545,6711,0.03809719934102142,0.5825015189653676
8309,0.8915,2,2,2,671636,4808,119547,6709,0.03808135850969459,0.5825301727880524
8310,0.8917,19,26,19,671662,4782,119566,6690,0.03787542770244583,0.5831589958158996
8311,0.8918,0,1,0,671663,4781,119566,6690,0.03786750728678241,0.5832098334931567
8312,0.8919,1,4,1,671667,4777,119567,6689,0.03783582562412875,0.5833769405197977
8313,0.892,3,7,3,671674,4770,119570,6686,0.037780382714484854,0.5836243016759777
8314,0.8921,0,1,0,671675,4769,119570,6686,0.03777246229882144,0.5836752509821039
8315,0.8922,0,6,0,671681,4763,119570,6686,0.03772493980484096,0.5839811337234693
8316,0.8923,1,1,1,671682,4762,119571,6685,0.03771701938917754,0.5839958067615969
8317,0.8924,0,2,0,671684,4760,119571,6685,0.03770117855785072,0.5840978593272171
8318,0.8925,28,26,28,671710,4734,119599,6657,0.03749524775060195,0.5844087437450619
8319,0.8926,0,1,0,671711,4733,119599,6657,0.037487327334938536,0.5844600526777876
8320,0.8927,3,2,3,671713,4731,119602,6654,0.037471486503611706,0.5844532279314888
8321,0.8928,0,2,0,671715,4729,119602,6654,0.03745564567228488,0.5845559167179126
8322,0.8929,2,1,2,671716,4728,119604,6652,0.03744772525662147,0.5845342706502636
8323,0.893,1,2,1,671718,4726,119605,6651,0.03743188442529464,0.5846005098004746
8324,0.8932,4,8,4,671726,4718,119609,6647,0.037368521099987326,0.5848658161020678
8325,0.8933,42,43,42,671769,4675,119651,6605,0.037027943226460525,0.5855496453900709
8326,0.8934,1,2,1,671771,4673,119652,6604,0.037012102395133695,0.5856167420413231
8327,0.8935,0,7,0,671778,4666,119652,6604,0.0369566594854898,0.585980479148181
8328,0.8937,1,3,1,671781,4663,119653,6603,0.03693289823849956,0.5860997692171135
8329,0.8938,1,3,1,671784,4660,119654,6602,0.036909136991509314,0.586219144024152
8330,0.8939,0,2,0,671786,4658,119654,6602,0.036893296160182484,0.5863232682060391
8331,0.894,11,17,11,671803,4641,119665,6591,0.03675864909390445,0.5868055555555556
8332,0.8941,0,2,0,671805,4639,119665,6591,0.03674280826257762,0.5869100623330366
8333,0.8942,4,9,4,671814,4630,119669,6587,0.036671524521606894,0.5872336631898012
8334,0.8943,3,4,3,671818,4626,119672,6584,0.03663984285895324,0.5873327386262266
8335,0.8945,2,2,2,671820,4624,119674,6582,0.03662400202762641,0.5873639121898983
8336,0.8946,2,2,2,671822,4622,119676,6580,0.03660816119629958,0.5873951080164257
8337,0.8947,0,2,0,671824,4620,119676,6580,0.03659232036497275,0.5875
8338,0.8948,0,2,0,671826,4618,119676,6580,0.03657647953364593,0.5876049294516879
8339,0.8949,2,1,2,671827,4617,119678,6578,0.03656855911798251,0.5875837427422956
8340,0.895,118,102,118,671929,4515,119796,6460,0.03576067672031428,0.5886104783599089
8341,0.8951,0,3,0,671932,4512,119796,6460,0.03573691547332404,0.5887714181553044
8342,0.8952,0,3,0,671935,4509,119796,6460,0.035713154226333796,0.5889324459841371
8343,0.8953,0,3,0,671938,4506,119796,6460,0.03568939297934356,0.5890935619186577
8344,0.8954,1,1,1,671939,4505,119797,6459,0.03568147256368014,0.5891098139365195
8345,0.8955,3,5,3,671944,4500,119800,6456,0.035641870485363075,0.5892661555312158
8346,0.8956,2,1,2,671945,4499,119802,6454,0.03563395006969966,0.5892449557198941
8347,0.8957,2,0,2,671945,4499,119804,6452,0.03563395006969966,0.5891699388183728
8348,0.8958,5,7,5,671952,4492,119809,6447,0.03557850716005576,0.5893591735990493
8349,0.896,5,10,5,671962,4482,119814,6442,0.03549930300342162,0.5897107286708165
8350,0.8961,0,2,0,671964,4480,119814,6442,0.03548346217209479,0.58981871452115
8351,0.8962,0,2,0,671966,4478,119814,6442,0.03546762134076796,0.5899267399267399
8352,0.8963,3,2,3,671968,4476,119817,6439,0.03545178050944114,0.5899221255153458
8353,0.8964,0,2,0,671970,4474,119817,6439,0.03543593967811431,0.5900302391642994
8354,0.8965,2,3,2,671973,4471,119819,6437,0.03541217843112406,0.5901173450678401
8355,0.8966,0,1,0,671974,4470,119819,6437,0.035404258015460655,0.5901714495278262
8356,0.8967,27,42,27,672016,4428,119846,6410,0.03507160055759726,0.5914375346004798
8357,0.8968,1,1,1,672017,4427,119847,6409,0.035063680141933846,0.591454411221853
8358,0.8969,1,0,1,672017,4427,119848,6408,0.035063680141933846,0.5914167051222888
8359,0.897,2,3,2,672020,4424,119850,6406,0.03503991889494361,0.5915050784856879
8360,0.8971,2,1,2,672021,4423,119852,6404,0.035031998479280194,0.5914842523321326
8361,0.8972,1,1,1,672022,4422,119853,6403,0.03502407806361678,0.5915011547344111
8362,0.8973,1,1,1,672023,4421,119854,6402,0.035016157647953364,0.5915180633835351
8363,0.8974,0,2,0,672025,4419,119854,6402,0.035000316816626534,0.5916273911838092
8364,0.8975,24,29,24,672054,4390,119878,6378,0.03477062476238753,0.5923105497771174
8365,0.8976,3,3,3,672057,4387,119881,6375,0.03474686351539729,0.5923620144954469
8366,0.8977,1,1,1,672058,4386,119882,6374,0.034738943099733875,0.5923791821561338
8367,0.8978,3,5,3,672063,4381,119885,6371,0.0346993410214168,0.5925409226190477
8368,0.898,9,9,9,672072,4372,119894,6362,0.03462805728044608,0.5926961058319359
8369,0.8982,1,2,1,672074,4370,119895,6361,0.03461221644911925,0.5927686142950331
8370,0.8983,23,25,23,672099,4345,119918,6338,0.0344142060575339,0.5932790414677525
8371,0.8984,0,1,0,672100,4344,119918,6338,0.03440628564187048,0.5933345815390376
8372,0.8985,2,1,2,672101,4343,119920,6336,0.034398365226207074,0.5933139807098042
8373,0.8986,1,3,1,672104,4340,119921,6335,0.03437460397921683,0.5934426229508196
8374,0.8988,3,1,3,672105,4339,119924,6332,0.034366683563553414,0.5933839377752788
8375,0.8989,1,0,1,672105,4339,119925,6331,0.034366683563553414,0.5933458294283036
8376,0.899,3,4,3,672109,4335,119928,6328,0.03433500190089976,0.5934539998124355
8377,0.8992,5,4,5,672113,4331,119933,6323,0.0343033202382461,0.5934860146423878
8378,0.8993,2,2,2,672115,4329,119935,6321,0.03428747940691927,0.5935211267605633
8379,0.8994,0,1,0,672116,4328,119935,6321,0.034279558991255864,0.5935768616771527
8380,0.8995,3,3,3,672119,4325,119938,6318,0.03425579774426562,0.5936296157098563
8381,0.8997,0,1,0,672120,4324,119938,6318,0.034247877328602204,0.5936853974816764
8382,0.8998,3,5,3,672125,4319,119941,6315,0.034208275250285136,0.5938499153658078
8383,0.8999,0,1,0,672126,4318,119941,6315,0.03420035483462172,0.5939057650710053
8384,0.9,685,486,685,672612,3832,120626,5630,0.030351032822202507,0.5950116254491651
8385,0.9001,1,2,1,672614,3830,120627,5629,0.03033519199087568,0.5950946188814885
8386,0.9002,2,4,2,672618,3826,120629,5627,0.030303510328222025,0.5952607637786946
8387,0.9004,0,1,0,672619,3825,120629,5627,0.03029558991255861,0.5953237410071942
8388,0.9005,1,3,1,672622,3822,120630,5626,0.03027182866556837,0.5954699407281965
8389,0.9006,1,2,1,672624,3820,120631,5625,0.030255987834241542,0.5955532027527792
8390,0.9007,0,4,0,672628,3816,120631,5625,0.030224306171587886,0.5958055290753098
8391,0.9008,5,8,5,672636,3808,120636,5620,0.030160942846280573,0.5960967331353415
8392,0.9009,1,3,1,672639,3805,120637,5619,0.03013718159929033,0.5962436332767402
8393,0.901,2,4,2,672643,3801,120639,5617,0.030105499936636675,0.5964111276279465
8394,0.9011,1,1,1,672644,3800,120640,5616,0.03009757952097326,0.5964316057774002
8395,0.9012,1,3,1,672647,3797,120641,5615,0.03007381827398302,0.5965788355291117
8396,0.9013,0,1,0,672648,3796,120641,5615,0.030065897858319604,0.5966422271809585
8397,0.9014,2,3,2,672651,3793,120643,5613,0.030042136611329363,0.5967467573889007
8398,0.9015,2,5,2,672656,3788,120645,5611,0.03000253453301229,0.5969784019576551
8399,0.9017,16,17,16,672673,3771,120661,5595,0.029867887466734255,0.5973734785393978
8400,0.9018,0,1,0,672674,3770,120661,5595,0.02985996705107084,0.597437266417512
8401,0.902,13,4,13,672678,3766,120674,5582,0.029828285388417183,0.5971330765939238
8402,0.9021,0,4,0,672682,3762,120674,5582,0.029796603725763527,0.597388698630137
8403,0.9022,3,2,3,672684,3760,120677,5579,0.0297807628944367,0.5973873005675125
8404,0.9023,1,3,1,672687,3757,120678,5578,0.02975700164744646,0.5975361542581682
8405,0.9024,0,2,0,672689,3755,120678,5578,0.02974116081611963,0.597664202292939
8406,0.9025,24,15,24,672704,3740,120702,5554,0.02962235458116842,0.5975898429094039
8407,0.9027,2,4,2,672708,3736,120704,5552,0.029590672918514763,0.5977605512489234
8408,0.9028,0,1,0,672709,3735,120704,5552,0.02958275250285135,0.5978249165500161
8409,0.9029,1,1,1,672710,3734,120705,5551,0.029574832087187936,0.5978459881529349
8410,0.903,0,1,0,672711,3733,120705,5551,0.02956691167152452,0.5979103834554071
8411,0.9031,2,4,2,672715,3729,120707,5549,0.029535230008870865,0.5980814830782496
8412,0.9032,2,2,2,672717,3727,120709,5547,0.02951938917754404,0.5981237869312055
8413,0.9033,43,52,43,672769,3675,120752,5504,0.02910752756304651,0.599629589279878
8414,0.9034,1,0,1,672769,3675,120753,5503,0.02910752756304651,0.5995859664414905
8415,0.9035,2,4,2,672773,3671,120755,5501,0.029075845900392853,0.5997601395551679
8416,0.9036,1,1,1,672774,3670,120756,5500,0.02906792548472944,0.5997818974918212
8417,0.9037,0,3,0,672777,3667,120756,5500,0.029044164237739197,0.5999781826115413
8418,0.9038,1,3,1,672780,3664,120757,5499,0.029020402990748956,0.6001309614754993
8419,0.9039,1,2,1,672782,3662,120758,5498,0.029004562159422126,0.6002183406113537
8420,0.904,5,11,5,672793,3651,120763,5493,0.028917437587124572,0.6007217847769029
8421,0.9041,0,1,0,672794,3650,120763,5493,0.028909517171461157,0.6007874876955047
8422,0.9042,4,5,4,672799,3645,120767,5489,0.02886991509314409,0.6009415371140793
8423,0.9043,1,2,1,672801,3643,120768,5488,0.02885407426181726,0.6010294600810426
8424,0.9044,1,2,1,672803,3641,120769,5487,0.028838233430490433,0.6011174408413672
8425,0.9045,2,2,2,672805,3639,120771,5485,0.028822392599163603,0.6011617711530031
8426,0.9046,1,1,1,672806,3638,120772,5484,0.02881447218350019,0.6011839508879632
8427,0.9047,1,4,1,672810,3634,120773,5483,0.028782790520846535,0.6014039706043655
8428,0.9048,0,2,0,672812,3632,120773,5483,0.028766949689519705,0.601535929786067
8429,0.9049,1,0,1,672812,3632,120774,5482,0.028766949689519705,0.6014922097871407
8430,0.905,113,72,113,672884,3560,120887,5369,0.0281966797617539,0.6012991376413932
8431,0.9052,1,3,1,672887,3557,120888,5368,0.028172918514763653,0.6014565826330532
8432,0.9053,0,5,0,672892,3552,120888,5368,0.028133316436446586,0.6017937219730942
8433,0.9054,0,1,0,672893,3551,120888,5368,0.02812539602078317,0.6018611952012557
8434,0.9055,0,2,0,672895,3549,120888,5368,0.028109555189456344,0.6019961870584277
8435,0.9056,2,3,2,672898,3546,120890,5366,0.0280857939424661,0.6021095152603232
8436,0.9057,0,4,0,672902,3542,120890,5366,0.028054112279812443,0.6023798832510103
8437,0.9058,7,13,7,672915,3529,120897,5359,0.027951146876188063,0.6029477947794779
8438,0.9059,0,1,0,672916,3528,120897,5359,0.027943226460524648,0.603015640823675
8439,0.906,13,6,13,672922,3522,120910,5346,0.027895703966544165,0.6028416779431665
8440,0.9062,1,3,1,672925,3519,120911,5345,0.027871942719553924,0.6030009025270758
8441,0.9063,1,5,1,672930,3514,120912,5344,0.027832340641236852,0.6032964551817566
8442,0.9064,1,0,1,672930,3514,120913,5343,0.027832340641236852,0.6032516653494411
8443,0.9065,0,3,0,672933,3511,120913,5343,0.02780857939424661,0.6034560650553422
8444,0.9066,0,5,0,672938,3506,120913,5343,0.02776897731592954,0.6037970392134705
8445,0.9067,43,28,43,672966,3478,120956,5300,0.02754720567735395,0.6037821827295512
8446,0.9068,1,1,1,672967,3477,120957,5299,0.027539285261690534,0.6038058340929808
8447,0.907,2,2,2,672969,3475,120959,5297,0.027523444430363704,0.6038531691746466
8448,0.9071,1,2,1,672971,3473,120960,5296,0.027507603599036878,0.6039457178697685
8449,0.9072,1,1,1,672972,3472,120961,5295,0.027499683183373463,0.6039694308201209
8450,0.9073,4,5,4,672977,3467,120965,5291,0.027460081105056395,0.6041333637816854
8451,0.9074,3,0,3,672977,3467,120968,5288,0.027460081105056395,0.6039977155910908
8452,0.9075,24,8,24,672985,3459,120992,5264,0.027396717779749082,0.603462111658833
8453,0.9076,0,4,0,672989,3455,120992,5264,0.027365036117095426,0.6037389608900103
8454,0.9077,1,1,1,672990,3454,120993,5263,0.02735711570143201,0.6037627624182632
8455,0.9079,0,2,0,672992,3452,120993,5263,0.027341274870105185,0.6039013195639702
8456,0.908,7,7,7,672999,3445,121000,5256,0.027285831960461283,0.6040684978738076
8457,0.9081,1,0,1,672999,3445,121001,5255,0.027285831960461283,0.6040229885057471
8458,0.9082,1,2,1,673001,3443,121002,5254,0.027269991129134457,0.6041163619638956
8459,0.9083,7,10,7,673011,3433,121009,5247,0.027190786972500318,0.6044930875576037
8460,0.9085,4,4,4,673015,3429,121013,5243,0.02715910530984666,0.604589483394834
8461,0.9087,1,1,1,673016,3428,121014,5242,0.027151184894183247,0.6046136101499423
8462,0.9089,2,0,2,673016,3428,121016,5240,0.027151184894183247,0.6045223811721273
8463,0.909,4,3,4,673019,3425,121020,5236,0.027127423647193005,0.6045491282761806
8464,0.9091,0,1,0,673020,3424,121020,5236,0.02711950323152959,0.6046189376443418
8465,0.9092,4,12,4,673032,3412,121024,5232,0.02702445824356862,0.6052753354928274
8466,0.9093,1,0,1,673032,3412,121025,5231,0.02702445824356862,0.6052296656253615
8467,0.9094,0,3,0,673035,3409,121025,5231,0.02700069699657838,0.6054398148148148
8468,0.9095,2,2,2,673037,3407,121027,5229,0.026984856165251554,0.6054886521537749
8469,0.9096,1,0,1,673037,3407,121028,5228,0.026984856165251554,0.6054429646786335
8470,0.9097,2,4,2,673041,3403,121030,5226,0.026953174502597897,0.6056321705875536
8471,0.9098,2,4,2,673045,3399,121032,5224,0.02692149283994424,0.6058216398005335
8472,0.91,669,418,669,673463,2981,121701,4555,0.02361075909263718,0.6044320594479831
8473,0.9101,1,1,1,673464,2980,121702,4554,0.023602838676973766,0.6044597823201486
8474,0.9102,2,4,2,673468,2976,121704,4552,0.02357115701432011,0.6046758767268863
8475,0.9103,0,1,0,673469,2975,121704,4552,0.0235632365986567,0.6047562109738276
8476,0.9104,1,0,1,673469,2975,121705,4551,0.0235632365986567,0.6047036938612809
8477,0.9105,4,2,4,673471,2973,121709,4547,0.02354739576732987,0.604654255319149
8478,0.9107,4,3,4,673474,2970,121713,4543,0.023523634520339627,0.6046852122986823
8479,0.9108,5,3,5,673477,2967,121718,4538,0.023499873273349386,0.6046635576282479
8480,0.9109,0,1,0,673478,2966,121718,4538,0.02349195285768597,0.6047441364605544
8481,0.911,2,2,2,673480,2964,121720,4536,0.023476112026359144,0.6048
8482,0.9111,0,2,0,673482,2962,121720,4536,0.023460271195032315,0.6049613230194718
8483,0.9112,2,5,2,673487,2957,121722,4534,0.023420669116715247,0.605259644907222
8484,0.9113,2,0,2,673487,2957,121724,4532,0.023420669116715247,0.6051542261984244
8485,0.9114,0,3,0,673490,2954,121724,4532,0.023396907869725002,0.6053967405824205
8486,0.9115,0,1,0,673491,2953,121724,4532,0.02338898745406159,0.6054776219104876
8487,0.9116,1,2,1,673493,2951,121725,4531,0.02337314662273476,0.6055867415129644
8488,0.9117,14,18,14,673511,2933,121739,4517,0.02323057914079331,0.6063087248322148
8489,0.9118,1,0,1,673511,2933,121740,4516,0.02323057914079331,0.60625587327158
8490,0.9119,1,0,1,673511,2933,121741,4515,0.02323057914079331,0.606203007518797
8491,0.912,6,3,6,673514,2930,121747,4509,0.023206817893803067,0.6061298561634628
8492,0.9121,1,1,1,673515,2929,121748,4508,0.023198897478139652,0.6061583972031733
8493,0.9122,0,1,0,673516,2928,121748,4508,0.023190977062476237,0.6062399139322217
8494,0.9123,1,2,1,673518,2926,121749,4507,0.02317513623114941,0.6063500605408314
8495,0.9124,1,2,1,673520,2924,121750,4506,0.02315929539982258,0.6064602960969044
8496,0.9125,11,13,11,673533,2911,121761,4495,0.0230563299961982,0.6069403186605455
8497,0.9126,0,2,0,673535,2909,121761,4495,0.02304048916487137,0.6071042679632631
8498,0.9127,2,4,2,673539,2905,121763,4493,0.023008807502217718,0.6073263044065964
8499,0.9128,1,0,1,673539,2905,121764,4492,0.023008807502217718,0.6072732188725158
8500,0.9129,3,3,3,673542,2902,121767,4489,0.022985046255227473,0.607360303071303
8501,0.913,0,5,0,673547,2897,121767,4489,0.022945444176910405,0.607771459518007
8502,0.9131,1,0,1,673547,2897,121768,4488,0.022945444176910405,0.6077183480027082
8503,0.9132,1,2,1,673549,2895,121769,4487,0.022929603345583575,0.6078298564074777
8504,0.9133,41,27,41,673576,2868,121810,4446,0.022715752122671396,0.6078753076292043
8505,0.9135,1,2,1,673578,2866,121811,4445,0.02269991129134457,0.6079879633429079
8506,0.9136,1,0,1,673578,2866,121812,4444,0.02269991129134457,0.6079343365253078
8507,0.9137,0,3,0,673581,2863,121812,4444,0.02267615004435433,0.6081839332147256
8508,0.9138,2,2,2,673583,2861,121814,4442,0.0226603092130275,0.6082431877310694
8509,0.9139,0,1,0,673584,2860,121814,4442,0.022652388797364087,0.6083264858942755
8510,0.914,7,4,7,673588,2856,121821,4435,0.02262070713471043,0.6082841859827184
8511,0.9142,4,10,4,673598,2846,121825,4431,0.022541502978076288,0.6089047684485365
8512,0.9143,3,3,3,673601,2843,121828,4428,0.022517741731086047,0.6089946362261037
8513,0.9145,2,2,2,673603,2841,121830,4426,0.02250190089975922,0.6090546305215357
8514,0.9147,2,1,2,673604,2840,121832,4424,0.022493980484095805,0.6090308370044053
8515,0.9148,4,2,4,673606,2838,121836,4420,0.02247813965276898,0.6089831909616974
8516,0.915,66,73,66,673679,2765,121902,4354,0.021899949309339754,0.6116027531956736
8517,0.9151,1,0,1,673679,2765,121903,4353,0.021899949309339754,0.6115481876931722
8518,0.9152,2,2,2,673681,2763,121905,4351,0.021884108478012927,0.6116109080685971
8519,0.9153,1,0,1,673681,2763,121906,4350,0.021884108478012927,0.6115563053563897
8520,0.9154,0,1,0,673682,2762,121906,4350,0.021876188062349512,0.6116422947131609
8521,0.9155,5,0,5,673682,2762,121911,4345,0.021876188062349512,0.6113690727451808
8522,0.9156,0,2,0,673684,2760,121911,4345,0.021860347231022682,0.6115411681914145
8523,0.9157,4,7,4,673691,2753,121915,4341,0.021804904321378785,0.6119255709049901
8524,0.9158,1,1,1,673692,2752,121916,4340,0.021796983905715373,0.6119571347997744
8525,0.9159,1,0,1,673692,2752,121917,4339,0.021796983905715373,0.6119024115075448
8526,0.916,6,8,6,673700,2744,121923,4333,0.02173362058040806,0.6122650840751731
8527,0.9161,1,0,1,673700,2744,121924,4332,0.02173362058040806,0.6122102882984737
8528,0.9162,1,6,1,673706,2738,121925,4331,0.021686098086427574,0.612675060121658
8529,0.9163,1,1,1,673707,2737,121926,4330,0.021678177670764163,0.6127069477854818
8530,0.9164,0,3,0,673710,2734,121926,4330,0.021654416423773918,0.6129671574178935
8531,0.9165,3,1,3,673711,2733,121929,4327,0.021646496008110507,0.6128895184135977
8532,0.9167,36,50,36,673761,2683,121965,4291,0.021250475224939804,0.6152853455692573
8533,0.9168,2,1,2,673762,2682,121967,4289,0.02124255480927639,0.6152632333954956
8534,0.9169,2,1,2,673763,2681,121969,4287,0.021234634393612978,0.6152411021814007
8535,0.917,1,4,1,673767,2677,121970,4286,0.02120295273095932,0.615539279046388
8536,0.9171,7,3,7,673770,2674,121977,4279,0.02117919148396908,0.6154178052639149
8537,0.9172,0,2,0,673772,2672,121977,4279,0.02116335065264225,0.6155948784347576
8538,0.9173,1,0,1,673772,2672,121978,4278,0.02116335065264225,0.6155395683453238
8539,0.9174,2,1,2,673773,2671,121980,4276,0.021155430236978835,0.6155174895638406
8540,0.9175,14,18,14,673791,2653,121994,4262,0.021012862755037384,0.6163412870571222
8541,0.9177,0,1,0,673792,2652,121994,4262,0.021004942339373972,0.6164304310095459
8542,0.9179,3,0,3,673792,2652,121997,4259,0.021004942339373972,0.6162639270727825
8543,0.918,8,6,8,673798,2646,122005,4251,0.020957419845393486,0.6163549369290996
8544,0.9181,0,1,0,673799,2645,122005,4251,0.02094949942973007,0.6164443155452436
8545,0.9182,2,2,2,673801,2643,122007,4249,0.020933658598403244,0.6165118978525828
8546,0.9183,10,16,10,673817,2627,122017,4239,0.02080693194778862,0.6173900378677541
8547,0.9185,3,2,3,673819,2625,122020,4236,0.020791091116461793,0.6174027109750765
8548,0.9186,1,0,1,673819,2625,122021,4235,0.020791091116461793,0.6173469387755102
8549,0.9187,2,1,2,673820,2624,122023,4233,0.020783170700798378,0.6173253609450197
8550,0.9188,0,2,0,673822,2622,122023,4233,0.02076732986947155,0.6175054704595186
8551,0.9189,3,3,3,673825,2619,122026,4230,0.020743568622481307,0.6176084099868594
8552,0.919,2,8,2,673833,2611,122028,4228,0.020680205297173997,0.6182190378710338
8553,0.9192,4,7,4,673840,2604,122032,4224,0.020624762387530096,0.6186291739894552
8554,0.9193,4,2,4,673842,2602,122036,4220,0.02060892155620327,0.6185869246555262
8555,0.9195,1,1,1,673843,2601,122037,4219,0.020601001140539855,0.6186217008797654
8556,0.9196,2,3,2,673846,2598,122039,4217,0.020577239893549613,0.6187820983125458
8557,0.9197,1,4,1,673850,2594,122040,4216,0.020545558230895957,0.6190895741556535
8558,0.9198,0,2,0,673852,2592,122040,4216,0.02052971739956913,0.6192714453584018
8559,0.92,606,340,606,674192,2252,122646,3610,0.017836776074008364,0.6158307744796998
8560,0.9201,2,1,2,674193,2251,122648,3608,0.01782885565834495,0.6158047448370029
8561,0.9202,0,1,0,674194,2250,122648,3608,0.017820935242681538,0.6159098668487538
8562,0.9203,1,0,1,674194,2250,122649,3607,0.017820935242681538,0.6158442888850948
8563,0.9206,0,1,0,674195,2249,122649,3607,0.017813014827018123,0.6159494535519126
8564,0.9207,2,0,2,674195,2249,122651,3605,0.017813014827018123,0.6158182439357704
8565,0.9208,4,4,4,674199,2245,122655,3601,0.017781333164364466,0.6159767362299008
8566,0.921,2,5,2,674204,2240,122657,3599,0.017741731086047395,0.6163726665524919
8567,0.9212,0,2,0,674206,2238,122657,3599,0.01772589025472057,0.6165838615727257
8568,0.9215,0,4,0,674210,2234,122657,3599,0.017694208592066912,0.6170066860963483
8569,0.9217,13,13,13,674223,2221,122670,3586,0.01759124318844253,0.6175305665576029
8570,0.9218,0,2,0,674225,2219,122670,3586,0.017575402357115702,0.6177433247200689
8571,0.9219,1,0,1,674225,2219,122671,3585,0.017575402357115702,0.6176774638180565
8572,0.922,1,2,1,674227,2217,122672,3584,0.017559561525788872,0.6178245130149974
8573,0.9221,0,1,0,674228,2216,122672,3584,0.01755164111012546,0.6179310344827587
8574,0.9223,0,2,0,674230,2214,122672,3584,0.01753580027879863,0.6181441876509141
8575,0.9224,1,1,1,674231,2213,122673,3583,0.017527879863135216,0.6181849551414769
8576,0.9225,17,9,17,674240,2204,122690,3566,0.01745659612216449,0.6180242634315425
8577,0.9227,0,1,0,674241,2203,122690,3566,0.017448675706501077,0.6181313919223436
8578,0.9228,1,2,1,674243,2201,122691,3565,0.01743283487517425,0.6182795698924731
8579,0.9229,2,1,2,674244,2200,122693,3563,0.017424914459510835,0.6182543813985771
8580,0.923,2,2,2,674246,2198,122695,3561,0.017409073628184005,0.6183365167563813
8581,0.9231,1,2,1,674248,2196,122696,3560,0.01739323279685718,0.6184850590687978
8582,0.9232,3,0,3,674248,2196,122699,3557,0.01739323279685718,0.618286111593951
8583,0.9233,24,18,24,674266,2178,122723,3533,0.017250665314915727,0.6186307126597794
8584,0.9235,0,3,0,674269,2175,122723,3533,0.017226904067925486,0.6189558514365803
8585,0.9236,1,3,1,674272,2172,122724,3532,0.01720314282093524,0.6192145862552595
8586,0.9237,1,1,1,674273,2171,122725,3531,0.01719522240527183,0.6192564012627149
8587,0.9238,2,2,2,674275,2169,122727,3529,0.017179381573945,0.6193401193401193
8588,0.9239,0,3,0,674278,2166,122727,3529,0.01715562032695476,0.6196663740122915
8589,0.924,5,7,5,674285,2159,122732,3524,0.01710017741731086,0.620095020235791
8590,0.9241,0,1,0,674286,2158,122732,3524,0.017092257001647446,0.620204153467089
8591,0.9242,7,6,7,674292,2152,122739,3517,0.017044734507666963,0.6203916034573999
8592,0.9244,0,1,0,674293,2151,122739,3517,0.017036814092003548,0.620501058574453
8593,0.9245,1,0,1,674293,2151,122740,3516,0.017036814092003548,0.6204340921122287
8594,0.9246,0,1,0,674294,2150,122740,3516,0.017028893676340133,0.6205435933639252
8595,0.9247,1,2,1,674296,2148,122741,3515,0.017013052845013307,0.6206957443051386
8596,0.9248,0,1,0,674297,2147,122741,3515,0.01700513242934989,0.6208053691275168
8597,0.925,46,51,46,674348,2096,122787,3469,0.016601191230515778,0.623360287511231
8598,0.9252,0,1,0,674349,2095,122787,3469,0.016593270814852363,0.6234723220704529
8599,0.9253,1,2,1,674351,2093,122788,3468,0.016577429983525536,0.6236288437331415
8600,0.9254,1,0,1,674351,2093,122789,3467,0.016577429983525536,0.6235611510791367
8601,0.9255,6,3,6,674354,2090,122795,3461,0.01655366873653529,0.6234912628355251
8602,0.9256,0,1,0,674355,2089,122795,3461,0.01654574832087188,0.6236036036036036
8603,0.9257,3,1,3,674356,2088,122798,3458,0.016537827905208465,0.6235124413992066
8604,0.9258,0,7,0,674363,2081,122798,3458,0.016482384995564568,0.6243004152374074
8605,0.926,8,4,8,674367,2077,122806,3450,0.01645070333291091,0.6242084313370726
8606,0.9261,0,1,0,674368,2076,122806,3450,0.016442782917247496,0.6243213897937026
8607,0.9262,0,1,0,674369,2075,122806,3450,0.016434862501584085,0.6244343891402715
8608,0.9264,3,1,3,674370,2074,122809,3447,0.01642694208592067,0.6243434160478174
8609,0.9265,1,0,1,674370,2074,122810,3446,0.01642694208592067,0.6242753623188406
8610,0.9266,0,3,0,674373,2071,122810,3446,0.01640318083893043,0.6246148268986769
8611,0.9267,30,25,30,674398,2046,122840,3416,0.016205170447345076,0.6254119370194068
8612,0.9268,0,4,0,674402,2042,122840,3416,0.01617348878469142,0.6258702821546354
8613,0.927,2,5,2,674407,2037,122842,3414,0.01613388670637435,0.6263070996147496
8614,0.9271,1,2,1,674409,2035,122843,3413,0.01611804587504752,0.6264684287812041
8615,0.9272,5,2,5,674411,2033,122848,3408,0.016102205043720695,0.6263554493659254
8616,0.9273,1,3,1,674414,2030,122849,3407,0.016078443796730454,0.6266323340077249
8617,0.9275,22,18,22,674432,2012,122871,3385,0.015935876314789,0.6272002964609968
8618,0.9276,0,1,0,674433,2011,122871,3385,0.015927955899125587,0.6273165307635286
8619,0.9277,2,0,2,674433,2011,122873,3383,0.015927955899125587,0.6271783463107156
8620,0.9278,2,1,2,674434,2010,122875,3381,0.015920035483462172,0.6271563717306622
8621,0.9279,1,1,1,674435,2009,122876,3380,0.015912115067798757,0.6272035628131378
8622,0.928,2,7,2,674442,2002,122878,3378,0.01585667215815486,0.6278810408921933
8623,0.9281,1,1,1,674443,2001,122879,3377,0.015848751742491445,0.6279285979918185
8624,0.9282,1,1,1,674444,2000,122880,3376,0.015840831326828033,0.6279761904761905
8625,0.9283,8,8,8,674452,1992,122888,3368,0.01577746800152072,0.6283582089552239
8626,0.9286,2,4,2,674456,1988,122890,3366,0.015745786338867064,0.6286888307807247
8627,0.9287,0,1,0,674457,1987,122890,3366,0.01573786592320365,0.6288062768541005
8628,0.9288,1,2,1,674459,1985,122891,3365,0.015722025091876823,0.6289719626168224
8629,0.9289,0,1,0,674460,1984,122891,3365,0.015714104676213408,0.629089549448495
8630,0.929,1,0,1,674460,1984,122892,3364,0.015714104676213408,0.6290201944652206
8631,0.9292,1,1,1,674461,1983,122893,3363,0.015706184260549993,0.6290684624017957
8632,0.9293,1,0,1,674461,1983,122894,3362,0.015706184260549993,0.6289990645463049
8633,0.9295,2,2,2,674463,1981,122896,3360,0.015690343429223166,0.6290956749672346
8634,0.9296,0,2,0,674465,1979,122896,3360,0.015674502597896336,0.6293313354560779
8635,0.9297,0,1,0,674466,1978,122896,3360,0.015666582182232925,0.6294492319220681
8636,0.9298,1,2,1,674468,1976,122897,3359,0.015650741350906095,0.6296157450796626
8637,0.9299,0,1,0,674469,1975,122897,3359,0.01564282093524268,0.6297337832770904
8638,0.93,511,277,511,674746,1698,123408,2848,0.013448865796477,0.6264848218213814
8639,0.9303,1,3,1,674749,1695,123409,2847,0.013425104549486757,0.6268163804491413
8640,0.9304,1,0,1,674749,1695,123410,2846,0.013425104549486757,0.6267341995155252
8641,0.9305,4,1,4,674750,1694,123414,2842,0.013417184133823343,0.6265432098765432
8642,0.9306,2,1,2,674751,1693,123416,2840,0.013409263718159928,0.6265166556364439
8643,0.9307,1,1,1,674752,1692,123417,2839,0.013401343302496515,0.6265725005517546
8644,0.9308,4,1,4,674753,1691,123421,2835,0.0133934228868331,0.6263809102960671
8645,0.9309,0,1,0,674754,1690,123421,2835,0.013385502471169687,0.6265193370165746
8646,0.931,3,2,3,674756,1688,123424,2832,0.013369661639842859,0.6265486725663717
8647,0.9311,0,1,0,674757,1687,123424,2832,0.013361741224179446,0.6266873202035849
8648,0.9313,1,2,1,674759,1685,123425,2831,0.013345900392852618,0.6268821966341895
8649,0.9314,1,0,1,674759,1685,123426,2830,0.013345900392852618,0.6267995570321152
8650,0.9315,2,1,2,674760,1684,123428,2828,0.013337979977189203,0.62677304964539
8651,0.9317,5,6,5,674766,1678,123433,2823,0.013290457483208718,0.627193956898467
8652,0.9318,0,1,0,674767,1677,123433,2823,0.013282537067545305,0.6273333333333333
8653,0.9319,0,1,0,674768,1676,123433,2823,0.01327461665188189,0.6274727717270504
8654,0.932,0,3,0,674771,1673,123433,2823,0.013250855404891649,0.6278914590747331
8655,0.9321,1,0,1,674771,1673,123434,2822,0.013250855404891649,0.6278086763070078
8656,0.9323,0,1,0,674772,1672,123434,2822,0.013242934989228235,0.6279483756119271
8657,0.9325,9,14,9,674786,1658,123443,2813,0.013132049169940438,0.6291657347349586
8658,0.9327,1,2,1,674788,1656,123444,2812,0.01311620833861361,0.6293643688451208
8659,0.9328,1,0,1,674788,1656,123445,2811,0.01311620833861361,0.6292813969106783
8660,0.9329,1,2,1,674790,1654,123446,2810,0.013100367507286782,0.6294802867383512
8661,0.933,0,1,0,674791,1653,123446,2810,0.013092447091623369,0.6296213309433116
8662,0.9331,1,0,1,674791,1653,123447,2809,0.013092447091623369,0.6295383236216943
8663,0.9332,2,1,2,674792,1652,123449,2807,0.013084526675959954,0.6295133437990581
8664,0.9333,20,14,20,674806,1638,123469,2787,0.012973640856672158,0.6298305084745762
8665,0.9334,0,2,0,674808,1636,123469,2787,0.01295780002534533,0.6301153063531539
8666,0.9335,0,1,0,674809,1635,123469,2787,0.012949879609681915,0.6302578018995929
8667,0.9337,0,1,0,674810,1634,123469,2787,0.012941959194018502,0.6304003619090703
8668,0.9338,0,3,0,674813,1631,123469,2787,0.01291819794702826,0.6308284291534632
8669,0.9339,0,1,0,674814,1630,123469,2787,0.012910277531364846,0.6309712474530225
8670,0.934,5,4,5,674818,1626,123474,2782,0.01287859586871119,0.6311252268602541
8671,0.9341,1,0,1,674818,1626,123475,2781,0.01287859586871119,0.6310415248468346
8672,0.9342,1,3,1,674821,1623,123476,2780,0.012854834621720948,0.6313876902112197
8673,0.9343,1,1,1,674822,1622,123477,2779,0.012846914206057533,0.631447398318564
8674,0.9344,1,1,1,674823,1621,123478,2778,0.01283899379039412,0.6315071607183451
8675,0.9345,0,2,0,674825,1619,123478,2778,0.012823152959067292,0.6317944052763248
8676,0.9346,1,0,1,674825,1619,123479,2777,0.012823152959067292,0.6317106460418562
8677,0.9347,2,1,2,674826,1618,123481,2775,0.012815232543403879,0.6316867744138402
8678,0.935,55,53,55,674879,1565,123536,2720,0.012395450513242935,0.6347724620770129
8679,0.9351,1,0,1,674879,1565,123537,2719,0.012395450513242935,0.63468720821662
8680,0.9355,0,2,0,674881,1563,123537,2719,0.012379609681916107,0.6349836524988324
8681,0.9358,1,6,1,674887,1557,123538,2718,0.012332087187935622,0.6357894736842106
8682,0.936,0,5,0,674892,1552,123538,2718,0.012292485109618553,0.6365339578454332
8683,0.9361,0,1,0,674893,1551,123538,2718,0.01228456469395514,0.6366830639494027
8684,0.9362,0,1,0,674894,1550,123538,2718,0.012276644278291724,0.6368322399250235
8685,0.9363,1,0,1,674894,1550,123539,2717,0.012276644278291724,0.6367471291305367
8686,0.9367,26,24,26,674918,1526,123565,2691,0.012086554302369788,0.638131373013991
8687,0.9368,2,1,2,674919,1525,123567,2689,0.012078633886706375,0.6381110583768391
8688,0.937,4,0,4,674919,1525,123571,2685,0.012078633886706375,0.6377672209026128
8689,0.9371,2,1,2,674920,1524,123573,2683,0.01207071347104296,0.6377466127882101
8690,0.9373,0,1,0,674921,1523,123573,2683,0.012062793055379547,0.6378982406086543
8691,0.9374,1,0,1,674921,1523,123574,2682,0.012062793055379547,0.6378121284185494
8692,0.9375,13,11,13,674932,1512,123587,2669,0.011975668483081993,0.6383640277445587
8693,0.9377,1,1,1,674933,1511,123588,2668,0.011967748067418578,0.6384302464704474
8694,0.938,7,2,7,674935,1509,123595,2661,0.01195190723609175,0.6381294964028777
8695,0.9382,2,0,2,674935,1509,123597,2659,0.01195190723609175,0.6379558541266794
8696,0.9383,9,7,9,674942,1502,123606,2650,0.011896464326447852,0.6382466281310212
8697,0.9385,1,0,1,674942,1502,123607,2649,0.011896464326447852,0.6381594796434594
8698,0.9386,0,1,0,674943,1501,123607,2649,0.011888543910784437,0.6383132530120482
8699,0.9387,1,1,1,674944,1500,123608,2648,0.011880623495121024,0.6383799421407907
8700,0.9388,1,1,1,674945,1499,123609,2647,0.01187270307945761,0.6384466956102267
8701,0.939,0,2,0,674947,1497,123609,2647,0.011856862248130783,0.6387548262548263
8702,0.9392,2,1,2,674948,1496,123611,2645,0.011848941832467368,0.6387346051678339
8703,0.9394,0,1,0,674949,1495,123611,2645,0.011841021416803954,0.6388888888888888
8704,0.9396,1,0,1,674949,1495,123612,2644,0.011841021416803954,0.6388016429089152
8705,0.9398,1,0,1,674949,1495,123613,2643,0.011841021416803954,0.638714354760754
8706,0.94,509,262,509,675211,1233,124122,2134,0.00976587251298948,0.6337986337986338
8707,0.9401,1,2,1,675213,1231,124123,2133,0.009750031681662654,0.6340665873959572
8708,0.9402,0,1,0,675214,1230,124123,2133,0.00974211126599924,0.6342551293487957
8709,0.9403,0,1,0,675215,1229,124123,2133,0.009734190850335826,0.6344437834622249
8710,0.9407,0,1,0,675216,1228,124123,2133,0.009726270434672411,0.6346325498363582
8711,0.9408,1,1,1,675217,1227,124124,2132,0.009718350019008998,0.6347127121167014
8712,0.941,1,3,1,675220,1224,124125,2131,0.009694588772018755,0.6351713859910582
8713,0.9411,0,1,0,675221,1223,124125,2131,0.009686668356355342,0.63536076326774
8714,0.9413,0,2,0,675223,1221,124125,2131,0.009670827525028514,0.6357398568019093
8715,0.9414,2,0,2,675223,1221,124127,2129,0.009670827525028514,0.6355223880597015
8716,0.9415,1,0,1,675223,1221,124128,2128,0.009670827525028514,0.6354135562854584
8717,0.9416,0,1,0,675224,1220,124128,2128,0.009662907109365099,0.6356033452807647
8718,0.9417,12,5,12,675229,1215,124140,2116,0.009623305031048029,0.6352446712698889
8719,0.9418,2,1,2,675230,1214,124142,2114,0.009615384615384616,0.6352163461538461
8720,0.942,2,2,2,675232,1212,124144,2112,0.009599543784057788,0.6353790613718412
8721,0.9422,0,1,0,675233,1211,124144,2112,0.009591623368394373,0.6355702678302738
8722,0.9423,0,2,0,675235,1209,124144,2112,0.009575782537067545,0.6359530261969286
8723,0.9424,0,1,0,675236,1208,124144,2112,0.009567862121404131,0.636144578313253
8724,0.9425,14,5,14,675241,1203,124158,2098,0.009528260043087062,0.6355649803089972
8725,0.9426,1,0,1,675241,1203,124159,2097,0.009528260043087062,0.6354545454545455
8726,0.9428,1,1,1,675242,1202,124160,2096,0.009520339627423647,0.635536688902365
8727,0.943,0,2,0,675244,1200,124160,2096,0.009504498796096819,0.6359223300970874
8728,0.9431,0,1,0,675245,1199,124160,2096,0.009496578380433406,0.6361153262518968
8729,0.9432,1,0,1,675245,1199,124161,2095,0.009496578380433406,0.6360048573163327
8730,0.9433,20,12,20,675257,1187,124181,2075,0.009401533392472437,0.6361128142244022
8731,0.9435,1,0,1,675257,1187,124182,2074,0.009401533392472437,0.636001226617602
8732,0.9437,2,1,2,675258,1186,124184,2072,0.009393612976809023,0.6359729895641498
8733,0.9438,2,1,2,675259,1185,124186,2070,0.009385692561145608,0.6359447004608295
8734,0.944,3,5,3,675264,1180,124189,2067,0.009346090482828539,0.6365876193409301
8735,0.9442,2,3,2,675267,1177,124191,2065,0.009322329235838298,0.6369524984577422
8736,0.9443,1,0,1,675267,1177,124192,2064,0.009322329235838298,0.6368404813329219
8737,0.9444,0,1,0,675268,1176,124192,2064,0.009314408820174883,0.6370370370370371
8738,0.9445,0,2,0,675270,1174,124192,2064,0.009298567988848054,0.6374305126621371
8739,0.9446,1,0,1,675270,1174,124193,2063,0.009298567988848054,0.6373185047883843
8740,0.9447,0,3,0,675273,1171,124193,2063,0.009274806741857813,0.6379097093382807
8741,0.9448,1,1,1,675274,1170,124194,2062,0.009266886326194398,0.6379950495049505
8742,0.945,42,30,42,675304,1140,124236,2020,0.009029273856291977,0.6392405063291139
8743,0.9455,0,2,0,675306,1138,124236,2020,0.009013433024965151,0.6396453451551615
8744,0.9456,1,1,1,675307,1137,124237,2019,0.009005512609301736,0.6397338403041825
8745,0.9457,2,1,2,675308,1136,124239,2017,0.008997592193638323,0.6397082143989851
8746,0.9458,2,1,2,675309,1135,124241,2015,0.008989671777974908,0.6396825396825396
8747,0.946,5,5,5,675314,1130,124246,2010,0.008950069699657838,0.6401273885350318
8748,0.9462,0,2,0,675316,1128,124246,2010,0.00893422886833101,0.6405353728489483
8749,0.9463,2,4,2,675320,1124,124248,2008,0.008902547205677354,0.6411238825031929
8750,0.9466,0,2,0,675322,1122,124248,2008,0.008886706374350526,0.6415335463258786
8751,0.9467,19,11,19,675333,1111,124267,1989,0.008799581802052972,0.6416129032258064
8752,0.9468,2,0,2,675333,1111,124269,1987,0.008799581802052972,0.6413815364751453
8753,0.9469,1,2,1,675335,1109,124270,1986,0.008783740970726144,0.6416801292407108
8754,0.947,0,1,0,675336,1108,124270,1986,0.00877582055506273,0.6418875242404655
8755,0.9473,1,1,1,675337,1107,124271,1985,0.008767900139399315,0.6419793014230272
8756,0.9475,7,7,7,675344,1100,124278,1978,0.008712457229755418,0.6426250812215725
8757,0.9477,0,3,0,675347,1097,124278,1978,0.008688695982765176,0.6432520325203253
8758,0.9478,1,1,1,675348,1096,124279,1977,0.008680775567101761,0.6433452652131467
8759,0.948,4,3,4,675351,1093,124283,1973,0.00865701432011152,0.6435094585779517
8760,0.9483,3,3,3,675354,1090,124286,1970,0.008633253073121277,0.6437908496732027
8761,0.9485,1,2,1,675356,1088,124287,1969,0.008617412241794449,0.6440955184821721
8762,0.9486,1,1,1,675357,1087,124288,1968,0.008609491826131035,0.644189852700491
8763,0.9488,0,1,0,675358,1086,124288,1968,0.00860157141046762,0.6444007858546169
8764,0.9489,1,0,1,675358,1086,124289,1967,0.00860157141046762,0.6442843105142483
8765,0.949,2,3,2,675361,1083,124291,1965,0.00857781016347738,0.6446850393700787
8766,0.9492,2,2,2,675363,1081,124293,1963,0.008561969332150551,0.6448751642575559
8767,0.9493,1,0,1,675363,1081,124294,1962,0.008561969332150551,0.6447584620440355
8768,0.9495,2,2,2,675365,1079,124296,1960,0.008546128500823723,0.6449489963803883
8769,0.9496,2,1,2,675366,1078,124298,1958,0.00853820808516031,0.644927536231884
8770,0.9498,1,1,1,675367,1077,124299,1957,0.008530287669496895,0.6450230718523401
8771,0.9499,0,1,0,675368,1076,124299,1957,0.008522367253833481,0.6452357401912298
8772,0.95,408,212,408,675580,864,124707,1549,0.00684323913318971,0.6419394944053046
8773,0.9502,2,3,2,675583,861,124709,1547,0.006819477886199468,0.6424418604651163
8774,0.9506,0,7,0,675590,854,124709,1547,0.006764034976555569,0.6443148688046647
8775,0.9507,3,0,3,675590,854,124712,1544,0.006764034976555569,0.6438698915763136
8776,0.9508,1,2,1,675592,852,124713,1543,0.006748194145228741,0.644258872651357
8777,0.951,2,0,2,675592,852,124715,1541,0.006748194145228741,0.6439615545340577
8778,0.9513,1,0,1,675592,852,124716,1540,0.006748194145228741,0.6438127090301003
8779,0.9517,4,10,4,675602,842,124720,1536,0.006668989988594601,0.6459209419680404
8780,0.9518,2,0,2,675602,842,124722,1534,0.006668989988594601,0.6456228956228957
8781,0.952,1,1,1,675603,841,124723,1533,0.006661069572931187,0.6457455770850885
8782,0.9521,0,2,0,675605,839,124723,1533,0.006645228741604359,0.6462900505902193
8783,0.9525,7,13,7,675618,826,124730,1526,0.006542263337979977,0.6488095238095238
8784,0.9527,3,4,3,675622,822,124733,1523,0.0065105816753263214,0.6494669509594883
8785,0.953,3,0,3,675622,822,124736,1520,0.0065105816753263214,0.6490179333902647
8786,0.9533,19,7,19,675629,815,124755,1501,0.006455138765682423,0.6481001727115717
8787,0.9534,1,1,1,675630,814,124756,1500,0.006447218350019009,0.648228176318064
8788,0.9535,1,1,1,675631,813,124757,1499,0.006439297934355595,0.648356401384083
8789,0.9539,0,1,0,675632,812,124757,1499,0.006431377518692181,0.6486369536996971
8790,0.954,1,2,1,675634,810,124758,1498,0.006415536687365353,0.6490467937608319
8791,0.9542,0,2,0,675636,808,124758,1498,0.006399695856038525,0.6496097137901128
8792,0.9543,0,1,0,675637,807,124758,1498,0.006391775440375111,0.6498915401301518
8793,0.9545,1,0,1,675637,807,124759,1497,0.006391775440375111,0.6497395833333334
8794,0.9547,0,3,0,675640,804,124759,1497,0.006368014193384869,0.6505867014341591
8795,0.9549,1,0,1,675640,804,124760,1496,0.006368014193384869,0.6504347826086957
8796,0.955,26,24,26,675664,780,124786,1470,0.006177924217462933,0.6533333333333333
8797,0.9553,0,2,0,675666,778,124786,1470,0.0061620833861361045,0.6539145907473309
8798,0.9554,1,0,1,675666,778,124787,1469,0.0061620833861361045,0.6537605696484201
8799,0.9555,0,3,0,675669,775,124787,1469,0.006138322139145862,0.6546345811051694
8800,0.9557,0,2,0,675671,773,124787,1469,0.006122481307819034,0.6552185548617306
8801,0.9558,1,0,1,675671,773,124788,1468,0.006122481307819034,0.6550647032574743
8802,0.956,1,2,1,675673,771,124789,1467,0.006106640476492206,0.6554959785522788
8803,0.9563,1,0,1,675673,771,124790,1466,0.006106640476492206,0.6553419758605274
8804,0.9564,1,0,1,675673,771,124791,1465,0.006106640476492206,0.6551878354203936
8805,0.9567,15,9,15,675682,762,124806,1450,0.00603535673552148,0.6555153707052441
8806,0.9569,1,0,1,675682,762,124807,1449,0.00603535673552148,0.655359565807327
8807,0.9571,0,2,0,675684,760,124807,1449,0.006019515904194652,0.6559529198732458
8808,0.9572,2,1,2,675685,759,124809,1447,0.006011595488531238,0.655938349954669
8809,0.9574,1,2,1,675687,757,124810,1446,0.00599575465720441,0.6563776668179755
8810,0.9575,5,5,5,675692,752,124815,1441,0.00595615257888734,0.6570907432740538
8811,0.9578,2,0,2,675692,752,124817,1439,0.00595615257888734,0.656777727065267
8812,0.958,2,1,2,675693,751,124819,1437,0.005948232163223926,0.656764168190128
8813,0.9581,2,2,2,675695,749,124821,1435,0.005932391331897098,0.657051282051282
8814,0.9582,1,1,1,675696,748,124822,1434,0.005924470916233684,0.6571952337305225
8815,0.9583,1,4,1,675700,744,124823,1433,0.0058927892535800275,0.6582452916858061
8816,0.9586,0,1,0,675701,743,124823,1433,0.005884868837916614,0.6585477941176471
8817,0.9587,0,2,0,675703,741,124823,1433,0.005869028006589786,0.6591536338546458
8818,0.9588,1,0,1,675703,741,124824,1432,0.005869028006589786,0.6589967786470318
8819,0.959,0,1,0,675704,740,124824,1432,0.005861107590926372,0.6593001841620626
8820,0.9592,2,1,2,675705,739,124826,1430,0.005853187175262958,0.6592899953895804
8821,0.9593,2,1,2,675706,738,124828,1428,0.005845266759599544,0.6592797783933518
8822,0.9595,1,0,1,675706,738,124829,1427,0.005845266759599544,0.6591224018475751
8823,0.9597,1,0,1,675706,738,124830,1426,0.005845266759599544,0.6589648798521257
8824,0.96,343,180,343,675886,558,125173,1083,0.004419591940185021,0.659963436928702
8825,0.9602,1,0,1,675886,558,125174,1082,0.004419591940185021,0.6597560975609756
8826,0.9603,0,1,0,675887,557,125174,1082,0.0044116715245216065,0.6601586333129957
8827,0.9604,1,0,1,675887,557,125175,1081,0.0044116715245216065,0.6599511599511599
8828,0.9606,1,0,1,675887,557,125176,1080,0.0044116715245216065,0.6597434331093464
8829,0.9608,0,1,0,675888,556,125176,1080,0.0044037511088581924,0.6601466992665037
8830,0.9609,0,1,0,675889,555,125176,1080,0.004395830693194779,0.6605504587155964
8831,0.9613,0,2,0,675891,553,125176,1080,0.004379989861867951,0.6613594611145132
8832,0.9617,2,2,2,675893,551,125178,1078,0.004364149030541123,0.6617556783302639
8833,0.9618,1,0,1,675893,551,125179,1077,0.004364149030541123,0.6615479115479116
8834,0.962,0,3,0,675896,548,125179,1077,0.004340387783550881,0.6627692307692308
8835,0.9622,0,1,0,675897,547,125179,1077,0.004332467367887467,0.6631773399014779
8836,0.9624,1,1,1,675898,546,125180,1076,0.0043245469522240525,0.6633785450061652
8837,0.9625,4,4,4,675902,542,125184,1072,0.004292865289570397,0.6641883519206939
8838,0.9626,1,0,1,675902,542,125185,1071,0.004292865289570397,0.6639801611903285
8839,0.9628,1,2,1,675904,540,125186,1070,0.004277024458243569,0.6645962732919255
8840,0.963,2,0,2,675904,540,125188,1068,0.004277024458243569,0.664179104477612
8841,0.9631,1,1,1,675905,539,125189,1067,0.004269104042580155,0.6643835616438356
8842,0.9632,0,1,0,675906,538,125189,1067,0.004261183626916741,0.664797507788162
8843,0.9633,10,8,10,675914,530,125199,1057,0.004197820301609428,0.6660365469439193
8844,0.9635,1,0,1,675914,530,125200,1056,0.004197820301609428,0.6658259773013872
8845,0.964,4,0,4,675914,530,125204,1052,0.004197820301609428,0.6649810366624526
8846,0.9642,1,1,1,675915,529,125205,1051,0.004189899885946015,0.6651898734177215
8847,0.9646,1,1,1,675916,528,125206,1050,0.004181979470282601,0.6653992395437263
8848,0.9647,1,2,1,675918,526,125207,1049,0.004166138638955773,0.6660317460317461
8849,0.9648,1,0,1,675918,526,125208,1048,0.004166138638955773,0.6658195679796697
8850,0.9649,1,0,1,675918,526,125209,1047,0.004166138638955773,0.6656071201525747
8851,0.965,22,14,22,675932,512,125231,1025,0.004055252819667976,0.6668835393623943
8852,0.9652,1,0,1,675932,512,125232,1024,0.004055252819667976,0.6666666666666666
8853,0.9654,0,1,0,675933,511,125232,1024,0.004047332404004562,0.6671009771986971
8854,0.9656,0,1,0,675934,510,125232,1024,0.004039411988341148,0.6675358539765319
8855,0.9657,1,1,1,675935,509,125233,1023,0.004031491572677734,0.6677545691906005
8856,0.9659,1,0,1,675935,509,125234,1022,0.004031491572677734,0.6675375571521881
8857,0.966,2,3,2,675938,506,125236,1020,0.004007730325687492,0.6684141546526867
8858,0.9661,1,0,1,675938,506,125237,1019,0.004007730325687492,0.6681967213114755
8859,0.9664,1,1,1,675939,505,125238,1018,0.003999809910024078,0.6684175968483257
8860,0.9667,11,10,11,675949,495,125249,1007,0.003920605753389938,0.670439414114514
8861,0.9668,0,2,0,675951,493,125249,1007,0.0039047649220631097,0.6713333333333333
8862,0.9669,1,0,1,675951,493,125250,1006,0.0039047649220631097,0.6711140760507005
8863,0.9671,1,0,1,675951,493,125251,1005,0.0039047649220631097,0.670894526034713
8864,0.9673,1,1,1,675952,492,125252,1004,0.003896844506399696,0.6711229946524064
8865,0.9675,9,2,9,675954,490,125261,995,0.003881003675072868,0.67003367003367
8866,0.9679,1,0,1,675954,490,125262,994,0.003881003675072868,0.6698113207547169
8867,0.968,2,1,2,675955,489,125264,992,0.003873083259409454,0.6698176907494936
8868,0.9683,2,1,2,675956,488,125266,990,0.0038651628437460397,0.6698240866035182
8869,0.9684,0,3,0,675959,485,125266,990,0.003841401596755798,0.6711864406779661
8870,0.9686,1,0,1,675959,485,125267,989,0.003841401596755798,0.6709633649932157
8871,0.969,1,1,1,675960,484,125268,988,0.003833481181092384,0.6711956521739131
8872,0.9691,1,1,1,675961,483,125269,987,0.0038255607654289698,0.6714285714285714
8873,0.9692,2,0,2,675961,483,125271,985,0.0038255607654289698,0.6709809264305178
8874,0.9695,1,0,1,675961,483,125272,984,0.0038255607654289698,0.6707566462167689
8875,0.9696,0,1,0,675962,482,125272,984,0.0038176403497655557,0.6712141882673943
8876,0.97,313,152,313,676114,330,125585,671,0.0026137371689266254,0.6703296703296703
8877,0.9708,0,2,0,676116,328,125585,671,0.0025978963375997972,0.6716716716716716
8878,0.9712,0,1,0,676117,327,125585,671,0.002589975921936383,0.6723446893787575
8879,0.9714,2,0,2,676117,327,125587,669,0.002589975921936383,0.6716867469879518
8880,0.9717,1,6,1,676123,321,125588,668,0.002542453427955899,0.6754297269969667
8881,0.972,2,2,2,676125,319,125590,666,0.002526612596629071,0.6761421319796954
8882,0.9725,4,1,4,676126,318,125594,662,0.0025186921809656573,0.6755102040816326
8883,0.9729,5,0,5,676126,318,125599,657,0.0025186921809656573,0.6738461538461539
8884,0.9733,5,7,5,676133,311,125604,652,0.002463249271321759,0.6770508826583593
8885,0.9737,1,0,1,676133,311,125605,651,0.002463249271321759,0.6767151767151767
8886,0.974,1,0,1,676133,311,125606,650,0.002463249271321759,0.676378772112383
8887,0.9747,2,0,2,676133,311,125608,648,0.002463249271321759,0.67570385818561
8888,0.9748,1,0,1,676133,311,125609,647,0.002463249271321759,0.675365344467641
8889,0.975,18,16,18,676149,295,125627,629,0.0023365226207071347,0.6807359307359307
8890,0.9754,2,1,2,676150,294,125629,627,0.0023286022050437206,0.6807817589576547
8891,0.976,1,2,1,676152,292,125630,626,0.0023127613737168925,0.681917211328976
8892,0.9765,1,2,1,676154,290,125631,625,0.0022969205423900648,0.6830601092896175
8893,0.9767,9,13,9,676167,277,125640,616,0.0021939551387656826,0.6898096304591266
8894,0.9768,0,1,0,676168,276,125640,616,0.0021860347231022685,0.6905829596412556
8895,0.9773,1,0,1,676168,276,125641,615,0.0021860347231022685,0.6902356902356902
8896,0.9775,3,6,3,676174,270,125644,612,0.0021385122291217844,0.6938775510204082
8897,0.9779,1,1,1,676175,269,125645,611,0.0021305918134583704,0.6943181818181818
8898,0.978,1,2,1,676177,267,125646,610,0.002114750982131542,0.6955530216647663
8899,0.9783,0,3,0,676180,264,125646,610,0.0020909897351413004,0.6979405034324943
8900,0.9787,1,0,1,676180,264,125647,609,0.0020909897351413004,0.697594501718213
8901,0.979,0,2,0,676182,262,125647,609,0.0020751489038144722,0.6991963260619977
8902,0.9792,3,0,3,676182,262,125650,606,0.0020751489038144722,0.6981566820276498
8903,0.98,235,116,235,676298,146,125885,371,0.0011563806868584462,0.7176015473887815
8904,0.9802,1,0,1,676298,146,125886,370,0.0011563806868584462,0.7170542635658915
8905,0.9805,1,0,1,676298,146,125887,369,0.0011563806868584462,0.7165048543689321
8906,0.9815,1,0,1,676298,146,125888,368,0.0011563806868584462,0.7159533073929961
8907,0.9817,1,0,1,676298,146,125889,367,0.0011563806868584462,0.7153996101364523
8908,0.9818,0,1,0,676299,145,125889,367,0.0011484602711950324,0.716796875
8909,0.982,2,0,2,676299,145,125891,365,0.0011484602711950324,0.7156862745098039
8910,0.9821,1,0,1,676299,145,125892,364,0.0011484602711950324,0.7151277013752456
8911,0.9825,1,0,1,676299,145,125893,363,0.0011484602711950324,0.7145669291338582
8912,0.9829,3,0,3,676299,145,125896,360,0.0011484602711950324,0.7128712871287128
8913,0.9833,7,5,7,676304,140,125903,353,0.0011088581928779622,0.716024340770791
8914,0.9837,1,0,1,676304,140,125904,352,0.0011088581928779622,0.7154471544715447
8915,0.984,4,0,4,676304,140,125908,348,0.0011088581928779622,0.7131147540983607
8916,0.9842,1,0,1,676304,140,125909,347,0.0011088581928779622,0.7125256673511293
8917,0.9843,1,0,1,676304,140,125910,346,0.0011088581928779622,0.7119341563786008
8918,0.985,9,7,9,676311,133,125919,337,0.001053415283234064,0.7170212765957447
8919,0.986,3,6,3,676317,127,125922,334,0.00100589278925358,0.7245119305856833
8920,0.9862,0,1,0,676318,126,125922,334,0.000997972373590166,0.7260869565217392
8921,0.9867,4,3,4,676321,123,125926,330,0.000974211126599924,0.7284768211920529
8922,0.9871,0,1,0,676322,122,125926,330,0.0009662907109365099,0.7300884955752213
8923,0.9875,2,0,2,676322,122,125928,328,0.0009662907109365099,0.7288888888888889
8924,0.988,2,1,2,676323,121,125930,326,0.000958370295273096,0.7293064876957495
8925,0.9883,1,0,1,676323,121,125931,325,0.000958370295273096,0.7286995515695067
8926,0.9886,1,1,1,676324,120,125932,324,0.0009504498796096819,0.7297297297297297
8927,0.9892,0,1,0,676325,119,125932,324,0.0009425294639462679,0.7313769751693002
8928,0.99,175,68,175,676393,51,126107,149,0.0004039411988341148,0.745
8929,0.9908,1,0,1,676393,51,126108,148,0.0004039411988341148,0.7437185929648241
8930,0.9909,1,0,1,676393,51,126109,147,0.0004039411988341148,0.7424242424242424
8931,0.9917,1,1,1,676394,50,126110,146,0.0003960207831707008,0.7448979591836735
8932,0.9933,0,1,0,676395,49,126110,146,0.00038810036750728676,0.7487179487179487
8933,0.995,5,4,5,676399,45,126115,141,0.0003564187048536307,0.7580645161290323
8934,0.996,1,1,1,676400,44,126116,140,0.0003484982891902167,0.7608695652173914
8935,0.9967,0,2,0,676402,42,126116,140,0.0003326574578633887,0.7692307692307693
8936,1.0,140,42,140,676444,0,126256,0,0.0,
