,y_proba,y_test,Neg,Pos,TN,FP,FN,TP,FP/P,Prec
0,0.0001,0,2,0,2,676442,0,126256,5.357701812191104,0.15728954102290027
1,0.0003,0,7,0,9,676435,0,126256,5.3576463692814595,0.15729091269243084
2,0.0004,0,10,0,19,676425,0,126256,5.357567165124825,0.15729287226183253
3,0.0005,0,16,0,35,676409,0,126256,5.357440438474211,0.15729600767443455
4,0.0006,0,18,0,53,676391,0,126256,5.357297870992269,0.15729953516302933
5,0.0007,0,24,0,77,676367,0,126256,5.357107781016348,0.15730423872727295
6,0.0008,0,28,0,105,676339,0,126256,5.356886009377772,0.1573097265744242
7,0.0009,0,39,0,144,676300,0,126256,5.356577113166899,0.1573173709996561
8,0.001,0,46,0,190,676254,0,126256,5.356212774046382,0.1573263884562186
9,0.0011,0,49,0,239,676205,0,126256,5.355824673678875,0.1573359951449354
10,0.0012,1,48,1,287,676157,1,126255,5.355444493727031,0.15734435676435546
11,0.0013,0,58,0,345,676099,1,126255,5.354985109618553,0.15735573076223214
12,0.0014,0,51,0,396,676048,1,126255,5.354581168419719,0.1573657333949892
13,0.0015,0,55,0,451,675993,1,126255,5.3541455455582305,0.15737652197325516
14,0.0016,0,81,0,532,675912,1,126255,5.353503991889494,0.15739241330047235
15,0.0017,0,78,0,610,675834,1,126255,5.352886199467748,0.15740771909351706
16,0.0018,1,82,1,692,675752,2,126254,5.3522367253833485,0.15742276242322376
17,0.0019,1,83,1,775,675669,3,126253,5.351579330883284,0.15743800519252496
18,0.002,0,81,0,856,675588,3,126253,5.350937777214548,0.15745390919147312
19,0.0021,0,90,0,946,675498,3,126253,5.350224939804841,0.157471584070366
20,0.0022,0,105,0,1051,675393,3,126253,5.349393296160183,0.157492209778381
21,0.0023,0,94,0,1145,675299,3,126253,5.3486487770878215,0.15751067928219253
22,0.0024,1,98,1,1243,675201,4,126252,5.347872576352807,0.15752888815688507
23,0.0025,2,82,2,1325,675119,6,126250,5.347223102268407,0.15754290470432472
24,0.0026,0,108,0,1433,675011,6,126250,5.346367697376758,0.15756413952507362
25,0.0027,0,134,0,1567,674877,6,126250,5.345306361677861,0.15759049439102665
26,0.0028,1,109,1,1676,674768,7,126249,5.344443036370548,0.15761088715969823
27,0.0029,0,122,0,1798,674646,7,126249,5.343476745659612,0.1576348959601446
28,0.003,0,133,0,1931,674513,7,126249,5.342423330376378,0.15766107782337324
29,0.0031,1,148,1,2079,674365,8,126248,5.341251108858193,0.15768917067297183
30,0.0032,0,138,0,2217,674227,8,126248,5.340158091496642,0.15771635591367625
31,0.0033,2,143,2,2360,674084,10,126246,5.339025472056774,0.15774243124711057
32,0.0034,0,140,0,2500,673944,10,126246,5.337916613863896,0.15777002961796574
33,0.0035,0,142,0,2642,673802,10,126246,5.336791914839691,0.15779803211807292
34,0.0036,0,139,0,2781,673663,10,126246,5.335690977062476,0.1578254526452384
35,0.0037,0,137,0,2918,673526,10,126246,5.334605880116588,0.15785248795906834
36,0.0038,1,139,1,3057,673387,11,126245,5.333504942339374,0.1578788742821698
37,0.0039,1,144,1,3201,673243,12,126244,5.332364402483842,0.15790625738754976
38,0.004,1,175,1,3376,673068,13,126243,5.330978329742745,0.15793977563176287
39,0.0041,0,176,0,3552,672892,13,126243,5.329584336585984,0.15797455999299242
40,0.0042,0,164,0,3716,672728,13,126243,5.328285388417184,0.1580069864863681
41,0.0043,0,170,0,3886,672558,13,126243,5.326938917754403,0.1580406133692872
42,0.0044,0,180,0,4066,672378,13,126243,5.325513242934989,0.15807623390819925
43,0.0045,1,184,1,4250,672194,14,126242,5.324055886452921,0.15811160819401932
44,0.0046,1,187,1,4437,672007,15,126241,5.322574768723863,0.15814759322917188
45,0.0047,2,184,2,4621,671823,17,126239,5.321117412241795,0.15818194576361236
46,0.0048,2,183,2,4804,671640,19,126237,5.319667976175389,0.15821611601788246
47,0.0049,5,194,5,4998,671446,24,126232,5.318131415536687,0.15824931864737402
48,0.005,1,206,1,5204,671240,25,126231,5.316499809910024,0.1582891415487209
49,0.0051,3,222,3,5426,671018,28,126228,5.314741477632746,0.15833005120126034
50,0.0052,2,211,2,5637,670807,30,126226,5.313070269927766,0.1583698541967522
51,0.0053,1,194,1,5831,670613,31,126225,5.311533709289064,0.1584073550709178
52,0.0054,1,229,1,6060,670384,32,126224,5.309719934102142,0.158451835783723
53,0.0055,1,226,1,6286,670158,33,126223,5.30792992016221,0.15849574512701836
54,0.0056,0,205,0,6491,669953,33,126223,5.306306234951211,0.15853655473161712
55,0.0057,2,235,2,6726,669718,35,126221,5.304444937270308,0.15858124806046694
56,0.0058,3,232,3,6958,669486,38,126218,5.302607400836396,0.1586243125584388
57,0.0059,1,219,1,7177,669267,39,126217,5.300872829806108,0.15866692479044203
58,0.006,2,205,2,7382,669062,41,126215,5.299249144595108,0.15870570882849624
59,0.0061,3,204,3,7586,668858,44,126212,5.297633379799772,0.15874325531085312
60,0.0062,4,229,4,7815,668629,48,126208,5.29581960461285,0.15878475712630388
61,0.0063,3,235,3,8050,668394,51,126205,5.293958306931947,0.1588285411887002
62,0.0064,3,231,3,8281,668163,54,126202,5.2921286909136995,0.15887155149081342
63,0.0065,2,258,2,8539,667905,56,126200,5.290085223672539,0.15892104948338065
64,0.0066,1,226,1,8765,667679,57,126199,5.288295209732607,0.1589652314335452
65,0.0067,5,234,5,8999,667445,62,126194,5.286441832467368,0.15900680284109023
66,0.0068,1,258,1,9257,667187,63,126193,5.284398365226207,0.1590574504020772
67,0.0069,1,268,1,9525,666919,64,126192,5.282275693828412,0.1591101371686939
68,0.007,2,276,2,9801,666643,66,126190,5.28008965910531,0.1591634051559408
69,0.0071,4,295,4,10096,666348,70,126186,5.277753136484603,0.15921840577186594
70,0.0072,6,273,6,10369,666075,76,126180,5.275590863008491,0.15926690270178162
71,0.0073,1,283,1,10652,665792,77,126179,5.273349385375744,0.15932275297959142
72,0.0074,2,260,2,10912,665532,79,126177,5.271290077303257,0.1593729514253343
73,0.0075,3,307,3,11219,665225,82,126174,5.268858509694589,0.15943158886983683
74,0.0076,6,273,6,11492,664952,88,126168,5.266696236218476,0.1594802305592072
75,0.0077,5,268,5,11760,664684,93,126163,5.264573564820682,0.15952896072185896
76,0.0078,4,296,4,12056,664388,97,126159,5.262229121784311,0.15958443963483512
77,0.0079,2,280,2,12336,664108,99,126157,5.260011405398555,0.15963885532068356
78,0.008,1,297,1,12633,663811,100,126156,5.257659041946521,0.1596978101616903
79,0.0081,5,289,5,12922,663522,105,126151,5.255370041819795,0.15975093488064046
80,0.0082,2,291,2,13213,663231,107,126149,5.253065200861741,0.15980769718006538
81,0.0083,0,300,0,13513,662931,107,126149,5.250689076162717,0.15986845440259542
82,0.0084,3,289,3,13802,662642,110,126146,5.24840007603599,0.159923832512665
83,0.0085,3,299,3,14101,662343,113,126143,5.2460318717526295,0.15998128058075856
84,0.0086,2,295,2,14396,662048,115,126141,5.243695349131922,0.16003902617265656
85,0.0087,4,290,4,14686,661758,119,126137,5.241398428589532,0.16009366730338434
86,0.0088,4,312,4,14998,661446,123,126133,5.238927258902547,0.16015282276444648
87,0.0089,0,309,0,15307,661137,123,126133,5.236479850462552,0.16021568204046896
88,0.009,5,340,5,15647,660797,128,126128,5.233786909136992,0.1602795692092639
89,0.0091,3,305,3,15952,660492,131,126125,5.23137118235965,0.16033851289763634
90,0.0092,2,296,2,16248,660196,133,126123,5.22902673932328,0.16039673465858004
91,0.0093,2,338,2,16586,659858,135,126121,5.226349638829046,0.1604635747265512
92,0.0094,5,339,5,16925,659519,140,126116,5.223664617919148,0.16052747140847848
93,0.0095,6,343,6,17268,659176,146,126110,5.220947915346597,0.16059117315220187
94,0.0096,3,352,3,17620,658824,149,126107,5.218159929033075,0.16065998157799857
95,0.0097,2,332,2,17952,658492,151,126105,5.215530351032823,0.16072582485020973
96,0.0098,4,346,4,18298,658146,155,126101,5.2127898872132805,0.16079245441805962
97,0.0099,2,314,2,18612,657832,157,126099,5.210302876694969,0.16085471808105561
98,0.01,5,331,5,18943,657501,162,126094,5.207681219110379,0.16091731060050155
99,0.0101,1,368,1,19311,657133,163,126093,5.2047665061462425,0.1609918465423773
100,0.0102,7,341,7,19652,656792,170,126086,5.202065644405018,0.16105446825686762
101,0.0103,4,339,4,19991,656453,174,126082,5.199380623495121,0.16111994990639397
102,0.0104,7,348,7,20339,656105,181,126075,5.196624318844253,0.1611841264159145
103,0.0105,3,350,3,20689,655755,184,126072,5.193852173362058,0.1612530649363606
104,0.0106,3,364,3,21053,655391,187,126069,5.190969142060576,0.161324955851867
105,0.0107,6,354,6,21407,655037,193,126063,5.188165314915727,0.16139162719242095
106,0.0108,2,357,2,21764,654680,195,126061,5.185337726523888,0.1614632765539404
107,0.0109,6,376,6,22140,654304,201,126055,5.182359650234444,0.16153462701141397
108,0.011,4,366,4,22506,653938,205,126051,5.179460778101634,0.16160612521458637
109,0.0111,3,314,3,22820,653624,208,126048,5.1769737675833225,0.16166798345971126
110,0.0112,6,354,6,23174,653270,214,126042,5.174169940438474,0.1617349662266204
111,0.0113,3,384,3,23558,652886,217,126039,5.171128500823723,0.16181147093751003
112,0.0114,3,352,3,23910,652534,220,126036,5.168340514510201,0.16188139794751916
113,0.0115,7,321,7,24231,652213,227,126029,5.165798061082246,0.16194063029237693
114,0.0116,4,390,4,24621,651823,231,126025,5.162709098973514,0.1620175149900752
115,0.0117,3,400,3,25021,651423,234,126022,5.159540932708149,0.1620976403475487
116,0.0118,7,380,7,25401,651043,241,126015,5.156531174756052,0.16216936187517533
117,0.0119,6,371,6,25772,650672,247,126009,5.153592700544925,0.1622403535042057
118,0.012,4,380,4,26152,650292,251,126005,5.150582942592827,0.16231545400793768
119,0.0121,4,398,4,26550,649894,255,126001,5.147430617158789,0.16239439614896345
120,0.0122,6,375,6,26925,649519,261,125995,5.144460461285008,0.1624664416116279
121,0.0123,7,371,7,27296,649148,268,125988,5.141521987073881,0.16253663873178384
122,0.0124,9,393,9,27689,648755,277,125979,5.1384092637181595,0.1626093601158591
123,0.0125,4,395,4,28084,648360,281,125975,5.135280699531111,0.16268798388294473
124,0.0126,6,396,6,28480,647964,287,125969,5.1321442149284,0.16276473544867578
125,0.0127,6,375,6,28855,647589,293,125963,5.129174059054619,0.16283714604835875
126,0.0128,10,383,10,29238,647206,303,125953,5.126140539855531,0.16290698291037162
127,0.0129,7,364,7,29602,646842,310,125946,5.123257508554049,0.16297613316976972
128,0.013,7,400,7,30002,646442,317,125939,5.120089342288684,0.1630529492569082
129,0.0131,6,399,6,30401,646043,323,125933,5.116929096438981,0.16313071908971263
130,0.0132,1,415,1,30816,645628,324,125932,5.113642123938664,0.1632173777800819
131,0.0133,9,386,9,31202,645242,333,125923,5.110584843492586,0.16328930903243793
132,0.0134,4,401,4,31603,644841,337,125919,5.107408756811558,0.16336992059785146
133,0.0135,7,424,7,32027,644417,344,125912,5.10405050057027,0.16345223923803984
134,0.0136,5,404,5,32431,644013,349,125907,5.100850652642251,0.16353257481296757
135,0.0137,3,375,3,32806,643638,352,125904,5.097880496768471,0.1636090037970637
136,0.0138,7,423,7,33229,643215,359,125897,5.094530160942846,0.1636913739481376
137,0.0139,8,394,8,33623,642821,367,125889,5.091409517171461,0.16376656996786826
138,0.014,4,418,4,34041,642403,371,125885,5.0880987834241544,0.16385131617310175
139,0.0141,12,415,12,34456,641988,383,125873,5.084811810923838,0.16392680446070318
140,0.0142,3,426,3,34882,641562,386,125870,5.081437713851223,0.1640145315806482
141,0.0143,6,394,6,35276,641168,392,125864,5.078317070079838,0.16409224126242453
142,0.0144,7,402,7,35678,640766,399,125857,5.075133062983145,0.16417065493730296
143,0.0145,7,446,7,36124,640320,406,125850,5.071600557597263,0.16425858490935433
144,0.0146,5,416,5,36540,639904,411,125845,5.068305664681282,0.1643423628369087
145,0.0147,10,438,10,36978,639466,421,125835,5.064836522620707,0.16442550055468372
146,0.0148,7,408,7,37386,639058,428,125828,5.061604993030034,0.16450556030571875
147,0.0149,5,393,5,37779,638665,433,125823,5.058492269674312,0.16458466319942236
148,0.015,7,419,7,38198,638246,440,125816,5.055173615511342,0.16466726522193226
149,0.0151,4,435,4,38633,637811,444,125812,5.051728234697757,0.16475669276593294
150,0.0152,11,406,11,39039,637405,455,125801,5.048512545938411,0.16483229953642922
151,0.0153,8,440,8,39479,636965,463,125793,5.045027563046509,0.1649186242556617
152,0.0154,4,418,4,39897,636547,467,125789,5.041716829299202,0.16500466985686102
153,0.0155,2,421,2,40318,636126,469,125787,5.038382334304904,0.16509365242488316
154,0.0156,10,416,10,40734,635710,479,125777,5.035087441388924,0.1651728788541367
155,0.0157,4,427,4,41161,635283,483,125773,5.031705423900647,0.16526116343606778
156,0.0158,6,434,6,41595,634849,489,125767,5.028267963502724,0.1653488751222693
157,0.0159,10,426,10,42021,634423,499,125757,5.02489386643011,0.1654305559209661
158,0.016,6,450,6,42471,633973,505,125751,5.021329679381574,0.16552195270914175
159,0.0161,12,421,12,42892,633552,517,125739,5.017995184387277,0.16560054050423356
160,0.0162,15,425,15,43317,633127,532,125724,5.014629007730326,0.1656767929409067
161,0.0163,5,422,5,43739,632705,537,125719,5.011286592320365,0.16576347794901006
162,0.0164,10,440,10,44179,632265,547,125709,5.007801609428463,0.16584869665714128
163,0.0165,10,404,10,44583,631861,557,125699,5.004601761500443,0.16592613126353029
164,0.0166,10,400,10,44983,631461,567,125689,5.001433595235078,0.16600277355874002
165,0.0167,3,431,3,45414,631030,570,125686,4.998019896084147,0.16609401677776076
166,0.0168,12,435,12,45849,630595,582,125674,4.994574515270561,0.16617632085937675
167,0.0169,7,443,7,46292,630152,589,125667,4.991065771131669,0.16626599754703175
168,0.017,14,436,14,46728,629716,603,125653,4.9876124699024205,0.16634651408781667
169,0.0171,7,442,7,47170,629274,610,125646,4.9841116461791914,0.16643617866793833
170,0.0172,6,464,6,47634,628810,616,125640,4.980436573311367,0.16653191066339718
171,0.0173,9,434,9,48068,628376,625,125631,4.976999112913446,0.16661781654546973
172,0.0174,7,466,7,48534,627910,632,125624,4.973308199214295,0.166713114471278
173,0.0175,9,456,9,48990,627454,641,125615,4.969696489671778,0.1668041042719857
174,0.0176,12,434,12,49424,627020,653,125603,4.966259029273856,0.16688700717357827
175,0.0177,7,423,7,49847,626597,660,125596,4.962908693448232,0.1669731039773037
176,0.0178,4,449,4,50296,626148,664,125592,4.959352426815359,0.1670684013089632
177,0.0179,6,414,6,50710,625734,670,125586,4.956073374730706,0.16715380929563967
178,0.018,10,482,10,51192,625252,680,125576,4.95225573438094,0.16725002264167027
179,0.0181,8,434,8,51626,624818,688,125568,4.948818273983019,0.1673378767727543
180,0.0182,8,431,8,52057,624387,696,125560,4.945404574832088,0.16742516471163962
181,0.0183,8,440,8,52497,623947,704,125552,4.941919591940185,0.16751456639701987
182,0.0184,11,442,11,52939,623505,715,125541,4.938418768216956,0.16760118871204172
183,0.0185,13,437,13,53376,623068,728,125528,4.934957546572044,0.1676845721857985
184,0.0186,14,459,14,53835,622609,742,125514,4.931322075782537,0.16777187708438318
185,0.0187,11,417,11,54252,622192,753,125503,4.928019262450894,0.16785320217468352
186,0.0188,14,472,14,54724,621720,767,125489,4.924280826257762,0.16794364093580244
187,0.0189,10,420,10,55144,621300,777,125479,4.920954251679128,0.16802695308786134
188,0.019,18,471,18,55615,620829,795,125461,4.91722373590166,0.16811293197014565
189,0.0191,5,436,5,56051,620393,800,125456,4.913770434672411,0.1682056287532731
190,0.0192,10,439,10,56490,619954,810,125446,4.910293372196173,0.1682935336731956
191,0.0193,10,467,10,56957,619487,820,125436,4.906594538081358,0.168387873646001
192,0.0194,9,427,9,57384,619060,829,125427,4.9032125205930805,0.16847439915001874
193,0.0195,15,483,15,57867,618577,844,125412,4.899386959827652,0.16856700838318847
194,0.0196,12,433,12,58300,618144,856,125400,4.895957419845393,0.16865175430102322
195,0.0197,12,442,12,58742,617702,868,125388,4.892456596122164,0.1687386453861578
196,0.0198,15,449,15,59191,617253,883,125373,4.888900329489291,0.16882387635229576
197,0.0199,8,451,8,59642,616802,891,125365,4.885328222025092,0.16891750778463607
198,0.02,13,447,13,60089,616355,904,125352,4.881787796223546,0.16900474176460517
199,0.0201,9,477,9,60566,615878,913,125343,4.878009757952097,0.16910341180295754
200,0.0202,13,439,13,61005,615439,926,125330,4.8745326954758585,0.16918904543791655
201,0.0203,7,438,7,61443,615001,933,125323,4.871063553415283,0.16928128765243325
202,0.0204,9,400,9,61843,614601,942,125314,4.867895387149917,0.16936269706655493
203,0.0205,18,449,18,62292,614152,960,125296,4.8643391205170445,0.16944531596542287
204,0.0206,17,440,17,62732,613712,977,125279,4.860854137625142,0.16952709843556957
205,0.0207,6,441,6,63173,613271,983,125273,4.857361234317577,0.16962157975692715
206,0.0208,16,429,16,63602,612842,999,125257,4.853963375997973,0.16970216732443752
207,0.0209,10,415,10,64017,612427,1009,125247,4.850676403497656,0.16978638260261308
208,0.021,6,448,6,64465,611979,1015,125241,4.847128057280446,0.16988280296248068
209,0.0211,15,443,15,64908,611536,1030,125226,4.843619313141554,0.16996804938365442
210,0.0212,11,451,11,65359,611085,1041,125215,4.840047205677354,0.170059758250713
211,0.0213,8,466,8,65825,610619,1049,125207,4.836356291978203,0.17015843419504068
212,0.0214,8,452,8,66277,610167,1057,125199,4.83277626409834,0.17025399596935403
213,0.0215,18,459,18,66736,609708,1075,125181,4.829140793308833,0.17034001053220282
214,0.0216,8,446,8,67182,609262,1083,125173,4.82560828792295,0.17043441557115332
215,0.0217,9,449,9,67631,608813,1092,125164,4.8220520212900775,0.17052850429918104
216,0.0218,12,441,12,68072,608372,1104,125152,4.818559117982511,0.17061745764283104
217,0.0219,7,494,7,68566,607878,1111,125145,4.8146464326447855,0.17072452024015616
218,0.022,13,484,13,69050,607394,1124,125132,4.810812951463693,0.17082260561399867
219,0.0221,11,457,11,69507,606937,1135,125121,4.807193321505513,0.1709167852820405
220,0.0222,13,457,13,69964,606480,1148,125108,4.803573691547332,0.17100881917144622
221,0.0223,18,474,18,70438,606006,1166,125090,4.799819414522874,0.17109928107936578
222,0.0224,8,464,8,70902,605542,1174,125082,4.79614434165505,0.17119886562718992
223,0.0225,12,412,12,71314,605130,1186,125070,4.792881130401724,0.17128184059161874
224,0.0226,8,419,8,71733,604711,1194,125062,4.789562476238753,0.17137109758788008
225,0.0227,13,484,13,72217,604227,1207,125049,4.785728995057661,0.17147006071775295
226,0.0228,17,480,17,72697,603747,1224,125032,4.781927195539222,0.17156367019357033
227,0.0229,11,474,11,73171,603273,1235,125021,4.7781729185147634,0.1716628174885417
228,0.023,14,475,14,73646,602798,1249,125007,4.774410721074642,0.1717589189411999
229,0.0231,7,501,7,74147,602297,1256,125000,4.770442592827272,0.17186926386331855
230,0.0232,4,455,4,74602,601842,1260,124996,4.766838803700418,0.17197229644019713
231,0.0233,20,461,20,75063,601381,1280,124976,4.7631874920795845,0.17205864333929458
232,0.0234,9,449,9,75512,600932,1289,124967,4.759631225446712,0.17215480390522647
233,0.0235,10,445,10,75957,600487,1299,124957,4.756106640476492,0.17224899509817435
234,0.0236,14,469,14,76426,600018,1313,124943,4.752391965530351,0.1723444433562633
235,0.0237,9,475,9,76901,599543,1322,124934,4.748629768090229,0.17244715843291092
236,0.0238,11,454,11,77355,599089,1333,124923,4.745033899379039,0.1725427202864041
237,0.0239,9,469,9,77824,598620,1342,124914,4.741319224432898,0.17264427103633
238,0.024,16,451,16,78275,598169,1358,124898,4.737747116968698,0.1727336470894122
239,0.0241,14,478,14,78753,597691,1372,124884,4.733961158281587,0.1728318859633948
240,0.0242,12,451,12,79204,597240,1384,124872,4.7303890508173865,0.17292608348843394
241,0.0243,14,472,14,79676,596768,1398,124858,4.726650614624256,0.1730231449532029
242,0.0244,10,458,10,80134,596310,1408,124848,4.723023064250412,0.17312156281979815
243,0.0245,10,452,10,80586,595858,1418,124838,4.719443036370548,0.17321866640025754
244,0.0246,11,463,11,81049,595395,1429,124827,4.715775883918388,0.17331739380357722
245,0.0247,21,520,21,81569,594875,1450,124806,4.711657267773413,0.1734185006968365
246,0.0248,13,448,13,82017,594427,1463,124793,4.708108921556203,0.17351158199160202
247,0.0249,13,472,13,82489,593955,1476,124780,4.7043704853630715,0.17361057969905458
248,0.025,10,483,10,82972,593472,1486,124770,4.700544924597643,0.17371582280067163
249,0.0251,9,465,9,83437,593007,1495,124761,4.696861931314156,0.17381800247433712
250,0.0252,17,443,17,83880,592564,1512,124744,4.693353187175263,0.17390576990637216
251,0.0253,20,484,20,84364,592080,1532,124724,4.6895197059941705,0.17400014508847608
252,0.0254,13,515,13,84879,591565,1545,124711,4.6854406919275124,0.17411025917383802
253,0.0255,11,446,11,85325,591119,1556,124700,4.68190818654163,0.17420604929458425
254,0.0256,16,508,16,85833,590611,1572,124684,4.677884615384615,0.1743112981357342
255,0.0257,11,450,11,86283,590161,1583,124673,4.674320428336079,0.17440832417036684
256,0.0258,17,443,17,86726,589718,1600,124656,4.6708116841971865,0.17449683219154113
257,0.0259,8,458,8,87184,589260,1608,124648,4.667184133823343,0.1745995282305283
258,0.026,11,481,11,87665,588779,1619,124637,4.663374413889241,0.17470452022382452
259,0.0261,18,419,18,88084,588360,1637,124619,4.66005575972627,0.1747863541562935
260,0.0262,21,487,21,88571,587873,1658,124598,4.656198517298188,0.17488150394893265
261,0.0263,12,474,12,89045,587399,1670,124586,4.65244424027373,0.17498402353982176
262,0.0264,12,465,12,89510,586934,1682,124574,4.648761246990242,0.17508446848102902
263,0.0265,10,479,10,89989,586455,1692,124564,4.644967367887467,0.17519081768560335
264,0.0266,11,439,11,90428,586016,1703,124553,4.641490305411228,0.17528628465356635
265,0.0267,13,406,13,90834,585610,1716,124540,4.638274616651882,0.17537140040836444
266,0.0268,9,461,9,91295,585149,1725,124531,4.634623305031048,0.17547486190959305
267,0.0269,15,493,15,91788,584656,1740,124516,4.630718540108985,0.17557940809845848
268,0.027,21,458,21,92246,584198,1761,124495,4.627090989735141,0.17566844882057533
269,0.0271,21,434,21,92680,583764,1782,124474,4.623653529337219,0.175751654104976
270,0.0272,11,474,11,93154,583290,1793,124463,4.619899252312761,0.1758565488242367
271,0.0273,17,453,17,93607,582837,1810,124446,4.616311304017235,0.17594937245770081
272,0.0274,14,477,14,94084,582360,1824,124432,4.612533265745786,0.17605179458737508
273,0.0275,16,450,16,94534,581910,1840,124416,4.60896907869725,0.1761452926835484
274,0.0276,10,460,10,94994,581450,1850,124406,4.60532568749208,0.17624841327409557
275,0.0277,17,469,17,95463,580981,1867,124389,4.601611012545939,0.1763457476218155
276,0.0278,14,437,14,95900,580544,1881,124375,4.598149790901027,0.17643871139804715
277,0.0279,6,474,6,96374,580070,1887,124369,4.594395513876568,0.17655041813414646
278,0.028,17,457,17,96831,579613,1904,124352,4.590775883918388,0.17664514571036913
279,0.0281,12,458,12,97289,579155,1916,124340,4.587148333544544,0.17674610338381935
280,0.0282,20,490,20,97779,578665,1936,124320,4.5832673298694715,0.1768458786460593
281,0.0283,23,510,23,98289,578155,1959,124297,4.579227917881131,0.1769473216675303
282,0.0284,11,455,11,98744,577700,1970,124286,4.575624128754277,0.17704911493961417
283,0.0285,16,449,16,99193,577251,1986,124270,4.572067862121404,0.17714366355390643
284,0.0286,10,400,10,99593,576851,1996,124260,4.568899695856039,0.1772329916375581
285,0.0287,16,490,16,100083,576361,2012,124244,4.565018692180965,0.17733815773510037
286,0.0288,9,476,9,100559,575885,2021,124235,4.56124857432518,0.17744815174541506
287,0.0289,18,481,18,101040,575404,2039,124217,4.557438854391078,0.17754898723737567
288,0.029,20,451,20,101491,574953,2059,124197,4.553866746926879,0.17763999141815062
289,0.0291,14,477,14,101968,574476,2073,124183,4.55008870865543,0.17774479395527717
290,0.0292,13,423,13,102391,574053,2086,124170,4.5467383728298065,0.1778371666358742
291,0.0293,13,476,13,102867,573577,2099,124157,4.542968254974021,0.17794317031992135
292,0.0294,12,462,12,103329,573115,2111,124145,4.539309022937524,0.17804692654103205
293,0.0295,15,482,15,103811,572633,2126,124130,4.535491382587758,0.17815239902233615
294,0.0296,24,471,24,104282,572162,2150,124106,4.5317608668102904,0.1782445839820299
295,0.0297,18,478,18,104760,571684,2168,124088,4.527974908123178,0.17834577993940542
296,0.0298,13,437,13,105197,571247,2181,124075,4.524513686478266,0.17844250577430312
297,0.0299,14,465,14,105662,570782,2195,124061,4.520830693194779,0.17854536924168482
298,0.03,17,478,17,106140,570304,2212,124044,4.5170447345076665,0.17864817065794097
299,0.0301,13,440,13,106580,569864,2225,124031,4.513559751615765,0.1787460638857464
300,0.0302,11,447,11,107027,569417,2236,124020,4.510019325814219,0.17884825874592788
301,0.0303,16,435,16,107462,568982,2252,124004,4.506573945000634,0.17894156591908061
302,0.0304,12,447,12,107909,568535,2264,123992,4.503033519199088,0.1790428387629652
303,0.0305,13,473,13,108382,568062,2277,123979,4.499287162590293,0.17914979025809163
304,0.0306,23,502,23,108884,567560,2300,123956,4.495311113927259,0.17925254079442848
305,0.0307,16,467,16,109351,567093,2316,123940,4.491612279812444,0.1793546762600339
306,0.0308,13,463,13,109814,566630,2329,123927,4.487945127360284,0.17945947981122484
307,0.0309,13,489,13,110303,566141,2342,123914,4.484072044100874,0.1795711936005101
308,0.031,21,447,21,110750,565694,2363,123893,4.480531618299328,0.1796626096489638
309,0.0311,12,448,12,111198,565246,2375,123881,4.476983272082119,0.1797651231195411
310,0.0312,11,459,11,111657,564787,2386,123870,4.473347801292612,0.17987183750401142
311,0.0313,9,484,9,112141,564303,2395,123861,4.46951432011152,0.17998761923029977
312,0.0314,13,484,13,112625,563819,2408,123848,4.465680838930427,0.18009879781929336
313,0.0315,17,478,17,113103,563341,2425,123831,4.461894880243316,0.18020379177265664
314,0.0316,13,436,13,113539,562905,2438,123818,4.458441579014067,0.18030268390602908
315,0.0317,19,483,19,114022,562422,2457,123799,4.454616018248638,0.18040689515476793
316,0.0318,20,450,20,114472,561972,2477,123779,4.451051831200101,0.1805013773220892
317,0.0319,17,480,17,114952,561492,2494,123762,4.447250031681663,0.18060748277281125
318,0.032,13,504,13,115456,560988,2507,123749,4.443258142187302,0.18072486224638074
319,0.0321,10,422,10,115878,560566,2517,123739,4.4399157267773415,0.18082434002381978
320,0.0322,12,474,12,116352,560092,2529,123727,4.436161449752883,0.18093530598009122
321,0.0323,18,445,18,116797,559647,2547,123709,4.432636864782664,0.18103155602643425
322,0.0324,22,438,22,117235,559209,2569,123687,4.429167722722088,0.18112128347508258
323,0.0325,11,477,11,117712,558732,2580,123676,4.42538968445064,0.18123468658046213
324,0.0326,32,464,32,118176,558268,2612,123644,4.421714611582816,0.18131958375860815
325,0.0327,15,455,15,118631,557813,2627,123629,4.418110822455962,0.18142263024586097
326,0.0328,17,488,17,119119,557325,2644,123612,4.414245659612217,0.18153221223108745
327,0.0329,16,459,16,119578,556866,2660,123596,4.41061018882271,0.1816354182893387
328,0.033,16,492,16,120070,556374,2676,123580,4.40671334431631,0.18174758880747816
329,0.0331,13,471,13,120541,555903,2689,123567,4.402982828538842,0.18185791867190604
330,0.0332,18,487,18,121028,555416,2707,123549,4.399125586110759,0.18196666985779827
331,0.0333,14,447,14,121475,554969,2721,123535,4.395585160309213,0.18206967092308962
332,0.0334,15,450,15,121925,554519,2736,123520,4.392020973260677,0.18217241191140923
333,0.0335,18,486,18,122411,554033,2754,123502,4.388171651248258,0.18228135815861912
334,0.0336,20,446,20,122857,553587,2774,123482,4.384639145862375,0.1823772761712617
335,0.0337,19,453,19,123310,553134,2793,123463,4.3810511975668485,0.1824764224494049
336,0.0338,17,444,17,123754,552690,2810,123446,4.377534533012293,0.1825756948306258
337,0.0339,17,471,17,124225,552219,2827,123429,4.373804017234825,0.1826824026712134
338,0.034,21,437,21,124662,551782,2848,123408,4.370342795589912,0.18277521882729306
339,0.0341,24,425,24,125087,551357,2872,123384,4.366976618932962,0.18286127565984578
340,0.0342,23,486,23,125573,550871,2895,123361,4.363127296920543,0.18296521078797803
341,0.0343,18,478,18,126051,550393,2913,123343,4.35934133823343,0.18307319187337473
342,0.0344,14,535,14,126586,549858,2927,123329,4.355103915853504,0.1832016958140903
343,0.0345,11,461,11,127047,549397,2938,123318,4.35145260423267,0.18331388478033045
344,0.0346,21,497,21,127544,548900,2959,123297,4.347516157647953,0.1834239069796503
345,0.0347,16,469,16,128013,548431,2975,123281,4.343801482701812,0.18353252584440952
346,0.0348,20,446,20,128459,547985,2995,123261,4.3402689773159295,0.18363014453717416
347,0.0349,22,473,22,128932,547512,3017,123239,4.336522620707135,0.18373286062935426
348,0.035,26,446,26,129378,547066,3043,123213,4.332990115321252,0.18382345262196786
349,0.0351,21,442,21,129820,546624,3064,123192,4.329489291598023,0.1839191658604751
350,0.0352,21,479,21,130299,546145,3085,123171,4.325695412495247,0.18402518391910547
351,0.0353,26,488,26,130787,545657,3111,123145,4.3218302496515015,0.1841277388524556
352,0.0354,20,435,20,131222,545222,3131,123125,4.318384868837916,0.1842231655113287
353,0.0355,19,498,19,131720,544724,3150,123106,4.314440501837536,0.1843373313567824
354,0.0356,23,492,23,132212,544232,3173,123083,4.310543657331137,0.18444512711388175
355,0.0357,18,399,18,132611,543833,3191,123065,4.307383411481434,0.1845334668869902
356,0.0358,14,456,14,133067,543377,3205,123051,4.303771701938918,0.18464260205153446
357,0.0359,30,462,30,133529,542915,3235,123021,4.3001124699024205,0.18473396842939863
358,0.036,17,431,17,133960,542484,3252,123004,4.296698770751489,0.18483278436275336
359,0.0361,19,439,19,134399,542045,3271,122985,4.29322170827525,0.18493150684931506
360,0.0362,13,501,13,134900,541544,3284,122972,4.2892535800278795,0.18505498738931794
361,0.0363,23,479,23,135379,541065,3307,122949,4.285459700925105,0.18516025264527555
362,0.0364,20,465,20,135844,540600,3327,122929,4.281776707641617,0.18526545184912793
363,0.0365,17,446,17,136290,540154,3344,122912,4.278244202255735,0.18536917893543026
364,0.0366,17,437,17,136727,539717,3361,122895,4.274782980610823,0.185470531774251
365,0.0367,26,465,26,137192,539252,3387,122869,4.271099987327335,0.18556880086872338
366,0.0368,17,478,17,137670,538774,3404,122852,4.267314028640223,0.18568194115708875
367,0.0369,22,462,22,138132,538312,3426,122830,4.263654796603726,0.1857845969549658
368,0.037,24,462,24,138594,537850,3450,122806,4.2599955645672285,0.18588493860647598
369,0.0371,22,492,22,139086,537358,3472,122784,4.2560987200608285,0.1859963462406573
370,0.0372,23,480,23,139566,536878,3495,122761,4.25229692054239,0.18610330802150873
371,0.0373,13,457,13,140023,536421,3508,122748,4.24867729058421,0.1862162814088648
372,0.0374,19,452,19,140475,535969,3527,122729,4.245097262704347,0.18632059001241844
373,0.0375,22,450,22,140925,535519,3549,122707,4.24153307565581,0.1864207734121715
374,0.0376,17,470,17,141395,535049,3566,122690,4.237810480294006,0.18653295608136358
375,0.0377,32,447,32,141842,534602,3598,122658,4.23427005449246,0.18662021117974623
376,0.0378,18,439,18,142281,534163,3616,122640,4.230792992016221,0.18672265504268404
377,0.0379,31,478,31,142759,533685,3647,122609,4.227007033329109,0.18682023605274464
378,0.038,23,460,23,143219,533225,3670,122586,4.223363642123939,0.18692275670886888
379,0.0381,20,439,20,143658,532786,3690,122566,4.2198865796477,0.18702315702095973
380,0.0382,21,461,21,144119,532325,3711,122545,4.216235268026866,0.1871287431093194
381,0.0383,10,426,10,144545,531899,3721,122535,4.212861170954252,0.1872381324931162
382,0.0384,15,456,15,145001,531443,3736,122520,4.209249461411735,0.18735004885597503
383,0.0385,15,442,15,145443,531001,3751,122505,4.205748637688506,0.18745811056057635
384,0.0386,21,462,21,145905,530539,3772,122484,4.202089405652009,0.18756460339069222
385,0.0387,26,480,26,146385,530059,3798,122458,4.19828760613357,0.1876702062934759
386,0.0388,26,427,26,146812,529632,3824,122432,4.194905588645292,0.18776071060509397
387,0.0389,16,473,16,147285,529159,3840,122416,4.191159232036497,0.18787706710662624
388,0.039,17,481,17,147766,528678,3857,122399,4.187349512102395,0.18799466115374985
389,0.0391,21,469,21,148235,528209,3878,122378,4.183634837156254,0.18810397379597193
390,0.0392,22,475,22,148710,527734,3900,122356,4.179872639716132,0.1882139396083619
391,0.0393,22,449,22,149159,527285,3922,122334,4.176316373083259,0.18831653630820527
392,0.0394,22,432,22,149591,526853,3944,122312,4.1728947535166645,0.18841434766199658
393,0.0395,20,450,20,150041,526403,3964,122292,4.169330566468128,0.1885200286729511
394,0.0396,28,450,28,150491,525953,3992,122264,4.165766379419592,0.18861584932206343
395,0.0397,18,389,18,150880,525564,4010,122246,4.162685337726524,0.1887065651965854
396,0.0398,14,476,14,151356,525088,4024,122232,4.158915219870739,0.18882778224062288
397,0.0399,10,453,10,151809,524635,4034,122222,4.155327271575212,0.1889474798912279
398,0.04,22,450,22,152259,524185,4056,122200,4.151763084526676,0.18905141672532624
399,0.0401,14,435,14,152694,523750,4070,122186,4.148317703713091,0.1891611552847341
400,0.0402,15,426,15,153120,523324,4085,122171,4.144943606640476,0.18926715156585255
401,0.0403,17,461,17,153581,522863,4102,122154,4.1412922950196425,0.18938105507296707
402,0.0404,17,459,17,154040,522404,4119,122137,4.1376568242301355,0.18949453952502635
403,0.0405,16,399,16,154439,522005,4135,122121,4.134496578380434,0.1895917879421107
404,0.0406,18,460,18,154899,521545,4153,122103,4.130853187175263,0.18970462115939146
405,0.0407,25,442,25,155341,521103,4178,122078,4.127352363452034,0.18980349232953087
406,0.0408,15,472,15,155813,520631,4193,122063,4.123613927258902,0.18992397626242039
407,0.0409,22,442,22,156255,520189,4215,122041,4.120113103535673,0.1900269373900316
408,0.041,22,438,22,156693,519751,4237,122019,4.1166439614750985,0.19012886236502174
409,0.0411,26,450,26,157143,519301,4263,121993,4.113079774426562,0.19022944234625616
410,0.0412,18,456,18,157599,518845,4281,121975,4.109468064884045,0.19034206173340407
411,0.0413,12,473,12,158072,518372,4293,121963,4.10572170827525,0.1904674896733741
412,0.0414,16,458,16,158530,517914,4309,121947,4.102094157901407,0.1905835798712533
413,0.0415,19,482,19,159012,517432,4328,121928,4.098276517551641,0.1907032032032032
414,0.0416,33,465,33,159477,516967,4361,121895,4.094593524268154,0.19080020411293833
415,0.0417,27,432,27,159909,516535,4388,121868,4.091171904701559,0.1908950929115308
416,0.0418,23,433,23,160342,516102,4411,121845,4.0877423647193005,0.19099549022097448
417,0.0419,26,471,26,160813,515631,4437,121819,4.084011848941833,0.19110361596988
418,0.042,23,449,23,161262,515182,4460,121796,4.08045558230896,0.191209115542452
419,0.0421,28,471,28,161733,514711,4488,121768,4.076725066531491,0.19131503160355645
420,0.0422,20,452,20,162185,514259,4508,121748,4.073145038651629,0.19142556607081368
421,0.0423,22,448,22,162633,513811,4530,121726,4.069596692434419,0.1915325150227288
422,0.0424,19,423,19,163056,513388,4549,121707,4.0662463566087945,0.19163589699178862
423,0.0425,24,472,24,163528,512916,4573,121683,4.062507920415664,0.19174785967201335
424,0.0426,22,469,22,163997,512447,4595,121661,4.058793245469523,0.1918616387113867
425,0.0427,19,394,19,164391,512053,4614,121642,4.055672601698137,0.1919566984116965
426,0.0428,20,481,20,164872,511572,4634,121622,4.051862881764035,0.19207699378073703
427,0.0429,27,463,27,165335,511109,4661,121595,4.048195729311875,0.1921830745498685
428,0.043,26,457,26,165792,510652,4687,121569,4.044576099353694,0.19228877243875164
429,0.0431,26,475,26,166267,510177,4713,121543,4.040813901913572,0.19240011397454568
430,0.0432,19,416,19,166683,509761,4732,121524,4.0375190089975925,0.19250259391558489
431,0.0433,28,455,28,167138,509306,4760,121496,4.033915219870739,0.19260560366010254
432,0.0434,21,452,21,167590,508854,4781,121475,4.030335191990876,0.1927168193118197
433,0.0435,24,476,24,168066,508378,4805,121451,4.026565074135091,0.1928317051136102
434,0.0436,20,454,20,168520,507924,4825,121431,4.022969205423901,0.19294515813809376
435,0.0437,24,456,24,168976,507468,4849,121407,4.019357495881384,0.19305426356589148
436,0.0438,23,429,23,169405,507039,4872,121384,4.015959637561779,0.19315652036924175
437,0.0439,29,477,29,169882,506562,4901,121355,4.012181599290331,0.19326598897625005
438,0.044,27,432,27,170314,506130,4928,121328,4.008759979723736,0.19336433673648276
439,0.0441,16,418,16,170732,505712,4944,121312,4.005449245976429,0.1934726581438669
440,0.0442,21,388,21,171120,505324,4965,121291,4.002376124699024,0.19356542693679532
441,0.0443,25,429,25,171549,504895,4990,121266,3.9989782663794196,0.19366584632386877
442,0.0444,25,462,25,172011,504433,5015,121241,3.995319034342922,0.19377663128082676
443,0.0445,23,439,23,172450,503994,5038,121218,3.9918419718666835,0.19388303487457054
444,0.0446,28,436,28,172886,503558,5066,121190,3.988388670637435,0.19398221362853502
445,0.0447,23,463,23,173349,503095,5089,121167,3.984721518185274,0.19409638901615028
446,0.0448,15,473,15,173822,502622,5104,121152,3.9809751615764797,0.1942241901714403
447,0.0449,25,447,25,174269,502175,5129,121127,3.9774347357749336,0.1943311588924791
448,0.045,21,471,21,174740,501704,5150,121106,3.9737042199974653,0.19445095615035082
449,0.0451,25,445,25,175185,501259,5175,121081,3.9701796350272462,0.1945576373043674
450,0.0452,26,435,26,175620,500824,5201,121055,3.966734254213661,0.194660054447891
451,0.0453,34,456,34,176076,500368,5235,121021,3.9631225446711444,0.1947588386662783
452,0.0454,14,428,14,176504,499940,5249,121007,3.959732606767203,0.19487492491307631
453,0.0455,24,398,24,176902,499542,5273,120983,3.9565802813331645,0.19496877643930544
454,0.0456,20,445,20,177347,499097,5293,120963,3.953055696362945,0.19508273392897463
455,0.0457,17,455,17,177802,498642,5310,120946,3.949451907236092,0.19520390969482948
456,0.0458,20,446,20,178248,498196,5330,120926,3.945919401850209,0.19531853172718786
457,0.0459,25,431,25,178679,497765,5355,120901,3.9425057026992776,0.19542208558414395
458,0.046,18,463,18,179142,497302,5373,120883,3.938838550247117,0.19554502293002904
459,0.0461,28,456,28,179598,496846,5401,120855,3.9352268407046003,0.19565291297893317
460,0.0462,18,455,18,180053,496391,5419,120837,3.9316230515777466,0.19577368492680178
461,0.0463,21,422,21,180475,495969,5440,120816,3.928280636167786,0.19588025000607992
462,0.0464,16,399,16,180874,495570,5456,120800,3.925120390318084,0.1959861771338644
463,0.0465,21,437,21,181311,495133,5477,120779,3.921659168673172,0.1960978191689722
464,0.0466,24,424,24,181735,494709,5501,120755,3.9183009124318846,0.19620156499811525
465,0.0467,19,414,19,182149,494295,5520,120736,3.915021860347231,0.19630880394646774
466,0.0468,15,418,15,182567,493877,5535,120721,3.911711126599924,0.19642270231923956
467,0.0469,27,443,27,183010,493434,5562,120694,3.9082023824610315,0.19652906234530912
468,0.047,23,479,23,183489,492955,5585,120671,3.904408503358256,0.19665235827686572
469,0.0471,23,483,23,183972,492472,5608,120648,3.9005829425928273,0.19677713987473905
470,0.0472,27,412,27,184384,492060,5635,120621,3.8973197313395005,0.19687406660235915
471,0.0473,34,417,34,184801,491643,5669,120587,3.894016918007857,0.1969635594466132
472,0.0474,26,430,26,185231,491213,5695,120561,3.890611139272589,0.19706787146887575
473,0.0475,26,436,26,185667,490777,5721,120535,3.8871578380433407,0.19717427434763263
474,0.0476,17,437,17,186104,490340,5738,120518,3.883696616398429,0.1972929878957139
475,0.0477,16,404,16,186508,489936,5754,120502,3.8804967684704095,0.1974025208129245
476,0.0478,21,390,21,186898,489546,5775,120481,3.8774078063616777,0.19750109421386267
477,0.0479,14,436,14,187334,489110,5789,120467,3.8739545051324296,0.19762392609957397
478,0.048,27,453,27,187787,488657,5816,120440,3.870366556836903,0.19773533607947502
479,0.0481,19,422,19,188209,488235,5835,120421,3.867024141426942,0.197847388344155
480,0.0482,17,423,17,188632,487812,5852,120404,3.863673805601318,0.1979625659305247
481,0.0483,14,430,14,189062,487382,5866,120390,3.86026802686605,0.19808414997729412
482,0.0484,18,450,18,189512,486932,5884,120372,3.8567038398175137,0.19820715819424867
483,0.0485,26,422,26,189934,486510,5910,120346,3.8533614244075527,0.19831063711984392
484,0.0486,25,418,25,190352,486092,5935,120321,3.850050690660246,0.19841428201572195
485,0.0487,27,416,27,190768,485676,5962,120294,3.8467557977442657,0.19851477795930492
486,0.0488,30,444,30,191212,485232,5992,120264,3.84323913318971,0.19862063498355068
487,0.0489,29,432,29,191644,484800,6021,120235,3.8398175136231147,0.19872404075797268
488,0.049,26,435,26,192079,484365,6047,120209,3.83637213280953,0.1988325664021278
489,0.0491,25,414,25,192493,483951,6072,120184,3.8330930807248764,0.19893566835227225
490,0.0492,17,383,17,192876,483568,6089,120167,3.830059561525789,0.19903931360613514
491,0.0493,25,405,25,193281,483163,6114,120142,3.826851793182106,0.19913973860650916
492,0.0494,16,429,16,193710,482734,6130,120126,3.8234539348625014,0.19926019307965365
493,0.0495,20,396,20,194106,482338,6150,120106,3.8203174502597896,0.19936458824388656
494,0.0496,25,459,25,194565,481879,6175,120081,3.8166819794702826,0.19948335437570602
495,0.0497,30,419,30,194984,481460,6205,120051,3.813363325307312,0.19958238502704023
496,0.0498,33,400,33,195384,481060,6238,120018,3.8101951590419465,0.19967125730770383
497,0.0499,17,438,17,195822,480622,6255,120001,3.8067260169813713,0.199794213674801
498,0.05,23,431,23,196253,480191,6278,119978,3.8033123178304398,0.19990702618762382
499,0.0501,26,440,26,196693,479751,6304,119952,3.7998273349385374,0.20001900940965778
500,0.0502,25,423,25,197116,479328,6329,119927,3.7964769991129135,0.2001268241399738
501,0.0503,28,418,28,197534,478910,6357,119899,3.793166265365606,0.20022912147279015
502,0.0504,24,402,24,197936,478508,6381,119875,3.789982258268914,0.2003315602214635
503,0.0505,29,410,29,198346,478098,6410,119846,3.7867348878469143,0.20043014061517467
504,0.0506,27,429,27,198775,477669,6437,119819,3.7833370295273094,0.20053791875317997
505,0.0507,22,384,22,199159,477285,6459,119797,3.7802955899125585,0.20063743338435927
506,0.0508,16,434,16,199593,476851,6475,119781,3.776858129514637,0.20076194371069603
507,0.0509,24,366,24,199959,476485,6499,119757,3.7739592573818275,0.2008530093485531
508,0.051,32,424,32,200383,476061,6531,119725,3.7706010011405398,0.20095302675792986
509,0.0511,24,449,24,200832,475612,6555,119701,3.767044734507667,0.20107237705207176
510,0.0512,18,423,18,201255,475189,6573,119683,3.763694398682043,0.20119118062373081
511,0.0513,24,438,24,201693,474751,6597,119659,3.7602252566214673,0.2013071785467943
512,0.0514,23,419,23,202112,474332,6620,119636,3.756906602458497,0.20141825822266518
513,0.0515,22,368,22,202480,473964,6642,119614,3.7539918894943605,0.20151353318350748
514,0.0516,25,436,25,202916,473528,6667,119589,3.7505385882651123,0.20162800931350813
515,0.0517,28,443,28,203359,473085,6695,119561,3.7470298441262195,0.20174100559187103
516,0.0518,27,401,27,203760,472684,6722,119534,3.7438537574451907,0.2018412138773222
517,0.0519,29,405,29,204165,472279,6751,119505,3.740645989101508,0.20194023495059008
518,0.052,28,409,28,204574,471870,6779,119477,3.7374065390951716,0.2020421174031491
519,0.0521,21,422,21,204996,471448,6800,119456,3.734064123685211,0.20215804936165604
520,0.0522,21,451,21,205447,470997,6821,119435,3.730492016221011,0.20228409029320904
521,0.0523,21,441,21,205888,470556,6842,119414,3.726999112913446,0.20240690204586673
522,0.0524,22,402,22,206290,470154,6864,119392,3.7238151058167532,0.20251515573000242
523,0.0525,26,417,26,206707,469737,6890,119366,3.7205122924851097,0.2026233103548955
524,0.0526,27,410,27,207117,469327,6917,119339,3.71726492206311,0.20272786265896112
525,0.0527,25,387,25,207504,468940,6942,119314,3.7141997212013687,0.20282735009026712
526,0.0528,22,442,22,207946,468498,6964,119292,3.7106988974781396,0.20295003317511356
527,0.0529,32,441,32,208387,468057,6996,119260,3.707205994170574,0.20305899539771538
528,0.053,31,427,31,208814,467630,7027,119229,3.7038239766822962,0.20316464431831155
529,0.0531,14,380,14,209194,467250,7041,119215,3.700814218730199,0.20327726292276607
530,0.0532,27,386,27,209580,466864,7068,119188,3.697756938284121,0.20337444458853482
531,0.0533,27,425,27,210005,466439,7095,119161,3.69439076162717,0.2034853142076503
532,0.0534,35,398,35,210403,466041,7130,119126,3.6912384361931316,0.20357607315518475
533,0.0535,23,405,23,210808,465636,7153,119103,3.6880306678494486,0.2036857469742911
534,0.0536,22,382,22,211190,465254,7175,119081,3.6850050690660248,0.20378892245030675
535,0.0537,29,409,29,211599,464845,7204,119052,3.6817656190596884,0.2038921248096839
536,0.0538,31,409,31,212008,464436,7235,119021,3.678526169053352,0.20399275353625032
537,0.0539,24,387,24,212395,464049,7259,118997,3.6754609681916106,0.20409538870003396
538,0.054,23,455,23,212850,463594,7282,118974,3.6718571790647574,0.20422336963238627
539,0.0541,22,445,22,213295,463149,7304,118952,3.668332594094538,0.20434941702556772
540,0.0542,21,398,21,213693,462751,7325,118931,3.6651802686604995,0.2044605127887746
541,0.0543,23,428,23,214121,462323,7348,118908,3.661790330756558,0.20457959055865912
542,0.0544,21,386,21,214507,461937,7369,118887,3.6587330503104805,0.2046867898020743
543,0.0545,26,416,26,214923,461521,7395,118861,3.6554381573945,0.20479787450334436
544,0.0546,35,414,35,215337,461107,7430,118826,3.6521591053098468,0.20489608282336064
545,0.0547,21,436,21,215773,460671,7451,118805,3.648705804080598,0.20502143315685206
546,0.0548,26,394,26,216167,460277,7477,118779,3.645585160309213,0.20512523831891907
547,0.0549,28,374,28,216541,459903,7505,118751,3.6426229248510964,0.20521935387986603
548,0.055,35,402,35,216943,459501,7540,118716,3.6394389177544038,0.20531392193588222
549,0.0551,30,384,30,217327,459117,7570,118686,3.636397478139653,0.20540911002538928
550,0.0552,24,405,24,217732,458712,7594,118662,3.6331897097959702,0.20552016543869311
551,0.0553,32,387,32,218119,458325,7626,118630,3.630124508934229,0.20561395602776647
552,0.0554,33,400,33,218519,457925,7659,118597,3.6269563426688634,0.2057111437204478
553,0.0555,23,398,23,218917,457527,7682,118574,3.6238040172348245,0.20582154865205926
554,0.0556,28,407,28,219324,457120,7710,118546,3.620580408059815,0.20592843767045474
555,0.0557,25,408,25,219732,456712,7735,118521,3.617348878469142,0.20603998727472173
556,0.0558,31,416,31,220148,456296,7766,118490,3.614053985553162,0.20614628748786504
557,0.0559,25,394,25,220542,455902,7791,118465,3.610933341781777,0.20625314476632536
558,0.056,23,373,23,220915,455529,7814,118442,3.6079790267393235,0.20635537335509982
559,0.0561,20,430,20,221345,455099,7834,118422,3.6045732480040553,0.20648241302410897
560,0.0562,25,405,25,221750,454694,7859,118397,3.6013654796603727,0.206593717228154
561,0.0563,25,437,25,222187,454257,7884,118372,3.5979042580154608,0.20671673980884656
562,0.0564,29,410,29,222597,453847,7913,118343,3.594656887593461,0.20682465614568588
563,0.0565,38,406,38,223003,453441,7951,118305,3.5914411988341146,0.20691880660293208
564,0.0566,27,398,27,223401,453043,7978,118278,3.588288873400076,0.20702547254520665
565,0.0567,24,414,24,223815,452629,8002,118254,3.5850098213154227,0.20714226908140548
566,0.0568,25,419,25,224234,452210,8027,118229,3.581691167152452,0.2072596719368767
567,0.0569,20,411,20,224645,451799,8047,118209,3.578435876314789,0.2073812999115802
568,0.057,15,400,15,225045,451399,8062,118194,3.5752677100494235,0.20750606134555727
569,0.0571,31,431,31,225476,450968,8093,118163,3.571854010898492,0.20762003826886954
570,0.0572,21,421,21,225897,450547,8114,118142,3.5685195159041947,0.20774447896829373
571,0.0573,25,391,25,226288,450156,8139,118117,3.5654226333797996,0.20785256382055808
572,0.0574,28,404,28,226692,449752,8167,118089,3.5622227854517807,0.2079613835563124
573,0.0575,37,396,37,227088,449356,8204,118052,3.5590863008490685,0.20805487409412626
574,0.0576,22,388,22,227476,448968,8226,118030,3.556013179571664,0.2081665191058875
575,0.0577,27,375,27,227851,448593,8253,118003,3.553043023697884,0.208266560300461
576,0.0578,29,388,29,228239,448205,8282,117974,3.549969902420479,0.2083687314435894
577,0.0579,27,378,27,228617,447827,8309,117947,3.5469759852997087,0.20847016653292658
578,0.058,15,391,15,229008,447436,8324,117932,3.5438791027753136,0.2085933409743742
579,0.0581,26,409,26,229417,447027,8350,117906,3.540639652768977,0.20870793527728068
580,0.0582,19,399,19,229816,446628,8369,117887,3.537479406919275,0.2088288176576353
581,0.0583,25,428,25,230244,446200,8394,117862,3.534089469015334,0.20895220738145806
582,0.0584,25,407,25,230651,445793,8419,117837,3.5308658598403246,0.20906800560651492
583,0.0585,28,404,28,231055,445389,8447,117809,3.5276660119123053,0.20917865475374559
584,0.0586,22,394,22,231449,444995,8469,117787,3.5245453681409202,0.20929418495971797
585,0.0587,20,406,20,231855,444589,8489,117767,3.521329679381574,0.20941716635014118
586,0.0588,29,404,29,232259,444185,8518,117738,3.5181298314535545,0.20952692806665682
587,0.0589,23,396,23,232655,443789,8541,117715,3.5149933468508427,0.20964231777511824
588,0.059,31,377,31,233032,443412,8572,117684,3.5120073501457356,0.209739509816502
589,0.0591,25,369,25,233401,443043,8597,117659,3.509084716765936,0.20984230482502292
590,0.0592,27,375,27,233776,442668,8624,117632,3.5061145608921556,0.20994467249687668
591,0.0593,25,368,25,234144,442300,8649,117607,3.5031998479280193,0.21004738286894073
592,0.0594,25,384,25,234528,441916,8674,117582,3.5001584083132684,0.210156247207318
593,0.0595,24,367,24,234895,441549,8698,117558,3.4972516157647955,0.21026029006970043
594,0.0596,28,410,28,235305,441139,8726,117530,3.4940042453427957,0.210375016333464
595,0.0597,29,388,29,235693,440751,8755,117501,3.490931124065391,0.21048021323703273
596,0.0598,30,405,30,236098,440346,8785,117471,3.4877233557217084,0.21059057002565357
597,0.0599,24,382,24,236480,439964,8809,117447,3.484697756938284,0.21070090113040468
598,0.06,24,407,24,236887,439557,8833,117423,3.4814741477632745,0.21082085532694173
599,0.0601,21,387,21,237274,439170,8854,117402,3.4784089469015336,0.21093766844181885
600,0.0602,24,367,24,237641,438803,8878,117378,3.4755021543530606,0.21104280800674602
601,0.0603,16,390,16,238031,438413,8894,117362,3.472413192244329,0.2111681885655166
602,0.0604,32,403,32,238434,438010,8926,117330,3.4692212647319733,0.2112759750783304
603,0.0605,26,377,26,238811,437633,8952,117304,3.466235268026866,0.21138255333488307
604,0.0606,25,387,25,239198,437246,8977,117279,3.463170067165125,0.21149452233893873
605,0.0607,29,394,29,239592,436852,9006,117250,3.4600494233937398,0.2116036397630761
606,0.0608,33,407,33,239999,436445,9039,117217,3.45682581421873,0.21171219986200968
607,0.0609,33,385,33,240384,436060,9072,117184,3.453776454188316,0.21181250948948385
608,0.061,33,384,33,240768,435676,9105,117151,3.450735014573565,0.21191258748215988
609,0.0611,24,417,24,241185,435259,9129,117127,3.447432201241921,0.21203832102913542
610,0.0612,27,372,27,241557,434887,9156,117100,3.4444858066151314,0.21214267727319666
611,0.0613,25,392,25,241949,434495,9181,117075,3.441381003675073,0.21225773700527584
612,0.0614,25,375,25,242324,434120,9206,117050,3.4384108478012925,0.2123664205236134
613,0.0615,22,365,22,242689,433755,9228,117028,3.4355198960841467,0.21247569369424982
614,0.0616,26,394,26,243083,433361,9254,117002,3.4323992523127616,0.21259059929537413
615,0.0617,31,395,31,243478,432966,9285,116971,3.4292706881257127,0.21269890914777512
616,0.0618,33,377,33,243855,432589,9318,116938,3.4262846914206055,0.21279755134870534
617,0.0619,29,371,29,244226,432218,9347,116909,3.4233462172094793,0.21289974814569307
618,0.062,35,421,35,244647,431797,9382,116874,3.420011722215182,0.21301289844004878
619,0.0621,26,388,26,245035,431409,9408,116848,3.4169386009377773,0.21312632579246593
620,0.0622,32,390,32,245425,431019,9440,116816,3.4138496388290456,0.21323208630335777
621,0.0623,28,398,28,245823,430621,9468,116788,3.410697313395007,0.21334687591910254
622,0.0624,15,402,15,246225,430219,9483,116773,3.4075133062983145,0.21348209845847838
623,0.0625,19,360,19,246585,429859,9502,116754,3.4046619566594853,0.2135953590565903
624,0.0626,31,396,31,246981,429463,9533,116723,3.4015254720567736,0.21370558747386423
625,0.0627,27,365,27,247346,429098,9560,116696,3.3986345203396273,0.21380960582197678
626,0.0628,26,378,26,247724,428720,9586,116670,3.395640603218857,0.21392031390381194
627,0.0629,18,403,18,248127,428317,9604,116652,3.392448675706501,0.21405254243819374
628,0.063,35,369,35,248496,427948,9639,116617,3.3895260423267013,0.214147071515797
629,0.0631,25,377,25,248873,427571,9664,116592,3.386540045621594,0.21425933038446202
630,0.0632,30,399,30,249272,427172,9694,116562,3.383379799771892,0.21437320454486936
631,0.0633,28,397,28,249669,426775,9722,116534,3.380235394753517,0.21448936056645482
632,0.0634,33,384,33,250053,426391,9755,116501,3.3771939551387655,0.21459332611274434
633,0.0635,32,402,32,250455,425989,9787,116469,3.3740099480420733,0.21470602332346467
634,0.0636,22,399,22,250854,425590,9809,116447,3.370849702192371,0.21483219780199506
635,0.0637,30,409,30,251263,425181,9839,116417,3.3676102521860347,0.214950941473196
636,0.0638,30,361,30,251624,424820,9869,116387,3.3647509821315422,0.21505080311230268
637,0.0639,27,368,27,251992,424452,9896,116360,3.361836269167406,0.21515794767867577
638,0.064,28,392,28,252384,424060,9924,116332,3.3587314662273475,0.21527335711853618
639,0.0641,38,408,38,252792,423652,9962,116294,3.355499936636675,0.21538079733899315
640,0.0642,27,393,27,253185,423259,9989,116267,3.352387213280953,0.21549841898258842
641,0.0643,24,365,24,253550,422894,10013,116243,3.349496261563807,0.21560939056306652
642,0.0644,22,387,22,253937,422507,10035,116221,3.3464310607020655,0.2157322433584295
643,0.0645,32,375,32,254312,422132,10067,116189,3.3434609048282855,0.21583590459967195
644,0.0646,20,397,20,254709,421735,10087,116169,3.34031649980991,0.21596604598590083
645,0.0647,28,369,28,255078,421366,10115,116141,3.3373938664301104,0.21607346508975697
646,0.0648,30,373,30,255451,420993,10145,116111,3.334439551387657,0.21617973427864995
647,0.0649,30,381,30,255832,420612,10175,116081,3.331421873019896,0.21628938704249917
648,0.065,33,376,33,256208,420236,10208,116048,3.3284437967304523,0.2163928067963989
649,0.0651,30,414,30,256622,419822,10238,116018,3.325164744645799,0.21651612421618394
650,0.0652,28,393,28,257015,419429,10266,115990,3.3220520212900775,0.21663407536901005
651,0.0653,32,364,32,257379,419065,10298,115958,3.3191689899885946,0.21673460767107208
652,0.0654,26,361,26,257740,418704,10324,115932,3.316309719934102,0.21684286131124728
653,0.0655,23,416,23,258156,418288,10347,115909,3.313014827018122,0.21697800624114325
654,0.0656,27,361,27,258517,417927,10374,115882,3.3101555569636294,0.21708513719326575
655,0.0657,37,371,37,258888,417556,10411,115845,3.3072170827525027,0.21718182005658032
656,0.0658,26,377,26,259265,417179,10437,115819,3.3042310860473956,0.2172972506463439
657,0.0659,33,356,33,259621,416823,10470,115786,3.30141141807122,0.21739399822383776
658,0.066,27,388,27,260009,416435,10497,115759,3.298338296793816,0.21751278669056773
659,0.0661,26,364,26,260373,416071,10523,115733,3.295455265492333,0.2176234101285436
660,0.0662,37,356,37,260729,415715,10560,115696,3.2926355975161576,0.21771472551377372
661,0.0663,24,362,24,261091,415353,10584,115672,3.289768407046002,0.2178277858857869
662,0.0664,35,384,35,261475,414969,10619,115637,3.286726967431251,0.2179338341443557
663,0.0665,36,375,36,261850,414594,10655,115601,3.2837568115574705,0.218034873961467
664,0.0666,31,393,31,262243,414201,10686,115570,3.2806440882017487,0.21815086140992995
665,0.0667,29,384,29,262627,413817,10715,115541,3.277602648586998,0.2182662772641577
666,0.0668,26,369,26,262996,413448,10741,115515,3.274680015207198,0.2183801135429132
667,0.0669,31,353,31,263349,413095,10772,115484,3.271884108478013,0.21848011366323672
668,0.067,24,377,24,263726,412718,10796,115460,3.2688981117729057,0.2186005475426845
669,0.0671,34,349,34,264075,412369,10830,115426,3.2661338867063745,0.2186947583815686
670,0.0672,44,350,44,264425,412019,10874,115382,3.2633617412241795,0.21877470842869087
671,0.0673,23,389,23,264814,411630,10897,115359,3.2602806995311115,0.2189021023209213
672,0.0674,22,342,22,265156,411288,10919,115337,3.2575719173742237,0.21901163066698315
673,0.0675,26,377,26,265533,410911,10945,115311,3.2545859206691166,0.21912994895690413
674,0.0676,33,345,33,265878,410566,10978,115278,3.2518533772652387,0.21922471303276256
675,0.0677,41,351,41,266229,410215,11019,115237,3.2490733113673804,0.21931023195268073
676,0.0678,28,373,28,266602,409842,11047,115209,3.246118996324927,0.21942439877269065
677,0.0679,32,361,32,266963,409481,11079,115177,3.2432597262704346,0.21952776856542738
678,0.068,39,343,39,267306,409138,11118,115138,3.240543023697884,0.21961333343506093
679,0.0681,34,399,34,267705,408739,11152,115104,3.2373827778481816,0.21972995725818614
680,0.0682,23,379,23,268084,408360,11175,115081,3.2343809403117474,0.21985476873229265
681,0.0683,24,371,24,268455,407989,11199,115057,3.231442466100621,0.21997491616416148
682,0.0684,34,395,34,268850,407594,11233,115023,3.2283139019135723,0.2200904295114778
683,0.0685,34,399,34,269249,407195,11267,114989,3.22515365606387,0.22020781946593537
684,0.0686,25,346,25,269595,406849,11292,114964,3.222413192244329,0.22031647352595662
685,0.0687,33,353,33,269948,406496,11325,114931,3.219617285515144,0.22041628070659938
686,0.0688,34,370,34,270318,406126,11359,114897,3.2166867317196806,0.2205219347322479
687,0.0689,18,363,18,270681,405763,11377,114879,3.2138116208338614,0.22064873752021544
688,0.069,39,389,39,271070,405374,11416,114840,3.2107305791407934,0.2207553045477438
689,0.0691,31,357,31,271427,405017,11447,114809,3.2079029907489547,0.22086044176320538
690,0.0692,32,378,32,271805,404639,11479,114777,3.2049090736281842,0.22097316986769758
691,0.0693,20,381,20,272186,404258,11499,114757,3.2018913952604233,0.22110536304345732
692,0.0694,25,369,25,272555,403889,11524,114732,3.1989687618806233,0.22122513357538548
693,0.0695,27,349,27,272904,403540,11551,114705,3.196204536814092,0.2213335391561906
694,0.0696,29,352,29,273256,403188,11580,114676,3.19341655050057,0.22144037816878562
695,0.0697,39,357,39,273613,402831,11619,114637,3.1905889621087313,0.22153447169680057
696,0.0698,35,362,35,273975,402469,11654,114602,3.1877217716385755,0.2216368738529138
697,0.0699,36,357,36,274332,402112,11690,114566,3.184894183246737,0.22173578127963645
698,0.07,31,384,31,274716,401728,11721,114535,3.181852743631986,0.22185397752695815
699,0.0701,34,356,34,275072,401372,11755,114501,3.1790330756558105,0.22195579144479358
700,0.0702,33,382,33,275454,400990,11788,114468,3.1760074768723863,0.22207046936898836
701,0.0703,35,391,35,275845,400599,11823,114433,3.172910594347991,0.2221861942558909
702,0.0704,28,375,28,276220,400224,11851,114405,3.169940438474211,0.22230577756014527
703,0.0705,31,371,31,276591,399853,11882,114374,3.1670019642630844,0.22241928175688946
704,0.0706,37,385,37,276976,399468,11919,114337,3.16395260423267,0.22252994813207344
705,0.0707,23,397,23,277373,399071,11942,114314,3.1608081992142947,0.22266719908061203
706,0.0708,27,359,27,277732,398712,11969,114287,3.1579647699911293,0.2227821106863756
707,0.0709,37,355,37,278087,398357,12006,114250,3.1551530224306172,0.2228802962113276
708,0.071,26,331,26,278418,398026,12032,114224,3.152531364846027,0.22298487066861883
709,0.0711,30,326,30,278744,397700,12062,114194,3.149949309339754,0.2230813410588911
710,0.0712,26,329,26,279073,397371,12088,114168,3.147343492586491,0.2231853289778492
711,0.0713,24,363,24,279436,397008,12112,114144,3.1444683817006718,0.2233073528030801
712,0.0714,31,345,31,279781,396663,12143,114113,3.141735838296794,0.22341104515482324
713,0.0715,36,377,36,280158,396286,12179,114077,3.138749841591687,0.22352129758622785
714,0.0716,24,357,24,280515,395929,12203,114053,3.135922253199848,0.22364122655309404
715,0.0717,28,309,28,280824,395620,12231,114025,3.133474844759853,0.2237341679011861
716,0.0718,34,345,34,281169,395275,12265,113991,3.130742301355975,0.22383390998024608
717,0.0719,42,334,42,281503,394941,12307,113949,3.1280968825243947,0.22391676000707422
718,0.072,24,378,24,281881,394563,12331,113925,3.125102965403624,0.2240465851701515
719,0.0721,34,349,34,282230,394214,12365,113891,3.122338740337093,0.22414855197252537
720,0.0722,37,395,37,282625,393819,12402,113854,3.119210176150044,0.22426640770732342
721,0.0723,31,346,31,282971,393473,12433,113823,3.116469712330503,0.22437196429697848
722,0.0724,40,357,40,283328,393116,12473,113783,3.1136421239386642,0.2244687797766419
723,0.0725,31,351,31,283679,392765,12504,113752,3.110862058040806,0.22457686513976827
724,0.0726,32,335,32,284014,392430,12536,113720,3.1082087187935623,0.22467647930455398
725,0.0727,39,372,39,284386,392058,12575,113681,3.1052623241667723,0.22478195274637708
726,0.0728,25,340,25,284726,391718,12600,113656,3.1025693828412115,0.22489483036325572
727,0.0729,23,375,23,285101,391343,12623,113633,3.099599226967431,0.2250265359145781
728,0.073,34,345,34,285446,390998,12657,113599,3.096866683563553,0.22512817159039789
729,0.0731,26,351,26,285797,390647,12683,113573,3.094086617665695,0.22524493276744278
730,0.0732,19,349,19,286146,390298,12702,113554,3.0913223925991637,0.2253717361447409
731,0.0733,32,344,32,286490,389954,12734,113522,3.0885977696109492,0.22547648745918375
732,0.0734,35,348,35,286838,389606,12769,113487,3.085841464960081,0.2255785709600412
733,0.0735,47,360,47,287198,389246,12816,113440,3.0829901153212522,0.22566771304551947
734,0.0736,34,365,34,287563,388881,12850,113406,3.080099163604106,0.22577928554790389
735,0.0737,26,347,26,287910,388534,12876,113380,3.0773507793689014,0.22589527289535657
736,0.0738,33,367,33,288277,388167,12909,113347,3.0744439868204285,0.22600964280159677
737,0.0739,24,365,24,288642,387802,12933,113323,3.0715530351032823,0.22613719131953106
738,0.074,37,365,37,289007,387437,12970,113286,3.068662083386136,0.22624484994697666
739,0.0741,34,326,34,289333,387111,13004,113252,3.0660800278798632,0.2263396773942118
740,0.0742,29,360,29,289693,386751,13033,113223,3.063228678241034,0.22645777580434182
741,0.0743,33,361,33,290054,386390,13066,113190,3.0603694081865416,0.22657031906801714
742,0.0744,24,337,24,290391,386053,13090,113166,3.0577002281079713,0.22668608366268111
743,0.0745,44,301,44,290692,385752,13134,113122,3.0553161829932836,0.22675465147512197
744,0.0746,32,354,32,291046,385398,13166,113090,3.052512355848435,0.22686604291377124
745,0.0747,30,317,30,291363,385081,13196,113060,3.0500015840831325,0.22696385160024973
746,0.0748,34,330,34,291693,384751,13230,113026,3.047387846914206,0.22706151549790368
747,0.0749,23,336,23,292029,384415,13253,113003,3.044726587251299,0.22717915314685033
748,0.075,17,339,17,292368,384076,13270,112986,3.0420415663414015,0.22730765980903792
749,0.0751,32,335,32,292703,383741,13302,112954,3.039388227094158,0.22741118795236515
750,0.0752,35,341,35,293044,383400,13337,112919,3.036687365352934,0.22751295034040606
751,0.0753,24,351,24,293395,383049,13361,112895,3.0339072994550755,0.22763658800187117
752,0.0754,27,330,27,293725,382719,13388,112868,3.031293562286149,0.2277460869635402
753,0.0755,22,357,22,294082,382362,13410,112846,3.02846597389431,0.22787596323161177
754,0.0756,36,332,36,294414,382030,13446,112810,3.0258363958940566,0.22797267803734542
755,0.0757,35,328,35,294742,381702,13481,112775,3.0232384995564567,0.2280692529682877
756,0.0758,37,337,37,295079,381365,13518,112738,3.020569319477886,0.22816700161707174
757,0.0759,34,353,34,295432,381012,13552,112704,3.017773412748701,0.22827698514935713
758,0.076,34,335,34,295767,380677,13586,112670,3.0151200735014574,0.22837880842490174
759,0.0761,25,364,25,296131,380313,13611,112645,3.0122370421999745,0.2285083110528686
760,0.0762,41,342,41,296473,379971,13652,112604,3.009528260043087,0.22860275085012435
761,0.0763,28,335,28,296808,379636,13680,112576,3.0068749207958434,0.2287144563724574
762,0.0764,25,352,25,297160,379284,13705,112551,3.004086934482322,0.2288389398883772
763,0.0765,27,339,27,297499,378945,13732,112524,3.0014019135724244,0.22895442031949115
764,0.0766,22,327,22,297826,378618,13754,112502,2.998811937650488,0.22907232448281478
765,0.0767,31,335,31,298161,378283,13785,112471,2.996158598403244,0.22917999649518903
766,0.0768,34,325,34,298486,377958,13819,112437,2.9935844633126347,0.22927843880953108
767,0.0769,21,339,21,298825,377619,13840,112416,2.9908994424027373,0.22940402216168232
768,0.077,32,343,32,299168,377276,13872,112384,2.988182739830186,0.22951435690070662
769,0.0771,32,338,32,299506,376938,13904,112352,2.9855056393359525,0.22962251425534957
770,0.0772,28,316,28,299822,376622,13932,112324,2.9830027879863135,0.22972680009653418
771,0.0773,32,339,32,300161,376283,13964,112292,2.980317767076416,0.22983574681471627
772,0.0774,40,296,40,300457,375987,14004,112252,2.9779733240400454,0.22991198982465555
773,0.0775,40,329,40,300786,375658,14044,112212,2.9753675072867822,0.2300038944800869
774,0.0776,26,362,26,301148,375296,14070,112186,2.9725003168166264,0.23013362544668317
775,0.0777,38,326,38,301474,374970,14108,112148,2.9699182613103536,0.23022758346027042
776,0.0778,27,332,27,301806,374638,14135,112121,2.9672886833101,0.23034191458195946
777,0.0779,29,320,29,302126,374318,14164,112092,2.9647541502978076,0.23044756481157871
778,0.078,29,334,29,302460,373984,14193,112063,2.9621087314662273,0.23056000757128425
779,0.0781,35,355,35,302815,373629,14228,112028,2.9592969839057153,0.23067308820834456
780,0.0782,27,326,27,303141,373303,14255,112001,2.9567149283994425,0.2307852397672387
781,0.0783,31,346,31,303487,372957,14286,111970,2.9539744645799013,0.23090073351246682
782,0.0784,22,371,22,303858,372586,14308,111948,2.9510359903687746,0.23104261001291962
783,0.0785,26,324,26,304182,372262,14334,111922,2.9484697756938285,0.23115592419410802
784,0.0786,35,313,35,304495,371949,14369,111887,2.94599068559118,0.23124984498879786
785,0.0787,36,347,36,304842,371602,14405,111851,2.943242301355975,0.23135858087549357
786,0.0788,31,335,31,305177,371267,14436,111820,2.9405889621087313,0.2314696938646662
787,0.0789,34,357,34,305534,370910,14470,111786,2.9377613737168926,0.23158675439614168
788,0.079,24,330,24,305864,370580,14494,111762,2.935147636547966,0.2317069631091632
789,0.0791,35,315,35,306179,370265,14529,111727,2.932652705613991,0.23180260253282212
790,0.0792,23,296,23,306475,369969,14552,111704,2.9303082625776202,0.23190836937092177
791,0.0793,37,341,37,306816,369628,14589,111667,2.9276074008363957,0.23201362989434754
792,0.0794,28,354,28,307170,369274,14617,111639,2.9248035736915474,0.23213970094382977
793,0.0795,26,345,26,307515,368929,14643,111613,2.9220710302876696,0.23226481764341098
794,0.0796,39,330,39,307845,368599,14682,111574,2.919457293118743,0.2323620861647781
795,0.0797,24,329,24,308174,368270,14706,111550,2.91685147636548,0.23248301446375724
796,0.0798,29,330,29,308504,367940,14735,111521,2.914237739196553,0.23259660326908757
797,0.0799,34,332,34,308836,367608,14769,111487,2.9116081611962996,0.23270332606268068
798,0.08,27,315,27,309151,367293,14796,111460,2.9091132302623244,0.23281316252848547
799,0.0801,36,326,36,309477,366967,14832,111424,2.906531174756051,0.2329140807414855
800,0.0802,27,311,27,309788,366656,14859,111397,2.9040679254847293,0.2330222799564065
801,0.0803,33,354,33,310142,366302,14892,111364,2.901264098339881,0.2331419862414323
802,0.0804,35,346,35,310488,365956,14927,111329,2.89852363452034,0.23325476392511812
803,0.0805,32,331,32,310819,365625,14959,111297,2.8959019769357495,0.23336520437304215
804,0.0806,34,313,34,311132,365312,14993,111263,2.893422886833101,0.2334637779992656
805,0.0807,22,384,22,311516,364928,15015,111241,2.89038144721835,0.23361663611028857
806,0.0808,30,314,30,311830,364614,15045,111211,2.887894436700038,0.23372248200493878
807,0.0809,32,349,32,312179,364265,15077,111179,2.8851302116335065,0.23384247145825796
808,0.081,29,318,29,312497,363947,15106,111150,2.882611519452541,0.23395222449310352
809,0.0811,23,331,23,312828,363616,15129,111127,2.879989861867951,0.23407822758840047
810,0.0812,31,296,31,313124,363320,15160,111096,2.8776454188315803,0.23417422683889244
811,0.0813,33,327,33,313451,362993,15193,111063,2.8750554429096438,0.2342824476433164
812,0.0814,24,323,24,313774,362670,15217,111039,2.872497148650361,0.23440339955542328
813,0.0815,35,323,35,314097,362347,15252,111004,2.8699388543910787,0.23450674024138535
814,0.0816,27,341,27,314438,362006,15279,110977,2.867237992649854,0.23463211151352162
815,0.0817,29,306,29,314744,361700,15308,110948,2.8648143454568498,0.23473705590629812
816,0.0818,23,325,23,315069,361375,15331,110925,2.86224021036624,0.2348613169595596
817,0.0819,32,326,32,315395,361049,15363,110893,2.859658154859967,0.23497167024761517
818,0.082,28,333,28,315728,360716,15391,110865,2.85702065644405,0.23509216868364077
819,0.0821,16,326,16,316054,360390,15407,110849,2.8544386009377773,0.23522883292766517
820,0.0822,38,325,38,316379,360065,15445,110811,2.8518644658471675,0.2353294710284661
821,0.0823,26,311,26,316690,359754,15471,110785,2.849401216575846,0.23544275819857652
822,0.0824,30,330,30,317020,359424,15501,110755,2.8467874794069195,0.23555922318946615
823,0.0825,39,316,39,317336,359108,15540,110716,2.8442846280572804,0.23565420242473778
824,0.0826,36,295,36,317631,358813,15576,110680,2.841948105436573,0.23574366390979204
825,0.0827,31,339,31,317970,358474,15607,110649,2.8392630845266758,0.23586351553856877
826,0.0828,38,354,38,318324,358120,15645,110611,2.8364592573818275,0.23597969837710756
827,0.0829,28,312,28,318636,357808,15673,110583,2.8339880876948422,0.23609121439139522
828,0.083,40,320,40,318956,357488,15713,110543,2.83145355468255,0.23618734656465062
829,0.0831,32,307,32,319263,357181,15745,110511,2.8290219870738817,0.23629012255929116
830,0.0832,29,298,29,319561,356883,15774,110482,2.826661703206184,0.2363933970237395
831,0.0833,35,310,35,319871,356573,15809,110447,2.824206374350526,0.23649308380797396
832,0.0834,20,326,20,320197,356247,15829,110427,2.821624318844253,0.23662556731251366
833,0.0835,28,327,28,320524,355920,15857,110399,2.8190343429223166,0.2367456612319035
834,0.0836,32,324,32,320848,355596,15889,110367,2.8164681282473705,0.23685786210493107
835,0.0837,36,316,36,321164,355280,15925,110331,2.8139652768977315,0.2369596079130433
836,0.0838,31,303,31,321467,354977,15956,110300,2.811565390951717,0.2370630828517206
837,0.0839,28,324,28,321791,354653,15984,110272,2.808999176276771,0.23718234123783405
838,0.084,35,296,35,322087,354357,16019,110237,2.8066547332404004,0.23727598720603366
839,0.0841,21,285,21,322372,354072,16040,110216,2.8043974147763273,0.23738713901716177
840,0.0842,31,346,31,322718,353726,16071,110185,2.801656950956786,0.23751322990832294
841,0.0843,33,291,33,323009,353435,16104,110152,2.7993521099987326,0.23760804336618585
842,0.0844,30,314,30,323323,353121,16134,110122,2.7968650994804207,0.23771972809087238
843,0.0845,26,317,26,323640,352804,16160,110096,2.7943543277151184,0.23783970620004322
844,0.0846,33,336,33,323976,352468,16193,110063,2.7916930680522114,0.23795810442975715
845,0.0847,25,334,25,324310,352134,16218,110038,2.789047649220631,0.2380888500385138
846,0.0848,41,299,41,324609,351835,16259,109997,2.7866794449372705,0.23817535380831126
847,0.0849,31,286,31,324895,351549,16290,109966,2.784414206057534,0.2382717788154231
848,0.085,31,298,31,325193,351251,16321,109935,2.7820539221898364,0.23837453868937913
849,0.0851,26,301,26,325494,350950,16347,109909,2.779669877075149,0.23848725966076392
850,0.0852,25,323,25,325817,350627,16372,109884,2.7771115828158663,0.23861319273589557
851,0.0853,29,312,29,326129,350315,16401,109855,2.774640413128881,0.23872699219853533
852,0.0854,27,318,27,326447,349997,16428,109828,2.7721217209479154,0.2388473875931061
853,0.0855,36,324,36,326771,349673,16464,109792,2.7695555062729693,0.23895617729315616
854,0.0856,41,298,41,327069,349375,16505,109751,2.767195222405272,0.23904331272896764
855,0.0857,29,297,29,327366,349078,16534,109722,2.7648428589532377,0.23914995640802092
856,0.0858,34,302,34,327668,348776,16568,109688,2.7624508934228866,0.23925106442381516
857,0.0859,28,315,28,327983,348461,16596,109660,2.7599559624889114,0.23936907498237364
858,0.086,31,341,31,328324,348120,16627,109629,2.7572551007476873,0.23949588093037888
859,0.0861,34,350,34,328674,347770,16661,109595,2.7544829552654924,0.23962262088266484
860,0.0862,32,314,32,328988,347456,16693,109563,2.7519959447471805,0.23973401543480688
861,0.0863,25,331,25,329319,347125,16718,109538,2.74937428716259,0.23986615950930992
862,0.0864,37,333,37,329652,346792,16755,109501,2.7467367887466736,0.23997957452777052
863,0.0865,34,314,34,329966,346478,16789,109467,2.7442497782283612,0.2400881685290989
864,0.0866,31,324,31,330290,346154,16820,109436,2.741683563553415,0.2402072038455629
865,0.0867,25,275,25,330565,345879,16845,109411,2.7395054492459763,0.2403105712842364
866,0.0868,41,295,41,330860,345584,16886,109370,2.7371689266252694,0.24039793034021023
867,0.0869,31,326,31,331186,345258,16917,109339,2.7345868711189962,0.2405185251992424
868,0.087,28,314,28,331500,344944,16945,109311,2.7320998606006843,0.2406379676613356
869,0.0871,29,316,29,331816,344628,16974,109282,2.7295970092510453,0.24075697825560133
870,0.0872,35,316,35,332132,344312,17009,109247,2.7270941579014067,0.24086612767027002
871,0.0873,31,308,31,332440,344004,17040,109216,2.7246546698770753,0.24097789153170646
872,0.0874,39,309,39,332749,343695,17079,109177,2.72220726143708,0.24107694889505202
873,0.0875,35,316,35,333065,343379,17114,109142,2.7197044100874415,0.24118659686511787
874,0.0876,39,285,39,333350,343094,17153,109103,2.7174470916233684,0.24127316191836742
875,0.0877,28,302,28,333652,342792,17181,109075,2.7150551260930174,0.2413873993896434
876,0.0878,24,339,24,333991,342453,17205,109051,2.71237010518312,0.2415283142563521
877,0.0879,34,316,34,334307,342137,17239,109017,2.7098672538334814,0.24164032680636768
878,0.088,32,307,32,334614,341830,17271,108985,2.7074356862248132,0.24175105087452725
879,0.0881,40,316,40,334930,341514,17311,108945,2.704932834875174,0.24185330962418333
880,0.0882,34,315,34,335245,341199,17345,108911,2.702437903941199,0.24196529737175357
881,0.0883,30,295,30,335540,340904,17375,108881,2.7001013813204917,0.24207343508565204
882,0.0884,34,303,34,335843,340601,17409,108847,2.6977014953744773,0.24217929549135828
883,0.0885,26,281,26,336124,340320,17435,108821,2.695475858573058,0.24228694329842967
884,0.0886,31,299,31,336423,340021,17466,108790,2.693107654289697,0.24239601970539937
885,0.0887,37,319,37,336742,339702,17503,108753,2.690581041693068,0.2425059370505402
886,0.0888,34,312,34,337054,339390,17537,108719,2.6881098720060828,0.24261730962779146
887,0.0889,31,307,31,337361,339083,17568,108688,2.6856783043974146,0.24273121751966964
888,0.089,38,294,38,337655,338789,17606,108650,2.683349702192371,0.24282639644733695
889,0.0891,29,300,29,337955,338489,17635,108621,2.6809735774933467,0.24294021605421484
890,0.0892,36,270,36,338225,338219,17671,108585,2.678835065264225,0.24302602483415547
891,0.0893,37,308,37,338533,337911,17708,108548,2.6763955772398935,0.24313094819457107
892,0.0894,28,287,28,338820,337624,17736,108520,2.674122417944494,0.24323985081050065
893,0.0895,19,280,19,339100,337344,17755,108501,2.671904701558738,0.24336036066345929
894,0.0896,26,284,26,339384,337060,17781,108475,2.669655303510328,0.24347133221856868
895,0.0897,33,292,33,339676,336768,17814,108442,2.6673425421366113,0.24357494216212575
896,0.0898,22,294,22,339970,336474,17836,108420,2.6650139399315678,0.24369849896829357
897,0.0899,26,329,26,340299,336145,17862,108394,2.6624081231783046,0.2438346241837049
898,0.09,32,284,32,340583,335861,17894,108362,2.660158725129895,0.24393604113249426
899,0.0901,31,305,31,340888,335556,17925,108331,2.6577429983525533,0.2440508507795903
900,0.0902,39,287,39,341175,335269,17964,108292,2.6554698390571536,0.24414229384458958
901,0.0903,38,286,38,341461,334983,18002,108254,2.653204600177417,0.24423502550554219
902,0.0904,28,274,28,341735,334709,18030,108226,2.6510344062856417,0.2443383340670753
903,0.0905,34,296,34,342031,334413,18064,108192,2.6486899632492715,0.24444369132748162
904,0.0906,32,311,32,342342,334102,18096,108160,2.6462267139779496,0.24456091637988342
905,0.0907,42,289,42,342631,333813,18138,108118,2.643937713851223,0.2446490515487712
906,0.0908,32,303,32,342934,333510,18170,108086,2.6415378279052084,0.24476218081685522
907,0.0909,27,314,27,343248,333196,18197,108059,2.6390508173868965,0.2448901428878993
908,0.091,37,301,37,343549,332895,18234,108022,2.636666772272209,0.2449939557785252
909,0.0911,29,303,29,343852,332592,18263,107993,2.6342668863261944,0.24511274782391593
910,0.0912,27,285,27,344137,332307,18290,107966,2.6320095678621214,0.24522512168586308
911,0.0913,28,284,28,344421,332023,18318,107938,2.6297601698137116,0.24533538199976815
912,0.0914,33,301,33,344722,331722,18351,107905,2.6273761246990244,0.24544670823220593
913,0.0915,35,307,35,345029,331415,18386,107870,2.6249445570903562,0.24555812285873635
914,0.0916,32,282,32,345311,331133,18418,107838,2.622710999873273,0.24566087509197645
915,0.0917,27,287,27,345598,330846,18445,107811,2.6204378405778734,0.24577517285715264
916,0.0918,35,301,35,345899,330545,18480,107776,2.6180537954631857,0.24588372448502352
917,0.0919,29,259,29,346158,330286,18509,107747,2.6160024078063615,0.24597918421671428
918,0.092,29,308,29,346466,329978,18538,107718,2.61356291978203,0.24610231759029097
919,0.0921,31,275,31,346741,329703,18569,107687,2.611384805474591,0.24620361690939435
920,0.0922,39,271,39,347012,329432,18608,107648,2.609238372829806,0.24628900887709343
921,0.0923,29,274,29,347286,329158,18637,107619,2.6070681789380306,0.24639346852054939
922,0.0924,28,311,28,347597,328847,18665,107591,2.604604929666709,0.24652069709786958
923,0.0925,27,330,27,347927,328517,18692,107564,2.601991192497782,0.24666059745781174
924,0.0926,28,274,28,348201,328243,18720,107536,2.599820998606007,0.24676728341659418
925,0.0927,29,292,29,348493,327951,18749,107507,2.5975082372322897,0.24688259258068515
926,0.0928,37,285,37,348778,327666,18786,107470,2.595250918768217,0.2469802544491837
927,0.0929,29,272,29,349050,327394,18815,107441,2.5930965657077683,0.24708452631457908
928,0.093,37,314,37,349364,327080,18852,107404,2.5906095551894563,0.24719897625689324
929,0.0931,35,273,35,349637,326807,18887,107369,2.588447281713344,0.24729372420400944
930,0.0932,28,308,28,349945,326499,18915,107341,2.5860077936890127,0.2474207080951503
931,0.0933,22,262,22,350207,326237,18937,107319,2.5839326447851985,0.24753203738386736
932,0.0934,31,269,31,350476,325968,18968,107288,2.58180205297174,0.2476318850748749
933,0.0935,36,286,36,350762,325682,19004,107252,2.5795368140920036,0.24773291079009735
934,0.0936,32,297,32,351059,325385,19036,107220,2.5771844506399697,0.24784734341951664
935,0.0937,40,295,40,351354,325090,19076,107180,2.5748479280192624,0.2479468850486964
936,0.0938,31,277,31,351631,324813,19107,107149,2.572653972880497,0.24805191197373844
937,0.0939,34,295,34,351926,324518,19141,107115,2.5703174502597896,0.2481622118790732
938,0.094,32,273,32,352199,324245,19173,107083,2.5681551767836774,0.24826350248534756
939,0.0941,36,312,36,352511,323933,19209,107047,2.5656840070966926,0.24838043528702028
940,0.0942,39,265,39,352776,323668,19248,107008,2.5635850969458875,0.24846520354048054
941,0.0943,39,268,39,353044,323400,19287,106969,2.561462425548093,0.24855182413231436
942,0.0944,26,287,26,353331,323113,19313,106943,2.559189266252693,0.2486722659374593
943,0.0945,31,284,31,353615,322829,19344,106912,2.5569398682042834,0.2487824061469583
944,0.0946,37,258,37,353873,322571,19381,106875,2.5548964009631225,0.24886714511254035
945,0.0947,37,275,37,354148,322296,19418,106838,2.5527182866556837,0.24896186272819212
946,0.0948,31,301,31,354449,321995,19449,106807,2.550334241540996,0.24908232704138505
947,0.0949,43,309,43,354758,321686,19492,106764,2.547886833101001,0.2491866028708134
948,0.095,39,290,39,355048,321396,19531,106725,2.545589912558611,0.2492870006376702
949,0.0951,36,273,36,355321,321123,19567,106689,2.5434276390824992,0.24938290651033632
950,0.0952,42,263,42,355584,320860,19609,106647,2.5413445697630213,0.24946258189924375
951,0.0953,26,299,26,355883,320561,19635,106621,2.53897636547966,0.24959150900552926
952,0.0954,33,252,33,356135,320309,19668,106588,2.53698042073248,0.24968083636099575
953,0.0955,31,288,31,356423,320021,19699,106557,2.5346993410214167,0.2497948792483438
954,0.0956,39,299,39,356722,319722,19738,106518,2.532331136738056,0.24990146396396395
955,0.0957,34,301,34,357023,319421,19772,106484,2.5299470916233684,0.25001819654617813
956,0.0958,32,282,32,357305,319139,19804,106452,2.5277135344062858,0.2501274698008182
957,0.0959,44,269,44,357574,318870,19848,106408,2.5255829425928273,0.2502080991727764
958,0.096,34,262,34,357836,318608,19882,106374,2.5235077936890127,0.2503023657472552
959,0.0961,29,253,29,358089,318355,19911,106345,2.521503928526169,0.25040028255238994
960,0.0962,34,267,34,358356,318088,19945,106311,2.5193891775440376,0.25049776271857377
961,0.0963,32,277,32,358633,317811,19977,106279,2.517195222405272,0.2506048244476408
962,0.0964,36,266,36,358899,317545,20013,106243,2.5150883918388036,0.25069846243876653
963,0.0965,37,270,37,359169,317275,20050,106206,2.512949879609682,0.2507928336808499
964,0.0966,33,292,33,359461,316983,20083,106173,2.510637118235965,0.2509074667498511
965,0.0967,35,296,35,359757,316687,20118,106138,2.5082926751995944,0.25102110802341393
966,0.0968,39,273,39,360030,316414,20157,106099,2.5061304017234827,0.25111416690137345
967,0.0969,36,262,36,360292,316152,20193,106063,2.504055252819668,0.25120613905237854
968,0.097,32,300,32,360592,315852,20225,106031,2.5016791281206436,0.2513279748176627
969,0.0971,45,296,45,360888,315556,20270,105986,2.499334685084273,0.25142453183787145
970,0.0972,28,331,28,361219,315225,20298,105958,2.496713027499683,0.25157235690899205
971,0.0973,37,274,37,361493,314951,20335,105921,2.4945428336079076,0.25167034157653634
972,0.0974,26,302,26,361795,314649,20361,105895,2.4921508680775566,0.2518048052046873
973,0.0975,25,291,25,362086,314358,20386,105870,2.489846027119503,0.2519346640395214
974,0.0976,43,253,43,362339,314105,20429,105827,2.4878421619566593,0.2520098492136822
975,0.0977,37,282,37,362621,313823,20466,105790,2.4856086047395767,0.2521132567389476
976,0.0978,34,261,34,362882,313562,20500,105756,2.483541376251426,0.2522095402534592
977,0.0979,25,253,25,363135,313309,20525,105731,2.481537511088582,0.25231720122184037
978,0.098,31,270,31,363405,313039,20556,105700,2.4793989988594602,0.2524245413013834
979,0.0981,38,273,38,363678,312766,20594,105662,2.477236725383348,0.25252134178401064
980,0.0982,50,283,50,363961,312483,20644,105612,2.474995247750602,0.2526028773364905
981,0.0983,39,257,39,364218,312226,20683,105573,2.4729597009251045,0.2526884937493867
982,0.0984,32,297,32,364515,311929,20715,105541,2.4706073374730706,0.2528109804297315
983,0.0985,36,259,36,364774,311670,20751,105505,2.4685559498162464,0.2529034577815066
984,0.0986,38,284,38,365058,311386,20789,105467,2.4663065517678366,0.2530076549766944
985,0.0987,39,253,39,365311,311133,20828,105428,2.464302686604993,0.25309138397497605
986,0.0988,37,281,37,365592,310852,20865,105391,2.4620770498035736,0.25319584953981206
987,0.0989,28,294,28,365886,310558,20893,105363,2.45974844759853,0.2533245496139892
988,0.099,30,279,30,366165,310279,20923,105333,2.4575386516284374,0.253440709122932
989,0.0991,30,257,30,366422,310022,20953,105303,2.45550310480294,0.25354361042557033
990,0.0992,28,270,28,366692,309752,20981,105275,2.453364592573818,0.25365819573184395
991,0.0993,38,258,38,366950,309494,21019,105237,2.4513211253326577,0.25374760989653533
992,0.0994,30,263,30,367213,309231,21049,105207,2.4492380560131797,0.2538546175785039
993,0.0995,24,268,24,367481,308963,21073,105183,2.4471153846153846,0.2539756510988878
994,0.0996,31,265,31,367746,308698,21104,105152,2.44501647446458,0.2540823970037453
995,0.0997,29,274,29,368020,308424,21133,105123,2.4428462805728044,0.25419843451893015
996,0.0998,25,254,25,368274,308170,21158,105098,2.4408344949942973,0.25430955215501805
997,0.0999,32,252,32,368526,307918,21190,105066,2.438838550247117,0.2544069503903299
998,0.1,42,309,42,368835,307609,21232,105024,2.436391141807122,0.25452157243846224
999,0.1001,34,256,34,369091,307353,21266,104990,2.4343635153972882,0.25461812132132716
1000,0.1002,31,258,31,369349,307095,21297,104959,2.4323200481561273,0.25472146854538485
1001,0.1003,36,268,36,369617,306827,21333,104923,2.4301973767583323,0.2548221007893139
1002,0.1004,27,264,27,369881,306563,21360,104896,2.428106387023191,0.2549367008620543
1003,0.1005,32,275,32,370156,306288,21392,104864,2.425928272715752,0.2550492275362883
1004,0.1006,32,281,32,370437,306007,21424,104832,2.4237026359143328,0.2551656488308072
1005,0.1007,34,306,34,370743,305701,21458,104798,2.421278988721328,0.25529416636824936
1006,0.1008,24,243,24,370986,305458,21482,104774,2.4193543277151184,0.2554018214083738
1007,0.1009,31,271,31,371257,305187,21513,104743,2.4172078950703333,0.2555143561095797
1008,0.101,34,269,34,371526,304918,21547,104709,2.415077303256875,0.2556203570565417
1009,0.1011,33,295,33,371821,304623,21580,104676,2.4127407806361676,0.2557445779246956
1010,0.1012,28,267,28,372088,304356,21608,104648,2.4106260296540363,0.2558605783806515
1011,0.1013,23,287,23,372375,304069,21631,104625,2.4083528703586365,0.2559983753125811
1012,0.1014,40,274,40,372649,303795,21671,104585,2.406182676466861,0.2560972623536902
1013,0.1015,34,267,34,372916,303528,21705,104551,2.4040679254847293,0.25620284307695324
1014,0.1016,38,283,38,373199,303245,21743,104513,2.4018264478519833,0.25631134153100615
1015,0.1017,30,310,30,373509,302935,21773,104483,2.3993711189963247,0.2564516049855431
1016,0.1018,37,253,37,373762,302682,21810,104446,2.3973672538334814,0.25654339667131715
1017,0.1019,24,266,24,374028,302416,21834,104422,2.395260423267013,0.25666727296860176
1018,0.102,36,249,36,374277,302167,21870,104386,2.393288239766823,0.25675865139354526
1019,0.1021,33,290,33,374567,301877,21903,104353,2.3909913192244328,0.25688156955419345
1020,0.1022,31,258,31,374825,301619,21934,104322,2.388947851983272,0.25698808447533017
1021,0.1023,31,262,31,375087,301357,21965,104291,2.3868727030794576,0.25709728631720113
1022,0.1024,29,263,29,375350,301094,21994,104262,2.3847896337599797,0.257210945440551
1023,0.1025,34,292,34,375642,300802,22028,104228,2.382476872386263,0.2573340246401501
1024,0.1026,35,267,35,375909,300535,22063,104193,2.3803621214041315,0.2574395643493902
1025,0.1027,43,306,43,376215,300229,22106,104150,2.3779384742111267,0.25755541212575334
1026,0.1028,23,280,23,376495,299949,22129,104127,2.3757207578253707,0.25769162236806936
1027,0.1029,35,276,35,376771,299673,22164,104092,2.3735347231022685,0.25780342525974265
1028,0.103,28,285,28,377056,299388,22192,104064,2.3712774046381955,0.2579340293269088
1029,0.1031,30,271,30,377327,299117,22222,104034,2.3691309719934104,0.25805219384300176
1030,0.1032,36,262,36,377589,298855,22258,103998,2.3670558230895957,0.2581537186020707
1031,0.1033,33,258,33,377847,298597,22291,103965,2.365012355848435,0.2582583552347216
1032,0.1034,28,256,28,378103,298341,22319,103937,2.362984729438601,0.25837107671809045
1033,0.1035,39,271,39,378374,298070,22358,103898,2.360838296793816,0.2584733113083629
1034,0.1036,29,246,29,378620,297824,22387,103869,2.358889874540616,0.258578068325811
1035,0.1037,30,257,30,378877,297567,22417,103839,2.3568543277151184,0.258688210938551
1036,0.1038,41,239,41,379116,297328,22458,103798,2.3549613483715626,0.2587665720995398
1037,0.1039,34,278,34,379394,297050,22492,103764,2.3527594728171333,0.25888317274346706
1038,0.104,46,259,46,379653,296791,22538,103718,2.350708085160309,0.2589654664439501
1039,0.1041,38,269,38,379922,296522,22576,103680,2.348577493346851,0.2590691700691151
1040,0.1042,38,248,38,380170,296274,22614,103642,2.3466132302623244,0.25915942347893056
1041,0.1043,35,262,35,380432,296012,22649,103607,2.3445380813585097,0.2592644493880421
1042,0.1044,35,251,35,380683,295761,22684,103572,2.3425500570269926,0.2593624869469841
1043,0.1045,27,273,27,380956,295488,22711,103545,2.340387783550881,0.25948981663170717
1044,0.1046,32,265,32,381221,295223,22743,103513,2.338288873400076,0.25960284499016895
1045,0.1047,36,254,36,381475,294969,22779,103477,2.336277087821569,0.2597014400947682
1046,0.1048,23,228,23,381703,294741,22802,103454,2.3344712330503103,0.25980738080588656
1047,0.1049,29,246,29,381949,294495,22831,103425,2.3325228107971108,0.2599140530759952
1048,0.105,36,244,36,382193,294251,22867,103389,2.3305902293752374,0.26000653857760786
1049,0.1051,26,281,26,382474,293970,22893,103363,2.328364592573818,0.2601419967634201
1050,0.1052,32,264,32,382738,293706,22925,103331,2.326273602838677,0.2602553414417296
1051,0.1053,31,259,31,382997,293447,22956,103300,2.3242222151818526,0.26036743819108904
1052,0.1054,29,240,29,383237,293207,22985,103271,2.3223213154226334,0.2604709466855664
1053,0.1055,35,280,35,383517,292927,23020,103236,2.3201035990368775,0.26058970676211557
1054,0.1056,39,262,39,383779,292665,23059,103197,2.318028450133063,0.2606893311305455
1055,0.1057,37,273,37,384052,292392,23096,103160,2.315866176656951,0.2608000970795243
1056,0.1058,39,289,39,384341,292103,23135,103121,2.313577176530224,0.26091785923931743
1057,0.1059,20,270,20,384611,291833,23155,103101,2.3114386643011025,0.261058809826452
1058,0.106,29,249,29,384860,291584,23184,103072,2.3094664808009124,0.2611692207897511
1059,0.1061,27,262,27,385122,291322,23211,103045,2.3073913318970978,0.2612921466552729
1060,0.1062,27,258,27,385380,291064,23238,103018,2.3053478646559373,0.26141259940824496
1061,0.1063,29,239,29,385619,290825,23267,102989,2.303454885312381,0.2615168582122525
1062,0.1064,26,275,26,385894,290550,23293,102963,2.301276771004942,0.26165082220917735
1063,0.1065,42,236,42,386130,290314,23335,102921,2.299407552908377,0.2617289915699264
1064,0.1066,24,252,24,386382,290062,23359,102897,2.2974116081611964,0.261851745347479
1065,0.1067,22,246,22,386628,289816,23381,102875,2.2954631859079964,0.2619744277307094
1066,0.1068,37,229,37,386857,289587,23418,102838,2.2936494107210748,0.2620577180352934
1067,0.1069,38,252,38,387109,289335,23456,102800,2.2916534659738943,0.26215461511979293
1068,0.107,30,289,30,387398,289046,23486,102770,2.2893644658471675,0.2622914837576822
1069,0.1071,40,243,40,387641,288803,23526,102730,2.287439804840958,0.2623789054817857
1070,0.1072,23,269,23,387910,288534,23549,102707,2.2853092130275,0.26251594285874946
1071,0.1073,36,272,36,388182,288262,23585,102671,2.283154859967051,0.2626306809606761
1072,0.1074,37,243,37,388425,288019,23622,102634,2.2812301989608414,0.26272420792877565
1073,0.1075,26,227,26,388652,287792,23648,102608,2.2794322646052465,0.262827868852459
1074,0.1076,41,251,41,388903,287541,23689,102567,2.2774442402737294,0.2629194992156018
1075,0.1077,34,233,34,389136,287308,23723,102533,2.275598783424154,0.26301235631962777
1076,0.1078,35,300,35,389436,287008,23758,102498,2.27322265872513,0.263148706310044
1077,0.1079,37,241,37,389677,286767,23795,102461,2.271313838550247,0.2632415961852693
1078,0.108,29,243,29,389920,286524,23824,102432,2.2693891775440376,0.26335112454879217
1079,0.1081,38,254,38,390174,286270,23862,102394,2.2673773919655305,0.2634512072123994
1080,0.1082,30,258,30,390432,286012,23892,102364,2.2653339247243696,0.26356932457206417
1081,0.1083,37,239,37,390671,285773,23929,102327,2.2634409453808138,0.26366142746714766
1082,0.1084,35,249,35,390920,285524,23964,102292,2.2614687618806233,0.26376425933948056
1083,0.1085,45,241,45,391161,285283,24009,102247,2.259559941705741,0.26384279926715354
1084,0.1086,32,255,32,391416,285028,24041,102215,2.2575402357115704,0.263955707398197
1085,0.1087,46,261,46,391677,284767,24087,102169,2.255473007223419,0.2640462505427254
1086,0.1088,40,266,40,391943,284501,24127,102129,2.253366176656951,0.2641517730129581
1087,0.1089,26,243,26,392186,284258,24153,102103,2.2514415156507415,0.26426839147843595
1088,0.109,36,246,36,392432,284012,24189,102067,2.2494930933975414,0.264368173353122
1089,0.1091,33,275,33,392707,283737,24222,102034,2.2473149790901026,0.2644937022223029
1090,0.1092,33,255,33,392962,283482,24255,102001,2.245295273095932,0.26460570245639886
1091,0.1093,34,246,34,393208,283236,24289,101967,2.243346850842732,0.26470977640361054
1092,0.1094,39,257,39,393465,282979,24328,101928,2.241311304017235,0.2648120195267948
1093,0.1095,35,240,35,393705,282739,24363,101893,2.2394104042580154,0.2649103558726263
1094,0.1096,39,261,39,393966,282478,24402,101854,2.2373431757698645,0.26501566354089695
1095,0.1097,27,262,27,394228,282216,24429,101827,2.23526802686605,0.2651447884742073
1096,0.1098,43,228,43,394456,281988,24472,101784,2.2334621720947916,0.2652199743597761
1097,0.1099,34,247,34,394703,281741,24506,101750,2.2315058294259282,0.26532565301402117
1098,0.11,31,247,31,394950,281494,24537,101719,2.229549486757065,0.26543723725447727
1099,0.1101,27,264,27,395214,281230,24564,101692,2.2274584970219236,0.26556844474853886
1100,0.1102,34,267,34,395481,280963,24598,101658,2.2253437460397922,0.26568850115388337
1101,0.1103,35,272,35,395753,280691,24633,101623,2.2231893929793434,0.26581030252619575
1102,0.1104,26,243,26,395996,280448,24659,101597,2.221264731973134,0.26592940622178013
1103,0.1105,50,245,50,396241,280203,24709,101547,2.2193242301355975,0.26600392927308447
1104,0.1106,30,251,30,396492,279952,24739,101517,2.2173362058040804,0.2661212313451421
1105,0.1107,27,222,27,396714,279730,24766,101490,2.2155778735268026,0.26622422748019514
1106,0.1108,37,237,37,396951,279493,24803,101453,2.2137007350145734,0.26631858583631274
1107,0.1109,32,254,32,397205,279239,24835,101421,2.2116889494360663,0.26643461356591186
1108,0.111,41,217,41,397422,279022,24876,101380,2.2099702192371056,0.2665075367637394
1109,0.1111,28,262,28,397684,278760,24904,101352,2.207895070333291,0.26663720166687715
1110,0.1112,31,266,31,397950,278494,24935,101321,2.205788239766823,0.2667640825138554
1111,0.1113,41,264,41,398214,278230,24976,101280,2.2036972500316816,0.266870438196622
1112,0.1114,29,265,29,398479,277965,25005,101251,2.201598339880877,0.2670008649424075
1113,0.1115,38,238,38,398717,277727,25043,101213,2.1997132809529845,0.2670950546260622
1114,0.1116,35,248,35,398965,277479,25078,101178,2.1977490178684578,0.2672022437192499
1115,0.1117,43,268,43,399233,277211,25121,101135,2.1956263464706627,0.2673082310900604
1116,0.1118,37,239,37,399472,276972,25158,101098,2.193733367127107,0.26740550691670856
1117,0.1119,41,269,41,399741,276703,25199,101057,2.1916027753136484,0.26751641253706054
1118,0.112,34,263,34,400004,276440,25233,101023,2.1895197059941705,0.2676368279804908
1119,0.1121,30,250,30,400254,276190,25263,100993,2.187539602078317,0.2677559699138084
1120,0.1122,32,249,32,400503,275941,25295,100961,2.185567418578127,0.26787069317753687
1121,0.1123,23,276,23,400779,275665,25318,100938,2.183381383855025,0.2680222940337703
1122,0.1124,43,253,43,401032,275412,25361,100895,2.181377518692181,0.2681188497689387
1123,0.1125,43,255,43,401287,275157,25404,100852,2.17935781269801,0.26821698416793216
1124,0.1126,32,208,32,401495,274949,25436,100820,2.1777103662400203,0.2683031330418422
1125,0.1127,54,258,54,401753,274691,25490,100766,2.1756668989988595,0.26838226481328087
1126,0.1128,34,246,34,401999,274445,25524,100732,2.1737184767456594,0.26849193847170805
1127,0.1129,35,237,35,402236,274208,25559,100697,2.1718413382334303,0.2685933769888372
1128,0.113,31,231,31,402467,273977,25590,100666,2.170011722215182,0.26869846760782934
1129,0.1131,34,269,34,402736,273708,25624,100632,2.1678811304017236,0.2688251322327296
1130,0.1132,28,243,28,402979,273465,25652,100604,2.165956469395514,0.2689450342049194
1131,0.1133,32,245,32,403224,273220,25684,100572,2.1640159675579773,0.2690587278486431
1132,0.1134,26,242,26,403466,272978,25710,100546,2.162099226967431,0.26918216767864983
1133,0.1135,43,258,43,403724,272720,25753,100503,2.1600557597262706,0.26928404733899036
1134,0.1136,32,227,32,403951,272493,25785,100471,2.1582578253706752,0.2693852489784537
1135,0.1137,21,268,21,404219,272225,25806,100450,2.1561351539728806,0.26953780103307173
1136,0.1138,32,249,32,404468,271976,25838,100418,2.1541629704726906,0.26965525760350595
1137,0.1139,34,258,34,404726,271718,25872,100384,2.1521195032315297,0.2697754916662636
1138,0.114,23,249,23,404975,271469,25895,100361,2.1501473197313397,0.2699109808245704
1139,0.1141,40,237,40,405212,271232,25935,100321,2.1482701812191105,0.27000454847626043
1140,0.1142,33,221,33,405433,271011,25968,100288,2.146519769357496,0.2701003773239357
1141,0.1143,42,215,42,405648,270796,26010,100246,2.144816879989862,0.27017426598606087
1142,0.1144,37,219,37,405867,270577,26047,100209,2.143082308959574,0.27026101309110917
1143,0.1145,25,243,25,406110,270334,26072,100184,2.1411576479533645,0.2703890229354579
1144,0.1146,29,248,29,406358,270086,26101,100155,2.139193384868838,0.2705129901874725
1145,0.1147,30,234,30,406592,269852,26131,100125,2.137340007603599,0.27062493073893784
1146,0.1148,33,225,33,406817,269627,26164,100092,2.135557914079331,0.2707245232189852
1147,0.1149,40,265,40,407082,269362,26204,100052,2.133459003928526,0.27083976243455854
1148,0.115,26,253,26,407335,269109,26230,100026,2.1314551387656824,0.2709740338900402
1149,0.1151,41,226,41,407561,268883,26271,99985,2.1296651248257508,0.27105902382424063
1150,0.1152,37,241,37,407802,268642,26308,99948,2.1277563046508683,0.27116308093003066
1151,0.1153,28,228,28,408030,268414,26336,99920,2.1259504498796096,0.27127552710311836
1152,0.1154,31,244,31,408274,268170,26367,99889,2.1240178684577367,0.2713939884638061
1153,0.1155,31,272,31,408546,267898,26398,99858,2.1218635153972882,0.2715332992527654
1154,0.1156,31,204,31,408750,267694,26429,99827,2.1202477506019517,0.27162257394815537
1155,0.1157,42,228,42,408978,267466,26471,99785,2.118441895830693,0.2717079054924289
1156,0.1158,27,219,27,409197,267247,26498,99758,2.1167073248004056,0.2718164602662089
1157,0.1159,22,225,22,409422,267022,26520,99736,2.1149252312761373,0.27193953506126656
1158,0.116,32,251,32,409673,266771,26552,99704,2.1129372069446206,0.2720622143393137
1159,0.1161,27,215,27,409888,266556,26579,99677,2.1112343175769865,0.27216826446551784
1160,0.1162,28,235,28,410123,266321,26607,99649,2.109373019896084,0.2722873459573189
1161,0.1163,32,241,32,410364,266080,26639,99617,2.1074641997212016,0.2724031096782309
1162,0.1164,27,248,27,410612,265832,26666,99590,2.105499936636675,0.27253422070920746
1163,0.1165,29,223,29,410835,265609,26695,99561,2.1037336839437333,0.2726428786592546
1164,0.1166,33,224,33,411059,265385,26728,99528,2.1019595108351288,0.272744462378704
1165,0.1167,47,209,47,411268,265176,26775,99481,2.100304143961475,0.2728070488157364
1166,0.1168,32,197,32,411465,264979,26807,99449,2.0987438220757824,0.27289066701790204
1167,0.1169,32,248,32,411713,264731,26839,99417,2.0967795589912557,0.2730126212419126
1168,0.117,39,201,39,411914,264530,26878,99378,2.0951875554429096,0.2730855051276696
1169,0.1171,37,200,37,412114,264330,26915,99341,2.093603472310227,0.27316173134508936
1170,0.1172,30,224,30,412338,264106,26945,99311,2.0918292992016223,0.27327010018793835
1171,0.1173,38,226,38,412564,263880,26983,99273,2.0900392852616907,0.2733641192555204
1172,0.1174,30,230,30,412794,263650,27013,99243,2.0882175896591053,0.27347730598275527
1173,0.1175,38,233,38,413027,263417,27051,99205,2.08637213280953,0.2735768927423047
1174,0.1176,30,232,30,413259,263185,27081,99175,2.084534596375618,0.27369190859918313
1175,0.1177,41,226,41,413485,262959,27122,99134,2.0827445824356863,0.2737804928568075
1176,0.1178,30,232,30,413717,262727,27152,99104,2.0809070460017742,0.27389582429366194
1177,0.1179,32,230,32,413947,262497,27184,99072,2.079085350399189,0.27400579142570297
1178,0.118,35,241,35,414188,262256,27219,99037,2.0771765302243064,0.27411823644521205
1179,0.1181,29,217,29,414405,262039,27248,99008,2.075457800025345,0.2742246854287669
1180,0.1182,34,218,34,414623,261821,27282,98974,2.073731149410721,0.27432198339777436
1181,0.1183,24,219,24,414842,261602,27306,98950,2.0719965783804333,0.27444030264705227
1182,0.1184,39,235,39,415077,261367,27345,98911,2.0701352806995312,0.2745407712932791
1183,0.1185,47,209,47,415286,261158,27392,98864,2.0684799138258776,0.2746054407786191
1184,0.1186,22,219,22,415505,260939,27414,98842,2.0667453427955897,0.27472823745556324
1185,0.1187,35,237,35,415742,260702,27449,98807,2.0648682042833606,0.27483873839041584
1186,0.1188,29,248,29,415990,260454,27478,98778,2.062903941198834,0.27496993586317475
1187,0.1189,38,243,38,416233,260211,27516,98740,2.0609792801926243,0.2750793283762965
1188,0.119,29,220,29,416453,259991,27545,98711,2.0592367887466736,0.2751894330112461
1189,0.1191,34,236,34,416689,259755,27579,98677,2.057367570650108,0.27530187036871706
1190,0.1192,35,234,35,416923,259521,27614,98642,2.0555141933848686,0.2754109162587984
1191,0.1193,41,221,41,417144,259300,27655,98601,2.0537637815232546,0.2754979729031213
1192,0.1194,50,220,50,417364,259080,27705,98551,2.0520212900773034,0.2755661561777363
1193,0.1195,31,196,31,417560,258884,27736,98520,2.050468888607274,0.2756544414723954
1194,0.1196,23,263,23,417823,258621,27759,98497,2.0483858192877964,0.27581079643143164
1195,0.1197,30,216,30,418039,258405,27789,98467,2.046675009504499,0.2759168553430922
1196,0.1198,33,260,33,418299,258145,27822,98434,2.044615701432011,0.27605102936516174
1197,0.1199,31,220,31,418519,257925,27853,98403,2.0428732099860603,0.2761584831952583
1198,0.12,41,224,41,418743,257701,27894,98362,2.0410990368774553,0.27624886607145366
1199,0.1201,43,224,43,418967,257477,27937,98319,2.039324863768851,0.27633531574272896
1200,0.1202,42,221,42,419188,257256,27979,98277,2.0375744519072363,0.27642159799512284
1201,0.1203,28,244,28,419432,257012,28007,98249,2.035641870485363,0.2765544205527767
1202,0.1204,25,212,25,419644,256800,28032,98224,2.0339627423647193,0.2766686195862815
1203,0.1205,38,223,38,419867,256577,28070,98186,2.032196489671778,0.27676505159782727
1204,0.1206,42,224,42,420091,256353,28112,98144,2.030422316563173,0.27685424700350075
1205,0.1207,42,261,42,420352,256092,28154,98102,2.0283550880750223,0.2769725065924324
1206,0.1208,37,222,37,420574,255870,28191,98065,2.0265967557977445,0.2770706485654146
1207,0.1209,37,236,37,420810,255634,28228,98028,2.0247275377011786,0.2771799062381596
1208,0.121,29,218,29,421028,255416,28257,97999,2.023000887086554,0.2772915694014119
1209,0.1211,36,204,36,421232,255212,28293,97963,2.021385122291218,0.2773780703617187
1210,0.1212,39,218,39,421450,254994,28332,97924,2.0196584716765935,0.2774695538340351
1211,0.1213,22,231,22,421681,254763,28354,97902,2.017828855658345,0.27760622687252773
1212,0.1214,32,212,32,421893,254551,28386,97870,2.016149727537701,0.2777076280925371
1213,0.1215,27,219,27,422112,254332,28413,97843,2.0144151565074133,0.2778249449847377
1214,0.1216,34,235,34,422347,254097,28447,97809,2.0125538588265113,0.277940700073315
1215,0.1217,39,188,39,422535,253909,28486,97770,2.0110648206817894,0.27800920726002976
1216,0.1218,39,214,39,422749,253695,28525,97731,2.0093698517298186,0.2780983763295829
1217,0.1219,32,210,32,422959,253485,28557,97699,2.0077065644405017,0.27819889288805866
1218,0.122,40,212,40,423171,253273,28597,97659,2.006027436319858,0.27828468193268213
1219,0.1221,30,208,30,423379,253065,28627,97629,2.004379989861868,0.2783879963729063
1220,0.1222,27,243,27,423622,252822,28654,97602,2.002455328855658,0.2785254434627765
1221,0.1223,35,220,35,423842,252602,28689,97567,2.0007128374097074,0.27862831946859945
1222,0.1224,43,213,43,424055,252389,28732,97524,1.9990257888734,0.2787092791636778
1223,0.1225,38,215,38,424270,252174,28770,97486,1.9973228995057661,0.2788022650574844
1224,0.1226,30,227,30,424497,251947,28800,97456,1.995524965150171,0.27892147462958244
1225,0.1227,33,235,33,424732,251712,28833,97423,1.9936636674692687,0.2790410586162946
1226,0.1228,27,186,27,424918,251526,28860,97396,1.9921904701558737,0.27913401849123876
1227,0.1229,27,225,27,425143,251301,28887,97369,1.9904083766316056,0.27925832449020566
1228,0.123,31,232,31,425375,251069,28918,97338,1.9885708401976936,0.2793801502266028
1229,0.1231,30,202,30,425577,250867,28948,97308,1.986970916233684,0.2794801464780642
1230,0.1232,33,234,33,425811,250633,28981,97275,1.985117538968445,0.27959977925198615
1231,0.1233,37,206,37,426017,250427,29018,97238,1.9834859333417818,0.27968878086663884
1232,0.1234,37,218,37,426235,250209,29055,97201,1.9817592827271575,0.27978757088166717
1233,0.1235,42,227,42,426462,249982,29097,97159,1.9799613483715626,0.2798833903226643
1234,0.1236,27,197,27,426659,249785,29124,97132,1.97840102648587,0.2799862791388142
1235,0.1237,29,247,29,426906,249538,29153,97103,1.9764446838170067,0.28012554775690124
1236,0.1238,26,215,26,427121,249323,29179,97077,1.9747417944493728,0.28024538106235564
1237,0.1239,33,205,33,427326,249118,29212,97044,1.9731181092383727,0.2803427297045892
1238,0.124,23,204,23,427530,248914,29235,97021,1.9715023444430364,0.28046020206108085
1239,0.1241,31,223,31,427753,248691,29266,96990,1.969736091750095,0.2805766009702587
1240,0.1242,26,216,26,427969,248475,29292,96964,1.9680252819667976,0.2806978945631501
1241,0.1243,21,215,21,428184,248260,29313,96943,1.9663223925991635,0.2808289615096045
1242,0.1244,37,206,37,428390,248054,29350,96906,1.9646907869725003,0.28091952690166977
1243,0.1245,24,225,24,428615,247829,29374,96882,1.9629086934482323,0.2810528239597808
1244,0.1246,26,214,26,428829,247615,29400,96856,1.9612137244962615,0.2811731611659617
1245,0.1247,37,234,37,429063,247381,29437,96819,1.9593603472310226,0.2812870424171993
1246,0.1248,31,199,31,429262,247182,29468,96788,1.9577841845140034,0.28138500450620696
1247,0.1249,24,198,24,429460,246984,29492,96764,1.9562159422126473,0.28149691052747944
1248,0.125,33,211,33,429671,246773,29525,96731,1.954544734507667,0.28160079649727515
1249,0.1251,39,202,39,429873,246571,29564,96692,1.9529448105436573,0.28168488884616166
1250,0.1252,33,190,33,430063,246381,29597,96659,1.9514399315676088,0.2817718050373134
1251,0.1253,27,204,27,430267,246177,29624,96632,1.9498241667722722,0.28188291439256263
1252,0.1254,37,215,37,430482,245962,29661,96595,1.9481212774046381,0.2819822686443424
1253,0.1255,35,199,35,430681,245763,29696,96560,1.9465451146876187,0.28207277921728896
1254,0.1256,47,199,47,430880,245564,29743,96513,1.9449689519705995,0.2821382320354774
1255,0.1257,38,230,38,431110,245334,29781,96475,1.943147256368014,0.28224827315840134
1256,0.1258,28,210,28,431320,245124,29809,96447,1.9414839690786974,0.2823629640689637
1257,0.1259,32,199,32,431519,244925,29841,96415,1.939907806361678,0.2824603035096971
1258,0.126,34,221,34,431740,244704,29875,96381,1.9381573945000634,0.2825717929548353
1259,0.1261,24,203,24,431943,244501,29899,96357,1.9365495501203904,0.2826895657429193
1260,0.1262,30,212,30,432155,244289,29929,96327,1.9348704219997466,0.2828023345937948
1261,0.1263,34,219,34,432374,244070,29963,96293,1.933135850969459,0.2829126550183187
1262,0.1264,29,226,29,432600,243844,29992,96264,1.9313458370295273,0.2830395050983805
1263,0.1265,24,239,24,432839,243605,30016,96240,1.9294528576859713,0.2831879239064868
1264,0.1266,23,198,23,433037,243407,30039,96217,1.9278846153846154,0.2833044778931995
1265,0.1267,36,228,36,433265,243179,30075,96181,1.926078760613357,0.2834187883074022
1266,0.1268,34,237,34,433502,242942,30109,96147,1.9242016221011278,0.2835450280014981
1267,0.1269,33,215,33,433717,242727,30142,96114,1.922498732733494,0.2836551656971854
1268,0.127,39,228,39,433945,242499,30181,96075,1.9206928779622354,0.2837636676177143
1269,0.1271,38,195,38,434140,242304,30219,96037,1.9191483969078698,0.2838467699746705
1270,0.1272,28,194,28,434334,242110,30247,96009,1.9176118362691674,0.28395032518137103
1271,0.1273,44,206,44,434540,241904,30291,95965,1.9159802306425042,0.28403020105425475
1272,0.1274,27,218,27,434758,241686,30318,95938,1.91425358002788,0.28415633959671116
1273,0.1275,43,217,43,434975,241469,30361,95895,1.912534849828919,0.28424787469913804
1274,0.1276,32,230,32,435205,241239,30393,95863,1.9107131542263338,0.2843738690366714
1275,0.1277,30,225,30,435430,241014,30423,95833,1.9089310607020658,0.2845000846081455
1276,0.1278,35,224,35,435654,240790,30458,95798,1.9071568875934608,0.28461501895492414
1277,0.1279,33,222,33,435876,240568,30491,95765,1.905398555316183,0.28473269051802824
1278,0.128,32,225,32,436101,240343,30523,95733,1.903616461791915,0.28485521132124875
1279,0.1281,28,217,28,436318,240126,30551,95705,1.901897731592954,0.28497964750127297
1280,0.1282,25,210,25,436528,239916,30576,95680,1.900234444303637,0.2851047092337215
1281,0.1283,33,193,33,436721,239723,30609,95647,1.8987058040805982,0.28519843754659036
1282,0.1284,23,219,23,436940,239504,30632,95624,1.8969712330503106,0.2853357523095653
1283,0.1285,24,216,24,437156,239288,30656,95600,1.8952604232670132,0.28546857456821384
1284,0.1286,31,194,31,437350,239094,30687,95569,1.8937238626283108,0.28556786976749743
1285,0.1287,37,203,37,437553,238891,30724,95532,1.8921160182486376,0.2856621703650766
1286,0.1288,26,208,26,437761,238683,30750,95506,1.8904685717906475,0.28578439146710394
1287,0.1289,44,201,44,437962,238482,30794,95462,1.8888765682423014,0.28586230026591286
1288,0.129,45,192,45,438154,238290,30839,95417,1.8873558484349258,0.28593047194095417
1289,0.1291,33,211,33,438365,238079,30872,95384,1.8856846407299455,0.2860407301559693
1290,0.1292,31,208,31,438573,237871,30903,95353,1.8840371942719554,0.2861528581374691
1291,0.1293,36,212,36,438785,237659,30939,95317,1.8823580661513115,0.28625786843496226
1292,0.1294,33,212,33,438997,237447,30972,95284,1.8806789380306679,0.28636946963162435
1293,0.1295,34,231,34,439228,237216,31006,95250,1.8788493220124192,0.2864954611900164
1294,0.1296,33,191,33,439419,237025,31039,95217,1.877336522620707,0.28658929334641614
1295,0.1297,33,215,33,439634,236810,31072,95184,1.8756336332530732,0.28670397657789
1296,0.1298,31,199,31,439833,236611,31103,95153,1.8740574705360538,0.28680929817581174
1297,0.1299,33,189,33,440022,236422,31136,95120,1.8725605119756685,0.2869018103287065
1298,0.13,35,196,35,440218,236226,31171,95085,1.8710081105056393,0.2869962059816909
1299,0.1301,37,200,37,440418,236026,31208,95048,1.8694240273729565,0.287089895310414
1300,0.1302,32,200,32,440618,235826,31240,95016,1.8678399442402738,0.28719449163044597
1301,0.1303,32,216,32,440834,235610,31272,94984,1.8661291344569764,0.2873131393794201
1302,0.1304,34,198,34,441032,235412,31306,94950,1.8645608921556203,0.28741199048316696
1303,0.1305,38,212,38,441244,235200,31344,94912,1.8628817640349766,0.28751454051958125
1304,0.1306,26,233,26,441477,234967,31370,94886,1.861036307185401,0.2876614734442312
1305,0.1307,31,196,31,441673,234771,31401,94855,1.859483905715372,0.2877655282046926
1306,0.1308,33,194,33,441867,234577,31434,94822,1.8579473450766697,0.2878636547166203
1307,0.1309,35,193,35,442060,234384,31469,94787,1.8564187048536307,0.28795671550653
1308,0.131,37,171,37,442231,234213,31506,94750,1.855064313775187,0.28802631298960674
1309,0.1311,35,206,35,442437,234007,31541,94715,1.8534327081485236,0.2881310043136754
1310,0.1312,30,190,30,442627,233817,31571,94685,1.851927829172475,0.288232643941285
1311,0.1313,34,212,34,442839,233605,31605,94651,1.8502487010518311,0.2883450721388185
1312,0.1314,38,230,38,443069,233375,31643,94613,1.848427005449246,0.28846482188372746
1313,0.1315,36,206,36,443275,233169,31679,94577,1.8467953998225828,0.28856797642076487
1314,0.1316,26,193,26,443468,232976,31705,94551,1.8452667595995438,0.28868154381165523
1315,0.1317,35,179,35,443647,232797,31740,94516,1.8438490051957928,0.28876335495382094
1316,0.1318,28,224,28,443871,232573,31768,94488,1.842074832087188,0.28890023573584134
1317,0.1319,32,217,32,444088,232356,31800,94456,1.840356101888227,0.28902243491671054
1318,0.132,42,215,42,444303,232141,31842,94414,1.838653212520593,0.2891212812543063
1319,0.1321,36,168,36,444471,231973,31878,94378,1.8373225826891395,0.28919169850866094
1320,0.1322,33,204,33,444675,231769,31911,94345,1.835706817893803,0.2893006739974365
1321,0.1323,36,197,36,444872,231572,31947,94309,1.8341464960081104,0.28939704984334774
1322,0.1324,27,175,27,445047,231397,31974,94282,1.8327604232670132,0.2894936425130266
1323,0.1325,36,233,36,445280,231164,32010,94246,1.8309149664174376,0.2896223226084017
1324,0.1326,36,193,36,445473,230971,32046,94210,1.8293863261943988,0.28971557378813645
1325,0.1327,27,195,27,445668,230776,32073,94183,1.827841845140033,0.2898304093747211
1326,0.1328,26,186,26,445854,230590,32099,94157,1.8263686478266379,0.289939552944292
1327,0.1329,38,210,38,446064,230380,32137,94119,1.824705360537321,0.2900440371156768
1328,0.133,30,197,30,446261,230183,32167,94089,1.8231450386516284,0.2901545616026052
1329,0.1331,29,200,29,446461,229983,32196,94060,1.8215609555189456,0.2902701184719312
1330,0.1332,33,202,33,446663,229781,32229,94027,1.819961031554936,0.29037886648878347
1331,0.1333,29,178,29,446841,229603,32258,93998,1.8185511975668482,0.290474998532143
1332,0.1334,30,193,30,447034,229410,32288,93968,1.8170225573438095,0.290582538082368
1333,0.1335,46,174,46,447208,229236,32334,93922,1.8156444050183753,0.2906380160788221
1334,0.1336,30,197,30,447405,229039,32364,93892,1.8140840831326828,0.2907494170581332
1335,0.1337,29,234,29,447639,228805,32393,93863,1.8122307058674438,0.29089652522097015
1336,0.1338,39,206,39,447845,228599,32432,93824,1.8105991002407806,0.29099661004332816
1337,0.1339,32,217,32,448062,228382,32464,93792,1.80888037004182,0.2911221886309882
1338,0.134,35,219,35,448281,228163,32499,93757,1.807145799011532,0.29124316600397615
1339,0.1341,35,194,35,448475,227969,32534,93722,1.8056092383728297,0.2913416912502992
1340,0.1342,35,201,35,448676,227768,32569,93687,1.8040172348244836,0.29144670327106437
1341,0.1343,29,205,29,448881,227563,32598,93658,1.8023935496134837,0.29156873305294484
1342,0.1344,25,189,25,449070,227374,32623,93633,1.8008965910530985,0.29168522804798647
1343,0.1345,42,214,42,449284,227160,32665,93591,1.7992016221011278,0.291787087179775
1344,0.1346,26,201,26,449485,226959,32691,93565,1.7976096185527817,0.2919126180878811
1345,0.1347,33,172,33,449657,226787,32724,93532,1.7962473070586744,0.2919964160727275
1346,0.1348,24,192,24,449849,226595,32748,93508,1.794726587251299,0.2921184743660634
1347,0.1349,26,188,26,450037,226407,32774,93482,1.793237549106577,0.29223261818943447
1348,0.135,39,186,39,450223,226221,32813,93443,1.791764351793182,0.2923163071224786
1349,0.1351,34,188,34,450411,226033,32847,93409,1.7902753136484604,0.2924130202039807
1350,0.1352,28,203,28,450614,225830,32875,93381,1.7886674692687872,0.29253691132197823
1351,0.1353,17,178,17,450792,225652,32892,93364,1.7872576352806995,0.2926624369937558
1352,0.1354,25,214,25,451006,225438,32917,93339,1.785562666328729,0.2928034331209592
1353,0.1355,26,193,26,451199,225245,32943,93313,1.78403402610569,0.2929231097633712
1354,0.1356,24,189,24,451388,225056,32967,93289,1.7825370675453047,0.29304371043993155
1355,0.1357,30,206,30,451594,224850,32997,93259,1.7809054619186415,0.293166807603683
1356,0.1358,25,187,25,451781,224663,33022,93234,1.7794243441895832,0.29328367364272073
1357,0.1359,39,184,39,451965,224479,33061,93195,1.7779669877075148,0.29336678481713957
1358,0.136,33,219,33,452184,224260,33094,93162,1.7762324166772272,0.29349572493399956
1359,0.1361,29,189,29,452373,224071,33123,93133,1.774735458116842,0.2936060074904478
1360,0.1362,36,188,36,452561,223883,33159,93097,1.77324641997212,0.2936999179758975
1361,0.1363,36,199,36,452760,223684,33195,93061,1.7716702572551009,0.29380416423305816
1362,0.1364,27,179,27,452939,223505,33222,93034,1.7702525028513496,0.29391007111288026
1363,0.1365,28,199,28,453138,223306,33250,93006,1.7686763401343302,0.29403247426591467
1364,0.1366,29,181,29,453319,223125,33279,92977,1.7672427448992523,0.29413607000272063
1365,0.1367,30,196,30,453515,222929,33309,92947,1.7656903434292233,0.29425154174422874
1366,0.1368,34,178,34,453693,222751,33343,92913,1.7642805094411356,0.29434145167013026
1367,0.1369,28,206,28,453899,222545,33371,92885,1.7626489038144721,0.2944710395333354
1368,0.137,28,192,28,454091,222353,33399,92857,1.7611281840070967,0.29458773516068654
1369,0.1371,32,198,32,454289,222155,33431,92825,1.7595599417057408,0.2947012508730713
1370,0.1372,27,193,27,454482,221962,33458,92798,1.7580313014827018,0.29482145126445547
1371,0.1373,22,176,22,454658,221786,33480,92776,1.756637308325941,0.2949370871243189
1372,0.1374,28,183,28,454841,221603,33508,92748,1.7551878722595362,0.2950459836297642
1373,0.1375,41,180,41,455021,221423,33549,92707,1.7537621974401216,0.29512303823257885
1374,0.1376,28,201,28,455222,221222,33577,92679,1.7521701938917755,0.29524913905976724
1375,0.1377,52,203,52,455425,221019,33629,92627,1.7505623495121023,0.29532339006395747
1376,0.1378,27,170,27,455595,220849,33656,92600,1.749215878849322,0.29542285985917965
1377,0.1379,37,193,37,455788,220656,33693,92563,1.7476872386262832,0.2955216637560301
1378,0.138,30,208,30,455996,220448,33723,92533,1.746039792168293,0.29565053469699437
1379,0.1381,35,208,35,456204,220240,33758,92498,1.7443923457103028,0.2957683428301006
1380,0.1382,39,174,39,456378,220066,33797,92459,1.7430141933848688,0.29584513238940885
1381,0.1383,26,225,26,456603,219841,33823,92433,1.7412320998606008,0.29599966695914487
1382,0.1384,42,205,42,456808,219636,33865,92391,1.739608414649601,0.2960993760155371
1383,0.1385,28,183,28,456991,219453,33893,92363,1.7381589785831961,0.29620994432614106
1384,0.1386,37,199,37,457190,219254,33930,92326,1.7365828158661767,0.29631555298799667
1385,0.1387,35,187,35,457377,219067,33965,92291,1.7351016981371183,0.2964144168449181
1386,0.1388,22,206,22,457583,218861,33987,92269,1.733470092510455,0.2965609230868126
1387,0.1389,32,184,32,457767,218677,34019,92237,1.7320127360283868,0.296664029281409
1388,0.139,28,197,28,457964,218480,34047,92209,1.7304524141426942,0.29678875016495593
1389,0.1391,32,171,32,458135,218309,34079,92177,1.7290980230642503,0.2968797304870429
1390,0.1392,41,211,41,458346,218098,34120,92136,1.72742681535927,0.2969887246401104
1391,0.1393,37,213,37,458559,217885,34157,92099,1.7257397668229628,0.2971088830391246
1392,0.1394,30,191,30,458750,217694,34187,92069,1.7242269674312507,0.2972240067406372
1393,0.1395,22,184,22,458934,217510,34209,92047,1.7227696109491826,0.29735073023708075
1394,0.1396,32,208,32,459142,217302,34241,92015,1.7211221644911925,0.2974779918336205
1395,0.1397,27,170,27,459312,217132,34268,91988,1.719775693828412,0.2975802277432712
1396,0.1398,26,192,26,459504,216940,34294,91962,1.7182549740210367,0.2977060685913332
1397,0.1399,29,201,29,459705,216739,34323,91933,1.7166629704726903,0.2978339467136637
1398,0.14,28,156,28,459861,216583,34351,91905,1.7154273856291977,0.29792082674204506
1399,0.1401,36,189,36,460050,216394,34387,91869,1.7139304270688125,0.2980214946328298
1400,0.1402,41,185,41,460235,216209,34428,91828,1.712465150171081,0.29810704558218654
1401,0.1403,36,185,36,460420,216024,34464,91792,1.7109998732733493,0.2982041219429789
1402,0.1404,53,191,53,460611,215833,34517,91739,1.7094870738816372,0.29826837293381714
1403,0.1405,33,174,33,460785,215659,34550,91706,1.7081089215562033,0.2983618824524588
1404,0.1406,29,178,29,460963,215481,34579,91677,1.7066990875681156,0.298468540620788
1405,0.1407,36,194,36,461157,215287,34615,91641,1.7051625269294133,0.29857491007663034
1406,0.1408,31,182,31,461339,215105,34646,91610,1.7037210112786718,0.2986811861174054
1407,0.1409,28,204,28,461543,214901,34674,91582,1.7021052464833355,0.29881592127458945
1408,0.141,45,180,45,461723,214721,34719,91537,1.700679571663921,0.2988885188305285
1409,0.1411,30,152,30,461875,214569,34749,91507,1.699475668483082,0.29896823011278245
1410,0.1412,29,181,29,462056,214388,34778,91478,1.6980420732480042,0.2990786815141271
1411,0.1413,27,182,27,462238,214206,34805,91451,1.6966005575972627,0.2991948491282712
1412,0.1414,29,190,29,462428,214016,34834,91422,1.6950956786212141,0.29931442715051826
1413,0.1415,24,203,24,462631,213813,34858,91398,1.693487834241541,0.2994584074623785
1414,0.1416,26,185,26,462816,213628,34884,91372,1.6920225573438095,0.29958032786885247
1415,0.1417,29,165,29,462981,213463,34913,91343,1.6907156887593462,0.2996758593990932
1416,0.1418,32,152,32,463133,213311,34945,91311,1.6895117855785071,0.2997518235715083
1417,0.1419,36,141,36,463274,213170,34981,91275,1.6883950069699658,0.2998078470659725
1418,0.142,27,191,27,463465,212979,35008,91248,1.6868822075782537,0.2999339309134298
1419,0.1421,48,183,48,463648,212796,35056,91200,1.685432771511849,0.3000039474203608
1420,0.1422,35,179,35,463827,212617,35091,91165,1.6840150171080979,0.3001000717619872
1421,0.1423,34,199,34,464026,212418,35125,91131,1.6824388543910784,0.30021841613709815
1422,0.1424,32,178,32,464204,212240,35157,91099,1.6810290204029907,0.30032076323848894
1423,0.1425,35,183,35,464387,212057,35192,91064,1.679579584336586,0.30042128390972583
1424,0.1426,43,182,43,464569,211875,35235,91021,1.6781380686858447,0.3005024827003328
1425,0.1427,40,168,40,464737,211707,35275,90981,1.676807438854391,0.30057683158896287
1426,0.1428,32,171,32,464908,211536,35307,90949,1.6754530477759473,0.30067276063275866
1427,0.1429,25,183,25,465091,211353,35332,90924,1.6740036117095425,0.30079695114084104
1428,0.143,27,177,27,465268,211176,35359,90897,1.6726016981371183,0.3009107070145296
1429,0.1431,33,201,33,465469,210975,35392,90864,1.671009694588772,0.30103465754922326
1430,0.1432,39,172,39,465641,210803,35431,90825,1.6696473830946648,0.3011159441431167
1431,0.1433,30,176,30,465817,210627,35461,90795,1.668253389937904,0.3012222067400522
1432,0.1434,31,179,31,465996,210448,35492,90764,1.666835635534153,0.301329296309576
1433,0.1435,30,190,30,466186,210258,35522,90734,1.6653307565581041,0.3014498724218584
1434,0.1436,36,168,36,466354,210090,35558,90698,1.6640001267266507,0.3015346356902536
1435,0.1437,29,184,29,466538,209906,35587,90669,1.6625427702445825,0.30165183398486234
1436,0.1438,32,191,32,466729,209715,35619,90637,1.6610299708528704,0.3017692574046452
1437,0.1439,30,210,30,466939,209505,35649,90607,1.6593666835635534,0.30191062003518687
1438,0.144,36,206,36,467145,209299,35685,90571,1.6577350779368902,0.3020342148264248
1439,0.1441,42,156,42,467301,209143,35727,90529,1.6564994930933976,0.3020936223604474
1440,0.1442,40,184,40,467485,208959,35767,90489,1.6550421366113293,0.30218602228099706
1441,0.1443,40,170,40,467655,208789,35807,90449,1.6536956659485489,0.30226441828912104
1442,0.1444,30,185,30,467840,208604,35837,90419,1.6522303890508174,0.3023814221648502
1443,0.1445,38,163,38,468003,208441,35875,90381,1.6509393612976808,0.3024576503738011
1444,0.1446,29,158,29,468161,208283,35904,90352,1.6496879356228615,0.3025499355400405
1445,0.1447,35,159,35,468320,208124,35939,90317,1.6484285895323787,0.3026293304204181
1446,0.1448,36,188,36,468508,207936,35975,90281,1.6469395513876568,0.3027359271939561
1447,0.1449,40,186,40,468694,207750,36015,90241,1.6454663540742618,0.3028312935625573
1448,0.145,34,196,34,468890,207554,36049,90207,1.6439139526042326,0.30295102447936434
1449,0.1451,43,187,43,469077,207367,36092,90164,1.6424328348751742,0.3030406915581906
1450,0.1452,23,176,23,469253,207191,36115,90141,1.6410388417184134,0.30316615769577443
1451,0.1453,40,173,40,469426,207018,36155,90101,1.6396686098086428,0.3032488666157331
1452,0.1454,38,160,38,469586,206858,36193,90063,1.6384013433024964,0.30332310614607927
1453,0.1455,32,202,32,469788,206656,36225,90031,1.6368014193384868,0.30345448233323336
1454,0.1456,41,194,41,469982,206462,36266,89990,1.6352648586997847,0.30355673093789215
1455,0.1457,29,212,29,470194,206250,36295,89961,1.6335857305791408,0.30370580430841526
1456,0.1458,23,176,23,470370,206074,36318,89938,1.63219173742238,0.3038322770698485
1457,0.1459,31,174,31,470544,205900,36349,89907,1.6308135850969459,0.30393804068193114
1458,0.146,34,165,34,470709,205735,36383,89873,1.6295067165124826,0.30402763118724796
1459,0.1461,31,179,31,470888,205556,36414,89842,1.6280889621087316,0.3041388228762551
1460,0.1462,29,197,29,471085,205359,36443,89813,1.626528640223039,0.3042734405702438
1461,0.1463,33,158,33,471243,205201,36476,89780,1.6252772145482195,0.30435858580722147
1462,0.1464,22,192,22,471435,205009,36498,89758,1.623756494740844,0.30450491405075875
1463,0.1465,32,169,32,471604,204840,36530,89726,1.622417944493727,0.3046040615685449
1464,0.1466,33,183,33,471787,204657,36563,89693,1.6209685084273222,0.30471547477492783
1465,0.1467,35,191,35,471978,204466,36598,89658,1.61945570903561,0.3048306156587018
1466,0.1468,32,167,32,472145,204299,36630,89626,1.6181329996198202,0.3049281279237901
1467,0.1469,33,179,33,472324,204120,36663,89593,1.616715245216069,0.3050358683476727
1468,0.147,33,178,33,472502,203942,36696,89560,1.6153054112279812,0.3051427247514497
1469,0.1471,29,196,29,472698,203746,36725,89531,1.613753009757952,0.30527794542360975
1470,0.1472,31,182,31,472880,203564,36756,89500,1.6123114941072108,0.305394043621871
1471,0.1473,39,184,39,473064,203380,36795,89461,1.6108541376251426,0.30549342475951113
1472,0.1474,28,170,28,473234,203210,36823,89433,1.6095076669623622,0.30560443953896044
1473,0.1475,38,182,38,473416,203028,36861,89395,1.6080661513116208,0.3057044076560325
1474,0.1476,33,163,33,473579,202865,36894,89362,1.6067751235584844,0.3057965211975622
1475,0.1477,31,163,31,473742,202702,36925,89331,1.6054840958053478,0.3058935120345988
1476,0.1478,32,159,32,473901,202543,36957,89299,1.604224749714865,0.30598405986801075
1477,0.1479,40,190,40,474091,202353,36997,89259,1.6027198707388164,0.3060882268219415
1478,0.148,35,175,35,474266,202178,37032,89224,1.601333797997719,0.30618870151886396
1479,0.1481,30,186,30,474452,201992,37062,89194,1.599860600684324,0.30631280350016826
1480,0.1482,38,167,38,474619,201825,37100,89156,1.5985378912685337,0.3063980122413491
1481,0.1483,27,197,27,474816,201628,37127,89129,1.5969775693828412,0.3065412010716853
1482,0.1484,28,142,28,474958,201486,37155,89101,1.5958528703586363,0.3066241779570318
1483,0.1485,49,166,49,475124,201320,37204,89052,1.5945380813585097,0.3066824624963839
1484,0.1486,37,174,37,475298,201146,37241,89015,1.5931599290330756,0.30677796120085055
1485,0.1487,34,144,34,475442,201002,37275,88981,1.592019389177544,0.3068490221840591
1486,0.1488,23,176,23,475618,200826,37298,88958,1.5906253960207832,0.30698037158711317
1487,0.1489,39,155,39,475773,200671,37337,88919,1.589397731592954,0.307051348458165
1488,0.149,32,153,32,475926,200518,37369,88887,1.5881859079964518,0.3071370570653582
1489,0.1491,28,184,28,476110,200334,37397,88859,1.5867285515143834,0.30726539024111926
1490,0.1492,27,191,27,476301,200143,37424,88832,1.5852157521226713,0.30740375465005626
1491,0.1493,46,194,46,476495,199949,37470,88786,1.5836791914839692,0.30749995670770774
1492,0.1494,35,180,35,476675,199769,37505,88751,1.5822535166645546,0.3076077914875919
1493,0.1495,32,181,32,476856,199588,37537,88719,1.5808199214294767,0.30772405803535813
1494,0.1496,34,156,34,477012,199432,37571,88685,1.579584336585984,0.3078089803794986
1495,0.1497,28,171,28,477183,199261,37599,88657,1.5782299455075401,0.30792447849734994
1496,0.1498,29,180,29,477363,199081,37628,88628,1.5768042706881258,0.308047367305159
1497,0.1499,31,164,31,477527,198917,37659,88597,1.5755053225193258,0.3081484727700216
1498,0.15,27,163,27,477690,198754,37686,88570,1.5742142947661892,0.3082582728905347
1499,0.1501,31,182,31,477872,198572,37717,88539,1.572772779115448,0.30837898931075436
1500,0.1502,31,172,31,478044,198400,37748,88508,1.5714104676213407,0.3084891324048127
1501,0.1503,36,194,36,478238,198206,37784,88472,1.5698739069826384,0.30861105491178253
1502,0.1504,37,174,37,478412,198032,37821,88435,1.5684957546572045,0.3087092055978525
1503,0.1505,46,188,46,478600,197844,37867,88389,1.5670067165124826,0.3088008720168534
1504,0.1506,27,172,27,478772,197672,37894,88362,1.5656444050183753,0.3089213170462253
1505,0.1507,28,155,28,478927,197517,37922,88334,1.5644167405905463,0.309021133387674
1506,0.1508,39,179,39,479106,197338,37961,88295,1.562998986186795,0.3091204447665361
1507,0.1509,39,176,39,479282,197162,38000,88256,1.5616049930300342,0.30921665767400797
1508,0.151,29,173,29,479455,196989,38029,88227,1.5602347611202636,0.3093339784584315
1509,0.1511,37,165,37,479620,196824,38066,88190,1.5589278925358003,0.309423396745423
1510,0.1512,27,143,27,479763,196681,38093,88163,1.5577952730959321,0.30951327744309165
1511,0.1513,33,164,33,479927,196517,38126,88130,1.5564963249271322,0.3096115539598169
1512,0.1514,32,165,32,480092,196352,38158,88098,1.555189456342669,0.3097134821585516
1513,0.1515,31,173,31,480265,196179,38189,88067,1.5538192244328983,0.309826699408259
1514,0.1516,37,193,37,480458,195986,38226,88030,1.5522905842098593,0.30994732691115995
1515,0.1517,28,160,28,480618,195826,38254,88002,1.5510233177037132,0.3100539763518751
1516,0.1518,37,181,37,480799,195645,38291,87965,1.5495897224686352,0.31016184196608015
1517,0.1519,29,172,29,480971,195473,38320,87936,1.548227410974528,0.31027949006559424
1518,0.152,29,165,29,481136,195308,38349,87907,1.5469205423900647,0.31038963331744435
1519,0.1521,31,151,31,481287,195157,38380,87876,1.5457245596248892,0.31047969671381076
1520,0.1522,39,182,39,481469,194975,38419,87837,1.5442830439741477,0.3105844165028358
1521,0.1523,32,187,32,481656,194788,38451,87805,1.5428019262450894,0.3107118718439593
1522,0.1524,30,153,30,481809,194635,38481,87775,1.541590102648587,0.3108069827555682
1523,0.1525,31,170,31,481979,194465,38512,87744,1.5402436319858066,0.31091850366217944
1524,0.1526,34,159,34,482138,194306,38546,87710,1.5389842858953238,0.3110107227958697
1525,0.1527,26,175,26,482313,194131,38572,87684,1.5375982131542263,0.3111402870677572
1526,0.1528,31,199,31,482512,193932,38603,87653,1.5360220504372069,0.31128433687873996
1527,0.1529,41,166,41,482678,193766,38644,87612,1.5347072614370803,0.311367626466888
1528,0.153,28,163,28,482841,193603,38672,87584,1.5334162336839436,0.3114795491967979
1529,0.1531,25,163,25,483004,193440,38697,87559,1.5321252059308073,0.311598973661828
1530,0.1532,40,188,40,483192,193252,38737,87519,1.5306361677860854,0.31170954265219697
1531,0.1533,34,131,34,483323,193121,38771,87485,1.5295985933341782,0.31177166560943104
1532,0.1534,26,174,26,483497,192947,38797,87459,1.528220441008744,0.3119013145225138
1533,0.1535,35,165,35,483662,192782,38832,87424,1.5269135724242808,0.31199902928559703
1534,0.1536,29,167,29,483829,192615,38861,87395,1.5255908630084907,0.31211385307667583
1535,0.1537,21,153,21,483982,192462,38882,87374,1.5243790394119883,0.31223287925785104
1536,0.1538,32,171,32,484153,192291,38914,87342,1.5230246483335446,0.3123451094827864
1537,0.1539,26,180,26,484333,192111,38940,87316,1.52159897351413,0.3124823299108533
1538,0.154,34,163,34,484496,191948,38974,87282,1.5203079457609936,0.3125810263940121
1539,0.1541,32,148,32,484644,191800,39006,87250,1.5191357242428083,0.3126679806486293
1540,0.1542,36,177,36,484821,191623,39042,87214,1.517733810670384,0.31277771601329807
1541,0.1543,30,159,30,484980,191464,39072,87184,1.516474464579901,0.31288220263558325
1542,0.1544,20,152,20,485132,191312,39092,87164,1.5152705613990622,0.31300363406541315
1543,0.1545,38,155,38,485287,191157,39130,87126,1.514042896971233,0.31308416252519916
1544,0.1546,32,166,32,485453,190991,39162,87094,1.5127281079711064,0.3131920096373411
1545,0.1547,35,145,35,485598,190846,39197,87059,1.5115796476999113,0.31326892283334234
1546,0.1548,30,160,30,485758,190686,39227,87029,1.510312381193765,0.3133752228003529
1547,0.1549,37,162,37,485920,190524,39264,86992,1.509029273856292,0.31346661093414435
1548,0.155,29,166,29,486086,190358,39293,86963,1.5077144848561652,0.3135824549889839
1549,0.1551,40,153,40,486239,190205,39333,86923,1.5065026612596628,0.3136565052971912
1550,0.1552,24,134,24,486373,190071,39357,86899,1.5054413255607655,0.31374878145647545
1551,0.1553,27,169,27,486542,189902,39384,86872,1.5041027753136484,0.31387341296509064
1552,0.1554,29,162,29,486704,189740,39413,86843,1.5028196679761754,0.31398531363098964
1553,0.1555,29,161,29,486865,189579,39442,86814,1.5015444810543657,0.3140962325384507
1554,0.1556,38,175,38,487040,189404,39480,86776,1.5001584083132682,0.31420088348178726
1555,0.1557,26,143,26,487183,189261,39506,86750,1.4990257888734,0.31429906779077643
1556,0.1558,39,191,39,487374,189070,39545,86711,1.497512989481688,0.3144197751114109
1557,0.1559,28,168,28,487542,188902,39573,86683,1.4961823596502344,0.31454179291325723
1558,0.156,44,195,44,487737,188707,39617,86639,1.4946378785958687,0.3146550158709406
1559,0.1561,31,176,31,487913,188531,39648,86608,1.493243885439108,0.31477907530375554
1560,0.1562,20,163,20,488076,188368,39668,86588,1.4919528576859713,0.31491584108002735
1561,0.1563,33,157,33,488233,188211,39701,86555,1.4907093524268153,0.3150135023984045
1562,0.1564,22,166,22,488399,188045,39723,86533,1.4893945634266885,0.31514906511082463
1563,0.1565,37,161,37,488560,187884,39760,86496,1.488119376504879,0.31524163568773234
1564,0.1566,38,154,38,488714,187730,39798,86458,1.4868996324927133,0.3153237924343881
1565,0.1567,30,156,30,488870,187574,39828,86428,1.4856640476492207,0.31542835453755813
1566,0.1568,24,166,24,489036,187408,39852,86404,1.4843492586490938,0.3155595810263977
1567,0.1569,30,165,30,489201,187243,39882,86374,1.4830423900646306,0.31567483014578773
1568,0.157,31,162,31,489363,187081,39913,86343,1.4817592827271575,0.31578427643513374
1569,0.1571,31,154,31,489517,186927,39944,86312,1.4805395387149918,0.31588462847543725
1570,0.1572,33,149,33,489666,186778,39977,86279,1.4793593967811431,0.3159743203799939
1571,0.1573,24,149,24,489815,186629,40001,86255,1.4781792548472943,0.3160866888494745
1572,0.1574,27,142,27,489957,186487,40028,86228,1.4770545558230896,0.31618356159360506
1573,0.1575,28,158,28,490115,186329,40056,86200,1.4758031301482701,0.3162966143052666
1574,0.1576,25,157,25,490272,186172,40081,86175,1.4745596248891142,0.31641618964042195
1575,0.1577,32,168,32,490440,186004,40113,86143,1.4732289950576607,0.3165311394209747
1576,0.1578,29,169,29,490609,185835,40142,86114,1.4718904448105437,0.31665496104048924
1577,0.1579,38,136,38,490745,185699,40180,86076,1.4708132682803194,0.31671787324073225
1578,0.158,33,154,33,490899,185545,40213,86043,1.4695935242681535,0.3168144395186827
1579,0.1581,32,172,32,491071,185373,40245,86011,1.4682312127740464,0.31693467558883354
1580,0.1582,33,172,33,491243,185201,40278,85978,1.4668689012799392,0.3170525741300027
1581,0.1583,28,155,28,491398,185046,40306,85950,1.46564123685211,0.3171633529646194
1582,0.1584,33,158,33,491556,184888,40339,85917,1.4643898111772906,0.3172651908199627
1583,0.1585,29,171,29,491727,184717,40368,85888,1.4630354200988467,0.3173925093771364
1584,0.1586,26,176,26,491903,184541,40394,85862,1.4616414269420859,0.3175334593181289
1585,0.1587,25,149,25,492052,184392,40419,85837,1.4604612850082372,0.31764540445326
1586,0.1588,23,161,23,492213,184231,40442,85814,1.4591860980864275,0.317776666851821
1587,0.1589,29,155,29,492368,184076,40471,85785,1.4579584336585985,0.3178858745798763
1588,0.159,43,156,43,492524,183920,40514,85742,1.4567228488151058,0.317961003033427
1589,0.1591,32,142,32,492666,183778,40546,85710,1.455598149790901,0.3180475568485424
1590,0.1592,30,150,30,492816,183628,40576,85680,1.454410087441389,0.3181487367623687
1591,0.1593,28,175,28,492991,183453,40604,85652,1.4530240147002915,0.3182846844168633
1592,0.1594,42,161,42,493152,183292,40646,85610,1.4517488277784818,0.318368773754007
1593,0.1595,34,136,34,493288,183156,40680,85576,1.4506716512482576,0.3184436539005403
1594,0.1596,22,146,22,493434,183010,40702,85554,1.4495152705613992,0.31856093891958714
1595,0.1597,33,150,33,493584,182860,40735,85521,1.448327208211887,0.31865519541249193
1596,0.1598,30,155,30,493739,182705,40765,85491,1.4470995437840577,0.31876314337275724
1597,0.1599,34,156,34,493895,182549,40799,85457,1.4458639589405653,0.31886226427766545
1598,0.16,26,168,26,494063,182381,40825,85431,1.4445333291091116,0.31899616148641585
1599,0.1601,37,155,37,494218,182226,40862,85394,1.4433056646812825,0.3190867648157836
1600,0.1602,30,137,30,494355,182089,40892,85364,1.4422205677353948,0.31917383615065076
1601,0.1603,36,124,36,494479,181965,40928,85328,1.4412384361931314,0.3192302080488453
1602,0.1604,38,171,38,494650,181794,40966,85290,1.4398840451146877,0.31933773644246755
1603,0.1605,24,152,24,494802,181642,40990,85266,1.4386801419338486,0.319458390156908
1604,0.1606,34,140,34,494942,181502,41024,85232,1.4375712837409707,0.31953931632262855
1605,0.1607,40,165,40,495107,181337,41064,85192,1.4362644151565074,0.31963501157472546
1606,0.1608,26,160,26,495267,181177,41090,85166,1.4349971486503612,0.31976060943970747
1607,0.1609,27,153,27,495420,181024,41117,85139,1.4337853250538588,0.31987541468949476
1608,0.161,31,158,31,495578,180866,41148,85108,1.4325338993790395,0.3199861640611488
1609,0.1611,28,150,28,495728,180716,41176,85080,1.4313458370295273,0.32009511053589973
1610,0.1612,27,162,27,495890,180554,41203,85053,1.4300627296920543,0.32022122910917256
1611,0.1613,21,164,21,496054,180390,41224,85032,1.4287637815232543,0.32036530506137395
1612,0.1614,34,166,34,496220,180224,41258,84998,1.4274489925231275,0.3204786933210669
1613,0.1615,28,152,28,496372,180072,41286,84970,1.4262450893422887,0.32059069883263785
1614,0.1616,32,148,32,496520,179924,41318,84938,1.4250728678241034,0.32068775437775143
1615,0.1617,31,152,31,496672,179772,41349,84907,1.4238689646432645,0.32079235602371176
1616,0.1618,24,142,24,496814,179630,41373,84883,1.4227442656190596,0.32090294238846484
1617,0.1619,19,167,19,496981,179463,41392,84864,1.4214215562032695,0.3210568727371778
1618,0.162,33,156,33,497137,179307,41425,84831,1.4201859713597769,0.3211616654930377
1619,0.1621,24,170,24,497307,179137,41449,84807,1.4188395006969965,0.3213067923498924
1620,0.1622,28,139,28,497446,178998,41477,84779,1.417738562919782,0.3214040647971582
1621,0.1623,33,137,33,497583,178861,41510,84746,1.4166534659738943,0.3214861517334517
1622,0.1624,33,144,33,497727,178717,41543,84713,1.4155129261183628,0.32157688949626084
1623,0.1625,26,139,26,497866,178578,41569,84687,1.4144119883411481,0.32167967637171674
1624,0.1626,41,153,41,498019,178425,41610,84646,1.4132001647446457,0.3217610454972232
1625,0.1627,32,151,32,498170,178274,41642,84614,1.4120041819794702,0.3218633030035605
1626,0.1628,29,161,29,498331,178113,41671,84585,1.4107289950576607,0.3219857022131878
1627,0.1629,20,167,20,498498,177946,41691,84565,1.4094062856418705,0.3221388817992389
1628,0.163,18,139,18,498637,177807,41709,84547,1.4083053478646559,0.32226304916258186
1629,0.1631,32,149,32,498786,177658,41741,84515,1.4071252059308073,0.3223634775510827
1630,0.1632,40,147,40,498933,177511,41781,84475,1.4059609048282853,0.32244089378821766
1631,0.1633,23,154,23,499087,177357,41804,84452,1.4047411608161195,0.32257103460919984
1632,0.1634,37,150,37,499237,177207,41841,84415,1.4035530984666076,0.3226601738385916
1633,0.1635,30,156,30,499393,177051,41871,84385,1.402317513623115,0.3227749812573632
1634,0.1636,25,145,25,499538,176906,41896,84360,1.4011690533519199,0.3228893158696501
1635,0.1637,31,152,31,499690,176754,41927,84329,1.399965150171081,0.3229969013685303
1636,0.1638,32,150,32,499840,176604,41959,84297,1.3987770878215688,0.3230995665022365
1637,0.1639,34,133,34,499973,176471,41993,84263,1.3977236725383348,0.32317611051876627
1638,0.164,28,163,28,500136,176308,42021,84235,1.3964326447851982,0.3233055580076993
1639,0.1641,32,137,32,500273,176171,42053,84203,1.3953475478393107,0.32339250462795827
1640,0.1642,28,155,28,500428,176016,42081,84175,1.3941198834114814,0.32351234285582514
1641,0.1643,33,158,33,500586,175858,42114,84142,1.3928684577366621,0.3236230769230769
1642,0.1644,34,151,34,500737,175707,42148,84108,1.3916724749714866,0.32372264880780555
1643,0.1645,26,160,26,500897,175547,42174,84082,1.3904052084653402,0.3238544230421101
1644,0.1646,37,151,37,501048,175396,42211,84045,1.3892092257001647,0.3239464849426266
1645,0.1647,36,147,36,501195,175249,42247,84009,1.388044924597643,0.32403628817625685
1646,0.1648,22,154,22,501349,175095,42269,83987,1.3868251805854772,0.3241714978269428
1647,0.1649,36,149,36,501498,174946,42305,83951,1.3856450386516284,0.32426408958002606
1648,0.165,29,152,29,501650,174794,42334,83922,1.3844411354707895,0.3243788555790906
1649,0.1651,39,164,39,501814,174630,42373,83883,1.3831421873019896,0.32448271460236044
1650,0.1652,27,161,27,501975,174469,42400,83856,1.3818670003801798,0.32461434239814185
1651,0.1653,32,147,32,502122,174322,42432,83824,1.380702699277658,0.3247154710900033
1652,0.1654,34,137,34,502259,174185,42466,83790,1.3796176023317703,0.32479891462351
1653,0.1655,36,150,36,502409,174035,42502,83754,1.3784295399822584,0.32489361454522886
1654,0.1656,38,152,38,502561,173883,42540,83716,1.3772256368014193,0.32498573364027034
1655,0.1657,36,147,36,502708,173736,42576,83680,1.3760613356988975,0.32507691829567703
1656,0.1658,34,141,34,502849,173595,42610,83646,1.374944557090356,0.32516589501673526
1657,0.1659,29,158,29,503007,173437,42639,83617,1.3736931314155367,0.325289627860294
1658,0.166,33,150,33,503157,173287,42672,83584,1.3725050690660245,0.3253929014953031
1659,0.1661,27,177,27,503334,173110,42699,83557,1.3711031554936004,0.3255463304593111
1660,0.1662,37,137,37,503471,172973,42736,83520,1.3700180585477126,0.32562292148323735
1661,0.1663,22,148,22,503619,172825,42758,83498,1.3688458370295273,0.32575305376419594
1662,0.1664,29,152,29,503771,172673,42787,83469,1.3676419338486885,0.32587002522038555
1663,0.1665,32,133,32,503904,172540,42819,83437,1.3665885185654543,0.3259550662754857
1664,0.1666,36,158,36,504062,172382,42855,83401,1.365337092890635,0.32606154435595797
1665,0.1667,26,162,26,504224,172220,42881,83375,1.364053985553162,0.32619965179287547
1666,0.1668,33,129,33,504353,172091,42914,83342,1.3630322519325815,0.326277340829102
1667,0.1669,49,151,49,504504,171940,42963,83293,1.361836269167406,0.3263410295690604
1668,0.167,26,126,26,504630,171814,42989,83267,1.3608382967938157,0.32643356424037856
1669,0.1671,36,128,36,504758,171686,43025,83231,1.3598244835888988,0.3265023517458624
1670,0.1672,33,170,33,504928,171516,43058,83198,1.3584780129261185,0.32663300800113065
1671,0.1673,34,133,34,505061,171383,43092,83164,1.3574245976428843,0.3267137306666352
1672,0.1674,22,145,22,505206,171238,43114,83142,1.3562761373716892,0.3268417328406321
1673,0.1675,33,146,33,505352,171092,43147,83109,1.3551197566848308,0.3269420655308201
1674,0.1676,34,138,34,505490,170954,43181,83075,1.3540267393232797,0.32702959110967644
1675,0.1677,26,117,26,505607,170837,43207,83049,1.3531000506906603,0.3271113806984237
1676,0.1678,23,143,23,505750,170694,43230,83026,1.351967431250792,0.3272347469651584
1677,0.1679,31,157,31,505907,170537,43261,82995,1.350723925991636,0.32735512676900747
1678,0.168,20,146,20,506053,170391,43281,82975,1.3495675453047775,0.32749066567732055
1679,0.1681,21,146,21,506199,170245,43302,82954,1.348411164617919,0.32762372679196994
1680,0.1682,27,161,27,506360,170084,43329,82927,1.3471359776961096,0.32776045310282953
1681,0.1683,31,120,31,506480,169964,43360,82896,1.3461855278164998,0.327833583801313
1682,0.1684,28,139,28,506619,169825,43388,82868,1.3450845900392852,0.32793943639119405
1683,0.1685,32,137,32,506756,169688,43420,82836,1.3439994930933976,0.3280321870396477
1684,0.1686,33,153,33,506909,169535,43453,82803,1.3427876694968952,0.3281432047491856
1685,0.1687,45,146,45,507055,169389,43498,82758,1.3416312888100368,0.32821330414401123
1686,0.1688,35,145,35,507200,169244,43533,82723,1.3404828285388417,0.328308865843543
1687,0.1689,28,150,28,507350,169094,43561,82695,1.3392947661893295,0.3284297566613315
1688,0.169,28,148,28,507498,168946,43589,82667,1.3381225446711444,0.32854820696863835
1689,0.1691,27,135,27,507633,168811,43616,82640,1.3370532885565833,0.32865250088486425
1690,0.1692,31,163,31,507796,168648,43647,82609,1.335762260803447,0.3287828796809641
1691,0.1693,25,136,25,507932,168512,43672,82584,1.3346850842732227,0.32889412814222446
1692,0.1694,32,150,32,508082,168362,43704,82552,1.3334970219237106,0.3290051571454761
1693,0.1695,39,159,39,508241,168203,43743,82513,1.3322376758332277,0.329109430590788
1694,0.1696,40,131,40,508372,168072,43783,82473,1.3312001013813204,0.3291743998084177
1695,0.1697,33,120,33,508492,167952,43816,82440,1.3302496515017108,0.3292437458065753
1696,0.1698,22,138,22,508630,167814,43838,82418,1.3291566341401597,0.3293663480290291
1697,0.1699,27,164,27,508794,167650,43865,82391,1.3278576859713598,0.3295099603664999
1698,0.17,30,133,30,508927,167517,43895,82361,1.3268042706881258,0.3296048471654167
1699,0.1701,41,134,41,509061,167383,43936,82320,1.3257429349892282,0.32967164992010506
1700,0.1702,28,144,28,509205,167239,43964,82292,1.3246023951336967,0.32978667981132603
1701,0.1703,38,145,38,509350,167094,44002,82254,1.3234539348625016,0.32987631743587276
1702,0.1704,26,158,26,509508,166936,44028,82228,1.3222025091876821,0.33001557207301213
1703,0.1705,31,138,31,509646,166798,44059,82197,1.321109491826131,0.33011506255145684
1704,0.1706,40,151,40,509797,166647,44099,82157,1.3199135090609555,0.3302077137023521
1705,0.1707,30,123,30,509920,166524,44129,82127,1.3189392979343555,0.33029024616832425
1706,0.1708,29,123,29,510043,166401,44158,82098,1.3179650868077557,0.33037557495201186
1707,0.1709,31,169,31,510212,166232,44189,82067,1.3166265365606387,0.3305168365559265
1708,0.171,28,144,28,510356,166088,44217,82039,1.3154859967051071,0.33063310320924366
1709,0.1711,34,144,34,510500,165944,44251,82005,1.3143454568495754,0.3307333362909308
1710,0.1712,34,139,34,510639,165805,44285,81971,1.313244519072361,0.3308270373240346
1711,0.1713,34,126,34,510765,165679,44319,81937,1.3122465466987707,0.3309034957353321
1712,0.1714,31,155,31,510920,165524,44350,81906,1.3110188822709417,0.33102695711918523
1713,0.1715,35,130,35,511050,165394,44385,81871,1.3099892282346977,0.33110630295432025
1714,0.1716,28,142,28,511192,165252,44413,81843,1.308864529210493,0.3312207855278334
1715,0.1717,38,142,38,511334,165110,44451,81805,1.3077398301862881,0.3313083449770164
1716,0.1718,37,146,37,511480,164964,44488,81768,1.3065834494994297,0.33140411458586644
1717,0.1719,35,154,35,511634,164810,44523,81733,1.305363705487264,0.33151620609792204
1718,0.172,35,136,35,511770,164674,44558,81698,1.3042865289570396,0.33160424074164274
1719,0.1721,32,145,32,511915,164529,44590,81666,1.3031380686858447,0.3317126667885213
1720,0.1722,34,130,34,512045,164399,44624,81632,1.302108414649601,0.3317955867350049
1721,0.1723,35,129,35,512174,164270,44659,81597,1.3010866810290205,0.3318745500616187
1722,0.1724,29,144,29,512318,164126,44688,81568,1.2999461411734887,0.3319901991908634
1723,0.1725,22,136,22,512454,163990,44710,81546,1.2988689646432645,0.33211423172162124
1724,0.1726,31,143,31,512597,163847,44741,81515,1.2977363452033963,0.3322234086777904
1725,0.1727,26,126,26,512723,163721,44767,81489,1.296738372829806,0.33232331470984056
1726,0.1728,32,148,32,512871,163573,44799,81457,1.2955661513116208,0.33243684446802435
1727,0.1729,32,128,32,512999,163445,44831,81425,1.294552338106704,0.3325233797525217
1728,0.173,29,131,29,513130,163314,44860,81396,1.2935147636547966,0.3326222876057374
1729,0.1731,35,156,35,513286,163158,44895,81361,1.292279178811304,0.3327389691598608
1730,0.1732,34,148,34,513434,163010,44929,81327,1.2911069572931186,0.3328476653147088
1731,0.1733,33,143,33,513577,162867,44962,81294,1.2899743378532504,0.3329524371214076
1732,0.1734,36,126,36,513703,162741,44998,81258,1.2889763654796604,0.33302595502440585
1733,0.1735,32,143,32,513846,162598,45030,81226,1.2878437460397922,0.33313373580943634
1734,0.1736,27,142,27,513988,162456,45057,81199,1.2867190470155874,0.3332539861689684
1735,0.1737,32,155,32,514143,162301,45089,81167,1.2854913825877583,0.33337851380879624
1736,0.1738,39,128,39,514271,162173,45128,81128,1.2844775693828412,0.33344704707337824
1737,0.1739,37,148,37,514419,162025,45165,81091,1.2833053478646559,0.3335485940867734
1738,0.174,32,161,32,514580,161864,45197,81059,1.2820301609428464,0.333681866270382
1739,0.1741,19,122,19,514702,161742,45216,81040,1.2810638702319097,0.3337973984891796
1740,0.1742,24,147,24,514849,161595,45240,81016,1.279899569129388,0.3339337457905866
1741,0.1743,23,125,23,514974,161470,45263,80993,1.278909517171461,0.3340427199201528
1742,0.1744,36,156,36,515130,161314,45299,80957,1.2776739323279687,0.334158855166322
1743,0.1745,30,128,30,515258,161186,45329,80927,1.2766601191230516,0.3342530140884628
1744,0.1746,33,150,33,515408,161036,45362,80894,1.2754720567735394,0.33436944570743604
1745,0.1747,28,127,28,515535,160909,45390,80866,1.2744661639842858,0.3344679971047462
1746,0.1748,39,150,39,515685,160759,45429,80827,1.2732781016347738,0.3345682282913745
1747,0.1749,32,136,32,515821,160623,45461,80795,1.2722009251045494,0.3346685002775269
1748,0.175,33,138,33,515959,160485,45494,80762,1.2711079077429983,0.33476892976907485
1749,0.1751,30,118,30,516077,160367,45524,80732,1.2701732986947154,0.33484999937784893
1750,0.1752,24,119,24,516196,160248,45548,80708,1.2692307692307692,0.3349491193412905
1751,0.1753,34,137,34,516333,160111,45582,80674,1.2681456722848816,0.335045787735947
1752,0.1754,28,110,28,516443,160001,45610,80646,1.267274426561906,0.335121568105981
1753,0.1755,34,149,34,516592,159852,45644,80612,1.2660942846280572,0.33523521192361433
1754,0.1756,35,135,35,516727,159717,45679,80577,1.2650250285134963,0.33532672476216635
1755,0.1757,28,138,28,516865,159579,45707,80549,1.2639320111519452,0.33544193097014924
1756,0.1758,34,138,34,517003,159441,45741,80515,1.262838993790394,0.3355406824584507
1757,0.1759,37,151,37,517154,159290,45778,80478,1.2616430110252186,0.33564946114577426
1758,0.176,27,130,27,517284,159160,45805,80451,1.2606133569889748,0.3357567056604246
1759,0.1761,37,159,37,517443,159001,45842,80414,1.259354010898492,0.33587703360274
1760,0.1762,28,131,28,517574,158870,45870,80386,1.2583164364465846,0.33598321463202596
1761,0.1763,26,148,26,517722,158722,45896,80360,1.2571442149283993,0.33611898846420896
1762,0.1764,27,118,27,517840,158604,45923,80333,1.2562096058801167,0.33620996329576414
1763,0.1765,31,135,31,517975,158469,45954,80302,1.2551403497655558,0.33631387396291845
1764,0.1766,34,133,34,518108,158336,45988,80268,1.2540869344823216,0.3364067660223634
1765,0.1767,27,154,27,518262,158182,46015,80241,1.2528671904701558,0.33654890677493365
1766,0.1768,29,149,29,518411,158033,46044,80212,1.2516870485363072,0.33667862914226954
1767,0.1769,37,116,37,518527,157917,46081,80175,1.2507682803193512,0.33673957965828333
1768,0.177,27,147,27,518674,157770,46108,80148,1.2496039792168292,0.3368723677905833
1769,0.1771,29,128,29,518802,157642,46137,80119,1.2485901660119123,0.3369728424762682
1770,0.1772,35,124,35,518926,157518,46172,80084,1.247608034469649,0.33705103492394844
1771,0.1773,24,107,24,519033,157411,46196,80060,1.2467605499936636,0.3371359029102501
1772,0.1774,32,145,32,519178,157266,46228,80028,1.2456120897224687,0.33725252218766594
1773,0.1775,33,137,33,519315,157129,46261,79995,1.244526992776581,0.3373551390833488
1774,0.1776,21,111,21,519426,157018,46282,79974,1.243647826637942,0.33745442884147986
1775,0.1777,36,136,36,519562,156882,46318,79938,1.2425706501077176,0.33754750443374715
1776,0.1778,25,126,25,519688,156756,46343,79913,1.2415726777341274,0.337657234365295
1777,0.1779,29,131,29,519819,156625,46372,79884,1.2405351032822203,0.33776304495812
1778,0.178,31,126,31,519945,156499,46403,79853,1.23953713090863,0.33785624830760896
1779,0.1781,29,135,29,520080,156364,46432,79824,1.2384678747940692,0.33796805934255764
1780,0.1782,38,140,38,520220,156224,46470,79786,1.2373590166011912,0.3380619465276895
1781,0.1783,28,133,28,520353,156091,46498,79758,1.2363056013179572,0.3381740011617603
1782,0.1784,23,106,23,520459,155985,46521,79735,1.2354660372576354,0.3382614966909893
1783,0.1785,36,124,36,520583,155861,46557,79699,1.234483905715372,0.3383384275768382
1784,0.1786,32,136,32,520719,155725,46589,79667,1.2334067291851476,0.3384439573137575
1785,0.1787,30,139,30,520858,155586,46619,79637,1.2323057914079332,0.33855957963294403
1786,0.1788,30,148,30,521006,155438,46649,79607,1.2311335698897479,0.33868833627603223
1787,0.1789,36,123,36,521129,155315,46685,79571,1.2301593587631479,0.3387643367420791
1788,0.179,32,124,32,521253,155191,46717,79539,1.2291772272208845,0.3388531504281515
1789,0.1791,25,118,25,521371,155073,46742,79514,1.2282426181726016,0.3389531389207416
1790,0.1792,22,132,22,521503,154941,46764,79492,1.227197123305031,0.3390819551854901
1791,0.1793,26,129,26,521632,154812,46790,79466,1.2261753896844507,0.33919531496768796
1792,0.1794,30,123,30,521755,154689,46820,79436,1.2252011785578507,0.3392888414308596
1793,0.1795,24,119,24,521874,154570,46844,79412,1.2242586490939045,0.33939362856971905
1794,0.1796,24,135,24,522009,154435,46868,79388,1.2231893929793436,0.3395217750178554
1795,0.1797,39,131,39,522140,154304,46907,79349,1.2221518185274363,0.33960188827021265
1796,0.1798,28,134,28,522274,154170,46935,79321,1.221090482828539,0.339717590827912
1797,0.1799,38,132,38,522406,154038,46973,79283,1.2200449879609683,0.3398022466901822
1798,0.18,39,114,39,522520,153924,47012,79244,1.219142060575339,0.3398579564948878
1799,0.1801,33,130,33,522650,153794,47045,79211,1.2181124065390951,0.3399540782386644
1800,0.1802,27,160,27,522810,153634,47072,79184,1.216845140032949,0.3401111597900506
1801,0.1803,22,140,22,522950,153494,47094,79162,1.215736281840071,0.3402534213602916
1802,0.1804,39,148,39,523098,153346,47133,79123,1.2145640603218857,0.34035935974258935
1803,0.1805,26,125,26,523223,153221,47159,79097,1.213574008363959,0.3404686679465216
1804,0.1806,35,120,35,523343,153101,47194,79062,1.2126235584843492,0.34054522038395435
1805,0.1807,22,123,22,523466,152978,47216,79040,1.2116493473577494,0.3406632244050031
1806,0.1808,36,114,36,523580,152864,47252,79004,1.21074641997212,0.3407283454379216
1807,0.1809,26,146,26,523726,152718,47278,78978,1.2095900392852617,0.3408690698156205
1808,0.181,21,144,21,523870,152574,47299,78957,1.2084494994297301,0.34102128872591575
1809,0.1811,23,120,23,523990,152454,47322,78934,1.2074990495501203,0.3411326430065518
1810,0.1812,31,123,31,524113,152331,47353,78903,1.2065248384235205,0.34122577129660864
1811,0.1813,30,134,30,524247,152197,47383,78873,1.205463502724623,0.34133812264681695
1812,0.1814,39,131,39,524378,152066,47422,78834,1.2044259282727157,0.34142052836725856
1813,0.1815,38,102,38,524480,151964,47460,78796,1.2036180458750476,0.34146299185300744
1814,0.1816,41,115,41,524595,151849,47501,78755,1.202707198073755,0.34151619226032504
1815,0.1817,25,110,25,524705,151739,47526,78730,1.2018359523507793,0.3416077650356447
1816,0.1818,34,113,34,524818,151626,47560,78696,1.2009409453808135,0.34167817229791336
1817,0.1819,35,121,35,524939,151505,47595,78661,1.1999825750855404,0.3417576879295813
1818,0.182,26,113,26,525052,151392,47621,78635,1.1990875681155746,0.3418511739926183
1819,0.1821,31,137,31,525189,151255,47652,78604,1.198002471169687,0.34196616186444734
1820,0.1822,27,119,27,525308,151136,47679,78577,1.1970599417057408,0.3420659692747037
1821,0.1823,43,139,43,525447,150997,47722,78534,1.1959590039285262,0.34214986211012893
1822,0.1824,23,130,23,525577,150867,47745,78511,1.1949293498922824,0.34227781217030406
1823,0.1825,33,124,33,525701,150743,47778,78478,1.193947218350019,0.34236828213819853
1824,0.1826,31,124,31,525825,150619,47809,78447,1.1929650868077557,0.3424646171845669
1825,0.1827,33,117,33,525942,150502,47842,78414,1.1920383981751361,0.3425448636180957
1826,0.1828,29,118,29,526060,150384,47871,78385,1.1911037891268534,0.3426382070997382
1827,0.1829,33,142,33,526202,150242,47904,78352,1.1899790901026486,0.34275615282990807
1828,0.183,25,137,25,526339,150105,47929,78327,1.1888939931567608,0.34288978777054
1829,0.1831,28,125,28,526464,149980,47957,78299,1.1879039411988341,0.34299694671870823
1830,0.1832,32,115,32,526579,149865,47989,78267,1.1869930933975414,0.34307769186260584
1831,0.1833,32,127,32,526706,149738,48021,78235,1.1859872006082879,0.34317660424699414
1832,0.1834,25,137,25,526843,149601,48046,78210,1.1849021036624001,0.343310902458617
1833,0.1835,33,127,33,526970,149474,48079,78177,1.1838962108731466,0.3434072330013925
1834,0.1836,33,118,33,527088,149356,48112,78144,1.1829616018248639,0.34349010989010986
1835,0.1837,22,137,22,527225,149219,48134,78122,1.181876504878976,0.34363357247482856
1836,0.1838,20,117,20,527342,149102,48154,78102,1.1809498162463565,0.34375275083185153
1837,0.1839,40,127,40,527469,148975,48194,78062,1.179943923457103,0.3438294198742936
1838,0.184,39,131,39,527600,148844,48233,78023,1.1789063490051959,0.3439151573388814
1839,0.1841,24,123,24,527723,148721,48257,77999,1.1779321378785959,0.34403228652081863
1840,0.1842,39,122,39,527845,148599,48296,77960,1.1769658471676594,0.34410462616801807
1841,0.1843,37,149,37,527994,148450,48333,77923,1.1757857052338108,0.34422391362927557
1842,0.1844,25,143,25,528137,148307,48358,77898,1.1746530857939426,0.3443690457770606
1843,0.1845,35,103,35,528240,148204,48393,77863,1.1738372829806107,0.34442444054196325
1844,0.1846,37,124,37,528364,148080,48430,77826,1.1728551514383474,0.3445061220153515
1845,0.1847,24,125,24,528489,147955,48454,77802,1.1718650994804207,0.34462718763980743
1846,0.1848,34,106,34,528595,147849,48488,77768,1.171025535420099,0.34469033805076743
1847,0.1849,39,146,39,528741,147703,48527,77729,1.1698691547332405,0.3448002058270343
1848,0.185,28,116,28,528857,147587,48555,77701,1.1689503865162845,0.34489631050033737
1849,0.1851,32,150,32,529007,147437,48587,77669,1.1677623241667723,0.3450330066724121
1850,0.1852,23,126,23,529133,147311,48610,77646,1.166764351793182,0.3451592971101144
1851,0.1853,38,107,38,529240,147204,48648,77608,1.165916867317197,0.34521288899169084
1852,0.1854,28,143,28,529383,147061,48676,77580,1.1647842478773287,0.34535102674934676
1853,0.1855,25,151,25,529534,146910,48701,77555,1.1635882651121532,0.3455104359254227
1854,0.1856,33,127,33,529661,146783,48734,77522,1.1625823723228994,0.34560977240810503
1855,0.1857,23,135,23,529796,146648,48757,77499,1.1615131162083385,0.34575077962230144
1856,0.1858,23,141,23,529937,146507,48780,77476,1.1603963375997972,0.34590125143426065
1857,0.1859,27,122,27,530059,146385,48807,77449,1.1594300468888608,0.3460108830651286
1858,0.186,33,109,33,530168,146276,48840,77416,1.1585667215815485,0.34608300699175654
1859,0.1861,38,138,38,530306,146138,48878,77378,1.1574737042199974,0.34618550797258363
1860,0.1862,39,125,39,530431,146013,48917,77339,1.1564836522620707,0.3462650882911279
1861,0.1863,27,125,27,530556,145888,48944,77312,1.155493600304144,0.3463799283154122
1862,0.1864,37,99,37,530655,145789,48981,77275,1.154709479153466,0.34642524118638596
1863,0.1865,31,124,31,530779,145665,49012,77244,1.1537273476112027,0.34652705812685897
1864,0.1866,33,134,33,530913,145531,49045,77211,1.152666011912305,0.3466387120525092
1865,0.1867,24,140,24,531053,145391,49069,77187,1.1515571537194271,0.3467862951414785
1866,0.1868,30,112,30,531165,145279,49099,77157,1.1506700671651249,0.34687280835835926
1867,0.1869,27,99,27,531264,145180,49126,77130,1.1498859460144468,0.34694795555755475
1868,0.187,24,115,24,531379,145065,49150,77106,1.1489750982131541,0.347056996637725
1869,0.1871,36,110,36,531489,144955,49186,77070,1.1481038524901788,0.347123071726157
1870,0.1872,28,121,28,531610,144834,49214,77042,1.1471454821949056,0.3472299843155636
1871,0.1873,26,118,26,531728,144716,49240,77016,1.1462108731466227,0.34733822813125753
1872,0.1874,35,110,35,531838,144606,49275,76981,1.1453396274236471,0.34740756452318955
1873,0.1875,22,130,22,531968,144476,49297,76959,1.1443099733874034,0.3475466841285253
1874,0.1876,31,106,31,532074,144370,49328,76928,1.1434704093270815,0.3476217588952453
1875,0.1877,31,115,31,532189,144255,49359,76897,1.1425595615257889,0.347711076544639
1876,0.1878,25,118,25,532307,144137,49384,76872,1.141624952477506,0.34782293933731206
1877,0.1879,33,119,33,532426,144018,49417,76839,1.1406824230135597,0.3479129029190834
1878,0.188,25,123,25,532549,143895,49442,76814,1.13970821188696,0.34803293023845877
1879,0.1881,35,123,35,532672,143772,49477,76779,1.13873400076036,0.34812356325747784
1880,0.1882,18,109,18,532781,143663,49495,76761,1.1378706754530479,0.34824247813305265
1881,0.1883,22,107,22,532888,143556,49517,76739,1.1370231909770625,0.3483465353276289
1882,0.1884,25,111,25,532999,143445,49542,76714,1.1361440248384236,0.3484481670065725
1883,0.1885,25,134,25,533133,143311,49567,76689,1.135082689139526,0.34858636363636364
1884,0.1886,30,135,30,533268,143176,49597,76659,1.1340134330249652,0.34871153365023766
1885,0.1887,33,124,33,533392,143052,49630,76626,1.1330313014827018,0.3488105317783301
1886,0.1888,28,118,28,533510,142934,49658,76598,1.132096692434419,0.34891496456097515
1887,0.1889,27,114,27,533624,142820,49685,76571,1.1311937650487898,0.3490161401333692
1888,0.189,30,109,30,533733,142711,49715,76541,1.1303304397414777,0.3491005783299582
1889,0.1891,35,118,35,533851,142593,49750,76506,1.1293958306931948,0.34918461517396243
1890,0.1892,33,127,33,533978,142466,49783,76473,1.1283899379039413,0.34928907138518034
1891,0.1893,34,125,34,534103,142341,49817,76439,1.1273998859460144,0.34938751256970474
1892,0.1894,26,135,26,534238,142206,49843,76413,1.1263306298314535,0.349525887502916
1893,0.1895,21,118,21,534356,142088,49864,76392,1.1253960207831708,0.3496521420725009
1894,0.1896,39,131,39,534487,141957,49903,76353,1.1243584463312635,0.34974577435756493
1895,0.1897,29,110,29,534597,141847,49932,76324,1.1234872006082879,0.34983567935243454
1896,0.1898,32,122,32,534719,141725,49964,76292,1.1225209098973514,0.3499360141640331
1897,0.1899,36,111,36,534830,141614,50000,76256,1.1216417437587125,0.35000688483958325
1898,0.19,35,119,35,534949,141495,50035,76221,1.1206992142947663,0.3500937000496059
1899,0.1901,35,147,35,535096,141348,50070,76186,1.1195349131922443,0.3502257118427464
1900,0.1902,22,127,22,535223,141221,50092,76164,1.1185290204029907,0.3503645605722566
1901,0.1903,31,132,31,535355,141089,50123,76133,1.11748352553542,0.3504847575291637
1902,0.1904,29,115,29,535470,140974,50152,76104,1.1165726777341274,0.3505836611724818
1903,0.1905,39,120,39,535590,140854,50191,76065,1.1156222278545178,0.350660845753484
1904,0.1906,32,102,32,535692,140752,50223,76033,1.1148143454568495,0.3507299859307609
1905,0.1907,22,98,22,535790,140654,50245,76011,1.114038144721835,0.35082269863614335
1906,0.1908,30,111,30,535901,140543,50275,75981,1.1131589785831961,0.3509126009126009
1907,0.1909,34,123,34,536024,140420,50309,75947,1.1121847674565961,0.35101008933894723
1908,0.191,34,121,34,536145,140299,50343,75913,1.111226397161323,0.351104471537195
1909,0.1911,31,129,31,536274,140170,50374,75882,1.1102046635407425,0.3512210023512858
1910,0.1912,29,104,29,536378,140066,50403,75853,1.1093809403117476,0.3513030349343967
1911,0.1913,34,125,34,536503,139941,50437,75819,1.1083908883538207,0.3514043381535039
1912,0.1914,33,144,33,536647,139797,50470,75786,1.1072503484982892,0.35153977818288085
1913,0.1915,33,122,33,536769,139675,50503,75753,1.1062840577873527,0.3516395268952968
1914,0.1916,32,127,32,536896,139548,50535,75721,1.1052781649980992,0.3517506004115781
1915,0.1917,33,140,33,537036,139408,50568,75688,1.1041693068052212,0.3518800907501767
1916,0.1918,21,138,21,537174,139270,50589,75667,1.10307628944367,0.35204269157939305
1917,0.1919,30,128,30,537302,139142,50619,75637,1.102062476238753,0.3521619897662248
1918,0.192,35,110,35,537412,139032,50654,75602,1.1011912305157774,0.35223683107056664
1919,0.1921,24,122,24,537534,138910,50678,75578,1.100224939804841,0.3523647010555369
1920,0.1922,39,102,39,537636,138808,50717,75539,1.0994170574071727,0.35241454277409995
1921,0.1923,36,134,36,537770,138674,50753,75503,1.0983557217082753,0.3525261816161399
1922,0.1924,41,121,41,537891,138553,50794,75462,1.0973973514130022,0.3526014531691704
1923,0.1925,25,109,25,538000,138444,50819,75437,1.09653402610569,0.3527054764097793
1924,0.1926,34,113,34,538113,138331,50853,75403,1.0956390191357241,0.352788980695631
1925,0.1927,31,104,31,538217,138227,50884,75372,1.0948152959067292,0.3528668205375493
1926,0.1928,27,110,27,538327,138117,50911,75345,1.0939440501837536,0.3529668043960986
1927,0.1929,33,121,33,538448,137996,50944,75312,1.0929856798884805,0.35306692669754536
1928,0.193,36,114,36,538562,137882,50980,75276,1.0920827525028514,0.35314649227333716
1929,0.1931,23,116,23,538678,137766,51003,75253,1.0911639842858953,0.35326895722916735
1930,0.1932,30,120,30,538798,137646,51033,75223,1.0902135344062855,0.3533769595384955
1931,0.1933,29,108,29,538906,137538,51062,75194,1.0893581295146368,0.3534682135268789
1932,0.1934,19,118,19,539024,137420,51081,75175,1.0884235204663542,0.35360662292151746
1933,0.1935,34,106,34,539130,137314,51115,75141,1.0875839564060321,0.35367960273940363
1934,0.1936,32,118,32,539248,137196,51147,75109,1.0866493473577494,0.3537787616871953
1935,0.1937,32,143,32,539391,137053,51179,75077,1.0855167279178812,0.35391976618111537
1936,0.1938,27,117,27,539508,136936,51206,75050,1.0845900392852617,0.3540328134876832
1937,0.1939,19,108,19,539616,136828,51225,75031,1.083734634393613,0.3541553580447373
1938,0.194,23,120,23,539736,136708,51248,75008,1.0827841845140034,0.3542859302083924
1939,0.1941,33,111,33,539847,136597,51281,74975,1.0819050183753642,0.35437108880192086
1940,0.1942,25,110,25,539957,136487,51306,74950,1.0810337726523889,0.3544791119813467
1941,0.1943,28,103,28,540060,136384,51334,74922,1.080217969839057,0.3545663634728782
1942,0.1944,26,108,26,540168,136276,51360,74896,1.0793625649474083,0.35466823253082796
1943,0.1945,34,110,34,540278,136166,51394,74862,1.078491319224433,0.3547491328164983
1944,0.1946,35,112,35,540390,136054,51429,74827,1.0776042326701305,0.3548304494003727
1945,0.1947,32,123,32,540513,135931,51461,74795,1.0766300215435307,0.3549395897990756
1946,0.1948,32,130,32,540643,135801,51493,74763,1.0756003675072867,0.3550606941357497
1947,0.1949,33,118,33,540761,135683,51526,74730,1.074665758459004,0.35515866415097924
1948,0.195,25,124,25,540885,135559,51551,74705,1.0736836269167407,0.35529144313815014
1949,0.1951,32,134,32,541019,135425,51583,74673,1.0726222912178431,0.3554198516882598
1950,0.1952,23,103,23,541122,135322,51606,74650,1.0718064884045115,0.35552359362200675
1951,0.1953,24,118,24,541240,135204,51630,74626,1.0708718793562286,0.355649811752371
1952,0.1954,18,130,18,541370,135074,51648,74608,1.0698422253199849,0.3558149960416249
1953,0.1955,26,96,26,541466,134978,51674,74582,1.069081865416297,0.35589807215117386
1954,0.1956,27,105,27,541571,134873,51701,74555,1.0682502217716385,0.35599346792214986
1955,0.1957,35,116,35,541687,134757,51736,74520,1.0673314535546825,0.3560830860534125
1956,0.1958,30,111,30,541798,134646,51766,74490,1.0664522874160436,0.3561797108101905
1957,0.1959,35,115,35,541913,134531,51801,74455,1.065541439614751,0.3562678839730891
1958,0.196,37,108,37,542021,134423,51838,74418,1.0646860347231022,0.35633807537791906
1959,0.1961,31,114,31,542135,134309,51869,74387,1.063783107337473,0.35643711427147623
1960,0.1962,26,124,26,542259,134185,51895,74361,1.0628009757952097,0.35656881455410316
1961,0.1963,38,114,38,542373,134071,51933,74323,1.0618980484095806,0.35664654452623396
1962,0.1964,44,121,44,542494,133950,51977,74279,1.0609396781143074,0.35671784429642367
1963,0.1965,34,119,34,542613,133831,52011,74245,1.0599971486503612,0.3568167400372941
1964,0.1966,32,108,32,542721,133723,52043,74213,1.0591417437587125,0.35690308556478917
1965,0.1967,31,98,31,542819,133625,52074,74182,1.0583655430236978,0.35697546280924125
1966,0.1968,35,111,35,542930,133514,52109,74147,1.0574863768850589,0.35705789724599224
1967,0.1969,28,98,28,543028,133416,52137,74119,1.0567101761500444,0.35713975955862864
1968,0.197,38,117,38,543145,133299,52175,74081,1.055783487517425,0.35722345452791976
1969,0.1971,28,113,28,543258,133186,52203,74053,1.0548884805474592,0.35733139032711025
1970,0.1972,25,89,25,543347,133097,52228,74028,1.0541835635534154,0.35740736270368134
1971,0.1973,32,120,32,543467,132977,52260,73996,1.0532331136738056,0.3575152314553106
1972,0.1974,32,114,32,543581,132863,52292,73964,1.0523301862881764,0.35761288419790455
1973,0.1975,22,104,22,543685,132759,52314,73942,1.0515064630591813,0.3577244425522857
1974,0.1976,20,118,20,543803,132641,52334,73922,1.0505718540108986,0.35786660728203984
1975,0.1977,31,120,31,543923,132521,52365,73891,1.0496214041312888,0.35797821832064025
1976,0.1978,22,128,22,544051,132393,52387,73869,1.048607590926372,0.3581318905081886
1977,0.1979,25,114,25,544165,132279,52412,73844,1.0477046635407425,0.35825211160326603
1978,0.198,24,103,24,544268,132176,52436,73820,1.046888860727411,0.35835647294122214
1979,0.1981,28,107,28,544375,132069,52464,73792,1.0460413762514256,0.35845546266655653
1980,0.1982,30,111,30,544486,131958,52494,73762,1.0451622101127866,0.3585553179078359
1981,0.1983,24,117,24,544603,131841,52518,73738,1.0442355214801673,0.358684495984512
1982,0.1984,29,128,29,544731,131713,52547,73709,1.0432217082752502,0.3588174586947844
1983,0.1985,27,104,27,544835,131609,52574,73682,1.0423979850462552,0.3589149061576007
1984,0.1986,24,104,24,544939,131505,52598,73658,1.04157426181726,0.35902185091853794
1985,0.1987,28,124,28,545063,131381,52626,73630,1.0405921302749968,0.3591514601655521
1986,0.1988,28,107,28,545170,131274,52654,73602,1.0397446457990116,0.3592514496573537
1987,0.1989,29,111,29,545281,131163,52683,73573,1.0388654796603727,0.3593554626445764
1988,0.199,22,122,22,545403,131041,52705,73551,1.037899188949436,0.3595008602486901
1989,0.1991,26,102,26,545505,130939,52731,73525,1.0370913065517677,0.3595987557711871
1990,0.1992,29,97,29,545602,130842,52760,73496,1.0363230262324166,0.3596785717781323
1991,0.1993,33,97,33,545699,130745,52793,73463,1.0355547459130656,0.3597459453106636
1992,0.1994,25,90,25,545789,130655,52818,73438,1.0348419085033582,0.35982615768301707
1993,0.1995,26,116,26,545905,130539,52844,73412,1.0339231402864022,0.35994920348515086
1994,0.1996,22,105,22,546010,130434,52866,73390,1.0330914966417437,0.36006554674621244
1995,0.1997,36,105,36,546115,130329,52902,73354,1.0322598529970852,0.36013805766804297
1996,0.1998,23,119,23,546234,130210,52925,73331,1.031317323533139,0.36027630796743654
1997,0.1999,19,112,19,546346,130098,52944,73312,1.0304302369788367,0.36041492551988596
1998,0.2,29,103,29,546449,129995,52973,73283,1.029614434165505,0.3605063017148929
1999,0.2001,27,97,27,546546,129898,53000,73256,1.0288461538461537,0.3605934414286699
2000,0.2002,18,105,18,546651,129793,53018,73238,1.0280145102014955,0.360723239308283
2001,0.2003,26,124,26,546775,129669,53044,73212,1.0270323786592321,0.3608617859730581
2002,0.2004,30,116,30,546891,129553,53074,73182,1.0261136104422761,0.36097368485954573
2003,0.2005,23,126,23,547017,129427,53097,73159,1.0251156380686859,0.36112564540491443
2004,0.2006,32,104,32,547121,129323,53129,73127,1.0242919148396907,0.3612101753519387
2005,0.2007,21,94,21,547215,129229,53150,73106,1.0235473957673298,0.36131168606518893
2006,0.2008,31,102,31,547317,129127,53181,73075,1.0227395133696617,0.3613960297128614
2007,0.2009,21,109,21,547426,129018,53202,73054,1.0218761880623495,0.3615246050912546
2008,0.201,27,108,27,547534,128910,53229,73027,1.0210207831707008,0.36163258838152496
2009,0.2011,29,95,29,547629,128815,53258,72998,1.0202683436826765,0.3617110889784107
2010,0.2012,30,119,30,547748,128696,53288,72968,1.0193258142187303,0.36182957791177406
2011,0.2013,41,105,41,547853,128591,53329,72927,1.0184941705740718,0.36188826804553437
2012,0.2014,29,126,29,547979,128465,53358,72898,1.0174961982004815,0.36202281451905266
2013,0.2015,27,126,27,548105,128339,53385,72871,1.0164982258268913,0.36216390835445555
2014,0.2016,27,121,27,548226,128218,53412,72844,1.0155398555316184,0.36229620714008615
2015,0.2017,31,90,31,548316,128128,53443,72813,1.014827018121911,0.3623600957494986
2016,0.2018,31,119,31,548435,128009,53474,72782,1.0138844886579648,0.3624764058150017
2017,0.2019,37,100,37,548535,127909,53511,72745,1.0130924470916234,0.36253949584857514
2018,0.202,39,97,39,548632,127812,53550,72706,1.0123241667722722,0.3625908895959465
2019,0.2021,25,97,25,548729,127715,53575,72681,1.011555886452921,0.36268687997764426
2020,0.2022,22,103,22,548832,127612,53597,72659,1.0107400836395894,0.36280340139111505
2021,0.2023,31,131,31,548963,127481,53628,72628,1.0097025091876821,0.36294219650290593
2022,0.2024,29,103,29,549066,127378,53657,72599,1.0088867063743505,0.363036749226161
2023,0.2025,24,105,24,549171,127273,53681,72575,1.008055062729692,0.3631509947560146
2024,0.2026,21,91,21,549262,127182,53702,72554,1.0073343049043213,0.3632494893259102
2025,0.2027,28,102,28,549364,127080,53730,72526,1.0065264225066533,0.3633457912086811
2026,0.2028,36,111,36,549475,126969,53766,72490,1.005647256368014,0.36343308649897976
2027,0.2029,34,105,34,549580,126864,53800,72456,1.0048156127233556,0.36351595424443106
2028,0.203,19,97,19,549677,126767,53819,72437,1.0040473324040045,0.363632256380394
2029,0.2031,19,111,19,549788,126656,53838,72418,1.0031681662653655,0.36377427489275344
2030,0.2032,28,93,28,549881,126563,53866,72390,1.0024315676086681,0.363854779772107
2031,0.2033,30,123,30,550004,126440,53896,72360,1.0014573564820681,0.3639839034205231
2032,0.2034,22,88,22,550092,126352,53918,72338,1.0007603599036878,0.36407468921435404
2033,0.2035,26,101,26,550193,126251,53944,72312,0.9999603979216829,0.36417660893519943
2034,0.2036,35,104,35,550297,126147,53979,72277,0.9991366746926879,0.36425533201628835
2035,0.2037,18,108,18,550405,126039,53997,72259,0.9982812698010392,0.3643960100454871
2036,0.2038,33,96,33,550501,125943,54030,72226,0.9975209098973514,0.36446669257048275
2037,0.2039,25,84,25,550585,125859,54055,72201,0.9968555949816247,0.36454104816722205
2038,0.204,34,102,34,550687,125757,54089,72167,0.9960477125839564,0.36461975303651906
2039,0.2041,31,111,31,550798,125646,54120,72136,0.9951685464453175,0.36472479800993013
2040,0.2042,30,97,30,550895,125549,54150,72106,0.9944002661259663,0.36480736637069644
2041,0.2043,23,98,23,550993,125451,54173,72083,0.9936240653909517,0.36491439448398755
2042,0.2044,29,114,29,551107,125337,54202,72054,0.9927211380053225,0.3650318403574631
2043,0.2045,26,97,26,551204,125240,54228,72028,0.9919528576859714,0.36512764361173633
2044,0.2046,27,98,27,551302,125142,54255,72001,0.9911766569509568,0.36522219911434844
2045,0.2047,31,113,31,551415,125029,54286,71970,0.990281649980991,0.36533180371473967
2046,0.2048,29,95,29,551510,124934,54315,71941,0.9895292104929667,0.36541460317460317
2047,0.2049,22,130,22,551640,124804,54337,71919,0.9884995564567228,0.3655851120611215
2048,0.205,27,107,27,551747,124697,54364,71892,0.9876520719807376,0.3656969616814776
2049,0.2051,24,90,24,551837,124607,54388,71868,0.9869392345710303,0.3657869958009925
2050,0.2052,25,105,25,551942,124502,54413,71843,0.9861075909263718,0.3659018564261886
2051,0.2053,25,90,25,552032,124412,54438,71818,0.9853947535166645,0.3659888905875758
2052,0.2054,25,92,25,552124,124320,54463,71793,0.9846660752756304,0.36607976013828764
2053,0.2055,30,102,30,552226,124218,54493,71763,0.9838581928779623,0.3661732514886647
2054,0.2056,23,89,23,552315,124129,54516,71740,0.9831532758839184,0.36626520786852435
2055,0.2057,23,97,23,552412,124032,54539,71717,0.9823849955645673,0.3663722420037906
2056,0.2058,20,112,20,552524,123920,54559,71697,0.9814979090102649,0.3665172249855585
2057,0.2059,32,95,32,552619,123825,54591,71665,0.9807454695222405,0.36659164151619006
2058,0.206,32,109,32,552728,123716,54623,71633,0.9798821442149284,0.366692432518211
2059,0.2061,32,116,32,552844,123600,54655,71601,0.9789633759979723,0.3668065225075691
2060,0.2062,30,109,30,552953,123491,54685,71571,0.9781000506906602,0.3669141093601009
2061,0.2063,30,102,30,553055,123389,54715,71541,0.977292168292992,0.367008669778895
2062,0.2064,32,105,32,553160,123284,54747,71509,0.9764605246483335,0.36710251395070664
2063,0.2065,28,94,28,553254,123190,54775,71481,0.9757160055759726,0.3671887440861762
2064,0.2066,26,109,26,553363,123081,54801,71455,0.9748526802686605,0.36730990664966895
2065,0.2067,39,103,39,553466,122978,54840,71416,0.9740368774553289,0.36737759395866126
2066,0.2068,47,108,47,553574,122870,54887,71369,0.9731814725636801,0.3674287861860903
2067,0.2069,26,73,26,553647,122797,54913,71343,0.9726032822202509,0.3674822293190481
2068,0.207,30,101,30,553748,122696,54943,71313,0.9718033202382461,0.3675757310227876
2069,0.2071,32,96,32,553844,122600,54975,71281,0.9710429603345584,0.3676533543771695
2070,0.2072,29,93,29,553937,122507,55004,71252,0.9703063616778609,0.36773517617246165
2071,0.2073,30,105,30,554042,122402,55034,71222,0.9694747180332024,0.36783663182250137
2072,0.2074,21,124,21,554166,122278,55055,71201,0.9684925864909391,0.36800376268225493
2073,0.2075,23,111,23,554277,122167,55078,71178,0.9676134203523001,0.36813985362952234
2074,0.2076,27,101,27,554378,122066,55105,71151,0.9668134583702953,0.36824399509359945
2075,0.2077,31,109,31,554487,121957,55136,71120,0.9659501330629832,0.36835045085639406
2076,0.2078,28,102,28,554589,121855,55164,71092,0.9651422506653149,0.36845351314091435
2077,0.2079,18,119,18,554708,121736,55182,71074,0.9641997212013687,0.36862195944193765
2078,0.208,28,82,28,554790,121654,55210,71046,0.9635502471169687,0.3686870783601453
2079,0.2081,31,109,31,554899,121545,55241,71015,0.9626869218096565,0.3687941420855837
2080,0.2082,28,107,28,555006,121438,55269,70987,0.9618394373336713,0.3689073665064311
2081,0.2083,32,103,32,555109,121335,55301,70955,0.9610236345203397,0.36899994799521557
2082,0.2084,23,105,23,555214,121230,55324,70932,0.9601919908756812,0.36912604989540077
2083,0.2085,29,101,29,555315,121129,55353,70903,0.9593920288936764,0.3692249208465256
2084,0.2086,24,102,24,555417,121027,55377,70879,0.9585841464960081,0.3693422821589737
2085,0.2087,15,95,15,555512,120932,55392,70864,0.9578317070079838,0.3694759014786544
2086,0.2088,20,123,20,555635,120809,55412,70844,0.9568574958813838,0.36964722701966574
2087,0.2089,31,87,31,555722,120722,55443,70813,0.9561684197186668,0.36971310726499074
2088,0.209,28,103,28,555825,120619,55471,70785,0.9553526169053352,0.36981985747424295
2089,0.2091,25,112,25,555937,120507,55496,70760,0.9544655303510329,0.36995404330072623
2090,0.2092,26,112,26,556049,120395,55522,70734,0.9535784437967304,0.37008512575276387
2091,0.2093,28,107,28,556156,120288,55550,70706,0.9527309593207451,0.37020011099825123
2092,0.2094,33,119,33,556275,120169,55583,70673,0.9517884298567989,0.37032204650967815
2093,0.2095,27,107,27,556382,120062,55610,70646,0.9509409453808136,0.37044067370010697
2094,0.2096,40,102,40,556484,119960,55650,70606,0.9501330629831454,0.3705068060409517
2095,0.2097,25,109,25,556593,119851,55675,70581,0.9492697376758332,0.37063623760712483
2096,0.2098,27,117,27,556710,119734,55702,70554,0.9483430490432138,0.3707748255276213
2097,0.2099,18,111,18,556821,119623,55720,70536,0.9474638829045748,0.3709316940034392
2098,0.21,24,109,24,556930,119514,55744,70512,0.9466005575972627,0.3710650121562313
2099,0.2101,31,105,31,557035,119409,55775,70481,0.9457689139526042,0.3711675180367581
2100,0.2102,21,105,21,557140,119304,55796,70460,0.9449372703079457,0.37130330305010434
2101,0.2103,25,100,25,557240,119204,55821,70435,0.9441452287416043,0.3714162171283333
2102,0.2104,27,99,27,557339,119105,55848,70408,0.9433611075909264,0.3715206872351765
2103,0.2105,28,104,28,557443,119001,55876,70380,0.9425373843619314,0.37163178988388484
2104,0.2106,21,115,21,557558,118886,55897,70359,0.9416265365606387,0.37178789399984147
2105,0.2107,31,99,31,557657,118787,55928,70328,0.9408424154099607,0.371879544192687
2106,0.2108,29,117,29,557774,118670,55957,70299,0.9399157267773413,0.3720133990231202
2107,0.2109,31,82,31,557856,118588,55988,70268,0.9392662526929413,0.3720718430973864
2108,0.211,26,94,26,557950,118494,56014,70242,0.9385217336205804,0.3721706510681587
2109,0.2111,29,93,29,558043,118401,56043,70213,0.9377851349638829,0.3722576266873085
2110,0.2112,32,95,32,558138,118306,56075,70181,0.9370326954758585,0.37233867587685093
2111,0.2113,23,92,23,558230,118214,56098,70158,0.9363040172348245,0.3724438876266112
2112,0.2114,27,107,27,558337,118107,56125,70131,0.9354565327588392,0.37256558186976063
2113,0.2115,21,110,21,558447,117997,56146,70110,0.9345852870358636,0.37271340247837664
2114,0.2116,32,83,32,558530,117914,56178,70078,0.9339278925358003,0.37277118175241497
2115,0.2117,22,101,22,558631,117813,56200,70056,0.9331279305537955,0.3728981364674321
2116,0.2118,45,102,45,558733,117711,56245,70011,0.9323200481561272,0.3729504266947934
2117,0.2119,34,107,34,558840,117604,56279,69977,0.931472563680142,0.37304950927865826
2118,0.212,23,89,23,558929,117515,56302,69954,0.9307676466860981,0.373149694082755
2119,0.2121,28,88,28,559017,117427,56330,69926,0.9300706501077176,0.37323127999017897
2120,0.2122,31,108,31,559125,117319,56361,69895,0.9292152452160689,0.3733428055594133
2121,0.2123,28,104,28,559229,117215,56389,69867,0.9283915219870739,0.37345655915587816
2122,0.2124,28,100,28,559329,117115,56417,69839,0.9275994804207325,0.3735624806102036
2123,0.2125,30,98,30,559427,117017,56447,69809,0.9268232796857179,0.37365784205624486
2124,0.2126,20,91,20,559518,116926,56467,69789,0.9261025218603472,0.37377286238384705
2125,0.2127,32,105,32,559623,116821,56499,69757,0.9252708782156888,0.37387580529322856
2126,0.2128,24,95,24,559718,116726,56523,69733,0.9245184387276645,0.37398570195056285
2127,0.2129,28,78,28,559796,116648,56551,69705,0.9239006463059182,0.3740481773837824
2128,0.213,28,98,28,559894,116550,56579,69677,0.9231244455709036,0.37415090185633665
2129,0.2131,36,111,36,560005,116439,56615,69641,0.9222452794322646,0.3742530094582975
2130,0.2132,36,100,36,560105,116339,56651,69605,0.9214532378659233,0.3743331325560384
2131,0.2133,39,123,39,560228,116216,56690,69566,0.9204790267393232,0.37444962375257024
2132,0.2134,21,91,21,560319,116125,56711,69545,0.9197582689139526,0.37456239564819305
2133,0.2135,23,113,23,560432,116012,56734,69522,0.9188632619439868,0.3747129906108853
2134,0.2136,28,91,28,560523,115921,56762,69494,0.9181425041186162,0.374802470134563
2135,0.2137,29,89,29,560612,115832,56791,69465,0.9174375871245724,0.3748846446515594
2136,0.2138,23,92,23,560704,115740,56814,69442,0.9167089088835382,0.374993249883898
2137,0.2139,17,81,17,560785,115659,56831,69425,0.9160673552148016,0.37509995461520174
2138,0.214,23,103,23,560888,115556,56854,69402,0.91525155240147,0.3752311335546448
2139,0.2141,21,91,21,560979,115465,56875,69381,0.9145307945760993,0.3753448816852948
2140,0.2142,27,110,27,561089,115355,56902,69354,0.9136595488531238,0.37547710181961896
2141,0.2143,28,92,28,561181,115263,56930,69326,0.9129308706120898,0.3755695084755863
2142,0.2144,24,77,24,561258,115186,56954,69302,0.9123209986060068,0.37564502840293135
2143,0.2145,30,89,30,561347,115097,56984,69272,0.911616081611963,0.37572476934842625
2144,0.2146,40,104,40,561451,114993,57024,69232,0.9107923583829679,0.3758013298955082
2145,0.2147,37,90,37,561541,114903,57061,69195,0.9100795209732607,0.37585959651924516
2146,0.2148,33,65,33,561606,114838,57094,69162,0.9095646939551387,0.3758804347826087
2147,0.2149,30,96,30,561702,114742,57124,69132,0.908804334051451,0.37597485234454026
2148,0.215,33,73,33,561775,114669,57157,69099,0.9082261437080218,0.37601214574898784
2149,0.2151,31,102,31,561877,114567,57188,69068,0.9074182613103535,0.3761156642252294
2150,0.2152,29,92,29,561969,114475,57217,69039,0.9066895830693195,0.37620563008816765
2151,0.2153,24,106,24,562075,114369,57241,69015,0.9058500190089976,0.37634144745452164
2152,0.2154,22,92,22,562167,114277,57263,68993,0.9051213407679635,0.3764555028100617
2153,0.2155,31,98,31,562265,114179,57294,68962,0.904345140032949,0.3765514002872104
2154,0.2156,25,85,25,562350,114094,57319,68937,0.9036719047015588,0.37664111543946105
2155,0.2157,38,85,38,562435,114009,57357,68899,0.9029986693701686,0.3766866402781726
2156,0.2158,30,87,30,562522,113922,57387,68869,0.9023095932074515,0.37676362621792103
2157,0.2159,32,77,32,562599,113845,57419,68837,0.9016997212013687,0.37681326020078604
2158,0.216,22,109,22,562708,113736,57441,68815,0.9008363958940565,0.37696315002382896
2159,0.2161,29,92,29,562800,113644,57470,68786,0.9001077176530224,0.3770542125746862
2160,0.2162,16,95,16,562895,113549,57486,68770,0.899355278164998,0.37719601358059224
2161,0.2163,20,103,20,562998,113446,57506,68750,0.8985394753516665,0.3773408856396408
2162,0.2164,26,79,26,563077,113367,57532,68724,0.8979137625142567,0.3774156877605154
2163,0.2165,32,89,32,563166,113278,57564,68692,0.8972088455202128,0.3774907951860197
2164,0.2166,23,103,23,563269,113175,57587,68669,0.8963930427068812,0.3776258771254482
2165,0.2167,28,89,28,563358,113086,57615,68641,0.8956881257128374,0.37771492403440327
2166,0.2168,22,88,22,563446,112998,57637,68619,0.894991129134457,0.377822560663374
2167,0.2169,24,90,24,563536,112908,57661,68595,0.8942782917247497,0.37792763755970976
2168,0.217,23,108,23,563644,112800,57684,68572,0.893422886833101,0.3780737930882385
2169,0.2171,25,93,25,563737,112707,57709,68547,0.8926862881764035,0.37818199874209674
2170,0.2172,26,80,26,563817,112627,57735,68521,0.8920526549233304,0.37825976549561685
2171,0.2173,23,93,23,563910,112534,57758,68498,0.8913160562666329,0.3783750939060498
2172,0.2174,28,89,28,563999,112445,57786,68470,0.8906111392725891,0.37846502501174584
2173,0.2175,32,95,32,564094,112350,57818,68438,0.8898586997845647,0.3785538863198885
2174,0.2176,28,96,28,564190,112254,57846,68410,0.8890983398808769,0.3786587255900456
2175,0.2177,31,90,31,564280,112164,57877,68379,0.8883855024711697,0.3787407985909174
2176,0.2178,27,91,27,564371,112073,57904,68352,0.887664744645799,0.3788388527088818
2177,0.2179,29,96,29,564467,111977,57933,68323,0.8869043847421113,0.3789406544647809
2178,0.218,33,83,33,564550,111894,57966,68290,0.8862469902420479,0.3790014651689384
2179,0.2181,18,78,18,564628,111816,57984,68272,0.8856291978203016,0.3791035493758607
2180,0.2182,34,94,34,564722,111722,58018,68238,0.8848846787479407,0.37918426316959325
2181,0.2183,20,91,20,564813,111631,58038,68218,0.88416392092257,0.37930708538829794
2182,0.2184,22,98,22,564911,111533,58060,68196,0.8833877201875554,0.37943793155250405
2183,0.2185,28,101,28,565012,111432,58088,68168,0.8825877582055506,0.37955456570155904
2184,0.2186,25,103,25,565115,111329,58113,68143,0.881771955392219,0.37968596772755636
2185,0.2187,26,89,26,565204,111240,58139,68117,0.8810670383981751,0.37978445223771584
2186,0.2188,32,91,32,565295,111149,58171,68085,0.8803462805728045,0.37986654317819163
2187,0.2189,31,86,31,565381,111063,58202,68054,0.8796651248257509,0.3799416024162977
2188,0.219,26,90,26,565471,110973,58228,68028,0.8789522874160436,0.38004256959458327
2189,0.2191,19,99,19,565570,110874,58247,68009,0.8781681662653656,0.38018704963579547
2190,0.2192,30,79,30,565649,110795,58277,67979,0.8775424534279559,0.3802510432165751
2191,0.2193,33,104,33,565753,110691,58310,67946,0.8767187301989608,0.3803579325671613
2192,0.2194,19,97,19,565850,110594,58329,67927,0.8759504498796097,0.38049865281955625
2193,0.2195,36,100,36,565950,110494,58365,67891,0.8751584083132683,0.38058693275779915
2194,0.2196,27,101,27,566051,110393,58392,67864,0.8743584463312635,0.3807087519704696
2195,0.2197,27,81,27,566132,110312,58419,67837,0.873716892662527,0.3807879920740504
2196,0.2198,23,103,23,566235,110209,58442,67814,0.8729010898491952,0.3809283070165091
2197,0.2199,28,96,28,566331,110113,58470,67786,0.8721407299455075,0.3810364307837593
2198,0.22,31,85,31,566416,110028,58501,67755,0.8714674946141173,0.3811106798737787
2199,0.2201,24,82,24,566498,109946,58525,67731,0.8708180205297174,0.3812029694332975
2200,0.2202,27,93,27,566591,109853,58552,67704,0.8700814218730198,0.38130853754005756
2201,0.2203,23,88,23,566679,109765,58575,67681,0.8693844252946394,0.38141744530730476
2202,0.2204,24,78,24,566757,109687,58599,67657,0.8687666328728931,0.38150148863226274
2203,0.2205,32,105,32,566862,109582,58631,67625,0.8679349892282346,0.3816158503896573
2204,0.2206,32,100,32,566962,109482,58663,67593,0.8671429476618933,0.381719610334604
2205,0.2207,22,64,22,567026,109418,58685,67571,0.8666360410594348,0.38178078863658194
2206,0.2208,24,79,24,567105,109339,58709,67547,0.8660103282220251,0.38186741743269675
2207,0.2209,26,77,26,567182,109262,58735,67521,0.8654004562159422,0.38194283386977257
2208,0.221,26,89,26,567271,109173,58761,67495,0.8646955392218983,0.3820442864582154
2209,0.2211,31,75,31,567346,109098,58792,67464,0.8641015080471424,0.38209807319808337
2210,0.2212,26,78,26,567424,109020,58818,67438,0.863483715625396,0.3821759285495699
2211,0.2213,25,84,25,567508,108936,58843,67413,0.8628184007096692,0.3822703842947791
2212,0.2214,30,98,30,567606,108838,58873,67383,0.8620421999746547,0.38237780968216045
2213,0.2215,23,78,23,567684,108760,58896,67360,0.8614244075529084,0.3824665001135589
2214,0.2216,27,83,27,567767,108677,58923,67333,0.860767013052845,0.3825521277200159
2215,0.2217,23,86,23,567853,108591,58946,67310,0.8600858573057915,0.38265842718347254
2216,0.2218,25,81,25,567934,108510,58971,67285,0.8594443036370548,0.3827469495719446
2217,0.2219,29,77,29,568011,108433,59000,67256,0.858834431630972,0.382812811274468
2218,0.222,20,92,20,568103,108341,59020,67236,0.8581057533899379,0.3829430961914146
2219,0.2221,26,102,26,568205,108239,59046,67210,0.8572978709922697,0.38307428369497687
2220,0.2222,33,76,33,568281,108163,59079,67177,0.8566959194018502,0.3831242158092848
2221,0.2223,26,81,26,568362,108082,59105,67151,0.8560543657331137,0.3832097835453368
2222,0.2224,28,91,28,568453,107991,59133,67123,0.855333607907743,0.3833103007183892
2223,0.2225,30,96,30,568549,107895,59163,67093,0.8545732480040552,0.3834148627334446
2224,0.2226,26,88,26,568637,107807,59189,67067,0.8538762514256748,0.3835161316147626
2225,0.2227,32,86,32,568723,107721,59221,67035,0.8531950956786212,0.38359197967451764
2226,0.2228,20,69,20,568792,107652,59241,67015,0.8526485869978456,0.3836729319218856
2227,0.2229,24,82,24,568874,107570,59265,66991,0.8519991129134457,0.38376842479133366
2228,0.223,19,104,19,568978,107466,59284,66972,0.8511753896844506,0.3839301069721047
2229,0.2231,27,94,27,569072,107372,59311,66945,0.8504308706120898,0.38404171710160223
2230,0.2232,20,71,20,569143,107301,59331,66925,0.8498685210999873,0.38412751254118216
2231,0.2233,27,91,27,569234,107210,59358,66898,0.8491477632746166,0.3842327750591587
2232,0.2234,19,75,19,569309,107135,59377,66879,0.8485537320998606,0.3843311457698806
2233,0.2235,20,96,20,569405,107039,59397,66859,0.8477933721961729,0.3844725068718444
2234,0.2236,21,101,21,569506,106938,59418,66838,0.8469934102141681,0.3846215818064635
2235,0.2237,25,94,25,569600,106844,59443,66813,0.8462488911418071,0.3847411852099253
2236,0.2238,27,95,27,569695,106749,59470,66786,0.8454964516537828,0.38485608090586915
2237,0.2239,25,91,25,569786,106658,59495,66761,0.8447756938284121,0.38496935168580143
2238,0.224,21,91,21,569877,106567,59516,66740,0.8440549360030415,0.38509696665454946
2239,0.2241,28,83,28,569960,106484,59544,66712,0.8433975415029781,0.3851821058223054
2240,0.2242,22,94,22,570054,106390,59566,66690,0.8426530224306171,0.3853131499884446
2241,0.2243,18,96,18,570150,106294,59584,66672,0.8418926625269294,0.38546303897875883
2242,0.2244,35,96,35,570246,106198,59619,66637,0.8411323026232417,0.38555269476668497
2243,0.2245,31,88,31,570334,106110,59650,66606,0.8404353060448613,0.3856388522198291
2244,0.2246,35,97,35,570431,106013,59685,66571,0.8396670257255101,0.38573100635053076
2245,0.2247,38,87,38,570518,105926,59723,66533,0.838977949562793,0.3857902457975519
2246,0.2248,28,82,28,570600,105844,59751,66505,0.8383284754783931,0.38587401145350425
2247,0.2249,34,104,34,570704,105740,59785,66471,0.837504752249398,0.3859857964938361
2248,0.225,28,84,28,570788,105656,59813,66443,0.8368394373336713,0.38607429444680097
2249,0.2251,39,86,39,570874,105570,59852,66404,0.8361582815866176,0.386128135648412
2250,0.2252,25,80,25,570954,105490,59877,66379,0.8355246483335446,0.3862185734483822
2251,0.2253,25,90,25,571044,105400,59902,66354,0.8348118109238373,0.3863316138197655
2252,0.2254,24,89,24,571133,105311,59926,66330,0.8341068939297934,0.38644612883868074
2253,0.2255,25,101,25,571234,105210,59951,66305,0.8333069319477886,0.3865842637670175
2254,0.2256,23,83,23,571317,105127,59974,66282,0.8326495374477253,0.3866891470109504
2255,0.2257,31,99,31,571416,105028,60005,66251,0.8318654162970472,0.3868016511072577
2256,0.2258,20,95,20,571511,104933,60025,66231,0.831112976809023,0.3869446846299455
2257,0.2259,33,68,33,571579,104865,60058,66198,0.8305743885439107,0.3869802353518879
2258,0.226,29,102,29,571681,104763,60087,66169,0.8297665061462426,0.3871071537219479
2259,0.2261,22,86,22,571767,104677,60109,66147,0.829085350399189,0.38722310682339717
2260,0.2262,32,88,32,571855,104589,60141,66115,0.8283883538208086,0.38730785453182115
2261,0.2263,35,79,35,571934,104510,60176,66080,0.8277626409833988,0.3873615100533443
2262,0.2264,29,89,29,572023,104421,60205,66051,0.827057723989355,0.38745952414472756
2263,0.2265,28,110,28,572133,104311,60233,66023,0.8261864782663794,0.3876090504538143
2264,0.2266,30,89,30,572222,104222,60263,65993,0.8254815612723355,0.3877037863878037
2265,0.2267,23,98,23,572320,104124,60286,65970,0.824705360537321,0.3878443684080567
2266,0.2268,23,67,23,572387,104057,60309,65947,0.8241746926878722,0.38791440201407024
2267,0.2269,21,84,21,572471,103973,60330,65926,0.8235093777721455,0.3880305357889099
2268,0.227,30,78,30,572549,103895,60360,65896,0.8228915853503992,0.3881006649351261
2269,0.2271,23,93,23,572642,103802,60383,65873,0.8221549866937017,0.3882304405481067
2270,0.2272,23,75,23,572717,103727,60406,65850,0.8215609555189456,0.38831917064224514
2271,0.2273,30,79,30,572796,103648,60436,65820,0.820935242681536,0.388391908796941
2272,0.2274,20,93,20,572889,103555,60456,65800,0.8201986440248384,0.3885329633019397
2273,0.2275,17,71,17,572960,103484,60473,65783,0.819636294512736,0.388634524154147
2274,0.2276,37,83,37,573043,103401,60510,65746,0.8189789000126727,0.38869149319822405
2275,0.2277,22,78,22,573121,103323,60532,65724,0.8183611075909264,0.3887912828976557
2276,0.2278,34,92,34,573213,103231,60566,65690,0.8176324293498923,0.3888800089982891
2277,0.2279,31,75,31,573288,103156,60597,65659,0.8170383981751362,0.3889405562301928
2278,0.228,20,81,20,573369,103075,60617,65639,0.8163968445063997,0.3890548502198988
2279,0.2281,21,89,21,573458,102986,60638,65618,0.8156919275123559,0.38918412374558137
2280,0.2282,30,97,30,573555,102889,60668,65588,0.8149236471930047,0.38929942959573116
2281,0.2283,27,84,27,573639,102805,60695,65561,0.814258332277278,0.3893957212263759
2282,0.2284,26,81,26,573720,102724,60721,65535,0.8136167786085414,0.38948882377762856
2283,0.2285,35,101,35,573821,102623,60756,65500,0.8128168166265366,0.3895957126627529
2284,0.2286,25,90,25,573911,102533,60781,65475,0.8121039792168293,0.38971358506737774
2285,0.2287,33,80,33,573991,102453,60814,65442,0.8114703459637562,0.3897793263646922
2286,0.2288,18,99,18,574090,102354,60832,65424,0.8106862248130782,0.3899438543790008
2287,0.2289,21,73,21,574163,102281,60853,65403,0.810108034469649,0.39003721285274684
2288,0.229,26,92,26,574255,102189,60879,65377,0.8093793562286149,0.39015671436926347
2289,0.2291,26,100,26,574355,102089,60905,65351,0.8085873146622735,0.39029503105590063
2290,0.2292,22,79,22,574434,102010,60927,65329,0.8079616018248638,0.3903991299099433
2291,0.2293,20,81,20,574515,101929,60947,65309,0.8073200481561272,0.39051531350530383
2292,0.2294,21,92,21,574607,101837,60968,65288,0.8065913699150932,0.3906537023186238
2293,0.2295,25,92,25,574699,101745,60993,65263,0.8058626916740591,0.39077768729641693
2294,0.2296,29,74,29,574773,101671,61022,65234,0.8052765809149665,0.39084509151912766
2295,0.2297,21,72,21,574845,101599,61043,65213,0.8047063109872006,0.390937102846318
2296,0.2298,26,66,26,574911,101533,61069,65187,0.8041835635534152,0.3909968809980806
2297,0.2299,16,83,16,574994,101450,61085,65171,0.803526169053352,0.39113317048871393
2298,0.23,17,75,17,575069,101375,61102,65154,0.8029321378785959,0.3912471701625543
2299,0.2301,15,92,15,575161,101283,61117,65139,0.8022034596375618,0.3914085878069005
2300,0.2302,16,73,16,575234,101210,61133,65123,0.8016252692941326,0.3915218266970475
2301,0.2303,36,83,36,575317,101127,61169,65087,0.8009678747940692,0.39158554634386994
2302,0.2304,19,96,19,575413,101031,61188,65068,0.8002075148903814,0.3917422741858771
2303,0.2305,29,80,29,575493,100951,61217,65039,0.7995738816373084,0.3918248087234171
2304,0.2306,31,76,31,575569,100875,61248,65008,0.7989719300468888,0.3918906699300109
2305,0.2307,18,85,18,575654,100790,61266,64990,0.7982986947154986,0.39202557606466404
2306,0.2308,24,70,24,575724,100720,61290,64966,0.7977442656190596,0.3921031348454305
2307,0.2309,39,76,39,575800,100644,61329,64927,0.7971423140286402,0.39213992788592206
2308,0.231,31,76,31,575876,100568,61360,64896,0.7965403624382208,0.39220615964802014
2309,0.2311,17,108,17,575984,100460,61377,64879,0.7956849575465721,0.39239985726295673
2310,0.2312,23,76,23,576060,100384,61400,64856,0.7950830059561526,0.3924957637375938
2311,0.2313,28,76,28,576136,100308,61428,64828,0.7944810543657331,0.39257339405096403
2312,0.2314,25,74,25,576210,100234,61453,64803,0.7938949436066405,0.392657404097263
2313,0.2315,22,82,22,576292,100152,61475,64781,0.7932454695222405,0.39277161029023905
2314,0.2316,23,79,23,576371,100073,61498,64758,0.7926197566848309,0.39287512664486657
2315,0.2317,28,82,28,576453,99991,61526,64730,0.7919702826004309,0.39296750262565183
2316,0.2318,18,94,18,576547,99897,61544,64712,0.79122576352807,0.3931255277657965
2317,0.2319,17,73,17,576620,99824,61561,64695,0.7906475731846407,0.3932372552714276
2318,0.232,32,84,32,576704,99740,61593,64663,0.789982258268914,0.39332007323467333
2319,0.2321,31,89,31,576793,99651,61624,64632,0.7892773412748701,0.39341867387374224
2320,0.2322,24,86,24,576879,99565,61648,64608,0.7885961855278165,0.3935360869326869
2321,0.2323,27,84,27,576963,99481,61675,64581,0.7879308706120898,0.39363777108654047
2322,0.2324,30,86,30,577049,99395,61705,64551,0.7872497148650361,0.3937333024288485
2323,0.2325,26,79,26,577128,99316,61731,64525,0.7866240020276264,0.3938269419742311
2324,0.2326,28,72,28,577200,99244,61759,64497,0.7860537320998606,0.3938964584313031
2325,0.2327,36,68,36,577268,99176,61795,64461,0.7855151438347484,0.39392680139577235
2326,0.2328,23,82,23,577350,99094,61818,64438,0.7848656697503485,0.3940390871511386
2327,0.2329,23,97,23,577447,98997,61841,64415,0.7840973894309974,0.3941876973539275
2328,0.233,21,89,21,577536,98908,61862,64394,0.7833924724369535,0.3943246255404098
2329,0.2331,19,82,19,577618,98826,61881,64375,0.7827429983525536,0.39445223987598116
2330,0.2332,35,86,35,577704,98740,61916,64340,0.7820618426054999,0.39453029188128524
2331,0.2333,24,75,24,577779,98665,61940,64316,0.7814678114307438,0.39462268607997253
2332,0.2334,20,82,20,577861,98583,61960,64296,0.780818337346344,0.3947470207945776
2333,0.2335,21,70,21,577931,98513,61981,64275,0.780263908249905,0.39483868589822346
2334,0.2336,22,72,22,578003,98441,62003,64253,0.7796936383221391,0.3949315893640823
2335,0.2337,22,71,22,578074,98370,62025,64231,0.7791312888100368,0.39502217083535773
2336,0.2338,28,60,28,578134,98310,62053,64203,0.7786560638702319,0.39506377951302357
2337,0.2339,28,74,28,578208,98236,62081,64175,0.7780699531111392,0.395139491783192
2338,0.234,20,92,20,578300,98144,62101,64155,0.7773412748701052,0.39528894201443016
2339,0.2341,27,69,27,578369,98075,62128,64128,0.7767947661893296,0.39535643607084947
2340,0.2342,24,69,24,578438,98006,62152,64104,0.7762482575085541,0.3954351983221269
2341,0.2343,26,90,26,578528,97916,62178,64078,0.7755354200988468,0.39555786016766054
2342,0.2344,28,84,28,578612,97832,62206,64050,0.77487010518312,0.3956585661160599
2343,0.2345,33,81,33,578693,97751,62239,64017,0.7742285515143835,0.395733395974482
2344,0.2346,30,70,30,578763,97681,62269,63987,0.7736741224179445,0.3957926120196947
2345,0.2347,27,79,27,578842,97602,62296,63960,0.7730484095805348,0.3958851710179374
2346,0.2348,32,88,32,578930,97514,62328,63928,0.7723514130021544,0.39598121926140656
2347,0.2349,20,96,20,579026,97418,62348,63908,0.7715910530984667,0.3961419733954849
2348,0.235,37,76,37,579102,97342,62385,63871,0.7709891015080471,0.39619013355002386
2349,0.2351,21,74,21,579176,97268,62406,63850,0.7704029907489545,0.39629339986841944
2350,0.2352,28,87,28,579263,97181,62434,63822,0.7697139145862375,0.39640255150525144
2351,0.2353,32,76,32,579339,97105,62466,63790,0.769111962995818,0.3964697473507567
2352,0.2354,20,72,20,579411,97033,62486,63770,0.7685416930680522,0.3965722032549144
2353,0.2355,18,77,18,579488,96956,62504,63752,0.7679318210619693,0.39669462627871666
2354,0.2356,28,77,28,579565,96879,62532,63724,0.7673219490558865,0.39677963674402095
2355,0.2357,33,76,33,579641,96803,62565,63691,0.766719997465467,0.3968434957070046
2356,0.2358,21,92,21,579733,96711,62586,63670,0.7659913192244329,0.3969921624132534
2357,0.2359,19,78,19,579811,96633,62605,63651,0.7653735268026866,0.3971138728756457
2358,0.236,23,84,23,579895,96549,62628,63628,0.7647082118869598,0.3972355581637813
2359,0.2361,27,59,27,579954,96490,62655,63601,0.7642409073628184,0.39728029683117727
2360,0.2362,32,61,32,580015,96429,62687,63569,0.7637577620073501,0.3973112163902049
2361,0.2363,28,74,28,580089,96355,62715,63541,0.7631716512482575,0.39738955320958624
2362,0.2364,20,96,20,580185,96259,62735,63521,0.7624112913445698,0.39755288521717363
2363,0.2365,41,77,41,580262,96182,62776,63480,0.7618014193384869,0.39758990868209093
2364,0.2366,20,82,20,580344,96100,62796,63460,0.7611519452540869,0.39771872649786916
2365,0.2367,24,65,24,580409,96035,62820,63436,0.760637118235965,0.39779019382834496
2366,0.2368,24,91,24,580500,95944,62844,63412,0.7599163604105943,0.3979266547855117
2367,0.2369,38,72,38,580572,95872,62882,63374,0.7593460904828285,0.39796290016703717
2368,0.237,18,59,18,580631,95813,62900,63356,0.7588787859586871,0.39804233236371406
2369,0.2371,35,63,35,580694,95750,62935,63321,0.7583797997718921,0.39806752959370345
2370,0.2372,21,76,21,580770,95674,62956,63300,0.7577778481814725,0.3981783184671707
2371,0.2373,29,73,29,580843,95601,62985,63271,0.7571996578380433,0.3982514225288282
2372,0.2374,20,79,20,580922,95522,63005,63251,0.7565739450006337,0.39837377891707026
2373,0.2375,26,82,26,581004,95440,63031,63225,0.7559244709162337,0.3984810764818958
2374,0.2376,18,76,18,581080,95364,63049,63207,0.7553225193258142,0.39860378001021624
2375,0.2377,28,76,28,581156,95288,63077,63179,0.7547205677353948,0.39868868597247376
2376,0.2378,27,80,27,581236,95208,63104,63152,0.7540869344823217,0.39878757261934833
2377,0.2379,25,69,25,581305,95139,63129,63127,0.753540425801546,0.39886646531788256
2378,0.238,20,66,20,581371,95073,63149,63107,0.7530176783677608,0.3989568845618915
2379,0.2381,23,87,23,581458,94986,63172,63084,0.7523286022050437,0.3990890111975707
2380,0.2382,19,88,19,581546,94898,63191,63065,0.7516316056266633,0.3992390623120604
2381,0.2383,24,75,24,581621,94823,63215,63041,0.7510375744519072,0.39933740434804643
2382,0.2384,30,82,30,581703,94741,63245,63011,0.7503881003675072,0.39943075206653483
2383,0.2385,30,73,30,581776,94668,63275,62981,0.749809910024078,0.39950142404962924
2384,0.2386,26,74,26,581850,94594,63301,62955,0.7492237992649854,0.39958996883509257
2385,0.2387,27,83,27,581933,94511,63328,62928,0.7485664047649221,0.3996976606812797
2386,0.2388,19,78,19,582011,94433,63347,62909,0.7479486123431758,0.39982331481740413
2387,0.2389,11,74,11,582085,94359,63358,62898,0.7473625015840831,0.3999694767164578
2388,0.239,26,87,26,582172,94272,63384,62872,0.7466734254213662,0.4000916356971949
2389,0.2391,17,78,17,582250,94194,63401,62855,0.7460556329996199,0.40022540735693957
2390,0.2392,25,98,25,582348,94096,63426,62830,0.7452794322646052,0.4003797968469215
2391,0.2393,28,66,28,582414,94030,63454,62802,0.7447566848308199,0.4004412364823505
2392,0.2394,20,77,20,582491,93953,63474,62782,0.744146812824737,0.4005614572367372
2393,0.2395,17,72,17,582563,93881,63491,62765,0.7435765428969713,0.4006805153020186
2394,0.2396,27,71,27,582634,93810,63518,62738,0.7430141933848688,0.40075887267802845
2395,0.2397,22,89,22,582723,93721,63540,62716,0.742309276390825,0.40090259976859693
2396,0.2398,17,82,17,582805,93639,63557,62699,0.741659802306425,0.4010477299185099
2397,0.2399,24,67,24,582872,93572,63581,62675,0.7411291344569763,0.4011277016518717
2398,0.24,25,89,25,582961,93483,63606,62650,0.7404242174629324,0.4012604638353199
2399,0.2401,14,73,14,583034,93410,63620,62636,0.7398460271195032,0.4013944606077695
2400,0.2402,18,81,18,583115,93329,63638,62618,0.7392044734507667,0.4015338544505505
2401,0.2403,29,72,29,583187,93257,63667,62589,0.7386342035230009,0.4016079976386946
2402,0.2404,27,68,27,583255,93189,63694,62562,0.7380956152578887,0.401679603983281
2403,0.2405,29,60,29,583315,93129,63723,62533,0.7376203903180839,0.4017229638575889
2404,0.2406,25,83,25,583398,93046,63748,62508,0.7369629958180205,0.4018411612687555
2405,0.2407,25,67,25,583465,92979,63773,62483,0.7364323279685718,0.4019181536323989
2406,0.2408,35,72,35,583537,92907,63808,62448,0.735862058040806,0.40196968234044606
2407,0.2409,29,73,29,583610,92834,63837,62419,0.7352838676973767,0.40204698137878175
2408,0.241,17,58,17,583668,92776,63854,62402,0.7348244835888987,0.40213174547938496
2409,0.2411,20,84,20,583752,92692,63874,62382,0.734159168673172,0.4022724634690535
2410,0.2412,25,58,25,583810,92634,63899,62357,0.733699784564694,0.40232658670503446
2411,0.2413,25,79,25,583889,92555,63924,62332,0.7330740717272842,0.402435323816718
2412,0.2414,27,77,27,583966,92478,63951,62305,0.7324641997212014,0.4025312857355136
2413,0.2415,21,83,21,584049,92395,63972,62284,0.7318068052211381,0.40266616670653416
2414,0.2416,28,71,28,584120,92324,64000,62256,0.7312444557090356,0.40274291628930003
2415,0.2417,34,58,34,584178,92266,64034,62222,0.7307850716005576,0.40276267412355654
2416,0.2418,20,70,20,584248,92196,64054,62202,0.7302306425041186,0.4028679127967979
2417,0.2419,26,70,26,584318,92126,64080,62176,0.7296762134076796,0.4029500589752563
2418,0.242,23,74,23,584392,92052,64103,62153,0.729090102648587,0.40305437566875263
2419,0.2421,30,70,30,584462,91982,64133,62123,0.728535673552148,0.4031212484993998
2420,0.2422,35,75,35,584537,91907,64168,62088,0.727941642377392,0.4031819214909575
2421,0.2423,25,64,25,584601,91843,64193,62063,0.7274347357749334,0.40325263472509193
2422,0.2424,22,73,22,584674,91770,64215,62041,0.7268565454315042,0.4033586674555136
2423,0.2425,18,65,18,584739,91705,64233,62023,0.7263417184133824,0.40345935678601164
2424,0.2426,28,74,28,584813,91631,64261,61995,0.7257556076542897,0.40354497285615715
2425,0.2427,38,83,38,584896,91548,64299,61957,0.7250982131542263,0.40361551740985635
2426,0.2428,24,70,24,584966,91478,64323,61933,0.7245437840577873,0.403706383505746
2427,0.2429,17,77,17,585043,91401,64340,61916,0.7239339120517044,0.4038430180606195
2428,0.243,17,83,17,585126,91318,64357,61899,0.7232765175516411,0.4039956401704772
2429,0.2431,26,83,26,585209,91235,64383,61873,0.7226191230515777,0.4041134362672101
2430,0.2432,24,75,24,585284,91160,64407,61849,0.7220250918768217,0.40421805253285753
2431,0.2433,16,71,16,585355,91089,64423,61833,0.7214627423647193,0.40434339074822456
2432,0.2434,22,78,22,585433,91011,64445,61811,0.720844949942973,0.4044640169609088
2433,0.2435,22,63,22,585496,90948,64467,61789,0.7203459637561779,0.4045450676653332
2434,0.2436,26,69,26,585565,90879,64493,61763,0.7197994550754023,0.4046265117071317
2435,0.2437,28,65,28,585630,90814,64521,61735,0.7192846280572804,0.40468964070560937
2436,0.2438,27,85,27,585715,90729,64548,61708,0.7186113927258903,0.404809855874886
2437,0.2439,31,69,31,585784,90660,64579,61677,0.7180648840451147,0.40487209279426534
2438,0.244,17,73,17,585857,90587,64596,61660,0.7174866937016855,0.40499977011041266
2439,0.2441,30,74,30,585931,90513,64626,61630,0.7169005829425928,0.4050794318502987
2440,0.2442,32,63,32,585994,90450,64658,61598,0.7164015967557977,0.40512206671577394
2441,0.2443,20,62,20,586056,90388,64678,61578,0.7159105309846661,0.4052090599212982
2442,0.2444,20,83,20,586139,90305,64698,61558,0.7152531364846028,0.40535219243660403
2443,0.2445,26,76,26,586215,90229,64724,61532,0.7146511848941832,0.40545331145683017
2444,0.2446,25,72,25,586287,90157,64749,61507,0.7140809149664175,0.4055477898512501
2445,0.2447,17,80,17,586367,90077,64766,61490,0.7134472817133443,0.4056951711124453
2446,0.2448,33,79,33,586446,89998,64799,61457,0.7128215688759346,0.4057772935855535
2447,0.2449,14,85,14,586531,89913,64813,61443,0.7121483335445444,0.40595021010068977
2448,0.245,26,66,26,586597,89847,64839,61417,0.7116255861107591,0.40602522741696634
2449,0.2451,20,65,20,586662,89782,64859,61397,0.7111107590926372,0.4061212205398898
2450,0.2452,21,61,21,586723,89721,64880,61376,0.7106276137371689,0.4062026380404641
2451,0.2453,20,72,20,586795,89649,64900,61356,0.7100573438094031,0.40631767160027815
2452,0.2454,19,65,19,586860,89584,64919,61337,0.7095425167912812,0.4064179272599572
2453,0.2455,24,59,24,586919,89525,64943,61313,0.7090752122671398,0.4064824513716703
2454,0.2456,21,75,21,586994,89450,64964,61292,0.7084811810923838,0.4066020087301482
2455,0.2457,28,78,28,587072,89372,64992,61264,0.7078633886706375,0.40670224913035397
2456,0.2458,24,82,24,587154,89290,65016,61240,0.7072139145862375,0.4068292034810337
2457,0.2459,19,62,19,587216,89228,65035,61221,0.7067228488151058,0.40692194697206363
2458,0.246,24,71,24,587287,89157,65059,61197,0.7061604993030034,0.40701943413544034
2459,0.2461,26,76,26,587363,89081,65085,61171,0.705558547712584,0.4071227005297766
2460,0.2462,30,83,30,587446,88998,65115,61141,0.7049011532125206,0.40722930084788095
2461,0.2463,25,65,25,587511,88933,65140,61116,0.7043863261943987,0.40730694639751014
2462,0.2464,32,73,32,587584,88860,65172,61084,0.7038081358509695,0.4073787547351011
2463,0.2465,20,66,20,587650,88794,65192,61064,0.7032853884171841,0.40747908019591883
2464,0.2466,26,100,26,587750,88694,65218,61038,0.7024933468508427,0.40764833168594555
2465,0.2467,24,70,24,587820,88624,65242,61014,0.7019389177544038,0.40774402224034
2466,0.2468,30,76,30,587896,88548,65272,60984,0.7013369661639843,0.4078324372040767
2467,0.2469,33,65,33,587961,88483,65305,60951,0.7008221391458623,0.40787906366690313
2468,0.247,24,65,24,588026,88418,65329,60927,0.7003073121277404,0.40796143158458603
2469,0.2471,15,61,15,588087,88357,65344,60912,0.6998241667722722,0.4080686545766368
2470,0.2472,28,56,28,588143,88301,65372,60884,0.699380623495121,0.4081107349934645
2471,0.2473,29,78,29,588221,88223,65401,60855,0.6987628310733748,0.40820912542427457
2472,0.2474,23,63,23,588284,88160,65424,60832,0.6982638448865797,0.40829037800687284
2473,0.2475,24,73,24,588357,88087,65448,60808,0.6976856545431505,0.408395177809866
2474,0.2476,16,65,16,588422,88022,65464,60792,0.6971708275250285,0.4085099520206432
2475,0.2477,22,70,22,588492,87952,65486,60770,0.6966163984285896,0.4086147308400909
2476,0.2478,28,64,28,588556,87888,65514,60742,0.696109491826131,0.4086792706721389
2477,0.2479,33,71,33,588627,87817,65547,60709,0.6955471423140286,0.4087432503400078
2478,0.248,25,59,25,588686,87758,65572,60684,0.6950798377898872,0.4088061330351248
2479,0.2481,32,74,32,588760,87684,65604,60652,0.6944937270307946,0.40888253694315607
2480,0.2482,25,73,25,588833,87611,65629,60627,0.6939155366873654,0.40898420108204375
2481,0.2483,28,73,28,588906,87538,65657,60599,0.6933373463439362,0.40907403282096977
2482,0.2484,19,73,19,588979,87465,65676,60580,0.6927591560005069,0.4091999054341585
2483,0.2485,29,60,29,589039,87405,65705,60551,0.6922839310607021,0.40925004731136283
2484,0.2486,26,54,26,589093,87351,65731,60525,0.6918562286148777,0.4092956260650816
2485,0.2487,27,68,27,589161,87283,65758,60498,0.6913176403497655,0.40937603616161755
2486,0.2488,28,72,28,589233,87211,65786,60470,0.6907473704219997,0.4094636412266981
2487,0.2489,29,79,29,589312,87132,65815,60441,0.69012165758459,0.4095667906730906
2488,0.249,22,57,22,589369,87075,65837,60419,0.6896701938917754,0.40963700218313964
2489,0.2491,29,67,29,589436,87008,65866,60390,0.6891395260423268,0.4097070516560605
2490,0.2492,28,88,28,589524,86920,65894,60362,0.6884425294639462,0.4098396273814859
2491,0.2493,27,60,27,589584,86860,65921,60335,0.6879673045241415,0.40989843405006965
2492,0.2494,19,75,19,589659,86785,65940,60316,0.6873732733493854,0.41003120305096497
2493,0.2495,22,71,22,589730,86714,65962,60294,0.6868109238372829,0.41014094471049195
2494,0.2496,26,86,26,589816,86628,65988,60268,0.6861297680902294,0.41027665831608756
2495,0.2497,20,74,20,589890,86554,66008,60248,0.6855436573311368,0.410403128022779
2496,0.2498,26,72,26,589962,86482,66034,60222,0.6849733874033709,0.4105000545315738
2497,0.2499,24,78,24,590040,86404,66058,60198,0.6843555949816247,0.4106219560442559
2498,0.25,23,59,23,590099,86345,66081,60175,0.6838882904574832,0.4106947856947857
2499,0.2501,25,78,25,590177,86267,66106,60150,0.6832704980357369,0.41081295204791796
2500,0.2502,28,54,28,590231,86213,66134,60122,0.6828427955899126,0.4108518126217241
2501,0.2503,24,74,24,590305,86139,66158,60098,0.6822566848308199,0.4109630257732311
2502,0.2504,31,79,31,590384,86060,66189,60067,0.6816309719934102,0.4110602421181575
2503,0.2505,24,85,24,590469,85975,66213,60043,0.68095773666202,0.4112027284307414
2504,0.2506,22,64,22,590533,85911,66235,60021,0.6804508300595615,0.4112943014554724
2505,0.2507,23,67,23,590600,85844,66258,59998,0.6799201622101128,0.4113904087985628
2506,0.2508,30,51,30,590651,85793,66288,59968,0.6795162210112786,0.41141320380623075
2507,0.2509,24,60,24,590711,85733,66312,59944,0.6790409960714738,0.4114856840819072
2508,0.251,26,81,26,590792,85652,66338,59918,0.6783994424027373,0.411609534931648
2509,0.2511,24,82,24,590874,85570,66362,59894,0.6777499683183373,0.41174448660837043
2510,0.2512,23,76,23,590950,85494,66385,59871,0.6771480167279179,0.41186668042513674
2511,0.2513,27,71,27,591021,85423,66412,59844,0.6765856672158155,0.4119586692091115
2512,0.2514,27,70,27,591091,85353,66439,59817,0.6760312381193765,0.4120479437900393
2513,0.2515,27,83,27,591174,85270,66466,59790,0.6753738436193132,0.4121742727147387
2514,0.2516,27,88,27,591262,85182,66493,59763,0.6746768470409327,0.41231501604056714
2515,0.2517,27,74,27,591336,85108,66520,59736,0.67409073628184,0.41241611664963684
2516,0.2518,17,65,17,591401,85043,66537,59719,0.6735759092637181,0.41253229438664846
2517,0.2519,19,77,19,591478,84966,66556,59700,0.6729660372576353,0.4126747127866949
2518,0.252,29,64,29,591542,84902,66585,59671,0.6724591306551768,0.41273958484640977
2519,0.2521,28,59,28,591601,84843,66613,59643,0.6719918261310354,0.4127943191727918
2520,0.2522,21,70,21,591671,84773,66634,59622,0.6714373970345964,0.4129090342463382
2521,0.2523,26,77,26,591748,84696,66660,59596,0.6708275250285135,0.41302359105147896
2522,0.2524,24,59,24,591807,84637,66684,59572,0.670360220504372,0.4130948831210257
2523,0.2525,26,74,26,591881,84563,66710,59546,0.6697741097452794,0.4132011185977281
2524,0.2526,23,65,23,591946,84498,66733,59523,0.6692592827271575,0.4132938946403649
2525,0.2527,26,57,26,592003,84441,66759,59497,0.6688078190343429,0.4133515819311092
2526,0.2528,23,78,23,592081,84363,66782,59474,0.6681900266125966,0.4134819274595549
2527,0.2529,26,50,26,592131,84313,66808,59448,0.6677940058294259,0.41351966110419375
2528,0.253,24,73,24,592204,84240,66832,59424,0.6672158154859967,0.41363180755095225
2529,0.2531,16,71,16,592275,84169,66848,59408,0.6666534659738943,0.41377100789123605
2530,0.2532,25,81,25,592356,84088,66873,59383,0.6660119123051578,0.4139024611245478
2531,0.2533,26,71,26,592427,84017,66899,59357,0.6654495627930553,0.41400114386150905
2532,0.2534,31,65,31,592492,83952,66930,59326,0.6649347357749334,0.41406217283881686
2533,0.2535,20,59,20,592551,83893,66950,59306,0.664467431250792,0.41415093680821796
2534,0.2536,24,57,24,592608,83836,66974,59282,0.6640159675579774,0.4142176385919311
2535,0.2537,26,59,26,592667,83777,67000,59256,0.663548663033836,0.41428201883481436
2536,0.2538,26,66,26,592733,83711,67026,59230,0.6630259156000506,0.4143667667079424
2537,0.2539,24,72,24,592805,83639,67050,59206,0.6624556456722849,0.414477230564598
2538,0.254,40,70,40,592875,83569,67090,59166,0.6619012165758459,0.41451641153185975
2539,0.2541,26,68,26,592943,83501,67116,59140,0.6613626283107338,0.41460730084618025
2540,0.2542,18,77,18,593020,83424,67134,59122,0.6607527563046509,0.41475734148976473
2541,0.2543,24,77,24,593097,83347,67158,59098,0.6601428842985679,0.4148829372740356
2542,0.2544,20,51,20,593148,83296,67178,59078,0.6597389430997339,0.414949358731229
2543,0.2545,29,66,29,593214,83230,67207,59049,0.6592161956659486,0.41502259644782435
2544,0.2546,27,61,27,593275,83169,67234,59022,0.6587330503104802,0.41508956263054625
2545,0.2547,24,63,24,593338,83106,67258,58998,0.6582340641236852,0.4151748015537916
2546,0.2548,24,44,24,593382,83062,67282,58974,0.657885565834495,0.41520459601791093
2547,0.2549,20,73,20,593455,82989,67302,58954,0.6573073754910658,0.4153357333577563
2548,0.255,26,68,26,593523,82921,67328,58928,0.6567687872259537,0.415427673088989
2549,0.2551,35,62,35,593585,82859,67363,58893,0.656277721454822,0.41546503753033465
2550,0.2552,27,55,27,593640,82804,67390,58866,0.6558420985933342,0.4155149290604927
2551,0.2553,27,59,27,593699,82745,67417,58839,0.6553747940691927,0.4155766188269861
2552,0.2554,21,67,21,593766,82678,67438,58818,0.654844126219744,0.4156866625204953
2553,0.2555,26,59,26,593825,82619,67464,58792,0.6543768216956026,0.41575266421989804
2554,0.2556,30,83,30,593908,82536,67494,58762,0.6537194271955392,0.4158728361335617
2555,0.2557,25,66,25,593974,82470,67519,58737,0.6531966797617539,0.41596379782871956
2556,0.2558,23,83,23,594057,82387,67542,58714,0.6525392852616906,0.41611328055789826
2557,0.2559,22,60,22,594117,82327,67564,58692,0.6520640603218857,0.416199235564002
2558,0.256,20,63,20,594180,82264,67584,58672,0.6515650741350906,0.4163024351478685
2559,0.2561,14,79,14,594259,82185,67598,58658,0.6509393612976809,0.4164779222254567
2560,0.2562,24,65,24,594324,82120,67622,58634,0.650424534279559,0.4165707546499567
2561,0.2563,23,62,23,594386,82058,67645,58611,0.6499334685084274,0.4166589653726123
2562,0.2564,24,76,24,594462,81982,67669,58587,0.6493315169180078,0.4167846395720251
2563,0.2565,27,90,27,594552,81892,67696,58560,0.6486186795083005,0.4169395950217868
2564,0.2566,26,65,26,594617,81827,67722,58534,0.6481038524901787,0.41702467209552513
2565,0.2567,26,62,26,594679,81765,67748,58508,0.647612786719047,0.41710093888346295
2566,0.2568,22,67,22,594746,81698,67770,58486,0.6470821188695983,0.41720881127660786
2567,0.2569,27,74,27,594820,81624,67797,58459,0.6464960081105057,0.41731687642326337
2568,0.257,22,61,22,594881,81563,67819,58437,0.6460128627550373,0.41740714285714287
2569,0.2571,33,60,33,594941,81503,67852,58404,0.6455376378152325,0.41744873380173975
2570,0.2572,26,64,26,595005,81439,67878,58378,0.6450307312127741,0.4175314875873463
2571,0.2573,21,54,21,595059,81385,67899,58357,0.6446030287669496,0.4176053011979219
2572,0.2574,29,74,29,595133,81311,67928,58328,0.6440169180078571,0.41770565529687265
2573,0.2575,23,57,23,595190,81254,67951,58305,0.6435654543150424,0.41778029363924934
2574,0.2576,25,71,25,595261,81183,67976,58280,0.6430031048029401,0.41788861561847945
2575,0.2577,22,59,22,595320,81124,67998,58258,0.6425358002787986,0.41797362643669916
2576,0.2578,20,68,20,595388,81056,68018,58238,0.6419972120136864,0.41809410312001954
2577,0.2579,21,53,21,595441,81003,68039,58217,0.6415774299835255,0.41816549346358284
2578,0.258,23,56,23,595497,80947,68062,58194,0.6411338867063744,0.4182376150811048
2579,0.2581,25,63,25,595560,80884,68087,58169,0.6406349005195793,0.4183225101220398
2580,0.2582,20,60,20,595620,80824,68107,58149,0.6401596755797744,0.4184194052082059
2581,0.2583,26,71,26,595691,80753,68133,58123,0.6395973260676721,0.4185244390679455
2582,0.2584,28,48,28,595739,80705,68161,58095,0.6392171461158281,0.41855187319884724
2583,0.2585,15,75,15,595814,80630,68176,58080,0.6386231149410722,0.41871530531324347
2584,0.2586,19,70,19,595884,80560,68195,58061,0.6380686858446332,0.41884707223292283
2585,0.2587,18,62,18,595946,80498,68213,58043,0.6375776200735015,0.4189590085245523
2586,0.2588,18,79,18,596025,80419,68231,58025,0.6369519072360917,0.4191225332986623
2587,0.2589,24,75,24,596100,80344,68255,58001,0.6363578760613356,0.41924897900177094
2588,0.259,15,61,15,596161,80283,68270,57986,0.6358747307058674,0.41937093636317613
2589,0.2591,26,46,26,596207,80237,68296,57960,0.6355103915853504,0.41940128946359184
2590,0.2592,18,72,18,596279,80165,68314,57942,0.6349401216575846,0.4195442664021375
2591,0.2593,29,69,29,596348,80096,68343,57913,0.6343936129768091,0.4196320529820519
2592,0.2594,20,64,20,596412,80032,68363,57893,0.6338867063743505,0.4197426137393511
2593,0.2595,19,65,19,596477,79967,68382,57874,0.6333718793562286,0.41986056398314
2594,0.2596,23,63,23,596540,79904,68405,57851,0.6328728931694335,0.4199557184857174
2595,0.2597,29,62,29,596602,79842,68434,57822,0.6323818273983018,0.4200226638772664
2596,0.2598,30,68,30,596670,79774,68464,57792,0.6318432391331897,0.42010380471918934
2597,0.2599,11,63,11,596733,79711,68475,57781,0.6313442529463946,0.4202499054490443
2598,0.26,20,54,20,596787,79657,68495,57761,0.6309165505005703,0.4203306699267927
2599,0.2601,26,72,26,596859,79585,68521,57735,0.6303462805728045,0.42044130498106613
2600,0.2602,24,67,24,596926,79518,68545,57711,0.6298156127233557,0.42054522003366634
2601,0.2603,19,69,19,596995,79449,68564,57692,0.6292691040425802,0.42067652999467703
2602,0.2604,23,63,23,597058,79386,68587,57669,0.6287701178557851,0.4207726824997264
2603,0.2605,17,58,17,597116,79328,68604,57652,0.6283107337473071,0.42087896043217987
2604,0.2606,26,63,26,597179,79265,68630,57626,0.627811747560512,0.42096266372515356
2605,0.2607,19,58,19,597237,79207,68649,57607,0.6273523634520339,0.4210607101612408
2606,0.2608,26,61,26,597298,79146,68675,57581,0.6268692180965657,0.42113847301557117
2607,0.2609,20,61,20,597359,79085,68695,57561,0.6263860727410975,0.42124174875225034
2608,0.261,25,44,25,597403,79041,68720,57536,0.6260375744519072,0.4212715171661407
2609,0.2611,27,60,27,597463,78981,68747,57509,0.6255623495121024,0.42134222287347056
2610,0.2612,14,79,14,597542,78902,68761,57495,0.6249366366746927,0.4215268664266809
2611,0.2613,23,62,23,597604,78840,68784,57472,0.624445570903561,0.42162098714713303
2612,0.2614,21,63,21,597667,78777,68805,57451,0.6239465847167659,0.4217268109346096
2613,0.2615,21,50,21,597717,78727,68826,57430,0.6235505639335952,0.42179248955250187
2614,0.2616,28,55,28,597772,78672,68854,57402,0.6231149410721074,0.4218439966488822
2615,0.2617,19,55,19,597827,78617,68873,57383,0.6226793182106197,0.4219338235294118
2616,0.2618,33,64,33,597891,78553,68906,57350,0.6221724116081612,0.42199215617020963
2617,0.2619,24,63,24,597954,78490,68930,57326,0.6216734254213662,0.4220857630912411
2618,0.262,20,63,20,598017,78427,68950,57306,0.621174439234571,0.42219651816433734
2619,0.2621,19,63,19,598080,78364,68969,57287,0.6206754530477759,0.4223116674407118
2620,0.2622,18,42,18,598122,78322,68987,57269,0.6203427955899126,0.42236579123983153
2621,0.2623,22,56,22,598178,78266,69009,57247,0.6198992523127613,0.4224465549430682
2622,0.2624,24,56,24,598234,78210,69033,57223,0.6194557090356102,0.42251888387616016
2623,0.2625,16,70,16,598304,78140,69049,57207,0.6189012799391712,0.4226691393233688
2624,0.2626,17,56,17,598360,78084,69066,57190,0.61845773666202,0.42277155994500054
2625,0.2627,27,65,27,598425,78019,69093,57163,0.6179429096438981,0.42285955230725986
2626,0.2628,30,66,30,598491,77953,69123,57133,0.6174201622101128,0.42293798024961876
2627,0.2629,17,49,17,598540,77904,69140,57116,0.6170320618426055,0.42301881202784775
2628,0.263,21,64,21,598604,77840,69161,57095,0.616525155240147,0.4231296550190833
2629,0.2631,25,79,25,598683,77761,69186,57070,0.6158994424027373,0.42327061284126055
2630,0.2632,26,52,26,598735,77709,69212,57044,0.6154875807882397,0.42332267185146155
2631,0.2633,19,61,19,598796,77648,69231,57025,0.6150044354327715,0.423433056366161
2632,0.2634,23,54,23,598850,77594,69254,57002,0.6145767329869471,0.4235044132069304
2633,0.2635,27,78,27,598928,77516,69281,56975,0.6139589405652008,0.4236342952316512
2634,0.2636,14,54,14,598982,77462,69295,56961,0.6135312381193765,0.42374444849467724
2635,0.2637,31,44,31,599026,77418,69326,56930,0.6131827398301863,0.4237502605174621
2636,0.2638,17,65,17,599091,77353,69343,56913,0.6126679128120643,0.4238824423159996
2637,0.2639,21,58,21,599149,77295,69364,56892,0.6122085287035863,0.423975496881218
2638,0.264,25,59,25,599208,77236,69389,56867,0.611741224179445,0.42405464456425285
2639,0.2641,16,73,16,599281,77163,69405,56851,0.6111630338360157,0.42421687286402915
2640,0.2642,17,67,17,599348,77096,69422,56834,0.610632365986567,0.42435600686926006
2641,0.2643,12,66,12,599414,77030,69434,56822,0.6101096185527817,0.4245136419328811
2642,0.2644,22,65,22,599479,76965,69456,56800,0.6095947915346598,0.42462527567001834
2643,0.2645,27,65,27,599544,76900,69483,56773,0.6090799645165378,0.4247155371690618
2644,0.2646,26,55,26,599599,76845,69509,56747,0.6086443416550501,0.4247784298460986
2645,0.2647,19,61,19,599660,76784,69528,56728,0.6081611962995818,0.4248906465336449
2646,0.2648,19,69,19,599729,76715,69547,56709,0.6076146876188062,0.42502848063316945
2647,0.2649,23,57,23,599786,76658,69570,56686,0.6071632239259916,0.4251109911207103
2648,0.265,22,62,22,599848,76596,69592,56664,0.60667215815486,0.42521386762719493
2649,0.2651,24,72,24,599920,76524,69616,56640,0.6061018882270942,0.4253401820311796
2650,0.2652,22,74,22,599994,76450,69638,56618,0.6055157774680016,0.42548170860011425
2651,0.2653,22,66,22,600060,76384,69660,56596,0.6049930300342162,0.4255978342607911
2652,0.2654,28,60,28,600120,76324,69688,56568,0.6045178050944113,0.42566896427173945
2653,0.2655,25,58,25,600178,76266,69713,56543,0.6040584209859333,0.42574674909079957
2654,0.2656,19,59,19,600237,76207,69732,56524,0.6035911164617919,0.42585379451672933
2655,0.2657,25,61,25,600298,76146,69757,56499,0.6031079711063236,0.42594142259414225
2656,0.2658,24,56,24,600354,76090,69781,56475,0.6026644278291725,0.4260174254139479
2657,0.2659,21,59,21,600413,76031,69802,56454,0.6021971233050311,0.4261161640940484
2658,0.266,21,73,21,600486,75958,69823,56433,0.6016189329616018,0.42626009320875285
2659,0.2661,17,64,17,600550,75894,69840,56416,0.6011120263591433,0.42639256292041416
2660,0.2662,20,53,20,600603,75841,69860,56396,0.6006922443289824,0.4264767047044322
2661,0.2663,24,66,24,600669,75775,69884,56372,0.600169496895197,0.4265855448856198
2662,0.2664,20,71,20,600740,75704,69904,56352,0.5996071473830946,0.4267280547646453
2663,0.2665,28,49,28,600789,75655,69932,56324,0.5992190470155874,0.4267648641071686
2664,0.2666,18,52,18,600841,75603,69950,56306,0.5988071854010899,0.4268548772259664
2665,0.2667,19,70,19,600911,75533,69969,56287,0.5982527563046509,0.4269989379456835
2666,0.2668,26,48,26,600959,75485,69995,56261,0.597872576352807,0.42704142820275376
2667,0.2669,25,71,25,601030,75414,70020,56236,0.5973102268407046,0.42716293201671096
2668,0.267,27,50,27,601080,75364,70047,56209,0.5969142060575339,0.42720770978848244
2669,0.2671,30,60,30,601140,75304,70077,56179,0.5964389811177291,0.42727196671813084
2670,0.2672,16,57,16,601197,75247,70093,56163,0.5959875174249145,0.42738756563427444
2671,0.2673,30,55,30,601252,75192,70123,56133,0.5955518945634267,0.4274357509994289
2672,0.2674,21,64,21,601316,75128,70144,56112,0.5950449879609682,0.4275525754343188
2673,0.2675,28,48,28,601364,75080,70172,56084,0.5946648080091244,0.4275868378518496
2674,0.2676,26,67,26,601431,75013,70198,56058,0.5941341401596756,0.4276918616627629
2675,0.2677,19,73,19,601504,74940,70217,56039,0.5935559498162464,0.42784721214851235
2676,0.2678,16,53,16,601557,74887,70233,56023,0.5931361677860855,0.4279505003437476
2677,0.2679,26,63,26,601620,74824,70259,55997,0.5926371815992904,0.42804289831143316
2678,0.268,22,66,22,601686,74758,70281,55975,0.592114434165505,0.42816274391316655
2679,0.2681,21,69,21,601755,74689,70302,55954,0.5915679254847295,0.4282969619497409
2680,0.2682,18,62,18,601817,74627,70320,55936,0.5910768597135978,0.4284215283043435
2681,0.2683,20,49,20,601866,74578,70340,55916,0.5906887593460904,0.4284947966956335
2682,0.2684,14,53,14,601919,74525,70354,55902,0.5902689773159295,0.42860757358522394
2683,0.2685,25,62,25,601981,74463,70379,55877,0.5897779115447979,0.42870185668252264
2684,0.2686,19,48,19,602029,74415,70398,55858,0.5893977315929539,0.4287764924427932
2685,0.2687,22,60,22,602089,74355,70420,55836,0.5889225066531492,0.4288775721824089
2686,0.2688,16,60,16,602149,74295,70436,55820,0.5884472817133443,0.42900511086346693
2687,0.2689,17,58,17,602207,74237,70453,55803,0.5879878976048662,0.4291218086742541
2688,0.269,23,58,23,602265,74179,70476,55780,0.5875285134963882,0.4292122900299325
2689,0.2691,18,56,18,602321,74123,70494,55762,0.5870849702192371,0.4293182430611695
2690,0.2692,26,38,26,602359,74085,70520,55736,0.5867839944240274,0.42932961539350334
2691,0.2693,26,46,26,602405,74039,70546,55710,0.5864196553035104,0.42936747104023926
2692,0.2694,18,67,18,602472,73972,70564,55692,0.5858889874540616,0.42951011846001974
2693,0.2695,26,65,26,602537,73907,70590,55666,0.5853741604359397,0.4296111072522825
2694,0.2696,23,57,23,602594,73850,70613,55643,0.584922696743125,0.4296989026433861
2695,0.2697,21,64,21,602658,73786,70634,55622,0.5844157901406666,0.42981886745796244
2696,0.2698,21,49,21,602707,73737,70655,55601,0.5840276897731593,0.4298891277118867
2697,0.2699,15,61,15,602768,73676,70670,55586,0.583544544417691,0.43002583899367175
2698,0.27,16,45,16,602813,73631,70686,55570,0.5831881257128374,0.4301050301468255
2699,0.2701,29,58,29,602871,73573,70715,55541,0.5827287416043594,0.43017023715476244
2700,0.2702,17,56,17,602927,73517,70732,55524,0.5822851983272083,0.4302818484047706
2701,0.2703,24,56,24,602983,73461,70756,55500,0.581841655050057,0.4303626677832833
2702,0.2704,36,56,36,603039,73405,70792,55464,0.5813981117729058,0.4303905516454694
2703,0.2705,22,66,22,603105,73339,70814,55442,0.5808753643391206,0.43051381803216315
2704,0.2706,23,50,23,603155,73289,70837,55419,0.5804793435559498,0.4305792957702707
2705,0.2707,30,46,30,603201,73243,70867,55389,0.5801150044354327,0.4306004726662106
2706,0.2708,25,61,25,603262,73182,70892,55364,0.5796318590799645,0.43069407060507525
2707,0.2709,23,50,23,603312,73132,70915,55341,0.5792358382967938,0.43075977053544323
2708,0.271,22,60,22,603372,73072,70937,55319,0.578760613356989,0.4308635340483367
2709,0.2711,14,53,14,603425,73019,70951,55305,0.578340831326828,0.4309793959041177
2710,0.2712,24,52,24,603477,72967,70975,55281,0.5779289697123305,0.4310476576632774
2711,0.2713,16,54,16,603531,72913,70991,55265,0.5775012672665062,0.4311582330821202
2712,0.2714,19,59,19,603590,72854,71010,55246,0.5770339627423647,0.43127244340359094
2713,0.2715,22,51,22,603641,72803,71032,55224,0.5766300215435306,0.4313465128449468
2714,0.2716,25,45,25,603686,72758,71057,55199,0.576273602838677,0.4313871066061255
2715,0.2717,26,57,26,603743,72701,71083,55173,0.5758221391458623,0.43146378466302765
2716,0.2718,17,43,17,603786,72658,71100,55156,0.5754815612723355,0.4315333218583254
2717,0.2719,22,59,22,603845,72599,71122,55134,0.5750142567481942,0.4316347380864773
2718,0.272,20,44,20,603889,72555,71142,55114,0.5746657584590039,0.4316944598923779
2719,0.2721,19,68,19,603957,72487,71161,55095,0.5741271701938918,0.43183991472151245
2720,0.2722,32,54,32,604011,72433,71193,55063,0.5736994677480675,0.43188021584990904
2721,0.2723,26,62,26,604073,72371,71219,55037,0.5732084019769358,0.4319744443049102
2722,0.2724,26,51,26,604124,72320,71245,55011,0.5728044607781017,0.43203147701659456
2723,0.2725,17,59,17,604183,72261,71262,54994,0.5723371562539602,0.43215590742996346
2724,0.2726,15,67,15,604250,72194,71277,54979,0.5718064884045114,0.4323166080850495
2725,0.2727,23,54,23,604304,72140,71300,54956,0.5713787859586871,0.4323975577516208
2726,0.2728,23,44,23,604348,72096,71323,54933,0.5710302876694969,0.43244455990364405
2727,0.2729,16,54,16,604402,72042,71339,54917,0.5706025852236726,0.4325569672098867
2728,0.273,22,55,22,604457,71987,71361,54895,0.5701669623621848,0.4326460806103309
2729,0.2731,18,66,18,604523,71921,71379,54877,0.5696442149283995,0.43279073802425905
2730,0.2732,22,53,22,604576,71868,71401,54855,0.5692244328982385,0.4328732747804266
2731,0.2733,23,71,23,604647,71797,71424,54832,0.5686620833861361,0.43301297491096036
2732,0.2734,18,62,18,604709,71735,71442,54814,0.5681710176150044,0.43314447368213105
2733,0.2735,28,49,28,604758,71686,71470,54786,0.5677829172474972,0.43318679233348095
2734,0.2736,25,49,25,604807,71637,71495,54761,0.5673948168799898,0.43324261459833224
2735,0.2737,29,51,29,604858,71586,71524,54732,0.5669908756811557,0.4332874174701943
2736,0.2738,29,70,29,604928,71516,71553,54703,0.5664364465847168,0.43339750750679373
2737,0.2739,22,56,22,604984,71460,71575,54681,0.5659929033075656,0.43349109330035435
2738,0.274,24,60,24,605044,71400,71599,54657,0.5655176783677608,0.43358956662462217
2739,0.2741,19,62,19,605106,71338,71618,54638,0.5650266125966291,0.43371753349844416
2740,0.2742,26,66,26,605172,71272,71644,54612,0.5645038651628438,0.43382796860601824
2741,0.2743,30,68,30,605240,71204,71674,54582,0.5639652768977316,0.4339274641057033
2742,0.2744,21,52,21,605292,71152,71695,54561,0.5635534152832341,0.43401239330856795
2743,0.2745,25,58,25,605350,71094,71720,54536,0.5630940311747561,0.4341001353179973
2744,0.2746,23,59,23,605409,71035,71743,54513,0.5626267266506146,0.43420046516073535
2745,0.2747,23,56,23,605465,70979,71766,54490,0.5621831833734634,0.4342905418868406
2746,0.2748,23,49,23,605514,70930,71789,54467,0.5617950830059562,0.4343564838074276
2747,0.2749,21,57,21,605571,70873,71810,54446,0.5613436193131416,0.4344592599685602
2748,0.275,19,54,19,605625,70819,71829,54427,0.5609159168673172,0.4345607843763474
2749,0.2751,21,63,21,605688,70756,71850,54406,0.5604169306805221,0.4346846486952909
2750,0.2752,27,61,27,605749,70695,71877,54379,0.5599337853250539,0.4347746134288501
2751,0.2753,24,60,24,605809,70635,71901,54355,0.559458560385249,0.4348747899831987
2752,0.2754,17,49,17,605858,70586,71918,54338,0.5590704600177417,0.4349684608241811
2753,0.2755,17,45,17,605903,70541,71935,54321,0.5587140413128882,0.4350482933158207
2754,0.2756,16,69,16,605972,70472,71951,54305,0.5581675326321125,0.43521642610416983
2755,0.2757,26,49,26,606021,70423,71977,54279,0.5577794322646052,0.435269682924091
2756,0.2758,21,53,21,606074,70370,71998,54258,0.5573596502344443,0.43535963025965274
2757,0.2759,18,53,18,606127,70317,72016,54240,0.5569398682042833,0.4354632818709506
2758,0.276,20,49,20,606176,70268,72036,54220,0.5565517678367761,0.4355439881755671
2759,0.2761,23,65,23,606241,70203,72059,54197,0.5560369408186542,0.43566720257234726
2760,0.2762,21,59,21,606300,70144,72080,54176,0.5555696362945127,0.4357786357786358
2761,0.2763,22,48,22,606348,70096,72102,54154,0.5551894563426688,0.43584708249496984
2762,0.2764,22,59,22,606407,70037,72124,54132,0.5547221518185275,0.4359542236790181
2763,0.2765,23,51,23,606458,69986,72147,54109,0.5543182106196933,0.4360288488657883
2764,0.2766,21,53,21,606511,69933,72168,54088,0.5538984285895324,0.43611968940743906
2765,0.2767,28,39,28,606550,69894,72196,54060,0.5535895323786593,0.43612953192313275
2766,0.2768,22,52,22,606602,69842,72218,54038,0.5531776707641617,0.4362124636745237
2767,0.2769,19,51,19,606653,69791,72237,54019,0.5527737295653276,0.4363056295937323
2768,0.277,21,61,21,606714,69730,72258,53998,0.5522905842098593,0.43642506142506143
2769,0.2771,26,47,26,606761,69683,72284,53972,0.5519183246736789,0.4364724434919736
2770,0.2772,27,51,27,606812,69632,72311,53945,0.5515143834748447,0.4365294512732952
2771,0.2773,27,46,27,606858,69586,72338,53918,0.5511500443543277,0.43656885606943907
2772,0.2774,18,54,18,606912,69532,72356,53900,0.5507223419085033,0.43667768487912373
2773,0.2775,15,57,15,606969,69475,72371,53885,0.5502708782156888,0.4368109597924773
2774,0.2776,21,56,21,607025,69419,72392,53864,0.5498273349385375,0.4369134430537868
2775,0.2777,22,53,22,607078,69366,72414,53842,0.5494075529083766,0.4370008441010324
2776,0.2778,26,68,26,607146,69298,72440,53816,0.5488689646432645,0.437123316600874
2777,0.2779,22,60,22,607206,69238,72462,53794,0.5483937397034596,0.4372358410819949
2778,0.278,17,50,17,607256,69188,72479,53777,0.5479977189202889,0.43733582726792175
2779,0.2781,26,66,26,607322,69122,72505,53751,0.5474749714865036,0.43745167774856963
2780,0.2782,18,48,18,607370,69074,72523,53733,0.5470947915346598,0.43754020536288646
2781,0.2783,25,53,25,607423,69021,72548,53708,0.5466750095044988,0.4376145817207017
2782,0.2784,23,54,23,607477,68967,72571,53685,0.5462473070586744,0.4377017904314646
2783,0.2785,28,65,28,607542,68902,72599,53657,0.5457324800405525,0.4378054651229204
2784,0.2786,21,73,21,607615,68829,72620,53636,0.5451542896971233,0.4379700322541134
2785,0.2787,21,58,21,607673,68771,72641,53615,0.5446949055886453,0.4380811530730639
2786,0.2788,16,52,16,607725,68719,72657,53599,0.5442830439741477,0.43819388806226395
2787,0.2789,25,42,25,607767,68677,72682,53574,0.5439503865162844,0.4382295441346083
2788,0.279,29,43,29,607810,68634,72711,53545,0.5436098086427575,0.43825043583594564
2789,0.2791,31,65,31,607875,68569,72742,53514,0.5430949816246357,0.4383411285764603
2790,0.2792,22,49,22,607924,68520,72764,53492,0.5427068812571284,0.4384158935186703
2791,0.2793,15,51,15,607975,68469,72779,53477,0.5423029400582943,0.4385301690912371
2792,0.2794,30,54,30,608029,68415,72809,53447,0.5418752376124699,0.4385862697149234
2793,0.2795,21,64,21,608093,68351,72830,53426,0.5413683310100114,0.43871995532818187
2794,0.2796,15,58,15,608151,68293,72845,53411,0.5409089469015333,0.4388598567015053
2795,0.2797,24,53,24,608204,68240,72869,53387,0.5404891648713724,0.43894036685933224
2796,0.2798,25,55,25,608259,68185,72894,53362,0.5400535420098846,0.43902358758340393
2797,0.2799,31,40,31,608299,68145,72925,53331,0.5397367253833482,0.4390249925911291
2798,0.28,16,60,16,608359,68085,72941,53315,0.5392615004435433,0.43916803953871497
2799,0.2801,18,54,18,608413,68031,72959,53297,0.5388337979977189,0.43928029803507845
2800,0.2802,20,51,20,608464,67980,72979,53277,0.5384298567988848,0.439372572305104
2801,0.2803,23,52,23,608516,67928,73002,53254,0.5380179951843873,0.43945470449406676
2802,0.2804,17,61,17,608577,67867,73019,53237,0.537534849828919,0.4395973708548025
2803,0.2805,20,61,20,608638,67806,73039,53217,0.5370517044734507,0.43972633301108055
2804,0.2806,25,64,25,608702,67742,73064,53192,0.5365447978709923,0.439843220268907
2805,0.2807,19,47,19,608749,67695,73083,53173,0.5361725383348118,0.4399262004831717
2806,0.2808,29,52,29,608801,67643,73112,53144,0.5357606767203142,0.43998112379643506
2807,0.2809,21,64,21,608865,67579,73133,53123,0.5352537701178558,0.4401169823200941
2808,0.281,15,39,15,608904,67540,73148,53108,0.5349448739069826,0.4401896425966448
2809,0.2811,18,65,18,608969,67475,73166,53090,0.5344300468888608,0.4403433832372579
2810,0.2812,12,57,12,609026,67418,73178,53078,0.5339785831960461,0.4404959500730315
2811,0.2813,17,50,17,609076,67368,73195,53061,0.5335825624128754,0.4405998555165284
2812,0.2814,18,63,18,609139,67305,73213,53043,0.5330835762260804,0.44074683418087546
2813,0.2815,23,54,23,609193,67251,73236,53020,0.532655873780256,0.4408377746921536
2814,0.2816,31,55,31,609248,67196,73267,52989,0.5322202509187682,0.44089528643341513
2815,0.2817,24,61,24,609309,67135,73291,52965,0.5317371055633,0.441007493755204
2816,0.2818,13,64,13,609373,67071,73304,52952,0.5312301989608414,0.44118210676287045
2817,0.2819,18,50,18,609423,67021,73322,52934,0.5308341781776708,0.44128214747196864
2818,0.282,31,64,31,609487,66957,73353,52903,0.5303272715752123,0.4413732688136159
2819,0.2821,16,57,16,609544,66900,73369,52887,0.5298758078823976,0.4415086779032783
2820,0.2822,28,60,28,609604,66840,73397,52859,0.5294005829425928,0.44159934502376796
2821,0.2823,22,67,22,609671,66773,73419,52837,0.5288699150931441,0.44174400133768077
2822,0.2824,19,59,19,609730,66714,73438,52818,0.5284026105690026,0.4418733058929826
2823,0.2825,26,60,26,609790,66654,73464,52792,0.5279273856291978,0.44197377894613465
2824,0.2826,22,43,22,609833,66611,73486,52770,0.527586807755671,0.4420301387993064
2825,0.2827,20,50,20,609883,66561,73506,52750,0.5271907869725003,0.4421218496199009
2826,0.2828,21,58,21,609941,66503,73527,52729,0.5267314028640223,0.44223866076221147
2827,0.2829,27,56,27,609997,66447,73554,52702,0.5262878595868711,0.4423201201856499
2828,0.283,21,60,21,610057,66387,73575,52681,0.5258126346470663,0.442444653475325
2829,0.2831,28,53,28,610110,66334,73603,52653,0.5253928526169054,0.4425105263600225
2830,0.2832,16,61,16,610171,66273,73619,52637,0.524909707261437,0.44266251787065847
2831,0.2833,28,54,28,610225,66219,73647,52609,0.5244820048156127,0.44273235264415794
2832,0.2834,14,57,14,610282,66162,73661,52595,0.5240305411227981,0.4428791565970848
2833,0.2835,25,53,25,610335,66109,73686,52570,0.5236107590926372,0.44295958004364716
2834,0.2836,28,43,28,610378,66066,73714,52542,0.5232701812191104,0.44298866855524077
2835,0.2837,17,60,17,610438,66006,73731,52525,0.5227949562793055,0.4431330200538256
2836,0.2838,19,50,19,610488,65956,73750,52506,0.5223989354961348,0.44323074065945195
2837,0.2839,26,66,26,610554,65890,73776,52480,0.5218761880623495,0.4433555799611388
2838,0.284,31,54,31,610608,65836,73807,52449,0.5214484856165251,0.4434120978991419
2839,0.2841,18,67,18,610675,65769,73825,52431,0.5209178177670765,0.4435786802030457
2840,0.2842,17,49,17,610724,65720,73842,52414,0.5205297173995691,0.4436825977280038
2841,0.2843,19,54,19,610778,65666,73861,52395,0.5201020149537448,0.4437960037607677
2842,0.2844,21,46,21,610824,65620,73882,52374,0.5197376758332277,0.4438700272895232
2843,0.2845,19,44,19,610868,65576,73901,52355,0.5193891775440375,0.44394603624153106
2844,0.2846,24,60,24,610928,65516,73925,52331,0.5189139526042327,0.4440588220319567
2845,0.2847,21,55,21,610983,65461,73946,52310,0.5184783297427449,0.4441670699917637
2846,0.2848,29,51,29,611034,65410,73975,52281,0.5180743885439107,0.4442225828652998
2847,0.2849,17,48,17,611082,65362,73992,52264,0.5176942085920669,0.44432353391257035
2848,0.285,21,60,21,611142,65302,74013,52243,0.517218983652262,0.444451061295674
2849,0.2851,19,53,19,611195,65249,74032,52224,0.5167992016221011,0.44456172907817115
2850,0.2852,23,56,23,611251,65193,74055,52201,0.5163556583449499,0.44466497435984803
2851,0.2853,19,68,19,611319,65125,74074,52182,0.5158170700798378,0.44483278917711644
2852,0.2854,35,40,35,611359,65085,74109,52147,0.5155002534533012,0.44481882079978163
2853,0.2855,18,52,18,611411,65033,74127,52129,0.5150883918388037,0.44493095030812035
2854,0.2856,23,54,23,611465,64979,74150,52106,0.5146606893929794,0.44502711705171455
2855,0.2857,19,51,19,611516,64928,74169,52087,0.5142567481941452,0.4451309661154553
2856,0.2858,22,56,22,611572,64872,74191,52065,0.513813204916994,0.44523974447779574
2857,0.2859,22,56,22,611628,64816,74213,52043,0.5133696616398429,0.4453486680529527
2858,0.286,21,52,21,611680,64764,74234,52022,0.5129578000253453,0.44544722826366173
2859,0.2861,26,47,26,611727,64717,74260,51996,0.5125855404891648,0.44550307163726405
2860,0.2862,29,44,29,611771,64673,74289,51967,0.5122370421999747,0.44553326474622773
2861,0.2863,21,42,21,611813,64631,74310,51946,0.5119043847421113,0.44559389931118487
2862,0.2864,14,57,14,611870,64574,74324,51932,0.5114529210492966,0.4457452835047122
2863,0.2865,32,56,32,611926,64518,74356,51900,0.5110093777721455,0.445807349378962
2864,0.2866,25,67,25,611993,64451,74381,51875,0.5104787099226967,0.44594501659130376
2865,0.2867,23,59,23,612052,64392,74404,51852,0.5100114053985553,0.4460617322184371
2866,0.2868,20,49,20,612101,64343,74424,51832,0.509623305031048,0.446154508284915
2867,0.2869,19,54,19,612155,64289,74443,51813,0.5091956025852237,0.4462713820606019
2868,0.287,17,51,17,612206,64238,74460,51796,0.5087916613863895,0.44638640398503887
2869,0.2871,20,60,20,612266,64178,74480,51776,0.5083164364465848,0.4465218966141746
2870,0.2872,17,51,17,612317,64127,74497,51759,0.5079124952477506,0.4466372124329082
2871,0.2873,24,43,24,612360,64084,74521,51735,0.5075719173742238,0.44668836719363836
2872,0.2874,13,48,13,612408,64036,74534,51722,0.5071917374223799,0.44681145147635587
2873,0.2875,26,66,26,612474,63970,74560,51696,0.5066689899885946,0.4469420573029239
2874,0.2876,20,53,20,612527,63917,74580,51676,0.5062492079584336,0.4470512920332546
2875,0.2877,15,47,15,612574,63870,74595,51661,0.5058769484222532,0.44716136794453437
2876,0.2878,26,48,26,612622,63822,74621,51635,0.5054967684704094,0.4472227755787869
2877,0.2879,28,45,28,612667,63777,74649,51607,0.5051403497655557,0.44726305206961103
2878,0.288,17,41,17,612708,63736,74666,51590,0.5048156127233557,0.44734058234916674
2879,0.2881,20,50,20,612758,63686,74686,51570,0.504419591940185,0.4474387450544874
2880,0.2882,30,46,30,612804,63640,74716,51540,0.504055252819668,0.4474735197082827
2881,0.2883,14,60,14,612864,63580,74730,51526,0.5035800278798631,0.4476395670078015
2882,0.2884,25,56,25,612920,63524,74755,51501,0.503136484602712,0.4477374483807868
2883,0.2885,24,48,24,612968,63476,74779,51477,0.5027563046508681,0.44780910459057177
2884,0.2886,17,46,17,613014,63430,74796,51460,0.502391965530351,0.447906693358865
2885,0.2887,22,45,22,613059,63385,74818,51438,0.5020355468254974,0.4479764507110945
2886,0.2888,22,44,22,613103,63341,74840,51416,0.5016870485363072,0.4480423852139739
2887,0.2889,21,51,21,613154,63290,74861,51395,0.501283107337473,0.44814055892226534
2888,0.289,20,42,20,613196,63248,74881,51375,0.5009504498796097,0.4482084747389267
2889,0.2891,27,38,27,613234,63210,74908,51348,0.5006494740844,0.44822709893678314
2890,0.2892,20,52,20,613286,63158,74928,51328,0.5002376124699024,0.448334294149503
2891,0.2893,13,41,13,613327,63117,74941,51315,0.49991287542770246,0.4484322567114094
2892,0.2894,22,52,22,613379,63065,74963,51293,0.49950101381320494,0.4485300547403767
2893,0.2895,29,55,29,613434,63010,74992,51264,0.49906539095171715,0.4486059821131666
2894,0.2896,19,41,19,613475,62969,75011,51245,0.49874065390951716,0.44867529374682613
2895,0.2897,28,52,28,613527,62917,75039,51217,0.49832879229501964,0.44874445826835124
2896,0.2898,22,43,22,613570,62874,75061,51195,0.4979882144214928,0.4488073008442259
2897,0.2899,28,52,28,613622,62822,75089,51167,0.4975763528069953,0.44887664599215715
2898,0.29,25,48,25,613670,62774,75114,51142,0.49719617285515144,0.448944836546227
2899,0.2901,25,44,25,613714,62730,75139,51117,0.49684767456596124,0.4489973385332947
2900,0.2902,20,53,20,613767,62677,75159,51097,0.4964278925358003,0.4491096384059627
2901,0.2903,16,46,16,613813,62631,75175,51081,0.49606355341528324,0.44921380329252847
2902,0.2904,23,55,23,613868,62576,75198,51058,0.49562793055379545,0.4493197458507137
2903,0.2905,17,71,17,613939,62505,75215,51041,0.49506558104169307,0.4495182569179011
2904,0.2906,31,40,31,613979,62465,75246,51010,0.49474876441515653,0.4495263273848865
2905,0.2907,23,52,23,614031,62413,75269,50987,0.494336902800659,0.44962081128747794
2906,0.2908,20,33,20,614064,62380,75289,50967,0.49407552908376634,0.44965460047464867
2907,0.2909,13,48,13,614112,62332,75302,50954,0.4936953491319224,0.4497819677630069
2908,0.291,19,52,19,614164,62280,75321,50935,0.4932834875174249,0.4498962151658349
2909,0.2911,14,49,14,614213,62231,75335,50921,0.49289538714991765,0.45002297794117646
2910,0.2912,20,53,20,614266,62178,75355,50901,0.4924756051197567,0.45013663014352795
2911,0.2913,22,53,22,614319,62125,75377,50879,0.4920558230895957,0.4502406994442675
2912,0.2914,19,52,19,614371,62073,75396,50860,0.4916439614750982,0.4503555205298717
2913,0.2915,16,59,16,614430,62014,75412,50844,0.4911766569509568,0.4505130340782222
2914,0.2916,26,43,26,614473,61971,75438,50818,0.49083607907743,0.4505581218026581
2915,0.2917,18,65,18,614538,61906,75456,50800,0.4903212520593081,0.4507302184444484
2916,0.2918,30,39,30,614577,61867,75486,50770,0.49001235584843494,0.45073998774825325
2917,0.2919,25,63,25,614640,61804,75511,50745,0.48951336966163983,0.450870287608064
2918,0.292,22,55,22,614695,61749,75533,50723,0.4890777468001521,0.45098335585745786
2919,0.2921,13,61,13,614756,61688,75546,50710,0.4885946014446838,0.45116461146995496
2920,0.2922,18,63,18,614819,61625,75564,50692,0.48809561525788875,0.45132971856442033
2921,0.2923,21,40,21,614859,61585,75585,50671,0.48777879863135215,0.4513878990877993
2922,0.2924,22,57,22,614916,61528,75607,50649,0.4873273349385376,0.45150966775720514
2923,0.2925,12,53,12,614969,61475,75619,50637,0.4869075529083766,0.45166440702154986
2924,0.2926,14,49,14,615018,61426,75633,50623,0.48651945254086937,0.45179341181090416
2925,0.2927,20,48,20,615066,61378,75653,50603,0.48613927258902545,0.45188915976817495
2926,0.2928,34,45,34,615111,61333,75687,50569,0.48578285388417186,0.45190434487319264
2927,0.2929,20,54,20,615165,61279,75707,50549,0.4853551514383475,0.4520245376828701
2928,0.293,23,53,23,615218,61226,75730,50526,0.48493536940818655,0.45212613644498534
2929,0.2931,17,49,17,615267,61177,75747,50509,0.48454726904067924,0.4522411045251867
2930,0.2932,28,62,28,615329,61115,75775,50481,0.48405620326954757,0.45235492311552383
2931,0.2933,20,48,20,615377,61067,75795,50461,0.4836760233177037,0.45245140233842623
2932,0.2934,12,49,12,615426,61018,75807,50449,0.4832879229501964,0.4525913499062503
2933,0.2935,23,41,23,615467,60977,75830,50426,0.4829631859079965,0.4526449018428588
2934,0.2936,26,61,26,615528,60916,75856,50400,0.4824800405525282,0.452765101153473
2935,0.2937,22,45,22,615573,60871,75878,50378,0.48212362184767454,0.45284002552831937
2936,0.2938,24,51,24,615624,60820,75902,50354,0.48171968064884046,0.4529296418227283
2937,0.2939,33,56,33,615680,60764,75935,50321,0.4812761373716893,0.45299545393167395
2938,0.294,22,46,22,615726,60718,75957,50299,0.4809117982511722,0.4530747543169064
2939,0.2941,20,48,20,615774,60670,75977,50279,0.48053161829932833,0.4531721782080055
2940,0.2942,22,44,22,615818,60626,75999,50257,0.48018312001013813,0.4532435089238206
2941,0.2943,18,48,18,615866,60578,76017,50239,0.47980294005829427,0.45335102015033796
2942,0.2944,30,42,30,615908,60536,76047,50209,0.4794702826004309,0.4533748701973001
2943,0.2945,21,39,21,615947,60497,76068,50188,0.47916138638955774,0.453430907530379
2944,0.2946,19,61,19,616008,60436,76087,50169,0.47867824103408946,0.4535870891912662
2945,0.2947,15,41,15,616049,60395,76102,50154,0.4783535039918895,0.45368117305448263
2946,0.2948,20,48,20,616097,60347,76122,50134,0.4779733240400456,0.4537793828803143
2947,0.2949,24,45,24,616142,60302,76146,50110,0.47761690533519197,0.45384559649313483
2948,0.295,15,42,15,616184,60260,76161,50095,0.4772842478773286,0.45394408952924653
2949,0.2951,19,51,19,616235,60209,76180,50076,0.4768803066784945,0.4540599356213447
2950,0.2952,22,49,22,616284,60160,76202,50054,0.4764922063109872,0.4541528299490083
2951,0.2953,19,53,19,616337,60107,76221,50035,0.47607242428082625,0.4542772057888907
2952,0.2954,19,42,19,616379,60065,76240,50016,0.4757397668229629,0.45435633760594474
2953,0.2955,17,42,17,616421,60023,76257,49999,0.4754071093650995,0.45444547454145534
2954,0.2956,16,39,16,616460,59984,76273,49983,0.47509821315422635,0.45452726727109044
2955,0.2957,23,32,23,616492,59952,76296,49960,0.47484475985299707,0.45454545454545453
2956,0.2958,25,33,25,616525,59919,76321,49935,0.4745833861361044,0.45455786771533124
2957,0.2959,17,61,17,616586,59858,76338,49918,0.4741002407806362,0.45472598746538406
2958,0.296,23,46,23,616632,59812,76361,49895,0.47373590166011914,0.454802337134367
2959,0.2961,15,54,15,616686,59758,76376,49880,0.4733081992142948,0.454951750305551
2960,0.2962,19,53,19,616739,59705,76395,49861,0.4728884171841338,0.45507730500337695
2961,0.2963,24,37,24,616776,59668,76419,49837,0.4725953618045875,0.4551116387379572
2962,0.2964,24,39,24,616815,59629,76443,49813,0.47228646559371434,0.4551543283200234
2963,0.2965,17,40,17,616855,59589,76460,49796,0.4719696489671778,0.455236092700096
2964,0.2966,21,49,21,616904,59540,76481,49775,0.4715815485996705,0.45533549833051273
2965,0.2967,23,38,23,616942,59502,76504,49752,0.4712805728044608,0.4553792080839145
2966,0.2968,26,46,26,616988,59456,76530,49726,0.47091623368394375,0.45544137312011135
2967,0.2969,20,37,20,617025,59419,76550,49706,0.4706231783043974,0.455495990836197
2968,0.297,25,39,25,617064,59380,76575,49681,0.47031428209352427,0.45553405892115423
2969,0.2971,23,46,23,617110,59334,76598,49658,0.46994994297300724,0.45561142102172636
2970,0.2972,15,34,15,617144,59300,76613,49643,0.46968064884045113,0.45567865764665927
2971,0.2973,21,62,21,617206,59238,76634,49622,0.46918958306931946,0.45583318023149
2972,0.2974,21,43,21,617249,59195,76655,49601,0.4688490051957927,0.45590830545240635
2973,0.2975,28,42,28,617291,59153,76683,49573,0.4685163477379293,0.4559443003513419
2974,0.2976,24,39,24,617330,59114,76707,49549,0.4682074515270561,0.4559877787287301
2975,0.2977,19,46,19,617376,59068,76726,49530,0.4678431124065391,0.45608574743549607
2976,0.2978,24,48,24,617424,59020,76750,49506,0.4674629324546952,0.45616718574350845
2977,0.2979,12,53,12,617477,58967,76762,49494,0.46704315042453426,0.45632992504218106
2978,0.298,22,43,22,617520,58924,76784,49472,0.4667025725510075,0.4564006051883833
2979,0.2981,23,40,23,617560,58884,76807,49449,0.4663857559244709,0.4564537121652682
2980,0.2982,23,55,23,617615,58829,76830,49426,0.46595013306298316,0.45657013532862223
2981,0.2983,32,49,32,617664,58780,76862,49394,0.46556203269547586,0.4566161924307135
2982,0.2984,12,52,12,617716,58728,76874,49382,0.46515017108097834,0.4567755064286375
2983,0.2985,9,48,9,617764,58680,76883,49373,0.4647699911291345,0.45693317168426606
2984,0.2986,21,43,21,617807,58637,76904,49352,0.46442941325560766,0.4570095102278936
2985,0.2987,27,49,27,617856,58588,76931,49325,0.46404131288810035,0.4570811672365702
2986,0.2988,25,55,25,617911,58533,76956,49300,0.4636056900266126,0.4571884302578988
2987,0.2989,21,45,21,617956,58488,76977,49279,0.46324927132175897,0.45727356240778716
2988,0.299,26,42,26,617998,58446,77003,49253,0.4629166138638956,0.45732086648901105
2989,0.2991,22,45,22,618043,58401,77025,49231,0.46256019515904195,0.45740114464099896
2990,0.2992,18,46,18,618089,58355,77043,49213,0.4621958560385249,0.4575059497248252
2991,0.2993,23,45,23,618134,58310,77066,49190,0.4618394373336713,0.4575813953488372
2992,0.2994,25,52,25,618186,58258,77091,49165,0.46142757571917375,0.4576766614226004
2993,0.2995,16,38,16,618224,58220,77107,49149,0.461126599923964,0.4577578258156451
2994,0.2996,14,38,14,618262,58182,77121,49135,0.4608256241287543,0.4578491758062562
2995,0.2997,21,42,21,618304,58140,77142,49114,0.4604929666708909,0.4579223152516456
2996,0.2998,19,44,19,618348,58096,77161,49095,0.46014446838170064,0.45801419895327034
2997,0.2999,26,46,26,618394,58050,77187,49069,0.4597801292611836,0.45807933233133247
2998,0.3,25,48,25,618442,58002,77212,49044,0.45939994930933975,0.4581581749901911
2999,0.3001,15,57,15,618499,57945,77227,49029,0.4589484856165252,0.45832632228391945
3000,0.3002,20,44,20,618543,57901,77247,49009,0.4585999873273349,0.4584136189318118
3001,0.3003,18,37,18,618580,57864,77265,48991,0.4583069319477886,0.4584811192737822
3002,0.3004,19,40,19,618620,57824,77284,48972,0.45799011532125206,0.4585565002434548
3003,0.3005,26,38,26,618658,57786,77310,48946,0.45768913952604234,0.4585878649327287
3004,0.3006,16,40,16,618698,57746,77326,48930,0.45737232289950575,0.45867861562113316
3005,0.3007,12,46,12,618744,57700,77338,48918,0.4570079837789887,0.45881558461047856
3006,0.3008,21,42,21,618786,57658,77359,48897,0.45667532632112534,0.45888977523344754
3007,0.3009,19,44,19,618830,57614,77378,48878,0.45632682803193514,0.45898283439131576
3008,0.301,19,48,19,618878,57566,77397,48859,0.4559466480800912,0.4590932581630256
3009,0.3011,21,36,21,618914,57530,77418,48838,0.45566151311620834,0.45914184717208184
3010,0.3012,14,49,14,618963,57481,77432,48824,0.45527341274870103,0.4592822538921029
3011,0.3013,15,52,15,619015,57429,77447,48809,0.4548615511342035,0.4594307121745515
3012,0.3014,30,42,30,619057,57387,77477,48779,0.45452889367634014,0.45945971403274116
3013,0.3015,26,51,26,619108,57336,77503,48753,0.454124952477506,0.45954811526171424
3014,0.3016,25,41,25,619149,57295,77528,48728,0.453800215435306,0.45959838902879563
3015,0.3017,17,43,17,619192,57252,77545,48711,0.45345963756177926,0.4596981965403018
3016,0.3018,11,41,11,619233,57211,77556,48700,0.4531349005195793,0.45982003757872175
3017,0.3019,22,45,22,619278,57166,77578,48678,0.45277848181472563,0.45990325384528175
3018,0.302,22,44,22,619322,57122,77600,48656,0.45242998352553543,0.4599822269280947
3019,0.3021,15,55,15,619377,57067,77615,48641,0.45199436066404763,0.4601449275362319
3020,0.3022,27,43,27,619420,57024,77642,48614,0.4516537827905208,0.4601942482818683
3021,0.3023,25,32,25,619452,56992,77667,48589,0.4514003294892916,0.4602059082600089
3022,0.3024,25,44,25,619496,56948,77692,48564,0.4510518312001014,0.46026992190461746
3023,0.3025,24,42,24,619538,56906,77716,48540,0.45071917374223797,0.460330406084631
3024,0.3026,19,38,19,619576,56868,77735,48521,0.45041819794702825,0.46039909288445663
3025,0.3027,6,47,6,619623,56821,77741,48515,0.4500459384108478,0.46057378294220397
3026,0.3028,18,47,18,619670,56774,77759,48497,0.44967367887466736,0.460687178805179
3027,0.3029,25,49,25,619719,56725,77784,48472,0.44928557850716005,0.46077359620521496
3028,0.303,25,39,25,619758,56686,77809,48447,0.4489766822962869,0.4608162993541514
3029,0.3031,16,37,16,619795,56649,77825,48431,0.4486836269167406,0.4608964598401218
3030,0.3032,16,49,16,619844,56600,77841,48415,0.4482955265492333,0.46102937675570155
3031,0.3033,13,32,13,619876,56568,77854,48402,0.44804207324800405,0.46110317233495285
3032,0.3034,16,54,16,619930,56514,77870,48386,0.4476143708021797,0.46125834127740706
3033,0.3035,19,30,19,619960,56484,77889,48367,0.4473767583322773,0.4612926915337002
3034,0.3036,24,54,24,620014,56430,77913,48343,0.4469490558864529,0.4614070418905634
3035,0.3037,19,46,19,620060,56384,77932,48324,0.44658471676593586,0.46151201436375444
3036,0.3038,21,53,21,620113,56331,77953,48303,0.44616493473577495,0.46163770858420783
3037,0.3039,22,39,22,620152,56292,77975,48281,0.4458560385249018,0.461696613848699
3038,0.304,12,34,12,620186,56258,77987,48269,0.4455867443923457,0.4617849933510002
3039,0.3041,29,55,29,620241,56203,78016,48240,0.44515112153085795,0.4618787281100696
3040,0.3042,20,50,20,620291,56153,78036,48220,0.44475510074768726,0.46199687658685673
3041,0.3043,19,29,19,620320,56124,78055,48201,0.44452540869344825,0.4620273184759166
3042,0.3044,13,55,13,620375,56069,78068,48188,0.44408978583196046,0.4622039767113959
3043,0.3045,24,46,24,620421,56023,78092,48164,0.4437254467114434,0.46228416213155193
3044,0.3046,16,43,16,620464,55980,78108,48148,0.4433848688379166,0.46239244007375535
3045,0.3047,23,41,23,620505,55939,78131,48125,0.4430601317957166,0.4624557964329643
3046,0.3048,28,42,28,620547,55897,78159,48097,0.44272747433785326,0.46249783641363923
3047,0.3049,20,50,20,620597,55847,78179,48077,0.44233145355468256,0.4626169123590316
3048,0.305,16,32,16,620629,55815,78195,48061,0.4420780002534533,0.4626766529323424
3049,0.3051,20,43,20,620672,55772,78215,48041,0.4417374223799265,0.4627647789775847
3050,0.3052,28,47,28,620719,55725,78243,48013,0.44136516284374605,0.462829435693767
3051,0.3053,14,57,14,620776,55668,78257,47999,0.4409136991509314,0.4630113729537847
3052,0.3054,12,44,12,620820,55624,78269,47987,0.4405652008617412,0.4631458049820965
3053,0.3055,20,42,20,620862,55582,78289,47967,0.44023254340387785,0.46322996842074765
3054,0.3056,21,46,21,620908,55536,78310,47946,0.43986820428336076,0.4633269554125355
3055,0.3057,15,32,15,620940,55504,78325,47931,0.43961475098213154,0.46339246870014983
3056,0.3058,16,48,16,620988,55456,78341,47915,0.4392345710302877,0.46352458619922415
3057,0.3059,20,41,20,621029,55415,78361,47895,0.4389098339880877,0.4636046849288549
3058,0.306,21,37,21,621066,55378,78382,47874,0.43861677860854137,0.4636617208383373
3059,0.3061,28,65,28,621131,55313,78410,47846,0.4381019515904195,0.4638082959315232
3060,0.3062,15,38,15,621169,55275,78425,47831,0.4378009757952097,0.46390122786258803
3061,0.3063,23,32,23,621201,55243,78448,47808,0.4375475224939805,0.463925629057457
3062,0.3064,18,51,18,621252,55192,78466,47790,0.43714358129514636,0.46406168068206094
3063,0.3065,13,48,13,621300,55144,78479,47777,0.4367634013433025,0.4642104138125358
3064,0.3066,18,34,18,621334,55110,78497,47759,0.43649410721074644,0.46427009108672196
3065,0.3067,12,40,12,621374,55070,78509,47747,0.43617729058420984,0.4643881848332474
3066,0.3068,22,27,22,621401,55043,78531,47725,0.43596343936129767,0.4643955316830142
3067,0.3069,22,38,22,621439,55005,78553,47703,0.43566246356608795,0.46445262296997314
3068,0.307,16,44,16,621483,54961,78569,47687,0.43531396527689775,0.4645682331852545
3069,0.3071,21,51,21,621534,54910,78590,47666,0.4349100240780636,0.4646895960068632
3070,0.3072,17,47,17,621581,54863,78607,47649,0.43453776454188314,0.46481387544872793
3071,0.3073,19,42,19,621623,54821,78626,47630,0.43420510708401977,0.4649051741808279
3072,0.3074,19,51,19,621674,54770,78645,47611,0.43380116588518564,0.4650374581221125
3073,0.3075,9,47,9,621721,54723,78654,47602,0.4334289063490052,0.465204006840948
3074,0.3076,24,51,24,621772,54672,78678,47578,0.4330249651501711,0.46531051344743274
3075,0.3077,18,32,18,621804,54640,78696,47560,0.43277151184894186,0.46536203522504893
3076,0.3078,19,43,19,621847,54597,78715,47541,0.43243093397541504,0.4654584973271456
3077,0.3079,17,39,17,621886,54558,78732,47524,0.4321220377645419,0.46554730510765857
3078,0.308,20,51,20,621937,54507,78752,47504,0.43171809656570775,0.46567527031398576
3079,0.3081,24,37,24,621974,54470,78776,47480,0.43142504118616143,0.4657184894556155
3080,0.3082,24,43,24,622017,54427,78800,47456,0.43108446331263467,0.46578918956057436
3081,0.3083,18,49,18,622066,54378,78818,47438,0.43069636294512736,0.465918912548126
3082,0.3084,26,45,26,622111,54333,78844,47412,0.4303399442402737,0.4659885006634233
3083,0.3085,20,39,20,622150,54294,78864,47392,0.43003104802940056,0.4660621914521173
3084,0.3086,15,51,15,622201,54243,78879,47377,0.4296271068305665,0.46621728006297974
3085,0.3087,12,34,12,622235,54209,78891,47365,0.4293578126980104,0.4663102762517967
3086,0.3088,17,56,17,622291,54153,78908,47348,0.4289142694208592,0.46647816277672144
3087,0.3089,24,31,24,622322,54122,78932,47324,0.42866873653529336,0.46649448967923823
3088,0.309,16,43,16,622365,54079,78948,47308,0.42832815866176654,0.4666081450284553
3089,0.3091,26,48,26,622413,54031,78974,47282,0.4279479787099227,0.4666923297108959
3090,0.3092,20,47,20,622460,53984,78994,47262,0.42757571917374226,0.466803626809948
3091,0.3093,25,43,25,622503,53941,79019,47237,0.42723514130021545,0.4668702682401313
3092,0.3094,19,39,19,622542,53902,79038,47218,0.4269262450893423,0.4669501582278481
3093,0.3095,19,37,19,622579,53865,79057,47199,0.42663318970979597,0.4670208976490145
3094,0.3096,20,41,20,622620,53824,79077,47179,0.426308452667596,0.46710493747710463
3095,0.3097,15,28,15,622648,53796,79092,47164,0.4260866810290204,0.4671553090332805
3096,0.3098,19,46,19,622694,53750,79111,47145,0.42572234190850333,0.4672679518311115
3097,0.3099,13,51,13,622745,53699,79124,47132,0.42531840070966925,0.46743561008023327
3098,0.31,11,47,11,622792,53652,79135,47121,0.4249461411734888,0.46759548688636837
3099,0.3101,9,42,9,622834,53610,79144,47112,0.4246134837156254,0.4677428962887949
3100,0.3102,18,40,18,622874,53570,79162,47094,0.4242966670890888,0.46783358499562905
3101,0.3103,18,38,18,622912,53532,79180,47076,0.4239956912938791,0.46791507633587787
3102,0.3104,13,51,13,622963,53481,79193,47063,0.42359175009504496,0.46808362507956713
3103,0.3105,20,49,20,623012,53432,79213,47043,0.4232036497275377,0.4682060213983578
3104,0.3106,25,35,25,623047,53397,79238,47018,0.4229264351793182,0.4682368172085844
3105,0.3107,27,43,27,623090,53354,79265,46991,0.4225858573057914,0.46829438437391
3106,0.3108,19,41,19,623131,53313,79284,46972,0.4222611202635914,0.4683851024579947
3107,0.3109,12,36,12,623167,53277,79296,46960,0.42197598529970853,0.46848967945968056
3108,0.311,28,34,28,623201,53243,79324,46932,0.4217066911671524,0.46850012478163217
3109,0.3111,15,33,15,623234,53210,79339,46917,0.4214453174502598,0.46857490986447214
3110,0.3112,14,39,14,623273,53171,79353,46903,0.42113642123938666,0.46868317445090635
3111,0.3113,22,39,22,623312,53132,79375,46881,0.4208275250285135,0.46874906262185917
3112,0.3114,17,35,17,623347,53097,79392,46864,0.420550310480294,0.4688228409079541
3113,0.3115,20,51,20,623398,53046,79412,46844,0.4201463692814599,0.46895585143658025
3114,0.3116,15,47,15,623445,52999,79427,46829,0.41977410974527946,0.4690968465761109
3115,0.3117,23,56,23,623501,52943,79450,46806,0.4193305664681283,0.4692377868449809
3116,0.3118,18,40,18,623541,52903,79468,46788,0.4190137498415917,0.46933023041197297
3117,0.3119,17,31,17,623572,52872,79485,46771,0.41876821695602584,0.4693857069738968
3118,0.312,18,36,18,623608,52836,79503,46753,0.41848308199214296,0.469459478456456
3119,0.3121,17,52,17,623660,52784,79520,46736,0.41807122037764544,0.46961414790996786
3120,0.3122,31,55,31,623715,52729,79551,46705,0.41763559751615764,0.46970855039523707
3121,0.3123,20,37,20,623752,52692,79571,46685,0.4173425421366113,0.4697767088964247
3122,0.3124,21,29,21,623781,52663,79592,46664,0.4171128500823723,0.46980176588440203
3123,0.3125,17,39,17,623820,52624,79609,46647,0.41680395387149916,0.4698955384754863
3124,0.3126,17,41,17,623861,52583,79626,46630,0.4164792168292992,0.469998891274329
3125,0.3127,21,37,21,623898,52546,79647,46609,0.4161861614497529,0.4700620241036761
3126,0.3128,20,35,20,623933,52511,79667,46589,0.4159089469015334,0.4701210898082745
3127,0.3129,21,30,21,623963,52481,79688,46568,0.41567133443163096,0.47015113731587393
3128,0.313,20,46,20,624009,52435,79708,46548,0.4153069953111139,0.47026257034036145
3129,0.3131,15,50,15,624059,52385,79723,46533,0.41491097452794323,0.47041994379182756
3130,0.3132,13,31,13,624090,52354,79736,46520,0.4146654416423774,0.47049780528753765
3131,0.3133,19,46,19,624136,52308,79755,46501,0.41430110252186036,0.4706150249471202
3132,0.3134,20,48,20,624184,52260,79775,46481,0.41392092257001645,0.47073657345985964
3133,0.3135,21,36,21,624220,52224,79796,46460,0.41363578760613356,0.47079567103076486
3134,0.3136,24,33,24,624253,52191,79820,46436,0.4133744138892409,0.4708244192766687
3135,0.3137,17,41,17,624294,52150,79837,46419,0.4130496768470409,0.47092899390274834
3136,0.3138,14,40,14,624334,52110,79851,46405,0.41273286022050437,0.4710450185250977
3137,0.3139,17,55,17,624389,52055,79868,46388,0.4122972373590166,0.47121684629684185
3138,0.314,16,36,16,624425,52019,79884,46372,0.4120121023951337,0.4713032696079926
3139,0.3141,19,50,19,624475,51969,79903,46353,0.411616081611963,0.4714407762250564
3140,0.3142,22,36,22,624511,51933,79925,46331,0.41133094664808006,0.4714951559065375
3141,0.3143,16,52,16,624563,51881,79941,46315,0.41091908503358254,0.47165872336958736
3142,0.3144,23,38,23,624601,51843,79964,46292,0.41061810923837283,0.4717175319712641
3143,0.3145,19,50,19,624651,51793,79983,46273,0.41022208845520214,0.47185568902575814
3144,0.3146,19,26,19,624677,51767,80002,46254,0.41001615764795335,0.4718784750206588
3145,0.3147,16,47,16,624724,51720,80018,46238,0.40964389811177293,0.4720186202249944
3146,0.3148,14,51,14,624775,51669,80032,46224,0.4092399569129388,0.4721890227084674
3147,0.3149,20,34,20,624809,51635,80052,46204,0.4089706627803827,0.47224521918662293
3148,0.315,21,37,21,624846,51598,80073,46183,0.4086776074008364,0.4723105715834365
3149,0.3151,22,43,22,624889,51555,80095,46161,0.4083370295273096,0.4723996070244382
3150,0.3152,18,52,18,624941,51503,80113,46143,0.4079251679128121,0.47255391925936546
3151,0.3153,16,38,16,624979,51465,80129,46127,0.4076241921176023,0.4726514468399049
3152,0.3154,22,35,22,625014,51430,80151,46105,0.4073469775693828,0.4727021069359717
3153,0.3155,17,44,17,625058,51386,80168,46088,0.4069984792801926,0.47282352217001455
3154,0.3156,14,49,14,625107,51337,80182,46074,0.4066103789126853,0.47298559710915605
3155,0.3157,22,49,22,625156,51288,80204,46052,0.40622227854517806,0.47310458187795357
3156,0.3158,21,38,21,625194,51250,80225,46031,0.4059213027499683,0.473175645809562
3157,0.3159,22,47,22,625241,51203,80247,46009,0.4055490432137879,0.47328519112866724
3158,0.316,16,41,16,625282,51162,80263,45993,0.4052243061715879,0.47339817816890534
3159,0.3161,15,52,15,625334,51110,80278,45978,0.40481244455709037,0.47357036914963746
3160,0.3162,16,32,16,625366,51078,80294,45962,0.4045589912558611,0.4736397361912613
3161,0.3163,14,44,14,625410,51034,80308,45948,0.4042104929666709,0.47377863933513437
3162,0.3164,21,38,21,625448,50996,80329,45927,0.4039095171714612,0.47385037607172703
3163,0.3165,18,40,18,625488,50956,80347,45909,0.4035927005449246,0.4739482785319775
3164,0.3166,19,34,19,625522,50922,80366,45890,0.4033234064123685,0.47401148617939926
3165,0.3167,19,46,19,625568,50876,80385,45871,0.4029590672918515,0.4741335648650604
3166,0.3168,20,30,20,625598,50846,80405,45851,0.40272145482194904,0.47417189778379887
3167,0.3169,21,37,21,625635,50809,80426,45830,0.4024283994424027,0.4742391787994495
3168,0.317,23,36,23,625671,50773,80449,45807,0.40214326447851984,0.47429074342513977
3169,0.3171,20,33,20,625704,50740,80469,45787,0.40188189076162717,0.47434396593699174
3170,0.3172,13,42,13,625746,50698,80482,45774,0.4015492333037638,0.47447964176134005
3171,0.3173,18,35,18,625781,50663,80500,45756,0.4012720187555443,0.47455377052240744
3172,0.3174,22,31,22,625812,50632,80522,45734,0.40102648586997847,0.4745864724072806
3173,0.3175,16,42,16,625854,50590,80538,45718,0.4006938284121151,0.4747061510985588
3174,0.3176,14,38,14,625892,50552,80552,45704,0.4003928526169053,0.4748171542553192
3175,0.3177,22,47,22,625939,50505,80574,45682,0.40002059308072485,0.4749290444654683
3176,0.3178,24,36,24,625975,50469,80598,45658,0.39973545811684197,0.47497581324705856
3177,0.3179,32,34,32,626009,50435,80630,45626,0.3994661639842859,0.47496903009546015
3178,0.318,21,43,21,626052,50392,80651,45605,0.3991255861107591,0.47506692917487003
3179,0.3181,17,35,17,626087,50357,80668,45588,0.3988483715625396,0.47514721976132157
3180,0.3182,29,33,29,626120,50324,80697,45559,0.39858699784564694,0.47515200817663195
3181,0.3183,18,41,18,626161,50283,80715,45541,0.39826226080344695,0.47525672065453334
3182,0.3184,18,40,18,626201,50243,80733,45523,0.3979454441769104,0.4753565983752062
3183,0.3185,14,41,14,626242,50202,80747,45509,0.3976207071347104,0.47548348674655994
3184,0.3186,21,55,21,626297,50147,80768,45488,0.39718508427322263,0.4756417629528938
3185,0.3187,16,44,16,626341,50103,80784,45472,0.39683658598403243,0.47577295317813234
3186,0.3188,12,36,12,626377,50067,80796,45460,0.39655145102014955,0.47588639860981713
3187,0.3189,20,38,20,626415,50029,80816,45440,0.3962504752249398,0.47596602038358
3188,0.319,15,29,15,626444,50000,80831,45425,0.3960207831707008,0.4760282944720985
3189,0.3191,17,39,17,626483,49961,80848,45408,0.3957118869598277,0.4761295599198901
3190,0.3192,15,35,15,626518,49926,80863,45393,0.3954346724116082,0.47622194945393886
3191,0.3193,26,37,26,626555,49889,80889,45367,0.39514161703206185,0.4762639623750735
3192,0.3194,17,40,17,626595,49849,80906,45350,0.39482480040552526,0.47637055011082047
3193,0.3195,17,46,17,626641,49803,80923,45333,0.3944604612850082,0.47650731584258327
3194,0.3196,16,38,16,626679,49765,80939,45317,0.3941594854897985,0.47660966323804715
3195,0.3197,27,35,27,626714,49730,80966,45290,0.393882270941579,0.476636497579457
3196,0.3198,24,30,24,626744,49700,80990,45266,0.39364465847167657,0.4766548027715182
3197,0.3199,12,36,12,626780,49664,81002,45254,0.3933595235077937,0.4767694220274342
3198,0.32,19,42,19,626822,49622,81021,45235,0.3930268660499303,0.4768757181863226
3199,0.3201,26,33,26,626855,49589,81047,45209,0.39276549233303765,0.47689824679845566
3200,0.3202,19,35,19,626890,49554,81066,45190,0.39248827778481815,0.47696951785865066
3201,0.3203,20,40,20,626930,49514,81086,45170,0.3921714611582816,0.47706053821131345
3202,0.3204,14,32,14,626962,49482,81100,45156,0.39191800785705233,0.4771444874152032
3203,0.3205,19,31,19,626993,49451,81119,45137,0.3916724749714865,0.4771958387956189
3204,0.3206,20,39,20,627032,49412,81139,45117,0.39136357876061334,0.47728210390462183
3205,0.3207,22,32,22,627064,49380,81161,45095,0.3911101254593841,0.47732204286848373
3206,0.3208,21,43,21,627107,49337,81182,45074,0.3907695475858573,0.47742318162078573
3207,0.3209,19,30,19,627137,49307,81201,45055,0.3905319351159549,0.4774697441766813
3208,0.321,16,39,16,627176,49268,81217,45039,0.39022303890508175,0.4775785466614355
3209,0.3211,24,35,24,627211,49233,81241,45015,0.38994582435686226,0.4776228673287497
3210,0.3212,16,35,16,627246,49198,81257,44999,0.38966860980864276,0.47771160440353727
3211,0.3213,21,38,21,627284,49160,81278,44978,0.38936763401343305,0.47778792836049205
3212,0.3214,21,41,21,627325,49119,81299,44957,0.38904289697123307,0.47787958671712233
3213,0.3215,16,41,16,627366,49078,81315,44941,0.3887181599290331,0.47799912783586296
3214,0.3216,9,33,9,627399,49045,81324,44932,0.3884567862121404,0.47811698607105996
3215,0.3217,15,40,15,627439,49005,81339,44917,0.3881399695856039,0.47823726070569195
3216,0.3218,20,41,20,627480,48964,81359,44897,0.3878152325434039,0.478334984711435
3217,0.3219,14,54,14,627534,48910,81373,44883,0.38738753009757954,0.47853251308733064
3218,0.322,29,36,29,627570,48874,81402,44854,0.3871023951336966,0.4785549675657221
3219,0.3221,20,50,20,627620,48824,81422,44834,0.3867063743505259,0.4786990967135749
3220,0.3222,25,34,25,627654,48790,81447,44809,0.38643708021796985,0.47873374715541833
3221,0.3223,23,43,23,627697,48747,81470,44786,0.38609650234444304,0.47882565511637604
3222,0.3224,21,37,21,627734,48710,81491,44765,0.3858034469648967,0.4788981010965499
3223,0.3225,16,29,16,627763,48681,81507,44749,0.3855737549106577,0.4789575082949802
3224,0.3226,12,38,12,627801,48643,81519,44737,0.385272779115448,0.4790854572713643
3225,0.3227,20,43,20,627844,48600,81539,44717,0.3849322012419212,0.4791945733360481
3226,0.3228,19,40,19,627884,48560,81558,44698,0.38461538461538464,0.4792940015869952
3227,0.3229,20,36,20,627920,48524,81578,44678,0.3843302496515017,0.47936739554945174
3228,0.323,25,42,25,627962,48482,81603,44653,0.3839975921936383,0.4794438181134912
3229,0.3231,23,37,23,627999,48445,81626,44630,0.383704536814092,0.4795057749127048
3230,0.3232,21,38,21,628037,48407,81647,44609,0.3834035610188823,0.47958415756429
3231,0.3233,15,39,15,628076,48368,81662,44594,0.38309466480800913,0.4797013833609432
3232,0.3234,17,33,17,628109,48335,81679,44577,0.38283329109111647,0.4797765627690718
3233,0.3235,15,48,15,628157,48287,81694,44562,0.3824531111392726,0.4799405486327262
3234,0.3236,15,33,15,628190,48254,81709,44547,0.38219173742237994,0.4800271548797966
3235,0.3237,13,38,13,628228,48216,81722,44534,0.38189076162717017,0.48015094339622644
3236,0.3238,14,34,14,628262,48182,81736,44520,0.3816214674946141,0.4802485383271127
3237,0.3239,14,35,14,628297,48147,81750,44506,0.3813442529463946,0.48035141873441767
3238,0.324,17,41,17,628338,48106,81767,44489,0.38101951590419464,0.48046870781359685
3239,0.3241,24,29,24,628367,48077,81791,44465,0.38078982384995563,0.4804845367508807
3240,0.3242,15,35,15,628402,48042,81806,44450,0.38051260930173614,0.48058210439821825
3241,0.3243,21,33,21,628435,48009,81827,44429,0.38025123558484347,0.4806356693134858
3242,0.3244,15,38,15,628473,47971,81842,44414,0.37995025978963376,0.4807490393462142
3243,0.3245,10,39,10,628512,47932,81852,44404,0.3796413635787606,0.48089585860336165
3244,0.3246,18,28,18,628540,47904,81870,44386,0.37941959194018504,0.4809405135984397
3245,0.3247,15,27,15,628567,47877,81885,44371,0.37920574071727287,0.4809968779810944
3246,0.3248,15,37,15,628604,47840,81900,44356,0.37891268533772654,0.4811054709531867
3247,0.3249,18,32,18,628636,47808,81918,44338,0.37865923203649726,0.481171184858811
3248,0.325,17,36,17,628672,47772,81935,44321,0.3783740970726144,0.4812635053695721
3249,0.3251,16,39,16,628711,47733,81951,44305,0.3780652008617412,0.481377257219844
3250,0.3252,16,34,16,628745,47699,81967,44289,0.37779590672918517,0.48146497369222074
3251,0.3253,22,34,22,628779,47665,81989,44267,0.37752661259662906,0.48151894878823476
3252,0.3254,16,40,16,628819,47625,82005,44251,0.3772097959700925,0.48163829509338674
3253,0.3255,16,42,16,628861,47583,82021,44235,0.37687713851222915,0.48176828072926875
3254,0.3256,22,31,22,628892,47552,82043,44213,0.3766316056266633,0.4818067890808042
3255,0.3257,15,38,15,628930,47514,82058,44198,0.37633062983145354,0.48192166782972784
3256,0.3258,20,33,20,628963,47481,82078,44178,0.3760692561145609,0.4819821294144601
3257,0.3259,16,39,16,629002,47442,82094,44162,0.3757603599036877,0.48209685166586613
3258,0.326,14,34,14,629036,47408,82108,44148,0.37549106577113167,0.48219668836559043
3259,0.3261,12,41,12,629077,47367,82120,44136,0.3751663287289317,0.4823448411527491
3260,0.3262,15,31,15,629108,47336,82135,44121,0.37492079584336585,0.48242343396350196
3261,0.3263,16,26,16,629134,47310,82151,44105,0.3747148650361171,0.4824700541486627
3262,0.3264,19,43,19,629177,47267,82170,44086,0.3743742871625903,0.4825895153963198
3263,0.3265,20,30,20,629207,47237,82190,44066,0.37413667469268785,0.48263474365573966
3264,0.3266,20,29,20,629236,47208,82210,44046,0.37390698263844885,0.48267473206653955
3265,0.3267,20,38,20,629274,47170,82230,44026,0.37360600684323914,0.4827624018597307
3266,0.3268,23,37,23,629311,47133,82253,44003,0.3733129514636928,0.48282786165730335
3267,0.3269,16,43,16,629354,47090,82269,43987,0.372972373590166,0.4829649637120239
3268,0.327,22,26,22,629380,47064,82291,43965,0.37276644278291726,0.48297795208120486
3269,0.3271,26,31,26,629411,47033,82317,43939,0.3725209098973514,0.4829947676208064
3270,0.3272,14,32,14,629443,47001,82331,43925,0.37226745659612215,0.48308514616281373
3271,0.3273,16,37,16,629480,46964,82347,43909,0.3719744012165758,0.483190826758223
3272,0.3274,15,28,15,629508,46936,82362,43894,0.37175262957800026,0.48325443135527907
3273,0.3275,18,39,18,629547,46897,82380,43876,0.3714437333671271,0.48335958930518985
3274,0.3276,19,43,19,629590,46854,82399,43857,0.3711031554936003,0.48348050401825576
3275,0.3277,20,41,20,629631,46813,82419,43837,0.3707784184514003,0.48358521787093217
3276,0.3278,19,37,19,629668,46776,82438,43818,0.37048536307185403,0.4836744155242069
3277,0.3279,19,33,19,629701,46743,82457,43799,0.37022398935496137,0.4837423516158247
3278,0.328,12,40,12,629741,46703,82469,43787,0.36990717272842477,0.48388772240026523
3279,0.3281,14,39,14,629780,46664,82483,43773,0.3695982765175516,0.48401649767241284
3280,0.3282,19,28,19,629808,46636,82502,43754,0.36937650487897605,0.48405797101449277
3281,0.3283,20,27,20,629835,46609,82522,43734,0.3691626536560639,0.48408841858251334
3282,0.3284,13,38,13,629873,46571,82535,43721,0.36886167786085416,0.4842178709077216
3283,0.3285,12,32,12,629905,46539,82547,43709,0.3686082245596249,0.48432098218243064
3284,0.3286,16,49,16,629954,46490,82563,43693,0.3682201241921176,0.4844926427375448
3285,0.3287,11,38,11,629992,46452,82574,43682,0.36791914839690787,0.48463398939356955
3286,0.3288,14,44,14,630036,46408,82588,43668,0.36757065010771767,0.484790621253164
3287,0.3289,16,30,16,630066,46378,82604,43652,0.3673330376378152,0.48486060202154835
3288,0.329,16,35,16,630101,46343,82620,43636,0.3670558230895957,0.484957601218062
3289,0.3291,19,33,19,630134,46310,82639,43617,0.36679444937270306,0.48502674391450845
3290,0.3292,23,32,23,630166,46278,82662,43594,0.36654099607147383,0.4850676517714082
3291,0.3293,20,39,20,630205,46239,82682,43574,0.3662320998606007,0.48516361773908007
3292,0.3294,19,36,19,630241,46203,82701,43555,0.3659469648967178,0.48524922569575973
3293,0.3295,13,33,13,630274,46170,82714,43542,0.36568559117982513,0.48535313001605135
3294,0.3296,18,44,18,630318,46126,82732,43524,0.3653370928906349,0.48548800892359173
3295,0.3297,23,31,23,630349,46095,82755,43501,0.3650915600050691,0.48552390731729095
3296,0.3298,17,30,17,630379,46065,82772,43484,0.36485394753516665,0.48558889546505263
3297,0.3299,22,33,22,630412,46032,82794,43462,0.364592573818274,0.4856414955192527
3298,0.33,16,34,16,630446,45998,82810,43446,0.3643232796857179,0.48573409060417694
3299,0.3301,11,35,11,630481,45963,82821,43435,0.36404606513749843,0.48586098123000515
3300,0.3302,11,33,11,630514,45930,82832,43424,0.36378469142060577,0.48597712469503324
3301,0.3303,22,36,22,630550,45894,82854,43402,0.3634995564567228,0.4860464074538613
3302,0.3304,20,32,20,630582,45862,82874,43382,0.3632461031554936,0.4861055084935682
3303,0.3305,24,46,24,630628,45816,82898,43358,0.3628817640349766,0.48621795590643013
3304,0.3306,24,36,24,630664,45780,82922,43334,0.36259662907109363,0.4862760060147676
3305,0.3307,17,36,17,630700,45744,82939,43317,0.36231149410721075,0.48637450736012394
3306,0.3308,15,32,15,630732,45712,82954,43302,0.3620580408059815,0.48646280360392746
3307,0.3309,17,45,17,630777,45667,82971,43285,0.3617016221011279,0.4866107563629823
3308,0.331,15,35,15,630812,45632,82986,43270,0.3614244075529084,0.48671570943285863
3309,0.3311,18,27,18,630839,45605,83004,43252,0.3612105563299962,0.4867596250154743
3310,0.3312,20,32,20,630871,45573,83024,43232,0.36095710302876693,0.4868194358425764
3311,0.3313,20,34,20,630905,45539,83044,43212,0.3606878088962109,0.4868902885601289
3312,0.3314,21,40,21,630945,45499,83065,43191,0.36037099226967434,0.4869883865148269
3313,0.3315,18,34,18,630979,45465,83083,43173,0.36010169813711823,0.4870710079198538
3314,0.3316,15,43,15,631022,45422,83098,43158,0.3597611202635914,0.4872205915556559
3315,0.3317,25,34,25,631056,45388,83123,43133,0.35949182613103536,0.4872629093661391
3316,0.3318,14,40,14,631096,45348,83137,43119,0.3591750095044988,0.4874020821323205
3317,0.3319,15,39,15,631135,45309,83152,43104,0.35886611329362567,0.48753011434969973
3318,0.332,14,18,14,631153,45291,83166,43090,0.3587235458116842,0.4875482286916871
3319,0.3321,20,36,20,631189,45255,83186,43070,0.3584384108478013,0.4876309085762808
3320,0.3322,14,45,14,631234,45210,83200,43056,0.35808199214294767,0.4877982462103188
3321,0.3323,21,30,21,631264,45180,83221,43035,0.3578443796730452,0.48784220370685255
3322,0.3324,15,34,15,631298,45146,83236,43020,0.35757508554048917,0.4879431980582084
3323,0.3325,21,51,21,631349,45095,83257,42999,0.35717114434165503,0.4881036165913683
3324,0.3326,14,35,14,631384,45060,83271,42985,0.35689392979343554,0.4882162530524164
3325,0.3327,18,27,18,631411,45033,83289,42967,0.35668007857052336,0.48826136363636363
3326,0.3328,13,48,13,631459,44985,83302,42954,0.3562998986186795,0.4884522225633678
3327,0.3329,19,38,19,631497,44947,83321,42935,0.3559989228234698,0.4885528322068228
3328,0.333,18,39,18,631536,44908,83339,42917,0.35569002661259663,0.4886649587247367
3329,0.3331,22,31,22,631567,44877,83361,42895,0.3554444937270308,0.4887093834024518
3330,0.3332,20,35,20,631602,44842,83381,42875,0.3551672791788113,0.4887878062405235
3331,0.3333,21,29,21,631631,44813,83402,42854,0.3549375871245723,0.4888270386804613
3332,0.3334,14,41,14,631672,44772,83416,42840,0.3546128500823723,0.48897411313518696
3333,0.3335,10,37,10,631709,44735,83426,42830,0.354319794702826,0.48912236624222005
3334,0.3336,13,43,13,631752,44692,83439,42817,0.3539792168292992,0.4892868162131895
3335,0.3337,17,37,17,631789,44655,83456,42800,0.3536861614497529,0.48939454576639413
3336,0.3338,18,30,18,631819,44625,83474,42782,0.35344854897985045,0.4894573661148421
3337,0.3339,21,31,21,631850,44594,83495,42761,0.3532030160942846,0.48950832808654343
3338,0.334,17,35,17,631885,44559,83512,42744,0.3529258015460651,0.4896051682072781
3339,0.3341,11,29,11,631914,44530,83523,42733,0.3526961094918261,0.48970353987371507
3340,0.3342,23,23,23,631937,44507,83546,42710,0.3525139399315676,0.48969810931355123
3341,0.3343,23,31,23,631968,44476,83569,42687,0.35226840704600176,0.48973761802599725
3342,0.3344,13,32,13,632000,44444,83582,42674,0.35201495374477254,0.4898413645859639
3343,0.3345,18,46,18,632046,44398,83600,42656,0.3516506146242555,0.4899947159234498
3344,0.3346,19,37,19,632083,44361,83619,42637,0.3513575592447092,0.4900917262465804
3345,0.3347,17,29,17,632112,44332,83636,42620,0.3511278671904702,0.49015548808538045
3346,0.3348,18,27,18,632139,44305,83654,42602,0.350914015967558,0.4902021701358924
3347,0.3349,18,30,18,632169,44275,83672,42584,0.35067640349765555,0.4902658331318574
3348,0.335,16,36,16,632205,44239,83688,42568,0.35039126853377267,0.4903752001566694
3349,0.3351,22,38,22,632243,44201,83710,42546,0.3500902927385629,0.4904607652137826
3350,0.3352,9,29,9,632272,44172,83719,42537,0.3498606006843239,0.4905719129502128
3351,0.3353,12,36,12,632308,44136,83731,42525,0.349575465720441,0.49070516149132826
3352,0.3354,19,26,19,632334,44110,83750,42506,0.3493695349131922,0.49074074074074076
3353,0.3355,23,33,23,632367,44077,83773,42483,0.34910816119629956,0.49079251386321626
3354,0.3356,13,28,13,632395,44049,83786,42470,0.348886389557724,0.49087483674106264
3355,0.3357,13,31,13,632426,44018,83799,42457,0.34864085667215816,0.4909742700202371
3356,0.3358,23,27,23,632453,43991,83822,42434,0.348427005449246,0.49099218975990744
3357,0.3359,13,28,13,632481,43963,83835,42421,0.34820523381067037,0.49107473606223373
3358,0.336,18,44,18,632525,43919,83853,42403,0.34785673552148016,0.49121892449201826
3359,0.3361,15,31,15,632556,43888,83868,42388,0.34761120263591433,0.4913069683341833
3360,0.3362,15,45,15,632601,43843,83883,42373,0.3472547839310607,0.49147490025053353
3361,0.3363,16,37,16,632638,43806,83899,42357,0.34696172855151436,0.4915915184011699
3362,0.3364,19,36,19,632674,43770,83918,42338,0.3466765935876315,0.4916848608723928
3363,0.3365,12,36,12,632710,43734,83930,42326,0.3463914586237486,0.4918196607018359
3364,0.3366,17,32,17,632742,43702,83947,42309,0.3461380053225193,0.49190219855599865
3365,0.3367,20,29,20,632771,43673,83967,42289,0.3459083132682803,0.49194993136502174
3366,0.3368,14,36,14,632807,43637,83981,42275,0.3456231783043974,0.4920732842909023
3367,0.3369,15,37,15,632844,43600,83996,42260,0.3453301229248511,0.4921965991148381
3368,0.337,21,30,21,632874,43570,84017,42239,0.34509251045494865,0.4922444032677225
3369,0.3371,18,34,18,632908,43536,84035,42221,0.3448232163223926,0.492332987394615
3370,0.3372,14,33,14,632941,43503,84049,42207,0.34456184260549994,0.49243962198109903
3371,0.3373,17,40,17,632981,43463,84066,42190,0.3442450259789634,0.4925688533968454
3372,0.3374,25,31,25,633012,43432,84091,42165,0.34399949309339756,0.4925990396859703
3373,0.3375,20,25,20,633037,43407,84111,42145,0.3438014827018122,0.4926243688049374
3374,0.3376,21,27,21,633064,43380,84132,42124,0.34358763147890004,0.4926553143712575
3375,0.3377,19,33,19,633097,43347,84151,42105,0.34332625776200737,0.49273276225249263
3376,0.3378,12,34,12,633131,43313,84163,42093,0.34305696362945126,0.4928576446619675
3377,0.3379,22,32,22,633163,43281,84185,42071,0.34280351032822204,0.49291170681413443
3378,0.338,15,34,15,633197,43247,84200,42056,0.34253421619566593,0.49301900284866884
3379,0.3381,16,43,16,633240,43204,84216,42040,0.34219363832213917,0.49317254000281546
3380,0.3382,19,38,19,633278,43166,84235,42021,0.3418926625269294,0.49327949100214824
3381,0.3383,13,38,13,633316,43128,84248,42008,0.3415916867317197,0.4934222890434129
3382,0.3384,16,34,16,633350,43094,84264,41992,0.3413223925991636,0.49352419904567146
3383,0.3385,18,29,18,633379,43065,84282,41974,0.3410927005449246,0.49358529615823327
3384,0.3386,10,24,10,633403,43041,84292,41964,0.3409026105690027,0.49366507852479263
3385,0.3387,25,33,25,633436,43008,84317,41939,0.34064123685211,0.49370784135990675
3386,0.3388,19,34,19,633470,42974,84336,41920,0.3403719427195539,0.4937922585812896
3387,0.3389,16,30,16,633500,42944,84352,41904,0.3401343302496515,0.49387139355082027
3388,0.339,21,52,21,633552,42892,84373,41883,0.339722468635154,0.49404895311117664
3389,0.3391,15,38,15,633590,42854,84388,41868,0.3394214928399442,0.49418096834352354
3390,0.3392,23,35,23,633625,42819,84411,41845,0.3391442782917248,0.4942478503259945
3391,0.3393,23,32,23,633657,42787,84434,41822,0.3388908249904955,0.4942972969778629
3392,0.3394,20,22,20,633679,42765,84454,41802,0.33871657584590037,0.49430628968746676
3393,0.3395,19,26,19,633705,42739,84473,41783,0.33851064503865164,0.49434466766049073
3394,0.3396,18,37,18,633742,42702,84491,41765,0.3382175896591053,0.49445345519552014
3395,0.3397,18,35,18,633777,42667,84509,41747,0.3379403751108858,0.4945506669509797
3396,0.3398,13,27,13,633804,42640,84522,41734,0.33772652388797364,0.4946310474790812
3397,0.3399,14,47,14,633851,42593,84536,41720,0.33735426435179316,0.49482286242928136
3398,0.34,19,33,19,633884,42560,84555,41701,0.3370928906349005,0.494902742668613
3399,0.3401,19,36,19,633920,42524,84574,41682,0.3368077556710176,0.49500035626914946
3400,0.3402,15,33,15,633953,42491,84589,41667,0.33654638195412495,0.49510444639844103
3401,0.3403,19,29,19,633982,42462,84608,41648,0.33631668989988595,0.49516109856140766
3402,0.3404,17,37,17,634019,42425,84625,41631,0.3360236345203396,0.4952769582183306
3403,0.3405,23,29,23,634048,42396,84648,41608,0.3357939424661006,0.4953097471548974
3404,0.3406,14,36,14,634084,42360,84662,41594,0.33550880750221773,0.49543797794030064
3405,0.3407,15,45,15,634129,42315,84677,41579,0.3351523887973641,0.4956135122893175
3406,0.3408,12,31,12,634160,42284,84689,41567,0.33490685591179825,0.49572455903924817
3407,0.3409,14,38,14,634198,42246,84703,41553,0.33460588011658854,0.4958651057888519
3408,0.341,20,33,20,634231,42213,84723,41533,0.3343445063996959,0.4959401046020108
3409,0.3411,19,31,19,634262,42182,84742,41514,0.33409897351413004,0.4960093672337985
3410,0.3412,17,33,17,634295,42149,84759,41497,0.33383759979723737,0.4961026229586591
3411,0.3413,20,31,20,634326,42118,84779,41477,0.33359206691167154,0.4961660386386746
3412,0.3414,10,28,10,634354,42090,84789,41467,0.3333702952730959,0.4962720059360676
3413,0.3415,18,36,18,634390,42054,84807,41449,0.33308516030921304,0.4963773756631498
3414,0.3416,19,35,19,634425,42019,84826,41430,0.33280794576099354,0.4964708983930305
3415,0.3417,16,35,16,634460,41984,84842,41414,0.33253073121277404,0.49658265186215494
3416,0.3418,23,31,23,634491,41953,84865,41391,0.3322851983272082,0.4966284315607602
3417,0.3419,15,25,15,634516,41928,84880,41376,0.33208718793562286,0.49668683376548545
3418,0.342,22,44,22,634560,41884,84902,41354,0.33173868964643266,0.49681635791345297
3419,0.3421,20,31,20,634591,41853,84922,41334,0.3314931567608668,0.49688052219697787
3420,0.3422,15,36,15,634627,41817,84937,41319,0.3312080217969839,0.4970049076212471
3421,0.3423,14,39,14,634666,41778,84951,41305,0.33089912558611073,0.49715344896067787
3422,0.3424,23,37,23,634703,41741,84974,41282,0.33060607020656446,0.4972357057682811
3423,0.3425,22,41,22,634744,41700,84996,41260,0.3302813331643645,0.49734811957569913
3424,0.3426,20,27,20,634771,41673,85016,41240,0.3300674819414523,0.497388829254761
3425,0.3427,22,28,22,634799,41645,85038,41218,0.3298457103028767,0.4974234579969347
3426,0.3428,20,27,20,634826,41618,85058,41198,0.3296318590799645,0.49746425811437406
3427,0.3429,15,37,15,634863,41581,85073,41183,0.3293388037004182,0.49759557295442464
3428,0.343,19,38,19,634901,41543,85092,41164,0.32903782790520847,0.4977087791843496
3429,0.3431,18,30,18,634931,41513,85110,41146,0.328800215435306,0.4977800360517306
3430,0.3432,16,36,16,634967,41477,85126,41130,0.32851508047142314,0.49789969373055554
3431,0.3433,20,34,20,635001,41443,85146,41110,0.3282457863388671,0.4979831138783569
3432,0.3434,12,35,12,635036,41408,85158,41098,0.3279685717906476,0.49812134875039393
3433,0.3435,19,34,19,635070,41374,85177,41079,0.3276992776580915,0.49821110208239844
3434,0.3436,22,26,22,635096,41348,85199,41057,0.32749334685084275,0.49823433044111404
3435,0.3437,20,36,20,635132,41312,85219,41037,0.3272082118869598,0.49833027723469625
3436,0.3438,18,33,18,635165,41279,85237,41019,0.32694683817006714,0.49842037473571654
3437,0.3439,21,29,21,635194,41250,85258,40998,0.32671714611582814,0.498468047855267
3438,0.344,15,30,15,635224,41220,85273,40983,0.32647953364592575,0.4985584467720156
3439,0.3441,18,24,18,635248,41196,85291,40965,0.3262894436700038,0.4985942235367145
3440,0.3442,9,25,9,635273,41171,85300,40956,0.32609143327841844,0.49869105166388644
3441,0.3443,17,37,17,635310,41134,85317,40939,0.3257983778988721,0.49881203318996503
3442,0.3444,21,29,21,635339,41105,85338,40918,0.3255686858446331,0.49886007583238845
3443,0.3445,20,29,20,635368,41076,85358,40898,0.3253389937903941,0.49891428989679654
3444,0.3446,17,43,17,635411,41033,85375,40881,0.32499841591686734,0.49907219767072786
3445,0.3447,26,33,26,635444,41000,85401,40855,0.3247370421999747,0.4991142874595321
3446,0.3448,13,34,13,635478,40966,85414,40842,0.32446774806741857,0.49924212790925093
3447,0.3449,18,30,18,635508,40936,85432,40824,0.3242301355975162,0.49931506849315066
3448,0.345,14,30,14,635538,40906,85446,40810,0.32399252312761373,0.49941259973566987
3449,0.3451,15,32,15,635570,40874,85461,40795,0.3237390698263845,0.4995163403494594
3450,0.3452,16,32,16,635602,40842,85477,40779,0.32348561652515523,0.49961406990847945
3451,0.3453,16,30,16,635632,40812,85493,40763,0.32324800405525284,0.49969966288691386
3452,0.3454,11,30,11,635662,40782,85504,40752,0.3230103915853504,0.4998160276694385
3453,0.3455,16,32,16,635694,40750,85520,40736,0.32275693828412116,0.4999140956728763
3454,0.3456,20,26,20,635720,40724,85540,40716,0.3225510074768724,0.499950884086444
3455,0.3457,12,29,12,635749,40695,85552,40704,0.32232131542263337,0.5000552832344378
3456,0.3458,23,30,23,635779,40665,85575,40681,0.322083702952731,0.5000983453396602
3457,0.3459,16,44,16,635823,40621,85591,40665,0.3217352046635407,0.5002706493123047
3458,0.346,21,37,21,635860,40584,85612,40644,0.32144214928399445,0.50036933077264
3459,0.3461,19,33,19,635893,40551,85631,40625,0.3211807755671018,0.5004557997437666
3460,0.3462,20,26,20,635919,40525,85651,40605,0.320974844759853,0.5004930358683595
3461,0.3463,23,37,23,635956,40488,85674,40582,0.32068178938030667,0.5005797458986061
3462,0.3464,16,33,16,635989,40455,85690,40566,0.320420415663414,0.5006850075906246
3463,0.3465,22,27,22,636016,40428,85712,40544,0.32020656444050183,0.5007162969915526
3464,0.3466,18,26,18,636042,40402,85730,40526,0.3200006336332531,0.5007661130881772
3465,0.3467,21,32,21,636074,40370,85751,40505,0.3197471803320238,0.5008346213292117
3466,0.3468,11,26,11,636100,40344,85762,40494,0.3195412495247751,0.5009277814889037
3467,0.3469,16,28,16,636128,40316,85778,40478,0.31931947788619947,0.5010025496942843
3468,0.347,12,26,12,636154,40290,85790,40466,0.3191135470789507,0.5010897023131409
3469,0.3471,20,31,20,636185,40259,85810,40446,0.31886801419338484,0.5011585403630506
3470,0.3472,17,24,17,636209,40235,85827,40429,0.31867792421746294,0.5012025190915402
3471,0.3473,17,20,17,636229,40215,85844,40412,0.31851951590419464,0.5012216751212373
3472,0.3474,19,33,19,636262,40182,85863,40393,0.318258142187302,0.5013093391250388
3473,0.3475,22,30,22,636292,40152,85885,40371,0.3180205297173996,0.5013598599158005
3474,0.3476,23,25,23,636317,40127,85908,40348,0.31782251932581423,0.5013730972351662
3475,0.3477,18,25,18,636342,40102,85926,40330,0.3176245089342289,0.5014173463298189
3476,0.3478,17,27,17,636369,40075,85943,40313,0.3174106577113167,0.5014803204458377
3477,0.3479,15,37,15,636406,40038,85958,40298,0.3171176023317704,0.5016182035451106
3478,0.348,20,34,20,636440,40004,85978,40278,0.3168483081992143,0.5017064846416383
3479,0.3481,15,31,15,636471,39973,85993,40263,0.31660277531364844,0.5018071688518869
3480,0.3482,16,33,16,636504,39940,86009,40247,0.3163414015967558,0.5019142753812962
3481,0.3483,19,23,19,636527,39917,86028,40228,0.31615923203649726,0.5019402333270946
3482,0.3484,12,34,12,636561,39883,86040,40216,0.3158899379039412,0.5020786776364249
3483,0.3485,20,27,20,636588,39856,86060,40196,0.31567608668102903,0.5021236196472293
3484,0.3486,16,30,16,636618,39826,86076,40180,0.3154384742111266,0.5022123340749444
3485,0.3487,18,29,18,636647,39797,86094,40162,0.3152087821568876,0.5022824197401168
3486,0.3488,12,30,12,636677,39767,86106,40150,0.3149711696869852,0.5023962360949485
3487,0.3489,28,33,28,636710,39734,86134,40122,0.3147097959700925,0.5024293728711681
3488,0.349,15,35,15,636745,39699,86149,40107,0.314432581421873,0.5025561987820465
3489,0.3491,15,33,15,636778,39666,86164,40092,0.31417120770498036,0.5026705784999624
3490,0.3492,19,31,19,636809,39635,86183,40073,0.3139256748194145,0.5027475284789482
3491,0.3493,21,34,21,636843,39601,86204,40052,0.31365638068685847,0.5028310295908504
3492,0.3494,17,29,17,636872,39572,86221,40035,0.31342668863261947,0.5029080357255016
3493,0.3495,19,29,19,636901,39543,86240,40016,0.31319699657838046,0.5029726366595859
3494,0.3496,14,41,14,636942,39502,86254,40002,0.3128722595361805,0.5031444958744214
3495,0.3497,16,32,16,636974,39470,86270,39986,0.3126188062349512,0.5032470801449859
3496,0.3498,17,41,17,637015,39429,86287,39969,0.3122940691927512,0.5034005894355021
3497,0.3499,16,22,16,637037,39407,86303,39953,0.31211982004815614,0.5034400201612903
3498,0.35,17,42,17,637079,39365,86320,39936,0.31178716259029277,0.5036002068069759
3499,0.3501,22,33,22,637112,39332,86342,39914,0.3115257888734001,0.5036721096332938
3500,0.3502,9,30,9,637142,39302,86351,39905,0.31128817640349765,0.5038064817503504
3501,0.3503,16,27,16,637169,39275,86367,39889,0.3110743251805855,0.5038780253650649
3502,0.3504,20,26,20,637195,39249,86387,39869,0.3108683943733367,0.5039181981344321
3503,0.3505,22,24,22,637219,39225,86409,39847,0.3106783043974148,0.5039331242411978
3504,0.3506,15,26,15,637245,39199,86424,39832,0.310472373590166,0.504004757626754
3505,0.3507,20,39,20,637284,39160,86444,39812,0.31016347737929284,0.5041280453831738
3506,0.3508,6,23,6,637307,39137,86450,39806,0.3099813078190343,0.5042372344603068
3507,0.3509,9,28,9,637335,39109,86459,39797,0.30975953618045876,0.5043596177730464
3508,0.351,14,33,14,637368,39076,86473,39783,0.3094981624635661,0.5044826842846092
3509,0.3511,12,31,12,637399,39045,86485,39771,0.30925262957800026,0.5046056638246041
3510,0.3512,23,23,23,637422,39022,86508,39748,0.30907046001774174,0.5046083534340485
3511,0.3513,12,24,12,637446,38998,86520,39736,0.3088803700418198,0.5046866664973201
3512,0.3514,11,34,11,637480,38964,86531,39725,0.30861107590926373,0.5048354916189048
3513,0.3515,9,30,9,637510,38934,86540,39716,0.3083734634393613,0.5049713922441195
3514,0.3516,19,39,19,637549,38895,86559,39697,0.30806456722848813,0.5051023004885994
3515,0.3517,14,26,14,637575,38869,86573,39683,0.3078586364212394,0.5051812811895305
3516,0.3518,19,23,19,637598,38846,86592,39664,0.3076764668609809,0.5052095274487326
3517,0.3519,14,27,14,637625,38819,86606,39650,0.3074626156380687,0.5052950846831232
3518,0.352,9,22,9,637647,38797,86615,39641,0.3072883664934736,0.5053800453861649
3519,0.3521,12,34,12,637681,38763,86627,39629,0.3070190723609175,0.5055235228084498
3520,0.3522,19,29,19,637710,38734,86646,39610,0.3067893803066785,0.5055907280710712
3521,0.3523,12,36,12,637746,38698,86658,39598,0.3065042453427956,0.5057474200470011
3522,0.3524,12,33,12,637779,38665,86670,39586,0.3062428716259029,0.5058849088190567
3523,0.3525,13,21,13,637800,38644,86683,39573,0.3060765428969712,0.505938606696754
3524,0.3526,21,31,21,637831,38613,86704,39552,0.3058310100114054,0.5060065246593743
3525,0.3527,15,32,15,637863,38581,86719,39537,0.30557755671017617,0.5061189482577639
3526,0.3528,15,21,15,637884,38560,86734,39522,0.3054112279812445,0.5061601905688892
3527,0.3529,13,27,13,637911,38533,86747,39509,0.30519737675833225,0.5062530432331309
3528,0.353,17,33,17,637944,38500,86764,39492,0.30493600304143964,0.5063596266283722
3529,0.3531,18,23,18,637967,38477,86782,39474,0.30475383348118107,0.5063950430398584
3530,0.3532,17,18,17,637985,38459,86799,39457,0.30461126599923966,0.5064043328712973
3531,0.3533,20,19,20,638004,38440,86819,39437,0.3044607781016348,0.5064011197144215
3532,0.3534,18,32,18,638036,38408,86837,39419,0.3042073248004055,0.5064951751962686
3533,0.3535,11,26,11,638062,38382,86848,39408,0.3040013939931568,0.5065946779791747
3534,0.3536,12,30,12,638092,38352,86860,39396,0.30376378152325434,0.5067139990739311
3535,0.3537,12,30,12,638122,38322,86872,39384,0.30352616905335195,0.5068334491545055
3536,0.3538,22,26,22,638148,38296,86894,39362,0.30332023824610316,0.5068634268201602
3537,0.3539,12,11,12,638159,38285,86906,39350,0.3032331136738056,0.5068590197720101
3538,0.354,14,33,14,638192,38252,86920,39336,0.30297173995691296,0.5069856163324226
3539,0.3541,21,25,21,638217,38227,86941,39315,0.3027737295653276,0.507015552861675
3540,0.3542,13,28,13,638245,38199,86954,39302,0.302551957926752,0.507116037212423
3541,0.3543,18,21,18,638266,38178,86972,39284,0.3023856291978203,0.5071389842761612
3542,0.3544,16,26,16,638292,38152,86988,39268,0.3021796983905715,0.5072074399380005
3543,0.3545,18,29,18,638321,38123,87006,39250,0.3019500063363325,0.5072829023044214
3544,0.3546,21,25,21,638346,38098,87027,39229,0.30175199594474716,0.5073130989175838
3545,0.3547,14,28,14,638374,38070,87041,39215,0.3015302243061716,0.5074076470207672
3546,0.3548,12,38,12,638412,38032,87053,39203,0.30122924851096183,0.5075807600181265
3547,0.3549,9,36,9,638448,37996,87062,39194,0.30094411354707895,0.5077600725482575
3548,0.355,23,28,23,638476,37968,87085,39171,0.30072234190850333,0.5077976121028274
3549,0.3551,19,21,19,638497,37947,87104,39152,0.30055601317957165,0.5078146279458877
3550,0.3552,20,23,20,638520,37924,87124,39132,0.30037384361931313,0.5078384551495017
3551,0.3553,19,31,19,638551,37893,87143,39113,0.3001283107337473,0.5079214606654027
3552,0.3554,22,36,22,638587,37857,87165,39091,0.2998431757698644,0.5080184020377397
3553,0.3555,13,23,13,638610,37834,87178,39078,0.2996610062096059,0.5080871645516954
3554,0.3556,12,39,12,638649,37795,87190,39066,0.29935210999873274,0.508268172415139
3555,0.3557,12,29,12,638678,37766,87202,39054,0.29912241794449373,0.5083832335329341
3556,0.3558,18,30,18,638708,37736,87220,39036,0.2988848054745913,0.508466628458292
3557,0.3559,23,31,23,638739,37705,87243,39013,0.29863927258902545,0.508524726921974
3558,0.356,12,32,12,638771,37673,87255,39001,0.29838581928779623,0.5086600412134491
3559,0.3561,13,26,13,638797,37647,87268,38988,0.29817988848054744,0.5087492660011744
3560,0.3562,21,20,21,638817,37627,87289,38967,0.2980214801672792,0.5087474214690446
3561,0.3563,18,22,18,638839,37605,87307,38949,0.29784723102268407,0.5087781174073204
3562,0.3564,25,24,25,638863,37581,87332,38924,0.2976571410467621,0.5087772041043069
3563,0.3565,21,25,21,638888,37556,87353,38903,0.29745913065517676,0.5088086425404466
3564,0.3566,16,44,16,638932,37512,87369,38887,0.29711063236598656,0.5089988088849331
3565,0.3567,11,27,11,638959,37485,87380,38876,0.2968967811430744,0.5091080525399091
3566,0.3568,13,26,13,638985,37459,87393,38863,0.29669085033582565,0.509197872173161
3567,0.3569,25,30,25,639015,37429,87418,38838,0.2964532378659232,0.5092372848020769
3568,0.357,16,28,16,639043,37401,87434,38822,0.2962314662273476,0.509321333455781
3569,0.3571,18,29,18,639072,37372,87452,38804,0.2960017741731086,0.5093992858643143
3570,0.3572,13,27,13,639099,37345,87465,38791,0.2957879229501964,0.5094961647578018
3571,0.3573,18,29,18,639128,37316,87483,38773,0.2955582308959574,0.5095743142898448
3572,0.3574,14,32,14,639160,37284,87497,38759,0.2953047775947282,0.5096984600817959
3573,0.3575,17,22,17,639182,37262,87514,38742,0.29513052845013305,0.5097363296668597
3574,0.3576,20,30,20,639212,37232,87534,38722,0.29489291598023065,0.5098085683439977
3575,0.3577,10,24,10,639236,37208,87544,38712,0.2947028260043087,0.5099051633298208
3576,0.3578,17,35,17,639271,37173,87561,38695,0.2944256114560892,0.5100305794274266
3577,0.3579,14,27,14,639298,37146,87575,38681,0.294211760233177,0.5101217244517124
3578,0.358,21,21,21,639319,37125,87596,38660,0.29404543150424534,0.5101273339051263
3579,0.3581,18,29,18,639348,37096,87614,38642,0.29381573945000633,0.5102062372917162
3580,0.3582,16,34,16,639382,37062,87630,38626,0.2935464453174503,0.51033188880668
3581,0.3583,12,32,12,639414,37030,87642,38614,0.293292992016221,0.5104700967690762
3582,0.3584,18,28,18,639442,37002,87660,38596,0.29307122037764544,0.5105426069472737
3583,0.3585,11,30,11,639472,36972,87671,38585,0.292833607907743,0.5106740606429583
3584,0.3586,9,32,9,639504,36940,87680,38576,0.29258015460651376,0.5108321415329202
3585,0.3587,11,26,11,639530,36914,87691,38565,0.292374223799265,0.5109368168629685
3586,0.3588,12,29,12,639559,36885,87703,38553,0.29214453174502597,0.5110554362522867
3587,0.3589,22,33,22,639592,36852,87725,38531,0.2918831580281333,0.5111364631282915
3588,0.359,16,25,16,639617,36827,87741,38515,0.29168514763654796,0.5112022510684612
3589,0.3591,19,37,19,639654,36790,87760,38496,0.29139209225700163,0.5113301277794012
3590,0.3592,15,28,15,639682,36762,87775,38481,0.29117032061842607,0.5114229895139747
3591,0.3593,16,29,16,639711,36733,87791,38465,0.29094062856418706,0.5115162637304184
3592,0.3594,16,24,16,639735,36709,87807,38449,0.2907505385882651,0.5115756140397563
3593,0.3595,11,26,11,639761,36683,87818,38438,0.2905446077810164,0.5116811544042279
3594,0.3596,17,28,17,639789,36655,87835,38421,0.29032283614244075,0.511761415099366
3595,0.3597,15,25,15,639814,36630,87850,38406,0.2901248257508554,0.5118343195266272
3596,0.3598,15,29,15,639843,36601,87865,38391,0.2898951336966164,0.5119346063580115
3597,0.3599,12,34,12,639877,36567,87877,38379,0.2896258395640603,0.5120887038667841
3598,0.36,18,27,18,639904,36540,87895,38361,0.2894119883411481,0.5121560459806945
3599,0.3601,18,34,18,639938,36506,87913,38343,0.28914269420859207,0.5122713730310359
3600,0.3602,12,27,12,639965,36479,87925,38331,0.2889288429856799,0.5123780243282984
3601,0.3603,19,27,19,639992,36452,87944,38312,0.2887149917627677,0.5124391418329678
3602,0.3604,11,22,11,640014,36430,87955,38301,0.2885407426181726,0.512518232058985
3603,0.3605,11,27,11,640041,36403,87966,38290,0.2883268913952604,0.5126317057823357
3604,0.3606,22,22,22,640063,36381,87988,38268,0.28815264225066534,0.5126391512277458
3605,0.3607,18,33,18,640096,36348,88006,38250,0.28789126853377267,0.5127483310544518
3606,0.3608,10,31,10,640127,36317,88016,38240,0.28764573564820684,0.5128961733975348
3607,0.3609,13,24,13,640151,36293,88029,38227,0.2874556456722849,0.5129763821792808
3608,0.361,11,33,11,640184,36260,88040,38216,0.2871942719553922,0.5131317471400183
3609,0.3611,20,30,20,640214,36230,88060,38196,0.2869566594854898,0.5132077499798458
3610,0.3612,20,28,20,640242,36202,88080,38176,0.2867348878469142,0.5132700529726532
3611,0.3613,15,19,15,640261,36183,88095,38161,0.28658439994930934,0.5133030237813407
3612,0.3614,13,33,13,640294,36150,88108,38148,0.2863230262324167,0.5134458531858193
3613,0.3615,16,32,16,640326,36118,88124,38132,0.28606957293118745,0.5135622895622896
3614,0.3616,21,39,21,640365,36079,88145,38111,0.2857606767203143,0.5136945680010783
3615,0.3617,11,22,11,640387,36057,88156,38100,0.28558642757571917,0.5137748290788462
3616,0.3618,23,28,23,640415,36029,88179,38077,0.2853646559371436,0.5138180444228537
3617,0.3619,17,26,17,640441,36003,88196,38060,0.2851587251298948,0.5138868260804991
3618,0.362,16,29,16,640470,35974,88212,38044,0.2849290330756558,0.513983085195493
3619,0.3621,13,24,13,640494,35950,88225,38031,0.28473894309973385,0.5140644219461754
3620,0.3622,22,30,22,640524,35920,88247,38009,0.28450133062983146,0.5141284205115719
3621,0.3623,15,29,15,640553,35891,88262,37994,0.28427163857559246,0.5142315760979901
3622,0.3624,15,32,15,640585,35859,88277,37979,0.2840181852743632,0.5143557517809259
3623,0.3625,24,19,24,640604,35840,88301,37955,0.2838676973767583,0.514330239176096
3624,0.3626,29,28,29,640632,35812,88330,37926,0.28364592573818276,0.5143345357888741
3625,0.3627,11,26,11,640658,35786,88341,37915,0.28343999493093397,0.5144434946608594
3626,0.3628,21,21,21,640679,35765,88362,37894,0.2832736662020023,0.5144517302705711
3627,0.3629,17,34,17,640713,35731,88379,37877,0.28300437206944623,0.5145772198674057
3628,0.363,14,29,14,640742,35702,88393,37863,0.2827746800152072,0.5146876911574798
3629,0.3631,11,25,11,640767,35677,88404,37852,0.2825766696236218,0.5147900828244638
3630,0.3632,19,35,19,640802,35642,88423,37833,0.2822994550754024,0.5149098332766247
3631,0.3633,21,31,21,640833,35611,88444,37812,0.28205392218983655,0.5149884913446741
3632,0.3634,18,24,18,640857,35587,88462,37794,0.2818638322139146,0.515037952603535
3633,0.3635,20,17,20,640874,35570,88482,37774,0.28172918514763656,0.5150250872600349
3634,0.3636,14,23,14,640897,35547,88496,37760,0.28154701558737805,0.5150940565021076
3635,0.3637,16,24,16,640921,35523,88512,37744,0.2813569256114561,0.5151568919158693
3636,0.3638,15,24,15,640945,35499,88527,37729,0.28116683563553413,0.5152264161249795
3637,0.3639,19,23,19,640968,35476,88546,37710,0.2809846660752756,0.5152624818954444
3638,0.364,22,32,22,641000,35444,88568,37688,0.2807312127740464,0.5153421210961002
3639,0.3641,19,25,19,641025,35419,88587,37669,0.28053320238246104,0.5153924036777583
3640,0.3642,16,25,16,641050,35394,88603,37653,0.2803351919908757,0.5154626473366463
3641,0.3643,16,40,16,641090,35354,88619,37637,0.2800183753643391,0.5156389143867052
3642,0.3644,12,32,12,641122,35322,88631,37625,0.2797649220631099,0.5157854332597639
3643,0.3645,19,32,19,641154,35290,88650,37606,0.2795114687618806,0.5158856453028973
3644,0.3646,16,30,16,641184,35260,88666,37590,0.2792738562919782,0.5159917638984214
3645,0.3647,17,23,17,641207,35237,88683,37573,0.2790916867317197,0.5160417525065238
3646,0.3648,19,22,19,641229,35215,88702,37554,0.27891743758712456,0.5160714040319366
3647,0.3649,11,26,11,641255,35189,88713,37543,0.27871150677987583,0.5161826981246219
3648,0.365,17,19,17,641274,35170,88730,37526,0.2785610188822709,0.5162044679212061
3649,0.3651,15,26,15,641300,35144,88745,37511,0.2783550880750222,0.5162893125043011
3650,0.3652,22,28,22,641328,35116,88767,37489,0.27813331643644656,0.5163418497348667
3651,0.3653,14,35,14,641363,35081,88781,37475,0.27785610188822707,0.5164976018523623
3652,0.3654,11,33,11,641396,35048,88792,37464,0.2775947281713344,0.5166593115622242
3653,0.3655,19,35,19,641431,35013,88811,37445,0.27731751362311496,0.5167821358580142
3654,0.3656,18,38,18,641469,34975,88829,37427,0.2770165378279052,0.5169332338885666
3655,0.3657,18,28,18,641497,34947,88847,37409,0.27679476618932963,0.5170131018851235
3656,0.3658,18,25,18,641522,34922,88865,37391,0.2765967557977443,0.5170716192109303
3657,0.3659,17,24,17,641546,34898,88882,37374,0.27640666582182233,0.5171297321230905
3658,0.366,20,27,20,641573,34871,88902,37354,0.27619281459891015,0.5171893388715819
3659,0.3661,14,26,14,641599,34845,88916,37340,0.27598688379166136,0.5172819837916465
3660,0.3662,16,24,16,641623,34821,88932,37324,0.27579679381573946,0.5173470094947675
3661,0.3663,15,27,15,641650,34794,88947,37309,0.2755829425928273,0.5174403284190672
3662,0.3664,16,29,16,641679,34765,88963,37293,0.2753532505385883,0.5175414249632241
3663,0.3665,13,25,13,641704,34740,88976,37280,0.27515524014700293,0.5176339905581783
3664,0.3666,11,26,11,641730,34714,88987,37269,0.27494930933975414,0.5177472458774989
3665,0.3667,20,34,20,641764,34680,89007,37249,0.2746800152071981,0.5178578876391998
3666,0.3668,18,20,18,641784,34660,89025,37231,0.2745216068939298,0.5178812368724875
3667,0.3669,21,20,21,641804,34640,89046,37210,0.2743631985806615,0.5178844815588031
3668,0.367,15,19,15,641823,34621,89061,37195,0.27421271068305664,0.5179207975938509
3669,0.3671,16,32,16,641855,34589,89077,37179,0.2739592573818274,0.5180442537063873
3670,0.3672,17,26,17,641881,34563,89094,37162,0.2737533265745786,0.5181178110840013
3671,0.3673,10,38,10,641919,34525,89104,37152,0.2734523507793689,0.5183252647292715
3672,0.3674,19,29,19,641948,34496,89123,37133,0.2732226587251299,0.5184073489787656
3673,0.3675,12,25,12,641973,34471,89135,37121,0.27302464833354456,0.5185076544865348
3674,0.3676,19,21,19,641994,34450,89154,37102,0.2728583196046129,0.518531976744186
3675,0.3677,12,31,12,642025,34419,89166,37090,0.27261278671904704,0.5186759708568153
3676,0.3678,23,37,23,642062,34382,89189,37067,0.2723197313395007,0.5187896261669163
3677,0.3679,13,27,13,642089,34355,89202,37054,0.27210588011658854,0.5188981781007996
3678,0.368,12,25,12,642114,34330,89214,37042,0.2719078697250032,0.5189990472454183
3679,0.3681,19,27,19,642141,34303,89233,37023,0.271694018502091,0.5190673807587696
3680,0.3682,22,21,22,642162,34282,89255,37001,0.2715276897731593,0.5190718684679376
3681,0.3683,13,34,13,642196,34248,89268,36988,0.2712583956406032,0.5192318490650795
3682,0.3684,15,36,15,642232,34212,89283,36973,0.27097326067672034,0.5193931305752616
3683,0.3685,15,23,15,642255,34189,89298,36958,0.27079109111646177,0.5194597101775198
3684,0.3686,20,24,20,642279,34165,89318,36938,0.27060100114053987,0.5194998804551144
3685,0.3687,18,29,18,642308,34136,89336,36920,0.27037130908630086,0.5195901823913534
3686,0.3688,10,35,10,642343,34101,89346,36910,0.27009409453808136,0.5197786258466998
3687,0.3689,14,19,14,642362,34082,89360,36896,0.2699436066404765,0.5198230437600383
3688,0.369,10,28,10,642390,34054,89370,36886,0.2697218350019009,0.5199605300253736
3689,0.3691,26,25,26,642415,34029,89396,36860,0.26952382461031554,0.5199678370410078
3690,0.3692,16,30,16,642445,33999,89412,36844,0.26928621214041315,0.5200796126646245
3691,0.3693,19,20,19,642465,33979,89431,36825,0.26912780382714485,0.5200977345912661
3692,0.3694,18,24,18,642489,33955,89449,36807,0.2689377138512229,0.5201520590147254
3693,0.3695,17,26,17,642515,33929,89466,36790,0.26873178304397416,0.5202279443996662
3694,0.3696,25,32,25,642547,33897,89491,36765,0.2684783297427449,0.5202937929863293
3695,0.3697,14,25,14,642572,33872,89505,36751,0.26828031935115954,0.5203828780992028
3696,0.3698,7,20,7,642592,33852,89512,36744,0.2681219110378913,0.5204827468978412
3697,0.3699,16,26,16,642618,33826,89528,36728,0.2679159802306425,0.5205658077500921
3698,0.37,18,21,18,642639,33805,89546,36710,0.2677496515017108,0.5205984542295965
3699,0.3701,13,29,13,642668,33776,89559,36697,0.2675199594474718,0.5207242490031644
3700,0.3702,14,24,14,642692,33752,89573,36683,0.26732986947154985,0.5208064172641442
3701,0.3703,15,32,15,642724,33720,89588,36668,0.26707641617032063,0.520941069500483
3702,0.3704,15,33,15,642757,33687,89603,36653,0.26681504245342796,0.5210833096388968
3703,0.3705,19,18,19,642775,33669,89622,36634,0.2666724749714865,0.5210872935721093
3704,0.3706,14,18,14,642793,33651,89636,36620,0.266529907489545,0.521125357544364
3705,0.3707,22,27,22,642820,33624,89658,36598,0.26631605626663285,0.521175699923101
3706,0.3708,15,27,15,642847,33597,89673,36583,0.2661022050437207,0.5212738671986321
3707,0.3709,10,20,10,642867,33577,89683,36573,0.26594379673045243,0.5213542409123307
3708,0.371,19,27,19,642894,33550,89702,36554,0.26572994550754026,0.521425310966564
3709,0.3711,13,24,13,642918,33526,89715,36541,0.2655398555316183,0.5215151212410978
3710,0.3712,20,31,20,642949,33495,89735,36521,0.26529432264605246,0.5216093464351006
3711,0.3713,15,26,15,642975,33469,89750,36506,0.2650883918388037,0.5217006073597713
3712,0.3714,15,25,15,643000,33444,89765,36491,0.2648903814472183,0.5217845141917494
3713,0.3715,19,17,19,643017,33427,89784,36472,0.2647557343809403,0.521781427488233
3714,0.3716,15,23,15,643040,33404,89799,36457,0.2645735648206818,0.5218505317702294
3715,0.3717,18,19,18,643059,33385,89817,36439,0.2644230769230769,0.5218692713107241
3716,0.3718,21,33,21,643092,33352,89838,36418,0.26416170320618426,0.5219721943528737
3717,0.3719,15,23,15,643115,33329,89853,36403,0.26397953364592575,0.5220415304307922
3718,0.372,12,21,12,643136,33308,89865,36391,0.26381320491699406,0.522116529648919
3719,0.3721,13,29,13,643165,33279,89878,36378,0.26358351286275505,0.5222447133812825
3720,0.3722,19,31,19,643196,33248,89897,36359,0.2633379799771892,0.5223468903989541
3721,0.3723,10,20,10,643216,33228,89907,36349,0.2631795716639209,0.5224283886916653
3722,0.3724,10,30,10,643246,33198,89917,36339,0.2629419591940185,0.5225850985806118
3723,0.3725,18,14,18,643260,33184,89935,36321,0.2628310733747307,0.5225667218185742
3724,0.3726,18,23,18,643283,33161,89953,36303,0.2626489038144722,0.5226160313255788
3725,0.3727,11,24,11,643307,33137,89964,36292,0.26245881383855024,0.5227210531622233
3726,0.3728,18,20,18,643327,33117,89982,36274,0.26230040552528194,0.5227479067890649
3727,0.3729,22,22,22,643349,33095,90004,36252,0.26212615638068687,0.5227623401156503
3728,0.373,19,27,19,643376,33068,90023,36233,0.2619123051577747,0.5228351683236894
3729,0.3731,17,29,17,643405,33039,90040,36216,0.2616826131035357,0.5229369720597791
3730,0.3732,12,26,12,643431,33013,90052,36204,0.2614766822962869,0.5230506956383547
3731,0.3733,15,27,15,643458,32986,90067,36189,0.2612628310733747,0.5231514275388507
3732,0.3734,19,24,19,643482,32962,90086,36170,0.2610727410974528,0.523201990395186
3733,0.3735,19,23,19,643505,32939,90105,36151,0.26089057153719425,0.5232450426979303
3734,0.3736,19,32,19,643537,32907,90124,36132,0.260637118235965,0.5233563637943771
3735,0.3737,9,23,9,643560,32884,90133,36123,0.2604549486757065,0.5234686336168795
3736,0.3738,12,26,12,643586,32858,90145,36111,0.2602490178684577,0.5235830590555177
3737,0.3739,8,23,8,643609,32835,90153,36103,0.2600668483081992,0.523702457280455
3738,0.374,17,25,17,643634,32810,90170,36086,0.25986883791661386,0.5237749651648862
3739,0.3741,16,26,16,643660,32784,90186,36070,0.2596629071093651,0.5238620849914312
3740,0.3742,13,20,13,643680,32764,90199,36057,0.2595044987960968,0.52392438354572
3741,0.3743,19,16,19,643696,32748,90218,36038,0.2593777721454822,0.523914750094496
3742,0.3744,17,29,17,643725,32719,90235,36021,0.2591480800912432,0.5240180389874891
3743,0.3745,18,23,18,643748,32696,90253,36003,0.25896591053098467,0.5240687637374635
3744,0.3746,5,24,5,643772,32672,90258,35998,0.2587758205550627,0.5242172710062618
3745,0.3747,10,15,10,643787,32657,90268,35988,0.2586570143201115,0.5242625100152961
3746,0.3748,17,24,17,643811,32633,90285,35971,0.2584669243441896,0.5243280275202612
3747,0.3749,11,24,11,643835,32609,90296,35960,0.25827683436826765,0.5244352404147646
3748,0.375,10,23,10,643858,32586,90306,35950,0.25809466480800913,0.5245418466207541
3749,0.3751,15,29,15,643887,32557,90321,35935,0.2578649727537701,0.52465981428488
3750,0.3752,15,28,15,643915,32529,90336,35920,0.2576432011151945,0.5247702669140528
3751,0.3753,14,23,14,643938,32506,90350,35906,0.257461031554936,0.5248494416184295
3752,0.3754,18,21,18,643959,32485,90368,35888,0.2572947028260043,0.5248855542392464
3753,0.3755,27,21,27,643980,32464,90395,35861,0.2571283740970726,0.524859129162093
3754,0.3756,19,30,19,644010,32434,90414,35842,0.25689076162717017,0.5249575253383326
3755,0.3757,25,30,25,644040,32404,90439,35817,0.2566531491572678,0.5250142917869864
3756,0.3758,19,16,19,644056,32388,90458,35798,0.25652642250665314,0.5250051330185082
3757,0.3759,17,23,17,644079,32365,90475,35781,0.2563442529463946,0.5250638335338831
3758,0.376,19,26,19,644105,32339,90494,35762,0.25613832213914584,0.5251317895478774
3759,0.3761,13,28,13,644133,32311,90507,35749,0.2559165505005703,0.5252571260652366
3760,0.3762,14,23,14,644156,32288,90521,35735,0.25573438094031176,0.5253370183614365
3761,0.3763,17,21,17,644177,32267,90538,35718,0.25556805221138007,0.5253805986614695
3762,0.3764,11,18,11,644195,32249,90549,35707,0.2554254847294386,0.5254429336629584
3763,0.3765,22,21,22,644216,32228,90571,35685,0.2552591560005069,0.5254516808269404
3764,0.3766,10,27,10,644243,32201,90581,35675,0.25504530477759474,0.5255907831928811
3765,0.3767,14,18,14,644261,32183,90595,35661,0.25490273729565327,0.5256323329992335
3766,0.3768,15,27,15,644288,32156,90610,35646,0.2546888860727411,0.5257367039320374
3767,0.3769,17,20,17,644308,32136,90627,35629,0.2545304777594728,0.5257728916107135
3768,0.377,11,18,11,644326,32118,90638,35618,0.2543879102775314,0.5258355970237393
3769,0.3771,15,29,15,644355,32089,90653,35603,0.2541582182232924,0.52595579979909
3770,0.3772,18,25,18,644380,32064,90671,35585,0.25396020783170703,0.5260240358320153
3771,0.3773,24,20,24,644400,32044,90695,35561,0.25380179951843873,0.5260113896901116
3772,0.3774,23,29,23,644429,32015,90718,35538,0.2535721074641997,0.5260758219472118
3773,0.3775,12,16,12,644445,31999,90730,35526,0.2534453808135851,0.5261162532395409
3774,0.3776,20,22,20,644467,31977,90750,35506,0.25327113166899,0.5261473259932131
3775,0.3777,10,33,10,644500,31944,90760,35496,0.25300975795209735,0.5263345195729537
3776,0.3778,16,15,16,644515,31929,90776,35480,0.2528909517171461,0.526339212864751
3777,0.3779,21,34,21,644549,31895,90797,35459,0.25262165758459004,0.5264572259999406
3778,0.378,16,23,16,644572,31872,90813,35443,0.2524394880243315,0.5265245487632771
3779,0.3781,11,19,11,644591,31853,90824,35432,0.25228900012672667,0.5265958237348591
3780,0.3782,12,22,12,644613,31831,90836,35420,0.25211475098213154,0.5266836180874633
3781,0.3783,17,26,17,644639,31805,90853,35403,0.25190882017488275,0.5267676467087251
3782,0.3784,21,32,21,644671,31773,90874,35382,0.25165536687365353,0.5268706723252178
3783,0.3785,18,27,18,644698,31746,90892,35364,0.25144151565074135,0.5269557443004024
3784,0.3786,13,33,13,644731,31713,90905,35351,0.2511801419338487,0.527123344864607
3785,0.3787,15,24,15,644755,31689,90920,35336,0.25099005195792673,0.5272062663185378
3786,0.3788,12,29,12,644784,31660,90932,35324,0.2507603599036877,0.5273498148811656
3787,0.3789,12,20,12,644804,31640,90944,35312,0.2506019515904195,0.5274226311387262
3788,0.379,16,26,16,644830,31614,90960,35296,0.2503960207831707,0.527514571812883
3789,0.3791,19,31,19,644861,31583,90979,35277,0.25015048789760486,0.5276248878253066
3790,0.3792,10,25,10,644886,31558,90989,35267,0.2499524775060195,0.5277515899738122
3791,0.3793,16,36,16,644922,31522,91005,35251,0.2496673425421366,0.5279229628742156
3792,0.3794,15,29,15,644951,31493,91020,35236,0.2494376504878976,0.5280462767312563
3793,0.3795,15,20,15,644971,31473,91035,35221,0.24927924217462932,0.5280984796233544
3794,0.3796,15,16,15,644987,31457,91050,35206,0.2491525155240147,0.5281190465475601
3795,0.3797,17,20,17,645007,31437,91067,35189,0.2489941072107464,0.5281571758772852
3796,0.3798,14,22,14,645029,31415,91081,35175,0.2488198580661513,0.528232467337438
3797,0.3799,15,30,15,645059,31385,91096,35160,0.2485822455962489,0.5283642647832294
3798,0.38,18,22,18,645081,31363,91114,35142,0.2484079964516538,0.5284113976392752
3799,0.3801,12,23,12,645104,31340,91126,35130,0.24822582689139527,0.5285091018504589
3800,0.3802,21,26,21,645130,31314,91147,35109,0.24801989608414649,0.5285669120635924
3801,0.3803,4,27,4,645157,31287,91151,35105,0.2478060448612343,0.5287534642728039
3802,0.3804,13,17,13,645174,31270,91164,35092,0.24767139779495628,0.528796600464121
3803,0.3805,13,22,13,645196,31248,91177,35079,0.24749714865036118,0.5288796417748428
3804,0.3806,11,27,11,645223,31221,91188,35068,0.247283297427449,0.529016880628762
3805,0.3807,12,25,12,645248,31196,91200,35056,0.24708528703586363,0.5291311960393649
3806,0.3808,17,32,17,645280,31164,91217,35039,0.24683183373463438,0.5292660453453771
3807,0.3809,18,27,18,645307,31137,91235,35021,0.2466179825117222,0.5293539707971825
3808,0.381,19,27,19,645334,31110,91254,35002,0.24640413128881003,0.5294348983543078
3809,0.3811,17,21,17,645355,31089,91271,34985,0.24623780255987834,0.529482095831946
3810,0.3812,15,18,15,645373,31071,91286,34970,0.2460952350779369,0.5295195408912645
3811,0.3813,24,24,24,645397,31047,91310,34946,0.24590514510201494,0.5295410119255073
3812,0.3814,7,23,7,645420,31024,91317,34939,0.24572297554175643,0.5296757273016691
3813,0.3815,17,28,17,645448,30996,91334,34922,0.24550120390318084,0.5297794229193847
3814,0.3816,11,18,11,645466,30978,91345,34911,0.2453586364212394,0.5298456495014342
3815,0.3817,14,29,14,645495,30949,91359,34897,0.2451289443670004,0.5299790420071075
3816,0.3818,6,27,6,645522,30922,91365,34891,0.24491509314408821,0.530153617066537
3817,0.3819,10,28,10,645550,30894,91375,34881,0.24469332150551262,0.5303078677309008
3818,0.382,14,20,14,645570,30874,91389,34867,0.24453491319224432,0.5303691760088833
3819,0.3821,21,19,21,645589,30855,91410,34846,0.24438442529463947,0.5303724448638529
3820,0.3822,19,26,19,645615,30829,91429,34827,0.2441784944873907,0.5304465700012184
3821,0.3823,21,16,21,645631,30813,91450,34806,0.24405176783677607,0.5304256389155579
3822,0.3824,18,28,18,645659,30785,91468,34788,0.24382999619820048,0.5305232336479954
3823,0.3825,10,19,10,645678,30766,91478,34778,0.24367950830059562,0.5306053948492616
3824,0.3826,13,20,13,645698,30746,91491,34765,0.24352109998732732,0.5306742379142434
3825,0.3827,16,22,16,645720,30724,91507,34749,0.24334685084273222,0.5307378614085195
3826,0.3828,16,38,16,645758,30686,91523,34733,0.24304587504752248,0.5309313807915131
3827,0.3829,15,19,15,645777,30667,91538,34718,0.24289538714991762,0.530978053070276
3828,0.383,17,25,17,645802,30642,91555,34701,0.24269737675833228,0.5310591800192829
3829,0.3831,16,18,16,645820,30624,91571,34685,0.24255480927639084,0.5310906613177356
3830,0.3832,10,25,10,645845,30599,91581,34675,0.24235679888480546,0.5312222324355792
3831,0.3833,14,22,14,645867,30577,91595,34661,0.24218254974021036,0.5313007756215703
3832,0.3834,12,27,12,645894,30550,91607,34649,0.2419686985172982,0.5314345312044664
3833,0.3835,13,20,13,645914,30530,91620,34636,0.24181029020402992,0.5315041586103183
3834,0.3836,7,26,7,645940,30504,91627,34629,0.24160435939678115,0.5316659757726498
3835,0.3837,14,21,14,645961,30483,91641,34615,0.24143803066784944,0.5317367661064856
3836,0.3838,13,25,13,645986,30458,91654,34602,0.2412400202762641,0.531847525361205
3837,0.3839,16,22,16,646008,30436,91670,34586,0.241065771131669,0.5319122758450986
3838,0.384,19,28,19,646036,30408,91689,34567,0.2408439994930934,0.5320046171604463
3839,0.3841,17,17,17,646053,30391,91706,34550,0.24070935242681535,0.5320213732464852
3840,0.3842,9,24,9,646077,30367,91715,34541,0.24051926245089342,0.5321532014543662
3841,0.3843,14,20,14,646097,30347,91729,34527,0.24036085413762515,0.5322162962049511
3842,0.3844,11,23,11,646120,30324,91740,34516,0.24017868457736663,0.5323257248611968
3843,0.3845,22,23,22,646143,30301,91762,34494,0.2399965150171081,0.532355891658307
3844,0.3846,11,17,11,646160,30284,91773,34483,0.23986186795083006,0.5324161996078249
3845,0.3847,17,29,17,646189,30255,91790,34466,0.23963217589659105,0.5325319448092583
3846,0.3848,16,20,16,646209,30235,91806,34450,0.23947376758332278,0.5325809693128237
3847,0.3849,20,19,20,646228,30216,91826,34430,0.2393232796857179,0.5325928905114006
3848,0.385,13,28,13,646256,30188,91839,34417,0.2391015080471423,0.5327296648866187
3849,0.3851,10,23,10,646279,30165,91849,34407,0.2389193384868838,0.5328470544508456
3850,0.3852,11,22,11,646301,30143,91860,34396,0.2387450893422887,0.5329490695548428
3851,0.3853,16,19,16,646320,30124,91876,34380,0.2385946014446838,0.5329902021580057
3852,0.3854,9,24,9,646344,30100,91885,34371,0.23840451146876188,0.5331234198321726
3853,0.3855,15,33,15,646377,30067,91900,34356,0.2381431377518692,0.5332878009406579
3854,0.3856,17,22,17,646399,30045,91917,34339,0.2379688886072741,0.5333467942345924
3855,0.3857,14,26,14,646425,30019,91931,34325,0.23776295780002535,0.5334607733432799
3856,0.3858,10,21,10,646446,29998,91941,34315,0.23759662907109366,0.5335624212834108
3857,0.3859,16,21,16,646467,29977,91957,34299,0.23743030034216195,0.5336206360072189
3858,0.386,12,16,12,646483,29961,91969,34287,0.23730357369154734,0.5336664176316772
3859,0.3861,9,21,9,646504,29940,91978,34278,0.23713724496261565,0.5337755769410446
3860,0.3862,16,20,16,646524,29920,91994,34262,0.23697883664934735,0.533825683213362
3861,0.3863,14,20,14,646544,29900,92008,34248,0.23682042833607908,0.5338903784997194
3862,0.3864,9,13,9,646557,29887,92017,34239,0.2367174629324547,0.5339331940242648
3863,0.3865,10,17,10,646574,29870,92027,34229,0.23658281586617666,0.5340020905162327
3864,0.3866,11,20,11,646594,29850,92038,34218,0.2364244075529084,0.5340887806705376
3865,0.3867,16,24,16,646618,29826,92054,34202,0.23623431757698643,0.5341725495095896
3866,0.3868,11,22,11,646640,29804,92065,34191,0.23606006843239133,0.5342761153215095
3867,0.3869,12,19,12,646659,29785,92077,34179,0.23590958053478647,0.5343474454380589
3868,0.387,15,22,15,646681,29763,92092,34164,0.23573533139019134,0.5344220751795016
3869,0.3871,13,18,13,646699,29745,92105,34151,0.2355927639082499,0.5344779015900839
3870,0.3872,16,24,16,646723,29721,92121,34135,0.23540267393232797,0.5345621398145828
3871,0.3873,15,26,15,646749,29695,92136,34120,0.2351967431250792,0.5346705320065815
3872,0.3874,13,27,13,646776,29668,92149,34107,0.23498289190216703,0.5348020384163074
3873,0.3875,16,14,16,646790,29654,92165,34091,0.23487200608287923,0.534802729625853
3874,0.3876,8,19,8,646809,29635,92173,34083,0.23472151818527437,0.5349037948460403
3875,0.3877,13,21,13,646830,29614,92186,34070,0.23455518945634266,0.5349852396206268
3876,0.3878,14,17,14,646847,29597,92200,34056,0.23442054239006463,0.5350258432438377
3877,0.3879,10,16,10,646863,29581,92210,34046,0.23429381573945002,0.5350873057035536
3878,0.388,15,21,15,646884,29560,92225,34031,0.2341274870105183,0.5351543457407495
3879,0.3881,19,11,19,646895,29549,92244,34012,0.23404036243822077,0.5351080064819622
3880,0.3882,13,20,13,646915,29529,92257,33999,0.23388195412495247,0.5351813373630525
3881,0.3883,14,17,14,646932,29512,92271,33985,0.23374730705867444,0.5352221364788887
3882,0.3884,11,26,11,646958,29486,92282,33974,0.23354137625142568,0.5353608572329026
3883,0.3885,19,23,19,646981,29463,92301,33955,0.23335920669116716,0.5354158125453341
3884,0.3886,17,24,17,647005,29439,92318,33938,0.2331691167152452,0.5354939489089102
3885,0.3887,13,16,13,647021,29423,92331,33925,0.2330423900646306,0.5355338763654732
3886,0.3888,14,16,14,647037,29407,92345,33911,0.23291566341401596,0.5355665055750339
3887,0.3889,7,22,7,647059,29385,92352,33904,0.23274141426942085,0.5357013067041666
3888,0.389,9,17,9,647076,29368,92361,33895,0.23260676720314283,0.5357792074356259
3889,0.3891,13,23,13,647099,29345,92374,33882,0.2324245976428843,0.5358786594334699
3890,0.3892,17,17,17,647116,29328,92391,33865,0.23228995057660626,0.5358979633820201
3891,0.3893,11,25,11,647141,29303,92402,33854,0.2320919401850209,0.5360292604145226
3892,0.3894,16,26,16,647167,29277,92418,33838,0.23188600937777215,0.5361324566267923
3893,0.3895,12,22,12,647189,29255,92430,33826,0.23171176023317705,0.5362311948130182
3894,0.3896,16,12,16,647201,29243,92446,33810,0.23161671524521607,0.5362155646836788
3895,0.3897,16,17,16,647218,29226,92462,33794,0.23148206817893804,0.5362424627102507
3896,0.3898,6,17,6,647235,29209,92468,33788,0.23134742111266,0.5363430004603393
3897,0.3899,16,14,16,647249,29195,92484,33772,0.2312365352933722,0.5363444343862658
3898,0.39,13,14,13,647263,29181,92497,33759,0.2311256494740844,0.536367969494757
3899,0.3901,7,20,7,647283,29161,92504,33752,0.23096724116081613,0.53648689460048
3900,0.3902,13,29,13,647312,29132,92517,33739,0.23073754910657712,0.536638513782189
3901,0.3903,19,24,19,647336,29108,92536,33720,0.23054745913065516,0.5367033806583053
3902,0.3904,14,18,14,647354,29090,92550,33706,0.23040489164871372,0.5367539333715523
3903,0.3905,15,20,15,647374,29070,92565,33691,0.23024648333544545,0.53681426363506
3904,0.3906,16,15,16,647389,29055,92581,33675,0.23012767710049423,0.5368244858919178
3905,0.3907,13,23,13,647412,29032,92594,33662,0.2299455075402357,0.5369253836092768
3906,0.3908,17,31,17,647443,29001,92611,33645,0.22969997465466988,0.5370654151901159
3907,0.3909,9,19,9,647462,28982,92620,33636,0.22954948675706502,0.5371618384490082
3908,0.391,10,18,10,647480,28964,92630,33626,0.22940691927512355,0.5372423709857804
3909,0.3911,8,19,8,647499,28945,92638,33618,0.2292564313775187,0.5373463548742867
3910,0.3912,17,24,17,647523,28921,92655,33601,0.22906634140159676,0.5374268257573335
3911,0.3913,14,27,14,647550,28894,92669,33587,0.2288524901786846,0.5375554168467214
3912,0.3914,18,10,18,647560,28884,92687,33569,0.22877328602205044,0.5375082061710407
3913,0.3915,11,29,11,647589,28855,92698,33558,0.22854359396781143,0.5376764456122923
3914,0.3916,16,16,16,647605,28839,92714,33542,0.22841686731719682,0.5376957727513185
3915,0.3917,17,15,17,647620,28824,92731,33525,0.2282980610822456,0.5376990809796468
3916,0.3918,11,20,11,647640,28804,92742,33514,0.22813965276897732,0.5377900446099041
3917,0.3919,14,23,14,647663,28781,92756,33500,0.22795748320871878,0.5378847481575441
3918,0.392,17,20,17,647683,28761,92773,33483,0.2277990748954505,0.5379313668787353
3919,0.3921,16,26,16,647709,28735,92789,33467,0.22759314408820175,0.5380373621426964
3920,0.3922,9,21,9,647730,28714,92798,33458,0.22742681535927006,0.5381522228655987
3921,0.3923,11,24,11,647754,28690,92809,33447,0.22723672538334813,0.538278320485379
3922,0.3924,18,18,18,647772,28672,92827,33429,0.22709415790140666,0.5383005104587688
3923,0.3925,17,20,17,647792,28652,92844,33412,0.2269357495881384,0.5383475122454241
3924,0.3926,14,20,14,647812,28632,92858,33398,0.2267773412748701,0.5384168950507818
3925,0.3927,12,24,12,647836,28608,92870,33386,0.22658725129894816,0.5385359873536149
3926,0.3928,14,16,14,647852,28592,92884,33372,0.22646052464833355,0.5385707830353108
3927,0.3929,22,26,22,647878,28566,92906,33350,0.2262545938410848,0.5386329866270431
3928,0.393,12,25,12,647903,28541,92918,33338,0.22605658344949944,0.5387611305935778
3929,0.3931,13,20,13,647923,28521,92931,33325,0.22589817513623114,0.5388384050706594
3930,0.3932,14,20,14,647943,28501,92945,33311,0.22573976682296287,0.5389083025949654
3931,0.3933,15,26,15,647969,28475,92960,33296,0.2255338360157141,0.5390231662106814
3932,0.3934,15,22,15,647991,28453,92975,33281,0.22535958687111898,0.5391032494249522
3933,0.3935,11,21,11,648012,28432,92986,33270,0.2251932581421873,0.5392045638715115
3934,0.3936,12,21,12,648033,28411,92998,33258,0.2250269294132556,0.5392985130292367
3935,0.3937,21,13,21,648046,28398,93019,33237,0.22492396400963122,0.5392552932587004
3936,0.3938,14,18,14,648064,28380,93033,33223,0.22478139652768978,0.5393081505770823
3937,0.3939,20,26,20,648090,28354,93053,33203,0.22457546572044101,0.5393862598892084
3938,0.394,13,24,13,648114,28330,93066,33190,0.22438537574451908,0.5394993498049415
3939,0.3941,15,27,15,648141,28303,93081,33175,0.2241715245216069,0.5396239305117277
3940,0.3942,22,16,22,648157,28287,93103,33153,0.22404479787099227,0.539599609375
3941,0.3943,12,22,12,648179,28265,93115,33141,0.22387054872639717,0.5397029606227405
3942,0.3944,17,18,17,648197,28247,93132,33124,0.2237279812444557,0.5397337504684623
3943,0.3945,10,24,10,648221,28223,93142,33114,0.22353789126853377,0.5398698990821201
3944,0.3946,13,30,13,648251,28193,93155,33101,0.22330027879863135,0.5400365451757105
3945,0.3947,12,15,12,648266,28178,93167,33089,0.22318147256368015,0.5400786720420455
3946,0.3948,18,20,18,648286,28158,93185,33071,0.22302306425041185,0.5401198778356661
3947,0.3949,10,15,10,648301,28143,93195,33061,0.22290425801546065,0.5401771126070192
3948,0.395,14,20,14,648321,28123,93209,33047,0.22274584970219238,0.5402484878208272
3949,0.3951,14,30,14,648351,28093,93223,33033,0.22250823723228996,0.5404083368779243
3950,0.3952,24,17,24,648368,28076,93247,33009,0.2223735901660119,0.5403781615781288
3951,0.3953,12,17,12,648385,28059,93259,32997,0.22223894309973388,0.540438286163522
3952,0.3954,23,19,23,648404,28040,93282,32974,0.222088455202129,0.540433343167142
3953,0.3955,11,25,11,648429,28015,93293,32963,0.22189044481054365,0.5405720095772246
3954,0.3956,15,21,15,648450,27994,93308,32948,0.22172411608161197,0.5406452036362442
3955,0.3957,8,19,8,648469,27975,93316,32940,0.2215736281840071,0.5407535089879341
3956,0.3958,20,20,20,648489,27955,93336,32920,0.2214152198707388,0.5407802874743326
3957,0.3959,13,19,13,648508,27936,93349,32907,0.22126473197313395,0.5408510428479858
3958,0.396,15,21,15,648529,27915,93364,32892,0.22109840324420227,0.5409245646060487
3959,0.3961,14,17,14,648546,27898,93378,32878,0.22096375617792421,0.5409701197841253
3960,0.3962,8,21,8,648567,27877,93386,32870,0.22079742744899253,0.541096679671424
3961,0.3963,10,17,10,648584,27860,93396,32860,0.22066278038271447,0.5411725955204216
3962,0.3964,13,21,13,648605,27839,93409,32847,0.2204964516537828,0.5412615759812807
3963,0.3965,15,21,15,648626,27818,93424,32832,0.2203301229248511,0.5413355317394889
3964,0.3966,7,22,7,648648,27796,93431,32825,0.220155873780256,0.541479025420234
3965,0.3967,16,34,16,648682,27762,93447,32809,0.21988657964769992,0.541661851381024
3966,0.3968,13,20,13,648702,27742,93460,32796,0.21972817133443162,0.5417423766890218
3967,0.3969,10,16,10,648718,27726,93470,32786,0.219601444683817,0.5418098889476467
3968,0.397,13,25,13,648743,27701,93483,32773,0.21940343429223166,0.5419353771868902
3969,0.3971,13,27,13,648770,27674,93496,32760,0.2191895830693195,0.5420789621736108
3970,0.3972,20,23,20,648793,27651,93516,32740,0.21900741350906094,0.5421337616532265
3971,0.3973,12,17,12,648810,27634,93528,32728,0.21887276644278292,0.5421954209602068
3972,0.3974,14,11,14,648821,27623,93542,32714,0.21878564187048535,0.5421880438205413
3973,0.3975,14,31,14,648852,27592,93556,32700,0.21854010898491952,0.5423605121740861
3974,0.3976,16,14,16,648866,27578,93572,32684,0.21842922316563174,0.5423650061398559
3975,0.3977,13,12,13,648878,27566,93585,32671,0.21833417817767076,0.5423742882281655
3976,0.3978,15,25,15,648903,27541,93600,32656,0.2181361677860854,0.542485505922222
3977,0.3979,10,21,10,648924,27520,93610,32646,0.21796983905715372,0.5425988099591131
3978,0.398,10,19,10,648943,27501,93620,32636,0.21781935115954884,0.5426941816186375
3979,0.3981,15,12,15,648955,27489,93635,32621,0.2177243061715879,0.5426884045915821
3980,0.3982,11,34,11,648989,27455,93646,32610,0.2174550120390318,0.5429118455007076
3981,0.3983,15,26,15,649015,27429,93661,32595,0.21724908123178305,0.5430327868852459
3982,0.3984,14,17,14,649032,27412,93675,32581,0.217114434165505,0.5430800260030337
3983,0.3985,14,22,14,649054,27390,93689,32567,0.2169401850209099,0.5431726070350418
3984,0.3986,14,19,14,649073,27371,93703,32553,0.21678969712330504,0.5432381015953541
3985,0.3987,10,16,10,649089,27355,93713,32543,0.2166629704726904,0.5433069551571004
3986,0.3988,10,15,10,649104,27340,93723,32533,0.2165441642377392,0.5433667930452791
3987,0.3989,14,19,14,649123,27321,93737,32519,0.21639367634013432,0.5434324866310161
3988,0.399,8,24,8,649147,27297,93745,32511,0.21620358636421239,0.5435894863563403
3989,0.3991,9,19,9,649166,27278,93754,32502,0.21605309846660753,0.5436935429909668
3990,0.3992,15,14,15,649180,27264,93769,32487,0.21594221264731972,0.5437063814831551
3991,0.3993,20,26,20,649206,27238,93789,32467,0.21573628184007096,0.5437903023197387
3992,0.3994,8,20,8,649226,27218,93797,32459,0.2155778735268027,0.5439113896476029
3993,0.3995,11,22,11,649248,27196,93808,32448,0.2154036243822076,0.5440278988666085
3994,0.3996,13,20,13,649268,27176,93821,32435,0.2152452160689393,0.5441109862273742
3995,0.3997,18,16,18,649284,27160,93839,32417,0.21511848941832468,0.5441193749265656
3996,0.3998,12,19,12,649303,27141,93851,32405,0.21496800152071982,0.5442011218217848
3997,0.3999,12,13,12,649316,27128,93863,32393,0.21486503611709543,0.5442280875657332
3998,0.4,15,18,15,649334,27110,93878,32378,0.21472246863515398,0.5442778375470683
3999,0.4001,11,21,11,649355,27089,93889,32367,0.21455613990622227,0.544385764262648
4000,0.4002,6,19,6,649374,27070,93895,32361,0.21440565200861741,0.5445138059262001
4001,0.4003,12,20,12,649394,27050,93907,32349,0.21424724369534914,0.5446051280324584
4002,0.4004,5,20,5,649414,27030,93912,32344,0.21408883538208084,0.5447502273722504
4003,0.4005,13,18,13,649432,27012,93925,32331,0.2139462679001394,0.5448157322683383
4004,0.4006,10,18,10,649450,26994,93935,32321,0.21380370041819793,0.5449043243698896
4005,0.4007,11,24,11,649474,26970,93946,32310,0.213613610442276,0.5450404858299596
4006,0.4008,16,18,16,649492,26952,93962,32294,0.21347104296033456,0.5450832123687676
4007,0.4009,13,25,13,649517,26927,93975,32281,0.21327303256874922,0.5452134846642346
4008,0.401,17,17,17,649534,26910,93992,32264,0.21313838550247116,0.5452394632777909
4009,0.4011,14,18,14,649552,26892,94006,32250,0.21299581802052972,0.5452977579385209
4010,0.4012,13,23,13,649575,26869,94019,32237,0.2128136484602712,0.5454099414611038
4011,0.4013,10,17,10,649592,26852,94029,32227,0.21267900139399315,0.5454899372027285
4012,0.4014,15,21,15,649613,26831,94044,32212,0.21251267266506146,0.5455684839862474
4013,0.4015,9,18,9,649631,26813,94053,32203,0.21237010518312002,0.5456655822149925
4014,0.4016,12,17,12,649648,26796,94065,32191,0.21223545811684197,0.5457304151762252
4015,0.4017,8,27,8,649675,26769,94073,32183,0.2120216068939298,0.5459187135296513
4016,0.4018,9,25,9,649700,26744,94082,32174,0.21182359650234445,0.5460809939237584
4017,0.4019,9,15,9,649715,26729,94091,32165,0.21170479026739322,0.5461507114476857
4018,0.402,18,26,18,649741,26703,94109,32147,0.21149885946014446,0.5462531860662702
4019,0.4021,13,25,13,649766,26678,94122,32134,0.21130084906855912,0.5463850914779297
4020,0.4022,10,22,10,649788,26656,94132,32124,0.21112659992396401,0.5465124191902008
4021,0.4023,10,23,10,649811,26633,94142,32114,0.2109444303637055,0.5466491905969667
4022,0.4024,18,14,18,649825,26619,94160,32096,0.2108335445444177,0.5466405518181044
4023,0.4025,6,15,6,649840,26604,94166,32090,0.2107147383094665,0.5467339080655603
4024,0.4026,12,26,12,649866,26578,94178,32078,0.2105088075022177,0.5468835242771413
4025,0.4027,11,24,11,649890,26554,94189,32067,0.21031871752629577,0.5470223981167158
4026,0.4028,12,24,12,649914,26530,94201,32055,0.21012862755037384,0.5471537082871042
4027,0.4029,12,20,12,649934,26510,94213,32043,0.20997021923710557,0.5472477925981589
4028,0.403,14,28,14,649962,26482,94227,32029,0.20974844759852998,0.5474013433371503
4029,0.4031,8,25,8,649987,26457,94235,32021,0.20955043720694463,0.5475734464242963
4030,0.4032,9,22,9,650009,26435,94244,32012,0.2093761880623495,0.5477098910123702
4031,0.4033,7,19,7,650028,26416,94251,32005,0.20922570016474465,0.5478338268773215
4032,0.4034,9,16,9,650044,26400,94260,31996,0.20909897351413,0.5479142407014179
4033,0.4035,12,20,12,650064,26380,94272,31984,0.20894056520086174,0.5480090466726064
4034,0.4036,10,23,10,650087,26357,94282,31974,0.20875839564060322,0.5481476401913219
4035,0.4037,17,17,17,650104,26340,94299,31957,0.20862374857432517,0.5481757208775752
4036,0.4038,14,28,14,650132,26312,94313,31943,0.20840197693574958,0.5483306153978199
4037,0.4039,18,21,18,650153,26291,94331,31925,0.2082356482068179,0.5483887591040264
4038,0.404,13,21,13,650174,26270,94344,31912,0.2080693194778862,0.5484857859819188
4039,0.4041,20,11,20,650185,26259,94364,31892,0.20798219490558864,0.5484342487661433
4040,0.4042,19,24,19,650209,26235,94383,31873,0.2077921049296667,0.5485131135127693
4041,0.4043,12,17,12,650226,26218,94395,31861,0.20765745786338868,0.5485803818936277
4042,0.4044,6,27,6,650253,26191,94401,31855,0.20744360664047648,0.5487888915687558
4043,0.4045,12,20,12,650273,26171,94413,31843,0.2072851983272082,0.5488847519564243
4044,0.4046,10,8,10,650281,26163,94423,31833,0.2072218350019009,0.5488826815642458
4045,0.4047,16,18,16,650299,26145,94439,31817,0.20707926751995945,0.548928608398606
4046,0.4048,11,17,11,650316,26128,94450,31806,0.20694462045368142,0.5490040390789519
4047,0.4049,12,18,12,650334,26110,94462,31794,0.20680205297173995,0.5490812379110251
4048,0.405,13,17,13,650351,26093,94475,31781,0.20666740590546193,0.5491412378615613
4049,0.4051,11,11,11,650362,26082,94486,31770,0.20658028133316436,0.5491599253266957
4050,0.4052,14,13,14,650375,26069,94500,31756,0.20647731592954,0.5491742325983571
4051,0.4053,13,26,13,650401,26043,94513,31743,0.2062713851222912,0.5493199044751323
4052,0.4054,13,20,13,650421,26023,94526,31730,0.20611297680902294,0.5494086887261268
4053,0.4055,11,18,11,650439,26005,94537,31719,0.2059704093270815,0.5494941445499273
4054,0.4056,17,24,17,650463,25981,94554,31702,0.20578031935115954,0.5495900005200839
4055,0.4057,8,18,8,650481,25963,94562,31694,0.2056377518692181,0.5496990825051599
4056,0.4058,11,15,11,650496,25948,94573,31683,0.2055189456342669,0.549756207596606
4057,0.4059,15,20,15,650516,25928,94588,31668,0.2053605373209986,0.5498298492950899
4058,0.406,13,19,13,650535,25909,94601,31655,0.20521004942339374,0.5499096657633243
4059,0.4061,8,20,8,650555,25889,94609,31647,0.20505164111012547,0.5500382369299222
4060,0.4062,12,18,12,650573,25871,94621,31635,0.204909073628184,0.5501165095816088
4061,0.4063,13,17,13,650590,25854,94634,31622,0.20477442656190598,0.550177465376853
4062,0.4064,11,18,11,650608,25836,94645,31611,0.2046318590799645,0.550263721343151
4063,0.4065,21,25,21,650633,25811,94666,31590,0.20443384868837916,0.5503388442710058
4064,0.4066,11,17,11,650650,25794,94677,31579,0.20429920162210113,0.5504157007651683
4065,0.4067,17,16,17,650666,25778,94694,31562,0.2041724749714865,0.5504359958144401
4066,0.4068,16,15,16,650681,25763,94710,31546,0.2040536687365353,0.5504545533860301
4067,0.4069,22,18,22,650699,25745,94732,31524,0.20391110125459383,0.5504548708725489
4068,0.407,14,14,14,650713,25731,94746,31510,0.20380021543530605,0.5504795513705212
4069,0.4071,15,23,15,650736,25708,94761,31495,0.20361804587504753,0.550583011380522
4070,0.4072,11,28,11,650764,25680,94772,31484,0.20339627423647194,0.550766216499895
4071,0.4073,10,18,10,650782,25662,94782,31474,0.20325370675453047,0.5508611033323999
4072,0.4074,13,12,13,650794,25650,94795,31461,0.20315866176656952,0.5508746125965226
4073,0.4075,12,22,12,650816,25628,94807,31449,0.2029844126219744,0.5509925188780069
4074,0.4076,11,27,11,650843,25601,94818,31438,0.20277056139906222,0.5511667455600554
4075,0.4077,13,15,13,650858,25586,94831,31425,0.20265175516411102,0.5512094157267896
4076,0.4078,12,16,12,650874,25570,94843,31413,0.20252502851349638,0.551269676921187
4077,0.4079,20,23,20,650897,25547,94863,31393,0.20234285895323786,0.5513347383210397
4078,0.408,10,22,10,650919,25525,94873,31383,0.20216860980864276,0.5514690377451325
4079,0.4081,17,26,17,650945,25499,94890,31366,0.201962679001394,0.5515870922359976
4080,0.4082,16,16,16,650961,25483,94906,31350,0.20183595235077936,0.5516161385110763
4081,0.4083,18,25,18,650986,25458,94924,31332,0.20163794195919402,0.5517168515583729
4082,0.4084,10,22,10,651008,25436,94934,31322,0.20146369281459892,0.5518517213432468
4083,0.4085,15,17,15,651025,25419,94949,31307,0.20132904574832086,0.5518986002891091
4084,0.4086,15,18,15,651043,25401,94964,31292,0.20118647826637942,0.5519552678461186
4085,0.4087,21,13,21,651056,25388,94985,31271,0.20108351286275503,0.5519158474381828
4086,0.4088,10,19,10,651075,25369,94995,31261,0.20093302496515017,0.5520218965212784
4087,0.4089,10,17,10,651092,25352,95005,31251,0.20079837789887214,0.5521085454834549
4088,0.409,15,18,15,651110,25334,95020,31236,0.20065581041693067,0.5521654587237051
4089,0.4091,14,23,14,651133,25311,95034,31222,0.20047364085667216,0.5522791997594325
4090,0.4092,10,22,10,651155,25289,95044,31212,0.20029939171207706,0.5524150015043982
4091,0.4093,13,30,13,651185,25259,95057,31199,0.20006177924217464,0.5526054766375005
4092,0.4094,8,13,8,651198,25246,95065,31191,0.19995881383855024,0.5526693481226854
4093,0.4095,14,17,14,651215,25229,95079,31177,0.19982416677227222,0.5527248874233237
4094,0.4096,9,20,9,651235,25209,95088,31168,0.19966575845900392,0.5528495663125034
4095,0.4097,14,18,14,651253,25191,95102,31154,0.19952319097706248,0.552915076759251
4096,0.4098,10,20,10,651273,25171,95112,31144,0.1993647826637942,0.5530320518511942
4097,0.4099,17,20,17,651293,25151,95129,31127,0.1992063743505259,0.5530935712001137
4098,0.41,13,17,13,651310,25134,95142,31114,0.19907172728424788,0.5531574455980657
4099,0.4101,7,14,7,651324,25120,95149,31107,0.19896084146496007,0.5532395468369289
4100,0.4102,15,17,15,651341,25103,95164,31092,0.19882619439868204,0.5532876590443989
4101,0.4103,6,21,6,651362,25082,95170,31086,0.19865986566975036,0.5534468024497935
4102,0.4104,19,21,19,651383,25061,95189,31067,0.19849353694081864,0.5535027080957811
4103,0.4105,13,18,13,651401,25043,95202,31054,0.1983509694588772,0.5535768401162272
4104,0.4106,8,14,8,651415,25029,95210,31046,0.1982400836395894,0.5536513597860009
4105,0.4107,14,14,14,651429,25015,95224,31032,0.1981291978203016,0.5536781629703642
4106,0.4108,9,15,9,651444,25000,95233,31023,0.1980103915853504,0.5537547078878318
4107,0.4109,11,17,11,651461,24983,95244,31012,0.19787574451907236,0.5538351638539155
4108,0.411,9,11,9,651472,24972,95253,31003,0.1977886199467748,0.5538722644037517
4109,0.4111,6,20,6,651492,24952,95259,30997,0.19763021163350653,0.5540224132692273
4110,0.4112,13,23,13,651515,24929,95272,30984,0.197448042073248,0.5541466206427843
4111,0.4113,7,19,7,651534,24910,95279,30977,0.19729755417564313,0.554279170468982
4112,0.4114,15,28,15,651562,24882,95294,30962,0.19707578253706753,0.554437361220543
4113,0.4115,9,21,9,651583,24861,95303,30953,0.19690945380813585,0.5545741211882323
4114,0.4116,19,16,19,651599,24845,95322,30934,0.19678272715752124,0.5545814733143297
4115,0.4117,15,18,15,651617,24827,95337,30919,0.19664015967557977,0.5546406917088221
4116,0.4118,13,29,13,651646,24798,95350,30906,0.19641046762134076,0.5548255062473072
4117,0.4119,10,23,10,651669,24775,95360,30896,0.19622829806108225,0.5549747624436421
4118,0.412,15,20,15,651689,24755,95375,30881,0.19606988974781397,0.555054281400532
4119,0.4121,14,20,14,651709,24735,95389,30867,0.19591148143454568,0.5551419013704543
4120,0.4122,13,17,13,651726,24718,95402,30854,0.19577683436826765,0.5552076585330742
4121,0.4123,14,16,14,651742,24702,95416,30840,0.195650107717653,0.5552554823376904
4122,0.4124,17,18,17,651760,24684,95433,30823,0.19550754023571157,0.5552993316158322
4123,0.4125,6,17,6,651777,24667,95439,30817,0.19537289316943354,0.5554213827409704
4124,0.4126,7,20,7,651797,24647,95446,30810,0.19521448485616524,0.5555655733270822
4125,0.4127,7,22,7,651819,24625,95453,30803,0.19504023571157014,0.5557299559789276
4126,0.4128,19,18,19,651837,24607,95472,30784,0.1948976682296287,0.5557581556570562
4127,0.4129,18,21,18,651858,24586,95490,30766,0.194731339500697,0.5558245411186588
4128,0.413,13,23,13,651881,24563,95503,30753,0.19454916994043847,0.5559512618410587
4129,0.4131,19,15,19,651896,24548,95522,30734,0.19443036370548727,0.5559494953149308
4130,0.4132,10,17,10,651913,24531,95532,30724,0.19429571663920922,0.5560401773595149
4131,0.4133,14,20,14,651933,24511,95546,30710,0.19413730832594095,0.5561290088915449
4132,0.4134,12,19,12,651952,24492,95558,30698,0.19398682042833607,0.5562239536147853
4133,0.4135,14,11,14,651963,24481,95572,30684,0.19389969585603853,0.5562222423638177
4134,0.4136,14,15,14,651978,24466,95586,30670,0.1937808896210873,0.5562608821822402
4135,0.4137,15,15,15,651993,24451,95601,30655,0.1936620833861361,0.5562915109062534
4136,0.4138,16,20,16,652013,24431,95617,30639,0.19350367507286784,0.5563646268385691
4137,0.4139,24,18,24,652031,24413,95641,30615,0.19336110759092637,0.5563531293159846
4138,0.414,19,17,19,652048,24396,95660,30596,0.19322646052464834,0.5563718359034041
4139,0.4141,9,9,9,652057,24387,95669,30587,0.1931551767836776,0.556390293593335
4140,0.4142,7,10,7,652067,24377,95676,30580,0.19307597262704346,0.5564350310242553
4141,0.4143,17,10,17,652077,24367,95693,30563,0.19299676847040934,0.5563990533406153
4142,0.4144,21,18,21,652095,24349,95714,30542,0.19285420098846787,0.5564117979268004
4143,0.4145,9,15,9,652110,24334,95723,30533,0.19273539475351667,0.5564911513295788
4144,0.4146,10,13,10,652123,24321,95733,30523,0.19263242934989228,0.5565421924002626
4145,0.4147,13,16,13,652139,24305,95746,30510,0.19250570269927766,0.5565994709477333
4146,0.4148,15,12,15,652151,24293,95761,30495,0.19241065771131668,0.5565999853982624
4147,0.4149,10,17,10,652168,24276,95771,30485,0.19227601064503866,0.5566918062124505
4148,0.415,18,21,18,652189,24255,95789,30467,0.19210968191610694,0.5567596213588685
4149,0.4151,9,10,9,652199,24245,95798,30458,0.19203047775947282,0.5567884759519588
4150,0.4152,14,22,14,652221,24223,95812,30444,0.19185622861487772,0.5568990432985165
4151,0.4153,12,24,12,652245,24199,95824,30432,0.19166613863895576,0.5570463656165913
4152,0.4154,17,27,17,652272,24172,95841,30415,0.1914522874160436,0.5571839448953048
4153,0.4155,15,18,15,652290,24154,95856,30400,0.19130971993410215,0.557246031455072
4154,0.4156,14,13,14,652303,24141,95870,30386,0.19120675453047775,0.557265208062061
4155,0.4157,15,26,15,652329,24115,95885,30371,0.191000823723229,0.5574092427412546
4156,0.4158,4,16,4,652345,24099,95889,30367,0.19087409707261438,0.557540483971652
4157,0.4159,15,12,15,652357,24087,95904,30352,0.1907790520846534,0.5575414684325576
4158,0.416,7,14,7,652371,24073,95911,30345,0.19066816626536562,0.5576279907383587
4159,0.4161,15,21,15,652392,24052,95926,30330,0.1905018375364339,0.5577213048435143
4160,0.4162,14,17,14,652409,24035,95940,30316,0.19036719047015588,0.5577818255413883
4161,0.4163,13,15,13,652424,24020,95953,30303,0.19024838423520465,0.5578300167516521
4162,0.4164,15,19,15,652443,24001,95968,30288,0.1900978963375998,0.5579030742876089
4163,0.4165,19,22,19,652465,23979,95987,30269,0.1899236471930047,0.5579744875387112
4164,0.4166,7,22,7,652487,23957,95994,30262,0.18974939804840957,0.5581438241206957
4165,0.4167,15,19,15,652506,23938,96009,30247,0.1895989101508047,0.5582172187874873
4166,0.4168,14,17,14,652523,23921,96023,30233,0.18946426308452669,0.5582782435277173
4167,0.4169,17,12,17,652535,23909,96040,30216,0.1893692180965657,0.5582632794457275
4168,0.417,12,16,12,652551,23893,96052,30204,0.1892424914459511,0.558330406492042
4169,0.4171,13,14,13,652565,23879,96065,30191,0.18913160562666329,0.5583687812095431
4170,0.4172,12,16,12,652581,23863,96077,30179,0.18900487897604867,0.5584360312349654
4171,0.4173,13,14,13,652595,23849,96090,30166,0.18889399315676086,0.5584744978246783
4172,0.4174,10,19,10,652614,23830,96100,30156,0.188743505259156,0.5585892638832289
4173,0.4175,14,18,14,652632,23812,96114,30142,0.18860093777721454,0.5586610816621567
4174,0.4176,17,17,17,652649,23795,96131,30125,0.1884662907109365,0.5586980712166172
4175,0.4177,14,17,14,652666,23778,96145,30111,0.18833164364465846,0.5587596726604688
4176,0.4178,11,15,11,652681,23763,96156,30100,0.18821283740970726,0.5588251675547221
4177,0.4179,18,13,18,652694,23750,96174,30082,0.18810987200608287,0.5588126021697132
4178,0.418,17,21,17,652715,23729,96191,30065,0.18794354327715118,0.5588913261702049
4179,0.4181,15,9,15,652724,23720,96206,30050,0.18787225953618045,0.5588618188580993
4180,0.4182,13,18,13,652742,23702,96219,30037,0.187729692054239,0.5589422951673831
4181,0.4183,16,15,16,652757,23687,96235,30021,0.1876108858192878,0.5589670067773889
4182,0.4184,17,15,17,652772,23672,96252,30004,0.18749207958433659,0.5589835308145167
4183,0.4185,9,14,9,652786,23658,96261,29995,0.1873811937650488,0.5590554116265632
4184,0.4186,13,22,13,652808,23636,96274,29982,0.18720694462045367,0.559177888022679
4185,0.4187,17,32,17,652840,23604,96291,29965,0.18695349131922442,0.5593720248651273
4186,0.4188,9,17,9,652857,23587,96300,29956,0.1868188442529464,0.5594755616980744
4187,0.4189,15,14,15,652871,23573,96315,29941,0.1867079584336586,0.5594984490039989
4188,0.419,21,14,21,652885,23559,96336,29920,0.1865970726143708,0.5594719422577087
4189,0.4191,18,18,18,652903,23541,96354,29902,0.18645450513242934,0.5595120034429205
4190,0.4192,16,26,16,652929,23515,96370,29886,0.18624857432518058,0.559652440965525
4191,0.4193,20,22,20,652951,23493,96390,29866,0.18607432518058548,0.5597181356472197
4192,0.4194,14,28,14,652979,23465,96404,29852,0.18585255354200989,0.5598964682934149
4193,0.4195,14,20,14,652999,23445,96418,29838,0.18569414522874161,0.5599909914982264
4194,0.4196,17,16,17,653015,23429,96435,29821,0.18556741857812697,0.560018779342723
4195,0.4197,5,20,5,653035,23409,96440,29816,0.1854090102648587,0.5601878816345702
4196,0.4198,11,21,11,653056,23388,96451,29805,0.18524268153592702,0.5603180869663301
4197,0.4199,14,16,14,653072,23372,96465,29791,0.18511595488531238,0.5603709346726107
4198,0.42,9,19,9,653091,23353,96474,29782,0.18496546698770752,0.5604968476522066
4199,0.4201,14,22,14,653113,23331,96488,29768,0.1847912178431124,0.5606131942221134
4200,0.4202,10,17,10,653130,23314,96498,29758,0.18465657077683437,0.5607099788965934
4201,0.4203,12,15,12,653145,23299,96510,29746,0.18453776454188317,0.5607691582618531
4202,0.4204,10,13,10,653158,23286,96520,29736,0.18443479913825878,0.5608238089849497
4203,0.4205,14,13,14,653171,23273,96534,29722,0.18433183373463438,0.5608453627700727
4204,0.4206,8,21,8,653192,23252,96542,29714,0.1841655050057027,0.5610013971226825
4205,0.4207,7,19,7,653211,23233,96549,29707,0.18401501710809784,0.561144692104269
4206,0.4208,17,14,17,653225,23219,96566,29690,0.18390413128881003,0.5611521669281219
4207,0.4209,20,25,20,653250,23194,96586,29670,0.18370612089722468,0.5612515133171913
4208,0.421,12,18,12,653268,23176,96598,29658,0.18356355341528324,0.561343074535337
4209,0.4211,18,26,18,653294,23150,96616,29640,0.18335762260803448,0.5614699753741239
4210,0.4212,14,15,14,653309,23135,96630,29626,0.18323881637308326,0.5615132389454331
4211,0.4213,8,21,8,653330,23114,96638,29618,0.18307248764415157,0.5616703330046272
4212,0.4214,14,17,14,653347,23097,96652,29604,0.18293784057787352,0.5617350714407696
4213,0.4215,10,17,10,653364,23080,96662,29594,0.1828031935115955,0.5618331624710483
4214,0.4216,8,24,8,653388,23056,96670,29586,0.18261310353567356,0.5620227195015387
4215,0.4217,14,11,14,653399,23045,96684,29572,0.182525978963376,0.562023680559515
4216,0.4218,12,24,12,653423,23021,96696,29560,0.18233588898745406,0.5621802552252715
4217,0.4219,19,18,19,653441,23003,96715,29541,0.18219332150551262,0.5622145249695494
4218,0.422,14,11,14,653452,22992,96729,29527,0.18210619693321506,0.5622155791237456
4219,0.4221,13,12,13,653464,22980,96742,29514,0.18201115194525408,0.5622356840781804
4220,0.4222,6,14,6,653478,22966,96748,29508,0.1819002661259663,0.5623356328848572
4221,0.4223,21,16,21,653494,22950,96769,29487,0.18177353947535166,0.5623319411865667
4222,0.4224,11,15,11,653509,22935,96780,29476,0.18165473324040046,0.5624010226860774
4223,0.4225,10,18,10,653527,22917,96790,29466,0.181512165758459,0.562510738216597
4224,0.4226,7,16,7,653543,22901,96797,29459,0.18138543910784438,0.5626241405653171
4225,0.4227,10,13,10,653556,22888,96807,29449,0.18128247370422,0.5626803217608958
4226,0.4228,16,21,16,653577,22867,96823,29433,0.1811161449752883,0.562772466539197
4227,0.4229,10,18,10,653595,22849,96833,29423,0.18097357749334686,0.5628826140189777
4228,0.423,10,20,10,653615,22829,96843,29413,0.18081516918007856,0.5630144328318212
4229,0.4231,13,17,13,653632,22812,96856,29400,0.18068052211380053,0.5630889450700989
4230,0.4232,16,21,16,653653,22791,96872,29384,0.18051419338486885,0.5631816003833253
4231,0.4233,18,18,18,653671,22773,96890,29366,0.18037162590292738,0.5632252248796487
4232,0.4234,14,14,14,653685,22759,96904,29352,0.1802607400836396,0.5632591967147051
4233,0.4235,17,22,17,653707,22737,96921,29335,0.18008649093904447,0.5633545859579044
4234,0.4236,15,18,15,653725,22719,96936,29320,0.17994392345710303,0.5634235861565364
4235,0.4237,12,19,12,653744,22700,96948,29308,0.17979343555949817,0.5635286878941701
4236,0.4238,15,19,15,653763,22681,96963,29293,0.1796429476618933,0.5636087274406434
4237,0.4239,12,16,12,653779,22665,96975,29281,0.17951622101127868,0.5636815154198591
4238,0.424,13,25,13,653804,22640,96988,29268,0.17931821061969333,0.5638437235108269
4239,0.4241,12,18,12,653822,22622,97000,29256,0.17917564313775186,0.5639384710281815
4240,0.4242,9,18,9,653840,22604,97009,29247,0.17903307565581042,0.5640585523905035
4241,0.4243,11,22,11,653862,22582,97020,29236,0.17885882651121532,0.5642054884403103
4242,0.4244,12,22,12,653884,22560,97032,29224,0.1786845773666202,0.56434419898038
4243,0.4245,10,19,10,653903,22541,97042,29214,0.17853408946901533,0.5644672012365956
4244,0.4246,17,17,17,653920,22524,97059,29197,0.1783994424027373,0.5645095802478683
4245,0.4247,15,21,15,653941,22503,97074,29182,0.1782331136738056,0.5646125568346716
4246,0.4248,15,17,15,653958,22486,97089,29167,0.17809846660752757,0.5646719454823534
4247,0.4249,13,21,13,653979,22465,97102,29154,0.17793213787859588,0.5647920339409908
4248,0.425,7,13,7,653992,22452,97109,29147,0.1778291724749715,0.5648752882807806
4249,0.4251,19,23,19,654015,22429,97128,29128,0.17764700291471297,0.564966929805846
4250,0.4252,11,8,11,654023,22421,97139,29117,0.17758363958940565,0.5649617757770965
4251,0.4253,14,13,14,654036,22408,97153,29103,0.17748067418578126,0.5649861194696278
4252,0.4254,11,18,11,654054,22390,97164,29092,0.17733810670383982,0.5650907113165766
4253,0.4255,20,15,20,654069,22375,97184,29072,0.17721930046888862,0.5650863995957004
4254,0.4256,12,22,12,654091,22353,97196,29060,0.1770450513242935,0.5652266936377959
4255,0.4257,12,17,12,654108,22336,97208,29048,0.17691040425801546,0.565312159427059
4256,0.4258,12,18,12,654126,22318,97220,29036,0.17676783677607402,0.5654087315496359
4257,0.4259,15,16,15,654142,22302,97235,29021,0.17664111012545938,0.5654579818015315
4258,0.426,13,19,13,654161,22283,97248,29008,0.17649062222785453,0.5655573102493615
4259,0.4261,15,16,15,654177,22267,97263,28993,0.1763638955772399,0.5656067108856808
4260,0.4262,20,13,20,654190,22254,97283,28973,0.17626093017361552,0.5655806508286646
4261,0.4263,23,20,23,654210,22234,97306,28950,0.17610252186034722,0.5656064395123476
4262,0.4264,8,22,8,654232,22212,97314,28942,0.17592827271575212,0.5657817570473472
4263,0.4265,7,14,7,654246,22198,97321,28935,0.17581738689646434,0.5658772221461679
4264,0.4266,14,13,14,654259,22185,97335,28921,0.17571442149283995,0.5659022423981529
4265,0.4267,13,19,13,654278,22166,97348,28908,0.1755639335952351,0.5660022712143165
4266,0.4268,9,22,9,654300,22144,97357,28899,0.17538968445063996,0.5661697000568149
4267,0.4269,8,13,8,654313,22131,97365,28891,0.1752867190470156,0.5662459331268864
4268,0.427,13,15,13,654328,22116,97378,28878,0.17516791281206437,0.5663019178726909
4269,0.4271,10,16,10,654344,22100,97388,28868,0.17504118616144976,0.5663946005336682
4270,0.4272,13,17,13,654361,22083,97401,28855,0.1749065390951717,0.566472967136519
4271,0.4273,15,19,15,654380,22064,97416,28840,0.17475605119756685,0.5665566556655666
4272,0.4274,8,15,8,654395,22049,97424,28832,0.17463724496261565,0.5666555295689943
4273,0.4275,14,16,14,654411,22033,97438,28818,0.174510518312001,0.5667145188885174
4274,0.4276,13,25,13,654436,22008,97451,28805,0.17431250792041567,0.5668824907011986
4275,0.4277,10,13,10,654449,21995,97461,28795,0.17420954251679127,0.5669423114786375
4276,0.4278,9,15,9,654464,21980,97470,28786,0.17409073628184007,0.5670330536185636
4277,0.4279,11,23,11,654487,21957,97481,28775,0.17390856672158156,0.5671962469447291
4278,0.428,11,22,11,654509,21935,97492,28764,0.17373431757698643,0.5673484684116058
4279,0.4281,13,15,13,654524,21920,97505,28751,0.17361551134203523,0.5674054192733516
4280,0.4282,12,13,12,654537,21907,97517,28739,0.17351254593841084,0.5674485645460648
4281,0.4283,16,24,16,654561,21883,97533,28723,0.1733224559624889,0.5675809192585859
4282,0.4284,8,17,8,654578,21866,97541,28715,0.17318780889621088,0.5677032877958127
4283,0.4285,7,12,7,654590,21854,97548,28708,0.1730927639082499,0.5677781733317511
4284,0.4286,9,15,9,654605,21839,97557,28699,0.1729739576732987,0.5678697217935019
4285,0.4287,18,17,18,654622,21822,97575,28681,0.17283931060702065,0.5679068570183949
4286,0.4288,15,19,15,654641,21803,97590,28666,0.1726888227094158,0.5679922328558125
4287,0.4289,16,17,16,654658,21786,97606,28650,0.17255417564313774,0.5680466333571259
4288,0.429,15,13,15,654671,21773,97621,28635,0.17245121023951338,0.5680645929217585
4289,0.4291,9,14,9,654685,21759,97630,28626,0.17234032442022557,0.5681452813337303
4290,0.4292,15,12,15,654697,21747,97645,28611,0.17224527943226461,0.5681520314547838
4291,0.4293,12,11,12,654708,21736,97657,28599,0.17215815485996705,0.568173239296712
4292,0.4294,14,17,14,654725,21719,97671,28585,0.17202350779368902,0.5682450699745547
4293,0.4295,8,15,8,654740,21704,97679,28577,0.1719047015587378,0.5683458960641197
4294,0.4296,11,26,11,654766,21678,97690,28566,0.17169877075148904,0.5685454979699068
4295,0.4297,11,18,11,654784,21660,97701,28555,0.1715562032695476,0.568654784426964
4296,0.4298,17,12,17,654796,21648,97718,28538,0.17146115828158662,0.5686446419320129
4297,0.4299,14,17,14,654813,21631,97732,28524,0.1713265112153086,0.5687169773701525
4298,0.43,14,13,14,654826,21618,97746,28510,0.1712235458116842,0.5687440153207788
4299,0.4301,12,14,12,654840,21604,97758,28498,0.1711126599923964,0.5687996487166181
4300,0.4302,6,23,6,654863,21581,97764,28492,0.17093049043213787,0.5690092465001099
4301,0.4303,8,16,8,654879,21565,97772,28484,0.17080376378152326,0.5691222601850187
4302,0.4304,14,17,14,654896,21548,97786,28470,0.1706691167152452,0.5691950897676836
4303,0.4305,8,16,8,654912,21532,97794,28462,0.1705423900646306,0.5693083169980397
4304,0.4306,17,21,17,654933,21511,97811,28445,0.1703760613356989,0.5694010729441908
4305,0.4307,15,18,15,654951,21493,97826,28430,0.17023349385375744,0.5694769945716404
4306,0.4308,16,14,16,654965,21479,97842,28414,0.17012260803446966,0.5694987272763714
4307,0.4309,10,12,10,654977,21467,97852,28404,0.17002756304650868,0.5695494375488761
4308,0.431,12,16,12,654993,21451,97864,28392,0.16990083639589407,0.5696286339104789
4309,0.4311,5,25,5,655018,21426,97869,28387,0.1697028260043087,0.5698713187320579
4310,0.4312,7,21,7,655039,21405,97876,28380,0.169536497275377,0.5700512202470623
4311,0.4313,15,11,15,655050,21394,97891,28365,0.16944937270307947,0.5700476295745494
4312,0.4314,14,17,14,655067,21377,97905,28351,0.16931472563680142,0.5701214607464608
4313,0.4315,15,19,15,655086,21358,97920,28336,0.16916423773919656,0.5702096832615607
4314,0.4316,11,19,11,655105,21339,97931,28325,0.16901374984159168,0.5703326353092784
4315,0.4317,13,15,13,655120,21324,97944,28312,0.16889494360664048,0.5703924570875977
4316,0.4318,13,18,13,655138,21306,97957,28299,0.168752376124699,0.5704868460840641
4317,0.4319,8,17,8,655155,21289,97965,28291,0.16861772905842098,0.5706131504638967
4318,0.432,13,12,13,655167,21277,97978,28278,0.16852268407046,0.5706386842901826
4319,0.4321,11,12,11,655179,21265,97989,28267,0.16842763908249905,0.5706815795849148
4320,0.4322,8,10,8,655189,21255,97997,28259,0.1683484349258649,0.5707274710182979
4321,0.4323,10,14,10,655203,21241,98007,28249,0.16823754910657712,0.5708021822590422
4322,0.4324,4,13,4,655216,21228,98011,28245,0.16813458370295273,0.5709174701352253
4323,0.4325,14,21,14,655237,21207,98025,28231,0.16796825497402104,0.5710384724301145
4324,0.4326,13,13,13,655250,21194,98038,28218,0.16786528957039665,0.5710758520197523
4325,0.4327,13,13,13,655263,21181,98051,28205,0.16776232416677228,0.5711132709674807
4326,0.4328,17,12,17,655275,21169,98068,28188,0.1676672791788113,0.5711044026176632
4327,0.4329,6,16,6,655291,21153,98074,28182,0.1675405525281967,0.57123745819398
4328,0.433,12,19,12,655310,21134,98086,28170,0.1673900646305918,0.5713532370598734
4329,0.4331,13,17,13,655327,21117,98099,28157,0.16725541756431378,0.5714372691480294
4330,0.4332,9,21,9,655348,21096,98108,28148,0.1670890888353821,0.5716026317927058
4331,0.4333,14,15,14,655363,21081,98122,28134,0.16697028260043087,0.5716549832368181
4332,0.4334,15,13,15,655376,21068,98137,28119,0.16686731719680648,0.571675442698274
4333,0.4335,8,20,8,655396,21048,98145,28111,0.1667089088835382,0.5718383205516793
4334,0.4336,12,12,12,655408,21036,98157,28099,0.16661386389557725,0.5718734099928767
4335,0.4337,14,21,14,655429,21015,98171,28085,0.16644753516664554,0.5719959266802443
4336,0.4338,13,10,13,655439,21005,98184,28072,0.16636833101001142,0.5719991034496811
4337,0.4339,9,20,9,655459,20985,98193,28063,0.16620992269674312,0.5721538085141086
4338,0.434,18,10,18,655469,20975,98211,28045,0.166130718540109,0.5721134230926153
4339,0.4341,16,19,16,655488,20956,98227,28029,0.1659802306425041,0.5721955700724711
4340,0.4342,4,19,4,655507,20937,98231,28025,0.16582974274489926,0.5723826641068583
4341,0.4343,16,26,16,655533,20911,98247,28009,0.1656238119376505,0.5725470155355683
4342,0.4344,13,19,13,655552,20892,98260,27996,0.1654733240400456,0.5726558664702994
4343,0.4345,10,10,10,655562,20882,98270,27986,0.1653941198834115,0.5726856020299582
4344,0.4346,8,9,8,655571,20873,98278,27978,0.16532283614244075,0.5727211316042661
4345,0.4347,10,17,10,655588,20856,98288,27968,0.16518818907616273,0.5728330329346223
4346,0.4348,12,15,12,655603,20841,98300,27956,0.1650693828412115,0.5729040719716376
4347,0.4349,7,16,7,655619,20825,98307,27949,0.1649426561905969,0.5730307130848403
4348,0.435,20,12,20,655631,20813,98327,27929,0.1648476112026359,0.5729965943129129
4349,0.4351,8,12,8,655643,20801,98335,27921,0.16475256621467493,0.5730676080620665
4350,0.4352,6,10,6,655653,20791,98341,27915,0.1646733620580408,0.5731326735925759
4351,0.4353,17,17,17,655670,20774,98358,27898,0.16453871499176276,0.5731837606837606
4352,0.4354,11,11,11,655681,20763,98369,27887,0.16445159041946522,0.5732168550873586
4353,0.4355,12,13,12,655694,20750,98381,27875,0.16434862501584083,0.5732647814910026
4354,0.4356,16,19,16,655713,20731,98397,27859,0.16419813711823597,0.5733484256019757
4355,0.4357,10,16,10,655729,20715,98407,27849,0.16407141046762133,0.5734494687422782
4356,0.4358,10,17,10,655746,20698,98417,27839,0.1639367634013433,0.5735624369038054
4357,0.4359,13,18,13,655764,20680,98430,27826,0.16379419591940186,0.573660990392941
4358,0.436,13,14,13,655778,20666,98443,27813,0.16368331010011405,0.5737123290496916
4359,0.4361,8,15,8,655793,20651,98451,27805,0.16356450386516283,0.5738195476308403
4360,0.4362,12,23,12,655816,20628,98463,27793,0.16338233430490431,0.5739864934635799
4361,0.4363,15,22,15,655838,20606,98478,27778,0.1632080851603092,0.57411541005291
4362,0.4364,13,18,13,655856,20588,98491,27765,0.16306551767836777,0.5742146299092094
4363,0.4365,8,16,8,655872,20572,98499,27757,0.16293879102775313,0.5743342506569554
4364,0.4366,10,20,10,655892,20552,98509,27747,0.16278038271448486,0.5744839437669517
4365,0.4367,14,14,14,655906,20538,98523,27733,0.16266949689519705,0.5745271488057011
4366,0.4368,14,14,14,655920,20524,98537,27719,0.16255861107590927,0.5745704039964347
4367,0.4369,19,19,19,655939,20505,98556,27700,0.1624081231783044,0.5746291878435847
4368,0.437,15,18,15,655957,20487,98571,27685,0.16226555569636295,0.5747114506352238
4369,0.4371,13,14,13,655971,20473,98584,27672,0.16215466987707514,0.5747637345518746
4370,0.4372,16,24,16,655995,20449,98600,27656,0.1619645799011532,0.574909053112982
4371,0.4373,11,21,11,656016,20428,98611,27645,0.16179825117222152,0.575062925134691
4372,0.4374,6,7,6,656023,20421,98617,27639,0.16174280826257761,0.5750936329588014
4373,0.4375,12,13,12,656036,20408,98629,27627,0.16163984285895325,0.5751431248048298
4374,0.4376,16,18,16,656054,20390,98645,27611,0.16149727537701178,0.5752171829753547
4375,0.4377,9,7,9,656061,20383,98654,27602,0.16144183246736787,0.5752214233614671
4376,0.4378,12,16,12,656077,20367,98666,27590,0.16131510581675326,0.5753070458952811
4377,0.4379,10,15,10,656092,20352,98676,27580,0.16119629958180207,0.575398481181674
4378,0.438,17,15,17,656107,20337,98693,27563,0.16107749334685084,0.575427974947808
4379,0.4381,14,10,14,656117,20327,98707,27549,0.1609982891902167,0.5754240120310803
4380,0.4382,14,21,14,656138,20306,98721,27535,0.160831960461285,0.5755523504943458
4381,0.4383,14,20,14,656158,20286,98735,27521,0.16067355214801674,0.5756688351078294
4382,0.4384,11,12,11,656170,20274,98746,27510,0.16057850716005576,0.5757157207433451
4383,0.4385,8,13,8,656183,20261,98754,27502,0.1604755417564314,0.5758013525113581
4384,0.4386,16,10,16,656193,20251,98770,27486,0.16039633759979724,0.5757797934516203
4385,0.4387,10,9,10,656202,20242,98780,27476,0.1603250538588265,0.5757994886625593
4386,0.4388,12,9,12,656211,20233,98792,27464,0.1602537701178558,0.5758014130867769
4387,0.4389,13,21,13,656232,20212,98805,27451,0.16008744138892408,0.5759394079264839
4388,0.439,14,19,14,656251,20193,98819,27437,0.15993695349131923,0.5760445097627546
4389,0.4391,16,16,16,656267,20177,98835,27421,0.1598102268407046,0.5760956342703475
4390,0.4392,7,14,7,656281,20163,98842,27414,0.1596993410214168,0.5762027870609748
4391,0.4393,5,16,5,656297,20147,98847,27409,0.15957261437080217,0.5763520901673816
4392,0.4394,9,7,9,656304,20140,98856,27400,0.1595171714611583,0.5763567522086663
4393,0.4395,9,16,9,656320,20124,98865,27391,0.15939044481054365,0.5764705882352941
4394,0.4396,15,13,15,656333,20111,98880,27376,0.15928747940691929,0.5764946195800956
4395,0.4397,12,12,12,656345,20099,98892,27364,0.1591924344189583,0.5765332996228641
4396,0.4398,14,11,14,656356,20088,98906,27350,0.15910530984666074,0.5765420127324086
4397,0.4399,18,15,18,656371,20073,98924,27332,0.15898650361170955,0.5765636536230355
4398,0.44,7,7,7,656378,20066,98931,27325,0.15893106070206564,0.5765862716549556
4399,0.4401,9,19,9,656397,20047,98940,27316,0.15878057280446078,0.5767371154698816
4400,0.4402,12,13,12,656410,20034,98952,27304,0.1586776074008364,0.5767882039798893
4401,0.4403,7,16,7,656426,20018,98959,27297,0.15855088075022178,0.5769206382753883
4402,0.4404,14,16,14,656442,20002,98973,27283,0.15842415409960714,0.5769905889817066
4403,0.4405,11,18,11,656460,19984,98984,27272,0.1582815866176657,0.5771119011342475
4404,0.4406,11,12,11,656472,19972,98995,27261,0.15818654162970472,0.5771600364152182
4405,0.4407,5,18,5,656490,19954,99000,27256,0.15804397414776328,0.5773353103156111
4406,0.4408,7,19,7,656509,19935,99007,27249,0.15789348625015842,0.5775050864699899
4407,0.4409,17,17,17,656526,19918,99024,27232,0.15775883918388037,0.577560975609756
4408,0.441,13,19,13,656545,19899,99037,27219,0.1576083512862755,0.5776773207691328
4409,0.4411,7,16,7,656561,19883,99044,27212,0.15748162463566087,0.577810807941395
4410,0.4412,13,15,13,656576,19868,99057,27199,0.15736281840070968,0.5778783436377929
4411,0.4413,12,20,12,656596,19848,99069,27187,0.15720441008744138,0.5780163707877113
4412,0.4414,9,16,9,656612,19832,99078,27178,0.15707768343682676,0.5781323122739842
4413,0.4415,18,17,18,656629,19815,99096,27160,0.15694303637054874,0.578179882916445
4414,0.4416,10,9,10,656638,19806,99106,27150,0.156871752629578,0.5782008688985433
4415,0.4417,14,19,14,656657,19787,99120,27136,0.15672126473197315,0.5783091447690898
4416,0.4418,14,14,14,656671,19773,99134,27122,0.15661037891268534,0.5783559014820343
4417,0.4419,14,14,14,656685,19759,99148,27108,0.15649949309339753,0.5784027140632001
4418,0.442,10,13,10,656698,19746,99158,27098,0.15639652768977316,0.5784732302963026
4419,0.4421,10,13,10,656711,19733,99168,27088,0.15629356228614877,0.5785438158091455
4420,0.4422,11,12,11,656723,19721,99179,27077,0.15619851729818782,0.5785931022693277
4421,0.4423,19,10,19,656733,19711,99198,27058,0.15611931314155367,0.5785456178237721
4422,0.4424,12,14,12,656747,19697,99210,27046,0.15600842732226589,0.5786107010675395
4423,0.4425,13,16,13,656763,19681,99223,27033,0.15588170067165125,0.5786916127927388
4424,0.4426,12,20,12,656783,19661,99235,27021,0.15572329235838298,0.5788312411636176
4425,0.4427,6,14,6,656797,19647,99241,27015,0.15561240653909517,0.5789507522180789
4426,0.4428,7,13,7,656810,19634,99248,27008,0.1555094411354708,0.5790489258608121
4427,0.4429,11,15,11,656825,19619,99259,26997,0.15539063490051958,0.5791359189977691
4428,0.443,10,10,10,656835,19609,99269,26987,0.15531143074388543,0.5791698858271096
4429,0.4431,9,10,9,656845,19599,99278,26978,0.1552322265872513,0.579212916246216
4430,0.4432,14,17,14,656862,19582,99292,26964,0.15509757952097325,0.5792978988527479
4431,0.4433,8,11,8,656873,19571,99300,26956,0.1550104549486757,0.579362520686913
4432,0.4434,13,13,13,656886,19558,99313,26943,0.15490748954505132,0.5794068944753876
4433,0.4435,15,16,15,656902,19542,99328,26928,0.1547807628944367,0.5794706262104583
4434,0.4436,15,9,15,656911,19533,99343,26913,0.15470947915346597,0.5794470998578996
4435,0.4437,18,10,18,656921,19523,99361,26895,0.15463027499683182,0.5794088500150804
4436,0.4438,12,10,12,656931,19513,99373,26883,0.1545510708401977,0.5794249504267609
4437,0.4439,18,20,18,656951,19493,99391,26865,0.1543926625269294,0.5795116269036628
4438,0.444,16,13,16,656964,19480,99407,26849,0.15428969712330504,0.5795290206997776
4439,0.4441,18,18,18,656982,19462,99425,26831,0.15414712964136357,0.5795908668697212
4440,0.4442,12,15,12,656997,19447,99437,26819,0.15402832340641237,0.5796697358751567
4441,0.4443,15,15,15,657012,19432,99452,26804,0.15390951717146115,0.5797214291893762
4442,0.4444,15,16,15,657028,19416,99467,26789,0.15378279052084654,0.5797857374742993
4443,0.4445,14,9,14,657037,19407,99481,26775,0.1537115067798758,0.5797713394829154
4444,0.4446,16,15,16,657052,19392,99497,26759,0.1535927005449246,0.5798140885354597
4445,0.4447,13,18,13,657070,19374,99510,26746,0.15345013306298314,0.5799219427580226
4446,0.4448,4,17,4,657087,19357,99514,26742,0.1533154859967051,0.5800993513959088
4447,0.4449,6,13,6,657100,19344,99520,26736,0.15321252059308071,0.5802083333333333
4448,0.445,18,13,18,657113,19331,99538,26718,0.15310955518945635,0.5802080392625247
4449,0.4451,10,15,10,657128,19316,99548,26708,0.15299074895450512,0.5803059273422562
4450,0.4452,13,9,13,657137,19307,99561,26695,0.15291946521353442,0.5803008564845007
4451,0.4453,6,10,6,657147,19297,99567,26689,0.15284026105690027,0.580372287217849
4452,0.4454,8,9,8,657156,19288,99575,26681,0.15276897731592953,0.5804128869455503
4453,0.4455,13,15,13,657171,19273,99588,26668,0.15265017108097834,0.5804836638296946
4454,0.4456,6,14,6,657185,19259,99594,26662,0.15253928526169053,0.5806058230439233
4455,0.4457,10,25,10,657210,19234,99604,26652,0.15234127487010518,0.5808307544784902
4456,0.4458,9,11,9,657221,19223,99613,26643,0.15225415029780762,0.5808878036017966
4457,0.4459,11,16,11,657237,19207,99624,26632,0.152127423647193,0.5809899866925544
4458,0.446,13,16,13,657253,19191,99637,26619,0.1520006969965784,0.5810740013097577
4459,0.4461,15,10,15,657263,19181,99652,26604,0.15192149283994424,0.581063667139893
4460,0.4462,15,13,15,657276,19168,99667,26589,0.15181852743631985,0.5810914177065805
4461,0.4463,6,16,6,657292,19152,99673,26583,0.15169180078570524,0.5812397507379469
4462,0.4464,7,15,7,657307,19137,99680,26576,0.15157299455075401,0.5813663509286199
4463,0.4465,10,18,10,657325,19119,99690,26566,0.15143042706881257,0.581503775856408
4464,0.4466,7,13,7,657338,19106,99697,26559,0.15132746166518818,0.5816051680718275
4465,0.4467,10,7,10,657345,19099,99707,26549,0.1512720187555443,0.5816026989134244
4466,0.4468,8,11,8,657356,19088,99715,26541,0.15118489418324674,0.5816695522584321
4467,0.4469,7,20,7,657376,19068,99722,26534,0.15102648586997847,0.581860444717337
4468,0.447,6,14,6,657390,19054,99728,26528,0.15091560005069066,0.5819841165372296
4469,0.4471,8,13,8,657403,19041,99736,26520,0.1508126346470663,0.5820767761901626
4470,0.4472,14,11,14,657414,19030,99750,26506,0.15072551007476873,0.5820888966971187
4471,0.4473,12,11,12,657425,19019,99762,26494,0.15063838550247116,0.5821193944587261
4472,0.4474,11,13,11,657438,19006,99773,26483,0.1505354200988468,0.5821847039943723
4473,0.4475,12,13,12,657451,18993,99785,26471,0.1504324546952224,0.5822408938940701
4474,0.4476,11,14,11,657465,18979,99796,26460,0.15032156887593462,0.5823191531503774
4475,0.4477,11,13,11,657478,18966,99807,26449,0.15021860347231022,0.5823846746669602
4476,0.4478,11,20,11,657498,18946,99818,26438,0.15006019515904195,0.5825401022386745
4477,0.4479,8,12,8,657510,18934,99826,26430,0.14996515017108097,0.5826205801957499
4478,0.448,9,14,9,657524,18920,99835,26421,0.1498542643517932,0.5827176286363336
4479,0.4481,20,17,20,657541,18903,99855,26401,0.14971961728551514,0.582752074871976
4480,0.4482,16,14,16,657555,18889,99871,26385,0.14960873146622736,0.5827848213102443
4481,0.4483,5,18,5,657573,18871,99876,26380,0.1494661639842859,0.5829705420874677
4482,0.4484,8,12,8,657585,18859,99884,26372,0.14937111899632494,0.5830514470164267
4483,0.4485,13,9,13,657594,18850,99897,26359,0.1492998352553542,0.5830476232608551
4484,0.4486,13,12,13,657606,18838,99910,26346,0.14920479026739322,0.5830825070821529
4485,0.4487,11,17,11,657623,18821,99921,26335,0.1490701432011152,0.5832004606253876
4486,0.4488,7,12,7,657635,18809,99928,26328,0.14897509821315422,0.5832908700179453
4487,0.4489,9,13,9,657648,18796,99937,26319,0.14887213280952985,0.5833758173556467
4488,0.449,11,21,11,657669,18775,99948,26308,0.14870580408059814,0.5835459042211033
4489,0.4491,6,24,6,657693,18751,99954,26302,0.1485157141046762,0.5838013006902981
4490,0.4492,10,17,10,657710,18734,99964,26292,0.14838106703839818,0.5839292853018256
4491,0.4493,14,7,14,657717,18727,99978,26278,0.14832562412875427,0.5838906788134651
4492,0.4494,10,16,10,657733,18711,99988,26268,0.14819889747813966,0.5840058694057226
4493,0.4495,13,14,13,657747,18697,100001,26255,0.14808801165885185,0.5840674497241503
4494,0.4496,7,24,7,657771,18673,100008,26248,0.14789792168292992,0.5843146857817056
4495,0.4497,14,11,14,657782,18662,100022,26234,0.14781079711063236,0.5843282252316465
4496,0.4498,4,13,4,657795,18649,100026,26230,0.147707831707008,0.5844604380668018
4497,0.4499,13,10,13,657805,18639,100039,26217,0.14762862755037384,0.584470304975923
4498,0.45,10,17,10,657822,18622,100049,26207,0.14749398048409582,0.5845992549465747
4499,0.4501,16,8,16,657830,18614,100065,26191,0.1474306171587885,0.58455529516795
4500,0.4502,14,9,14,657839,18605,100079,26177,0.14735933341781776,0.5845428966995668
4501,0.4503,13,13,13,657852,18592,100092,26164,0.1472563680141934,0.5845920100098311
4502,0.4504,8,18,8,657870,18574,100100,26156,0.14711380053225193,0.584752962217751
4503,0.4505,6,16,6,657886,18558,100106,26150,0.14698707388163731,0.5849065044287376
4504,0.4506,13,17,13,657903,18541,100119,26137,0.14685242681535926,0.5850082814808183
4505,0.4507,11,11,11,657914,18530,100130,26126,0.14676530224306172,0.5850501612325332
4506,0.4508,11,17,11,657931,18513,100141,26115,0.14663065517678367,0.5851707448238774
4507,0.4509,7,21,7,657952,18492,100148,26108,0.14646432644785198,0.5853811659192825
4508,0.451,18,14,18,657966,18478,100166,26090,0.14635344062856417,0.5853975946867708
4509,0.4511,8,11,8,657977,18467,100174,26082,0.14626631605626664,0.5854676872657074
4510,0.4512,7,12,7,657989,18455,100181,26075,0.14617127106830566,0.5855602964293735
4511,0.4513,11,11,11,658000,18444,100192,26064,0.14608414649600812,0.5856025882987328
4512,0.4514,8,19,8,658019,18425,100200,26056,0.14593365859840324,0.5857781974326117
4513,0.4515,6,16,6,658035,18409,100206,26050,0.14580693194778863,0.5859331069074878
4514,0.4516,8,16,8,658051,18393,100214,26042,0.145680205297174,0.5860695397772027
4515,0.4517,9,11,9,658062,18382,100223,26033,0.14559308072487645,0.5861308116627265
4516,0.4518,5,13,5,658075,18369,100228,26028,0.14549011532125206,0.586255828096493
4517,0.4519,9,14,9,658089,18355,100237,26019,0.14537922950196427,0.586356875647902
4518,0.452,9,13,9,658102,18342,100246,26010,0.14527626409833988,0.5864448051948052
4519,0.4521,5,19,5,658121,18323,100251,26005,0.14512577620073502,0.586649521746977
4520,0.4522,10,17,10,658138,18306,100261,25995,0.14499112913445697,0.5867813367644071
4521,0.4523,13,20,13,658158,18286,100274,25982,0.1448327208211887,0.5869250926176922
4522,0.4524,11,12,11,658170,18274,100285,25971,0.14473767583322772,0.5869815798395299
4523,0.4525,15,14,15,658184,18260,100300,25956,0.14462679001393994,0.5870273204269948
4524,0.4526,9,7,9,658191,18253,100309,25947,0.14457134710429603,0.5870361990950226
4525,0.4527,9,17,9,658208,18236,100318,25938,0.144436700038018,0.5871779779961063
4526,0.4528,7,14,7,658222,18222,100325,25931,0.1443258142187302,0.5872987112993454
4527,0.4529,14,16,14,658238,18206,100339,25917,0.14419908756811559,0.5873807311379553
4528,0.453,13,12,13,658250,18194,100352,25904,0.1441040425801546,0.5874189305637444
4529,0.4531,14,15,14,658265,18179,100366,25890,0.1439852363452034,0.5874878032176813
4530,0.4532,7,14,7,658279,18165,100373,25883,0.1438743505259156,0.5876089720305122
4531,0.4533,13,14,13,658293,18151,100386,25870,0.1437634647066278,0.5876740646509621
4532,0.4534,15,15,15,658308,18136,100401,25855,0.1436446584716766,0.5877338546520879
4533,0.4535,16,24,16,658332,18112,100417,25839,0.14345456849575466,0.5879047120657095
4534,0.4536,15,13,15,658345,18099,100432,25824,0.14335160309213027,0.5879379823782529
4535,0.4537,5,12,5,658357,18087,100437,25819,0.14325655810416932,0.5880517469138614
4536,0.4538,13,19,13,658376,18068,100450,25806,0.14310607020656443,0.588184346081962
4537,0.4539,10,11,10,658387,18057,100460,25796,0.1430189456342669,0.5882379768772946
4538,0.454,9,8,9,658395,18049,100469,25787,0.14295558230895958,0.5882607902180856
4539,0.4541,9,14,9,658409,18035,100478,25778,0.14284469648967177,0.5883641841462579
4540,0.4542,14,12,14,658421,18023,100492,25764,0.14274965150171082,0.5883938155160208
4541,0.4543,12,10,12,658431,18013,100504,25752,0.14267044734507667,0.5884154004341369
4542,0.4544,14,16,14,658447,17997,100518,25738,0.14254372069446206,0.5884989139133417
4543,0.4545,10,21,10,658468,17976,100528,25728,0.14237739196553034,0.5886875343218012
4544,0.4546,8,13,8,658481,17963,100536,25720,0.14227442656190598,0.5887874001327748
4545,0.4547,7,18,7,658499,17945,100543,25713,0.1421318590799645,0.588964221906638
4546,0.4548,11,14,11,658513,17931,100554,25702,0.14202097326067673,0.589049572571219
4547,0.4549,11,18,11,658531,17913,100565,25691,0.14187840577873526,0.589189065223374
4548,0.455,9,13,9,658544,17900,100574,25682,0.1417754403751109,0.5892799779725575
4549,0.4551,11,11,11,658555,17889,100585,25671,0.14168831580281332,0.5893250688705234
4550,0.4552,11,12,11,658567,17877,100596,25660,0.14159327081485237,0.5893837425637963
4551,0.4553,11,19,11,658586,17858,100607,25649,0.1414427829172475,0.5895373158342335
4552,0.4554,12,14,12,658600,17844,100619,25637,0.1413318970979597,0.5896138543271774
4553,0.4555,17,9,17,658609,17835,100636,25620,0.14126061335698897,0.5895754228512254
4554,0.4556,8,13,8,658622,17822,100644,25612,0.14115764795336458,0.5896762904636921
4555,0.4557,17,17,17,658639,17805,100661,25595,0.14102300088708655,0.5897465437788019
4556,0.4558,10,11,10,658650,17794,100671,25585,0.140935876314789,0.5898015168629982
4557,0.4559,11,7,11,658657,17787,100682,25574,0.1408804334051451,0.5897926708332373
4558,0.456,11,14,11,658671,17773,100693,25563,0.1407695475858573,0.5898790843640391
4559,0.4561,7,14,7,658685,17759,100700,25556,0.14065866176656952,0.5900034630035784
4560,0.4562,5,21,5,658706,17738,100705,25551,0.1404923330376378,0.5902423248400287
4561,0.4563,7,12,7,658718,17726,100712,25544,0.14039728804967685,0.590339727293737
4562,0.4564,8,17,8,658735,17709,100720,25536,0.1402626409833988,0.5904960110995491
4563,0.4565,9,17,9,658752,17692,100729,25527,0.14012799391712077,0.5906430042342489
4564,0.4566,7,10,7,658762,17682,100736,25520,0.14004878976048662,0.5907133928984769
4565,0.4567,13,9,13,658771,17673,100749,25507,0.1399775060195159,0.5907132931912923
4566,0.4568,14,12,14,658783,17661,100763,25493,0.13988246103155494,0.5907447745284331
4567,0.4569,13,11,13,658794,17650,100776,25480,0.13979533645925737,0.590772084396012
4568,0.457,10,12,10,658806,17638,100786,25470,0.13970029147129642,0.5908416071262874
4569,0.4571,8,16,8,658822,17622,100794,25462,0.13957356482068178,0.590985052455668
4570,0.4572,8,16,8,658838,17606,100802,25454,0.13944683817006717,0.5911286576869484
4571,0.4573,5,13,5,658851,17593,100807,25449,0.13934387276644278,0.5912596998280749
4572,0.4574,11,13,11,658864,17580,100818,25438,0.1392409073628184,0.5913338602445488
4573,0.4575,10,20,10,658884,17560,100828,25428,0.1390824990495501,0.5915139108588443
4574,0.4576,11,11,11,658895,17549,100839,25417,0.13899537447725258,0.5915607689801238
4575,0.4577,10,6,10,658901,17543,100849,25407,0.13894785198327209,0.5915483119906868
4576,0.4578,7,6,7,658907,17537,100856,25400,0.1389003294892916,0.5915643850292289
4577,0.4579,16,10,16,658917,17527,100872,25384,0.13882112533265745,0.5915499522267018
4578,0.458,9,10,9,658927,17517,100881,25375,0.13874192117602333,0.5916021635736268
4579,0.4581,11,12,11,658939,17505,100892,25364,0.13864687618806235,0.5916629732440691
4580,0.4582,16,17,16,658956,17488,100908,25348,0.13851222912178432,0.5917452609954245
4581,0.4583,13,9,13,658965,17479,100921,25335,0.13844094538081358,0.591745690661933
4582,0.4584,12,25,12,658990,17454,100933,25323,0.13824293498922824,0.5919769969843608
4583,0.4585,9,7,9,658997,17447,100942,25314,0.13818749207958433,0.5919880264727204
4584,0.4586,9,12,9,659009,17435,100951,25305,0.13809244709162335,0.5920683200748713
4585,0.4587,12,13,12,659022,17422,100963,25293,0.137989481687999,0.5921339108041671
4586,0.4588,16,11,16,659033,17411,100979,25277,0.13790235711570142,0.5921336206896551
4587,0.4589,9,10,9,659043,17401,100988,25268,0.1378231529590673,0.5921863648081745
4588,0.459,17,7,17,659050,17394,101005,25251,0.1377677100494234,0.5921209989447767
4589,0.4591,11,6,11,659056,17388,101016,25240,0.1377201875554429,0.5920990898001314
4590,0.4592,16,17,16,659073,17371,101032,25224,0.13758554048916488,0.5921821810071605
4591,0.4593,10,5,10,659078,17366,101042,25214,0.1375459384108478,0.5921559417566933
4592,0.4594,11,15,11,659093,17351,101053,25203,0.13742713217589658,0.5922592470743056
4593,0.4595,7,10,7,659103,17341,101060,25196,0.13734792801926246,0.5923313820908855
4594,0.4596,13,12,13,659115,17329,101073,25183,0.13725288303130148,0.5923739179525781
4595,0.4597,11,10,11,659125,17319,101084,25172,0.13717367887466733,0.5924078040055542
4596,0.4598,11,8,11,659133,17311,101095,25161,0.13711031554936004,0.5924138255792051
4597,0.4599,14,15,14,659148,17296,101109,25147,0.13699150931440882,0.5924887496171336
4598,0.46,13,15,13,659163,17281,101122,25134,0.13687270307945762,0.5925733820582341
4599,0.4601,7,8,7,659171,17273,101129,25127,0.1368093397541503,0.5926179245283019
4600,0.4602,9,19,9,659190,17254,101138,25118,0.13665885185654544,0.5927971301803078
4601,0.4603,9,15,9,659205,17239,101147,25109,0.13654004562159422,0.592920562954567
4602,0.4604,10,6,10,659211,17233,101157,25099,0.13649252312761373,0.5929084380610413
4603,0.4605,10,14,10,659225,17219,101167,25089,0.13638163730832595,0.5930084144842583
4604,0.4606,10,13,10,659238,17206,101177,25079,0.13627867190470155,0.5930944779472627
4605,0.4607,12,13,12,659251,17193,101189,25067,0.1361757065010772,0.5931613819214387
4606,0.4608,9,9,9,659260,17184,101198,25058,0.13610442276010645,0.5932010794943421
4607,0.4609,10,16,10,659276,17168,101208,25048,0.1359776961094918,0.5933295433011181
4608,0.461,9,8,9,659284,17160,101217,25039,0.13591433278418452,0.5933552927794498
4609,0.4611,12,15,12,659299,17145,101229,25027,0.1357955265492333,0.5934506307502608
4610,0.4612,6,17,6,659316,17128,101235,25021,0.13566087948295527,0.5936321146409167
4611,0.4613,4,21,4,659337,17107,101239,25017,0.13549455075402358,0.5938894691862121
4612,0.4614,4,14,4,659351,17093,101243,25013,0.13538366493473578,0.5940483541538023
4613,0.4615,10,13,10,659364,17080,101253,25003,0.13528069953111138,0.5941353990922701
4614,0.4616,15,14,15,659378,17066,101268,24988,0.1351698137118236,0.5941884244067152
4615,0.4617,14,13,14,659391,17053,101282,24974,0.1350668483081992,0.5942370380945583
4616,0.4618,9,19,9,659410,17034,101291,24965,0.13491636041059435,0.5944189147360651
4617,0.4619,11,18,11,659428,17016,101302,24954,0.1347737929286529,0.5945675482487491
4618,0.462,6,10,6,659438,17006,101308,24948,0.13469458877201876,0.5946512847404299
4619,0.4621,8,12,8,659450,16994,101316,24940,0.13459954378405778,0.5947441217150761
4620,0.4622,11,16,11,659466,16978,101327,24929,0.13447281713344317,0.5948648197198558
4621,0.4623,14,10,14,659476,16968,101341,24915,0.13439361297680902,0.5948714275481699
4622,0.4624,9,12,9,659488,16956,101350,24906,0.13429856798884807,0.5949548516554393
4623,0.4625,10,11,10,659499,16945,101360,24896,0.1342114434165505,0.5950144595014459
4624,0.4626,9,11,9,659510,16934,101369,24887,0.13412431884425294,0.5950838095693551
4625,0.4627,11,16,11,659526,16918,101380,24876,0.13399759219363833,0.5952050533569412
4626,0.4628,6,14,6,659540,16904,101386,24870,0.13388670637435052,0.5953463877052713
4627,0.4629,12,9,12,659549,16895,101398,24858,0.1338154226333798,0.5953584173592317
4628,0.463,8,13,8,659562,16882,101406,24850,0.13371245722975542,0.5954663088277581
4629,0.4631,7,12,7,659574,16870,101413,24843,0.13361741224179444,0.5955697264641718
4630,0.4632,13,13,13,659587,16857,101426,24830,0.13351444683817007,0.5956293328855519
4631,0.4633,13,13,13,659600,16844,101439,24817,0.13341148143454568,0.595689013705864
4632,0.4634,8,13,8,659613,16831,101447,24809,0.1333085160309213,0.5957973102785783
4633,0.4635,7,15,7,659628,16816,101454,24802,0.13318970979597008,0.595944062665193
4634,0.4636,9,11,9,659639,16805,101463,24793,0.13310258522367255,0.5960142314534352
4635,0.4637,15,11,15,659650,16794,101478,24778,0.13301546065137498,0.5960261714615607
4636,0.4638,14,8,14,659658,16786,101492,24764,0.13295209732606766,0.5960048134777377
4637,0.4639,12,6,12,659664,16780,101504,24752,0.13290457483208717,0.5959741885774824
4638,0.464,12,11,12,659675,16769,101516,24740,0.13281745025978964,0.5960153219783662
4639,0.4641,12,23,12,659698,16746,101528,24728,0.13263528069953112,0.5962289627236341
4640,0.4642,7,10,7,659708,16736,101535,24721,0.13255607654289697,0.5963046047712087
4641,0.4643,8,12,8,659720,16724,101543,24713,0.132461031554936,0.5963993532350315
4642,0.4644,11,18,11,659738,16706,101554,24702,0.13231846407299455,0.5965513910355487
4643,0.4645,12,22,12,659760,16684,101566,24690,0.13214421492839945,0.5967515831198337
4644,0.4646,6,12,6,659772,16672,101572,24684,0.13204916994043847,0.596866234645517
4645,0.4647,11,15,11,659787,16657,101583,24673,0.13193036370548727,0.5969755625453665
4646,0.4648,7,13,7,659800,16644,101590,24666,0.13182739830186288,0.5970951343500364
4647,0.4649,9,13,9,659813,16631,101599,24657,0.13172443289823849,0.597195310986243
4648,0.465,15,18,15,659831,16613,101614,24642,0.13158186541629704,0.5973094170403588
4649,0.4651,11,11,11,659842,16602,101625,24631,0.13149474084399948,0.5973613367933451
4650,0.4652,13,13,13,659855,16589,101638,24618,0.1313917754403751,0.5974227679763147
4651,0.4653,11,10,11,659865,16579,101649,24607,0.13131257128374096,0.597460302044384
4652,0.4654,8,12,8,659877,16567,101657,24599,0.13121752629578,0.5975562357285138
4653,0.4655,10,13,10,659890,16554,101667,24589,0.13111456089215562,0.5976472303915611
4654,0.4656,8,12,8,659902,16542,101675,24581,0.13101951590419464,0.5977433552999538
4655,0.4657,10,16,10,659918,16526,101685,24571,0.13089278925358003,0.5978781906221865
4656,0.4658,13,13,13,659931,16513,101698,24558,0.13078982384995563,0.5979401524189818
4657,0.4659,10,13,10,659944,16500,101708,24548,0.13068685844633127,0.5980315727928279
4658,0.466,7,17,7,659961,16483,101715,24541,0.1305522113800532,0.5982108034321373
4659,0.4661,12,11,12,659972,16472,101727,24529,0.13046508680775568,0.5982537011292407
4660,0.4662,11,13,11,659985,16459,101738,24518,0.13036212140413128,0.5983356517070552
4661,0.4663,12,13,12,659998,16446,101750,24506,0.13025915600050691,0.5984078921664387
4662,0.4664,10,8,10,660006,16438,101760,24496,0.1301957926751996,0.5984267357209166
4663,0.4665,14,10,14,660016,16428,101774,24482,0.13011658851856545,0.5984355903202151
4664,0.4666,9,17,9,660033,16411,101783,24473,0.12998194145228742,0.5985960277859309
4665,0.4667,10,13,10,660046,16398,101793,24463,0.12987897604866303,0.5986882357259979
4666,0.4668,11,11,11,660057,16387,101804,24452,0.1297918514763655,0.5987413991527706
4667,0.4669,6,14,6,660071,16373,101810,24446,0.12968096565707768,0.5988877728508782
4668,0.467,11,10,11,660081,16363,101821,24435,0.12960176150044353,0.5989264179616648
4669,0.4671,3,9,3,660090,16354,101824,24432,0.12953047775947282,0.5990290786054038
4670,0.4672,7,24,7,660114,16330,101831,24425,0.1293403877835509,0.5993129677340203
4671,0.4673,15,11,15,660125,16319,101846,24410,0.12925326321125333,0.5993272606742125
4672,0.4674,11,11,11,660136,16308,101857,24399,0.12916613863895576,0.5993809418527526
4673,0.4675,11,10,11,660146,16298,101868,24388,0.12908693448232164,0.5994199478936243
4674,0.4676,13,13,13,660159,16285,101881,24375,0.12898396907869725,0.5994835218888342
4675,0.4677,13,15,13,660174,16270,101894,24362,0.12886516284374605,0.5995766883244733
4676,0.4678,16,9,16,660183,16261,101910,24346,0.12879387910277532,0.5995518014135494
4677,0.4679,14,15,14,660198,16246,101924,24332,0.1286750728678241,0.5996352703435359
4678,0.468,13,10,13,660208,16236,101937,24319,0.12859586871118997,0.599654789791641
4679,0.4681,12,13,12,660221,16223,101949,24307,0.12849290330756558,0.5997285961016531
4680,0.4682,15,11,15,660232,16212,101964,24292,0.12840577873526804,0.599743235236026
4681,0.4683,17,9,17,660241,16203,101981,24275,0.1283344949942973,0.5997084836207323
4682,0.4684,13,11,13,660252,16192,101994,24262,0.12824737042199974,0.5997429178820388
4683,0.4685,12,16,12,660268,16176,102006,24250,0.12812064377138513,0.5998614752881809
4684,0.4686,7,15,7,660283,16161,102013,24243,0.1280018375364339,0.60001485001485
4685,0.4687,14,18,14,660301,16143,102027,24229,0.12785927005449246,0.6001436639254929
4686,0.4688,13,15,13,660316,16128,102040,24216,0.12774046381954124,0.6002379535990482
4687,0.4689,5,7,5,660323,16121,102045,24211,0.12768502090989736,0.6002925716552613
4688,0.469,11,12,11,660335,16109,102056,24200,0.12758997592193638,0.6003622019896301
4689,0.4691,15,12,15,660347,16097,102071,24185,0.1274949309339754,0.6003922347450474
4690,0.4692,12,10,12,660357,16087,102083,24173,0.12741572677734128,0.6004222553402881
4691,0.4693,11,12,11,660369,16075,102094,24162,0.1273206817893803,0.6004920843999304
4692,0.4694,10,11,10,660380,16064,102104,24152,0.12723355721708277,0.6005569922418937
4693,0.4695,6,12,6,660392,16052,102110,24146,0.1271385122291218,0.6006766505796308
4694,0.4696,11,11,11,660403,16041,102121,24135,0.12705138765682422,0.600731780167264
4695,0.4697,11,8,11,660411,16033,102132,24124,0.12698802433151693,0.6007420873073188
4696,0.4698,8,6,8,660417,16027,102140,24116,0.12694050183753644,0.6007523104899982
4697,0.4699,14,13,14,660430,16014,102154,24102,0.12683753643391205,0.6008076577924021
4698,0.47,10,13,10,660443,16001,102164,24092,0.12673457103028768,0.6009029007557429
4699,0.4701,5,10,5,660453,15991,102169,24087,0.12665536687365353,0.601003044064075
4700,0.4702,11,15,11,660468,15976,102180,24076,0.1265365606387023,0.6011185458903425
4701,0.4703,15,11,15,660479,15965,102195,24061,0.12644943606640477,0.601134262729226
4702,0.4704,8,8,8,660487,15957,102203,24053,0.12638607274109745,0.6011747063234192
4703,0.4705,13,11,13,660498,15946,102216,24040,0.12629894816879988,0.6012104236482769
4704,0.4706,5,6,5,660504,15940,102221,24035,0.12625142567481942,0.6012507817385866
4705,0.4707,10,11,10,660515,15929,102231,24025,0.12616430110252186,0.6013165139910898
4706,0.4708,10,8,10,660523,15921,102241,24015,0.12610093777721454,0.6013371394230769
4707,0.4709,12,8,12,660531,15913,102253,24003,0.12603757445190725,0.6013378093997395
4708,0.471,13,11,13,660542,15902,102266,23990,0.12595044987960968,0.6013737090143387
4709,0.4711,6,15,6,660557,15887,102272,23984,0.12583164364465846,0.601539966391613
4710,0.4712,9,9,9,660566,15878,102281,23975,0.12576035990368775,0.6015858279175972
4711,0.4713,5,13,5,660579,15865,102286,23970,0.12565739450006336,0.6017321450985315
4712,0.4714,12,12,12,660591,15853,102298,23958,0.1255623495121024,0.6017934741654317
4713,0.4715,12,14,12,660605,15839,102310,23946,0.1254514636928146,0.6018851325876586
4714,0.4716,9,11,9,660616,15828,102319,23937,0.12536433912051703,0.6019615239532252
4715,0.4717,11,12,11,660628,15816,102330,23926,0.12526929413255608,0.6020331135826078
4716,0.4718,7,6,7,660634,15810,102337,23919,0.1252217716385756,0.6020539152759948
4717,0.4719,8,14,8,660648,15796,102345,23911,0.1251108858192878,0.6021860125418692
4718,0.472,10,8,10,660656,15788,102355,23901,0.1250475224939805,0.6022071606742422
4719,0.4721,12,17,12,660673,15771,102367,23889,0.12491287542770245,0.6023449319213313
4720,0.4722,6,6,6,660679,15765,102373,23883,0.12486535293372196,0.6023759079903148
4721,0.4723,10,2,10,660681,15763,102383,23873,0.12484951210239513,0.602305984458573
4722,0.4724,11,9,11,660690,15754,102394,23862,0.12477822836142441,0.6023323909531503
4723,0.4725,9,13,9,660703,15741,102403,23853,0.12467526295780003,0.6024397636005455
4724,0.4726,7,14,7,660717,15727,102410,23846,0.12456437713851223,0.6025825689232558
4725,0.4727,8,7,8,660724,15720,102418,23838,0.12450893422886833,0.6026088275443653
4726,0.4728,5,12,5,660736,15708,102423,23833,0.12441388924090736,0.6027414582332262
4727,0.4729,9,8,9,660744,15700,102432,23824,0.12435052591560006,0.6027729986843436
4728,0.473,13,11,13,660755,15689,102445,23811,0.1242634013433025,0.6028101265822785
4729,0.4731,9,11,9,660766,15678,102454,23802,0.12417627677100494,0.6028875379939209
4730,0.4732,9,14,9,660780,15664,102463,23793,0.12406539095171715,0.6030108725954837
4731,0.4733,13,12,13,660792,15652,102476,23780,0.12397034596375618,0.6030635017244877
4732,0.4734,7,10,7,660802,15642,102483,23773,0.12389114180712203,0.6031460104021311
4733,0.4735,9,12,9,660814,15630,102492,23764,0.12379609681916107,0.6032390719398893
4734,0.4736,2,9,2,660823,15621,102494,23762,0.12372481307819035,0.6033567783053602
4735,0.4737,10,12,10,660835,15609,102504,23752,0.12362976809022938,0.6034399532532202
4736,0.4738,17,17,17,660852,15592,102521,23735,0.12349512102395134,0.6035293818496199
4737,0.4739,13,13,13,660865,15579,102534,23722,0.12339215562032696,0.6035978728276634
4738,0.474,11,8,11,660873,15571,102545,23711,0.12332879229501964,0.6036097958352427
4739,0.4741,12,18,12,660891,15553,102557,23699,0.12318622481307819,0.6037654132273514
4740,0.4742,19,14,19,660905,15539,102576,23680,0.12307533899379039,0.6037889798312043
4741,0.4743,6,10,6,660915,15529,102582,23674,0.12299613483715625,0.6038823559421472
4742,0.4744,9,8,9,660923,15521,102591,23665,0.12293277151184895,0.603914663400194
4743,0.4745,11,6,11,660929,15515,102602,23654,0.12288524901786846,0.6038959381143251
4744,0.4746,8,10,8,660939,15505,102610,23646,0.12280604486123432,0.6039692472733774
4745,0.4747,8,10,8,660949,15495,102618,23638,0.12272684070460017,0.604042623872435
4746,0.4748,11,16,11,660965,15479,102629,23627,0.12260011405398555,0.6041783869482944
4747,0.4749,9,10,9,660975,15469,102638,23618,0.12252090989735141,0.6042418195307903
4748,0.475,11,11,11,660986,15458,102649,23607,0.12243378532505386,0.6043005247664149
4749,0.4751,8,13,8,660999,15445,102657,23599,0.12233081992142948,0.6044206536215552
4750,0.4752,13,15,13,661014,15430,102670,23586,0.12221201368647827,0.6045212220627435
4751,0.4753,9,6,9,661020,15424,102679,23577,0.12216449119249778,0.6045229609497192
4752,0.4754,14,9,14,661029,15415,102693,23563,0.12209320745152706,0.6045204987428806
4753,0.4755,10,12,10,661041,15403,102703,23553,0.12199816246356608,0.6046051956052982
4754,0.4756,7,14,7,661055,15389,102710,23546,0.12188727664427829,0.6047515089251316
4755,0.4757,9,7,9,661062,15382,102719,23537,0.1218318337346344,0.6047688789537244
4756,0.4758,13,8,13,661070,15374,102732,23524,0.12176847040932708,0.6047611702401152
4757,0.4759,11,13,11,661083,15361,102743,23513,0.1216655050057027,0.6048515717446108
4758,0.476,19,9,19,661092,15352,102762,23494,0.12159422126473197,0.6047984348452865
4759,0.4761,8,14,8,661106,15338,102770,23486,0.12148333544544418,0.6049350916958582
4760,0.4762,10,16,10,661122,15322,102780,23476,0.12135660879482955,0.6050827362235167
4761,0.4763,10,9,10,661131,15313,102790,23466,0.12128532505385883,0.6051213285541144
4762,0.4764,12,14,12,661145,15299,102802,23454,0.12117443923457102,0.605217660568214
4763,0.4765,12,15,12,661160,15284,102814,23442,0.12105563299961981,0.6053297526209781
4764,0.4766,6,14,6,661174,15270,102820,23436,0.12094474718033202,0.6054875213145249
4765,0.4767,7,11,7,661185,15259,102827,23429,0.12085762260803447,0.6055882961124897
4766,0.4768,11,5,11,661190,15254,102838,23418,0.1208180205297174,0.6055544062887878
4767,0.4769,15,7,15,661197,15247,102853,23403,0.1207625776200735,0.6055109961190168
4768,0.477,11,7,11,661204,15240,102864,23392,0.1207071347104296,0.6055083868295713
4769,0.4771,16,12,16,661216,15228,102880,23376,0.12061208972246863,0.6055331053776811
4770,0.4772,8,10,8,661226,15218,102888,23368,0.1205328855658345,0.6056082516975069
4771,0.4773,19,8,19,661234,15210,102907,23349,0.12046952224052718,0.6055395627479966
4772,0.4774,11,6,11,661240,15204,102918,23338,0.1204219997465467,0.6055212495459499
4773,0.4775,11,11,11,661251,15193,102929,23327,0.12033487517424915,0.6055815160955348
4774,0.4776,7,7,7,661258,15186,102936,23320,0.12027943226460525,0.6056199033916793
4775,0.4777,10,10,10,661268,15176,102946,23310,0.12020022810797111,0.6056747908330302
4776,0.4778,6,9,6,661277,15167,102952,23304,0.12012894436700038,0.6057549842738686
4777,0.4779,5,12,5,661289,15155,102957,23299,0.12003389937903941,0.6058927549799761
4778,0.478,9,17,9,661306,15138,102966,23290,0.11989925231276137,0.606068491724784
4779,0.4781,10,9,10,661315,15129,102976,23280,0.11982796857179065,0.6061079434507537
4780,0.4782,10,11,10,661326,15118,102986,23270,0.1197408439994931,0.6061790142752944
4781,0.4783,6,13,6,661339,15105,102992,23264,0.1196378785958687,0.6063228126873257
4782,0.4784,6,7,6,661346,15098,102998,23258,0.11958243568622481,0.6063718844509334
4783,0.4785,15,13,15,661359,15085,103013,23243,0.11947947028260043,0.6064235024003339
4784,0.4786,18,7,18,661366,15078,103031,23225,0.11942402737295653,0.606349372111845
4785,0.4787,10,9,10,661375,15069,103041,23215,0.11935274363198581,0.6063890920488977
4786,0.4788,11,9,11,661384,15060,103052,23204,0.11928145989101507,0.6064185657537111
4787,0.4789,9,11,9,661395,15049,103061,23195,0.11919433531871752,0.6065003660704947
4788,0.479,9,8,9,661403,15041,103070,23186,0.11913097199341022,0.6065346482852434
4789,0.4791,9,5,9,661408,15036,103079,23177,0.11909136991509314,0.6065213409049276
4790,0.4792,13,12,13,661420,15024,103092,23164,0.11899632492713218,0.606577982612339
4791,0.4793,14,10,14,661430,15014,103106,23150,0.11891712077049804,0.6065926003563568
4792,0.4794,8,17,8,661447,14997,103114,23142,0.11878247370422,0.6067804609454889
4793,0.4795,13,15,13,661462,14982,103127,23129,0.11866366746926879,0.6068851512686626
4794,0.4796,6,13,6,661475,14969,103133,23123,0.11856070206564441,0.6070303475795442
4795,0.4797,15,10,15,661485,14959,103148,23108,0.11848149790901026,0.6070349646675598
4796,0.4798,11,8,11,661493,14951,103159,23097,0.11841813458370296,0.6070489907485281
4797,0.4799,7,9,7,661502,14942,103166,23090,0.11834685084273222,0.6071203197307531
4798,0.48,9,11,9,661513,14931,103175,23081,0.11825972627043467,0.6072029885299379
4799,0.4801,5,11,5,661524,14920,103180,23076,0.11817260169813712,0.607327087061796
4800,0.4802,6,6,6,661530,14914,103186,23070,0.11812507920415663,0.6073609941027801
4801,0.4803,10,14,10,661544,14900,103196,23060,0.11801419338486883,0.6074815595363541
4802,0.4804,8,14,8,661558,14886,103204,23052,0.11790330756558104,0.6076229637830144
4803,0.4805,8,17,8,661575,14869,103212,23044,0.117768660499303,0.6078126236383299
4804,0.4806,18,14,18,661589,14855,103230,23026,0.1176577746800152,0.607850901507352
4805,0.4807,10,7,10,661596,14848,103240,23016,0.11760233177037131,0.6078597084301711
4806,0.4808,10,13,10,661609,14835,103250,23006,0.11749936636674693,0.6079649057900162
4807,0.4809,6,10,6,661619,14825,103256,23000,0.11742016221011278,0.6080634500991408
4808,0.481,12,16,12,661635,14809,103268,22988,0.11729343555949816,0.6081964177051089
4809,0.4811,8,11,8,661646,14798,103276,22980,0.11720631098720061,0.6082905394674148
4810,0.4812,9,12,9,661658,14786,103285,22971,0.11711126599923964,0.6083904971263607
4811,0.4813,8,11,8,661669,14775,103293,22963,0.11702414142694209,0.6084848163654671
4812,0.4814,7,15,7,661684,14760,103300,22956,0.11690533519199088,0.6086541520839962
4813,0.4815,12,14,12,661698,14746,103312,22944,0.11679444937270309,0.6087556381002919
4814,0.4816,8,18,8,661716,14728,103320,22936,0.11665188189076163,0.6089634664401019
4815,0.4817,9,11,9,661727,14717,103329,22927,0.11656475731846408,0.6090479226437148
4816,0.4818,15,12,15,661739,14705,103344,22912,0.1164697123305031,0.6090863173565143
4817,0.4819,9,14,9,661753,14691,103353,22903,0.1163588265112153,0.6092195563121775
4818,0.482,5,8,5,661761,14683,103358,22898,0.116295463185908,0.6092972512705889
4819,0.4821,10,13,10,661774,14670,103368,22888,0.11619249778228362,0.6094041216252196
4820,0.4822,8,7,8,661781,14663,103376,22880,0.11613705487263971,0.6094345150893642
4821,0.4823,9,10,9,661791,14653,103385,22871,0.11605785071600558,0.6095032512525317
4822,0.4824,14,10,14,661801,14643,103399,22857,0.11597864655937144,0.60952
4823,0.4825,5,12,5,661813,14631,103404,22852,0.11588360157141046,0.6096630472480858
4824,0.4826,11,13,11,661826,14618,103415,22841,0.11578063616778608,0.6097600042713367
4825,0.4827,8,5,8,661831,14613,103423,22833,0.11574103408946902,0.6097580515942957
4826,0.4828,13,11,13,661842,14602,103436,22820,0.11565390951717146,0.609801720912832
4827,0.4829,16,13,16,661855,14589,103452,22804,0.11555094411354708,0.609846762763084
4828,0.483,8,15,8,661870,14574,103460,22796,0.11543213787859587,0.61000802782981
4829,0.4831,15,17,15,661887,14557,103475,22781,0.11529749081231783,0.6101290910064814
4830,0.4832,9,12,9,661899,14545,103484,22772,0.11520244582435686,0.6102312618913632
4831,0.4833,12,8,12,661907,14537,103496,22760,0.11513908249904956,0.6102367482639355
4832,0.4834,7,7,7,661914,14530,103503,22753,0.11508363958940565,0.6102781428533112
4833,0.4835,11,7,11,661921,14523,103514,22742,0.11502819667976176,0.6102777405071783
4834,0.4836,8,13,8,661934,14510,103522,22734,0.11492523127613737,0.6104070454301364
4835,0.4837,10,6,10,661940,14504,103532,22724,0.11487770878215689,0.6104007736112603
4836,0.4838,11,14,11,661954,14490,103543,22713,0.1147668229628691,0.6105152810257237
4837,0.4839,8,10,8,661964,14480,103551,22705,0.11468761880623494,0.6105956702971629
4838,0.484,15,9,15,661973,14471,103566,22690,0.11461633506526422,0.6105863674282177
4839,0.4841,5,11,5,661984,14460,103571,22685,0.11452921049296667,0.6107147664557814
4840,0.4842,6,8,6,661992,14452,103577,22679,0.11446584716765935,0.6107834424066144
4841,0.4843,5,15,5,662007,14437,103582,22674,0.11434704093270814,0.610977877179273
4842,0.4844,8,10,8,662017,14427,103590,22666,0.11426783677607401,0.6110586903189281
4843,0.4845,17,7,17,662024,14420,103607,22649,0.1142123938664301,0.6109957107016645
4844,0.4846,14,9,14,662033,14411,103621,22635,0.11414111012545938,0.6109971386924364
4845,0.4847,7,11,7,662044,14400,103628,22628,0.11405398555316183,0.6111051096467538
4846,0.4848,9,4,9,662048,14396,103637,22619,0.11402230389050817,0.61107659057139
4847,0.4849,10,9,10,662057,14387,103647,22609,0.11395102014953745,0.6111201210941724
4848,0.485,8,8,8,662065,14379,103655,22601,0.11388765682423013,0.6111681990265008
4849,0.4851,14,10,14,662075,14369,103669,22587,0.113808452667596,0.6111862755709493
4850,0.4852,6,10,6,662085,14359,103675,22581,0.11372924851096186,0.6112885760693015
4851,0.4853,16,7,16,662092,14352,103691,22565,0.11367380560131796,0.6112360159276214
4852,0.4854,12,14,12,662106,14338,103703,22553,0.11356291978203016,0.6113415196118295
4853,0.4855,9,7,9,662113,14331,103712,22544,0.11350747687238626,0.6113627118644068
4854,0.4856,7,7,7,662120,14324,103719,22537,0.11345203396274237,0.6114050080030384
4855,0.4857,5,7,5,662127,14317,103724,22532,0.11339659105309846,0.6114684251947136
4856,0.4858,14,14,14,662141,14303,103738,22518,0.11328570523381067,0.6115531897558458
4857,0.4859,9,5,9,662146,14298,103747,22509,0.1132461031554936,0.6115412829081425
4858,0.486,9,17,9,662163,14281,103756,22500,0.11311145608921556,0.6117288817596042
4859,0.4861,7,14,7,662177,14267,103763,22493,0.11300057026992777,0.6118879216539717
4860,0.4862,4,12,4,662189,14255,103767,22489,0.1129055252819668,0.6120455040278685
4861,0.4863,7,7,7,662196,14248,103774,22482,0.1128500823723229,0.6120882112714402
4862,0.4864,14,4,14,662200,14244,103788,22468,0.11281840070966924,0.6120069731967749
4863,0.4865,11,10,11,662210,14234,103799,22457,0.1127391965530351,0.612057452781336
4864,0.4866,10,15,10,662225,14219,103809,22447,0.1126203903180839,0.6122020400370916
4865,0.4867,12,12,12,662237,14207,103821,22435,0.11252534533012293,0.6122755308116369
4866,0.4868,6,12,6,662249,14195,103827,22429,0.11243030034216196,0.612412625600699
4867,0.4869,15,13,15,662262,14182,103842,22414,0.11232733493853757,0.6124713083397093
4868,0.487,5,13,5,662275,14169,103847,22409,0.11222436953491319,0.6126360107168243
4869,0.4871,7,14,7,662289,14155,103854,22402,0.11211348371562539,0.612796454851328
4870,0.4872,6,16,6,662305,14139,103860,22396,0.11198675706501077,0.6130012316956344
4871,0.4873,10,8,10,662313,14131,103870,22386,0.11192339373970346,0.6130295478818085
4872,0.4874,9,11,9,662324,14120,103879,22377,0.11183626916740591,0.6131188864838206
4873,0.4875,13,8,13,662332,14112,103892,22364,0.11177290584209859,0.6131154731878495
4874,0.4876,8,11,8,662343,14101,103900,22356,0.11168578126980104,0.6132155690265244
4875,0.4877,12,8,12,662351,14093,103912,22344,0.11162241794449372,0.6132228229546889
4876,0.4878,9,8,9,662359,14085,103921,22335,0.11155905461918642,0.6132619439868204
4877,0.4879,12,7,12,662366,14078,103933,22323,0.11150361170954251,0.6132523831762864
4878,0.488,10,7,10,662373,14071,103943,22313,0.11144816879989862,0.613264072119613
4879,0.4881,5,8,5,662381,14063,103948,22308,0.1113848054745913,0.6133457974760111
4880,0.4882,7,17,7,662398,14046,103955,22301,0.11125015840831327,0.6135582028778166
4881,0.4883,7,9,7,662407,14037,103962,22294,0.11117887466734254,0.6136357380749222
4882,0.4884,11,17,11,662424,14020,103973,22283,0.1110442276010645,0.6138060215409195
4883,0.4885,16,3,16,662427,14017,103989,22267,0.11102046635407427,0.6136864733766949
4884,0.4886,16,6,16,662433,14011,104005,22251,0.11097294386009378,0.6136175610832276
4885,0.4887,6,6,6,662439,14005,104011,22245,0.11092542136611329,0.6136551724137931
4886,0.4888,6,13,6,662452,13992,104017,22239,0.11082245596248891,0.6138113769975987
4887,0.4889,9,13,9,662465,13979,104026,22230,0.11071949055886453,0.61393576182717
4888,0.489,11,9,11,662474,13970,104037,22219,0.11064820681789381,0.6139710961894498
4889,0.4891,10,10,10,662484,13960,104047,22209,0.11056900266125966,0.6140341176145317
4890,0.4892,12,11,12,662495,13949,104059,22197,0.11048187808896211,0.6140928456814032
4891,0.4893,13,12,13,662507,13937,104072,22184,0.11038683310100114,0.614157969048476
4892,0.4894,14,12,14,662519,13925,104086,22170,0.11029178811304018,0.6142124948053747
4893,0.4895,12,10,12,662529,13915,104098,22158,0.11021258395640603,0.6142544285199457
4894,0.4896,12,6,12,662535,13909,104110,22146,0.11016506146242555,0.6142282623769242
4895,0.4897,7,20,7,662555,13889,104117,22139,0.11000665314915727,0.6144942822249362
4896,0.4898,9,18,9,662573,13871,104126,22130,0.10986408566721581,0.6147051470792478
4897,0.4899,6,12,6,662585,13859,104132,22124,0.10976904067925485,0.6148458994525192
4898,0.49,7,8,7,662593,13851,104139,22117,0.10970567735394754,0.6149076957295374
4899,0.4901,6,7,6,662600,13844,104145,22111,0.10965023444430363,0.6149631483799194
4900,0.4902,17,11,17,662611,13833,104162,22094,0.10956310987200608,0.6149692431875748
4901,0.4903,12,9,12,662620,13824,104174,22082,0.10949182613103536,0.6149947084052805
4902,0.4904,13,9,13,662629,13815,104187,22069,0.10942054239006463,0.6150094749749192
4903,0.4905,17,10,17,662639,13805,104204,22052,0.1093413382334305,0.6149984661293472
4904,0.4906,10,9,10,662648,13796,104214,22042,0.10927005449245976,0.6150454824487974
4905,0.4907,7,10,7,662658,13786,104221,22035,0.10919085033582562,0.6151419558359621
4906,0.4908,8,9,8,662667,13777,104229,22027,0.1091195665948549,0.6152105909954195
4907,0.4909,9,7,9,662674,13770,104238,22018,0.109064123685211,0.61523415670057
4908,0.491,7,15,7,662689,13755,104245,22011,0.10894531745025979,0.6154168763630263
4909,0.4911,5,6,5,662695,13749,104250,22006,0.10889779495627931,0.6154663683400923
4910,0.4912,14,17,14,662712,13732,104264,21992,0.10876314789000127,0.6156085544731833
4911,0.4913,10,5,10,662717,13727,104274,21982,0.1087235458116842,0.61558710689182
4912,0.4914,15,9,15,662726,13718,104289,21967,0.10865226207071348,0.615580776236514
4913,0.4915,7,13,7,662739,13705,104296,21960,0.1085492966670891,0.615729706995654
4914,0.4916,10,16,10,662755,13689,104306,21950,0.10842257001647447,0.615898313645164
4915,0.4917,9,14,9,662769,13675,104315,21941,0.10831168419718668,0.6160433513027853
4916,0.4918,9,11,9,662780,13664,104324,21932,0.10822455962488911,0.6161366445668053
4917,0.4919,8,8,8,662788,13656,104332,21924,0.1081611962995818,0.6161888701517707
4918,0.492,13,6,13,662794,13650,104345,21911,0.10811367380560132,0.6161525266443576
4919,0.4921,6,7,6,662801,13643,104351,21905,0.10805823089595742,0.6162090694272533
4920,0.4922,6,10,6,662811,13633,104357,21899,0.10797902673932327,0.6163176854666217
4921,0.4923,7,8,7,662819,13625,104364,21892,0.10791566341401597,0.6163808880254527
4922,0.4924,12,12,12,662831,13613,104376,21880,0.107820618426055,0.6164595835798609
4923,0.4925,4,11,4,662842,13602,104380,21876,0.10773349385375744,0.6166074750549636
4924,0.4926,10,8,10,662850,13594,104390,21866,0.10767013052845013,0.6166384658770445
4925,0.4927,8,13,8,662863,13581,104398,21858,0.10756716512482575,0.6167781257936172
4926,0.4928,9,7,9,662870,13574,104407,21849,0.10751172221518185,0.6168026423510149
4927,0.4929,10,5,10,662875,13569,104417,21839,0.10747212013686479,0.616781518300949
4928,0.493,4,16,4,662891,13553,104421,21835,0.10734539348625016,0.6170170679326326
4929,0.4931,6,9,6,662900,13544,104427,21829,0.10727410974527943,0.6171090945071099
4930,0.4932,10,5,10,662905,13539,104437,21819,0.10723450766696237,0.617088070592228
4931,0.4933,5,8,5,662913,13531,104442,21814,0.10717114434165505,0.6171735747630499
4932,0.4934,10,15,10,662928,13516,104452,21804,0.10705233810670384,0.6173272933182333
4933,0.4935,10,7,10,662935,13509,104462,21794,0.10699689519705995,0.6173413024388862
4934,0.4936,7,15,7,662950,13494,104469,21787,0.10687808896210874,0.6175278478501176
4935,0.4937,9,13,9,662963,13481,104478,21778,0.10677512355848436,0.6176579029467654
4936,0.4938,6,17,6,662980,13464,104484,21772,0.10664047649220632,0.6178907935066409
4937,0.4939,11,8,11,662988,13456,104495,21761,0.106577113166899,0.6179118039583156
4938,0.494,6,10,6,662998,13446,104501,21755,0.10649790901026486,0.6180222152779751
4939,0.4941,12,9,12,663007,13437,104513,21743,0.10642662526929414,0.6180500284252416
4940,0.4942,8,10,8,663017,13427,104521,21735,0.10634742111265999,0.6181388999488083
4941,0.4943,4,11,4,663028,13416,104525,21731,0.10626029654036244,0.6182889009019262
4942,0.4944,9,7,9,663035,13409,104534,21722,0.10620485363071853,0.6183143092994791
4943,0.4945,13,10,13,663045,13399,104547,21709,0.1061256494740844,0.6183490942235388
4944,0.4946,7,14,7,663059,13385,104554,21702,0.1060147636547966,0.6185196796534329
4945,0.4947,12,11,12,663070,13374,104566,21690,0.10592763908249905,0.6185831622176592
4946,0.4948,12,10,12,663080,13364,104578,21678,0.1058484349258649,0.618629073683009
4947,0.4949,10,7,10,663087,13357,104588,21668,0.10579299201622101,0.6186438258386866
4948,0.495,11,12,11,663099,13345,104599,21657,0.10569794702826005,0.6187360722244443
4949,0.4951,15,11,15,663110,13334,104614,21642,0.10561082245596248,0.6187671546203111
4950,0.4952,11,10,11,663120,13324,104625,21631,0.10553161829932835,0.6188242025461307
4951,0.4953,11,11,11,663131,13313,104636,21620,0.1054444937270308,0.6188990352961383
4952,0.4954,14,8,14,663139,13305,104650,21606,0.10538113040172348,0.6188880295608834
4953,0.4955,8,10,8,663149,13295,104658,21598,0.10530192624508934,0.618978018513742
4954,0.4956,11,10,11,663159,13285,104669,21587,0.1052227220884552,0.6190353292039459
4955,0.4957,8,9,8,663168,13276,104677,21579,0.10515143834748447,0.619107732032707
4956,0.4958,13,13,13,663181,13263,104690,21566,0.10504847294386009,0.619196646472767
4957,0.4959,11,8,11,663189,13255,104701,21555,0.10498510961855279,0.6192186153404194
4958,0.496,6,10,6,663199,13245,104707,21549,0.10490590546191864,0.6193309191239869
4959,0.4961,4,4,4,663203,13241,104711,21545,0.10487422379926499,0.6193583625596505
4960,0.4962,5,5,5,663208,13236,104716,21540,0.10483462172094792,0.6193926846100759
4961,0.4963,8,11,8,663219,13225,104724,21532,0.10474749714865036,0.6195011076905371
4962,0.4964,11,14,11,663233,13211,104735,21521,0.10463661132936257,0.6196303121041115
4963,0.4965,7,8,7,663241,13203,104742,21514,0.10457324800405525,0.6196964023389118
4964,0.4966,11,3,11,663244,13200,104753,21503,0.104549486757065,0.6196294268507045
4965,0.4967,5,10,5,663254,13190,104758,21498,0.10447028260043087,0.6197532287822878
4966,0.4968,12,10,12,663264,13180,104770,21486,0.10439107844379673,0.6198003807765534
4967,0.4969,10,8,10,663272,13172,104780,21476,0.10432771511848941,0.6198337566381898
4968,0.497,10,6,10,663278,13166,104790,21466,0.10428019262450894,0.6198313698313699
4969,0.4971,6,12,6,663290,13154,104796,21460,0.10418514763654797,0.6199803547697463
4970,0.4972,9,13,9,663303,13141,104805,21451,0.10408218223292358,0.6201144773358002
4971,0.4973,4,8,4,663311,13133,104809,21447,0.10401881890761627,0.620213996529786
4972,0.4974,9,11,9,663322,13122,104818,21438,0.10393169433531872,0.6203125
4973,0.4975,11,18,11,663340,13104,104829,21427,0.10378912685337727,0.6205148996553821
4974,0.4976,5,13,5,663353,13091,104834,21422,0.10368616144975289,0.6206936516674876
4975,0.4977,17,5,17,663358,13086,104851,21405,0.10364655937143581,0.6205966773941028
4976,0.4978,11,12,11,663370,13074,104862,21394,0.10355151438347485,0.6206916560287803
4977,0.4979,6,8,6,663378,13066,104868,21388,0.10348815105816753,0.6207697219481048
4978,0.498,6,9,6,663387,13057,104874,21382,0.1034168673171968,0.6208658788001975
4979,0.4981,4,12,4,663399,13045,104878,21378,0.10332182232923584,0.6210382593033728
4980,0.4982,11,6,11,663405,13039,104889,21367,0.10327429983525535,0.6210254025460675
4981,0.4983,10,7,10,663412,13032,104899,21357,0.10321885692561146,0.6210416121434179
4982,0.4984,11,6,11,663418,13026,104910,21346,0.10317133443163097,0.6210287443267776
4983,0.4985,10,11,10,663429,13015,104920,21336,0.10308420985933342,0.6211172891618876
4984,0.4986,15,8,15,663437,13007,104935,21321,0.1030208465340261,0.6210964810067583
4985,0.4987,5,8,5,663445,12999,104940,21316,0.1029574832087188,0.6211860702316772
4986,0.4988,14,8,14,663453,12991,104954,21302,0.10289411988341148,0.6211763333624938
4987,0.4989,9,11,9,663464,12980,104963,21293,0.10280699531111392,0.6212762232661279
4988,0.499,10,10,10,663474,12970,104973,21283,0.10272779115447979,0.6213470352961784
4989,0.4991,11,10,11,663484,12960,104984,21272,0.10264858699784565,0.6214068707641972
4990,0.4992,4,15,4,663499,12945,104988,21268,0.10252978076289444,0.6216350510040043
4991,0.4993,15,11,15,663510,12934,105003,21253,0.10244265619059688,0.6216690554889286
4992,0.4994,8,9,8,663519,12925,105011,21245,0.10237137244962616,0.6217442200760901
4993,0.4995,11,9,11,663528,12916,105022,21234,0.10230008870865542,0.6217862371888726
4994,0.4996,9,6,9,663534,12910,105031,21225,0.10225256621467495,0.6217958107514282
4995,0.4997,10,6,10,663540,12904,105041,21215,0.10220504372069446,0.6217943081567455
4996,0.4998,9,5,9,663545,12899,105050,21206,0.1021654416423774,0.6217856619264037
4997,0.4999,8,8,8,663553,12891,105058,21198,0.10210207831707008,0.6218428231980991
4998,0.5,12,9,12,663562,12882,105070,21186,0.10203079457609936,0.6218738992603029
4999,0.5001,6,12,6,663574,12870,105076,21180,0.10193574958813839,0.6220264317180617
5000,0.5002,10,9,10,663583,12861,105086,21170,0.10186446584716766,0.6220798683553231
5001,0.5003,15,11,15,663594,12850,105101,21155,0.1017773412748701,0.6221143949419203
5002,0.5004,8,11,8,663605,12839,105109,21147,0.10169021670257256,0.6222267992702878
5003,0.5005,11,10,11,663615,12829,105120,21136,0.1016110125459384,0.6222876490504932
5004,0.5006,11,8,11,663623,12821,105131,21125,0.1015476492206311,0.6223119071466446
5005,0.5007,12,9,12,663632,12812,105143,21113,0.10147636547966037,0.622343404568902
5006,0.5008,11,11,11,663643,12801,105154,21102,0.10138924090736282,0.6224227944429697
5007,0.5009,8,13,8,663656,12788,105162,21094,0.10128627550373843,0.6225724573519863
5008,0.501,13,10,13,663666,12778,105175,21081,0.1012070713471043,0.6226114179391004
5009,0.5011,4,9,4,663675,12769,105179,21077,0.10113578760613356,0.6227323760562548
5010,0.5012,6,7,6,663682,12762,105185,21071,0.10108034469648967,0.6227943132444654
5011,0.5013,10,12,10,663694,12750,105195,21061,0.10098529970852871,0.6229037887078169
5012,0.5014,12,9,12,663703,12741,105207,21049,0.10091401596755797,0.6229357798165137
5013,0.5015,6,6,6,663709,12735,105213,21043,0.1008664934735775,0.622979454082539
5014,0.5016,15,9,15,663718,12726,105228,21028,0.10079520973260676,0.6229780174201576
5015,0.5017,9,12,9,663730,12714,105237,21019,0.1007001647446458,0.623099042480657
5016,0.5018,10,8,10,663738,12706,105247,21009,0.10063680141933849,0.6231351030698502
5017,0.5019,6,9,6,663747,12697,105253,21003,0.10056551767836776,0.6232344213649852
5018,0.502,7,13,7,663760,12684,105260,20996,0.10046255227474338,0.623396674584323
5019,0.5021,18,8,18,663768,12676,105278,20978,0.10039918894943607,0.6233434361442919
5020,0.5022,7,11,7,663779,12665,105285,20971,0.10031206437713851,0.6234689023665121
5021,0.5023,10,4,10,663783,12661,105295,20961,0.10028038271448486,0.6234310867884123
5022,0.5024,7,12,7,663795,12649,105302,20954,0.10018533772652388,0.6235752760170223
5023,0.5025,4,8,4,663803,12641,105306,20950,0.10012197440121658,0.6236789616266262
5024,0.5026,9,5,9,663808,12636,105315,20941,0.1000823723228995,0.6236709652440658
5025,0.5027,11,4,11,663812,12632,105326,20930,0.10005069066024586,0.6236219533996782
5026,0.5028,12,16,12,663828,12616,105338,20918,0.09992396400963123,0.6237848154112244
5027,0.5029,8,9,8,663837,12607,105346,20910,0.0998526802686605,0.6238625175284184
5028,0.503,7,10,7,663847,12597,105353,20903,0.09977347611202636,0.6239701492537314
5029,0.5031,6,9,6,663856,12588,105359,20897,0.09970219237105564,0.6240704793190981
5030,0.5032,12,11,12,663867,12577,105371,20885,0.09961506779875808,0.6241408164485087
5031,0.5033,12,19,12,663886,12558,105383,20873,0.09946457990115322,0.6243606233735156
5032,0.5034,7,11,7,663897,12547,105390,20866,0.09937745532885565,0.6244874749349055
5033,0.5035,7,7,7,663904,12540,105397,20859,0.09932201241921176,0.6245396568759544
5034,0.5036,8,8,8,663912,12532,105405,20851,0.09925864909390444,0.6245993469730102
5035,0.5037,15,8,15,663920,12524,105420,20836,0.09919528576859714,0.6245803357314149
5036,0.5038,7,10,7,663930,12514,105427,20829,0.09911608161196299,0.6246888402363314
5037,0.5039,10,9,10,663939,12505,105437,20819,0.09904479787099227,0.6247449285800024
5038,0.504,9,15,9,663954,12490,105446,20810,0.09892599163604106,0.6249249249249249
5039,0.5041,8,13,8,663967,12477,105454,20802,0.09882302623241668,0.6250788785720724
5040,0.5042,6,12,6,663979,12465,105460,20796,0.09872798124445571,0.6252367637773969
5041,0.5043,7,11,7,663990,12454,105467,20789,0.09864085667215816,0.6253647384411756
5042,0.5044,10,16,10,664006,12438,105477,20779,0.09851413002154354,0.6255531806002951
5043,0.5045,8,9,8,664015,12429,105485,20771,0.0984428462805728,0.6256325301204819
5044,0.5046,12,12,12,664027,12417,105497,20759,0.09834780129261184,0.6257234145165179
5045,0.5047,12,11,12,664038,12406,105509,20747,0.09826067672031429,0.6257955539468525
5046,0.5048,13,7,13,664045,12399,105522,20734,0.09820523381067038,0.6257809434702563
5047,0.5049,5,7,5,664052,12392,105527,20729,0.09814979090102649,0.6258567072250234
5048,0.505,13,7,13,664059,12385,105540,20716,0.09809434799138259,0.6258421195734268
5049,0.5051,6,6,6,664065,12379,105546,20710,0.09804682549740211,0.6258877572607211
5050,0.5052,10,8,10,664073,12371,105556,20700,0.09798346217209479,0.6259260379184179
5051,0.5053,6,5,6,664078,12366,105562,20694,0.09794386009377772,0.6259528130671507
5052,0.5054,9,5,9,664083,12361,105571,20685,0.09790425801546065,0.6259456515160685
5053,0.5055,6,5,6,664088,12356,105577,20679,0.09786465593714358,0.6259724534584532
5054,0.5056,11,7,11,664095,12349,105588,20668,0.09780921302749969,0.6259805554714238
5055,0.5057,6,14,6,664109,12335,105594,20662,0.0976983272082119,0.6261781374064309
5056,0.5058,9,8,9,664117,12327,105603,20653,0.09763496388290457,0.6262280169799879
5057,0.5059,7,12,7,664129,12315,105610,20646,0.09753991889494361,0.6263766269227269
5058,0.506,11,12,11,664141,12303,105621,20635,0.09744487390698264,0.6264800534337239
5059,0.5061,4,2,4,664143,12301,105625,20631,0.09742903307565581,0.6264727316895421
5060,0.5062,14,5,14,664148,12296,105639,20617,0.09738943099733874,0.6264090177133655
5061,0.5063,7,13,7,664161,12283,105646,20610,0.09728646559371436,0.6265770832699966
5062,0.5064,5,6,5,664167,12277,105651,20605,0.09723894309973387,0.6266346329298704
5063,0.5065,5,6,5,664173,12271,105656,20600,0.09719142060575339,0.6266922211067506
5064,0.5066,10,10,10,664183,12261,105666,20590,0.09711221644911924,0.6267693525311254
5065,0.5067,15,11,15,664194,12250,105681,20575,0.09702509187682169,0.6268088347296268
5066,0.5068,9,10,9,664204,12240,105690,20566,0.09694588772018756,0.6268975187465707
5067,0.5069,1,14,1,664218,12226,105691,20565,0.09683500190089976,0.627153792199079
5068,0.507,7,12,7,664230,12214,105698,20558,0.0967399569129388,0.6273037959233492
5069,0.5071,7,10,7,664240,12204,105705,20551,0.09666075275630465,0.6274156617310335
5070,0.5072,7,5,7,664245,12199,105712,20544,0.09662115067798759,0.6274318174877073
5071,0.5073,8,11,8,664256,12188,105720,20536,0.09653402610569002,0.6275516440532942
5072,0.5074,7,11,7,664267,12177,105727,20529,0.09644690153339247,0.627682993946065
5073,0.5075,6,6,6,664273,12171,105733,20523,0.096399379039412,0.6277298586896678
5074,0.5076,9,8,9,664281,12163,105742,20514,0.09633601571410468,0.6277810080484745
5075,0.5077,7,11,7,664292,12152,105749,20507,0.09624889114180712,0.6279126733825285
5076,0.5078,8,10,8,664302,12142,105757,20499,0.09616968698517298,0.6280138476149628
5077,0.5079,1,8,1,664310,12134,105758,20498,0.09610632365986567,0.6281564108850208
5078,0.508,7,7,7,664317,12127,105765,20491,0.09605088075022176,0.6282114170090134
5079,0.5081,5,13,5,664330,12114,105770,20486,0.09594791534659738,0.6284049079754601
5080,0.5082,9,10,9,664340,12104,105779,20477,0.09586871118996325,0.6284951352014978
5081,0.5083,6,13,6,664353,12091,105785,20471,0.09576574578633887,0.6286775996560408
5082,0.5084,8,9,8,664362,12082,105793,20463,0.09569446204536815,0.6287601782147796
5083,0.5085,14,7,14,664369,12075,105807,20449,0.09563901913572424,0.6287357028655762
5084,0.5086,10,12,10,664381,12063,105817,20439,0.09554397414776328,0.6288536090086764
5085,0.5087,9,13,9,664394,12050,105826,20430,0.0954410087441389,0.6290024630541872
5086,0.5088,8,7,8,664401,12043,105834,20422,0.09538556583449499,0.62904666563992
5087,0.5089,8,8,8,664409,12035,105842,20414,0.09532220250918769,0.6291102961570464
5088,0.509,16,7,16,664416,12028,105858,20398,0.09526675959954378,0.6290630975143403
5089,0.5091,6,4,6,664420,12024,105864,20392,0.09523507793689012,0.6290720631786771
5090,0.5092,14,5,14,664425,12019,105878,20378,0.09519547585857306,0.6290088588449548
5091,0.5093,8,7,8,664432,12012,105886,20370,0.09514003294892916,0.62905317769131
5092,0.5094,4,14,4,664446,11998,105890,20366,0.09502914712964136,0.6292794462983562
5093,0.5095,10,5,10,664451,11993,105900,20356,0.09498954505132429,0.6292621101115954
5094,0.5096,10,8,10,664459,11985,105910,20346,0.09492618172601698,0.629303145587826
5095,0.5097,13,13,13,664472,11972,105923,20333,0.0948232163223926,0.629407212505804
5096,0.5098,13,9,13,664481,11963,105936,20320,0.09475193258142188,0.6294334479447388
5097,0.5099,7,7,7,664488,11956,105943,20313,0.09469648967177798,0.6294896030245747
5098,0.51,7,5,7,664493,11951,105950,20306,0.0946568875934609,0.6295067737235329
5099,0.5101,9,5,9,664498,11946,105959,20297,0.09461728551514384,0.6295009769562385
5100,0.5102,6,11,6,664509,11935,105965,20291,0.09453016094284628,0.6296468689877739
5101,0.5103,13,12,13,664521,11923,105978,20278,0.09443511595488531,0.6297319959007485
5102,0.5104,10,10,10,664531,11913,105988,20268,0.09435591179825117,0.6298126223548056
5103,0.5105,9,3,9,664534,11910,105997,20259,0.09433215055126093,0.6297677888650565
5104,0.5106,4,11,4,664545,11899,106001,20255,0.09424502597896338,0.6299371773340797
5105,0.5107,6,7,6,664552,11892,106007,20249,0.09418958306931947,0.6300052891944868
5106,0.5108,4,6,4,664558,11886,106011,20245,0.094142060575339,0.630076872801967
5107,0.5109,10,7,10,664565,11879,106021,20235,0.0940866176656951,0.6300990222332938
5108,0.511,8,5,8,664570,11874,106029,20227,0.09404701558737802,0.6301049811532351
5109,0.5111,7,9,7,664579,11865,106036,20220,0.0939757318464073,0.6302010285179991
5110,0.5112,7,12,7,664591,11853,106043,20213,0.09388068685844633,0.6303561404603006
5111,0.5113,6,4,6,664595,11849,106049,20207,0.09384900519579267,0.6303656101821812
5112,0.5114,9,6,9,664601,11843,106058,20198,0.0938014827018122,0.6303798258481321
5113,0.5115,9,12,9,664613,11831,106067,20189,0.09370643771385122,0.6305121798875702
5114,0.5116,19,10,19,664623,11821,106086,20170,0.09362723355721708,0.6304898252633553
5115,0.5117,10,7,10,664630,11814,106096,20160,0.09357179064757319,0.6305122912366298
5116,0.5118,8,7,8,664637,11807,106104,20152,0.09351634773792929,0.6305579023123377
5117,0.5119,14,8,14,664645,11799,106118,20138,0.09345298441262198,0.6305539029965244
5118,0.512,3,5,3,664650,11794,106121,20135,0.0934133823343049,0.6306179335400419
5119,0.5121,9,11,9,664661,11783,106130,20126,0.09332625776200736,0.6307311416841643
5120,0.5122,11,9,11,664670,11774,106141,20115,0.09325497402103662,0.6307817742795321
5121,0.5123,11,15,11,664685,11759,106152,20104,0.09313616778608541,0.630951260082227
5122,0.5124,18,10,18,664695,11749,106170,20086,0.09305696362945128,0.6309407884403958
5123,0.5125,8,11,8,664706,11738,106178,20078,0.09296983905715372,0.6310661302489313
5124,0.5126,6,7,6,664713,11731,106184,20072,0.09291439614750982,0.6311354274753954
5125,0.5127,8,9,8,664722,11722,106192,20064,0.0928431124065391,0.6312212923928774
5126,0.5128,9,10,9,664732,11712,106201,20055,0.09276390824990495,0.6313155161016148
5127,0.5129,4,7,4,664739,11705,106205,20051,0.09270846534026106,0.6314082378133267
5128,0.513,9,10,9,664749,11695,106214,20042,0.09262926118362692,0.6315026625074833
5129,0.5131,7,12,7,664761,11683,106221,20035,0.09253421619566594,0.6316602560060534
5130,0.5132,6,9,6,664770,11674,106227,20029,0.09246293245469522,0.6317698640507208
5131,0.5133,5,2,5,664772,11672,106232,20024,0.0924470916233684,0.6317516405855629
5132,0.5134,4,6,4,664778,11666,106236,20020,0.0923995691293879,0.6318247806602285
5133,0.5135,8,7,8,664785,11659,106244,20012,0.09234412621974401,0.6318714281203625
5134,0.5136,13,7,13,664792,11652,106257,19999,0.09228868331010011,0.6318599728286626
5135,0.5137,10,12,10,664804,11640,106267,19989,0.09219363832213914,0.631983306459262
5136,0.5138,12,10,12,664814,11630,106279,19977,0.09211443416550501,0.6320435346600437
5137,0.5139,12,12,12,664826,11618,106291,19965,0.09201938917754404,0.6321438748693917
5138,0.514,10,9,10,664835,11609,106301,19955,0.09194810543657331,0.6322075782537068
5139,0.5141,6,12,6,664847,11597,106307,19949,0.09185306044861234,0.6323781144994611
5140,0.5142,8,11,8,664858,11586,106315,19941,0.09176593587631479,0.6325054715006185
5141,0.5143,7,9,7,664867,11577,106322,19934,0.09169465213534406,0.6326044873218876
5142,0.5144,11,13,11,664880,11564,106333,19923,0.09159168673171968,0.6327373201638772
5143,0.5145,5,8,5,664888,11556,106338,19918,0.09152832340641237,0.6328398042829002
5144,0.5146,5,7,5,664895,11549,106343,19913,0.09147288049676847,0.6329222554192359
5145,0.5147,6,8,6,664903,11541,106349,19907,0.09140951717146116,0.6330132281862122
5146,0.5148,6,10,6,664913,11531,106355,19901,0.09133031301482702,0.6331445660473403
5147,0.5149,11,9,11,664922,11522,106366,19890,0.09125902927385629,0.6331975041385458
5148,0.515,8,10,8,664932,11512,106374,19882,0.09117982511722215,0.6333057272090208
5149,0.5151,8,11,8,664943,11501,106382,19874,0.0910927005449246,0.6334342629482071
5150,0.5152,10,13,10,664956,11488,106392,19864,0.09098973514130021,0.6335799948966573
5151,0.5153,6,7,6,664963,11481,106398,19858,0.09093429223165632,0.6336513609240882
5152,0.5154,6,15,6,664978,11466,106404,19852,0.09081548599670511,0.6338846669646848
5153,0.5155,10,12,10,664990,11454,106414,19842,0.09072044100874414,0.634010736196319
5154,0.5156,12,9,12,664999,11445,106426,19830,0.09064915726777341,0.634052757793765
5155,0.5157,15,12,15,665011,11433,106441,19815,0.09055411227981244,0.6341205837173579
5156,0.5158,8,8,8,665019,11425,106449,19807,0.09049074895450514,0.6341892930327869
5157,0.5159,8,8,8,665027,11417,106457,19799,0.09042738562919782,0.6342580727831881
5158,0.516,9,5,9,665032,11412,106466,19790,0.09038778355088076,0.6342542144734312
5159,0.5161,8,17,8,665049,11395,106474,19782,0.09025313648460272,0.6345062064983802
5160,0.5162,14,7,14,665056,11388,106488,19768,0.09019769357495881,0.6344845294646296
5161,0.5163,8,10,8,665066,11378,106496,19760,0.09011848941832468,0.6345943862804291
5162,0.5164,9,14,9,665080,11364,106505,19751,0.09000760359903688,0.6347742246504902
5163,0.5165,7,6,7,665086,11358,106512,19744,0.08996008110505639,0.6348144813838338
5164,0.5166,7,6,7,665092,11352,106519,19737,0.08991255861107592,0.6348547717842323
5165,0.5167,5,10,5,665102,11342,106524,19732,0.08983335445444177,0.6350003218124477
5166,0.5168,6,6,6,665108,11336,106530,19726,0.08978583196046129,0.6350524756937738
5167,0.5169,10,6,10,665114,11330,106540,19716,0.0897383094664808,0.6350576563808542
5168,0.517,9,7,9,665121,11323,106549,19707,0.0896828665568369,0.635095069287786
5169,0.5171,7,11,7,665132,11312,106556,19700,0.08959574198453935,0.6352379723977815
5170,0.5172,10,6,10,665138,11306,106566,19690,0.08954821949055887,0.6352432571944767
5171,0.5173,9,2,9,665140,11304,106575,19681,0.08953237865923204,0.6351783120864934
5172,0.5174,5,11,5,665151,11293,106580,19676,0.08944525408693449,0.6353450224417966
5173,0.5175,8,6,8,665157,11287,106588,19668,0.089397731592954,0.6353739298982394
5174,0.5176,10,10,10,665167,11277,106598,19658,0.08931852743631986,0.6354614514304187
5175,0.5177,9,7,9,665174,11270,106607,19649,0.08926308452667596,0.6354992076069731
5176,0.5178,10,10,10,665184,11260,106617,19639,0.08918388037004182,0.6355869121978057
5177,0.5179,9,8,9,665192,11252,106626,19630,0.0891205170447345,0.6356453597564925
5178,0.518,9,13,9,665205,11239,106635,19621,0.08901755164111012,0.6358068697342839
5179,0.5181,9,8,9,665213,11231,106644,19612,0.08895418831580282,0.6358655124339396
5180,0.5182,9,9,9,665222,11222,106653,19603,0.08888290457483208,0.6359448499594486
5181,0.5183,12,8,12,665230,11214,106665,19591,0.08881954124952478,0.6359681869826327
5182,0.5184,8,12,8,665242,11202,106673,19583,0.08872449626156381,0.6361214877375345
5183,0.5185,8,7,8,665249,11195,106681,19575,0.08866905335191991,0.6361715957101073
5184,0.5186,9,8,9,665257,11187,106690,19566,0.0886056900266126,0.6362306116476442
5185,0.5187,8,11,8,665268,11176,106698,19558,0.08851856545431504,0.6363636363636364
5186,0.5188,7,9,7,665277,11167,106705,19551,0.08844728171334432,0.6364672179178332
5187,0.5189,14,9,14,665286,11158,106719,19537,0.0883759979723736,0.6364880273660205
5188,0.519,8,8,8,665294,11150,106727,19529,0.08831263464706628,0.6365592098829819
5189,0.5191,4,7,4,665301,11143,106731,19525,0.08825719173742239,0.6366571018651362
5190,0.5192,6,9,6,665310,11134,106737,19519,0.08818590799645165,0.6367729096662643
5191,0.5193,9,9,9,665319,11125,106746,19510,0.08811462425548093,0.6368532724008487
5192,0.5194,4,10,4,665329,11115,106750,19506,0.08803542009884678,0.6370138140491819
5193,0.5195,7,4,7,665333,11111,106757,19499,0.08800373843619314,0.6370140476968311
5194,0.5196,11,7,11,665340,11104,106768,19488,0.08794829552654923,0.6370292887029289
5195,0.5197,7,2,7,665342,11102,106775,19481,0.0879324546952224,0.6369878690775921
5196,0.5198,10,7,10,665349,11095,106785,19471,0.08787701178557851,0.637014983969116
5197,0.5199,4,5,4,665354,11090,106789,19467,0.08783740970726144,0.6370717020649933
5198,0.52,11,6,11,665360,11084,106800,19456,0.08778988721328096,0.6370661427635887
5199,0.5201,9,12,9,665372,11072,106809,19447,0.08769484222531998,0.6372096071299846
5200,0.5202,7,8,7,665380,11064,106816,19440,0.08763147890001267,0.6372934697088907
5201,0.5203,11,10,11,665390,11054,106827,19429,0.08755227474337854,0.6373716497720041
5202,0.5204,12,6,12,665396,11048,106839,19417,0.08750475224939805,0.6373543410471032
5203,0.5205,8,7,8,665403,11041,106847,19409,0.08744930933975414,0.6374055829228243
5204,0.5206,6,6,6,665409,11035,106853,19403,0.08740178684577367,0.6374597542545503
5205,0.5207,14,3,14,665412,11032,106867,19389,0.08737802559878342,0.6373557739719273
5206,0.5208,10,13,10,665425,11019,106877,19379,0.08727506019515904,0.6375090466478057
5207,0.5209,9,12,9,665437,11007,106886,19370,0.08718001520719808,0.6376534878361918
5208,0.521,9,8,9,665445,10999,106895,19361,0.08711665188189076,0.6377140974967062
5209,0.5211,9,7,9,665452,10992,106904,19352,0.08706120897224687,0.6377537569206433
5210,0.5212,10,6,10,665458,10986,106914,19342,0.08701368647826638,0.6377604853600634
5211,0.5213,11,15,11,665473,10971,106925,19331,0.08689488024331517,0.6379446901194641
5212,0.5214,9,6,9,665479,10965,106934,19322,0.08684735774933469,0.6379634826823389
5213,0.5215,7,8,7,665487,10957,106941,19315,0.08678399442402737,0.6380483615221987
5214,0.5216,6,8,6,665495,10949,106947,19309,0.08672063109872007,0.6381452838918633
5215,0.5217,12,7,12,665502,10942,106959,19297,0.08666518818907616,0.6381494097027018
5216,0.5218,8,10,8,665512,10932,106967,19289,0.08658598403244203,0.6382647827669501
5217,0.5219,7,4,7,665516,10928,106974,19282,0.08655430236978837,0.6382654750082754
5218,0.522,9,8,9,665524,10920,106983,19273,0.08649093904448106,0.6383267644818336
5219,0.5221,9,5,9,665529,10915,106992,19264,0.08645133696616399,0.6383246628450246
5220,0.5222,11,10,11,665539,10905,107003,19253,0.08637213280952985,0.6384044034750315
5221,0.5223,7,11,7,665550,10894,107010,19246,0.08628500823723229,0.6385534173855342
5222,0.5224,7,10,7,665560,10884,107017,19239,0.08620580408059815,0.6386814062344388
5223,0.5225,8,9,8,665569,10875,107025,19231,0.08613452033962743,0.638776323656414
5224,0.5226,6,7,6,665576,10868,107031,19225,0.08607907742998352,0.6388528893762669
5225,0.5227,5,10,5,665586,10858,107036,19220,0.08599987327334939,0.6390052530088437
5226,0.5228,5,7,5,665593,10851,107041,19215,0.08594443036370548,0.6390939932149272
5227,0.5229,8,6,8,665599,10845,107049,19207,0.08589690786972501,0.6391255157726607
5228,0.523,9,12,9,665611,10833,107058,19198,0.08580186288176403,0.6392727514901269
5229,0.5231,6,8,6,665619,10825,107064,19192,0.08573849955645672,0.6393710230869174
5230,0.5232,11,7,11,665626,10818,107075,19181,0.08568305664681282,0.6393879795993199
5231,0.5233,5,14,5,665640,10804,107080,19176,0.08557217082752502,0.6396264176117412
5232,0.5234,7,4,7,665644,10800,107087,19169,0.08554048916487138,0.6396276152023758
5233,0.5235,5,5,5,665649,10795,107092,19164,0.0855008870865543,0.6396742214359625
5234,0.5236,7,10,7,665659,10785,107099,19157,0.08542168292992017,0.6398036203326432
5235,0.5237,7,9,7,665668,10776,107106,19150,0.08535039918894943,0.6399117823965782
5236,0.5238,11,8,11,665676,10768,107117,19139,0.08528703586364213,0.6399505132577658
5237,0.5239,5,10,5,665686,10758,107122,19134,0.08520783170700798,0.6401043757527097
5238,0.524,9,8,9,665694,10750,107131,19125,0.08514446838170067,0.6401673640167364
5239,0.5241,5,5,5,665699,10745,107136,19120,0.0851048663033836,0.6402142976728612
5240,0.5242,7,11,7,665710,10734,107143,19113,0.08501774173108605,0.6403658659161725
5241,0.5243,9,11,9,665721,10723,107152,19104,0.0849306171587885,0.6404935125892648
5242,0.5244,9,7,9,665728,10716,107161,19095,0.08487517424914459,0.6405353728489483
5243,0.5245,6,8,6,665736,10708,107167,19089,0.08481181092383729,0.6406349632513341
5244,0.5246,9,13,9,665749,10695,107176,19080,0.0847088455202129,0.6408060453400504
5245,0.5247,14,7,14,665756,10688,107190,19066,0.084653402610569,0.6407877932378839
5246,0.5248,7,4,7,665760,10684,107197,19059,0.08462172094791534,0.6407894294455838
5247,0.5249,8,8,8,665768,10676,107205,19051,0.08455835762260804,0.6408652067144347
5248,0.525,11,14,11,665782,10662,107216,19040,0.08444747180332024,0.641034273786277
5249,0.5251,7,10,7,665792,10652,107223,19033,0.0843682676466861,0.6411655718376285
5250,0.5252,5,6,5,665798,10646,107228,19028,0.08432074515270561,0.6412347509604367
5251,0.5253,6,6,6,665804,10640,107234,19022,0.08427322265872512,0.6412918886116917
5252,0.5254,3,10,3,665814,10630,107237,19019,0.08419401850209099,0.6414718877533813
5253,0.5255,4,11,4,665825,10619,107241,19015,0.08410689392979344,0.6416616049132753
5254,0.5256,13,11,13,665836,10608,107254,19002,0.08401976935749589,0.641742654508612
5255,0.5257,8,8,8,665844,10600,107262,18994,0.08395640603218857,0.6418192876934514
5256,0.5258,8,3,8,665847,10597,107270,18986,0.08393264478519832,0.6417875130987392
5257,0.5259,3,9,3,665856,10588,107273,18983,0.0838613610442276,0.6419465016401203
5258,0.526,7,14,7,665870,10574,107280,18976,0.08375047522493981,0.642165820642978
5259,0.5261,8,6,8,665876,10568,107288,18968,0.08370295273095932,0.6421993499458288
5260,0.5262,8,2,8,665878,10566,107296,18960,0.08368711189963249,0.6421459053038
5261,0.5263,6,9,6,665887,10557,107302,18954,0.08361582815866177,0.6422689844464776
5262,0.5264,11,10,11,665897,10547,107313,18943,0.08353662400202763,0.6423533401152933
5263,0.5265,7,8,7,665905,10539,107320,18936,0.08347326067672031,0.6424427480916031
5264,0.5266,7,6,7,665911,10533,107327,18929,0.08342573818273984,0.642488629420949
5265,0.5267,6,7,6,665918,10526,107333,18923,0.08337029527309593,0.6425685082685321
5266,0.5268,10,7,10,665925,10519,107343,18913,0.08331485236345203,0.6425998912748029
5267,0.5269,10,12,10,665937,10507,107353,18903,0.08321980737549106,0.6427405644338661
5268,0.527,9,8,9,665945,10499,107362,18894,0.08315644405018376,0.6428061102983703
5269,0.5271,6,6,6,665951,10493,107368,18888,0.08310892155620327,0.6428644362002655
5270,0.5272,5,9,5,665960,10484,107373,18883,0.08303763781523255,0.6430006469847107
5271,0.5273,4,12,4,665972,10472,107377,18879,0.08294259282727158,0.6432148819461007
5272,0.5274,7,10,7,665982,10462,107384,18872,0.08286338867063743,0.6433490147951183
5273,0.5275,11,7,11,665989,10455,107395,18861,0.08280794576099354,0.6433688088415882
5274,0.5276,11,12,11,666001,10443,107406,18850,0.08271290077303257,0.6434984467278873
5275,0.5277,13,9,13,666010,10434,107419,18837,0.08264161703206184,0.6435379727375218
5276,0.5278,8,11,8,666021,10423,107427,18829,0.08255449245976429,0.6436824832490086
5277,0.5279,11,4,11,666025,10419,107438,18818,0.08252281079711063,0.6436364880117659
5278,0.528,4,5,4,666030,10414,107442,18814,0.08248320871879357,0.6436978240043794
5279,0.5281,8,6,8,666036,10408,107450,18806,0.08243568622481308,0.6437324570411447
5280,0.5282,6,5,6,666041,10403,107456,18800,0.082396084146496,0.643769475738794
5281,0.5283,7,8,7,666049,10395,107463,18793,0.0823327208211887,0.6438604906125805
5282,0.5284,6,3,6,666052,10392,107469,18787,0.08230895957419845,0.6438534562527846
5283,0.5285,10,11,10,666063,10381,107479,18777,0.0822218350019009,0.6439742094793882
5284,0.5286,9,4,9,666067,10377,107488,18768,0.08219015333924724,0.6439526505404014
5285,0.5287,2,6,2,666073,10371,107490,18766,0.08214263084526675,0.6440608161444212
5286,0.5288,7,4,7,666077,10367,107497,18759,0.08211094918261311,0.6440637231339696
5287,0.5289,6,10,6,666087,10357,107503,18753,0.08203174502597896,0.6442116111301958
5288,0.529,9,1,9,666088,10356,107512,18744,0.08202382461031554,0.6441237113402062
5289,0.5291,5,8,5,666096,10348,107517,18739,0.08196046128500824,0.6442396947089766
5290,0.5292,3,9,3,666105,10339,107520,18736,0.08188917754403752,0.644402407566638
5291,0.5293,10,8,10,666113,10331,107530,18726,0.0818258142187302,0.644457445710156
5292,0.5294,7,3,7,666116,10328,107537,18719,0.08180205297173995,0.6444383240954316
5293,0.5295,8,10,8,666126,10318,107545,18711,0.08172284881510582,0.6445623342175066
5294,0.5296,11,12,11,666138,10306,107556,18700,0.08162780382714485,0.6446942011997517
5295,0.5297,9,10,9,666148,10296,107565,18691,0.0815485996705107,0.6448062924759375
5296,0.5298,10,4,10,666152,10292,107575,18681,0.08151691800785706,0.6447727194284334
5297,0.5299,8,10,8,666162,10282,107583,18673,0.0814377138512229,0.6448972543602142
5298,0.53,6,5,6,666167,10277,107589,18667,0.08139811177290585,0.6449350469872858
5299,0.5301,14,5,14,666172,10272,107603,18653,0.08135850969458877,0.6448746758859119
5300,0.5302,7,10,7,666182,10262,107610,18646,0.08127930553795464,0.6450117614501176
5301,0.5303,6,8,6,666190,10254,107616,18640,0.08121594221264732,0.6451166332110473
5302,0.5304,6,6,6,666196,10248,107622,18634,0.08116841971866684,0.6451769268056229
5303,0.5305,8,8,8,666204,10240,107630,18626,0.08110505639335952,0.645257396244717
5304,0.5306,11,3,11,666207,10237,107641,18615,0.08108129514636928,0.6451892416470262
5305,0.5307,3,7,3,666214,10230,107644,18612,0.08102585223672538,0.6453089244851259
5306,0.5308,12,10,12,666224,10220,107656,18600,0.08094664808009125,0.6453851492019431
5307,0.5309,5,6,5,666230,10214,107661,18595,0.08089912558611076,0.6454580165920372
5308,0.531,5,8,5,666238,10206,107666,18590,0.08083576226080345,0.645575774413113
5309,0.5311,8,10,8,666248,10196,107674,18582,0.0807565581041693,0.6457015775939954
5310,0.5312,6,4,6,666252,10192,107680,18576,0.08072487644151564,0.6457174638487208
5311,0.5313,14,6,14,666258,10186,107694,18562,0.08067735394753517,0.6456796994573536
5312,0.5314,10,9,10,666267,10177,107704,18552,0.08060607020656443,0.6457586410943645
5313,0.5315,9,6,9,666273,10171,107713,18543,0.08055854771258396,0.6457825450999513
5314,0.5316,6,5,6,666278,10166,107719,18537,0.08051894563426688,0.6458209943211511
5315,0.5317,9,7,9,666285,10159,107728,18528,0.08046350272462299,0.645867466099627
5316,0.5318,9,4,9,666289,10155,107737,18519,0.08043182106196933,0.6458464113831346
5317,0.5319,9,9,9,666298,10146,107746,18510,0.08036053732099861,0.6459380234505863
5318,0.532,4,6,4,666304,10140,107750,18506,0.08031301482701812,0.6460238776792572
5319,0.5321,9,5,9,666309,10135,107759,18497,0.08027341274870105,0.646025426096675
5320,0.5322,15,3,15,666312,10132,107774,18482,0.0802496515017108,0.6459075976794576
5321,0.5323,11,8,11,666320,10124,107785,18471,0.0801862881764035,0.6459520895261409
5322,0.5324,7,4,7,666324,10120,107792,18464,0.08015460651374984,0.6459557794570389
5323,0.5325,4,6,4,666330,10114,107796,18460,0.08010708401976936,0.6460418562329391
5324,0.5326,9,8,9,666338,10106,107805,18451,0.08004372069446204,0.6461112861995307
5325,0.5327,8,6,8,666344,10100,107813,18443,0.07999619820048157,0.6461479171775917
5326,0.5328,12,10,12,666354,10090,107825,18431,0.07991699404384742,0.6462255881631079
5327,0.5329,7,5,7,666359,10085,107832,18424,0.07987739196553036,0.6462520607527448
5328,0.533,9,5,9,666364,10080,107841,18415,0.07983778988721328,0.6462537287243376
5329,0.5331,9,4,9,666368,10076,107850,18406,0.07980610822455962,0.6462327083772207
5330,0.5332,7,8,7,666376,10068,107857,18399,0.07974274489925232,0.6463273263779112
5331,0.5333,6,9,6,666385,10059,107863,18393,0.07967146115828158,0.6464571910586251
5332,0.5334,8,11,8,666396,10048,107871,18385,0.07958433658598403,0.6466078148630113
5333,0.5335,11,7,11,666403,10041,107882,18374,0.07952889367634014,0.6466303008974134
5334,0.5336,5,8,5,666411,10033,107887,18369,0.07946553035103282,0.6467502288571227
5335,0.5337,11,8,11,666419,10025,107898,18358,0.07940216702572551,0.6467956170947398
5336,0.5338,8,6,8,666425,10019,107906,18350,0.07935464453174502,0.6468328104621242
5337,0.5339,2,9,2,666434,10010,107908,18348,0.0792833607907743,0.6470131885182312
5338,0.534,3,3,3,666437,10007,107911,18345,0.07925959954378406,0.6470443002257337
5339,0.5341,10,7,10,666444,10000,107921,18335,0.07920415663414015,0.6470795835539086
5340,0.5342,5,3,5,666447,9997,107926,18330,0.07918039538714992,0.6470858191831115
5341,0.5343,10,12,10,666459,9985,107936,18320,0.07908535039918894,0.6472354707648825
5342,0.5344,7,6,7,666465,9979,107943,18313,0.07903782790520847,0.6472854517178
5343,0.5345,12,6,12,666471,9973,107955,18301,0.07899030541122798,0.6472731131074485
5344,0.5346,10,8,10,666479,9965,107965,18291,0.07892694208592067,0.6473315402038505
5345,0.5347,11,4,11,666483,9961,107976,18280,0.07889526042326701,0.6472858609822598
5346,0.5348,14,4,14,666487,9957,107990,18266,0.07886357876061335,0.6472026361478227
5347,0.5349,9,7,9,666494,9950,107999,18257,0.07880813585096946,0.6472506824547098
5348,0.535,4,6,4,666500,9944,108003,18253,0.07876061335698897,0.6473383693300706
5349,0.5351,2,6,2,666506,9938,108005,18251,0.0787130908630085,0.6474511334208379
5350,0.5352,5,9,5,666515,9929,108010,18246,0.07864180712203776,0.6475953859804792
5351,0.5353,4,6,4,666521,9923,108014,18242,0.07859428462805729,0.6476832948695189
5352,0.5354,8,5,8,666526,9918,108022,18234,0.07855468254974021,0.6476982097186701
5353,0.5355,6,13,6,666539,9905,108028,18228,0.07845171714611583,0.6479223687484449
5354,0.5356,8,8,8,666547,9897,108036,18220,0.07838835382080851,0.6480065440836504
5355,0.5357,7,13,7,666560,9884,108043,18213,0.07828538841718413,0.6482186710324945
5356,0.5358,7,5,7,666565,9879,108050,18206,0.07824578633886706,0.6482463948727079
5357,0.5359,12,8,12,666573,9871,108062,18194,0.07818242301355975,0.6482807767682166
5358,0.536,5,12,5,666585,9859,108067,18189,0.07808737802559879,0.6484954363947518
5359,0.5361,6,6,6,666591,9853,108073,18183,0.0780398555316183,0.6485589955771152
5360,0.5362,5,4,5,666595,9849,108078,18178,0.07800817386896464,0.648588860741428
5361,0.5363,9,6,9,666601,9843,108087,18169,0.07796065137498416,0.6486148793374268
5362,0.5364,9,10,9,666611,9833,108096,18160,0.07788144721835003,0.6487336119744221
5363,0.5365,7,6,7,666617,9827,108103,18153,0.07783392472436954,0.6487848463187992
5364,0.5366,13,9,13,666626,9818,108116,18140,0.07776264098339881,0.6488303884398026
5365,0.5367,5,9,5,666635,9809,108121,18135,0.07769135724242808,0.6489765244775265
5366,0.5368,6,6,6,666641,9803,108127,18129,0.0776438347484476,0.6490405269941286
5367,0.5369,6,11,6,666652,9792,108133,18123,0.07755671017615004,0.6492208490059108
5368,0.537,6,12,6,666664,9780,108139,18117,0.07746166518818907,0.6494246693192817
5369,0.5371,5,8,5,666672,9772,108144,18112,0.07739830186288177,0.649548127958686
5370,0.5372,12,3,12,666675,9769,108156,18100,0.07737454061589152,0.6494671498797947
5371,0.5373,9,13,9,666688,9756,108165,18091,0.07727157521226714,0.6496570546198872
5372,0.5374,7,4,7,666692,9752,108172,18084,0.07723989354961348,0.6496623078028453
5373,0.5375,6,7,6,666699,9745,108178,18078,0.07718445063996958,0.6497502066635518
5374,0.5376,9,10,9,666709,9735,108187,18069,0.07710524648333544,0.6498705222270177
5375,0.5377,5,9,5,666718,9726,108192,18064,0.07703396274236472,0.6500179920834833
5376,0.5378,16,9,16,666727,9717,108208,18048,0.07696267900139399,0.6500270124257158
5377,0.5379,7,2,7,666729,9715,108215,18041,0.07694683817006716,0.649985588701542
5378,0.538,8,5,8,666734,9710,108223,18033,0.0769072360917501,0.650001802256425
5379,0.5381,5,8,5,666742,9702,108228,18028,0.07684387276644278,0.6501262170934007
5380,0.5382,7,5,7,666747,9697,108235,18021,0.07680427068812572,0.650155133848041
5381,0.5383,11,5,11,666752,9692,108246,18010,0.07676466860980864,0.6501335643635838
5382,0.5384,14,6,14,666758,9686,108260,17996,0.07671714611582815,0.6500975363051803
5383,0.5385,10,10,10,666768,9676,108270,17986,0.07663794195919402,0.6502060588533005
5384,0.5386,8,4,8,666772,9672,108278,17978,0.07660626029654036,0.6501989150090416
5385,0.5387,6,5,6,666777,9667,108284,17972,0.0765666582182233,0.650240602047831
5386,0.5388,5,6,5,666783,9661,108289,17967,0.0765191357242428,0.6503185174460692
5387,0.5389,8,5,8,666788,9656,108297,17959,0.07647953364592573,0.6503349628824914
5388,0.539,6,4,6,666792,9652,108303,17953,0.07644785198327209,0.6503531968846223
5389,0.5391,8,6,8,666798,9646,108311,17945,0.0764003294892916,0.6503932441738248
5390,0.5392,9,5,9,666803,9641,108320,17936,0.07636072741097452,0.6503970700221199
5391,0.5393,9,3,9,666806,9638,108329,17927,0.07633696616398429,0.6503537094141121
5392,0.5394,4,10,4,666816,9628,108333,17923,0.07625776200735014,0.6505390003992596
5393,0.5395,6,6,6,666822,9622,108339,17917,0.07621023951336967,0.6506045971168162
5394,0.5396,7,10,7,666832,9612,108346,17910,0.07613103535673552,0.6507521255722695
5395,0.5397,8,8,8,666840,9604,108354,17902,0.07606767203142821,0.6508398167672508
5396,0.5398,5,7,5,666847,9597,108359,17897,0.0760122291217843,0.6509420237142649
5397,0.5399,7,9,7,666856,9588,108366,17890,0.07594094538081358,0.6510663075915277
5398,0.54,7,4,7,666860,9584,108373,17883,0.07590926371815993,0.65107219572578
5399,0.5401,4,9,4,666869,9575,108377,17879,0.0758379799771892,0.6512347927442267
5400,0.5402,5,7,5,666876,9568,108382,17874,0.0757825370675453,0.6513373660811894
5401,0.5403,5,6,5,666882,9562,108387,17869,0.07573501457356482,0.651416280850133
5402,0.5404,6,9,6,666891,9553,108393,17863,0.07566373083259409,0.6515538371753721
5403,0.5405,8,10,8,666901,9543,108401,17855,0.07558452667595995,0.6516899043725819
5404,0.5406,12,7,12,666908,9536,108413,17843,0.07552908376631606,0.6517038606231053
5405,0.5407,3,5,3,666913,9531,108416,17840,0.07548948168799899,0.6517847356691389
5406,0.5408,6,9,6,666922,9522,108422,17834,0.07541819794702825,0.6519227957303699
5407,0.5409,6,9,6,666931,9513,108428,17828,0.07534691420605753,0.6520610072784463
5408,0.541,11,2,11,666933,9511,108439,17817,0.0753310733747307,0.6519686768149883
5409,0.5411,9,6,9,666939,9505,108448,17808,0.07528355088075023,0.6519972174422436
5410,0.5412,7,14,7,666953,9491,108455,17801,0.07517266506146243,0.6522424153598124
5411,0.5413,12,4,12,666957,9487,108467,17789,0.07514098339880877,0.6521850711247984
5412,0.5414,10,9,10,666966,9478,108477,17779,0.07506969965783804,0.6522728106541439
5413,0.5415,7,8,7,666974,9470,108484,17772,0.07500633633253073,0.6523750091770061
5414,0.5416,12,5,12,666979,9465,108496,17760,0.07496673425421366,0.6523415977961432
5415,0.5417,10,7,10,666986,9458,108506,17750,0.07491129134456977,0.6523816524551602
5416,0.5418,12,4,12,666990,9454,108518,17738,0.0748796096819161,0.6523242130038247
5417,0.5419,7,9,7,666999,9445,108525,17731,0.07480832594094539,0.6524506917868708
5418,0.542,10,10,10,667009,9435,108535,17721,0.07472912178431124,0.6525629695095007
5419,0.5421,7,6,7,667015,9429,108542,17714,0.07468159929033076,0.6526176178020116
5420,0.5422,6,5,6,667020,9424,108548,17708,0.07464199721201369,0.6526610644257703
5421,0.5423,8,5,8,667025,9419,108556,17700,0.07460239513369661,0.6526789335889966
5422,0.5424,6,6,6,667031,9413,108562,17694,0.07455487263971614,0.6527465230383296
5423,0.5425,10,13,10,667044,9400,108572,17684,0.07445190723609175,0.6529316201447349
5424,0.5426,7,6,7,667050,9394,108579,17677,0.07440438474211127,0.6529865908167412
5425,0.5427,10,9,10,667059,9385,108589,17667,0.07433310100114054,0.6530755581842378
5426,0.5428,7,5,7,667064,9380,108596,17660,0.07429349892282347,0.6531065088757396
5427,0.5429,2,8,2,667072,9372,108598,17658,0.07423013559751616,0.6532741398446171
5428,0.543,6,7,6,667079,9365,108604,17652,0.07417469268787226,0.6533663989340045
5429,0.5431,11,7,11,667086,9358,108615,17641,0.07411924977822835,0.6533945701692655
5430,0.5432,9,7,9,667093,9351,108624,17632,0.07406380686858446,0.6534484675536449
5431,0.5433,6,7,6,667100,9344,108630,17626,0.07400836395894056,0.653540971449759
5432,0.5434,6,8,6,667108,9336,108636,17620,0.07394500063363325,0.6536578127318593
5433,0.5435,7,3,7,667111,9333,108643,17613,0.07392123938664301,0.6536406145624583
5434,0.5436,6,8,6,667119,9325,108649,17607,0.0738578760613357,0.6537576117629585
5435,0.5437,6,5,6,667124,9320,108655,17601,0.07381827398301863,0.653801864715278
5436,0.5438,9,9,9,667133,9311,108664,17592,0.07374699024204791,0.6539047689848716
5437,0.5439,4,11,4,667144,9300,108668,17588,0.07365986566975034,0.6541207973817317
5438,0.544,6,11,6,667155,9289,108674,17582,0.07357274109745279,0.6543113393621376
5439,0.5441,9,3,9,667158,9286,108683,17573,0.07354897985046255,0.6542685878104174
5440,0.5442,10,6,10,667164,9280,108693,17563,0.07350145735648207,0.6542860336028015
5441,0.5443,5,9,5,667173,9271,108698,17558,0.07343017361551134,0.6544410898654441
5442,0.5444,5,4,5,667177,9267,108703,17553,0.07339849195285769,0.6544742729306487
5443,0.5445,11,5,11,667182,9262,108714,17542,0.07335888987454062,0.6544545590210417
5444,0.5446,7,3,7,667185,9259,108721,17535,0.07333512862755037,0.6544375606479063
5445,0.5447,9,3,9,667188,9256,108730,17526,0.07331136738056013,0.6543947427376596
5446,0.5448,10,4,10,667192,9252,108740,17516,0.07327968571790648,0.6543634190077705
5447,0.5449,5,3,5,667195,9249,108745,17511,0.07325592447091624,0.6543721973094171
5448,0.545,10,11,10,667206,9238,108755,17501,0.07316879989861869,0.6545121358315569
5449,0.5451,13,4,13,667210,9234,108768,17488,0.07313711823596503,0.6544420327819774
5450,0.5452,6,6,6,667216,9228,108774,17482,0.07308959574198454,0.6545114189442156
5451,0.5453,5,6,5,667222,9222,108779,17477,0.07304207324800406,0.6545938050114236
5452,0.5454,9,5,9,667227,9217,108788,17468,0.07300247116968699,0.6545999625257636
5453,0.5455,7,10,7,667237,9207,108795,17461,0.07292326701305285,0.6547547622618869
5454,0.5456,9,9,9,667246,9198,108804,17452,0.07285198327208212,0.654859287054409
5455,0.5457,10,9,10,667255,9189,108814,17442,0.0727806995311114,0.654950996958432
5456,0.5458,5,8,5,667263,9181,108819,17437,0.07271733620580408,0.6550830265234052
5457,0.5459,11,10,11,667273,9171,108830,17426,0.07263813204916994,0.655186675188931
5458,0.546,8,4,8,667277,9167,108838,17418,0.07260645038651628,0.6551814933233027
5459,0.5461,8,3,8,667280,9164,108846,17410,0.07258268913952604,0.6551516519906676
5460,0.5462,5,4,5,667284,9160,108851,17405,0.07255100747687239,0.6551853943158291
5461,0.5463,4,4,4,667288,9156,108855,17401,0.07251932581421873,0.6552321421847347
5462,0.5464,17,6,17,667294,9150,108872,17384,0.07247180332023824,0.6551594181050727
5463,0.5465,8,6,8,667300,9144,108880,17376,0.07242428082625776,0.6552036199095023
5464,0.5466,9,5,9,667305,9139,108889,17367,0.07238467874794069,0.6552101411001283
5465,0.5467,8,5,8,667310,9134,108897,17359,0.07234507666962363,0.6552296833125731
5466,0.5468,7,4,7,667314,9130,108904,17352,0.07231339500696997,0.6552375198247866
5467,0.5469,6,7,6,667321,9123,108910,17346,0.07225795209732606,0.6553326532925309
5468,0.547,12,6,12,667327,9117,108922,17334,0.07221042960334559,0.6553249404559374
5469,0.5471,7,5,7,667332,9112,108929,17327,0.07217082752502851,0.6553576156435569
5470,0.5472,8,3,8,667335,9109,108937,17319,0.07214706627803827,0.6553276827607083
5471,0.5473,7,7,7,667342,9102,108944,17312,0.07209162336839438,0.6554100098432649
5472,0.5474,9,8,9,667350,9094,108953,17303,0.07202826004308706,0.6554911542978369
5473,0.5475,4,6,4,667356,9088,108957,17299,0.07198073754910658,0.6555879789290181
5474,0.5476,7,11,7,667367,9077,108964,17292,0.07189361297680902,0.6557700329932876
5475,0.5477,6,8,6,667375,9069,108970,17286,0.07183024965150171,0.6558907228229938
5476,0.5478,5,6,5,667381,9063,108975,17281,0.07178272715752122,0.6559747950197389
5477,0.5479,3,9,3,667390,9054,108978,17278,0.0717114434165505,0.6561598055597752
5478,0.548,8,6,8,667396,9048,108986,17270,0.07166392092257001,0.6562048787901816
5479,0.5481,8,10,8,667406,9038,108994,17262,0.07158471676593588,0.6563498098859316
5480,0.5482,12,8,12,667414,9030,109006,17250,0.07152135344062856,0.656392694063927
5481,0.5483,5,3,5,667417,9027,109011,17245,0.07149759219363833,0.6564022533495737
5482,0.5484,10,5,10,667422,9022,109021,17235,0.07145799011532125,0.6563963895342194
5483,0.5485,7,4,7,667426,9018,109028,17228,0.07142630845266759,0.6564047854911225
5484,0.5486,8,5,8,667431,9013,109036,17220,0.07138670637435053,0.6564251134067777
5485,0.5487,7,10,7,667441,9003,109043,17213,0.07130750221771638,0.6565837656393042
5486,0.5488,7,4,7,667445,8999,109050,17206,0.07127582055506274,0.6565922533867583
5487,0.5489,7,3,7,667448,8996,109057,17199,0.07125205930807249,0.656575682382134
5488,0.549,8,10,8,667458,8986,109065,17191,0.07117285515143834,0.6567215494518088
5489,0.5491,4,8,4,667466,8978,109069,17187,0.07110949182613104,0.6568698643225683
5490,0.5492,8,3,8,667469,8975,109077,17179,0.07108573057914079,0.6568402538808595
5491,0.5493,11,12,11,667481,8963,109088,17168,0.07099068559117983,0.6569974359955608
5492,0.5494,8,9,8,667490,8954,109096,17160,0.0709194018502091,0.6571187868576243
5493,0.5495,4,5,4,667495,8949,109100,17156,0.07087979977189203,0.6571921087914193
5494,0.5496,12,7,12,667502,8942,109112,17144,0.07082435686224813,0.6572107643946945
5495,0.5497,4,6,4,667508,8936,109116,17140,0.07077683436826765,0.657309403282712
5496,0.5498,6,5,6,667513,8931,109122,17134,0.07073723228995057,0.657356608478803
5497,0.5499,6,8,6,667521,8923,109128,17128,0.07067386896464327,0.6574795593259376
5498,0.55,8,10,8,667531,8913,109136,17120,0.07059466480800912,0.657626858218415
5499,0.5501,10,10,10,667541,8903,109146,17110,0.07051546065137498,0.6577480490523969
5500,0.5502,4,6,4,667547,8897,109150,17106,0.0704679381573945,0.6578471714802138
5501,0.5503,5,4,5,667551,8893,109155,17101,0.07043625649474085,0.6578825882896053
5502,0.5504,11,6,11,667557,8887,109166,17090,0.07038873400076036,0.657889671632598
5503,0.5505,7,2,7,667559,8885,109173,17083,0.07037289316943353,0.6578481207640172
5504,0.5506,4,8,4,667567,8877,109177,17079,0.07030952984412622,0.6579981507165973
5505,0.5507,9,2,9,667569,8875,109186,17070,0.07029368901279939,0.6579302370398921
5506,0.5508,7,5,7,667574,8870,109193,17063,0.07025408693448232,0.6579647553310454
5507,0.5509,13,7,13,667581,8863,109206,17050,0.07019864402483843,0.6579709026357426
5508,0.551,10,4,10,667585,8859,109216,17040,0.07016696236218477,0.657940461021661
5509,0.5511,6,8,6,667593,8851,109222,17034,0.07010359903687746,0.6580645161290323
5510,0.5512,10,12,10,667605,8839,109232,17024,0.07000855404891648,0.6582376367784093
5511,0.5513,6,10,6,667615,8829,109238,17018,0.06992934989228235,0.658412968623051
5512,0.5514,7,7,7,667622,8822,109245,17011,0.06987390698263844,0.6584988193396044
5513,0.5515,4,6,4,667628,8816,109249,17007,0.06982638448865797,0.6585989234403439
5514,0.5516,11,5,11,667633,8811,109260,16996,0.06978678241034089,0.6585810051536405
5515,0.5517,7,8,7,667641,8803,109267,16989,0.06972341908503359,0.658692617866005
5516,0.5518,7,10,7,667651,8793,109274,16982,0.06964421492839944,0.6588554801163918
5517,0.5519,11,6,11,667657,8787,109285,16971,0.06959669243441896,0.6588632657815048
5518,0.552,4,8,4,667665,8779,109289,16967,0.06953332910911164,0.6590149926202129
5519,0.5521,9,8,9,667673,8771,109298,16958,0.06946996578380434,0.6591006257530413
5520,0.5522,9,9,9,667682,8762,109307,16949,0.0693986820428336,0.6592120104235542
5521,0.5523,9,5,9,667687,8757,109316,16940,0.06935907996451654,0.6592209207300463
5522,0.5524,14,10,14,667697,8747,109330,16926,0.0692798758078824,0.6592918630467807
5523,0.5525,4,7,4,667704,8740,109334,16922,0.0692244328982385,0.6594185955888083
5524,0.5526,1,4,1,667708,8736,109335,16921,0.06919275123558484,0.6595081264372296
5525,0.5527,5,5,5,667713,8731,109340,16916,0.06915314915726778,0.6595703201154131
5526,0.5528,16,13,16,667726,8718,109356,16900,0.06905018375364338,0.6596924037785932
5527,0.5529,9,6,9,667732,8712,109365,16891,0.06900266125966291,0.6597273756981604
5528,0.553,7,7,7,667739,8705,109372,16884,0.068947218350019,0.6598147641564734
5529,0.5531,10,5,10,667744,8700,109382,16874,0.06890761627170194,0.6598107452881833
5530,0.5532,8,3,8,667747,8697,109390,16866,0.0688838550247117,0.6597817157610609
5531,0.5533,9,2,9,667749,8695,109399,16857,0.06886801419338487,0.6597135253600501
5532,0.5534,8,4,8,667753,8691,109407,16849,0.06883633253073121,0.6597102584181675
5533,0.5535,7,5,7,667758,8686,109414,16842,0.06879673045241415,0.659746161078032
5534,0.5536,8,5,8,667763,8681,109422,16834,0.06875712837409707,0.6597687634724672
5535,0.5537,10,6,10,667769,8675,109432,16824,0.06870960588011658,0.659790580022746
5536,0.5538,11,6,11,667775,8669,109443,16813,0.06866208338613611,0.6597990738560553
5537,0.5539,8,5,8,667780,8664,109451,16805,0.06862248130781903,0.6598217440810397
5538,0.554,12,6,12,667786,8658,109463,16793,0.06857495881383854,0.6598169030686417
5539,0.5541,6,6,6,667792,8652,109469,16787,0.06852743631985807,0.6598922913636542
5540,0.5542,6,0,6,667792,8652,109475,16781,0.06852743631985807,0.659812055203869
5541,0.5543,6,5,6,667797,8647,109481,16775,0.06848783424154099,0.6598615372511998
5542,0.5544,8,7,8,667804,8640,109489,16767,0.0684323913318971,0.6599362380446334
5543,0.5545,7,2,7,667806,8638,109496,16760,0.06841655050057027,0.6598944798803056
5544,0.5546,7,9,7,667815,8629,109503,16753,0.06834526675959954,0.6600346702387518
5545,0.5547,9,6,9,667821,8623,109512,16744,0.06829774426561906,0.6600701699057832
5546,0.5548,10,7,10,667828,8616,109522,16734,0.06824230135597516,0.6601183431952663
5547,0.5549,10,4,10,667832,8612,109532,16724,0.06821061969332151,0.660088411746132
5548,0.555,5,2,5,667834,8610,109537,16719,0.06819477886199468,0.6600734336136445
5549,0.5551,8,2,8,667836,8608,109545,16711,0.06817893803066785,0.6600181681740985
5550,0.5552,14,1,14,667837,8607,109559,16697,0.06817101761500444,0.6598561492254189
5551,0.5553,4,4,4,667841,8603,109563,16693,0.06813933595235078,0.6599067046173308
5552,0.5554,6,5,6,667846,8598,109569,16687,0.06809973387403372,0.6599564959462132
5553,0.5555,13,6,13,667852,8592,109582,16674,0.06805221138005323,0.6599382569460935
5554,0.5556,6,4,6,667856,8588,109588,16668,0.06802052971739957,0.6599619892302819
5555,0.5557,7,9,7,667865,8579,109595,16661,0.06794924597642885,0.6601030110935023
5556,0.5558,6,9,6,667874,8570,109601,16655,0.06787796223545811,0.6602576808721506
5557,0.5559,8,10,8,667884,8560,109609,16647,0.06779875807882398,0.6604117903756893
5558,0.556,5,1,5,667885,8559,109614,16642,0.06779083766316056,0.6603706202134836
5559,0.5561,9,7,9,667892,8552,109623,16633,0.06773539475351667,0.6604327972999802
5560,0.5562,7,6,7,667898,8546,109630,16626,0.06768787225953618,0.6604957889718736
5561,0.5563,9,10,9,667908,8536,109639,16617,0.06760866810290204,0.6606369021587882
5562,0.5564,6,3,6,667911,8533,109645,16611,0.0675849068559118,0.6606347438752784
5563,0.5565,9,8,9,667919,8525,109654,16602,0.06752154353060448,0.6607235244955626
5564,0.5566,8,10,8,667929,8515,109662,16594,0.06744233937397034,0.6608785694372535
5565,0.5567,7,2,7,667931,8513,109669,16587,0.06742649854264351,0.6608366533864541
5566,0.5568,10,7,10,667938,8506,109679,16577,0.06737105563299962,0.6608858589482917
5567,0.5569,4,3,4,667941,8503,109683,16573,0.06734729438600938,0.6609108310735364
5568,0.557,6,10,6,667951,8493,109689,16567,0.06726809022937524,0.6610933758978452
5569,0.5571,8,3,8,667954,8490,109697,16559,0.067244328982385,0.6610643139446685
5570,0.5572,4,4,4,667958,8486,109701,16555,0.06721264731973134,0.6611157701369753
5571,0.5573,13,4,13,667962,8482,109714,16542,0.06718096565707768,0.6610453964194374
5572,0.5574,6,4,6,667966,8478,109720,16536,0.06714928399442403,0.6610698009114896
5573,0.5575,4,4,4,667970,8474,109724,16532,0.06711760233177037,0.6611213308805887
5574,0.5576,8,7,8,667977,8467,109732,16524,0.06706215942212647,0.6611980312912649
5575,0.5577,12,11,12,667988,8456,109744,16512,0.06697503484982892,0.6613264979173342
5576,0.5578,8,4,8,667992,8452,109752,16504,0.06694335318717526,0.661323930117006
5577,0.5579,11,3,11,667995,8449,109763,16493,0.06691959194018503,0.6612541095341191
5578,0.558,5,8,5,668003,8441,109768,16488,0.06685622861487771,0.6613983713747041
5579,0.5581,8,3,8,668006,8438,109776,16480,0.06683246736788746,0.6613692912753832
5580,0.5582,9,6,9,668012,8432,109785,16471,0.06678494487390699,0.6614062562743445
5581,0.5583,7,11,7,668023,8421,109792,16464,0.06669782030160942,0.6616033755274262
5582,0.5584,6,7,6,668030,8414,109798,16458,0.06664237739196553,0.661707944676745
5583,0.5585,7,5,7,668035,8409,109805,16451,0.06660277531364846,0.6617457763475463
5584,0.5586,2,6,2,668041,8403,109807,16449,0.06655525281966798,0.6618783196523419
5585,0.5587,3,9,3,668050,8394,109810,16446,0.06648396907869725,0.6620772946859903
5586,0.5588,8,4,8,668054,8390,109818,16438,0.06645228741604359,0.6620750765265023
5587,0.5589,10,6,10,668060,8384,109828,16428,0.06640476492206311,0.6620989843624053
5588,0.559,6,4,6,668064,8380,109834,16422,0.06637308325940945,0.6621240222562697
5589,0.5591,7,5,7,668069,8375,109841,16415,0.06633348118109238,0.6621621621621622
5590,0.5592,7,8,7,668077,8367,109848,16408,0.06627011785578507,0.6622805247225025
5591,0.5593,8,6,8,668083,8361,109856,16400,0.06622259536180458,0.6623318928960866
5592,0.5594,6,5,6,668088,8356,109862,16394,0.06618299328348752,0.6623838383838384
5593,0.5595,12,6,12,668094,8350,109874,16382,0.06613547078950703,0.6623807213326864
5594,0.5596,4,10,4,668104,8340,109878,16378,0.0660562666328729,0.6625940610081722
5595,0.5597,10,8,10,668112,8332,109888,16368,0.06599290330756558,0.662672064777328
5596,0.5598,10,4,10,668116,8328,109898,16358,0.06596122164491193,0.6626427934861865
5597,0.5599,6,6,6,668122,8322,109904,16352,0.06591369915093144,0.6627218934911243
5598,0.56,5,5,5,668127,8317,109909,16347,0.06587409707261437,0.6627878689588064
5599,0.5601,5,8,5,668135,8309,109914,16342,0.06581073374730706,0.6629345665490244
5600,0.5602,12,8,12,668143,8301,109926,16330,0.06574737042199974,0.6629856684665665
5601,0.5603,10,7,10,668150,8294,109936,16320,0.06569192751235585,0.6630372958478914
5602,0.5604,8,6,8,668156,8288,109944,16312,0.06564440501837536,0.6630894308943089
5603,0.5605,6,5,6,668161,8283,109950,16306,0.0656048029400583,0.6631420553906219
5604,0.5606,9,2,9,668163,8281,109959,16297,0.06558896210873147,0.6630726666124176
5605,0.5607,6,9,6,668172,8272,109965,16291,0.06551767836776073,0.6632333184057322
5606,0.5608,15,7,15,668179,8265,109980,16276,0.06546223545811684,0.663216657837904
5607,0.5609,6,6,6,668185,8259,109986,16270,0.06541471296413635,0.6632965061763627
5608,0.561,5,9,5,668194,8250,109991,16265,0.06534342922316563,0.663471344075056
5609,0.5611,8,5,8,668199,8245,109999,16257,0.06530382714484856,0.663496857399396
5610,0.5612,5,7,5,668206,8238,110004,16252,0.06524838423520467,0.6636178031849734
5611,0.5613,10,4,10,668210,8234,110014,16242,0.06521670257255101,0.6635888217028927
5612,0.5614,7,2,7,668212,8232,110021,16235,0.06520086174122418,0.6635468181632402
5613,0.5615,4,7,4,668219,8225,110025,16231,0.06514541883158029,0.6636817140987896
5614,0.5616,9,7,9,668226,8218,110034,16222,0.06508997592193638,0.6637479541734861
5615,0.5617,9,6,9,668232,8212,110043,16213,0.06504245342795589,0.6637871033776868
5616,0.5618,6,10,6,668242,8202,110049,16207,0.06496324927132176,0.6639764021467491
5617,0.5619,12,7,12,668249,8195,110061,16195,0.06490780636167787,0.6640016400164002
5618,0.562,7,5,7,668254,8190,110068,16188,0.06486820428336079,0.6640413487570761
5619,0.5621,4,5,4,668259,8185,110072,16184,0.06482860220504372,0.6641224506545201
5620,0.5622,12,7,12,668266,8178,110084,16172,0.06477315929539983,0.6641478439425051
5621,0.5623,7,6,7,668272,8172,110091,16165,0.06472563680141934,0.664214981304187
5622,0.5624,3,7,3,668279,8165,110094,16162,0.06467019389177545,0.664364697661035
5623,0.5625,5,6,5,668285,8159,110099,16157,0.06462267139779496,0.6644596150682678
5624,0.5626,9,4,9,668289,8155,110108,16148,0.0645909897351413,0.6644447187590009
5625,0.5627,9,5,9,668294,8150,110117,16139,0.06455138765682424,0.6644571616781259
5626,0.5628,4,8,4,668302,8142,110121,16135,0.06448802433151692,0.6646208345347449
5627,0.5629,8,9,8,668311,8133,110129,16127,0.0644167405905462,0.6647568013190437
5628,0.563,8,12,8,668323,8121,110137,16119,0.06432169560258523,0.6649752475247525
5629,0.5631,3,5,3,668328,8116,110140,16116,0.06428209352426816,0.6650709805216243
5630,0.5632,9,9,9,668337,8107,110149,16107,0.06421080978329742,0.6651936896010573
5631,0.5633,10,10,10,668347,8097,110159,16097,0.06413160562666329,0.6653302471687195
5632,0.5634,5,3,5,668350,8094,110164,16092,0.06410784437967304,0.6653435871992062
5633,0.5635,8,10,8,668360,8084,110172,16084,0.0640286402230389,0.665508109897385
5634,0.5636,7,6,7,668366,8078,110179,16077,0.06398111772905841,0.6655764851997517
5635,0.5637,7,9,7,668375,8069,110186,16070,0.0639098339880877,0.665727660632172
5636,0.5638,4,3,4,668378,8066,110190,16066,0.06388607274109745,0.6657550140891761
5637,0.5639,9,6,9,668384,8060,110199,16057,0.06383855024711697,0.6657959115976282
5638,0.564,5,6,5,668390,8054,110204,16052,0.06379102775313648,0.6658923089687214
5639,0.5641,11,6,11,668396,8048,110215,16041,0.063743505259156,0.6659056000664204
5640,0.5642,6,6,6,668402,8042,110221,16035,0.06369598276517552,0.665988287577356
5641,0.5643,12,4,12,668406,8038,110233,16023,0.06366430110252186,0.6659324217613566
5642,0.5644,3,2,3,668408,8036,110236,16020,0.06364846027119503,0.6659461257066844
5643,0.5645,7,2,7,668410,8034,110243,16013,0.0636326194398682,0.6659042708030107
5644,0.5646,6,6,6,668416,8028,110249,16007,0.06358509694588772,0.6659871021427085
5645,0.5647,7,5,7,668421,8023,110256,16000,0.06354549486757065,0.6660283894601008
5646,0.5648,10,7,10,668428,8016,110266,15990,0.06349005195792676,0.6660834791302175
5647,0.5649,4,4,4,668432,8012,110270,15986,0.0634583702952731,0.666138844903742
5648,0.565,9,4,9,668436,8008,110279,15977,0.06342668863261944,0.6661246612466125
5649,0.5651,11,3,11,668439,8005,110290,15966,0.06340292738562919,0.6660548162362855
5650,0.5652,7,7,7,668446,7998,110297,15959,0.0633474844759853,0.6661518554076052
5651,0.5653,5,6,5,668452,7992,110302,15954,0.06329996198200481,0.6662490603858682
5652,0.5654,5,7,5,668459,7985,110307,15949,0.06324451907236092,0.666374195704855
5653,0.5655,7,6,7,668465,7979,110314,15942,0.06319699657838043,0.666443710547218
5654,0.5656,2,6,2,668471,7973,110316,15940,0.06314947408439994,0.6665830301509639
5655,0.5657,6,7,6,668478,7966,110322,15934,0.06309403117475605,0.6666945606694561
5656,0.5658,5,10,5,668488,7956,110327,15929,0.06301482701812192,0.6669039145907474
5657,0.5659,12,2,12,668490,7954,110339,15917,0.06299898618679509,0.6667923421725106
5658,0.566,8,8,8,668498,7946,110347,15909,0.06293562286148777,0.6669042129532593
5659,0.5661,5,5,5,668503,7941,110352,15904,0.0628960207831707,0.6669742084294401
5660,0.5662,8,7,8,668510,7934,110360,15896,0.0628405778735268,0.6670583298363407
5661,0.5663,10,9,10,668519,7925,110370,15886,0.06276929413255608,0.667170635420604
5662,0.5664,4,7,4,668526,7918,110374,15882,0.06271385122291218,0.6673109243697479
5663,0.5665,8,5,8,668531,7913,110382,15874,0.06267424914459511,0.6673393029806197
5664,0.5666,11,8,11,668539,7905,110393,15863,0.0626108858192878,0.6674099629754291
5665,0.5667,11,3,11,668542,7902,110404,15852,0.06258712457229755,0.6673402374336954
5666,0.5668,9,5,9,668547,7897,110413,15843,0.06254752249398049,0.6673546756529065
5667,0.5669,9,9,9,668556,7888,110422,15834,0.062476238753009755,0.6674816625916871
5668,0.567,5,5,5,668561,7883,110427,15829,0.06243663667469269,0.667552294197031
5669,0.5671,10,7,10,668568,7876,110437,15819,0.06238119376504879,0.667609200253218
5670,0.5672,6,2,6,668570,7874,110443,15813,0.06236535293372196,0.6675813737493139
5671,0.5673,7,1,7,668571,7873,110450,15806,0.062357432518058545,0.667511296929769
5672,0.5674,8,7,8,668578,7866,110458,15798,0.06230198960841465,0.6675963488843814
5673,0.5675,7,8,7,668586,7858,110465,15791,0.062238626283107334,0.6677237938179205
5674,0.5676,8,6,8,668592,7852,110473,15783,0.06219110378912685,0.6677808335096256
5675,0.5677,11,3,11,668595,7849,110484,15772,0.062167342542136614,0.6677109351847932
5676,0.5678,3,6,3,668601,7843,110487,15769,0.062119820048156124,0.6678383872607149
5677,0.5679,8,4,8,668605,7839,110495,15761,0.06208813838550247,0.6678389830508474
5678,0.568,7,3,7,668608,7836,110502,15754,0.062064377138512226,0.6678253497244595
5679,0.5681,3,6,3,668614,7830,110505,15751,0.062016854644531744,0.6679530130189559
5680,0.5682,11,8,11,668622,7822,110516,15740,0.06195349131922443,0.6680247856718445
5681,0.5683,10,8,10,668630,7814,110526,15730,0.06189012799391712,0.6681107713217805
5682,0.5684,16,7,16,668637,7807,110542,15714,0.06183468508427322,0.6680838399727903
5683,0.5685,9,8,9,668645,7799,110551,15705,0.06177132175896591,0.6681841388699796
5684,0.5686,7,5,7,668650,7794,110558,15698,0.06173171968064884,0.6682274816958965
5685,0.5687,9,4,9,668654,7790,110567,15689,0.06170003801799519,0.6682141488138337
5686,0.5688,10,6,10,668660,7784,110577,15679,0.0616525155240147,0.6682436176107062
5687,0.5689,6,5,6,668665,7779,110583,15673,0.06161291344569763,0.6683012109841379
5688,0.569,6,4,6,668669,7775,110589,15667,0.06158123178304398,0.6683303472399966
5689,0.5691,7,3,7,668672,7772,110596,15660,0.06155747053605373,0.6683168316831684
5690,0.5692,8,4,8,668676,7768,110604,15652,0.06152578887340008,0.6683176771989753
5691,0.5693,6,5,6,668681,7763,110610,15646,0.061486186795083005,0.6683754111666453
5692,0.5694,6,2,6,668683,7761,110616,15640,0.061470345963756175,0.6683475065168155
5693,0.5695,6,12,6,668695,7749,110622,15634,0.06137530097579521,0.6686053970833512
5694,0.5696,11,4,11,668699,7745,110633,15623,0.061343619313141556,0.6685638479972612
5695,0.5697,7,2,7,668701,7743,110640,15616,0.061327778481814726,0.6685217689113404
5696,0.5698,5,4,5,668705,7739,110645,15611,0.06129609681916107,0.6685653104925053
5697,0.5699,8,0,8,668705,7739,110653,15603,0.06129609681916107,0.668451717933339
5698,0.57,5,6,5,668711,7733,110658,15598,0.061248574325180584,0.6685525695426685
5699,0.5701,9,3,9,668714,7730,110667,15589,0.061224813078190346,0.668510656546164
5700,0.5702,2,8,2,668722,7722,110669,15587,0.06116144975288303,0.6687116564417178
5701,0.5703,8,9,8,668731,7713,110677,15579,0.061090166011912306,0.6688562596599691
5702,0.5704,5,1,5,668732,7712,110682,15574,0.06108224559624889,0.6688138795842996
5703,0.5705,6,4,6,668736,7708,110688,15568,0.06105056393359524,0.6688434438907028
5704,0.5706,5,5,5,668741,7703,110693,15563,0.06101096185527816,0.668916014785524
5705,0.5707,3,4,3,668745,7699,110696,15560,0.06097928019262451,0.6689883485962423
5706,0.5708,6,5,6,668750,7694,110702,15554,0.060939678114307436,0.6690467997247075
5707,0.5709,9,3,9,668753,7691,110711,15545,0.0609159168673172,0.6690049922533999
5708,0.571,7,6,7,668759,7685,110718,15538,0.060868394373336715,0.6690780691555785
5709,0.5711,2,5,2,668764,7680,110720,15536,0.06082879229501964,0.6691936595451413
5710,0.5712,9,2,9,668766,7678,110729,15527,0.06081295146369282,0.6691230338289161
5711,0.5713,8,5,8,668771,7673,110737,15519,0.06077334938537574,0.6691531562607795
5712,0.5714,8,5,8,668776,7668,110745,15511,0.060733747307058675,0.6691833124811252
5713,0.5715,6,4,6,668780,7664,110751,15505,0.060702065644405015,0.6692131727739652
5714,0.5716,10,9,10,668789,7655,110761,15495,0.060630781903434294,0.6693304535637149
5715,0.5717,2,7,2,668796,7648,110763,15493,0.0605753389937904,0.6695043429411002
5716,0.5718,12,7,12,668803,7641,110775,15481,0.0605198960841465,0.6695355073090563
5717,0.5719,8,2,8,668805,7639,110783,15473,0.06050405525281967,0.6694790584977501
5718,0.572,11,8,11,668813,7631,110794,15462,0.060440691927512356,0.669553544364093
5719,0.5721,7,6,7,668819,7625,110801,15455,0.060393169433531874,0.6696273830155979
5720,0.5722,10,5,10,668824,7620,110811,15445,0.0603535673552148,0.669629308476046
5721,0.5723,6,7,6,668831,7613,110817,15439,0.0602981244455709,0.6697466597258372
5722,0.5724,5,6,5,668837,7607,110822,15434,0.06025060195159042,0.6698493988976173
5723,0.5725,9,5,9,668842,7602,110831,15425,0.06021099987327335,0.6698658097016545
5724,0.5726,6,6,6,668848,7596,110837,15419,0.06016347737929287,0.6699543775798392
5725,0.5727,7,2,7,668850,7594,110844,15412,0.06014763654796604,0.6699121968182213
5726,0.5728,3,6,3,668856,7588,110847,15409,0.060100114053985555,0.6700439187720137
5727,0.5729,6,6,6,668862,7582,110853,15403,0.06005259156000507,0.6701326952360235
5728,0.573,2,4,2,668866,7578,110855,15401,0.06002090989735141,0.6702206362330824
5729,0.5731,9,4,9,668870,7574,110864,15392,0.05998922823469776,0.670208133762954
5730,0.5732,12,9,12,668879,7565,110876,15380,0.05991794449372703,0.6702985399869252
5731,0.5733,9,9,9,668888,7556,110885,15371,0.059846660752756305,0.6704322414620316
5732,0.5734,5,4,5,668892,7552,110890,15366,0.05981497909010265,0.6704773540448555
5733,0.5735,9,4,9,668896,7548,110899,15357,0.05978329742744899,0.6704649639816634
5734,0.5736,3,6,3,668902,7542,110902,15354,0.05973577493346851,0.6705974842767296
5735,0.5737,8,6,8,668908,7536,110910,15346,0.059688252439488027,0.6706581592518136
5736,0.5738,10,5,10,668913,7531,110920,15336,0.05964865036117095,0.670660777539686
5737,0.5739,4,2,4,668915,7529,110924,15332,0.05963280952984413,0.6706618258168934
5738,0.574,2,4,2,668919,7525,110926,15330,0.05960112786719047,0.6707503828483921
5739,0.5741,7,5,7,668924,7520,110933,15323,0.0595615257888734,0.670796305213851
5740,0.5742,3,8,3,668932,7512,110936,15320,0.05949816246356609,0.6709880868955851
5741,0.5743,4,2,4,668934,7510,110940,15316,0.05948232163223926,0.670989222816087
5742,0.5744,6,7,6,668941,7503,110946,15310,0.05942687872259536,0.6711085784421164
5743,0.5745,3,8,3,668949,7495,110949,15307,0.05936351539728805,0.671300763090957
5744,0.5746,5,9,5,668958,7486,110954,15302,0.05929223165631732,0.6714937686501667
5745,0.5747,5,2,5,668960,7484,110959,15297,0.0592763908249905,0.6714806198147579
5746,0.5748,10,5,10,668965,7479,110969,15287,0.05923678874667342,0.6714837916190811
5747,0.5749,5,5,5,668970,7474,110974,15282,0.059197186668356355,0.6715591492353665
5748,0.575,3,4,3,668974,7470,110977,15279,0.0591655050057027,0.6716339179744164
5749,0.5751,10,10,10,668984,7460,110987,15269,0.05908630084906856,0.6717849443442299
5750,0.5752,7,7,7,668991,7453,110994,15262,0.05903085793942466,0.6718908210433634
5751,0.5753,6,4,6,668995,7449,111000,15256,0.058999176276771,0.6719224840343536
5752,0.5754,7,3,7,668998,7446,111007,15249,0.058975415029780764,0.6719101123595506
5753,0.5755,7,5,7,669003,7441,111014,15242,0.05893581295146369,0.6719569721818102
5754,0.5756,9,2,9,669005,7439,111023,15233,0.05891997212013687,0.6718860268172194
5755,0.5757,2,5,2,669010,7434,111025,15231,0.05888037004181979,0.672005294506949
5756,0.5758,7,7,7,669017,7427,111032,15224,0.058824927132175894,0.6721116065515871
5757,0.5759,11,6,11,669023,7421,111043,15213,0.05877740463819541,0.672130423257047
5758,0.576,7,5,7,669028,7416,111050,15206,0.058737802559878344,0.67217752630183
5759,0.5761,9,7,9,669035,7409,111059,15197,0.058682359650234446,0.6722551534990711
5760,0.5762,8,7,8,669042,7402,111067,15189,0.05862691674059055,0.6723473949803019
5761,0.5763,13,9,13,669051,7393,111080,15176,0.05855563299961982,0.6724267800965926
5762,0.5764,7,4,7,669055,7389,111087,15169,0.05852395133696616,0.6724443656352513
5763,0.5765,6,7,6,669062,7382,111093,15163,0.05846850842732226,0.6725659791528055
5764,0.5766,6,4,6,669066,7378,111099,15157,0.05843682676466861,0.6725981806079432
5765,0.5767,6,7,6,669073,7371,111105,15151,0.05838138385502471,0.6727200071041648
5766,0.5768,3,5,3,669078,7366,111108,15148,0.058341781776707645,0.6728257972816913
5767,0.5769,7,3,7,669081,7363,111115,15141,0.0583180205297174,0.6728137220049769
5768,0.577,10,3,10,669084,7360,111125,15131,0.058294259282727155,0.6727579920857232
5769,0.5771,8,8,8,669092,7352,111133,15123,0.05823089595741984,0.672880978865406
5770,0.5772,7,5,7,669097,7347,111140,15116,0.058191293879102775,0.6729288162756533
5771,0.5773,7,0,7,669097,7347,111147,15109,0.058191293879102775,0.6728268614178838
5772,0.5774,4,3,4,669100,7344,111151,15105,0.05816753263211253,0.6728584792195643
5773,0.5775,3,5,3,669105,7339,111154,15102,0.05812793055379546,0.6729646628938104
5774,0.5776,8,4,8,669109,7335,111162,15094,0.05809624889114181,0.6729680324579785
5775,0.5777,9,2,9,669111,7333,111171,15085,0.05808040805981498,0.6728967793737175
5776,0.5778,3,7,3,669118,7326,111174,15082,0.05802496515017108,0.6730631917172438
5777,0.5779,8,3,8,669121,7323,111182,15074,0.05800120390318084,0.6730365673974193
5778,0.578,4,6,4,669127,7317,111186,15070,0.057953681409200354,0.6731585295037299
5779,0.5781,5,6,5,669133,7311,111191,15065,0.05790615891521987,0.6732659992849481
5780,0.5782,4,10,4,669143,7301,111195,15061,0.05782695475858573,0.6735086307128164
5781,0.5783,5,5,5,669148,7296,111200,15056,0.05778735268026866,0.6735862562634216
5782,0.5784,11,5,11,669153,7291,111211,15045,0.05774775060195159,0.6735762893982808
5783,0.5785,9,5,9,669158,7286,111220,15036,0.05770814852363452,0.6735955559537676
5784,0.5786,6,6,6,669164,7280,111226,15030,0.057660626029654036,0.6736889287315105
5785,0.5787,7,2,7,669166,7278,111233,15023,0.057644785198327206,0.6736469216627057
5786,0.5788,3,8,3,669174,7270,111236,15020,0.05758142187301989,0.6738447734410049
5787,0.5789,7,5,7,669179,7265,111243,15013,0.057541819794702825,0.673893527246611
5788,0.579,11,1,11,669180,7264,111254,15002,0.05753389937903941,0.673762687505614
5789,0.5791,6,2,6,669182,7262,111260,14996,0.05751805854771258,0.6737352861892353
5790,0.5792,6,7,6,669189,7255,111266,14990,0.05746261563806868,0.673859294223421
5791,0.5793,10,6,10,669195,7249,111276,14980,0.0574150931440882,0.6738944621890324
5792,0.5794,6,3,6,669198,7246,111282,14974,0.05739133189709796,0.673897389738974
5793,0.5795,5,5,5,669203,7241,111287,14969,0.05735172981878089,0.6739756866276452
5794,0.5796,2,7,2,669210,7234,111289,14967,0.05729628690913699,0.6741588216746993
5795,0.5797,6,8,6,669218,7226,111295,14961,0.05723292358382968,0.6743137873529544
5796,0.5798,6,3,6,669221,7223,111301,14955,0.05720916233683944,0.6743168906123185
5797,0.5799,5,3,5,669224,7220,111306,14950,0.057185401089849194,0.6743346865133063
5798,0.58,4,4,4,669228,7216,111310,14946,0.05715371942719554,0.674397617543543
5799,0.5801,11,3,11,669231,7213,111321,14935,0.0571299581802053,0.6743272530251039
5800,0.5802,9,3,9,669234,7210,111330,14926,0.05710619693321505,0.6742862305746296
5801,0.5803,4,8,4,669242,7202,111334,14922,0.057042833607907746,0.6744711625384198
5802,0.5804,6,4,6,669246,7198,111340,14916,0.057011151945254086,0.6745048385638057
5803,0.5805,4,3,4,669249,7195,111344,14912,0.05698739069826384,0.6745374768172977
5804,0.5806,5,4,5,669253,7191,111349,14907,0.05695570903561019,0.6745859353787673
5805,0.5807,8,2,8,669255,7189,111357,14899,0.05693986820428336,0.6745291561028612
5806,0.5808,7,4,7,669259,7185,111364,14892,0.056908186541629706,0.6745481723060198
5807,0.5809,4,7,4,669266,7178,111368,14888,0.05685274363198581,0.6747031632375601
5808,0.581,7,5,7,669271,7173,111375,14881,0.05681314155366873,0.6747528792962728
5809,0.5811,10,4,10,669275,7169,111385,14871,0.05678145989101508,0.6747277676950998
5810,0.5812,4,5,4,669280,7164,111389,14867,0.05674185781269801,0.6748218419499796
5811,0.5813,5,3,5,669283,7161,111394,14862,0.05671809656570777,0.6748399400626618
5812,0.5814,3,5,3,669288,7156,111397,14859,0.0566784944873907,0.6749488984783102
5813,0.5815,8,4,8,669292,7152,111405,14851,0.05664681282473704,0.6749534154433486
5814,0.5816,11,5,11,669297,7147,111416,14840,0.05660721074641997,0.6749442852594715
5815,0.5817,7,6,7,669303,7141,111423,14833,0.05655968825243949,0.6750250295804132
5816,0.5818,9,7,9,669310,7134,111432,14824,0.05650424534279559,0.6751070224974952
5817,0.5819,7,5,7,669315,7129,111439,14817,0.05646464326447852,0.6751572040462954
5818,0.582,6,3,6,669318,7126,111445,14811,0.05644088201748828,0.6751606874230752
5819,0.5821,7,2,7,669320,7124,111452,14804,0.05642504118616145,0.6751185698650127
5820,0.5822,4,4,4,669324,7120,111456,14800,0.0563933595235078,0.6751824817518248
5821,0.5823,5,2,5,669326,7118,111461,14795,0.05637751869218097,0.6751699904166476
5822,0.5824,11,8,11,669334,7110,111472,14784,0.056314155366873654,0.6752534941079747
5823,0.5825,5,8,5,669342,7102,111477,14779,0.05625079204156634,0.6754261688222659
5824,0.5826,8,7,8,669349,7095,111485,14771,0.056195349131922444,0.675523644013537
5825,0.5827,8,2,8,669351,7093,111493,14763,0.056179508300595614,0.6754666910688141
5826,0.5828,7,5,7,669356,7088,111500,14756,0.056139906222278546,0.6755173045229811
5827,0.5829,5,3,5,669359,7085,111505,14751,0.0561161449752883,0.6755358124198572
5828,0.583,6,3,6,669362,7082,111511,14745,0.05609238372829806,0.6755394694644248
5829,0.5831,6,4,6,669366,7078,111517,14739,0.056060702065644404,0.6755740935967365
5830,0.5832,7,4,7,669370,7074,111524,14732,0.05602902040299075,0.6755938732458956
5831,0.5833,5,6,5,669376,7068,111529,14727,0.05598149790901027,0.675705437026841
5832,0.5834,7,3,7,669379,7065,111536,14720,0.05595773666202002,0.6756942850585265
5833,0.5835,6,5,6,669384,7060,111542,14714,0.055918134583702955,0.6757600808303481
5834,0.5836,2,6,2,669390,7054,111544,14712,0.055870612089722466,0.6759165671230359
5835,0.5837,6,7,6,669397,7047,111550,14706,0.05581516918007857,0.6760446834919321
5836,0.5838,7,4,7,669401,7043,111557,14699,0.055783487517424915,0.6760647594517524
5837,0.5839,11,7,11,669408,7036,111568,14688,0.05572804460778102,0.6761185785306574
5838,0.584,6,8,6,669416,7028,111574,14682,0.055664681282473705,0.6762782128051589
5839,0.5841,7,5,7,669421,7023,111581,14675,0.05562507920415664,0.6763296156327772
5840,0.5842,5,6,5,669427,7017,111586,14670,0.05557755671017615,0.6764421081754046
5841,0.5843,7,3,7,669430,7014,111593,14663,0.05555379546318591,0.676431240485307
5842,0.5844,9,3,9,669433,7011,111602,14654,0.055530034216195664,0.6763904915762751
5843,0.5845,7,6,7,669439,7005,111609,14647,0.05548251172221518,0.676473305006466
5844,0.5846,6,5,6,669444,7000,111615,14641,0.055442909643898114,0.6765399011136269
5845,0.5847,5,6,5,669450,6994,111620,14636,0.055395387149917624,0.6766527970411466
5846,0.5848,11,8,11,669458,6986,111631,14625,0.05533202382461032,0.6767386978853361
5847,0.5849,6,5,6,669463,6981,111637,14619,0.055292421746293244,0.6768055555555555
5848,0.585,9,2,9,669465,6979,111646,14610,0.05527658091496642,0.6767335217008662
5849,0.5851,8,10,8,669475,6969,111654,14602,0.05519737675833228,0.6769273561726392
5850,0.5852,3,1,3,669476,6968,111657,14599,0.05518945634266886,0.676913803496082
5851,0.5853,2,6,2,669482,6962,111659,14597,0.05514193384868838,0.6770722204183868
5852,0.5854,7,12,7,669494,6950,111666,14590,0.05504688886072741,0.6773444753946146
5853,0.5855,7,4,7,669498,6946,111673,14583,0.055015207198073755,0.6773654140926193
5854,0.5856,7,2,7,669500,6944,111680,14576,0.054999366366746925,0.6773234200743494
5855,0.5857,9,7,9,669507,6937,111689,14567,0.05494392345710303,0.6774088541666666
5856,0.5858,5,8,5,669515,6929,111694,14562,0.054880560131795715,0.677585966218417
5857,0.5859,8,4,8,669519,6925,111702,14554,0.05484887846914206,0.6775920666697705
5858,0.586,8,7,8,669526,6918,111710,14546,0.054793435559498165,0.6776928811032427
5859,0.5861,5,5,5,669531,6913,111715,14541,0.05475383348118109,0.6777757061620211
5860,0.5862,5,5,5,669536,6908,111720,14536,0.05471423140286402,0.6778586084685693
5861,0.5863,4,3,4,669539,6905,111724,14532,0.05469047015587378,0.6778933619443019
5862,0.5864,11,11,11,669550,6894,111735,14521,0.05460334558357623,0.6780761148727528
5863,0.5865,3,5,3,669555,6889,111738,14518,0.05456374350525916,0.6781893773064885
5864,0.5866,8,4,8,669559,6885,111746,14510,0.0545320618426055,0.6781958401495677
5865,0.5867,6,3,6,669562,6882,111752,14504,0.05450830059561526,0.6782006920415224
5866,0.5868,8,3,8,669565,6879,111760,14496,0.054484539348625016,0.6781754385964912
5867,0.5869,5,4,5,669569,6875,111765,14491,0.054452857685971356,0.6782270897687915
5868,0.587,6,6,6,669575,6869,111771,14485,0.054405335191990874,0.6783272454809404
5869,0.5871,6,2,6,669577,6867,111777,14479,0.05438949436066405,0.6783003841469127
5870,0.5872,11,7,11,669584,6860,111788,14468,0.054334051451020146,0.6783570892723181
5871,0.5873,6,7,6,669591,6853,111794,14462,0.05427860854137625,0.6784893267651888
5872,0.5874,9,7,9,669598,6846,111803,14453,0.05422316563173235,0.6785764589886849
5873,0.5875,1,3,1,669601,6843,111804,14452,0.05419940438474211,0.6786569617281052
5874,0.5876,9,5,9,669606,6838,111813,14443,0.05415980230642504,0.6786805131337813
5875,0.5877,9,4,9,669610,6834,111822,14434,0.054128120643771385,0.6786721835621591
5876,0.5878,9,6,9,669616,6828,111831,14425,0.0540805981497909,0.6787277090293136
5877,0.5879,5,3,5,669619,6825,111836,14420,0.05405683690280066,0.6787479406919276
5878,0.588,9,8,9,669627,6817,111845,14411,0.053993473577493345,0.6788675334463916
5879,0.5881,3,7,3,669634,6810,111848,14408,0.05393803066784945,0.6790460929399567
5880,0.5882,7,9,7,669643,6801,111855,14401,0.05386674692687872,0.6792283746816338
5881,0.5883,3,11,3,669654,6790,111858,14398,0.05377962235458117,0.6795355861808571
5882,0.5884,13,4,13,669658,6786,111871,14385,0.05374794069192751,0.6794671956922205
5883,0.5885,13,3,13,669661,6783,111884,14372,0.05372417944493727,0.679366580004727
5884,0.5886,9,4,9,669665,6779,111893,14363,0.05369249778228361,0.6793586226468641
5885,0.5887,7,7,7,669672,6772,111900,14356,0.053637054872639714,0.6794774706550549
5886,0.5888,7,5,7,669677,6767,111907,14349,0.053597452794322646,0.6795321083538549
5887,0.5889,3,6,3,669683,6761,111910,14346,0.05354993030034216,0.679679727104752
5888,0.589,9,2,9,669685,6759,111919,14337,0.053534089469015333,0.6796075085324232
5889,0.5891,6,1,6,669686,6758,111925,14331,0.05352616905335192,0.6795485798283465
5890,0.5892,7,1,7,669687,6757,111932,14324,0.053518248637688504,0.6794744082349035
5891,0.5893,4,2,4,669689,6755,111936,14320,0.05350240780636168,0.6794780545670226
5892,0.5894,4,2,4,669691,6753,111940,14316,0.05348656697503485,0.6794817029759362
5893,0.5895,9,0,9,669691,6753,111949,14307,0.05348656697503485,0.6793447293447293
5894,0.5896,6,5,6,669696,6748,111955,14301,0.05344696489671778,0.6794146990355836
5895,0.5897,11,1,11,669697,6747,111966,14290,0.05343904448105437,0.6792793649284594
5896,0.5898,3,9,3,669706,6738,111969,14287,0.05336776074008364,0.6795243757431629
5897,0.5899,5,3,5,669709,6735,111974,14282,0.053343999493093396,0.6795451301327496
5898,0.59,6,6,6,669715,6729,111980,14276,0.05329647699911291,0.6796477029278744
5899,0.5901,4,4,4,669719,6725,111984,14272,0.05326479533645926,0.6797161499261799
5900,0.5902,6,5,6,669724,6720,111990,14266,0.053225193258142185,0.6797865243495663
5901,0.5903,10,6,10,669730,6714,112000,14256,0.0531776707641617,0.6798283261802575
5902,0.5904,10,4,10,669734,6710,112010,14246,0.05314598910150805,0.6798053063561749
5903,0.5905,8,5,8,669739,6705,112018,14238,0.053106387023190975,0.6798452943704341
5904,0.5906,11,9,11,669748,6696,112029,14227,0.053035103282220254,0.6799694116522487
5905,0.5907,3,6,3,669754,6690,112032,14224,0.052987580788239765,0.6801185808549297
5906,0.5908,8,2,8,669756,6688,112040,14216,0.05297173995691294,0.6800612323000382
5907,0.5909,9,4,9,669760,6684,112049,14207,0.05294005829425928,0.6800536116030826
5908,0.591,8,5,8,669765,6679,112057,14199,0.052900456215942214,0.6800938787240157
5909,0.5911,5,3,5,669768,6676,112062,14194,0.05287669496895197,0.6801149976042166
5910,0.5912,11,5,11,669773,6671,112073,14183,0.0528370928906349,0.6801093315431093
5911,0.5913,9,7,9,669780,6664,112082,14174,0.052781649980991004,0.6801996352816969
5912,0.5914,10,4,10,669784,6660,112092,14164,0.052749968318337344,0.6801767191701883
5913,0.5915,9,7,9,669791,6653,112101,14155,0.052694525408693446,0.6802672049211842
5914,0.5916,6,5,6,669796,6648,112107,14149,0.05265492333037638,0.6803385103620715
5915,0.5917,5,6,5,669802,6642,112112,14144,0.052607400836395896,0.6804580005773117
5916,0.5918,7,6,7,669808,6636,112119,14137,0.05255987834241541,0.6805468637173254
5917,0.5919,7,4,7,669812,6632,112126,14130,0.05252819667976175,0.6805702726134284
5918,0.592,4,5,4,669817,6627,112130,14126,0.052488594601444685,0.6806726738302896
5919,0.5921,7,0,7,669817,6627,112137,14119,0.052488594601444685,0.6805649281789261
5920,0.5922,4,5,4,669822,6622,112141,14115,0.05244899252312761,0.6806674060857405
5921,0.5923,4,0,4,669822,6622,112145,14111,0.05244899252312761,0.6806057975208605
5922,0.5924,2,4,2,669826,6618,112147,14109,0.05241731086047396,0.6807063250832248
5923,0.5925,7,1,7,669827,6617,112154,14102,0.05240939044481054,0.6806313045996428
5924,0.5926,8,2,8,669829,6615,112162,14094,0.05239354961348371,0.6805736636245111
5925,0.5927,4,4,4,669833,6611,112166,14090,0.05236186795083006,0.6806434471764649
5926,0.5928,4,5,4,669838,6606,112170,14086,0.05232226587251299,0.6807461820993621
5927,0.5929,3,6,3,669844,6600,112173,14083,0.0522747433785325,0.68089735531596
5928,0.593,5,6,5,669850,6594,112178,14078,0.05222722088455202,0.6810178018575851
5929,0.5931,8,4,8,669854,6590,112186,14070,0.05219553922189837,0.681026137463698
5930,0.5932,6,6,6,669860,6584,112192,14064,0.052148016727917884,0.6811313444401395
5931,0.5933,6,6,6,669866,6578,112198,14058,0.052100494233937394,0.6812366737739872
5932,0.5934,6,2,6,669868,6576,112204,14052,0.05208465340261057,0.6812100058173357
5933,0.5935,5,8,5,669876,6568,112209,14047,0.05202129007730326,0.6813970409895707
5934,0.5936,1,7,1,669883,6561,112210,14046,0.05196584716765936,0.6816130441112244
5935,0.5937,6,9,6,669892,6552,112216,14040,0.051894563426688634,0.6818181818181818
5936,0.5938,8,5,8,669897,6547,112224,14032,0.051854961348371566,0.6818601486952719
5937,0.5939,9,4,9,669901,6543,112233,14023,0.051823279685717906,0.681853544685403
5938,0.594,5,6,5,669907,6537,112238,14018,0.05177575719173742,0.6819751885186086
5939,0.5941,4,4,4,669911,6533,112242,14014,0.05174407552908376,0.6820460407845428
5940,0.5942,3,7,3,669918,6526,112245,14011,0.051688632619439866,0.6822320689487267
5941,0.5943,7,3,7,669921,6523,112252,14004,0.05166487137244963,0.6822234130657183
5942,0.5944,6,8,6,669929,6515,112258,13998,0.051601508047142315,0.682396529030371
5943,0.5945,3,4,3,669933,6511,112261,13995,0.051569826384488655,0.6824831756559055
5944,0.5946,5,3,5,669936,6508,112266,13990,0.05154606513749842,0.6825056103034443
5945,0.5947,6,5,6,669941,6503,112272,13984,0.05150646305918134,0.6825791965636745
5946,0.5948,8,7,8,669948,6496,112280,13976,0.051451020149537445,0.6826885502149277
5947,0.5949,7,4,7,669952,6492,112287,13969,0.05141933848688379,0.6827134548653536
5948,0.595,5,4,5,669956,6488,112292,13964,0.05138765682423013,0.6827694113045178
5949,0.5951,6,6,6,669962,6482,112298,13958,0.05134013433024965,0.6828767123287671
5950,0.5952,3,1,3,669963,6481,112301,13955,0.051332213914586235,0.6828635740849481
5951,0.5953,8,7,8,669970,6474,112309,13947,0.05127677100494234,0.6829734097252828
5952,0.5954,3,3,3,669973,6471,112312,13944,0.0512530097579521,0.6830271858927259
5953,0.5955,7,2,7,669975,6469,112319,13937,0.05123716892662527,0.6829853964520239
5954,0.5956,6,8,6,669983,6461,112325,13931,0.051173805601317957,0.6831600627697136
5955,0.5957,8,1,8,669984,6460,112333,13923,0.05116588518565454,0.683069224353628
5956,0.5958,5,6,5,669990,6454,112338,13918,0.05111836269167406,0.6831926173178873
5957,0.5959,10,4,10,669994,6450,112348,13908,0.051086681029020406,0.6831712348953728
5958,0.596,6,1,6,669995,6449,112354,13902,0.05107876061335699,0.6831113950174439
5959,0.5961,7,5,7,670000,6444,112361,13895,0.051039158535039916,0.68317026402478
5960,0.5962,6,4,6,670004,6440,112367,13889,0.05100747687238626,0.6832111761522948
5961,0.5963,7,2,7,670006,6438,112374,13882,0.050991636041059434,0.6831692913385827
5962,0.5964,5,5,5,670011,6433,112379,13877,0.050952033962742366,0.6832594780896111
5963,0.5965,5,7,5,670018,6426,112384,13872,0.05089659105309847,0.6834170854271356
5964,0.5966,7,4,7,670022,6422,112391,13865,0.05086490939044481,0.6834425987085325
5965,0.5967,6,5,6,670027,6417,112397,13859,0.05082530731212774,0.6835174590649044
5966,0.5968,4,4,4,670031,6413,112401,13855,0.05079362564947409,0.6835898954016183
5967,0.5969,4,3,4,670034,6410,112405,13851,0.05076986440248384,0.683628646167514
5968,0.597,4,5,4,670039,6405,112409,13847,0.050730262324166775,0.6837349397590361
5969,0.5971,5,8,5,670047,6397,112414,13842,0.05066689899885946,0.6839270714956273
5970,0.5972,9,5,9,670052,6392,112423,13833,0.05062729692054239,0.683955500618047
5971,0.5973,7,5,7,670057,6387,112430,13826,0.05058769484222532,0.6840152377183001
5972,0.5974,8,3,8,670060,6384,112438,13818,0.050563933595235075,0.683991683991684
5973,0.5975,8,4,8,670064,6380,112446,13810,0.05053225193258142,0.6840019811788014
5974,0.5976,2,6,2,670070,6374,112448,13808,0.05048472943860094,0.6841740164503023
5975,0.5977,4,4,4,670074,6370,112452,13804,0.05045304777594728,0.6842470506592644
5976,0.5978,7,9,7,670083,6361,112459,13797,0.05038176403497656,0.6844429010814564
5977,0.5979,8,3,8,670086,6358,112467,13789,0.050358002787986314,0.684419516553333
5978,0.598,6,5,6,670091,6353,112473,13783,0.050318400709669246,0.6844954310687326
5979,0.5981,7,4,7,670095,6349,112480,13776,0.050286719047015586,0.6845217391304348
5980,0.5982,7,4,7,670099,6345,112487,13769,0.050255037384361934,0.6845480759669882
5981,0.5983,7,6,7,670105,6339,112494,13762,0.050207514890381444,0.6846425550967613
5982,0.5984,3,2,3,670107,6337,112497,13759,0.05019167405905462,0.6846636146496815
5983,0.5985,5,3,5,670110,6334,112502,13754,0.050167912812064376,0.6846873755475906
5984,0.5986,11,2,11,670112,6332,112513,13743,0.050152071980737546,0.6845828144458281
5985,0.5987,4,4,4,670116,6328,112517,13739,0.05012039031808389,0.6846564010564609
5986,0.5988,5,3,5,670119,6325,112522,13734,0.05009662907109365,0.6846801934293834
5987,0.5989,9,6,9,670125,6319,112531,13725,0.050049106577113166,0.6847435641588505
5988,0.599,4,5,4,670130,6314,112535,13721,0.0500095044987961,0.6848515098577489
5989,0.5991,8,5,8,670135,6309,112543,13713,0.04996990242047903,0.6848966137249026
5990,0.5992,9,5,9,670140,6304,112552,13704,0.049930300342161955,0.6849260295881647
5991,0.5993,4,5,4,670145,6299,112556,13700,0.04989069826384489,0.6850342517125856
5992,0.5994,4,3,4,670148,6296,112560,13696,0.04986693701685464,0.6850740296118447
5993,0.5995,8,2,8,670150,6294,112568,13688,0.04985109618552782,0.685016514863377
5994,0.5996,4,6,4,670156,6288,112572,13684,0.04980357369154733,0.6851592229120769
5995,0.5997,6,4,6,670160,6284,112578,13678,0.04977189202889368,0.6852018835787997
5996,0.5998,4,5,4,670165,6279,112582,13674,0.04973228995057661,0.6853104796271238
5997,0.5999,7,1,7,670166,6278,112589,13667,0.049724369534913195,0.685234394585109
5998,0.6,2,3,2,670169,6275,112591,13665,0.04970060828792295,0.6853059177532598
5999,0.6001,6,2,6,670171,6273,112597,13659,0.04968476745659612,0.6852799518362432
6000,0.6002,7,6,7,670177,6267,112604,13652,0.04963724496261564,0.6853757718760982
6001,0.6003,6,4,6,670181,6263,112610,13646,0.049605563299961984,0.6854186548797027
6002,0.6004,4,2,4,670183,6261,112614,13642,0.049589722468635154,0.6854243078932825
6003,0.6005,8,5,8,670188,6256,112622,13634,0.049550120390318086,0.6854700854700855
6004,0.6006,10,1,10,670189,6255,112632,13624,0.04954219997465467,0.6853463453896071
6005,0.6007,4,2,4,670191,6253,112636,13620,0.04952635914332784,0.6853519851054194
6006,0.6008,13,5,13,670196,6248,112649,13607,0.049486757065010774,0.6853185595567867
6007,0.6009,3,5,3,670201,6243,112652,13604,0.0494471549866937,0.6854436438756487
6008,0.601,4,4,4,670205,6239,112656,13600,0.049415473324040046,0.6855184233076264
6009,0.6011,7,2,7,670207,6237,112663,13593,0.049399632492713216,0.6854765506807867
6010,0.6012,9,10,9,670217,6227,112672,13584,0.04932042833607908,0.6856796729089899
6011,0.6013,8,3,8,670220,6224,112680,13576,0.049296667089088836,0.6856565656565656
6012,0.6014,9,4,9,670224,6220,112689,13567,0.049264985426435176,0.6856521958861879
6013,0.6015,5,3,5,670227,6217,112694,13562,0.04924122417944494,0.6856767278426614
6014,0.6016,9,4,9,670231,6213,112703,13553,0.04920954251679128,0.6856723666902762
6015,0.6017,5,5,5,670236,6208,112708,13548,0.04916994043847421,0.6857663494634542
6016,0.6018,3,6,3,670242,6202,112711,13545,0.04912241794449373,0.6859269762495569
6017,0.6019,12,3,12,670245,6199,112723,13533,0.04909865669750348,0.6858402594769917
6018,0.602,11,5,11,670250,6194,112734,13522,0.049059054619186415,0.6858389125583283
6019,0.6021,8,2,8,670252,6192,112742,13514,0.049043213787859585,0.6857809804120573
6020,0.6022,5,6,5,670258,6186,112747,13509,0.0489956912938791,0.6859101294744859
6021,0.6023,3,4,3,670262,6182,112750,13506,0.04896400963122545,0.6860016253555465
6022,0.6024,5,7,5,670269,6175,112755,13501,0.04890856672158155,0.6861658873754828
6023,0.6025,8,2,8,670271,6173,112763,13493,0.04889272589025472,0.6861080036611411
6024,0.6026,5,0,5,670271,6173,112768,13488,0.04889272589025472,0.686028177610498
6025,0.6027,7,5,7,670276,6168,112775,13481,0.04885312381193765,0.6860908952109522
6026,0.6028,5,5,5,670281,6163,112780,13476,0.04881352173362058,0.6861856510005601
6027,0.6029,6,4,6,670285,6159,112786,13470,0.04878184007096693,0.6862295583065872
6028,0.603,9,4,9,670289,6155,112795,13461,0.04875015840831327,0.6862255301794453
6029,0.6031,9,4,9,670293,6151,112804,13452,0.048718476745659614,0.6862214967096872
6030,0.6032,6,5,6,670298,6146,112810,13446,0.04867887466734254,0.6863005308289097
6031,0.6033,6,5,6,670303,6141,112816,13440,0.04863927258902547,0.6863796537459782
6032,0.6034,3,6,3,670309,6135,112819,13437,0.04859175009504499,0.6865419987737584
6033,0.6035,8,5,8,670314,6130,112827,13429,0.04855214801672792,0.6865892939311826
6034,0.6036,6,6,6,670320,6124,112833,13423,0.04850462552274743,0.6867038420217936
6035,0.6037,9,6,9,670326,6118,112842,13414,0.04845710302876695,0.6867704280155642
6036,0.6038,9,5,9,670331,6113,112851,13405,0.04841750095044988,0.686801926426888
6037,0.6039,3,5,3,670336,6108,112854,13402,0.04837789887213281,0.6869297796002051
6038,0.604,1,7,1,670343,6101,112855,13401,0.04832245596248891,0.6871602912521793
6039,0.6041,5,3,5,670346,6098,112860,13396,0.04829869471549867,0.687185800759208
6040,0.6042,8,5,8,670351,6093,112868,13388,0.0482590926371816,0.687233714901699
6041,0.6043,5,4,5,670355,6089,112873,13383,0.04822741097452794,0.6872945768282662
6042,0.6044,5,4,5,670359,6085,112878,13378,0.04819572931187429,0.6873554950418743
6043,0.6045,4,5,4,670364,6080,112882,13374,0.048156127233557215,0.6874678729310167
6044,0.6046,6,5,6,670369,6075,112888,13368,0.04811652515524015,0.687548217867613
6045,0.6047,2,5,2,670374,6070,112890,13366,0.04807692307692308,0.6876929409343486
6046,0.6048,7,3,7,670377,6067,112897,13359,0.048053161829932835,0.6876866055801503
6047,0.6049,7,1,7,670378,6066,112904,13352,0.04804524141426942,0.6876094345452672
6048,0.605,5,0,5,670378,6066,112909,13347,0.04804524141426942,0.6875289754288364
6049,0.6051,6,3,6,670381,6063,112915,13341,0.04802148016727918,0.6875386518243661
6050,0.6052,6,2,6,670383,6061,112921,13335,0.04800563933595235,0.6875128892555166
6051,0.6053,8,3,8,670386,6058,112929,13327,0.04798187808896211,0.6874903275728657
6052,0.6054,10,5,10,670391,6053,112939,13317,0.04794227601064504,0.6875064532782653
6053,0.6055,5,6,5,670397,6047,112944,13312,0.04789475351666456,0.687638824319438
6054,0.6056,8,3,8,670400,6044,112952,13304,0.04787099226967431,0.6876162910895183
6055,0.6057,6,5,6,670405,6039,112958,13298,0.047831390191357244,0.6876971608832808
6056,0.6058,6,6,6,670411,6033,112964,13292,0.04778386769737676,0.6878137128072445
6057,0.6059,8,2,8,670413,6031,112972,13284,0.04776802686604993,0.6877556303391147
6058,0.606,5,8,5,670421,6023,112977,13279,0.04770466354074262,0.6879597969122371
6059,0.6061,8,8,8,670429,6015,112985,13271,0.047641300215435306,0.6881157316187908
6060,0.6062,6,3,6,670432,6012,112991,13265,0.04761753896844506,0.6881257457073197
6061,0.6063,5,1,5,670433,6011,112996,13260,0.04760961855278165,0.6880805355196928
6062,0.6064,8,5,8,670438,6006,113004,13252,0.04757001647446458,0.6881296084744003
6063,0.6065,5,5,5,670443,6001,113009,13247,0.04753041439614751,0.6882273482959268
6064,0.6066,4,4,4,670447,5997,113013,13243,0.04749873273349385,0.6883056133056134
6065,0.6067,3,3,3,670450,5994,113016,13240,0.04747497148650361,0.6883643547883955
6066,0.6068,10,6,10,670456,5988,113026,13230,0.04742744899252313,0.6884171089603497
6067,0.6069,6,3,6,670459,5985,113032,13224,0.047403687745532885,0.6884272997032641
6068,0.607,5,2,5,670461,5983,113037,13219,0.047387846914206055,0.6884178731382148
6069,0.6071,6,6,6,670467,5977,113043,13213,0.04734032442022557,0.6885356956748306
6070,0.6072,9,4,9,670471,5973,113052,13204,0.04730864275757192,0.6885331386556813
6071,0.6073,5,5,5,670476,5968,113057,13199,0.047269040679254845,0.6886315020608337
6072,0.6074,5,3,5,670479,5965,113062,13194,0.04724527943226461,0.688658071924422
6073,0.6075,6,6,6,670485,5959,113068,13188,0.047197756938284124,0.6887763096046378
6074,0.6076,4,2,4,670487,5957,113072,13184,0.047181916106957295,0.6887832401650906
6075,0.6077,2,9,2,670496,5948,113074,13182,0.04711063236598657,0.6890747516989022
6076,0.6078,8,7,8,670503,5941,113082,13174,0.04705518945634267,0.689196965733717
6077,0.6079,3,3,3,670506,5938,113085,13171,0.047031428209352424,0.689256371343346
6078,0.608,7,6,7,670512,5932,113092,13164,0.04698390571537194,0.6893590280687055
6079,0.6081,1,4,1,670516,5928,113093,13163,0.04695222405271829,0.689487192918129
6080,0.6082,6,7,6,670523,5921,113099,13157,0.04689678114307439,0.6896425201803124
6081,0.6083,9,1,9,670524,5920,113108,13148,0.046888860727410976,0.6895322005454164
6082,0.6084,7,7,7,670531,5913,113115,13141,0.04683341781776708,0.6896714600608796
6083,0.6085,4,5,4,670536,5908,113119,13137,0.046793815739450004,0.689787345760042
6084,0.6086,8,7,8,670543,5901,113127,13129,0.046738372829806106,0.6899106673673148
6085,0.6087,6,9,6,670552,5892,113133,13123,0.046667089088835385,0.6901393636602682
6086,0.6088,2,3,2,670555,5889,113135,13121,0.04664332784184514,0.6902156759600211
6087,0.6089,10,5,10,670560,5884,113145,13111,0.04660372576352807,0.6902342721768887
6088,0.609,8,8,8,670568,5876,113153,13103,0.04654036243822076,0.69039464671479
6089,0.6091,7,6,7,670574,5870,113160,13096,0.04649283994424027,0.6904987873035959
6090,0.6092,4,4,4,670578,5866,113164,13092,0.04646115828158662,0.6905791750184619
6091,0.6093,9,1,9,670579,5865,113173,13083,0.0464532378659232,0.6904686510449651
6092,0.6094,6,3,6,670582,5862,113179,13077,0.046429476618932965,0.6904799619832093
6093,0.6095,5,3,5,670585,5859,113184,13072,0.04640571537194272,0.690507632982938
6094,0.6096,6,6,6,670591,5853,113190,13066,0.04635819287796224,0.690628468735134
6095,0.6097,8,3,8,670594,5850,113198,13058,0.04633443163097199,0.6906071504125239
6096,0.6098,4,5,4,670599,5845,113202,13054,0.046294829552654924,0.6907243769511614
6097,0.6099,7,3,7,670602,5842,113209,13047,0.04627106830566468,0.6907194663560803
6098,0.61,8,5,8,670607,5837,113217,13039,0.04623146622734761,0.690771349862259
6099,0.6101,6,4,6,670611,5833,113223,13033,0.04619978456469395,0.6908194635852857
6100,0.6102,10,3,10,670614,5830,113233,13023,0.046176023317703714,0.6907653954277834
6101,0.6103,5,4,5,670618,5826,113238,13018,0.046144341655050054,0.6908299724050095
6102,0.6104,8,4,8,670622,5822,113246,13010,0.0461126599923964,0.6908453695836874
6103,0.6105,7,3,7,670625,5819,113253,13003,0.04608889874540616,0.6908405057910956
6104,0.6106,5,9,5,670634,5810,113258,12998,0.046017615004435436,0.6910888983411314
6105,0.6107,8,8,8,670642,5802,113266,12990,0.04595425167912812,0.6912515964240102
6106,0.6108,4,5,4,670647,5797,113270,12986,0.04591464960081105,0.6913698557205984
6107,0.6109,7,8,7,670655,5789,113277,12979,0.045851286275503736,0.6915494458653026
6108,0.611,7,4,7,670659,5785,113284,12972,0.04581960461285008,0.6915818094578025
6109,0.6111,11,1,11,670660,5784,113295,12961,0.04581168419718667,0.6914377167244599
6110,0.6112,4,4,4,670664,5780,113299,12957,0.045780002534533015,0.6915194534877515
6111,0.6113,6,5,6,670669,5775,113305,12951,0.04574040045621594,0.6916052547260494
6112,0.6114,4,4,4,670673,5771,113309,12947,0.04570871879356229,0.6916871460626135
6113,0.6115,7,5,7,670678,5766,113316,12940,0.04566911671524521,0.6917566556185181
6114,0.6116,2,3,2,670681,5763,113318,12938,0.045645355468254975,0.6918346612480616
6115,0.6117,4,2,4,670683,5761,113322,12934,0.045629514636928145,0.6918427387001872
6116,0.6118,7,3,7,670686,5758,113329,12927,0.04560575338993791,0.6918383730264919
6117,0.6119,6,6,6,670692,5752,113335,12921,0.04555823089595742,0.6919616558667595
6118,0.612,6,10,6,670702,5742,113341,12915,0.04547902673932328,0.6922334780511337
6119,0.6121,6,3,6,670705,5739,113347,12909,0.04545526549233304,0.6922458172458172
6120,0.6122,3,6,3,670711,5733,113350,12906,0.045407742998352554,0.6924191211974892
6121,0.6123,8,1,8,670712,5732,113358,12898,0.04539982258268914,0.6923242082662373
6122,0.6124,4,2,4,670714,5730,113362,12894,0.04538398175136231,0.6923324742268041
6123,0.6125,3,5,3,670719,5725,113365,12891,0.04534437967304524,0.6924688440051568
6124,0.6126,9,5,9,670724,5720,113374,12882,0.045304777594728174,0.6925061821309536
6125,0.6127,12,4,12,670728,5716,113386,12870,0.045273095932074514,0.6924566878295492
6126,0.6128,5,9,5,670737,5707,113391,12865,0.045201812191103787,0.6927094550936894
6127,0.6129,4,3,4,670740,5704,113395,12861,0.04517805094411355,0.6927551844869377
6128,0.613,6,3,6,670743,5701,113401,12855,0.045154289697123304,0.6927678378960983
6129,0.6131,3,3,3,670746,5698,113404,12852,0.045130528450133066,0.6928301886792453
6130,0.6132,7,3,7,670749,5695,113411,12845,0.04510676720314282,0.6928263214670982
6131,0.6133,9,3,9,670752,5692,113420,12836,0.045083005956152576,0.6927892918825561
6132,0.6134,6,1,6,670753,5691,113426,12830,0.04507508554048917,0.6927271745586091
6133,0.6135,6,4,6,670757,5687,113432,12824,0.04504340387783551,0.6927772675706336
6134,0.6136,8,6,8,670763,5681,113440,12816,0.044995881383855026,0.6928691139103639
6135,0.6137,5,1,5,670764,5680,113445,12811,0.04498796096819161,0.6928235357741604
6136,0.6138,9,3,9,670767,5677,113454,12802,0.044964199721201366,0.6927864061908112
6137,0.6139,8,6,8,670773,5671,113462,12794,0.04491667722722088,0.6928784186298402
6138,0.614,3,7,3,670780,5664,113465,12791,0.044861234317576985,0.6930913031698727
6139,0.6141,6,5,6,670785,5659,113471,12785,0.04482163223925992,0.6931793537193668
6140,0.6142,2,7,2,670792,5652,113473,12783,0.04476618932961602,0.6934092758340114
6141,0.6143,5,4,5,670796,5648,113478,12778,0.04473450766696236,0.6934766091392598
6142,0.6144,6,8,6,670804,5640,113484,12772,0.04467114434165505,0.6936780360634369
6143,0.6145,6,5,6,670809,5635,113490,12766,0.04463154226333798,0.6937666431172219
6144,0.6146,9,2,9,670811,5633,113499,12757,0.04461570143201115,0.6936922240348016
6145,0.6147,4,5,4,670816,5628,113503,12753,0.04457609935369408,0.6938142647298842
6146,0.6148,4,5,4,670821,5623,113507,12749,0.044536497275377014,0.693936424994557
6147,0.6149,6,7,6,670828,5616,113513,12743,0.044481054365733116,0.6941009858924778
6148,0.615,3,5,3,670833,5611,113516,12740,0.04444145228741604,0.69424009590758
6149,0.6151,3,1,3,670834,5610,113519,12737,0.04443353187175263,0.6942279391726168
6150,0.6152,12,3,12,670837,5607,113531,12725,0.04440977062476239,0.6941413921012437
6151,0.6153,11,5,11,670842,5602,113542,12714,0.044370168546445314,0.6941471937104171
6152,0.6154,8,5,8,670847,5597,113550,12706,0.044330566468128246,0.6942031360979074
6153,0.6155,6,3,6,670850,5594,113556,12700,0.04430680522113801,0.694216683065486
6154,0.6156,3,1,3,670851,5593,113559,12697,0.04429888480547459,0.6942044833242209
6155,0.6157,6,7,6,670858,5586,113565,12691,0.044243441895830696,0.6943699731903485
6156,0.6158,8,5,8,670863,5581,113573,12683,0.04420383981751362,0.6944261936049059
6157,0.6159,5,4,5,670867,5577,113578,12678,0.04417215815485997,0.6944946589975349
6158,0.616,3,6,3,670873,5571,113581,12675,0.044124635660879485,0.6946728049983558
6159,0.6161,5,3,5,670876,5568,113586,12670,0.04410087441388924,0.6947033665972147
6160,0.6162,9,6,9,670882,5562,113595,12661,0.04405335191990876,0.694781320309499
6161,0.6163,9,5,9,670887,5557,113604,12652,0.04401374984159169,0.6948212422428469
6162,0.6164,8,4,8,670891,5553,113612,12644,0.04398206817893803,0.6948398087596857
6163,0.6165,5,3,5,670894,5550,113617,12639,0.043958306931947785,0.6948705261421738
6164,0.6166,7,3,7,670897,5547,113624,12632,0.04393454568495755,0.6948677044941965
6165,0.6167,3,7,3,670904,5540,113627,12629,0.04387910277531365,0.6950850349496395
6166,0.6168,3,5,3,670909,5535,113630,12626,0.043839500696996575,0.695226033808711
6167,0.6169,2,2,2,670911,5533,113632,12624,0.04382365986566975,0.6952690422426613
6168,0.617,7,9,7,670920,5524,113639,12617,0.043752376124699024,0.69549638939419
6169,0.6171,1,3,1,670923,5521,113640,12616,0.04372861487770878,0.6955946407895462
6170,0.6172,7,3,7,670926,5518,113647,12609,0.04370485363071854,0.6955922105147019
6171,0.6173,4,4,4,670930,5514,113651,12605,0.04367317196806488,0.6956785694574755
6172,0.6174,2,5,2,670935,5509,113653,12603,0.043633569889747814,0.6958370141342756
6173,0.6175,5,6,5,670941,5503,113658,12598,0.04358604739576733,0.6959836473123032
6174,0.6176,7,4,7,670945,5499,113665,12591,0.04355436573311367,0.6960199004975124
6175,0.6177,12,3,12,670948,5496,113677,12579,0.043530604486123434,0.6959336099585062
6176,0.6178,6,4,6,670952,5492,113683,12573,0.043498922823469774,0.6959867146415721
6177,0.6179,4,4,4,670956,5488,113687,12569,0.04346724116081612,0.6960735448856399
6178,0.618,7,2,7,670958,5486,113694,12562,0.04345140032948929,0.6960328014184397
6179,0.6181,4,8,4,670966,5478,113698,12558,0.04338803700418198,0.696274118429807
6180,0.6182,7,2,7,670968,5476,113705,12551,0.04337219617285515,0.6962334276363233
6181,0.6183,9,5,9,670973,5471,113714,12542,0.04333259409453808,0.6962749125631489
6182,0.6184,8,3,8,670976,5468,113722,12534,0.043308832847547836,0.6962559715587157
6183,0.6185,5,6,5,670982,5462,113727,12529,0.04326131035356735,0.6964037574342727
6184,0.6186,6,4,6,670986,5458,113733,12523,0.0432296286909137,0.6964573716700962
6185,0.6187,8,4,8,670990,5454,113741,12515,0.04319794702826004,0.69647726640325
6186,0.6188,5,2,5,670992,5452,113746,12510,0.04318210619693322,0.6964703262442935
6187,0.6189,8,8,8,671000,5444,113754,12502,0.043118742871625905,0.6966454920316505
6188,0.619,7,3,7,671003,5441,113761,12495,0.04309498162463566,0.6966436217662801
6189,0.6191,4,3,4,671006,5438,113765,12491,0.04307122037764542,0.6966925093424061
6190,0.6192,7,2,7,671008,5436,113772,12484,0.04305537954631859,0.6966517857142858
6191,0.6193,11,4,11,671012,5432,113783,12473,0.04302369788366493,0.6966210555710696
6192,0.6194,7,6,7,671018,5426,113790,12466,0.04297617538968445,0.6967359713838587
6193,0.6195,3,6,3,671024,5420,113793,12463,0.04292865289570397,0.6969188614885645
6194,0.6196,14,5,14,671029,5415,113807,12449,0.0428890508173869,0.6968763994626064
6195,0.6197,5,1,5,671030,5414,113812,12444,0.042881130401723484,0.6968305521334975
6196,0.6198,9,4,9,671034,5410,113821,12435,0.042849448739069824,0.6968338470159708
6197,0.6199,3,2,3,671036,5408,113824,12432,0.042833607907743,0.6968609865470852
6198,0.62,5,6,5,671042,5402,113829,12427,0.04278608541376251,0.6970104885299232
6199,0.6201,5,4,5,671046,5398,113834,12422,0.04275440375110886,0.6970819304152638
6200,0.6202,6,5,6,671051,5393,113840,12416,0.04271480167279179,0.6971755853781796
6201,0.6203,8,2,8,671053,5391,113848,12408,0.04269896084146496,0.6971178156076184
6202,0.6204,6,4,6,671057,5387,113854,12402,0.0426672791788113,0.6971724099162404
6203,0.6205,3,4,3,671061,5383,113857,12399,0.04263559751615765,0.6972781464402205
6204,0.6206,5,1,5,671062,5382,113862,12394,0.042627677100494234,0.6972322232223223
6205,0.6207,10,4,10,671066,5378,113872,12384,0.04259599543784058,0.697218781668731
6206,0.6208,11,5,11,671071,5373,113883,12373,0.042556393359523506,0.6972275442353206
6207,0.6209,5,5,5,671076,5368,113888,12368,0.04251679128120644,0.6973387460532251
6208,0.621,8,3,8,671079,5365,113896,12360,0.04249303003421619,0.6973201692524683
6209,0.6211,3,5,3,671084,5360,113899,12357,0.042453427955899126,0.6974657108991364
6210,0.6212,2,8,2,671092,5352,113901,12355,0.04239006463059181,0.6977466538657028
6211,0.6213,9,2,9,671094,5350,113910,12346,0.04237422379926498,0.6976717902350814
6212,0.6214,4,5,4,671099,5345,113914,12342,0.042334621720947915,0.6978006445411884
6213,0.6215,7,8,7,671107,5337,113921,12335,0.0422712583956406,0.6979968311453146
6214,0.6216,3,4,3,671111,5333,113924,12332,0.04223957673298695,0.6981035946787433
6215,0.6217,4,2,4,671113,5331,113928,12328,0.04222373590166012,0.6981142760065688
6216,0.6218,1,2,1,671115,5329,113929,12327,0.04220789507033329,0.6981762573629361
6217,0.6219,12,5,12,671120,5324,113941,12315,0.04216829299201622,0.6981688304325642
6218,0.622,9,2,9,671122,5322,113950,12306,0.04215245216068939,0.6980939414567733
6219,0.6221,8,4,8,671126,5318,113958,12298,0.04212077049803574,0.6981153496821072
6220,0.6222,5,4,5,671130,5314,113963,12293,0.04208908883538208,0.6981882205940819
6221,0.6223,3,4,3,671134,5310,113966,12290,0.04205740717272843,0.6982954545454545
6222,0.6224,5,7,5,671141,5303,113971,12285,0.04200196426308453,0.6984876051853537
6223,0.6225,7,6,7,671147,5297,113978,12278,0.04195444176910404,0.698605974395448
6224,0.6226,4,2,4,671149,5295,113982,12274,0.041938600937777216,0.6986168820080824
6225,0.6227,8,3,8,671152,5292,113990,12266,0.04191483969078697,0.698598929263014
6226,0.6228,7,6,7,671158,5286,113997,12259,0.04186731719680649,0.6987175833570818
6227,0.6229,8,2,8,671160,5284,114005,12251,0.04185147636547966,0.6986598232107214
6228,0.623,3,3,3,671163,5281,114008,12248,0.04182771511848942,0.6987278224656284
6229,0.6231,7,5,7,671168,5276,114015,12241,0.041788113040172346,0.6988068733230576
6230,0.6232,5,3,5,671171,5273,114020,12236,0.04176435179318211,0.6988405962647781
6231,0.6233,6,6,6,671177,5267,114026,12230,0.04171682929920162,0.6989769674801395
6232,0.6234,4,7,4,671184,5260,114030,12226,0.04166138638955772,0.6991879217659842
6233,0.6235,5,3,5,671187,5257,114035,12221,0.04163762514256748,0.6992218789335164
6234,0.6236,6,4,6,671191,5253,114041,12215,0.04160594347991382,0.6992786810167163
6235,0.6237,6,5,6,671196,5248,114047,12209,0.041566341401596756,0.6993756086383686
6236,0.6238,6,2,6,671198,5246,114053,12203,0.041550500570269926,0.6993523984182475
6237,0.6239,4,6,4,671204,5240,114057,12199,0.04150297807628944,0.699524055278399
6238,0.624,6,4,6,671208,5236,114063,12193,0.04147129641363579,0.699581157840381
6239,0.6241,2,3,2,671211,5233,114065,12191,0.041447535166645545,0.6996671258034894
6240,0.6242,6,4,6,671215,5229,114071,12185,0.04141585350399189,0.6997243597105777
6241,0.6243,4,8,4,671223,5221,114075,12181,0.04135249017868458,0.6999770141363062
6242,0.6244,7,6,7,671229,5215,114082,12174,0.04130496768470409,0.7000977629535914
6243,0.6245,9,3,9,671232,5212,114091,12165,0.04128120643771385,0.7000633020659492
6244,0.6246,7,1,7,671233,5211,114098,12158,0.04127328602205044,0.6999827278484656
6245,0.6247,12,3,12,671236,5208,114110,12146,0.04124952477506019,0.6998962775152703
6246,0.6248,7,1,7,671237,5207,114117,12139,0.041241604359396784,0.6998155194281103
6247,0.6249,6,5,6,671242,5202,114123,12133,0.04120200228107971,0.6999134698586674
6248,0.625,6,2,6,671244,5200,114129,12127,0.04118616144975288,0.6998903445489698
6249,0.6251,3,4,3,671248,5196,114132,12124,0.04115447978709923,0.7
6250,0.6252,4,3,4,671251,5193,114136,12120,0.04113071854010898,0.7000519840582221
6251,0.6253,3,5,3,671256,5188,114139,12117,0.041091116461791914,0.7002022536839064
6252,0.6254,11,8,11,671264,5180,114150,12106,0.0410277531364846,0.700335531644105
6253,0.6255,3,3,3,671267,5177,114153,12103,0.041003991889494364,0.7004050925925925
6254,0.6256,5,4,5,671271,5173,114158,12098,0.040972310226840704,0.7004805743732267
6255,0.6257,3,3,3,671274,5170,114161,12095,0.040948548979850466,0.7005502461627571
6256,0.6258,10,5,10,671279,5165,114171,12085,0.04090894690153339,0.7005797101449275
6257,0.6259,11,6,11,671285,5159,114182,12074,0.04086142440755291,0.7006325073985957
6258,0.626,5,1,5,671286,5158,114187,12069,0.040853503991889493,0.7005862889649969
6259,0.6261,7,4,7,671290,5154,114194,12062,0.04082182232923584,0.7006273234200744
6260,0.6262,6,4,6,671294,5150,114200,12056,0.04079014066658218,0.7006858072765314
6261,0.6263,7,4,7,671298,5146,114207,12049,0.04075845900392853,0.7007269555103227
6262,0.6264,9,2,9,671300,5144,114216,12040,0.0407426181726017,0.7006517690875232
6263,0.6265,2,4,2,671304,5140,114218,12038,0.040710936509948045,0.7007800675282337
6264,0.6266,9,3,9,671307,5137,114227,12029,0.0406871752629578,0.7007456600256321
6265,0.6267,3,4,3,671311,5133,114230,12026,0.04065549360030414,0.7008566932804942
6266,0.6268,4,5,4,671316,5128,114234,12022,0.04061589152198707,0.7009912536443149
6267,0.6269,1,4,1,671320,5124,114235,12021,0.04058420985933342,0.7011373578302712
6268,0.627,5,1,5,671321,5123,114240,12016,0.040576289443670005,0.7010910788260692
6269,0.6271,2,5,2,671326,5118,114242,12014,0.04053668736535293,0.7012607985057203
6270,0.6272,3,5,3,671331,5113,114245,12011,0.04049708528703586,0.7014132212099977
6271,0.6273,2,2,2,671333,5111,114247,12009,0.04048124445570903,0.7014602803738318
6272,0.6274,4,3,4,671336,5108,114251,12005,0.040457483208718795,0.7015134692923508
6273,0.6275,5,5,5,671341,5103,114256,12000,0.04041788113040173,0.7016312927556569
6274,0.6276,2,3,2,671344,5100,114258,11998,0.04039411988341148,0.7017194993566499
6275,0.6277,4,5,4,671349,5095,114262,11994,0.040354517805094414,0.7018549944408684
6276,0.6278,9,3,9,671352,5092,114271,11985,0.04033075655810417,0.7018211629677343
6277,0.6279,3,1,3,671353,5091,114274,11982,0.040322836142440754,0.7018098752416095
6278,0.628,2,3,2,671356,5088,114276,11980,0.040299074895450517,0.7018982891961566
6279,0.6281,9,5,9,671361,5083,114285,11971,0.04025947281713344,0.7019467573589774
6280,0.6282,10,3,10,671364,5080,114295,11961,0.040235711570143204,0.7018954286720263
6281,0.6283,0,5,0,671369,5075,114295,11961,0.04019610949182613,0.7021014322610941
6282,0.6284,7,1,7,671370,5074,114302,11954,0.040188189076162714,0.702020202020202
6283,0.6285,5,11,5,671381,5063,114307,11949,0.040101064503865164,0.7023865506701152
6284,0.6286,3,5,3,671386,5058,114310,11946,0.040061462425548096,0.7025405786873676
6285,0.6287,4,0,4,671386,5058,114314,11942,0.040061462425548096,0.7024705882352941
6286,0.6288,6,6,6,671392,5052,114320,11936,0.040013939931567606,0.7026136096067812
6287,0.6289,6,4,6,671396,5048,114326,11930,0.03998225826891395,0.7026740487689952
6288,0.629,3,5,3,671401,5043,114329,11927,0.039942656190596885,0.7028285209192693
6289,0.6291,3,3,3,671404,5040,114332,11924,0.03991889494360664,0.7029002593727894
6290,0.6292,3,5,3,671409,5035,114335,11921,0.03987929286528957,0.7030549657938193
6291,0.6293,6,4,6,671413,5031,114341,11915,0.03984761120263591,0.7031157795349935
6292,0.6294,1,4,1,671417,5027,114342,11914,0.03981592953998226,0.7032642701139248
6293,0.6295,5,2,5,671419,5025,114347,11909,0.03980008870865543,0.703259714184481
6294,0.6296,2,3,2,671422,5022,114349,11907,0.039776327461665185,0.7033492822966507
6295,0.6297,8,7,8,671429,5015,114357,11899,0.03972088455202129,0.7035000591226204
6296,0.6298,4,3,4,671432,5012,114361,11895,0.03969712330503105,0.7035547406399716
6297,0.6299,3,3,3,671435,5009,114364,11892,0.039673362058040805,0.703627004319271
6298,0.63,6,5,6,671440,5004,114370,11886,0.03963375997972374,0.7037300177619893
6299,0.6301,5,4,5,671444,5000,114375,11881,0.03960207831707008,0.7038090160535513
6300,0.6302,9,5,9,671449,4995,114384,11872,0.03956247623875301,0.703859607517638
6301,0.6303,4,5,4,671454,4990,114388,11868,0.03952287416043594,0.7039981017914343
6302,0.6304,7,4,7,671458,4986,114395,11861,0.03949119249778228,0.7040422627173978
6303,0.6305,3,1,3,671459,4985,114398,11858,0.03948327208211887,0.7040313483346198
6304,0.6306,2,3,2,671462,4982,114400,11856,0.03945951083512863,0.7041216296472265
6305,0.6307,4,11,4,671473,4971,114404,11852,0.03937238626283107,0.7045116804374962
6306,0.6308,6,4,6,671477,4967,114410,11846,0.03934070460017742,0.7045738416701363
6307,0.6309,3,3,3,671480,4964,114413,11843,0.039316943353187174,0.7046468733265902
6308,0.631,7,4,7,671484,4960,114420,11836,0.03928526169053352,0.7046915932364849
6309,0.6311,5,3,5,671487,4957,114425,11831,0.039261500443543276,0.7047295687395759
6310,0.6312,8,1,8,671488,4956,114433,11823,0.03925358002787986,0.704630788485607
6311,0.6313,7,4,7,671492,4952,114440,11816,0.03922189836522621,0.704675572519084
6312,0.6314,4,2,4,671494,4950,114444,11812,0.03920605753389938,0.7046891779023983
6313,0.6315,6,5,6,671499,4945,114450,11806,0.03916645545558231,0.7047937436570951
6314,0.6316,2,3,2,671502,4942,114452,11804,0.039142694208592066,0.7048847485966798
6315,0.6317,8,2,8,671504,4940,114460,11796,0.039126853377265236,0.7048279158699808
6316,0.6318,7,0,7,671504,4940,114467,11789,0.039126853377265236,0.7047044055233427
6317,0.6319,3,4,3,671508,4936,114470,11786,0.03909517171461158,0.7048199976079417
6318,0.632,3,8,3,671516,4928,114473,11783,0.03903180838930427,0.70510442223685
6319,0.6321,9,6,9,671522,4922,114482,11774,0.03898428589532379,0.7051988500239579
6320,0.6322,6,5,6,671527,4917,114488,11768,0.03894468381700671,0.7053041654180402
6321,0.6323,6,3,6,671530,4914,114494,11762,0.038920922570016475,0.7053250179899256
6322,0.6324,3,5,3,671535,4909,114497,11759,0.03888132049169941,0.7054835613150948
6323,0.6325,7,8,7,671543,4901,114504,11752,0.038817957166392095,0.7056986729117877
6324,0.6326,6,2,6,671545,4899,114510,11746,0.038802116335065265,0.7056773805947733
6325,0.6327,5,2,5,671547,4897,114515,11741,0.038786275503738435,0.7056737588652482
6326,0.6328,8,9,8,671556,4888,114523,11733,0.03871499176276771,0.7059142049214848
6327,0.6329,5,5,5,671561,4883,114528,11728,0.03867538968445064,0.7060381674793811
6328,0.633,3,6,3,671567,4877,114531,11725,0.03862786719047016,0.7062402120226479
6329,0.6331,2,6,2,671573,4871,114533,11723,0.038580344696489674,0.7064601663251778
6330,0.6332,5,0,5,671573,4871,114538,11718,0.038580344696489674,0.7063716920851166
6331,0.6333,3,2,3,671575,4869,114541,11715,0.038564503865162844,0.7064037626628076
6332,0.6334,5,2,5,671577,4867,114546,11710,0.038548663033836014,0.7064004343367316
6333,0.6335,7,6,7,671583,4861,114553,11703,0.03850114053985553,0.7065322385897126
6334,0.6336,3,1,3,671584,4860,114556,11700,0.038493220124192117,0.7065217391304348
6335,0.6337,8,2,8,671586,4858,114564,11692,0.03847737929286529,0.7064652567975831
6336,0.6338,7,5,7,671591,4853,114571,11685,0.03843777721454822,0.7065546015237635
6337,0.6339,7,3,7,671594,4850,114578,11678,0.038414015967557974,0.7065585672797676
6338,0.634,5,3,5,671597,4847,114583,11673,0.038390254720567736,0.7065980629539952
6339,0.6341,6,6,6,671603,4841,114589,11667,0.03834273222658725,0.7067482432759874
6340,0.6342,7,3,7,671606,4838,114596,11660,0.03831897097959701,0.7067523336161959
6341,0.6343,3,6,3,671612,4832,114599,11657,0.038271448485616526,0.7069561525865729
6342,0.6344,7,5,7,671617,4827,114606,11650,0.03823184640729946,0.7070461855920374
6343,0.6345,2,7,2,671624,4820,114608,11648,0.03817640349765556,0.7073111488948264
6344,0.6346,6,4,6,671628,4816,114614,11642,0.0381447218350019,0.7073763519261149
6345,0.6347,5,4,5,671632,4812,114619,11637,0.03811304017234825,0.7074594200255334
6346,0.6348,4,2,4,671634,4810,114623,11633,0.03809719934102142,0.7074743051754546
6347,0.6349,6,2,6,671636,4808,114629,11627,0.03808135850969459,0.7074536051110435
6348,0.635,3,3,3,671639,4805,114632,11624,0.03805759726270435,0.7075293687990748
6349,0.6351,5,7,5,671646,4798,114637,11619,0.038002154353060445,0.7077419747822379
6350,0.6352,8,4,8,671650,4794,114645,11611,0.03797047269040679,0.7077720207253886
6351,0.6353,9,5,9,671655,4789,114654,11602,0.037930870612089725,0.7078274662924776
6352,0.6354,5,4,5,671659,4785,114659,11597,0.037899188949436065,0.7079111219631302
6353,0.6355,4,3,4,671662,4782,114663,11593,0.03787542770244583,0.707969465648855
6354,0.6356,2,3,2,671665,4779,114665,11591,0.03785166645545558,0.7080635308491142
6355,0.6357,7,3,7,671668,4776,114672,11584,0.03782790520846534,0.7080684596577017
6356,0.6358,6,3,6,671671,4773,114678,11578,0.0378041439614751,0.7080912482416978
6357,0.6359,7,6,7,671677,4767,114685,11571,0.03775662146749462,0.7082262210796915
6358,0.636,3,3,3,671680,4764,114688,11568,0.03773286022050437,0.7083027185892726
6359,0.6361,1,4,1,671684,4760,114689,11567,0.03770117855785072,0.7084583818215227
6360,0.6362,7,6,7,671690,4754,114696,11560,0.03765365606387023,0.7085938457766335
6361,0.6363,9,5,9,671695,4749,114705,11551,0.03761405398555316,0.7086503067484663
6362,0.6364,9,1,9,671696,4748,114714,11542,0.037606133569889746,0.7085328422344996
6363,0.6365,6,4,6,671700,4744,114720,11536,0.037574451907236094,0.7085995085995086
6364,0.6366,8,7,8,671707,4737,114728,11528,0.037519008997592196,0.7087611435597909
6365,0.6367,10,3,10,671710,4734,114738,11518,0.03749524775060195,0.7087127738124539
6366,0.6368,11,4,11,671714,4730,114749,11507,0.0374635660879483,0.7086900289462339
6367,0.6369,5,7,5,671721,4723,114754,11502,0.0374081231783044,0.7089060092449923
6368,0.637,5,3,5,671724,4720,114759,11497,0.037384361931314156,0.7089474008756244
6369,0.6371,6,6,6,671730,4714,114765,11491,0.03733683943733367,0.7091021289725393
6370,0.6372,5,3,5,671733,4711,114770,11486,0.03731307819034343,0.7091436685806013
6371,0.6373,6,3,6,671736,4708,114776,11480,0.03728931694335319,0.7091672844082036
6372,0.6374,5,9,5,671745,4699,114781,11475,0.03721803320238246,0.709471992086064
6373,0.6375,8,3,8,671748,4696,114789,11467,0.03719427195539222,0.7094598774979892
6374,0.6376,2,4,2,671752,4692,114791,11465,0.037162590292738565,0.7095995543727177
6375,0.6377,4,2,4,671754,4690,114795,11461,0.037146749461411735,0.7096155036839824
6376,0.6378,5,2,5,671756,4688,114800,11456,0.037130908630084905,0.709613478691774
6377,0.6379,12,2,12,671758,4686,114812,11444,0.03711506779875808,0.7094854308741475
6378,0.638,6,4,6,671762,4682,114818,11438,0.03708338613610442,0.7095533498759306
6379,0.6381,11,4,11,671766,4678,114829,11427,0.03705170447345077,0.7095312014902204
6380,0.6382,5,5,5,671771,4673,114834,11422,0.037012102395133695,0.7096613855234545
6381,0.6383,5,4,5,671775,4669,114839,11417,0.03698042073248004,0.7097476066144474
6382,0.6384,3,4,3,671779,4665,114842,11414,0.03694873906982638,0.709870016792089
6383,0.6385,6,3,6,671782,4662,114848,11408,0.036924977822836144,0.7098942128189173
6384,0.6386,5,7,5,671789,4655,114853,11403,0.036869534913192246,0.7101133391455972
6385,0.6387,8,2,8,671791,4653,114861,11395,0.03685369408186542,0.7100573280159521
6386,0.6388,7,3,7,671794,4650,114868,11388,0.03682993283487517,0.7100635989524878
6387,0.6389,9,5,9,671799,4645,114877,11379,0.036790330756558104,0.7101223165252122
6388,0.639,4,3,4,671802,4642,114881,11375,0.03676656950956786,0.7101829306361991
6389,0.6391,6,3,6,671805,4639,114887,11369,0.03674280826257762,0.710207396301849
6390,0.6392,5,5,5,671810,4634,114892,11364,0.03670320618426055,0.7103387923490436
6391,0.6393,4,3,4,671813,4631,114896,11360,0.03667944493727031,0.7103995997748733
6392,0.6394,2,2,2,671815,4629,114898,11358,0.03666360410594348,0.7104522424469881
6393,0.6395,1,6,1,671821,4623,114899,11357,0.036616081611962996,0.7107008760951189
6394,0.6396,7,6,7,671827,4617,114906,11350,0.03656855911798251,0.7108411097889397
6395,0.6397,6,6,6,671833,4611,114912,11344,0.03652103662400203,0.7109996866186149
6396,0.6398,11,5,11,671838,4606,114923,11333,0.036481434545684956,0.7110232762406675
6397,0.6399,8,4,8,671842,4602,114931,11325,0.0364497528830313,0.7110566961763044
6398,0.64,6,4,6,671846,4598,114937,11319,0.03641807122037764,0.7111264685556323
6399,0.6401,5,5,5,671851,4593,114942,11314,0.036378469142060575,0.7112591940655058
6400,0.6402,10,3,10,671854,4590,114952,11304,0.03635470789507033,0.711211778029445
6401,0.6403,6,1,6,671855,4589,114958,11298,0.03634678747940692,0.7111474790709384
6402,0.6404,5,5,5,671860,4584,114963,11293,0.03630718540108985,0.7112804686023808
6403,0.6405,8,3,8,671863,4581,114971,11285,0.03628342415409961,0.7112693810664313
6404,0.6406,5,1,5,671864,4580,114976,11280,0.036275503738436195,0.7112232030264817
6405,0.6407,13,4,13,671868,4576,114989,11267,0.036243822075782535,0.7111658145553241
6406,0.6408,5,5,5,671873,4571,114994,11262,0.03620421999746547,0.7112991852460052
6407,0.6409,6,0,6,671873,4571,115000,11256,0.03620421999746547,0.7111897390535161
6408,0.641,5,5,5,671878,4566,115005,11251,0.0361646179191484,0.711323259783777
6409,0.6411,7,4,7,671882,4562,115012,11244,0.03613293625649474,0.7113754270530178
6410,0.6412,11,2,11,671884,4560,115023,11233,0.03611709542516791,0.7112644842651807
6411,0.6413,5,2,5,671886,4558,115028,11228,0.03610125459384109,0.7112631445584695
6412,0.6414,9,6,9,671892,4552,115037,11219,0.036053732099860604,0.7113689683596475
6413,0.6415,9,5,9,671897,4547,115046,11210,0.03601413002154353,0.7114298407057181
6414,0.6416,10,1,10,671898,4546,115056,11200,0.036006209605880114,0.7112917566366062
6415,0.6417,8,1,8,671899,4545,115064,11192,0.0359982891902167,0.7111901887272034
6416,0.6418,6,5,6,671904,4540,115070,11186,0.03595868711189963,0.711306117258044
6417,0.6419,9,4,9,671908,4536,115079,11177,0.03592700544924598,0.7113218354228983
6418,0.642,8,6,8,671914,4530,115087,11169,0.03587948295526549,0.7114465889547105
6419,0.6421,7,5,7,671919,4525,115094,11162,0.03583988087694842,0.7115445910626633
6420,0.6422,6,2,6,671921,4523,115100,11156,0.03582404004562159,0.7115249697047006
6421,0.6423,6,0,6,671921,4523,115106,11150,0.03582404004562159,0.7114145345498628
6422,0.6424,6,2,6,671923,4521,115112,11144,0.03580819921429477,0.7113948292371529
6423,0.6425,7,5,7,671928,4516,115119,11137,0.035768597135977694,0.7114930045358717
6424,0.6426,7,5,7,671933,4511,115126,11130,0.035728995057660626,0.7115913304775909
6425,0.6427,6,3,6,671936,4508,115132,11124,0.03570523381067038,0.7116171954964176
6426,0.6428,7,3,7,671939,4505,115139,11117,0.03568147256368014,0.7116246319293305
6427,0.6429,5,3,5,671942,4502,115144,11112,0.0356577113166899,0.7116690149865506
6428,0.643,3,1,3,671943,4501,115147,11109,0.03564979090102648,0.7116591928251121
6429,0.6431,8,5,8,671948,4496,115155,11101,0.035610188822709415,0.7117394370712317
6430,0.6432,3,3,3,671951,4493,115158,11098,0.03558642757571917,0.7118209223269835
6431,0.6433,10,3,10,671954,4490,115168,11088,0.03556266632872893,0.7117730132237772
6432,0.6434,6,1,6,671955,4489,115174,11082,0.03555474591306552,0.7117076616787618
6433,0.6435,7,4,7,671959,4485,115181,11075,0.035523064250411865,0.7117609254498715
6434,0.6436,3,4,3,671963,4481,115184,11072,0.035491382587758205,0.7118883816627017
6435,0.6437,5,3,5,671966,4478,115189,11067,0.03546762134076796,0.71193309745899
6436,0.6438,6,3,6,671969,4475,115195,11061,0.03544386009377772,0.7119593202883625
6437,0.6439,8,2,8,671971,4473,115203,11053,0.03542801926245089,0.71190261496844
6438,0.644,9,1,9,671972,4472,115212,11044,0.03542009884678748,0.7117813869554008
6439,0.6441,5,2,5,671974,4470,115217,11039,0.035404258015460655,0.7117802566251854
6440,0.6442,4,2,4,671976,4468,115221,11035,0.035388417184133825,0.7117977165709862
6441,0.6443,3,1,3,671977,4467,115224,11032,0.03538049676847041,0.7117878572811149
6442,0.6444,9,7,9,671984,4460,115233,11023,0.03532505385882651,0.7119421300781502
6443,0.6445,7,1,7,671985,4459,115240,11016,0.0353171334431631,0.7118578352180936
6444,0.6446,4,4,4,671989,4455,115244,11012,0.035285451780509444,0.7119674144953773
6445,0.6447,7,5,7,671994,4450,115251,11005,0.03524584970219237,0.7120672921384665
6446,0.6448,7,0,7,671994,4450,115258,10998,0.03524584970219237,0.7119368203003625
6447,0.6449,3,2,3,671996,4448,115261,10995,0.03523000887086554,0.7119730622288415
6448,0.645,4,1,4,671997,4447,115265,10991,0.03522208845520213,0.711944552403161
6449,0.6451,4,2,4,671999,4445,115269,10987,0.0352062476238753,0.7119621565578019
6450,0.6452,4,6,4,672005,4439,115273,10983,0.03515872512989482,0.7121644404098042
6451,0.6453,8,4,8,672009,4435,115281,10975,0.03512704346724116,0.7121998702141467
6452,0.6454,9,3,9,672012,4432,115290,10966,0.03510328222025092,0.7121704117417846
6453,0.6455,11,5,11,672017,4427,115301,10955,0.035063680141933846,0.7121960733324665
6454,0.6456,9,5,9,672022,4422,115310,10946,0.03502407806361678,0.7122592399791775
6455,0.6457,5,4,5,672026,4418,115315,10941,0.034992396400963126,0.7123510645224298
6456,0.6458,9,5,9,672031,4413,115324,10932,0.03495279432264605,0.7124144672531769
6457,0.6459,6,6,6,672037,4407,115330,10926,0.03490527182866557,0.7125807082762668
6458,0.646,3,4,3,672041,4403,115333,10923,0.034873590166011915,0.7127104267258254
6459,0.6461,4,5,4,672046,4398,115337,10919,0.03483398808769484,0.7128680551021741
6460,0.6462,8,5,8,672051,4393,115345,10911,0.03479438600937777,0.7129508625196027
6461,0.6463,3,2,3,672053,4391,115348,10908,0.03477854517805094,0.7129877769788875
6462,0.6464,4,2,4,672055,4389,115352,10904,0.03476270434672411,0.7130059504348395
6463,0.6465,9,5,9,672060,4384,115361,10895,0.034723102268407045,0.713070227109104
6464,0.6466,5,3,5,672063,4381,115366,10890,0.0346993410214168,0.7131163643507301
6465,0.6467,6,2,6,672065,4379,115372,10884,0.03468350019008998,0.7130970320382625
6466,0.6468,10,1,10,672066,4378,115382,10874,0.03467557977442656,0.7129556779438763
6467,0.6469,11,1,11,672067,4377,115393,10863,0.03466765935876315,0.7127952755905512
6468,0.647,9,1,9,672068,4376,115402,10854,0.03465973894309973,0.7126723571897571
6469,0.6471,3,8,3,672076,4368,115405,10851,0.03459637561779242,0.712990341021092
6470,0.6472,4,3,4,672079,4365,115409,10847,0.03457261437080218,0.7130554825138049
6471,0.6473,6,1,6,672080,4364,115415,10841,0.03456469395513877,0.7129891483064781
6472,0.6474,3,1,3,672081,4363,115418,10838,0.03455677353947535,0.7129794092493915
6473,0.6475,8,4,8,672085,4359,115426,10830,0.03452509187682169,0.7130159984199091
6474,0.6476,4,0,4,672085,4359,115430,10826,0.03452509187682169,0.712940401712216
6475,0.6477,6,3,6,672088,4356,115436,10820,0.034501330629831455,0.7129678439641539
6476,0.6478,8,2,8,672090,4354,115444,10812,0.034485489798504625,0.712910457602532
6477,0.6479,5,2,5,672092,4352,115449,10807,0.034469648967177795,0.7129098225476614
6478,0.648,5,3,5,672095,4349,115454,10802,0.03444588772018756,0.7129562405121774
6479,0.6481,6,3,6,672098,4346,115460,10796,0.03442212647319731,0.7129837537973848
6480,0.6482,10,4,10,672102,4342,115470,10786,0.03439044481054366,0.7129825489159175
6481,0.6483,7,3,7,672105,4339,115477,10779,0.034366683563553414,0.7129911363937028
6482,0.6484,2,9,2,672114,4330,115479,10777,0.03429539982258269,0.7133779042827828
6483,0.6485,7,5,7,672119,4325,115486,10770,0.03425579774426562,0.7134812851937727
6484,0.6486,4,1,4,672120,4324,115490,10766,0.034247877328602204,0.713452617627568
6485,0.6487,5,3,5,672123,4321,115495,10761,0.034224116081611966,0.7134995358705742
6486,0.6488,6,6,6,672129,4315,115501,10755,0.034176593587631476,0.7136695421366954
6487,0.6489,4,2,4,672131,4313,115505,10751,0.03416075275630465,0.713688263409453
6488,0.649,4,3,4,672134,4310,115509,10747,0.03413699150931441,0.7137543999468685
6489,0.6491,5,7,5,672141,4303,115514,10742,0.03408154859967051,0.7139913592555667
6490,0.6492,6,4,6,672145,4299,115520,10736,0.03404986693701686,0.7140671765879614
6491,0.6493,4,3,4,672148,4296,115524,10732,0.03402610569002661,0.7141336172478041
6492,0.6494,7,5,7,672153,4291,115531,10725,0.033986503611709545,0.7142381459776239
6493,0.6495,5,5,5,672158,4286,115536,10720,0.03394690153339247,0.7143809143009463
6494,0.6496,4,3,4,672161,4283,115540,10716,0.03392314028640223,0.7144476298419895
6495,0.6497,4,0,4,672161,4283,115544,10712,0.03392314028640223,0.7143714571523841
6496,0.6498,4,4,4,672165,4279,115548,10708,0.03389145862374857,0.7144858877694001
6497,0.6499,6,6,6,672171,4273,115554,10702,0.03384393612976809,0.7146577629382304
6498,0.65,5,1,5,672172,4272,115559,10697,0.033836015714104675,0.7146101944017637
6499,0.6501,4,3,4,672175,4269,115563,10693,0.03381225446711444,0.7146771821948937
6500,0.6502,3,5,3,672180,4264,115566,10690,0.03377265238879736,0.7148589006285944
6501,0.6503,5,3,5,672183,4261,115571,10685,0.033748891141807125,0.7149069985280343
6502,0.6504,1,3,1,672186,4258,115572,10684,0.03372512989481688,0.7150314549591755
6503,0.6505,6,2,6,672188,4256,115578,10678,0.03370928906349005,0.7150127226463104
6504,0.6506,11,3,11,672191,4253,115589,10667,0.03368552781649981,0.714946380697051
6505,0.6507,4,0,4,672191,4253,115593,10663,0.03368552781649981,0.7148699383212658
6506,0.6508,4,4,4,672195,4249,115597,10659,0.03365384615384615,0.7149852428226455
6507,0.6509,5,3,5,672198,4246,115602,10654,0.033630084906855914,0.7150335570469799
6508,0.651,9,4,9,672202,4242,115611,10645,0.033598403244202255,0.7150534022973064
6509,0.6511,4,1,4,672203,4241,115615,10641,0.03359048282853884,0.7150248622496976
6510,0.6512,2,2,2,672205,4239,115617,10639,0.03357464199721202,0.7150826724022046
6511,0.6513,7,5,7,672210,4234,115624,10632,0.03353503991889494,0.7151890219292345
6512,0.6514,6,2,6,672212,4232,115630,10626,0.03351919908756812,0.7151702786377709
6513,0.6515,4,3,4,672215,4229,115634,10622,0.033495437840577874,0.7152380311090162
6514,0.6516,5,1,5,672216,4228,115639,10617,0.03348751742491446,0.7151902997642304
6515,0.6517,2,6,2,672222,4222,115641,10615,0.033439994930933976,0.7154411269124487
6516,0.6518,7,2,7,672224,4220,115648,10608,0.033424154099607147,0.7154032910709469
6517,0.6519,3,5,3,672229,4215,115651,10605,0.03338455202129008,0.7155870445344129
6518,0.652,3,2,3,672231,4213,115654,10602,0.03336871118996325,0.7156260546743166
6519,0.6521,8,7,8,672238,4206,115662,10594,0.03331326828031935,0.7158108108108108
6520,0.6522,4,4,4,672242,4202,115666,10590,0.0332815866176657,0.7159275283937263
6521,0.6523,9,2,9,672244,4200,115675,10581,0.03326574578633887,0.7158514308910088
6522,0.6524,6,2,6,672246,4198,115681,10575,0.03324990495501204,0.7158329384688282
6523,0.6525,2,2,2,672248,4196,115683,10573,0.03323406412368521,0.7158913941363667
6524,0.6526,4,5,4,672253,4191,115687,10569,0.03319446204536814,0.7160569105691057
6525,0.6527,12,3,12,672256,4188,115699,10557,0.033170700798377896,0.715971515768057
6526,0.6528,8,3,8,672259,4185,115707,10549,0.03314693955138766,0.7159630785937288
6527,0.6529,1,2,1,672261,4183,115708,10548,0.03313109872006083,0.7160410019686375
6528,0.653,2,1,2,672262,4182,115710,10546,0.03312317830439741,0.7160510592069528
6529,0.6531,8,2,8,672264,4180,115718,10538,0.03310733747307058,0.7159940209267563
6530,0.6532,6,4,6,672268,4176,115724,10532,0.03307565581041693,0.7160728855044873
6531,0.6533,7,3,7,672271,4173,115731,10525,0.033051894563426686,0.7160838209280174
6532,0.6534,10,3,10,672274,4170,115741,10515,0.03302813331643645,0.7160367722165475
6533,0.6535,6,2,6,672276,4168,115747,10509,0.03301229248510962,0.7160182598623697
6534,0.6536,8,2,8,672278,4166,115755,10501,0.03299645165378279,0.7159610008863435
6535,0.6537,2,3,2,672281,4163,115757,10499,0.03297269040679255,0.716068749147456
6536,0.6538,8,1,8,672282,4162,115765,10491,0.032964769991129135,0.7159626015150481
6537,0.6539,8,4,8,672286,4158,115773,10483,0.032933088328475475,0.7160030052592036
6538,0.654,7,4,7,672290,4154,115780,10476,0.03290140666582182,0.7160628844839371
6539,0.6541,3,2,3,672292,4152,115783,10473,0.03288556583449499,0.7161025641025641
6540,0.6542,9,9,9,672301,4143,115792,10464,0.032814282093524265,0.716368864243171
6541,0.6543,6,5,6,672306,4138,115798,10458,0.0327746800152072,0.7164976705946835
6542,0.6544,9,1,9,672307,4137,115807,10449,0.03276675959954378,0.7163718634306869
6543,0.6545,7,3,7,672310,4134,115814,10442,0.032742998352553544,0.7163830954994511
6544,0.6546,10,0,10,672310,4134,115824,10432,0.032742998352553544,0.7161883839077303
6545,0.6547,3,3,3,672313,4131,115827,10429,0.0327192371055633,0.7162774725274725
6546,0.6548,6,3,6,672316,4128,115833,10423,0.032695475858573055,0.7163081575149475
6547,0.6549,4,2,4,672318,4126,115837,10419,0.03267963502724623,0.7163286352698521
6548,0.655,7,2,7,672320,4124,115844,10412,0.0326637941959194,0.7162905888827737
6549,0.6551,3,3,3,672323,4121,115847,10409,0.03264003294892916,0.7163799036476256
6550,0.6552,5,2,5,672325,4119,115852,10404,0.032624192117602334,0.716380913034497
6551,0.6553,5,4,5,672329,4115,115857,10399,0.032592510454948674,0.716480639382665
6552,0.6554,6,2,6,672331,4113,115863,10393,0.032576669623621844,0.7164621535916172
6553,0.6555,1,2,1,672333,4111,115864,10392,0.03256082879229502,0.7165414052265049
6554,0.6556,3,4,3,672337,4107,115867,10389,0.03252914712964136,0.7166804635761589
6555,0.6557,3,0,3,672337,4107,115870,10386,0.03252914712964136,0.7166218174291037
6556,0.6558,6,6,6,672343,4101,115876,10380,0.03248162463566088,0.7168013258752849
6557,0.6559,7,6,7,672349,4095,115883,10373,0.032434102141680396,0.7169615703621786
6558,0.656,5,1,5,672350,4094,115888,10368,0.03242618172601698,0.7169132900013829
6559,0.6561,5,2,5,672352,4092,115893,10363,0.03241034089469015,0.7169145624351435
6560,0.6562,6,2,6,672354,4090,115899,10357,0.03239450006336333,0.7168962414342078
6561,0.6563,5,4,5,672358,4086,115904,10352,0.03236281840070967,0.7169968139631528
6562,0.6564,4,4,4,672362,4082,115908,10348,0.032331136738056016,0.7171171171171171
6563,0.6565,7,2,7,672364,4080,115915,10341,0.032315295906729186,0.7170792594133555
6564,0.6566,5,4,5,672368,4076,115920,10336,0.032283614244075526,0.717180127671385
6565,0.6567,4,1,4,672369,4075,115924,10332,0.03227569382841212,0.7171513847435275
6566,0.6568,7,4,7,672373,4071,115931,10325,0.03224401216575846,0.7172131147540983
6567,0.6569,8,5,8,672378,4066,115939,10317,0.03220441008744139,0.7173051519154557
6568,0.657,6,5,6,672383,4061,115945,10311,0.032164808009124315,0.717436682438074
6569,0.6571,4,2,4,672385,4059,115949,10307,0.03214896717779749,0.7174578866768759
6570,0.6572,4,4,4,672389,4055,115953,10303,0.03211728551514383,0.7175790500069648
6571,0.6573,8,8,8,672397,4047,115961,10295,0.03205392218983652,0.7178217821782178
6572,0.6574,4,4,4,672401,4043,115965,10291,0.03202224052718287,0.7179433514720246
6573,0.6575,5,4,5,672405,4039,115970,10286,0.03199055886452921,0.71804537521815
6574,0.6576,8,5,8,672410,4034,115978,10278,0.03195095678621214,0.7181386249301286
6575,0.6577,4,3,4,672413,4031,115982,10274,0.0319271955392219,0.718210415938483
6576,0.6578,6,0,6,672413,4031,115988,10268,0.0319271955392219,0.7180921742779215
6577,0.6579,10,0,10,672413,4031,115998,10258,0.0319271955392219,0.7178948841766394
6578,0.658,7,4,7,672417,4027,116005,10251,0.03189551387656824,0.7179576971564645
6579,0.6581,5,2,5,672419,4025,116010,10246,0.03187967304524141,0.7179594982832317
6580,0.6582,4,3,4,672422,4022,116014,10242,0.031855911798251174,0.7180314077397645
6581,0.6583,3,5,3,672427,4017,116017,10239,0.0318163097199341,0.7182239057239057
6582,0.6584,9,2,9,672429,4015,116026,10230,0.031800468888607276,0.7181467181467182
6583,0.6585,6,2,6,672431,4013,116032,10224,0.03178462805728045,0.7181288192737234
6584,0.6586,3,6,3,672437,4007,116035,10221,0.031737105563299964,0.7183722237840877
6585,0.6587,2,5,2,672442,4002,116037,10219,0.03169750348498289,0.7185851909148443
6586,0.6588,2,4,2,672446,3998,116039,10217,0.031665821822329236,0.7187478016180091
6587,0.6589,4,3,4,672449,3995,116043,10213,0.03164206057533899,0.7188203828828829
6588,0.659,5,4,5,672453,3991,116048,10208,0.03161037891268534,0.7189238678780195
6589,0.6591,5,3,5,672456,3988,116053,10203,0.031586617665695094,0.718976816292016
6590,0.6592,9,1,9,672457,3987,116062,10194,0.03157869725003168,0.7188491643748678
6591,0.6593,5,2,5,672459,3985,116067,10189,0.031562856418704856,0.7188514180894596
6592,0.6594,4,7,4,672466,3978,116071,10185,0.03150741350906096,0.7191273035373862
6593,0.6595,8,0,8,672466,3978,116079,10177,0.03150741350906096,0.7189685623454609
6594,0.6596,5,4,5,672470,3974,116084,10172,0.0314757318464073,0.719072529336915
6595,0.6597,9,3,9,672473,3971,116093,10163,0.03145197059941706,0.7190462714022924
6596,0.6598,5,3,5,672476,3968,116098,10158,0.031428209352426816,0.7190995327764406
6597,0.6599,7,3,7,672479,3965,116105,10151,0.03140444810543657,0.7191130631907056
6598,0.66,6,6,6,672485,3959,116111,10145,0.03135692561145609,0.719299489506523
6599,0.6601,3,4,3,672489,3955,116114,10142,0.031325243948802435,0.719443853302121
6600,0.6602,7,1,7,672490,3954,116121,10135,0.03131732353313902,0.7193555255873376
6601,0.6603,5,4,5,672494,3950,116126,10130,0.03128564187048536,0.7194602272727273
6602,0.6604,9,1,9,672495,3949,116135,10121,0.03127772145482195,0.7193319118692253
6603,0.6605,5,1,5,672496,3948,116140,10116,0.03126980103915854,0.7192832764505119
6604,0.6606,8,2,8,672498,3946,116148,10108,0.03125396020783171,0.7192258431763199
6605,0.6607,3,3,3,672501,3943,116151,10105,0.031230198960841466,0.7193194760820045
6606,0.6608,3,3,3,672504,3940,116154,10102,0.03120643771385122,0.7194131890044153
6607,0.6609,5,6,5,672510,3934,116159,10097,0.03115891521987074,0.7196208395695246
6608,0.661,5,4,5,672514,3930,116164,10092,0.031127233557217082,0.7197261446298674
6609,0.6611,2,1,2,672515,3929,116166,10090,0.031119313141553667,0.7197374991083529
6610,0.6612,7,2,7,672517,3927,116173,10083,0.03110347231022684,0.7197002141327623
6611,0.6613,4,2,4,672519,3925,116177,10079,0.031087631478900014,0.7197229363039132
6612,0.6614,5,2,5,672521,3923,116182,10074,0.031071790647573184,0.7197256554976066
6613,0.6615,4,1,4,672522,3922,116186,10070,0.03106387023190977,0.7196969696969697
6614,0.6616,4,3,4,672525,3919,116190,10066,0.031040108984919528,0.7197711834107973
6615,0.6617,7,2,7,672527,3917,116197,10059,0.031024268153592702,0.719733829421866
6616,0.6618,6,3,6,672530,3914,116203,10053,0.031000506906602457,0.7197680246294837
6617,0.6619,11,0,11,672530,3914,116214,10042,0.031000506906602457,0.7195471481799943
6618,0.662,5,4,5,672534,3910,116219,10037,0.030968825243948804,0.7196529719652972
6619,0.6621,4,2,4,672536,3908,116223,10033,0.030952984412621974,0.7196757764866222
6620,0.6622,7,2,7,672538,3906,116230,10026,0.030937143581295148,0.7196382428940569
6621,0.6623,7,2,7,672540,3904,116237,10019,0.030921302749968318,0.7196006607771314
6622,0.6624,9,2,9,672542,3902,116246,10010,0.03090546191864149,0.7195227142035653
6623,0.6625,8,5,8,672547,3897,116254,10002,0.03086585984032442,0.7196201165551479
6624,0.6626,5,5,5,672552,3892,116259,9997,0.03082625776200735,0.7197782417740658
6625,0.6627,4,1,4,672553,3891,116263,9993,0.030818337346343937,0.7197493517718236
6626,0.6628,8,5,8,672558,3886,116271,9985,0.030778735268026866,0.7198471631461322
6627,0.6629,14,5,14,672563,3881,116285,9971,0.030739133189709795,0.7198238521513138
6628,0.663,3,3,3,672566,3878,116288,9968,0.030715371942719553,0.7199191102123357
6629,0.6631,3,6,3,672572,3872,116291,9965,0.03066784944873907,0.7201705572017055
6630,0.6632,7,3,7,672575,3869,116298,9958,0.03064408820174883,0.7201851450061474
6631,0.6633,3,3,3,672578,3866,116301,9955,0.030620326954758584,0.720280732219087
6632,0.6634,6,5,6,672583,3861,116307,9949,0.030580724876441517,0.7204199855177408
6633,0.6635,9,3,9,672586,3858,116316,9940,0.030556963629451275,0.7203942600376866
6634,0.6636,7,4,7,672590,3854,116323,9933,0.03052528196679762,0.7204613041270762
6635,0.6637,6,1,6,672591,3853,116329,9927,0.030517361551134204,0.7203918722786647
6636,0.6638,3,7,3,672598,3846,116332,9924,0.030461918641490306,0.7206971677559912
6637,0.6639,7,2,7,672600,3844,116339,9917,0.030446077810163476,0.7206598357677494
6638,0.664,5,1,5,672601,3843,116344,9912,0.030438157394500065,0.7206106870229008
6639,0.6641,5,3,5,672604,3840,116349,9907,0.03041439614750982,0.7206663271986615
6640,0.6642,6,4,6,672608,3836,116355,9901,0.030382714484856164,0.7207541675766179
6641,0.6643,4,1,4,672609,3835,116359,9897,0.030374794069192752,0.7207253131371978
6642,0.6644,5,2,5,672611,3833,116364,9892,0.030358953237865922,0.7207285974499089
6643,0.6645,6,2,6,672613,3831,116370,9886,0.030343112406539096,0.7207115258438435
6644,0.6646,3,3,3,672616,3828,116373,9883,0.030319351159548855,0.7208081102764204
6645,0.6647,5,3,5,672619,3825,116378,9878,0.03029558991255861,0.720864044369846
6646,0.6648,5,5,5,672624,3820,116383,9873,0.030255987834241542,0.7210253414153217
6647,0.6649,10,4,10,672628,3816,116393,9863,0.030224306171587886,0.7210322391987718
6648,0.665,5,2,5,672630,3814,116398,9858,0.030208465340261056,0.7210356933879462
6649,0.6651,9,3,9,672633,3811,116407,9849,0.030184704093270814,0.7210102489019034
6650,0.6652,7,2,7,672635,3809,116414,9842,0.030168863261943988,0.7209728225038459
6651,0.6653,5,4,5,672639,3805,116419,9837,0.03013718159929033,0.7210819527928456
6652,0.6654,1,6,1,672645,3799,116420,9836,0.030089659105309845,0.7213788045471213
6653,0.6655,5,7,5,672652,3792,116425,9831,0.030034216195665948,0.7216472142699846
6654,0.6656,8,4,8,672656,3788,116433,9823,0.03000253453301229,0.7216956873117332
6655,0.6657,7,3,7,672659,3785,116440,9816,0.02997877328602205,0.7217116388500846
6656,0.6658,7,6,7,672665,3779,116447,9809,0.029931250792041567,0.7218869590815425
6657,0.6659,7,5,7,672670,3774,116454,9802,0.029891648713724496,0.7220094284030643
6658,0.666,5,1,5,672671,3773,116459,9797,0.02988372829806108,0.7219602063375092
6659,0.6661,8,2,8,672673,3771,116467,9789,0.029867887466734255,0.7219026548672567
6660,0.6662,8,2,8,672675,3769,116475,9781,0.029852046635407425,0.7218450184501845
6661,0.6663,6,6,6,672681,3763,116481,9775,0.029804524141426942,0.7220416605111538
6662,0.6664,1,4,1,672685,3759,116482,9774,0.029772842478773286,0.7222345377964975
6663,0.6665,4,5,4,672690,3754,116486,9770,0.029733240400456214,0.7224194025436261
6664,0.6666,6,1,6,672691,3753,116492,9764,0.029725319984792803,0.722349633794481
6665,0.6667,5,4,5,672695,3749,116497,9759,0.029693638322139147,0.7224607639917087
6666,0.6668,7,1,7,672696,3748,116504,9752,0.02968571790647573,0.7223703703703703
6667,0.6669,5,4,5,672700,3744,116509,9747,0.029654036243822075,0.7224816544362909
6668,0.667,7,6,7,672706,3738,116516,9740,0.029606513749841593,0.7226591482415788
6669,0.6671,7,1,7,672707,3737,116523,9733,0.029598593334178178,0.7225686711210096
6670,0.6672,2,1,2,672708,3736,116525,9731,0.029590672918514763,0.7225811242295983
6671,0.6673,2,5,2,672713,3731,116527,9729,0.029551070840197695,0.7228083209509658
6672,0.6674,4,1,4,672714,3730,116531,9725,0.02954315042453428,0.7227796358231141
6673,0.6675,7,0,7,672714,3730,116538,9718,0.02954315042453428,0.7226353361094586
6674,0.6676,5,2,5,672716,3728,116543,9713,0.02952730959320745,0.7226396845472807
6675,0.6677,2,3,2,672719,3725,116545,9711,0.02950354834621721,0.7227597499255731
6676,0.6678,5,4,5,672723,3721,116550,9706,0.029471866683563552,0.7228718254263797
6677,0.6679,8,3,8,672726,3718,116558,9698,0.02944810543657331,0.7228682170542635
6678,0.668,3,3,3,672729,3715,116561,9695,0.02942434418958307,0.7229679343773303
6679,0.6681,5,2,5,672731,3713,116566,9690,0.02940850335825624,0.7229724688502575
6680,0.6682,5,2,5,672733,3711,116571,9685,0.029392662526929413,0.7229770080621081
6681,0.6683,2,4,2,672737,3707,116573,9683,0.029360980864275757,0.7231516056758776
6682,0.6684,4,4,4,672741,3703,116577,9679,0.0293292992016221,0.7232850097145419
6683,0.6685,3,4,3,672745,3699,116580,9676,0.029297617538968444,0.7234392523364486
6684,0.6686,4,3,4,672748,3696,116584,9672,0.029273856291978203,0.7235188509874326
6685,0.6687,2,2,2,672750,3694,116586,9670,0.029258015460651376,0.7235857527686321
6686,0.6688,4,5,4,672755,3689,116590,9666,0.029218413382334305,0.7237738674653688
6687,0.6689,4,6,4,672761,3683,116594,9662,0.029170890888353822,0.7240164855751218
6688,0.669,6,3,6,672764,3680,116600,9656,0.029147129641363578,0.7240551889622076
6689,0.6691,7,6,7,672770,3674,116607,9649,0.029099607147383095,0.7242362831194176
6690,0.6692,5,1,5,672771,3673,116612,9644,0.02909168673171968,0.7241871292333109
6691,0.6693,6,3,6,672774,3670,116618,9638,0.02906792548472944,0.7242260294559664
6692,0.6694,3,6,3,672780,3664,116621,9635,0.029020402990748956,0.7244905632002406
6693,0.6695,4,1,4,672781,3663,116625,9631,0.02901248257508554,0.7244621633819769
6694,0.6696,7,4,7,672785,3659,116632,9624,0.028980800912431885,0.7245351200782956
6695,0.6697,10,5,10,672790,3654,116642,9614,0.028941198834114813,0.7246005426590293
6696,0.6698,7,2,7,672792,3652,116649,9607,0.028925358002787987,0.7245644467908591
6697,0.6699,3,1,3,672793,3651,116652,9604,0.028917437587124572,0.7245567710298001
6698,0.67,5,5,5,672798,3646,116657,9599,0.0288778355088075,0.7247263118157795
6699,0.6701,7,1,7,672799,3645,116664,9592,0.02886991509314409,0.7246354914255496
6700,0.6702,7,8,7,672807,3637,116671,9585,0.028806551767836776,0.7249281500529421
6701,0.6703,5,2,5,672809,3635,116676,9580,0.028790710936509947,0.7249337873628453
6702,0.6704,2,4,2,672813,3631,116678,9578,0.02875902927385629,0.7251116662881368
6703,0.6705,6,5,6,672818,3626,116684,9572,0.028719427195539222,0.7252614032429155
6704,0.6706,3,2,3,672820,3624,116687,9569,0.028703586364212393,0.725308875919048
6705,0.6707,6,3,6,672823,3621,116693,9563,0.02867982511722215,0.7253489077669902
6706,0.6708,7,1,7,672824,3620,116700,9556,0.028671904701558736,0.7252580449301761
6707,0.6709,7,3,7,672827,3617,116707,9549,0.028648143454568495,0.7252772292267963
6708,0.671,6,3,6,672830,3614,116713,9543,0.028624382207578253,0.7253173215778673
6709,0.6711,6,1,6,672831,3613,116719,9537,0.02861646179191484,0.7252471482889734
6710,0.6712,5,1,5,672832,3612,116724,9532,0.028608541376251427,0.7251978088861838
6711,0.6713,7,3,7,672835,3609,116731,9525,0.028584780129261182,0.7252169940612152
6712,0.6714,9,0,9,672835,3609,116740,9516,0.028584780129261182,0.7250285714285715
6713,0.6715,5,5,5,672840,3604,116745,9511,0.028545178050944114,0.7252001524971406
6714,0.6716,10,6,10,672846,3598,116755,9501,0.028497655556963628,0.7253225437056264
6715,0.6717,8,6,8,672852,3592,116763,9493,0.028450133062983145,0.7254871990829194
6716,0.6718,7,3,7,672855,3589,116770,9486,0.028426371815992904,0.7255066921606118
6717,0.6719,6,3,6,672858,3586,116776,9480,0.028402610569002663,0.7255472217970305
6718,0.672,7,1,7,672859,3585,116783,9473,0.028394690153339248,0.725455659365906
6719,0.6721,5,6,5,672865,3579,116788,9468,0.02834716765935876,0.7256840653023684
6720,0.6722,3,4,3,672869,3575,116791,9465,0.02831548599670511,0.7258435582822086
6721,0.6723,2,3,2,672872,3572,116793,9463,0.028291724749714864,0.7259685462217108
6722,0.6724,4,6,4,672878,3566,116797,9459,0.02824420225573438,0.7262188099808061
6723,0.6725,6,0,6,672878,3566,116803,9453,0.02824420225573438,0.7260926338428451
6724,0.6726,8,0,8,672878,3566,116811,9445,0.02824420225573438,0.7259242179694105
6725,0.6727,4,2,4,672880,3564,116815,9441,0.02822836142440755,0.7259515570934256
6726,0.6728,0,4,0,672884,3560,116815,9441,0.0281966797617539,0.7261749096223368
6727,0.6729,4,3,4,672887,3557,116819,9437,0.028172918514763653,0.7262582730490996
6728,0.673,5,4,5,672891,3553,116824,9432,0.028141236852109997,0.7263765883711976
6729,0.6731,6,1,6,672892,3552,116830,9426,0.028133316436446586,0.7263060564031438
6730,0.6732,10,6,10,672898,3546,116840,9416,0.0280857939424661,0.7264311063107545
6731,0.6733,5,2,5,672900,3544,116845,9411,0.028069953111139273,0.7264376688537244
6732,0.6734,6,0,6,672900,3544,116851,9405,0.028069953111139273,0.7263109120395397
6733,0.6735,5,2,5,672902,3542,116856,9400,0.028054112279812443,0.7263174161644259
6734,0.6736,6,2,6,672904,3540,116862,9394,0.028038271448485617,0.726302767898562
6735,0.6737,4,3,4,672907,3537,116866,9390,0.028014510201495375,0.7263866326293804
6736,0.6738,5,2,5,672909,3535,116871,9385,0.027998669370168545,0.7263931888544891
6737,0.6739,8,2,8,672911,3533,116879,9377,0.02798282853884172,0.7263361735089078
6738,0.674,2,0,2,672911,3533,116881,9375,0.02798282853884172,0.7262937713046173
6739,0.6741,7,5,7,672916,3528,116888,9368,0.027943226460524648,0.7264267990074442
6740,0.6742,5,1,5,672917,3527,116893,9363,0.027935306044861233,0.726377036462374
6741,0.6743,6,2,6,672919,3525,116899,9357,0.027919465213534406,0.7263623660922217
6742,0.6744,8,2,8,672921,3523,116907,9349,0.02790362438220758,0.7263051584835302
6743,0.6745,1,2,1,672923,3521,116908,9348,0.02788778355088075,0.7263967674255964
6744,0.6746,4,1,4,672924,3520,116912,9344,0.027879863135217335,0.7263681592039801
6745,0.6747,6,3,6,672927,3517,116918,9338,0.027856101888227094,0.7264099572150914
6746,0.6748,8,2,8,672929,3515,116926,9330,0.027840261056900267,0.7263526664071623
6747,0.6749,3,1,3,672930,3514,116929,9327,0.027832340641236852,0.726345300210264
6748,0.675,7,3,7,672933,3511,116936,9320,0.02780857939424661,0.7263658327488115
6749,0.6751,1,3,1,672936,3508,116937,9319,0.02778481814725637,0.7265143837218367
6750,0.6752,2,2,2,672938,3506,116939,9317,0.02776897731592954,0.7265850425017547
6751,0.6753,2,2,2,672940,3504,116941,9315,0.027753136484602713,0.7266557453779546
6752,0.6754,3,2,3,672942,3502,116944,9312,0.027737295653275883,0.726705166224442
6753,0.6755,5,3,5,672945,3499,116949,9307,0.027713534406285642,0.7267687021708574
6754,0.6756,4,5,4,672950,3494,116953,9303,0.02767393232796857,0.7269672579510823
6755,0.6757,4,2,4,672952,3492,116957,9299,0.027658091496641744,0.7269955437416934
6756,0.6758,1,1,1,672953,3491,116958,9298,0.02765017108097833,0.7270310423019782
6757,0.6759,4,1,4,672954,3490,116962,9294,0.027642250665314914,0.7270025031289111
6758,0.676,6,6,6,672960,3484,116968,9288,0.02759472817133443,0.7272157845286564
6759,0.6761,5,1,5,672961,3483,116973,9283,0.027586807755671017,0.7271659094469685
6760,0.6762,4,7,4,672968,3476,116977,9279,0.02753136484602712,0.7274794198353587
6761,0.6763,5,1,5,672969,3475,116982,9274,0.027523444430363704,0.7274296023217507
6762,0.6764,7,4,7,672973,3471,116989,9267,0.027491762767710048,0.7275082430522845
6763,0.6765,7,3,7,672976,3468,116996,9260,0.027468001520719806,0.7275298554368321
6764,0.6766,5,3,5,672979,3465,117001,9255,0.027444240273729565,0.7275943396226415
6765,0.6767,4,4,4,672983,3461,117005,9251,0.02741255861107591,0.7277375707992448
6766,0.6768,6,0,6,672983,3461,117011,9245,0.02741255861107591,0.7276090036203369
6767,0.6769,7,2,7,672985,3459,117018,9238,0.027396717779749082,0.7275734425454832
6768,0.677,6,3,6,672988,3456,117024,9232,0.02737295653275884,0.7276166456494325
6769,0.6771,4,1,4,672989,3455,117028,9228,0.027365036117095426,0.7275881100685958
6770,0.6772,4,1,4,672990,3454,117032,9224,0.02735711570143201,0.7275595519798076
6771,0.6773,2,0,2,672990,3454,117034,9222,0.02735711570143201,0.7275165667402966
6772,0.6774,8,6,8,672996,3448,117042,9214,0.027309593207451528,0.7276891486337072
6773,0.6775,4,2,4,672998,3446,117046,9210,0.0272937523761247,0.7277180783817951
6774,0.6776,9,4,9,673002,3442,117055,9201,0.027262070713471042,0.7277544886498457
6775,0.6777,6,3,6,673005,3439,117061,9195,0.0272383094664808,0.7277980053823018
6776,0.6778,7,2,7,673007,3437,117068,9188,0.027222468635153974,0.7277623762376237
6777,0.6779,6,1,6,673008,3436,117074,9182,0.02721454821949056,0.7276906007291172
6778,0.678,6,4,6,673012,3432,117080,9176,0.027182866556836903,0.7277918781725888
6779,0.6781,6,2,6,673014,3430,117086,9170,0.027167025725510073,0.7277777777777777
6780,0.6782,5,4,5,673018,3426,117091,9165,0.02713534406285642,0.7279008815820824
6781,0.6783,6,2,6,673020,3424,117097,9159,0.02711950323152959,0.7278868314392434
6782,0.6784,4,4,4,673024,3420,117101,9155,0.027087821568875934,0.7280318091451292
6783,0.6785,4,3,4,673027,3417,117105,9151,0.027064060321885693,0.7281190324633992
6784,0.6786,4,2,4,673029,3415,117109,9147,0.027048219490558866,0.7281483840152841
6785,0.6787,6,1,6,673030,3414,117115,9141,0.02704029907489545,0.7280764635603345
6786,0.6788,2,1,2,673031,3413,117117,9139,0.027032378659232036,0.7280911408540471
6787,0.6789,2,1,2,673032,3412,117119,9137,0.02702445824356862,0.7281058251653518
6788,0.679,4,3,4,673035,3409,117123,9133,0.02700069699657838,0.7281932706107479
6789,0.6791,5,1,5,673036,3408,117128,9128,0.026992776580914965,0.7281429483088705
6790,0.6792,2,2,2,673038,3406,117130,9126,0.02697693574958814,0.7282157676348547
6791,0.6793,4,4,4,673042,3402,117134,9122,0.026945254086934482,0.7283615458320025
6792,0.6794,5,5,5,673047,3397,117139,9117,0.02690565200861741,0.7285440306856321
6793,0.6795,5,4,5,673051,3393,117144,9112,0.026873970345963755,0.7286685325869652
6794,0.6796,7,1,7,673052,3392,117151,9105,0.026866049930300343,0.7285748579659118
6795,0.6797,5,3,5,673055,3389,117156,9100,0.026842288683310102,0.7286412042597485
6796,0.6798,5,2,5,673057,3387,117161,9095,0.026826447851983272,0.728649254927095
6797,0.6799,4,1,4,673058,3386,117165,9091,0.026818527436319857,0.7286206620181134
6798,0.68,1,3,1,673061,3383,117166,9090,0.026794766189329616,0.7287741521686844
6799,0.6801,8,2,8,673063,3381,117174,9082,0.02677892535800279,0.7287170023268876
6800,0.6802,7,4,7,673067,3377,117181,9075,0.026747243695349133,0.7287985865724381
6801,0.6803,8,6,8,673073,3371,117189,9067,0.026699721201368647,0.7289757195690626
6802,0.6804,10,2,10,673075,3369,117199,9057,0.02668388037004182,0.7288749396426847
6803,0.6805,4,3,4,673078,3366,117203,9053,0.02666011912305158,0.728963684676705
6804,0.6806,6,3,6,673081,3363,117209,9047,0.026636357876061334,0.7290088638195004
6805,0.6807,5,4,5,673085,3359,117214,9042,0.02660467621340768,0.7291347471978066
6806,0.6808,3,3,3,673088,3356,117217,9039,0.026580914966417436,0.7292456635740218
6807,0.6809,7,3,7,673091,3353,117224,9032,0.026557153719427195,0.729269277351635
6808,0.681,3,4,3,673095,3349,117227,9029,0.02652547205677354,0.7294393278397157
6809,0.6811,7,0,7,673095,3349,117234,9022,0.02652547205677354,0.729286233934201
6810,0.6812,5,0,5,673095,3349,117239,9017,0.02652547205677354,0.7291767750283034
6811,0.6813,4,2,4,673097,3347,117243,9013,0.026509631225446712,0.7292071197411003
6812,0.6814,3,0,3,673097,3347,117246,9010,0.026509631225446712,0.7291413773569637
6813,0.6815,3,5,3,673102,3342,117249,9007,0.02647002914712964,0.7293707992550004
6814,0.6816,4,3,4,673105,3339,117253,9003,0.0264462679001394,0.7294603791929996
6815,0.6817,3,3,3,673108,3336,117256,9000,0.026422506653149158,0.7295719844357976
6816,0.6818,4,3,4,673111,3333,117260,8996,0.026398745406158917,0.7296617730553978
6817,0.6819,5,2,5,673113,3331,117265,8991,0.026382904574832087,0.72967050803441
6818,0.682,6,4,6,673117,3327,117271,8985,0.02635122291217843,0.729775828460039
6819,0.6821,4,6,4,673123,3321,117275,8981,0.026303700418197948,0.730043895301577
6820,0.6822,8,6,8,673129,3315,117283,8973,0.02625617792421746,0.730224609375
6821,0.6823,6,1,6,673130,3314,117289,8967,0.02624825750855405,0.7301522677306408
6822,0.6824,8,3,8,673133,3311,117297,8959,0.026224496261563805,0.7301548492257539
6823,0.6825,7,3,7,673136,3308,117304,8952,0.026200735014573564,0.7301794453507341
6824,0.6826,4,2,4,673138,3306,117308,8948,0.026184894183246737,0.7302105434960013
6825,0.6827,7,5,7,673143,3301,117315,8941,0.026145292104929666,0.7303545172357458
6826,0.6828,8,3,8,673146,3298,117323,8933,0.026121530857939425,0.7303572888561851
6827,0.6829,3,5,3,673151,3293,117326,8930,0.026081928779622354,0.7305898715536284
6828,0.683,5,1,5,673152,3292,117331,8925,0.026074008363958942,0.7305394122943439
6829,0.6831,1,4,1,673156,3288,117332,8924,0.026042326701305286,0.7307566328201769
6830,0.6832,5,2,5,673158,3286,117337,8919,0.026026485869978456,0.7307660794756248
6831,0.6833,5,1,5,673159,3285,117342,8914,0.02601856545431504,0.7307156324288876
6832,0.6834,2,3,2,673162,3282,117344,8912,0.0259948042073248,0.7308512383139248
6833,0.6835,5,2,5,673164,3280,117349,8907,0.025978963375997973,0.7308607532616723
6834,0.6836,4,5,4,673169,3275,117353,8903,0.025939361297680902,0.7310724256856627
6835,0.6837,4,3,4,673172,3272,117357,8899,0.02591560005069066,0.7311642428724016
6836,0.6838,4,0,4,673172,3272,117361,8895,0.02591560005069066,0.7310758609353168
6837,0.6839,8,2,8,673174,3270,117369,8887,0.02589975921936383,0.7310191659126429
6838,0.684,6,1,6,673175,3269,117375,8881,0.02589183880370042,0.7309465020576131
6839,0.6841,5,1,5,673176,3268,117380,8876,0.025883918388037004,0.7308959156785244
6840,0.6842,6,3,6,673179,3265,117386,8870,0.025860157141046763,0.73094355170993
6841,0.6843,7,4,7,673183,3261,117393,8863,0.025828475478393106,0.7310293632464533
6842,0.6844,4,3,4,673186,3258,117397,8859,0.025804714231402865,0.7311215647437485
6843,0.6845,3,2,3,673188,3256,117400,8856,0.025788873400076035,0.7311756935270806
6844,0.6846,3,2,3,673190,3254,117403,8853,0.02577303256874921,0.7312298670190799
6845,0.6847,3,3,3,673193,3251,117406,8850,0.025749271321758967,0.7313445169820676
6846,0.6848,5,1,5,673194,3250,117411,8845,0.025741350906095552,0.7312939231087227
6847,0.6849,2,1,2,673195,3249,117413,8843,0.025733430490432137,0.7313099569963613
6848,0.685,5,2,5,673197,3247,117418,8838,0.02571758965910531,0.731319817956144
6849,0.6851,4,3,4,673200,3244,117422,8834,0.025693828412115066,0.7314124855108461
6850,0.6852,3,1,3,673201,3243,117425,8831,0.025685907996451655,0.7314063276461819
6851,0.6853,10,4,10,673205,3239,117435,8821,0.025654226333798,0.7314262023217247
6852,0.6854,6,2,6,673207,3237,117441,8815,0.02563838550247117,0.7314138732160638
6853,0.6855,3,6,3,673213,3231,117444,8812,0.025590863008490686,0.7317113675994353
6854,0.6856,7,6,7,673219,3225,117451,8805,0.025543340514510203,0.7319201995012469
6855,0.6857,3,0,3,673219,3225,117454,8802,0.025543340514510203,0.7318533300074832
6856,0.6858,6,4,6,673223,3221,117460,8796,0.025511658851856547,0.7319630523425148
6857,0.6859,4,2,4,673225,3219,117464,8792,0.025495818020529717,0.7319956706352511
6858,0.686,7,3,7,673228,3216,117471,8785,0.025472056773539475,0.7320223314723773
6859,0.6861,7,2,7,673230,3214,117478,8778,0.02545621594221265,0.7319879919946631
6860,0.6862,5,3,5,673233,3211,117483,8773,0.025432454695222404,0.7320594125500668
6861,0.6863,4,2,4,673235,3209,117487,8769,0.025416613863895578,0.7320921689764568
6862,0.6864,4,1,4,673236,3208,117491,8765,0.025408693448232163,0.732063810239706
6863,0.6865,3,3,3,673239,3205,117494,8762,0.02538493220124192,0.7321801621124759
6864,0.6866,7,3,7,673242,3202,117501,8755,0.02536117095425168,0.7322070753533495
6865,0.6867,3,2,3,673244,3200,117504,8752,0.02534533012292485,0.7322623828647925
6866,0.6868,5,3,5,673247,3197,117509,8747,0.02532156887593461,0.7323342263898192
6867,0.6869,5,2,5,673249,3195,117514,8742,0.025305728044607782,0.7323448102538326
6868,0.687,4,2,4,673251,3193,117518,8738,0.025289887213280952,0.7323778392423099
6869,0.6871,3,3,3,673254,3190,117521,8735,0.02526612596629071,0.7324947589098533
6870,0.6872,7,4,7,673258,3186,117528,8728,0.025234444303637055,0.7325835151922109
6871,0.6873,4,4,4,673262,3182,117532,8724,0.0252027626409834,0.7327397950613136
6872,0.6874,7,1,7,673263,3181,117539,8717,0.025194842225319983,0.7326441418725836
6873,0.6875,3,4,3,673267,3177,117542,8714,0.025163160562666327,0.7328231435539484
6874,0.6876,3,5,3,673272,3172,117545,8711,0.02512355848434926,0.7330640410670706
6875,0.6877,6,2,6,673274,3170,117551,8705,0.02510771765302243,0.7330526315789474
6876,0.6878,8,4,8,673278,3166,117559,8697,0.025076035990368773,0.7331197842029841
6877,0.6879,5,1,5,673279,3165,117564,8692,0.02506811557470536,0.7330690731213629
6878,0.688,4,3,4,673282,3162,117568,8688,0.025044354327715117,0.7331645569620253
6879,0.6881,7,0,7,673282,3162,117575,8681,0.025044354327715117,0.7330068394832391
6880,0.6882,5,1,5,673283,3161,117580,8676,0.025036433912051705,0.7329559854692912
6881,0.6883,4,1,4,673284,3160,117584,8672,0.02502851349638829,0.7329276538201488
6882,0.6884,0,2,0,673286,3158,117584,8672,0.025012672665061464,0.7330515638207946
6883,0.6885,6,1,6,673287,3157,117590,8666,0.02500475224939805,0.7329780935464772
6884,0.6886,4,5,4,673292,3152,117594,8662,0.024965150171080978,0.7331979007956662
6885,0.6887,12,4,12,673296,3148,117606,8650,0.02493346850842732,0.7331751144261739
6886,0.6888,3,3,3,673299,3145,117609,8647,0.02490970726143708,0.7332937584803256
6887,0.6889,4,3,4,673302,3142,117613,8643,0.02488594601444684,0.7333899024183284
6888,0.689,8,3,8,673305,3139,117621,8635,0.024862184767456597,0.7333956174622048
6889,0.6891,5,3,5,673308,3136,117626,8630,0.024838423520466352,0.7334693183749788
6890,0.6892,1,5,1,673313,3131,117627,8629,0.024798821442149285,0.7337585034013605
6891,0.6893,8,2,8,673315,3129,117635,8621,0.024782980610822455,0.7337021276595744
6892,0.6894,5,2,5,673317,3127,117640,8616,0.02476713977949563,0.7337137017797837
6893,0.6895,3,2,3,673319,3125,117643,8613,0.0247512989481688,0.7337706593968308
6894,0.6896,2,4,2,673323,3121,117645,8611,0.024719617285515146,0.7339754517558813
6895,0.6897,6,3,6,673326,3118,117651,8605,0.0246958560385249,0.7340271261622452
6896,0.6898,3,4,3,673330,3114,117654,8602,0.024664174375871244,0.7342096278593376
6897,0.6899,4,2,4,673332,3112,117658,8598,0.024648333544544418,0.7342442356959863
6898,0.69,5,4,5,673336,3108,117663,8593,0.02461665188189076,0.7343816767797624
6899,0.6901,7,5,7,673341,3103,117670,8586,0.02457704980357369,0.7345367439473008
6900,0.6902,5,1,5,673342,3102,117675,8581,0.02456912938791028,0.7344860053068561
6901,0.6903,5,2,5,673344,3100,117680,8576,0.02455328855658345,0.7344981157930798
6902,0.6904,4,1,4,673345,3099,117684,8572,0.024545368140920034,0.7344700539799504
6903,0.6905,5,4,5,673349,3095,117689,8567,0.024513686478266378,0.734608128965872
6904,0.6906,5,4,5,673353,3091,117694,8562,0.024482004815612725,0.7347464172316142
6905,0.6907,4,2,4,673355,3089,117698,8558,0.024466163984285895,0.734781488795398
6906,0.6908,5,2,5,673357,3087,117703,8553,0.02445032315295907,0.7347938144329897
6907,0.6909,8,3,8,673360,3084,117711,8545,0.024426561905968824,0.734800928712701
6908,0.691,6,3,6,673363,3081,117717,8539,0.024402800658978582,0.7348537005163511
6909,0.6911,9,0,9,673363,3081,117726,8530,0.024402800658978582,0.7346481784514685
6910,0.6912,12,2,12,673365,3079,117738,8518,0.024386959827651756,0.7345003018021902
6911,0.6913,5,3,5,673368,3076,117743,8513,0.024363198580661515,0.7345758909310554
6912,0.6914,5,3,5,673371,3073,117748,8508,0.02433943733367127,0.7346515844918401
6913,0.6915,8,3,8,673374,3070,117756,8500,0.02431567608668103,0.7346585998271391
6914,0.6916,5,4,5,673378,3066,117761,8495,0.024283994424027372,0.7347980278522619
6915,0.6917,6,2,6,673380,3064,117767,8489,0.024268153592700546,0.73478750108197
6916,0.6918,3,1,3,673381,3063,117770,8486,0.02426023317703713,0.7347822322278985
6917,0.6919,7,1,7,673382,3062,117777,8479,0.024252312761373716,0.7346850359587558
6918,0.692,0,1,0,673383,3061,117777,8479,0.024244392345710304,0.7347487001733102
6919,0.6921,2,0,2,673383,3061,117779,8477,0.024244392345710304,0.7347027214421911
6920,0.6922,6,4,6,673387,3057,117785,8471,0.024212710683056648,0.7348195697432338
6921,0.6923,6,3,6,673390,3054,117791,8465,0.024188949436066406,0.7348728188210782
6922,0.6924,6,5,6,673395,3049,117797,8459,0.024149347357749335,0.7350538755648245
6923,0.6925,6,4,6,673399,3045,117803,8453,0.02411766569509568,0.7351713341450687
6924,0.6926,2,2,2,673401,3043,117805,8451,0.02410182486376885,0.7352531755698626
6925,0.6927,6,5,6,673406,3038,117811,8445,0.02406222278545178,0.735434990856048
6926,0.6928,1,3,1,673409,3035,117812,8444,0.02403846153846154,0.7356041467026745
6927,0.6929,2,2,2,673411,3033,117814,8442,0.02402262070713471,0.735686274509804
6928,0.693,8,1,8,673412,3032,117822,8434,0.024014700291471295,0.735566021280307
6929,0.6931,4,1,4,673413,3031,117826,8430,0.024006779875807883,0.7355379111770352
6930,0.6932,2,1,2,673414,3030,117828,8428,0.02399885946014447,0.7355559434456275
6931,0.6933,7,0,7,673414,3030,117835,8421,0.02399885946014447,0.7353942887084097
6932,0.6934,5,4,5,673418,3026,117840,8416,0.023967177797490812,0.7355357454990387
6933,0.6935,2,2,2,673420,3024,117842,8414,0.023951336966163986,0.7356181150550796
6934,0.6936,5,2,5,673422,3022,117847,8409,0.023935496134837156,0.7356311783745954
6935,0.6937,9,2,9,673424,3020,117856,8400,0.02391965530351033,0.7355516637478109
6936,0.6938,6,3,6,673427,3017,117862,8394,0.023895894056520085,0.7356059942161073
6937,0.6939,3,3,3,673430,3014,117865,8391,0.023872132809529843,0.7357299430074529
6938,0.694,11,2,11,673432,3012,117876,8380,0.023856291978203017,0.7356039325842697
6939,0.6941,6,4,6,673436,3008,117882,8374,0.02382461031554936,0.7357230715164295
6940,0.6942,5,2,5,673438,3006,117887,8369,0.02380876948422253,0.7357362637362638
6941,0.6943,8,2,8,673440,3004,117895,8361,0.023792928652895704,0.735679718433788
6942,0.6944,7,0,7,673440,3004,117902,8354,0.023792928652895704,0.735516816340905
6943,0.6945,5,2,5,673442,3002,117907,8349,0.023777087821568874,0.7355299092590961
6944,0.6946,3,4,3,673446,2998,117910,8346,0.02374540615891522,0.735719322990127
6945,0.6947,4,3,4,673449,2995,117914,8342,0.023721644911924977,0.7358207638705124
6946,0.6948,7,3,7,673452,2992,117921,8335,0.023697883664934735,0.7358523880992319
6947,0.6949,3,6,3,673458,2986,117924,8332,0.023650361170954252,0.7361724686340343
6948,0.695,4,1,4,673459,2985,117928,8328,0.023642440755290837,0.7361442588172898
6949,0.6951,4,1,4,673460,2984,117932,8324,0.023634520339627423,0.7361160240537672
6950,0.6952,5,1,5,673461,2983,117937,8319,0.02362659992396401,0.7360644133781632
6951,0.6953,2,3,2,673464,2980,117939,8317,0.023602838676973766,0.7362131539346729
6952,0.6954,5,4,5,673468,2976,117944,8312,0.02357115701432011,0.7363571934798016
6953,0.6955,4,4,4,673472,2972,117948,8308,0.023539475351666457,0.7365248226950355
6954,0.6956,4,2,4,673474,2970,117952,8304,0.023523634520339627,0.736562001064396
6955,0.6957,3,3,3,673477,2967,117955,8301,0.023499873273349386,0.7366879659211928
6956,0.6958,12,3,12,673480,2964,117967,8289,0.023476112026359144,0.7366035723806985
6957,0.6959,6,1,6,673481,2963,117973,8283,0.02346819161069573,0.7365285434821269
6958,0.696,7,4,7,673485,2959,117980,8276,0.023436509948042073,0.7366266132621273
6959,0.6961,9,2,9,673487,2957,117989,8267,0.023420669116715247,0.7365466856735566
6960,0.6962,6,4,6,673491,2953,117995,8261,0.02338898745406159,0.7366684501515962
6961,0.6963,4,6,4,673497,2947,117999,8257,0.023341464960081104,0.7369689396644056
6962,0.6964,7,3,7,673500,2944,118006,8250,0.023317703713090863,0.7370019653385742
6963,0.6965,5,1,5,673501,2943,118011,8245,0.023309783297427448,0.7369503038970325
6964,0.6966,4,1,4,673502,2942,118015,8241,0.023301862881764036,0.7369221139229187
6965,0.6967,3,4,3,673506,2938,118018,8238,0.02327018121911038,0.7371152469577666
6966,0.6968,5,1,5,673507,2937,118023,8233,0.023262260803446965,0.7370635631154879
6967,0.6969,8,4,8,673511,2933,118031,8225,0.02323057914079331,0.7371392722710163
6968,0.697,8,4,8,673515,2929,118039,8217,0.023198897478139652,0.7372151444464382
6969,0.6971,5,2,5,673517,2927,118044,8212,0.023183056646812826,0.7372295538199121
6970,0.6972,9,1,9,673518,2926,118053,8203,0.02317513623114941,0.7370832958936113
6971,0.6973,6,0,6,673518,2926,118059,8197,0.02317513623114941,0.736941472624292
6972,0.6974,6,3,6,673521,2923,118065,8191,0.02315137498415917,0.7369983804210906
6973,0.6975,11,2,11,673523,2921,118076,8180,0.02313553415283234,0.7368705522025043
6974,0.6976,3,4,3,673527,2917,118079,8177,0.023103852490178683,0.7370650802235442
6975,0.6977,4,2,4,673529,2915,118083,8173,0.023088011658851857,0.7371031746031746
6976,0.6978,6,3,6,673532,2912,118089,8167,0.023064250411861616,0.7371603935373229
6977,0.6979,5,3,5,673535,2909,118094,8162,0.02304048916487137,0.7372414416041911
6978,0.698,6,3,6,673538,2906,118100,8156,0.02301672791788113,0.7372988609654674
6979,0.6981,5,2,5,673540,2904,118105,8151,0.023000887086554303,0.7373134328358208
6980,0.6982,6,4,6,673544,2900,118111,8145,0.022969205423900647,0.7374377546401086
6981,0.6983,2,2,2,673546,2898,118113,8143,0.022953364592573817,0.7375237750203786
6982,0.6984,4,1,4,673547,2897,118117,8139,0.022945444176910405,0.7374954693729612
6983,0.6985,4,2,4,673549,2895,118121,8135,0.022929603345583575,0.7375339981867634
6984,0.6986,5,3,5,673552,2892,118126,8130,0.022905842098593334,0.7376156777354382
6985,0.6987,3,6,3,673558,2886,118129,8127,0.02285831960461285,0.7379460637428493
6986,0.6988,4,2,4,673560,2884,118133,8123,0.02284247877328602,0.7379849186881076
6987,0.6989,9,3,9,673563,2881,118142,8114,0.02281871752629578,0.7379718053660755
6988,0.699,8,3,8,673566,2878,118150,8106,0.02279495627930554,0.7379825200291333
6989,0.6991,6,3,6,673569,2875,118156,8100,0.022771195032315297,0.7380410022779044
6990,0.6992,3,4,3,673573,2871,118159,8097,0.02273951336966164,0.7382385120350109
6991,0.6993,11,1,11,673574,2870,118170,8086,0.022731592953998226,0.7380430814165754
6992,0.6994,0,2,0,673576,2868,118170,8086,0.022715752122671396,0.738177834580975
6993,0.6995,5,1,5,673577,2867,118175,8081,0.022707831707007985,0.7381256850566313
6994,0.6996,4,2,4,673579,2865,118179,8077,0.022691990875681155,0.7381648693109121
6995,0.6997,5,2,5,673581,2863,118184,8072,0.02267615004435433,0.7381801554641061
6996,0.6998,6,0,6,673581,2863,118190,8066,0.02267615004435433,0.738036416872541
6997,0.6999,7,2,7,673583,2861,118197,8059,0.0226603092130275,0.738003663003663
6998,0.7,5,2,5,673585,2859,118202,8054,0.022644468381700672,0.7380188765692294
6999,0.7001,8,6,8,673591,2853,118210,8046,0.02259694588772019,0.7382328654004955
7000,0.7002,4,1,4,673592,2852,118214,8042,0.022589025472056774,0.7382045162474756
7001,0.7003,7,2,7,673594,2850,118221,8035,0.022573184640729944,0.7381717960496096
7002,0.7004,5,1,5,673595,2849,118226,8030,0.022565264225066533,0.7381193124368048
7003,0.7005,3,2,3,673597,2847,118229,8027,0.022549423393739703,0.7381828214088652
7004,0.7006,5,2,5,673599,2845,118234,8022,0.022533582562412877,0.7381982147786877
7005,0.7007,9,1,9,673600,2844,118243,8013,0.02252566214674946,0.7380491848576956
7006,0.7008,5,1,5,673601,2843,118248,8008,0.022517741731086047,0.7379964980186158
7007,0.7009,4,2,4,673603,2841,118252,8004,0.02250190089975922,0.7380359612724758
7008,0.701,3,1,3,673604,2840,118255,8001,0.022493980484095805,0.7380315469052671
7009,0.7011,2,4,2,673608,2836,118257,7999,0.02246229882144215,0.7382556529764651
7010,0.7012,2,4,2,673612,2832,118259,7997,0.022430617158788493,0.7384800073875704
7011,0.7013,5,2,5,673614,2830,118264,7992,0.022414776327461666,0.7384956569950102
7012,0.7014,4,3,4,673617,2827,118268,7988,0.02239101508047142,0.7386037910309755
7013,0.7015,6,2,6,673619,2825,118274,7982,0.022375174249144595,0.7385953548625891
7014,0.7016,5,2,5,673621,2823,118279,7977,0.02235933341781777,0.7386111111111111
7015,0.7017,4,2,4,673623,2821,118283,7973,0.02234349258649094,0.7386511024643321
7016,0.7018,4,1,4,673624,2820,118287,7969,0.022335572170827524,0.7386226712392251
7017,0.7019,2,5,2,673629,2815,118289,7967,0.022295970092510456,0.7389167130402523
7018,0.702,4,0,4,673629,2815,118293,7963,0.022295970092510456,0.7388198181480794
7019,0.7021,5,1,5,673630,2814,118298,7958,0.02228804967684704,0.7387671741552172
7020,0.7022,5,1,5,673631,2813,118303,7953,0.022280129261183626,0.7387144714843025
7021,0.7023,6,2,6,673633,2811,118309,7947,0.0222642884298568,0.7387060791968767
7022,0.7024,5,3,5,673636,2808,118314,7942,0.022240527182866558,0.7387906976744186
7023,0.7025,3,3,3,673639,2805,118317,7939,0.022216765935876313,0.7389240506329114
7024,0.7026,5,2,5,673641,2803,118322,7934,0.022200925104549487,0.73894011362578
7025,0.7027,1,2,1,673643,2801,118323,7933,0.022185084273222657,0.7390534749394447
7026,0.7028,3,0,3,673643,2801,118326,7930,0.022185084273222657,0.7389805237163358
7027,0.7029,7,3,7,673646,2798,118333,7923,0.022161323026232416,0.7390168827534744
7028,0.703,3,5,3,673651,2793,118336,7920,0.022121720947915348,0.7392887146457575
7029,0.7031,9,0,9,673651,2793,118345,7911,0.022121720947915348,0.7390695067264574
7030,0.7032,5,1,5,673652,2792,118350,7906,0.022113800532251933,0.7390166386240419
7031,0.7033,1,1,1,673653,2791,118351,7905,0.022105880116588518,0.7390613313388182
7032,0.7034,1,2,1,673655,2789,118352,7904,0.02209003928526169,0.73917516132049
7033,0.7035,4,1,4,673656,2788,118356,7900,0.022082118869598277,0.7391467065868264
7034,0.7036,11,2,11,673658,2786,118367,7889,0.02206627803827145,0.7390163934426229
7035,0.7037,4,4,4,673662,2782,118371,7885,0.022034596375617794,0.7391956501359332
7036,0.7038,6,1,6,673663,2781,118377,7879,0.02202667595995438,0.7391181988742964
7037,0.7039,7,5,7,673668,2776,118384,7872,0.021987073881637308,0.7392937640871525
7038,0.704,7,4,7,673672,2772,118391,7865,0.02195539221898365,0.7394002068252327
7039,0.7041,0,1,0,673673,2771,118391,7865,0.02194747180332024,0.7394697254606996
7040,0.7042,7,6,7,673679,2765,118398,7858,0.021899949309339754,0.7397157111926951
7041,0.7043,9,4,9,673683,2761,118407,7849,0.021868267646686097,0.7397737983034873
7042,0.7044,8,4,8,673687,2757,118415,7841,0.02183658598403244,0.7398565767125873
7043,0.7045,8,1,8,673688,2756,118423,7833,0.02182866556836903,0.7397299083955048
7044,0.7046,6,3,6,673691,2753,118429,7827,0.021804904321378785,0.7397920604914934
7045,0.7047,5,5,5,673696,2748,118434,7822,0.021765302243061717,0.7400189214758751
7046,0.7048,5,4,5,673700,2744,118439,7817,0.02173362058040806,0.7401761196856358
7047,0.7049,1,2,1,673702,2742,118440,7816,0.02171777974908123,0.7402917219170297
7048,0.705,5,2,5,673704,2740,118445,7811,0.021701938917754404,0.7403089754525637
7049,0.7051,4,6,4,673710,2734,118449,7807,0.021654416423773918,0.7406318186130348
7050,0.7052,7,3,7,673713,2731,118456,7800,0.021630655176783677,0.7406704016712563
7051,0.7053,4,3,4,673716,2728,118460,7796,0.021606893929793435,0.7407829722538959
7052,0.7054,3,1,3,673717,2727,118463,7793,0.02159897351413002,0.7407794676806083
7053,0.7055,7,0,7,673717,2727,118470,7786,0.02159897351413002,0.7406068676876248
7054,0.7056,2,2,2,673719,2725,118472,7784,0.021583132682803194,0.7406984489485203
7055,0.7057,5,0,5,673719,2725,118477,7779,0.021583132682803194,0.7405750190403656
7056,0.7058,5,1,5,673720,2724,118482,7774,0.02157521226713978,0.7405220041912746
7057,0.7059,4,5,4,673725,2719,118486,7770,0.02153561018882271,0.7407760511011536
7058,0.706,4,1,4,673726,2718,118490,7766,0.021527689773159296,0.740747806180847
7059,0.7061,5,1,5,673727,2717,118495,7761,0.02151976935749588,0.7406947890818859
7060,0.7062,1,3,1,673730,2714,118496,7760,0.02149600811050564,0.74088218445675
7061,0.7063,4,3,4,673733,2711,118500,7756,0.0214722468635154,0.7409955096971435
7062,0.7064,11,4,11,673737,2707,118511,7745,0.021440565200861742,0.7410065059318791
7063,0.7065,3,2,3,673739,2705,118514,7742,0.021424724369534912,0.7410739925337417
7064,0.7066,4,5,4,673744,2700,118518,7738,0.021385122291217844,0.7413297566583636
7065,0.7067,6,2,6,673746,2698,118524,7732,0.021369281459891015,0.7413231064237775
7066,0.7068,9,3,9,673749,2695,118533,7723,0.021345520212900773,0.741313111921674
7067,0.7069,7,1,7,673750,2694,118540,7716,0.021337599797237358,0.7412103746397695
7068,0.707,4,0,4,673750,2694,118544,7712,0.021337599797237358,0.7411108975591005
7069,0.7071,4,1,4,673751,2693,118548,7708,0.021329679381573943,0.7410825882126718
7070,0.7072,6,1,6,673752,2692,118554,7702,0.021321758965910532,0.7410044256301712
7071,0.7073,3,1,3,673753,2691,118557,7699,0.021313838550247117,0.7410009624639076
7072,0.7074,8,5,8,673758,2686,118565,7691,0.021274236471930046,0.7411583309241592
7073,0.7075,10,0,10,673758,2686,118575,7681,0.021274236471930046,0.740908652454905
7074,0.7076,10,3,10,673761,2683,118585,7671,0.021250475224939804,0.7408730925246282
7075,0.7077,9,4,9,673765,2679,118594,7662,0.021218793562286148,0.7409341456338845
7076,0.7078,8,1,8,673766,2678,118602,7654,0.021210873146622736,0.740805265195509
7077,0.7079,6,3,6,673769,2675,118608,7648,0.02118711189963249,0.7408699021602247
7078,0.708,10,3,10,673772,2672,118618,7638,0.02116335065264225,0.7408341416100873
7079,0.7081,9,1,9,673773,2671,118627,7629,0.021155430236978835,0.7406796116504855
7080,0.7082,7,5,7,673778,2666,118634,7622,0.021115828158661767,0.7408631415241057
7081,0.7083,8,4,8,673782,2662,118642,7614,0.02108414649600811,0.740949785908914
7082,0.7084,5,5,5,673787,2657,118647,7609,0.02104454441769104,0.7411844924995129
7083,0.7085,3,3,3,673790,2654,118650,7606,0.0210207831707008,0.7413255360623782
7084,0.7086,1,0,1,673790,2654,118651,7605,0.0210207831707008,0.7413003216687787
7085,0.7087,3,2,3,673792,2652,118654,7602,0.021004942339373972,0.7413692217671153
7086,0.7088,13,0,13,673792,2652,118667,7589,0.021004942339373972,0.7410409139732448
7087,0.7089,3,4,3,673796,2648,118670,7586,0.020973260676720316,0.7412546413914403
7088,0.709,2,5,2,673801,2643,118672,7584,0.020933658598403244,0.7415664417717805
7089,0.7091,5,1,5,673802,2642,118677,7579,0.02092573818273983,0.7415125721553664
7090,0.7092,5,1,5,673803,2641,118682,7574,0.020917817767076415,0.7414586392559961
7091,0.7093,5,0,5,673803,2641,118687,7569,0.020917817767076415,0.741332027424094
7092,0.7094,8,2,8,673805,2639,118695,7561,0.020901976935749588,0.7412745098039216
7093,0.7095,6,2,6,673807,2637,118701,7555,0.02088613610442276,0.7412676609105181
7094,0.7096,8,5,8,673812,2632,118709,7547,0.02084653402610569,0.7414284310836035
7095,0.7097,4,2,4,673814,2630,118713,7543,0.02083069319477886,0.7414725253121006
7096,0.7098,2,2,2,673816,2628,118715,7541,0.020814852363452034,0.741567509096273
7097,0.7099,6,4,6,673820,2624,118721,7535,0.020783170700798378,0.7417068609115071
7098,0.71,1,4,1,673824,2620,118722,7534,0.02075148903814472,0.7419736064605081
7099,0.7101,3,1,3,673825,2619,118725,7531,0.020743568622481307,0.7419704433497537
7100,0.7102,7,4,7,673829,2615,118732,7524,0.02071188695982765,0.7420850182463754
7101,0.7103,5,3,5,673832,2612,118737,7519,0.02068812571283741,0.7421774750764979
7102,0.7104,5,4,5,673836,2608,118742,7514,0.020656444050183752,0.742343410393203
7103,0.7105,7,1,7,673837,2607,118749,7507,0.02064852363452034,0.7422384813130315
7104,0.7106,6,3,6,673840,2604,118755,7501,0.020624762387530096,0.7423057892132607
7105,0.7107,3,2,3,673842,2602,118758,7498,0.02060892155620327,0.7423762376237624
7106,0.7108,1,8,1,673850,2594,118759,7497,0.020545558230895957,0.7429392527995243
7107,0.7109,3,0,3,673850,2594,118762,7494,0.020545558230895957,0.742862807295797
7108,0.711,5,1,5,673851,2593,118767,7489,0.020537637815232542,0.7428089664749058
7109,0.7111,2,0,2,673851,2593,118769,7487,0.020537637815232542,0.7427579365079365
7110,0.7112,6,3,6,673854,2590,118775,7481,0.0205138765682423,0.7428259358554264
7111,0.7113,6,4,6,673858,2586,118781,7475,0.020482194905588644,0.742967895835404
7112,0.7114,8,2,8,673860,2584,118789,7467,0.020466354074261818,0.7429111531190926
7113,0.7115,7,2,7,673862,2582,118796,7460,0.020450513242934988,0.7428799044015136
7114,0.7116,4,4,4,673866,2578,118800,7456,0.020418831580281332,0.7430735499302372
7115,0.7117,9,6,9,673872,2572,118809,7447,0.02037130908630085,0.7432877532687893
7116,0.7118,5,2,5,673874,2570,118814,7442,0.020355468254974023,0.7433080303635637
7117,0.7119,4,2,4,673876,2568,118818,7438,0.020339627423647193,0.7433539876074355
7118,0.712,3,1,3,673877,2567,118821,7435,0.020331707007983778,0.7433513297340532
7119,0.7121,2,4,2,673881,2563,118823,7433,0.02030002534533012,0.7435974389755903
7120,0.7122,6,1,6,673882,2562,118829,7427,0.02029210492966671,0.7435178696566223
7121,0.7123,3,2,3,673884,2560,118832,7424,0.02027626409833988,0.7435897435897436
7122,0.7124,4,4,4,673888,2556,118836,7420,0.020244582435686224,0.743785084202085
7123,0.7125,3,5,3,673893,2551,118839,7417,0.020204980357369156,0.7440810593900482
7124,0.7126,4,3,4,673896,2548,118843,7413,0.02018121911037891,0.7442023893183415
7125,0.7127,6,1,6,673897,2547,118849,7407,0.0201732986947155,0.744122965641953
7126,0.7128,2,4,2,673901,2543,118851,7405,0.020141617032061843,0.7443707277844793
7127,0.7129,1,2,1,673903,2541,118852,7404,0.020125776200735013,0.7444947209653092
7128,0.713,5,5,5,673908,2536,118857,7399,0.020086174122417946,0.7447408152994464
7129,0.7131,6,4,6,673912,2532,118863,7393,0.02005449245976429,0.7448866498740554
7130,0.7132,5,1,5,673913,2531,118868,7388,0.020046572044100874,0.7448331485028733
7131,0.7133,4,5,4,673918,2526,118872,7384,0.020006969965783803,0.7451059535822402
7132,0.7134,9,1,9,673919,2525,118881,7375,0.01999904955012039,0.7449494949494949
7133,0.7135,5,2,5,673921,2523,118886,7370,0.01998320871879356,0.7449711917517436
7134,0.7136,5,3,5,673924,2520,118891,7365,0.01995944747180332,0.7450682852807283
7135,0.7137,4,2,4,673926,2518,118895,7361,0.019943606640476494,0.7451159024192732
7136,0.7138,5,1,5,673927,2517,118900,7356,0.01993568622481308,0.745062291096931
7137,0.7139,7,2,7,673929,2515,118907,7349,0.01991984539348625,0.7450324412003244
7138,0.714,4,0,4,673929,2515,118911,7345,0.01991984539348625,0.7449290060851927
7139,0.7141,3,1,3,673930,2514,118914,7342,0.019911924977822838,0.744926948051948
7140,0.7142,5,1,5,673931,2513,118919,7337,0.019904004562159423,0.7448730964467005
7141,0.7143,7,1,7,673932,2512,118926,7330,0.019896084146496008,0.7447673237146921
7142,0.7144,7,5,7,673937,2507,118933,7323,0.019856482068178936,0.7449643947100713
7143,0.7145,1,5,1,673942,2502,118934,7322,0.01981687998986187,0.7453175895765473
7144,0.7146,5,2,5,673944,2500,118939,7317,0.01980103915853504,0.7453397168177651
7145,0.7147,6,4,6,673948,2496,118945,7311,0.019769357495881382,0.7454879167941266
7146,0.7148,4,3,4,673951,2493,118949,7307,0.01974559624889114,0.7456122448979592
7147,0.7149,8,5,8,673956,2488,118957,7299,0.019705994170574073,0.7457852252988658
7148,0.715,7,4,7,673960,2484,118964,7292,0.019674312507920417,0.7459083469721768
7149,0.7151,4,2,4,673962,2482,118968,7288,0.019658471676593587,0.745957011258956
7150,0.7152,3,2,3,673964,2480,118971,7285,0.01964263084526676,0.746031746031746
7151,0.7153,8,1,8,673965,2479,118979,7277,0.019634710429603346,0.7458999589995899
7152,0.7154,6,2,6,673967,2477,118985,7271,0.01961886959827652,0.7458965941731637
7153,0.7155,7,0,7,673967,2477,118992,7264,0.01961886959827652,0.745713992403244
7154,0.7156,7,2,7,673969,2475,118999,7257,0.01960302876694969,0.7456843403205918
7155,0.7158,3,2,3,673971,2473,119002,7254,0.019587187935622863,0.745759226894212
7156,0.7159,4,3,4,673974,2470,119006,7250,0.019563426688632618,0.7458847736625515
7157,0.716,9,3,9,673977,2467,119015,7241,0.019539665441642377,0.7458796868562011
7158,0.7161,5,0,5,673977,2467,119020,7236,0.019539665441642377,0.7457487375038648
7159,0.7162,1,2,1,673979,2465,119021,7235,0.01952382461031555,0.7458762886597938
7160,0.7163,7,1,7,673980,2464,119028,7228,0.019515904194652135,0.7457697069748246
7161,0.7164,2,2,2,673982,2462,119030,7226,0.01950006336332531,0.7458711808422791
7162,0.7165,5,1,5,673983,2461,119035,7221,0.019492142947661894,0.7458169799628176
7163,0.7166,3,4,3,673987,2457,119038,7218,0.019460461285008238,0.746046511627907
7164,0.7167,4,2,4,673989,2455,119042,7214,0.019444620453681408,0.746095769986555
7165,0.7168,5,2,5,673991,2453,119047,7209,0.01942877962235458,0.7461188159801283
7166,0.7169,9,2,9,673993,2451,119056,7200,0.019412938791027755,0.7460366801367734
7167,0.717,8,3,8,673996,2448,119064,7192,0.01938917754403751,0.7460580912863071
7168,0.7171,9,2,9,673998,2446,119073,7183,0.019373336712710684,0.7459756984110499
7169,0.7172,2,2,2,674000,2444,119075,7181,0.019357495881383854,0.7460779220779221
7170,0.7173,11,0,11,674000,2444,119086,7170,0.019357495881383854,0.7457873933846474
7171,0.7174,6,6,6,674006,2438,119092,7164,0.01930997338740337,0.7460945636325765
7172,0.7175,7,2,7,674008,2436,119099,7157,0.019294132556076544,0.7460648389450641
7173,0.7176,7,1,7,674009,2435,119106,7150,0.01928621214041313,0.7459572248304642
7174,0.7177,7,5,7,674014,2430,119113,7143,0.019246610062096058,0.7461610780319649
7175,0.7178,2,2,2,674016,2428,119115,7141,0.019230769230769232,0.7462639774271084
7176,0.7179,3,0,3,674016,2428,119118,7138,0.019230769230769232,0.7461844030942922
7177,0.718,5,1,5,674017,2427,119123,7133,0.019222848815105817,0.7461297071129707
7178,0.7181,5,2,5,674019,2425,119128,7128,0.019207007983778987,0.7461530409295509
7179,0.7182,4,3,4,674022,2422,119132,7124,0.019183246736788746,0.7462811648858161
7180,0.7183,6,2,6,674024,2420,119138,7118,0.01916740590546192,0.7462780457118893
7181,0.7184,4,3,4,674027,2417,119142,7114,0.019143644658471678,0.7464064631203441
7182,0.7185,0,5,0,674032,2412,119142,7114,0.019104042580154607,0.7467982364056267
7183,0.7186,7,4,7,674036,2408,119149,7107,0.01907236091750095,0.7469259064634787
7184,0.7187,6,5,6,674041,2403,119155,7101,0.01903275883918388,0.7471590909090909
7185,0.7188,5,3,5,674044,2400,119160,7096,0.019008997592193638,0.7472620050547599
7186,0.7189,4,3,4,674047,2397,119164,7092,0.018985236345203396,0.7473917167246286
7187,0.719,9,1,9,674048,2396,119173,7083,0.01897731592953998,0.7472307205401414
7188,0.7191,4,1,4,674049,2395,119177,7079,0.01896939551387657,0.7472028710154106
7189,0.7192,3,4,3,674053,2391,119180,7076,0.018937713851222913,0.7474384704763917
7190,0.7193,5,4,5,674057,2387,119185,7071,0.018906032188569257,0.7476210615352082
7191,0.7194,5,1,5,674058,2386,119190,7066,0.018898111772905842,0.7475666525603047
7192,0.7195,8,0,8,674058,2386,119198,7058,0.018898111772905842,0.7473528166031342
7193,0.7196,6,4,6,674062,2382,119204,7052,0.018866430110252186,0.7475090099639602
7194,0.7197,6,0,6,674062,2382,119210,7046,0.018866430110252186,0.7473483241408571
7195,0.7198,7,1,7,674063,2381,119217,7039,0.01885850969458877,0.74723991507431
7196,0.7199,5,2,5,674065,2379,119222,7034,0.018842668863261944,0.7472644215446722
7197,0.72,2,3,2,674068,2376,119224,7032,0.018818907616271703,0.7474489795918368
7198,0.7201,2,3,2,674071,2373,119226,7030,0.018795146369281458,0.7476337339147081
7199,0.7202,3,2,3,674073,2371,119229,7027,0.018779305537954632,0.7477122792083422
7200,0.7203,3,2,3,674075,2369,119232,7024,0.018763464706627805,0.7477909081230704
7201,0.7204,3,4,3,674079,2365,119235,7021,0.01873178304397415,0.7480289793309184
7202,0.7205,7,4,7,674083,2361,119242,7014,0.018700101381320493,0.74816
7203,0.7206,8,0,8,674083,2361,119250,7006,0.018700101381320493,0.7479449129924202
7204,0.7207,3,1,3,674084,2360,119253,7003,0.018692180965657078,0.747944035031507
7205,0.7208,5,0,5,674084,2360,119258,6998,0.018692180965657078,0.7478093609745672
7206,0.7209,7,4,7,674088,2356,119265,6991,0.01866049930300342,0.7479405156734781
7207,0.721,6,2,6,674090,2354,119271,6985,0.018644658471676595,0.7479387514723204
7208,0.7211,5,2,5,674092,2352,119276,6980,0.018628817640349765,0.7479639948564081
7209,0.7212,2,4,2,674096,2348,119278,6978,0.01859713597769611,0.7482307527342912
7210,0.7213,6,3,6,674099,2345,119284,6972,0.018573374730705867,0.7483095416979715
7211,0.7214,6,2,6,674101,2343,119290,6966,0.01855753389937904,0.7483080889461811
7212,0.7215,3,3,3,674104,2340,119293,6963,0.018533772652388796,0.7484682360528861
7213,0.7216,3,3,3,674107,2337,119296,6960,0.018510011405398555,0.7486285898676993
7214,0.7217,3,0,3,674107,2337,119299,6957,0.018510011405398555,0.7485474499677212
7215,0.7218,6,0,6,674107,2337,119305,6951,0.018510011405398555,0.7483850129198967
7216,0.7219,3,0,3,674107,2337,119308,6948,0.018510011405398555,0.7483037156704362
7217,0.722,8,2,8,674109,2335,119316,6940,0.01849417057407173,0.7482479784366577
7218,0.7221,3,3,3,674112,2332,119319,6937,0.018470409327081484,0.7484086740748732
7219,0.7222,6,2,6,674114,2330,119325,6931,0.018454568495754657,0.7484072994277076
7220,0.7223,4,1,4,674115,2329,119329,6927,0.018446648080091242,0.7483794295592049
7221,0.7224,4,6,4,674121,2323,119333,6923,0.01839912558611076,0.7487562189054726
7222,0.7225,8,0,8,674121,2323,119341,6915,0.01839912558611076,0.7485386447282961
7223,0.7226,6,0,6,674121,2323,119347,6909,0.01839912558611076,0.7483752166377816
7224,0.7227,6,4,6,674125,2319,119353,6903,0.018367443923457103,0.7485361093038386
7225,0.7228,5,4,5,674129,2315,119358,6898,0.018335762260803447,0.7487246282427006
7226,0.7229,3,0,3,674129,2315,119361,6895,0.018335762260803447,0.748642779587405
7227,0.723,7,0,7,674129,2315,119368,6888,0.018335762260803447,0.7484515918722155
7228,0.7231,5,2,5,674131,2313,119373,6883,0.01831992142947662,0.7484775989560678
7229,0.7232,4,2,4,674133,2311,119377,6879,0.01830408059814979,0.7485310119695321
7230,0.7233,7,3,7,674136,2308,119384,6872,0.01828031935115955,0.7485838779956427
7231,0.7234,5,3,5,674139,2305,119389,6867,0.018256558104169308,0.7486916703009159
7232,0.7235,2,3,2,674142,2302,119391,6865,0.018232796857179066,0.7488818588414967
7233,0.7236,4,1,4,674143,2301,119395,6861,0.01822487644151565,0.7488539620170268
7234,0.7237,4,2,4,674145,2299,119399,6857,0.01820903561018882,0.7489078200087375
7235,0.7238,2,0,2,674145,2299,119401,6855,0.01820903561018882,0.7488529604544462
7236,0.7239,2,3,2,674148,2296,119403,6853,0.01818527436319858,0.749043611323642
7237,0.724,3,1,3,674149,2295,119406,6850,0.018177353947535165,0.7490431930016402
7238,0.7241,6,4,6,674153,2291,119412,6844,0.01814567228488151,0.7492063492063492
7239,0.7242,4,2,4,674155,2289,119416,6840,0.018129831453554682,0.7492605980939862
7240,0.7243,6,1,6,674156,2288,119422,6834,0.018121911037891267,0.7491778118833589
7241,0.7244,3,2,3,674158,2286,119425,6831,0.01810607020656444,0.7492596248766041
7242,0.7245,7,2,7,674160,2284,119432,6824,0.01809022937523761,0.7492314448836188
7243,0.7246,6,2,6,674162,2282,119438,6818,0.018074388543910785,0.7492307692307693
7244,0.7247,2,4,2,674166,2278,119440,6816,0.01804270688125713,0.7495051682427974
7245,0.7248,7,2,7,674168,2276,119447,6809,0.018026866049930302,0.7494771601541002
7246,0.7249,4,1,4,674169,2275,119451,6805,0.018018945634266887,0.7494493392070485
7247,0.725,5,2,5,674171,2273,119456,6800,0.018003104802940057,0.7494764686432271
7248,0.7251,1,0,1,674171,2273,119457,6799,0.018003104802940057,0.7494488536155203
7249,0.7252,5,2,5,674173,2271,119462,6794,0.01798726397161323,0.7494760066188637
7250,0.7253,1,3,1,674176,2268,119463,6793,0.01796350272462299,0.7496965014899017
7251,0.7254,3,2,3,674178,2266,119466,6790,0.01794766189329616,0.7497791519434629
7252,0.7255,7,3,7,674181,2263,119473,6783,0.017923900646305918,0.7498341808534159
7253,0.7256,6,2,6,674183,2261,119479,6777,0.01790805981497909,0.7498340340783359
7254,0.7257,6,0,6,674183,2261,119485,6771,0.01790805981497909,0.74966784765279
7255,0.7258,8,2,8,674185,2259,119493,6763,0.017892218983652262,0.7496120594103303
7256,0.7259,3,1,3,674186,2258,119496,6760,0.017884298567988847,0.7496118873364382
7257,0.726,8,6,8,674192,2252,119504,6752,0.017836776074008364,0.7498889382496668
7258,0.7261,5,1,5,674193,2251,119509,6747,0.01782885565834495,0.749833296288064
7259,0.7262,6,0,6,674193,2251,119515,6741,0.01782885565834495,0.7496663701067615
7260,0.7263,6,4,6,674197,2247,119521,6735,0.017797173995691293,0.7498329993319973
7261,0.7264,6,1,6,674198,2246,119527,6729,0.01778925358002788,0.7497493036211699
7262,0.7265,3,2,3,674200,2244,119530,6726,0.01777341274870105,0.7498327759197324
7263,0.7266,6,0,6,674200,2244,119536,6720,0.01777341274870105,0.749665327978581
7264,0.7267,4,1,4,674201,2243,119540,6716,0.017765492333037636,0.749637236298694
7265,0.7268,5,1,5,674202,2242,119545,6711,0.017757571917374225,0.7495811459845861
7266,0.7269,6,1,6,674203,2241,119551,6705,0.01774965150171081,0.7494969818913481
7267,0.727,5,1,5,674204,2240,119556,6700,0.017741731086047395,0.7494407158836689
7268,0.7271,1,2,1,674206,2238,119557,6699,0.01772589025472057,0.7495803961060759
7269,0.7272,3,4,3,674210,2234,119560,6696,0.017694208592066912,0.7498320268756999
7270,0.7273,7,2,7,674212,2232,119567,6689,0.017678367760740082,0.749803833650936
7271,0.7274,4,3,4,674215,2229,119571,6685,0.01765460651374984,0.7499439084586045
7272,0.7275,4,2,4,674217,2227,119575,6681,0.017638765682423015,0.75
7273,0.7276,7,8,7,674225,2219,119582,6674,0.017575402357115702,0.7504779039694142
7274,0.7277,4,1,4,674226,2218,119586,6670,0.017567481941452287,0.7504500450045004
7275,0.7278,4,1,4,674227,2217,119590,6666,0.017559561525788872,0.7504221546774739
7276,0.7279,9,2,9,674229,2215,119599,6657,0.017543720694462046,0.7503381424706943
7277,0.728,5,2,5,674231,2213,119604,6652,0.017527879863135216,0.7503666102650874
7278,0.7281,2,4,2,674235,2209,119606,6650,0.017496198200481563,0.7506490574556948
7279,0.7282,2,0,2,674235,2209,119608,6648,0.017496198200481563,0.7505927514959919
7280,0.7283,3,4,3,674239,2205,119611,6645,0.017464516537827907,0.7508474576271187
7281,0.7284,8,1,8,674240,2204,119619,6637,0.01745659612216449,0.7507069336047958
7282,0.7285,1,0,1,674240,2204,119620,6636,0.01745659612216449,0.7506787330316742
7283,0.7286,4,5,4,674245,2199,119624,6632,0.01741699404384742,0.7509908277658249
7284,0.7287,4,3,4,674248,2196,119628,6628,0.01739323279685718,0.7511332728921124
7285,0.7288,2,2,2,674250,2194,119630,6626,0.017377391965530353,0.7512471655328798
7286,0.7289,6,0,6,674250,2194,119636,6620,0.017377391965530353,0.7510778307238484
7287,0.729,7,4,7,674254,2190,119643,6613,0.017345710302876696,0.7512211745995683
7288,0.7291,7,2,7,674256,2188,119650,6606,0.017329869471549866,0.7511939959062998
7289,0.7292,6,2,6,674258,2186,119656,6600,0.01731402864022304,0.7511950830867289
7290,0.7293,1,3,1,674261,2183,119657,6599,0.0172902673932328,0.7514233659758597
7291,0.7294,3,3,3,674264,2180,119660,6596,0.017266506146242554,0.7515952597994531
7292,0.7295,6,2,6,674266,2178,119666,6590,0.017250665314915727,0.7515967153284672
7293,0.7296,4,2,4,674268,2176,119670,6586,0.017234824483588897,0.7516548733165944
7294,0.7297,5,1,5,674269,2175,119675,6581,0.017226904067925486,0.7515989036089539
7295,0.7298,4,2,4,674271,2173,119679,6577,0.017211063236598656,0.7516571428571429
7296,0.7299,2,2,2,674273,2171,119681,6575,0.01719522240527183,0.7517722387377087
7297,0.73,9,2,9,674275,2169,119690,6566,0.017179381573945,0.7516886090440755
7298,0.7301,3,2,3,674277,2167,119693,6563,0.017163540742618173,0.7517754868270332
7299,0.7302,2,1,2,674278,2166,119695,6561,0.01715562032695476,0.7518047438982468
7300,0.7303,8,1,8,674279,2165,119703,6553,0.017147699911291343,0.7516632255104382
7301,0.7304,9,0,9,674279,2165,119712,6544,0.017147699911291343,0.7514065908829946
7302,0.7305,7,1,7,674280,2164,119719,6537,0.017139779495627932,0.7512929548327778
7303,0.7306,5,3,5,674283,2161,119724,6532,0.017116018248637687,0.7514091797998389
7304,0.7307,4,1,4,674284,2160,119728,6528,0.017108097832974276,0.7513812154696132
7305,0.7308,9,1,9,674285,2159,119737,6519,0.01710017741731086,0.7512099562111085
7306,0.7309,4,3,4,674288,2156,119741,6515,0.01707641617032062,0.7513550916849268
7307,0.731,5,4,5,674292,2152,119746,6510,0.017044734507666963,0.7515585315169707
7308,0.7311,3,3,3,674295,2149,119749,6507,0.01702097326067672,0.7517329020332717
7309,0.7312,6,3,6,674298,2146,119755,6501,0.016997212013686477,0.7518214409621834
7310,0.7313,4,3,4,674301,2143,119759,6497,0.016973450766696235,0.7519675925925926
7311,0.7314,8,3,8,674304,2140,119767,6489,0.016949689519705994,0.7519990728937305
7312,0.7315,4,0,4,674304,2140,119771,6485,0.016949689519705994,0.7518840579710145
7313,0.7316,6,2,6,674306,2138,119777,6479,0.016933848688379168,0.7518858071254497
7314,0.7317,2,2,2,674308,2136,119779,6477,0.016918007857052338,0.7520027864855451
7315,0.7318,4,2,4,674310,2134,119783,6473,0.01690216702572551,0.7520622748925293
7316,0.7319,4,0,4,674310,2134,119787,6469,0.01690216702572551,0.7519469952342206
7317,0.732,5,1,5,674311,2133,119792,6464,0.016894246610062096,0.7518901942538094
7318,0.7321,6,4,6,674315,2129,119798,6458,0.01686256494740844,0.7520670781413765
7319,0.7322,6,2,6,674317,2127,119804,6452,0.016846724116081613,0.7520690057116214
7320,0.7323,7,2,7,674319,2125,119811,6445,0.016830883284754784,0.7520420070011669
7321,0.7324,11,3,11,674322,2122,119822,6434,0.016807122037764542,0.751986909770921
7322,0.7325,9,3,9,674325,2119,119831,6425,0.0167833607907743,0.7519897003745318
7323,0.7326,6,5,6,674330,2114,119837,6419,0.01674375871245723,0.7522559474979491
7324,0.7327,4,1,4,674331,2113,119841,6415,0.016735838296793815,0.7522279549718575
7325,0.7328,7,2,7,674333,2111,119848,6408,0.016719997465466988,0.7522009625542904
7326,0.7329,6,1,6,674334,2110,119854,6402,0.016712077049803573,0.7521146616541353
7327,0.733,12,1,12,674335,2109,119866,6390,0.01670415663414016,0.7518531591951995
7328,0.7331,5,2,5,674337,2107,119871,6385,0.016688315802813332,0.7518841262364578
7329,0.7332,3,4,3,674341,2103,119874,6382,0.016656634140159676,0.7521508544490277
7330,0.7333,5,3,5,674344,2100,119879,6377,0.016632872893169434,0.7522708505367465
7331,0.7334,4,3,4,674347,2097,119883,6373,0.016609111646179193,0.7524203069657616
7332,0.7335,8,1,8,674348,2096,119891,6365,0.016601191230515778,0.7522751447819407
7333,0.7336,4,2,4,674350,2094,119895,6361,0.016585350399188948,0.7523358959195742
7334,0.7337,8,1,8,674351,2093,119903,6353,0.016577429983525536,0.7521903859815298
7335,0.7338,7,3,7,674354,2090,119910,6346,0.01655366873653529,0.7522522522522522
7336,0.7339,3,1,3,674355,2089,119913,6343,0.01654574832087188,0.7522533206831119
7337,0.734,4,1,4,674356,2088,119917,6339,0.016537827905208465,0.7522249911000356
7338,0.7341,7,4,7,674360,2084,119924,6332,0.01650614624255481,0.7523764258555133
7339,0.7342,4,3,4,674363,2081,119928,6328,0.016482384995564568,0.7525270543465334
7340,0.7343,5,2,5,674365,2079,119933,6323,0.016466544164237738,0.7525589145441561
7341,0.7344,7,2,7,674367,2077,119940,6316,0.01645070333291091,0.7525318717979268
7342,0.7345,5,1,5,674368,2076,119945,6311,0.016442782917247496,0.7524740670084655
7343,0.7346,6,1,6,674369,2075,119951,6305,0.016434862501584085,0.7523866348448688
7344,0.7347,5,1,5,674370,2074,119956,6300,0.01642694208592067,0.7523286362550752
7345,0.7348,5,3,5,674373,2071,119961,6295,0.01640318083893043,0.7524503944537413
7346,0.7349,8,2,8,674375,2069,119969,6287,0.0163873400076036,0.7523934897079942
7347,0.735,7,1,7,674376,2068,119976,6280,0.016379419591940184,0.7522759942501198
7348,0.7351,3,3,3,674379,2065,119979,6277,0.016355658344949942,0.7524574442579717
7349,0.7352,6,0,6,674379,2065,119985,6271,0.016355658344949942,0.7522792706333973
7350,0.7353,1,1,1,674380,2064,119986,6270,0.016347737929286527,0.7523398128149748
7351,0.7354,0,1,0,674381,2063,119986,6270,0.016339817513623116,0.7524300972038882
7352,0.7355,4,6,4,674387,2057,119990,6266,0.01629229501964263,0.7528535383876006
7353,0.7356,8,1,8,674388,2056,119998,6258,0.016284374603979218,0.7527062785662737
7354,0.7357,6,4,6,674392,2052,120004,6252,0.016252692941325562,0.7528901734104047
7355,0.7358,8,0,8,674392,2052,120012,6244,0.016252692941325562,0.7526518804243009
7356,0.7359,1,1,1,674393,2051,120013,6243,0.016244772525662147,0.7527128044369423
7357,0.736,2,2,2,674395,2049,120015,6241,0.01622893169433532,0.7528347406513872
7358,0.7361,4,1,4,674396,2048,120019,6237,0.016221011278671905,0.7528062764031382
7359,0.7362,3,2,3,674398,2046,120022,6234,0.016205170447345076,0.7528985507246376
7360,0.7363,8,3,8,674401,2043,120030,6226,0.016181409200354834,0.7529326399806506
7361,0.7364,4,4,4,674405,2039,120034,6222,0.016149727537701178,0.7531775814066094
7362,0.7365,9,3,9,674408,2036,120043,6213,0.016125966290710936,0.7531822039035034
7363,0.7366,4,3,4,674411,2033,120047,6209,0.016102205043720695,0.753336568793982
7364,0.7367,5,1,5,674412,2032,120052,6204,0.01609428462805728,0.7532782904322487
7365,0.7368,3,0,3,674412,2032,120055,6201,0.01609428462805728,0.753188388193854
7366,0.7369,6,0,6,674412,2032,120061,6195,0.01609428462805728,0.7530083870183542
7367,0.737,5,3,5,674415,2029,120066,6190,0.01607052338106704,0.7531329845479985
7368,0.7371,7,2,7,674417,2027,120073,6183,0.01605468254974021,0.7531059683313033
7369,0.7372,5,4,5,674421,2023,120078,6178,0.016023000887086553,0.7533227655164004
7370,0.7373,6,2,6,674423,2021,120084,6172,0.016007160055759726,0.7533260100085439
7371,0.7374,3,4,3,674427,2017,120087,6169,0.01597547839310607,0.7536037136574639
7372,0.7375,4,1,4,674428,2016,120091,6165,0.015967557977442655,0.7535753575357536
7373,0.7376,2,2,2,674430,2014,120093,6163,0.01595171714611583,0.7536994007582243
7374,0.7377,4,0,4,674430,2014,120097,6159,0.01595171714611583,0.7535788572127737
7375,0.7378,2,1,2,674431,2013,120099,6157,0.015943796730452413,0.7536107711138311
7376,0.7379,3,4,3,674435,2009,120102,6154,0.015912115067798757,0.7538895014087957
7377,0.738,2,2,2,674437,2007,120104,6152,0.01589627423647193,0.754013972300527
7378,0.7381,7,2,7,674439,2005,120111,6145,0.0158804334051451,0.7539877300613497
7379,0.7382,5,2,5,674441,2003,120116,6140,0.015864592573818274,0.7540218592656269
7380,0.7383,2,1,2,674442,2002,120118,6138,0.01585667215815486,0.754054054054054
7381,0.7384,2,2,2,674444,2000,120120,6136,0.015840831326828033,0.7541789577187807
7382,0.7385,3,4,3,674448,1996,120123,6133,0.015809149664174377,0.7544593430926313
7383,0.7386,7,4,7,674452,1992,120130,6126,0.01577746800152072,0.754619364375462
7384,0.7387,7,0,7,674452,1992,120137,6119,0.01577746800152072,0.7544075946245838
7385,0.7388,5,1,5,674453,1991,120142,6114,0.015769547585857305,0.7543491671807526
7386,0.7389,4,2,4,674455,1989,120146,6110,0.01575370675453048,0.7544141252006421
7387,0.739,5,1,5,674456,1988,120151,6105,0.015745786338867064,0.7543556159644137
7388,0.7391,7,3,7,674459,1985,120158,6098,0.015722025091876823,0.7544228627984659
7389,0.7392,4,1,4,674460,1984,120162,6094,0.015714104676213408,0.7543946521416192
7390,0.7393,6,0,6,674460,1984,120168,6088,0.015714104676213408,0.7542120911793855
7391,0.7394,6,2,6,674462,1982,120174,6082,0.01569826384488658,0.7542162698412699
7392,0.7395,3,3,3,674465,1979,120177,6079,0.015674502597896336,0.7544055596922313
7393,0.7396,8,2,8,674467,1977,120185,6071,0.01565866176656951,0.7543489065606361
7394,0.7397,4,4,4,674471,1973,120189,6067,0.015626980103915854,0.7546019900497513
7395,0.7398,5,3,5,674474,1970,120194,6062,0.01560321885692561,0.7547310756972112
7396,0.7399,5,2,5,674476,1968,120199,6057,0.015587378025598784,0.7547663551401869
7397,0.74,9,4,9,674480,1964,120208,6048,0.015555696362945128,0.7548676984523215
7398,0.7401,9,0,9,674480,1964,120217,6039,0.015555696362945128,0.754592027989504
7399,0.7402,3,2,3,674482,1962,120220,6036,0.0155398555316183,0.754688672168042
7400,0.7403,4,2,4,674484,1960,120224,6032,0.015524014700291472,0.7547547547547547
7401,0.7404,5,2,5,674486,1958,120229,6027,0.015508173868964643,0.7547902316844083
7402,0.7405,5,0,5,674486,1958,120234,6022,0.015508173868964643,0.7546365914786968
7403,0.7406,5,3,5,674489,1955,120239,6017,0.015484412621974402,0.7547666833918716
7404,0.7407,2,2,2,674491,1953,120241,6015,0.015468571790647574,0.754894578313253
7405,0.7408,4,2,4,674493,1951,120245,6011,0.015452730959320746,0.7549610650590304
7406,0.7409,7,2,7,674495,1949,120252,6004,0.015436890127993918,0.7549352445618006
7407,0.741,4,2,4,674497,1947,120256,6000,0.01542104929666709,0.7550018875047187
7408,0.7411,4,0,4,674497,1947,120260,5996,0.01542104929666709,0.7548785093793277
7409,0.7412,4,3,4,674500,1944,120264,5992,0.015397288049676846,0.7550403225806451
7410,0.7413,5,4,5,674504,1940,120269,5987,0.015365606387023192,0.7552668096379462
7411,0.7414,5,4,5,674508,1936,120274,5982,0.015333924724369535,0.755493811568578
7412,0.7415,3,0,3,674508,1936,120277,5979,0.015333924724369535,0.7554011370814908
7413,0.7416,10,0,10,674508,1936,120287,5969,0.015333924724369535,0.7550917141049969
7414,0.7417,7,3,7,674511,1933,120294,5962,0.015310163477379292,0.7551614946168461
7415,0.7418,2,0,2,674511,1933,120296,5960,0.015310163477379292,0.7550994552134803
7416,0.7419,2,2,2,674513,1931,120298,5958,0.015294322646052464,0.755228799594372
7417,0.742,1,2,1,674515,1929,120299,5957,0.015278481814725638,0.7553892974892215
7418,0.7421,8,0,8,674515,1929,120307,5949,0.015278481814725638,0.7551408987052551
7419,0.7422,7,2,7,674517,1927,120314,5942,0.01526264098339881,0.7551150082602618
7420,0.7423,3,1,3,674518,1926,120317,5939,0.015254720567735395,0.7551176096630642
7421,0.7424,7,1,7,674519,1925,120324,5932,0.015246800152071981,0.7549955453735523
7422,0.7425,3,3,3,674522,1922,120327,5929,0.015223038905081738,0.7551904216023436
7423,0.7426,4,1,4,674523,1921,120331,5925,0.015215118489418325,0.7551618659189396
7424,0.7427,5,3,5,674526,1918,120336,5920,0.015191357242428082,0.7552947180403164
7425,0.7428,5,2,5,674528,1916,120341,5915,0.015175516411101254,0.7553313753032819
7426,0.7429,4,2,4,674530,1914,120345,5911,0.015159675579774427,0.7553993610223643
7427,0.743,3,3,3,674533,1911,120348,5908,0.015135914332784184,0.7555953446732319
7428,0.7431,0,3,0,674536,1908,120348,5908,0.015112153085793943,0.755885363357216
7429,0.7432,4,2,4,674538,1906,120352,5904,0.015096312254467115,0.7559539052496799
7430,0.7433,6,4,6,674542,1902,120358,5898,0.015064630591813458,0.7561538461538462
7431,0.7434,6,1,6,674543,1901,120364,5892,0.015056710176150045,0.7560631335814192
7432,0.7435,7,2,7,674545,1899,120371,5885,0.015040869344823217,0.7560380267214799
7433,0.7436,3,2,3,674547,1897,120374,5882,0.015025028513496389,0.7561383211209667
7434,0.7437,6,3,6,674550,1894,120380,5876,0.015001267266506146,0.7562419562419562
7435,0.7438,2,0,2,674550,1894,120382,5874,0.015001267266506146,0.7561791967044285
7436,0.7439,4,0,4,674550,1894,120386,5870,0.015001267266506146,0.756053580628542
7437,0.744,12,3,12,674553,1891,120398,5858,0.014977506019515904,0.7559685120660731
7438,0.7441,9,1,9,674554,1890,120407,5849,0.01496958560385249,0.7557824008269802
7439,0.7442,5,6,5,674560,1884,120412,5844,0.014922063109872007,0.7562111801242236
7440,0.7443,9,3,9,674563,1881,120421,5835,0.014898301862881764,0.7562208398133748
7441,0.7444,6,1,6,674564,1880,120427,5829,0.01489038144721835,0.7561291996367882
7442,0.7445,4,2,4,674566,1878,120431,5825,0.014874540615891522,0.7561988835518629
7443,0.7446,7,1,7,674567,1877,120438,5818,0.014866620200228107,0.7560753736192333
7444,0.7447,4,1,4,674568,1876,120442,5814,0.014858699784564694,0.7560468140442133
7445,0.7448,5,4,5,674572,1872,120447,5809,0.014827018121911038,0.7562817341491993
7446,0.7449,2,3,2,674575,1869,120449,5807,0.014803256874920796,0.7565138092756644
7447,0.745,7,1,7,674576,1868,120456,5800,0.014795336459257381,0.7563901930099113
7448,0.7451,2,2,2,674578,1866,120458,5798,0.014779495627930553,0.7565240083507306
7449,0.7452,4,2,4,674580,1864,120462,5794,0.014763654796603725,0.7565944110733873
7450,0.7453,5,3,5,674583,1861,120467,5789,0.014739893549613484,0.7567320261437909
7451,0.7454,8,0,8,674583,1861,120475,5781,0.014739893549613484,0.7564773619471342
7452,0.7455,5,3,5,674586,1858,120480,5776,0.014716132302623242,0.7566151427822898
7453,0.7456,8,2,8,674588,1856,120488,5768,0.014700291471296414,0.7565582371458552
7454,0.7457,10,1,10,674589,1855,120498,5758,0.014692371055633,0.7563378431630107
7455,0.7458,4,2,4,674591,1853,120502,5754,0.014676530224306171,0.7564085710529775
7456,0.7459,5,3,5,674594,1850,120507,5749,0.01465276897731593,0.7565469140676405
7457,0.746,2,4,2,674598,1846,120509,5747,0.014621087314662273,0.7568813380745424
7458,0.7461,5,3,5,674601,1843,120514,5742,0.014597326067672032,0.7570204350692156
7459,0.7462,7,0,7,674601,1843,120521,5735,0.014597326067672032,0.7567959883874373
7460,0.7463,7,3,7,674604,1840,120528,5728,0.014573564820681789,0.7568710359408034
7461,0.7464,4,3,4,674607,1837,120532,5724,0.014549803573691547,0.7570427192170348
7462,0.7465,3,4,3,674611,1833,120535,5721,0.014518121911037891,0.7573471008737093
7463,0.7466,1,1,1,674612,1832,120536,5720,0.014510201495374478,0.7574152542372882
7464,0.7467,9,5,9,674617,1827,120545,5711,0.014470599417057407,0.7576280180419209
7465,0.7468,4,2,4,674619,1825,120549,5707,0.014454758585730578,0.7577004779607011
7466,0.7469,7,4,7,674623,1821,120556,5700,0.014423076923076924,0.7578779417630634
7467,0.747,3,2,3,674625,1819,120559,5697,0.014407236091750096,0.7579829696647152
7468,0.7471,5,1,5,674626,1818,120564,5692,0.01439931567608668,0.7579227696404793
7469,0.7472,7,6,7,674632,1812,120571,5685,0.014351793182106196,0.7583033213285314
7470,0.7473,3,1,3,674633,1811,120574,5682,0.014343872766442783,0.7583077539036434
7471,0.7474,7,2,7,674635,1809,120581,5675,0.014328031935115955,0.7582843399251737
7472,0.7475,5,1,5,674636,1808,120586,5670,0.014320111519452542,0.7582241240973522
7473,0.7476,11,3,11,674639,1805,120597,5659,0.014296350272462299,0.7581725616291533
7474,0.7477,2,1,2,674640,1804,120599,5657,0.014288429856798885,0.758209355314301
7475,0.7478,3,2,3,674642,1802,120602,5654,0.014272589025472057,0.7583154506437768
7476,0.7479,5,2,5,674644,1800,120607,5649,0.014256748194145229,0.7583568264196536
7477,0.748,6,1,6,674645,1799,120613,5643,0.014248827778481814,0.7582639075517335
7478,0.7481,8,1,8,674646,1798,120621,5635,0.014240907362818401,0.7581057446522266
7479,0.7482,3,1,3,674647,1797,120624,5632,0.014232986947154986,0.7581101090321712
7480,0.7483,3,2,3,674649,1795,120627,5629,0.01421714611582816,0.7582165948275862
7481,0.7484,7,3,7,674652,1792,120634,5622,0.014193384868837916,0.7582951173455624
7482,0.7485,4,3,4,674655,1789,120638,5618,0.014169623621847675,0.7584717159443769
7483,0.7486,9,3,9,674658,1786,120647,5609,0.014145862374857432,0.7584854631507776
7484,0.7487,9,1,9,674659,1785,120656,5600,0.014137941959194019,0.7582938388625592
7485,0.7488,3,1,3,674660,1784,120659,5597,0.014130021543530604,0.7582983335591383
7486,0.7489,3,3,3,674663,1781,120662,5594,0.014106260296540362,0.7585084745762712
7487,0.749,3,5,3,674668,1776,120665,5591,0.014066658218223293,0.7589249355232794
7488,0.7491,7,1,7,674669,1775,120672,5584,0.014058737802559878,0.75879874983014
7489,0.7492,4,1,4,674670,1774,120676,5580,0.014050817386896465,0.75877073701387
7490,0.7493,12,2,12,674672,1772,120688,5568,0.014034976555569637,0.75858310626703
7491,0.7494,5,4,5,674676,1768,120693,5563,0.01400329489291598,0.7588323557495567
7492,0.7495,4,1,4,674677,1767,120697,5559,0.013995374477252567,0.7588042588042588
7493,0.7496,2,1,2,674678,1766,120699,5557,0.013987454061589152,0.758842004642906
7494,0.7497,6,3,6,674681,1763,120705,5551,0.01396369281459891,0.7589554279464041
7495,0.7498,5,5,5,674686,1758,120710,5546,0.01392409073628184,0.7593099671412924
7496,0.7499,6,1,6,674687,1757,120716,5540,0.013916170320618426,0.759216116212142
7497,0.75,6,1,6,674688,1756,120722,5534,0.013908249904955011,0.7591220850480109
7498,0.7501,5,1,5,674689,1755,120727,5529,0.013900329489291598,0.7590609555189456
7499,0.7502,3,2,3,674691,1753,120730,5526,0.01388448865796477,0.7591702156889683
7500,0.7503,2,4,2,674695,1749,120732,5524,0.013852806995311114,0.7595215179430771
7501,0.7504,2,1,2,674696,1748,120734,5522,0.0138448865796477,0.7595598349381018
7502,0.7505,6,3,6,674699,1745,120740,5516,0.013821125332657457,0.7596749758986365
7503,0.7506,4,0,4,674699,1745,120744,5512,0.013821125332657457,0.7595425106793441
7504,0.7507,7,2,7,674701,1743,120751,5505,0.013805284501330629,0.7595198675496688
7505,0.7508,4,5,4,674706,1738,120755,5501,0.01376568242301356,0.7599115899986186
7506,0.7509,3,1,3,674707,1737,120758,5498,0.013757762007350146,0.7599170697995854
7507,0.751,5,4,5,674711,1733,120763,5493,0.01372608034469649,0.7601716025463604
7508,0.7511,6,3,6,674714,1730,120769,5487,0.013702319097706247,0.7602882083968407
7509,0.7512,6,2,6,674716,1728,120775,5481,0.01368647826637942,0.7602996254681648
7510,0.7513,8,0,8,674716,1728,120783,5473,0.01368647826637942,0.7600333287043466
7511,0.7514,2,2,2,674718,1726,120785,5471,0.013670637435052592,0.7601778518827289
7512,0.7515,1,2,1,674720,1724,120786,5470,0.013654796603725764,0.7603558520989714
7513,0.7516,6,0,6,674720,1724,120792,5464,0.013654796603725764,0.760155815247635
7514,0.7517,5,1,5,674721,1723,120797,5459,0.01364687618806235,0.7600946811473127
7515,0.7518,8,2,8,674723,1721,120805,5451,0.013631035356735521,0.7600390407138874
7516,0.7519,5,3,5,674726,1718,120810,5446,0.01360727410974528,0.7601898380792853
7517,0.752,7,3,7,674729,1715,120817,5439,0.013583512862755037,0.7602739726027398
7518,0.7521,9,0,9,674729,1715,120826,5430,0.013583512862755037,0.7599720083974808
7519,0.7522,10,1,10,674730,1714,120836,5420,0.013575592447091623,0.7597420801794225
7520,0.7523,6,3,6,674733,1711,120842,5414,0.013551831200101382,0.759859649122807
7521,0.7524,5,3,5,674736,1708,120847,5409,0.013528069953111139,0.7600112406913025
7522,0.7525,4,3,4,674739,1705,120851,5405,0.013504308706120897,0.760196905766526
7523,0.7526,6,2,6,674741,1703,120857,5399,0.01348846787479407,0.7602083920022529
7524,0.7527,2,3,2,674744,1700,120859,5397,0.013464706627803828,0.7604621671128646
7525,0.7528,12,1,12,674745,1699,120871,5385,0.013456786212140413,0.7601637492941841
7526,0.7529,4,0,4,674745,1699,120875,5381,0.013456786212140413,0.7600282485875707
7527,0.753,5,1,5,674746,1698,120880,5376,0.013448865796477,0.7599660729431722
7528,0.7531,2,3,2,674749,1695,120882,5374,0.013425104549486757,0.7602206818503324
7529,0.7532,2,4,2,674753,1691,120884,5372,0.0133934228868331,0.7605833215347586
7530,0.7533,3,2,3,674755,1689,120887,5369,0.013377582055506272,0.7606970813261548
7531,0.7534,4,3,4,674758,1686,120891,5365,0.01335382080851603,0.7608849808537796
7532,0.7535,4,2,4,674760,1684,120895,5361,0.013337979977189203,0.7609652235628105
7533,0.7536,3,1,3,674761,1683,120898,5358,0.01333005956152579,0.7609714529186196
7534,0.7537,2,3,2,674764,1680,120900,5356,0.013306298314535546,0.7612279704377487
7535,0.7538,3,4,3,674768,1676,120903,5353,0.01327461665188189,0.761559254517001
7536,0.7539,5,1,5,674769,1675,120908,5348,0.013266696236218477,0.7614979353552613
7537,0.754,3,3,3,674772,1672,120911,5345,0.013242934989228235,0.76172153341884
7538,0.7541,4,2,4,674774,1670,120915,5341,0.013227094157901407,0.7618028811867066
7539,0.7542,4,2,4,674776,1668,120919,5337,0.013211253326574579,0.7618843683083512
7540,0.7543,5,4,5,674780,1664,120924,5332,0.013179571663920923,0.7621497998856489
7541,0.7544,4,1,4,674781,1663,120928,5328,0.013171651248257508,0.762122729223287
7542,0.7545,9,3,9,674784,1660,120937,5319,0.013147890001267266,0.7621435735778764
7543,0.7546,4,0,4,674784,1660,120941,5315,0.013147890001267266,0.7620071684587814
7544,0.7547,6,0,6,674784,1660,120947,5309,0.013147890001267266,0.7618022671832401
7545,0.7548,5,2,5,674786,1658,120952,5304,0.013132049169940438,0.7618500430910657
7546,0.7549,5,1,5,674787,1657,120957,5299,0.013124128754277025,0.7617883841288097
7547,0.755,7,1,7,674788,1656,120964,5292,0.01311620833861361,0.7616580310880829
7548,0.7551,6,3,6,674791,1653,120970,5286,0.013092447091623369,0.7617812364894077
7549,0.7552,5,2,5,674793,1651,120975,5281,0.01307660626029654,0.7618291979226774
7550,0.7553,3,1,3,674794,1650,120978,5278,0.013068685844633126,0.7618360277136259
7551,0.7554,6,0,6,674794,1650,120984,5272,0.013068685844633126,0.7616295868246171
7552,0.7555,7,3,7,674797,1647,120991,5265,0.013044924597642884,0.76171875
7553,0.7556,3,2,3,674799,1645,120994,5262,0.013029083766316056,0.761835818734617
7554,0.7557,1,2,1,674801,1643,120995,5261,0.013013242934989228,0.7620220162224797
7555,0.7558,7,5,7,674806,1638,121002,5254,0.012973640856672158,0.7623331398723158
7556,0.7559,4,3,4,674809,1635,121006,5250,0.012949879609681915,0.7625272331154684
7557,0.756,3,1,3,674810,1634,121009,5247,0.012941959194018502,0.7625345153320738
7558,0.7561,5,0,5,674810,1634,121014,5242,0.012941959194018502,0.7623618382780687
7559,0.7562,4,6,4,674816,1628,121018,5238,0.012894436700038018,0.7628896009321293
7560,0.7563,9,2,9,674818,1626,121027,5229,0.01287859586871119,0.762800875273523
7561,0.7564,7,1,7,674819,1625,121034,5222,0.012870675453047776,0.7626697823864467
7562,0.7565,3,3,3,674822,1622,121037,5219,0.012846914206057533,0.7629001607952054
7563,0.7566,2,2,2,674824,1620,121039,5217,0.012831073374730707,0.7630539710399298
7564,0.7567,2,1,2,674825,1619,121041,5215,0.012823152959067292,0.7630962832894351
7565,0.7568,7,4,7,674829,1615,121048,5208,0.012791471296413635,0.7633006009086912
7566,0.7569,8,2,8,674831,1613,121056,5200,0.012775630465086807,0.763246734184647
7567,0.757,2,2,2,674833,1611,121058,5198,0.012759789633759979,0.7634013805257747
7568,0.7571,6,3,6,674836,1608,121064,5192,0.012736028386769738,0.7635294117647059
7569,0.7572,5,3,5,674839,1605,121069,5187,0.012712267139779496,0.7636925795053003
7570,0.7573,2,5,2,674844,1600,121071,5185,0.012672665061462425,0.7641857037582903
7571,0.7574,6,1,6,674845,1599,121077,5179,0.012664744645799012,0.7640897019769843
7572,0.7575,8,0,8,674845,1599,121085,5171,0.012664744645799012,0.7638109305760709
7573,0.7576,5,3,5,674848,1596,121090,5166,0.012640983398808769,0.7639751552795031
7574,0.7577,7,1,7,674849,1595,121097,5159,0.012633062983145356,0.7638436482084691
7575,0.7578,3,4,3,674853,1591,121100,5156,0.0126013813204917,0.7641914925151919
7576,0.7579,3,2,3,674855,1589,121103,5153,0.012585540489164871,0.7643132601601899
7577,0.758,4,1,4,674856,1588,121107,5149,0.012577620073501458,0.764286774528722
7578,0.7581,7,1,7,674857,1587,121114,5142,0.012569699657838043,0.7641551493535443
7579,0.7582,1,0,1,674857,1587,121115,5141,0.012569699657838043,0.7641200951248514
7580,0.7583,6,3,6,674860,1584,121121,5135,0.012545938410847801,0.7642506325346033
7581,0.7584,6,4,6,674864,1580,121127,5129,0.012514256748194145,0.7644954538679386
7582,0.7585,3,3,3,674867,1577,121130,5126,0.012490495501203904,0.7647322094584514
7583,0.7586,3,1,3,674868,1576,121133,5123,0.012482575085540489,0.7647410061203165
7584,0.7587,5,0,5,674868,1576,121138,5118,0.012482575085540489,0.7645652823423962
7585,0.7588,2,2,2,674870,1574,121140,5116,0.01246673425421366,0.7647234678624814
7586,0.7589,5,0,5,674870,1574,121145,5111,0.01246673425421366,0.7645474943904264
7587,0.759,3,0,3,674870,1574,121148,5108,0.01246673425421366,0.7644417838970368
7588,0.7591,8,0,8,674870,1574,121156,5100,0.01246673425421366,0.7641594246329038
7589,0.7592,2,2,2,674872,1572,121158,5098,0.012450893422886833,0.7643178410794603
7590,0.7593,7,4,7,674876,1568,121165,5091,0.012419211760233176,0.7645292085898784
7591,0.7594,5,4,5,674880,1564,121170,5086,0.012387530097579522,0.7648120300751879
7592,0.7595,4,3,4,674883,1561,121174,5082,0.012363768850589279,0.7650158061116965
7593,0.7596,5,1,5,674884,1560,121179,5077,0.012355848434925865,0.764954045502486
7594,0.7597,4,3,4,674887,1557,121183,5073,0.012332087187935622,0.7651583710407239
7595,0.7598,6,3,6,674890,1554,121189,5067,0.01230832594094538,0.765292251925691
7596,0.7599,4,2,4,674892,1552,121193,5063,0.012292485109618553,0.7653817082388511
7597,0.76,6,1,6,674893,1551,121199,5057,0.01228456469395514,0.7652845036319612
7598,0.7601,4,0,4,674893,1551,121203,5053,0.01228456469395514,0.7651423379769836
7599,0.7602,10,4,10,674897,1547,121213,5043,0.012252883031301483,0.7652503793626707
7600,0.7603,3,1,3,674898,1546,121216,5040,0.012244962615638068,0.7652596416641361
7601,0.7604,3,2,3,674900,1544,121219,5037,0.01222912178431124,0.7653851998176568
7602,0.7605,4,3,4,674903,1541,121223,5033,0.012205360537320999,0.7655917249771829
7603,0.7606,7,2,7,674905,1539,121230,5026,0.01218951970599417,0.7655750190403656
7604,0.7607,3,1,3,674906,1538,121233,5023,0.012181599290330757,0.765584514555708
7605,0.7608,2,4,2,674910,1534,121235,5021,0.012149917627677101,0.7659801678108314
7606,0.7609,3,1,3,674911,1533,121238,5018,0.012141997212013686,0.7659899252022592
7607,0.761,0,1,0,674912,1532,121238,5018,0.012134076796350273,0.7661068702290076
7608,0.7611,8,1,8,674913,1531,121246,5010,0.012126156380686858,0.7659379299801253
7609,0.7612,1,2,1,674915,1529,121247,5009,0.01211031554936003,0.7661364331599878
7610,0.7613,6,1,6,674916,1528,121253,5003,0.012102395133696616,0.7660388914408207
7611,0.7614,7,4,7,674920,1524,121260,4996,0.01207071347104296,0.7662576687116565
7612,0.7615,3,2,3,674922,1522,121263,4993,0.012054872639716132,0.7663852647735994
7613,0.7616,1,3,1,674925,1519,121264,4992,0.01203111139272589,0.7667025034556904
7614,0.7617,5,2,5,674927,1517,121269,4987,0.012015270561399062,0.7667589175891759
7615,0.7618,3,3,3,674930,1514,121272,4984,0.01199150931440882,0.7670052323791936
7616,0.7619,4,0,4,674930,1514,121276,4980,0.01199150931440882,0.7668617185093933
7617,0.762,8,0,8,674930,1514,121284,4972,0.01199150931440882,0.7665741597286463
7618,0.7621,4,3,4,674933,1511,121288,4968,0.011967748067418578,0.7667849976848279
7619,0.7622,8,2,8,674935,1509,121296,4960,0.01195190723609175,0.7667336528056886
7620,0.7623,8,2,8,674937,1507,121304,4952,0.011936066404764922,0.7666821489394643
7621,0.7624,6,3,6,674940,1504,121310,4946,0.01191230515777468,0.7668217054263566
7622,0.7625,3,0,3,674940,1504,121313,4943,0.01191230515777468,0.7667131999379556
7623,0.7626,7,5,7,674945,1499,121320,4936,0.01187270307945761,0.7670551670551671
7624,0.7627,6,1,6,674946,1498,121326,4930,0.011864782663794196,0.7669570628500311
7625,0.7628,5,2,5,674948,1496,121331,4925,0.011848941832467368,0.7670144837252765
7626,0.7629,4,2,4,674950,1494,121335,4921,0.01183310100114054,0.7671083398285269
7627,0.763,4,2,4,674952,1492,121339,4917,0.011817260169813711,0.7672023716648463
7628,0.7631,4,2,4,674954,1490,121343,4913,0.011801419338486883,0.7672965797282524
7629,0.7632,2,2,2,674956,1488,121345,4911,0.011785578507160055,0.7674636661978435
7630,0.7633,5,2,5,674958,1486,121350,4906,0.011769737675833229,0.7675219023779725
7631,0.7634,3,2,3,674960,1484,121353,4903,0.0117538968445064,0.7676530452481604
7632,0.7635,6,2,6,674962,1482,121359,4897,0.011738056013179572,0.7676751841981502
7633,0.7636,2,2,2,674964,1480,121361,4895,0.011722215181852744,0.7678431372549019
7634,0.7637,2,2,2,674966,1478,121363,4893,0.011706374350525916,0.7680113012086015
7635,0.7638,4,1,4,674967,1477,121367,4889,0.011698453934862501,0.7679861765629908
7636,0.7639,7,0,7,674967,1477,121374,4882,0.011698453934862501,0.7677307752791319
7637,0.764,4,2,4,674969,1475,121378,4878,0.011682613103535673,0.7678262238312609
7638,0.7641,6,0,6,674969,1475,121384,4872,0.011682613103535673,0.7676067433433118
7639,0.7642,4,1,4,674970,1474,121388,4868,0.01167469268787226,0.7675812046672974
7640,0.7643,2,1,2,674971,1473,121390,4866,0.011666772272208846,0.767628963558921
7641,0.7644,4,1,4,674972,1472,121394,4862,0.011658851856545431,0.7676034101673508
7642,0.7645,4,0,4,674972,1472,121398,4858,0.011658851856545431,0.7674565560821485
7643,0.7646,6,1,6,674973,1471,121404,4852,0.011650931440882018,0.7673572671200379
7644,0.7647,9,1,9,674974,1470,121413,4843,0.011643011025218603,0.7671471566608585
7645,0.7648,6,0,6,674974,1470,121419,4837,0.011643011025218603,0.7669256381798002
7646,0.7649,3,1,3,674975,1469,121422,4834,0.01163509060955519,0.7669363795018246
7647,0.765,4,4,4,674979,1465,121426,4830,0.011603408946901534,0.767275615567911
7648,0.7651,3,0,3,674979,1465,121429,4827,0.011603408946901534,0.7671646535282899
7649,0.7652,7,1,7,674980,1464,121436,4820,0.011595488531238119,0.7670273711012094
7650,0.7653,4,2,4,674982,1462,121440,4816,0.01157964769991129,0.7671232876712328
7651,0.7654,6,1,6,674983,1461,121446,4810,0.011571727284247877,0.767022803380641
7652,0.7655,6,1,6,674984,1460,121452,4804,0.011563806868584464,0.7669220945083014
7653,0.7656,7,3,7,674987,1457,121459,4797,0.011540045621594221,0.7670291013751199
7654,0.7657,7,3,7,674990,1454,121466,4790,0.01151628437460398,0.7671364509929532
7655,0.7658,0,2,0,674992,1452,121466,4790,0.011500443543277152,0.7673822492790772
7656,0.7659,1,1,1,674993,1451,121467,4789,0.011492523127613737,0.7674679487179488
7657,0.766,6,3,6,674996,1448,121473,4783,0.011468761880623495,0.7676135451773392
7658,0.7661,3,0,3,674996,1448,121476,4780,0.011468761880623495,0.7675016056518946
7659,0.7662,4,1,4,674997,1447,121480,4776,0.01146084146496008,0.7674754941346618
7660,0.7663,1,2,1,674999,1445,121481,4775,0.011445000633633254,0.7676848874598071
7661,0.7664,5,2,5,675001,1443,121486,4770,0.011429159802306426,0.7677450507001449
7662,0.7665,3,2,3,675003,1441,121489,4767,0.011413318970979597,0.7678801546391752
7663,0.7666,1,2,1,675005,1439,121490,4766,0.01139747813965277,0.7680902497985496
7664,0.7667,1,1,1,675006,1438,121491,4765,0.011389557723989354,0.7681766886990166
7665,0.7668,6,3,6,675009,1435,121497,4759,0.011365796476999113,0.768324184694866
7666,0.7669,4,1,4,675010,1434,121501,4755,0.011357876061335698,0.7682985942801746
7667,0.767,4,2,4,675012,1432,121505,4751,0.011342035230008872,0.7683972181788775
7668,0.7671,4,2,4,675014,1430,121509,4747,0.011326194398682043,0.7684960336733042
7669,0.7672,7,1,7,675015,1429,121516,4740,0.011318273983018629,0.7683579186253849
7670,0.7673,6,0,6,675015,1429,121522,4734,0.011318273983018629,0.7681324030504625
7671,0.7674,2,1,2,675016,1428,121524,4732,0.011310353567355215,0.7681818181818182
7672,0.7675,8,5,8,675021,1423,121532,4724,0.011270751489038144,0.7685049617699691
7673,0.7676,4,1,4,675022,1422,121536,4720,0.01126283107337473,0.7684793226961901
7674,0.7677,7,4,7,675026,1418,121543,4713,0.011231149410721075,0.7687163594845865
7675,0.7678,7,4,7,675030,1414,121550,4706,0.011199467748067418,0.7689542483660131
7676,0.7679,4,4,4,675034,1410,121554,4702,0.011167786085413762,0.7693062827225131
7677,0.768,6,0,6,675034,1410,121560,4696,0.011167786085413762,0.7690795938421225
7678,0.7681,3,2,3,675036,1408,121563,4693,0.011151945254086934,0.7692181609572202
7679,0.7682,7,2,7,675038,1406,121570,4686,0.011136104422760107,0.7692055154300722
7680,0.7683,4,0,4,675038,1406,121574,4682,0.011136104422760107,0.769053876478318
7681,0.7684,11,1,11,675039,1405,121585,4671,0.011128184007096692,0.7687623436471362
7682,0.7685,7,0,7,675039,1405,121592,4664,0.011128184007096692,0.7684956335475367
7683,0.7686,8,2,8,675041,1403,121600,4656,0.011112343175769864,0.7684436375639544
7684,0.7687,9,3,9,675044,1400,121609,4647,0.011088581928779623,0.7684802381346122
7685,0.7688,8,3,8,675047,1397,121617,4639,0.01106482068178938,0.7685553346587144
7686,0.7689,3,1,3,675048,1396,121620,4636,0.011056900266125966,0.7685676392572944
7687,0.769,3,0,3,675048,1396,121623,4633,0.011056900266125966,0.7684524796815392
7688,0.7691,4,1,4,675049,1395,121627,4629,0.011048979850462552,0.7684262948207171
7689,0.7692,8,2,8,675051,1393,121635,4621,0.011033139019135725,0.7683737944795477
7690,0.7693,4,1,4,675052,1392,121639,4617,0.01102521860347231,0.7683474787818273
7691,0.7694,5,0,5,675052,1392,121644,4612,0.01102521860347231,0.7681545636242505
7692,0.7695,5,5,5,675057,1387,121649,4607,0.01098561652515524,0.768601935268602
7693,0.7696,2,1,2,675058,1386,121651,4605,0.010977696109491826,0.7686529794692039
7694,0.7697,5,3,5,675061,1383,121656,4600,0.010953934862501584,0.7688450610061842
7695,0.7698,3,4,3,675065,1379,121659,4597,0.010922253199847928,0.7692436412315931
7696,0.7699,5,2,5,675067,1377,121664,4592,0.0109064123685211,0.769308091807673
7697,0.77,2,1,2,675068,1376,121666,4590,0.010898491952857687,0.7693597049949715
7698,0.7701,8,4,8,675072,1372,121674,4582,0.01086681029020403,0.7695666778636211
7699,0.7702,8,1,8,675073,1371,121682,4574,0.010858889874540615,0.7693860386879731
7700,0.7703,4,1,4,675074,1370,121686,4570,0.010850969458877202,0.7693602693602694
7701,0.7704,2,1,2,675075,1369,121688,4568,0.010843049043213787,0.7694121610240863
7702,0.7705,4,2,4,675077,1367,121692,4564,0.010827208211886959,0.7695161018378014
7703,0.7706,0,1,0,675078,1366,121692,4564,0.010819287796223546,0.76964586846543
7704,0.7707,3,1,3,675079,1365,121695,4561,0.010811367380560133,0.7696591292608842
7705,0.7708,3,0,3,675079,1365,121698,4558,0.010811367380560133,0.7695424615904103
7706,0.7709,4,1,4,675080,1364,121702,4554,0.010803446964896718,0.7695167286245354
7707,0.771,2,0,2,675080,1364,121704,4552,0.010803446964896718,0.7694388100067613
7708,0.7711,6,5,6,675085,1359,121710,4546,0.010763844886579648,0.7698560541913633
7709,0.7712,6,1,6,675086,1358,121716,4540,0.010755924470916233,0.7697524584604951
7710,0.7713,3,1,3,675087,1357,121719,4537,0.01074800405525282,0.7697658635900916
7711,0.7714,6,2,6,675089,1355,121725,4531,0.010732163223925992,0.7697927285083248
7712,0.7715,4,1,4,675090,1354,121729,4527,0.010724242808262577,0.7697670464206767
7713,0.7716,9,2,9,675092,1352,121738,4518,0.01070840197693575,0.7696763202725724
7714,0.7717,5,4,5,675096,1348,121743,4513,0.010676720314282094,0.7700051185804471
7715,0.7718,6,3,6,675099,1345,121749,4507,0.010652959067291851,0.7701640464798359
7716,0.7719,5,2,5,675101,1343,121754,4502,0.010637118235965023,0.7702309666381523
7717,0.772,5,0,5,675101,1343,121759,4497,0.010637118235965023,0.7700342465753425
7718,0.7721,5,1,5,675102,1342,121764,4492,0.01062919782030161,0.7699691463832705
7719,0.7722,1,2,1,675104,1340,121765,4491,0.010613356988974781,0.7701937918024353
7720,0.7723,7,5,7,675109,1335,121772,4484,0.010573754910657712,0.770579137308816
7721,0.7724,6,2,6,675111,1333,121778,4478,0.010557914079330884,0.7706074685940458
7722,0.7725,4,0,4,675111,1333,121782,4474,0.010557914079330884,0.7704494575512313
7723,0.7726,1,4,1,675115,1329,121783,4473,0.010526232416677227,0.7709410548086867
7724,0.7727,5,3,5,675118,1326,121788,4468,0.010502471169686986,0.7711425612702796
7725,0.7728,8,3,8,675121,1323,121796,4460,0.010478709922696743,0.7712260072626664
7726,0.7729,3,1,3,675122,1322,121799,4457,0.01047078950703333,0.7712406990828863
7727,0.773,5,2,5,675124,1320,121804,4452,0.010454948675706502,0.7713097713097713
7728,0.7731,6,1,6,675125,1319,121810,4446,0.010447028260043087,0.7712055507372073
7729,0.7732,4,1,4,675126,1318,121814,4442,0.010439107844379673,0.7711805555555555
7730,0.7733,4,0,4,675126,1318,121818,4438,0.010439107844379673,0.7710215427380125
7731,0.7734,6,1,6,675127,1317,121824,4432,0.010431187428716258,0.7709166811619412
7732,0.7735,3,1,3,675128,1316,121827,4429,0.010423267013052845,0.7709312445604873
7733,0.7736,7,0,7,675128,1316,121834,4422,0.010423267013052845,0.7706517950505403
7734,0.7737,2,1,2,675129,1315,121836,4420,0.01041534659738943,0.7707061900610288
7735,0.7738,8,1,8,675130,1314,121844,4412,0.010407426181726017,0.7705204331121202
7736,0.7739,6,1,6,675131,1313,121850,4406,0.010399505766062602,0.7704144081133065
7737,0.774,6,6,6,675137,1307,121856,4400,0.01035198327208212,0.7709830033292447
7738,0.7741,6,4,6,675141,1303,121862,4394,0.010320301609428463,0.7712831314727049
7739,0.7742,2,0,2,675141,1303,121864,4392,0.010320301609428463,0.7712028094820017
7740,0.7743,3,4,3,675145,1299,121867,4389,0.010288619946774807,0.7716244725738397
7741,0.7744,7,3,7,675148,1296,121874,4382,0.010264858699784565,0.7717506164142304
7742,0.7745,5,0,5,675148,1296,121879,4377,0.010264858699784565,0.7715494447382337
7743,0.7746,0,3,0,675151,1293,121879,4377,0.010241097452794322,0.771957671957672
7744,0.7747,6,3,6,675154,1290,121885,4371,0.01021733620580408,0.7721250662427133
7745,0.7748,5,2,5,675156,1288,121890,4366,0.010201495374477253,0.7721966749204103
7746,0.7749,2,2,2,675158,1286,121892,4364,0.010185654543150425,0.7723893805309735
7747,0.775,5,1,5,675159,1285,121897,4359,0.010177734127487011,0.7723245924875974
7748,0.7751,8,0,8,675159,1285,121905,4351,0.010177734127487011,0.7720014194464159
7749,0.7752,7,1,7,675160,1284,121912,4344,0.010169813711823596,0.7718550106609808
7750,0.7753,3,3,3,675163,1281,121915,4341,0.010146052464833355,0.772145144076841
7751,0.7754,6,1,6,675164,1280,121921,4335,0.01013813204916994,0.7720391807658059
7752,0.7755,1,2,1,675166,1278,121922,4334,0.010122291217843112,0.7722736992159658
7753,0.7756,2,0,2,675166,1278,121924,4332,0.010122291217843112,0.772192513368984
7754,0.7757,7,1,7,675167,1277,121931,4325,0.010114370802179699,0.7720456979650125
7755,0.7758,3,4,3,675171,1273,121934,4322,0.010082689139526042,0.7724754244861484
7756,0.7759,7,0,7,675171,1273,121941,4315,0.010082689139526042,0.7721904080171796
7757,0.776,5,4,5,675175,1269,121946,4310,0.010051007476872386,0.7725398816992293
7758,0.7761,4,1,4,675176,1268,121950,4306,0.010043087061208973,0.7725152493720847
7759,0.7762,2,1,2,675177,1267,121952,4304,0.010035166645545558,0.7725722491473703
7760,0.7763,1,0,1,675177,1267,121953,4303,0.010035166645545558,0.7725314183123878
7761,0.7764,4,2,4,675179,1265,121957,4299,0.01001932581421873,0.7726455787203451
7762,0.7765,4,0,4,675179,1265,121961,4295,0.01001932581421873,0.7724820143884892
7763,0.7766,4,2,4,675181,1263,121965,4291,0.010003484982891902,0.772596326971552
7764,0.7767,8,2,8,675183,1261,121973,4283,0.009987644151565073,0.7725468975468975
7765,0.7768,6,1,6,675184,1260,121979,4277,0.00997972373590166,0.7724399494310998
7766,0.7769,6,3,6,675187,1257,121985,4271,0.009955962488911419,0.7726121562952243
7767,0.777,2,3,2,675190,1254,121987,4269,0.009932201241921176,0.7729494839761
7768,0.7771,3,3,3,675193,1251,121990,4266,0.009908439994930934,0.7732463295269169
7769,0.7772,12,0,12,675193,1251,122002,4254,0.009908439994930934,0.7727520435967302
7770,0.7773,7,2,7,675195,1249,122009,4247,0.009892599163604106,0.7727438136826783
7771,0.7774,5,0,5,675195,1249,122014,4242,0.009892599163604106,0.7725368785285012
7772,0.7775,1,2,1,675197,1247,122015,4241,0.009876758332277278,0.7727769679300291
7773,0.7776,4,1,4,675198,1246,122019,4237,0.009868837916613863,0.7727521429874157
7774,0.7777,6,1,6,675199,1245,122025,4231,0.00986091750095045,0.7726442658875091
7775,0.7778,9,1,9,675200,1244,122034,4222,0.009852997085287037,0.7724112696670326
7776,0.7779,2,2,2,675202,1242,122036,4220,0.009837156253960208,0.7726107652874405
7777,0.778,3,0,3,675202,1242,122039,4217,0.009837156253960208,0.7724858032606704
7778,0.7781,4,4,4,675206,1238,122043,4213,0.009805474591306552,0.772885709044212
7779,0.7782,5,2,5,675208,1236,122048,4208,0.009789633759979724,0.7729610580455547
7780,0.7783,7,4,7,675212,1232,122055,4201,0.009757952097326068,0.7732376219399963
7781,0.7784,3,1,3,675213,1231,122058,4198,0.009750031681662654,0.7732547430466016
7782,0.7785,3,2,3,675215,1229,122061,4195,0.009734190850335826,0.7734144542772862
7783,0.7786,3,1,3,675216,1228,122064,4192,0.009726270434672411,0.7734317343173431
7784,0.7787,3,3,3,675219,1225,122067,4189,0.00970250918768217,0.7737347617288511
7785,0.7788,5,1,5,675220,1224,122072,4184,0.009694588772018755,0.7736686390532544
7786,0.7789,6,0,6,675220,1224,122078,4178,0.009694588772018755,0.7734172528693076
7787,0.779,9,1,9,675221,1223,122087,4169,0.009686668356355342,0.7731824925816023
7788,0.7791,4,2,4,675223,1221,122091,4165,0.009670827525028514,0.7733011511325659
7789,0.7792,7,3,7,675226,1218,122098,4158,0.009647066278038272,0.7734375
7790,0.7793,7,0,7,675226,1218,122105,4151,0.009647066278038272,0.7731421121251629
7791,0.7794,6,5,6,675231,1213,122111,4145,0.009607464199721201,0.7736095558044046
7792,0.7795,3,3,3,675234,1210,122114,4142,0.00958370295273096,0.773916292974589
7793,0.7796,5,2,5,675236,1208,122119,4137,0.009567862121404131,0.7739943872778298
7794,0.7797,3,1,3,675237,1207,122122,4134,0.009559941705740716,0.7740123572364725
7795,0.7798,4,1,4,675238,1206,122126,4130,0.009552021290077303,0.7739880059970015
7796,0.7799,2,2,2,675240,1204,122128,4128,0.009536180458750475,0.7741935483870968
7797,0.78,3,2,3,675242,1202,122131,4125,0.009520339627423647,0.7743570489956824
7798,0.7801,5,2,5,675244,1200,122136,4120,0.009504498796096819,0.7744360902255639
7799,0.7802,6,4,6,675248,1196,122142,4114,0.009472817133443162,0.7747645951035782
7800,0.7803,5,0,5,675248,1196,122147,4109,0.009472817133443162,0.7745523091423185
7801,0.7804,4,3,4,675251,1193,122151,4105,0.009449055886452921,0.7748206870517176
7802,0.7805,5,3,5,675254,1190,122156,4100,0.00942529463946268,0.775047258979206
7803,0.7806,0,1,0,675255,1189,122156,4100,0.009417374223799265,0.7751937984496124
7804,0.7807,3,0,3,675255,1189,122159,4097,0.009417374223799265,0.7750662126371547
7805,0.7808,2,1,2,675256,1188,122161,4095,0.009409453808135852,0.7751277683134583
7806,0.7809,4,1,4,675257,1187,122165,4091,0.009401533392472437,0.7751042061386889
7807,0.781,4,2,4,675259,1185,122169,4087,0.009385692561145608,0.775227617602428
7808,0.7811,5,0,5,675259,1185,122174,4082,0.009385692561145608,0.7750142396050883
7809,0.7812,5,4,5,675263,1181,122179,4077,0.009354010898491952,0.7753898820844427
7810,0.7813,3,3,3,675266,1178,122182,4074,0.00933024965150171,0.7757044935262757
7811,0.7814,4,1,4,675267,1177,122186,4070,0.009322329235838298,0.7756813417190775
7812,0.7815,8,2,8,675269,1175,122194,4062,0.00930648840451147,0.7756349054802367
7813,0.7816,5,1,5,675270,1174,122199,4057,0.009298567988848054,0.7755687249091952
7814,0.7817,3,0,3,675270,1174,122202,4054,0.009298567988848054,0.7754399387911247
7815,0.7818,5,1,5,675271,1173,122207,4049,0.009290647573184641,0.7753734201455381
7816,0.7819,4,1,4,675272,1172,122211,4045,0.009282727157521226,0.7753498179030094
7817,0.782,7,1,7,675273,1171,122218,4038,0.009274806741857813,0.775196774812824
7818,0.7821,1,2,1,675275,1169,122219,4037,0.009258965910530985,0.7754514022281982
7819,0.7822,4,1,4,675276,1168,122223,4033,0.00925104549486757,0.7754278023457027
7820,0.7823,10,2,10,675278,1166,122233,4023,0.009235204663540742,0.7752938909231065
7821,0.7824,5,2,5,675280,1164,122238,4018,0.009219363832213915,0.7753763025858742
7822,0.7825,7,0,7,675280,1164,122245,4011,0.009219363832213915,0.7750724637681159
7823,0.7826,2,2,2,675282,1162,122247,4009,0.009203523000887087,0.7752852446335332
7824,0.7827,8,3,8,675285,1159,122255,4001,0.009179761753896844,0.7753875968992248
7825,0.7828,8,3,8,675288,1156,122263,3993,0.009156000506906603,0.7754903864828122
7826,0.7829,4,0,4,675288,1156,122267,3989,0.009156000506906603,0.7753158406219631
7827,0.783,6,2,6,675290,1154,122273,3983,0.009140159675579775,0.7753552657192914
7828,0.7831,5,2,5,675292,1152,122278,3978,0.009124318844252946,0.775438596491228
7829,0.7832,4,4,4,675296,1148,122282,3974,0.00909263718159929,0.775868801249512
7830,0.7833,10,0,10,675296,1148,122292,3964,0.00909263718159929,0.7754303599374022
7831,0.7834,3,3,3,675299,1145,122295,3961,0.009068875934609049,0.7757540148844496
7832,0.7835,3,1,3,675300,1144,122298,3958,0.009060955518945634,0.7757742061936496
7833,0.7836,2,0,2,675300,1144,122300,3956,0.009060955518945634,0.7756862745098039
7834,0.7837,4,1,4,675301,1143,122304,3952,0.00905303510328222,0.7756624141315015
7835,0.7838,3,2,3,675303,1141,122307,3949,0.009037194271955392,0.7758349705304519
7836,0.7839,11,1,11,675304,1140,122318,3938,0.009029273856291977,0.7755021662071682
7837,0.784,2,1,2,675305,1139,122320,3936,0.009021353440628564,0.7755665024630541
7838,0.7841,2,1,2,675306,1138,122322,3934,0.009013433024965151,0.7756309148264984
7839,0.7842,1,0,1,675306,1138,122323,3933,0.009013433024965151,0.7755866692959968
7840,0.7843,9,4,9,675310,1134,122332,3924,0.008981751362311495,0.7758007117437722
7841,0.7844,3,4,3,675314,1130,122335,3921,0.008950069699657838,0.7762819243714116
7842,0.7845,7,0,7,675314,1130,122342,3914,0.008950069699657838,0.7759714512291832
7843,0.7846,3,0,3,675314,1130,122345,3911,0.008950069699657838,0.7758381273556834
7844,0.7847,4,0,4,675314,1130,122349,3907,0.008950069699657838,0.7756601151479054
7845,0.7848,5,2,5,675316,1128,122354,3902,0.00893422886833101,0.7757455268389662
7846,0.7849,4,2,4,675318,1126,122358,3898,0.008918388037004182,0.7758757961783439
7847,0.785,2,3,2,675321,1123,122360,3896,0.00889462679001394,0.7762502490535963
7848,0.7851,3,0,3,675321,1123,122363,3893,0.00889462679001394,0.7761164274322169
7849,0.7852,4,3,4,675324,1120,122367,3889,0.008870865543023698,0.7764024755440208
7850,0.7853,4,0,4,675324,1120,122371,3885,0.008870865543023698,0.7762237762237763
7851,0.7854,9,3,9,675327,1117,122380,3876,0.008847104296033456,0.776286801522131
7852,0.7855,5,4,5,675331,1113,122385,3871,0.0088154226333798,0.776685393258427
7853,0.7856,4,1,4,675332,1112,122389,3867,0.008807502217716385,0.7766619803173328
7854,0.7857,3,2,3,675334,1110,122392,3864,0.008791661386389558,0.7768395657418576
7855,0.7858,11,4,11,675338,1106,122403,3853,0.008759979723735902,0.7769711635410365
7856,0.7859,5,1,5,675339,1105,122408,3848,0.008752059308072487,0.7769028871391076
7857,0.786,6,1,6,675340,1104,122414,3842,0.008744138892409074,0.7767893247068338
7858,0.7861,8,1,8,675341,1103,122422,3834,0.008736218476745659,0.7765849706299373
7859,0.7862,3,0,3,675341,1103,122425,3831,0.008736218476745659,0.7764491284961492
7860,0.7863,2,1,2,675342,1102,122427,3829,0.008728298061082246,0.776515919691746
7861,0.7864,3,4,3,675346,1098,122430,3826,0.00869661639842859,0.7770105605199025
7862,0.7865,8,1,8,675347,1097,122438,3818,0.008688695982765176,0.7768056968463886
7863,0.7866,7,0,7,675347,1097,122445,3811,0.008688695982765176,0.7764873675631622
7864,0.7867,5,0,5,675347,1097,122450,3806,0.008688695982765176,0.776259433000204
7865,0.7868,2,1,2,675348,1096,122452,3804,0.008680775567101761,0.7763265306122449
7866,0.7869,3,2,3,675350,1094,122455,3801,0.008664934735774933,0.7765066394279877
7867,0.787,8,2,8,675352,1092,122463,3793,0.008649093904448105,0.7764585465711361
7868,0.7871,4,1,4,675353,1091,122467,3789,0.008641173488784692,0.7764344262295082
7869,0.7872,5,2,5,675355,1089,122472,3784,0.008625332657457864,0.7765237020316027
7870,0.7873,6,2,6,675357,1087,122478,3778,0.008609491826131035,0.7765673175745118
7871,0.7874,2,0,2,675357,1087,122480,3776,0.008609491826131035,0.7764754266913428
7872,0.7875,4,0,4,675357,1087,122484,3772,0.008609491826131035,0.7762914179872402
7873,0.7876,6,0,6,675357,1087,122490,3766,0.008609491826131035,0.7760148361838038
7874,0.7877,4,1,4,675358,1086,122494,3762,0.00860157141046762,0.775990099009901
7875,0.7878,7,1,7,675359,1085,122501,3755,0.008593650994804207,0.7758264462809917
7876,0.7879,5,4,5,675363,1081,122506,3750,0.008561969332150551,0.7762368039743325
7877,0.788,7,1,7,675364,1080,122513,3743,0.008554048916487138,0.7760729836201534
7878,0.7881,4,2,4,675366,1078,122517,3739,0.00853820808516031,0.7762092588748184
7879,0.7882,5,0,5,675366,1078,122522,3734,0.00853820808516031,0.7759767248545303
7880,0.7883,5,1,5,675367,1077,122527,3729,0.008530287669496895,0.7759051186017478
7881,0.7884,3,2,3,675369,1075,122530,3726,0.008514446838170067,0.7760883149343887
7882,0.7885,5,3,5,675372,1072,122535,3721,0.008490685591179825,0.7763404965574796
7883,0.7886,6,3,6,675375,1069,122541,3715,0.008466924344189584,0.7765468227424749
7884,0.7887,6,0,6,675375,1069,122547,3709,0.008466924344189584,0.7762662201758058
7885,0.7888,7,2,7,675377,1067,122554,3702,0.008451083512862756,0.7762633675823024
7886,0.7889,8,2,8,675379,1065,122562,3694,0.008435242681535927,0.7762134902290397
7887,0.789,6,0,6,675379,1065,122568,3688,0.008435242681535927,0.7759309909530823
7888,0.7891,6,0,6,675379,1065,122574,3682,0.008435242681535927,0.7756477775437118
7889,0.7892,8,2,8,675381,1063,122582,3674,0.0084194018502091,0.7755963690099219
7890,0.7893,7,1,7,675382,1062,122589,3667,0.008411481434545684,0.7754282089236625
7891,0.7894,3,4,3,675386,1058,122592,3664,0.00837979977189203,0.7759423972892842
7892,0.7895,4,0,4,675386,1058,122596,3660,0.00837979977189203,0.7757524374735058
7893,0.7896,3,1,3,675387,1057,122599,3657,0.008371879356228615,0.7757742893508698
7894,0.7897,5,2,5,675389,1055,122604,3652,0.008356038524901787,0.7758657318886765
7895,0.7898,0,1,0,675390,1054,122604,3652,0.008348118109238373,0.7760305992350192
7896,0.7899,2,1,2,675391,1053,122606,3650,0.008340197693574958,0.7761003614714013
7897,0.79,8,1,8,675392,1052,122614,3642,0.008332277277911545,0.775884107371112
7898,0.7901,6,2,6,675394,1050,122620,3636,0.008316436446584717,0.7759282970550576
7899,0.7902,7,0,7,675394,1050,122627,3629,0.008316436446584717,0.7755930754434708
7900,0.7903,4,5,4,675399,1045,122631,3625,0.008276834368267646,0.7762312633832976
7901,0.7904,7,1,7,675400,1044,122638,3618,0.008268913952604233,0.7760617760617761
7902,0.7905,5,0,5,675400,1044,122643,3613,0.008268913952604233,0.7758213442130126
7903,0.7906,3,0,3,675400,1044,122646,3610,0.008268913952604233,0.7756768371293511
7904,0.7907,2,0,2,675400,1044,122648,3608,0.008268913952604233,0.7755803955288049
7905,0.7908,5,3,5,675403,1041,122653,3603,0.008245152705613991,0.7758397932816538
7906,0.7909,4,2,4,675405,1039,122657,3599,0.008229311874287163,0.7759810263044415
7907,0.791,6,1,6,675406,1038,122663,3593,0.008221391458623748,0.7758583459296048
7908,0.7911,9,1,9,675407,1037,122672,3584,0.008213471042960335,0.7755896991993075
7909,0.7912,1,3,1,675410,1034,122673,3583,0.008189709795970092,0.7760450508988521
7910,0.7913,3,3,3,675413,1031,122676,3580,0.00816594854897985,0.7764042507048362
7911,0.7914,2,1,2,675414,1030,122678,3578,0.008158028133316437,0.7764756944444444
7912,0.7915,7,3,7,675417,1027,122685,3571,0.008134266886326194,0.7766420182688125
7913,0.7916,5,0,5,675417,1027,122690,3566,0.008134266886326194,0.7763988678423688
7914,0.7917,4,2,4,675419,1025,122694,3562,0.008118426054999366,0.776542402441683
7915,0.7918,7,2,7,675421,1023,122701,3555,0.008102585223672538,0.7765399737876802
7916,0.7919,5,2,5,675423,1021,122706,3550,0.00808674439234571,0.7766353095602713
7917,0.792,5,1,5,675424,1020,122711,3545,0.008078823976682296,0.7765607886089814
7918,0.7921,9,1,9,675425,1019,122720,3536,0.008070903561018881,0.7762897914379803
7919,0.7922,4,3,4,675428,1016,122724,3532,0.00804714231402864,0.7766051011433597
7920,0.7923,3,3,3,675431,1013,122727,3529,0.008023381067038399,0.7769704975781594
7921,0.7924,5,2,5,675433,1011,122732,3524,0.00800754023571157,0.7770672546857773
7922,0.7925,4,5,4,675438,1006,122736,3520,0.0079679381573945,0.7777286787450287
7923,0.7926,3,3,3,675441,1003,122739,3517,0.007944176910404258,0.7780973451327433
7924,0.7927,2,4,2,675445,999,122741,3515,0.007912495247750602,0.7786885245901639
7925,0.7928,2,1,2,675446,998,122743,3513,0.007904574832087188,0.778763023719796
7926,0.7929,1,1,1,675447,997,122744,3512,0.007896654416423773,0.77888667110224
7927,0.793,4,1,4,675448,996,122748,3508,0.00788873400076036,0.7788632326820604
7928,0.7931,3,2,3,675450,994,122751,3505,0.007872893169433532,0.7790620137808402
7929,0.7932,5,1,5,675451,993,122756,3500,0.007864972753770117,0.7789895392833296
7930,0.7933,7,2,7,675453,991,122763,3493,0.00784913192244329,0.7789919714540589
7931,0.7934,6,4,6,675457,987,122769,3487,0.007817450259789634,0.7793920429146178
7932,0.7935,6,1,6,675458,986,122775,3481,0.007809529844126219,0.7792702037161406
7933,0.7936,3,2,3,675460,984,122778,3478,0.007793689012799392,0.7794710891976692
7934,0.7937,5,2,5,675462,982,122783,3473,0.007777848181472564,0.7795735129068463
7935,0.7938,5,0,5,675462,982,122788,3468,0.007777848181472564,0.7793258426966292
7936,0.7939,0,1,0,675463,981,122788,3468,0.00776992776580915,0.7795010114632501
7937,0.794,3,1,3,675464,980,122791,3465,0.007762007350145736,0.7795275590551181
7938,0.7941,5,2,5,675466,978,122796,3460,0.007746166518818908,0.7796304641730509
7939,0.7942,4,0,4,675466,978,122800,3456,0.007746166518818908,0.7794316644113667
7940,0.7943,10,2,10,675468,976,122810,3446,0.0077303256874920795,0.7792853912256897
7941,0.7944,6,1,6,675469,975,122816,3440,0.007722405271828665,0.7791619479048698
7942,0.7945,1,1,1,675470,974,122817,3439,0.007714484856165251,0.7792884658962157
7943,0.7946,4,3,4,675473,971,122821,3435,0.00769072360917501,0.7796187017703132
7944,0.7947,3,4,3,675477,967,122824,3432,0.007659041946521354,0.7801773130256876
7945,0.7948,4,2,4,675479,965,122828,3428,0.0076432011151945254,0.7803323469155474
7946,0.7949,2,2,2,675481,963,122830,3426,0.007627360283867697,0.7805878332194122
7947,0.795,6,2,6,675483,961,122836,3420,0.007611519452540869,0.7806436886555581
7948,0.7951,4,1,4,675484,960,122840,3416,0.007603599036877455,0.7806215722120659
7949,0.7952,4,2,4,675486,958,122844,3412,0.007587758205550627,0.7807780320366132
7950,0.7953,5,2,5,675488,956,122849,3407,0.0075719173742238,0.7808847123538849
7951,0.7954,5,2,5,675490,954,122854,3402,0.007556076542896971,0.78099173553719
7952,0.7955,6,2,6,675492,952,122860,3396,0.007540235711570143,0.781048758049678
7953,0.7956,5,2,5,675494,950,122865,3391,0.007524394880243315,0.7811564155724487
7954,0.7957,4,1,4,675495,949,122869,3387,0.007516474464579901,0.7811346863468634
7955,0.7958,4,2,4,675497,947,122873,3383,0.007500633633253073,0.7812933025404157
7956,0.7959,1,1,1,675498,946,122874,3382,0.007492713217589659,0.7814232902033271
7957,0.796,5,2,5,675500,944,122879,3377,0.0074768723862628315,0.7815320527655635
7958,0.7961,5,5,5,675505,939,122884,3372,0.007437270307945761,0.7821851078636047
7959,0.7962,2,0,2,675505,939,122886,3370,0.007437270307945761,0.7820840102111859
7960,0.7963,4,3,4,675508,936,122890,3366,0.007413509060955519,0.7824267782426778
7961,0.7964,3,2,3,675510,934,122893,3363,0.007397668229628691,0.7826390505003491
7962,0.7965,2,2,2,675512,932,122895,3361,0.0073818273983018625,0.7829023992546005
7963,0.7966,8,0,8,675512,932,122903,3353,0.0073818273983018625,0.7824970828471411
7964,0.7967,3,1,3,675513,931,122906,3350,0.007373906982638449,0.7825274468582107
7965,0.7968,3,1,3,675514,930,122909,3347,0.007365986566975035,0.7825578676642506
7966,0.7969,5,1,5,675515,929,122914,3342,0.007358066151311621,0.7824865371107469
7967,0.797,7,0,7,675515,929,122921,3335,0.007358066151311621,0.7821294559099438
7968,0.7971,5,2,5,675517,927,122926,3330,0.007342225319984793,0.7822410147991543
7969,0.7972,7,0,7,675517,927,122933,3323,0.007342225319984793,0.7818823529411765
7970,0.7973,2,3,2,675520,924,122935,3321,0.007318464072994551,0.7823321554770318
7971,0.7974,5,1,5,675521,923,122940,3316,0.007310543657331137,0.7822599669733428
7972,0.7975,3,0,3,675521,923,122943,3313,0.007310543657331137,0.7821057601510859
7973,0.7976,5,1,5,675522,922,122948,3308,0.0073026232416677226,0.782033096926714
7974,0.7977,6,0,6,675522,922,122954,3302,0.0073026232416677226,0.7817234848484849
7975,0.7978,3,0,3,675522,922,122957,3299,0.0073026232416677226,0.7815683487325278
7976,0.7979,3,2,3,675524,920,122960,3296,0.007286782410340894,0.7817836812144212
7977,0.798,6,4,6,675528,916,122966,3290,0.007255100747687239,0.7822158820732287
7978,0.7981,3,3,3,675531,913,122969,3287,0.007231339500696997,0.7826190476190477
7979,0.7982,4,3,4,675534,910,122973,3283,0.0072075782537067545,0.7829716193656093
7980,0.7983,4,0,4,675534,910,122977,3279,0.0072075782537067545,0.7827643829076152
7981,0.7984,2,0,2,675534,910,122979,3277,0.0072075782537067545,0.7826606161929782
7982,0.7985,5,1,5,675535,909,122984,3272,0.00719965783804334,0.7825878976321454
7983,0.7986,1,1,1,675536,908,122985,3271,0.007191737422379926,0.7827231395070591
7984,0.7987,6,2,6,675538,906,122991,3265,0.007175896591053098,0.7827859026612323
7985,0.7988,2,0,2,675538,906,122993,3263,0.007175896591053098,0.7826816982489806
7986,0.7989,4,1,4,675539,905,122997,3259,0.007167976175389684,0.7826609029779059
7987,0.799,6,1,6,675540,904,123003,3253,0.007160055759726271,0.7825354823189801
7988,0.7991,6,3,6,675543,901,123009,3247,0.007136294512736029,0.7827868852459017
7989,0.7992,4,4,4,675547,897,123013,3243,0.007104612850082372,0.7833333333333333
7990,0.7993,4,1,4,675548,896,123017,3239,0.007096692434418958,0.7833131801692865
7991,0.7994,1,3,1,675551,893,123018,3238,0.007072931187428716,0.7838295812152021
7992,0.7995,4,2,4,675553,891,123022,3234,0.007057090356101888,0.784
7993,0.7996,5,2,5,675555,889,123027,3229,0.0070412495247750605,0.7841185041282176
7994,0.7997,5,0,5,675555,889,123032,3224,0.0070412495247750605,0.7838560661317773
7995,0.7998,4,0,4,675555,889,123036,3220,0.0070412495247750605,0.7836456558773425
7996,0.7999,3,0,3,675555,889,123039,3217,0.0070412495247750605,0.7834875791524598
7997,0.8,5,0,5,675555,889,123044,3212,0.0070412495247750605,0.7832236039990246
7998,0.8001,2,1,2,675556,888,123046,3210,0.007033329109111646,0.7833089311859444
7999,0.8002,4,0,4,675556,888,123050,3206,0.007033329109111646,0.7830972154372252
8000,0.8003,5,2,5,675558,886,123055,3201,0.007017488277784818,0.7832150721800832
8001,0.8004,4,1,4,675559,885,123059,3197,0.007009567862121404,0.7831945124938755
8002,0.8005,6,3,6,675562,882,123065,3191,0.006985806615131162,0.7834520009820771
8003,0.8006,3,1,3,675563,881,123068,3188,0.006977886199467748,0.7834848857213075
8004,0.8007,4,0,4,675563,881,123072,3184,0.006977886199467748,0.7832718327183272
8005,0.8008,5,1,5,675564,880,123077,3179,0.006969965783804334,0.7831978319783198
8006,0.8009,6,2,6,675566,878,123083,3173,0.006954124952477506,0.7832633917551222
8007,0.801,0,1,0,675567,877,123083,3173,0.006946204536814092,0.7834567901234568
8008,0.8011,2,3,2,675570,874,123085,3171,0.00692244328982385,0.7839307787391842
8009,0.8012,3,2,3,675572,872,123088,3168,0.006906602458497022,0.7841584158415842
8010,0.8013,4,2,4,675574,870,123092,3164,0.006890761627170194,0.7843331680713932
8011,0.8014,5,0,5,675574,870,123097,3159,0.006890761627170194,0.7840655249441548
8012,0.8015,1,1,1,675575,869,123098,3158,0.00688284121150678,0.7842066054134591
8013,0.8016,5,2,5,675577,867,123103,3153,0.006867000380179952,0.7843283582089552
8014,0.8017,5,2,5,675579,865,123108,3148,0.0068511595488531234,0.784450535758784
8015,0.8018,3,3,3,675582,862,123111,3145,0.006827398301862882,0.7848764661841777
8016,0.8019,5,1,5,675583,861,123116,3140,0.006819477886199468,0.7848037990502374
8017,0.802,5,2,5,675585,859,123121,3135,0.00680363705487264,0.7849273910866299
8018,0.8021,3,0,3,675585,859,123124,3132,0.00680363705487264,0.7847657228764721
8019,0.8022,7,1,7,675586,858,123131,3125,0.006795716639209226,0.7845844840572432
8020,0.8023,0,2,0,675588,856,123131,3125,0.006779875807882398,0.7849786485807586
8021,0.8024,3,1,3,675589,855,123134,3122,0.0067719553922189835,0.7850138295197385
8022,0.8025,10,2,10,675591,853,123144,3112,0.006756114560892155,0.7848675914249684
8023,0.8026,5,2,5,675593,851,123149,3107,0.006740273729565327,0.7849924204143507
8024,0.8027,5,1,5,675594,850,123154,3102,0.006732353313901914,0.784919028340081
8025,0.8028,6,1,6,675595,849,123160,3096,0.0067244328982385,0.7847908745247149
8026,0.8029,5,1,5,675596,848,123165,3091,0.006716512482575086,0.7847169332317847
8027,0.803,6,2,6,675598,846,123171,3085,0.006700671651248258,0.7847875858560163
8028,0.8031,8,2,8,675600,844,123179,3077,0.0066848308199214295,0.7847487885743433
8029,0.8032,4,0,4,675600,844,123183,3073,0.0066848308199214295,0.7845289762573397
8030,0.8033,5,2,5,675602,842,123188,3068,0.006668989988594601,0.7846547314578005
8031,0.8034,6,1,6,675603,841,123194,3062,0.006661069572931187,0.784524724570843
8032,0.8035,4,3,4,675606,838,123198,3058,0.006637308325940945,0.7849075975359343
8033,0.8036,6,0,6,675606,838,123204,3052,0.006637308325940945,0.7845758354755784
8034,0.8037,5,1,5,675607,837,123209,3047,0.006629387910277532,0.7845005149330587
8035,0.8038,6,1,6,675608,836,123215,3041,0.006621467494614118,0.7843693577508383
8036,0.8039,4,2,4,675610,834,123219,3037,0.0066056266632872895,0.7845517954017049
8037,0.804,3,1,3,675611,833,123222,3034,0.0065977062476238755,0.7845875355572796
8038,0.8041,4,2,4,675613,831,123226,3030,0.006581865416297047,0.7847707847707848
8039,0.8042,2,2,2,675615,829,123228,3028,0.006566024584970219,0.7850661135597615
8040,0.8043,1,1,1,675616,828,123229,3027,0.006558104169306805,0.7852140077821012
8041,0.8044,0,1,0,675617,827,123229,3027,0.006550183753643391,0.7854177477944992
8042,0.8045,8,2,8,675619,825,123237,3019,0.006534342922316563,0.7853798126951093
8043,0.8046,1,3,1,675622,822,123238,3018,0.0065105816753263214,0.7859375
8044,0.8047,3,1,3,675623,821,123241,3015,0.006502661259662907,0.7859749739311783
8045,0.8048,4,3,4,675626,818,123245,3011,0.006478900012672665,0.7863671977017498
8046,0.8049,6,4,6,675630,814,123251,3005,0.006447218350019009,0.7868551976957319
8047,0.805,4,0,4,675630,814,123255,3001,0.006447218350019009,0.7866317169069462
8048,0.8051,4,1,4,675631,813,123259,2997,0.006439297934355595,0.7866141732283465
8049,0.8052,4,2,4,675633,811,123263,2993,0.0064234571030287665,0.7868033648790747
8050,0.8053,8,0,8,675633,811,123271,2985,0.0064234571030287665,0.7863540569020021
8051,0.8054,4,2,4,675635,809,123275,2981,0.006407616271701939,0.7865435356200527
8052,0.8055,3,0,3,675635,809,123278,2978,0.006407616271701939,0.7863744388698178
8053,0.8056,7,2,7,675637,807,123285,2971,0.006391775440375111,0.7863949179460031
8054,0.8057,3,3,3,675640,804,123288,2968,0.006368014193384869,0.7868504772004242
8055,0.8058,5,2,5,675642,802,123293,2963,0.006352173362058041,0.7869853917662682
8056,0.8059,6,2,6,675644,800,123299,2957,0.0063363325307312125,0.7870641469257387
8057,0.806,6,1,6,675645,799,123305,2951,0.0063284121150677984,0.7869333333333334
8058,0.8061,4,0,4,675645,799,123309,2947,0.0063284121150677984,0.7867058195408436
8059,0.8062,4,3,4,675648,796,123313,2943,0.006304650868077557,0.7871088526343942
8060,0.8063,7,2,7,675650,794,123320,2936,0.006288810036750729,0.7871313672922252
8061,0.8064,8,2,8,675652,792,123328,2928,0.006272969205423901,0.7870967741935484
8062,0.8065,5,1,5,675653,791,123333,2923,0.006265048789760487,0.7870220786214324
8063,0.8066,5,2,5,675655,789,123338,2918,0.0062492079584336585,0.787159428108983
8064,0.8067,2,2,2,675657,787,123340,2916,0.00623336712710683,0.7874696192276532
8065,0.8068,5,2,5,675659,785,123345,2911,0.006217526295780002,0.7876082251082251
8066,0.8069,7,2,7,675661,783,123352,2904,0.006201685464453175,0.7876322213181448
8067,0.807,7,3,7,675664,780,123359,2897,0.006177924217462933,0.7878705466412836
8068,0.8071,7,1,7,675665,779,123366,2890,0.0061700038017995186,0.7876805669119651
8069,0.8072,7,0,7,675665,779,123373,2883,0.0061700038017995186,0.7872747132714364
8070,0.8073,2,0,2,675665,779,123375,2881,0.0061700038017995186,0.7871584699453552
8071,0.8074,7,1,7,675666,778,123382,2874,0.0061620833861361045,0.7869660460021906
8072,0.8075,7,3,7,675669,775,123389,2867,0.006138322139145862,0.7872048325096102
8073,0.8076,3,1,3,675670,774,123392,2864,0.006130401723482448,0.7872457394172623
8074,0.8077,6,1,6,675671,773,123398,2858,0.006122481307819034,0.7871109887083448
8075,0.8078,1,0,1,675671,773,123399,2857,0.006122481307819034,0.7870523415977961
8076,0.8079,2,1,2,675672,772,123401,2855,0.00611456089215562,0.7871519161841742
8077,0.808,4,1,4,675673,771,123405,2851,0.006106640476492206,0.7871341800110436
8078,0.8081,3,3,3,675676,768,123408,2848,0.0060828792295019645,0.7876106194690266
8079,0.8082,9,1,9,675677,767,123417,2839,0.0060749588138385505,0.7872989462007765
8080,0.8083,4,0,4,675677,767,123421,2835,0.0060749588138385505,0.7870627429205996
8081,0.8084,4,1,4,675678,766,123425,2831,0.006067038398175136,0.7870447595218237
8082,0.8085,1,2,1,675680,764,123426,2830,0.006051197566848308,0.7874234835837507
8083,0.8086,3,2,3,675682,762,123429,2827,0.00603535673552148,0.7876845918083032
8084,0.8087,5,5,5,675687,757,123434,2822,0.00599575465720441,0.7884884045822855
8085,0.8088,10,0,10,675687,757,123444,2812,0.00599575465720441,0.7878957691230036
8086,0.8089,5,1,5,675688,756,123449,2807,0.0059878342415409964,0.787819253438114
8087,0.809,4,4,4,675692,752,123453,2803,0.00595615257888734,0.7884669479606189
8088,0.8091,2,1,2,675693,751,123455,2801,0.005948232163223926,0.7885698198198198
8089,0.8092,4,2,4,675695,749,123459,2797,0.005932391331897098,0.7887760857304005
8090,0.8093,6,3,6,675698,746,123465,2791,0.005908630084906856,0.7890867967203845
8091,0.8094,2,1,2,675699,745,123467,2789,0.0059007096692434416,0.7891907187323146
8092,0.8095,2,1,2,675700,744,123469,2787,0.0058927892535800275,0.7892948173322005
8093,0.8096,4,4,4,675704,740,123473,2783,0.005861107590926372,0.7899517456713029
8094,0.8097,3,0,3,675704,740,123476,2780,0.005861107590926372,0.7897727272727273
8095,0.8098,4,2,4,675706,738,123480,2776,0.005845266759599544,0.7899829254410927
8096,0.8099,4,0,4,675706,738,123484,2772,0.005845266759599544,0.7897435897435897
8097,0.81,3,3,3,675709,735,123487,2769,0.005821505512609302,0.7902397260273972
8098,0.8101,2,1,2,675710,734,123489,2767,0.0058135850969458875,0.7903456155384176
8099,0.8102,3,0,3,675710,734,123492,2764,0.0058135850969458875,0.7901658090337336
8100,0.8103,4,2,4,675712,732,123496,2760,0.005797744265619059,0.7903780068728522
8101,0.8104,4,3,4,675715,729,123500,2756,0.005773983018628818,0.7908177905308464
8102,0.8105,4,4,4,675719,725,123504,2752,0.005742301355975162,0.7914869140063273
8103,0.8106,5,0,5,675719,725,123509,2747,0.005742301355975162,0.7911866359447005
8104,0.8107,3,0,3,675719,725,123512,2744,0.005742301355975162,0.7910060536177573
8105,0.8108,5,0,5,675719,725,123517,2739,0.005742301355975162,0.7907043879907621
8106,0.8109,3,0,3,675719,725,123520,2736,0.005742301355975162,0.7905229702398151
8107,0.811,2,2,2,675721,723,123522,2734,0.0057264605246483335,0.7908591264101822
8108,0.8111,3,2,3,675723,721,123525,2731,0.005710619693321505,0.791135573580533
8109,0.8112,2,1,2,675724,720,123527,2729,0.005702699277658091,0.7912438387938533
8110,0.8113,4,3,4,675727,717,123531,2725,0.005678938030667849,0.7916908773968623
8111,0.8114,6,2,6,675729,715,123537,2719,0.005663097199341022,0.7917880023296447
8112,0.8115,3,0,3,675729,715,123540,2716,0.005663097199341022,0.7916059457883999
8113,0.8116,9,0,9,675729,715,123549,2707,0.005663097199341022,0.7910578609000585
8114,0.8117,2,1,2,675730,714,123551,2705,0.005655176783677608,0.791167007897046
8115,0.8118,6,0,6,675730,714,123557,2699,0.005655176783677608,0.7907998828010548
8116,0.8119,4,0,4,675730,714,123561,2695,0.005655176783677608,0.7905544147843943
8117,0.812,5,0,5,675730,714,123566,2690,0.005655176783677608,0.7902467685076381
8118,0.8121,6,3,6,675733,711,123572,2684,0.005631415536687365,0.7905743740795287
8119,0.8122,4,1,4,675734,710,123576,2680,0.005623495121023951,0.7905604719764012
8120,0.8123,4,1,4,675735,709,123580,2676,0.005615574705360537,0.790546528803545
8121,0.8124,7,1,7,675736,708,123587,2669,0.005607654289697123,0.7903464613562333
8122,0.8125,1,1,1,675737,707,123588,2668,0.005599733874033709,0.7905185185185185
8123,0.8126,4,1,4,675738,706,123592,2664,0.005591813458370295,0.7905044510385757
8124,0.8127,2,0,2,675738,706,123594,2662,0.005591813458370295,0.7903800475059383
8125,0.8128,5,1,5,675739,705,123599,2657,0.005583893042706881,0.7903033908387864
8126,0.8129,5,1,5,675740,704,123604,2652,0.005575972627043467,0.7902264600715138
8127,0.813,4,2,4,675742,702,123608,2648,0.0055601317957166396,0.7904477611940298
8128,0.8131,2,0,2,675742,702,123610,2646,0.0055601317957166396,0.7903225806451613
8129,0.8132,6,2,6,675744,700,123616,2640,0.005544290964389811,0.7904191616766467
8130,0.8133,4,0,4,675744,700,123620,2636,0.005544290964389811,0.790167865707434
8131,0.8134,2,2,2,675746,698,123622,2634,0.005528450133062983,0.790516206482593
8132,0.8135,3,1,3,675747,697,123625,2631,0.005520529717399569,0.7905649038461539
8133,0.8136,4,6,4,675753,691,123629,2627,0.005473007223419085,0.7917420132610006
8134,0.8137,4,1,4,675754,690,123633,2623,0.005465086807755671,0.791729550256565
8135,0.8138,7,0,7,675754,690,123640,2616,0.005465086807755671,0.7912885662431942
8136,0.8139,3,1,3,675755,689,123643,2613,0.005457166392092257,0.7913385826771654
8137,0.814,4,1,4,675756,688,123647,2609,0.005449245976428843,0.7913254473764028
8138,0.8141,4,1,4,675757,687,123651,2605,0.005441325560765429,0.7913122721749696
8139,0.8142,3,1,3,675758,686,123654,2602,0.005433405145102015,0.7913625304136253
8140,0.8143,1,0,1,675758,686,123655,2601,0.005433405145102015,0.7912990568907818
8141,0.8144,3,0,3,675758,686,123658,2598,0.005433405145102015,0.7911084043848965
8142,0.8145,2,2,2,675760,684,123660,2596,0.005417564313775187,0.7914634146341464
8143,0.8146,1,0,1,675760,684,123661,2595,0.005417564313775187,0.7913998170173834
8144,0.8147,3,2,3,675762,682,123664,2592,0.005401723482448359,0.7916921197312157
8145,0.8148,5,1,5,675763,681,123669,2587,0.005393803066784945,0.7916156670746634
8146,0.8149,2,0,2,675763,681,123671,2585,0.005393803066784945,0.7914880587875076
8147,0.815,5,0,5,675763,681,123676,2580,0.005393803066784945,0.7911683532658693
8148,0.8151,3,1,3,675764,680,123679,2577,0.005385882651121531,0.7912189131102242
8149,0.8152,2,3,2,675767,677,123681,2575,0.005362121404131288,0.791820418204182
8150,0.8153,2,3,2,675770,674,123683,2573,0.005338360157141047,0.7924237757930397
8151,0.8154,5,0,5,675770,674,123688,2568,0.005338360157141047,0.7921036397285626
8152,0.8155,5,1,5,675771,673,123693,2563,0.005330439741477633,0.792027194066749
8153,0.8156,5,2,5,675773,671,123698,2558,0.005314598910150805,0.7921957262310313
8154,0.8157,3,0,3,675773,671,123701,2555,0.005314598910150805,0.792002479851209
8155,0.8158,5,0,5,675773,671,123706,2550,0.005314598910150805,0.7916796026078857
8156,0.8159,6,2,6,675775,669,123712,2544,0.005298758078823977,0.7917833800186741
8157,0.816,2,3,2,675778,666,123714,2542,0.005274996831833734,0.7923940149625935
8158,0.8161,4,1,4,675779,665,123718,2538,0.00526707641617032,0.7923821417421167
8159,0.8162,1,2,1,675781,663,123719,2537,0.005251235584843493,0.7928125
8160,0.8163,3,1,3,675782,662,123722,2534,0.005243315169180079,0.7928660826032541
8161,0.8164,8,0,8,675782,662,123730,2526,0.005243315169180079,0.7923462986198243
8162,0.8165,2,2,2,675784,660,123732,2524,0.005227474337853251,0.792713567839196
8163,0.8166,6,2,6,675786,658,123738,2518,0.005211633506526423,0.7928211586901763
8164,0.8167,6,3,6,675789,655,123744,2512,0.00518787225953618,0.7931796652983897
8165,0.8168,3,2,3,675791,653,123747,2509,0.005172031428209352,0.7934851359898798
8166,0.8169,2,1,2,675792,652,123749,2507,0.005164111012545938,0.7936055713833492
8167,0.817,5,1,5,675793,651,123754,2502,0.005156190596882524,0.7935299714557564
8168,0.8171,8,2,8,675795,649,123762,2494,0.005140349765555697,0.7935093859370028
8169,0.8172,3,1,3,675796,648,123765,2491,0.005132429349892283,0.7935648295635552
8170,0.8173,2,2,2,675798,646,123767,2489,0.0051165885185654545,0.793939393939394
8171,0.8174,4,1,4,675799,645,123771,2485,0.00510866810290204,0.7939297124600639
8172,0.8175,1,2,1,675801,643,123772,2484,0.005092827271575212,0.7943716021746082
8173,0.8176,4,2,4,675803,641,123776,2480,0.005076986440248384,0.7946171099006729
8174,0.8177,7,1,7,675804,640,123783,2473,0.00506906602458497,0.7944105364600065
8175,0.8178,2,0,2,675804,640,123785,2471,0.00506906602458497,0.7942783670845387
8176,0.8179,8,2,8,675806,638,123793,2463,0.005053225193258142,0.7942599161560787
8177,0.818,6,1,6,675807,637,123799,2457,0.005045304777594728,0.7941176470588235
8178,0.8181,4,2,4,675809,635,123803,2453,0.0050294639462679005,0.7943652849740933
8179,0.8182,3,0,3,675809,635,123806,2450,0.0050294639462679005,0.7941653160453809
8180,0.8183,4,1,4,675810,634,123810,2446,0.005021543530604486,0.7941558441558442
8181,0.8184,2,0,2,675810,634,123812,2444,0.005021543530604486,0.7940220922677063
8182,0.8185,3,1,3,675811,633,123815,2441,0.005013623114941072,0.7940793754066363
8183,0.8186,5,0,5,675811,633,123820,2436,0.005013623114941072,0.793743890518084
8184,0.8187,3,3,3,675814,630,123823,2433,0.00498986186795083,0.7943192948090108
8185,0.8188,1,0,1,675814,630,123824,2432,0.00498986186795083,0.7942521227955585
8186,0.8189,3,1,3,675815,629,123827,2429,0.004981941452287416,0.7943100065402223
8187,0.819,2,3,2,675818,626,123829,2427,0.004958180205297174,0.7949557811988208
8188,0.8191,4,3,4,675821,623,123833,2423,0.0049344189583069315,0.7954694681549573
8189,0.8192,2,2,2,675823,621,123835,2421,0.004918578126980104,0.7958579881656804
8190,0.8193,5,0,5,675823,621,123840,2416,0.004918578126980104,0.7955218966084953
8191,0.8194,3,0,3,675823,621,123843,2413,0.004918578126980104,0.7953197099538563
8192,0.8195,7,0,7,675823,621,123850,2406,0.004918578126980104,0.7948463825569871
8193,0.8196,5,1,5,675824,620,123855,2401,0.00491065771131669,0.7947699437272426
8194,0.8197,6,1,6,675825,619,123861,2395,0.004902737295653276,0.7946250829462508
8195,0.8198,2,3,2,675828,616,123863,2393,0.004878976048663034,0.7952808241940844
8196,0.8199,2,1,2,675829,615,123865,2391,0.00487105563299962,0.7954091816367266
8197,0.82,3,1,3,675830,614,123868,2388,0.004863135217336206,0.7954696868754164
8198,0.8201,5,1,5,675831,613,123873,2383,0.004855214801672792,0.7953938584779706
8199,0.8202,0,1,0,675832,612,123873,2383,0.0048472943860093775,0.7956594323873122
8200,0.8203,4,1,4,675833,611,123877,2379,0.004839373970345963,0.7956521739130434
8201,0.8204,3,1,3,675834,610,123880,2376,0.004831453554682549,0.7957133288680509
8202,0.8205,5,1,5,675835,609,123885,2371,0.004823533139019136,0.7956375838926174
8203,0.8206,3,6,3,675841,603,123888,2368,0.004776010645038652,0.7970380343318748
8204,0.8207,5,1,5,675842,602,123893,2363,0.0047680902293752376,0.796964586846543
8205,0.8208,3,1,3,675843,601,123896,2360,0.0047601698137118235,0.7970280310705843
8206,0.8209,2,0,2,675843,601,123898,2358,0.0047601698137118235,0.7968908415005069
8207,0.821,4,1,4,675844,600,123902,2354,0.004752249398048409,0.7968855788761002
8208,0.8211,4,2,4,675846,598,123906,2350,0.004736408566721581,0.7971506105834464
8209,0.8212,1,1,1,675847,597,123907,2349,0.004728488151058167,0.7973523421588594
8210,0.8213,5,2,5,675849,595,123912,2344,0.00471264731973134,0.7975501871384825
8211,0.8214,6,1,6,675850,594,123918,2338,0.004704726904067926,0.7974079126875853
8212,0.8215,1,2,1,675852,592,123919,2337,0.004688886072741098,0.797883236599522
8213,0.8216,3,1,3,675853,591,123922,2334,0.0046809656570776835,0.7979487179487179
8214,0.8217,3,2,3,675855,589,123925,2331,0.004665124825750855,0.7982876712328767
8215,0.8218,6,3,6,675858,586,123931,2325,0.004641363578760613,0.7986946066643765
8216,0.8219,6,0,6,675858,586,123937,2319,0.004641363578760613,0.7982788296041308
8217,0.822,4,2,4,675860,584,123941,2315,0.004625522747433785,0.7985512245601931
8218,0.8221,3,1,3,675861,583,123944,2312,0.004617602331770371,0.7986183074265976
8219,0.8222,5,1,5,675862,582,123949,2307,0.004609681916106958,0.7985462097611631
8220,0.8223,5,1,5,675863,581,123954,2302,0.004601761500443544,0.7984738120013875
8221,0.8224,2,0,2,675863,581,123956,2300,0.004601761500443544,0.798333911836168
8222,0.8225,6,1,6,675864,580,123962,2294,0.0045938410847801295,0.7981906750173974
8223,0.8226,5,1,5,675865,579,123967,2289,0.0045859206691167154,0.7981171548117155
8224,0.8227,3,4,3,675869,575,123970,2286,0.004554239006463059,0.7990213212163579
8225,0.8228,4,0,4,675869,575,123974,2282,0.004554239006463059,0.7987399369968499
8226,0.823,4,1,4,675870,574,123978,2278,0.004546318590799645,0.7987377279102384
8227,0.8231,4,3,4,675873,571,123982,2274,0.004522557343809403,0.7992970123022847
8228,0.8232,4,3,4,675876,568,123986,2270,0.004498796096819161,0.7998590556730092
8229,0.8233,3,0,3,675876,568,123989,2267,0.004498796096819161,0.799647266313933
8230,0.8234,2,0,2,675876,568,123991,2265,0.004498796096819161,0.7995058242146135
8231,0.8235,3,2,3,675878,566,123994,2262,0.004482955265492333,0.7998585572842999
8232,0.8236,1,1,1,675879,565,123995,2261,0.004475034849828919,0.800070771408351
8233,0.8237,3,2,3,675881,563,123998,2258,0.004459194018502091,0.8004253810705424
8234,0.8238,5,2,5,675883,561,124003,2253,0.004443353187175263,0.8006396588486141
8235,0.8239,6,1,6,675884,560,124009,2247,0.004435432771511849,0.800498753117207
8236,0.824,5,1,5,675885,559,124014,2242,0.004427512355848435,0.8004284184219922
8237,0.8241,2,1,2,675886,558,124016,2240,0.004419591940185021,0.8005718370264474
8238,0.8242,4,0,4,675886,558,124020,2236,0.004419591940185021,0.800286327845383
8239,0.8243,3,0,3,675886,558,124023,2233,0.004419591940185021,0.8000716589036188
8240,0.8244,3,0,3,675886,558,124026,2230,0.004419591940185021,0.7998565279770444
8241,0.8245,3,0,3,675886,558,124029,2227,0.004419591940185021,0.7996409335727109
8242,0.8246,3,2,3,675888,556,124032,2224,0.0044037511088581924,0.8
8243,0.8247,5,1,5,675889,555,124037,2219,0.004395830693194779,0.7999279019466474
8244,0.8248,5,0,5,675889,555,124042,2214,0.004395830693194779,0.7995666305525461
8245,0.8249,1,3,1,675892,552,124043,2213,0.004372069446204537,0.8003616636528029
8246,0.825,3,1,3,675893,551,124046,2210,0.004364149030541123,0.8004346251358203
8247,0.8251,5,3,5,675896,548,124051,2205,0.004340387783550881,0.8009444242644388
8248,0.8252,3,2,3,675898,546,124054,2202,0.0043245469522240525,0.8013100436681223
8249,0.8253,2,3,2,675901,543,124056,2200,0.00430078570523381,0.8020415603353992
8250,0.8254,2,0,2,675901,543,124058,2198,0.00430078570523381,0.8018971178402043
8251,0.8255,1,3,1,675904,540,124059,2197,0.004277024458243569,0.8027036901717208
8252,0.8256,5,1,5,675905,539,124064,2192,0.004269104042580155,0.8026363969242036
8253,0.8257,7,2,7,675907,537,124071,2185,0.004253263211253327,0.8027185892725937
8254,0.8258,7,0,7,675907,537,124078,2178,0.004253263211253327,0.8022099447513812
8255,0.8259,2,2,2,675909,535,124080,2176,0.0042374223799264985,0.8026558465510881
8256,0.826,6,1,6,675910,534,124086,2170,0.004229501964263084,0.8025147928994083
8257,0.8261,4,0,4,675910,534,124090,2166,0.004229501964263084,0.8022222222222222
8258,0.8262,3,2,3,675912,532,124093,2163,0.004213661132936256,0.8025974025974026
8259,0.8263,5,1,5,675913,531,124098,2158,0.004205740717272842,0.8025288211230941
8260,0.8264,4,0,4,675913,531,124102,2154,0.004205740717272842,0.8022346368715084
8261,0.8265,3,2,3,675915,529,124105,2151,0.004189899885946015,0.8026119402985075
8262,0.8266,7,2,7,675917,527,124112,2144,0.004174059054619187,0.8026956196181205
8263,0.8267,1,1,1,675918,526,124113,2143,0.004166138638955773,0.8029224428624954
8264,0.8268,4,0,4,675918,526,124117,2139,0.004166138638955773,0.8026266416510319
8265,0.8269,2,0,2,675918,526,124119,2137,0.004166138638955773,0.8024784078107398
8266,0.827,7,2,7,675920,524,124126,2130,0.0041502978076289445,0.8025621703089676
8267,0.8271,5,1,5,675921,523,124131,2125,0.00414237739196553,0.8024924471299094
8268,0.8272,4,0,4,675921,523,124135,2121,0.00414237739196553,0.8021936459909228
8269,0.8273,3,1,3,675922,522,124138,2118,0.004134456976302116,0.8022727272727272
8270,0.8274,1,3,1,675925,519,124139,2117,0.004110695729311874,0.8031107738998483
8271,0.8275,1,0,1,675925,519,124140,2116,0.004110695729311874,0.8030360531309297
8272,0.8276,1,0,1,675925,519,124141,2115,0.004110695729311874,0.8029612756264237
8273,0.8277,2,1,2,675926,518,124143,2113,0.00410277531364846,0.8031166856708476
8274,0.8278,5,2,5,675928,516,124148,2108,0.004086934482321632,0.8033536585365854
8275,0.8279,6,0,6,675928,516,124154,2102,0.004086934482321632,0.8029029793735676
8276,0.828,5,0,5,675928,516,124159,2097,0.004086934482321632,0.8025258323765786
8277,0.8281,9,0,9,675928,516,124168,2088,0.004086934482321632,0.8018433179723502
8278,0.8282,2,0,2,675928,516,124170,2086,0.004086934482321632,0.8016910069177555
8279,0.8283,3,1,3,675929,515,124173,2083,0.004079014066658219,0.8017705927636644
8280,0.8284,4,1,4,675930,514,124177,2079,0.0040710936509948045,0.8017740069417663
8281,0.8285,5,1,5,675931,513,124182,2074,0.0040631732353313904,0.801700811751063
8282,0.8286,3,0,3,675931,513,124185,2071,0.0040631732353313904,0.8014705882352942
8283,0.8287,3,1,3,675932,512,124188,2068,0.004055252819667976,0.8015503875968992
8284,0.8288,4,0,4,675932,512,124192,2064,0.004055252819667976,0.8012422360248447
8285,0.8289,1,0,1,675932,512,124193,2063,0.004055252819667976,0.8011650485436893
8286,0.829,1,2,1,675934,510,124194,2062,0.004039411988341148,0.8017107309486781
8287,0.8291,3,2,3,675936,508,124197,2059,0.00402357115701432,0.8021036229061161
8288,0.8292,3,1,3,675937,507,124200,2056,0.004015650741350906,0.8021849395239953
8289,0.8293,4,1,4,675938,506,124204,2052,0.004007730325687492,0.8021892103205629
8290,0.8294,5,1,5,675939,505,124209,2047,0.003999809910024078,0.802115987460815
8291,0.8295,1,1,1,675940,504,124210,2046,0.003991889494360664,0.8023529411764706
8292,0.8296,3,0,3,675940,504,124213,2043,0.003991889494360664,0.8021201413427562
8293,0.8297,7,1,7,675941,503,124220,2036,0.00398396907869725,0.8018905080740449
8294,0.8298,5,2,5,675943,501,124225,2031,0.003968128247370422,0.8021327014218009
8295,0.8299,1,1,1,675944,500,124226,2030,0.003960207831707008,0.8023715415019763
8296,0.83,6,0,6,675944,500,124232,2024,0.003960207831707008,0.8019017432646592
8297,0.8301,2,0,2,675944,500,124234,2022,0.003960207831707008,0.8017446471054719
8298,0.8302,5,2,5,675946,498,124239,2017,0.00394436700038018,0.8019880715705765
8299,0.8303,5,0,5,675946,498,124244,2012,0.00394436700038018,0.801593625498008
8300,0.8304,7,1,7,675947,497,124251,2005,0.003936446584716766,0.8013589128697043
8301,0.8305,2,0,2,675947,497,124253,2003,0.003936446584716766,0.8012
8302,0.8306,4,2,4,675949,495,124257,1999,0.003920605753389938,0.801523656776263
8303,0.8307,2,1,2,675950,494,124259,1997,0.003912685337726524,0.8016860698514653
8304,0.8308,3,1,3,675951,493,124262,1994,0.0039047649220631097,0.8017691998391636
8305,0.8309,1,1,1,675952,492,124263,1993,0.003896844506399696,0.8020120724346076
8306,0.831,6,4,6,675956,488,124269,1987,0.0038651628437460397,0.8028282828282828
8307,0.8311,3,2,3,675958,486,124272,1984,0.0038493220124192116,0.8032388663967611
8308,0.8312,2,0,2,675958,486,124274,1982,0.0038493220124192116,0.8030794165316045
8309,0.8313,4,1,4,675959,485,124278,1978,0.003841401596755798,0.8030856678846935
8310,0.8314,4,0,4,675959,485,124282,1974,0.003841401596755798,0.8027653517690118
8311,0.8315,5,4,5,675963,481,124287,1969,0.0038097199341021416,0.8036734693877551
8312,0.8316,2,1,2,675964,480,124289,1967,0.0038017995184387275,0.8038414384961177
8313,0.8317,4,0,4,675964,480,124293,1963,0.0038017995184387275,0.803520261972984
8314,0.8318,0,2,0,675966,478,124293,1963,0.0037859586871119,0.8041786153215895
8315,0.8319,2,1,2,675967,477,124295,1961,0.0037780382714484857,0.8043478260869565
8316,0.832,3,0,3,675967,477,124298,1958,0.0037780382714484857,0.8041067761806981
8317,0.8321,3,2,3,675969,475,124301,1955,0.0037621974401216575,0.8045267489711934
8318,0.8322,0,3,0,675972,472,124301,1955,0.0037384361931314157,0.8055212196126905
8319,0.8323,1,1,1,675973,471,124302,1954,0.0037305157774680017,0.8057731958762887
8320,0.8324,3,1,3,675974,470,124305,1951,0.0037225953618045876,0.8058653448988021
8321,0.8325,6,0,6,675974,470,124311,1945,0.0037225953618045876,0.8053830227743272
8322,0.8326,4,1,4,675975,469,124315,1941,0.0037146749461411735,0.8053941908713693
8323,0.8327,2,2,2,675977,467,124317,1939,0.0036988341148143453,0.8059019118869493
8324,0.8328,3,0,3,675977,467,124320,1936,0.0036988341148143453,0.8056595921764461
8325,0.8329,7,3,7,675980,464,124327,1929,0.0036750728678241035,0.8061011282908483
8326,0.833,3,1,3,675981,463,124330,1926,0.0036671524521606894,0.8061950606948514
8327,0.8331,3,1,3,675982,462,124333,1923,0.0036592320364972754,0.8062893081761007
8328,0.8332,5,1,5,675983,461,124338,1918,0.0036513116208338613,0.8062211013030686
8329,0.8333,2,1,2,675984,460,124340,1916,0.003643391205170447,0.8063973063973064
8330,0.8334,5,1,5,675985,459,124345,1911,0.003635470789507033,0.8063291139240506
8331,0.8335,3,1,3,675986,458,124348,1908,0.0036275503738436195,0.8064243448858833
8332,0.8336,5,1,5,675987,457,124353,1903,0.0036196299581802054,0.8063559322033899
8333,0.8337,4,1,4,675988,456,124357,1899,0.0036117095425167913,0.8063694267515924
8334,0.8338,3,0,3,675988,456,124360,1896,0.0036117095425167913,0.8061224489795918
8335,0.8339,1,1,1,675989,455,124361,1895,0.0036037891268533772,0.8063829787234043
8336,0.834,3,0,3,675989,455,124364,1892,0.0036037891268533772,0.8061354921175969
8337,0.8341,1,0,1,675989,455,124365,1891,0.0036037891268533772,0.8060528559249787
8338,0.8342,8,1,8,675990,454,124373,1883,0.003595868711189963,0.8057338468121523
8339,0.8343,3,1,3,675991,453,124376,1880,0.003587948295526549,0.8058294042006001
8340,0.8344,4,1,4,675992,452,124380,1876,0.0035800278798631354,0.8058419243986255
8341,0.8345,3,1,3,675993,451,124383,1873,0.0035721074641997213,0.8059380378657487
8342,0.8346,2,3,2,675996,448,124385,1871,0.003548346217209479,0.8068132815868909
8343,0.8347,8,2,8,675998,446,124393,1863,0.003532505385882651,0.8068427890861845
8344,0.8348,4,0,4,675998,446,124397,1859,0.003532505385882651,0.8065075921908894
8345,0.8349,2,1,2,675999,445,124399,1857,0.0035245849702192373,0.8066898349261512
8346,0.835,2,1,2,676000,444,124401,1855,0.003516664554555823,0.8068725532840365
8347,0.8351,2,0,2,676000,444,124403,1853,0.003516664554555823,0.8067043970396169
8348,0.8352,4,2,4,676002,442,124407,1849,0.003500823723228995,0.8070711479703186
8349,0.8353,6,1,6,676003,441,124413,1843,0.003492903307565581,0.8069176882661997
8350,0.8354,2,1,2,676004,440,124415,1841,0.003484982891902167,0.8071021481806225
8351,0.8355,3,0,3,676004,440,124418,1838,0.003484982891902167,0.8068481123792801
8352,0.8356,2,1,2,676005,439,124420,1836,0.003477062476238753,0.807032967032967
8353,0.8357,2,1,2,676006,438,124422,1834,0.003469142060575339,0.8072183098591549
8354,0.8358,3,0,3,676006,438,124425,1831,0.003469142060575339,0.8069634200088145
8355,0.8359,2,2,2,676008,436,124427,1829,0.003453301229248511,0.807505518763797
8356,0.836,3,0,3,676008,436,124430,1826,0.003453301229248511,0.8072502210433244
8357,0.8361,4,1,4,676009,435,124434,1822,0.003445380813585097,0.8072662826761188
8358,0.8362,3,0,3,676009,435,124437,1819,0.003445380813585097,0.8070097604259094
8359,0.8363,5,0,5,676009,435,124442,1814,0.003445380813585097,0.8065807025344598
8360,0.8364,4,0,4,676009,435,124446,1810,0.003445380813585097,0.8062360801781737
8361,0.8365,4,0,4,676009,435,124450,1806,0.003445380813585097,0.8058902275769746
8362,0.8366,1,0,1,676009,435,124451,1805,0.003445380813585097,0.8058035714285714
8363,0.8367,3,0,3,676009,435,124454,1802,0.003445380813585097,0.805543138131426
8364,0.8368,4,1,4,676010,434,124458,1798,0.003437460397921683,0.8055555555555556
8365,0.8369,1,1,1,676011,433,124459,1797,0.0034295399822582688,0.805829596412556
8366,0.837,3,0,3,676011,433,124462,1794,0.0034295399822582688,0.8055680287382129
8367,0.8371,6,2,6,676013,431,124468,1788,0.003413699150931441,0.8057683641279856
8368,0.8372,1,4,1,676017,427,124469,1787,0.0033820174882777847,0.8071364046973803
8369,0.8373,4,2,4,676019,425,124473,1783,0.003366176656950957,0.8075181159420289
8370,0.8374,4,1,4,676020,424,124477,1779,0.003358256241287543,0.8075351793009532
8371,0.8375,1,0,1,676020,424,124478,1778,0.003358256241287543,0.8074477747502271
8372,0.8376,1,1,1,676021,423,124479,1777,0.003350335825624129,0.8077272727272727
8373,0.8377,8,0,8,676021,423,124487,1769,0.003350335825624129,0.8070255474452555
8374,0.8378,5,2,5,676023,421,124492,1764,0.0033344949942973007,0.8073226544622426
8375,0.8379,4,1,4,676024,420,124496,1760,0.0033265745786338866,0.8073394495412844
8376,0.838,6,1,6,676025,419,124502,1754,0.0033186541629704725,0.8071790151863782
8377,0.8381,4,1,4,676026,418,124506,1750,0.003310733747307059,0.8071955719557196
8378,0.8382,1,1,1,676027,417,124507,1749,0.0033028133316436448,0.8074792243767313
8379,0.8383,4,0,4,676027,417,124511,1745,0.0033028133316436448,0.807123034227567
8380,0.8384,4,1,4,676028,416,124515,1741,0.0032948929159802307,0.8071395456652758
8381,0.8385,4,1,4,676029,415,124519,1737,0.0032869725003168166,0.8071561338289963
8382,0.8386,2,2,2,676031,413,124521,1735,0.0032711316689899884,0.8077281191806331
8383,0.8387,2,0,2,676031,413,124523,1733,0.0032711316689899884,0.8075489282385834
8384,0.8388,4,0,4,676031,413,124527,1729,0.0032711316689899884,0.8071895424836601
8385,0.8389,5,0,5,676031,413,124532,1724,0.0032711316689899884,0.8067384183434722
8386,0.839,7,1,7,676032,412,124539,1717,0.0032632112533265744,0.8064819163926726
8387,0.8391,5,0,5,676032,412,124544,1712,0.0032632112533265744,0.8060263653483992
8388,0.8392,2,3,2,676035,409,124546,1710,0.0032394500063363326,0.8069844266163284
8389,0.8393,4,0,4,676035,409,124550,1706,0.0032394500063363326,0.8066193853427897
8390,0.8394,1,0,1,676035,409,124551,1705,0.0032394500063363326,0.8065279091769157
8391,0.8395,2,0,2,676035,409,124553,1703,0.0032394500063363326,0.806344696969697
8392,0.8396,3,1,3,676036,408,124556,1700,0.0032315295906729185,0.8064516129032258
8393,0.8397,1,1,1,676037,407,124557,1699,0.0032236091750095044,0.8067426400759734
8394,0.8398,4,2,4,676039,405,124561,1695,0.0032077683436826767,0.8071428571428572
8395,0.8399,2,0,2,676039,405,124563,1693,0.0032077683436826767,0.8069590085795996
8396,0.84,4,0,4,676039,405,124567,1689,0.0032077683436826767,0.8065902578796562
8397,0.8401,1,1,1,676040,404,124568,1688,0.0031998479280192626,0.8068833652007649
8398,0.8402,5,0,5,676040,404,124573,1683,0.0031998479280192626,0.806420699568759
8399,0.8403,2,0,2,676040,404,124575,1681,0.0031998479280192626,0.8062350119904077
8400,0.8404,4,0,4,676040,404,124579,1677,0.0031998479280192626,0.8058625660740029
8401,0.8405,2,2,2,676042,402,124581,1675,0.0031840070966924344,0.8064516129032258
8402,0.8406,2,1,2,676043,401,124583,1673,0.0031760866810290203,0.8066538090646095
8403,0.8407,4,3,4,676046,398,124587,1669,0.0031523254340387785,0.8074504112239961
8404,0.8408,5,0,5,676046,398,124592,1664,0.0031523254340387785,0.8069835111542192
8405,0.8409,1,1,1,676047,397,124593,1663,0.0031444050183753645,0.8072815533980583
8406,0.841,5,0,5,676047,397,124598,1658,0.0031444050183753645,0.8068126520681265
8407,0.8411,4,2,4,676049,395,124602,1654,0.0031285641870485363,0.8072230356271352
8408,0.8412,3,2,3,676051,393,124605,1651,0.003112723355721708,0.8077299412915852
8409,0.8413,5,0,5,676051,393,124610,1646,0.003112723355721708,0.8072584600294261
8410,0.8415,3,0,3,676051,393,124613,1643,0.003112723355721708,0.8069744597249509
8411,0.8416,6,3,6,676054,390,124619,1637,0.0030889621087314663,0.8075974346324618
8412,0.8418,2,2,2,676056,388,124621,1635,0.003073121277404638,0.8082056351952546
8413,0.8419,2,1,2,676057,387,124623,1633,0.003065200861741224,0.8084158415841585
8414,0.842,4,2,4,676059,385,124627,1629,0.0030493600304143964,0.8088381330685204
8415,0.8421,1,2,1,676061,383,124628,1628,0.003033519199087568,0.8095474888115366
8416,0.8422,6,1,6,676062,382,124634,1622,0.003025598783424154,0.8093812375249501
8417,0.8423,5,2,5,676064,380,124639,1617,0.003009757952097326,0.8097145718577867
8418,0.8424,4,2,4,676066,378,124643,1613,0.0029939171207704982,0.8101456554495229
8419,0.8425,2,1,2,676067,377,124645,1611,0.002985996705107084,0.8103621730382293
8420,0.8426,5,0,5,676067,377,124650,1606,0.002985996705107084,0.8098840141200202
8421,0.8427,7,2,7,676069,375,124657,1599,0.002970155873780256,0.8100303951367781
8422,0.8428,6,1,6,676070,374,124663,1593,0.002962235458116842,0.809862735129639
8423,0.8429,4,0,4,676070,374,124667,1589,0.002962235458116842,0.8094752929190016
8424,0.843,5,2,5,676072,372,124672,1584,0.0029463946267900137,0.8098159509202454
8425,0.8431,4,0,4,676072,372,124676,1580,0.0029463946267900137,0.8094262295081968
8426,0.8432,1,0,1,676072,372,124677,1579,0.0029463946267900137,0.8093285494618144
8427,0.8433,3,1,3,676073,371,124680,1576,0.0029384742111266,0.8094504365690807
8428,0.8434,4,0,4,676073,371,124684,1572,0.0029384742111266,0.8090581574884199
8429,0.8435,1,2,1,676075,369,124685,1571,0.002922633379799772,0.8097938144329897
8430,0.8436,2,1,2,676076,368,124687,1569,0.002914712964136358,0.8100154878678368
8431,0.8437,1,0,1,676076,368,124688,1568,0.002914712964136358,0.8099173553719008
8432,0.8438,1,1,1,676077,367,124689,1567,0.0029067925484729438,0.8102378490175801
8433,0.8439,6,2,6,676079,365,124695,1561,0.002890951717146116,0.8104880581516095
8434,0.844,6,0,6,676079,365,124701,1555,0.002890951717146116,0.8098958333333334
8435,0.8441,5,0,5,676079,365,124706,1550,0.002890951717146116,0.8093994778067886
8436,0.8442,4,1,4,676080,364,124710,1546,0.002883031301482702,0.8094240837696335
8437,0.8443,1,1,1,676081,363,124711,1545,0.002875110885819288,0.809748427672956
8438,0.8444,2,0,2,676081,363,124713,1543,0.002875110885819288,0.8095487932843651
8439,0.8445,4,3,4,676084,360,124717,1539,0.0028513496388290456,0.8104265402843602
8440,0.8446,5,0,5,676084,360,124722,1534,0.0028513496388290456,0.8099260823653643
8441,0.8447,5,0,5,676084,360,124727,1529,0.0028513496388290456,0.8094229751191107
8442,0.8448,5,0,5,676084,360,124732,1524,0.0028513496388290456,0.8089171974522293
8443,0.8449,2,1,2,676085,359,124734,1522,0.0028434292231656316,0.809144072301967
8444,0.845,1,0,1,676085,359,124735,1521,0.0028434292231656316,0.8090425531914893
8445,0.8451,3,2,3,676087,357,124738,1518,0.002827588391838804,0.8096
8446,0.8452,4,0,4,676087,357,124742,1514,0.002827588391838804,0.809192944949225
8447,0.8453,3,2,3,676089,355,124745,1511,0.0028117475605119757,0.8097534833869239
8448,0.8454,2,0,2,676089,355,124747,1509,0.0028117475605119757,0.8095493562231759
8449,0.8455,3,1,3,676090,354,124750,1506,0.0028038271448485616,0.8096774193548387
8450,0.8456,5,0,5,676090,354,124755,1501,0.0028038271448485616,0.8091644204851752
8451,0.8457,3,1,3,676091,353,124758,1498,0.0027959067291851475,0.8092922744462453
8452,0.8458,4,3,4,676094,350,124762,1494,0.0027721454821949057,0.8101952277657267
8453,0.8459,4,0,4,676094,350,124766,1490,0.0027721454821949057,0.8097826086956522
8454,0.846,0,1,0,676095,349,124766,1490,0.0027642250665314916,0.8102229472539424
8455,0.8461,1,2,1,676097,347,124767,1489,0.0027483842352046635,0.8110021786492375
8456,0.8462,5,2,5,676099,345,124772,1484,0.0027325434038778353,0.811372334609076
8457,0.8463,2,1,2,676100,344,124774,1482,0.0027246229882144216,0.8116100766703176
8458,0.8464,4,1,4,676101,343,124778,1478,0.0027167025725510076,0.8116419549697969
8459,0.8465,2,0,2,676101,343,124780,1476,0.0027167025725510076,0.811434854315558
8460,0.8466,4,1,4,676102,342,124784,1472,0.0027087821568875935,0.8114663726571113
8461,0.8467,6,0,6,676102,342,124790,1466,0.0027087821568875935,0.8108407079646017
8462,0.8468,3,0,3,676102,342,124793,1463,0.0027087821568875935,0.8105263157894737
8463,0.8469,3,2,3,676104,340,124796,1460,0.0026929413255607653,0.8111111111111111
8464,0.847,1,1,1,676105,339,124797,1459,0.0026850209098973512,0.8114571746384872
8465,0.8471,4,2,4,676107,337,124801,1455,0.0026691800785705235,0.8119419642857143
8466,0.8472,7,0,7,676107,337,124808,1448,0.0026691800785705235,0.8112044817927171
8467,0.8473,1,3,1,676110,334,124809,1447,0.0026454188315802813,0.8124649073554183
8468,0.8474,4,0,4,676110,334,124813,1443,0.0026454188315802813,0.8120427687113112
8469,0.8475,1,0,1,676110,334,124814,1442,0.0026454188315802813,0.8119369369369369
8470,0.8476,2,1,2,676111,333,124816,1440,0.002637498415916867,0.8121827411167513
8471,0.8477,1,0,1,676111,333,124817,1439,0.002637498415916867,0.8120767494356659
8472,0.8478,1,1,1,676112,332,124818,1438,0.002629578000253453,0.8124293785310734
8473,0.8479,6,1,6,676113,331,124824,1432,0.0026216575845900395,0.8122518434486671
8474,0.848,6,0,6,676113,331,124830,1426,0.0026216575845900395,0.8116107000569152
8475,0.8481,1,0,1,676113,331,124831,1425,0.0026216575845900395,0.8115034168564921
8476,0.8482,7,1,7,676114,330,124838,1418,0.0026137371689266254,0.8112128146453089
8477,0.8483,4,0,4,676114,330,124842,1414,0.0026137371689266254,0.8107798165137615
8478,0.8484,3,2,3,676116,328,124845,1411,0.0025978963375997972,0.8113858539390454
8479,0.8485,5,0,5,676116,328,124850,1406,0.0025978963375997972,0.8108419838523645
8480,0.8486,1,0,1,676116,328,124851,1405,0.0025978963375997972,0.8107328332371609
8481,0.8487,1,0,1,676116,328,124852,1404,0.0025978963375997972,0.8106235565819861
8482,0.8488,4,0,4,676116,328,124856,1400,0.0025978963375997972,0.8101851851851852
8483,0.8489,2,1,2,676117,327,124858,1398,0.002589975921936383,0.8104347826086956
8484,0.849,3,0,3,676117,327,124861,1395,0.002589975921936383,0.8101045296167247
8485,0.8491,1,2,1,676119,325,124862,1394,0.002574135090609555,0.8109365910413031
8486,0.8492,1,3,1,676122,322,124863,1393,0.002550373843619313,0.8122448979591836
8487,0.8493,10,1,10,676123,321,124873,1383,0.002542453427955899,0.8116197183098591
8488,0.8494,2,0,2,676123,321,124875,1381,0.002542453427955899,0.8113983548766157
8489,0.8495,4,2,4,676125,319,124879,1377,0.002526612596629071,0.8119103773584906
8490,0.8496,5,2,5,676127,317,124884,1372,0.002510771765302243,0.8123149792776792
8491,0.8497,0,1,0,676128,316,124884,1372,0.002502851349638829,0.8127962085308057
8492,0.8498,5,0,5,676128,316,124889,1367,0.002502851349638829,0.8122400475341652
8493,0.8499,4,0,4,676128,316,124893,1363,0.002502851349638829,0.8117927337701013
8494,0.85,3,1,3,676129,315,124896,1360,0.002494930933975415,0.8119402985074626
8495,0.8501,5,1,5,676130,314,124901,1355,0.002487010518312001,0.8118633912522468
8496,0.8502,3,0,3,676130,314,124904,1352,0.002487010518312001,0.8115246098439376
8497,0.8503,1,0,1,676130,314,124905,1351,0.002487010518312001,0.8114114114114114
8498,0.8504,3,1,3,676131,313,124908,1348,0.002479090102648587,0.8115593016255268
8499,0.8505,7,1,7,676132,312,124915,1341,0.002471169686985173,0.8112522686025408
8500,0.8506,2,0,2,676132,312,124917,1339,0.002471169686985173,0.8110236220472441
8501,0.8507,2,1,2,676133,311,124919,1337,0.002463249271321759,0.8112864077669902
8502,0.8508,3,1,3,676134,310,124922,1334,0.002455328855658345,0.8114355231143552
8503,0.8509,2,1,2,676135,309,124924,1332,0.002447408439994931,0.8117001828153565
8504,0.851,6,1,6,676136,308,124930,1326,0.002439488024331517,0.8115055079559363
8505,0.8511,5,3,5,676139,305,124935,1321,0.0024157267773412747,0.8124231242312423
8506,0.8512,4,0,4,676139,305,124939,1317,0.0024157267773412747,0.811960542540074
8507,0.8513,2,1,2,676140,304,124941,1315,0.002407806361677861,0.8122297714638665
8508,0.8514,2,1,2,676141,303,124943,1313,0.002399885946014447,0.8125
8509,0.8515,1,0,1,676141,303,124944,1312,0.002399885946014447,0.8123839009287925
8510,0.8516,3,1,3,676142,302,124947,1309,0.002391965530351033,0.8125387957790192
8511,0.8517,3,0,3,676142,302,124950,1306,0.002391965530351033,0.8121890547263682
8512,0.8518,2,1,2,676143,301,124952,1304,0.0023840451146876188,0.8124610591900312
8513,0.8519,2,0,2,676143,301,124954,1302,0.0023840451146876188,0.8122270742358079
8514,0.852,4,1,4,676144,300,124958,1298,0.0023761246990242047,0.8122653316645807
8515,0.8521,8,1,8,676145,299,124966,1290,0.0023682042833607906,0.8118313404657017
8516,0.8522,3,0,3,676145,299,124969,1287,0.0023682042833607906,0.8114754098360656
8517,0.8523,5,0,5,676145,299,124974,1282,0.0023682042833607906,0.8108791903858318
8518,0.8524,3,1,3,676146,298,124977,1279,0.002360283867697377,0.8110336081166772
8519,0.8525,2,3,2,676149,295,124979,1277,0.0023365226207071347,0.8123409669211196
8520,0.8526,4,2,4,676151,293,124983,1273,0.0023206817893803066,0.8128991060025543
8521,0.8527,5,1,5,676152,292,124988,1268,0.0023127613737168925,0.8128205128205128
8522,0.8528,1,0,1,676152,292,124989,1267,0.0023127613737168925,0.812700449005773
8523,0.8529,1,0,1,676152,292,124990,1266,0.0023127613737168925,0.8125802310654685
8524,0.853,1,0,1,676152,292,124991,1265,0.0023127613737168925,0.8124598587026333
8525,0.8531,5,0,5,676152,292,124996,1260,0.0023127613737168925,0.8118556701030928
8526,0.8532,2,1,2,676153,291,124998,1258,0.002304840958053479,0.8121368624919303
8527,0.8533,3,0,3,676153,291,125001,1255,0.002304840958053479,0.8117723156532989
8528,0.8534,2,0,2,676153,291,125003,1253,0.002304840958053479,0.8115284974093264
8529,0.8535,2,1,2,676154,290,125005,1251,0.0022969205423900648,0.8118105126541207
8530,0.8536,5,1,5,676155,289,125010,1246,0.0022890001267266507,0.8117263843648208
8531,0.8537,3,0,3,676155,289,125013,1243,0.0022890001267266507,0.8113577023498695
8532,0.8538,3,1,3,676156,288,125016,1240,0.0022810797110632366,0.8115183246073299
8533,0.8539,4,1,4,676157,287,125020,1236,0.0022731592953998225,0.8115561391989494
8534,0.8541,2,1,2,676158,286,125022,1234,0.0022652388797364084,0.8118421052631579
8535,0.8542,3,1,3,676159,285,125025,1231,0.0022573184640729944,0.8120052770448549
8536,0.8543,5,0,5,676159,285,125030,1226,0.0022573184640729944,0.8113831899404368
8537,0.8544,2,1,2,676160,284,125032,1224,0.0022493980484095807,0.8116710875331565
8538,0.8545,6,0,6,676160,284,125038,1218,0.0022493980484095807,0.810918774966711
8539,0.8546,7,0,7,676160,284,125045,1211,0.0022493980484095807,0.8100334448160535
8540,0.8547,4,2,4,676162,282,125049,1207,0.0022335572170827525,0.8106111484217595
8541,0.8548,2,0,2,676162,282,125051,1205,0.0022335572170827525,0.8103564223268326
8542,0.8549,1,1,1,676163,281,125052,1204,0.0022256368014193385,0.8107744107744108
8543,0.855,5,0,5,676163,281,125057,1199,0.0022256368014193385,0.8101351351351351
8544,0.8551,3,1,3,676164,280,125060,1196,0.0022177163857559244,0.8102981029810298
8545,0.8552,2,1,2,676165,279,125062,1194,0.0022097959700925103,0.8105906313645621
8546,0.8553,3,0,3,676165,279,125065,1191,0.0022097959700925103,0.810204081632653
8547,0.8554,4,0,4,676165,279,125069,1187,0.0022097959700925103,0.8096862210095498
8548,0.8555,4,1,4,676166,278,125073,1183,0.0022018755544290962,0.809719370294319
8549,0.8556,3,0,3,676166,278,125076,1180,0.0022018755544290962,0.8093278463648834
8550,0.8557,3,2,3,676168,276,125079,1177,0.0021860347231022685,0.8100481761871989
8551,0.8558,6,2,6,676170,274,125085,1171,0.0021701938917754403,0.8103806228373702
8552,0.8559,0,1,0,676171,273,125085,1171,0.0021622734761120263,0.8109418282548476
8553,0.856,1,2,1,676173,271,125086,1170,0.0021464326447851985,0.8119361554476058
8554,0.8561,1,1,1,676174,270,125087,1169,0.0021385122291217844,0.812369701181376
8555,0.8562,5,0,5,676174,270,125092,1164,0.0021385122291217844,0.8117154811715481
8556,0.8563,3,0,3,676174,270,125095,1161,0.0021385122291217844,0.8113207547169812
8557,0.8564,3,1,3,676175,269,125098,1158,0.0021305918134583704,0.8114926419060967
8558,0.8565,5,0,5,676175,269,125103,1153,0.0021305918134583704,0.8108298171589311
8559,0.8566,1,0,1,676175,269,125104,1152,0.0021305918134583704,0.8106966924700915
8560,0.8567,3,0,3,676175,269,125107,1149,0.0021305918134583704,0.810296191819464
8561,0.8568,2,0,2,676175,269,125109,1147,0.0021305918134583704,0.8100282485875706
8562,0.8569,1,0,1,676175,269,125110,1146,0.0021305918134583704,0.8098939929328622
8563,0.857,0,2,0,676177,267,125110,1146,0.002114750982131542,0.8110403397027601
8564,0.8571,4,0,4,676177,267,125114,1142,0.002114750982131542,0.8105039034776437
8565,0.8572,2,1,2,676178,266,125116,1140,0.002106830566468128,0.8108108108108109
8566,0.8573,3,1,3,676179,265,125119,1137,0.002098910150804714,0.8109843081312411
8567,0.8574,3,1,3,676180,264,125122,1134,0.0020909897351413004,0.8111587982832618
8568,0.8575,5,1,5,676181,263,125127,1129,0.0020830693194778863,0.8110632183908046
8569,0.8576,1,0,1,676181,263,125128,1128,0.0020830693194778863,0.8109273903666427
8570,0.8577,3,0,3,676181,263,125131,1125,0.0020830693194778863,0.8105187319884726
8571,0.8578,2,1,2,676182,262,125133,1123,0.0020751489038144722,0.8108303249097473
8572,0.8579,0,3,0,676185,259,125133,1123,0.00205138765682423,0.8125904486251809
8573,0.858,2,1,2,676186,258,125135,1121,0.002043467241160816,0.8129079042784626
8574,0.8581,5,0,5,676186,258,125140,1116,0.002043467241160816,0.8122270742358079
8575,0.8582,1,0,1,676186,258,125141,1115,0.002043467241160816,0.8120903131828113
8576,0.8583,1,0,1,676186,258,125142,1114,0.002043467241160816,0.8119533527696793
8577,0.8584,3,1,3,676187,257,125145,1111,0.0020355468254974023,0.8121345029239766
8578,0.8585,2,0,2,676187,257,125147,1109,0.0020355468254974023,0.8118594436310396
8579,0.8586,5,0,5,676187,257,125152,1104,0.0020355468254974023,0.8111682586333578
8580,0.8587,2,0,2,676187,257,125154,1102,0.0020355468254974023,0.8108903605592347
8581,0.8588,2,1,2,676188,256,125156,1100,0.002027626409833988,0.8112094395280236
8582,0.8589,4,1,4,676189,255,125160,1096,0.002019705994170574,0.8112509252405625
8583,0.859,2,2,2,676191,253,125162,1094,0.002003865162843746,0.8121752041573868
8584,0.8591,3,0,3,676191,253,125165,1091,0.002003865162843746,0.8117559523809523
8585,0.8592,3,0,3,676191,253,125168,1088,0.002003865162843746,0.8113348247576435
8586,0.8593,3,0,3,676191,253,125171,1085,0.002003865162843746,0.8109118086696562
8587,0.8594,3,0,3,676191,253,125174,1082,0.002003865162843746,0.8104868913857678
8588,0.8595,3,0,3,676191,253,125177,1079,0.002003865162843746,0.81006006006006
8589,0.8596,3,1,3,676192,252,125180,1076,0.001995944747180332,0.8102409638554217
8590,0.8597,2,0,2,676192,252,125182,1074,0.001995944747180332,0.8099547511312217
8591,0.8598,3,0,3,676192,252,125185,1071,0.001995944747180332,0.8095238095238095
8592,0.8599,2,1,2,676193,251,125187,1069,0.001988024331516918,0.8098484848484848
8593,0.86,3,0,3,676193,251,125190,1066,0.001988024331516918,0.809415337889142
8594,0.8601,3,1,3,676194,250,125193,1063,0.001980103915853504,0.8095963442498096
8595,0.8602,5,0,5,676194,250,125198,1058,0.001980103915853504,0.808868501529052
8596,0.8603,2,0,2,676194,250,125200,1056,0.001980103915853504,0.8085758039816233
8597,0.8604,5,1,5,676195,249,125205,1051,0.00197218350019009,0.8084615384615385
8598,0.8606,1,1,1,676196,248,125206,1050,0.001964263084526676,0.8089368258859785
8599,0.8607,2,1,2,676197,247,125208,1048,0.001956342668863262,0.8092664092664092
8600,0.8608,3,0,3,676197,247,125211,1045,0.001956342668863262,0.8088235294117647
8601,0.8609,2,2,2,676199,245,125213,1043,0.001940501837536434,0.8097826086956522
8602,0.861,3,0,3,676199,245,125216,1040,0.001940501837536434,0.8093385214007782
8603,0.8611,3,0,3,676199,245,125219,1037,0.001940501837536434,0.8088923556942278
8604,0.8612,1,0,1,676199,245,125220,1036,0.001940501837536434,0.8087431693989071
8605,0.8613,7,1,7,676200,244,125227,1029,0.0019325814218730199,0.8083267871170463
8606,0.8614,3,0,3,676200,244,125230,1026,0.0019325814218730199,0.8078740157480315
8607,0.8615,1,0,1,676200,244,125231,1025,0.0019325814218730199,0.8077226162332545
8608,0.8616,2,0,2,676200,244,125233,1023,0.0019325814218730199,0.8074191002367798
8609,0.8617,3,0,3,676200,244,125236,1020,0.0019325814218730199,0.8069620253164557
8610,0.8618,5,0,5,676200,244,125241,1015,0.0019325814218730199,0.8061953931691819
8611,0.8619,3,2,3,676202,242,125244,1012,0.001916740590546192,0.8070175438596491
8612,0.862,1,1,1,676203,241,125245,1011,0.0019088201748827778,0.8075079872204473
8613,0.8621,1,0,1,676203,241,125246,1010,0.0019088201748827778,0.8073541167066347
8614,0.8622,3,2,3,676205,239,125249,1007,0.00189297934355595,0.8081861958266453
8615,0.8623,2,2,2,676207,237,125251,1005,0.0018771385122291217,0.8091787439613527
8616,0.8624,3,1,3,676208,236,125254,1002,0.0018692180965657079,0.8093699515347335
8617,0.8625,6,0,6,676208,236,125260,996,0.0018692180965657079,0.8084415584415584
8618,0.8626,2,1,2,676209,235,125262,994,0.0018612976809022938,0.8087876322213181
8619,0.8627,4,3,4,676212,232,125266,990,0.0018375364339120518,0.8101472995090017
8620,0.8628,2,2,2,676214,230,125268,988,0.0018216956025852236,0.8111658456486043
8621,0.8629,2,0,2,676214,230,125270,986,0.0018216956025852236,0.8108552631578947
8622,0.863,5,1,5,676215,229,125275,981,0.0018137751869218097,0.8107438016528926
8623,0.8631,4,0,4,676215,229,125279,977,0.0018137751869218097,0.8101160862354893
8624,0.8632,2,0,2,676215,229,125281,975,0.0018137751869218097,0.8098006644518272
8625,0.8633,2,1,2,676216,228,125283,973,0.0018058547712583957,0.8101582014987511
8626,0.8634,2,1,2,676217,227,125285,971,0.0017979343555949816,0.8105175292153589
8627,0.8635,1,1,1,676218,226,125286,970,0.0017900139399315677,0.8110367892976589
8628,0.8636,1,0,1,676218,226,125287,969,0.0017900139399315677,0.8108786610878661
8629,0.8637,2,0,2,676218,226,125289,967,0.0017900139399315677,0.8105616093880972
8630,0.8638,4,0,4,676218,226,125293,963,0.0017900139399315677,0.8099243061396131
8631,0.8639,1,1,1,676219,225,125294,962,0.0017820935242681536,0.81044650379107
8632,0.864,1,1,1,676220,224,125295,961,0.0017741731086047396,0.810970464135021
8633,0.8641,4,0,4,676220,224,125299,957,0.0017741731086047396,0.8103302286198137
8634,0.8642,0,1,0,676221,223,125299,957,0.0017662526929413255,0.8110169491525424
8635,0.8643,1,2,1,676223,221,125300,956,0.0017504118616144975,0.8122344944774851
8636,0.8644,3,1,3,676224,220,125303,953,0.0017424914459510834,0.8124467178175618
8637,0.8645,3,0,3,676224,220,125306,950,0.0017424914459510834,0.811965811965812
8638,0.8646,4,0,4,676224,220,125310,946,0.0017424914459510834,0.8113207547169812
8639,0.8647,1,2,1,676226,218,125311,945,0.0017266506146242555,0.8125537403267412
8640,0.8648,1,1,1,676227,217,125312,944,0.0017187301989608414,0.8130921619293713
8641,0.8649,2,0,2,676227,217,125314,942,0.0017187301989608414,0.8127696289905091
8642,0.865,3,1,3,676228,216,125317,939,0.0017108097832974276,0.812987012987013
8643,0.8651,1,0,1,676228,216,125318,938,0.0017108097832974276,0.8128249566724437
8644,0.8652,2,1,2,676229,215,125320,936,0.0017028893676340135,0.8132059079061685
8645,0.8653,4,1,4,676230,214,125324,932,0.0016949689519705994,0.8132635253054101
8646,0.8654,2,0,2,676230,214,125326,930,0.0016949689519705994,0.8129370629370629
8647,0.8655,1,1,1,676231,213,125327,929,0.0016870485363071853,0.8134851138353766
8648,0.8656,6,0,6,676231,213,125333,923,0.0016870485363071853,0.8125
8649,0.8657,4,0,4,676231,213,125337,919,0.0016870485363071853,0.8118374558303887
8650,0.8658,2,0,2,676231,213,125339,917,0.0016870485363071853,0.8115044247787611
8651,0.8659,4,0,4,676231,213,125343,913,0.0016870485363071853,0.8108348134991119
8652,0.866,2,1,2,676232,212,125345,911,0.0016791281206437714,0.811219946571683
8653,0.8662,4,1,4,676233,211,125349,907,0.0016712077049803574,0.8112701252236136
8654,0.8663,2,0,2,676233,211,125351,905,0.0016712077049803574,0.8109318996415771
8655,0.8664,2,1,2,676234,210,125353,903,0.0016632872893169433,0.8113207547169812
8656,0.8665,1,1,1,676235,209,125354,902,0.0016553668736535294,0.8118811881188119
8657,0.8666,1,2,1,676237,207,125355,901,0.0016395260423267013,0.8131768953068592
8658,0.8667,3,0,3,676237,207,125358,898,0.0016395260423267013,0.8126696832579186
8659,0.8668,3,1,3,676238,206,125361,895,0.0016316056266632872,0.812897366030881
8660,0.8669,2,0,2,676238,206,125363,893,0.0016316056266632872,0.8125568698817106
8661,0.867,1,0,1,676238,206,125364,892,0.0016316056266632872,0.8123861566484517
8662,0.8671,1,0,1,676238,206,125365,891,0.0016316056266632872,0.8122151321786691
8663,0.8672,3,1,3,676239,205,125368,888,0.0016236852109998733,0.8124428179322964
8664,0.8673,1,3,1,676242,202,125369,887,0.0015999239640096313,0.8145087235996327
8665,0.8674,4,0,4,676242,202,125373,883,0.0015999239640096313,0.8138248847926267
8666,0.8675,1,1,1,676243,201,125374,882,0.0015920035483462172,0.814404432132964
8667,0.8676,1,0,1,676243,201,125375,881,0.0015920035483462172,0.8142329020332717
8668,0.8677,2,1,2,676244,200,125377,879,0.0015840831326828031,0.8146431881371641
8669,0.8678,1,0,1,676244,200,125378,878,0.0015840831326828031,0.8144712430426716
8670,0.8679,3,2,3,676246,198,125381,875,0.0015682423013559752,0.8154706430568499
8671,0.868,3,0,3,676246,198,125384,872,0.0015682423013559752,0.8149532710280374
8672,0.8681,2,3,2,676249,195,125386,870,0.0015444810543657332,0.8169014084507042
8673,0.8682,3,0,3,676249,195,125389,867,0.0015444810543657332,0.8163841807909604
8674,0.8683,3,0,3,676249,195,125392,864,0.0015444810543657332,0.8158640226628895
8675,0.8684,1,0,1,676249,195,125393,863,0.0015444810543657332,0.8156899810964083
8676,0.8685,6,0,6,676249,195,125399,857,0.0015444810543657332,0.814638783269962
8677,0.8686,2,1,2,676250,194,125401,855,0.001536560638702319,0.8150619637750238
8678,0.8687,3,0,3,676250,194,125404,852,0.001536560638702319,0.8145315487571702
8679,0.8688,5,0,5,676250,194,125409,847,0.001536560638702319,0.813640730067243
8680,0.8689,1,1,1,676251,193,125410,846,0.001528640223038905,0.8142444658325313
8681,0.869,4,1,4,676252,192,125414,842,0.0015207198073754911,0.8143133462282398
8682,0.8691,2,0,2,676252,192,125416,840,0.0015207198073754911,0.813953488372093
8683,0.8692,1,2,1,676254,190,125417,839,0.001504878976048663,0.815354713313897
8684,0.8693,2,1,2,676255,189,125419,837,0.0014969585603852491,0.8157894736842105
8685,0.8694,1,1,1,676256,188,125420,836,0.001489038144721835,0.81640625
8686,0.8695,2,0,2,676256,188,125422,834,0.001489038144721835,0.8160469667318982
8687,0.8696,1,0,1,676256,188,125423,833,0.001489038144721835,0.8158667972575906
8688,0.8697,5,1,5,676257,187,125428,828,0.001481117729058421,0.8157635467980295
8689,0.8699,1,1,1,676258,186,125429,827,0.0014731973133950069,0.8163869693978283
8690,0.87,4,0,4,676258,186,125433,823,0.0014731973133950069,0.8156590683845392
8691,0.8701,2,0,2,676258,186,125435,821,0.0014731973133950069,0.8152929493545183
8692,0.8702,2,1,2,676259,185,125437,819,0.001465276897731593,0.8157370517928287
8693,0.8703,4,0,4,676259,185,125441,815,0.001465276897731593,0.815
8694,0.8704,2,1,2,676260,184,125443,813,0.001457356482068179,0.8154463390170511
8695,0.8705,3,0,3,676260,184,125446,810,0.001457356482068179,0.8148893360160966
8696,0.8706,4,0,4,676260,184,125450,806,0.001457356482068179,0.8141414141414142
8697,0.8707,5,0,5,676260,184,125455,801,0.001457356482068179,0.8131979695431472
8698,0.8708,3,0,3,676260,184,125458,798,0.001457356482068179,0.8126272912423625
8699,0.8709,3,1,3,676261,183,125461,795,0.0014494360664047648,0.8128834355828221
8700,0.871,2,1,2,676262,182,125463,793,0.001441515650741351,0.8133333333333334
8701,0.8711,5,2,5,676264,180,125468,788,0.0014256748194145228,0.8140495867768595
8702,0.8712,1,1,1,676265,179,125469,787,0.001417754403751109,0.8146997929606625
8703,0.8713,2,0,2,676265,179,125471,785,0.001417754403751109,0.8143153526970954
8704,0.8714,4,0,4,676265,179,125475,781,0.001417754403751109,0.8135416666666667
8705,0.8715,2,0,2,676265,179,125477,779,0.001417754403751109,0.8131524008350731
8706,0.8716,3,0,3,676265,179,125480,776,0.001417754403751109,0.812565445026178
8707,0.8717,7,0,7,676265,179,125487,769,0.001417754403751109,0.8111814345991561
8708,0.8718,2,0,2,676265,179,125489,767,0.001417754403751109,0.8107822410147991
8709,0.8719,2,0,2,676265,179,125491,765,0.001417754403751109,0.8103813559322034
8710,0.872,3,1,3,676266,178,125494,762,0.0014098339880876949,0.8106382978723404
8711,0.8721,1,0,1,676266,178,125495,761,0.0014098339880876949,0.8104366347177849
8712,0.8722,4,1,4,676267,177,125499,757,0.0014019135724242808,0.8104925053533191
8713,0.8723,0,1,0,676268,176,125499,757,0.0013939931567608667,0.8113612004287245
8714,0.8724,2,0,2,676268,176,125501,755,0.0013939931567608667,0.8109559613319012
8715,0.8726,1,1,1,676269,175,125502,754,0.0013860727410974528,0.8116254036598493
8716,0.8727,3,1,3,676270,174,125505,751,0.0013781523254340388,0.8118918918918919
8717,0.8728,1,1,1,676271,173,125506,750,0.0013702319097706247,0.8125677139761647
8718,0.8729,3,1,3,676272,172,125509,747,0.0013623114941072108,0.8128400435255713
8719,0.873,3,1,3,676273,171,125512,744,0.0013543910784437967,0.8131147540983606
8720,0.8731,1,0,1,676273,171,125513,743,0.0013543910784437967,0.812910284463895
8721,0.8732,2,1,2,676274,170,125515,741,0.0013464706627803827,0.8133918770581778
8722,0.8733,2,0,2,676274,170,125517,739,0.0013464706627803827,0.812981298129813
8723,0.8734,4,1,4,676275,169,125521,735,0.0013385502471169688,0.8130530973451328
8724,0.8735,4,3,4,676278,166,125525,731,0.0013147890001267266,0.8149386845039019
8725,0.8736,3,1,3,676279,165,125528,728,0.0013068685844633127,0.8152295632698768
8726,0.8737,4,0,4,676279,165,125532,724,0.0013068685844633127,0.8143982002249719
8727,0.8738,2,0,2,676279,165,125534,722,0.0013068685844633127,0.8139797068771139
8728,0.8739,2,1,2,676280,164,125536,720,0.0012989481687998986,0.8144796380090498
8729,0.874,4,0,4,676280,164,125540,716,0.0012989481687998986,0.8136363636363636
8730,0.8741,1,1,1,676281,163,125541,715,0.0012910277531364845,0.8143507972665148
8731,0.8742,0,1,0,676282,162,125541,715,0.0012831073374730707,0.8152793614595211
8732,0.8743,4,1,4,676283,161,125545,711,0.0012751869218096566,0.8153669724770642
8733,0.8744,5,0,5,676283,161,125550,706,0.0012751869218096566,0.8143021914648212
8734,0.8745,2,3,2,676286,158,125552,704,0.0012514256748194146,0.8167053364269141
8735,0.8746,2,2,2,676288,156,125554,702,0.0012355848434925864,0.8181818181818182
8736,0.8747,1,1,1,676289,155,125555,701,0.0012276644278291725,0.8189252336448598
8737,0.8748,3,0,3,676289,155,125558,698,0.0012276644278291725,0.8182883939038686
8738,0.8749,2,0,2,676289,155,125560,696,0.0012276644278291725,0.81786133960047
8739,0.875,1,0,1,676289,155,125561,695,0.0012276644278291725,0.8176470588235294
8740,0.8751,4,0,4,676289,155,125565,691,0.0012276644278291725,0.8167848699763594
8741,0.8752,3,2,3,676291,153,125568,688,0.0012118235965023444,0.8180737217598097
8742,0.8753,2,0,2,676291,153,125570,686,0.0012118235965023444,0.8176400476758046
8743,0.8754,3,2,3,676293,151,125573,683,0.0011959827651755164,0.8189448441247003
8744,0.8755,2,0,2,676293,151,125575,681,0.0011959827651755164,0.8185096153846154
8745,0.8756,2,1,2,676294,150,125577,679,0.0011880623495121023,0.8190591073582629
8746,0.8757,3,0,3,676294,150,125580,676,0.0011880623495121023,0.8184019370460048
8747,0.8759,3,0,3,676294,150,125583,673,0.0011880623495121023,0.8177399756986634
8748,0.876,2,1,2,676295,149,125585,671,0.0011801419338486885,0.8182926829268292
8749,0.8761,3,1,3,676296,148,125588,668,0.0011722215181852744,0.8186274509803921
8750,0.8763,0,1,0,676297,147,125588,668,0.0011643011025218603,0.8196319018404908
8751,0.8764,2,1,2,676298,146,125590,666,0.0011563806868584462,0.8201970443349754
8752,0.8765,2,0,2,676298,146,125592,664,0.0011563806868584462,0.8197530864197531
8753,0.8766,1,0,1,676298,146,125593,663,0.0011563806868584462,0.8195302843016069
8754,0.8767,2,1,2,676299,145,125595,661,0.0011484602711950324,0.8200992555831266
8755,0.8768,2,0,2,676299,145,125597,659,0.0011484602711950324,0.8196517412935324
8756,0.8769,2,0,2,676299,145,125599,657,0.0011484602711950324,0.8192019950124688
8757,0.877,2,0,2,676299,145,125601,655,0.0011484602711950324,0.81875
8758,0.8771,1,0,1,676299,145,125602,654,0.0011484602711950324,0.818523153942428
8759,0.8772,2,0,2,676299,145,125604,652,0.0011484602711950324,0.8180677540777918
8760,0.8773,3,0,3,676299,145,125607,649,0.0011484602711950324,0.8173803526448362
8761,0.8774,2,0,2,676299,145,125609,647,0.0011484602711950324,0.8169191919191919
8762,0.8775,3,1,3,676300,144,125612,644,0.0011405398555316183,0.817258883248731
8763,0.8776,6,0,6,676300,144,125618,638,0.0011405398555316183,0.8158567774936062
8764,0.8777,4,0,4,676300,144,125622,634,0.0011405398555316183,0.8149100257069408
8765,0.8778,1,0,1,676300,144,125623,633,0.0011405398555316183,0.8146718146718147
8766,0.8779,3,0,3,676300,144,125626,630,0.0011405398555316183,0.813953488372093
8767,0.878,3,0,3,676300,144,125629,627,0.0011405398555316183,0.8132295719844358
8768,0.8781,1,3,1,676303,141,125630,626,0.0011167786085413763,0.8161668839634941
8769,0.8782,4,0,4,676303,141,125634,622,0.0011167786085413763,0.8152031454783748
8770,0.8783,1,0,1,676303,141,125635,621,0.0011167786085413763,0.8149606299212598
8771,0.8785,1,2,1,676305,139,125636,620,0.0011009377772145481,0.8168642951251647
8772,0.8786,2,0,2,676305,139,125638,618,0.0011009377772145481,0.8163804491413474
8773,0.8787,1,0,1,676305,139,125639,617,0.0011009377772145481,0.8161375661375662
8774,0.8788,3,0,3,676305,139,125642,614,0.0011009377772145481,0.8154050464807437
8775,0.8789,1,0,1,676305,139,125643,613,0.0011009377772145481,0.8151595744680851
8776,0.879,3,1,3,676306,138,125646,610,0.0010930173615511342,0.8155080213903744
8777,0.8791,1,0,1,676306,138,125647,609,0.0010930173615511342,0.8152610441767069
8778,0.8792,1,0,1,676306,138,125648,608,0.0010930173615511342,0.8150134048257373
8779,0.8794,2,1,2,676307,137,125650,606,0.0010850969458877202,0.8156123822341858
8780,0.8795,1,0,1,676307,137,125651,605,0.0010850969458877202,0.8153638814016172
8781,0.8796,3,1,3,676308,136,125654,602,0.001077176530224306,0.8157181571815718
8782,0.8797,2,1,2,676309,135,125656,600,0.0010692561145608922,0.8163265306122449
8783,0.8798,5,0,5,676309,135,125661,595,0.0010692561145608922,0.815068493150685
8784,0.8799,3,0,3,676309,135,125664,592,0.0010692561145608922,0.8143053645116919
8785,0.88,4,1,4,676310,134,125668,588,0.0010613356988974781,0.814404432132964
8786,0.8801,2,0,2,676310,134,125670,586,0.0010613356988974781,0.8138888888888889
8787,0.8802,1,0,1,676310,134,125671,585,0.0010613356988974781,0.8136300417246175
8788,0.8804,1,1,1,676311,133,125672,584,0.001053415283234064,0.8145048814504882
8789,0.8805,0,2,0,676313,131,125672,584,0.0010375744519072361,0.8167832167832167
8790,0.8806,1,1,1,676314,130,125673,583,0.001029654036243822,0.8176718092566619
8791,0.8807,2,0,2,676314,130,125675,581,0.001029654036243822,0.8171589310829818
8792,0.8808,2,0,2,676314,130,125677,579,0.001029654036243822,0.8166431593794076
8793,0.8809,3,0,3,676314,130,125680,576,0.001029654036243822,0.8158640226628895
8794,0.881,2,0,2,676314,130,125682,574,0.001029654036243822,0.8153409090909091
8795,0.8811,1,0,1,676314,130,125683,573,0.001029654036243822,0.8150782361308677
8796,0.8812,1,0,1,676314,130,125684,572,0.001029654036243822,0.8148148148148148
8797,0.8813,2,1,2,676315,129,125686,570,0.001021733620580408,0.8154506437768241
8798,0.8814,2,1,2,676316,128,125688,568,0.001013813204916994,0.8160919540229885
8799,0.8815,2,1,2,676317,127,125690,566,0.00100589278925358,0.8167388167388168
8800,0.8816,1,0,1,676317,127,125691,565,0.00100589278925358,0.8164739884393064
8801,0.8817,1,0,1,676317,127,125692,564,0.00100589278925358,0.8162083936324168
8802,0.8818,1,2,1,676319,125,125693,563,0.000990051957926752,0.8183139534883721
8803,0.8819,2,1,2,676320,124,125695,561,0.000982131542263338,0.8189781021897811
8804,0.8821,4,0,4,676320,124,125699,557,0.000982131542263338,0.8179148311306902
8805,0.8822,4,1,4,676321,123,125703,553,0.000974211126599924,0.8180473372781065
8806,0.8824,4,0,4,676321,123,125707,549,0.000974211126599924,0.8169642857142857
8807,0.8825,1,0,1,676321,123,125708,548,0.000974211126599924,0.8166915052160953
8808,0.8826,1,1,1,676322,122,125709,547,0.0009662907109365099,0.8176382660687593
8809,0.8827,4,0,4,676322,122,125713,543,0.0009662907109365099,0.8165413533834587
8810,0.8828,3,0,3,676322,122,125716,540,0.0009662907109365099,0.8157099697885196
8811,0.8829,1,0,1,676322,122,125717,539,0.0009662907109365099,0.8154311649016641
8812,0.883,1,0,1,676322,122,125718,538,0.0009662907109365099,0.8151515151515152
8813,0.8831,1,0,1,676322,122,125719,537,0.0009662907109365099,0.8148710166919575
8814,0.8832,1,0,1,676322,122,125720,536,0.0009662907109365099,0.8145896656534954
8815,0.8835,3,1,3,676323,121,125723,533,0.000958370295273096,0.8149847094801224
8816,0.8836,2,0,2,676323,121,125725,531,0.000958370295273096,0.8144171779141104
8817,0.8837,2,0,2,676323,121,125727,529,0.000958370295273096,0.8138461538461539
8818,0.8839,1,1,1,676324,120,125728,528,0.0009504498796096819,0.8148148148148148
8819,0.884,1,0,1,676324,120,125729,527,0.0009504498796096819,0.8145285935085008
8820,0.8841,4,0,4,676324,120,125733,523,0.0009504498796096819,0.8133748055987559
8821,0.8842,1,1,1,676325,119,125734,522,0.0009425294639462679,0.8143525741029641
8822,0.8843,2,1,2,676326,118,125736,520,0.0009346090482828539,0.8150470219435737
8823,0.8844,1,3,1,676329,115,125737,519,0.0009108478012926118,0.8186119873817035
8824,0.8845,1,0,1,676329,115,125738,518,0.0009108478012926118,0.8183254344391785
8825,0.8846,2,1,2,676330,114,125740,516,0.0009029273856291978,0.819047619047619
8826,0.8848,4,0,4,676330,114,125744,512,0.0009029273856291978,0.8178913738019169
8827,0.885,1,0,1,676330,114,125745,511,0.0009029273856291978,0.8176
8828,0.8851,1,0,1,676330,114,125746,510,0.0009029273856291978,0.8173076923076923
8829,0.8852,1,1,1,676331,113,125747,509,0.0008950069699657839,0.8183279742765274
8830,0.8853,1,0,1,676331,113,125748,508,0.0008950069699657839,0.8180354267310789
8831,0.8854,2,0,2,676331,113,125750,506,0.0008950069699657839,0.8174474959612278
8832,0.8855,2,0,2,676331,113,125752,504,0.0008950069699657839,0.8168557536466775
8833,0.8856,1,1,1,676332,112,125753,503,0.0008870865543023698,0.8178861788617886
8834,0.8857,2,0,2,676332,112,125755,501,0.0008870865543023698,0.8172920065252854
8835,0.8859,3,1,3,676333,111,125758,498,0.0008791661386389558,0.8177339901477833
8836,0.8861,1,2,1,676335,109,125759,497,0.0008633253073121277,0.8201320132013201
8837,0.8862,3,0,3,676335,109,125762,494,0.0008633253073121277,0.8192371475953566
8838,0.8863,0,1,0,676336,108,125762,494,0.0008554048916487138,0.8205980066445183
8839,0.8864,1,0,1,676336,108,125763,493,0.0008554048916487138,0.8202995008319468
8840,0.8865,1,0,1,676336,108,125764,492,0.0008554048916487138,0.82
8841,0.8866,2,0,2,676336,108,125766,490,0.0008554048916487138,0.8193979933110368
8842,0.8867,1,1,1,676337,107,125767,489,0.0008474844759852997,0.8204697986577181
8843,0.8868,1,0,1,676337,107,125768,488,0.0008474844759852997,0.8201680672268907
8844,0.8869,1,0,1,676337,107,125769,487,0.0008474844759852997,0.8198653198653199
8845,0.887,1,0,1,676337,107,125770,486,0.0008474844759852997,0.8195615514333895
8846,0.8871,1,0,1,676337,107,125771,485,0.0008474844759852997,0.8192567567567568
8847,0.8872,5,2,5,676339,105,125776,480,0.0008316436446584716,0.8205128205128205
8848,0.8873,0,1,0,676340,104,125776,480,0.0008237232289950577,0.821917808219178
8849,0.8874,1,0,1,676340,104,125777,479,0.0008237232289950577,0.8216123499142367
8850,0.8875,2,0,2,676340,104,125779,477,0.0008237232289950577,0.8209982788296041
8851,0.8876,4,0,4,676340,104,125783,473,0.0008237232289950577,0.8197573656845754
8852,0.8877,2,0,2,676340,104,125785,471,0.0008237232289950577,0.8191304347826087
8853,0.8878,2,0,2,676340,104,125787,469,0.0008237232289950577,0.8184991273996509
8854,0.888,3,0,3,676340,104,125790,466,0.0008237232289950577,0.8175438596491228
8855,0.8881,0,1,0,676341,103,125790,466,0.0008158028133316436,0.8189806678383128
8856,0.8882,1,1,1,676342,102,125791,465,0.0008078823976682296,0.8201058201058201
8857,0.8883,3,1,3,676343,101,125794,462,0.0007999619820048156,0.8206039076376554
8858,0.8884,1,0,1,676343,101,125795,461,0.0007999619820048156,0.8202846975088968
8859,0.8885,1,0,1,676343,101,125796,460,0.0007999619820048156,0.8199643493761141
8860,0.8886,2,2,2,676345,99,125798,458,0.0007841211506779876,0.822262118491921
8861,0.8887,0,1,0,676346,98,125798,458,0.0007762007350145735,0.8237410071942446
8862,0.8888,1,0,1,676346,98,125799,457,0.0007762007350145735,0.8234234234234235
8863,0.8889,3,2,3,676348,96,125802,454,0.0007603599036877456,0.8254545454545454
8864,0.889,3,0,3,676348,96,125805,451,0.0007603599036877456,0.8244972577696527
8865,0.8891,2,1,2,676349,95,125807,449,0.0007524394880243315,0.8253676470588235
8866,0.8892,3,0,3,676349,95,125810,446,0.0007524394880243315,0.8243992606284658
8867,0.8893,1,0,1,676349,95,125811,445,0.0007524394880243315,0.8240740740740741
8868,0.8895,1,3,1,676352,92,125812,444,0.0007286782410340895,0.8283582089552238
8869,0.8896,4,0,4,676352,92,125816,440,0.0007286782410340895,0.8270676691729323
8870,0.8897,1,1,1,676353,91,125817,439,0.0007207578253706755,0.8283018867924529
8871,0.8899,1,0,1,676353,91,125818,438,0.0007207578253706755,0.8279773156899811
8872,0.89,1,0,1,676353,91,125819,437,0.0007207578253706755,0.8276515151515151
8873,0.8901,4,1,4,676354,90,125823,433,0.0007128374097072614,0.8279158699808795
8874,0.8902,1,0,1,676354,90,125824,432,0.0007128374097072614,0.8275862068965517
8875,0.8904,3,1,3,676355,89,125827,429,0.0007049169940438474,0.8281853281853282
8876,0.8905,2,0,2,676355,89,125829,427,0.0007049169940438474,0.8275193798449613
8877,0.8906,2,0,2,676355,89,125831,425,0.0007049169940438474,0.8268482490272373
8878,0.8908,3,0,3,676355,89,125834,422,0.0007049169940438474,0.8258317025440313
8879,0.8909,2,0,2,676355,89,125836,420,0.0007049169940438474,0.825147347740668
8880,0.891,3,0,3,676355,89,125839,417,0.0007049169940438474,0.8241106719367589
8881,0.8911,1,0,1,676355,89,125840,416,0.0007049169940438474,0.8237623762376237
8882,0.8912,5,0,5,676355,89,125845,411,0.0007049169940438474,0.822
8883,0.8915,5,0,5,676355,89,125850,406,0.0007049169940438474,0.8202020202020202
8884,0.8916,2,0,2,676355,89,125852,404,0.0007049169940438474,0.8194726166328601
8885,0.8917,2,0,2,676355,89,125854,402,0.0007049169940438474,0.8187372708757638
8886,0.8918,2,0,2,676355,89,125856,400,0.0007049169940438474,0.8179959100204499
8887,0.8919,1,0,1,676355,89,125857,399,0.0007049169940438474,0.8176229508196722
8888,0.892,1,0,1,676355,89,125858,398,0.0007049169940438474,0.8172484599589322
8889,0.8922,3,0,3,676355,89,125861,395,0.0007049169940438474,0.8161157024793388
8890,0.8923,1,1,1,676356,88,125862,394,0.0006969965783804334,0.8174273858921162
8891,0.8927,1,1,1,676357,87,125863,393,0.0006890761627170194,0.81875
8892,0.8928,2,0,2,676357,87,125865,391,0.0006890761627170194,0.8179916317991632
8893,0.8929,2,0,2,676357,87,125867,389,0.0006890761627170194,0.8172268907563025
8894,0.893,1,0,1,676357,87,125868,388,0.0006890761627170194,0.8168421052631579
8895,0.8931,1,0,1,676357,87,125869,387,0.0006890761627170194,0.8164556962025317
8896,0.8932,2,0,2,676357,87,125871,385,0.0006890761627170194,0.815677966101695
8897,0.8933,1,0,1,676357,87,125872,384,0.0006890761627170194,0.8152866242038217
8898,0.8934,1,0,1,676357,87,125873,383,0.0006890761627170194,0.8148936170212766
8899,0.8935,3,0,3,676357,87,125876,380,0.0006890761627170194,0.8137044967880086
8900,0.8936,1,0,1,676357,87,125877,379,0.0006890761627170194,0.8133047210300429
8901,0.8938,4,0,4,676357,87,125881,375,0.0006890761627170194,0.8116883116883117
8902,0.8939,2,0,2,676357,87,125883,373,0.0006890761627170194,0.8108695652173913
8903,0.8941,1,1,1,676358,86,125884,372,0.0006811557470536054,0.8122270742358079
8904,0.8942,1,0,1,676358,86,125885,371,0.0006811557470536054,0.811816192560175
8905,0.8943,1,1,1,676359,85,125886,370,0.0006732353313901913,0.8131868131868132
8906,0.8944,1,0,1,676359,85,125887,369,0.0006732353313901913,0.8127753303964758
8907,0.8946,2,0,2,676359,85,125889,367,0.0006732353313901913,0.8119469026548672
8908,0.8947,1,0,1,676359,85,125890,366,0.0006732353313901913,0.811529933481153
8909,0.8948,1,1,1,676360,84,125891,365,0.0006653149157267774,0.8129175946547884
8910,0.8951,2,0,2,676360,84,125893,363,0.0006653149157267774,0.8120805369127517
8911,0.8952,2,0,2,676360,84,125895,361,0.0006653149157267774,0.8112359550561797
8912,0.8953,2,0,2,676360,84,125897,359,0.0006653149157267774,0.8103837471783296
8913,0.8954,2,1,2,676361,83,125899,357,0.0006573945000633633,0.8113636363636364
8914,0.8956,3,1,3,676362,82,125902,354,0.0006494740843999493,0.8119266055045872
8915,0.8958,1,0,1,676362,82,125903,353,0.0006494740843999493,0.8114942528735632
8916,0.8962,2,0,2,676362,82,125905,351,0.0006494740843999493,0.8106235565819861
8917,0.8963,1,2,1,676364,80,125906,350,0.0006336332530731213,0.813953488372093
8918,0.8964,2,1,2,676365,79,125908,348,0.0006257128374097073,0.8149882903981265
8919,0.8965,2,1,2,676366,78,125910,346,0.0006177924217462932,0.8160377358490566
8920,0.8966,2,1,2,676367,77,125912,344,0.0006098720060828792,0.8171021377672208
8921,0.8967,0,1,0,676368,76,125912,344,0.0006019515904194653,0.819047619047619
8922,0.8968,1,0,1,676368,76,125913,343,0.0006019515904194653,0.8186157517899761
8923,0.897,2,0,2,676368,76,125915,341,0.0006019515904194653,0.8177458033573142
8924,0.8971,2,0,2,676368,76,125917,339,0.0006019515904194653,0.8168674698795181
8925,0.8972,1,0,1,676368,76,125918,338,0.0006019515904194653,0.8164251207729468
8926,0.8973,2,0,2,676368,76,125920,336,0.0006019515904194653,0.8155339805825242
8927,0.8974,1,1,1,676369,75,125921,335,0.0005940311747560512,0.8170731707317073
8928,0.8975,2,0,2,676369,75,125923,333,0.0005940311747560512,0.8161764705882353
8929,0.8976,0,1,0,676370,74,125923,333,0.0005861107590926372,0.8181818181818182
8930,0.8979,2,0,2,676370,74,125925,331,0.0005861107590926372,0.817283950617284
8931,0.898,1,1,1,676371,73,125926,330,0.0005781903434292231,0.8188585607940446
8932,0.8981,1,1,1,676372,72,125927,329,0.0005702699277658091,0.8204488778054863
8933,0.8982,0,1,0,676373,71,125927,329,0.0005623495121023952,0.8225
8934,0.8984,2,0,2,676373,71,125929,327,0.0005623495121023952,0.821608040201005
8935,0.8985,1,0,1,676373,71,125930,326,0.0005623495121023952,0.8211586901763224
8936,0.8986,1,0,1,676373,71,125931,325,0.0005623495121023952,0.8207070707070707
8937,0.8987,1,0,1,676373,71,125932,324,0.0005623495121023952,0.8202531645569621
8938,0.8988,3,0,3,676373,71,125935,321,0.0005623495121023952,0.8188775510204082
8939,0.8992,4,1,4,676374,70,125939,317,0.0005544290964389811,0.8191214470284238
8940,0.8993,3,0,3,676374,70,125942,314,0.0005544290964389811,0.8177083333333334
8941,0.8994,3,1,3,676375,69,125945,311,0.0005465086807755671,0.8184210526315789
8942,0.8995,3,0,3,676375,69,125948,308,0.0005465086807755671,0.8169761273209549
8943,0.8996,2,2,2,676377,67,125950,306,0.0005306678494487391,0.8203753351206434
8944,0.8997,1,0,1,676377,67,125951,305,0.0005306678494487391,0.8198924731182796
8945,0.8998,0,1,0,676378,66,125951,305,0.0005227474337853251,0.8221024258760108
8946,0.8999,1,0,1,676378,66,125952,304,0.0005227474337853251,0.8216216216216217
8947,0.9,1,0,1,676378,66,125953,303,0.0005227474337853251,0.8211382113821138
8948,0.9001,3,0,3,676378,66,125956,300,0.0005227474337853251,0.819672131147541
8949,0.9003,2,0,2,676378,66,125958,298,0.0005227474337853251,0.8186813186813187
8950,0.9005,2,0,2,676378,66,125960,296,0.0005227474337853251,0.8176795580110497
8951,0.9006,2,1,2,676379,65,125962,294,0.000514827018121911,0.8189415041782729
8952,0.9007,2,0,2,676379,65,125964,292,0.000514827018121911,0.8179271708683473
8953,0.9008,2,0,2,676379,65,125966,290,0.000514827018121911,0.8169014084507042
8954,0.901,0,1,0,676380,64,125966,290,0.000506906602458497,0.8192090395480226
8955,0.9011,3,1,3,676381,63,125969,287,0.000498986186795083,0.82
8956,0.9012,2,1,2,676382,62,125971,285,0.000491065771131669,0.8213256484149856
8957,0.9015,2,0,2,676382,62,125973,283,0.000491065771131669,0.8202898550724638
8958,0.9016,1,0,1,676382,62,125974,282,0.000491065771131669,0.8197674418604651
8959,0.9017,2,0,2,676382,62,125976,280,0.000491065771131669,0.8187134502923976
8960,0.9018,1,1,1,676383,61,125977,279,0.00048314535546825497,0.8205882352941176
8961,0.9019,2,0,2,676383,61,125979,277,0.00048314535546825497,0.8195266272189349
8962,0.9021,0,1,0,676384,60,125979,277,0.00047522493980484094,0.8219584569732937
8963,0.9023,1,0,1,676384,60,125980,276,0.00047522493980484094,0.8214285714285714
8964,0.9024,1,0,1,676384,60,125981,275,0.00047522493980484094,0.8208955223880597
8965,0.9025,4,0,4,676384,60,125985,271,0.00047522493980484094,0.8187311178247734
8966,0.9026,0,1,0,676385,59,125985,271,0.00046730452414142697,0.8212121212121212
8967,0.9027,1,0,1,676385,59,125986,270,0.00046730452414142697,0.8206686930091185
8968,0.9028,1,0,1,676385,59,125987,269,0.00046730452414142697,0.8201219512195121
8969,0.9029,1,0,1,676385,59,125988,268,0.00046730452414142697,0.8195718654434251
8970,0.903,1,0,1,676385,59,125989,267,0.00046730452414142697,0.8190184049079755
8971,0.9031,1,0,1,676385,59,125990,266,0.00046730452414142697,0.8184615384615385
8972,0.9032,2,0,2,676385,59,125992,264,0.00046730452414142697,0.8173374613003096
8973,0.9033,0,1,0,676386,58,125992,264,0.00045938410847801294,0.8198757763975155
8974,0.9034,3,1,3,676387,57,125995,261,0.0004514636928145989,0.8207547169811321
8975,0.9035,3,0,3,676387,57,125998,258,0.0004514636928145989,0.819047619047619
8976,0.9036,1,0,1,676387,57,125999,257,0.0004514636928145989,0.8184713375796179
8977,0.9037,1,0,1,676387,57,126000,256,0.0004514636928145989,0.8178913738019169
8978,0.9038,1,1,1,676388,56,126001,255,0.0004435432771511849,0.819935691318328
8979,0.9039,2,1,2,676389,55,126003,253,0.00043562286148777086,0.8214285714285714
8980,0.9042,2,0,2,676389,55,126005,251,0.00043562286148777086,0.8202614379084967
8981,0.9044,1,1,1,676390,54,126006,250,0.0004277024458243569,0.8223684210526315
8982,0.9045,1,1,1,676391,53,126007,249,0.00041978203016094286,0.8245033112582781
8983,0.9046,1,0,1,676391,53,126008,248,0.00041978203016094286,0.8239202657807309
8984,0.9048,1,0,1,676391,53,126009,247,0.00041978203016094286,0.8233333333333334
8985,0.9049,3,0,3,676391,53,126012,244,0.00041978203016094286,0.8215488215488216
8986,0.905,1,0,1,676391,53,126013,243,0.00041978203016094286,0.8209459459459459
8987,0.9052,1,0,1,676391,53,126014,242,0.00041978203016094286,0.8203389830508474
8988,0.9053,1,0,1,676391,53,126015,241,0.00041978203016094286,0.8197278911564626
8989,0.9054,2,0,2,676391,53,126017,239,0.00041978203016094286,0.8184931506849316
8990,0.9055,2,0,2,676391,53,126019,237,0.00041978203016094286,0.8172413793103448
8991,0.9056,1,0,1,676391,53,126020,236,0.00041978203016094286,0.8166089965397924
8992,0.9057,1,0,1,676391,53,126021,235,0.00041978203016094286,0.8159722222222222
8993,0.9058,1,0,1,676391,53,126022,234,0.00041978203016094286,0.8153310104529616
8994,0.906,1,0,1,676391,53,126023,233,0.00041978203016094286,0.8146853146853147
8995,0.9061,1,1,1,676392,52,126024,232,0.00041186161449752884,0.8169014084507042
8996,0.9062,1,0,1,676392,52,126025,231,0.00041186161449752884,0.8162544169611308
8997,0.9065,1,2,1,676394,50,126026,230,0.0003960207831707008,0.8214285714285714
8998,0.9067,1,1,1,676395,49,126027,229,0.00038810036750728676,0.8237410071942446
8999,0.9068,1,0,1,676395,49,126028,228,0.00038810036750728676,0.8231046931407943
9000,0.907,2,0,2,676395,49,126030,226,0.00038810036750728676,0.8218181818181818
9001,0.9071,2,1,2,676396,48,126032,224,0.0003801799518438728,0.8235294117647058
9002,0.9072,4,0,4,676396,48,126036,220,0.0003801799518438728,0.8208955223880597
9003,0.9073,1,0,1,676396,48,126037,219,0.0003801799518438728,0.8202247191011236
9004,0.9074,1,1,1,676397,47,126038,218,0.00037225953618045876,0.8226415094339623
9005,0.9075,0,2,0,676399,45,126038,218,0.0003564187048536307,0.8288973384030418
9006,0.9077,2,1,2,676400,44,126040,216,0.0003484982891902167,0.8307692307692308
9007,0.9079,1,0,1,676400,44,126041,215,0.0003484982891902167,0.8301158301158301
9008,0.908,2,0,2,676400,44,126043,213,0.0003484982891902167,0.8287937743190662
9009,0.9082,1,0,1,676400,44,126044,212,0.0003484982891902167,0.828125
9010,0.9083,2,0,2,676400,44,126046,210,0.0003484982891902167,0.8267716535433071
9011,0.9084,1,1,1,676401,43,126047,209,0.0003405778735268027,0.8293650793650794
9012,0.9085,1,0,1,676401,43,126048,208,0.0003405778735268027,0.8286852589641435
9013,0.9086,1,0,1,676401,43,126049,207,0.0003405778735268027,0.828
9014,0.9087,2,0,2,676401,43,126051,205,0.0003405778735268027,0.8266129032258065
9015,0.9089,3,0,3,676401,43,126054,202,0.0003405778735268027,0.8244897959183674
9016,0.9091,1,0,1,676401,43,126055,201,0.0003405778735268027,0.8237704918032787
9017,0.9092,1,1,1,676402,42,126056,200,0.0003326574578633887,0.8264462809917356
9018,0.9093,1,1,1,676403,41,126057,199,0.00032473704219997465,0.8291666666666667
9019,0.9097,1,0,1,676403,41,126058,198,0.00032473704219997465,0.8284518828451883
9020,0.9098,1,0,1,676403,41,126059,197,0.00032473704219997465,0.8277310924369747
9021,0.91,2,0,2,676403,41,126061,195,0.00032473704219997465,0.826271186440678
9022,0.9102,2,0,2,676403,41,126063,193,0.00032473704219997465,0.8247863247863247
9023,0.9103,1,0,1,676403,41,126064,192,0.00032473704219997465,0.8240343347639485
9024,0.9105,1,0,1,676403,41,126065,191,0.00032473704219997465,0.8232758620689655
9025,0.9106,1,0,1,676403,41,126066,190,0.00032473704219997465,0.8225108225108225
9026,0.9107,1,0,1,676403,41,126067,189,0.00032473704219997465,0.8217391304347826
9027,0.9108,1,0,1,676403,41,126068,188,0.00032473704219997465,0.8209606986899564
9028,0.9109,2,0,2,676403,41,126070,186,0.00032473704219997465,0.8193832599118943
9029,0.911,2,0,2,676403,41,126072,184,0.00032473704219997465,0.8177777777777778
9030,0.9111,1,0,1,676403,41,126073,183,0.00032473704219997465,0.8169642857142857
9031,0.9112,2,1,2,676404,40,126075,181,0.0003168166265365606,0.8190045248868778
9032,0.9113,2,0,2,676404,40,126077,179,0.0003168166265365606,0.817351598173516
9033,0.9114,1,0,1,676404,40,126078,178,0.0003168166265365606,0.8165137614678899
9034,0.9115,1,0,1,676404,40,126079,177,0.0003168166265365606,0.815668202764977
9035,0.9116,1,1,1,676405,39,126080,176,0.0003088962108731466,0.8186046511627907
9036,0.9118,1,0,1,676405,39,126081,175,0.0003088962108731466,0.8177570093457944
9037,0.9119,2,0,2,676405,39,126083,173,0.0003088962108731466,0.8160377358490566
9038,0.9121,2,0,2,676405,39,126085,171,0.0003088962108731466,0.8142857142857143
9039,0.9122,1,0,1,676405,39,126086,170,0.0003088962108731466,0.8133971291866029
9040,0.9124,0,1,0,676406,38,126086,170,0.00030097579520973263,0.8173076923076923
9041,0.9126,1,0,1,676406,38,126087,169,0.00030097579520973263,0.8164251207729468
9042,0.9127,1,0,1,676406,38,126088,168,0.00030097579520973263,0.8155339805825242
9043,0.9128,1,0,1,676406,38,126089,167,0.00030097579520973263,0.8146341463414634
9044,0.9129,2,0,2,676406,38,126091,165,0.00030097579520973263,0.812807881773399
9045,0.9133,1,1,1,676407,37,126092,164,0.0002930553795463186,0.8159203980099502
9046,0.9135,1,0,1,676407,37,126093,163,0.0002930553795463186,0.815
9047,0.9136,1,1,1,676408,36,126094,162,0.0002851349638829046,0.8181818181818182
9048,0.9137,1,0,1,676408,36,126095,161,0.0002851349638829046,0.817258883248731
9049,0.9138,1,0,1,676408,36,126096,160,0.0002851349638829046,0.8163265306122449
9050,0.9141,0,1,0,676409,35,126096,160,0.00027721454821949055,0.8205128205128205
9051,0.9142,1,1,1,676410,34,126097,159,0.0002692941325560765,0.8238341968911918
9052,0.9145,2,0,2,676410,34,126099,157,0.0002692941325560765,0.8219895287958116
9053,0.9147,2,0,2,676410,34,126101,155,0.0002692941325560765,0.8201058201058201
9054,0.9149,1,0,1,676410,34,126102,154,0.0002692941325560765,0.8191489361702128
9055,0.915,2,0,2,676410,34,126104,152,0.0002692941325560765,0.8172043010752689
9056,0.9151,1,1,1,676411,33,126105,151,0.00026137371689266255,0.8206521739130435
9057,0.9152,2,0,2,676411,33,126107,149,0.00026137371689266255,0.8186813186813187
9058,0.9153,0,1,0,676412,32,126107,149,0.0002534533012292485,0.8232044198895028
9059,0.9154,1,0,1,676412,32,126108,148,0.0002534533012292485,0.8222222222222222
9060,0.916,1,0,1,676412,32,126109,147,0.0002534533012292485,0.8212290502793296
9061,0.9161,1,0,1,676412,32,126110,146,0.0002534533012292485,0.8202247191011236
9062,0.9162,1,1,1,676413,31,126111,145,0.0002455328855658345,0.8238636363636364
9063,0.9163,2,0,2,676413,31,126113,143,0.0002455328855658345,0.8218390804597702
9064,0.9165,1,0,1,676413,31,126114,142,0.0002455328855658345,0.8208092485549133
9065,0.9167,1,0,1,676413,31,126115,141,0.0002455328855658345,0.8197674418604651
9066,0.9168,1,0,1,676413,31,126116,140,0.0002455328855658345,0.8187134502923976
9067,0.9169,1,1,1,676414,30,126117,139,0.00023761246990242047,0.8224852071005917
9068,0.917,2,0,2,676414,30,126119,137,0.00023761246990242047,0.8203592814371258
9069,0.9172,1,0,1,676414,30,126120,136,0.00023761246990242047,0.8192771084337349
9070,0.9173,1,0,1,676414,30,126121,135,0.00023761246990242047,0.8181818181818182
9071,0.9174,1,0,1,676414,30,126122,134,0.00023761246990242047,0.8170731707317073
9072,0.9175,1,0,1,676414,30,126123,133,0.00023761246990242047,0.8159509202453987
9073,0.9177,1,1,1,676415,29,126124,132,0.00022969205423900647,0.8198757763975155
9074,0.9178,0,1,0,676416,28,126124,132,0.00022177163857559244,0.825
9075,0.918,1,0,1,676416,28,126125,131,0.00022177163857559244,0.8238993710691824
9076,0.9181,1,0,1,676416,28,126126,130,0.00022177163857559244,0.8227848101265823
9077,0.9182,1,1,1,676417,27,126127,129,0.00021385122291217844,0.8269230769230769
9078,0.9183,0,1,0,676418,26,126127,129,0.00020593080724876442,0.832258064516129
9079,0.9184,1,0,1,676418,26,126128,128,0.00020593080724876442,0.8311688311688312
9080,0.9186,0,1,0,676419,25,126128,128,0.0001980103915853504,0.8366013071895425
9081,0.9187,1,0,1,676419,25,126129,127,0.0001980103915853504,0.8355263157894737
9082,0.9189,1,0,1,676419,25,126130,126,0.0001980103915853504,0.8344370860927153
9083,0.919,1,0,1,676419,25,126131,125,0.0001980103915853504,0.8333333333333334
9084,0.9191,2,2,2,676421,23,126133,123,0.00018216956025852237,0.8424657534246576
9085,0.9193,2,0,2,676421,23,126135,121,0.00018216956025852237,0.8402777777777778
9086,0.9195,1,0,1,676421,23,126136,120,0.00018216956025852237,0.8391608391608392
9087,0.9198,1,0,1,676421,23,126137,119,0.00018216956025852237,0.8380281690140845
9088,0.9201,1,0,1,676421,23,126138,118,0.00018216956025852237,0.8368794326241135
9089,0.9204,2,0,2,676421,23,126140,116,0.00018216956025852237,0.8345323741007195
9090,0.9207,1,0,1,676421,23,126141,115,0.00018216956025852237,0.8333333333333334
9091,0.9208,3,0,3,676421,23,126144,112,0.00018216956025852237,0.8296296296296296
9092,0.9209,2,0,2,676421,23,126146,110,0.00018216956025852237,0.8270676691729323
9093,0.9211,2,0,2,676421,23,126148,108,0.00018216956025852237,0.8244274809160306
9094,0.9212,1,0,1,676421,23,126149,107,0.00018216956025852237,0.823076923076923
9095,0.9213,1,0,1,676421,23,126150,106,0.00018216956025852237,0.8217054263565892
9096,0.9214,2,0,2,676421,23,126152,104,0.00018216956025852237,0.8188976377952756
9097,0.9219,1,0,1,676421,23,126153,103,0.00018216956025852237,0.8174603174603174
9098,0.9222,1,0,1,676421,23,126154,102,0.00018216956025852237,0.816
9099,0.9223,0,1,0,676422,22,126154,102,0.00017424914459510834,0.8225806451612904
9100,0.9224,1,0,1,676422,22,126155,101,0.00017424914459510834,0.8211382113821138
9101,0.9225,1,1,1,676423,21,126156,100,0.00016632872893169434,0.8264462809917356
9102,0.923,1,0,1,676423,21,126157,99,0.00016632872893169434,0.825
9103,0.9232,1,1,1,676424,20,126158,98,0.0001584083132682803,0.8305084745762712
9104,0.9233,2,0,2,676424,20,126160,96,0.0001584083132682803,0.8275862068965517
9105,0.9237,3,0,3,676424,20,126163,93,0.0001584083132682803,0.8230088495575221
9106,0.9238,2,0,2,676424,20,126165,91,0.0001584083132682803,0.8198198198198198
9107,0.924,1,0,1,676424,20,126166,90,0.0001584083132682803,0.8181818181818182
9108,0.9242,1,0,1,676424,20,126167,89,0.0001584083132682803,0.8165137614678899
9109,0.9243,1,0,1,676424,20,126168,88,0.0001584083132682803,0.8148148148148148
9110,0.9245,1,0,1,676424,20,126169,87,0.0001584083132682803,0.8130841121495327
9111,0.9246,1,0,1,676424,20,126170,86,0.0001584083132682803,0.8113207547169812
9112,0.9249,1,0,1,676424,20,126171,85,0.0001584083132682803,0.8095238095238095
9113,0.9252,1,0,1,676424,20,126172,84,0.0001584083132682803,0.8076923076923077
9114,0.9255,1,0,1,676424,20,126173,83,0.0001584083132682803,0.8058252427184466
9115,0.9256,0,2,0,676426,18,126173,83,0.0001425674819414523,0.8217821782178217
9116,0.9257,1,0,1,676426,18,126174,82,0.0001425674819414523,0.82
9117,0.9258,0,1,0,676427,17,126174,82,0.00013464706627803826,0.8282828282828283
9118,0.9259,2,0,2,676427,17,126176,80,0.00013464706627803826,0.8247422680412371
9119,0.9261,1,0,1,676427,17,126177,79,0.00013464706627803826,0.8229166666666666
9120,0.9262,1,0,1,676427,17,126178,78,0.00013464706627803826,0.8210526315789474
9121,0.9264,1,0,1,676427,17,126179,77,0.00013464706627803826,0.8191489361702128
9122,0.9265,1,0,1,676427,17,126180,76,0.00013464706627803826,0.8172043010752689
9123,0.9266,1,0,1,676427,17,126181,75,0.00013464706627803826,0.8152173913043478
9124,0.9268,1,0,1,676427,17,126182,74,0.00013464706627803826,0.8131868131868132
9125,0.9274,1,0,1,676427,17,126183,73,0.00013464706627803826,0.8111111111111111
9126,0.9275,2,0,2,676427,17,126185,71,0.00013464706627803826,0.8068181818181818
9127,0.9282,1,0,1,676427,17,126186,70,0.00013464706627803826,0.8045977011494253
9128,0.9283,1,0,1,676427,17,126187,69,0.00013464706627803826,0.8023255813953488
9129,0.9285,1,2,1,676429,15,126188,68,0.00011880623495121023,0.8192771084337349
9130,0.9286,0,1,0,676430,14,126188,68,0.00011088581928779622,0.8292682926829268
9131,0.9288,1,0,1,676430,14,126189,67,0.00011088581928779622,0.8271604938271605
9132,0.929,1,0,1,676430,14,126190,66,0.00011088581928779622,0.825
9133,0.9295,0,1,0,676431,13,126190,66,0.00010296540362438221,0.8354430379746836
9134,0.9296,1,0,1,676431,13,126191,65,0.00010296540362438221,0.8333333333333334
9135,0.93,0,1,0,676432,12,126191,65,9.50449879609682e-05,0.8441558441558441
9136,0.9302,1,0,1,676432,12,126192,64,9.50449879609682e-05,0.8421052631578947
9137,0.9304,1,0,1,676432,12,126193,63,9.50449879609682e-05,0.84
9138,0.9308,1,0,1,676432,12,126194,62,9.50449879609682e-05,0.8378378378378378
9139,0.9311,1,0,1,676432,12,126195,61,9.50449879609682e-05,0.8356164383561644
9140,0.9314,1,0,1,676432,12,126196,60,9.50449879609682e-05,0.8333333333333334
9141,0.9316,0,1,0,676433,11,126196,60,8.712457229755417e-05,0.8450704225352113
9142,0.9317,1,0,1,676433,11,126197,59,8.712457229755417e-05,0.8428571428571429
9143,0.9318,1,0,1,676433,11,126198,58,8.712457229755417e-05,0.8405797101449275
9144,0.9319,1,0,1,676433,11,126199,57,8.712457229755417e-05,0.8382352941176471
9145,0.9324,1,0,1,676433,11,126200,56,8.712457229755417e-05,0.835820895522388
9146,0.9326,1,0,1,676433,11,126201,55,8.712457229755417e-05,0.8333333333333334
9147,0.9327,1,0,1,676433,11,126202,54,8.712457229755417e-05,0.8307692307692308
9148,0.9329,2,0,2,676433,11,126204,52,8.712457229755417e-05,0.8253968253968254
9149,0.933,3,0,3,676433,11,126207,49,8.712457229755417e-05,0.8166666666666667
9150,0.9336,1,0,1,676433,11,126208,48,8.712457229755417e-05,0.8135593220338984
9151,0.9341,1,0,1,676433,11,126209,47,8.712457229755417e-05,0.8103448275862069
9152,0.9342,2,0,2,676433,11,126211,45,8.712457229755417e-05,0.8035714285714286
9153,0.9352,0,1,0,676434,10,126211,45,7.920415663414016e-05,0.8181818181818182
9154,0.9355,1,0,1,676434,10,126212,44,7.920415663414016e-05,0.8148148148148148
9155,0.9358,1,0,1,676434,10,126213,43,7.920415663414016e-05,0.8113207547169812
9156,0.9361,1,0,1,676434,10,126214,42,7.920415663414016e-05,0.8076923076923077
9157,0.9366,1,0,1,676434,10,126215,41,7.920415663414016e-05,0.803921568627451
9158,0.9367,1,0,1,676434,10,126216,40,7.920415663414016e-05,0.8
9159,0.9368,1,0,1,676434,10,126217,39,7.920415663414016e-05,0.7959183673469388
9160,0.937,1,0,1,676434,10,126218,38,7.920415663414016e-05,0.7916666666666666
9161,0.9373,1,0,1,676434,10,126219,37,7.920415663414016e-05,0.7872340425531915
9162,0.9375,1,0,1,676434,10,126220,36,7.920415663414016e-05,0.782608695652174
9163,0.9376,2,0,2,676434,10,126222,34,7.920415663414016e-05,0.7727272727272727
9164,0.9378,1,0,1,676434,10,126223,33,7.920415663414016e-05,0.7674418604651163
9165,0.938,0,1,0,676435,9,126223,33,7.128374097072614e-05,0.7857142857142857
9166,0.9384,1,0,1,676435,9,126224,32,7.128374097072614e-05,0.7804878048780488
9167,0.9388,2,0,2,676435,9,126226,30,7.128374097072614e-05,0.7692307692307693
9168,0.9392,1,0,1,676435,9,126227,29,7.128374097072614e-05,0.7631578947368421
9169,0.9395,1,0,1,676435,9,126228,28,7.128374097072614e-05,0.7567567567567568
9170,0.9397,1,0,1,676435,9,126229,27,7.128374097072614e-05,0.75
9171,0.9398,0,1,0,676436,8,126229,27,6.336332530731213e-05,0.7714285714285715
9172,0.9401,1,0,1,676436,8,126230,26,6.336332530731213e-05,0.7647058823529411
9173,0.9407,1,0,1,676436,8,126231,25,6.336332530731213e-05,0.7575757575757576
9174,0.9411,1,0,1,676436,8,126232,24,6.336332530731213e-05,0.75
9175,0.9412,1,0,1,676436,8,126233,23,6.336332530731213e-05,0.7419354838709677
9176,0.9413,1,0,1,676436,8,126234,22,6.336332530731213e-05,0.7333333333333333
9177,0.9414,0,1,0,676437,7,126234,22,5.544290964389811e-05,0.7586206896551724
9178,0.9415,0,1,0,676438,6,126234,22,4.75224939804841e-05,0.7857142857142857
9179,0.942,1,0,1,676438,6,126235,21,4.75224939804841e-05,0.7777777777777778
9180,0.9421,1,0,1,676438,6,126236,20,4.75224939804841e-05,0.7692307692307693
9181,0.9435,1,0,1,676438,6,126237,19,4.75224939804841e-05,0.76
9182,0.9441,0,1,0,676439,5,126237,19,3.960207831707008e-05,0.7916666666666666
9183,0.9442,1,0,1,676439,5,126238,18,3.960207831707008e-05,0.782608695652174
9184,0.9446,0,1,0,676440,4,126238,18,3.1681662653656065e-05,0.8181818181818182
9185,0.9473,1,0,1,676440,4,126239,17,3.1681662653656065e-05,0.8095238095238095
9186,0.9478,1,0,1,676440,4,126240,16,3.1681662653656065e-05,0.8
9187,0.949,1,0,1,676440,4,126241,15,3.1681662653656065e-05,0.7894736842105263
9188,0.9507,1,0,1,676440,4,126242,14,3.1681662653656065e-05,0.7777777777777778
9189,0.9515,1,0,1,676440,4,126243,13,3.1681662653656065e-05,0.7647058823529411
9190,0.9517,1,0,1,676440,4,126244,12,3.1681662653656065e-05,0.75
9191,0.9528,0,1,0,676441,3,126244,12,2.376124699024205e-05,0.8
9192,0.9533,1,0,1,676441,3,126245,11,2.376124699024205e-05,0.7857142857142857
9193,0.9534,1,0,1,676441,3,126246,10,2.376124699024205e-05,0.7692307692307693
9194,0.9539,1,0,1,676441,3,126247,9,2.376124699024205e-05,0.75
9195,0.955,1,0,1,676441,3,126248,8,2.376124699024205e-05,0.7272727272727273
9196,0.956,1,0,1,676441,3,126249,7,2.376124699024205e-05,0.7
9197,0.9562,1,0,1,676441,3,126250,6,2.376124699024205e-05,0.6666666666666666
9198,0.958,0,1,0,676442,2,126250,6,1.5840831326828033e-05,0.75
9199,0.9581,1,0,1,676442,2,126251,5,1.5840831326828033e-05,0.7142857142857143
9200,0.9602,1,0,1,676442,2,126252,4,1.5840831326828033e-05,0.6666666666666666
9201,0.9649,1,0,1,676442,2,126253,3,1.5840831326828033e-05,0.6
9202,0.9665,1,2,1,676444,0,126254,2,0.0,1.0
9203,0.9668,1,0,1,676444,0,126255,1,0.0,1.0
9204,0.9964,1,0,1,676444,0,126256,0,0.0,
